RequestID,ArrivalTime,DelayTime,FinishTime,InitiatorID,TargetID,IOType,Size,VolumeID,Offset
0,6150310652,135266,6150445918,5,0,0,223232,5,3540591140
1,6150329159,163212,6150492371,7,0,0,156672,7,9320998288
2,6150353648,108335,6150461983,2,0,1,19968,2,9021891981
3,6150385982,309568,6150695550,6,0,0,3072,6,1814264571
4,6150405714,264903,6150670617,8,0,0,393216,8,5615409797
5,6150416916,275206,6150692122,9,0,0,70144,9,6203156753
6,6150565615,4846,6150570461,0,0,1,18432,0,9211097787
7,6150754637,349067,6151103704,3,0,1,27648,3,2451063525
8,6150772055,72020,6150844075,6,0,0,5120,6,5140883752
9,6150853198,89061,6150942259,7,0,0,116736,7,6474309412
10,6150879902,274218,6151154120,8,0,1,512,8,2729807204
11,6150901506,115533,6151017039,2,0,1,392192,2,4533825264
12,6150911365,92322,6151003687,6,0,1,1024,6,3257445936
13,6150988574,211695,6151200269,1,0,0,191488,1,10533090169
14,6151015651,35567,6151051218,2,0,0,6144,2,8098441698
15,6151016903,231637,6151248540,7,0,1,9216,7,1423523456
16,6151195027,475725,6151670752,5,0,0,62464,5,4473209437
17,6151224537,161153,6151385690,1,0,1,1024,1,6563792143
18,6151371150,55049,6151426199,7,0,1,2048,7,3874659569
19,6151473499,112420,6151585919,7,0,1,69120,7,10391789191
20,6151599055,66975,6151666030,6,0,1,33280,6,4419447185
21,6151604700,101500,6151706200,5,0,0,113664,5,599158651
22,6151713705,30745,6151744450,8,0,0,49664,8,7303629531
23,6151720033,2942,6151722975,2,0,1,114176,2,8409702588
24,6151747034,135001,6151882035,6,0,0,3072,6,2063274925
25,6151823937,31651,6151855588,3,0,0,512,3,8811144453
26,6151857280,91276,6151948556,6,0,1,14848,6,1921853922
27,6151894476,86560,6151981036,7,0,1,24576,7,7447686757
28,6151949067,134035,6152083102,2,0,1,131584,2,3773886437
29,6152002983,77222,6152080205,8,0,1,35328,8,1163029781
30,6152049772,139516,6152189288,9,0,1,512,9,6178613513
31,6152204056,23204,6152227260,5,0,1,46080,5,10345908746
32,6152250912,105400,6152356312,5,0,0,38400,5,6304252058
33,6152309507,45592,6152355099,5,0,1,512,5,5814629318
34,6152379658,61444,6152441102,0,0,1,1024,0,7001923425
35,6152384671,146526,6152531197,5,0,1,7680,5,2680999227
36,6152411151,168996,6152580147,4,0,0,423936,4,728652699
37,6152487315,258833,6152746148,9,0,1,2048,9,446080199
38,6152553420,132600,6152686020,8,0,1,25600,8,7450617006
39,6152560276,188566,6152748842,0,0,1,13824,0,6848964797
40,6152573571,261421,6152834992,4,0,0,123904,4,1062774085
41,6152601013,289563,6152890576,1,0,0,276480,1,593075471
42,6152651641,51770,6152703411,7,0,1,5120,7,4535343133
43,6152868054,101100,6152969154,6,0,1,1024,6,4420301599
44,6152907788,383546,6153291334,9,0,0,83968,9,106576317
45,6153046995,90232,6153137227,7,0,1,21504,7,5789967503
46,6153050731,113554,6153164285,8,0,0,184320,8,3195948519
47,6153157796,126318,6153284114,6,0,1,30208,6,184817513
48,6153192564,101362,6153293926,9,0,0,163840,9,6907702963
49,6153252537,75291,6153327828,0,0,1,41984,0,5356981912
50,6153253803,100520,6153354323,9,0,1,9216,9,9853254687
51,6153259055,153086,6153412141,4,0,0,126464,4,171007580
52,6153261342,168564,6153429906,2,0,1,467968,2,891544008
53,6153275796,84729,6153360525,7,0,0,242176,7,5535005216
54,6153370321,43580,6153413901,7,0,1,8704,7,2438013825
55,6153417667,203540,6153621207,1,0,0,138240,1,978252306
56,6153460096,43196,6153503292,8,0,0,14336,8,9579081275
57,6153509237,619699,6154128936,0,0,1,33792,0,1318572361
58,6153553740,181041,6153734781,2,0,1,363520,2,3464974252
59,6153680174,504801,6154184975,7,0,0,70656,7,6514504573
60,6153700011,203036,6153903047,5,0,0,117760,5,4892896564
61,6153856920,561026,6154417946,9,0,1,4608,9,6860456462
62,6153937827,9161,6153946988,2,0,1,16384,2,1411714333
63,6154064036,214346,6154278382,3,0,0,3072,3,9691182987
64,6154087875,562,6154088437,7,0,1,1536,7,7972075133
65,6154093795,3894,6154097689,2,0,1,383488,2,8990602780
66,6154182349,13508,6154195857,0,0,1,39424,0,1290840787
67,6154188060,220970,6154409030,0,0,1,82432,0,8048633147
68,6154213408,33071,6154246479,3,0,0,512,3,8216313887
69,6154223329,208650,6154431979,3,0,0,4096,3,1743516329
70,6154233347,93304,6154326651,4,0,0,26112,4,6094622868
71,6154234305,448819,6154683124,5,0,1,1024,5,101403860
72,6154273915,308648,6154582563,7,0,1,14336,7,6177746869
73,6154284288,277909,6154562197,7,0,0,54272,7,8304233407
74,6154322100,394089,6154716189,3,0,0,151552,3,384006979
75,6154356402,121691,6154478093,7,0,1,26112,7,2391901298
76,6154429315,290524,6154719839,3,0,1,204288,3,3708520963
77,6154446514,258636,6154705150,1,0,1,1024,1,6141942148
78,6154462248,255472,6154717720,8,0,0,286720,8,10523388683
79,6154492251,244748,6154736999,8,0,1,8704,8,7615927198
80,6154519323,152999,6154672322,8,0,0,156160,8,5123323771
81,6154596026,12733,6154608759,6,0,1,23552,6,811013158
82,6154612058,390946,6155003004,2,0,0,1536,2,6423100850
83,6154614522,638408,6155252930,8,0,1,42496,8,3855126925
84,6154698430,142246,6154840676,2,0,1,180224,2,6795092351
85,6154823319,424235,6155247554,4,0,0,24576,4,8582193435
86,6154906587,533834,6155440421,5,0,1,39936,5,10286106993
87,6154925488,320349,6155245837,1,0,0,147456,1,121978691
88,6155040916,654416,6155695332,7,0,0,931840,7,8782982662
89,6155192098,504540,6155696638,6,0,0,2048,6,6253620703
90,6155339486,367777,6155707263,8,0,0,34304,8,5052776639
91,6155386348,322541,6155708889,6,0,0,2560,6,3357256734
92,6155440148,209461,6155649609,6,0,1,6656,6,6853082629
93,6155500734,220702,6155721436,6,0,0,2048,6,1945964961
94,6155541796,361839,6155903635,7,0,0,168448,7,8102064550
95,6155590551,229076,6155819627,1,0,0,183296,1,7799101124
96,6155705647,156529,6155862176,5,0,0,138240,5,2144156121
97,6155710721,105582,6155816303,3,0,1,271872,3,8931565512
98,6155742166,237576,6155979742,1,0,1,9728,1,7771548689
99,6155757055,289335,6156046390,5,0,0,10240,5,8288771383
100,6155826579,488040,6156314619,0,0,1,8704,0,9624662150
101,6155870265,333507,6156203772,8,0,1,16384,8,8349299950
102,6155978411,150614,6156129025,8,0,0,418816,8,3893662617
103,6155988934,257572,6156246506,2,0,1,10752,2,5206478166
104,6156016310,233507,6156249817,1,0,1,1024,1,2223542234
105,6156048431,265951,6156314382,6,0,1,21504,6,6546803263
106,6156065894,101362,6156167256,6,0,1,29696,6,4868021559
107,6156117345,421352,6156538697,5,0,1,20480,5,107893078
108,6156302118,7187,6156309305,7,0,0,163840,7,109572915
109,6156400269,455337,6156855606,6,0,1,46080,6,8452622292
110,6156403110,187271,6156590381,9,0,0,6656,9,5893857488
111,6156404419,159218,6156563637,0,0,1,12288,0,2211727234
112,6156458822,163219,6156622041,5,0,1,3584,5,3211333151
113,6156525473,145555,6156671028,5,0,1,22016,5,5794421585
114,6156555850,360104,6156915954,1,0,1,29696,1,3471077259
115,6156564968,213015,6156777983,0,0,1,27136,0,5584232907
116,6156759792,168540,6156928332,9,0,0,276992,9,667752581
117,6156807555,127543,6156935098,5,0,0,144896,5,7773539583
118,6156843567,163566,6157007133,8,0,1,12800,8,8842565975
119,6156857089,197579,6157054668,0,0,1,22528,0,4281678782
120,6156900231,284930,6157185161,3,0,1,39936,3,6022016028
121,6157014763,202714,6157217477,9,0,1,40960,9,10574125117
122,6157024459,112612,6157137071,7,0,1,5120,7,2554303274
123,6157154286,292715,6157447001,1,0,1,54784,1,8057941393
124,6157187048,282412,6157469460,2,0,1,176128,2,6280490281
125,6157267186,150743,6157417929,3,0,1,166912,3,1609114447
126,6157322940,257380,6157580320,6,0,1,13824,6,10543264754
127,6157335524,218850,6157554374,4,0,0,359424,4,6618457422
128,6157336124,224663,6157560787,5,0,0,30720,5,9504781569
129,6157362465,209971,6157572436,5,0,0,39424,5,10605846557
130,6157478324,60637,6157538961,0,0,1,8192,0,9991709442
131,6157508629,91753,6157600382,5,0,1,1536,5,5005952956
132,6157522833,172858,6157695691,3,0,0,36352,3,10473808765
133,6157575597,104278,6157679875,9,0,0,148480,9,10085314537
134,6157584372,325197,6157909569,3,0,0,69120,3,8217050906
135,6157821593,2466,6157824059,2,0,0,2560,2,3226869394
136,6157864067,163145,6158027212,8,0,0,264192,8,6662764498
137,6158041223,118469,6158159692,8,0,1,6144,8,6831473913
138,6158062775,161795,6158224570,5,0,1,21504,5,2212829670
139,6158102713,160905,6158263618,5,0,1,23552,5,3149444533
140,6158147435,114071,6158261506,2,0,1,219648,2,3522053241
141,6158159934,147179,6158307113,3,0,0,185344,3,5491216316
142,6158164345,96300,6158260645,8,0,0,122368,8,9167830588
143,6158186103,68445,6158254548,6,0,1,34816,6,1952373702
144,6158216530,35108,6158251638,2,0,0,2048,2,2978317042
145,6158245051,1514,6158246565,2,0,0,1024,2,6954134678
146,6158283880,295368,6158579248,8,0,0,26112,8,4256238361
147,6158332760,1514,6158334274,2,0,0,1536,2,8023982447
148,6158460510,297803,6158758313,6,0,0,1536,6,903802837
149,6158484941,34016,6158518957,7,0,0,59392,7,6361094456
150,6158538635,271636,6158810271,3,0,1,284160,3,3816529026
151,6158612746,253274,6158866020,0,0,1,70656,0,7280441126
152,6158636158,307908,6158944066,0,0,0,502784,0,7080508096
153,6158636342,350273,6158986615,9,0,0,138240,9,4993499855
154,6158767077,394548,6159161625,4,0,0,505344,4,9377417617
155,6158780703,468542,6159249245,5,0,0,280064,5,6253714276
156,6158831705,398584,6159230289,5,0,1,27648,5,9508539908
157,6158854847,313399,6159168246,6,0,0,6656,6,5611228540
158,6158956814,1514,6158958328,4,0,0,55808,4,1902862674
159,6159129655,584973,6159714628,7,0,1,11264,7,8394389457
160,6159305040,93733,6159398773,3,0,0,1536,3,4293796675
161,6159341065,325790,6159666855,9,0,0,155648,9,9665944965
162,6159503152,75550,6159578702,5,0,0,126976,5,6935054475
163,6159513567,71753,6159585320,5,0,0,23552,5,2508136262
164,6159551899,390200,6159942099,0,0,0,636416,0,1538279291
165,6159565241,380084,6159945325,6,0,0,5120,6,4138375005
166,6159574337,433352,6160007689,4,0,0,200192,4,7176203575
167,6159610541,282384,6159892925,6,0,1,20480,6,2170256155
168,6159767179,313254,6160080433,2,0,1,329216,2,6389237176
169,6159831966,5798,6159837764,5,0,1,63488,5,8922077725
170,6159836445,646163,6160482608,6,0,1,62976,6,4185744244
171,6159952311,809052,6160761363,6,0,1,58368,6,5902103991
172,6160100905,485077,6160585982,7,0,1,34816,7,1170162184
173,6160201231,138605,6160339836,3,0,0,6144,3,3651442963
174,6160298802,2942,6160301744,1,0,0,201728,1,6310426285
175,6160400091,401899,6160801990,7,0,1,25088,7,3268902088
176,6160443116,229702,6160672818,8,0,0,3072,8,2642411193
177,6160455468,188260,6160643728,8,0,1,42496,8,1743370878
178,6160560305,18391,6160578696,9,0,1,54272,9,2105040475
179,6160625348,1514,6160626862,5,0,0,9216,5,8163393409
180,6160661959,156473,6160818432,2,0,0,1536,2,1013212497
181,6160676165,94079,6160770244,5,0,0,153088,5,4544617858
182,6160696396,175435,6160871831,0,0,1,24576,0,6727542231
183,6160783851,91891,6160875742,5,0,1,12800,5,4170154358
184,6160822650,205454,6161028104,3,0,1,300032,3,865716705
185,6160835261,196355,6161031616,2,0,1,27648,2,10637649192
186,6160843760,373027,6161216787,3,0,0,333312,3,9603698281
187,6160874262,368851,6161243113,7,0,0,77824,7,10090269284
188,6160939669,295828,6161235497,8,0,1,32768,8,1482154715
189,6161025066,269025,6161294091,5,0,1,23552,5,10715914221
190,6161129091,101620,6161230711,2,0,1,425472,2,4121854627
191,6161204933,25444,6161230377,7,0,0,164352,7,4557477614
192,6161247371,28708,6161276079,6,0,1,14336,6,5683341137
193,6161281775,223145,6161504920,6,0,0,1024,6,6291080230
194,6161284208,522588,6161806796,4,0,0,27136,4,7545553807
195,6161342484,309206,6161651690,0,0,0,379392,0,7285295252
196,6161381952,424393,6161806345,2,0,1,75264,2,5757345396
197,6161464237,428374,6161892611,3,0,0,697344,3,7429050696
198,6161489222,506305,6161995527,1,0,0,328704,1,6476104094
199,6161554888,338376,6161893264,5,0,0,128512,5,8824752416
200,6161580920,477748,6162058668,0,0,0,28160,0,2807679336
201,6161660677,457617,6162118294,1,0,0,100352,1,9897697329
202,6161666692,409119,6162075811,9,0,1,22016,9,9009213972
203,6161733254,276709,6162009963,6,0,1,46080,6,621566779
204,6161796953,416862,6162213815,2,0,0,6144,2,3742240044
205,6161983678,167338,6162151016,5,0,0,255488,5,5599143146
206,6162008416,144226,6162152642,1,0,0,2560,1,7137487156
207,6162039474,175942,6162215416,9,0,0,202240,9,98069572
208,6162186863,228975,6162415838,6,0,1,8704,6,2833786423
209,6162205118,309278,6162514396,1,0,0,375808,1,8017780842
210,6162264617,233996,6162498613,6,0,1,24576,6,7290385898
211,6162277451,291024,6162568475,7,0,0,255488,7,10084252961
212,6162293118,276072,6162569190,3,0,0,186368,3,334952711
213,6162348303,185198,6162533501,1,0,1,512,1,175511902
214,6162389586,249828,6162639414,4,0,0,18432,4,333242644
215,6162398069,206794,6162604863,1,0,1,25600,1,1566113855
216,6162398840,180362,6162579202,7,0,0,106496,7,2327922149
217,6162431993,194977,6162626970,4,0,0,24064,4,9348338191
218,6162433443,151029,6162584472,2,0,0,60416,2,746761774
219,6162482217,114180,6162596397,6,0,0,7680,6,358265963
220,6162499572,194083,6162693655,7,0,1,4096,7,5305072287
221,6162513240,155516,6162668756,1,0,1,119296,1,5692768155
222,6162549997,64452,6162614449,9,0,1,14336,9,1614068379
223,6162571338,390992,6162962330,7,0,0,256000,7,10616515990
224,6162668611,370339,6163038950,1,0,0,29696,1,1712501124
225,6162672280,92132,6162764412,3,0,1,32256,3,7010869461
226,6162755624,321773,6163077397,7,0,1,3584,7,3734424875
227,6162791458,268187,6163059645,8,0,0,96768,8,10173503022
228,6162826415,222289,6163048704,8,0,1,17920,8,2713994258
229,6162880133,187018,6163067151,1,0,1,27648,1,9056411575
230,6162986925,203483,6163190408,4,0,0,318976,4,7433900812
231,6163023782,229502,6163253284,4,0,0,202752,4,1532821325
232,6163199582,54368,6163253950,4,0,0,1024,4,1605031477
233,6163268768,6274,6163275042,3,0,1,147456,3,1388348668
234,6163269266,220409,6163489675,5,0,1,27648,5,10131963421
235,6163289537,83696,6163373233,6,0,0,6656,6,4147458981
236,6163396246,332100,6163728346,6,0,1,2560,6,8560651534
237,6163427156,533453,6163960609,9,0,0,136192,9,3441680206
238,6163495896,448465,6163944361,2,0,1,358400,2,6596764222
239,6163603028,266018,6163869046,0,0,1,7680,0,2185121842
240,6163610558,227901,6163838459,8,0,1,4096,8,3925904512
241,6163678354,210173,6163888527,7,0,0,274944,7,5512037781
242,6163716950,335595,6164052545,7,0,1,1536,7,8753015543
243,6163734713,345476,6164080189,2,0,0,130048,2,4053692678
244,6163775952,175255,6163951207,5,0,1,8704,5,3112369564
245,6163850573,272889,6164123462,7,0,1,23040,7,8973239589
246,6163852474,310761,6164163235,4,0,0,290816,4,942358941
247,6163855720,225421,6164081141,6,0,1,7680,6,8712464964
248,6163889371,339266,6164228637,8,0,1,9728,8,5592709932
249,6163904040,319769,6164223809,7,0,0,562688,7,2244680837
250,6163916397,444846,6164361243,7,0,1,90112,7,792317761
251,6163928956,480343,6164409299,8,0,1,35328,8,3871456864
252,6163943381,455960,6164399341,1,0,1,1536,1,3016940185
253,6163980419,556217,6164536636,4,0,0,175104,4,3750799412
254,6163988573,469543,6164458116,9,0,1,12288,9,5423356001
255,6164003082,188858,6164191940,1,0,0,39424,1,8026994570
256,6164283778,124378,6164408156,7,0,0,18432,7,10699463289
257,6164348269,537780,6164886049,4,0,0,11264,4,1034378130
258,6164363882,3894,6164367776,0,0,1,12800,0,383201273
259,6164422223,228707,6164650930,3,0,1,122368,3,2111483133
260,6164518036,335171,6164853207,8,0,1,54784,8,3503984635
261,6164548033,260770,6164808803,7,0,0,4096,7,1206124944
262,6164718080,225358,6164943438,9,0,0,368640,9,1226039735
263,6164725963,234255,6164960218,0,0,1,36864,0,8898489304
264,6164751220,225948,6164977168,9,0,0,135680,9,4180977892
265,6164760532,200786,6164961318,3,0,1,133120,3,9685484631
266,6164764916,74518,6164839434,6,0,0,17408,6,9847190056
267,6164828963,288090,6165117053,9,0,1,13824,9,5402563050
268,6164842688,402540,6165245228,9,0,0,169984,9,3238307218
269,6164943848,467572,6165411420,9,0,1,30208,9,2893516032
270,6164980707,337058,6165317765,2,0,0,48128,2,7868017016
271,6165003152,183137,6165186289,0,0,1,27136,0,7388044003
272,6165177719,244084,6165421803,8,0,0,296448,8,1785830873
273,6165195047,223748,6165418795,0,0,0,251904,0,6015759796
274,6165196712,457936,6165654648,9,0,1,22528,9,3856567977
275,6165201782,203575,6165405357,8,0,1,25600,8,9964560774
276,6165225905,291141,6165517046,4,0,0,41984,4,7048498893
277,6165257524,6274,6165263798,5,0,0,26112,5,3828369805
278,6165501762,354107,6165855869,0,0,0,6656,0,7724267723
279,6165545960,31003,6165576963,1,0,1,1024,1,710337253
280,6165600943,5450,6165606393,3,0,1,306688,3,6785482425
281,6165615021,222082,6165837103,7,0,0,50176,7,8984281958
282,6165628850,309383,6165938233,0,0,1,9216,0,7854878375
283,6165696642,284303,6165980945,3,0,0,13824,3,5919347127
284,6165733568,221942,6165955510,2,0,1,64512,2,5913314893
285,6165843829,140175,6165984004,2,0,1,258560,2,9666006535
286,6165907549,52248,6165959797,0,0,0,218624,0,8751199380
287,6165913229,364801,6166278030,2,0,1,96768,2,6799740837
288,6165998702,179797,6166178499,9,0,0,5120,9,1535913234
289,6166017793,376089,6166393882,1,0,1,29696,1,9696231099
290,6166028844,309528,6166338372,4,0,0,230912,4,8075882619
291,6166035530,302106,6166337636,0,0,1,33792,0,6465785644
292,6166182891,181017,6166363908,1,0,0,255488,1,3022461479
293,6166191716,93240,6166284956,7,0,1,22528,7,6802845284
294,6166275814,93993,6166369807,9,0,0,8192,9,7690079300
295,6166318377,56608,6166374985,4,0,0,125440,4,5069266804
296,6166358028,40949,6166398977,7,0,0,3584,7,1362130306
297,6166359787,275039,6166634826,5,0,1,512,5,10338376309
298,6166369497,44400,6166413897,3,0,1,161792,3,920669981
299,6166390674,32295,6166422969,8,0,0,65024,8,3008691054
300,6166392025,309044,6166701069,0,0,1,2048,0,3114332991
301,6166428709,318921,6166747630,1,0,1,1536,1,5547559493
302,6166482422,250478,6166732900,4,0,0,76288,4,7204735753
303,6166555430,321271,6166876701,2,0,1,58368,2,5556902013
304,6166555516,23462,6166578978,2,0,1,108032,2,1603460356
305,6166566495,4158,6166570653,4,0,0,52736,4,2373853596
306,6166610102,214297,6166824399,2,0,1,149504,2,1662869605
307,6166667422,21395,6166688817,2,0,1,295424,2,8267917411
308,6166668045,349737,6167017782,0,0,1,53760,0,10703871500
309,6166712525,510301,6167222826,2,0,0,38912,2,5791531760
310,6166747524,120202,6166867726,8,0,0,11264,8,5769808589
311,6166816937,105842,6166922779,1,0,0,34816,1,731023422
312,6166951908,597848,6167549756,3,0,0,181760,3,10184795036
313,6166958517,175047,6167133564,0,0,1,35328,0,6241164600
314,6166972477,166779,6167139256,8,0,0,21504,8,9908362421
315,6167090234,317550,6167407784,8,0,0,143360,8,3707629653
316,6167098513,624421,6167722934,1,0,0,123392,1,923280854
317,6167133873,158604,6167292477,2,0,0,157184,2,3896053733
318,6167139799,13508,6167153307,3,0,1,66048,3,799760711
319,6167337451,102920,6167440371,5,0,1,14848,5,6167352072
320,6167351449,76954,6167428403,5,0,1,11264,5,6634971695
321,6167357313,116650,6167473963,8,0,1,11776,8,7277988956
322,6167367124,127993,6167495117,0,0,0,26112,0,10014185517
323,6167383290,437461,6167820751,0,0,0,120832,0,5172102912
324,6167397141,346598,6167743739,2,0,0,171008,2,5766249083
325,6167481941,216266,6167698207,2,0,0,354304,2,4929034068
326,6167502397,120778,6167623175,1,0,1,35328,1,7363995189
327,6167580015,64738,6167644753,6,0,0,4096,6,10572477385
328,6167614085,1038,6167615123,1,0,1,3072,1,2849233799
329,6167686960,246970,6167933930,2,0,0,105984,2,1995035535
330,6167703332,26475,6167729807,2,0,1,114176,2,7834207834
331,6167733070,1514,6167734584,3,0,1,17408,3,1024166448
332,6167780634,465325,6168245959,8,0,1,1536,8,4983233342
333,6167792580,274078,6168066658,6,0,0,1024,6,9988639896
334,6167841933,258561,6168100494,0,0,0,48128,0,7438613456
335,6167887013,74258,6167961271,9,0,0,1536,9,4521067395
336,6168008481,16904,6168025385,0,0,0,124416,0,6440380577
337,6168067141,423761,6168490902,7,0,0,2048,7,3983857516
338,6168114389,16114,6168130503,7,0,0,3584,7,4100111202
339,6168156799,42937,6168199736,1,0,0,70144,1,1067873073
340,6168170487,114906,6168285393,7,0,1,30720,7,4646871207
341,6168293647,101032,6168394679,2,0,1,31744,2,388445592
342,6168384931,278050,6168662981,8,0,0,454656,8,4636042124
343,6168427499,293328,6168720827,8,0,0,186880,8,7793246323
344,6168427863,213007,6168640870,0,0,1,92672,0,448202953
345,6168454104,152241,6168606345,5,0,1,4608,5,222856910
346,6168513517,340449,6168853966,2,0,0,18944,2,228296802
347,6168590246,394937,6168985183,0,0,0,51712,0,9670364474
348,6168609950,212869,6168822819,1,0,0,250880,1,1759604350
349,6168625895,124216,6168750111,2,0,1,40960,2,4833259572
350,6168718052,13578,6168731630,5,0,0,71168,5,5199424175
351,6168797332,63962,6168861294,3,0,1,166400,3,10096620000
352,6168829996,408848,6169238844,9,0,0,2048,9,6892876777
353,6168847053,441601,6169288654,1,0,0,104448,1,1228625141
354,6168850261,142191,6168992452,1,0,1,18944,1,2282060946
355,6169069867,189455,6169259322,0,0,1,24064,0,8174610279
356,6169106737,426978,6169533715,0,0,1,32768,0,10072964908
357,6169174778,102472,6169277250,1,0,0,164352,1,6825176522
358,6169256586,96977,6169353563,0,0,0,156672,0,535097540
359,6169307139,48050,6169355189,7,0,0,2560,7,5307995397
360,6169499321,54052,6169553373,9,0,1,3584,9,7671357740
361,6169646274,56075,6169702349,4,0,0,95744,4,454857779
362,6169665352,166693,6169832045,1,0,0,258048,1,6039147972
363,6169692663,140688,6169833351,7,0,0,2048,7,8736918689
364,6169876773,92613,6169969386,0,0,1,512,0,1666951377
365,6170011295,65452,6170076747,5,0,1,10752,5,384802104
366,6170037665,92986,6170130651,3,0,1,36864,3,10316307838
367,6170087297,166222,6170253519,1,0,1,14848,1,4709815881
368,6170088062,128443,6170216505,7,0,1,1536,7,6089980827
369,6170178391,134564,6170312955,3,0,1,90112,3,1924995092
370,6170243606,128515,6170372121,5,0,1,56320,5,9795255795
371,6170255486,151197,6170406683,9,0,1,16896,9,4385110023
372,6170293062,193932,6170486994,8,0,1,70144,8,1355161814
373,6170373122,70145,6170443267,3,0,1,235520,3,5189506912
374,6170379284,35825,6170415109,0,0,0,104448,0,10373747897
375,6170421440,257008,6170678448,8,0,1,81408,8,10487849334
376,6170512170,16101,6170528271,8,0,0,62976,8,1740701754
377,6170530889,4416,6170535305,7,0,1,45056,7,7811209689
378,6170601406,302181,6170903587,7,0,1,23040,7,7828521111
379,6170612438,220430,6170832868,0,0,1,11776,0,7303362085
380,6170616061,142480,6170758541,6,0,0,2048,6,9433419489
381,6170688067,214714,6170902781,7,0,0,11776,7,9569480508
382,6170693935,283870,6170977805,5,0,0,459264,5,8526089730
383,6170699524,283670,6170983194,8,0,0,17408,8,888314166
384,6170708056,306909,6171014965,1,0,0,102912,1,6607876145
385,6170776115,240476,6171016591,7,0,0,2560,7,5177336227
386,6170969636,36702,6171006338,5,0,1,20992,5,1675729187
387,6170990616,31520,6171022136,8,0,0,34816,8,2992346721
388,6171033169,100552,6171133721,1,0,0,51200,1,3379026674
389,6171040795,73358,6171114153,0,0,0,150016,0,620482210
390,6171073135,126175,6171199310,6,0,0,8192,6,4022737912
391,6171108617,406198,6171514815,4,0,0,208896,4,6698820303
392,6171134544,257555,6171392099,4,0,0,903168,4,1637070652
393,6171216625,511958,6171728583,8,0,1,48640,8,2163599056
394,6171304919,595798,6171900717,2,0,0,60416,2,131896609
395,6171394817,441488,6171836305,6,0,0,2560,6,7904837692
396,6171405532,353216,6171758748,3,0,1,35328,3,9267846101
397,6171497971,353806,6171851777,8,0,1,18432,8,3693172622
398,6171503010,233231,6171736241,4,0,0,964096,4,9641516392
399,6171538415,592700,6172131115,8,0,0,18944,8,4256300643
400,6171567028,562992,6172130020,2,0,1,109568,2,8074120586
401,6171657187,589518,6172246705,1,0,0,92160,1,1503607028
402,6171661820,499370,6172161190,4,0,0,65536,4,7413413259
403,6171742513,335072,6172077585,8,0,1,34816,8,3860728708
404,6171787490,500375,6172287865,9,0,1,6656,9,10226641046
405,6171807878,346123,6172154001,1,0,1,64000,1,1301982227
406,6171827112,466750,6172293862,8,0,1,18432,8,3684113834
407,6171828095,486372,6172314467,0,0,1,39424,0,3763942129
408,6171842299,632073,6172474372,2,0,1,153600,2,8687137404
409,6171847416,662314,6172509730,3,0,1,15872,3,6534467014
410,6171879952,521697,6172401649,5,0,0,1134592,5,8311878211
411,6171931434,700804,6172632238,4,0,0,146432,4,10545362111
412,6171974272,692384,6172666656,9,0,1,52224,9,582807832
413,6171984059,728329,6172712388,8,0,1,3584,8,10363545594
414,6171989820,709706,6172699526,3,0,1,17920,3,170162363
415,6171992906,521713,6172514619,1,0,0,223744,1,6980130370
416,6172027448,472645,6172500093,2,0,1,325120,2,5069345884
417,6172180910,270656,6172451566,1,0,0,11776,1,95516072
418,6172229989,471406,6172701395,0,0,0,46080,0,6258724347
419,6172264812,856947,6173121759,8,0,1,4608,8,1132619249
420,6172343472,900046,6173243518,5,0,0,404480,5,1589398828
421,6172377312,344507,6172721819,0,0,0,93696,0,10247936170
422,6172380727,547672,6172928399,9,0,1,57856,9,6856442104
423,6172445993,513851,6172959844,1,0,1,4096,1,98979860
424,6172459237,433497,6172892734,3,0,1,5120,3,8911686472
425,6172478498,414247,6172892745,1,0,0,99840,1,7644101954
426,6172509941,264098,6172774039,9,0,1,1024,9,4375385744
427,6172546618,252968,6172799586,7,0,1,4096,7,5591841308
428,6172605491,262087,6172867578,7,0,1,72704,7,10011090456
429,6172628658,452454,6173081112,6,0,0,3584,6,9720463806
430,6172639807,111572,6172751379,6,0,0,3584,6,4719566048
431,6172663564,429146,6173092710,2,0,0,111616,2,8455045880
432,6172702188,138694,6172840882,3,0,1,10752,3,6227708407
433,6172757056,671560,6173428616,7,0,1,33280,7,10043034638
434,6172814630,134831,6172949461,7,0,1,25600,7,7732104807
435,6172842567,101428,6172943995,7,0,1,9728,7,369555298
436,6172885605,378078,6173263683,4,0,0,117248,4,2165229657
437,6172895954,299403,6173195357,8,0,0,24064,8,6655483021
438,6172931404,68785,6173000189,3,0,0,100352,3,8288874580
439,6172975322,443593,6173418915,7,0,0,5120,7,7567098217
440,6173045259,458713,6173503972,4,0,0,69632,4,9268499968
441,6173114934,231266,6173346200,5,0,0,382976,5,5543419278
442,6173133726,189761,6173323487,9,0,1,2560,9,1647894783
443,6173156695,79628,6173236323,3,0,0,9216,3,5596542216
444,6173282586,92392,6173374978,3,0,0,50688,3,10598723381
445,6173310887,309472,6173620359,3,0,0,128000,3,6769438638
446,6173380119,142792,6173522911,5,0,1,3072,5,5347100564
447,6173394878,154829,6173549707,9,0,1,6656,9,3845068013
448,6173439440,72213,6173511653,2,0,0,251392,2,7767125507
449,6173479994,66471,6173546465,9,0,1,9728,9,7278177578
450,6173523362,49089,6173572451,9,0,0,2048,9,6900634675
451,6173533930,284393,6173818323,7,0,0,7680,7,2612343173
452,6173552900,31003,6173583903,2,0,0,15872,2,5740438390
453,6173640271,562,6173640833,2,0,0,50176,2,10501581213
454,6173678121,232864,6173910985,9,0,0,512,9,3549251904
455,6173692401,25442,6173717843,0,0,1,18432,0,4626269280
456,6173715977,23236,6173739213,7,0,1,5120,7,2860309386
457,6173726574,14690,6173741264,1,0,1,13824,1,7555788504
458,6173888347,7864,6173896211,0,0,0,46080,0,2306928056
459,6173890899,334546,6174225445,6,0,0,512,6,3953401168
460,6173899599,356237,6174255836,9,0,0,8704,9,1727684807
461,6173908691,446527,6174355218,9,0,0,3584,9,1726852044
462,6174153486,176263,6174329749,3,0,1,11776,3,4336523101
463,6174214968,314080,6174529048,2,0,1,163328,2,3674016000
464,6174373551,45304,6174418855,8,0,1,4096,8,9176555646
465,6174468348,13766,6174482114,2,0,1,431616,2,1097545814
466,6174484315,3894,6174488209,6,0,0,512,6,7510648348
467,6174515349,318307,6174833656,2,0,1,38912,2,2358405299
468,6174538152,31779,6174569931,5,0,1,37888,5,1924020412
469,6174554224,25066,6174579290,8,0,0,26624,8,3085466088
470,6174564195,44658,6174608853,1,0,1,28160,1,5337538012
471,6174584909,115690,6174700599,9,0,0,4096,9,10268873625
472,6174586261,424768,6175011029,5,0,1,9216,5,8914495382
473,6174621078,366519,6174987597,9,0,1,9216,9,6217179306
474,6174661444,401197,6175062641,1,0,0,51712,1,1154769489
475,6174668823,333104,6175001927,7,0,0,1024,7,6694954289
476,6174686481,363777,6175050258,3,0,0,76800,3,896741461
477,6174709560,134956,6174844516,2,0,1,165888,2,1098385275
478,6174808833,25506,6174834339,3,0,0,30720,3,6872126119
479,6174843992,24408,6174868400,9,0,1,23040,9,3017674994
480,6174886450,389151,6175275601,3,0,1,65024,3,6589490447
481,6174903264,232100,6175135364,5,0,1,50688,5,8926804868
482,6174918629,19860,6174938489,9,0,0,512,9,7520633771
483,6175000346,16651,6175016997,5,0,0,44032,5,4491172607
484,6175063775,2466,6175066241,2,0,1,43008,2,3745766294
485,6175073275,206842,6175280117,2,0,1,227328,2,9810586811
486,6175102593,407279,6175509872,9,0,0,4096,9,8640840484
487,6175106148,473582,6175579730,3,0,0,512,3,10623574958
488,6175194151,360550,6175554701,3,0,0,2560,3,7149267171
489,6175317433,101032,6175418465,1,0,1,26624,1,7167894708
490,6175349399,146548,6175495947,7,0,1,31744,7,9390783298
491,6175473242,102395,6175575637,0,0,0,165888,0,7053106698
492,6175475207,190780,6175665987,0,0,1,19456,0,768685207
493,6175488040,202134,6175690174,9,0,1,16384,9,9365370939
494,6175498990,205366,6175704356,3,0,1,32768,3,1769629150
495,6175525557,257142,6175782699,1,0,0,336384,1,2952954915
496,6175629473,115720,6175745193,5,0,0,33280,5,3548540294
497,6175659804,113925,6175773729,5,0,0,105984,5,4799456647
498,6175672216,112957,6175785173,9,0,0,46592,9,2022672610
499,6175696628,155735,6175852363,9,0,0,215040,9,4351999940
500,6175799845,216008,6176015853,9,0,0,353792,9,7752197514
501,6175962522,69396,6176031918,1,0,0,52224,1,3128776859
502,6176188347,62929,6176251276,4,0,0,102400,4,1853060472
503,6176265379,50668,6176316047,8,0,1,46592,8,2196785356
504,6176272257,150536,6176422793,5,0,1,2560,5,5073559110
505,6176279874,188217,6176468091,9,0,1,11264,9,147585278
506,6176359491,323259,6176682750,4,0,0,309760,4,2429937451
507,6176415250,157516,6176572766,0,0,0,155136,0,1089835866
508,6176435977,180243,6176616220,1,0,1,15872,1,3349624988
509,6176494194,13806,6176508000,5,0,1,5632,5,5761455952
510,6176539759,219296,6176759055,8,0,1,45568,8,3406760241
511,6176582673,267903,6176850576,6,0,0,1536,6,7232647891
512,6176762994,22969,6176785963,9,0,1,2048,9,6321125132
513,6176765414,76889,6176842303,9,0,1,13312,9,5314928247
514,6176789928,53634,6176843562,5,0,1,4096,5,1638914750
515,6176797506,109063,6176906569,2,0,0,21504,2,328303482
516,6177041115,3894,6177045009,7,0,0,4096,7,941861
517,6177179558,6274,6177185832,3,0,1,70144,3,2691811146
518,6177227228,112732,6177339960,7,0,0,6656,7,4450972678
519,6177283977,92946,6177376923,9,0,0,141312,9,5535270647
520,6177334669,86967,6177421636,0,0,1,30720,0,152706114
521,6177365895,147838,6177513733,5,0,0,145920,5,7952293780
522,6177415853,288950,6177704803,4,0,0,472576,4,7430414718
523,6177439636,295187,6177734823,2,0,0,314880,2,2213937708
524,6177466353,363462,6177829815,0,0,0,108032,0,4837616497
525,6177475949,367902,6177843851,3,0,1,25088,3,1744693776
526,6177489089,344132,6177833221,3,0,1,19968,3,10487136435
527,6177490584,380413,6177870997,1,0,0,10240,1,640547558
528,6177493971,350268,6177844239,9,0,0,126976,9,8737721258
529,6177516690,377547,6177894237,9,0,1,24576,9,2986174326
530,6177520291,408868,6177929159,4,0,0,185856,4,3865181676
531,6177569130,362295,6177931425,3,0,0,3584,3,10467338623
532,6177787483,72004,6177859487,9,0,1,57856,9,9238311597
533,6177875486,68716,6177944202,2,0,0,60416,2,152098383
534,6177879120,83382,6177962502,3,0,0,512,3,5660753288
535,6177880314,361664,6178241978,2,0,0,51200,2,2888978235
536,6178138716,10985,6178149701,7,0,0,512,7,1997605024
537,6178160110,36083,6178196193,5,0,1,22528,5,3736282180
538,6178182782,102056,6178284838,2,0,0,63488,2,10543955098
539,6178233603,219924,6178453527,5,0,0,615424,5,3012807449
540,6178276349,377749,6178654098,3,0,1,1024,3,6698681572
541,6178286149,424318,6178710467,9,0,0,327168,9,2082116981
542,6178375105,443514,6178818619,0,0,0,353792,0,973489023
543,6178399585,423540,6178823125,3,0,0,7168,3,6299612205
544,6178460731,362740,6178823471,6,0,0,512,6,3440967644
545,6178493191,304454,6178797645,2,0,0,89600,2,7363893937
546,6178512631,360088,6178872719,7,0,1,8704,7,3008739
547,6178548814,201158,6178749972,1,0,1,28160,1,6263727356
548,6178656287,243175,6178899462,5,0,0,32256,5,6514646934
549,6178677146,439911,6179117057,9,0,0,210944,9,2182817364
550,6178769068,234559,6179003627,1,0,0,267776,1,1474824579
551,6178777891,282660,6179060551,2,0,0,182272,2,4052610312
552,6178807848,278624,6179086472,0,0,0,91136,0,6472317797
553,6178843460,238379,6179081839,2,0,1,17408,2,7957423658
554,6178852919,210707,6179063626,7,0,0,7680,7,6233019543
555,6178891933,89597,6178981530,6,0,0,46080,6,3987260074
556,6178906771,277460,6179184231,1,0,1,20992,1,4562783983
557,6178927970,321094,6179249064,1,0,1,512,1,2188562274
558,6179014029,323960,6179337989,2,0,0,1536,2,3566612701
559,6179071183,12991,6179084174,3,0,1,4096,3,3944742108
560,6179118795,336414,6179455209,7,0,1,4608,7,3358261108
561,6179309284,55558,6179364842,8,0,0,25088,8,7576578369
562,6179374627,53171,6179427798,5,0,0,94720,5,3473447770
563,6179378960,318030,6179696990,3,0,0,3072,3,3549272074
564,6179441957,193498,6179635455,8,0,1,8704,8,3084726495
565,6179548053,243628,6179791681,4,0,0,394240,4,668885692
566,6179789322,127467,6179916789,0,0,1,44544,0,4546581987
567,6179826161,65041,6179891202,2,0,0,211456,2,2132352528
568,6179909375,31573,6179940948,9,0,0,74752,9,8743002955
569,6179936376,19892,6179956268,8,0,1,26624,8,651146298
570,6179946709,32295,6179979004,2,0,0,6144,2,1023747312
571,6179959978,299089,6180259067,4,0,0,15872,4,346378309
572,6179992874,23204,6180016078,6,0,0,52736,6,9760600504
573,6180041626,357870,6180399496,3,0,1,31744,3,280807960
574,6180115215,305370,6180420585,5,0,0,38400,5,9303513661
575,6180195540,217817,6180413357,2,0,0,357376,2,9489892904
576,6180199301,339546,6180538847,2,0,0,379392,2,9602672856
577,6180227809,331929,6180559738,2,0,0,67072,2,9758058561
578,6180284830,286788,6180571618,5,0,1,1536,5,6474966489
579,6180296987,274642,6180571629,9,0,0,38912,9,2029109439
580,6180308654,246029,6180554683,9,0,1,15360,9,2118174463
581,6180361935,247547,6180609482,8,0,1,32256,8,2886374107
582,6180367702,189519,6180557221,9,0,0,137728,9,10735053549
583,6180372085,175378,6180547463,5,0,0,28160,5,9961688483
584,6180393427,188112,6180581539,7,0,1,10240,7,562345382
585,6180436526,168069,6180604595,8,0,0,30720,8,1483980838
586,6180472519,409533,6180882052,9,0,1,2560,9,619360514
587,6180494652,333648,6180828300,1,0,0,189440,1,7370438528
588,6180514951,23462,6180538413,5,0,0,9216,5,7563797459
589,6180545993,472695,6181018688,7,0,1,15872,7,1670731415
590,6180728195,317442,6181045637,4,0,0,38912,4,2398250990
591,6180747265,73483,6180820748,9,0,1,13312,9,5420491505
592,6180774558,242743,6181017301,3,0,1,68096,3,5271439332
593,6180886378,301604,6181187982,2,0,0,122880,2,7389079622
594,6180943553,6750,6180950303,9,0,1,17408,9,8843589381
595,6181115618,215311,6181330929,4,0,0,7168,4,3498775273
596,6181187766,4370,6181192136,3,0,0,4608,3,542782076
597,6181285219,13508,6181298727,2,0,0,26112,2,4433462117
598,6181340939,188217,6181529156,0,0,0,309760,0,9851046264
599,6181411265,21203,6181432468,5,0,1,9728,5,6298658733
600,6181512779,222329,6181735108,9,0,0,7680,9,5591585332
601,6181525031,125555,6181650586,5,0,1,512,5,6997304205
602,6181662860,83696,6181746556,9,0,0,136192,9,3240267758
603,6181686839,133160,6181819999,9,0,1,4096,9,7587935913
604,6181695724,243654,6181939378,8,0,0,202240,8,8489234572
605,6182049950,54052,6182104002,2,0,1,3584,2,9853812129
606,6182077972,104048,6182182020,3,0,1,26624,3,5883706174
607,6182095628,138118,6182233746,8,0,1,44032,8,7066851320
608,6182248822,12991,6182261813,1,0,1,23040,1,2324458957
609,6182262680,3124,6182265804,9,0,0,25088,9,5473881207
610,6182285862,90700,6182376562,9,0,1,20480,9,9774762557
611,6182308644,31849,6182340493,9,0,0,9216,9,2734837199
612,6182338152,32295,6182370447,5,0,0,49152,5,6974936095
613,6182379666,184166,6182563832,2,0,0,52736,2,6016259546
614,6182385190,175178,6182560368,0,0,1,24064,0,8259619194
615,6182590089,562,6182590651,3,0,0,512,3,6966911151
616,6182610986,34016,6182645002,2,0,1,571392,2,8746965550
617,6182706582,23204,6182729786,1,0,0,59392,1,5862103899
618,6182791062,2866,6182793928,8,0,1,59392,8,8151905559
619,6182829219,57860,6182887079,2,0,0,38400,2,7045709411
620,6182850439,556691,6183407130,9,0,1,4608,9,6731797764
621,6182855418,267208,6183122626,0,0,0,8704,0,10706037125
622,6182900480,394741,6183295221,1,0,0,173568,1,9850154694
623,6183051207,146159,6183197366,1,0,0,18944,1,1978562842
624,6183076419,84655,6183161074,0,0,1,9216,0,3600828367
625,6183114337,64406,6183178743,7,0,0,2560,7,7528860825
626,6183132686,123886,6183256572,9,0,0,108032,9,6371027011
627,6183170505,91764,6183262269,4,0,0,27136,4,10138087744
628,6183173633,226235,6183399868,8,0,1,1024,8,8823604053
629,6183248448,194983,6183443431,6,0,0,319488,6,8794373392
630,6183310413,111080,6183421493,5,0,1,20992,5,3459963462
631,6183329539,44621,6183374160,5,0,1,1024,5,7771641713
632,6183343897,160977,6183504874,1,0,0,47104,1,2254618678
633,6183349824,25183,6183375007,7,0,1,2048,7,5742336793
634,6183421083,221417,6183642500,0,0,0,34816,0,6617778232
635,6183434671,187979,6183622650,1,0,1,6144,1,8551795817
636,6183440521,192574,6183633095,9,0,1,23040,9,9776216673
637,6183470920,211708,6183682628,6,0,0,45568,6,10401033931
638,6183543501,135494,6183678995,9,0,1,17408,9,838689617
639,6183651156,76048,6183727204,0,0,1,10240,0,1112375332
640,6183714569,214662,6183929231,1,0,1,23040,1,9145348968
641,6183854911,77139,6183932050,1,0,1,9216,1,2197374121
642,6183878519,116567,6183995086,2,0,0,193536,2,4607691793
643,6183928595,154428,6184083023,4,0,0,236544,4,1856794587
644,6183985419,503237,6184488656,6,0,0,1221120,6,1074847443
645,6184026380,440981,6184467361,6,0,0,103424,6,3786516879
646,6184038342,776362,6184814704,9,0,1,5632,9,4427652593
647,6184038548,767275,6184805823,2,0,0,110592,2,3424412873
648,6184074817,786776,6184861593,7,0,0,4096,7,5088137520
649,6184140362,753093,6184893455,7,0,0,1024,7,814685129
650,6184233291,688214,6184921505,1,0,1,6656,1,4184354182
651,6184400006,404436,6184804442,5,0,1,5632,5,9531177766
652,6184406163,341739,6184747902,1,0,1,89600,1,1783145726
653,6184424704,326926,6184751630,5,0,0,10752,5,9503142493
654,6184509009,500470,6185009479,2,0,0,78848,2,7326043954
655,6184549948,338423,6184888371,4,0,0,92160,4,5819463866
656,6184569505,43912,6184613417,9,0,0,99328,9,10165713604
657,6184704468,555160,6185259628,0,0,1,1536,0,837437928
658,6184743670,103579,6184847249,2,0,1,333824,2,8626187165
659,6184864682,85120,6184949802,6,0,0,11264,6,9648746227
660,6184866204,16609,6184882813,0,0,0,164352,0,8646724692
661,6184900114,472323,6185372437,4,0,0,49152,4,2187713878
662,6184902458,74604,6184977062,0,0,1,10240,0,6649298149
663,6185041086,575822,6185616908,5,0,0,32256,5,5554829329
664,6185046851,173752,6185220603,9,0,1,20480,9,3430357024
665,6185089487,231431,6185320918,8,0,1,4608,8,3518967557
666,6185135085,421591,6185556676,2,0,0,121856,2,3864180036
667,6185145751,361378,6185507129,5,0,0,87040,5,10708954158
668,6185211072,198447,6185409519,2,0,1,180736,2,40426061
669,6185212829,1990,6185214819,3,0,1,3072,3,4351267949
670,6185438688,391695,6185830383,3,0,0,2048,3,5756865977
671,6185575334,29908,6185605242,7,0,0,2560,7,10491350312
672,6185598115,39028,6185637143,6,0,0,55296,6,5450758892
673,6185605455,33846,6185639301,3,0,1,128512,3,277910541
674,6185610716,11459,6185622175,9,0,1,9216,9,7835435081
675,6185672131,205561,6185877692,9,0,1,10240,9,2372118149
676,6185723529,211910,6185935439,2,0,0,55808,2,4836044821
677,6185746172,198206,6185944378,2,0,0,9216,2,5128595718
678,6185964998,43900,6186008898,7,0,1,512,7,7540885368
679,6185987144,96575,6186083719,0,0,0,161280,0,2873662469
680,6186071839,61120,6186132959,9,0,0,98816,9,4093749012
681,6186106954,126354,6186233308,5,0,1,30720,5,9988769730
682,6186268860,103060,6186371920,3,0,1,38400,3,7520866592
683,6186371381,2045,6186373426,3,0,0,1536,3,4450318003
684,6186377076,1990,6186379066,7,0,0,2048,7,2311554379
685,6186474918,4370,6186479288,4,0,0,4608,4,5462207323
686,6186480092,110483,6186590575,7,0,1,53760,7,6107857426
687,6186495821,116825,6186612646,5,0,0,194048,5,938545542
688,6186510130,192753,6186702883,5,0,1,35840,5,10109498383
689,6186687634,64650,6186752284,3,0,1,28160,3,9520958384
690,6186699168,100059,6186799227,7,0,1,16384,7,9831841628
691,6186714087,5494,6186719581,4,0,0,109056,4,7036236109
692,6186749193,2466,6186751659,9,0,1,17920,9,6578932181
693,6186796208,104972,6186901180,7,0,0,2560,7,2042287945
694,6186798725,232245,6187030970,7,0,1,9216,7,7420000371
695,6186805114,259886,6187065000,7,0,0,2560,7,4733842681
696,6187030282,13766,6187044048,2,0,0,26624,2,10398462842
697,6187133899,23462,6187157361,9,0,0,38912,9,7249913248
698,6187173483,2466,6187175949,3,0,0,2560,3,10044776395
699,6187210900,135266,6187346166,8,0,0,223232,8,3972610975
700,6187238881,74516,6187313397,3,0,1,20480,3,1545937728
701,6187308355,65060,6187373415,2,0,0,124928,2,8277531763
702,6187319117,287156,6187606273,3,0,0,2048,3,7253160987
703,6187465525,147459,6187612984,3,0,1,36352,3,8313218900
704,6187530062,93248,6187623310,1,0,1,3584,1,5310070698
705,6187607190,24408,6187631598,7,0,1,10752,7,3093317996
706,6187617928,80454,6187698382,5,0,0,44032,5,3744001537
707,6187693497,4370,6187697867,3,0,1,45056,3,102408520
708,6187742875,14283,6187757158,7,0,0,4608,7,7660947639
709,6187743443,64204,6187807647,8,0,1,28672,8,2828831306
710,6187782215,219153,6188001368,9,0,0,27648,9,9199194923
711,6187819378,100720,6187920098,5,0,1,6656,5,37079814
712,6187829806,216781,6188046587,1,0,1,30720,1,6021158807
713,6187831745,173529,6188005274,0,0,0,281088,0,1039031869
714,6187843083,199198,6188042281,5,0,0,128000,5,9061517523
715,6187895017,203779,6188098796,0,0,0,180224,0,3908853610
716,6187898101,201041,6188099142,3,0,0,512,3,8192285958
717,6187924011,256004,6188180015,2,0,1,415744,2,2971710536
718,6188080178,154829,6188235007,9,0,1,18944,9,2811508566
719,6188220000,21863,6188241863,1,0,0,251392,1,6728167068
720,6188356192,700547,6189056739,3,0,0,5120,3,9569731008
721,6188458035,166534,6188624569,1,0,0,91136,1,8887654179
722,6188461699,188837,6188650536,3,0,1,1024,3,3606738298
723,6188480650,85694,6188566344,8,0,0,489984,8,8406542499
724,6188497305,304819,6188802124,4,0,0,1024,4,1983321378
725,6188576155,288830,6188864985,7,0,0,512,7,3708137653
726,6188617857,210326,6188828183,0,0,1,22528,0,9529647962
727,6188670631,34821,6188705452,0,0,1,31744,0,3111765078
728,6188685496,307475,6188992971,2,0,1,228352,2,3831921420
729,6188685965,233746,6188919711,1,0,1,512,1,2981182506
730,6188720009,319291,6189039300,7,0,1,19968,7,6840484739
731,6188722333,156125,6188878458,1,0,1,5120,1,7400286152
732,6188753606,334868,6189088474,3,0,0,3072,3,4851452118
733,6188846286,220358,6189066644,9,0,1,14336,9,6870336256
734,6188866445,489126,6189355571,5,0,1,1536,5,9360970927
735,6188872375,315050,6189187425,7,0,1,41984,7,7722070113
736,6189149125,43155,6189192280,7,0,0,5120,7,9394375792
737,6189170644,49095,6189219739,6,0,0,49664,6,3724346544
738,6189301207,1514,6189302721,3,0,0,1536,3,457643063
739,6189314899,562,6189315461,2,0,1,159744,2,3155047367
740,6189434688,221164,6189655852,7,0,0,512,7,5121220192
741,6189441541,94533,6189536074,4,0,0,122880,4,3623413843
742,6189477001,562,6189477563,2,0,1,964096,2,4128364580
743,6189518010,213512,6189731522,2,0,1,119296,2,8756769792
744,6189536668,153017,6189689685,3,0,0,512,3,1562404615
745,6189567646,492214,6190059860,8,0,1,2048,8,761417629
746,6189589646,337079,6189926725,3,0,1,1024,3,9384588536
747,6189618963,322431,6189941394,0,0,1,68096,0,9290451891
748,6189642568,1046525,6190689093,2,0,0,345600,2,5564876112
749,6189659480,536187,6190195667,1,0,1,20992,1,2512134620
750,6189745203,511674,6190256877,1,0,0,136192,1,5376775581
751,6189807114,508828,6190315942,1,0,0,546304,1,773999704
752,6189867528,366485,6190234013,2,0,1,118272,2,4543525810
753,6189884434,349559,6190233993,2,0,0,209920,2,8481155089
754,6189884859,692132,6190576991,5,0,1,12800,5,3760915544
755,6189987358,961496,6190948854,2,0,0,105984,2,10189554598
756,6190011882,1013448,6191025330,5,0,0,26624,5,1388767074
757,6190014747,1099443,6191114190,2,0,0,140800,2,9668153300
758,6190157101,736505,6190893606,7,0,0,512,7,9483112637
759,6190174054,968291,6191142345,1,0,0,198144,1,7645232368
760,6190181562,518238,6190699800,4,0,0,116736,4,4135881800
761,6190247506,411381,6190658887,7,0,1,7680,7,5989809622
762,6190314340,388088,6190702428,9,0,0,91136,9,9985333674
763,6190338939,366520,6190705459,7,0,0,2048,7,4727623851
764,6190361173,393156,6190754329,7,0,0,1024,7,4573486701
765,6190366513,529226,6190895739,4,0,0,112128,4,531114009
766,6190384711,396873,6190781584,4,0,0,80384,4,8028387662
767,6190387331,411605,6190798936,9,0,0,524800,9,10629947754
768,6190390456,687747,6191078203,1,0,0,1536,1,3897550402
769,6190491938,685608,6191177546,2,0,1,88576,2,4515917463
770,6190500371,591348,6191091719,8,0,0,58368,8,680857438
771,6190771223,387277,6191158500,1,0,0,221184,1,4954292660
772,6190847467,228867,6191076334,2,0,1,600064,2,4912183173
773,6190932859,205829,6191138688,3,0,0,5120,3,8331221110
774,6190956563,275804,6191232367,7,0,0,11264,7,7204649101
775,6190958604,10237,6190968841,1,0,0,238080,1,7035199527
776,6191272277,275922,6191548199,3,0,1,5632,3,7986422621
777,6191286294,134837,6191421131,3,0,1,28672,3,4431267496
778,6191381366,26860,6191408226,1,0,0,16384,1,8831012273
779,6191442047,951892,6192393939,6,0,0,219136,6,1277590475
780,6191551330,528809,6192080139,7,0,0,2048,7,7995719422
781,6191581877,219220,6191801097,4,0,0,137728,4,909657125
782,6191859886,175220,6192035106,9,0,1,8704,9,9526176730
783,6191864540,157267,6192021807,8,0,1,19968,8,7297841001
784,6191897479,199257,6192096736,9,0,1,2048,9,10692602521
785,6191899213,78099,6191977312,1,0,1,18944,1,3275193099
786,6192026837,209716,6192236553,3,0,1,9728,3,9088098505
787,6192096744,82265,6192179009,7,0,1,2560,7,8632393658
788,6192183341,35308,6192218649,8,0,1,11264,8,10158532380
789,6192219755,124541,6192344296,0,0,0,61952,0,602055438
790,6192280965,181327,6192462292,8,0,1,32256,8,5830556195
791,6192404864,112262,6192517126,9,0,0,181760,9,4403324296
792,6192582701,72279,6192654980,6,0,0,117248,6,2395464591
793,6192634280,96833,6192731113,6,0,0,161792,6,5916690940
794,6192674618,208868,6192883486,7,0,1,31232,7,10599874695
795,6192723685,562,6192724247,7,0,1,47104,7,1539798075
796,6192740099,100699,6192840798,9,0,1,5632,9,7506985877
797,6192849150,245281,6193094431,8,0,1,28672,8,8948393894
798,6192889227,230594,6193119821,3,0,0,512,3,9894266015
799,6192934504,107734,6193042238,0,0,0,179712,0,7745577434
800,6192992459,147862,6193140321,0,0,1,7680,0,10510619565
801,6193060845,198630,6193259475,0,0,1,24576,0,5797362000
802,6193186327,2866,6193189193,9,0,1,60416,9,1412314666
803,6193229894,97288,6193327182,3,0,1,19456,3,1052663518
804,6193313155,159274,6193472429,6,0,0,8704,6,10494998142
805,6193345662,42679,6193388341,2,0,0,69632,2,566523066
806,6193424446,117313,6193541759,9,0,1,10240,9,8333825173
807,6193515505,5450,6193520955,7,0,1,18944,7,10099842368
808,6193529429,43900,6193573329,8,0,1,512,8,4756342790
809,6193551893,7702,6193559595,4,0,0,13824,4,1676885639
810,6193579604,89452,6193669056,7,0,0,8192,7,5252064708
811,6193609199,91744,6193700943,7,0,1,16384,7,1224329693
812,6193827519,82404,6193909923,6,0,0,133632,6,7129592706
813,6193854555,33122,6193887677,5,0,1,6656,5,10164696809
814,6193881986,127405,6194009391,4,0,0,24576,4,1171635288
815,6193931468,82802,6194014270,0,0,1,10752,0,2181857565
816,6193932418,215233,6194147651,2,0,1,1134592,2,351477941
817,6193987082,138745,6194125827,5,0,1,13824,5,9283639939
818,6193993340,245437,6194238777,6,0,0,352256,6,5352822436
819,6194070494,237871,6194308365,3,0,0,1024,3,7186008722
820,6194145402,155268,6194300670,5,0,0,397824,5,3912779443
821,6194164514,562,6194165076,2,0,0,47104,2,5565962059
822,6194249063,586161,6194835224,3,0,0,3072,3,7062404055
823,6194382203,1089718,6195471921,3,0,1,15872,3,6852944133
824,6194480784,393818,6194874602,7,0,0,512,7,9525816164
825,6194633345,649815,6195283160,5,0,1,16384,5,8294662114
826,6194721319,317458,6195038777,3,0,0,7168,3,10056677636
827,6194778203,299204,6195077407,5,0,0,70656,5,1121256267
828,6194808229,244661,6195052890,4,0,0,65024,4,9142091797
829,6194841781,114101,6194955882,2,0,1,2560,2,1356383513
830,6194940062,286165,6195226227,5,0,1,19968,5,1510481818
831,6194980158,189392,6195169550,1,0,1,10240,1,10715408242
832,6195098720,44400,6195143120,2,0,0,76288,2,6759218176
833,6195100277,97593,6195197870,0,0,1,25088,0,4793490673
834,6195105461,117964,6195223425,0,0,0,163840,0,3841321147
835,6195121599,38703,6195160302,0,0,1,4608,0,5053313296
836,6195131480,75291,6195206771,8,0,1,34304,8,1538766104
837,6195187628,98789,6195286417,7,0,0,4608,7,4050007688
838,6195207448,238328,6195445776,1,0,0,126464,1,1137985958
839,6195223348,135447,6195358795,8,0,0,128000,8,7955457496
840,6195224004,145100,6195369104,5,0,0,121344,5,6230758202
841,6195250948,107501,6195358449,6,0,0,117760,6,3382015339
842,6195309335,40054,6195349389,8,0,0,74752,8,2605606679
843,6195323800,383338,6195707138,8,0,1,2048,8,8376995042
844,6195382069,105207,6195487276,9,0,0,25088,9,3730221503
845,6195409622,103858,6195513480,2,0,0,166400,2,9723439271
846,6195467372,74923,6195542295,6,0,0,172032,6,4455385636
847,6195470838,259738,6195730576,1,0,1,8704,1,2900268719
848,6195497383,75782,6195573165,3,0,0,13312,3,7232155609
849,6195512589,22429,6195535018,1,0,0,60416,1,8008203568
850,6195547491,218820,6195766311,8,0,1,36352,8,6574764305
851,6195570357,224764,6195795121,1,0,1,74752,1,4933338500
852,6195571756,197900,6195769656,8,0,1,24064,8,4145078584
853,6195603720,6750,6195610470,8,0,1,4096,8,9397977453
854,6195631360,296704,6195928064,6,0,0,36864,6,10156550267
855,6195808216,12988,6195821204,7,0,0,7168,7,8065253212
856,6195835093,430905,6196265998,3,0,0,4096,3,4375180809
857,6195857344,266462,6196123806,4,0,0,432128,4,1459141161
858,6195876851,267539,6196144390,4,0,0,73728,4,7143735888
859,6195910066,106849,6196016915,3,0,1,110080,3,7146245847
860,6196054323,146638,6196200961,1,0,0,64000,1,4947692375
861,6196077615,354284,6196431899,1,0,0,211968,1,4997247177
862,6196228181,43201,6196271382,0,0,1,15360,0,3257315568
863,6196380162,1038,6196381200,9,0,0,70656,9,8553385552
864,6196380208,123016,6196503224,7,0,1,13312,7,8593985693
865,6196433288,41387,6196474675,7,0,0,1024,7,6790329477
866,6196467131,392634,6196859765,1,0,0,67072,1,6480017485
867,6196472432,175594,6196648026,7,0,1,1536,7,806324170
868,6196486877,228991,6196715868,9,0,1,16384,9,9038355392
869,6196538576,185204,6196723780,3,0,1,11776,3,2732639422
870,6196564016,14025,6196578041,2,0,0,300544,2,3304050710
871,6196768821,15317,6196784138,8,0,0,27136,8,6233320695
872,6196783595,429306,6197212901,8,0,0,29696,8,6767802160
873,6196909995,245954,6197155949,4,0,0,398848,4,938021176
874,6196915605,281785,6197197390,1,0,0,498176,1,3646667713
875,6196929445,298637,6197228082,9,0,1,14336,9,6902126370
876,6196933577,203395,6197136972,7,0,1,15360,7,6074491669
877,6196936552,361593,6197298145,3,0,1,10240,3,6239205119
878,6197054083,245917,6197300000,9,0,1,2560,9,5936364344
879,6197080949,423275,6197504224,8,0,0,110592,8,10528782150
880,6197082688,289600,6197372288,9,0,1,21504,9,6247797108
881,6197083826,333688,6197417514,6,0,0,151040,6,3041558631
882,6197189030,229470,6197418500,7,0,0,1536,7,8007229530
883,6197189950,228896,6197418846,3,0,0,512,3,1248055895
884,6197307449,147584,6197455033,0,0,0,123904,0,6488393921
885,6197445507,34104,6197479611,5,0,1,13824,5,4388178930
886,6197463447,210400,6197673847,0,0,1,53760,0,7982340395
887,6197473891,221410,6197695301,1,0,0,56320,1,1331589001
888,6197486154,176398,6197662552,2,0,0,333312,2,9998461241
889,6197496278,68368,6197564646,8,0,1,29184,8,6919929313
890,6197501270,364344,6197865614,2,0,0,92160,2,2714275485
891,6197541461,371098,6197912559,9,0,1,34816,9,5088177708
892,6197547732,362797,6197910529,3,0,1,8704,3,5646039335
893,6197549188,92183,6197641371,7,0,0,4608,7,1792780376
894,6197678928,87945,6197766873,0,0,0,71168,0,593787929
895,6197766903,51709,6197818612,8,0,0,140800,8,1867895979
896,6197771152,362227,6198133379,3,0,0,5120,3,513687917
897,6197818254,369020,6198187274,8,0,0,49152,8,8388234439
898,6197846202,97181,6197943383,8,0,0,152576,8,132624544
899,6198050490,43883,6198094373,8,0,0,75264,8,7798885587
900,6198075051,562,6198075613,9,0,1,8704,9,7438340869
901,6198128455,91005,6198219460,3,0,0,512,3,7181020193
902,6198207351,24666,6198232017,3,0,1,6656,3,2687151972
903,6198220712,102986,6198323698,2,0,0,44544,2,2173502502
904,6198465914,80860,6198546774,1,0,1,20992,1,1225847243
905,6198494686,103170,6198597856,0,0,0,167424,0,10468670865
906,6198514764,193956,6198708720,8,0,1,26112,8,6172696017
907,6198568780,154483,6198723263,1,0,1,6656,1,9476264981
908,6198576219,157620,6198733839,4,0,0,253952,4,9698628110
909,6198640971,246661,6198887632,2,0,1,39424,2,6381259706
910,6198788117,126533,6198914650,2,0,0,192512,2,7119553342
911,6198789805,84257,6198874062,8,0,1,13824,8,2934433866
912,6198834259,62177,6198896436,7,0,0,6144,7,2012946862
913,6198856685,2466,6198859151,3,0,0,512,3,2339089159
914,6198921842,1514,6198923356,7,0,0,2560,7,4373695837
915,6198935409,220683,6199156092,3,0,0,1536,3,8171991277
916,6199013029,36342,6199049371,5,0,0,64000,5,2944939126
917,6199087432,2942,6199090374,3,0,0,3072,3,952446446
918,6199102670,60862,6199163532,1,0,0,98304,1,33277083
919,6199229303,7702,6199237005,3,0,1,52224,3,8176653881
920,6199235134,130363,6199365497,2,0,1,261120,2,220321523
921,6199265376,141669,6199407045,1,0,1,5120,1,7247711357
922,6199315964,93851,6199409815,7,0,0,8192,7,5050477858
923,6199350448,306794,6199657242,2,0,0,141312,2,7302930198
924,6199389760,167946,6199557706,1,0,1,7168,1,8571035359
925,6199491072,388232,6199879304,2,0,1,284672,2,3706915877
926,6199542406,336917,6199879323,0,0,0,456704,0,9262688039
927,6199599519,279815,6199879334,5,0,0,132608,5,3140343587
928,6199643898,254997,6199898895,2,0,0,114688,2,5615431202
929,6199706136,111903,6199818039,0,0,1,4608,0,7641662646
930,6199798641,249347,6200047988,8,0,0,47616,8,10737374929
931,6199914061,3900,6199917961,1,0,1,67072,1,3825659488
932,6200019909,113861,6200133770,1,0,1,2048,1,4155258768
933,6200037422,125488,6200162910,2,0,0,10752,2,9863757328
934,6200039370,113861,6200153231,5,0,1,1536,5,7485259854
935,6200045057,118837,6200163894,1,0,1,14336,1,2342230443
936,6200046756,100041,6200146797,2,0,1,453632,2,368852026
937,6200062552,393725,6200456277,0,0,0,204288,0,820857670
938,6200070603,146274,6200216877,3,0,1,87040,3,3396209962
939,6200076765,362485,6200439250,7,0,0,4096,7,3333768569
940,6200093192,442697,6200535889,2,0,0,69632,2,4113682499
941,6200093686,422829,6200516515,5,0,1,5120,5,9041879529
942,6200153616,5708,6200159324,1,0,0,141824,1,1551569993
943,6200161523,587562,6200749085,2,0,0,168448,2,8959697372
944,6200357584,749636,6201107220,0,0,1,20480,0,10326834830
945,6200393863,415085,6200808948,2,0,1,53248,2,5774377149
946,6200402846,466598,6200869444,7,0,1,70656,7,3549233147
947,6200452326,374051,6200826377,7,0,1,7168,7,5649480734
948,6200517360,448749,6200966109,9,0,0,14336,9,850393966
949,6200580632,305929,6200886561,5,0,0,495616,5,726809654
950,6200589151,249594,6200838745,0,0,1,72192,0,7780593808
951,6200668329,295567,6200963896,6,0,0,109056,6,3407882379
952,6200677117,335631,6201012748,7,0,1,3584,7,2497603908
953,6200686640,379850,6201066490,4,0,0,176640,4,1945437252
954,6200725950,399848,6201125798,0,0,0,212992,0,5534899432
955,6200728184,427259,6201155443,2,0,0,148480,2,1162109556
956,6200742357,602472,6201344829,6,0,0,121856,6,8549058614
957,6200769757,515617,6201285374,2,0,1,86016,2,528291922
958,6200778843,413910,6201192753,2,0,0,158720,2,9699146259
959,6200898928,299798,6201198726,9,0,0,22528,9,6186078849
960,6200939950,306356,6201246306,5,0,0,154112,5,6390279954
961,6200962277,114933,6201077210,8,0,1,14336,8,3458330953
962,6201120816,64508,6201185324,9,0,1,20480,9,5279654967
963,6201142919,384908,6201527827,6,0,0,47104,6,4066279729
964,6201214440,352461,6201566901,2,0,0,76288,2,4676696088
965,6201216297,287569,6201503866,7,0,0,434688,7,335141533
966,6201227736,178120,6201405856,0,0,1,16384,0,6836136397
967,6201330528,162123,6201492651,8,0,1,4096,8,8398857311
968,6201358525,104979,6201463504,2,0,0,55808,2,1559691553
969,6201498366,481480,6201979846,5,0,0,171008,5,8816910655
970,6201512326,263138,6201775464,8,0,0,364544,8,151268515
971,6201586430,215877,6201802307,6,0,0,87552,6,9823648950
972,6201731885,91825,6201823710,6,0,0,77824,6,7152575582
973,6201754272,111578,6201865850,0,0,0,144384,0,9983833673
974,6201782473,83633,6201866106,9,0,0,9216,9,2153035108
975,6201918297,113812,6202032109,1,0,1,8704,1,3967139420
976,6201987350,203443,6202190793,5,0,0,184832,5,10347817913
977,6202012055,103153,6202115208,8,0,1,27648,8,2983735666
978,6202112037,290516,6202402553,8,0,1,10240,8,6647722272
979,6202259925,287852,6202547777,0,0,1,52224,0,10692708703
980,6202489575,58525,6202548100,5,0,1,1024,5,3325586159
981,6202513320,61120,6202574440,1,0,1,4096,1,9660338248
982,6202520800,74237,6202595037,7,0,0,98816,7,5130818678
983,6202556914,4416,6202561330,2,0,1,200192,2,709495197
984,6202590584,295871,6202886455,7,0,1,13824,7,5837498649
985,6202656365,266424,6202922789,7,0,0,11776,7,2208684069
986,6202829722,28316,6202858038,3,0,0,1024,3,8192286130
987,6202858208,1514,6202859722,5,0,1,9216,5,6164516004
988,6202909245,84988,6202994233,3,0,0,1536,3,6744217963
989,6202938486,12921,6202951407,1,0,0,138752,1,3329801927
990,6202988522,175209,6203163731,5,0,1,11264,5,6118729545
991,6203013459,6274,6203019733,2,0,0,4608,2,8034192313
992,6203044978,118121,6203163099,5,0,0,6656,5,4063881728
993,6203051746,89595,6203141341,0,0,1,22528,0,8695500415
994,6203151206,195930,6203347136,0,0,1,16384,0,10444338912
995,6203162551,154483,6203317034,4,0,0,253952,4,3986006203
996,6203277832,66352,6203344184,7,0,0,89088,7,3143279551
997,6203289364,80537,6203369901,9,0,0,81920,9,8578421890
998,6203289717,222938,6203512655,0,0,0,295424,0,9409032154
999,6203296721,216920,6203513641,2,0,0,1536,2,2118918017
1000,6203307221,207726,6203514947,1,0,0,2048,1,9002011679
1001,6203365849,53376,6203419225,5,0,1,2560,5,2134593870
1002,6203457131,53445,6203510576,2,0,1,187392,2,10452637810
1003,6203461917,166498,6203628415,5,0,0,512,5,10251814376
1004,6203462514,144616,6203607130,1,0,0,1024,1,3227729423
1005,6203548286,3418,6203551704,7,0,0,238080,7,10483734235
1006,6203681951,372554,6204054505,7,0,1,47104,7,7018990839
1007,6203682832,170896,6203853728,0,0,1,22016,0,594747532
1008,6203736148,3418,6203739566,1,0,0,3584,1,9617885941
1009,6203775364,297310,6204072674,8,0,1,8704,8,3969168702
1010,6203912533,214043,6204126576,5,0,0,3584,5,7560968406
1011,6204029553,111016,6204140569,9,0,1,64512,9,802722341
1012,6204051155,102912,6204154067,9,0,0,166912,9,1072344264
1013,6204054532,135518,6204190050,9,0,0,114688,9,2296875622
1014,6204175500,130254,6204305754,8,0,0,602112,8,10631246686
1015,6204219294,369175,6204588469,8,0,0,363008,8,8569412895
1016,6204259161,438871,6204698032,1,0,0,8192,1,10438000987
1017,6204338636,404150,6204742786,5,0,0,2048,5,2929331592
1018,6204349026,325981,6204675007,3,0,0,4608,3,626083970
1019,6204354447,318497,6204672944,9,0,1,16896,9,7577260409
1020,6204379413,355505,6204734918,7,0,0,224256,7,2693574169
1021,6204539535,218912,6204758447,7,0,1,1536,7,5760341762
1022,6204629695,141513,6204771208,7,0,0,116224,7,5622672172
1023,6204652952,1990,6204654942,2,0,1,149504,2,4372735097
1024,6204699197,274916,6204974113,2,0,1,16896,2,922389938
1025,6204710734,380596,6205091330,7,0,1,38400,7,632707569
1026,6204724529,314490,6205039019,7,0,1,17920,7,9009120148
1027,6204788630,339996,6205128626,5,0,1,8192,5,6875323467
1028,6204865817,264607,6205130424,5,0,0,2048,5,686113286
1029,6204884072,169184,6205053256,0,0,0,247296,0,7379450822
1030,6204896579,82072,6204978651,7,0,1,67584,7,4127960038
1031,6204971129,102095,6205073224,7,0,1,10752,7,691693899
1032,6204971195,16609,6204987804,9,0,0,10752,9,40122873
1033,6204977443,1038,6204978481,8,0,0,144384,8,1933465974
1034,6205029194,26217,6205055411,3,0,1,1536,3,2611293436
1035,6205112309,404113,6205516422,6,0,0,32256,6,9021604000
1036,6205140861,271977,6205412838,1,0,0,1024,1,8682960920
1037,6205157578,122967,6205280545,9,0,1,2048,9,10437490232
1038,6205219308,106442,6205325750,9,0,1,6144,9,8393451443
1039,6205238764,423598,6205662362,6,0,0,47616,6,5240601268
1040,6205257857,96317,6205354174,6,0,0,177152,6,3994383533
1041,6205303911,285836,6205589747,0,0,1,15360,0,5022833295
1042,6205330944,284232,6205615176,6,0,0,160768,6,8493592941
1043,6205372073,407987,6205780060,4,0,0,652288,4,7824595610
1044,6205409993,406664,6205816657,7,0,0,117760,7,9661390283
1045,6205513184,329283,6205842467,3,0,1,13312,3,7413568337
1046,6205517029,392586,6205909615,6,0,0,305664,6,6517434130
1047,6205553563,367394,6205920957,7,0,0,37888,7,423670632
1048,6205607584,318199,6205925783,5,0,0,7680,5,5583915361
1049,6205640596,285533,6205926129,3,0,0,512,3,8631015076
1050,6205874839,172495,6206047334,7,0,0,279040,7,1302739056
1051,6205921334,204378,6206125712,4,0,0,252416,4,8729461010
1052,6206003433,123265,6206126698,5,0,0,1536,5,3544487491
1053,6206019281,128922,6206148203,9,0,0,70144,9,3279762402
1054,6206067278,170850,6206238128,1,0,1,2560,1,10563912002
1055,6206101789,133287,6206235076,0,0,1,10240,0,8936810582
1056,6206125598,168205,6206293803,6,0,0,216064,6,8776807434
1057,6206395641,30745,6206426386,5,0,1,25088,5,6420474246
1058,6206495005,194881,6206689886,9,0,1,15360,9,3850346309
1059,6206517290,59729,6206577019,3,0,1,21504,3,865892190
1060,6206529255,58232,6206587487,7,0,0,49664,7,404282042
1061,6206582881,143138,6206726019,8,0,0,84480,8,278881860
1062,6206585351,170114,6206755465,3,0,0,12800,3,10336824359
1063,6206586825,89319,6206676144,7,0,1,10240,7,6835093768
1064,6206588011,91723,6206679734,0,0,0,97792,0,8674482742
1065,6206602082,225254,6206827336,4,0,0,62464,4,8423209136
1066,6206822261,14283,6206836544,4,0,0,27648,4,6300342326
1067,6206908607,3418,6206912025,3,0,0,3584,3,1205895234
1068,6206936664,81772,6207018436,8,0,1,18944,8,6513642471
1069,6206965400,53749,6207019149,9,0,0,91136,9,9446616330
1070,6207017032,164800,6207181832,7,0,0,264704,7,5678237136
1071,6207068621,113557,6207182178,5,0,0,512,5,716369950
1072,6207111097,156676,6207267773,0,0,1,11776,0,72268352
1073,6207196344,239373,6207435717,7,0,1,48640,7,2346220932
1074,6207339457,78485,6207417942,9,0,1,3584,9,1658520538
1075,6207359739,99870,6207459609,8,0,1,8192,8,10126006810
1076,6207486065,21137,6207507202,7,0,1,26112,7,6280275997
1077,6207499105,99316,6207598421,7,0,1,15360,7,3292130396
1078,6207538543,90967,6207629510,6,0,0,34304,6,3769195461
1079,6207622912,74536,6207697448,8,0,1,15360,8,9135980170
1080,6207656886,113812,6207770698,2,0,1,422400,2,3212367697
1081,6207673027,371090,6208044117,9,0,1,33792,9,916742141
1082,6207736860,365256,6208102116,8,0,1,11264,8,484176742
1083,6207760462,249500,6208009962,0,0,0,184832,0,6786761925
1084,6207787507,255034,6208042541,9,0,1,10240,9,7550525525
1085,6207789910,199953,6207989863,0,0,1,3584,0,918894694
1086,6207842626,121856,6207964482,9,0,1,37888,9,273055738
1087,6207843691,80334,6207924025,3,0,1,3584,3,6810438867
1088,6207924689,316919,6208241608,1,0,0,3072,1,2256982469
1089,6207928816,1514,6207930330,0,0,1,77312,0,8412128656
1090,6207969117,234934,6208204051,5,0,0,4608,5,5607661318
1091,6208060896,8264,6208069160,3,0,0,1536,3,8005679409
1092,6208069850,3900,6208073750,5,0,0,512,5,3107082223
1093,6208142483,20878,6208163361,1,0,0,10752,1,7299189782
1094,6208147737,281066,6208428803,6,0,0,33792,6,7513045808
1095,6208187652,26133,6208213785,2,0,0,4096,2,2549087532
1096,6208194205,117662,6208311867,5,0,1,34816,5,9010985564
1097,6208329743,197825,6208527568,4,0,0,325120,4,8980562506
1098,6208338023,205815,6208543838,6,0,0,53248,6,3720137983
1099,6208397128,5798,6208402926,1,0,1,93184,1,1960716052
1100,6208555287,300948,6208856235,8,0,1,11264,8,1780377009
1101,6208589728,33758,6208623486,1,0,0,6144,1,3921217956
1102,6208635976,197706,6208833682,8,0,1,512,8,3172355981
1103,6208646840,147780,6208794620,2,0,1,292864,2,4135118775
1104,6208715622,312391,6209028013,3,0,1,1024,3,4497126253
1105,6208739319,335822,6209075141,6,0,0,58880,6,9021886844
1106,6208765548,186531,6208952079,3,0,1,13312,3,6996003317
1107,6208796142,169599,6208965741,6,0,0,203776,6,9547946653
1108,6208813085,221203,6209034288,3,0,0,19456,3,6226939857
1109,6208882256,163920,6209046176,8,0,0,265728,8,8539236704
1110,6208884585,193977,6209078562,6,0,0,114176,6,1138668201
1111,6208920016,161132,6209081148,5,0,0,4096,5,4596650591
1112,6208924524,168375,6209092899,9,0,0,48128,9,1038344353
1113,6209045936,22170,6209068106,8,0,1,46592,8,9705544021
1114,6209110825,94487,6209205312,1,0,1,13824,1,6317309237
1115,6209120481,1514,6209121995,8,0,0,36352,8,6647081378
1116,6209135781,221874,6209357655,5,0,1,3584,5,5680609994
1117,6209161098,189391,6209350489,3,0,1,23040,3,6339122495
1118,6209236407,192017,6209428424,2,0,0,1536,2,960839281
1119,6209303369,97350,6209400719,6,0,0,162816,6,6358275572
1120,6209363774,37509,6209401283,1,0,0,10752,1,6797769774
1121,6209460678,16609,6209477287,7,0,0,32256,7,647133953
1122,6209501862,110237,6209612099,7,0,1,13312,7,8848771880
1123,6209512504,117785,6209630289,8,0,1,8192,8,9591211748
1124,6209558034,145652,6209703686,5,0,1,14336,5,7272017692
1125,6209608411,157734,6209766145,9,0,0,249856,9,7602812958
1126,6209831419,1038,6209832457,3,0,0,1024,3,4058628648
1127,6209921158,1990,6209923148,1,0,0,2048,1,866429329
1128,6209949011,1038,6209950049,2,0,1,317952,2,1513078287
1129,6210047417,306850,6210354267,5,0,0,1024,5,2515799936
1130,6210076395,195241,6210271636,3,0,1,51712,3,4852090578
1131,6210195557,13845,6210209402,1,0,1,10752,1,6552791996
1132,6210244480,144549,6210389029,5,0,1,12288,5,3307779067
1133,6210262178,103820,6210365998,5,0,0,4608,5,7460242031
1134,6210283152,106700,6210389852,4,0,0,177664,4,6611574547
1135,6210421965,34104,6210456069,7,0,0,56320,7,5799475861
1136,6210454471,1038,6210455509,5,0,1,8192,5,5968938045
1137,6210499297,71437,6210570734,3,0,0,1024,3,10107635567
1138,6210770437,121780,6210892217,2,0,1,99840,2,601767438
1139,6210889387,34342,6210923729,4,0,0,51200,4,2123779774
1140,6210922435,562,6210922997,1,0,1,43008,1,1642493948
1141,6210970490,140895,6211111385,5,0,0,512,5,5892051692
1142,6210986679,5322,6210992001,5,0,1,25600,5,10449215431
1143,6211063573,116575,6211180148,9,0,0,5632,9,5469830032
1144,6211124685,84383,6211209068,0,0,0,140800,0,2595440103
1145,6211139623,183663,6211323286,5,0,1,48640,5,8125761530
1146,6211384469,143670,6211528139,0,0,0,232960,0,3408310373
1147,6211421122,261026,6211682148,4,0,0,371200,4,5116706643
1148,6211466481,217613,6211684094,5,0,0,3072,5,6568819111
1149,6211564383,163903,6211728286,5,0,1,56320,5,1277142522
1150,6211571573,562,6211572135,9,0,0,163840,9,1329850146
1151,6211714560,562,6211715122,2,0,1,134656,2,8949445879
1152,6211717689,327533,6212045222,3,0,1,39936,3,1928052254
1153,6211737908,562,6211738470,5,0,0,512,5,4390294310
1154,6211807864,297013,6212104877,2,0,0,512,2,6076175015
1155,6211857894,105842,6211963736,1,0,1,6656,1,7125448440
1156,6211923280,422587,6212345867,2,0,1,60928,2,2344089609
1157,6211925672,281292,6212206964,3,0,0,512,3,4428779094
1158,6211933617,30850,6211964467,7,0,1,23552,7,3231546141
1159,6211987785,19929,6212007714,9,0,1,8192,9,6510871023
1160,6212109859,260865,6212370724,1,0,0,1536,1,3503760481
1161,6212121126,6770,6212127896,2,0,0,512,2,6769512787
1162,6212163591,312686,6212476277,8,0,1,15360,8,7582468380
1163,6212179833,4370,6212184203,5,0,0,2560,5,9989785699
1164,6212252347,145070,6212397417,3,0,0,4608,3,964974975
1165,6212295819,57904,6212353723,7,0,1,6144,7,4424190841
1166,6212345313,125421,6212470734,9,0,1,6144,9,1081577015
1167,6212363133,148473,6212511606,2,0,1,74752,2,5216408429
1168,6212368278,238583,6212606861,8,0,0,391168,8,4203165854
1169,6212473338,155233,6212628571,6,0,0,71168,6,8640111420
1170,6212576854,72279,6212649133,7,0,1,25088,7,3931631448
1171,6212615710,154520,6212770230,7,0,1,4096,7,6154592571
1172,6212659934,208646,6212868580,0,0,0,117248,0,6777890124
1173,6212731338,87484,6212818822,0,0,1,56320,0,1146468968
1174,6212840313,137471,6212977784,0,0,0,146944,0,6369470620
1175,6212844419,270365,6213114784,7,0,1,1536,7,7513016133
1176,6213022773,114539,6213137312,3,0,1,20992,3,7907090953
1177,6213187261,74516,6213261777,6,0,0,124928,6,5180285268
1178,6213194780,78134,6213272914,0,0,0,45056,0,4232175382
1179,6213385014,76325,6213461339,8,0,0,128512,8,6347112765
1180,6213416534,71648,6213488182,7,0,0,87552,7,10140997838
1181,6213419756,86504,6213506260,7,0,1,35840,7,9810117314
1182,6213448669,7226,6213455895,7,0,0,137216,7,7639049928
1183,6213597703,4675,6213602378,7,0,0,7680,7,5924904532
1184,6213613056,256215,6213869271,2,0,1,183296,2,9020224696
1185,6213620040,279403,6213899443,9,0,1,40448,9,2846348648
1186,6213654585,243033,6213897618,5,0,1,16896,5,5953730988
1187,6213656458,289913,6213946371,6,0,0,12288,6,5246858174
1188,6213661432,256488,6213917920,8,0,1,26112,8,6300757744
1189,6213922929,1990,6213924919,1,0,0,2048,1,1125919112
1190,6213925212,47284,6213972496,8,0,1,1536,8,1910480202
1191,6214076044,124454,6214200498,6,0,0,202240,6,10366293650
1192,6214076188,150743,6214226931,4,0,0,93696,4,4119814186
1193,6214180904,1038,6214181942,9,0,1,5120,9,4731906427
1194,6214272678,210314,6214482992,3,0,0,1024,3,9690872547
1195,6214288719,278649,6214567368,0,0,0,570368,0,3312462288
1196,6214331600,349442,6214681042,8,0,1,11264,8,239836780
1197,6214343188,310424,6214653612,8,0,0,49152,8,4448001614
1198,6214383277,228147,6214611424,9,0,1,20480,9,7817483321
1199,6214461448,202775,6214664223,0,0,0,114688,0,3620152788
1200,6214491326,210228,6214701554,1,0,0,7168,1,1956444951
1201,6214520368,413440,6214933808,0,0,0,117248,0,10596712591
1202,6214605456,207627,6214813083,6,0,0,263680,6,4337445495
1203,6214609216,282142,6214891358,6,0,0,260096,6,1554042606
1204,6214755865,151709,6214907574,0,0,1,24064,0,801710050
1205,6214871642,122387,6214994029,8,0,0,198144,8,5332303466
1206,6214999109,114329,6215113438,4,0,0,185856,4,10678347810
1207,6215003667,71883,6215075550,7,0,1,3584,7,5398764448
1208,6215043143,188980,6215232123,4,0,0,15872,4,7703412720
1209,6215226996,43108,6215270104,9,0,0,73728,9,8872938411
1210,6215227135,59751,6215286886,9,0,0,55808,9,8937314455
1211,6215234365,54223,6215288588,7,0,1,13824,7,5186425090
1212,6215243493,20237,6215263730,0,0,0,35328,0,8274517238
1213,6215283483,208419,6215491902,1,0,0,20480,1,6945394189
1214,6215324447,178311,6215502758,9,0,1,16896,9,4394860040
1215,6215892895,123679,6216016574,4,0,0,200704,4,10661127212
1216,6216046999,196992,6216243991,4,0,0,478208,4,7988502329
1217,6216118864,295287,6216414151,3,0,1,27136,3,6250101028
1218,6216125408,241729,6216367137,3,0,1,28160,3,2189876509
1219,6216141101,334452,6216475553,4,0,0,443392,4,7566451435
1220,6216142411,340032,6216482443,3,0,1,7680,3,6377873545
1221,6216151386,293589,6216444975,1,0,1,10752,1,10172221854
1222,6216187890,229273,6216417163,5,0,0,512,5,631031572
1223,6216289417,417679,6216707096,8,0,0,120832,8,6756776243
1224,6216328584,310990,6216639574,7,0,1,11264,7,7956058408
1225,6216335217,295545,6216630762,1,0,1,81920,1,2142009590
1226,6216377905,295836,6216673741,9,0,0,478720,9,8221945854
1227,6216399426,152899,6216552325,8,0,0,71680,8,9710501286
1228,6216542517,34818,6216577335,3,0,0,8704,3,8737452925
1229,6216581684,430930,6217012614,0,0,1,35840,0,10415668753
1230,6216605311,92787,6216698098,9,0,1,41472,9,6925091475
1231,6216661584,159104,6216820688,8,0,0,1536,8,2028909750
1232,6216703424,331540,6217034964,4,0,0,150528,4,6025156231
1233,6216729939,121177,6216851116,4,0,0,199168,4,1595517099
1234,6216804053,342454,6217146507,7,0,0,115712,7,1268302285
1235,6216821436,199076,6217020512,9,0,0,261632,9,1132542060
1236,6216830895,190923,6217021818,2,0,0,2048,2,9818331960
1237,6216904728,132848,6217037576,7,0,0,50688,7,2957505411
1238,6216981646,97762,6217079408,7,0,0,142848,7,6219816497
1239,6217074305,5769,6217080074,0,0,0,1024,0,2779613896
1240,6217083452,4158,6217087610,9,0,1,40448,9,1263627122
1241,6217106419,1038,6217107457,0,0,0,11264,0,8769992263
1242,6217274924,36342,6217311266,2,0,0,1024,2,1842428241
1243,6217283656,1038,6217284694,0,0,0,64000,0,5254697136
1244,6217312962,319361,6217632323,5,0,1,34304,5,6463971691
1245,6217326925,1514,6217328439,1,0,0,1024,1,8376262355
1246,6217460373,186934,6217647307,2,0,0,1536,2,10723397631
1247,6217649776,5708,6217655484,5,0,0,14336,5,2739242853
1248,6217661012,1038,6217662050,1,0,0,1024,1,5835435016
1249,6217684187,92172,6217776359,0,0,1,8192,0,1942171350
1250,6217836135,162112,6217998247,7,0,0,262144,7,7644227940
1251,6217869042,114534,6217983576,1,0,1,25600,1,1300744986
1252,6217974713,296531,6218271244,7,0,1,3072,7,7753703459
1253,6218050007,104152,6218154159,3,0,1,2560,3,10176036994
1254,6218059456,158056,6218217512,3,0,1,5120,3,3130025305
1255,6218111789,178840,6218290629,0,0,1,41984,0,3857257035
1256,6218189185,45692,6218234877,0,0,0,78848,0,1099113569
1257,6218205477,111305,6218316782,5,0,1,3584,5,9131107794
1258,6218242129,77100,6218319229,2,0,1,276992,2,2289018168
1259,6218269773,188147,6218457920,9,0,0,130048,9,8543106900
1260,6218271432,94854,6218366286,1,0,1,39424,1,4662897710
1261,6218438192,462550,6218900742,7,0,1,29184,7,9461920818
1262,6218511515,86987,6218598502,9,0,0,154624,9,6538417359
1263,6218572528,309958,6218882486,5,0,1,27648,5,5284345437
1264,6218624927,197000,6218821927,3,0,0,7680,3,3835434242
1265,6218701476,102874,6218804350,7,0,1,9728,7,5601826400
1266,6218789835,125680,6218915515,0,0,1,112640,0,7614287746
1267,6218872657,51818,6218924475,8,0,1,29696,8,5327659015
1268,6218879993,46281,6218926274,9,0,1,2560,9,2523508681
1269,6218901563,108894,6219010457,7,0,0,52736,7,5807089963
1270,6218904991,137826,6219042817,7,0,1,17920,7,4655549186
1271,6218907914,142895,6219050809,2,0,1,227328,2,7055887368
1272,6218968015,155632,6219123647,2,0,1,39936,2,8557116697
1273,6218990062,400265,6219390327,2,0,1,603648,2,2918919468
1274,6219014355,81088,6219095443,0,0,0,231424,0,3868791924
1275,6219017888,445341,6219463229,9,0,0,53248,9,2423090720
1276,6219024492,452195,6219476687,3,0,1,8192,3,6033415125
1277,6219034619,451350,6219485969,8,0,1,19968,8,1865804134
1278,6219077816,463131,6219540947,9,0,1,43008,9,7300522305
1279,6219227102,272043,6219499145,8,0,0,32768,8,9820125717
1280,6219288770,287141,6219575911,1,0,1,56320,1,364015786
1281,6219323770,146496,6219470266,2,0,1,60416,2,9641900585
1282,6219335779,831122,6220166901,4,0,0,468992,4,556042525
1283,6219420147,515833,6219935980,0,0,1,6656,0,4279503662
1284,6219476770,357435,6219834205,3,0,0,512,3,7559440510
1285,6219482179,305570,6219787749,4,0,0,351744,4,4536907165
1286,6219509356,280740,6219790096,1,0,1,43008,1,6688277955
1287,6219534063,421552,6219955615,8,0,0,7680,8,10392551363
1288,6219558904,234910,6219793814,1,0,0,7168,1,3936861946
1289,6219563143,100783,6219663926,3,0,1,17408,3,10554743337
1290,6219574443,309115,6219883558,8,0,1,58368,8,2127387318
1291,6219606800,84554,6219691354,8,0,0,148480,8,9571919746
1292,6219735839,71917,6219807756,9,0,1,13824,9,492750615
1293,6219741974,475760,6220217734,3,0,0,1024,3,6254430565
1294,6219756168,428468,6220184636,9,0,1,1024,9,7067675083
1295,6219790548,271295,6220061843,7,0,0,54272,7,1646866526
1296,6219809086,260856,6220069942,7,0,0,19968,7,6758936997
1297,6219850648,135613,6219986261,0,0,1,31232,0,9571601642
1298,6219904797,26475,6219931272,4,0,0,220672,4,2550357271
1299,6220022143,33587,6220055730,8,0,1,4096,8,1891924978
1300,6220029971,25936,6220055907,0,0,0,48128,0,330868967
1301,6220064305,298680,6220362985,0,0,0,55296,0,10305873199
1302,6220072942,8872,6220081814,1,0,0,1536,1,3236965290
1303,6220142438,133228,6220275666,5,0,0,2048,5,3261087149
1304,6220177872,23462,6220201334,8,0,0,38912,8,1821915196
1305,6220226630,23204,6220249834,9,0,0,38400,9,6730034388
1306,6220230266,184807,6220415073,8,0,1,5120,8,4660075185
1307,6220253878,226627,6220480505,4,0,1,10752,4,8611975271
1308,6220377634,104633,6220482267,6,0,0,173568,6,10591093144
1309,6220459663,63704,6220523367,4,0,0,103936,4,6708584242
1310,6220556178,1990,6220558168,3,0,1,14336,3,1506179616
1311,6220586069,148395,6220734464,4,0,1,9728,4,7972419762
1312,6220613284,244773,6220858057,8,0,1,26624,8,2851604206
1313,6220642657,176864,6220819521,9,0,1,3584,9,8087013947
1314,6220667872,238175,6220906047,5,0,0,2048,5,2077206397
1315,6220702833,309275,6221012108,4,0,0,605184,4,7324910180
1316,6220705083,370725,6221075808,9,0,1,54272,9,2286503922
1317,6220735376,236452,6220971828,5,0,1,23040,5,5494299467
1318,6220843315,213072,6221056387,6,0,0,29696,6,3458435631
1319,6220870268,200883,6221071151,0,0,1,7680,0,8617902972
1320,6220877661,153116,6221030777,1,0,1,3584,1,3337846890
1321,6220894539,84996,6220979535,6,0,0,50176,6,2884491309
1322,6220978698,41387,6221020085,8,0,0,116736,8,7006728029
1323,6221025350,509944,6221535294,2,0,1,254464,2,8569014766
1324,6221051964,145882,6221197846,2,0,0,8192,2,3819065666
1325,6221125608,13079,6221138687,8,0,1,512,8,4956580740
1326,6221139228,453467,6221592695,6,0,0,67072,6,2904308628
1327,6221278378,418800,6221697178,3,0,0,22016,3,3602345405
1328,6221334626,224670,6221559296,4,0,0,364032,4,9798331663
1329,6221363805,279002,6221642807,7,0,0,268800,7,7426281481
1330,6221438049,216612,6221654661,9,0,0,40448,9,3827623581
1331,6221476683,198664,6221675347,0,0,0,66048,0,3882597538
1332,6221495560,180133,6221675693,1,0,0,512,1,9667355683
1333,6221692539,117342,6221809881,7,0,1,6656,7,2119285906
1334,6221700084,241776,6221941860,8,0,0,195072,8,2133415157
1335,6221715408,308815,6222024223,9,0,0,428544,9,4062894573
1336,6221778206,257051,6222035257,7,0,0,44544,7,5546568934
1337,6221782887,278906,6222061793,8,0,0,86016,8,6008958685
1338,6221859462,204277,6222063739,2,0,0,3072,2,10368632039
1339,6221898369,21424,6221919793,2,0,1,113664,2,9711810688
1340,6222042981,145391,6222188372,5,0,0,1024,5,6832365989
1341,6222055461,381330,6222436791,1,0,1,8192,1,4282332783
1342,6222061031,17679,6222078710,7,0,1,106496,7,6203213417
1343,6222096746,246255,6222343001,4,0,0,239616,4,10436850587
1344,6222121773,278714,6222400487,9,0,1,24064,9,8536965865
1345,6222265395,371915,6222637310,5,0,0,9728,5,86993021
1346,6222297434,562,6222297996,9,0,1,38912,9,3365471409
1347,6222442204,2466,6222444670,5,0,0,512,5,7962241655
1348,6222448514,210771,6222659285,1,0,0,2560,1,10582146904
1349,6222562964,74087,6222637051,7,0,0,120832,7,6827224910
1350,6222632142,66458,6222698600,4,0,0,112640,4,5572122543
1351,6222680949,1514,6222682463,7,0,1,28672,7,1494943294
1352,6222692555,25442,6222717997,9,0,1,51712,9,10486895784
1353,6222732573,9033,6222741606,3,0,0,1536,3,3838080372
1354,6222779062,8405,6222787467,8,0,0,46080,8,3043844426
1355,6222798377,136757,6222935134,2,0,0,4608,2,6499015253
1356,6222801271,239807,6223041078,5,0,0,3584,5,1766525066
1357,6222819430,149086,6222968516,3,0,1,11776,3,10265202005
1358,6223055002,194554,6223249556,0,0,0,315392,0,9272696226
1359,6223068694,91971,6223160665,3,0,1,29184,3,4741515047
1360,6223158891,166158,6223325049,1,0,0,2048,1,9756448855
1361,6223191798,114948,6223306746,6,0,0,273408,6,9893421519
1362,6223244954,303536,6223548490,2,0,0,3072,2,10471833245
1363,6223252687,40013,6223292700,1,0,1,10240,1,89747918
1364,6223332228,270983,6223603211,7,0,0,22528,7,10146113
1365,6223378767,198859,6223577626,6,0,0,327168,6,97598381
1366,6223412160,186152,6223598312,0,0,0,66048,0,630203209
1367,6223415657,184281,6223599938,3,0,0,2560,3,8387095721
1368,6223416367,224891,6223641258,4,0,0,140288,4,2252440191
1369,6223540624,131893,6223672517,9,0,0,108544,9,9160885495
1370,6223637660,38083,6223675743,3,0,0,5120,3,9764931695
1371,6223669784,6625,6223676409,1,0,0,1024,1,7469262540
1372,6223794640,68133,6223862773,8,0,1,512,8,9756637859
1373,6223981203,562,6223981765,3,0,0,512,3,7649058640
1374,6224038557,112420,6224150977,7,0,1,69120,7,2852800364
1375,6224073277,68705,6224141982,8,0,1,14336,8,8326452179
1376,6224083063,145099,6224228162,4,0,1,2560,4,2920624757
1377,6224152514,118192,6224270706,3,0,1,88064,3,88516886
1378,6224166248,73556,6224239804,4,0,1,31744,4,8428492615
1379,6224215858,156760,6224372618,9,0,1,1024,9,1307390683
1380,6224245923,105735,6224351658,1,0,1,8704,1,2914700149
1381,6224345054,47284,6224392338,9,0,1,1536,9,7436289688
1382,6224365022,66975,6224431997,0,0,0,113664,0,6733188713
1383,6224416484,15769,6224432253,9,0,0,9216,9,3058739935
1384,6224578689,20878,6224599567,8,0,0,33792,8,1199318543
1385,6224675433,4675,6224680108,7,0,0,12288,7,6067683322
1386,6224676879,106787,6224783666,2,0,1,173056,2,9480795403
1387,6224734557,292415,6225026972,4,0,1,16384,4,4025630723
1388,6224896768,85798,6224982566,1,0,1,7680,1,2422394481
1389,6225022143,22687,6225044830,4,0,0,37376,4,2104033043
1390,6225028027,116881,6225144908,1,0,1,65536,1,2185529694
1391,6225093829,108052,6225201881,3,0,1,18944,3,5676609796
1392,6225098983,20878,6225119861,5,0,1,54784,5,7350953440
1393,6225204304,162532,6225366836,7,0,1,52736,7,5735112427
1394,6225214251,131815,6225346066,4,0,0,33792,4,9629277385
1395,6225227453,175920,6225403373,2,0,1,40448,2,196621709
1396,6225253472,291573,6225545045,6,0,0,472064,6,159664659
1397,6225260191,321758,6225581949,7,0,0,119296,7,5925141241
1398,6225347177,327881,6225675058,8,0,1,16896,8,3708659776
1399,6225351851,395553,6225747404,7,0,0,312320,7,8981509533
1400,6225474624,298066,6225772690,7,0,0,305664,7,4362997437
1401,6225531463,224827,6225756290,9,0,1,8192,9,6190905981
1402,6225548209,159018,6225707227,1,0,0,512,1,3525835204
1403,6225573244,15566,6225588810,8,0,1,24576,8,7714750570
1404,6225614364,14025,6225628389,1,0,0,512,1,7578373954
1405,6225686379,268754,6225955133,3,0,1,14336,3,6591865296
1406,6225759762,247929,6226007691,2,0,0,3072,2,1367688402
1407,6225772112,429435,6226201547,7,0,0,27136,7,8492599316
1408,6225953818,51770,6226005588,8,0,1,19456,8,1851107755
1409,6225965134,24914,6225990048,0,0,0,83968,0,8830216527
1410,6225992976,184110,6226177086,1,0,0,1536,1,9156544133
1411,6226033687,185116,6226218803,6,0,0,303616,6,6525445425
1412,6226043682,242823,6226286505,8,0,0,217600,8,1529151723
1413,6226067970,239733,6226307703,1,0,0,76800,1,4709547198
1414,6226082495,247020,6226329515,0,0,0,71680,0,10281486629
1415,6226127379,194809,6226322188,5,0,1,13824,5,10709796762
1416,6226135065,336520,6226471585,7,0,0,9728,7,4046633736
1417,6226225581,165988,6226391569,2,0,1,115200,2,10128661541
1418,6226289073,155094,6226444167,9,0,1,8192,9,792837533
1419,6226298767,31743,6226330510,1,0,1,27648,1,5577197262
1420,6226318962,7072,6226326034,5,0,1,53248,5,373164590
1421,6226374160,63704,6226437864,6,0,0,269824,6,5902775564
1422,6226385720,315915,6226701635,3,0,0,1024,3,4882779739
1423,6226511017,427794,6226938811,3,0,0,3072,3,4585604453
1424,6226520563,366809,6226887372,3,0,1,7680,3,8762069504
1425,6226532427,149616,6226682043,4,0,1,3072,4,2165700734
1426,6226536354,367452,6226903806,5,0,0,1024,5,1203323844
1427,6226540069,115943,6226656012,9,0,0,103936,9,9081043355
1428,6226598638,195557,6226794195,1,0,1,5120,1,249802680
1429,6226614135,320233,6226934368,5,0,1,2560,5,8696206741
1430,6226675544,199720,6226875264,1,0,1,41984,1,1932609762
1431,6226680410,33758,6226714168,0,0,1,30720,0,9232013930
1432,6226724862,223867,6226948729,9,0,1,31744,9,2916944614
1433,6226893509,293614,6227187123,1,0,0,58880,1,9737778109
1434,6227068279,133545,6227201824,8,0,0,216576,8,10349289544
1435,6227217650,207950,6227425600,7,0,0,341504,7,3026208434
1436,6227225528,241188,6227466716,9,0,0,139264,9,2542363579
1437,6227251942,343793,6227595735,9,0,0,376320,9,10234700951
1438,6227252666,344528,6227597194,1,0,1,32768,1,9605088780
1439,6227281659,355551,6227637210,9,0,1,85504,9,2755657977
1440,6227372707,297840,6227670547,0,0,0,253952,0,9126846698
1441,6227425980,222821,6227648801,7,0,1,25088,7,9512548102
1442,6227454926,201345,6227656271,2,0,1,580608,2,1915141754
1443,6227469334,221136,6227690470,1,0,0,78848,1,6378785529
1444,6227492398,127692,6227620090,8,0,0,15872,8,8590436499
1445,6227493907,380249,6227874156,9,0,0,77312,9,6203622567
1446,6227500486,2466,6227502952,8,0,1,16896,8,8461265023
1447,6227590216,651019,6228241235,7,0,1,29184,7,6605055658
1448,6227598488,62929,6227661417,6,0,0,45056,6,9640039667
1449,6227668646,32067,6227700713,2,0,1,169984,2,5119408048
1450,6227839079,509223,6228348302,7,0,1,23552,7,5857331625
1451,6227928730,872435,6228801165,3,0,0,2560,3,4986866721
1452,6228022504,710542,6228733046,7,0,0,102400,7,4962252766
1453,6228055632,547296,6228602928,5,0,0,3584,5,8815467607
1454,6228209486,242531,6228452017,4,0,0,111104,4,4029343239
1455,6228237818,226327,6228464145,0,0,0,95744,0,9360914044
1456,6228239718,241042,6228480760,8,0,1,6144,8,1582634877
1457,6228337476,93230,6228430706,3,0,1,28160,3,6969474494
1458,6228383128,79803,6228462931,3,0,1,2048,3,4220927001
1459,6228387576,8281,6228395857,5,0,0,3072,5,1335081010
1460,6228401669,200416,6228602085,3,0,0,1024,3,6682449325
1461,6228474497,98489,6228572986,3,0,0,2048,3,6404909734
1462,6228495740,43624,6228539364,3,0,1,2048,3,10403272520
1463,6228531361,370901,6228902262,5,0,1,76288,5,1859631151
1464,6228622507,1990,6228624497,6,0,0,74752,6,9944410702
1465,6228769514,347786,6229117300,2,0,0,2048,2,1092328035
1466,6228902649,107428,6229010077,0,0,1,52736,0,2288824789
1467,6228990997,43883,6229034880,7,0,0,75264,7,105713324
1468,6229040175,6750,6229046925,6,0,0,7168,6,2581946718
1469,6229083236,24238,6229107474,0,0,1,22016,0,5339548677
1470,6229099282,110900,6229210182,1,0,0,40448,1,3998379005
1471,6229158231,58684,6229216915,1,0,1,8704,1,7908799125
1472,6229160941,93678,6229254619,9,0,1,6656,9,3133814268
1473,6229232108,72020,6229304128,0,0,0,116736,0,1535075468
1474,6229242510,67724,6229310234,4,0,0,29184,4,5013971306
1475,6229261612,49288,6229310900,3,0,0,1024,3,5030011422
1476,6229281570,112520,6229394090,8,0,0,182272,8,6872571762
1477,6229347096,66191,6229413287,8,0,1,12800,8,10002277487
1478,6229359465,14283,6229373748,9,0,0,101888,9,3190766992
1479,6229383018,50995,6229434013,1,0,1,21504,1,3045830328
1480,6229392879,47087,6229439966,0,0,1,26112,0,6625646507
1481,6229453043,165809,6229618852,0,0,0,27648,0,3846326397
1482,6229458048,216384,6229674432,7,0,1,42496,7,2983129587
1483,6229474551,342754,6229817305,0,0,0,82432,0,6760173896
1484,6229478805,385171,6229863976,2,0,0,512,2,5707139802
1485,6229632801,194664,6229827465,7,0,1,10752,7,4980824738
1486,6229657505,206254,6229863759,7,0,0,545792,7,671667618
1487,6229677084,336821,6230013905,0,0,0,140288,0,438292329
1488,6229729678,358562,6230088240,3,0,0,6656,3,8156076833
1489,6229742782,310154,6230052936,5,0,0,2560,5,708023767
1490,6229746161,298676,6230044837,7,0,1,4096,7,8597297976
1491,6229786393,256691,6230043084,6,0,0,2560,6,1741050526
1492,6229809471,235391,6230044862,0,0,1,2560,0,3128750551
1493,6229854135,154842,6230008977,2,0,1,27136,2,9792160583
1494,6229920976,133889,6230054865,8,0,1,26112,8,8042254327
1495,6229951426,250688,6230202114,9,0,0,204288,9,4923910973
1496,6229973045,325808,6230298853,3,0,0,1024,3,9846455348
1497,6230004404,332211,6230336615,9,0,0,768000,9,6448155733
1498,6230155066,482884,6230637950,4,0,1,8192,4,10417947479
1499,6230212032,164754,6230376786,4,0,1,1024,4,6370751005
1500,6230322727,125112,6230447839,6,0,0,1536,6,51706952
1501,6230363035,122238,6230485273,6,0,0,1024,6,8242572935
1502,6230367292,15947,6230383239,1,0,0,14848,1,5868947494
1503,6230367368,139486,6230506854,5,0,1,1024,5,7126185336
1504,6230474569,296120,6230770689,2,0,0,1536,2,7097601289
1505,6230578409,135411,6230713820,1,0,1,1536,1,9763753509
1506,6230632588,154571,6230787159,4,0,0,250880,4,4591535102
1507,6230655411,254885,6230910296,8,0,1,29696,8,5291782031
1508,6230663537,291579,6230955116,1,0,0,747520,1,1711344899
1509,6230677538,274646,6230952184,7,0,1,11264,7,6435656314
1510,6230714917,504856,6231219773,9,0,0,68608,9,3403262939
1511,6230762361,474674,6231237035,6,0,0,4608,6,6926748271
1512,6230889657,430136,6231319793,3,0,1,23040,3,2809106004
1513,6230984246,224009,6231208255,8,0,0,50688,8,8443108668
1514,6230997315,226462,6231223777,9,0,1,20992,9,2045451495
1515,6231055983,219565,6231275548,0,0,0,215552,0,1527981603
1516,6231150954,108084,6231259038,8,0,1,2560,8,8589986793
1517,6231170370,33931,6231204301,2,0,0,4608,2,2550534939
1518,6231244882,2466,6231247348,6,0,0,9728,6,1315123258
1519,6231245863,4370,6231250233,8,0,1,4608,8,7458584091
1520,6231325327,191987,6231517314,5,0,0,2560,5,5809093327
1521,6231377799,294513,6231672312,2,0,0,4608,2,4524325452
1522,6231409711,15833,6231425544,3,0,1,22016,3,3450296595
1523,6231476359,130862,6231607221,4,0,0,30720,4,8389973999
1524,6231483991,104891,6231588882,0,0,1,36864,0,10065100600
1525,6231498606,117981,6231616587,7,0,0,174080,7,6632374501
1526,6231507062,86442,6231593504,0,0,1,5632,0,1644918388
1527,6231516570,215696,6231732266,0,0,0,99328,0,3957874284
1528,6231549095,31520,6231580615,2,0,0,1536,2,5857749817
1529,6231553009,30186,6231583195,5,0,1,12800,5,271323
1530,6231660681,204870,6231865551,7,0,1,2048,7,9541928047
1531,6231710131,1038,6231711169,9,0,0,51200,9,1338735747
1532,6231711811,99940,6231811751,5,0,0,512,5,3626627555
1533,6231735589,122071,6231857660,5,0,1,17408,5,7165570860
1534,6231736078,204896,6231940974,8,0,1,28160,8,3090203981
1535,6231822165,26475,6231848640,5,0,0,1024,5,10300930482
1536,6231830120,118673,6231948793,9,0,1,4096,9,9149853933
1537,6231839782,468172,6232307954,7,0,0,48128,7,5746746664
1538,6231850035,129229,6231979264,8,0,0,196608,8,6664834481
1539,6231874401,75633,6231950034,7,0,1,35840,7,4903621604
1540,6231874524,3641,6231878165,4,0,1,14848,4,6520659339
1541,6231904604,117035,6232021639,4,0,0,12800,4,10131393259
1542,6231976732,95596,6232072328,1,0,1,13312,1,575455866
1543,6231991337,244157,6232235494,5,0,0,10240,5,9075836975
1544,6231998182,279386,6232277568,1,0,0,156672,1,9863374990
1545,6232006903,172351,6232179254,0,0,0,216064,0,2773801752
1546,6232053378,146813,6232200191,5,0,1,8192,5,1304131081
1547,6232056917,285683,6232342600,5,0,1,48128,5,9661650524
1548,6232106971,332392,6232439363,1,0,0,229376,1,1589083125
1549,6232130366,469645,6232600011,4,0,1,22016,4,7348798570
1550,6232285129,258776,6232543905,3,0,1,24064,3,4545328266
1551,6232370214,188734,6232558948,8,0,0,310784,8,10337703338
1552,6232383310,562,6232383872,8,0,1,4096,8,6997866488
1553,6232419546,242522,6232662068,3,0,1,2048,3,5744053957
1554,6232464445,218466,6232682911,3,0,1,35840,3,584802221
1555,6232526973,1038,6232528011,5,0,1,512,5,1133472206
1556,6232587507,227832,6232815339,5,0,0,512,5,425155
1557,6232718672,381569,6233100241,3,0,0,1024,3,6689806789
1558,6232783474,3418,6232786892,5,0,0,3584,5,3165634439
1559,6232797287,11270,6232808557,0,0,0,18432,0,3267393464
1560,6232798097,16659,6232814756,1,0,0,19456,1,7937320101
1561,6232798349,562,6232798911,1,0,1,1024,1,3345151512
1562,6232815060,50220,6232865280,6,0,0,512,6,6838089256
1563,6232861209,35567,6232896776,5,0,1,39936,5,5154527388
1564,6232870865,41499,6232912364,0,0,1,15360,0,379168446
1565,6232881946,131737,6233013683,0,0,0,62464,0,5052175460
1566,6232882735,206048,6233088783,9,0,0,32256,9,6073916014
1567,6232914679,3894,6232918573,8,0,0,212992,8,10646611762
1568,6233083145,244098,6233327243,5,0,0,4096,5,3226385108
1569,6233162920,133029,6233295949,9,0,0,215552,9,10629236527
1570,6233311232,14025,6233325257,2,0,1,140288,2,7491261070
1571,6233318735,2466,6233321201,8,0,1,6656,8,8999372266
1572,6233325180,166484,6233491664,1,0,0,27136,1,10112395364
1573,6233390183,217775,6233607958,2,0,0,2560,2,2103548873
1574,6233599526,2466,6233601992,2,0,0,2560,2,993439251
1575,6233603529,1990,6233605519,5,0,0,2048,5,1227194287
1576,6233631543,30487,6233662030,7,0,0,49152,7,8984172071
1577,6233648423,276241,6233924664,4,0,0,451072,4,130080915
1578,6233703352,222298,6233925650,2,0,0,1536,2,4652743366
1579,6233746450,246635,6233993085,8,0,1,78848,8,7116897268
1580,6233751953,230908,6233982861,8,0,0,234496,8,3527649242
1581,6233769866,94202,6233864068,8,0,1,9728,8,3495622796
1582,6233799042,25510,6233824552,8,0,0,100864,8,4544338157
1583,6233863834,36859,6233900693,1,0,1,28160,1,2875750263
1584,6233936414,316656,6234253070,5,0,0,1024,5,8385590057
1585,6233941954,454679,6234396633,1,0,1,4608,1,10213145668
1586,6234006412,345886,6234352298,2,0,0,2048,2,5404581320
1587,6234026072,270689,6234296761,4,0,0,65024,4,2815988513
1588,6234043203,24150,6234067353,7,0,1,24576,7,9918134232
1589,6234257907,17840,6234275747,8,0,0,43520,8,129978994
1590,6234266803,4675,6234271478,5,0,0,4096,5,7299423768
1591,6234295728,268523,6234564251,4,0,0,12288,4,5717749269
1592,6234302907,107954,6234410861,4,0,1,33280,4,2416309549
1593,6234456282,204785,6234661067,4,0,0,741888,4,6085352627
1594,6234457311,458062,6234915373,2,0,0,2048,2,8842890230
1595,6234531887,458339,6234990226,2,0,0,8704,2,4071098961
1596,6234573077,383917,6234956994,3,0,0,1536,3,9238810425
1597,6234667883,343713,6235011596,5,0,1,24576,5,2027705669
1598,6234678546,280896,6234959442,1,0,0,138752,1,4276035393
1599,6234718156,243552,6234961708,6,0,0,3584,6,7928336075
1600,6234771760,209076,6234980836,5,0,1,41984,5,10105298837
1601,6234790151,360173,6235150324,7,0,0,122368,7,7267466753
1602,6234873239,71860,6234945099,2,0,1,196608,2,2874303586
1603,6235055276,455319,6235510595,0,0,1,6656,0,9634482506
1604,6235074040,275321,6235349361,8,0,1,3072,8,6168238091
1605,6235123388,193694,6235317082,7,0,1,5632,7,2502952492
1606,6235194924,266957,6235461881,7,0,1,32768,7,6659210604
1607,6235256840,176574,6235433414,1,0,1,24064,1,6257297836
1608,6235427430,8442,6235435872,3,0,0,2560,3,5245979559
1609,6235512382,74356,6235586738,4,0,1,9728,4,1963248768
1610,6235655559,49444,6235705003,1,0,1,3584,1,9388866585
1611,6235705556,143412,6235848968,7,0,0,232448,7,4468412262
1612,6235755958,5798,6235761756,2,0,1,8704,2,3921618747
1613,6235844559,234771,6236079330,2,0,1,13312,2,5576927410
1614,6235940081,105556,6236045637,0,0,0,6144,0,2856219828
1615,6235960721,233082,6236193803,1,0,1,46592,1,4865211300
1616,6236073892,39049,6236112941,0,0,0,61952,0,5719951320
1617,6236131352,175854,6236307206,7,0,0,285696,7,3423560209
1618,6236172900,2942,6236175842,2,0,1,105984,2,3525535911
1619,6236262086,268186,6236530272,2,0,1,26624,2,9888933757
1620,6236332678,195098,6236527776,5,0,0,3072,5,958852600
1621,6236367342,68914,6236436256,5,0,1,33792,5,1456544184
1622,6236416064,6750,6236422814,1,0,1,512,1,7999904468
1623,6236499839,562,6236500401,2,0,0,7168,2,9386298219
1624,6236518406,252399,6236770805,5,0,0,512,5,4325088461
1625,6236649448,54613,6236704061,1,0,0,89600,1,3325226998
1626,6236717079,4370,6236721449,5,0,0,4608,5,5997230341
1627,6236787378,23204,6236810582,0,0,0,38400,0,4703735370
1628,6236821530,46467,6236867997,0,0,0,80384,0,5822636773
1629,6236833002,45433,6236878435,5,0,1,1024,5,9586253156
1630,6236882599,40612,6236923211,4,0,0,78336,4,4414095878
1631,6236928149,33640,6236961789,1,0,0,65536,1,3437635120
1632,6236937115,69864,6237006979,4,0,1,3072,4,8117944232
1633,6236938347,212238,6237150585,2,0,0,5120,2,465268291
1634,6236996470,64738,6237061208,8,0,0,105984,8,5134638433
1635,6237016311,146335,6237162646,3,0,1,27648,3,1088208698
1636,6237073493,41904,6237115397,3,0,1,17408,3,450231141
1637,6237136011,46984,6237182995,0,0,0,68096,0,6268416417
1638,6237163877,1514,6237165391,4,0,0,81408,4,6679191812
1639,6237250469,234413,6237484882,5,0,0,1536,5,4702711483
1640,6237384298,562,6237384860,3,0,0,512,3,2111095015
1641,6237409968,109456,6237519424,2,0,1,59392,2,9451261762
1642,6237472940,46503,6237519443,7,0,0,80384,7,7527499233
1643,6237496863,23210,6237520073,3,0,0,1024,3,1016316547
1644,6237507252,33846,6237541098,1,0,1,76288,1,4845301683
1645,6237531751,107882,6237639633,7,0,0,55808,7,3189564248
1646,6237550724,276151,6237826875,7,0,1,25088,7,4377418287
1647,6237620159,163255,6237783414,9,0,0,243200,9,1471915867
1648,6237671716,127619,6237799335,9,0,0,103936,9,1291725368
1649,6237719413,240497,6237959910,3,0,1,9728,3,4459214797
1650,6238023940,101344,6238125284,4,0,1,32768,4,405854615
1651,6238140917,81148,6238222065,5,0,1,16896,5,8280336102
1652,6238255250,4158,6238259408,3,0,0,11264,3,4784540949
1653,6238308888,64204,6238373092,9,0,1,6656,9,1253284423
1654,6238318576,65140,6238383716,5,0,1,9728,5,3386069362
1655,6238362973,26475,6238389448,7,0,0,48128,7,7590897473
1656,6238364298,69980,6238434278,9,0,0,96768,9,9987031680
1657,6238463931,562,6238464493,3,0,0,512,3,7603139486
1658,6238568000,177690,6238745690,8,0,1,61952,8,3669622943
1659,6238622248,123453,6238745701,7,0,0,188416,7,655258169
1660,6238638985,65363,6238704348,1,0,1,20992,1,9595346008
1661,6238680349,8581,6238688930,3,0,0,2048,3,8797355058
1662,6238740541,138476,6238879017,2,0,0,3584,2,9898354087
1663,6238748131,42937,6238791068,4,0,0,70144,4,6912372184
1664,6238773467,86708,6238860175,3,0,1,43008,3,4004773465
1665,6238806747,63023,6238869770,8,0,0,145408,8,2859736703
1666,6238831418,182842,6239014260,6,0,0,1536,6,7015497166
1667,6238854424,130237,6238984661,9,0,1,10240,9,2990111175
1668,6238936429,48243,6238984672,1,0,0,79872,1,9677808071
1669,6239014931,562,6239015493,5,0,0,512,5,6536657011
1670,6239020703,1038,6239021741,2,0,0,1024,2,2895853331
1671,6239031015,73054,6239104069,0,0,1,11776,0,3691629348
1672,6239062432,2466,6239064898,4,0,0,118784,4,8286487010
1673,6239132820,54354,6239187174,8,0,1,28672,8,1847907476
1674,6239142263,222040,6239364303,9,0,1,16384,9,9751115304
1675,6239162862,137267,6239300129,4,0,1,13824,4,8958972243
1676,6239176563,163226,6239339789,2,0,0,2560,2,604208393
1677,6239183206,75033,6239258239,1,0,0,89088,1,3080710681
1678,6239185808,137265,6239323073,8,0,1,19968,8,2454658191
1679,6239240253,171654,6239411907,9,0,0,125952,9,8322399494
1680,6239292854,71503,6239364357,8,0,0,115712,8,9600176372
1681,6239412158,69616,6239481774,7,0,1,14336,7,8813056781
1682,6239471945,169632,6239641577,8,0,1,25088,8,8658150324
1683,6239475542,148633,6239624175,8,0,1,87552,8,5908360352
1684,6239578251,262594,6239840845,8,0,1,32768,8,9141863020
1685,6239728443,8078,6239736521,6,0,0,2048,6,5232477721
1686,6239783518,198600,6239982118,8,0,0,326656,8,3855651104
1687,6239926085,131893,6240057978,3,0,1,3584,3,1041767149
1688,6239987074,53537,6240040611,6,0,1,8704,6,605612742
1689,6240004452,109670,6240114122,7,0,0,85504,7,5732459309
1690,6240063603,33152,6240096755,4,0,0,52736,4,10634780644
1691,6240143850,5322,6240149172,8,0,0,5632,8,7294294522
1692,6240246336,1990,6240248326,2,0,0,2048,2,8440909912
1693,6240290656,23633,6240314289,1,0,0,42496,1,9121301315
1694,6240307497,123452,6240430949,2,0,1,85504,2,6630879900
1695,6240416353,69218,6240485571,0,0,0,89600,0,5383918788
1696,6240416374,299134,6240715508,1,0,0,538624,1,2074148555
1697,6240454454,371592,6240826046,6,0,1,2560,6,1742636504
1698,6240548786,284750,6240833536,4,0,1,6144,4,8386441255
1699,6240622228,226893,6240849121,3,0,1,22528,3,8930383479
1700,6240661871,196275,6240858146,5,0,1,18432,5,5978268761
1701,6240702937,174449,6240877386,7,0,0,322048,7,7171907589
1702,6240750518,113200,6240863718,6,0,1,512,6,2359948732
1703,6240817783,405628,6241223411,9,0,0,111104,9,9586913061
1704,6240959252,115275,6241074527,3,0,1,13312,3,6254647595
1705,6240977779,97491,6241075270,8,0,0,190976,8,7612267081
1706,6241016249,13604,6241029853,8,0,0,74240,8,8871537720
1707,6241096066,12571,6241108637,2,0,1,42496,2,6688886842
1708,6241100802,74604,6241175406,5,0,0,1024,5,9180754666
1709,6241102821,246853,6241349674,3,0,0,1536,3,7327033191
1710,6241103892,191186,6241295078,8,0,0,121856,8,1762057776
1711,6241106528,227069,6241333597,8,0,0,311296,8,7969994955
1712,6241122781,216626,6241339407,8,0,1,29696,8,1376994903
1713,6241169069,485139,6241654208,4,0,0,175616,4,5353675727
1714,6241175679,595708,6241771387,9,0,1,11264,9,9715218218
1715,6241282789,377711,6241660500,2,0,1,414720,2,1753536119
1716,6241317423,312270,6241629693,2,0,1,38912,2,4769557159
1717,6241336801,199250,6241536051,6,0,1,48128,6,9502647381
1718,6241393687,182415,6241576102,9,0,0,560128,9,2817593603
1719,6241397838,179413,6241577251,6,0,1,55808,6,6763534250
1720,6241459139,465169,6241924308,2,0,0,3072,2,5280110056
1721,6241466523,726158,6242192681,8,0,1,7680,8,10595351649
1722,6241567405,398746,6241966151,9,0,1,94720,9,1281739408
1723,6241572170,199250,6241771420,5,0,0,512,5,2271126687
1724,6241589016,132527,6241721543,2,0,0,1536,2,1950754328
1725,6241604580,660617,6242265197,1,0,0,139264,1,5739914875
1726,6241628677,137610,6241766287,0,0,1,9216,0,2410591904
1727,6241631497,652913,6242284410,2,0,1,1536,2,2192640738
1728,6241766912,19434,6241786346,4,0,0,279552,4,1341708105
1729,6241779321,438386,6242217707,0,0,1,7168,0,10416003927
1730,6241833646,629506,6242463152,2,0,0,512,2,7872743462
1731,6241840441,440277,6242280718,7,0,0,111104,7,4278355017
1732,6241904350,615156,6242519506,4,0,1,4096,4,8287652309
1733,6242019074,96833,6242115907,4,0,1,39936,4,5310064230
1734,6242031328,386775,6242418103,6,0,0,27648,6,2648322581
1735,6242170556,63962,6242234518,0,0,0,161792,0,7777902745
1736,6242181391,26475,6242207866,9,0,1,20480,9,1418712568
1737,6242254307,348276,6242602583,6,0,0,104448,6,2933682358
1738,6242276297,32992,6242309289,5,0,1,1024,5,3019120366
1739,6242307277,192221,6242499498,7,0,0,48128,7,8877168105
1740,6242334369,13508,6242347877,7,0,0,36352,7,7842528397
1741,6242379825,231994,6242611819,7,0,0,26112,7,9357143217
1742,6242413579,23891,6242437470,5,0,1,15360,5,4605662610
1743,6242423574,4370,6242427944,0,0,1,35328,0,9000583633
1744,6242549899,244606,6242794505,1,0,0,43008,1,3164116031
1745,6242560010,4846,6242564856,4,0,1,1536,4,5488744443
1746,6242595956,266658,6242862614,7,0,0,4608,7,10279130297
1747,6242605085,172362,6242777447,9,0,1,59392,9,9183111618
1748,6242661113,75550,6242736663,3,0,0,5120,3,998230285
1749,6242744652,246298,6242990950,4,0,0,126976,4,9469429672
1750,6242748573,1878,6242750451,7,0,1,9728,7,2629773447
1751,6242827777,109172,6242936949,8,0,1,14848,8,5198042747
1752,6242847811,4933,6242852744,3,0,1,20992,3,6331189660
1753,6242851036,91774,6242942810,2,0,0,1536,2,7273047115
1754,6242855825,130303,6242986128,3,0,1,3584,3,10200263305
1755,6242877920,142405,6243020325,2,0,0,12800,2,495822586
1756,6242937835,75808,6243013643,4,0,0,127488,4,1397439204
1757,6242962669,124570,6243087239,1,0,1,11776,1,10295433874
1758,6242969996,68389,6243038385,1,0,1,12288,1,10503600354
1759,6242991358,166654,6243158012,0,0,0,232960,0,9719278459
1760,6243017944,145303,6243163247,8,0,1,51200,8,1594853724
1761,6243043031,114631,6243157662,4,0,1,2048,4,336164998
1762,6243044320,43927,6243088247,6,0,1,33280,6,5861999800
1763,6243051656,34104,6243085760,0,0,0,108544,0,3736733311
1764,6243065719,28185,6243093904,3,0,1,10240,3,8610105736
1765,6243109381,152076,6243261457,4,0,1,15360,4,4574990879
1766,6243126226,289188,6243415414,5,0,0,6144,5,6118551993
1767,6243175822,272963,6243448785,0,0,0,56320,0,7611113082
1768,6243182407,268052,6243450459,2,0,0,1024,2,2364345063
1769,6243378316,562,6243378878,2,0,0,512,2,7389235731
1770,6243407138,96848,6243503986,4,0,1,18944,4,1473478346
1771,6243511378,203906,6243715284,9,0,1,11776,9,895263049
1772,6243641725,74662,6243716387,0,0,1,3584,0,4618979897
1773,6243861779,97600,6243959379,4,0,1,20480,4,454114104
1774,6243898457,1514,6243899971,9,0,1,35328,9,2133336047
1775,6243968086,1038,6243969124,3,0,0,1536,3,5477390652
1776,6243978971,102124,6244081095,5,0,0,1024,5,3658070811
1777,6244086349,64384,6244150733,8,0,1,12288,8,2531337139
1778,6244148467,86814,6244235281,3,0,1,23040,3,4154060423
1779,6244156568,176541,6244333109,7,0,0,290304,7,10452224238
1780,6244160584,172867,6244333451,9,0,1,20480,9,5435791809
1781,6244176409,163445,6244339854,0,0,0,52736,0,6162304560
1782,6244197329,141897,6244339226,5,0,1,27136,5,2552680779
1783,6244197685,298327,6244496012,4,0,0,40448,4,5058931887
1784,6244230228,232405,6244462633,6,0,1,10240,6,5213220772
1785,6244230574,200046,6244430620,3,0,1,3584,3,3559371230
1786,6244262438,345099,6244607537,2,0,1,271360,2,7522664496
1787,6244271213,236552,6244507765,9,0,0,324608,9,10640110130
1788,6244327930,132512,6244460442,4,0,1,11776,4,8699473945
1789,6244347514,124773,6244472287,6,0,1,28160,6,2506177760
1790,6244367675,97715,6244465390,7,0,1,3584,7,9762100527
1791,6244480142,83538,6244563680,1,0,0,214528,1,986185361
1792,6244491427,493896,6244985323,7,0,0,5632,7,5875916115
1793,6244544509,389762,6244934271,0,0,0,83456,0,8371752604
1794,6244559352,125916,6244685268,3,0,0,1024,3,10337040532
1795,6244647892,450694,6245098586,0,0,1,2048,0,987140218
1796,6244649466,46984,6244696450,2,0,1,100864,2,3236682940
1797,6244655529,307550,6244963079,3,0,1,40448,3,8798149936
1798,6244795265,195988,6244991253,0,0,1,52224,0,2119078619
1799,6244885041,126482,6245011523,4,0,1,5632,4,6562678126
1800,6244901607,418589,6245320196,9,0,0,81408,9,3363017725
1801,6244971531,63358,6245034889,7,0,1,29696,7,2880527473
1802,6245087658,129760,6245217418,8,0,1,28672,8,1375712211
1803,6245133651,254946,6245388597,8,0,0,106496,8,6068171999
1804,6245154050,181542,6245335592,5,0,1,17920,5,1986966032
1805,6245166518,233814,6245400332,5,0,1,13312,5,8560424583
1806,6245186221,279636,6245465857,7,0,0,760320,7,6986293915
1807,6245250785,469221,6245720006,3,0,0,1536,3,2694530004
1808,6245264517,405643,6245670160,5,0,1,1024,5,902402103
1809,6245314258,86450,6245400708,8,0,1,3072,8,6037379378
1810,6245375817,291596,6245667413,1,0,1,10240,1,8221891308
1811,6245382414,382382,6245764796,7,0,1,3584,7,1255270095
1812,6245500378,117600,6245617978,4,0,1,19456,4,6770225136
1813,6245514208,437583,6245951791,2,0,1,197120,2,2398884735
1814,6245565689,358537,6245924226,6,0,1,23552,6,8561880702
1815,6245573204,33329,6245606533,5,0,0,5120,5,2235604153
1816,6245606239,466945,6246073184,8,0,0,195584,8,4602596597
1817,6245659337,422651,6246081988,0,0,1,4608,0,1783976288
1818,6245796929,330418,6246127347,9,0,1,1024,9,10094862889
1819,6245866944,193149,6246060093,9,0,0,54784,9,1279644279
1820,6245904628,167244,6246071872,0,0,1,11264,0,8315483259
1821,6245914056,180123,6246094179,0,0,1,29696,0,38484215
1822,6245957613,162698,6246120311,4,0,1,7168,4,9482305161
1823,6246074105,108480,6246182585,8,0,1,13824,8,94665543
1824,6246125494,82816,6246208310,5,0,1,12288,5,4397190180
1825,6246307746,35825,6246343571,7,0,1,16384,7,5095909126
1826,6246347323,84064,6246431387,8,0,0,62976,8,1800051654
1827,6246448194,3641,6246451835,2,0,0,10240,2,1660505578
1828,6246527670,1038,6246528708,5,0,1,6144,5,2527516250
1829,6246537339,54832,6246592171,5,0,0,1024,5,4453004888
1830,6246696806,22858,6246719664,9,0,0,40960,9,5129399233
1831,6246839599,55744,6246895343,0,0,1,4096,0,6270921869
1832,6246891043,4311,6246895354,1,0,0,9728,1,4656467810
1833,6246947604,50668,6246998272,7,0,1,2560,7,2537366824
1834,6246947881,183654,6247131535,4,0,0,297472,4,1216506324
1835,6247124156,10285,6247134441,5,0,0,4608,5,7979474178
1836,6247131075,4846,6247135921,2,0,1,50176,2,6535832535
1837,6247153498,185457,6247338955,3,0,0,5120,3,8801626728
1838,6247224552,70606,6247295158,8,0,1,2560,8,7107064532
1839,6247245937,113503,6247359440,0,0,0,103936,0,4600511190
1840,6247312450,57318,6247369768,8,0,0,90112,8,1952186852
1841,6247353107,2466,6247355573,9,0,1,6144,9,9344729014
1842,6247406566,66596,6247473162,3,0,0,2560,3,841258372
1843,6247439422,3894,6247443316,3,0,0,4096,3,10452598023
1844,6247491868,3383,6247495251,2,0,0,9728,2,4701658519
1845,6247535460,101032,6247636492,0,0,1,31744,0,5684643592
1846,6247567059,14909,6247581968,8,0,1,19968,8,622896767
1847,6247621594,23891,6247645485,5,0,0,8192,5,1414541691
1848,6247649583,57436,6247707019,9,0,0,43008,9,2937535093
1849,6247666242,68992,6247735234,1,0,1,4608,1,7829194085
1850,6247672720,204182,6247876902,1,0,1,12288,1,8512341069
1851,6247880706,82662,6247963368,9,0,0,134144,9,1889572870
1852,6247914670,92632,6248007302,7,0,0,143360,7,7922399569
1853,6247927392,175954,6248103346,3,0,1,31232,3,5184131147
1854,6247929888,209030,6248138918,9,0,0,281088,9,9507209830
1855,6247972525,219106,6248191631,7,0,0,178688,7,1134194787
1856,6248015650,202517,6248218167,7,0,0,86016,7,10525654302
1857,6248065440,163045,6248228485,0,0,0,32768,0,3862217090
1858,6248139157,237535,6248376692,5,0,1,512,5,8698526440
1859,6248295002,85036,6248380038,0,0,1,7680,0,6131617804
1860,6248368502,198120,6248566622,3,0,1,3072,3,2103433383
1861,6248531139,208467,6248739606,8,0,0,342528,8,9456879960
1862,6248645634,115068,6248760702,0,0,0,76288,0,10075743182
1863,6248724318,52347,6248776665,9,0,0,59904,9,5347437325
1864,6248736226,83752,6248819978,0,0,0,130560,0,8518998737
1865,6248795118,42937,6248838055,3,0,1,24064,3,7569858074
1866,6248798981,1514,6248800495,2,0,1,200704,2,1667340254
1867,6248814066,216683,6249030749,7,0,1,19968,7,6361070152
1868,6248832007,80432,6248912439,0,0,0,70144,0,4361420595
1869,6248918194,38260,6248956454,5,0,1,9728,5,3465787951
1870,6248930487,213570,6249144057,2,0,0,1536,2,6543838156
1871,6248935267,294354,6249229621,0,0,0,116224,0,9184602055
1872,6248945670,197021,6249142691,9,0,1,1536,9,7945689137
1873,6248979436,290854,6249270290,5,0,0,2048,5,5364606178
1874,6248997438,246333,6249243771,8,0,0,632832,8,5780230351
1875,6249024106,407283,6249431389,7,0,0,296960,7,7456428214
1876,6249029971,473470,6249503441,4,0,1,34816,4,9953662785
1877,6249033200,415027,6249448227,7,0,1,11264,7,2812222137
1878,6249084175,353592,6249437767,3,0,0,2560,3,9866009673
1879,6249105630,497533,6249603163,2,0,1,530944,2,8148635650
1880,6249151819,156832,6249308651,1,0,0,21504,1,5596272322
1881,6249265885,65892,6249331777,6,0,1,8704,6,5012915239
1882,6249370683,406668,6249777351,9,0,0,48640,9,335064527
1883,6249399027,302436,6249701463,7,0,1,41472,7,10490012028
1884,6249400995,823332,6250224327,6,0,1,13312,6,7911799156
1885,6249461634,356065,6249817699,2,0,0,1536,2,9883936592
1886,6249539850,244776,6249784626,9,0,1,1024,9,7971369562
1887,6249572908,389481,6249962389,7,0,0,330752,7,230973211
1888,6249684216,542967,6250227183,1,0,0,3584,1,450620575
1889,6249777362,165723,6249943085,4,0,1,46592,4,10563902560
1890,6249779613,116990,6249896603,2,0,0,9728,2,2671306187
1891,6249797630,174234,6249971864,4,0,1,5632,4,2063233883
1892,6249829012,208380,6250037392,5,0,0,1024,5,9439398016
1893,6249834634,165995,6250000629,2,0,1,164352,2,7265530278
1894,6249938392,403826,6250342218,7,0,1,34816,7,5387253284
1895,6249940043,439053,6250379096,0,0,0,328704,0,9708964104
1896,6249987882,601747,6250589629,0,0,1,16896,0,2025367255
1897,6250353414,39042,6250392456,3,0,1,57856,3,2176893566
1898,6250430677,154817,6250585494,8,0,0,54784,8,4875706567
1899,6250434061,74321,6250508382,9,0,0,94208,9,6595131790
1900,6250539697,1038,6250540735,5,0,0,1024,5,7591346875
1901,6250585327,14283,6250599610,6,0,0,27648,6,2748733414
1902,6250624133,11529,6250635662,0,0,0,18944,0,6914084152
1903,6250660347,2942,6250663289,3,0,0,3072,3,7789460358
1904,6250711389,141967,6250853356,9,0,1,12800,9,7918420928
1905,6250743623,134164,6250877787,9,0,1,26624,9,2470122865
1906,6250776615,123579,6250900194,1,0,1,54272,1,372399804
1907,6250785949,198037,6250983986,7,0,1,35840,7,4292171184
1908,6250855986,333217,6251189203,8,0,1,19968,8,9533721398
1909,6250858432,118243,6250976675,7,0,0,594944,7,774842201
1910,6250900089,367196,6251267285,1,0,0,145920,1,5927756134
1911,6250916264,367986,6251284250,6,0,0,220672,6,1064748381
1912,6251006248,420128,6251426376,7,0,0,54272,7,329718816
1913,6251009525,333874,6251343399,6,0,1,13824,6,7189193343
1914,6251023393,351030,6251374423,9,0,1,15360,9,3556418905
1915,6251038323,320241,6251358564,1,0,0,18944,1,2171407935
1916,6251041615,317717,6251359332,9,0,0,11776,9,6209860544
1917,6251080963,266237,6251347200,0,0,1,14848,0,4887642666
1918,6251114926,68989,6251183915,4,0,1,13312,4,6203376553
1919,6251144989,409308,6251554297,9,0,0,174592,9,3257044433
1920,6251176099,84383,6251260482,3,0,1,10752,3,4831026029
1921,6251314820,330724,6251645544,7,0,1,15872,7,195524199
1922,6251369182,321402,6251690584,8,0,0,96256,8,8540463066
1923,6251389370,535503,6251924873,5,0,1,512,5,5076883942
1924,6251406094,237304,6251643398,7,0,0,140800,7,820011861
1925,6251428799,55041,6251483840,3,0,1,7680,3,598936587
1926,6251548239,139480,6251687719,0,0,1,29184,0,4183862507
1927,6251578695,341863,6251920558,7,0,1,7680,7,5074936118
1928,6251630905,2466,6251633371,7,0,0,93696,7,4431684349
1929,6251707902,294440,6252002342,0,0,1,165376,0,8966984348
1930,6251723728,54783,6251778511,9,0,1,16384,9,7944974704
1931,6251755584,200592,6251956176,5,0,0,2560,5,7061813379
1932,6251840213,310966,6252151179,1,0,1,59392,1,9152193595
1933,6251844884,249213,6252094097,0,0,0,93184,0,6043533594
1934,6251974382,115835,6252090217,8,0,1,2560,8,700288086
1935,6252080375,11348,6252091723,9,0,0,1536,9,40919189
1936,6252157595,225358,6252382953,4,0,0,368640,4,2903327607
1937,6252163991,219415,6252383406,6,0,1,8704,6,7271783254
1938,6252164204,223485,6252387689,5,0,0,1024,5,7924873282
1939,6252185974,185005,6252370979,4,0,0,282624,4,9317398791
1940,6252201081,222516,6252423597,9,0,1,10752,9,9500861434
1941,6252231920,147283,6252379203,0,0,1,29184,0,7192477234
1942,6252310908,286551,6252597459,2,0,1,99840,2,820061878
1943,6252325231,176025,6252501256,0,0,1,3584,0,4168696780
1944,6252332118,156412,6252488530,8,0,0,124928,8,7952026779
1945,6252337689,332769,6252670458,2,0,1,668160,2,10328864313
1946,6252366227,267408,6252633635,4,0,1,64512,4,10705138133
1947,6252409065,185109,6252594174,1,0,0,192512,1,5144249582
1948,6252495039,124939,6252619978,4,0,1,11264,4,8079122326
1949,6252602317,130183,6252732500,7,0,0,437248,7,3867107050
1950,6252645282,824219,6253469501,2,0,1,311808,2,2957003108
1951,6252674275,881431,6253555706,5,0,1,2048,5,9428700377
1952,6252716490,284865,6253001355,4,0,0,111616,4,9099071724
1953,6252769939,390516,6253160455,8,0,1,7168,8,5125576888
1954,6252777006,847213,6253624219,3,0,0,512,3,10622155024
1955,6252782796,539808,6253322604,8,0,0,44544,8,6013770252
1956,6252803249,402591,6253205840,0,0,1,4608,0,8141422566
1957,6252813415,665739,6253479154,9,0,1,6144,9,6932284188
1958,6252850041,543317,6253393358,1,0,1,2048,1,9531219832
1959,6252907485,463858,6253371343,6,0,0,111104,6,2222530314
1960,6252994400,254684,6253249084,0,0,1,11264,0,5959198503
1961,6253062521,181725,6253244246,9,0,0,15360,9,4590934453
1962,6253105248,455651,6253560899,8,0,0,250880,8,9284086898
1963,6253156503,364983,6253521486,2,0,0,8192,2,8983888362
1964,6253163217,318874,6253482091,4,0,0,54784,4,3351676556
1965,6253171893,328737,6253500630,3,0,0,512,3,6999286496
1966,6253176946,320407,6253497353,8,0,1,512,8,8177807325
1967,6253247917,178270,6253426187,7,0,1,9728,7,62535568
1968,6253324655,5368,6253330023,0,0,0,42496,0,9294841112
1969,6253345618,98922,6253444540,0,0,1,20992,0,9203034398
1970,6253422080,1514,6253423594,9,0,1,3584,9,8467337874
1971,6253458397,324152,6253782549,6,0,1,53760,6,3173523146
1972,6253498543,1990,6253500533,2,0,0,1536,2,8092373266
1973,6253545458,455668,6254001126,5,0,0,1536,5,4766206725
1974,6253550073,301880,6253851953,4,0,1,30208,4,7979443545
1975,6253599723,305324,6253905047,2,0,1,441344,2,3415247214
1976,6253694753,118803,6253813556,3,0,0,2048,3,10033499295
1977,6253733782,21912,6253755694,4,0,1,35840,4,2681263496
1978,6253736605,4846,6253741451,0,0,0,188416,0,3641224934
1979,6253739050,44916,6253783966,7,0,1,33792,7,9938901730
1980,6253748897,586913,6254335810,3,0,1,17408,3,9886194621
1981,6253838368,463801,6254302169,1,0,1,3584,1,3079009307
1982,6253874950,360334,6254235284,1,0,0,35840,1,1352668303
1983,6253922536,207464,6254130000,3,0,0,5120,3,7160688869
1984,6253940029,455139,6254395168,6,0,0,77312,6,4200557468
1985,6253991257,186376,6254177633,4,0,0,290816,4,2976253348
1986,6254021634,166033,6254187667,5,0,1,12288,5,9898783179
1987,6254070423,164018,6254234441,8,0,0,86016,8,5703725561
1988,6254126865,622020,6254748885,0,0,0,101888,0,5866267887
1989,6254131786,174084,6254305870,2,0,0,4608,2,4420870425
1990,6254165160,464508,6254629668,3,0,1,31744,3,734521584
1991,6254195672,336412,6254532084,7,0,1,40960,7,6624525323
1992,6254252070,222134,6254474204,4,0,0,264704,4,6302393124
1993,6254252320,441619,6254693939,0,0,1,27648,0,5606047511
1994,6254319789,384273,6254704062,8,0,1,32256,8,7850364269
1995,6254578610,91276,6254669886,0,0,1,14848,0,5805961377
1996,6254605690,25183,6254630873,1,0,1,1024,1,1236028817
1997,6254623094,108934,6254732028,6,0,1,26112,6,8694998914
1998,6254653417,109595,6254763012,6,0,0,45568,6,1276154892
1999,6254656990,151718,6254808708,6,0,1,18432,6,5342228914
2000,6254670277,226838,6254897115,1,0,1,22016,1,8131276925
2001,6254691930,116050,6254807980,7,0,1,75776,7,1014881525
2002,6254752386,144820,6254897206,3,0,1,39936,3,5743319499
2003,6254754650,298255,6255052905,1,0,0,192512,1,2793081098
2004,6254799443,296301,6255095744,8,0,1,31744,8,4184358895
2005,6254937159,186321,6255123480,2,0,1,68096,2,3873548992
2006,6254941271,215749,6255157020,3,0,1,75776,3,10369843059
2007,6254947585,209650,6255157235,8,0,0,353280,8,7947291676
2008,6254972904,287048,6255259952,2,0,1,241664,2,1988295792
2009,6254980425,250392,6255230817,8,0,0,87040,8,4977214332
2010,6255018163,422801,6255440964,7,0,0,252928,7,971772779
2011,6255079241,316475,6255395716,8,0,0,181248,8,3152287686
2012,6255084359,226262,6255310621,2,0,1,59392,2,5345775491
2013,6255169473,72035,6255241508,0,0,0,39424,0,3835221074
2014,6255177115,44110,6255221225,3,0,1,54784,3,2039476312
2015,6255297369,443237,6255740606,6,0,1,35840,6,8284998366
2016,6255329972,397763,6255727735,2,0,0,6656,2,5293825974
2017,6255360163,123876,6255484039,7,0,0,3584,7,6148185574
2018,6255451013,390003,6255841016,7,0,0,198144,7,8195635802
2019,6255524862,264677,6255789539,0,0,1,2560,0,7712108717
2020,6255596163,119686,6255715849,0,0,1,89600,0,3666157385
2021,6255743505,339120,6256082625,8,0,1,7680,8,10389560107
2022,6255773998,132665,6255906663,8,0,1,15872,8,726065850
2023,6255920353,51253,6255971606,6,0,0,82944,6,9664867947
2024,6255971202,67844,6256039046,3,0,1,512,3,9847251373
2025,6256049816,70972,6256120788,8,0,1,8704,8,8861501822
2026,6256101298,318550,6256419848,7,0,0,520192,7,9808174776
2027,6256169446,272522,6256441968,0,0,0,81408,0,5949488312
2028,6256281733,236223,6256517956,0,0,1,5120,0,8286485190
2029,6256301793,243787,6256545580,0,0,1,24064,0,4514398871
2030,6256376339,1514,6256377853,0,0,1,20480,0,2574996896
2031,6256501294,129854,6256631148,3,0,1,5120,3,4601205881
2032,6256624177,352023,6256976200,2,0,0,1536,2,7364220533
2033,6256675700,4370,6256680070,5,0,1,36864,5,9310020139
2034,6256694800,102592,6256797392,0,0,0,4608,0,3222910971
2035,6256801523,6750,6256808273,2,0,1,479232,2,2626124604
2036,6256864823,384832,6257249655,3,0,0,7168,3,9797555479
2037,6256923285,269181,6257192466,5,0,1,19968,5,10256363751
2038,6256924446,268700,6257193146,7,0,0,439808,7,8561695581
2039,6256976508,267971,6257244479,6,0,0,84480,6,3076523169
2040,6256977529,267296,6257244825,3,0,0,512,3,9052067778
2041,6257077266,10849,6257088115,7,0,1,18944,7,830488725
2042,6257195182,7226,6257202408,4,0,1,5120,4,2380837018
2043,6257234335,6225,6257240560,4,0,0,9728,4,6253614736
2044,6257289719,15833,6257305552,5,0,0,7680,5,2897752647
2045,6257298410,1038,6257299448,4,0,0,15360,4,1449584687
2046,6257312349,331621,6257643970,5,0,1,55808,5,6540339229
2047,6257317921,3894,6257321815,0,0,0,30720,0,4133781370
2048,6257391501,170184,6257561685,2,0,0,1024,2,7168005598
2049,6257401113,4846,6257405959,0,0,1,20480,0,9099488420
2050,6257415485,120117,6257535602,0,0,0,4096,0,271204394
2051,6257499946,327619,6257827565,1,0,0,5120,1,9207701512
2052,6257514886,5450,6257520336,2,0,1,14336,2,10696940884
2053,6257526071,81807,6257607878,3,0,1,27136,3,1497389765
2054,6257542487,60376,6257602863,9,0,1,9216,9,7514454293
2055,6257585434,142498,6257727932,0,0,0,13824,0,5139494916
2056,6257660853,21750,6257682603,8,0,0,27136,8,6993442697
2057,6257666990,20119,6257687109,0,0,0,7168,0,2341764745
2058,6257668735,42898,6257711633,4,0,0,53248,4,5003724083
2059,6257686783,52477,6257739260,7,0,1,512,7,6594628841
2060,6257698066,44916,6257742982,5,0,0,77312,5,7589165685
2061,6257774639,3894,6257778533,2,0,0,4096,2,6679015295
2062,6257826218,5708,6257831926,4,0,0,14336,4,555812377
2063,6257912798,69378,6257982176,7,0,1,3072,7,6271189663
2064,6257926136,136300,6258062436,0,0,0,225280,0,4914794331
2065,6257954596,139918,6258094514,6,0,0,104448,6,8680466821
2066,6257982194,112986,6258095180,3,0,0,1024,3,2495028055
2067,6258003855,22416,6258026271,1,0,1,24064,1,7773933754
2068,6258003855,89924,6258093779,5,0,1,14336,5,7641046252
2069,6258076630,275361,6258351991,2,0,0,6144,2,8485534910
2070,6258109538,279740,6258389278,5,0,1,14336,5,10175506155
2071,6258176576,151313,6258327889,0,0,1,33280,0,2759975441
2072,6258181949,222730,6258404679,4,0,1,10752,4,3585701937
2073,6258340221,1038,6258341259,7,0,1,18944,7,5645355042
2074,6258377762,128745,6258506507,2,0,0,1024,2,1946873577
2075,6258396201,117093,6258513294,3,0,1,7680,3,6643196128
2076,6258503056,42420,6258545476,9,0,0,69120,9,7033268199
2077,6258568851,14283,6258583134,8,0,0,27648,8,3096395432
2078,6258619084,104633,6258723717,7,0,0,173568,7,470839443
2079,6258630460,149291,6258779751,6,0,0,179712,6,10104951523
2080,6258713007,97798,6258810805,4,0,0,99328,4,2111453506
2081,6258764641,46830,6258811471,3,0,0,1024,3,4509040246
2082,6258884683,182199,6259066882,4,0,1,20480,4,8777380808
2083,6259141540,4675,6259146215,2,0,1,19456,2,8002698370
2084,6259178378,88072,6259266450,1,0,0,12288,1,4270362585
2085,6259198033,236346,6259434379,4,0,0,383488,4,3322430221
2086,6259242797,113490,6259356287,1,0,1,2048,1,10189154259
2087,6259324115,225836,6259549951,2,0,0,5120,2,9987316594
2088,6259325698,320090,6259645788,8,0,1,16384,8,662760314
2089,6259338337,174304,6259512641,8,0,1,14848,8,4966165228
2090,6259377320,159735,6259537055,2,0,1,30208,2,5282041319
2091,6259418386,72658,6259491044,9,0,0,282624,9,2878082900
2092,6259444706,307418,6259752124,7,0,0,48128,7,8677626809
2093,6259447299,164756,6259612055,8,0,1,2048,8,1023107199
2094,6259495922,295233,6259791155,4,0,1,1024,4,8594026022
2095,6259509445,217041,6259726486,4,0,1,9728,4,2180004977
2096,6259537992,191039,6259729031,4,0,0,29696,4,1513148703
2097,6259555005,181460,6259736465,6,0,0,355840,6,159597019
2098,6259557852,129054,6259686906,2,0,1,7168,2,8640632370
2099,6259582633,107646,6259690279,2,0,0,2560,2,163222444
2100,6259592980,282423,6259875403,4,0,0,11776,4,4591547397
2101,6259644378,362900,6260007278,2,0,1,19968,2,4886044887
2102,6259649252,262420,6259911672,7,0,0,6144,7,10720504559
2103,6259671006,243777,6259914783,3,0,0,512,3,8940598459
2104,6259715830,178092,6259893922,8,0,0,293376,8,3408685039
2105,6259732231,245027,6259977258,2,0,1,20480,2,9912541354
2106,6259737436,267512,6260004948,6,0,0,284672,6,5683452068
2107,6259775172,114225,6259889397,6,0,1,15360,6,2865892699
2108,6259855916,358997,6260214913,3,0,1,36864,3,2038117994
2109,6259939285,254128,6260193413,3,0,1,16384,3,6606727504
2110,6260075848,55300,6260131148,4,0,0,94208,4,10413979143
2111,6260121262,228446,6260349708,4,0,1,48128,4,2051599403
2112,6260122176,268608,6260390784,6,0,1,14336,6,8382940260
2113,6260130693,306695,6260437388,8,0,0,638976,8,4293064047
2114,6260148287,394987,6260543274,4,0,1,12800,4,3865018856
2115,6260152122,426056,6260578178,1,0,0,284160,1,3278432415
2116,6260178664,461997,6260640661,1,0,1,30208,1,1360790118
2117,6260203711,416617,6260620328,4,0,0,29696,4,6681224931
2118,6260431839,188835,6260620674,2,0,0,512,2,10423007924
2119,6260458123,199660,6260657783,8,0,0,120320,8,10268543227
2120,6260567761,199679,6260767440,3,0,1,4608,3,4312555230
2121,6260625019,175079,6260800098,8,0,0,284160,8,3594269678
2122,6260787388,72537,6260859925,1,0,0,117760,1,793577862
2123,6260937711,6484,6260944195,4,0,1,10240,4,9320761382
2124,6260982093,232911,6261215004,8,0,1,4096,8,8361642215
2125,6261044982,268787,6261313769,0,0,0,15872,0,4573424392
2126,6261176747,147083,6261323830,3,0,1,33280,3,4667067095
2127,6261178400,47284,6261225684,7,0,1,56320,7,638451435
2128,6261207030,203123,6261410153,7,0,1,9216,7,8394141660
2129,6261305007,195086,6261500093,2,0,1,1536,2,9456955016
2130,6261391523,34791,6261426314,1,0,0,60928,1,8839103049
2131,6261416263,63358,6261479621,1,0,1,24576,1,9604130520
2132,6261455798,156177,6261611975,2,0,1,29696,2,8877785701
2133,6261485248,160152,6261645400,1,0,0,106496,1,2506564828
2134,6261494957,253299,6261748256,0,0,1,13824,0,3224742530
2135,6261608217,84988,6261693205,3,0,1,18432,3,2262405343
2136,6261662453,155976,6261818429,5,0,1,19456,5,8397851484
2137,6261671679,84533,6261756212,8,0,0,138752,8,4695386094
2138,6261679671,83188,6261762859,9,0,0,27648,9,4350307767
2139,6261681027,80769,6261761796,3,0,0,512,3,9162672995
2140,6261702589,178001,6261880590,0,0,1,8192,0,4441802879
2141,6261707777,2466,6261710243,8,0,1,19968,8,9446643376
2142,6261877649,3383,6261881032,6,0,0,2560,6,6408340081
2143,6261895167,245463,6262140630,4,0,0,9728,4,1976198094
2144,6261943991,135139,6262079130,7,0,1,81920,7,8738940584
2145,6262067249,74385,6262141634,2,0,1,6144,2,5117309895
2146,6262109340,81038,6262190378,0,0,1,2560,0,7777086664
2147,6262160079,45592,6262205671,5,0,1,1024,5,7634221711
2148,6262171631,103528,6262275159,6,0,1,39936,6,6405754776
2149,6262227778,175766,6262403544,4,0,0,288768,4,5218252537
2150,6262281828,162832,6262444660,8,0,0,139264,8,1667778862
2151,6262334254,73502,6262407756,9,0,1,7168,9,4181843439
2152,6262373424,43209,6262416633,3,0,0,3584,3,7971099185
2153,6262409823,1038,6262410861,2,0,0,29184,2,6484432733
2154,6262523483,43108,6262566591,3,0,0,1024,3,2294174557
2155,6262535178,269820,6262804998,8,0,0,73728,8,1488395432
2156,6262650026,92023,6262742049,9,0,1,10752,9,8108478975
2157,6262673201,43196,6262716397,7,0,1,13824,7,9800398311
2158,6262702892,99310,6262802202,5,0,0,70656,5,6908448127
2159,6262742612,70060,6262812672,4,0,1,10752,4,10069393302
2160,6262776140,77182,6262853322,1,0,1,22016,1,4139632821
2161,6262782199,92543,6262874742,1,0,1,18432,1,6070715958
2162,6262791933,78676,6262870609,2,0,1,7168,2,2369014170
2163,6262899441,222792,6263122233,3,0,1,5120,3,10316763041
2164,6262899668,144656,6263044324,0,0,1,13824,0,3551733546
2165,6262998345,105199,6263103544,1,0,1,43520,1,1458567704
2166,6263202228,25442,6263227670,7,0,0,46080,7,7434037937
2167,6263253916,45592,6263299508,3,0,1,1024,3,2921547632
2168,6263270315,74087,6263344402,7,0,0,120832,7,6419359005
2169,6263296146,48922,6263345068,3,0,0,1024,3,7077416074
2170,6263387362,11787,6263399149,8,0,0,19456,8,2134230933
2171,6263424580,96244,6263520824,5,0,1,26112,5,9162036103
2172,6263478060,104891,6263582951,6,0,0,174080,6,5873246567
2173,6263499393,116565,6263615958,5,0,1,38912,5,10048876230
2174,6263507604,184444,6263692048,6,0,0,131584,6,4575485837
2175,6263693461,178350,6263871811,8,0,0,293888,8,2242611465
2176,6263729900,171058,6263900958,0,0,1,15872,0,5274719341
2177,6263747206,130956,6263878162,1,0,0,156672,1,1324504767
2178,6263750166,75085,6263825251,6,0,1,16896,6,7389763023
2179,6263793619,220687,6264014306,2,0,0,30208,2,3715794451
2180,6263805425,208413,6264013838,2,0,1,512,2,6542125483
2181,6263840639,114241,6263954880,0,0,1,2560,0,2945181155
2182,6263854316,196577,6264050893,7,0,0,7680,7,1711844127
2183,6263865306,275520,6264140826,7,0,1,4608,7,3770667959
2184,6263885185,97614,6263982799,8,0,1,39936,8,9717955460
2185,6263923830,104979,6264028809,4,0,0,188928,4,8343447963
2186,6263996138,115639,6264111777,5,0,1,5120,5,1247864368
2187,6264007690,299215,6264306905,0,0,0,171008,0,6370064977
2188,6264017818,315551,6264333369,4,0,0,74752,4,3508120743
2189,6264037857,257758,6264295615,6,0,1,11264,6,711483778
2190,6264095015,155516,6264250531,5,0,1,110080,5,4367947465
2191,6264205535,300170,6264505705,1,0,0,256000,1,3716494517
2192,6264269965,125239,6264395204,3,0,0,8192,3,4311945005
2193,6264305539,127159,6264432698,0,0,1,7680,0,6550134669
2194,6264365627,32037,6264397664,8,0,0,163328,8,2308021131
2195,6264477554,272650,6264750204,5,0,1,20480,5,10181783116
2196,6264487239,160173,6264647412,4,0,1,5632,4,6093054564
2197,6264505945,65796,6264571741,3,0,1,24064,3,2907800673
2198,6264520548,150905,6264671453,5,0,0,52224,5,2175126407
2199,6264571942,272942,6264844884,4,0,0,100864,4,485224168
2200,6264577554,326242,6264903796,7,0,1,28672,7,7885294687
2201,6264754975,134267,6264889242,3,0,1,13312,3,1470240544
2202,6264866434,56646,6264923080,6,0,1,3072,6,714506000
2203,6265085042,104374,6265189416,1,0,0,173056,1,2121730383
2204,6265089296,121625,6265210921,7,0,0,78336,7,3762069404
2205,6265092397,133975,6265226372,0,0,0,57344,0,439431619
2206,6265106238,120480,6265226718,7,0,0,512,7,6129042880
2207,6265144353,223009,6265367362,4,0,1,30720,4,546675639
2208,6265149692,172696,6265322388,1,0,0,312832,1,5707858999
2209,6265204831,84960,6265289791,5,0,0,7680,5,4849720265
2210,6265297956,259922,6265557878,7,0,0,17408,7,10180327932
2211,6265310082,94212,6265404294,2,0,0,74752,2,4472912958
2212,6265326472,88574,6265415046,0,0,0,37888,0,6419029877
2213,6265340858,32701,6265373559,6,0,1,1536,6,7693841183
2214,6265382806,190303,6265573109,8,0,0,10240,8,7252186092
2215,6265400550,86708,6265487258,7,0,1,40448,7,3381295850
2216,6265502267,68653,6265570920,1,0,0,145408,1,2413535288
2217,6265531766,22135,6265553901,9,0,0,38400,9,703156019
2218,6265584493,302659,6265887152,4,0,0,29696,4,4210198006
2219,6265714340,23462,6265737802,4,0,1,512,4,9179136526
2220,6265717530,77589,6265795119,5,0,0,38912,5,6094772561
2221,6265788551,44141,6265832692,7,0,0,75776,7,7453956330
2222,6265805863,90991,6265896854,8,0,0,142336,8,1026666423
2223,6265813476,89894,6265903370,5,0,0,31232,5,4083358958
2224,6265959474,74604,6266034078,9,0,0,121856,9,4684561623
2225,6265971501,64523,6266036024,2,0,0,3072,2,7996642677
2226,6265995632,11020,6266006652,6,0,1,14848,6,9618985907
2227,6266029830,86405,6266116235,3,0,0,7680,3,486894562
2228,6266046572,55558,6266102130,4,0,0,94720,4,810886245
2229,6266097279,152365,6266249644,4,0,1,35840,4,7301401661
2230,6266114434,269084,6266383518,7,0,0,645632,7,5623060750
2231,6266124000,398346,6266522346,5,0,1,3072,5,727047079
2232,6266144802,409196,6266553998,8,0,0,139776,8,7451960320
2233,6266171608,403690,6266575298,8,0,0,77312,8,1628034663
2234,6266212986,413898,6266626884,5,0,0,164864,5,8446590804
2235,6266215201,305943,6266521144,6,0,1,68608,6,3702456669
2236,6266327047,182628,6266509675,1,0,0,20992,1,6293004813
2237,6266330442,507809,6266838251,9,0,1,16384,9,4994848461
2238,6266408345,317796,6266726141,9,0,1,10240,9,2576481431
2239,6266428121,423078,6266851199,1,0,1,14848,1,9789090015
2240,6266454228,339097,6266793325,7,0,0,6144,7,5045425110
2241,6266507128,297783,6266804911,2,0,0,486400,2,8489381672
2242,6266556404,294426,6266850830,5,0,1,100864,5,3125069138
2243,6266573669,289799,6266863468,2,0,0,212480,2,8141080326
2244,6266576669,361402,6266938071,2,0,1,16384,2,2196869600
2245,6266595078,324845,6266919923,5,0,0,64000,5,167093367
2246,6266649484,526021,6267175505,9,0,1,8704,9,3430458139
2247,6266717152,262606,6266979758,9,0,1,27136,9,1062548432
2248,6266740946,145391,6266886337,0,0,1,83456,0,7640083823
2249,6266819830,96598,6266916428,1,0,0,407552,1,10226243710
2250,6266942991,477399,6267420390,0,0,1,11264,0,9596628798
2251,6266996029,509472,6267505501,7,0,0,239616,7,6390492236
2252,6267049701,337708,6267387409,7,0,1,19456,7,3754061755
2253,6267070641,297143,6267367784,8,0,0,90624,8,49650896
2254,6267314167,177570,6267491737,8,0,1,2048,8,5343741920
2255,6267326472,568404,6267894876,0,0,0,920064,0,2901617082
2256,6267430324,465218,6267895542,3,0,0,1024,3,7499072549
2257,6267541628,380245,6267921873,8,0,0,84992,8,5641808779
2258,6267547820,377279,6267925099,4,0,0,5120,4,6066733161
2259,6267639123,282494,6267921617,1,0,1,1024,1,8032187818
2260,6267643911,299064,6267942975,3,0,0,2048,3,9425149926
2261,6267690162,282594,6267972756,0,0,0,147968,0,165744090
2262,6267717828,188320,6267906148,5,0,1,38400,5,1625359682
2263,6267827494,439609,6268267103,8,0,1,25088,8,6433456388
2264,6267894849,104863,6267999712,2,0,0,567808,2,665273826
2265,6267920368,348150,6268268518,4,0,1,3072,4,8490303472
2266,6267952330,306632,6268258962,8,0,0,59904,8,4895230935
2267,6268003430,204535,6268207965,4,0,1,6144,4,3860660944
2268,6268061918,186666,6268248584,4,0,1,11264,4,4528713862
2269,6268101155,125964,6268227119,3,0,1,32768,3,771975080
2270,6268122825,95283,6268218108,9,0,1,9728,9,10357453664
2271,6268175517,413870,6268589387,0,0,0,306688,0,5973628805
2272,6268240725,4846,6268245571,0,0,0,7168,0,5690876054
2273,6268333015,615135,6268948150,2,0,1,24576,2,1965960639
2274,6268335123,124420,6268459543,5,0,0,158720,5,7530520844
2275,6268347547,558675,6268906222,3,0,1,20992,3,1986885897
2276,6268434922,2942,6268437864,2,0,1,5632,2,8422386955
2277,6268472040,314597,6268786637,5,0,1,13312,5,4612405947
2278,6268517934,370499,6268888433,8,0,0,5120,8,562446582
2279,6268589812,157850,6268747662,7,0,1,38912,7,2950264189
2280,6268612572,323460,6268936032,8,0,0,3072,8,733577911
2281,6268691846,147200,6268839046,1,0,0,243200,1,4807079309
2282,6268787757,50413,6268838170,0,0,1,23040,0,7393330150
2283,6268799292,93449,6268892741,6,0,1,91136,6,6957410974
2284,6268809831,172680,6268982511,5,0,0,68608,5,2593488541
2285,6268837878,134663,6268972541,7,0,1,2560,7,4008688325
2286,6268856328,210265,6269066593,9,0,1,40448,9,3016691237
2287,6268915400,82662,6268998062,9,0,0,134144,9,9937587867
2288,6268917462,346744,6269264206,8,0,1,56320,8,7637655223
2289,6268954869,359567,6269314436,2,0,1,55296,2,5542905135
2290,6269017479,337964,6269355443,0,0,0,586752,0,2687455470
2291,6269046426,369567,6269415993,7,0,1,18944,7,7825786061
2292,6269055264,251003,6269306267,5,0,0,163328,5,7371128327
2293,6269174174,493533,6269667707,3,0,0,512,3,1871398691
2294,6269274947,191653,6269466600,7,0,0,132608,7,7341192808
2295,6269283233,204975,6269488208,7,0,0,70656,7,1958368264
2296,6269320328,76423,6269396751,1,0,1,34304,1,4663361883
2297,6269371947,5192,6269377139,1,0,1,7168,1,7396594231
2298,6269417994,219149,6269637143,2,0,0,21504,2,8441670110
2299,6269502163,22657,6269524820,2,0,0,13312,2,10165102851
2300,6269516831,197651,6269714482,6,0,0,33792,6,7218944280
2301,6269592235,183654,6269775889,1,0,0,297472,1,386628747
2302,6269615284,55334,6269670618,5,0,1,8704,5,3013305663
2303,6269677030,29010,6269706040,6,0,1,33280,6,3316049115
2304,6269701393,273453,6269974846,2,0,1,7680,2,7500473001
2305,6269736006,404035,6270140041,2,0,0,49152,2,7568932477
2306,6269766196,115104,6269881300,2,0,0,6144,2,1774115946
2307,6269927014,138918,6270065932,0,0,0,187392,0,3878231583
2308,6269982324,138068,6270120392,9,0,0,226816,9,7616472992
2309,6270035477,135430,6270170907,2,0,0,176640,2,5647020773
2310,6270043697,535307,6270579004,2,0,1,1024,2,10603940962
2311,6270130897,202848,6270333745,2,0,1,12800,2,8311911973
2312,6270278277,164524,6270442801,7,0,1,5120,7,10663316988
2313,6270374970,192598,6270567568,1,0,1,512,1,8100534089
2314,6270428885,124454,6270553339,5,0,1,33792,5,6376218344
2315,6270478436,105812,6270584248,2,0,0,202240,2,5240043658
2316,6270538603,150753,6270689356,2,0,0,133120,2,4127960716
2317,6270605725,235741,6270841466,9,0,0,385536,9,613557797
2318,6270617797,225935,6270843732,3,0,0,3584,3,10327687240
2319,6270645923,486292,6271132215,2,0,1,512,2,8599686257
2320,6270663584,276896,6270940480,6,0,1,10240,6,3870794097
2321,6270760239,142249,6270902488,2,0,0,548864,2,3945704937
2322,6270760731,336733,6271097464,0,0,1,32768,0,3865162661
2323,6270781206,342916,6271124122,0,0,0,97280,0,5866209115
2324,6270840425,380040,6271220465,8,0,1,34816,8,91232037
2325,6270886740,177746,6271064486,2,0,0,233984,2,4215716655
2326,6270924644,310217,6271234861,2,0,1,8192,2,6022197718
2327,6270971096,412849,6271383945,8,0,1,30208,8,3643220321
2328,6270988549,305369,6271293918,5,0,1,512,5,6366519106
2329,6271000666,337443,6271338109,4,0,1,1536,4,8556056347
2330,6271003392,266496,6271269888,9,0,0,467456,9,1044948490
2331,6271079029,130041,6271209070,9,0,1,17920,9,4856395248
2332,6271105598,406174,6271511772,6,0,0,100352,6,1137687163
2333,6271202060,239407,6271441467,0,0,1,14336,0,1090524120
2334,6271214067,11787,6271225854,8,0,1,13312,8,6011002974
2335,6271237427,423405,6271660832,1,0,1,34816,1,9692776312
2336,6271253395,330707,6271584102,4,0,0,37888,4,6814322748
2337,6271276887,562,6271277449,0,0,1,26112,0,9496244093
2338,6271449273,339275,6271788548,7,0,1,2048,7,1659845223
2339,6271461289,14283,6271475572,4,0,0,19456,4,2652127233
2340,6271476756,456435,6271933191,5,0,1,20480,5,1201370267
2341,6271549180,262817,6271811997,3,0,0,512,3,2051744303
2342,6271583469,99028,6271682497,0,0,0,27648,0,10370237010
2343,6271764828,419021,6272183849,6,0,1,30208,6,1405592097
2344,6271783982,31779,6271815761,1,0,1,66048,1,2620682274
2345,6271890680,82996,6271973676,6,0,1,17920,6,9663489232
2346,6271913335,213274,6272126609,4,0,0,51712,4,2962290321
2347,6271922357,105547,6272027904,8,0,1,3072,8,2238015262
2348,6272013817,82920,6272096737,9,0,0,134656,9,6960653075
2349,6272057471,40572,6272098043,9,0,0,2048,9,4948781620
2350,6272090457,44400,6272134857,9,0,1,48640,9,6889412558
2351,6272098313,140668,6272238981,8,0,1,33792,8,9082838508
2352,6272099865,88791,6272188656,9,0,0,76288,9,7191098551
2353,6272184436,129320,6272313756,8,0,1,5632,8,7912033134
2354,6272193263,273559,6272466822,2,0,1,16384,2,3325788765
2355,6272268100,176541,6272444641,4,0,0,290304,4,2055426908
2356,6272326506,139026,6272465532,7,0,0,67072,7,9785600706
2357,6272441677,34480,6272476157,7,0,0,42496,7,7556748995
2358,6272445838,104392,6272550230,5,0,1,8704,5,4142912263
2359,6272461842,161452,6272623294,1,0,1,33280,1,883470134
2360,6272497949,264869,6272762818,5,0,0,479232,5,6707434449
2361,6272504641,295804,6272800445,3,0,1,5120,3,4020167303
2362,6272557897,251307,6272809204,0,0,0,57344,0,10045362908
2363,6272635567,178463,6272814030,3,0,0,7680,3,9007793111
2364,6272644223,278031,6272922254,2,0,1,54272,2,10219520145
2365,6272936361,4370,6272940731,8,0,1,22528,8,1142985501
2366,6272995802,125734,6273121536,8,0,0,4608,8,6369741857
2367,6273158897,499766,6273658663,6,0,0,813056,6,10012162899
2368,6273192901,265662,6273458563,5,0,0,119808,5,7947516007
2369,6273419677,502769,6273922446,5,0,1,24576,5,6897772467
2370,6273449998,154966,6273604964,2,0,1,19456,2,715275219
2371,6273476484,113201,6273589685,9,0,1,13824,9,8020261257
2372,6273541690,303552,6273845242,3,0,0,1536,3,328379168
2373,6273609376,304657,6273914033,4,0,0,82944,4,4761028396
2374,6273625671,315401,6273941072,7,0,0,499712,7,7944483003
2375,6273626223,243755,6273869978,7,0,1,13312,7,10550478601
2376,6273688810,363186,6274051996,4,0,1,12288,4,4766716328
2377,6273698905,365049,6274063954,3,0,0,15872,3,3347883448
2378,6273726529,372823,6274099352,4,0,0,501760,4,666081267
2379,6273846799,149668,6273996467,9,0,0,587776,9,7742123022
2380,6273883255,458207,6274341462,1,0,0,30208,1,7561046105
2381,6274056633,428062,6274484695,5,0,1,38400,5,7094463671
2382,6274111644,22946,6274134590,6,0,1,6656,6,9812172096
2383,6274156823,45692,6274202515,7,0,1,20992,7,7422000004
2384,6274320955,3418,6274324373,7,0,0,37888,7,5715251994
2385,6274346082,323201,6274669283,6,0,0,78848,6,8042010019
2386,6274423015,439447,6274862462,3,0,0,3584,3,8443034905
2387,6274504192,61895,6274566087,5,0,1,111104,5,3038126230
2388,6274524179,122167,6274646346,6,0,1,13824,6,5604744459
2389,6274559681,165447,6274725128,4,0,1,7168,4,4953507367
2390,6274586827,46253,6274633080,5,0,0,100352,5,2044395732
2391,6274643384,316176,6274959560,1,0,0,73216,1,6085552449
2392,6274726425,218333,6274944758,9,0,0,358400,9,4663068375
2393,6274977673,207383,6275185056,3,0,1,43008,3,8312535688
2394,6275189231,11270,6275200501,0,0,0,18432,0,7499321890
2395,6275220287,286454,6275506741,6,0,0,464384,6,2029266493
2396,6275262871,202137,6275465008,1,0,1,11264,1,1633779138
2397,6275316048,108048,6275424096,9,0,0,46592,9,4662378069
2398,6275415936,271539,6275687475,1,0,0,19456,1,759431946
2399,6275453119,417821,6275870940,4,0,0,676864,4,6028509761
2400,6275574494,299992,6275874486,8,0,0,5632,8,6261858183
2401,6275578118,394971,6275973089,1,0,0,324608,1,4523738382
2402,6275611229,542591,6276153820,2,0,0,586752,2,9538690230
2403,6275663998,478908,6276142906,3,0,1,25600,3,2071007107
2404,6275677498,211923,6275889421,7,0,0,4096,7,7096107883
2405,6275742042,171893,6275913935,4,0,1,8192,4,8212060927
2406,6275857068,105473,6275962541,1,0,1,42496,1,9508139105
2407,6275957510,487910,6276445420,3,0,1,1024,3,5405300064
2408,6275991004,590833,6276581837,1,0,1,7680,1,8452157544
2409,6276000680,268944,6276269624,5,0,0,52736,5,2960846470
2410,6276004983,180881,6276185864,8,0,1,3584,8,2068583070
2411,6276023235,335102,6276358337,1,0,1,11264,1,4329135159
2412,6276098871,502156,6276601027,6,0,0,111104,6,4352774598
2413,6276141107,355344,6276496451,1,0,1,2048,1,10250348610
2414,6276144093,326954,6276471047,5,0,0,529920,5,9651676642
2415,6276152541,334366,6276486907,9,0,0,59392,9,8400258676
2416,6276182783,294614,6276477397,0,0,1,1536,0,2933648350
2417,6276234330,333215,6276567545,4,0,0,143872,4,1407855140
2418,6276243002,402316,6276645318,7,0,0,160768,7,102396673
2419,6276350917,334444,6276685361,2,0,1,14848,2,8814113500
2420,6276478018,338970,6276816988,6,0,1,67072,6,2904495225
2421,6276532711,292082,6276824793,4,0,1,20480,4,1361607121
2422,6276613690,211114,6276824804,4,0,0,338432,4,4796242638
2423,6276626890,197925,6276824815,3,0,0,512,3,6862036467
2424,6276694461,136497,6276830958,7,0,0,33792,7,4567740609
2425,6276728563,191692,6276920255,1,0,1,63488,1,1380186716
2426,6276741250,321965,6277063215,7,0,1,4608,7,6437088530
2427,6276814799,156033,6276970832,5,0,1,36864,5,498909759
2428,6276930971,192368,6277123339,2,0,0,257024,2,778331362
2429,6276931847,371833,6277303680,6,0,0,129024,6,5711343388
2430,6276954498,215934,6277170432,6,0,1,61440,6,8786735711
2431,6276987113,233848,6277220961,6,0,0,250368,6,3626309473
2432,6276989783,207881,6277197664,7,0,0,65536,7,9934462206
2433,6277042388,177153,6277219541,1,0,0,94720,1,8150351860
2434,6277059708,222230,6277281938,6,0,0,110592,6,5284839547
2435,6277090802,169598,6277260400,1,0,1,28160,1,6838268623
2436,6277115886,194012,6277309898,3,0,0,5632,3,10069704428
2437,6277132588,459449,6277592037,6,0,0,139264,6,655739294
2438,6277213451,224652,6277438103,2,0,0,305664,2,4710528823
2439,6277259277,355214,6277614491,0,0,1,9728,0,9382075447
2440,6277391026,388908,6277779934,5,0,0,633856,5,8137632366
2441,6277481014,412410,6277893424,9,0,0,363008,9,8867774787
2442,6277747345,13079,6277760424,0,0,1,17408,0,2038343545
2443,6277773489,13203,6277786692,6,0,1,52736,6,4580004043
2444,6277778608,324965,6278103573,1,0,1,53760,1,10312505980
2445,6277790553,314900,6278105453,1,0,1,23040,1,8015606126
2446,6277791601,326172,6278117773,8,0,1,56320,8,6885037905
2447,6277816632,168484,6277985116,6,0,1,34816,6,8362056162
2448,6277881106,344531,6278225637,9,0,1,5120,9,3178866375
2449,6277898225,161407,6278059632,1,0,0,22016,1,6666659740
2450,6277902927,256608,6278159535,8,0,0,7680,8,7716305454
2451,6277948820,159979,6278108799,7,0,0,278016,7,6466029888
2452,6277974736,163051,6278137787,8,0,0,4096,8,1603645007
2453,6277975989,165055,6278141044,8,0,1,5632,8,6939279766
2454,6277977746,383055,6278360801,4,0,0,37888,4,1522291845
2455,6277985065,400787,6278385852,2,0,0,56320,2,4537493461
2456,6277993891,281788,6278275679,9,0,0,43520,9,267528078
2457,6278171916,22429,6278194345,6,0,1,6144,6,6347853720
2458,6278235446,217641,6278453087,9,0,0,36864,9,7872884276
2459,6278235803,156466,6278392269,2,0,0,411648,2,6453772558
2460,6278239667,265211,6278504878,3,0,1,17920,3,10097130553
2461,6278257158,265259,6278522417,1,0,0,77824,1,5084284103
2462,6278428796,140177,6278568973,7,0,0,157184,7,4655932784
2463,6278434887,182014,6278616901,2,0,1,111104,2,1473608785
2464,6278523009,83696,6278606705,0,0,1,10240,0,7660489416
2465,6278598612,406257,6279004869,7,0,1,16384,7,2329589476
2466,6278635824,247543,6278883367,9,0,0,136192,9,2060656696
2467,6278708184,206141,6278914325,4,0,0,337920,4,10430982824
2468,6278746346,270589,6279016935,1,0,1,11776,1,3241370198
2469,6278880857,177575,6279058432,1,0,0,292352,1,9414281332
2470,6278884310,155512,6279039822,3,0,1,17920,3,6031506579
2471,6278908105,219119,6279127224,1,0,0,16384,1,4614191338
2472,6279042653,248375,6279291028,0,0,1,22528,0,5144355144
2473,6279136604,449400,6279586004,9,0,0,731648,9,9112154938
2474,6279158150,683651,6279841801,6,0,0,785408,6,3578008834
2475,6279277471,591480,6279868951,2,0,0,89088,2,5729871072
2476,6279300908,584415,6279885323,5,0,0,53760,5,9103929532
2477,6279329522,582746,6279912268,4,0,0,96256,4,8225309229
2478,6279346783,336655,6279683438,1,0,0,373248,1,9435907613
2479,6279483394,679384,6280162778,1,0,0,27648,1,9535896362
2480,6279555212,548572,6280103784,6,0,0,11776,6,8946032132
2481,6279570511,477522,6280048033,0,0,0,490496,0,553842545
2482,6279576586,333153,6279909739,6,0,0,4608,6,5395732323
2483,6279662188,612565,6280274753,3,0,1,6144,3,5243694150
2484,6279706099,609396,6280315495,6,0,1,28160,6,2277198240
2485,6279751710,437498,6280189208,8,0,0,5120,8,1943778001
2486,6279771918,432650,6280204568,8,0,1,2560,8,8151064711
2487,6279803554,137636,6279941190,6,0,1,1024,6,1992731759
2488,6279959160,95963,6280055123,6,0,1,16384,6,7629140337
2489,6280003280,78976,6280082256,8,0,1,10240,8,3671381263
2490,6280081606,596820,6280678426,3,0,1,12288,3,5216777576
2491,6280118865,377991,6280496856,9,0,0,223744,9,2490843293
2492,6280166849,421407,6280588256,1,0,0,22016,1,654057748
2493,6280186742,163662,6280350404,9,0,0,4608,9,2168354250
2494,6280291666,440361,6280732027,2,0,0,265216,2,10401512424
2495,6280394782,187958,6280582740,1,0,1,35328,1,3160693139
2496,6280437283,179707,6280616990,1,0,0,309248,1,3851714908
2497,6280459625,171348,6280630973,1,0,1,2560,1,9650502431
2498,6280500449,164848,6280665297,2,0,0,157184,2,1402094105
2499,6280512953,297803,6280810756,5,0,0,28672,5,9055510897
2500,6280555909,52804,6280608713,9,0,1,26112,9,6800762040
2501,6280570502,230435,6280800937,7,0,1,23040,7,9578564415
2502,6280659407,311390,6280970797,9,0,1,34816,9,3073928654
2503,6280698155,77165,6280775320,2,0,0,86016,2,4495528321
2504,6280769876,333777,6281103653,2,0,1,56832,2,4510771993
2505,6280790145,383539,6281173684,5,0,0,126976,5,856392005
2506,6280814526,476186,6281290712,7,0,0,602112,7,3740613529
2507,6280830158,415915,6281246073,2,0,0,129536,2,10027926547
2508,6280872714,364264,6281236978,1,0,1,20480,1,8778720511
2509,6280933684,438909,6281372593,0,0,0,201216,0,9880237546
2510,6280966663,303908,6281270571,2,0,1,32768,2,7469969327
2511,6281004672,368772,6281373444,2,0,1,14848,2,2457019015
2512,6281021088,460774,6281481862,2,0,0,88576,2,528618726
2513,6281030939,181912,6281212851,2,0,0,656896,2,5294607165
2514,6281120883,515313,6281636196,4,0,1,19456,4,1374289267
2515,6281130703,384759,6281515462,3,0,1,14336,3,6641728633
2516,6281147418,334697,6281482115,3,0,1,41984,3,4530941986
2517,6281163119,382120,6281545239,8,0,0,2560,8,8797157975
2518,6281229860,71503,6281301363,7,0,0,63488,7,10696620580
2519,6281251503,35385,6281286888,8,0,1,3072,8,7883223371
2520,6281302450,204040,6281506490,1,0,1,2048,1,2777955630
2521,6281368754,3172,6281371926,6,0,1,30720,6,4982633797
2522,6281452711,584868,6282037579,0,0,1,11264,0,9129327786
2523,6281518381,571136,6282089517,9,0,1,5632,9,8530126151
2524,6281558331,381155,6281939486,6,0,1,3072,6,2219373745
2525,6281564335,73981,6281638316,7,0,0,115712,7,5760719833
2526,6281603039,649455,6282252494,3,0,0,4096,3,6435054736
2527,6281655561,294016,6281949577,8,0,0,2048,8,7425324410
2528,6281675939,97472,6281773411,6,0,0,113664,6,1773411028
2529,6281691074,33587,6281724661,8,0,1,67584,8,8094667562
2530,6281711218,330773,6282041991,8,0,1,38912,8,1553819018
2531,6281716924,101831,6281818755,4,0,0,159744,4,7073596730
2532,6281723161,288103,6282011264,4,0,1,27648,4,687137741
2533,6281732513,144962,6281877475,3,0,1,24064,3,9822451670
2534,6281799853,21043,6281820896,2,0,1,10240,2,2368630448
2535,6281819305,341202,6282160507,7,0,0,55296,7,10344849925
2536,6281836062,34363,6281870425,5,0,1,512,5,8348783134
2537,6281885776,449733,6282335509,0,0,0,235520,0,8620425977
2538,6281981086,390539,6282371625,2,0,1,23040,2,6321423093
2539,6282011641,526829,6282538470,7,0,0,3072,7,10068120223
2540,6282035986,173270,6282209256,1,0,0,56832,1,1265022772
2541,6282085092,423909,6282509001,5,0,0,280576,5,2265468521
2542,6282123141,374584,6282497725,6,0,1,104448,6,7222536229
2543,6282238650,63874,6282302524,3,0,1,2048,3,5780654962
2544,6282244079,180419,6282424498,9,0,1,31744,9,7221546854
2545,6282354342,300258,6282654600,3,0,1,8704,3,3743627979
2546,6282463946,67841,6282531787,2,0,0,107520,2,4923893505
2547,6282466886,379860,6282846746,9,0,1,22528,9,7758547027
2548,6282482099,137784,6282619883,1,0,0,73216,1,9030982656
2549,6282495320,123726,6282619046,0,0,0,183296,0,6382805323
2550,6282510684,162002,6282672686,3,0,0,2048,3,10241509963
2551,6282514343,172830,6282687173,5,0,0,143360,5,7805379201
2552,6282644782,139189,6282783971,5,0,1,33280,5,68445634
2553,6282764602,480086,6283244688,5,0,1,16384,5,10603271917
2554,6282798924,84124,6282883048,3,0,1,22528,3,2657767224
2555,6282921763,242889,6283164652,0,0,0,140288,0,5993997606
2556,6282986256,83569,6283069825,9,0,1,8704,9,9684761878
2557,6283024523,71503,6283096026,0,0,1,3072,0,1737202502
2558,6283041892,139225,6283181117,6,0,0,115712,6,2896997444
2559,6283042434,104705,6283147139,0,0,0,169984,0,9447286617
2560,6283102875,246826,6283349701,5,0,0,82944,5,384162313
2561,6283111908,239708,6283351616,9,0,1,21504,9,4445945228
2562,6283181816,183654,6283365470,4,0,0,297472,4,1237693347
2563,6283223183,143593,6283366776,8,0,0,2048,8,288162982
2564,6283332479,1180,6283333659,1,0,1,33280,1,10324493006
2565,6283366262,23891,6283390153,8,0,0,1024,8,2079440760
2566,6283433604,10237,6283443841,1,0,0,43008,1,2310454313
2567,6283445464,314684,6283760148,7,0,1,33280,7,3498680623
2568,6283509196,163095,6283672291,0,0,1,19968,0,10447316533
2569,6283574062,280035,6283854097,5,0,0,16384,5,630570427
2570,6283663662,80860,6283744522,6,0,1,20992,6,6494592681
2571,6283664022,36188,6283700210,5,0,1,4608,5,2824188130
2572,6283708345,92566,6283800911,0,0,0,60416,0,7084268327
2573,6283747086,226188,6283973274,5,0,1,23552,5,8131159101
2574,6283754867,282706,6284037573,0,0,0,624640,0,3226516668
2575,6283850136,385895,6284236031,9,0,1,5120,9,6501747730
2576,6283892777,284493,6284177270,4,0,0,267776,4,8183966040
2577,6283902184,331291,6284233475,5,0,1,13312,5,3735976934
2578,6283973294,243304,6284216598,5,0,1,3584,5,7127907734
2579,6283987245,195357,6284182602,1,0,1,8192,1,2214947119
2580,6283994452,278813,6284273265,1,0,1,6656,1,8993021025
2581,6283997136,161679,6284158815,5,0,0,53760,5,10142839370
2582,6284045505,145915,6284191420,5,0,1,1024,5,6837063585
2583,6284102194,128688,6284230882,2,0,1,3584,2,8654828446
2584,6284104478,325282,6284429760,0,0,0,90112,0,2465142240
2585,6284122508,117112,6284239620,3,0,0,3584,3,975534476
2586,6284156312,220023,6284376335,1,0,0,54784,1,1270381231
2587,6284195426,344028,6284539454,4,0,0,83968,4,1633104567
2588,6284231728,106763,6284338491,9,0,0,91136,9,9482973793
2589,6284241141,112688,6284353829,1,0,0,55808,1,4921170004
2590,6284242586,216411,6284458997,1,0,1,18432,1,1575763897
2591,6284366667,102946,6284469613,6,0,1,1024,6,6163527379
2592,6284423911,188220,6284612131,7,0,1,18432,7,7386048485
2593,6284566261,94389,6284660650,2,0,1,7168,2,7412308856
2594,6284672015,562,6284672577,3,0,1,18432,3,9389811721
2595,6284695333,77008,6284772341,7,0,1,42496,7,6800958090
2596,6284725802,157753,6284883555,8,0,0,512,8,1558002629
2597,6284817083,119515,6284936598,9,0,1,18432,9,9934813154
2598,6284914425,198083,6285112508,1,0,0,325632,1,2528498501
2599,6284976650,29099,6285005749,0,0,1,512,0,7841902568
2600,6285064977,1038,6285066015,3,0,1,4608,3,9452024393
2601,6285092887,252258,6285345145,4,0,1,1024,4,179445755
2602,6285095160,177467,6285272627,1,0,0,48128,1,1230452070
2603,6285130257,165380,6285295637,3,0,0,1024,3,5291887776
2604,6285263606,92836,6285356442,5,0,1,19968,5,2874806626
2605,6285285988,81748,6285367736,0,0,1,13824,0,750895836
2606,6285290935,83608,6285374543,9,0,0,139264,9,951667351
2607,6285328052,153598,6285481650,2,0,0,245248,2,3085656749
2608,6285406853,81108,6285487961,4,0,0,30208,4,10140323111
2609,6285427303,195997,6285623300,3,0,1,38912,3,3044820906
2610,6285440161,361178,6285801339,6,0,0,887296,6,2668418811
2611,6285525142,548154,6286073296,9,0,1,1536,9,7719183751
2612,6285599375,214973,6285814348,1,0,1,16896,1,5359202628
2613,6285777848,166587,6285944435,8,0,0,7168,8,6864427358
2614,6285831726,417789,6286249515,5,0,0,26112,5,10018579513
2615,6285849638,257544,6286107182,4,0,0,349184,4,1416530700
2616,6285877918,385386,6286263304,4,0,1,44544,4,3026976234
2617,6285886504,170704,6286057208,3,0,1,23040,3,553576416
2618,6286065726,199597,6286265323,7,0,1,36352,7,6605401734
2619,6286092611,421175,6286513786,5,0,0,278016,5,10044632068
2620,6286098197,385416,6286483613,1,0,0,118272,1,870742688
2621,6286188210,274861,6286463071,1,0,1,13824,1,6869158094
2622,6286265064,562,6286265626,8,0,1,17408,8,4585590059
2623,6286329480,166666,6286496146,3,0,1,2048,3,5647197787
2624,6286407258,303707,6286710965,8,0,1,45056,8,6029810125
2625,6286440950,197463,6286638413,0,0,1,34304,0,9951943595
2626,6286465847,228543,6286694390,8,0,0,512,8,7292624380
2627,6286474407,279600,6286754007,0,0,0,457728,0,7500288588
2628,6286549209,210904,6286760113,2,0,0,29184,2,8780696304
2629,6286588612,269675,6286858287,6,0,1,1024,6,6983999069
2630,6286705221,23204,6286728425,2,0,1,512,2,8291022319
2631,6286731653,33758,6286765411,9,0,1,9728,9,2707692474
2632,6286735543,241133,6286976676,7,0,1,12800,7,2637071632
2633,6286784969,289899,6287074868,0,0,1,21504,0,5377681189
2634,6286835817,278240,6287114057,9,0,0,38400,9,10525254592
2635,6286867052,231565,6287098617,6,0,0,58880,6,1401936512
2636,6286901105,348115,6287249220,4,0,0,1526784,4,9773477246
2637,6286904020,245541,6287149561,0,0,1,18432,0,3567326123
2638,6287023367,563348,6287586715,7,0,1,4096,7,5160465300
2639,6287120430,689368,6287809798,0,0,1,27648,0,3375285399
2640,6287159507,524918,6287684425,6,0,0,16384,6,5873302009
2641,6287164564,444046,6287608610,5,0,0,87040,5,1202997192
2642,6287174663,432975,6287607638,0,0,0,198144,0,2339840994
2643,6287197383,943287,6288140670,4,0,1,2048,4,8761205298
2644,6287203037,690070,6287893107,0,0,1,5632,0,2946738659
2645,6287334127,711754,6288045881,3,0,1,18944,3,7240361446
2646,6287336916,405000,6287741916,0,0,0,126976,0,9738822291
2647,6287367375,206480,6287573855,2,0,0,31744,2,2390824658
2648,6287402457,763610,6288166067,1,0,0,36864,1,688900531
2649,6287403489,638159,6288041648,0,0,1,33792,0,7224778424
2650,6287424370,614318,6288038688,7,0,1,25600,7,655460529
2651,6287494700,590373,6288085073,6,0,1,24064,6,8313579032
2652,6287498984,494512,6287993496,9,0,0,11264,9,8029800273
2653,6287625042,357908,6287982950,8,0,1,94720,8,4551864358
2654,6287637854,579261,6288217115,8,0,0,3584,8,7435423347
2655,6287697131,143228,6287840359,3,0,1,12800,3,2045450982
2656,6287815880,433411,6288249291,5,0,1,6656,5,4208171285
2657,6287857780,23732,6287881512,7,0,1,6656,7,3416860747
2658,6287878660,208478,6288087138,6,0,0,92160,6,8018775237
2659,6287903893,226980,6288130873,6,0,1,17920,6,2575690230
2660,6287965463,215600,6288181063,6,0,1,2560,6,1483647164
2661,6288035275,375188,6288410463,8,0,0,512,8,5330937866
2662,6288101528,134062,6288235590,8,0,1,84480,8,9286822092
2663,6288217198,185084,6288402282,4,0,0,217600,4,9708249731
2664,6288229052,353877,6288582929,7,0,0,210944,7,5217862580
2665,6288272023,172701,6288444724,5,0,1,54784,5,4489378922
2666,6288308625,106928,6288415553,4,0,0,215040,4,2934618293
2667,6288411712,99581,6288511293,0,0,0,129536,0,9978223894
2668,6288421005,97700,6288518705,3,0,0,3072,3,2100682982
2669,6288428480,424825,6288853305,7,0,0,18432,7,8538944374
2670,6288613857,62154,6288676011,9,0,1,32256,9,6482197175
2671,6288642058,30365,6288672423,5,0,0,100864,5,267000411
2672,6288679236,42937,6288722173,7,0,0,25600,7,9881399271
2673,6288858470,327597,6289186067,6,0,1,47616,6,8176730649
2674,6288887936,31520,6288919456,6,0,0,70144,6,5032983787
2675,6288958628,6750,6288965378,5,0,0,51200,5,6471439486
2676,6289057919,6274,6289064193,7,0,0,7168,7,8063564329
2677,6289104999,282022,6289387021,8,0,0,6656,8,8221214866
2678,6289219561,124282,6289343843,2,0,1,9216,2,10295617282
2679,6289350170,84820,6289434990,4,0,1,13824,4,8694059322
2680,6289454772,1990,6289456762,8,0,1,31744,8,6718164809
2681,6289470317,101032,6289571349,8,0,1,16384,8,2908225157
2682,6289506030,90490,6289596520,3,0,0,2048,3,8887696126
2683,6289563532,1990,6289565522,7,0,0,2048,7,511580252
2684,6289572830,168484,6289741314,0,0,0,278016,0,7437322465
2685,6289598341,175051,6289773392,5,0,0,104448,5,1533398492
2686,6289684709,165509,6289850218,3,0,1,3072,3,8441790427
2687,6289691921,92019,6289783940,7,0,1,19968,7,4873007690
2688,6289791083,3418,6289794501,7,0,1,5120,7,1263271230
2689,6289807311,160527,6289967838,9,0,1,15872,9,905425811
2690,6289907430,309748,6290217178,9,0,0,3584,9,3651753696
2691,6289969202,1038,6289970240,0,0,1,15872,0,5723224094
2692,6289992225,45592,6290037817,0,0,1,1024,0,8816360191
2693,6290008900,94660,6290103560,3,0,0,1024,3,7185185890
2694,6290174665,73999,6290248664,9,0,0,123904,9,6044749138
2695,6290218334,117984,6290336318,1,0,1,14848,1,3378875790
2696,6290220266,36782,6290257048,9,0,1,18432,9,6516924917
2697,6290251008,95179,6290346187,3,0,1,26624,3,5004375266
2698,6290299547,238042,6290537589,1,0,0,60416,1,1544019954
2699,6290346041,266970,6290613011,9,0,1,4608,9,6024478052
2700,6290413400,72795,6290486195,4,0,1,26112,4,3671915738
2701,6290467065,68197,6290535262,4,0,0,118272,4,826386878
2702,6290473609,88539,6290562148,7,0,0,3072,7,10036565930
2703,6290484219,190580,6290674799,0,0,0,98816,0,335183107
2704,6290503081,183925,6290687006,1,0,0,247296,1,7508048500
2705,6290558133,100675,6290658808,3,0,1,35840,3,8395521415
2706,6290587637,104204,6290691841,7,0,0,2048,7,9487815814
2707,6290588536,243169,6290831705,5,0,1,2048,5,7192294609
2708,6290678330,310341,6290988671,1,0,0,169472,1,5512189480
2709,6290709746,179807,6290889553,0,0,1,2048,0,7448959983
2710,6290711587,130684,6290842271,7,0,1,10240,7,1104391851
2711,6290733537,213066,6290946603,7,0,1,23552,7,359186358
2712,6290787232,227076,6291014308,3,0,1,6144,3,52305891
2713,6290799652,284645,6291084297,6,0,0,460800,6,7515815142
2714,6290877105,284341,6291161446,1,0,0,254464,1,6424465400
2715,6290884747,85571,6290970318,2,0,1,45056,2,5004777929
2716,6291022433,76421,6291098854,3,0,1,11776,3,2847374036
2717,6291054029,361148,6291415177,2,0,1,1536,2,2481612126
2718,6291078461,238549,6291317010,3,0,0,4096,3,6737233901
2719,6291088277,221519,6291309796,4,0,0,1024,4,3862361037
2720,6291093147,1038,6291094185,4,0,1,9216,4,568204287
2721,6291163457,2466,6291165923,1,0,1,26624,1,9303345766
2722,6291222291,1038,6291223329,0,0,1,72704,0,9512035745
2723,6291252320,129296,6291381616,2,0,1,20480,2,491863724
2724,6291296002,258591,6291554593,3,0,0,1024,3,8605259477
2725,6291342936,1038,6291343974,0,0,0,2560,0,10432109453
2726,6291370786,3418,6291374204,7,0,0,1024,7,7384180317
2727,6291451998,284271,6291736269,8,0,0,1024,8,6467797677
2728,6291455891,416234,6291872125,7,0,0,3584,7,6669380373
2729,6291464835,101878,6291566713,1,0,0,164864,1,8960719186
2730,6291481042,98158,6291579200,3,0,1,18944,3,8788447901
2731,6291520742,161074,6291681816,0,0,1,10240,0,6973506285
2732,6291523396,126201,6291649597,9,0,1,15872,9,644946501
2733,6291581894,38528,6291620422,9,0,1,6144,9,10317994088
2734,6291617293,77359,6291694652,2,0,0,59904,2,2837583518
2735,6291676930,124754,6291801684,0,0,0,130560,0,9898120110
2736,6291679897,562,6291680459,8,0,1,13824,8,1066025189
2737,6291691566,246554,6291938120,8,0,1,123904,8,10576868871
2738,6291813685,286506,6292100191,5,0,0,512,5,8656077260
2739,6292046783,1514,6292048297,5,0,0,1536,5,2611716586
2740,6292049676,4846,6292054522,3,0,0,5120,3,6325767510
2741,6292075362,1514,6292076876,9,0,1,35840,9,2363647242
2742,6292120317,102280,6292222597,3,0,1,12800,3,2247231900
2743,6292126416,133657,6292260073,4,0,0,1536,4,4635776147
2744,6292157120,154054,6292311174,9,0,0,249856,9,6716920713
2745,6292200774,122351,6292323125,3,0,1,512,3,5160569536
2746,6292379812,34275,6292414087,7,0,1,19968,7,5063434931
2747,6292403309,124865,6292528174,3,0,1,4096,3,1220995191
2748,6292483693,183918,6292667611,6,0,0,59904,6,6099948262
2749,6292527993,226650,6292754643,2,0,1,17920,2,749851617
2750,6292535448,226394,6292761842,6,0,0,371200,6,5312538530
2751,6292537970,118533,6292656503,3,0,0,3584,3,6627187926
2752,6292648097,273401,6292921498,7,0,0,3584,7,3872912032
2753,6292661368,177688,6292839056,4,0,0,240128,4,3895449030
2754,6292672048,168634,6292840682,8,0,0,2560,8,2560804253
2755,6292673927,168138,6292842065,0,0,0,14848,0,6470360612
2756,6292733385,43607,6292776992,5,0,1,59904,5,469130176
2757,6292740351,127094,6292867445,5,0,1,10752,5,6931282842
2758,6292799444,349438,6293148882,3,0,0,1536,3,6144221100
2759,6292812406,290136,6293102542,2,0,1,49664,2,3130212753
2760,6292891446,219109,6293110555,2,0,0,359936,2,47522584
2761,6292903878,209263,6293113141,5,0,0,4096,5,3431037715
2762,6292915730,141910,6293057640,8,0,1,23040,8,8260037879
2763,6292979793,125440,6293105233,9,0,1,34304,9,2554315550
2764,6292988237,51672,6293039909,4,0,1,1024,4,8056976982
2765,6292997050,301515,6293298565,9,0,0,90624,9,3511272526
2766,6293013866,306313,6293320179,5,0,0,512,5,8245509594
2767,6293019611,394041,6293413652,9,0,1,47104,9,4681470980
2768,6293084055,184366,6293268421,9,0,1,8704,9,5820201998
2769,6293089260,255641,6293344901,7,0,0,2560,7,2966756378
2770,6293129499,358441,6293487940,2,0,1,6656,2,9238003036
2771,6293309034,69029,6293378063,6,0,0,89600,6,8723797299
2772,6293327373,161600,6293488973,0,0,0,401408,0,1624644887
2773,6293373705,257923,6293631628,0,0,0,33280,0,2313128028
2774,6293396252,222011,6293618263,5,0,0,512,5,6917387371
2775,6293404068,199810,6293603878,4,0,1,512,4,4685939550
2776,6293488722,118784,6293607506,1,0,0,38400,1,5711085142
2777,6293497685,115313,6293612998,6,0,0,26112,6,1818332702
2778,6293514431,114837,6293629268,2,0,0,61440,2,5839815154
2779,6293521221,109993,6293631214,3,0,0,3072,3,4161530995
2780,6293527230,105610,6293632840,7,0,0,2560,7,4234375422
2781,6293612391,82404,6293694795,6,0,0,133632,6,3572448529
2782,6293626340,229735,6293856075,9,0,0,328192,9,3827670244
2783,6293632052,225009,6293857061,7,0,0,1536,7,9873684861
2784,6293722492,136350,6293858842,7,0,1,2048,7,5320575231
2785,6293753876,62265,6293816141,8,0,1,2048,8,3394718234
2786,6293773993,131420,6293905413,1,0,1,54784,1,2136699812
2787,6293800493,6484,6293806977,3,0,0,18944,3,3834549683
2788,6293842300,340346,6294182646,0,0,1,8192,0,2932598194
2789,6293885532,274554,6294160086,9,0,0,15872,9,6191022913
2790,6294000154,40870,6294041024,9,0,1,5632,9,3159584950
2791,6294077581,28598,6294106179,0,0,0,66048,0,5212748933
2792,6294090199,124108,6294214307,5,0,0,512,5,3981239278
2793,6294220715,4933,6294225648,8,0,0,12800,8,6988924207
2794,6294271991,144353,6294416344,6,0,1,65536,6,7994679892
2795,6294319846,99332,6294419178,9,0,1,6144,9,5780965507
2796,6294345912,315537,6294661449,2,0,0,510976,2,10170236300
2797,6294349824,241612,6294591436,8,0,1,46080,8,7122296395
2798,6294405487,149242,6294554729,0,0,1,108544,0,7548189603
2799,6294420183,370628,6294790811,7,0,0,512,7,6344464864
2800,6294450577,440350,6294890927,1,0,1,17920,1,3778431396
2801,6294514038,345076,6294859114,1,0,0,15360,1,4839086591
2802,6294515394,42458,6294557852,6,0,1,4096,6,10474173880
2803,6294593194,297113,6294890307,3,0,1,7680,3,8853439042
2804,6294754425,233254,6294987679,8,0,0,7168,8,5050975546
2805,6294846697,12562,6294859259,8,0,1,5632,8,666102615
2806,6294847519,6274,6294853793,5,0,0,20992,5,9540790927
2807,6294910833,90221,6295001054,5,0,0,6656,5,555285319
2808,6294925483,327900,6295253383,6,0,0,535040,6,2822696181
2809,6294939815,270813,6295210628,3,0,0,15360,3,4261175918
2810,6294939826,317634,6295257460,5,0,1,3072,5,680584878
2811,6294945047,265888,6295210935,3,0,1,37376,3,8083679608
2812,6294947631,154758,6295102389,5,0,1,9728,5,4381407071
2813,6294986625,346774,6295333399,7,0,1,9216,7,2703699946
2814,6294991572,352942,6295344514,9,0,0,9728,9,9550309538
2815,6295015119,282865,6295297984,7,0,1,5632,7,10179137275
2816,6295102713,395146,6295497859,6,0,0,14336,6,316952736
2817,6295123332,191652,6295314984,2,0,1,14848,2,7060243585
2818,6295258517,173793,6295432310,0,0,1,13824,0,3239533553
2819,6295308882,202414,6295511296,7,0,1,41984,7,8907741204
2820,6295312891,423084,6295735975,4,0,1,1536,4,6018027012
2821,6295396915,210978,6295607893,0,0,0,359424,0,5525615436
2822,6295403682,218850,6295622532,5,0,1,39424,5,1876027838
2823,6295427518,250714,6295678232,6,0,0,200704,6,1937468698
2824,6295477861,402787,6295880648,2,0,0,503296,2,4997873232
2825,6295534656,285880,6295820536,5,0,1,11264,5,8112460543
2826,6295542332,268026,6295810358,6,0,1,512,6,10442319633
2827,6295595754,275353,6295871107,3,0,0,1536,3,8754271662
2828,6295615554,417144,6296032698,7,0,0,3072,7,4066796514
2829,6295634558,126175,6295760733,2,0,0,84992,2,1155274682
2830,6295685727,45959,6295731686,2,0,1,35840,2,7101217889
2831,6295855681,387947,6296243628,2,0,0,208896,2,2706048439
2832,6295937280,24238,6295961518,9,0,0,14848,9,874440084
2833,6296098919,627916,6296726835,9,0,0,40448,9,8436597576
2834,6296171681,25183,6296196864,1,0,0,45568,1,10346295209
2835,6296214994,194812,6296409806,2,0,0,315904,2,5690501625
2836,6296317151,12545,6296329696,1,0,1,5120,1,6772400447
2837,6296360383,169300,6296529683,1,0,1,11264,1,9610719042
2838,6296402548,94337,6296496885,3,0,0,16896,3,4636374334
2839,6296420699,161732,6296582431,1,0,0,153600,1,8686065994
2840,6296440498,81628,6296522126,1,0,0,20992,1,1935805526
2841,6296491892,134321,6296626213,8,0,1,81920,8,7421613315
2842,6296513821,3894,6296517715,2,0,0,218112,2,5909047984
2843,6296701625,255762,6296957387,7,0,0,4096,7,9259270991
2844,6296735131,35889,6296771020,9,0,0,41984,9,4688251780
2845,6296754629,74087,6296828716,1,0,1,7680,1,2541450099
2846,6296790896,60086,6296850982,2,0,0,120832,2,2100398095
2847,6296808763,210070,6297018833,5,0,0,6144,5,3451499292
2848,6296844028,268442,6297112470,6,0,0,439296,6,9821320469
2849,6296941048,279471,6297220519,8,0,0,353280,8,10046289583
2850,6296977140,245325,6297222465,3,0,0,3072,3,210227444
2851,6297022885,257221,6297280106,1,0,0,185856,1,319273149
2852,6297044223,148092,6297192315,7,0,1,10240,7,4148736556
2853,6297184932,31076,6297216008,6,0,0,179712,6,5729219744
2854,6297297131,306844,6297603975,3,0,1,21504,3,8275232894
2855,6297302294,125400,6297427694,7,0,0,512,7,5365132438
2856,6297322403,68268,6297390671,1,0,0,207360,1,7060932759
2857,6297332333,61626,6297393959,8,0,1,6144,8,7138752918
2858,6297337911,239566,6297577477,9,0,1,62976,9,9128756616
2859,6297396112,280601,6297676713,2,0,0,54784,2,5353760594
2860,6297402561,302549,6297705110,5,0,1,56832,5,8747856921
2861,6297405020,442161,6297847181,3,0,0,3584,3,7860639420
2862,6297514341,262035,6297776376,8,0,1,12288,8,4930923963
2863,6297551161,72279,6297623440,5,0,1,22528,5,1881762602
2864,6297758515,326473,6298084988,9,0,0,117248,9,277244618
2865,6297766267,75313,6297841580,3,0,1,1536,3,2779725815
2866,6297781575,223269,6298004844,8,0,0,565248,8,1098667203
2867,6297797737,359604,6298157341,1,0,1,4608,1,465580350
2868,6297845999,297126,6298143125,3,0,0,3072,3,10132323207
2869,6297864543,330783,6298195326,6,0,0,176128,6,10251158158
2870,6297949271,246401,6298195672,5,0,0,512,5,2954707408
2871,6298054863,223193,6298278056,4,0,0,263168,4,4016681035
2872,6298066589,214373,6298280962,7,0,0,4608,7,3209872086
2873,6298145904,191982,6298337886,9,0,0,190464,9,10200501725
2874,6298151311,55723,6298207034,4,0,1,8192,4,2782870415
2875,6298290413,213665,6298504078,1,0,1,3072,1,9430262306
2876,6298292583,81112,6298373695,2,0,0,33280,2,10676126
2877,6298386087,1038,6298387125,7,0,1,2048,7,7164974356
2878,6298388003,238761,6298626764,6,0,0,131072,6,7802835146
2879,6298488472,199425,6298687897,8,0,1,2048,8,7204057408
2880,6298507542,203526,6298711068,7,0,0,1024,7,6428733323
2881,6298627250,15317,6298642567,0,0,1,35840,0,5586023814
2882,6298699840,151863,6298851703,4,0,0,29696,4,4131985040
2883,6298827345,23721,6298851066,6,0,0,39424,6,4458922309
2884,6298834665,4846,6298839511,7,0,1,51200,7,8152392315
2885,6298906314,47440,6298953754,3,0,0,5120,3,2320348485
2886,6298936692,254640,6299191332,1,0,1,2048,1,5638406395
2887,6299267905,5192,6299273097,0,0,0,13312,0,10163458583
2888,6299291377,1038,6299292415,3,0,0,1024,3,180015812
2889,6299375520,55744,6299431264,2,0,1,4096,2,2236693321
2890,6299386270,47284,6299433554,2,0,1,1536,2,8677219283
2891,6299424483,104633,6299529116,4,0,0,173568,4,127188359
2892,6299436364,90544,6299526908,5,0,1,36864,5,4463053239
2893,6299444168,81112,6299525280,3,0,1,4096,3,3597874963
2894,6299493660,60301,6299553961,4,0,1,7680,4,7966335249
2895,6299494256,146505,6299640761,5,0,1,7168,5,9922892947
2896,6299540341,233413,6299773754,9,0,0,131072,9,2847578319
2897,6299562458,303294,6299865752,5,0,0,2048,5,1764856150
2898,6299798516,76984,6299875500,6,0,1,3584,6,2981716357
2899,6299800501,89510,6299890011,5,0,1,13312,5,3558317771
2900,6299860416,40612,6299901028,4,0,0,65536,4,7962267196
2901,6299953034,1514,6299954548,3,0,0,1536,3,9982387413
2902,6300014141,142637,6300156778,1,0,0,230912,1,2329909608
2903,6300018599,176439,6300195038,1,0,1,5120,1,3855880979
2904,6300066771,104931,6300171702,8,0,1,8192,8,5192849903
2905,6300098608,62309,6300160917,8,0,0,150016,8,7498212843
2906,6300146376,184504,6300330880,0,0,0,8192,0,3966643153
2907,6300175113,68149,6300243262,8,0,0,190976,8,72751238
2908,6300218900,115275,6300334175,5,0,1,2560,5,9613826756
2909,6300234806,92270,6300327076,4,0,1,48640,4,8843422670
2910,6300294543,43107,6300337650,8,0,0,149504,8,738600104
2911,6300332718,38829,6300371547,0,0,1,52736,0,3108550881
2912,6300340013,204774,6300544787,2,0,1,8192,2,9132656066
2913,6300347572,258441,6300606013,7,0,0,6144,7,70990495
2914,6300352196,198557,6300550753,3,0,0,512,3,10240947149
2915,6300376948,325730,6300702678,6,0,0,540672,6,1246527736
2916,6300379982,327348,6300707330,1,0,1,20480,1,4405427461
2917,6300386277,334237,6300720514,6,0,0,124416,6,10305520117
2918,6300411400,314959,6300726359,3,0,0,3072,3,3119812139
2919,6300426825,378290,6300805115,1,0,1,3584,1,5958356324
2920,6300427311,353178,6300780489,7,0,0,9728,7,304981143
2921,6300449597,337278,6300786875,1,0,1,77824,1,9823764562
2922,6300492913,350337,6300843250,0,0,0,300032,0,1787765408
2923,6300542753,315626,6300858379,0,0,1,2560,0,4600358152
2924,6300593977,189789,6300783766,6,0,1,10240,6,6386134366
2925,6300643003,176790,6300819793,0,0,1,8704,0,1437916830
2926,6300726911,197653,6300924564,0,0,0,237056,0,3547621930
2927,6300771067,51050,6300822117,8,0,0,99840,8,5294070551
2928,6300787723,4462,6300792185,4,0,0,122368,4,10214858220
2929,6300873441,363722,6301237163,6,0,1,8704,6,8698613092
2930,6300934992,3900,6300938892,7,0,0,1024,7,9355930616
2931,6300947484,445491,6301392975,4,0,1,11776,4,9615673884
2932,6300981836,290987,6301272823,3,0,0,9216,3,7776513862
2933,6301010795,225322,6301236117,5,0,0,10752,5,3328465777
2934,6301027739,190322,6301218061,0,0,1,9728,0,9978753029
2935,6301225059,1038,6301226097,3,0,0,1024,3,6992630256
2936,6301259901,7226,6301267127,5,0,1,8192,5,2379194318
2937,6301262410,133909,6301396319,5,0,0,7680,5,3574372782
2938,6301315189,199511,6301514700,0,0,1,18944,0,8430083869
2939,6301545517,189194,6301734711,6,0,1,12288,6,9013874058
2940,6301616642,276499,6301893141,9,0,0,451584,9,1308739671
2941,6301811017,83814,6301894831,2,0,1,7168,2,9515278833
2942,6301837238,39685,6301876923,2,0,1,13312,2,4402237149
2943,6301850955,86041,6301936996,8,0,0,133632,8,4990551464
2944,6301896710,221566,6302118276,3,0,0,2560,3,6861891471
2945,6301949893,262811,6302212704,5,0,1,5632,5,6962262668
2946,6302047163,454822,6302501985,2,0,0,939008,2,1446814361
2947,6302091386,510240,6302601626,5,0,0,5632,5,891541430
2948,6302104213,380712,6302484925,4,0,1,27648,4,803821865
2949,6302136970,581040,6302718010,2,0,0,80896,2,9663786516
2950,6302140687,539144,6302679831,8,0,1,5632,8,5303284168
2951,6302188240,515577,6302703817,7,0,0,6144,7,237027293
2952,6302191231,468173,6302659404,6,0,0,12288,6,572433733
2953,6302247480,466053,6302713533,3,0,1,45056,3,11069931
2954,6302334884,449103,6302783987,4,0,1,25088,4,3052450096
2955,6302339497,503651,6302843148,8,0,0,603136,8,193562884
2956,6302393620,429458,6302823078,2,0,1,46080,2,5944313913
2957,6302414663,577376,6302992039,7,0,0,12800,7,8010183374
2958,6302420683,438140,6302858823,6,0,0,599552,6,1341193298
2959,6302597981,615449,6303213430,6,0,1,30720,6,5611686782
2960,6302608448,468697,6303077145,1,0,1,59392,1,6762540238
2961,6302694078,421018,6303115096,3,0,1,31744,3,988518219
2962,6302727139,447031,6303174170,9,0,0,472576,9,9628879434
2963,6302798186,370762,6303168948,7,0,1,17408,7,10056438208
2964,6302814340,240637,6303054977,2,0,0,35840,2,3199042527
2965,6302932579,302867,6303235446,1,0,1,19968,1,4857180382
2966,6302974997,60862,6303035859,7,0,1,44544,7,5701185889
2967,6303004168,513977,6303518145,2,0,1,12800,2,4048165369
2968,6303030872,317199,6303348071,2,0,1,38400,2,2849352341
2969,6303085113,480686,6303565799,5,0,1,28160,5,4007829586
2970,6303161168,91495,6303252663,7,0,1,27136,7,4154486479
2971,6303187808,23880,6303211688,8,0,0,98304,8,7938624263
2972,6303268755,1038,6303269793,1,0,1,8704,1,8626213745
2973,6303324165,505688,6303829853,4,0,1,60928,4,5800573896
2974,6303416304,323047,6303739351,1,0,0,147968,1,7747962814
2975,6303426702,62412,6303489114,3,0,1,4096,3,3836592083
2976,6303439567,64919,6303504486,5,0,1,43008,5,4949762471
2977,6303442272,399336,6303841608,9,0,1,12288,9,6128085507
2978,6303456455,303873,6303760328,5,0,1,13312,5,10734748309
2979,6303465747,266268,6303732015,7,0,1,2048,7,3280866283
2980,6303485225,311457,6303796682,0,0,0,2048,0,10259626596
2981,6303514359,627643,6304142002,7,0,0,1024,7,6328322676
2982,6303591924,372326,6303964250,2,0,0,101376,2,635727178
2983,6303606199,395209,6304001408,2,0,0,55808,2,6441532682
2984,6303677921,185721,6303863642,8,0,0,301568,8,5263752902
2985,6303702912,191682,6303894594,8,0,0,98816,8,2653796496
2986,6303792133,175091,6303967224,9,0,0,241152,9,6267744663
2987,6303800365,347293,6304147658,9,0,1,20992,9,10505347860
2988,6304055480,266979,6304322459,8,0,0,433152,8,2476172731
2989,6304141345,171041,6304312386,5,0,1,2048,5,2623574320
2990,6304157422,104371,6304261793,1,0,0,20480,1,1814864264
2991,6304251037,255224,6304506261,9,0,0,88064,9,9081156869
2992,6304257459,145264,6304402723,2,0,1,512,2,8616401919
2993,6304302237,190655,6304492892,2,0,1,23040,2,9877654085
2994,6304330092,145908,6304476000,0,0,1,17920,0,2485708093
2995,6304366952,65525,6304432477,9,0,0,240640,9,5193959660
2996,6304411198,210392,6304621590,3,0,1,12800,3,1992900350
2997,6304420732,162444,6304583176,4,0,1,18432,4,4496890331
2998,6304453544,126933,6304580477,2,0,0,29696,2,9999703341
2999,6304459816,46804,6304506620,8,0,0,204800,8,137092638
3000,6304541328,14025,6304555353,8,0,0,14848,8,7114665445
3001,6304607674,171500,6304779174,9,0,1,6656,9,2997628689
3002,6304609866,374079,6304983945,0,0,1,17408,0,9746743462
3003,6304700400,244513,6304944913,1,0,0,27136,1,4947277492
3004,6304740010,6052,6304746062,6,0,1,48640,6,9979826431
3005,6304850285,1514,6304851799,8,0,0,11264,8,877454444
3006,6304898735,3900,6304902635,3,0,0,1536,3,10658940812
3007,6304912334,206790,6305119124,3,0,0,10752,3,4661875173
3008,6304951892,24238,6304976130,2,0,1,10752,2,7621161692
3009,6304970046,67144,6305037190,2,0,0,40448,2,5278507202
3010,6305040244,216445,6305256689,5,0,1,11264,5,8982528532
3011,6305219680,135096,6305354776,4,0,0,219648,4,3859730816
3012,6305322282,1990,6305324272,3,0,1,12288,3,2145081646
3013,6305391010,109598,6305500608,2,0,1,25088,2,9573962984
3014,6305418649,3418,6305422067,3,0,0,2048,3,7507502894
3015,6305435382,139511,6305574893,3,0,0,3584,3,1609491761
3016,6305448045,421136,6305869181,5,0,0,1135104,5,5201848810
3017,6305476685,174770,6305651455,2,0,1,40448,2,8821311745
3018,6305483138,484043,6305967181,2,0,1,9728,2,5236037605
3019,6305495508,532218,6306027726,9,0,0,187392,9,957954260
3020,6305512433,309489,6305821922,7,0,1,15360,7,8572000218
3021,6305717414,277723,6305995137,0,0,1,32256,0,6055624464
3022,6305749503,184241,6305933744,3,0,1,1024,3,3285547508
3023,6305760887,212857,6305973744,7,0,1,2048,7,4557343464
3024,6305771190,701062,6306472252,9,0,0,159232,9,6734642085
3025,6305771336,711547,6306482883,3,0,0,9216,3,8947960687
3026,6305876200,482830,6306359030,4,0,1,3072,4,572748529
3027,6305880902,482940,6306363842,0,0,1,29184,0,829837796
3028,6305903342,162311,6306065653,0,0,1,6144,0,9395819266
3029,6305991492,69120,6306060612,6,0,1,25088,6,9237437690
3030,6306095191,21654,6306116845,3,0,0,5120,3,7770966829
3031,6306192248,506688,6306698936,5,0,0,6144,5,6320231933
3032,6306345134,441925,6306787059,4,0,0,35328,4,9017919755
3033,6306380620,71183,6306451803,2,0,0,104960,2,3671264398
3034,6306436914,26333,6306463247,9,0,0,38400,9,5919447290
3035,6306481303,142378,6306623681,5,0,0,230400,5,8994483206
3036,6306643714,1038,6306644752,0,0,1,9216,0,2861426807
3037,6306723558,150638,6306874196,7,0,0,1024,7,4873365343
3038,6306733976,105182,6306839158,7,0,1,17920,7,4765826783
3039,6306761872,114241,6306876113,3,0,1,4608,3,5669022544
3040,6306778434,228518,6307006952,9,0,1,8704,9,5375840321
3041,6306800924,269317,6307070241,8,0,0,188928,8,8398848314
3042,6306906017,131482,6307037499,8,0,1,33280,8,8464887969
3043,6306928992,82055,6307011047,2,0,1,6144,2,8009866257
3044,6306955455,30610,6306986065,9,0,0,121344,9,6134786270
3045,6306989265,15593,6307004858,6,0,1,13824,6,5589935811
3046,6307006911,98514,6307105425,3,0,0,1536,3,8849038851
3047,6307021939,88252,6307110191,3,0,0,1024,3,1847601447
3048,6307049153,210296,6307259449,3,0,1,25088,3,10597739586
3049,6307098599,99160,6307197759,5,0,1,25600,5,495874484
3050,6307186552,88824,6307275376,1,0,1,9728,1,4263733874
3051,6307203330,167708,6307371038,2,0,0,276480,2,1992352041
3052,6307261814,154921,6307416735,2,0,1,19456,2,3068904247
3053,6307278277,177534,6307455811,1,0,0,199168,1,654492229
3054,6307298056,167323,6307465379,0,0,0,113152,0,6090565546
3055,6307405813,71420,6307477233,8,0,0,48640,8,8765273621
3056,6307436282,42257,6307478539,3,0,0,2048,3,8077645071
3057,6307450105,28588,6307478693,9,0,0,8704,9,4906923735
3058,6307479810,36600,6307516410,6,0,1,17920,6,5886991539
3059,6307513775,40612,6307554387,0,0,0,64512,0,4558806197
3060,6307610682,264925,6307875607,4,0,0,65536,4,10189839702
3061,6307636571,4158,6307640729,6,0,1,29184,6,5894609447
3062,6307832192,238470,6308070662,7,0,0,11264,7,1299748231
3063,6307929046,84639,6308013685,9,0,1,512,9,6119182480
3064,6307987615,257541,6308245156,2,0,0,421376,2,4092858837
3065,6308087810,126265,6308214075,2,0,1,11776,2,6055385564
3066,6308121797,188744,6308310541,2,0,0,4608,2,5304866548
3067,6308136175,205869,6308342044,6,0,0,310784,6,4266581070
3068,6308164485,60580,6308225065,2,0,1,14336,2,2426202002
3069,6308204902,207222,6308412124,0,0,1,1536,0,8316849226
3070,6308285330,195499,6308480829,6,0,0,6144,6,8629577914
3071,6308289239,161829,6308451068,6,0,0,320512,6,10128667122
3072,6308338360,38499,6308376859,2,0,0,49152,2,2902795058
3073,6308359863,390159,6308750022,8,0,1,14336,8,873015149
3074,6308424949,232348,6308657297,0,0,1,31232,0,7839709867
3075,6308441317,562,6308441879,7,0,1,46080,7,6192037390
3076,6308467284,212688,6308679972,6,0,0,26624,6,4495695280
3077,6308480906,278998,6308759904,2,0,1,32256,2,5574299237
3078,6308594493,249248,6308843741,0,0,1,1536,0,5597139440
3079,6308616923,224286,6308841209,3,0,0,512,3,8088170783
3080,6308725005,259153,6308984158,6,0,0,411136,6,1864702342
3081,6308732198,207668,6308939866,6,0,1,19968,6,6121417017
3082,6308807647,327173,6309134820,5,0,0,108032,5,1559253993
3083,6309020768,147200,6309167968,0,0,0,243200,0,1181388454
3084,6309056170,221650,6309277820,5,0,0,295936,5,2073603209
3085,6309071980,211025,6309283005,4,0,0,24576,4,3879876929
3086,6309111675,103261,6309214936,4,0,1,55808,4,7905148485
3087,6309112288,71909,6309184197,8,0,1,5120,8,9331979573
3088,6309185748,208537,6309394285,2,0,0,28672,2,5837261380
3089,6309217476,344473,6309561949,1,0,1,19456,1,2470673297
3090,6309220314,16609,6309236923,2,0,1,10752,2,9989914480
3091,6309222694,287321,6309510015,9,0,0,18432,9,10545176126
3092,6309389201,316089,6309705290,3,0,1,40960,3,3051143843
3093,6309432295,2942,6309435237,8,0,1,2560,8,2237808855
3094,6309476603,133540,6309610143,4,0,0,32256,4,9811331368
3095,6309521985,212408,6309734393,1,0,1,4608,1,7426753149
3096,6309542791,84016,6309626807,2,0,0,3072,2,191165561
3097,6309562542,73483,6309636025,5,0,0,122880,5,1358119316
3098,6309612085,15833,6309627918,6,0,1,28672,6,8294986929
3099,6309625418,145107,6309770525,9,0,1,21504,9,9478103828
3100,6309641742,204030,6309845772,9,0,1,40448,9,6293476541
3101,6309691584,247423,6309939007,1,0,0,30720,1,9472373355
3102,6309797156,99664,6309896820,0,0,1,25088,0,5442007854
3103,6309825271,79703,6309904974,3,0,1,15360,3,188957044
3104,6309896899,36342,6309933241,4,0,0,64000,4,10042893192
3105,6309902960,157044,6310060004,9,0,1,24064,9,8582976682
3106,6309912557,276391,6310188948,3,0,1,103936,3,7442773324
3107,6310016033,277791,6310293824,0,0,0,454144,0,3520250279
3108,6310042840,261949,6310304789,3,0,1,31744,3,3445677251
3109,6310054732,259881,6310314613,1,0,1,10752,1,6409290885
3110,6310057418,106700,6310164118,3,0,1,61440,3,3851993784
3111,6310068030,261962,6310329992,4,0,1,16896,4,8197134603
3112,6310070109,424410,6310494519,1,0,0,102912,1,799116165
3113,6310146740,417235,6310563975,7,0,1,44032,7,5802792051
3114,6310273550,127164,6310400714,1,0,0,177664,1,3956077470
3115,6310318783,524083,6310842866,4,0,1,15872,4,9243614760
3116,6310392379,267565,6310659944,1,0,1,512,1,5397406168
3117,6310396921,230178,6310627099,5,0,1,24576,5,2832875505
3118,6310419190,562,6310419752,2,0,1,4608,2,3736840705
3119,6310461825,165457,6310627282,1,0,1,3584,1,8903014299
3120,6310536861,310106,6310846967,6,0,1,20992,6,1198134249
3121,6310614305,264641,6310878946,9,0,1,13824,9,2122903104
3122,6310659932,74668,6310734600,5,0,1,10752,5,2631213917
3123,6310680259,136591,6310816850,5,0,0,512,5,5480160903
3124,6310732459,309888,6311042347,5,0,0,499200,5,75311323
3125,6310734345,312508,6311046853,3,0,0,7168,3,5080511392
3126,6310756217,312141,6311068358,6,0,0,78336,6,676758587
3127,6310818595,296728,6311115323,2,0,0,159232,2,5665900745
3128,6310841528,199862,6311041390,5,0,1,12800,5,5629704959
3129,6310941997,309555,6311251552,1,0,0,94208,1,6339085728
3130,6310949882,216041,6311165923,9,0,1,28160,9,8339197991
3131,6310951535,160172,6311111707,0,0,0,81920,0,5812757333
3132,6311009030,142193,6311151223,8,0,0,2560,8,5594355897
3133,6311033115,272394,6311305509,6,0,0,29184,6,5002913980
3134,6311108374,118623,6311226997,9,0,0,173568,9,7503019725
3135,6311127561,117895,6311245456,1,0,1,33792,1,1544455808
3136,6311160029,320684,6311480713,5,0,1,10240,5,6727251918
3137,6311247153,338898,6311586051,8,0,1,14336,8,8008304183
3138,6311501491,73737,6311575228,3,0,1,4096,3,5678693548
3139,6311674516,65166,6311739682,9,0,0,110080,9,364654993
3140,6311738150,88889,6311827039,7,0,1,5120,7,1766728850
3141,6311760282,200401,6311960683,2,0,1,9728,2,6825737850
3142,6311789538,183969,6311973507,9,0,1,24064,9,4727333441
3143,6312136894,41645,6312178539,2,0,0,67584,2,2470968673
3144,6312178729,1038,6312179767,3,0,0,1024,3,4319765716
3145,6312333192,108676,6312441868,5,0,1,56832,5,6880652689
3146,6312350681,97758,6312448439,4,0,1,21504,4,764613137
3147,6312372421,32706,6312405127,8,0,1,44032,8,4630027964
3148,6312380202,89697,6312469899,6,0,1,4608,6,2099555880
3149,6312425929,135009,6312560938,4,0,0,16384,4,6185904168
3150,6312505168,3292,6312508460,3,0,0,1024,3,9853358380
3151,6312587494,35308,6312622802,2,0,1,9728,2,956419738
3152,6312598290,65140,6312663430,4,0,0,61952,4,2678091350
3153,6312685770,20362,6312706132,0,0,0,32768,0,8328241143
3154,6312693141,17817,6312710958,4,0,0,7680,4,10036951231
3155,6312758571,184946,6312943517,1,0,0,300032,1,10667744468
3156,6312825374,148946,6312974320,5,0,1,13312,5,2102048410
3157,6312840366,143576,6312983942,5,0,1,42496,5,9115590725
3158,6312916308,291396,6313207704,5,0,1,512,5,6323016022
3159,6312955782,131695,6313087477,0,0,1,1536,0,6958400677
3160,6312986456,294854,6313281310,5,0,1,1536,5,4716785616
3161,6313059371,85158,6313144529,1,0,1,20992,1,4936181883
3162,6313095937,80114,6313176051,2,0,0,142336,2,8214013130
3163,6313106678,68123,6313174801,4,0,0,18944,4,5581140630
3164,6313124878,168501,6313293379,4,0,0,29696,4,3399971451
3165,6313148070,3418,6313151488,4,0,1,19968,4,4508912513
3166,6313183752,226254,6313410006,4,0,1,16896,4,6424407599
3167,6313251020,203460,6313454480,7,0,0,3584,7,656653614
3168,6313388838,203387,6313592225,5,0,0,329216,5,9099759465
3169,6313431530,158319,6313589849,3,0,1,18944,3,4967810740
3170,6313449357,191584,6313640941,5,0,0,57344,5,3984244246
3171,6313472494,148430,6313620924,1,0,1,3584,1,626634576
3172,6313473513,123151,6313596664,4,0,1,18432,4,9930243435
3173,6313521610,246159,6313767769,9,0,0,208384,9,4647473746
3174,6313547555,202870,6313750425,3,0,0,1024,3,2035164417
3175,6313608543,198588,6313807131,9,0,0,328192,9,2423108264
3176,6313613491,67234,6313680725,5,0,0,1024,5,3061587835
3177,6313718529,412889,6314131418,9,0,1,25088,9,7260144003
3178,6313755002,223491,6313978493,2,0,1,16896,2,6671168813
3179,6313777545,337729,6314115274,2,0,0,114176,2,6709637587
3180,6313814827,286302,6314101129,5,0,1,24576,5,1380273606
3181,6313853489,134837,6313988326,5,0,1,74752,5,2123869917
3182,6313988929,176861,6314165790,8,0,1,1536,8,907295319
3183,6313995694,335462,6314331156,2,0,0,219136,2,606183266
3184,6313999639,161511,6314161150,0,0,1,12800,0,7886847704
3185,6314017732,179212,6314196944,9,0,1,11264,9,979251611
3186,6314029958,223917,6314253875,1,0,1,512,1,1845583121
3187,6314031280,168225,6314199505,4,0,1,13824,4,9071253492
3188,6314041821,380292,6314422113,6,0,1,7680,6,10436683287
3189,6314130890,211223,6314342113,0,0,1,47104,0,3032096356
3190,6314142557,370467,6314513024,2,0,0,277504,2,8876963223
3191,6314170435,47764,6314218199,1,0,1,5632,1,587829385
3192,6314179683,264340,6314444023,6,0,0,355328,6,869888759
3193,6314180820,119851,6314300671,6,0,1,7680,6,10248669011
3194,6314325953,351452,6314677405,5,0,1,32768,5,4170067310
3195,6314340179,303881,6314644060,2,0,1,68096,2,5623182968
3196,6314340339,5967,6314346306,8,0,0,60928,8,4522706117
3197,6314395311,257556,6314652867,8,0,1,1024,8,5099519755
3198,6314473079,291428,6314764507,5,0,1,62464,5,5391630277
3199,6314555554,461658,6315017212,9,0,0,14848,9,3744960380
3200,6314615197,139460,6314754657,8,0,0,507904,8,3964479985
3201,6314619773,313987,6314933760,4,0,1,28672,4,5906920943
3202,6314622050,174506,6314796556,0,0,1,19968,0,6544571409
3203,6314694933,232406,6314927339,9,0,1,62976,9,4913385579
3204,6314704048,272547,6314976595,6,0,0,25088,6,10191411546
3205,6314714125,93211,6314807336,4,0,0,176128,4,1137743883
3206,6314761863,140796,6314902659,3,0,1,3072,3,1400952396
3207,6314761929,464193,6315226122,0,0,1,22528,0,10357747336
3208,6314934423,468011,6315402434,3,0,1,20992,3,10040453516
3209,6314934884,219546,6315154430,5,0,0,132608,5,1615561941
3210,6314944600,492033,6315436633,8,0,0,307712,8,1784321164
3211,6314964270,231340,6315195610,6,0,0,101376,6,7359881067
3212,6314967850,311373,6315279223,6,0,0,277504,6,10108971516
3213,6314993025,166052,6315159077,0,0,1,14848,0,1183134168
3214,6315072562,485603,6315558165,5,0,1,2560,5,5287615905
3215,6315139707,423574,6315563281,2,0,0,86016,2,746110209
3216,6315191372,334027,6315525399,2,0,1,27136,2,5987667025
3217,6315357605,256766,6315614371,9,0,0,419840,9,9393232135
3218,6315365914,253744,6315619658,2,0,0,16896,2,3532430833
3219,6315395673,234712,6315630385,9,0,0,34816,9,588482458
3220,6315401073,229978,6315631051,6,0,0,1024,6,4138270029
3221,6315487057,48326,6315535383,2,0,1,15360,2,9846539991
3222,6315509959,11012,6315520971,2,0,1,28160,2,8173454197
3223,6315573972,300550,6315874522,3,0,1,9216,3,7242350032
3224,6315582492,290351,6315872843,3,0,1,32256,3,5824516708
3225,6315589138,152245,6315741383,3,0,0,22528,3,993897237
3226,6315635698,286194,6315921892,4,0,0,17920,4,10621446851
3227,6315704390,61861,6315766251,5,0,0,246272,5,522457273
3228,6315821924,330651,6316152575,2,0,0,89088,2,5786460381
3229,6315832240,109147,6315941387,4,0,0,149504,4,9981853178
3230,6315861484,102023,6315963507,4,0,0,73216,4,9585252782
3231,6315864030,110716,6315974746,5,0,0,45568,5,746759086
3232,6315874095,56075,6315930170,5,0,1,11776,5,5450072336
3233,6315965408,65942,6316031350,9,0,0,95744,9,1313493294
3234,6316041180,338811,6316379991,8,0,1,33792,8,3802113726
3235,6316053924,296840,6316350764,8,0,0,111616,8,4738900910
3236,6316059553,434832,6316494385,9,0,0,657920,9,9515665803
3237,6316088087,165168,6316253255,6,0,1,512,6,4986724866
3238,6316100600,35379,6316135979,0,0,1,17408,0,1022994768
3239,6316335323,410302,6316745625,5,0,0,20992,5,7504200798
3240,6316465778,13766,6316479544,9,0,0,11264,9,6055887405
3241,6316506927,475579,6316982506,1,0,1,7168,1,3697311638
3242,6316538953,5322,6316544275,0,0,0,26624,0,6196638003
3243,6316591845,164263,6316756108,3,0,0,5632,3,9972951770
3244,6316659872,84820,6316744692,7,0,1,13824,7,4776134373
3245,6316826184,156657,6316982841,4,0,1,32768,4,7634886880
3246,6316859777,144425,6317004202,5,0,1,26624,5,7187299761
3247,6316916823,100175,6317016998,9,0,1,18432,9,9622470931
3248,6316976252,71406,6317047658,1,0,1,17920,1,5370204921
3249,6316976393,100329,6317076722,0,0,1,3584,0,8418059934
3250,6317042738,81657,6317124395,6,0,1,10752,6,8084939943
3251,6317152883,50995,6317203878,5,0,0,82432,5,581169946
3252,6317165283,69357,6317234640,0,0,0,96768,0,8930161916
3253,6317215551,75808,6317291359,2,0,0,127488,2,8532102797
3254,6317235235,187701,6317422936,5,0,0,278016,5,1200253638
3255,6317270935,170146,6317441081,9,0,1,6144,9,8359029920
3256,6317405435,43971,6317449406,2,0,0,72192,2,4027703815
3257,6317557899,562,6317558461,7,0,0,512,7,4919569042
3258,6317606190,45592,6317651782,1,0,1,1024,1,9508325537
3259,6317798971,22687,6317821658,2,0,0,37376,2,6185829130
3260,6317834602,119836,6317954438,7,0,1,19456,7,552735910
3261,6317927948,74224,6318002172,2,0,1,14336,2,9861982450
3262,6318017931,78832,6318096763,6,0,1,14336,6,1761238411
3263,6318061381,118878,6318180259,0,0,1,18944,0,8780609442
3264,6318147130,207692,6318354822,5,0,0,340992,5,3444589721
3265,6318152911,233551,6318386462,9,0,1,8192,9,3816309739
3266,6318157502,246409,6318403911,6,0,1,13824,6,5680685175
3267,6318157766,322283,6318480049,6,0,0,117248,6,7351351751
3268,6318164570,417898,6318582468,6,0,0,478720,6,1387999390
3269,6318177317,483119,6318660436,6,0,0,250368,6,4995508431
3270,6318271022,461532,6318732554,1,0,0,230400,1,635491174
3271,6318360786,403949,6318764735,9,0,0,113152,9,9653184764
3272,6318425161,283373,6318708534,2,0,0,190976,2,7416239244
3273,6318477337,396601,6318873938,1,0,0,56832,1,2136604574
3274,6318485698,361412,6318847110,9,0,1,12288,9,3716431656
3275,6318514034,227840,6318741874,8,0,1,23040,8,9926657374
3276,6318568745,280691,6318849436,4,0,1,7680,4,196931914
3277,6318617220,250672,6318867892,4,0,0,22016,4,3592889468
3278,6318667633,263657,6318931290,5,0,0,236032,5,8898934571
3279,6318686317,100477,6318786794,4,0,0,110592,4,3648497569
3280,6318695214,74426,6318769640,3,0,1,20480,3,270788868
3281,6318842112,293811,6319135923,6,0,1,1024,6,8477052588
3282,6318852083,181554,6319033637,3,0,0,4096,3,6837878828
3283,6318894199,517552,6319411751,2,0,0,52224,2,6365476349
3284,6318930129,62885,6318993014,9,0,1,2560,9,5195828573
3285,6319024768,158100,6319182868,9,0,0,95744,9,4775031455
3286,6319072708,45415,6319118123,1,0,0,261120,1,4438220665
3287,6319179854,409365,6319589219,9,0,1,75264,9,575850996
3288,6319191192,167244,6319358436,9,0,0,27648,9,2754878764
3289,6319273853,315893,6319589746,0,0,1,5632,0,3224643333
3290,6319277203,223629,6319500832,0,0,1,18432,0,8687423156
3291,6319284322,300507,6319584829,3,0,1,4096,3,3929681985
3292,6319287409,298328,6319585737,1,0,1,23552,1,1182125836
3293,6319477609,31003,6319508612,1,0,1,31744,1,9046013333
3294,6319556417,223132,6319779549,3,0,1,10240,3,4077733004
3295,6319626375,191692,6319818067,9,0,0,50176,9,3139499967
3296,6319691265,101795,6319793060,7,0,1,5120,7,5635579366
3297,6319708139,84932,6319793071,2,0,0,139776,2,3468319613
3298,6319722819,166429,6319889248,3,0,1,5120,3,2756908212
3299,6319850705,49086,6319899791,9,0,0,194048,9,10577241798
3300,6319908084,116825,6320024909,8,0,1,1536,8,640223206
3301,6319908734,133567,6320042301,0,0,1,6656,0,1726692590
3302,6319936900,137850,6320074750,5,0,0,228352,5,8178793018
3303,6319948535,137659,6320086194,9,0,0,38400,9,7113975437
3304,6320044431,175766,6320220197,8,0,1,21504,8,9637478166
3305,6320045911,151116,6320197027,6,0,0,288768,6,6573586282
3306,6320071867,124196,6320196063,3,0,0,2048,3,5904224150
3307,6320131286,187384,6320318670,8,0,1,24576,8,6260648244
3308,6320175318,305901,6320481219,6,0,0,201728,6,8936979381
3309,6320211573,146942,6320358515,4,0,1,62976,4,307339196
3310,6320246410,306864,6320553274,3,0,1,41472,3,5917665094
3311,6320324278,82404,6320406682,5,0,0,242688,5,359248845
3312,6320372127,177963,6320550090,5,0,1,11264,5,3192757069
3313,6320406862,126724,6320533586,7,0,1,24064,7,9789978913
3314,6320468975,245888,6320714863,4,0,1,3584,4,2527733505
3315,6320478683,339702,6320818385,6,0,1,7168,6,10602726475
3316,6320519074,554190,6321073264,0,0,1,17920,0,9125277907
3317,6320532202,13508,6320545710,6,0,0,133632,6,3277311960
3318,6320538538,248093,6320786631,8,0,0,149504,8,748968844
3319,6320554126,433535,6320987661,9,0,1,20992,9,3791853210
3320,6320630305,2942,6320633247,8,0,1,17408,8,6196627982
3321,6320749690,365153,6321114843,7,0,1,58368,7,8262133646
3322,6320761800,281633,6321043433,2,0,1,14848,2,9048209416
3323,6320775930,244750,6321020680,8,0,0,26112,8,9566737584
3324,6320809825,296574,6321106399,8,0,1,9728,8,4281868040
3325,6320818421,258844,6321077265,7,0,0,3072,7,8186704132
3326,6320862745,360405,6321223150,5,0,0,810496,5,7190091845
3327,6320885738,500113,6321385851,9,0,1,4608,9,4176246598
3328,6320893560,392696,6321286256,4,0,1,512,4,6223684292
3329,6320914005,357751,6321271756,5,0,1,6656,5,840638535
3330,6320980582,540539,6321521121,6,0,0,41472,6,5546998315
3331,6321049050,437308,6321486358,5,0,0,369152,5,2531036011
3332,6321068731,394682,6321463413,9,0,1,56320,9,6319969786
3333,6321091932,151865,6321243797,8,0,0,9216,8,5319407234
3334,6321206610,602338,6321808948,2,0,1,16896,2,5831771234
3335,6321336055,337019,6321673074,7,0,0,2048,7,209495413
3336,6321368402,207445,6321575847,5,0,0,289792,5,1375928271
3337,6321380379,210919,6321591298,2,0,0,57344,2,6629771869
3338,6321419482,121299,6321540781,4,0,1,2560,4,4314535355
3339,6321475491,111005,6321586496,4,0,0,26112,4,4111586666
3340,6321491072,100890,6321591962,5,0,0,16896,5,482652766
3341,6321497100,164608,6321661708,0,0,1,3584,0,8119492480
3342,6321503453,294969,6321798422,9,0,0,3584,9,1986589080
3343,6321611808,76347,6321688155,4,0,0,270336,4,9916140245
3344,6321736871,65863,6321802734,6,0,0,126976,6,2051549465
3345,6321751221,409614,6322160835,7,0,0,6144,7,593524954
3346,6321765480,88099,6321853579,8,0,0,117248,8,10133691338
3347,6321773841,253442,6322027283,4,0,0,346624,4,5036479364
3348,6321828885,60852,6321889737,5,0,1,57344,5,2879767281
3349,6321966995,143929,6322110924,9,0,0,10752,9,7466962849
3350,6322029093,16092,6322045185,1,0,0,233472,1,502208549
3351,6322110746,490870,6322601616,9,0,1,47616,9,1697225970
3352,6322192044,257371,6322449415,9,0,0,31232,9,485613027
3353,6322199702,207732,6322407434,1,0,1,20992,1,9393253818
3354,6322336129,92787,6322428916,2,0,0,150528,2,9171673811
3355,6322422636,202180,6322624816,0,0,1,18944,0,10005320510
3356,6322489597,98320,6322587917,7,0,1,1536,7,7794943116
3357,6322527443,166106,6322693549,7,0,1,3072,7,536898312
3358,6322669126,43883,6322713009,0,0,0,75264,0,7696612427
3359,6322682252,53749,6322736001,7,0,1,35328,7,4628096895
3360,6322769034,261451,6323030485,4,0,0,91136,4,2496758360
3361,6322842309,141875,6322984184,8,0,0,391680,8,10154415203
3362,6322892807,139471,6323032278,0,0,1,10240,0,305649806
3363,6322946613,243786,6323190399,2,0,1,40448,2,6462639137
3364,6322978051,150373,6323128424,2,0,0,160768,2,9153437826
3365,6322997055,135102,6323132157,6,0,0,764416,6,2115545617
3366,6323025592,173557,6323199149,8,0,0,101376,8,2062904671
3367,6323031180,499696,6323530876,2,0,0,14848,2,5349870652
3368,6323066400,451715,6323518115,7,0,1,28672,7,5207575573
3369,6323120615,502623,6323623238,8,0,0,43008,8,6296425171
3370,6323152551,498418,6323650969,4,0,0,2048,4,6057043128
3371,6323209870,419710,6323629580,7,0,1,16384,7,3789037525
3372,6323249889,389080,6323638969,5,0,1,3584,5,5785348501
3373,6323256005,190141,6323446146,1,0,1,1536,1,2438282148
3374,6323263196,172810,6323436006,6,0,1,1024,6,1613913339
3375,6323325084,383797,6323708881,8,0,1,76800,8,2555492075
3376,6323352873,110153,6323463026,0,0,0,14848,0,3042030765
3377,6323411627,444223,6323855850,5,0,0,140800,5,5534075264
3378,6323495516,96058,6323591574,7,0,1,6144,7,9626616219
3379,6323602468,433756,6324036224,9,0,1,9728,9,452802745
3380,6323614770,61338,6323676108,2,0,0,160256,2,6308044469
3381,6323697513,305777,6324003290,1,0,0,96256,1,9051317963
3382,6323708405,315330,6324023735,6,0,0,481280,6,661029154
3383,6323761543,284312,6324045855,9,0,0,73216,9,3171386871
3384,6323785807,261431,6324047238,9,0,0,14848,9,6103788269
3385,6323786781,286481,6324073262,0,0,0,83456,0,6586350264
3386,6323912149,177997,6324090146,9,0,0,56320,9,10598246485
3387,6323963491,167698,6324131189,1,0,1,3584,1,4953322207
3388,6324018794,72537,6324091331,8,0,1,1536,8,280938410
3389,6324069219,204051,6324273270,7,0,1,31744,7,10475776713
3390,6324085463,311951,6324397414,9,0,1,23552,9,3709560034
3391,6324131053,43712,6324174765,1,0,1,6656,1,4272888175
3392,6324132417,40545,6324172962,9,0,0,117760,9,10119464053
3393,6324206983,260917,6324467900,0,0,1,25600,0,9185787248
3394,6324224471,126712,6324351183,1,0,1,3072,1,10669220432
3395,6324255248,562,6324255810,0,0,0,71680,0,1225716639
3396,6324260041,147891,6324407932,7,0,0,2560,7,3288254420
3397,6324284690,235774,6324520464,0,0,1,17408,0,3820956184
3398,6324362423,314156,6324676579,9,0,0,512,9,4428875657
3399,6324374096,134749,6324508845,6,0,0,222208,6,6584553476
3400,6324435373,74752,6324510125,4,0,0,14336,4,920898279
3401,6324450413,75470,6324525883,4,0,0,50688,4,5028212989
3402,6324476074,50593,6324526667,9,0,1,18944,9,4397690692
3403,6324496386,124850,6324621236,5,0,0,68096,5,9838899885
3404,6324555299,155863,6324711162,5,0,0,253440,5,978911923
3405,6324617182,166130,6324783312,3,0,1,4096,3,5912345139
3406,6324617765,165830,6324783595,0,0,0,233472,0,3410957781
3407,6324623659,264068,6324887727,0,0,0,18432,0,6364856709
3408,6324644093,280376,6324924469,9,0,0,345088,9,8288526952
3409,6324660390,260810,6324921200,4,0,1,40960,4,9228950153
3410,6324677780,219514,6324897294,2,0,0,59392,2,6275480890
3411,6324725285,334496,6325059781,9,0,0,21504,9,3820317380
3412,6324753324,278788,6325032112,5,0,0,286720,5,9218608978
3413,6324759782,318783,6325078565,9,0,0,148480,9,5169321514
3414,6324893753,186438,6325080191,7,0,0,2560,7,8979801412
3415,6324936593,42345,6324978938,2,0,1,25600,2,873816415
3416,6324988117,562,6324988679,3,0,1,6656,3,10638894475
3417,6325054116,175313,6325229429,2,0,0,53248,2,4119255661
3418,6325072305,258721,6325331026,4,0,1,4608,4,402336527
3419,6325120059,61378,6325181437,9,0,1,36352,9,8971606557
3420,6325151213,176134,6325327347,3,0,0,512,3,3422752723
3421,6325157166,253984,6325411150,9,0,0,99328,9,9402241158
3422,6325197692,112528,6325310220,0,0,0,582144,0,5092549922
3423,6325211387,357241,6325568628,8,0,0,154112,8,9413808372
3424,6325218086,378271,6325596357,0,0,1,37376,0,10106650684
3425,6325275988,391126,6325667114,6,0,0,283648,6,9371435297
3426,6325334230,414862,6325749092,3,0,0,512,3,5533020921
3427,6325357167,356966,6325714133,4,0,1,3072,4,5580979627
3428,6325364850,331940,6325696790,0,0,0,26624,0,8739553689
3429,6325471712,33846,6325505558,7,0,1,24576,7,6440995821
3430,6325768995,140642,6325909637,0,0,0,55808,0,4548497691
3431,6325780760,46402,6325827162,9,0,0,220160,9,377890729
3432,6325813108,468310,6326281418,4,0,1,44032,4,8976228395
3433,6325838020,144446,6325982466,2,0,1,24064,2,180778663
3434,6325877906,261193,6326139099,3,0,0,4608,3,9971844362
3435,6325892652,104075,6325996727,6,0,0,234496,6,9558010255
3436,6325970237,1038,6325971275,1,0,0,101376,1,3313337618
3437,6326096736,562,6326097298,5,0,1,6144,5,3470104849
3438,6326098226,562,6326098788,7,0,0,1024,7,2973423036
3439,6326135431,343644,6326479075,7,0,0,512,7,5552557141
3440,6326162509,3641,6326166150,9,0,0,512,9,5621033737
3441,6326228371,23633,6326252004,5,0,0,10240,5,9196663497
3442,6326240525,245950,6326486475,7,0,1,22016,7,3242411074
3443,6326276984,112807,6326389791,1,0,0,42496,1,4472896554
3444,6326292644,23116,6326315760,2,0,1,1024,2,2842618324
3445,6326394100,114399,6326508499,5,0,1,11776,5,2173056617
3446,6326465983,3507,6326469490,8,0,0,41472,8,9238427207
3447,6326505546,12304,6326517850,3,0,0,512,3,1026133419
3448,6326509948,311047,6326820995,6,0,0,20480,6,64953220
3449,6326512499,68646,6326581145,2,0,0,109568,2,605688797
3450,6326552187,143670,6326695857,5,0,0,232960,5,8027624631
3451,6326561779,136344,6326698123,7,0,0,3584,7,7964318525
3452,6326588441,137556,6326725997,7,0,1,33792,7,9017640412
3453,6326706863,34363,6326741226,7,0,0,56832,7,2978266060
3454,6326746607,99316,6326845923,6,0,1,26112,6,7881704569
3455,6326839342,132489,6326971831,4,0,0,208384,4,712639145
3456,6326857150,115040,6326972190,5,0,0,9728,5,173929042
3457,6326903516,85661,6326989177,9,0,0,65024,9,643897446
3458,6326903852,199250,6327103102,6,0,1,4608,6,9555869147
3459,6326931013,208751,6327139764,1,0,0,340480,1,3384680704
3460,6326948716,211939,6327160655,5,0,0,75264,5,1551996233
3461,6327060874,132436,6327193310,5,0,1,12800,5,5851847480
3462,6327312193,67612,6327379805,6,0,1,19456,6,8656451718
3463,6327337571,58060,6327395631,4,0,1,12800,4,2487550356
3464,6327360131,173278,6327533409,6,0,1,6656,6,822061079
3465,6327392503,348925,6327741428,7,0,0,569344,7,7416263894
3466,6327483985,237350,6327721335,7,0,1,20480,7,7712850163
3467,6327524662,306581,6327831243,2,0,0,65536,2,3926076862
3468,6327625617,164960,6327790577,4,0,0,96768,4,1476884719
3469,6327661539,130505,6327792044,5,0,1,45056,5,4241129418
3470,6327774719,53233,6327827952,0,0,1,9216,0,6356531811
3471,6327914319,30824,6327945143,7,0,0,90112,7,7379956873
3472,6327922609,323524,6328246133,4,0,1,67584,4,1886299838
3473,6327938354,63874,6328002228,3,0,0,2560,3,2174410631
3474,6327967664,347164,6328314828,8,0,0,107520,8,3832823831
3475,6327994001,297714,6328291715,0,0,1,49152,0,5457103276
3476,6328063261,307479,6328370740,1,0,0,498688,1,3632727968
3477,6328104244,115219,6328219463,6,0,1,57344,6,488332386
3478,6328247405,162070,6328409475,9,0,1,59392,9,10328941647
3479,6328297456,111745,6328409201,7,0,0,143360,7,799373260
3480,6328310096,438163,6328748259,1,0,1,7168,1,8737454597
3481,6328363679,279975,6328643654,2,0,0,180736,2,1210098165
3482,6328396710,467766,6328864476,2,0,1,7168,2,431357911
3483,6328485944,237194,6328723138,6,0,1,26112,6,3405213212
3484,6328551832,264137,6328815969,7,0,0,427520,7,10311339833
3485,6328629082,190552,6328819634,5,0,1,8192,5,6072944374
3486,6328858420,155516,6329013936,0,0,0,256000,0,6648310237
3487,6328921315,103348,6329024663,2,0,0,34816,2,6944608517
3488,6328932637,170609,6329103246,9,0,0,253440,9,5535473678
3489,6328940389,163216,6329103605,6,0,0,9728,6,5552915094
3490,6328975250,159409,6329134659,0,0,0,107520,0,7985745386
3491,6328978682,171837,6329150519,8,0,0,51200,8,4276192442
3492,6328984324,166349,6329150673,3,0,0,8704,3,8034534906
3493,6329107866,145945,6329253811,3,0,1,19456,3,1247174531
3494,6329178346,136313,6329314659,6,0,1,3584,6,5798556311
3495,6329202465,335319,6329537784,5,0,1,40448,5,4814108023
3496,6329275487,157819,6329433306,1,0,1,19456,1,9399239209
3497,6329317513,103060,6329420573,5,0,1,5632,5,2005031659
3498,6329448893,376224,6329825117,5,0,1,38400,5,9023821227
3499,6329624445,31003,6329655448,8,0,0,50176,8,241975199
3500,6329689044,83954,6329772998,1,0,0,136704,1,5579709774
3501,6329706757,209620,6329916377,3,0,1,19456,3,1402927918
3502,6329934605,13508,6329948113,1,0,0,26112,1,2995785151
3503,6330039693,54052,6330093745,4,0,1,3584,4,4395494903
3504,6330147767,109300,6330257067,6,0,1,58880,6,2871862734
3505,6330147802,114335,6330262137,8,0,0,185856,8,1422658501
3506,6330193880,125488,6330319368,9,0,1,2560,9,5355730374
3507,6330214084,203065,6330417149,4,0,0,204288,4,7288157483
3508,6330221019,1514,6330222533,2,0,1,47616,2,4472590365
3509,6330422967,322950,6330745917,3,0,0,1536,3,3085457040
3510,6330559645,104152,6330663797,8,0,1,41984,8,242535096
3511,6330663476,56130,6330719606,6,0,0,95232,6,4930589715
3512,6330683030,36922,6330719952,8,0,0,512,8,10162050990
3513,6330793995,54052,6330848047,5,0,1,3584,5,4040577331
3514,6330837177,69616,6330906793,4,0,1,14336,4,8832804877
3515,6330837768,247933,6331085701,2,0,0,406016,2,8849421558
3516,6330929425,183441,6331112866,4,0,1,13312,4,2880129390
3517,6331007399,56075,6331063474,8,0,1,20992,8,9522416
3518,6331077884,44658,6331122542,4,0,0,95744,4,6290525933
3519,6331154337,219173,6331373510,6,0,0,76800,6,9559291048
3520,6331195084,127984,6331323068,0,0,1,10752,0,4336474880
3521,6331276472,132948,6331409420,6,0,0,212480,6,6212729821
3522,6331298044,301379,6331599423,6,0,0,94208,6,5062877084
3523,6331318122,138902,6331457024,5,0,1,10752,5,7415748692
3524,6331400192,9470,6331409662,4,0,1,24576,4,10724572367
3525,6331500112,9724,6331509836,5,0,1,6144,5,10658928144
3526,6331529635,236527,6331766162,6,0,0,4096,6,8103316790
3527,6331535340,6274,6331541614,1,0,0,14848,1,3171078976
3528,6331554476,1038,6331555514,2,0,1,3584,2,5785327593
3529,6331586170,181666,6331767836,3,0,0,6656,3,8041210742
3530,6331607996,4433,6331612429,7,0,0,1024,7,8181399945
3531,6331630915,82816,6331713731,7,0,1,12288,7,10047070268
3532,6331680279,191737,6331872016,3,0,0,3072,3,1175816157
3533,6331690022,23462,6331713484,0,0,1,3072,0,4514656090
3534,6331744062,92260,6331836322,1,0,0,38912,1,423928891
3535,6331786644,94013,6331880657,2,0,1,9216,2,2395501630
3536,6331888656,60820,6331949476,6,0,1,5632,6,1297929418
3537,6331922026,96648,6332018674,2,0,1,14848,2,8152113535
3538,6332014830,72048,6332086878,2,0,1,9728,2,8739410968
3539,6332081926,263362,6332345288,0,0,0,425984,0,5917054191
3540,6332106734,254005,6332360739,5,0,0,57344,5,9430800261
3541,6332124977,60110,6332185087,4,0,1,62976,4,10243968767
3542,6332150485,265799,6332416284,1,0,1,41472,1,2884017803
3543,6332301935,325816,6332627751,8,0,0,2048,8,1491414679
3544,6332320333,56075,6332376408,0,0,1,57856,0,8732111390
3545,6332516522,357416,6332873938,9,0,0,95744,9,5119679264
3546,6332526026,155790,6332681816,6,0,1,13312,6,4443942279
3547,6332580365,54613,6332634978,2,0,1,5120,2,2058569460
3548,6332639753,48162,6332687915,7,0,0,89600,7,4380539
3549,6332712799,195337,6332908136,0,0,1,512,0,2020912982
3550,6332775099,32812,6332807911,9,0,1,60928,9,6106938234
3551,6332777360,166772,6332944132,8,0,1,17920,8,9660955537
3552,6332792500,169990,6332962490,9,0,0,53760,9,6121048257
3553,6332926826,2466,6332929292,3,0,1,20992,3,1552418693
3554,6332964782,105113,6333069895,7,0,1,16384,7,2490373302
3555,6333020384,102959,6333123343,3,0,0,2560,3,2304997839
3556,6333122971,48976,6333171947,0,0,1,2048,0,3132754229
3557,6333172898,194812,6333367710,9,0,0,315904,9,2907970893
3558,6333226505,74017,6333300522,0,0,1,9728,0,8682816064
3559,6333268807,63446,6333332253,2,0,1,50176,2,10164606405
3560,6333280537,18689,6333299226,8,0,1,2048,8,5911663865
3561,6333294359,136623,6333430982,8,0,0,1024,8,6635413683
3562,6333322789,194531,6333517320,0,0,1,14336,0,3760458956
3563,6333345322,155237,6333500559,1,0,0,103424,1,3700554801
3564,6333392985,90052,6333483037,3,0,0,4608,3,10624942556
3565,6333444616,321727,6333766343,1,0,1,8192,1,10433953506
3566,6333471545,157702,6333629247,1,0,1,512,1,9359670394
3567,6333547945,105666,6333653611,0,0,0,175616,0,4077477727
3568,6333552335,166289,6333718624,1,0,1,11776,1,3927655852
3569,6333562737,190824,6333753561,7,0,1,11776,7,7386662344
3570,6333641446,277275,6333918721,0,0,0,453120,0,7561786981
3571,6333696745,222437,6333919182,1,0,0,10240,1,5452364875
3572,6333698625,248889,6333947514,2,0,1,1024,2,3299887757
3573,6333716668,290236,6334006904,0,0,0,288768,0,1624539586
3574,6333797167,148991,6333946158,5,0,1,5120,5,8107451880
3575,6333873734,244335,6334118069,5,0,1,40960,5,10578011571
3576,6333946924,325342,6334272266,7,0,1,11776,7,8808075360
3577,6334276082,99628,6334375710,2,0,1,27136,2,8440089675
3578,6334308203,11336,6334319539,8,0,1,1024,8,7324476849
3579,6334364393,104779,6334469172,1,0,0,16896,1,6963695400
3580,6334365029,94129,6334459158,9,0,1,8192,9,6559424134
3581,6334415406,42937,6334458343,6,0,1,104960,6,6556893127
3582,6334427143,128874,6334556017,1,0,0,70144,1,3973831366
3583,6334490014,69060,6334559074,7,0,1,3072,7,6508659369
3584,6334524878,5967,6334530845,6,0,1,58880,6,4158942673
3585,6334547960,195073,6334743033,0,0,1,51712,0,8812170770
3586,6334576640,108823,6334685463,6,0,0,14848,6,8098514817
3587,6334603925,290976,6334894901,5,0,1,44544,5,9350411763
3588,6334689080,255538,6334944618,9,0,1,18944,9,8982033219
3589,6334845718,13756,6334859474,1,0,0,11264,1,3054424447
3590,6334857260,90434,6334947694,1,0,1,19968,1,4429090468
3591,6334860621,109538,6334970159,7,0,1,20480,7,9622280557
3592,6335032197,2466,6335034663,4,0,0,2560,4,5360301698
3593,6335043390,55341,6335098731,7,0,1,512,7,6436801111
3594,6335071030,86450,6335157480,0,0,0,144896,0,9406919510
3595,6335109571,2466,6335112037,5,0,1,8192,5,7613538317
3596,6335161677,1514,6335163191,3,0,1,8192,3,3475936113
3597,6335170855,124408,6335295263,8,0,1,7680,8,8197681282
3598,6335188613,86350,6335274963,8,0,0,2560,8,4978796971
3599,6335197658,101847,6335299505,8,0,0,1536,8,3966309507
3600,6335238316,579,6335238895,6,0,1,14336,6,10157787401
3601,6335271556,122453,6335394009,4,0,0,512,4,7340430035
3602,6335271562,184596,6335456158,1,0,0,299008,1,2701785627
3603,6335299828,159556,6335459384,4,0,0,5120,4,7668211163
3604,6335375922,85728,6335461650,3,0,0,3584,3,8124068051
3605,6335390372,195152,6335585524,0,0,0,483328,0,5589357548
3606,6335415145,165777,6335580922,3,0,1,9216,3,6772642925
3607,6335447807,296233,6335744040,9,0,1,10752,9,1691058095
3608,6335456903,230688,6335687591,8,0,0,1536,8,3806069977
3609,6335567311,135731,6335703042,1,0,0,57344,1,5694199877
3610,6335652654,562,6335653216,8,0,1,4096,8,5770878298
3611,6335683562,1990,6335685552,8,0,1,1024,8,5566267012
3612,6335738205,181783,6335919988,3,0,1,7168,3,2198944968
3613,6335780536,210992,6335991528,6,0,0,512,6,7099338525
3614,6335826504,293308,6336119812,4,0,0,2048,4,1190832475
3615,6335993604,3894,6335997498,4,0,0,4096,4,8510468315
3616,6336079452,102904,6336182356,6,0,1,46592,6,2860525014
3617,6336085446,65540,6336150986,8,0,1,37888,8,8173397905
3618,6336097847,161700,6336259547,2,0,1,19456,2,5556335041
3619,6336134180,109479,6336243659,9,0,1,8192,9,8793162450
3620,6336140972,177389,6336318361,3,0,1,5632,3,4358939032
3621,6336169165,154829,6336323994,5,0,0,251392,5,1084061089
3622,6336212649,26475,6336239124,4,0,1,4608,4,9205527804
3623,6336321862,189647,6336511509,7,0,0,48128,7,5665644450
3624,6336484253,1990,6336486243,8,0,0,2048,8,6913099970
3625,6336541625,76583,6336618208,5,0,0,129024,5,7707228872
3626,6336550727,200180,6336750907,7,0,1,25600,7,8411582923
3627,6336681917,33329,6336715246,4,0,1,15872,4,1936698635
3628,6336700188,119149,6336819337,9,0,1,7168,9,7304306040
3629,6336735027,73624,6336808651,8,0,1,8192,8,971299082
3630,6336742597,110121,6336852718,7,0,1,17408,7,4421681293
3631,6336754210,177786,6336931996,5,0,0,54784,5,6123988540
3632,6336855155,4706,6336859861,0,0,1,13312,0,6483950543
3633,6336868650,85132,6336953782,1,0,1,14848,1,5406259685
3634,6336877935,83608,6336961543,3,0,0,12288,3,692629776
3635,6336891776,109257,6337001033,6,0,0,139264,6,9790471332
3636,6336892663,562,6336893225,0,0,0,86016,0,5636034873
3637,6336997809,136483,6337134292,6,0,1,29696,6,7018636800
3638,6337022080,296342,6337318422,2,0,1,27136,2,3152392448
3639,6337113060,45692,6337158752,3,0,0,512,3,8724783593
3640,6337115873,173575,6337289448,0,0,0,78848,0,6652790614
3641,6337118036,128001,6337246037,0,0,1,19968,0,388171278
3642,6337164666,136205,6337300871,9,0,1,12288,9,5389705246
3643,6337228500,200332,6337428832,3,0,1,86016,3,4806293898
3644,6337374229,45592,6337419821,3,0,1,12288,3,9573164421
3645,6337393247,91191,6337484438,8,0,1,1024,8,773069315
3646,6337431482,47284,6337478766,9,0,1,1536,9,6626479363
3647,6337495754,54052,6337549806,3,0,1,3584,3,8554944360
3648,6337508043,44488,6337552531,6,0,0,73216,6,10580245923
3649,6337529814,98746,6337628560,7,0,1,6144,7,5988615205
3650,6337629388,63446,6337692834,6,0,0,103424,6,650187196
3651,6337631087,47284,6337678371,9,0,1,18944,9,4411228569
3652,6337664987,133458,6337798445,0,0,1,1536,0,1940991528
3653,6337667036,170606,6337837642,2,0,1,22528,2,8217405458
3654,6337932321,43624,6337975945,6,0,0,74752,6,2899683746
3655,6337942062,112328,6338054390,3,0,1,49664,3,231087569
3656,6337974789,86708,6338061497,5,0,1,5120,5,7737649611
3657,6337991768,169048,6338160816,5,0,1,52224,5,2843213224
3658,6338008310,70122,6338078432,5,0,0,145408,5,1222581635
3659,6338041155,105696,6338146851,4,0,1,512,4,6332118479
3660,6338075801,260943,6338336744,4,0,1,6144,4,37536060
3661,6338175917,15833,6338191750,2,0,1,7168,2,6865088781
3662,6338264156,157264,6338421420,2,0,1,12800,2,9373970587
3663,6338291772,71620,6338363392,0,0,1,15872,0,3499851375
3664,6338305847,107947,6338413794,9,0,0,30720,9,6847328287
3665,6338347827,127208,6338475035,1,0,0,210944,1,10425375096
3666,6338399349,200504,6338599853,6,0,1,26624,6,3518818303
3667,6338453595,171541,6338625136,7,0,1,18944,7,9380527123
3668,6338497032,86027,6338583059,0,0,1,7168,0,2546748707
3669,6338544892,166330,6338711222,6,0,1,18944,6,6198437262
3670,6338682135,214545,6338896680,1,0,0,347648,1,4608726162
3671,6339035416,562,6339035978,3,0,1,23552,3,5892544050
3672,6339046050,98536,6339144586,4,0,0,512,4,8906388415
3673,6339118846,52360,6339171206,2,0,1,3072,2,10376594844
3674,6339120047,206141,6339326188,7,0,0,337920,7,2443696726
3675,6339205381,101939,6339307320,6,0,1,8192,6,6569253538
3676,6339225555,20620,6339246175,4,0,0,2048,4,5407000523
3677,6339286926,1038,6339287964,5,0,1,27136,5,7832727909
3678,6339321314,185940,6339507254,1,0,0,33280,1,6792276128
3679,6339352723,64204,6339416927,4,0,0,1024,4,4955698659
3680,6339367249,47097,6339414346,0,0,1,54784,0,6534584428
3681,6339422907,273504,6339696411,6,0,1,6656,6,4361904492
3682,6339485956,360133,6339846089,0,0,0,79360,0,10642248422
3683,6339692603,93304,6339785907,1,0,0,151552,1,9449954693
3684,6339700729,108640,6339809369,4,0,1,17408,4,1892427733
3685,6339708117,92254,6339800371,0,0,0,106496,0,4100897114
3686,6339724849,56075,6339780924,4,0,0,512,4,7402410443
3687,6339791292,58884,6339850176,8,0,1,64000,8,2322923705
3688,6339800824,25493,6339826317,6,0,0,95744,6,1481310863
3689,6339802201,170411,6339972612,4,0,0,6656,4,590904621
3690,6339815393,5322,6339820715,8,0,1,12800,8,3545222210
3691,6339836578,187302,6340023880,3,0,0,1536,3,3699377448
3692,6339878095,169312,6340047407,1,0,1,30720,1,472184205
3693,6339938216,279227,6340217443,1,0,0,5632,1,1491048275
3694,6340088611,113307,6340201918,0,0,1,58880,0,7137642012
3695,6340141767,89618,6340231385,7,0,1,16384,7,1683867921
3696,6340243286,63187,6340306473,0,0,0,102912,0,277364612
3697,6340353787,65896,6340419683,0,0,1,7168,0,8165358812
3698,6340381984,40612,6340422596,8,0,1,136192,8,3540214566
3699,6340382155,101786,6340483941,0,0,0,65536,0,6531988308
3700,6340382290,63153,6340445443,6,0,0,132608,6,6240543915
3701,6340390932,168319,6340559251,7,0,1,16384,7,2833638262
3702,6340424789,194091,6340618880,3,0,0,6144,3,1399480181
3703,6340424846,180350,6340605196,5,0,1,15872,5,1858925231
3704,6340497446,73180,6340570626,9,0,1,19456,9,1022089370
3705,6340604672,78447,6340683119,8,0,1,9216,8,6869753374
3706,6340610133,223551,6340833684,3,0,1,4096,3,499493922
3707,6340666907,127698,6340794605,5,0,1,11776,5,1373457407
3708,6340675587,154777,6340830364,9,0,0,246784,9,9691827036
3709,6340675933,457970,6341133903,7,0,0,621568,7,2741328669
3710,6340692156,346106,6341038262,4,0,1,27648,4,2802878598
3711,6340758824,252592,6341011416,0,0,1,4608,0,8347185367
3712,6340790600,406964,6341197564,0,0,1,1024,0,6093777116
3713,6340808767,380862,6341189629,9,0,1,2560,9,1530463836
3714,6340817755,247816,6341065571,4,0,1,18432,4,3536025972
3715,6340902202,248811,6341151013,0,0,0,67072,0,9482855111
3716,6340949015,193371,6341142386,6,0,0,143872,6,2805339902
3717,6340954331,246753,6341201084,7,0,0,22016,7,3794485792
3718,6340982925,445216,6341428141,5,0,0,94208,5,1180324004
3719,6341028518,240152,6341268670,0,0,1,10752,0,8808446822
3720,6341061033,145239,6341206272,6,0,1,4608,6,7510586676
3721,6341198234,665363,6341863597,4,0,1,5632,4,10445548278
3722,6341262507,237231,6341499738,5,0,0,387584,5,5378067576
3723,6341353550,146752,6341500302,1,0,0,10752,1,6181018193
3724,6341380784,277283,6341658067,5,0,1,17920,5,820046367
3725,6341476940,2942,6341479882,1,0,1,50688,1,3485074444
3726,6341620201,168301,6341788502,0,0,1,5120,0,3387997491
3727,6341665812,340062,6342005874,8,0,0,3072,8,3180213406
3728,6341726902,127208,6341854110,9,0,0,210944,9,2330746372
3729,6341909364,172495,6342081859,0,0,0,279040,0,1496007009
3730,6341911237,176831,6342088068,9,0,0,29696,9,5787200186
3731,6341917840,171214,6342089054,3,0,0,1536,3,7554895818
3732,6342061027,35789,6342096816,3,0,1,20480,3,10495478942
3733,6342069740,147248,6342216988,1,0,0,62464,1,1659585100
3734,6342293734,562,6342294296,6,0,1,8704,6,1612288327
3735,6342298719,70972,6342369691,8,0,0,512,8,133087514
3736,6342307498,84471,6342391969,9,0,0,137728,9,7252029397
3737,6342346865,149071,6342495936,9,0,0,241664,9,1868929942
3738,6342386319,110603,6342496922,8,0,0,1536,8,99596012
3739,6342396271,70612,6342466883,4,0,1,6144,4,3971525633
3740,6342407437,76745,6342484182,1,0,1,77824,1,4469830994
3741,6342427616,45817,6342473433,3,0,0,2048,3,7518127005
3742,6342437446,54316,6342491762,7,0,0,59904,7,1286626925
3743,6342470000,14025,6342484025,8,0,0,2560,8,7572541362
3744,6342483518,282565,6342766083,7,0,0,80896,7,7925977854
3745,6342490453,312355,6342802808,8,0,1,16384,8,6921846128
3746,6342518505,234342,6342752847,0,0,1,6656,0,2718615520
3747,6342574212,221797,6342796009,6,0,0,27136,6,10427499434
3748,6342749616,56866,6342806482,0,0,1,2048,0,7566185876
3749,6342858370,42162,6342900532,0,0,0,68608,0,3612169221
3750,6342942497,62664,6343005161,8,0,1,5120,8,6837883994
3751,6343031862,562,6343032424,0,0,1,4608,0,9249074814
3752,6343046042,57436,6343103478,4,0,0,512,4,333559495
3753,6343074485,562,6343075047,4,0,1,35840,4,10400371361
3754,6343139398,102280,6343241678,3,0,0,512,3,6991683445
3755,6343252916,1038,6343253954,4,0,0,1024,4,6789611693
3756,6343281645,48976,6343330621,2,0,1,2048,2,10199051359
3757,6343314278,92270,6343406548,7,0,0,149504,7,6825090279
3758,6343342821,67273,6343410094,8,0,0,5632,8,444127136
3759,6343483625,207175,6343690800,9,0,0,339968,9,4268707359
3760,6343500731,89114,6343589845,5,0,1,22016,5,5539837053
3761,6343502212,50093,6343552305,6,0,1,28160,6,6912713924
3762,6343622679,562,6343623241,6,0,0,75776,6,525267368
3763,6343673451,245593,6343919044,6,0,0,48128,6,1817507447
3764,6343715114,305426,6344020540,8,0,1,8192,8,2210795026
3765,6343730695,135867,6343866562,4,0,0,512,4,9093049233
3766,6343785518,68475,6343853993,0,0,1,2048,0,8968784730
3767,6343900208,50668,6343950876,0,0,1,9728,0,8206836924
3768,6343906219,562,6343906781,4,0,1,2560,4,5509173740
3769,6343912785,103216,6344016001,6,0,1,18944,6,9542123890
3770,6343925652,131635,6344057287,2,0,1,38912,2,6681979403
3771,6344002448,132934,6344135382,4,0,0,512,4,1626155624
3772,6344047342,54266,6344101608,7,0,0,92160,7,2734298876
3773,6344139604,36859,6344176463,1,0,0,65024,1,10603950748
3774,6344211112,1514,6344212626,5,0,1,41984,5,9014336882
3775,6344364131,4846,6344368977,3,0,0,1536,3,5040006900
3776,6344386138,200441,6344586579,4,0,0,5120,4,9907437968
3777,6344393024,91495,6344484519,6,0,0,147968,6,6113025115
3778,6344530609,1990,6344532599,8,0,0,2048,8,7301757642
3779,6344538696,96676,6344635372,3,0,1,16384,3,328937172
3780,6344606123,166933,6344773056,7,0,0,274944,7,7546586487
3781,6344630887,208994,6344839881,9,0,1,8704,9,4084905067
3782,6344669828,178286,6344848114,7,0,1,5120,7,4100236240
3783,6344680553,1940,6344682493,2,0,1,53248,2,8851731046
3784,6344733432,1514,6344734946,1,0,1,22016,1,9479320243
3785,6344823381,5322,6344828703,4,0,1,31232,4,3945018166
3786,6344846728,266447,6345113175,3,0,0,512,3,4137368921
3787,6344898455,23116,6344921571,3,0,0,1536,3,4687794116
3788,6344904712,260032,6345164744,4,0,0,5632,4,3692807541
3789,6344918180,97756,6345015936,9,0,1,20992,9,8058377078
3790,6344925697,238073,6345163770,1,0,0,41472,1,3259730664
3791,6344942410,120373,6345062783,0,0,0,192000,0,7427088307
3792,6344979799,149204,6345129003,2,0,1,50176,2,1151551142
3793,6344986392,145666,6345132058,2,0,1,46592,2,270654288
3794,6344999769,102678,6345102447,5,0,1,32256,5,5135281308
3795,6345091804,137075,6345228879,5,0,1,6144,5,5507898312
3796,6345092502,66480,6345158982,6,0,0,226816,6,7236873547
3797,6345163443,44434,6345207877,8,0,0,512,8,997040756
3798,6345188075,33071,6345221146,3,0,0,4096,3,9869960003
3799,6345236818,1990,6345238808,7,0,0,54272,7,9233457223
3800,6345279900,376567,6345656467,5,0,1,60928,5,3042714918
3801,6345322493,124479,6345446972,9,0,1,15360,9,1335660118
3802,6345331806,27765,6345359571,4,0,0,2048,4,2607767444
3803,6345376633,11800,6345388433,9,0,0,33792,9,4994239083
3804,6345395989,61378,6345457367,8,0,0,3584,8,8338745555
3805,6345418211,102038,6345520249,0,0,0,99328,0,2939117343
3806,6345420915,4370,6345425285,0,0,0,121344,0,9965577425
3807,6345428648,269905,6345698553,5,0,1,12288,5,5066032777
3808,6345429413,183913,6345613326,2,0,1,23552,2,7843087929
3809,6345443328,3418,6345446746,2,0,1,11264,2,10483213544
3810,6345513768,250217,6345763985,6,0,1,45568,6,8837233066
3811,6345543328,259801,6345803129,3,0,0,4608,3,3706500655
3812,6345660795,226286,6345887081,7,0,0,3584,7,3606343064
3813,6345665357,203904,6345869261,0,0,0,330240,0,1079484063
3814,6345790017,147049,6345937066,6,0,0,218112,6,7018551930
3815,6345826749,97606,6345924355,8,0,1,512,8,6704668206
3816,6345843966,3894,6345847860,3,0,0,7168,3,3094544507
3817,6345976234,94863,6346071097,8,0,1,5632,8,6686873977
3818,6346038983,244515,6346283498,8,0,1,36864,8,3486245496
3819,6346062748,23374,6346086122,8,0,0,4096,8,6611352119
3820,6346111456,7023,6346118479,7,0,0,41984,7,6425800981
3821,6346130073,3418,6346133491,8,0,0,3584,8,608508170
3822,6346172682,229543,6346402225,8,0,1,20480,8,1987020935
3823,6346219914,96706,6346316620,4,0,1,1024,4,1903730870
3824,6346228606,73483,6346302089,8,0,0,3584,8,3090771907
3825,6346251818,34684,6346286502,5,0,0,122880,5,1916251291
3826,6346265250,28507,6346293757,4,0,1,39424,4,10080727823
3827,6346292243,180100,6346472343,4,0,0,2560,4,5513071672
3828,6346298574,21654,6346320228,6,0,0,8704,6,6698734023
3829,6346406419,122049,6346528468,3,0,1,7168,3,8172251025
3830,6346407319,125144,6346532463,8,0,1,15360,8,5864915642
3831,6346455243,339238,6346794481,0,0,0,35328,0,9189083417
3832,6346472789,225704,6346698493,6,0,0,366080,6,3310013487
3833,6346573193,106170,6346679363,8,0,1,22528,8,2073825918
3834,6346592989,86627,6346679616,4,0,0,1024,4,4658584985
3835,6346633320,188374,6346821694,0,0,0,74752,0,6782196845
3836,6346651252,162416,6346813668,6,0,1,18432,6,919490888
3837,6346711960,269726,6346981686,7,0,1,12800,7,10106791619
3838,6346793069,136572,6346929641,8,0,1,25088,8,8067709858
3839,6346852631,135354,6346987985,6,0,0,220160,6,198891517
3840,6346951135,1990,6346953125,7,0,1,94208,7,850815062
3841,6346992753,178043,6347170796,2,0,1,13312,2,7160565617
3842,6346992930,272637,6347265567,0,0,1,7680,0,10327774457
3843,6347047276,128869,6347176145,8,0,0,2048,8,9208256583
3844,6347097106,237289,6347334395,2,0,1,7168,2,2263424957
3845,6347196190,143114,6347339304,1,0,1,79360,1,9837074516
3846,6347254158,98536,6347352694,2,0,1,23552,2,1659473400
3847,6347269848,88161,6347358009,6,0,1,17408,6,1299784242
3848,6347290737,168225,6347458962,0,0,0,277504,0,2969858012
3849,6347431689,53321,6347485010,0,0,1,69120,0,5350363111
3850,6347440515,129887,6347570402,0,0,1,1024,0,5194713530
3851,6347483360,183063,6347666423,1,0,0,87040,1,7224623275
3852,6347517156,135525,6347652681,7,0,0,223744,7,2693302214
3853,6347558935,3894,6347562829,1,0,1,1536,1,5262900284
3854,6347654739,193021,6347847760,5,0,1,26112,5,36800283
3855,6347671685,50668,6347722353,5,0,0,4096,5,1051085379
3856,6347732332,223680,6347956012,7,0,1,39424,7,8606765579
3857,6347815952,75302,6347891254,4,0,1,2560,4,3608468078
3858,6347822239,124960,6347947199,8,0,1,2048,8,456458039
3859,6347830080,170965,6348001045,0,0,1,28672,0,10177789304
3860,6347834817,293835,6348128652,3,0,1,21504,3,10360898276
3861,6347908418,177107,6348085525,1,0,1,46592,1,3455809244
3862,6347914297,297096,6348211393,6,0,0,481792,6,1763922803
3863,6347984280,182341,6348166621,2,0,1,3072,2,7323906956
3864,6348045527,277720,6348323247,0,0,0,62464,0,9640600753
3865,6348198501,2942,6348201443,4,0,1,22016,4,2144680293
3866,6348256338,95755,6348352093,6,0,1,15360,6,4186144886
3867,6348284125,6713,6348290838,1,0,1,16384,1,10455214761
3868,6348305365,105457,6348410822,8,0,0,3072,8,5479156275
3869,6348329906,205341,6348535247,4,0,1,4608,4,6802442554
3870,6348373178,291318,6348664496,4,0,0,5120,4,2604699091
3871,6348399346,90484,6348489830,9,0,0,142848,9,4503281963
3872,6348454673,116567,6348571240,5,0,0,193536,5,4246405739
3873,6348463697,166797,6348630494,7,0,1,62464,7,1269837119
3874,6348487454,71503,6348558957,3,0,1,24064,3,931144168
3875,6348600680,179750,6348780430,8,0,1,36864,8,3028416411
3876,6348634241,330165,6348964406,9,0,1,34304,9,7537365808
3877,6348638261,256161,6348894422,9,0,0,115712,9,1013952777
3878,6348681341,234636,6348915977,9,0,1,10240,9,3432434820
3879,6348849744,75808,6348925552,9,0,0,127488,9,7154226350
3880,6348975154,105244,6349080398,5,0,1,45568,5,1513668835
3881,6348986805,641,6348987446,6,0,1,19968,6,7183042031
3882,6349060868,124193,6349185061,0,0,1,4096,0,3972112920
3883,6349080311,78234,6349158545,3,0,0,512,3,2843353381
3884,6349239302,12821,6349252123,7,0,1,65024,7,3712889647
3885,6349253719,111172,6349364891,5,0,0,21504,5,436800424
3886,6349337275,122803,6349460078,7,0,1,59904,7,10337255835
3887,6349358205,113812,6349472017,0,0,0,184832,0,282647842
3888,6349545745,70972,6349616717,2,0,1,19456,2,3563391006
3889,6349562113,97293,6349659406,1,0,1,8704,1,1767809090
3890,6349581809,107027,6349688836,2,0,1,17408,2,3177507374
3891,6349722353,95776,6349818129,9,0,1,24576,9,10085198857
3892,6349794020,58528,6349852548,4,0,1,8192,4,10259768276
3893,6349865252,2466,6349867718,8,0,0,2560,8,193324097
3894,6349970960,100408,6350071368,7,0,1,29696,7,2084800214
3895,6350085089,1038,6350086127,8,0,1,18944,8,2308766271
3896,6350093590,82396,6350175986,0,0,1,20992,0,1409390797
3897,6350125934,97132,6350223066,6,0,0,1024,6,6328793013
3898,6350228133,74516,6350302649,9,0,0,124928,9,6229036512
3899,6350316419,106949,6350423368,7,0,1,27136,7,818868823
3900,6350405821,79432,6350485253,1,0,1,11264,1,3899257571
3901,6350411213,173270,6350584483,9,0,0,280576,9,1217062490
3902,6350473609,176358,6350649967,6,0,1,9216,6,7212069111
3903,6350594282,81887,6350676169,1,0,0,132608,1,6650826525
3904,6350821821,55744,6350877565,2,0,1,30208,2,1040388353
3905,6350841081,99472,6350940553,9,0,1,26624,9,1493823356
3906,6350873231,146278,6351019509,3,0,1,4096,3,5526539883
3907,6350884007,113037,6350997044,0,0,0,183296,0,10354225798
3908,6350899656,128545,6351028201,0,0,0,99840,0,5579049478
3909,6350912319,177621,6351089940,6,0,1,30208,6,3696224503
3910,6351084691,96510,6351181201,4,0,1,8704,4,6998664344
3911,6351113134,164179,6351277313,6,0,0,266240,6,643367323
3912,6351250875,94242,6351345117,6,0,0,391168,6,2808383640
3913,6351290434,238583,6351529017,6,0,0,340992,6,4489055368
3914,6351359987,302760,6351662747,0,0,1,21504,0,1161069613
3915,6351372818,12821,6351385639,0,0,1,26624,0,3860318306
3916,6351458133,197449,6351655582,0,0,1,42496,0,727896682
3917,6351494179,340056,6351834235,3,0,1,23552,3,2715648047
3918,6351640822,200474,6351841296,5,0,0,21504,5,2612048543
3919,6351647769,479475,6352127244,6,0,1,27648,6,8110183958
3920,6351768830,141330,6351910160,7,0,1,1536,7,3571625463
3921,6351800969,173948,6351974917,3,0,1,15360,3,9459583934
3922,6351811895,147472,6351959367,2,0,1,8704,2,8442642688
3923,6351866511,108915,6351975426,0,0,1,9216,0,10542678951
3924,6351991772,81280,6352073052,7,0,1,12288,7,9053719355
3925,6352110637,101032,6352211669,0,0,1,31744,0,7711680198
3926,6352210518,24776,6352235294,6,0,0,42496,6,1674991549
3927,6352226944,13842,6352240786,5,0,0,17920,5,6324024198
3928,6352252088,5798,6352257886,4,0,0,6144,4,3770025932
3929,6352317754,135266,6352453020,7,0,0,223232,7,4434411334
3930,6352377884,5322,6352383206,9,0,1,4608,9,8517775441
3931,6352431242,152068,6352583310,3,0,1,20992,3,1710285926
3932,6352482160,42420,6352524580,8,0,0,5632,8,5238148550
3933,6352588599,214435,6352803034,7,0,0,69120,7,10312682319
3934,6352589150,116099,6352705249,0,0,0,159232,0,2203877882
3935,6352657827,126335,6352784162,1,0,1,11264,1,1354365484
3936,6352771891,54676,6352826567,1,0,1,20480,1,4420476074
3937,6352787076,96019,6352883095,7,0,1,5632,7,10335692823
3938,6352875147,101500,6352976647,3,0,1,33280,3,249852167
3939,6352977845,84556,6353062401,0,0,1,23040,0,1548976553
3940,6352989487,113294,6353102781,3,0,1,19456,3,9880827840
3941,6352997491,276587,6353274078,6,0,0,448512,6,8145788048
3942,6353028543,246099,6353274642,4,0,0,10752,4,9447297139
3943,6353034581,240407,6353274988,8,0,0,512,8,869482440
3944,6353124561,175803,6353300364,6,0,1,47616,6,74592101
3945,6353139963,33480,6353173443,3,0,1,35328,3,1826855512
3946,6353140710,170058,6353310768,9,0,0,133120,9,2581476102
3947,6353162992,264001,6353426993,8,0,1,1536,8,6748024360
3948,6353289446,2942,6353292388,6,0,0,30720,6,9230244732
3949,6353296545,79364,6353375909,9,0,1,39936,9,7811514794
3950,6353345795,309709,6353655504,1,0,1,8192,1,2666655018
3951,6353407111,40857,6353447968,3,0,0,3072,3,4953052821
3952,6353408826,1038,6353409864,1,0,0,57344,1,7167614842
3953,6353538703,346353,6353885056,8,0,0,1024,8,6967092351
3954,6353540281,124854,6353665135,4,0,1,10240,4,7780221396
3955,6353546468,143154,6353689622,1,0,1,23040,1,4899374855
3956,6353576059,129035,6353705094,5,0,0,231936,5,10668171177
3957,6353590844,562,6353591406,9,0,0,1024,9,2897255018
3958,6353625826,227808,6353853634,8,0,1,12288,8,4385746438
3959,6353735039,183165,6353918204,8,0,0,512,8,10241288308
3960,6353906743,118192,6354024935,2,0,1,88064,2,4577490699
3961,6353985346,71762,6354057108,6,0,0,116224,6,7660342912
3962,6353985723,146912,6354132635,6,0,1,5632,6,6745073570
3963,6354044625,94514,6354139139,3,0,1,14336,3,684725572
3964,6354068583,137084,6354205667,6,0,1,8704,6,10098366428
3965,6354138039,109830,6354247869,2,0,1,4096,2,6692081266
3966,6354216930,74356,6354291286,9,0,1,9728,9,5890942091
3967,6354221900,114758,6354336658,0,0,0,189952,0,7840193342
3968,6354243189,182946,6354426135,1,0,1,1536,1,6668554612
3969,6354285575,228322,6354513897,1,0,0,558080,1,10028163408
3970,6354346042,344878,6354690920,9,0,0,398336,9,1190934146
3971,6354349148,293348,6354642496,6,0,1,39424,6,1756938650
3972,6354359910,310377,6354670287,0,0,1,512,0,8355653244
3973,6354364829,402930,6354767759,1,0,1,39936,1,119766807
3974,6354387713,408679,6354796392,2,0,1,23552,2,10293867934
3975,6354444587,356997,6354801584,0,0,0,150528,0,1344260224
3976,6354466343,61378,6354527721,6,0,1,3584,6,1565720400
3977,6354541995,76825,6354618820,1,0,1,11776,1,5472897848
3978,6354652585,257846,6354910431,7,0,1,68608,7,9651438387
3979,6354804453,423074,6355227527,6,0,0,99328,6,10196950049
3980,6354805685,506982,6355312667,5,0,0,63488,5,9647991285
3981,6354820635,190559,6355011194,6,0,0,259072,6,2579848377
3982,6354836424,244837,6355081261,3,0,1,6144,3,8193108694
3983,6354875870,206658,6355082528,1,0,1,7680,1,166369289
3984,6354990189,14039,6355004228,6,0,0,338944,6,9549188013
3985,6355183474,325999,6355509473,3,0,0,1024,3,7589520342
3986,6355420245,72537,6355492782,7,0,0,117760,7,7363659871
3987,6355450281,133981,6355584262,8,0,1,33792,8,595271471
3988,6355549211,89260,6355638471,9,0,1,7680,9,1669582629
3989,6355581445,111950,6355693395,5,0,1,26624,5,8507938836
3990,6355625966,88936,6355714902,1,0,1,10752,1,10608660967
3991,6355631670,347721,6355979391,1,0,0,563712,1,8104501906
3992,6355708766,242032,6355950798,0,0,1,16384,0,4006278339
3993,6355712218,331960,6356044178,9,0,1,31232,9,5307638053
3994,6355753014,317899,6356070913,0,0,0,58368,0,3315761223
3995,6355790534,272777,6356063311,5,0,0,370688,5,8523582518
3996,6355809759,512842,6356322601,3,0,1,4608,3,7191345259
3997,6355840162,278074,6356118236,8,0,0,7168,8,853204985
3998,6355975073,455307,6356430380,4,0,1,38400,4,923233224
3999,6356074321,258139,6356332460,5,0,1,6656,5,5105612940
4000,6356168701,174833,6356343534,3,0,1,20992,3,9788116409
4001,6356287258,57691,6356344949,1,0,1,4608,1,2561039143
4002,6356327471,54613,6356382084,0,0,0,89600,0,2326209773
4003,6356384387,113878,6356498265,1,0,1,10240,1,9655643725
4004,6356432410,69894,6356502304,5,0,1,67584,5,5500136965
4005,6356509322,562,6356509884,1,0,1,5632,1,7602933655
4006,6356526076,119673,6356645749,2,0,1,80384,2,6713222887
4007,6356597037,278901,6356875938,3,0,0,512,3,6710089383
4008,6356649847,100096,6356749943,6,0,1,28672,6,10180606309
4009,6356696578,76921,6356773499,7,0,0,100864,7,6885479975
4010,6356696980,95808,6356792788,4,0,1,17920,4,5993993223
4011,6356710739,1038,6356711777,9,0,1,23040,9,5190495749
4012,6356806193,142319,6356948512,4,0,0,1024,4,603275903
4013,6356997174,74356,6357071530,5,0,1,9728,5,698482476
4014,6357132047,72664,6357204711,2,0,1,9216,2,8008696163
4015,6357217653,60820,6357278473,1,0,1,5632,1,6647744835
4016,6357331105,175079,6357506184,5,0,0,284160,5,10352823013
4017,6357333951,209137,6357543088,1,0,0,127488,1,426001587
4018,6357376147,142098,6357518245,1,0,1,3584,1,7867392740
4019,6357399672,225653,6357625325,0,0,1,2560,0,1593827161
4020,6357443232,183618,6357626850,1,0,0,136704,1,8473796312
4021,6357448370,131508,6357579878,0,0,0,157696,0,5138378224
4022,6357500826,260920,6357761746,8,0,0,512,8,2489655845
4023,6357680887,5450,6357686337,0,0,0,13824,0,837120111
4024,6357681440,82323,6357763763,8,0,1,17920,8,8540050421
4025,6357735591,1514,6357737105,5,0,1,5120,5,3999697858
4026,6357894134,231467,6358125601,3,0,0,1536,3,8590854887
4027,6357936913,96376,6358033289,9,0,1,21504,9,4786876147
4028,6358027148,32608,6358059756,9,0,0,48128,9,2452218938
4029,6358053869,104620,6358158489,7,0,1,43520,7,4382792648
4030,6358106528,60071,6358166599,3,0,1,17408,3,120957657
4031,6358124398,105787,6358230185,9,0,1,512,9,8971061783
4032,6358127268,166029,6358293297,3,0,1,50176,3,8068811896
4033,6358128381,254529,6358382910,0,0,0,412160,0,4972670420
4034,6358177101,76583,6358253684,9,0,1,5632,9,7757668998
4035,6358216523,288369,6358504892,2,0,1,38912,2,412857075
4036,6358370464,289201,6358659665,0,0,0,129024,0,6649076400
4037,6358626526,47284,6358673810,2,0,1,1536,2,5616407284
4038,6358646187,45433,6358691620,7,0,1,2560,7,7751197025
4039,6358691351,148911,6358840262,7,0,0,78336,7,3847130629
4040,6358723501,185721,6358909222,7,0,0,301568,7,3279005654
4041,6358745895,162271,6358908166,9,0,1,50176,9,5146504479
4042,6358799357,81887,6358881244,0,0,0,168960,0,2735536534
4043,6358813432,4416,6358817848,8,0,1,16896,8,3995129662
4044,6358834139,366808,6359200947,8,0,1,4608,8,6695600681
4045,6358927610,172611,6359100221,1,0,0,132608,1,8480469331
4046,6358989390,358593,6359347983,8,0,1,10752,8,683015629
4047,6359032562,355155,6359387717,0,0,0,11776,0,5921898515
4048,6359151562,101188,6359252750,3,0,1,35840,3,930058543
4049,6359177569,209882,6359387451,7,0,1,32256,7,5195836067
4050,6359276003,166167,6359442170,6,0,0,264704,6,4063351403
4051,6359276679,170778,6359447457,3,0,0,16896,3,8586481794
4052,6359290929,156784,6359447713,9,0,0,9216,9,4486104871
4053,6359319840,233272,6359553112,4,0,1,15872,4,590952416
4054,6359323268,204027,6359527295,8,0,1,18944,8,1572391223
4055,6359351445,189277,6359540722,6,0,0,309248,6,10660976720
4056,6359366541,250234,6359616775,4,0,0,512,4,7078200589
4057,6359378066,314788,6359692854,3,0,1,2048,3,8651945486
4058,6359618405,47284,6359665689,4,0,1,52736,4,4223647287
4059,6359633545,118005,6359751550,6,0,1,6656,6,1082448893
4060,6359659975,144813,6359804788,0,0,1,18944,0,6545423796
4061,6359701335,352336,6360053671,0,0,1,1536,0,8636325788
4062,6359954212,79300,6360033512,2,0,1,15872,2,8089489714
4063,6359974245,63448,6360037693,0,0,1,9216,0,5162363032
4064,6360095264,94508,6360189772,0,0,0,157184,0,9791640831
4065,6360096657,119203,6360215860,2,0,1,1024,2,5069513942
4066,6360105658,141653,6360247311,6,0,1,2560,6,2994324717
4067,6360162121,5322,6360167443,2,0,1,39936,2,1118620289
4068,6360265872,134084,6360399956,3,0,0,5632,3,2546667980
4069,6360290629,61643,6360352272,0,0,0,95744,0,2976416920
4070,6360316641,42044,6360358685,6,0,0,30720,6,2108762230
4071,6360353132,123726,6360476858,8,0,1,34816,8,1935868125
4072,6360430966,226133,6360657099,9,0,0,370176,9,2769006041
4073,6360543326,125217,6360668543,7,0,0,38400,7,8630188332
4074,6360741467,137850,6360879317,0,0,0,228352,0,1359413975
4075,6360866932,71503,6360938435,5,0,1,20480,5,4722694633
4076,6360917950,60477,6360978427,5,0,0,115712,5,6668782781
4077,6360932842,262976,6361195818,0,0,0,6144,0,7049101399
4078,6361058843,132253,6361191096,1,0,0,214016,1,1417563708
4079,6361066445,55387,6361121832,8,0,1,31744,8,1133221884
4080,6361156395,74492,6361230887,5,0,0,74240,5,3429363313
4081,6361164031,209695,6361373726,9,0,0,95232,9,7462343055
4082,6361206956,105563,6361312519,6,0,1,7680,6,646247557
4083,6361215197,104116,6361319313,7,0,0,172544,7,1494447395
4084,6361256057,180769,6361436826,0,0,1,11776,0,9566708945
4085,6361390302,72573,6361462875,3,0,1,1024,3,2372461174
4086,6361430108,117506,6361547614,0,0,1,4608,0,1405476462
4087,6361494565,171169,6361665734,0,0,1,3584,0,617439485
4088,6361540503,327124,6361867627,5,0,0,533504,5,2855330008
4089,6361672007,214429,6361886436,0,0,1,20992,0,5149559976
4090,6361690361,295581,6361985942,7,0,0,386048,7,913639037
4091,6361700858,334525,6362035383,5,0,0,138240,5,3199128372
4092,6361750901,327633,6362078534,7,0,1,22528,7,4778032028
4093,6361762578,251655,6362014233,7,0,1,9728,7,3912774985
4094,6361778142,302920,6362081062,9,0,0,2048,9,1805267621
4095,6361799191,262472,6362061663,1,0,0,172032,1,6149864379
4096,6361813873,281988,6362095861,7,0,1,10752,7,70919455
4097,6361819756,3124,6361822880,7,0,1,8704,7,9693539120
4098,6361872667,341457,6362214124,5,0,1,10240,5,2680678308
4099,6361939791,369841,6362309632,1,0,1,26112,1,2998917491
4100,6362003160,334097,6362337257,0,0,1,5120,0,2077534974
4101,6362028068,272299,6362300367,8,0,1,35328,8,689451426
4102,6362131277,172299,6362303576,3,0,1,2560,3,4544978197
4103,6362148526,332822,6362481348,8,0,0,9216,8,1916133821
4104,6362282647,117342,6362399989,0,0,0,195072,0,1759186171
4105,6362300373,171755,6362472128,4,0,1,14848,4,361838090
4106,6362497436,171690,6362669126,1,0,1,2048,1,9311180451
4107,6362583271,70372,6362653643,1,0,1,39424,1,5759445454
4108,6362586517,2466,6362588983,5,0,1,31232,5,8087533506
4109,6362617638,168801,6362786439,0,0,1,11776,0,2339751119
4110,6362699850,27450,6362727300,8,0,0,2560,8,2744782419
4111,6362707300,94620,6362801920,0,0,1,9216,0,7348221802
4112,6362724633,234399,6362959032,0,0,0,39936,0,8499840071
4113,6362873840,48976,6362922816,5,0,1,2048,5,9854077891
4114,6362958337,55744,6363014081,8,0,1,4096,8,2628312524
4115,6363015245,45692,6363060937,1,0,0,78848,1,5843176910
4116,6363017749,72795,6363090544,3,0,1,15360,3,7429382560
4117,6363040435,40688,6363081123,5,0,0,118272,5,6227097669
4118,6363050157,136722,6363186879,2,0,1,32256,2,398550893
4119,6363074168,178257,6363252425,3,0,0,2560,3,8622649266
4120,6363117482,96101,6363213583,0,0,1,4608,0,6503430365
4121,6363216515,282037,6363498552,4,0,1,4608,4,749287805
4122,6363326981,69409,6363396390,4,0,1,6656,4,427886254
4123,6363328347,104896,6363433243,2,0,1,31744,2,8002418362
4124,6363434824,100876,6363535700,5,0,1,31232,5,6371348964
4125,6363526011,103060,6363629071,9,0,1,38400,9,4994785528
4126,6363613004,11815,6363624819,0,0,1,4608,0,6468200195
4127,6363620190,57436,6363677626,3,0,0,3072,3,4961192050
4128,6363747253,5322,6363752575,3,0,0,5632,3,9146126193
4129,6363795257,54052,6363849309,9,0,1,3584,9,1849553444
4130,6363800390,50668,6363851058,8,0,1,2560,8,6486576072
4131,6363846680,235741,6364082421,7,0,0,385536,7,1150881752
4132,6363874772,208635,6364083407,9,0,0,1536,9,6955257707
4133,6364064154,207175,6364271329,5,0,0,339968,5,2325249831
4134,6364068702,201342,6364270044,5,0,1,4608,5,4373719689
4135,6364086564,76293,6364162857,6,0,0,62976,6,7906885986
4136,6364114069,277352,6364391421,7,0,1,29184,7,6269459678
4137,6364178693,273265,6364451958,2,0,1,14336,2,5292863686
4138,6364218231,108158,6364326389,5,0,0,31744,5,7326901228
4139,6364267644,230571,6364498215,3,0,1,2048,3,4947836895
4140,6364280123,133804,6364413927,5,0,1,3072,5,50621717
4141,6364282528,190803,6364473331,0,0,1,51712,0,3123488453
4142,6364307062,131120,6364438182,1,0,0,217088,1,6051780424
4143,6364345829,260513,6364606342,0,0,1,5120,0,4273387583
4144,6364494673,107217,6364601890,6,0,0,178688,6,5346274708
4145,6364675881,2942,6364678823,7,0,1,24064,7,4223775057
4146,6364726200,114760,6364840960,8,0,1,16384,8,4482112883
4147,6364742831,136402,6364879233,7,0,1,76800,7,3282320267
4148,6364784482,93991,6364878473,9,0,0,3072,9,4124444759
4149,6364794210,80004,6364874214,7,0,0,156160,7,1365682363
4150,6364829395,248115,6365077510,0,0,0,76800,0,4107010189
4151,6364876392,155360,6365031752,4,0,1,11264,4,8058281964
4152,6364929596,124624,6365054220,6,0,0,205824,6,3721055796
4153,6364932782,24682,6364957464,5,0,1,3584,5,3178222769
4154,6364957910,163381,6365121291,9,0,1,18944,9,8000758610
4155,6365029884,64433,6365094317,8,0,0,512,8,240863733
4156,6365031741,245012,6365276753,6,0,0,103936,6,3610379219
4157,6365108457,162010,6365270467,9,0,1,13312,9,5931056129
4158,6365127564,186408,6365313972,7,0,0,306176,7,5165096278
4159,6365147839,207453,6365355292,6,0,0,132096,6,657131187
4160,6365180825,237718,6365418543,3,0,1,16896,3,3617700910
4161,6365186009,162166,6365348175,6,0,1,56320,6,7106112496
4162,6365280680,367586,6365648266,6,0,1,1536,6,193276050
4163,6365392687,207762,6365600449,6,0,1,17408,6,7631604740
4164,6365528735,138844,6365667579,5,0,1,28672,5,3354264436
4165,6365663156,1990,6365665146,6,0,1,36864,6,2030679405
4166,6365668077,107007,6365775084,0,0,1,15872,0,3272718418
4167,6365672536,106933,6365779469,8,0,1,61952,8,4722504655
4168,6365702718,134816,6365837534,3,0,0,2048,3,2823632442
4169,6365796672,24408,6365821080,9,0,1,17408,9,1989096797
4170,6365811467,105800,6365917267,6,0,1,40448,6,332351946
4171,6365814002,96749,6365910751,6,0,1,27136,6,8087881922
4172,6365854798,147691,6366002489,7,0,0,44032,7,3081589541
4173,6365937936,327900,6366265836,6,0,0,535040,6,6976954417
4174,6365954951,313151,6366268102,8,0,0,3584,8,8905911102
4175,6365970306,216630,6366186936,0,0,0,83968,0,7827765832
4176,6365986596,323922,6366310518,0,0,0,89600,0,9595690817
4177,6366066905,334885,6366401790,2,0,1,3584,2,3118166535
4178,6366125368,197739,6366323107,8,0,0,2560,8,9970389177
4179,6366240447,84286,6366324733,8,0,0,2560,8,8939181836
4180,6366254564,22951,6366277515,1,0,1,7680,1,1294573918
4181,6366307762,161983,6366469745,5,0,1,48640,5,1700781610
4182,6366312202,1990,6366314192,0,0,0,33280,0,4458602337
4183,6366452282,293818,6366746100,3,0,0,2048,3,9903086438
4184,6366500268,116825,6366617093,1,0,0,194048,1,8749461920
4185,6366641683,71074,6366712757,2,0,1,11776,2,6185927217
4186,6366692220,69280,6366761500,8,0,1,8192,8,8024029253
4187,6366695425,172753,6366868178,1,0,0,279552,1,10468515237
4188,6366701076,77390,6366778466,1,0,1,4608,1,1353760935
4189,6366796792,235995,6367032787,1,0,0,20480,1,8533113177
4190,6366809508,271315,6367080823,8,0,1,32256,8,4722494394
4191,6367022964,23374,6367046338,7,0,1,12800,7,4411349414
4192,6367065915,82972,6367148887,1,0,0,41984,1,79525731
4193,6367260201,562,6367260763,4,0,0,512,4,4185549566
4194,6367312438,52984,6367365422,7,0,1,5120,7,4351737786
4195,6367363298,194554,6367557852,0,0,0,315392,0,4456732865
4196,6367460110,124790,6367584900,6,0,0,88576,6,8324008303
4197,6367519214,562,6367519776,5,0,1,35328,5,6904295958
4198,6367563186,204474,6367767660,7,0,1,2560,7,563204989
4199,6367590024,163148,6367753172,8,0,0,512,8,6694324199
4200,6367789819,20620,6367810439,7,0,0,33280,7,7293376812
4201,6367791683,110979,6367902662,1,0,0,166400,1,9706424076
4202,6367840477,84654,6367925131,9,0,1,16896,9,4234421067
4203,6367882220,168909,6368051129,5,0,1,6656,5,2519473468
4204,6367916517,2466,6367918983,4,0,1,5120,4,10248232545
4205,6367981359,69280,6368050639,3,0,1,8192,3,8363324683
4206,6368017736,210222,6368227958,0,0,0,2560,0,9268571832
4207,6368039827,78700,6368118527,2,0,1,18944,2,9319685515
4208,6368183326,93733,6368277059,7,0,0,155648,7,2930520620
4209,6368291420,1990,6368293410,8,0,0,2048,8,2118454240
4210,6368335445,4416,6368339861,3,0,0,11776,3,493946222
4211,6368363714,5322,6368369036,8,0,1,20992,8,482377466
4212,6368489036,147633,6368636669,5,0,0,5632,5,4389851053
4213,6368515210,100096,6368615306,0,0,1,28672,0,4272403572
4214,6368542960,3894,6368546854,4,0,1,25600,4,9774111711
4215,6368564757,81928,6368646685,2,0,1,19456,2,3022851311
4216,6368604177,161235,6368765412,0,0,1,75264,0,8379243116
4217,6368621644,164302,6368785946,9,0,0,4096,9,4119683024
4218,6368659700,149261,6368808961,7,0,1,20480,7,1248086736
4219,6368799137,8501,6368807638,0,0,1,40448,0,189852404
4220,6368800471,120609,6368921080,1,0,0,10752,1,9556070396
4221,6368873920,82145,6368956065,7,0,0,133120,7,5437908472
4222,6368891685,61178,6368952863,1,0,1,28160,1,5659883904
4223,6368897153,169184,6369066337,8,0,0,3584,8,5204829195
4224,6369032374,43900,6369076274,8,0,1,70656,8,3401053141
4225,6369033117,2466,6369035583,6,0,1,512,6,7312608733
4226,6369078377,21769,6369100146,4,0,1,19456,4,872502311
4227,6369107929,135477,6369243406,8,0,0,2560,8,2654131881
4228,6369108126,145560,6369253686,1,0,0,34304,1,264315991
4229,6369227241,3894,6369231135,4,0,0,4096,4,10701796673
4230,6369238055,1514,6369239569,8,0,0,1536,8,873888616
4231,6369239043,98848,6369337891,1,0,1,24576,1,4564406449
4232,6369303934,84556,6369388490,4,0,1,23040,4,7938462183
4233,6369317969,266204,6369584173,6,0,0,431616,6,6625577897
4234,6369447995,136332,6369584327,4,0,0,8704,4,951026071
4235,6369470066,114620,6369584686,4,0,0,9728,4,8041539654
4236,6369681315,184429,6369865744,7,0,0,299008,7,1737069235
4237,6369785320,303545,6370088865,0,0,1,85504,0,8626213864
4238,6369988788,100556,6370089344,9,0,1,1536,9,2195914231
4239,6370172411,84212,6370256623,7,0,0,137216,7,251598663
4240,6370243883,17925,6370261808,7,0,0,24576,7,1653804023
4241,6370304829,26734,6370331563,1,0,0,48640,1,3659367493
4242,6370355465,155346,6370510811,6,0,0,252416,6,203483668
4243,6370423584,357763,6370781347,1,0,0,569344,1,7927730745
4244,6370604991,131951,6370736942,5,0,1,26112,5,4686109207
4245,6370652302,1514,6370653816,8,0,0,4608,8,5208828232
4246,6370760987,231612,6370992599,1,0,1,3584,1,10209589935
4247,6370793833,1514,6370795347,9,0,0,1536,9,2302961580
4248,6370846750,200956,6371047706,2,0,1,59392,2,6569677674
4249,6370856652,140065,6370996717,3,0,1,30720,3,9399521629
4250,6370889360,132253,6371021613,8,0,1,28160,8,4933921379
4251,6370893435,103428,6370996863,4,0,0,1536,4,3662007307
4252,6370909087,256174,6371165261,6,0,0,214016,6,7293092781
4253,6370968762,127866,6371096628,0,0,0,98304,0,8743565172
4254,6370977409,313413,6371290822,7,0,1,7680,7,6941463882
4255,6371115194,96058,6371211252,1,0,0,160256,1,8501798156
4256,6371242061,562,6371242623,1,0,0,512,1,9123214006
4257,6371324375,158359,6371482734,0,0,0,261632,0,7303387790
4258,6371335997,147723,6371483720,4,0,0,1536,4,9853977674
4259,6371384914,274498,6371659412,7,0,0,412672,7,10128219307
4260,6371504896,159342,6371664238,3,0,0,7680,3,3477306568
4261,6371672059,25700,6371697759,3,0,1,4096,3,6617753497
4262,6371879370,244363,6372123733,0,0,0,46592,0,1744560546
4263,6371896227,562,6371896789,2,0,1,5632,2,7219301677
4264,6371921314,60820,6371982134,1,0,1,512,1,2913330925
4265,6371925082,163718,6372088800,9,0,0,512,9,2694804837
4266,6372031049,66458,6372097507,1,0,0,112640,1,5271328605
4267,6372073670,26103,6372099773,8,0,0,3584,8,220188488
4268,6372117519,5329,6372122848,3,0,0,5632,3,6518049482
4269,6372122821,562,6372123383,3,0,0,512,3,219986366
4270,6372128881,1990,6372130871,8,0,0,2048,8,6445363958
4271,6372150191,562,6372150753,3,0,0,512,3,8540011507
4272,6372198427,2466,6372200893,9,0,0,2560,9,3042881198
4273,6372241167,1514,6372242681,3,0,0,1536,3,2566265375
4274,6372243882,101362,6372345244,6,0,0,163840,6,8265074116
4275,6372246344,139937,6372386281,7,0,1,101888,7,1732815525
4276,6372247754,198555,6372446309,6,0,0,145920,6,389509361
4277,6372363306,348947,6372712253,4,0,1,14336,4,10336720143
4278,6372490216,71908,6372562124,2,0,1,37376,2,2789653494
4279,6372548029,209385,6372757414,4,0,1,53760,4,9547816363
4280,6372601038,215585,6372816623,4,0,1,11776,4,8794491446
4281,6372629762,165413,6372795175,6,0,1,82944,6,5469495872
4282,6372659581,163506,6372823087,5,0,1,26112,5,3241797898
4283,6372683199,268958,6372952157,6,0,0,440320,6,6716873314
4284,6372698420,204340,6372902760,1,0,0,262144,1,5281796966
4285,6372723679,335917,6373059596,4,0,0,1024,4,5609852206
4286,6372804265,311324,6373115589,4,0,1,17920,4,6709766944
4287,6372925531,111418,6373036949,8,0,0,3072,8,3921234705
4288,6372949319,114678,6373063997,1,0,0,96768,1,1617674088
4289,6372963021,194029,6373157050,5,0,1,19456,5,2185857204
4290,6373098603,13508,6373112111,9,0,1,1024,9,2676260329
4291,6373184223,133767,6373317990,6,0,0,26112,6,525594535
4292,6373187844,3641,6373191485,6,0,1,73728,6,4121074658
4293,6373261941,4933,6373266874,6,0,1,37888,6,4942871634
4294,6373366511,142097,6373508608,0,0,0,10240,0,3512308105
4295,6373372220,55744,6373427964,7,0,1,4096,7,3723095330
4296,6373387550,272822,6373660372,7,0,0,12800,7,9161845769
4297,6373454730,17457,6373472187,0,0,0,18944,0,7505585934
4298,6373538890,56680,6373595570,2,0,1,7168,2,9061372758
4299,6373542380,132084,6373674464,0,0,1,112128,0,3550643589
4300,6373803518,5322,6373808840,7,0,1,22528,7,1259533696
4301,6373884208,98224,6373982432,9,0,0,5632,9,2954100685
4302,6373889739,62512,6373952251,3,0,1,6144,3,2130760037
4303,6374017139,1038,6374018177,4,0,0,1024,4,420280163
4304,6374024747,44916,6374069663,0,0,0,77312,0,5223925791
4305,6374110430,137075,6374247505,1,0,1,4096,1,7144819043
4306,6374114665,118587,6374233252,7,0,0,226816,7,9270023636
4307,6374132484,178608,6374311092,5,0,0,330752,5,5087296205
4308,6374155631,255517,6374411148,1,0,1,20992,1,4267507880
4309,6374184598,198623,6374383221,1,0,0,274432,1,5100431984
4310,6374210247,286402,6374496649,7,0,0,16384,7,8521000451
4311,6374227808,265938,6374493746,0,0,1,13312,0,10584484020
4312,6374236095,272280,6374508375,4,0,1,15872,4,1869589537
4313,6374266107,134447,6374400554,7,0,1,14336,7,6551420556
4314,6374365652,106834,6374472486,5,0,0,81408,5,9849982776
4315,6374418314,339947,6374758261,1,0,0,87552,1,7105527369
4316,6374534719,146425,6374681144,6,0,0,241664,6,3220883692
4317,6374537035,219340,6374756375,6,0,0,244736,6,10728346710
4318,6374610992,172021,6374783013,1,0,0,86528,1,4330336487
4319,6374648052,203278,6374851330,5,0,0,220672,5,1520121066
4320,6374680047,430865,6375110912,7,0,0,540672,7,10014510667
4321,6374689497,407846,6375097343,8,0,1,512,8,9780049255
4322,6374703412,234447,6374937859,8,0,0,512,8,9262687598
4323,6374766212,207833,6374974045,5,0,1,6656,5,3873511855
4324,6374788259,6678,6374794937,4,0,1,26624,4,4458266999
4325,6374797375,1038,6374798413,5,0,1,17408,5,4401954259
4326,6374843106,367930,6375211036,5,0,1,27136,5,3358532540
4327,6374877477,323211,6375200688,8,0,0,1024,8,7997047407
4328,6374885569,519450,6375405019,7,0,1,18432,7,9105893047
4329,6374904450,427989,6375332439,9,0,0,9728,9,10360177814
4330,6375099088,1058,6375100146,0,0,1,16896,0,1940484185
4331,6375101399,95708,6375197107,6,0,1,8704,6,5268829263
4332,6375109151,503788,6375612939,8,0,0,5632,8,2157772936
4333,6375122498,485746,6375608244,4,0,0,1024,4,9465748763
4334,6375176660,2466,6375179126,3,0,1,3072,3,1656133082
4335,6375225336,279734,6375505070,8,0,0,1024,8,5711428079
4336,6375261663,323246,6375584909,1,0,1,27648,1,7489738062
4337,6375332467,238216,6375570683,6,0,0,2560,6,1451581007
4338,6375434075,36859,6375470934,8,0,1,21504,8,9870482278
4339,6375435471,123622,6375559093,2,0,1,4096,2,9847691629
4340,6375442783,144686,6375587469,4,0,1,10240,4,6472307636
4341,6375502720,139109,6375641829,7,0,0,65024,7,5550747153
4342,6375540722,53062,6375593784,0,0,0,86528,0,7966198299
4343,6375543660,51430,6375595090,8,0,0,2048,8,2310610330
4344,6375547773,134769,6375682542,1,0,0,189952,1,6517635872
4345,6375581083,107156,6375688239,1,0,0,27136,1,2030963008
4346,6375601454,87771,6375689225,8,0,0,1536,8,4515875969
4347,6375668644,37056,6375705700,5,0,0,54272,5,872444322
4348,6375705439,6274,6375711713,6,0,0,6656,6,4925900863
4349,6375834096,101968,6375936064,2,0,1,34816,2,1051745024
4350,6375919881,52963,6375972844,5,0,1,2048,5,5553067835
4351,6375919920,116310,6376036230,0,0,0,193024,0,5232580159
4352,6375921104,116470,6376037574,5,0,1,11264,5,10548732894
4353,6375923626,99170,6376022796,6,0,0,6144,6,6379395896
4354,6375939462,188119,6376127581,9,0,1,56832,9,8014758364
4355,6375941592,2942,6375944534,8,0,0,1024,8,936958527
4356,6376064736,300902,6376365638,6,0,1,47104,6,4138565853
4357,6376106578,189999,6376296577,2,0,1,52736,2,613065498
4358,6376170103,39027,6376209130,8,0,0,3072,8,5277693640
4359,6376223369,181690,6376405059,9,0,0,8192,9,4285715328
4360,6376268573,99940,6376368513,6,0,1,28160,6,1830672672
4361,6376308428,1990,6376310418,2,0,1,34816,2,1892392268
4362,6376430304,151099,6376581403,4,0,0,2048,4,1351806740
4363,6376454117,142219,6376596336,0,0,0,226304,0,10221836331
4364,6376641942,59769,6376701711,2,0,1,3072,2,1435258502
4365,6376687355,101812,6376789167,3,0,1,34304,3,3185647128
4366,6376797687,6750,6376804437,6,0,1,9216,6,7440107018
4367,6376821063,5967,6376827030,6,0,0,7168,6,7571904207
4368,6376823526,72664,6376896190,4,0,0,14848,4,10180818999
4369,6376845490,50668,6376896158,2,0,1,2560,2,994852205
4370,6376877159,52360,6376929519,6,0,1,3072,6,8265166416
4371,6376908012,112757,6377020769,6,0,1,7168,6,6127375824
4372,6376953249,124624,6377077873,7,0,0,205824,7,7274937090
4373,6377023054,124108,6377147162,7,0,0,204800,7,1808991748
4374,6377064546,38083,6377102629,2,0,1,1536,2,9773350113
4375,6377109425,1514,6377110939,4,0,0,512,4,2384934869
4376,6377126689,5798,6377132487,3,0,1,6144,3,4777378910
4377,6377198460,169092,6377367552,9,0,0,1536,9,337074688
4378,6377210026,271690,6377481716,9,0,0,6144,9,111079748
4379,6377373194,54096,6377427290,5,0,0,88576,5,7861827296
4380,6377427373,162887,6377590260,5,0,0,263680,5,1299744718
4381,6377480146,39454,6377519600,2,0,1,3584,2,10325088556
4382,6377557424,131181,6377688605,0,0,0,31744,0,9313781923
4383,6377703892,118819,6377822711,1,0,1,4608,1,10609572316
4384,6377849443,73288,6377922731,0,0,1,11264,0,1035111150
4385,6377872910,52672,6377925582,9,0,1,4096,9,5739876412
4386,6377958536,125488,6378084024,5,0,0,204288,5,4711617854
4387,6378034914,50096,6378085010,9,0,0,1536,9,6303974581
4388,6378153654,2466,6378156120,5,0,1,24576,5,5477738283
4389,6378176162,94240,6378270402,3,0,0,2560,3,856420507
4390,6378197813,5798,6378203611,5,0,1,14848,5,4142448975
4391,6378238253,90467,6378328720,7,0,1,4096,7,5672658845
4392,6378239854,67598,6378307452,8,0,1,30720,8,2193678744
4393,6378251280,150321,6378401601,4,0,0,6144,4,5274578096
4394,6378347874,83752,6378431626,2,0,1,15360,2,7958562469
4395,6378390224,54052,6378444276,3,0,1,3584,3,1398380416
4396,6378443344,1486,6378444830,8,0,0,512,8,8329510359
4397,6378505249,5322,6378510571,6,0,1,15872,6,5296443965
4398,6378536458,93124,6378629582,7,0,0,5632,7,3232824643
4399,6378549783,132253,6378682036,7,0,0,214016,7,6354531919
4400,6378632666,159795,6378792461,2,0,1,3584,2,2959302721
4401,6378738547,91711,6378830258,5,0,1,512,5,1720048235
4402,6378768996,62954,6378831950,4,0,1,1024,4,6652345635
4403,6378880957,59128,6378940085,1,0,1,5120,1,4414684168
4404,6379036732,34275,6379071007,7,0,0,59904,7,5653553777
4405,6379106435,3383,6379109818,4,0,0,9728,4,7786804149
4406,6379141053,1038,6379142091,3,0,0,1024,3,3344245033
4407,6379158933,7226,6379166159,9,0,0,7680,9,6768821694
4408,6379246007,33846,6379279853,5,0,0,55808,5,6038054030
4409,6379322623,36342,6379358965,4,0,1,19456,4,8288060463
4410,6379348775,86536,6379435311,5,0,0,64000,5,2720697516
4411,6379408699,3394,6379412093,9,0,0,3072,9,3214722437
4412,6379495662,96317,6379591979,7,0,0,160768,7,105895404
4413,6379505882,87083,6379592965,4,0,0,1536,4,1602025006
4414,6379555174,27394,6379582568,7,0,1,29696,7,8132638909
4415,6379567197,18280,6379585477,9,0,0,2560,9,271979684
4416,6379577937,142782,6379720719,3,0,0,2560,3,9637660020
4417,6379650959,132253,6379783212,5,0,0,214016,5,683058250
4418,6379811901,135499,6379947400,6,0,1,33280,6,4604946948
4419,6379820906,314762,6380135668,5,0,0,509440,5,688243739
4420,6379853417,282597,6380136014,4,0,0,512,4,8083062586
4421,6379878129,289247,6380167376,0,0,0,100864,0,3680772771
4422,6379902909,264813,6380167722,3,0,0,512,3,4443219105
4423,6379904256,277417,6380181673,8,0,1,40960,8,9433779296
4424,6379975870,205814,6380181684,1,0,0,37376,1,7041240523
4425,6380066005,111384,6380177389,5,0,1,8704,5,7098990662
4426,6380070311,43821,6380114132,9,0,0,3072,9,7389272226
4427,6380137885,562,6380138447,4,0,0,512,4,5331608944
4428,6380196548,272245,6380468793,1,0,1,11776,1,2656404232
4429,6380240874,160241,6380401115,3,0,1,7680,3,4034220275
4430,6380244792,204168,6380448960,8,0,0,512,8,9992163806
4431,6380290477,176248,6380466725,5,0,1,16384,5,5948315826
4432,6380602968,5322,6380608290,8,0,0,5632,8,9838177424
4433,6380629501,82920,6380712421,3,0,1,65024,3,8524850301
4434,6380644228,1990,6380646218,0,0,0,134656,0,5359977995
4435,6380658186,202084,6380860270,6,0,1,53248,6,1093593620
4436,6380741186,11750,6380752936,2,0,1,37888,2,3477407865
4437,6380769469,202482,6380971951,3,0,0,2048,3,9067131292
4438,6380791991,93379,6380885370,4,0,1,7168,4,9268895312
4439,6380824502,181086,6381005588,3,0,0,12288,3,3109559955
4440,6380844405,170111,6381014516,6,0,1,40960,6,7079135407
4441,6380878176,179681,6381057857,0,0,1,39424,0,7959733082
4442,6380948714,121958,6381070672,1,0,1,32256,1,4996470814
4443,6381005396,78260,6381083656,6,0,1,12800,6,8408009906
4444,6381107577,55744,6381163321,3,0,1,4096,3,9830134662
4445,6381166226,105556,6381271782,6,0,1,46592,6,292799187
4446,6381329963,562,6381330525,7,0,1,46592,7,843224699
4447,6381403583,105556,6381509139,3,0,0,512,3,10439310467
4448,6381447894,98848,6381546742,1,0,1,24576,1,9993418316
4449,6381512097,57436,6381569533,2,0,1,4608,2,4304162437
4450,6381546557,54697,6381601254,5,0,1,5120,5,2368926268
4451,6381619039,562,6381619601,9,0,0,512,9,8253771091
4452,6381655236,2466,6381657702,6,0,0,2560,6,3199492526
4453,6381659051,4846,6381663897,9,0,0,5120,9,9902275383
4454,6381676514,5322,6381681836,4,0,0,5632,4,2280538206
4455,6381726214,122872,6381849086,9,0,1,103424,9,8386318439
4456,6381839518,92997,6381932515,7,0,0,135680,7,515403240
4457,6381859052,295647,6382154699,5,0,1,76800,5,3189745487
4458,6381999929,177317,6382177246,7,0,0,291840,7,6448426362
4459,6382016148,186815,6382202963,1,0,0,90112,1,8119632484
4460,6382049785,158324,6382208109,7,0,0,8192,7,8571031776
4461,6382084846,59695,6382144541,4,0,1,14336,4,8179701097
4462,6382124796,148188,6382272984,4,0,1,53248,4,6006257096
4463,6382131501,192517,6382324018,6,0,1,18432,6,2151898615
4464,6382152600,114028,6382266628,6,0,0,6656,6,5628783915
4465,6382167859,237060,6382404919,7,0,1,9728,7,661911170
4466,6382185553,283460,6382469013,4,0,1,27648,4,236658091
4467,6382275446,186795,6382462241,8,0,1,12288,8,10587703292
4468,6382282113,327809,6382609922,9,0,1,20480,9,4634350531
4469,6382462271,43108,6382505379,7,0,1,4096,7,10694113028
4470,6382506014,94320,6382600334,9,0,1,15872,9,6297495747
4471,6382529868,14800,6382544668,9,0,1,15872,9,1991644961
4472,6382540120,2942,6382543062,0,0,0,73728,0,9528187729
4473,6382541362,189143,6382730505,4,0,1,14336,4,811241840
4474,6382595289,163741,6382759030,1,0,0,28672,1,4794112433
4475,6382617108,189731,6382806839,9,0,0,3072,9,6697788236
4476,6382716655,47852,6382764507,7,0,0,77312,7,4850245687
4477,6382880638,1514,6382882152,9,0,0,1536,9,6841057470
4478,6382924317,1514,6382925831,4,0,1,1024,4,5017877698
4479,6382942510,45592,6382988102,6,0,0,1536,6,7852991370
4480,6383012350,114916,6383127266,8,0,1,77312,8,4886232745
4481,6383250253,100096,6383350349,8,0,1,28672,8,3019166263
4482,6383332289,106336,6383438625,4,0,1,49152,4,8780602119
4483,6383428267,96418,6383524685,3,0,1,17920,3,7651898468
4484,6383451254,146763,6383598017,1,0,1,97280,1,5646249446
4485,6383596934,97392,6383694326,1,0,0,160768,1,8964326538
4486,6383664055,41408,6383705463,1,0,0,45056,1,8351958215
4487,6383666933,38290,6383705223,3,0,1,13312,3,1114141813
4488,6383667839,149169,6383817008,4,0,0,1024,4,6354935229
4489,6383718965,83440,6383802405,4,0,1,12288,4,1865915728
4490,6383797606,249915,6384047521,6,0,1,17920,6,2044490607
4491,6383902201,170514,6384072715,4,0,1,17920,4,7661285009
4492,6384072646,3003,6384075649,4,0,0,3072,4,9124431663
4493,6384093524,2466,6384095990,8,0,0,2560,8,8323807864
4494,6384117826,1514,6384119340,6,0,0,1536,6,2292429950
4495,6384198941,105400,6384304341,4,0,1,46080,4,9391729793
4496,6384320658,225616,6384546274,7,0,0,369152,7,2314579266
4497,6384325699,167182,6384492881,3,0,1,1024,3,4303713501
4498,6384367971,251100,6384619071,7,0,1,19456,7,3341445567
4499,6384380078,1990,6384382068,4,0,0,1536,4,10589199803
4500,6384570583,295019,6384865602,7,0,1,22016,7,9049507086
4501,6384581749,126404,6384708153,9,0,0,2048,9,4828978073
4502,6384603930,63504,6384667434,5,0,1,4608,5,6804685143
4503,6384661648,167708,6384829356,4,0,1,14336,4,6827308463
4504,6384662432,129850,6384792282,5,0,0,102400,5,9758473296
4505,6384828806,117298,6384946104,6,0,1,56320,6,1584156923
4506,6384903065,43050,6384946115,5,0,0,65024,5,3182728174
4507,6384916899,222552,6385139451,0,0,0,354816,0,3669296013
4508,6384988380,256493,6385244873,3,0,1,20480,3,5838626798
4509,6385212313,102893,6385315206,5,0,1,8704,5,1760032251
4510,6385319286,14800,6385334086,8,0,1,3584,8,4733815684
4511,6385346639,54052,6385400691,0,0,0,28672,0,7669977284
4512,6385365168,43971,6385409139,5,0,0,72192,5,1842852354
4513,6385405147,5618,6385410765,6,0,0,2560,6,1579492909
4514,6385510115,1514,6385511629,6,0,0,1536,6,5725026350
4515,6385525521,102952,6385628473,2,0,1,9216,2,5066592824
4516,6385583942,67456,6385651398,3,0,1,12288,3,6224790675
4517,6385595006,69910,6385664916,6,0,1,5120,6,7751534099
4518,6385600019,76730,6385676749,6,0,1,4096,6,4072109019
4519,6385749641,14800,6385764441,1,0,0,28672,1,9799717347
4520,6385799286,1038,6385800324,3,0,1,37376,3,5334936150
4521,6385800283,2942,6385803225,8,0,0,1024,8,961920366
4522,6385882440,131670,6386014110,1,0,1,7680,1,9649560007
4523,6385911406,67588,6385978994,4,0,0,3072,4,1258894584
4524,6385930935,91369,6386022304,2,0,1,10752,2,3675805597
4525,6385951623,162451,6386114074,2,0,1,83968,2,1150742126
4526,6386036794,108573,6386145367,3,0,1,36352,3,3405834210
4527,6386080283,74863,6386155146,5,0,0,122368,5,596719779
4528,6386093086,4846,6386097932,3,0,1,5120,3,4233922158
4529,6386193198,2942,6386196140,9,0,0,5120,9,1802022828
4530,6386217691,133130,6386350821,9,0,0,3072,9,4325906849
4531,6386232766,47284,6386280050,2,0,1,11264,2,10193066712
4532,6386251441,74824,6386326265,5,0,1,5120,5,2539791307
4533,6386252877,59128,6386312005,9,0,1,1536,9,2585440603
4534,6386379507,5798,6386385305,8,0,0,6144,8,3122150030
4535,6386490259,1990,6386492249,3,0,0,2048,3,1314955115
4536,6386547785,45592,6386593377,8,0,1,9728,8,9946725850
4537,6386568143,71284,6386639427,0,0,1,1024,0,10124463740
4538,6386601569,89920,6386691489,7,0,1,20480,7,9106422831
4539,6386772691,48976,6386821667,8,0,1,2048,8,9960309605
4540,6386805405,57436,6386862841,9,0,1,4608,9,231188691
4541,6386813887,54613,6386868500,5,0,0,89600,5,6055894995
4542,6386847935,26876,6386874811,1,0,0,22016,1,2898962211
4543,6386951057,125141,6387076198,0,0,0,206848,0,1772924975
4544,6386951736,128968,6387080704,3,0,0,7168,3,6360015339
4545,6386951760,130532,6387082292,0,0,0,15872,0,8362993836
4546,6386968765,291553,6387260318,5,0,1,28672,5,3992347612
4547,6386973549,244852,6387218401,3,0,1,33280,3,3621803304
4548,6387022601,189239,6387211840,8,0,1,7680,8,10100084250
4549,6387090090,319870,6387409960,3,0,1,2048,3,4980250491
4550,6387377210,32983,6387410193,1,0,0,57344,1,5053005087
4551,6387382246,114317,6387496563,3,0,1,3072,3,10726698561
4552,6387497457,23462,6387520919,1,0,0,38912,1,4253425243
4553,6387500579,83139,6387583718,9,0,1,9728,9,4050365386
4554,6387593458,3418,6387596876,3,0,0,3584,3,2538500952
4555,6387593859,54792,6387648651,9,0,1,3584,9,3315996959
4556,6387599224,71596,6387670820,9,0,1,10752,9,1380745564
4557,6387649592,103216,6387752808,1,0,1,38912,1,8848083703
4558,6387698996,88072,6387787068,7,0,1,19456,7,4580298034
4559,6387778003,9076,6387787079,6,0,0,4608,6,1082211078
4560,6387858327,95020,6387953347,0,0,1,27136,0,8132543684
4561,6387891546,126950,6388018496,1,0,0,210432,1,1312484679
4562,6387912547,106295,6388018842,6,0,0,512,6,4188246481
4563,6387960027,10075,6387970102,8,0,1,57856,8,665925601
4564,6388009945,3418,6388013363,7,0,0,13824,7,9474154005
4565,6388095398,171401,6388266799,4,0,0,3584,4,7017849910
4566,6388134553,90520,6388225073,8,0,1,17408,8,7385031297
4567,6388162317,85095,6388247412,8,0,1,12288,8,3889444689
4568,6388314574,2942,6388317516,9,0,1,15872,9,2650277105
4569,6388316536,6274,6388322810,6,0,1,22016,6,9036483549
4570,6388336054,73156,6388409210,8,0,0,3072,8,9957709751
4571,6388345040,562,6388345602,9,0,0,6656,9,9230343549
4572,6388407242,136384,6388543626,0,0,1,72192,0,7272862622
4573,6388415392,130428,6388545820,4,0,0,512,4,7883673771
4574,6388506516,31173,6388537689,1,0,0,42496,1,4561313423
4575,6388508882,30294,6388539176,6,0,0,1536,6,10319329377
4576,6388572902,2466,6388575368,9,0,0,2560,9,2102463174
4577,6388577719,2942,6388580661,2,0,1,1024,2,7874905363
4578,6388581328,45592,6388626920,9,0,0,3072,9,6062986572
4579,6388588598,98380,6388686978,5,0,1,23040,5,3553019926
4580,6388643267,45592,6388688859,3,0,1,1024,3,551315097
4581,6388728831,77608,6388806439,6,0,1,15360,6,3111565163
4582,6388743270,127297,6388870567,7,0,1,64512,7,6883661370
4583,6388856704,77042,6388933746,1,0,0,102912,1,6922544243
4584,6388992006,105231,6389097237,7,0,1,6656,7,7238029719
4585,6389014576,136264,6389150840,6,0,1,8192,6,4746112271
4586,6389018719,126450,6389145169,9,0,1,2560,9,9325445622
4587,6389048812,475987,6389524799,0,0,0,770048,0,6270499731
4588,6389060504,489950,6389550454,3,0,1,11776,3,10529036129
4589,6389061692,394979,6389456671,7,0,0,87552,7,7288408733
4590,6389083522,207948,6389291470,7,0,1,29696,7,5957831400
4591,6389117890,170720,6389288610,8,0,1,7680,8,9493524146
4592,6389159569,506962,6389666531,0,0,0,4608,0,7154993383
4593,6389163285,501039,6389664324,3,0,1,26624,3,2744084539
4594,6389314173,469022,6389783195,5,0,1,34816,5,2691112452
4595,6389347266,432328,6389779594,6,0,0,1024,6,7004932507
4596,6389385480,383243,6389768723,4,0,0,1536,4,4669376912
4597,6389596127,147458,6389743585,5,0,0,243712,5,1176329503
4598,6389602829,141422,6389744251,6,0,0,1024,6,8856312615
4599,6389634188,135780,6389769968,1,0,0,81920,1,7865780652
4600,6389668286,182984,6389851270,7,0,0,256000,7,2082078228
4601,6389697870,143997,6389841867,2,0,1,23040,2,240163454
4602,6389708579,182311,6389890890,9,0,0,2048,9,2045143523
4603,6389732812,339742,6390072554,5,0,1,34304,5,906937172
4604,6389918249,132089,6390050338,5,0,1,25600,5,9123929674
4605,6389933605,207175,6390140780,0,0,0,339968,0,5147240418
4606,6389997850,125101,6390122951,2,0,1,33280,2,2829179857
4607,6390017945,22946,6390040891,6,0,0,3584,6,10651906384
4608,6390027536,233040,6390260576,4,0,1,6656,4,6074215651
4609,6390042364,347460,6390389824,0,0,1,10240,0,9144211813
4610,6390141934,407484,6390549418,0,0,0,37888,0,3567894684
4611,6390189260,250971,6390440231,5,0,0,601600,5,5296398969
4612,6390207352,340641,6390547993,5,0,1,6144,5,4523542945
4613,6390210507,368916,6390579423,0,0,1,16896,0,7757411714
4614,6390356485,110844,6390467329,7,0,1,56320,7,5177103663
4615,6390442179,142174,6390584353,8,0,1,29696,8,8759173313
4616,6390448958,1514,6390450472,6,0,0,2560,6,10183293665
4617,6390469205,385493,6390854698,1,0,1,26112,1,6245152187
4618,6390596640,145391,6390742031,4,0,0,1536,4,2739557423
4619,6390605917,327739,6390933656,5,0,0,239616,5,3267596228
4620,6390649151,223860,6390873011,0,0,0,314368,0,332903184
4621,6390781757,91965,6390873722,1,0,1,14336,1,6993612740
4622,6390783952,219822,6391003774,8,0,0,4608,8,1024840868
4623,6390820269,112003,6390932272,0,0,1,19456,0,431491915
4624,6390857887,249445,6391107332,8,0,1,69120,8,1935146071
4625,6390935648,34791,6390970439,0,0,0,181248,0,5665796582
4626,6391031480,369692,6391401172,7,0,1,4096,7,9742625475
4627,6391080493,164993,6391245486,7,0,1,12288,7,5867155104
4628,6391120568,7702,6391128270,5,0,0,60928,5,7962073153
4629,6391171073,116451,6391287524,7,0,1,8704,7,2660824859
4630,6391180878,216210,6391397088,3,0,1,11776,3,9954340532
4631,6391228114,2466,6391230580,1,0,0,8192,1,9265143096
4632,6391314258,157890,6391472148,4,0,0,2560,4,8349596698
4633,6391338515,807,6391339322,8,0,0,512,8,3647435667
4634,6391352974,25700,6391378674,7,0,1,13312,7,8744579655
4635,6391388806,88558,6391477364,0,0,0,46592,0,2674288357
4636,6391569898,135008,6391704906,7,0,0,222720,7,1343427482
4637,6391573420,133752,6391707172,9,0,0,3584,9,5979418537
4638,6391659288,52390,6391711678,9,0,0,7168,9,9091889317
4639,6391664430,34275,6391698705,0,0,1,19968,0,10025241966
4640,6391694382,2466,6391696848,5,0,0,59904,5,2894668828
4641,6391777095,211077,6391988172,6,0,0,2560,6,1660684232
4642,6391845486,3383,6391848869,4,0,1,4096,4,5284657362
4643,6391859495,68896,6391928391,7,0,1,18944,7,10330583794
4644,6391896344,90988,6391987332,6,0,0,9728,6,3684616846
4645,6391903447,142637,6392046084,0,0,0,230912,0,5000779657
4646,6391912192,191123,6392103315,7,0,0,192000,7,2342393069
4647,6391934927,175117,6392110044,5,0,0,229888,5,5344192112
4648,6391967553,240404,6392207957,3,0,0,1024,3,677490943
4649,6391971512,208444,6392179956,0,0,1,53248,0,8327343168
4650,6391998958,188585,6392187543,5,0,0,38912,5,601953083
4651,6392049302,252341,6392301643,7,0,1,51200,7,6668710012
4652,6392054493,247161,6392301654,0,0,0,299520,0,4299445935
4653,6392073810,257894,6392331704,7,0,0,113152,7,6470633240
4654,6392077555,254815,6392332370,4,0,0,1024,4,2716714161
4655,6392170107,164849,6392334956,1,0,0,4096,1,7719009932
4656,6392210708,17828,6392228536,4,0,1,32768,4,6101505183
4657,6392221556,302074,6392523630,3,0,1,8704,3,7740976316
4658,6392319074,348752,6392667826,9,0,0,3072,9,838682448
4659,6392363701,257800,6392621501,5,0,0,421888,5,3470446766
4660,6392439463,182704,6392622167,3,0,0,1024,3,8155334885
4661,6392554097,68736,6392622833,3,0,0,1024,3,8221555729
4662,6392582828,7859,6392590687,2,0,1,29184,2,5041917870
4663,6392617560,91495,6392709055,1,0,0,4096,1,8522552265
4664,6392681558,248431,6392929989,4,0,1,44032,4,867101749
4665,6392720533,186338,6392906871,0,0,0,147968,0,1070307334
4666,6392752712,7970,6392760682,7,0,1,50176,7,3957569246
4667,6392860480,154405,6393014885,6,0,0,512,6,2753855398
4668,6392975498,54613,6393030111,7,0,0,89600,7,10237461173
4669,6392988174,80615,6393068789,0,0,0,111616,0,1905860143
4670,6393003166,3894,6393007060,9,0,1,30208,9,5102198721
4671,6393069478,3894,6393073372,8,0,0,4096,8,2410729885
4672,6393101830,312796,6393414626,8,0,0,4096,8,8882233029
4673,6393240769,3418,6393244187,0,0,1,45056,0,8223997548
4674,6393256839,182554,6393439393,9,0,1,7680,9,3661417203
4675,6393305415,110987,6393416402,0,0,1,77312,0,6065600725
4676,6393332834,181648,6393514482,1,0,1,2048,1,9017467106
4677,6393432018,260033,6393692051,8,0,0,3584,8,9424015324
4678,6393481058,25075,6393506133,6,0,0,5632,6,1315162450
4679,6393481935,31087,6393513022,5,0,0,16896,5,6942199968
4680,6393516874,2942,6393519816,3,0,0,3072,3,2251838006
4681,6393527196,3124,6393530320,7,0,1,5632,7,2671521813
4682,6393578276,61019,6393639295,9,0,0,9216,9,3757593907
4683,6393591882,175079,6393766961,7,0,0,284160,7,6448549470
4684,6393636809,130498,6393767307,9,0,0,512,9,3936844927
4685,6393708515,59778,6393768293,6,0,0,1536,6,1066256976
4686,6393712353,287658,6394000011,5,0,0,470016,5,6722837059
4687,6393734534,287494,6394022028,5,0,0,80896,5,4038529855
4688,6393779200,187476,6393966676,7,0,0,87552,7,3795709351
4689,6393782363,203912,6393986275,5,0,1,512,5,1209160906
4690,6393845174,269897,6394115071,7,0,1,2560,7,7766374741
4691,6393849935,343799,6394193734,5,0,1,12288,5,1640985632
4692,6394103601,186666,6394290267,3,0,0,306688,3,923735123
4693,6394133589,3418,6394137007,0,0,1,37888,0,4252027831
4694,6394248593,271337,6394519930,8,0,1,15360,8,7760422981
4695,6394312290,88589,6394400879,6,0,0,3584,6,10374910355
4696,6394395629,250031,6394645660,6,0,1,15872,6,7958760947
4697,6394547952,6750,6394554702,5,0,1,13312,5,1633407487
4698,6394552068,84664,6394636732,4,0,0,7168,4,5031765441
4699,6394626808,104464,6394731272,5,0,1,43008,5,3040960270
4700,6394628088,113335,6394741423,5,0,1,33280,5,9083320149
4701,6394631410,91877,6394723287,7,0,1,29696,7,8243089782
4702,6394653213,137278,6394790491,1,0,1,1536,1,8981306527
4703,6394776194,562,6394776756,7,0,1,12800,7,3318911023
4704,6394782337,70684,6394853021,4,0,0,512,4,4390008342
4705,6394956899,99784,6395056683,2,0,1,27648,2,3214861417
4706,6395020772,319583,6395340355,0,0,0,522240,0,9610937782
4707,6395037586,246888,6395284474,0,0,0,179200,0,7448806653
4708,6395082455,355584,6395438039,8,0,1,26112,8,3556868467
4709,6395109950,316534,6395426484,7,0,1,5632,7,9245916340
4710,6395128842,394813,6395523655,6,0,1,6144,6,6782226418
4711,6395136877,473826,6395610703,0,0,0,756224,0,42192983
4712,6395137991,565008,6395702999,9,0,1,12288,9,1170738294
4713,6395155442,546789,6395702231,4,0,0,512,4,8764567517
4714,6395192403,511454,6395703857,6,0,0,2560,6,9510627236
4715,6395209190,554986,6395764176,8,0,1,121856,8,3161211246
4716,6395375635,356322,6395731957,6,0,1,12288,6,5207411368
4717,6395407865,348442,6395756307,7,0,0,181760,7,9850142053
4718,6395415756,75547,6395491303,6,0,0,4608,6,7509403169
4719,6395582322,65471,6395647793,5,0,1,18944,5,8050138649
4720,6395689344,434233,6396123577,1,0,0,2048,1,9762378674
4721,6395700406,137973,6395838379,8,0,0,1536,8,1990213311
4722,6395710283,324245,6396034528,7,0,1,6144,7,3004350991
4723,6395788679,2942,6395791621,3,0,1,25088,3,8685509797
4724,6395957766,562,6395958328,9,0,0,3072,9,8249686274
4725,6395993474,300986,6396294460,6,0,0,512,6,2711104330
4726,6396012592,5708,6396018300,1,0,1,14336,1,4365473059
4727,6396133251,1514,6396134765,6,0,0,14336,6,8770976990
4728,6396147984,5192,6396153176,4,0,0,1536,4,1902861195
4729,6396161005,162000,6396323005,0,0,0,13312,0,8005626192
4730,6396252485,2466,6396254951,7,0,0,2560,7,3889126010
4731,6396412911,85158,6396498069,0,0,0,142336,0,2229035941
4732,6396418018,190620,6396608638,0,0,1,16384,0,1288846838
4733,6396652172,5322,6396657494,2,0,1,3584,2,1416017232
4734,6396689444,54052,6396743496,8,0,0,5632,8,7214558850
4735,6396826190,1038,6396827228,2,0,1,14848,2,3996209342
4736,6396854029,2942,6396856971,6,0,0,1024,6,8281853176
4737,6396858834,95357,6396954191,8,0,0,3072,8,1818542976
4738,6396944803,74356,6397019159,9,0,1,9728,9,6983694846
4739,6397079863,42937,6397122800,0,0,0,70144,0,10262442537
4740,6397180855,2466,6397183321,9,0,1,10752,9,8428390015
4741,6397247355,77740,6397325095,8,0,0,2560,8,5550204560
4742,6397262991,3418,6397266409,9,0,0,3584,9,8514639457
4743,6397328889,10753,6397339642,8,0,1,53760,8,1194094572
4744,6397351985,25700,6397377685,5,0,0,17408,5,1538216213
4745,6397364225,107740,6397471965,8,0,1,83968,8,2537001498
4746,6397365506,161632,6397527138,3,0,0,46592,3,7912832345
4747,6397475784,114907,6397590691,6,0,1,31744,6,5368595781
4748,6397624931,71161,6397696092,3,0,1,18432,3,522993101
4749,6397625009,77008,6397702017,9,0,1,2048,9,3134442407
4750,6397628737,148796,6397777533,1,0,1,48640,1,9878795731
4751,6397774778,80487,6397855265,5,0,1,10752,5,8175031196
4752,6397777566,108599,6397886165,6,0,1,16384,6,7022163370
4753,6397831616,84088,6397915704,4,0,1,21504,4,3696674600
4754,6397877109,110008,6397987117,4,0,1,47104,4,5782532529
4755,6397901356,86864,6397988220,8,0,1,3584,8,7003707790
4756,6397901425,134532,6398035957,7,0,1,46080,7,5670757572
4757,6398070699,45592,6398116291,8,0,1,1024,8,4004884941
4758,6398137979,1514,6398139493,9,0,0,1536,9,9432908198
4759,6398165629,93484,6398259113,7,0,1,27136,7,1080378852
4760,6398194233,66927,6398261160,2,0,1,6656,2,4717590594
4761,6398243610,17561,6398261171,5,0,0,29184,5,5704167581
4762,6398251704,13067,6398264771,1,0,0,10240,1,309135688
4763,6398423320,62380,6398485700,6,0,1,19456,6,2187317920
4764,6398432671,100148,6398532819,5,0,1,10752,5,9499370033
4765,6398551461,4846,6398556307,9,0,0,5120,9,4991568267
4766,6398560114,2466,6398562580,3,0,1,5632,3,5327226072
4767,6398582858,53140,6398635998,6,0,0,2560,6,7645702006
4768,6398626603,20878,6398647481,5,0,0,33792,5,3338851480
4769,6398795518,34533,6398830051,2,0,1,13824,2,10632204559
4770,6398817769,5359,6398823128,0,0,0,60416,0,8242839214
4771,6398849529,69460,6398918989,9,0,0,4096,9,6765429579
4772,6398867091,562,6398867653,8,0,0,512,8,1382525290
4773,6398905312,562,6398905874,9,0,0,512,9,3568983406
4774,6398924174,3124,6398927298,0,0,1,33792,0,5124886478
4775,6398963864,101656,6399065520,1,0,0,9216,1,9972446295
4776,6399010706,69280,6399079986,8,0,1,57344,8,6104908088
4777,6399050106,126163,6399176269,9,0,1,8192,9,1384567528
4778,6399077462,135525,6399212987,0,0,0,223744,0,836339857
4779,6399082447,129849,6399212296,6,0,1,16896,6,162022284
4780,6399083804,229545,6399313349,4,0,0,1024,4,6978840920
4781,6399258542,247675,6399506217,5,0,0,405504,5,4288471212
4782,6399323418,81559,6399404977,1,0,1,11264,1,2144796377
4783,6399446163,277439,6399723602,7,0,0,78336,7,4113872593
4784,6399459615,164260,6399623875,0,0,0,249344,0,9897949066
4785,6399555370,73997,6399629367,5,0,0,17920,5,4886915885
4786,6399565921,125810,6399691731,7,0,0,200192,7,9991923721
4787,6399655302,1038,6399656340,6,0,1,112128,6,3550402102
4788,6399746902,272222,6400019124,8,0,0,1024,8,630902213
4789,6399852225,31038,6399883263,7,0,1,74240,7,5263080105
4790,6399898485,23332,6399921817,4,0,0,2048,4,7923723137
4791,6399908777,562,6399909339,8,0,0,4096,8,3605602453
4792,6400002102,5322,6400007424,9,0,0,512,9,7166079922
4793,6400005982,238748,6400244730,6,0,0,5632,6,3548621371
4794,6400031529,22525,6400054054,4,0,1,68096,4,7770067450
4795,6400038275,18609,6400056884,3,0,1,2048,3,6077638955
4796,6400069996,88527,6400158523,8,0,0,1536,8,6049808954
4797,6400075218,174739,6400249957,1,0,0,2048,1,1417435857
4798,6400078429,62459,6400140888,5,0,1,17920,5,713263606
4799,6400143820,133321,6400277141,7,0,0,69120,7,5664283592
4800,6400176175,44658,6400220833,7,0,0,76800,7,5553456297
4801,6400204483,17656,6400222139,9,0,0,2048,9,111897167
4802,6400334177,2466,6400336643,8,0,0,2560,8,10229873581
4803,6400402653,2866,6400405519,1,0,0,8704,1,7022540265
4804,6400563338,24150,6400587488,5,0,0,43520,5,1771117041
4805,6400574018,58373,6400632391,0,0,1,4096,0,8546929834
4806,6400724041,7226,6400731267,6,0,0,7680,6,10669240461
4807,6400745979,124712,6400870691,7,0,0,202752,7,3891540100
4808,6400760336,115501,6400875837,1,0,0,8192,1,9705894609
4809,6400762202,138974,6400901176,8,0,1,512,8,7043952160
4810,6400769632,195969,6400965601,8,0,1,14336,8,7280338088
4811,6400856147,145133,6401001280,3,0,0,239104,3,7122716775
4812,6400908740,76808,6400985548,0,0,1,27136,0,10599597750
4813,6400928018,1514,6400929532,4,0,0,5632,4,7230550803
4814,6401138075,301582,6401439657,2,0,1,2560,2,10366700579
4815,6401169597,94646,6401264243,1,0,0,1536,1,1327422722
4816,6401203309,56137,6401259446,1,0,1,2560,1,1994616828
4817,6401340842,23891,6401364733,0,0,0,43008,0,10037733705
4818,6401482050,2942,6401484992,0,0,1,5120,0,4950488845
4819,6401482190,59128,6401541318,2,0,1,5120,2,7648632544
4820,6401520473,60559,6401581032,1,0,0,3072,1,4353877423
4821,6401545943,1038,6401546981,9,0,0,1024,9,1347287331
4822,6401581307,102904,6401684211,3,0,1,37888,3,6372141125
4823,6401641519,48976,6401690495,9,0,1,2048,9,3268612072
4824,6401654670,100096,6401754766,0,0,1,28672,0,10071298919
4825,6401708770,100252,6401809022,1,0,1,29184,1,35688414
4826,6401738745,134333,6401873078,6,0,1,15360,6,1795205820
4827,6401915519,79144,6401994663,2,0,1,15360,2,3781941162
4828,6402047436,1990,6402049426,4,0,0,2048,4,3058008527
4829,6402049271,7226,6402056497,8,0,1,10240,8,3987090933
4830,6402114472,81331,6402195803,9,0,0,7680,9,10647564383
4831,6402154932,59440,6402214372,5,0,1,6144,5,1397579262
4832,6402234788,11787,6402246575,5,0,0,19456,5,3498534034
4833,6402289171,3124,6402292295,9,0,0,9216,9,8033707896
4834,6402298120,82552,6402380672,2,0,1,21504,2,10525080807
4835,6402626652,7702,6402634354,0,0,0,8192,0,7800306579
4836,6402682526,47284,6402729810,1,0,1,1536,1,4045745188
4837,6402773260,4370,6402777630,3,0,1,27648,3,4757975605
4838,6402800468,99784,6402900252,8,0,0,4608,8,9486629120
4839,6402830079,103170,6402933249,5,0,0,167424,5,6111169399
4840,6402867220,251908,6403119128,6,0,1,15872,6,5954432835
4841,6402945399,202739,6403148138,6,0,1,4096,6,1798068543
4842,6403096184,82440,6403178624,3,0,1,12288,3,2792111795
4843,6403220739,64391,6403285130,6,0,0,108544,6,3957538508
4844,6403280022,166550,6403446572,7,0,1,10752,7,9392937633
4845,6403332258,236521,6403568779,6,0,1,58880,6,2157241987
4846,6403438803,158434,6403597237,6,0,1,47616,6,8386431609
4847,6403723882,2466,6403726348,8,0,0,2560,8,3395175966
4848,6403728116,33329,6403761445,3,0,0,54784,3,39173503
4849,6403858956,4370,6403863326,1,0,0,4608,1,1729509666
4850,6403901250,97156,6403998406,7,0,1,24064,7,2398839439
4851,6403926222,162628,6404088850,6,0,0,263168,6,1257828312
4852,6403982913,111224,6404094137,6,0,0,16896,6,3746060098
4853,6403996858,56918,6404053776,0,0,1,512,0,5423086251
4854,6404003506,64775,6404068281,2,0,1,30208,2,694783380
4855,6404037885,20116,6404058001,1,0,0,1024,1,2208992165
4856,6404041370,4933,6404046303,6,0,0,46080,6,4438297284
4857,6404069892,202969,6404272861,8,0,1,3072,8,6968980202
4858,6404092033,122891,6404214924,3,0,0,20480,3,10237229823
4859,6404131504,217111,6404348615,3,0,1,16896,3,977342514
4860,6404143427,302498,6404445925,4,0,0,12800,4,7232774741
4861,6404169039,234020,6404403059,7,0,0,378880,7,2800901301
4862,6404411431,562,6404411993,8,0,0,512,8,6090709704
4863,6404504832,10753,6404515585,5,0,0,17408,5,738931216
4864,6404520890,11012,6404531902,9,0,1,61440,9,6040933099
4865,6404543454,138881,6404682335,9,0,1,13312,9,4210349259
4866,6404543734,163315,6404707049,3,0,1,2560,3,2566862320
4867,6404572163,143743,6404715906,7,0,1,27648,7,8189802875
4868,6404618835,233255,6404852090,8,0,1,6144,8,9102116446
4869,6404620356,182597,6404802953,2,0,1,14848,2,8285254393
4870,6404630898,179104,6404810002,6,0,0,17920,6,1844676430
4871,6404636170,219620,6404855790,4,0,1,75776,4,3477060954
4872,6404653587,190541,6404844128,4,0,1,66048,4,6144250869
4873,6404665276,238865,6404904141,6,0,0,272384,6,9845387059
4874,6404740752,26088,6404766840,7,0,1,19968,7,9838244728
4875,6404774657,154170,6404928827,3,0,1,12800,3,1481361122
4876,6404779750,159121,6404938871,0,0,1,1536,0,5323023373
4877,6404824744,228130,6405052874,9,0,1,53760,9,10388453145
4878,6404826372,24238,6404850610,4,0,1,16384,4,10725894460
4879,6404834987,246916,6405081903,9,0,0,9728,9,2176804988
4880,6404949188,117489,6405066677,3,0,1,3072,3,5489863443
4881,6404958550,127798,6405086348,6,0,1,14336,6,9191294713
4882,6404996908,78232,6405075140,5,0,0,40448,5,9649455621
4883,6405037220,319031,6405356251,9,0,1,17408,9,5859502256
4884,6405123475,82816,6405206291,9,0,1,12288,9,8215143680
4885,6405191392,5967,6405197359,7,0,1,13312,7,10269683518
4886,6405215787,86200,6405301987,9,0,0,14848,9,7687896117
4887,6405243001,48976,6405291977,3,0,1,19968,3,1521616467
4888,6405298812,151328,6405450140,6,0,1,2048,6,8609239019
4889,6405330276,76048,6405406324,2,0,1,10240,2,1507631296
4890,6405453855,1514,6405455369,8,0,1,40448,8,279431760
4891,6405457878,92080,6405549958,9,0,1,22528,9,10270020831
4892,6405482502,108438,6405590940,4,0,1,9216,4,9946617409
4893,6405509429,133789,6405643218,9,0,0,1536,9,3204279330
4894,6405757523,6750,6405764273,4,0,0,7168,4,7878843249
4895,6405795629,5798,6405801427,9,0,0,6144,9,16461594
4896,6405802366,21654,6405824020,8,0,1,30208,8,6813654018
4897,6405816471,109665,6405926136,0,0,0,35328,0,2828734886
4898,6405845228,9921,6405855149,1,0,1,6144,1,8456912787
4899,6405903140,115451,6406018591,8,0,0,1024,8,6885389919
4900,6405996885,81370,6406078255,7,0,0,131584,7,8086538566
4901,6406025812,337785,6406363597,7,0,0,1071616,7,4546644647
4902,6406131303,454972,6406586275,7,0,0,20480,7,5780795046
4903,6406167397,672810,6406840207,3,0,1,6144,3,3121172198
4904,6406205338,573323,6406778661,5,0,1,73728,5,9842101534
4905,6406211746,492959,6406704705,9,0,1,6144,9,2328393287
4906,6406212653,496251,6406708904,1,0,0,1536,1,4385869977
4907,6406220805,550912,6406771717,6,0,0,38400,6,2410846015
4908,6406239835,414093,6406653928,1,0,1,33280,1,4225327082
4909,6406343892,359542,6406703434,0,0,1,5632,0,3428065960
4910,6406398454,290755,6406689209,0,0,0,111616,0,8964478986
4911,6406425841,251028,6406676869,2,0,1,32256,2,7771199267
4912,6406467252,96213,6406563465,4,0,0,512,4,6454867313
4913,6406506990,562654,6407069644,4,0,0,9216,4,7638000986
4914,6406534891,306137,6406841028,1,0,1,15360,1,673629904
4915,6406661816,445549,6407107365,9,0,0,5632,9,10473930995
4916,6406738165,293138,6407031303,8,0,1,24064,8,7996214432
4917,6406835098,276687,6407111785,0,0,0,836608,0,8047671235
4918,6406838099,264367,6407102466,0,0,1,16384,0,5051911929
4919,6407004534,313751,6407318285,0,0,1,11776,0,6243222193
4920,6407020936,517003,6407537939,7,0,1,10752,7,3115311566
4921,6407021527,336475,6407358002,7,0,0,19968,7,3283948340
4922,6407037312,568812,6407606124,7,0,1,20480,7,7447382824
4923,6407062179,275232,6407337411,3,0,1,20992,3,9280149593
4924,6407131690,65696,6407197386,6,0,0,149504,6,7411925056
4925,6407297455,398641,6407696096,2,0,1,49664,2,1761165485
4926,6407298708,192608,6407491316,8,0,1,35840,8,9541036387
4927,6407341237,562,6407341799,9,0,0,11776,9,2246995258
4928,6407451032,384651,6407835683,6,0,1,51200,6,10736987090
4929,6407650556,248996,6407899552,8,0,0,512,8,8776063699
4930,6407808831,103216,6407912047,8,0,1,38912,8,5447611869
4931,6407866659,51253,6407917912,7,0,0,82944,7,4912263011
4932,6407972148,84383,6408056531,6,0,1,29696,6,3936122532
4933,6407974719,169073,6408143792,5,0,1,6144,5,10372516538
4934,6408019710,1038,6408020748,3,0,0,140800,3,3425542711
4935,6408021492,178874,6408200366,7,0,1,18944,7,4747066269
4936,6408153034,6155,6408159189,1,0,0,1024,1,3365510060
4937,6408198573,243593,6408442166,3,0,0,4608,3,5531534871
4938,6408348328,116050,6408464378,0,0,0,192512,0,1507717182
4939,6408405548,40612,6408446160,2,0,1,16384,2,6396182305
4940,6408456343,26475,6408482818,3,0,0,65536,3,8650348291
4941,6408517536,226147,6408743683,0,0,0,48128,0,6679490778
4942,6408527465,4846,6408532311,0,0,1,8192,0,936317994
4943,6408607954,5322,6408613276,9,0,1,18432,9,5419444496
4944,6408646066,141689,6408787755,4,0,0,5120,4,7124900944
4945,6408660645,11529,6408672174,8,0,0,5632,8,4718393020
4946,6408716802,47440,6408764242,0,0,1,2048,0,9070540153
4947,6408747515,215692,6408963207,9,0,0,18944,9,5299648599
4948,6408750443,77756,6408828199,7,0,0,122368,7,2362440425
4949,6408769932,68789,6408838721,6,0,0,33792,6,2814071772
4950,6408786839,24168,6408811007,5,0,1,5632,5,929902696
4951,6408814899,73717,6408888616,8,0,0,512,8,2975184122
4952,6409044897,3894,6409048791,4,0,0,4096,4,6378501050
4953,6409129083,2466,6409131549,1,0,0,2560,1,6042263774
4954,6409168856,1514,6409170370,4,0,1,66560,4,8622141865
4955,6409200099,3418,6409203517,8,0,0,1536,8,3895522712
4956,6409203145,111640,6409314785,8,0,0,3584,8,7114531498
4957,6409347449,69616,6409417065,8,0,1,14336,8,5433499441
4958,6409442777,5322,6409448099,6,0,1,84992,6,177976095
4959,6409476216,5322,6409481538,4,0,0,5632,4,3003595429
4960,6409527150,117256,6409644406,7,0,0,5632,7,1738029804
4961,6409620324,54525,6409674849,3,0,0,92672,3,10726955437
4962,6409703189,1514,6409704703,1,0,0,1536,1,2793292765
4963,6409850975,1990,6409852965,4,0,0,2048,4,2273721570
4964,6409855459,562,6409856021,1,0,0,512,1,4530549919
4965,6409995586,100720,6410096306,9,0,1,30720,9,1646635848
4966,6410091151,97676,6410188827,5,0,0,150016,5,10621144468
4967,6410105560,85213,6410190773,1,0,0,3072,1,7772461729
4968,6410222979,59128,6410282107,4,0,1,5120,4,5197192143
4969,6410290645,88624,6410379269,8,0,1,7168,8,2220070244
4970,6410330343,378354,6410708697,7,0,0,613376,7,813533295
4971,6410369928,307473,6410677401,2,0,1,71168,2,5311642090
4972,6410401570,197796,6410599366,8,0,0,512,8,10426621564
4973,6410445469,160750,6410606219,7,0,1,33792,7,86807017
4974,6410513833,95886,6410609719,9,0,0,4096,9,9114450141
4975,6410551865,89647,6410641512,4,0,0,1536,4,2976887379
4976,6410608643,562,6410609205,5,0,1,14336,5,6979983465
4977,6410627047,4675,6410631722,0,0,0,32768,0,10299874764
4978,6410635232,459943,6411095175,8,0,0,3072,8,2917510543
4979,6410680055,400900,6411080955,9,0,1,4096,9,747948838
4980,6410758683,167573,6410926256,9,0,0,512,9,4909736378
4981,6410766556,267113,6411033669,8,0,0,12288,8,5699488723
4982,6410798024,158644,6410956668,7,0,1,3072,7,5106868626
4983,6410846292,131838,6410978130,3,0,1,34304,3,4572262659
4984,6410865592,25245,6410890837,2,0,1,66560,2,5807702658
4985,6410969486,18671,6410988157,6,0,0,32256,6,8841424904
4986,6410980886,225922,6411206808,4,0,0,7680,4,5674521470
4987,6411018384,96561,6411114945,3,0,1,30720,3,218600458
4988,6411076057,2466,6411078523,5,0,0,131072,5,5156671624
4989,6411161104,268774,6411429878,9,0,1,55808,9,5451549360
4990,6411228933,4933,6411233866,4,0,0,2560,4,2642181350
4991,6411260735,25442,6411286177,6,0,1,41472,6,2381337972
4992,6411295101,103996,6411399097,3,0,0,12800,3,232411233
4993,6411309916,562,6411310478,6,0,0,46080,6,7544270414
4994,6411342618,295841,6411638459,7,0,1,37376,7,6310562461
4995,6411431335,5322,6411436657,8,0,0,512,8,6489807588
4996,6411442081,157863,6411599944,7,0,1,33280,7,3829010725
4997,6411457275,27527,6411484802,1,0,0,5632,1,4710139608
4998,6411499421,116356,6411615777,0,0,0,48128,0,4512096280
4999,6411583535,122645,6411706180,6,0,0,198656,6,10514847000
5000,6411660416,62034,6411722450,7,0,0,61440,7,1255081776
5001,6411719107,7226,6411726333,6,0,1,6656,6,5506683760
5002,6411740424,562,6411740986,1,0,0,7680,1,9160013837
5003,6411843525,47284,6411890809,2,0,1,1536,2,1657160840
5004,6411884178,188194,6412072372,4,0,0,512,4,1227861267
5005,6411891096,76672,6411967768,8,0,1,12288,8,5058258762
5006,6412080545,1514,6412082059,4,0,0,1536,4,2639094931
5007,6412091877,60820,6412152697,4,0,1,5632,4,3486795792
5008,6412109340,74512,6412183852,6,0,1,10240,6,7478483434
5009,6412199452,1038,6412200490,7,0,1,11776,7,10260307690
5010,6412207216,14800,6412222016,4,0,0,1024,4,8676606770
5011,6412226445,80292,6412306737,3,0,0,28672,3,4415877638
5012,6412425719,562,6412426281,4,0,0,512,4,9883362180
5013,6412426226,82684,6412508910,6,0,1,16896,6,5668820775
5014,6412467238,67588,6412534826,8,0,1,7680,8,6483087075
5015,6412533560,106346,6412639906,0,0,1,45056,0,1696216950
5016,6412572311,105569,6412677880,3,0,1,12288,3,3098549710
5017,6412671169,53062,6412724231,0,0,0,86528,0,4422143672
5018,6412771691,14541,6412786232,5,0,0,28160,5,9082227134
5019,6412845481,110423,6412955904,0,0,1,20992,0,2182141775
5020,6412980305,77296,6413057601,5,0,1,14336,5,287371788
5021,6413117994,61444,6413179438,9,0,1,57344,9,657989984
5022,6413132925,108832,6413241757,8,0,1,7680,8,5521535731
5023,6413157974,69175,6413227149,4,0,1,1024,4,465989611
5024,6413266893,62929,6413329822,5,0,0,102400,5,4327293147
5025,6413267901,227549,6413495450,0,0,0,324096,0,9810733276
5026,6413307493,255966,6413563459,5,0,0,219136,5,7637893566
5027,6413415837,184526,6413600363,0,0,0,119296,0,9728977468
5028,6413462937,255704,6413718641,4,0,1,4608,4,1702514372
5029,6413525092,196104,6413721196,6,0,1,52224,6,10086568557
5030,6413535457,303144,6413838601,3,0,1,72192,3,8079241436
5031,6413613537,394842,6414008379,7,0,0,318464,7,2424308898
5032,6413613652,306301,6413919953,6,0,0,329728,6,4191493877
5033,6413670768,249196,6413919964,1,0,0,3584,1,3802281191
5034,6413786350,141435,6413927785,0,0,0,45568,0,4770260586
5035,6413906160,11325,6413917485,4,0,1,40960,4,3077224884
5036,6413919366,105925,6414025291,9,0,0,4608,9,2275144928
5037,6413960891,74863,6414035754,6,0,0,176128,6,8585679174
5038,6414019249,238484,6414257733,9,0,1,37888,9,5073732332
5039,6414030822,182990,6414213812,9,0,1,34304,9,7675620505
5040,6414101397,420753,6414522150,6,0,0,122368,6,2514991441
5041,6414128531,141022,6414269553,4,0,1,2560,4,9220155194
5042,6414185902,56765,6414242667,6,0,0,218624,6,566408061
5043,6414193499,56705,6414250204,5,0,1,19968,5,6684650847
5044,6414213429,354686,6414568115,9,0,1,8704,9,1287335171
5045,6414242581,197663,6414440244,2,0,1,1024,2,6248618850
5046,6414249385,205584,6414454969,8,0,1,23552,8,1639226758
5047,6414270170,271853,6414542023,7,0,0,24576,7,5137029754
5048,6414289954,247503,6414537457,0,0,0,67584,0,3573997337
5049,6414302192,210590,6414512782,6,0,0,392192,6,3045659078
5050,6414339451,408698,6414748149,8,0,0,512,8,305582593
5051,6414389735,212473,6414602208,0,0,0,174592,0,6220179599
5052,6414420123,186318,6414606441,4,0,0,7168,4,2193913073
5053,6414455701,278588,6414734289,0,0,0,407040,0,10329924067
5054,6414619564,92880,6414712444,9,0,1,2048,9,2721786488
5055,6414636363,36342,6414672705,3,0,1,18944,3,9017530286
5056,6414641755,28804,6414670559,1,0,0,512,1,9385414278
5057,6414723594,562,6414724156,3,0,0,64000,3,61099660
5058,6414732758,1514,6414734272,9,0,0,2560,9,428700079
5059,6414743207,191099,6414934306,5,0,1,20992,5,7722081175
5060,6414783162,211888,6414995050,1,0,0,512,1,9931722415
5061,6414813774,7226,6414821000,9,0,0,1536,9,3915084074
5062,6414927797,287442,6415215239,8,0,0,7680,8,5538753021
5063,6415050659,1514,6415052173,9,0,0,1536,9,2160927811
5064,6415073138,11270,6415084408,5,0,0,18432,5,5972215877
5065,6415081271,186238,6415267509,3,0,0,302592,3,9524759122
5066,6415108227,127066,6415235293,2,0,1,2048,2,7091534441
5067,6415160952,88127,6415249079,0,0,1,14336,0,6756690820
5068,6415221624,5322,6415226946,3,0,0,144896,3,3470951326
5069,6415242589,263737,6415506326,2,0,1,42496,2,5128180016
5070,6415355678,562,6415356240,4,0,0,5632,4,9876844839
5071,6415416000,211161,6415627161,8,0,0,512,8,255295897
5072,6415437804,76205,6415514009,6,0,1,1024,6,4901277295
5073,6415519289,186011,6415705300,7,0,1,29696,7,9332231943
5074,6415648140,114898,6415763038,6,0,1,51712,6,9790336040
5075,6415701880,27053,6415728933,4,0,1,16384,4,9669332506
5076,6415735996,116784,6415852780,6,0,0,28672,6,761696483
5077,6415821562,97288,6415918850,3,0,1,19456,3,4430835196
5078,6415865349,194554,6416059903,6,0,0,315392,6,4083455235
5079,6415870106,195186,6416065292,6,0,0,17408,6,6025214922
5080,6415966983,101855,6416068838,0,0,0,5632,0,8679231024
5081,6416040807,5322,6416046129,5,0,1,10240,5,3643988422
5082,6416139601,195720,6416335321,5,0,1,13824,5,294101769
5083,6416154642,85787,6416240429,8,0,0,5632,8,9253500541
5084,6416154744,212665,6416367409,5,0,0,140288,5,3080837777
5085,6416272667,257283,6416529950,3,0,0,420864,3,1468698926
5086,6416345305,185311,6416530616,1,0,0,1024,1,6801357514
5087,6416520504,208467,6416728971,0,0,0,342528,0,2474435869
5088,6416591408,66060,6416657468,2,0,1,9728,2,8253262133
5089,6416665177,196098,6416861275,8,0,0,3584,8,3854573722
5090,6416690937,21395,6416712332,8,0,1,80896,8,10029373375
5091,6416782826,217208,6417000034,0,0,1,38400,0,10101571341
5092,6416794391,7702,6416802093,3,0,1,101376,3,7250414912
5093,6416844480,65170,6416909650,7,0,0,34816,7,5068224015
5094,6416845676,177225,6417022901,6,0,1,15360,6,9735749834
5095,6416861657,186736,6417048393,3,0,1,2560,3,5754036503
5096,6416913185,111325,6417024510,5,0,0,8192,5,6960122162
5097,6417007394,381125,6417388519,6,0,1,4096,6,8820187795
5098,6417024084,155031,6417179115,0,0,1,11776,0,6726719421
5099,6417030209,149853,6417180062,2,0,1,3072,2,9783556548
5100,6417143550,380333,6417523883,3,0,0,620544,3,3583437193
5101,6417146709,377840,6417524549,4,0,0,1024,4,10299738626
5102,6417341204,184011,6417525215,8,0,0,1024,8,3998712132
5103,6417387297,175881,6417563178,7,0,1,5632,7,7962441336
5104,6417389804,218339,6417608143,2,0,1,1536,2,3960352008
5105,6417427405,169613,6417597018,5,0,0,250880,5,7522060396
5106,6417438819,125624,6417564443,5,0,0,8192,5,1589572823
5107,6417483373,314667,6417798040,9,0,1,11264,9,5523265579
5108,6417486504,260811,6417747315,9,0,1,6144,9,2908152074
5109,6417542213,261092,6417803305,5,0,1,14848,5,6245574874
5110,6417583342,177068,6417760410,9,0,1,58368,9,9851860447
5111,6417716006,436701,6418152707,0,0,1,18432,0,617457698
5112,6417772222,82920,6417855142,6,0,1,10752,6,7999704612
5113,6417819463,116568,6417936031,0,0,1,9216,0,8934892235
5114,6417850039,200262,6418050301,5,0,0,134656,5,760007090
5115,6417895086,106442,6418001528,6,0,0,177152,6,3405826424
5116,6417963590,40844,6418004434,1,0,0,4608,1,8369465626
5117,6418023744,84988,6418108732,3,0,0,138752,3,2516368098
5118,6418177340,1038,6418178378,8,0,1,5120,8,1716798119
5119,6418215825,78856,6418294681,6,0,1,46080,6,4962165646
5120,6418244041,150579,6418394620,8,0,0,1024,8,554579640
5121,6418245406,235948,6418481354,2,0,1,19456,2,5089110282
5122,6418393120,97000,6418490120,4,0,1,23552,4,5130606191
5123,6418418203,74775,6418492978,7,0,0,125440,7,7200641789
5124,6418428318,183745,6418612063,9,0,1,47616,9,4874066323
5125,6418436186,76048,6418512234,4,0,1,37888,4,988411577
5126,6418565920,232646,6418798566,9,0,1,10240,9,9032174208
5127,6418613041,69394,6418682435,9,0,1,6144,9,8574411912
5128,6418711781,1514,6418713295,9,0,0,1536,9,9903548038
5129,6418790136,1514,6418791650,4,0,0,1536,4,8118912284
5130,6418826552,1514,6418828066,9,0,0,1536,9,3797760571
5131,6418859472,24925,6418884397,6,0,0,45056,6,1346534153
5132,6418926101,54008,6418980109,7,0,0,91648,7,4572226288
5133,6418934040,93792,6419027832,6,0,0,123392,6,4743703392
5134,6418946014,251127,6419197141,7,0,0,333312,7,8924164570
5135,6419006460,313490,6419319950,0,0,0,371200,0,3590637174
5136,6419155491,167365,6419322856,1,0,0,4608,1,7247162960
5137,6419319347,2466,6419321813,2,0,1,27136,2,9669590132
5138,6419347306,1990,6419349296,4,0,0,2560,4,800611812
5139,6419459666,243847,6419703513,3,0,1,24576,3,810108060
5140,6419488954,86987,6419575941,9,0,1,24064,9,9090947222
5141,6419498557,113582,6419612139,0,0,1,3584,0,6485626936
5142,6419509714,20362,6419530076,9,0,0,2048,9,8036782311
5143,6419545138,17860,6419562998,9,0,1,20992,9,10352845398
5144,6419603855,97756,6419701611,6,0,0,32768,6,5256005862
5145,6419606703,212488,6419819191,9,0,0,512,9,6930034533
5146,6419651290,47284,6419698574,2,0,1,1536,2,1669991753
5147,6419684385,117342,6419801727,3,0,0,195072,3,8482501182
5148,6419726712,75169,6419801881,0,0,0,8704,0,7574774055
5149,6419875470,118748,6419994218,7,0,1,31232,7,8464633477
5150,6420021710,76048,6420097758,3,0,1,10240,3,9827584548
5151,6420033610,98224,6420131834,4,0,1,22528,4,7692778197
5152,6420192979,115696,6420308675,6,0,1,79872,6,7505619220
5153,6420314275,67588,6420381863,7,0,1,7680,7,1059056363
5154,6420324797,104620,6420429417,2,0,1,43520,2,4203362450
5155,6420354128,285162,6420639290,0,0,0,461824,0,2221081907
5156,6420518511,191926,6420710437,3,0,1,12800,3,2661353970
5157,6420633549,193520,6420827069,6,0,0,313344,6,505040472
5158,6420684179,51512,6420735691,5,0,1,8192,5,4770796166
5159,6420813453,207204,6421020657,7,0,0,83456,7,366242329
5160,6420886434,59128,6420945562,7,0,1,11264,7,7959421962
5161,6420908728,126738,6421035466,4,0,1,9728,4,2024236965
5162,6420930009,137052,6421067061,9,0,1,5120,9,8474019715
5163,6420959473,139849,6421099322,7,0,1,37888,7,7440429840
5164,6421015839,148783,6421164622,8,0,1,60416,8,9838406739
5165,6421022053,181655,6421203708,4,0,1,2048,4,4515305555
5166,6421146581,139725,6421286306,4,0,1,52224,4,3710923112
5167,6421203404,87892,6421291296,7,0,1,13824,7,6450424898
5168,6421210299,85416,6421295715,3,0,0,142848,3,2620535741
5169,6421218215,79088,6421297303,6,0,0,15872,6,7212687555
5170,6421222079,65552,6421287631,0,0,1,27136,0,8576942172
5171,6421232737,5322,6421238059,1,0,0,1536,1,6520521525
5172,6421314102,3894,6421317996,8,0,0,5632,8,218303000
5173,6421373379,202739,6421576118,8,0,0,4096,8,2084008405
5174,6421406649,43971,6421450620,0,0,1,13824,0,7776228339
5175,6421425062,97652,6421522714,3,0,0,72192,3,10227248924
5176,6421504679,64072,6421568751,2,0,1,11264,2,5235331636
5177,6421517186,65683,6421582869,7,0,0,111104,7,7764771198
5178,6421569759,48976,6421618735,7,0,1,2048,7,9350581987
5179,6421731118,6750,6421737868,4,0,1,3584,4,10071512748
5180,6421734454,54052,6421788506,1,0,0,7168,1,2154143306
5181,6421798152,102592,6421900744,3,0,1,36864,3,2347935025
5182,6421905238,409158,6422314396,7,0,0,666624,7,10676659450
5183,6422185244,135053,6422320297,6,0,0,19968,6,3167809317
5184,6422191237,63874,6422255111,6,0,1,28160,6,8293942457
5185,6422293546,132512,6422426058,3,0,0,107520,3,6230314996
5186,6422301716,55300,6422357016,5,0,1,12800,5,6515986811
5187,6422361841,49271,6422411112,3,0,0,214528,3,8311287105
5188,6422406854,48609,6422455463,4,0,1,4096,4,3027966654
5189,6422504800,382225,6422887025,5,0,0,94208,5,5060876148
5190,6422513095,24150,6422537245,4,0,0,3584,4,7833989593
5191,6422514103,218979,6422733082,4,0,0,512,4,2369561221
5192,6422550176,380871,6422931047,7,0,0,43520,7,7681563012
5193,6422558205,145538,6422703743,4,0,1,36864,4,5212003576
5194,6422664223,1990,6422666213,5,0,1,51712,5,2130938527
5195,6422745841,5798,6422751639,2,0,1,20992,2,4923561874
5196,6422778327,168969,6422947296,8,0,0,2048,8,8801426262
5197,6422865388,285858,6423151246,8,0,0,6144,8,7486386455
5198,6422991394,78208,6423069602,4,0,1,12288,4,6635309658
5199,6423167104,4846,6423171950,5,0,1,24064,5,10363760188
5200,6423169294,3418,6423172712,8,0,0,5120,8,1172151638
5201,6423201049,97156,6423298205,6,0,0,3584,6,35867110
5202,6423255148,90052,6423345200,5,0,1,15872,5,8410625152
5203,6423303968,83696,6423387664,7,0,0,136192,7,2614524216
5204,6423345409,98552,6423443961,5,0,1,2048,5,8076814022
5205,6423370778,205971,6423576749,7,0,0,334336,7,5469656883
5206,6423420532,158483,6423579015,4,0,0,3584,4,4174308545
5207,6423545920,35681,6423581601,4,0,0,4096,4,5885971878
5208,6423605448,3418,6423608866,9,0,1,31744,9,2685112950
5209,6423620599,117751,6423738350,6,0,0,3584,6,1515956913
5210,6423655902,152503,6423808405,7,0,1,7680,7,1792331615
5211,6423675222,9545,6423684767,5,0,0,246784,5,858711946
5212,6423756659,189775,6423946434,5,0,1,2048,5,8075211550
5213,6423819486,143591,6423963077,8,0,0,2048,8,9006903087
5214,6423883117,103216,6423986333,7,0,1,38912,7,9205789343
5215,6423935691,63704,6423999395,9,0,1,20480,9,1915654627
5216,6423945988,24925,6423970913,6,0,0,103936,6,5003553462
5217,6423990061,81484,6424071545,5,0,1,2048,5,5187869883
5218,6424043498,6750,6424050248,6,0,0,45056,6,5522100404
5219,6424052266,164168,6424216434,3,0,1,6144,3,9398872715
5220,6424082256,67521,6424149777,8,0,0,7168,8,2595730769
5221,6424082293,37505,6424119798,0,0,0,59904,0,1738713422
5222,6424093146,27087,6424120233,3,0,0,15360,3,7519629509
5223,6424101557,172896,6424274453,3,0,1,3584,3,4809437128
5224,6424130773,154905,6424285678,2,0,1,10240,2,4178404707
5225,6424287539,48976,6424336515,9,0,1,24064,9,9753648304
5226,6424311732,99841,6424411573,8,0,1,2048,8,7386324224
5227,6424559264,4370,6424563634,4,0,0,4608,4,3856974131
5228,6424610444,236087,6424846531,5,0,0,382976,5,2194683351
5229,6424883403,2466,6424885869,4,0,0,2560,4,9003952184
5230,6425071640,1514,6425073154,8,0,0,1536,8,4052852305
5231,6425115441,66052,6425181493,5,0,1,7680,5,4655240381
5232,6425187444,71128,6425258572,3,0,1,9216,3,7221894476
5233,6425276390,97444,6425373834,2,0,1,19968,2,3091270554
5234,6425363173,95025,6425458198,5,0,0,158208,5,9389501941
5235,6425387058,72216,6425459274,7,0,0,13312,7,8373732337
5236,6425401979,169311,6425571290,2,0,1,62464,2,7071565324
5237,6425518438,166416,6425684854,0,0,0,273920,0,10154259877
5238,6425532797,149625,6425682422,9,0,1,8704,9,9783885629
5239,6425535575,219377,6425754952,8,0,0,512,8,5931800643
5240,6425543963,158716,6425702679,8,0,1,15360,8,9371296927
5241,6425560399,214906,6425775305,0,0,0,280064,0,3011846962
5242,6425566187,194120,6425760307,9,0,1,8704,9,435374334
5243,6425582811,97679,6425680490,4,0,0,2560,4,2416235757
5244,6425595882,100052,6425695934,8,0,1,1536,8,10064324939
5245,6425658576,168831,6425827407,3,0,1,37888,3,2018385083
5246,6425679598,288698,6425968296,8,0,0,512,8,9678309684
5247,6425681091,305203,6425986294,6,0,0,6144,6,7295646713
5248,6425730865,164973,6425895838,8,0,1,3072,8,8910414798
5249,6425829236,1990,6425831226,7,0,1,6144,7,5358539691
5250,6425876652,144689,6426021341,9,0,1,11264,9,2410279813
5251,6425906125,126415,6426032540,8,0,0,2048,8,1711799742
5252,6425925109,104948,6426030057,5,0,1,13312,5,3533729152
5253,6425956571,228350,6426184921,9,0,1,32768,9,2274830607
5254,6426208885,73600,6426282485,3,0,1,12288,3,335554830
5255,6426245583,77140,6426322723,0,0,1,13824,0,5536630935
5256,6426317931,85444,6426403375,0,0,1,15872,0,8927630102
5257,6426385169,3894,6426389063,7,0,1,46592,7,6224223232
5258,6426405663,122698,6426528361,9,0,0,4096,9,2744275080
5259,6426445359,108832,6426554191,6,0,1,57344,6,8680929652
5260,6426470315,61510,6426531825,5,0,1,4096,5,2083320603
5261,6426488760,127424,6426616184,6,0,1,72704,6,1962387207
5262,6426493012,147128,6426640140,6,0,1,1024,6,8126117603
5263,6426500548,132533,6426633081,6,0,1,10240,6,10601605114
5264,6426514106,132605,6426646711,8,0,1,20992,8,3367778140
5265,6426539834,111473,6426651307,7,0,1,3584,7,398563121
5266,6426556826,98224,6426655050,5,0,1,10752,5,7667627357
5267,6426563762,139331,6426703093,3,0,1,22528,3,5912133843
5268,6426757988,116164,6426874152,3,0,1,81408,3,5277770076
5269,6426878818,101968,6426980786,9,0,1,34816,9,2156782791
5270,6427013867,3418,6427017285,8,0,0,3584,8,4926427983
5271,6427102015,76048,6427178063,8,0,1,10240,8,7352664544
5272,6427113026,12033,6427125059,7,0,1,41984,7,6165472976
5273,6427136592,123861,6427260453,5,0,1,6144,5,2014872333
5274,6427177292,108408,6427285700,0,0,0,18432,0,9471996633
5275,6427240745,154312,6427395057,6,0,0,250368,6,6653378719
5276,6427292052,106871,6427398923,4,0,0,6144,4,2214371142
5277,6427332708,118723,6427451431,3,0,0,177664,3,1205638954
5278,6427431680,23617,6427455297,3,0,0,6144,3,9562102240
5279,6427463227,6274,6427469501,9,0,1,47104,9,6280570153
5280,6427476825,83041,6427559866,4,0,0,6656,4,9137717002
5281,6427514620,180394,6427695014,2,0,1,7168,2,8881448690
5282,6427553082,144627,6427697709,9,0,1,11776,9,8115293544
5283,6427554230,179957,6427734187,8,0,1,67072,8,2016482824
5284,6427623526,178092,6427801618,7,0,0,293376,7,10303316724
5285,6427628322,189668,6427817990,0,0,0,61952,0,201630945
5286,6427656563,150540,6427807103,2,0,1,7168,2,3346985473
5287,6427668124,194365,6427862489,0,0,1,3584,0,1821662145
5288,6427715339,294176,6428009515,4,0,1,20992,4,5323941560
5289,6427724477,320284,6428044761,0,0,0,182784,0,8337337903
5290,6427812924,258285,6428071209,6,0,1,27136,6,5820755582
5291,6427865623,109428,6427975051,4,0,1,52224,4,6777949044
5292,6427961792,93974,6428055766,5,0,0,165888,5,7646218775
5293,6427977257,14233,6427991490,1,0,0,2048,1,8904005835
5294,6428069723,332205,6428401928,6,0,0,24576,6,794736854
5295,6428076785,190192,6428266977,6,0,0,309760,6,10253350960
5296,6428122586,92794,6428215380,2,0,1,16384,2,3304365297
5297,6428179982,14025,6428194007,7,0,0,27648,7,1320979016
5298,6428269104,4311,6428273415,5,0,0,27136,5,5547589189
5299,6428279484,174923,6428454407,9,0,0,1024,9,7374102406
5300,6428356134,87225,6428443359,0,0,0,146432,0,230814024
5301,6428402441,83437,6428485878,0,0,0,135680,0,7635905121
5302,6428424814,212536,6428637350,7,0,0,313344,7,335687898
5303,6428496898,176435,6428673333,8,0,0,122880,8,1535911038
5304,6428531613,148133,6428679746,6,0,0,22528,6,1046349587
5305,6428635641,396537,6429032178,8,0,0,642048,8,10385202039
5306,6428692853,319769,6429012622,6,0,1,34816,6,8563619982
5307,6428749211,302258,6429051469,8,0,0,126976,8,4864906470
5308,6428761406,286502,6429047908,0,0,1,30720,0,6718037376
5309,6428772316,270646,6429042962,7,0,0,18432,7,7705916322
5310,6428788226,276418,6429064644,3,0,0,8704,3,7920161552
5311,6428840269,272551,6429112820,0,0,0,115712,0,3721394243
5312,6428849704,244316,6429094020,8,0,1,1536,8,2706877510
5313,6428880606,178728,6429059334,7,0,0,136704,7,4379571242
5314,6428909507,137533,6429047040,1,0,0,1024,1,10655591604
5315,6428932239,527294,6429459533,3,0,1,14848,3,5620591740
5316,6428972089,297241,6429269330,5,0,1,10752,5,2327474204
5317,6429016415,544573,6429560988,5,0,0,132096,5,9460907495
5318,6429020427,195063,6429215490,2,0,1,160256,2,9188586911
5319,6429057956,479838,6429537794,1,0,0,512,1,7863830948
5320,6429140821,43196,6429184017,2,0,1,2048,2,10435022013
5321,6429212105,17469,6429229574,4,0,1,4608,4,155641860
5322,6429269985,307039,6429577024,6,0,1,69120,6,2408674909
5323,6429278451,505416,6429783867,3,0,1,3072,3,3208082445
5324,6429386390,2466,6429388856,6,0,1,13312,6,4336532408
5325,6429393962,1038,6429395000,6,0,0,70656,6,7759146842
5326,6429421315,329451,6429750766,3,0,0,2560,3,1116898140
5327,6429452143,152608,6429604751,3,0,1,17408,3,7037310183
5328,6429529689,327247,6429856936,5,0,0,2560,5,6494969251
5329,6429571581,324594,6429896175,4,0,0,1024,4,7917493064
5330,6429756266,101188,6429857454,0,0,1,32256,0,9554304201
5331,6429938471,71245,6430009716,0,0,0,115200,0,2999517371
5332,6429960123,65044,6430025167,6,0,0,57344,6,4358983174
5333,6430105485,4846,6430110331,6,0,1,35328,6,312094780
5334,6430137050,562,6430137612,1,0,0,5120,1,4737780682
5335,6430194588,119731,6430314319,4,0,0,512,4,10653004990
5336,6430208104,56486,6430264590,5,0,1,30208,5,1296040693
5337,6430216006,1990,6430217996,7,0,1,1536,7,3534835181
5338,6430334924,174623,6430509547,4,0,0,2048,4,3173042187
5339,6430408574,94337,6430502911,6,0,0,153600,6,8082559039
5340,6430411325,12562,6430423887,6,0,1,1024,6,1020084343
5341,6430421922,113050,6430534972,0,0,1,3584,0,6261959043
5342,6430501101,137025,6430638126,8,0,0,20992,8,4529468172
5343,6430577840,1038,6430578878,6,0,1,42496,6,2158165005
5344,6430586518,562,6430587080,1,0,0,1024,1,9174976459
5345,6430605462,104308,6430709770,2,0,1,39936,2,4439040166
5346,6430637288,2942,6430640230,1,0,0,512,1,5382730746
5347,6430685219,146904,6430832123,5,0,0,3072,5,2748089461
5348,6430735616,51253,6430786869,8,0,0,82944,8,9448073235
5349,6430766790,562,6430767352,3,0,1,51200,3,5688412306
5350,6430801437,161673,6430963110,5,0,1,1024,5,6609174712
5351,6430815352,20199,6430835551,3,0,0,512,3,2002744422
5352,6430908275,127360,6431035635,3,0,0,7680,3,4204360460
5353,6430956953,107896,6431064849,8,0,1,54272,8,1268565542
5354,6431005251,94614,6431099865,3,0,1,5632,3,1720272369
5355,6431112486,83308,6431195794,7,0,1,18944,7,8488169838
5356,6431114925,97444,6431212369,4,0,1,19968,4,879234970
5357,6431129612,1038,6431130650,5,0,1,23040,5,5497580412
5358,6431225467,146108,6431371575,1,0,0,1024,1,9882973047
5359,6431256572,79432,6431336004,4,0,1,11264,4,9079019106
5360,6431316931,53749,6431370680,7,0,0,91136,7,4240937264
5361,6431416427,62068,6431478495,4,0,1,9728,4,6206863829
5362,6431578712,47284,6431625996,4,0,1,1536,4,9210737816
5363,6431584935,103684,6431688619,7,0,1,40448,7,6397938571
5364,6431605307,151286,6431756593,5,0,1,50688,5,7216378028
5365,6431657597,20674,6431678271,2,0,1,19456,2,481679614
5366,6431747440,142046,6431889486,6,0,0,18944,6,5714124816
5367,6431826586,64738,6431891324,8,0,0,105984,8,1565103060
5368,6431894094,83765,6431977859,5,0,1,13824,5,6296962033
5369,6431922316,65942,6431988258,8,0,0,111616,8,4952312838
5370,6432007754,1514,6432009268,3,0,0,1536,3,6486161814
5371,6432072503,98224,6432170727,2,0,1,22528,2,8453019897
5372,6432213001,99940,6432312941,4,0,1,28160,4,1684749649
5373,6432556126,57436,6432613562,3,0,1,4608,3,7609998923
5374,6432654216,2466,6432656682,3,0,0,2560,3,1846025265
5375,6432669755,48976,6432718731,3,0,1,2048,3,3123217802
5376,6432676872,64908,6432741780,0,0,0,109568,0,675835213
5377,6432704637,562,6432705199,3,0,1,11264,3,10579366127
5378,6432743775,21137,6432764912,3,0,0,512,3,6803550578
5379,6432780967,19894,6432800861,0,0,1,24576,0,6659237706
5380,6432791041,144326,6432935367,6,0,0,34304,6,3623186327
5381,6432793270,148925,6432942195,5,0,0,1536,5,2191175190
5382,6432794922,198673,6432993595,7,0,1,10240,7,1020723573
5383,6432798199,183683,6432981882,7,0,0,315904,7,565507001
5384,6432813535,133131,6432946666,5,0,0,512,5,941077176
5385,6432822967,286273,6433109240,0,0,1,34304,0,6608419139
5386,6432864753,321514,6433186267,4,0,0,1024,4,1002610329
5387,6432955037,237660,6433192697,7,0,1,31232,7,3304062047
5388,6433074943,183137,6433258080,0,0,0,296448,0,2867207994
5389,6433112472,125373,6433237845,5,0,1,18432,5,2874978321
5390,6433135933,181476,6433317409,4,0,0,5120,4,1000151820
5391,6433247253,1990,6433249243,4,0,1,12288,4,333654688
5392,6433249041,144289,6433393330,2,0,1,10240,2,8117097298
5393,6433288474,1514,6433289988,0,0,1,46592,0,8113937063
5394,6433333742,171570,6433505312,9,0,0,2048,9,93211942
5395,6433430839,242617,6433673456,0,0,1,21504,0,1005307298
5396,6433437934,2942,6433440876,4,0,0,1536,4,7614073846
5397,6433527995,128229,6433656224,5,0,0,3072,5,9822229240
5398,6433547786,103429,6433651215,6,0,0,167936,6,4778736177
5399,6433576291,75270,6433651561,3,0,0,512,3,7520809043
5400,6433582023,69692,6433651715,5,0,0,8704,5,4616379528
5401,6433586921,402394,6433989315,6,0,0,627712,6,6016833824
5402,6433608189,246610,6433854799,8,0,1,50176,8,9827546088
5403,6433706344,440418,6434146762,3,0,1,33792,3,9422325029
5404,6433743051,15795,6433758846,1,0,0,512,1,4197781905
5405,6433960228,367704,6434327932,8,0,1,12288,8,3066241120
5406,6434012509,32812,6434045321,3,0,1,5632,3,5113505850
5407,6434039554,16036,6434055590,9,0,0,7168,9,3250131541
5408,6434063352,213846,6434277198,8,0,0,53760,8,8356553068
5409,6434075220,113902,6434189122,8,0,1,24064,8,2438137336
5410,6434080794,178340,6434259134,3,0,0,1024,3,3393834021
5411,6434190489,171010,6434361499,7,0,1,44032,7,8410989996
5412,6434346470,237550,6434584020,7,0,0,389120,7,8411912666
5413,6434348116,236570,6434584686,5,0,0,1024,5,4837445761
5414,6434409456,197350,6434606806,0,0,0,81408,0,4269403185
5415,6434413720,194072,6434607792,3,0,0,1536,3,6096634793
5416,6434419881,224508,6434644389,4,0,0,117760,4,5325019188
5417,6434621777,115960,6434737737,6,0,1,512,6,6349402492
5418,6434676110,134837,6434810947,6,0,1,15360,6,5329012582
5419,6434707975,226077,6434934052,8,0,0,219136,8,9332893610
5420,6434769439,89540,6434858979,7,0,0,60928,7,10505211755
5421,6434798498,122645,6434921143,3,0,1,20992,3,5553868922
5422,6434864574,96539,6434961113,0,0,1,3072,0,7044930992
5423,6434912677,153429,6435066106,4,0,0,198656,4,7162564957
5424,6434919557,330066,6435249623,7,0,1,1024,7,5407478732
5425,6434954643,272633,6435227276,0,0,0,59392,0,5978451545
5426,6435145400,13079,6435158479,4,0,0,22016,4,8424575264
5427,6435221574,67900,6435289474,2,0,1,8704,2,8035241434
5428,6435298424,1038,6435299462,1,0,0,1024,1,8753272367
5429,6435306933,1038,6435307971,1,0,0,1024,1,1530396528
5430,6435440264,35825,6435476089,4,0,0,62976,4,4674257268
5431,6435443684,33587,6435477271,7,0,1,9728,7,249829779
5432,6435460233,119677,6435579910,8,0,1,29184,8,915030702
5433,6435471240,148992,6435620232,7,0,0,55296,7,1805366832
5434,6435531331,122387,6435653718,8,0,0,198144,8,8563831618
5435,6435593041,112775,6435705816,4,0,0,167424,4,10255992426
5436,6435620465,133033,6435753498,7,0,0,162816,7,1542715877
5437,6435630009,110644,6435740653,7,0,1,45056,7,4420045563
5438,6435644480,90533,6435735013,5,0,0,2560,5,3294247898
5439,6435647801,30459,6435678260,2,0,1,13824,2,6573287555
5440,6435660588,196043,6435856631,0,0,1,71168,0,5471010882
5441,6435666217,125229,6435791446,3,0,0,2560,3,8220669943
5442,6435726637,318401,6436045038,5,0,0,512,5,5536191821
5443,6435781193,130136,6435911329,6,0,1,58880,6,1201550205
5444,6435794774,247719,6436042493,8,0,0,203776,8,2356686313
5445,6435826259,401271,6436227530,4,0,0,124928,4,3655911496
5446,6435936027,87728,6436023755,0,0,1,2560,0,535651330
5447,6435974142,159453,6436133595,4,0,0,129536,4,89792008
5448,6436038352,284819,6436323171,7,0,1,13824,7,1072066105
5449,6436092571,196275,6436288846,3,0,1,42496,3,4048337990
5450,6436101954,58536,6436160490,4,0,0,322048,4,4230200449
5451,6436130092,8978,6436139070,7,0,1,44032,7,9481474285
5452,6436238431,108157,6436346588,0,0,1,43520,0,7341747791
5453,6436240359,229923,6436470282,1,0,0,1024,1,3621409584
5454,6436290583,12741,6436303324,9,0,0,1024,9,4299140880
5455,6436351160,42162,6436393322,9,0,0,4096,9,1952046456
5456,6436392131,403999,6436796130,3,0,1,38400,3,1879382059
5457,6436401756,205865,6436607621,6,0,0,68608,6,7673389948
5458,6436465954,157067,6436623021,0,0,0,259072,0,4675461964
5459,6436502548,69929,6436572477,3,0,1,1024,3,6658702166
5460,6436560346,74258,6436634604,8,0,1,8704,8,5040261972
5461,6436627395,250160,6436877555,7,0,1,21504,7,2119409626
5462,6436641204,158947,6436800151,8,0,0,124416,8,4172205724
5463,6436694126,5103,6436699229,0,0,1,45056,0,10403734550
5464,6436720447,258573,6436979020,2,0,1,12288,2,5403822911
5465,6436874302,294207,6437168509,1,0,0,2048,1,819770910
5466,6436958223,76325,6437034548,6,0,0,128512,6,1249293487
5467,6437030778,103473,6437134251,6,0,1,13312,6,1456729790
5468,6437032711,121096,6437153807,7,0,1,1024,7,7985033849
5469,6437092273,72664,6437164937,0,0,1,9216,0,10177682726
5470,6437123427,64908,6437188335,4,0,0,109568,4,1178492417
5471,6437276317,268958,6437545275,4,0,0,440320,4,1155513337
5472,6437292741,258743,6437551484,8,0,0,21504,8,8246649976
5473,6437361120,288659,6437649779,8,0,0,323072,8,9724003979
5474,6437371047,281134,6437652181,6,0,1,7680,6,3822891132
5475,6437509028,143337,6437652365,3,0,0,4096,3,1084746256
5476,6437509404,317487,6437826891,6,0,1,16896,6,4022703902
5477,6437738296,88606,6437826902,6,0,0,136192,6,7634911265
5478,6437750410,62154,6437812564,3,0,1,3072,3,5888358549
5479,6437793008,32614,6437825622,0,0,0,100864,0,2059476216
5480,6437822702,5798,6437828500,1,0,0,8704,1,10180406150
5481,6437871668,92496,6437964164,9,0,0,6144,9,288417609
5482,6437884958,198600,6438083558,6,0,1,5632,6,9471447750
5483,6437891006,97846,6437988852,6,0,0,326656,6,8969886536
5484,6437994666,73732,6438068398,3,0,0,4608,3,9389838767
5485,6438035152,379336,6438414488,7,0,0,53760,7,3382938843
5486,6438065790,96575,6438162365,0,0,0,161280,0,2010131222
5487,6438156219,1038,6438157257,3,0,1,22528,3,468201480
5488,6438192672,44400,6438237072,9,0,0,1024,9,2814577486
5489,6438211127,38620,6438249747,8,0,0,76288,8,2883872783
5490,6438222808,562,6438223370,0,0,0,28160,0,10239455844
5491,6438296359,313210,6438609569,5,0,0,512,5,3758354446
5492,6438369247,217300,6438586547,7,0,0,356352,7,2303562566
5493,6438432671,196528,6438629199,6,0,0,138752,6,4436952174
5494,6438454609,131982,6438586591,4,0,1,10240,4,6364739208
5495,6438503630,126185,6438629815,7,0,0,30720,7,2891830659
5496,6438515943,30300,6438546243,6,0,0,31232,6,10011931735
5497,6438614734,198296,6438813030,1,0,0,4608,1,1607705360
5498,6438654661,3124,6438657785,3,0,0,9216,3,10033228273
5499,6438711815,81112,6438792927,8,0,0,131072,8,8733187476
5500,6438752732,41181,6438793913,0,0,0,1536,0,9905278300
5501,6438753429,41470,6438794899,1,0,0,1536,1,7564960420
5502,6438866927,6484,6438873411,1,0,0,15872,1,1594108173
5503,6438922366,130144,6439052510,2,0,1,50688,2,6449379200
5504,6439040058,5192,6439045250,3,0,1,4608,3,2049726991
5505,6439055849,69880,6439125729,6,0,1,14336,6,4574099389
5506,6439091319,88048,6439179367,6,0,0,13312,6,9638477242
5507,6439110450,99316,6439209766,8,0,1,26112,8,4519691819
5508,6439377719,106024,6439483743,2,0,1,48128,2,10181746804
5509,6439425780,110697,6439536477,6,0,1,18432,6,5030288789
5510,6439433442,131995,6439565437,4,0,0,213504,4,5067933531
5511,6439496436,226715,6439723151,7,0,1,12288,7,3115077242
5512,6439556430,176248,6439732678,3,0,1,31232,3,2858933411
5513,6439559128,316829,6439875957,4,0,0,513536,4,8448825991
5514,6439587458,290445,6439877903,0,0,0,3072,0,5453749209
5515,6439597544,286260,6439883804,7,0,0,28160,7,65447686
5516,6439777717,196377,6439974094,0,0,1,11264,0,7908563562
5517,6439935159,388732,6440323891,4,0,0,878080,4,8452986738
5518,6439987954,540008,6440527962,7,0,1,5632,7,7641717756
5519,6440089492,401638,6440491130,6,0,0,51712,6,6319363083
5520,6440155401,336395,6440491796,1,0,0,1024,1,4474927703
5521,6440213989,279753,6440493742,5,0,0,3072,5,1984582336
5522,6440330112,341716,6440671828,0,0,1,17920,0,4787868479
5523,6440627562,117600,6440745162,6,0,0,195584,6,3732166831
5524,6440648873,99930,6440748803,4,0,1,8192,4,2524689338
5525,6440744485,5798,6440750283,3,0,1,18944,3,745870813
5526,6440763674,1038,6440764712,1,0,0,6144,1,3041305206
5527,6440929821,193253,6441123074,0,0,0,1024,0,9830285094
5528,6440933893,49429,6440983322,7,0,1,1024,7,8602031062
5529,6441000107,91237,6441091344,7,0,0,147456,7,8863133696
5530,6441034155,99533,6441133688,4,0,0,145408,4,6598278276
5531,6441059759,75555,6441135314,3,0,0,2560,3,5852231548
5532,6441176467,2942,6441179409,7,0,1,23552,7,4863942453
5533,6441212551,149945,6441362496,4,0,1,26624,4,5939559329
5534,6441303764,170074,6441473838,8,0,0,3072,8,8481856609
5535,6441530224,1038,6441531262,8,0,0,1024,8,2788660827
5536,6441630469,1514,6441631983,8,0,0,1536,8,2524478931
5537,6441921809,562,6441922371,6,0,1,45056,6,4738135980
5538,6441961821,105088,6442066909,8,0,0,512,8,457955946
5539,6442099711,562,6442100273,0,0,1,512,0,6003841962
5540,6442123496,43900,6442167396,3,0,0,512,3,3031673679
5541,6442231045,5322,6442236367,8,0,0,5632,8,3365095172
5542,6442273099,11787,6442284886,4,0,0,19456,4,8844562223
5543,6442298564,73756,6442372320,8,0,1,12800,8,4652567927
5544,6442358094,47284,6442405378,7,0,1,1536,7,5046553241
5545,6442469419,2466,6442471885,2,0,1,10240,2,1664654599
5546,6442490979,77584,6442568563,2,0,1,12800,2,2511007459
5547,6442508200,7702,6442515902,8,0,0,2560,8,6700018488
5548,6442554736,84794,6442639530,9,0,0,8192,9,4562354040
5549,6442575726,43493,6442619219,7,0,0,71168,7,7066603391
5550,6442576264,57436,6442633700,0,0,1,27648,0,1535899146
5551,6442625529,3124,6442628653,3,0,1,4608,3,3410196806
5552,6442649079,2942,6442652021,3,0,1,24064,3,6178492539
5553,6442694233,212183,6442906416,3,0,0,9216,3,9266015644
5554,6442721418,1990,6442723408,0,0,0,3072,0,4562066231
5555,6442792021,245487,6443037508,5,0,0,2048,5,10467287192
5556,6442846198,124538,6442970736,6,0,1,46080,6,6318143594
5557,6442985165,6274,6442991439,8,0,0,6656,8,6502586251
5558,6443017319,183395,6443200714,7,0,0,296960,7,8478732148
5559,6443105961,101474,6443207435,4,0,0,32256,4,2014471102
5560,6443178709,29712,6443208421,0,0,0,1536,0,5350691387
5561,6443257298,1038,6443258336,3,0,0,1024,3,9886024530
5562,6443425370,3418,6443428788,8,0,1,40448,8,2985902515
5563,6443434408,103684,6443538092,7,0,1,15360,7,10710751629
5564,6443446736,103065,6443549801,5,0,0,3584,5,1342942911
5565,6443456502,142014,6443598516,6,0,1,40448,6,8878526408
5566,6443757636,1038,6443758674,2,0,1,16896,2,3669808217
5567,6443815195,88828,6443904023,3,0,0,1024,3,1667640956
5568,6443874028,562,6443874590,3,0,0,512,3,6663398489
5569,6443895913,47284,6443943197,0,0,1,1536,0,6736691294
5570,6443983746,81616,6444065362,7,0,1,18432,7,5387308496
5571,6444105003,5192,6444110195,6,0,0,13312,6,7977027919
5572,6444181394,22170,6444203564,4,0,0,36352,4,6651144120
5573,6444222892,264395,6444487287,0,0,1,18944,0,7103404597
5574,6444234377,283987,6444518364,7,0,0,428032,7,10481883569
5575,6444241352,211246,6444452598,4,0,1,45568,4,3616842285
5576,6444323611,322791,6444646402,7,0,0,115200,7,4923302949
5577,6444382770,203571,6444586341,4,0,0,172544,4,6456129222
5578,6444420493,105309,6444525802,4,0,1,25600,4,1513343335
5579,6444532926,129932,6444662858,4,0,0,166400,4,9233185496
5580,6444534122,96881,6444631003,6,0,0,82432,6,4888662916
5581,6444583750,4370,6444588120,7,0,0,62976,7,7923518334
5582,6444587463,397329,6444984792,0,0,1,50176,0,3358295234
5583,6444624559,256397,6444880956,2,0,1,22528,2,10557207634
5584,6444657774,3418,6444661192,6,0,1,38912,6,7535949963
5585,6444678476,346227,6445024703,7,0,1,29184,7,2701850031
5586,6444722218,291807,6445014025,3,0,0,4608,3,10448032266
5587,6444899636,353743,6445253379,1,0,0,3584,1,3174013380
5588,6444902712,163662,6445066374,6,0,0,265216,6,8132919407
5589,6445146969,3383,6445150352,8,0,0,9728,8,6753229903
5590,6445230150,172237,6445402387,6,0,0,278528,6,3863007608
5591,6445288316,78859,6445367175,7,0,1,21504,7,4210672082
5592,6445305476,71628,6445377104,3,0,1,30208,3,68925095
5593,6445339695,41392,6445381087,4,0,0,52736,4,5773827872
5594,6445347592,156718,6445504310,1,0,0,1024,1,5962228072
5595,6445379454,8619,6445388073,8,0,0,2560,8,9911707
5596,6445436426,223436,6445659862,0,0,0,4608,0,2519875429
5597,6445554728,1514,6445556242,8,0,0,1536,8,3415669331
5598,6445633341,562,6445633903,5,0,0,512,5,5685047055
5599,6445756662,1990,6445758652,8,0,0,2048,8,6035393642
5600,6445774785,562,6445775347,3,0,1,6656,3,7760651845
5601,6445795461,64204,6445859665,6,0,0,512,6,4286153615
5602,6445873266,155087,6446028353,6,0,0,251904,6,10454725131
5603,6445891285,113868,6446005153,6,0,1,25600,6,7315327103
5604,6445915151,35502,6445950653,8,0,0,1024,8,8744808990
5605,6445994503,288982,6446283485,1,0,0,1536,1,394883927
5606,6446031847,283607,6446315454,6,0,1,43520,6,8541321540
5607,6446073599,374737,6446448336,6,0,0,606208,6,8815101988
5608,6446128607,176158,6446304765,8,0,1,39936,8,7793633969
5609,6446246496,333780,6446580276,7,0,1,48128,7,5099350251
5610,6446266202,5192,6446271394,7,0,1,34304,7,3777846728
5611,6446273484,470264,6446743748,5,0,0,2048,5,6466895078
5612,6446392409,225110,6446617519,0,0,1,57344,0,9504760581
5613,6446397131,370599,6446767730,4,0,1,4608,4,88106945
5614,6446505254,291508,6446796762,8,0,1,512,8,10373829721
5615,6446557744,153662,6446711406,6,0,1,6656,6,10721598619
5616,6446576590,141647,6446718237,1,0,0,1536,1,2695337871
5617,6446598700,235260,6446833960,0,0,1,29696,0,6890339648
5618,6446765918,4370,6446770288,1,0,0,4608,1,6714372952
5619,6446782814,6750,6446789564,3,0,0,7168,3,7490597183
5620,6446827683,1990,6446829673,4,0,1,10752,4,4290148139
5621,6446847704,74668,6446922372,6,0,1,6656,6,5565777280
5622,6446875518,64204,6446939722,1,0,0,2048,1,2298787566
5623,6447001669,25442,6447027111,7,0,0,46080,7,9588568183
5624,6447088504,98692,6447187196,4,0,1,24064,4,64387669
5625,6447155721,115065,6447270786,8,0,1,46592,8,1262371975
5626,6447246327,45949,6447292276,0,0,1,74240,0,1922811549
5627,6447258675,113980,6447372655,7,0,0,55808,7,2958024126
5628,6447318501,562,6447319063,7,0,1,3584,7,5256874943
5629,6447388643,102389,6447491032,9,0,0,512,9,10404044464
5630,6447438223,62512,6447500735,7,0,1,6144,7,8310230955
5631,6447511552,182620,6447694172,7,0,0,295424,7,1993305918
5632,6447598655,21605,6447620260,6,0,1,46080,6,4339579045
5633,6447682885,1038,6447683923,4,0,0,32768,4,7295999567
5634,6447729757,4846,6447734603,9,0,0,1024,9,5241495634
5635,6447735033,207343,6447942376,1,0,0,5120,1,6093243944
5636,6447743138,185979,6447929117,4,0,0,302080,4,9527248742
5637,6447830256,292467,6448122723,4,0,0,466432,4,5858076841
5638,6447986375,58165,6448044540,0,0,1,27648,0,9023269599
5639,6448045255,119779,6448165034,2,0,1,20992,2,5904914613
5640,6448065224,1514,6448066738,5,0,0,1024,5,7770430453
5641,6448080897,228886,6448309783,7,0,1,1024,7,3046436216
5642,6448229386,299914,6448529300,3,0,0,1536,3,10287061412
5643,6448298106,45592,6448343698,8,0,1,1024,8,4287537113
5644,6448416025,3894,6448419919,3,0,0,4096,3,6069003795
5645,6448452254,86200,6448538454,0,0,1,13312,0,4906950403
5646,6448654774,1038,6448655812,8,0,1,22528,8,9639578063
5647,6448670973,96688,6448767661,1,0,0,1024,1,536520024
5648,6448787828,2466,6448790294,5,0,0,2560,5,2565848010
5649,6448804219,1038,6448805257,0,0,1,89088,0,8832761762
5650,6448811057,118504,6448929561,1,0,0,1024,1,6135006558
5651,6448909779,16060,6448925839,9,0,0,9216,9,1276128681
5652,6449153669,3124,6449156793,0,0,0,9216,0,9018454726
5653,6449251982,1514,6449253496,1,0,0,1536,1,8208731459
5654,6449269719,21912,6449291631,3,0,1,36352,3,3715994666
5655,6449287084,102436,6449389520,4,0,0,35840,4,3446988254
5656,6449454174,93562,6449547736,4,0,0,152064,4,7927164787
5657,6449455084,92998,6449548082,3,0,0,512,3,9450727695
5658,6449490199,125116,6449615315,7,0,0,186368,7,9036442784
5659,6449582647,22255,6449604902,2,0,1,4608,2,9866243147
5660,6449594686,54096,6449648782,3,0,0,2560,3,5209297981
5661,6449688692,1038,6449689730,7,0,0,88576,7,2063879129
5662,6449702536,182370,6449884906,6,0,1,41472,6,2097770080
5663,6449761233,7702,6449768935,3,0,0,1024,3,5592015307
5664,6449787487,97902,6449885389,5,0,0,8192,5,2683910876
5665,6449840009,248977,6450088986,0,0,1,15872,0,6586348866
5666,6450033685,46208,6450079893,7,0,0,79872,7,10035686572
5667,6450081082,1038,6450082120,4,0,1,33792,4,4643041746
5668,6450133315,562,6450133877,9,0,0,1024,9,4020116316
5669,6450259774,228116,6450487890,3,0,0,512,3,983741557
5670,6450275502,131995,6450407497,4,0,0,213504,4,4786481512
5671,6450333606,74557,6450408163,3,0,0,1024,3,1888562786
5672,6450351307,112968,6450464275,0,0,1,9216,0,9400420163
5673,6450526928,83437,6450610365,4,0,0,135680,4,6709439859
5674,6450620374,3894,6450624268,9,0,0,4096,9,10083479945
5675,6450690127,72664,6450762791,7,0,1,9216,7,2713276831
5676,6450743157,216525,6450959682,7,0,0,354816,7,7623648676
5677,6451001642,58372,6451060014,6,0,1,2048,6,9195073859
5678,6451052587,1038,6451053625,6,0,1,7680,6,2597695321
5679,6451056053,107740,6451163793,2,0,1,24576,2,9642880591
5680,6451090348,25076,6451115424,0,0,1,53760,0,9246588228
5681,6451147848,218144,6451365992,3,0,0,1024,3,5874923043
5682,6451186341,202605,6451388946,4,0,0,22528,4,8638954648
5683,6451354663,54052,6451408715,6,0,1,3584,6,1098673559
5684,6451419535,51136,6451470671,0,0,1,4096,0,2394683868
5685,6451474004,1038,6451475042,3,0,0,1024,3,5873914465
5686,6451519097,7226,6451526323,0,0,1,41472,0,187739091
5687,6451523011,103996,6451627007,5,0,0,7680,5,3560382835
5688,6451593092,2942,6451596034,4,0,1,7168,4,4439938069
5689,6451637788,75529,6451713317,9,0,0,3072,9,2508690771
5690,6451703374,239100,6451942474,4,0,0,392192,4,10390407091
5691,6451753113,195979,6451949092,4,0,0,23552,4,4376025866
5692,6451850057,219160,6452069217,3,0,1,11776,3,4144017434
5693,6451894930,347462,6452242392,4,0,0,563200,4,8105566807
5694,6451910118,353984,6452264102,6,0,0,79360,6,9700126923
5695,6451946963,193686,6452140649,7,0,1,12288,7,735313523
5696,6452072362,39525,6452111887,8,0,0,3072,8,3620626057
5697,6452226984,1990,6452228974,9,0,0,10240,9,9155441448
5698,6452269497,362281,6452631778,8,0,0,2048,8,447675658
5699,6452270899,59349,6452330248,4,0,1,23552,4,2428700860
5700,6452279028,192227,6452471255,9,0,1,512,9,676467461
5701,6452334298,155258,6452489556,6,0,0,255488,6,4267983239
5702,6452379499,112003,6452491502,9,0,0,3072,9,9868361079
5703,6452504326,2942,6452507268,3,0,1,3584,3,7373919558
5704,6452534942,157034,6452691976,1,0,0,3072,1,4847871868
5705,6452820757,182362,6453003119,9,0,0,294912,9,5602532288
5706,6452926135,562,6452926697,0,0,1,50176,0,4905958624
5707,6453005400,56056,6453061456,2,0,1,18944,2,1556311664
5708,6453039818,139572,6453179390,2,0,1,5120,2,818245752
5709,6453040875,1038,6453041913,8,0,0,512,8,7364671442
5710,6453126272,43900,6453170172,6,0,1,512,6,8236445093
5711,6453161612,4675,6453166287,3,0,0,1024,3,1063480955
5712,6453172170,312006,6453484176,7,0,1,8704,7,2982795212
5713,6453173998,104932,6453278930,9,0,0,12288,9,4211090643
5714,6453256044,34363,6453290407,6,0,1,44544,6,9411618078
5715,6453316894,193809,6453510703,4,0,1,4096,4,6849914070
5716,6453328337,2466,6453330803,9,0,0,56832,9,771352648
5717,6453411133,121736,6453532869,1,0,0,2560,1,2329072334
5718,6453451439,52360,6453503799,3,0,1,3072,3,5584635751
5719,6453493759,22858,6453516617,2,0,1,3072,2,10553725224
5720,6453522087,52360,6453574447,7,0,0,40960,7,6677457655
5721,6453544305,562,6453544867,9,0,1,26112,9,3531749558
5722,6453624116,165371,6453789487,0,0,0,512,0,10025329794
5723,6453651094,75292,6453726386,3,0,1,11264,3,10021339644
5724,6453652708,80349,6453733057,2,0,1,12800,2,939120570
5725,6453721874,99828,6453821702,7,0,1,15872,7,9808996925
5726,6453838541,187183,6454025724,6,0,0,307712,6,6618179553
5727,6453914095,208232,6454122327,4,0,1,64512,4,1041218047
5728,6454019210,218850,6454238060,6,0,0,359424,6,9137014557
5729,6454031061,279322,6454310383,6,0,0,231424,6,5458314131
5730,6454163272,148737,6454312009,0,0,0,2560,0,8310037383
5731,6454169516,142839,6454312355,1,0,0,512,1,9380731565
5732,6454229012,120247,6454349259,6,0,0,127488,6,8654969312
5733,6454241852,91821,6454333673,2,0,1,45568,2,5073627610
5734,6454260984,107888,6454368872,1,0,0,5632,1,3408958547
5735,6454265808,43108,6454308916,7,0,0,75264,7,3258808751
5736,6454421721,374052,6454795773,0,0,1,4608,0,9118336643
5737,6454445996,210387,6454656383,2,0,1,9216,2,2201827374
5738,6454477946,205254,6454683200,7,0,0,73728,7,6418660989
5739,6454510098,79539,6454589637,4,0,1,7680,4,3982942736
5740,6454592753,245175,6454837928,6,0,1,1536,6,1810545726
5741,6454653743,118651,6454772394,7,0,1,40448,7,2313512608
5742,6454769735,9401,6454779136,5,0,0,7168,5,8256525503
5743,6454779227,101161,6454880388,9,0,1,26112,9,6295988400
5744,6454814114,93436,6454907550,9,0,1,13312,9,7077082838
5745,6454836601,207950,6455044551,7,0,0,341504,7,10456375534
5746,6454858688,128094,6454986782,2,0,1,8192,2,5685965334
5747,6454937757,237991,6455175748,7,0,0,77312,7,7931206764
5748,6454946576,197755,6455144331,7,0,0,252928,7,9035153404
5749,6455004161,140836,6455144997,0,0,0,1024,0,8238100644
5750,6455109092,54096,6455163188,8,0,1,10752,8,5025144045
5751,6455147293,155661,6455302954,9,0,0,88576,9,348897152
5752,6455322815,1990,6455324805,1,0,0,2048,1,3732743333
5753,6455434295,92056,6455526351,0,0,1,17408,0,7169804568
5754,6455564521,145738,6455710259,7,0,0,237056,7,7346373011
5755,6455596817,115708,6455712525,0,0,0,3584,0,10292684575
5756,6455603590,2466,6455606056,8,0,1,29696,8,4652868115
5757,6455666582,183088,6455849670,3,0,1,12800,3,9211180469
5758,6455735959,147907,6455883866,5,0,0,2560,5,7779137941
5759,6455938267,283870,6456222137,6,0,0,459264,6,9042739676
5760,6456046285,238455,6456284740,4,0,0,341504,4,6318262481
5761,6456058663,279690,6456338353,6,0,1,11776,6,6337766134
5762,6456104466,223775,6456328241,8,0,0,3584,8,4806081112
5763,6456248569,266116,6456514685,4,0,0,434688,4,2875330819
5764,6456273483,242828,6456516311,6,0,0,2560,6,1562601252
5765,6456309112,129349,6456438461,9,0,0,339968,9,1379169635
5766,6456350868,315051,6456665919,1,0,0,5120,1,3688177474
5767,6456358523,273306,6456631829,4,0,1,38400,4,9083245375
5768,6456489573,134612,6456624185,1,0,0,1536,1,7372338719
5769,6456494803,95081,6456589884,2,0,1,23040,2,8728098141
5770,6456530356,70792,6456601148,9,0,0,14848,9,9130832386
5771,6456531133,375479,6456906612,4,0,1,6144,4,4387399302
5772,6456555951,6274,6456562225,0,0,0,2048,0,7808353221
5773,6456604285,562,6456604847,8,0,1,2048,8,9060892374
5774,6456731864,190722,6456922586,9,0,1,60416,9,5113384571
5775,6456740711,1038,6456741749,0,0,0,6656,0,7056362161
5776,6456771134,391706,6457162840,8,0,0,512,8,8162806805
5777,6456895998,276973,6457172971,3,0,0,1024,3,3485202211
5778,6456974836,94840,6457069676,8,0,1,21504,8,6962948977
5779,6457189004,33329,6457222333,7,0,0,54784,7,237797358
5780,6457198378,22700,6457221078,4,0,1,512,4,4797732057
5781,6457200619,17038,6457217657,0,0,0,1536,0,1241507997
5782,6457207267,51267,6457258534,1,0,0,1536,1,9054218860
5783,6457220202,112436,6457332638,4,0,1,17408,4,5204613066
5784,6457393898,93148,6457487046,0,0,1,25088,0,8933962636
5785,6457395589,102494,6457498083,8,0,1,20992,8,5237541377
5786,6457412964,90173,6457503137,2,0,1,12800,2,5977052144
5787,6457575872,5798,6457581670,1,0,0,6144,1,5255986622
5788,6457646992,1514,6457648506,5,0,0,1536,5,10038587760
5789,6457651252,103684,6457754936,3,0,1,40448,3,10026615177
5790,6457704004,119956,6457823960,9,0,1,37888,9,9424423531
5791,6457882804,68056,6457950860,7,0,1,9216,7,7539447322
5792,6457902848,54052,6457956900,0,0,1,3584,0,2739179956
5793,6457957925,136558,6458094483,6,0,0,225792,6,9044690547
5794,6457976504,157330,6458133834,0,0,1,5120,0,7408045724
5795,6458104579,139101,6458243680,8,0,1,1024,8,922749445
5796,6458388491,1990,6458390481,9,0,1,18944,9,8189406106
5797,6458429586,1038,6458430624,8,0,0,2048,8,3835531607
5798,6458438333,97132,6458535465,0,0,0,1024,0,10585751982
5799,6458524354,105136,6458629490,0,0,1,19456,0,543197363
5800,6458862926,1038,6458863964,0,0,0,1024,0,966388216
5801,6458943504,2866,6458946370,0,0,1,57856,0,611433305
5802,6458995960,108988,6459104948,6,0,0,8704,6,8507577471
5803,6459156103,239969,6459396072,7,0,0,444928,7,1363248529
5804,6459178620,274779,6459453399,0,0,1,3584,0,10287307992
5805,6459198374,236054,6459434428,1,0,0,5632,1,1481900885
5806,6459298949,182444,6459481393,4,0,0,159232,4,8515626771
5807,6459325065,2942,6459328007,8,0,1,22016,8,1974379739
5808,6459361989,261666,6459623655,3,0,1,29696,3,2282072271
5809,6459390882,305309,6459696191,8,0,1,40448,8,5953485196
5810,6459395721,244278,6459639999,0,0,1,16384,0,7192516607
5811,6459516232,305962,6459822194,8,0,0,3072,8,5212478068
5812,6459857933,174821,6460032754,9,0,0,283648,9,10236552796
5813,6459876314,305125,6460181439,4,0,0,388096,4,1627777815
5814,6459986355,205811,6460192166,6,0,0,43008,6,3140168488
5815,6460009392,156455,6460165847,7,0,1,1536,7,1246868469
5816,6460056909,253494,6460310403,7,0,0,68608,7,6186734867
5817,6460102863,32037,6460134900,9,0,1,5632,9,5060893699
5818,6460218522,194572,6460413094,0,0,1,10240,0,1144603772
5819,6460240701,1038,6460241739,7,0,0,52224,7,855742467
5820,6460290661,159385,6460450046,8,0,1,5120,8,9758424831
5821,6460348293,284944,6460633237,5,0,0,1024,5,7988459133
5822,6460420229,7702,6460427931,8,0,1,5120,8,2649322311
5823,6460504042,3641,6460507683,0,0,0,8192,0,1738814345
5824,6460509360,1492,6460510852,5,0,0,10240,5,8131666553
5825,6460511855,153527,6460665382,5,0,0,512,5,6545968829
5826,6460604363,562,6460604925,4,0,1,1024,4,5158197827
5827,6460635862,45592,6460681454,3,0,0,512,3,8262454291
5828,6460667869,33241,6460701110,8,0,1,28672,8,977321295
5829,6460691411,31703,6460723114,4,0,0,57856,4,3912032794
5830,6460695215,4878,6460700093,6,0,0,3584,6,4232205146
5831,6460725266,290787,6461016053,5,0,0,5120,5,3251249349
5832,6460979569,562,6460980131,3,0,0,512,3,5089349777
5833,6461057612,12991,6461070603,7,0,0,25088,7,5520196717
5834,6461084835,75292,6461160127,7,0,1,12800,7,3788219692
5835,6461111105,49762,6461160867,1,0,1,1536,1,5745154581
5836,6461125616,56195,6461181811,4,0,1,2560,4,8361020816
5837,6461131565,1514,6461133079,8,0,1,20992,8,9498219887
5838,6461154101,119180,6461273281,7,0,1,28672,7,1137410582
5839,6461221239,105391,6461326630,8,0,0,1536,8,1755616124
5840,6461233448,134491,6461367939,6,0,0,221696,6,5340766615
5841,6461289330,78955,6461368285,8,0,0,512,8,3404688531
5842,6461345378,174562,6461519940,9,0,0,283136,9,575910807
5843,6461355983,231045,6461587028,7,0,0,214528,7,7857830130
5844,6461454274,148717,6461602991,4,0,0,51712,4,4125256676
5845,6461497146,74863,6461572009,3,0,1,21504,3,4713340038
5846,6461620520,40612,6461661132,4,0,0,122368,4,6082517076
5847,6461706446,30645,6461737091,4,0,0,65536,4,10152724909
5848,6461716759,328594,6462045353,3,0,0,512,3,2096071142
5849,6461758141,142378,6461900519,4,0,0,230400,4,7861563970
5850,6461857602,68838,6461926440,9,0,0,82944,9,9959741651
5851,6461917255,170466,6462087721,7,0,1,7168,7,5766057607
5852,6462068145,357329,6462425474,6,0,0,579072,6,6523837510
5853,6462154886,234824,6462389710,2,0,1,48640,2,2273744099
5854,6462191446,226510,6462417956,4,0,1,1024,4,3370561880
5855,6462194196,215452,6462409648,8,0,0,5632,8,3033342489
5856,6462224220,154079,6462378299,6,0,0,79360,6,10032408781
5857,6462237224,324402,6462561626,0,0,0,3072,0,2620938060
5858,6462298751,289397,6462588148,9,0,0,8704,9,1545877765
5859,6462482814,67952,6462550766,8,0,1,37888,8,5842534040
5860,6462547466,218711,6462766177,2,0,1,4608,2,2764108006
5861,6462558430,149897,6462708327,2,0,1,2560,2,7983673922
5862,6462939111,12045,6462951156,6,0,0,19968,6,4006471972
5863,6463066691,2466,6463069157,9,0,1,10240,9,1407822697
5864,6463118886,76048,6463194934,3,0,1,38912,3,4332070033
5865,6463136011,1990,6463138001,8,0,0,2560,8,9035099451
5866,6463161681,103216,6463264897,8,0,0,2048,8,5747903273
5867,6463186176,336562,6463522738,6,0,0,545280,6,221003490
5868,6463381102,209748,6463590850,4,0,0,219648,4,2301408124
5869,6463468336,123500,6463591836,8,0,0,1536,8,565425657
5870,6463540508,51674,6463592182,1,0,0,512,1,6978069111
5871,6463579918,2866,6463582784,2,0,1,28160,2,10245964783
5872,6463613382,1514,6463614896,5,0,0,8704,5,3040837108
5873,6463729787,1990,6463731777,8,0,0,1536,8,1810361509
5874,6463753659,238358,6463992017,5,0,0,2048,5,3367588467
5875,6463831247,15575,6463846822,4,0,0,30208,4,3714780900
5876,6463836930,16350,6463853280,9,0,1,73728,9,5218884444
5877,6463870621,2942,6463873563,9,0,1,50688,9,1186004957
5878,6463881466,97531,6463978997,6,0,0,31744,6,7648477329
5879,6463939759,231538,6464171297,4,0,1,16384,4,1423587755
5880,6463943830,274060,6464217890,9,0,1,11264,9,9815369734
5881,6463960812,209925,6464170737,3,0,0,3072,3,10138122011
5882,6464026384,235483,6464261867,7,0,0,385024,7,3530822551
5883,6464073495,3641,6464077136,7,0,1,44032,7,7098585722
5884,6464268723,3124,6464271847,2,0,1,43520,2,10500774490
5885,6464366424,354043,6464720467,2,0,1,1024,2,8947175866
5886,6464370098,93439,6464463537,1,0,0,10240,1,10578042909
5887,6464384169,228140,6464612309,5,0,0,9216,5,8407223669
5888,6464407833,165042,6464572875,7,0,0,579072,7,3647593781
5889,6464544920,357329,6464902249,3,0,0,1536,3,8609117293
5890,6464576605,221228,6464797833,7,0,1,12800,7,3722087131
5891,6464888767,5798,6464894565,8,0,0,6144,8,517319811
5892,6464945902,76852,6465022754,1,0,1,17920,1,7250388333
5893,6464979455,144446,6465123901,9,0,0,234496,9,10156332962
5894,6465167775,2466,6465170241,8,0,0,2560,8,10522535353
5895,6465228770,2942,6465231712,8,0,0,3072,8,5757323079
5896,6465256076,7226,6465263302,5,0,0,7680,5,5276792384
5897,6465259709,188063,6465447772,1,0,1,23552,1,2104502477
5898,6465265666,24666,6465290332,9,0,1,48640,9,10694445452
5899,6465437189,214024,6465651213,3,0,0,44544,3,6140658477
5900,6465489534,232987,6465722521,3,0,0,376832,3,7420042211
5901,6465512063,292842,6465804905,7,0,0,271360,7,7450716047
5902,6465520448,240109,6465760557,8,0,1,17920,8,3284171176
5903,6465564950,315445,6465880395,5,0,0,8704,5,5984075913
5904,6465682333,205575,6465887908,3,0,1,2560,3,3588973475
5905,6465682482,252443,6465934925,2,0,1,37888,2,3766733427
5906,6465807504,156202,6465963706,7,0,1,5120,7,10330170562
5907,6465909151,188475,6466097626,4,0,0,310272,4,3329205950
5908,6465944429,174805,6466119234,9,0,0,78848,9,5008165451
5909,6465957768,367033,6466324801,6,0,0,484864,6,8994345368
5910,6466046605,264925,6466311530,7,0,1,13312,7,2661261110
5911,6466134398,206488,6466340886,3,0,1,9728,3,4126745947
5912,6466187874,275805,6466463679,8,0,1,26112,8,4901337166
5913,6466222420,140994,6466363414,9,0,1,20480,9,4299474923
5914,6466276616,521104,6466797720,3,0,0,335360,3,4249300601
5915,6466303240,327679,6466630919,1,0,1,23040,1,5477006635
5916,6466328117,270093,6466598210,3,0,1,7168,3,168656011
5917,6466370090,50252,6466420342,3,0,1,7168,3,5017190596
5918,6466375572,468557,6466844129,4,0,0,432640,4,8440374185
5919,6466529971,53573,6466583544,3,0,1,19968,3,6388099751
5920,6466597039,562,6466597601,1,0,0,2560,1,9429487009
5921,6466602869,22858,6466625727,1,0,0,3584,1,2499006862
5922,6466610265,102120,6466712385,2,0,1,8704,2,9150505006
5923,6466654571,214759,6466869330,4,0,1,23040,4,6533777701
5924,6466667950,428415,6467096365,8,0,0,512,8,6266606193
5925,6466674211,160809,6466835020,7,0,0,40960,7,3069884454
5926,6466772753,185891,6466958644,3,0,1,512,3,4744218734
5927,6466847367,41088,6466888455,7,0,0,305152,7,5184405777
5928,6466850069,31429,6466881498,8,0,1,17408,8,4800510470
5929,6466880771,412529,6467293300,2,0,1,19968,2,7545370971
5930,6466993796,279230,6467273026,1,0,0,2560,1,6538201975
5931,6467003609,355954,6467359563,4,0,0,8704,4,10630108592
5932,6467090551,306962,6467397513,6,0,0,497664,6,4877984625
5933,6467173657,224532,6467398189,1,0,1,38400,1,2792237997
5934,6467193462,210617,6467404079,9,0,1,1536,9,8839430488
5935,6467218974,177403,6467396377,6,0,0,104448,6,4220798237
5936,6467278621,122699,6467401320,7,0,0,93696,7,7936827146
5937,6467364994,350400,6467715394,3,0,0,110592,3,9478135947
5938,6467382866,149633,6467532499,3,0,1,8704,3,5771722534
5939,6467427501,4096,6467431597,8,0,1,27136,8,5219536354
5940,6467513265,246742,6467760007,2,0,1,9216,2,3873827452
5941,6467529909,103946,6467633855,1,0,0,1536,1,2636969729
5942,6467598359,92716,6467691075,7,0,0,168960,7,4526923974
5943,6467610575,254195,6467864770,0,0,0,1536,0,3279759531
5944,6467633271,2866,6467636137,8,0,1,18944,8,5831238489
5945,6467665869,206615,6467872484,7,0,1,18944,7,4074828072
5946,6467678559,162118,6467840677,7,0,1,2560,7,9230252710
5947,6467804709,2942,6467807651,9,0,1,16896,9,6391661382
5948,6467812638,117657,6467930295,5,0,0,8704,5,6966830489
5949,6467843709,280161,6468123870,5,0,0,3072,5,5694636558
5950,6467922806,129352,6468052158,4,0,1,67584,4,6119018278
5951,6467966244,99160,6468065404,1,0,1,25600,1,4832682454
5952,6468008693,96104,6468104797,8,0,1,24576,8,1525691526
5953,6468047671,96253,6468143924,9,0,1,34816,9,10183925888
5954,6468047690,123564,6468171254,4,0,1,21504,4,4628330256
5955,6468120096,139951,6468260047,9,0,0,623616,9,3777344568
5956,6468147807,385378,6468533185,6,0,0,171520,6,2344773607
5957,6468223730,324673,6468548403,9,0,1,50176,9,3052430834
5958,6468253039,410585,6468663624,6,0,0,53248,6,7657525776
5959,6468347640,321623,6468669263,7,0,1,3072,7,6276723717
5960,6468440723,138445,6468579168,5,0,0,7168,5,6299263846
5961,6468450371,71905,6468522276,9,0,1,3584,9,7642001393
5962,6468471696,61519,6468533215,8,0,1,2560,8,4078935948
5963,6468508441,161648,6468670089,4,0,1,18944,4,9388450482
5964,6468508569,4416,6468512985,8,0,0,2048,8,3294423934
5965,6468537796,149213,6468687009,9,0,1,2048,9,4339653499
5966,6468554899,3641,6468558540,7,0,1,33280,7,10082206115
5967,6468603113,189265,6468792378,4,0,1,3072,4,7881272763
5968,6468607795,125698,6468733493,7,0,0,11776,7,8122616969
5969,6468646021,293816,6468939837,3,0,1,29696,3,320075577
5970,6468647714,264920,6468912634,6,0,0,10240,6,7954130014
5971,6468732305,205750,6468938055,9,0,1,6656,9,67360572
5972,6468805606,164267,6468969873,4,0,1,4096,4,8971075412
5973,6469082613,47284,6469129897,4,0,1,1536,4,7403317587
5974,6469142961,2466,6469145427,1,0,0,2560,1,7179013820
5975,6469362842,33499,6469396341,6,0,0,58368,6,7251427518
5976,6469378606,18401,6469397007,5,0,0,1024,5,7716645488
5977,6469409328,3900,6469413228,8,0,0,10752,8,10567276506
5978,6469470625,98692,6469569317,1,0,1,24064,1,10251989877
5979,6469632313,75160,6469707473,3,0,1,17408,3,9994407817
5980,6469680364,115363,6469795727,9,0,0,187904,9,6349797018
5981,6469688403,107670,6469796073,8,0,0,512,8,4949903140
5982,6469689162,128519,6469817681,7,0,0,78848,7,9407196893
5983,6469735207,45330,6469780537,1,0,1,9728,1,344045620
5984,6469773337,3641,6469776978,1,0,0,1536,1,5737631855
5985,6469935196,228989,6470164185,1,0,0,10240,1,7345791813
5986,6470409318,2466,6470411784,8,0,0,2560,8,9128751636
5987,6470440348,3641,6470443989,8,0,0,10240,8,1405765935
5988,6470610717,562,6470611279,1,0,0,512,1,5917982463
5989,6470653982,66975,6470720957,7,0,0,113664,7,2135815858
5990,6470714241,187183,6470901424,7,0,0,307712,7,3414262690
5991,6470735571,114001,6470849572,1,0,1,9728,1,10307981028
5992,6470785794,1514,6470787308,0,0,1,11776,0,6942146597
5993,6470787769,202361,6470990130,1,0,0,512,1,1886739339
5994,6470917366,289185,6471206551,1,0,0,1536,1,3427773793
5995,6470937817,132432,6471070249,8,0,1,8192,8,8325940280
5996,6471095903,145221,6471241124,6,0,0,236032,6,5376180901
5997,6471143913,69129,6471213042,5,0,1,22016,5,5451786759
5998,6471172559,58010,6471230569,7,0,0,10752,7,7693760770
5999,6471185944,207184,6471393128,8,0,0,3584,8,5078811702
6000,6471207895,94249,6471302144,7,0,1,3584,7,957243674
6001,6471290785,28566,6471319351,9,0,0,156672,9,1686679028
6002,6471318662,15967,6471334629,1,0,1,23552,1,820643307
6003,6471359694,16712,6471376406,1,0,0,5120,1,4250709173
6004,6471373279,51770,6471425049,8,0,0,1536,8,317024241
6005,6471377360,28498,6471405858,5,0,0,7680,5,7761921897
6006,6471407841,164508,6471572349,9,0,0,83968,9,9752713791
6007,6471409134,74203,6471483337,2,0,1,512,2,3505413559
6008,6471442967,311314,6471754281,7,0,0,48640,7,4661022161
6009,6471451117,3383,6471454500,5,0,1,25600,5,7119815798
6010,6471540007,105879,6471645886,5,0,0,9728,5,7180113969
6011,6471611200,152858,6471764058,8,0,1,14336,8,6468597671
6012,6471615314,227530,6471842844,4,0,1,54272,4,2009591089
6013,6471849464,72064,6471921528,7,0,1,12288,7,9468749963
6014,6471856561,103372,6471959933,9,0,1,39424,9,3128489702
6015,6471899535,131666,6472031201,9,0,1,24064,9,5471739244
6016,6471902895,100252,6472003147,7,0,1,12288,7,98654432
6017,6471946658,149619,6472096277,2,0,1,29184,2,9729745586
6018,6472040673,11852,6472052525,8,0,0,2048,8,4382727835
6019,6472042680,3916,6472046596,7,0,1,33792,7,7974748827
6020,6472048620,107439,6472156059,1,0,0,512,1,7998566760
6021,6472093302,103461,6472196763,2,0,1,8192,2,7238642165
6022,6472242023,4846,6472246869,1,0,0,5120,1,6221733697
6023,6472255755,54676,6472310431,0,0,1,5632,0,8493413240
6024,6472412143,1038,6472413181,0,0,0,1024,0,5590826679
6025,6472446360,50668,6472497028,7,0,1,2560,7,8455083407
6026,6472484845,293737,6472778582,9,0,0,475136,9,2935467444
6027,6472528247,243471,6472771718,9,0,0,410624,9,6417206801
6028,6472597496,234076,6472831572,3,0,1,12288,3,7300159999
6029,6472627904,378916,6473006820,3,0,1,40960,3,6609409238
6030,6472642255,216628,6472858883,8,0,1,17408,8,9949558574
6031,6472675509,126205,6472801714,8,0,1,24064,8,5716710864
6032,6472710484,226498,6472936982,0,0,1,9728,0,6800842382
6033,6472723499,151235,6472874734,8,0,1,3072,8,5530207527
6034,6472758054,7970,6472766024,0,0,1,25088,0,5578536435
6035,6472769309,323897,6473093206,4,0,0,293376,4,9299177418
6036,6472829856,382252,6473212108,9,0,1,16384,9,6211592070
6037,6472846198,476262,6473322460,1,0,0,2560,1,3154134107
6038,6472990129,102416,6473092545,1,0,0,1024,1,2952324830
6039,6473072518,21138,6473093656,3,0,1,39424,3,2379858760
6040,6473075327,559191,6473634518,9,0,0,159744,9,6436465414
6041,6473161751,222407,6473384158,5,0,0,8192,5,8694655089
6042,6473176326,127344,6473303670,2,0,1,7168,2,1790544480
6043,6473290667,175079,6473465746,1,0,1,15872,1,4732985732
6044,6473310735,97269,6473408004,7,0,0,284160,7,5658056176
6045,6473388904,61012,6473449916,0,0,0,9728,0,2527662655
6046,6473426787,292662,6473719449,1,0,0,2560,1,5652644560
6047,6473608050,1038,6473609088,8,0,0,1024,8,7298245921
6048,6473663254,1990,6473665244,9,0,1,18432,9,3161443515
6049,6473679288,96976,6473776264,1,0,0,2048,1,4073744939
6050,6473856532,5322,6473861854,0,0,0,5632,0,5821564983
6051,6473863156,78052,6473941208,4,0,1,11776,4,7220993704
6052,6473955736,47284,6474003020,7,0,1,1536,7,558404413
6053,6474098547,102904,6474201451,2,0,1,37888,2,3426502458
6054,6474122495,121586,6474244081,7,0,1,15360,7,10728126568
6055,6474192498,59613,6474252111,9,0,1,2560,9,9977133267
6056,6474232242,173270,6474405512,9,0,0,280576,9,6288483117
6057,6474344057,88093,6474432150,6,0,0,94720,6,9747982418
6058,6474424359,145172,6474569531,4,0,1,35840,4,1450548264
6059,6474576909,1514,6474578423,5,0,0,1536,5,4386325118
6060,6474617151,97180,6474714331,1,0,1,29184,1,4563322179
6061,6474705329,9013,6474714342,8,0,0,1024,8,7201236116
6062,6474713477,133369,6474846846,6,0,0,214528,6,7155191333
6063,6474779140,71572,6474850712,8,0,0,6144,8,8012981956
6064,6474811690,204583,6475016273,3,0,1,8704,3,8360873688
6065,6474987133,62512,6475049645,0,0,1,6144,0,5363256967
6066,6475033395,1514,6475034909,4,0,1,58880,4,9374978796
6067,6475110736,109300,6475220036,1,0,0,1536,1,8707379107
6068,6475133450,3418,6475136868,8,0,1,40960,8,6393891153
6069,6475177136,113077,6475290213,5,0,0,3584,5,8427884005
6070,6475510821,84508,6475595329,8,0,1,12800,8,1184122564
6071,6475626155,1514,6475627669,9,0,1,14336,9,9563068210
6072,6475648307,74224,6475722531,8,0,0,1536,8,3962655035
6073,6475669623,75046,6475744669,1,0,1,18944,1,6085985595
6074,6475691285,63225,6475754510,1,0,1,11776,1,7573940213
6075,6475713552,78518,6475792070,8,0,1,4608,8,5652271433
6076,6475749961,164639,6475914600,7,0,1,16896,7,4083941808
6077,6475983964,64738,6476048702,4,0,0,105984,4,4643970433
6078,6475999588,175489,6476175077,0,0,1,58880,0,6782552521
6079,6476088188,112792,6476200980,4,0,1,41984,4,5738235021
6080,6476113632,119910,6476233542,3,0,1,9728,3,10487399323
6081,6476223720,86200,6476309920,4,0,1,13312,4,3993136639
6082,6476298449,84508,6476382957,1,0,1,12800,1,969740678
6083,6476340500,396020,6476736520,4,0,0,641024,4,4805813918
6084,6476379405,221824,6476601229,8,0,1,5632,8,316434082
6085,6476423891,354849,6476778740,5,0,1,6656,5,4239826381
6086,6476530556,415287,6476945843,7,0,0,59392,7,7550967580
6087,6476585339,278296,6476863635,4,0,1,10752,4,9307217619
6088,6476632135,251984,6476884119,9,0,1,22528,9,6093710421
6089,6476881763,562,6476882325,3,0,1,4096,3,7289302453
6090,6476887811,1514,6476889325,0,0,0,512,0,1228362585
6091,6476889799,562,6476890361,9,0,0,1536,9,3029193257
6092,6476891608,100697,6476992305,5,0,0,512,5,8539028013
6093,6476902511,115104,6477017615,7,0,0,187392,7,9009812092
6094,6476946280,123741,6477070021,9,0,0,177152,9,2747007815
6095,6476993308,215279,6477208587,3,0,1,22528,3,121723552
6096,6477117607,562,6477118169,2,0,1,9728,2,45596873
6097,6477161749,155367,6477317116,5,0,1,8192,5,4009886163
6098,6477226943,20993,6477247936,0,0,0,512,0,1081090733
6099,6477272851,147963,6477420814,4,0,0,33792,4,1402253596
6100,6477283624,4846,6477288470,5,0,1,45568,5,8595392655
6101,6477319670,106938,6477426608,4,0,0,5120,4,8676130852
6102,6477341358,50668,6477392026,5,0,1,2560,5,4746373987
6103,6477417967,20362,6477438329,7,0,0,32768,7,8097587209
6104,6477459433,101656,6477561089,0,0,1,33792,0,8965906352
6105,6477568118,7702,6477575820,5,0,1,14336,5,7797852887
6106,6477591513,80368,6477671881,9,0,0,8192,9,4435859377
6107,6477594667,192745,6477787412,9,0,0,311808,9,389966771
6108,6477698801,192340,6477891141,2,0,1,36352,2,6729926188
6109,6477804613,1990,6477806603,8,0,1,80896,8,5851144194
6110,6477817193,175524,6477992717,2,0,1,24064,2,9646181893
6111,6477891506,29300,6477920806,8,0,0,2048,8,8991406159
6112,6477958072,201266,6478159338,8,0,0,7680,8,10052973119
6113,6477973508,108694,6478082202,3,0,1,20480,3,8368519953
6114,6478044140,61288,6478105428,8,0,1,7168,8,5305336827
6115,6478177598,134421,6478312019,1,0,1,65024,1,1344941136
6116,6478278514,47284,6478325798,0,0,1,1536,0,7953995838
6117,6478339020,1514,6478340534,0,0,0,1536,0,4458524717
6118,6478348173,1514,6478349687,2,0,1,17920,2,7632667359
6119,6478409303,93748,6478503051,5,0,0,1536,5,3213386822
6120,6478434856,23204,6478458060,7,0,0,38400,7,4159669698
6121,6478438547,24339,6478462886,1,0,0,7680,1,659792934
6122,6478451656,158089,6478609745,5,0,1,73216,5,4981128119
6123,6478508002,117042,6478625044,9,0,1,50176,9,6725800532
6124,6478637905,1514,6478639419,1,0,0,1536,1,3808138009
6125,6478751448,44658,6478796106,9,0,1,34304,9,9452835738
6126,6478767103,101812,6478868915,7,0,0,76800,7,3055221748
6127,6478817594,103404,6478920998,4,0,1,5120,4,1283713193
6128,6478834848,256596,6479091444,2,0,0,416256,2,6945234309
6129,6478874839,283590,6479158429,6,0,0,214016,6,9074399211
6130,6478974796,171797,6479146593,5,0,1,20992,5,9492627636
6131,6479008649,150572,6479159221,7,0,0,72704,7,3938393031
6132,6479016219,181009,6479197228,7,0,0,64000,7,9372080460
6133,6479030659,31465,6479062124,9,0,1,2048,9,5717774841
6134,6479169309,1990,6479171299,5,0,0,5632,5,6908953905
6135,6479199050,383856,6479582906,5,0,1,16384,5,4670235115
6136,6479307728,184924,6479492652,1,0,0,2048,1,6899457696
6137,6479326454,80410,6479406864,2,0,1,1536,2,4819859825
6138,6479360424,178918,6479539342,8,0,1,41472,8,5154221846
6139,6479483110,111172,6479594282,4,0,1,65024,4,8788035189
6140,6479495246,7361,6479502607,9,0,1,13312,9,675470656
6141,6479566156,117608,6479683764,2,0,1,5120,2,10495757855
6142,6479592363,67390,6479659753,9,0,0,13824,9,4360297192
6143,6479649629,86450,6479736079,3,0,0,144896,3,9748505003
6144,6479765389,562,6479765951,0,0,0,512,0,8544290231
6145,6479777772,1038,6479778810,5,0,1,4608,5,7216527567
6146,6479793647,122962,6479916609,8,0,0,1024,8,3107877636
6147,6479835917,155863,6479991780,9,0,0,253440,9,9923948891
6148,6479934946,5726,6479940672,2,0,1,9728,2,9350197356
6149,6479987130,146973,6480134103,0,0,0,13312,0,4675511745
6150,6480029374,97444,6480126818,1,0,1,19456,1,2426664159
6151,6480084402,6831,6480091233,4,0,1,19968,4,650377216
6152,6480136116,69283,6480205399,8,0,1,7680,8,4660423607
6153,6480162412,181964,6480344376,8,0,1,7680,8,8934757867
6154,6480176062,67588,6480243650,0,0,0,1024,0,141747338
6155,6480177150,54001,6480231151,4,0,1,3072,4,1869184798
6156,6480207746,66211,6480273957,9,0,1,85504,9,10238952589
6157,6480210373,158229,6480368602,4,0,1,2048,4,1263519329
6158,6480250418,143412,6480393830,7,0,0,232448,7,2458540118
6159,6480259372,140257,6480399629,2,0,0,27648,2,695134446
6160,6480290924,144892,6480435816,7,0,0,123904,7,8772105731
6161,6480297745,176632,6480474377,2,0,1,45568,2,1138583452
6162,6480354346,72537,6480426883,6,0,0,264704,6,9513166161
6163,6480384537,59327,6480443864,2,0,1,27136,2,1770370429
6164,6480515495,28563,6480544058,4,0,0,117760,4,7275216201
6165,6480529371,350183,6480879554,0,0,0,1024,0,6608148931
6166,6480561441,382748,6480944189,5,0,0,2048,5,3068648619
6167,6480851664,4933,6480856597,5,0,0,12800,5,1001813545
6168,6480868828,106804,6480975632,9,0,1,50688,9,3179635805
6169,6480931022,51770,6480982792,6,0,0,83968,6,6672474553
6170,6480934252,50166,6480984418,5,0,0,2560,5,8266781236
6171,6480970283,79616,6481049899,7,0,0,124416,7,189205204
6172,6480972964,370293,6481343257,4,0,0,538624,4,6016238863
6173,6481003306,344777,6481348083,5,0,0,7680,5,6631218832
6174,6481106725,244904,6481351629,0,0,0,5632,0,95368282
6175,6481133267,219988,6481353255,1,0,0,2560,1,6416559066
6176,6481139831,185259,6481325090,3,0,0,271360,3,7464534177
6177,6481197274,306747,6481504021,4,0,1,8192,4,3870411969
6178,6481233657,212932,6481446589,1,0,0,512,1,4372772495
6179,6481246690,201149,6481447839,7,0,0,40448,7,3677658583
6180,6481261308,328245,6481589553,6,0,1,55808,6,3715954814
6181,6481266017,330833,6481596850,7,0,0,483840,7,1958150058
6182,6481388591,285510,6481674101,4,0,0,254976,4,71242181
6183,6481393972,261107,6481655079,0,0,1,12288,0,8195828453
6184,6481395644,313610,6481709254,2,0,1,13312,2,6054587707
6185,6481416540,235580,6481652120,0,0,0,5632,0,1915386874
6186,6481432046,114793,6481546839,7,0,0,227328,7,85555827
6187,6481508894,93350,6481602244,2,0,1,8192,2,4363004827
6188,6481511382,64224,6481575606,8,0,0,2048,8,5833593930
6189,6481542516,378260,6481920776,5,0,1,64512,5,8190530002
6190,6481634115,49873,6481683988,8,0,0,3072,8,10688649462
6191,6481656864,396442,6482053306,0,0,0,2048,0,6642772866
6192,6481691379,25442,6481716821,7,0,0,25600,7,8104615679
6193,6481727850,343778,6482071628,3,0,0,81408,3,6462866047
6194,6481794222,474926,6482269148,2,0,0,46080,2,10197981033
6195,6482060046,4933,6482064979,7,0,1,15872,7,7147765979
6196,6482182735,210436,6482393171,0,0,1,10240,0,7848648278
6197,6482193932,106790,6482300722,1,0,0,12800,1,8792173969
6198,6482358325,54266,6482412591,4,0,0,92160,4,7450169580
6199,6482408880,1990,6482410870,8,0,1,1536,8,237651161
6200,6482425153,96176,6482521329,8,0,0,2048,8,10289356375
6201,6482434808,562,6482435370,6,0,1,10752,6,997187448
6202,6482510456,165376,6482675832,1,0,0,512,1,1561882366
6203,6482522744,108833,6482631577,7,0,1,11776,7,9568707891
6204,6482604352,198859,6482803211,4,0,0,327168,4,1731598979
6205,6482703051,172074,6482875125,3,0,0,229376,3,4906850032
6206,6482706824,169149,6482875973,8,0,1,7680,8,1201896363
6207,6482708562,174742,6482883304,0,0,0,4096,0,3241366329
6208,6482709075,192565,6482901640,3,0,0,20992,3,4053254575
6209,6482711832,214817,6482926649,0,0,1,10240,0,9231292737
6210,6482731672,12647,6482744319,2,0,0,209920,2,4722321985
6211,6482935468,313689,6483249157,8,0,0,2560,8,5269791754
6212,6482967842,3383,6482971225,9,0,1,2048,9,1891841489
6213,6483006556,126922,6483133478,6,0,1,7168,6,3616638699
6214,6483055266,14113,6483069379,8,0,0,9728,8,7217214375
6215,6483061433,185127,6483246560,5,0,1,19968,5,7832104684
6216,6483101757,1475,6483103232,4,0,0,24064,4,2513181749
6217,6483166181,180572,6483346753,3,0,1,6656,3,1450505756
6218,6483190762,78849,6483269611,8,0,0,512,8,9448217730
6219,6483258288,21395,6483279683,6,0,0,34816,6,9604445639
6220,6483474932,54052,6483528984,4,0,1,3584,4,4317441613
6221,6483500560,88360,6483588920,9,0,1,15360,9,3588199100
6222,6483639143,47284,6483686427,5,0,1,15360,5,1892330379
6223,6483660384,79144,6483739528,0,0,1,1536,0,8445534413
6224,6483710073,8225,6483718298,0,0,0,13312,0,4569382663
6225,6483726123,99316,6483825439,0,0,1,26112,0,1092973272
6226,6483790825,35050,6483825875,3,0,0,61440,3,8818929035
6227,6483840067,15575,6483855642,7,0,1,36864,7,1723660022
6228,6483884273,120397,6484004670,2,0,0,30208,2,10210196049
6229,6483900353,2942,6483903295,0,0,1,9728,0,10158309655
6230,6483901276,4370,6483905646,7,0,1,38912,7,2508231826
6231,6483975813,103216,6484079029,8,0,0,3072,8,10045787893
6232,6483983818,118575,6484102393,8,0,0,4608,8,378798497
6233,6484110547,243424,6484353971,6,0,0,489984,6,5133258652
6234,6484165122,299592,6484464714,0,0,1,9216,0,10315488428
6235,6484180524,291261,6484471785,9,0,1,8704,9,3851933243
6236,6484228156,97719,6484325875,2,0,0,351232,2,2453009949
6237,6484260032,50839,6484310871,3,0,1,9728,3,10101542445
6238,6484320113,364700,6484684813,9,0,1,12288,9,9438274002
6239,6484423004,256581,6484679585,1,0,0,2048,1,10613605023
6240,6484485642,46208,6484531850,7,0,0,58880,7,8979780506
6241,6484557354,370687,6484928041,4,0,0,79872,4,1458267184
6242,6484568659,179236,6484747895,1,0,1,7680,1,6669337121
6243,6484589945,212282,6484802227,9,0,1,27648,9,5741719604
6244,6484598745,207549,6484806294,7,0,1,13312,7,9552577965
6245,6484699361,164954,6484864315,9,0,0,267776,9,10563695501
6246,6484710435,157106,6484867541,8,0,0,5120,8,1686745095
6247,6484713296,166770,6484880066,5,0,1,18432,5,3231088797
6248,6484724176,234146,6484958322,2,0,1,30208,2,5363217172
6249,6484726488,218895,6484945383,7,0,0,90112,7,6582051162
6250,6484761395,213380,6484974775,1,0,1,50176,1,2308220928
6251,6484783790,113295,6484897085,4,0,1,16384,4,9164082547
6252,6484787092,93298,6484880390,0,0,1,11264,0,7253122429
6253,6484904488,313522,6485218010,4,0,0,183808,4,835450067
6254,6484927071,243177,6485170248,0,0,0,4096,0,1561663085
6255,6485014814,151903,6485166717,2,0,1,17408,2,9699315207
6256,6485024063,5039,6485029102,2,0,0,237056,2,7419685052
6257,6485171593,258892,6485430485,0,0,0,1024,0,10274748015
6258,6485349531,42679,6485392210,7,0,0,69632,7,959974887
6259,6485350458,42418,6485392876,8,0,0,1024,8,4234498266
6260,6485403425,25183,6485428608,9,0,0,45568,9,9831782464
6261,6485410905,23809,6485434714,7,0,0,20992,7,8198189416
6262,6485446109,101584,6485547693,1,0,1,22016,1,7175987578
6263,6485528232,25183,6485553415,4,0,1,1536,4,3966553382
6264,6485632117,228727,6485860844,9,0,0,45568,9,1822150013
6265,6485677644,163535,6485841179,0,0,1,512,0,5290250139
6266,6485729160,266891,6485996051,6,0,0,436224,6,926918490
6267,6485762221,240243,6486002464,4,0,0,30720,4,9128405489
6268,6485817511,185107,6486002618,1,0,0,8704,1,8000868956
6269,6485821179,78472,6485899651,1,0,1,8704,1,6516511507
6270,6485934771,15787,6485950558,4,0,0,34304,4,2624059318
6271,6485998442,1038,6485999480,5,0,0,1536,5,6191251011
6272,6486028129,250634,6486278763,0,0,0,1024,0,9013260190
6273,6486037855,308942,6486346797,3,0,0,504832,3,2347254761
6274,6486093812,274572,6486368384,3,0,1,9728,3,1802525929
6275,6486117889,373810,6486491699,2,0,0,464384,2,8344798912
6276,6486155327,410572,6486565899,2,0,1,23552,2,4063588858
6277,6486259054,233289,6486492343,8,0,1,38912,8,669516225
6278,6486279361,124196,6486403557,5,0,1,59904,5,5120376981
6279,6486410494,426179,6486836673,3,0,1,3584,3,8198582637
6280,6486470614,160800,6486631414,0,0,1,10240,0,10221809675
6281,6486522316,473995,6486996311,2,0,0,201728,2,177306836
6282,6486543558,562,6486544120,2,0,0,186880,2,4596168
6283,6486562614,344266,6486906880,6,0,1,46080,6,2169290924
6284,6486599619,468715,6487068334,0,0,1,34816,0,4306512327
6285,6486624565,243408,6486867973,2,0,1,66560,2,3810735999
6286,6486768584,431660,6487200244,8,0,1,22528,8,510968121
6287,6486874661,467225,6487341886,8,0,0,512,8,302177156
6288,6487063319,5031,6487068350,1,0,0,1536,1,4029416474
6289,6487067612,5192,6487072804,0,0,0,13312,0,6694787371
6290,6487110024,1990,6487112014,8,0,0,2048,8,2140745582
6291,6487121166,4370,6487125536,5,0,0,4608,5,9104210517
6292,6487139494,1038,6487140532,8,0,0,1024,8,974377526
6293,6487155682,334753,6487490435,3,0,0,541696,3,8464786482
6294,6487305856,160092,6487465948,4,0,1,16896,4,4590462448
6295,6487320940,133071,6487454011,3,0,1,82432,3,5075375481
6296,6487330689,219982,6487550671,1,0,0,512,1,8100473938
6297,6487367500,314326,6487681826,4,0,1,129024,4,3566634459
6298,6487374492,235312,6487609804,4,0,0,64000,4,5204316557
6299,6487414463,164596,6487579059,4,0,0,381440,4,5329795287
6300,6487496316,136404,6487632720,9,0,0,36864,9,5539984489
6301,6487520759,153468,6487674227,1,0,1,6144,1,9111827791
6302,6487524854,380917,6487905771,0,0,0,512,0,7481826296
6303,6487529090,231831,6487760921,6,0,0,69120,6,2429996405
6304,6487535451,220454,6487755905,2,0,0,236544,2,7870447132
6305,6487740089,30490,6487770579,6,0,0,36352,6,5879962519
6306,6487824657,195241,6488019898,9,0,0,320000,9,6062793957
6307,6487850767,170757,6488021524,8,0,0,2560,8,3773199112
6308,6487857182,81660,6487938842,0,0,1,6656,0,3603747112
6309,6487950284,2942,6487953226,2,0,0,33280,2,1221135914
6310,6488061373,93616,6488154989,0,0,0,3072,0,238009938
6311,6488151386,392170,6488543556,8,0,1,512,8,10223071567
6312,6488322190,104374,6488426564,2,0,0,173056,2,8976032286
6313,6488347599,80553,6488428152,0,0,0,15872,0,7375104687
6314,6488371460,13337,6488384797,7,0,1,6656,7,3209732968
6315,6488424443,98751,6488523194,7,0,0,22528,7,5857022137
6316,6488606373,20620,6488626993,4,0,0,33280,4,10249844248
6317,6488621269,263078,6488884347,4,0,0,572416,4,7927682902
6318,6488666626,350475,6489017101,2,0,1,512,2,9753100109
6319,6488706630,322755,6489029385,4,0,0,194048,4,7534340927
6320,6488726368,364972,6489091340,3,0,0,198144,3,1155106125
6321,6488747129,361095,6489108224,4,0,0,64512,4,4768835673
6322,6488825288,201280,6489026568,1,0,1,1536,1,9971156816
6323,6488912129,201989,6489114118,4,0,0,16384,4,8760089996
6324,6488913046,67018,6488980064,8,0,0,2560,8,1873725050
6325,6489051883,53839,6489105722,8,0,0,6144,8,9127504834
6326,6489069888,75485,6489145373,0,0,0,7680,0,7818726205
6327,6489074061,65244,6489139305,4,0,0,82432,4,9993345470
6328,6489085928,340941,6489426869,8,0,0,2560,8,9297639277
6329,6489156725,84212,6489240937,7,0,0,137216,7,6541590535
6330,6489176919,6750,6489183669,0,0,1,7168,0,1500941332
6331,6489277844,6750,6489284594,1,0,0,7168,1,3313186681
6332,6489338598,234667,6489573265,6,0,1,69632,6,4398279743
6333,6489354412,96317,6489450729,0,0,0,7168,0,9618556742
6334,6489385647,76061,6489461708,9,0,0,160768,9,7958027601
6335,6489406569,66541,6489473110,8,0,0,1024,8,6767069614
6336,6489416435,209871,6489626306,5,0,0,512,5,5504084151
6337,6489466249,50698,6489516947,8,0,1,58368,8,8677606129
6338,6489491152,30846,6489521998,8,0,1,3584,8,8743426657
6339,6489497782,13766,6489511548,7,0,0,59392,7,10107757478
6340,6489517645,215052,6489732697,9,0,0,43520,9,334082347
6341,6489577711,3641,6489581352,9,0,1,47616,9,6661061932
6342,6489614809,2466,6489617275,6,0,0,26624,6,1627090097
6343,6489691413,325696,6490017109,4,0,1,12288,4,8605848818
6344,6489715746,228753,6489944499,8,0,0,10240,8,3898226516
6345,6489724503,63704,6489788207,5,0,0,2560,5,1621445499
6346,6489725622,51860,6489777482,0,0,1,6656,0,1225470126
6347,6489772622,162690,6489935312,2,0,0,103936,2,6364001492
6348,6489795500,198387,6489993887,4,0,0,36352,4,2937546561
6349,6489855998,2942,6489858940,1,0,1,50688,1,6801238571
6350,6489930016,5322,6489935338,1,0,0,3072,1,2297559561
6351,6489952544,219352,6490171896,1,0,1,3072,1,759429736
6352,6489973671,123761,6490097432,1,0,0,5632,1,4813115324
6353,6490063825,15381,6490079206,1,0,0,3072,1,1422221647
6354,6490081300,4158,6490085458,2,0,1,16384,2,2664420753
6355,6490133928,92602,6490226530,5,0,0,11264,5,4831631825
6356,6490190222,327988,6490518210,4,0,0,531968,4,2024177939
6357,6490210249,313350,6490523599,4,0,0,25600,4,5646006567
6358,6490226019,84124,6490310143,6,0,1,3584,6,3427660465
6359,6490241471,345698,6490587169,8,0,1,49152,8,9696237165
6360,6490487235,407821,6490895056,4,0,0,140288,4,1956720811
6361,6490541295,170876,6490712171,2,0,1,16384,2,72645766
6362,6490683366,30745,6490714111,6,0,0,49664,6,5987527151
6363,6490686319,73107,6490759426,4,0,0,98304,4,7644303611
6364,6490690341,70711,6490761052,8,0,0,2560,8,4446457402
6365,6490873222,13079,6490886301,7,0,0,22016,7,8608368901
6366,6490899477,2942,6490902419,7,0,1,23552,7,2714125623
6367,6490908205,60820,6490969025,5,0,0,3072,5,2163529104
6368,6490920720,3418,6490924138,2,0,1,5632,2,6259105265
6369,6491002348,47284,6491049632,8,0,1,1536,8,10635966412
6370,6491033929,200965,6491234894,6,0,1,47616,6,9946440000
6371,6491035509,105868,6491141377,0,0,0,3584,0,4268281950
6372,6491113059,64717,6491177776,5,0,1,46592,5,10218887599
6373,6491137484,117734,6491255218,7,0,0,101376,7,6521934783
6374,6491303510,45592,6491349102,2,0,1,1024,2,4908483675
6375,6491371063,114129,6491485192,7,0,1,19456,7,8098234778
6376,6491480520,38251,6491518771,6,0,0,55296,6,9408262319
6377,6491553802,47284,6491601086,4,0,1,1536,4,7827892374
6378,6491601838,562,6491602400,1,0,0,512,1,10203264340
6379,6491643474,46467,6491689941,9,0,1,37376,9,1208662318
6380,6491683871,19781,6491703652,3,0,0,80384,3,3646546524
6381,6491711940,102748,6491814688,5,0,0,14848,5,10138509056
6382,6491755048,63358,6491818406,4,0,0,106496,4,8645770738
6383,6491827030,1038,6491828068,4,0,1,23040,4,5056747348
6384,6491995088,200593,6492195681,0,0,0,1024,0,5227569825
6385,6492059767,47284,6492107051,9,0,1,20480,9,3283834773
6386,6492100321,94528,6492194849,4,0,1,1536,4,2092100238
6387,6492241754,3641,6492245395,1,0,0,10240,1,3095791820
6388,6492248287,96064,6492344351,3,0,1,20480,3,5800701813
6389,6492269694,84729,6492354423,4,0,0,138240,4,828358596
6390,6492321640,33129,6492354769,5,0,0,512,5,325478002
6391,6492321707,33408,6492355115,1,0,0,512,1,3401683286
6392,6492503906,1990,6492505896,0,0,0,2048,0,4314526487
6393,6492533079,96981,6492630060,6,0,1,20992,6,6174023330
6394,6492536995,101188,6492638183,9,0,1,26624,9,2696937275
6395,6492629533,225683,6492855216,4,0,0,355840,4,1080455839
6396,6492657651,208292,6492865943,3,0,0,43008,3,7791920767
6397,6492663621,212552,6492876173,8,0,1,25088,8,1044593638
6398,6492685572,119006,6492804578,9,0,0,113152,9,2457283294
6399,6492762034,18776,6492780810,0,0,1,8704,0,10091427544
6400,6492785019,271796,6493056815,3,0,0,28160,3,7644243034
6401,6492809689,189895,6492999584,4,0,1,56320,4,10539510058
6402,6492890075,41387,6492931462,5,0,0,7680,5,2114197497
6403,6492979107,270610,6493249717,2,0,0,67072,2,4589525196
6404,6493129381,217848,6493347229,9,0,0,459264,9,2640522558
6405,6493161226,283870,6493445096,6,0,0,206336,6,602105382
6406,6493186754,313980,6493500734,6,0,1,13312,6,3086146820
6407,6493265913,230184,6493496097,6,0,0,67072,6,4602990347
6408,6493425885,73758,6493499643,2,0,0,5632,2,92932409
6409,6493558269,212008,6493770277,0,0,1,16896,0,2445978637
6410,6493577548,201765,6493779313,2,0,0,511488,2,2299826816
6411,6493592913,315795,6493908708,9,0,0,4096,9,10272464704
6412,6493595797,303016,6493898813,0,0,1,11264,0,9009168754
6413,6493628499,278312,6493906811,5,0,1,11776,5,5000632712
6414,6493648876,264177,6493913053,7,0,0,108544,7,1356766698
6415,6493663357,151387,6493814744,2,0,0,512,2,4129274811
6416,6493776813,135528,6493912341,5,0,0,1024,5,4714774054
6417,6493793018,171583,6493964601,0,0,0,512,0,2322332946
6418,6493859508,199998,6494059506,4,0,1,1024,4,914843834
6419,6493882752,470886,6494353638,5,0,1,2048,5,2853028184
6420,6493917453,199751,6494117204,3,0,1,54272,3,5785322083
6421,6493950820,134026,6494084846,9,0,1,12288,9,3036561803
6422,6494106795,4846,6494111641,4,0,1,47104,4,5059623266
6423,6494228708,364524,6494593232,5,0,1,3584,5,9676654439
6424,6494259761,66363,6494326124,5,0,0,5120,5,8491137612
6425,6494353424,60064,6494413488,9,0,1,8192,9,3550574969
6426,6494396754,32554,6494429308,4,0,1,19456,4,251387197
6427,6494425895,105330,6494531225,3,0,0,53248,3,4430918436
6428,6494441199,186431,6494627630,6,0,0,301056,6,9108870176
6429,6494499830,132306,6494632136,8,0,0,7168,8,4222583443
6430,6494502304,136245,6494638549,7,0,0,30720,7,1041777975
6431,6494507354,69069,6494576423,7,0,1,24064,7,7854981720
6432,6494572066,230721,6494802787,1,0,0,4096,1,10051450147
6433,6494581801,213788,6494795589,0,0,1,19968,0,7077570075
6434,6494757824,115533,6494873357,6,0,0,191488,6,6857368752
6435,6494898456,1038,6494899494,6,0,1,7168,6,8493544878
6436,6494943701,60376,6495004077,5,0,1,9216,5,7912811315
6437,6494965630,62512,6495028142,9,0,1,6144,9,4275158377
6438,6494989268,204488,6495193756,5,0,0,1024,5,3456697076
6439,6495050063,79300,6495129363,5,0,1,512,5,1140881918
6440,6495058058,112472,6495170530,4,0,1,15872,4,5878059220
6441,6495093779,75916,6495169695,1,0,1,14848,1,5426852468
6442,6495117599,47284,6495164883,7,0,1,26112,7,7932437257
6443,6495125430,97780,6495223210,9,0,1,1536,9,1845413977
6444,6495203435,54052,6495257487,8,0,1,3584,8,8720355073
6445,6495263061,74087,6495337148,6,0,0,120832,6,1392823234
6446,6495269117,103468,6495372585,7,0,1,22528,7,6249588294
6447,6495290216,161609,6495451825,3,0,0,155648,3,8821011412
6448,6495414882,3418,6495418300,7,0,1,22528,7,4901639735
6449,6495426985,133071,6495560056,6,0,1,50176,6,3166207685
6450,6495456000,158264,6495614264,8,0,0,3584,8,4555436697
6451,6495544516,1514,6495546030,4,0,1,6656,4,1197535601
6452,6495556727,83620,6495640347,1,0,1,19968,1,2111139503
6453,6495618207,140445,6495758652,1,0,0,1536,1,269030521
6454,6495773863,5798,6495779661,8,0,0,6144,8,5375275880
6455,6495778520,98380,6495876900,2,0,1,23040,2,3050813566
6456,6495839839,1514,6495841353,1,0,1,32256,1,8622086515
6457,6495868212,131753,6495999965,4,0,1,48128,4,4372655747
6458,6495922210,17702,6495939912,2,0,0,1536,2,2793116162
6459,6495926233,172649,6496098882,3,0,1,19968,3,4147626559
6460,6495982274,99881,6496082155,9,0,0,5632,9,2226389256
6461,6496022075,95307,6496117382,0,0,1,14848,0,4255031422
6462,6496134805,26217,6496161022,3,0,0,47616,3,255633065
6463,6496174376,61302,6496235678,0,0,1,2560,0,3282354848
6464,6496194310,94396,6496288706,4,0,1,25088,4,8258933055
6465,6496302556,65535,6496368091,0,0,1,12288,0,10250324495
6466,6496303707,88516,6496392223,6,0,1,15872,6,3994423683
6467,6496309049,153279,6496462328,4,0,0,248320,4,1027642690
6468,6496356064,160331,6496516395,7,0,1,4096,7,7275972187
6469,6496367623,374005,6496741628,6,0,0,578048,6,853362626
6470,6496380542,402714,6496783256,7,0,0,133632,7,7010428145
6471,6496519683,346265,6496865948,3,0,0,272896,3,93170845
6472,6496595730,332351,6496928081,9,0,0,709120,9,902275985
6473,6496608479,167979,6496776458,5,0,0,2560,5,1417527689
6474,6496625138,526976,6497152114,0,0,1,2048,0,8521443202
6475,6496629010,515853,6497144863,6,0,1,14848,6,6509972394
6476,6496691873,436325,6497128198,1,0,0,6144,1,5510289122
6477,6496710268,418276,6497128544,0,0,0,512,0,5389944399
6478,6496750710,378820,6497129530,1,0,0,1536,1,5351202985
6479,6496799091,63727,6496862818,1,0,1,17920,1,9017549865
6480,6496858743,1038,6496859781,2,0,1,7168,2,4746592102
6481,6497081254,440325,6497521579,3,0,0,57344,3,6607478608
6482,6497149470,2466,6497151936,8,0,1,24576,8,7814825194
6483,6497180748,699280,6497880028,2,0,0,1024,2,9188741368
6484,6497291765,3418,6497295183,0,0,0,2560,0,9418818136
6485,6497372062,346385,6497718447,3,0,1,8704,3,3076611169
6486,6497426529,126456,6497552985,5,0,0,3584,5,4143626766
6487,6497510725,117600,6497628325,3,0,0,195584,3,10010998926
6488,6497525005,104626,6497629631,7,0,0,2048,7,1312110306
6489,6497602503,28114,6497630617,0,0,0,1536,0,3907358463
6490,6497636141,175252,6497811393,6,0,1,43520,6,10442236983
6491,6497793696,32295,6497825991,6,0,1,13312,6,1480562733
6492,6497813011,75448,6497888459,4,0,0,52736,4,6363765400
6493,6497928606,76067,6498004673,3,0,0,128000,3,534400836
6494,6497941646,38656,6497980302,9,0,1,65536,9,4018582034
6495,6497969563,26667,6497996230,4,0,0,5632,4,8400060253
6496,6497981898,562,6497982460,8,0,0,512,8,10558100598
6497,6498040108,74139,6498114247,1,0,0,512,1,552137268
6498,6498054970,51292,6498106262,2,0,1,1024,2,4233931356
6499,6498055420,31779,6498087199,2,0,1,9216,2,8583365007
6500,6498081260,76204,6498157464,5,0,1,4608,5,3329327131
6501,6498092549,4370,6498096919,9,0,1,10752,9,4500635453
6502,6498101558,284077,6498385635,9,0,0,51712,9,4571451494
6503,6498128422,173122,6498301544,9,0,1,40960,9,4671065468
6504,6498189034,73999,6498263033,5,0,0,4608,5,5296859334
6505,6498194888,163722,6498358610,4,0,0,123904,4,1210545807
6506,6498266647,155516,6498422163,3,0,0,256000,3,2086048995
6507,6498273528,142859,6498416387,9,0,0,450048,9,5126456261
6508,6498277485,348564,6498626049,5,0,0,3072,5,9467558611
6509,6498413388,346553,6498759941,0,0,1,10752,0,1470326062
6510,6498435383,238194,6498673577,3,0,0,224768,3,9023119683
6511,6498468511,256152,6498724663,2,0,1,33280,2,798951010
6512,6498558071,138649,6498696720,9,0,0,16384,9,5955261461
6513,6498628458,1038,6498629496,1,0,1,2048,1,6946195281
6514,6498728116,149385,6498877501,8,0,0,1024,8,1907994447
6515,6498757283,177575,6498934858,4,0,0,292352,4,8338793469
6516,6498768775,243232,6499012007,4,0,0,254464,4,5924265022
6517,6498777591,291955,6499069546,7,0,0,185344,7,9711757062
6518,6498848892,303550,6499152442,4,0,0,273920,4,6501199014
6519,6498849557,339380,6499188937,7,0,0,125440,7,6277860763
6520,6498982229,287475,6499269704,8,0,1,18432,8,7907059792
6521,6499035482,335821,6499371303,2,0,1,40960,2,10711402274
6522,6499071647,162367,6499234014,4,0,0,494080,4,6262377268
6523,6499210225,172166,6499382391,0,0,1,32256,0,1188856705
6524,6499245447,19431,6499264878,8,0,0,512,8,1726045608
6525,6499247234,477009,6499724243,7,0,1,5120,7,1440259351
6526,6499277276,84988,6499362264,9,0,0,133632,9,9759864685
6527,6499288822,62670,6499351492,8,0,1,9216,8,4989829250
6528,6499300118,370043,6499670161,0,0,1,51712,0,1419385624
6529,6499432597,339477,6499772074,5,0,0,4096,5,4184725134
6530,6499439373,427913,6499867286,1,0,0,138752,1,816350401
6531,6499493659,417732,6499911391,4,0,0,101888,4,2850450293
6532,6499597739,203904,6499801643,3,0,0,330240,3,8623122352
6533,6499610630,113037,6499723667,1,0,1,16384,1,5775705685
6534,6499757313,95186,6499852499,0,0,1,512,0,3259553085
6535,6499769814,352946,6500122760,4,0,0,183296,4,1876568897
6536,6499790251,286543,6500076794,0,0,0,4096,0,1520530437
6537,6499800324,376781,6500177105,2,0,1,4096,2,9656456523
6538,6499957306,317901,6500275207,3,0,0,846336,3,7573650719
6539,6500140429,520275,6500660704,8,0,1,22528,8,9333303762
6540,6500183509,296658,6500480167,8,0,0,4096,8,221005864
6541,6500193985,292186,6500486171,5,0,0,20480,5,9219125865
6542,6500253442,274357,6500527799,1,0,0,141824,1,6828881921
6543,6500396495,132610,6500529105,2,0,0,2048,2,5626548038
6544,6500437953,54199,6500492152,6,0,1,27648,6,2058179600
6545,6500476852,334717,6500811569,8,0,0,3072,8,8393337391
6546,6500716444,59128,6500775572,1,0,1,5120,1,9243960519
6547,6500863073,6274,6500869347,2,0,1,10240,2,10202584009
6548,6500896052,72976,6500969028,0,0,0,6656,0,7440561878
6549,6500940201,1990,6500942191,2,0,0,2048,2,1694816226
6550,6500948545,67234,6501015779,7,0,0,114176,7,596623041
6551,6501057291,83954,6501141245,6,0,0,136704,6,4532058824
6552,6501075979,70758,6501146737,1,0,0,17920,1,6537642243
6553,6501109063,38288,6501147351,0,0,1,73216,0,5387571696
6554,6501109435,193366,6501302801,8,0,0,1536,8,6169435663
6555,6501278516,1514,6501280030,1,0,1,19968,1,4182837878
6556,6501319859,95908,6501415767,2,0,0,1536,2,4268788469
6557,6501324619,454060,6501778679,9,0,0,1284608,9,1078105018
6558,6501393501,387064,6501780565,5,0,1,29184,5,7083511177
6559,6501393932,251111,6501645043,0,0,1,3072,0,10566328828
6560,6501411339,438994,6501850333,4,0,0,276992,4,4083004649
6561,6501467228,413622,6501880850,1,0,1,3584,1,3289245467
6562,6501494131,394771,6501888902,2,0,1,9728,2,5543319774
6563,6501558281,595272,6502153553,9,0,1,46080,9,1575321467
6564,6501572740,793221,6502365961,8,0,1,31744,8,5377736022
6565,6501585099,581898,6502166997,8,0,1,26112,8,1541239322
6566,6501676100,790012,6502466112,6,0,1,27136,6,9810545840
6567,6501752258,454482,6502206740,6,0,0,25600,6,10305398434
6568,6501805335,458534,6502263869,3,0,0,183296,3,1175009744
6569,6501812957,329940,6502142897,7,0,0,202240,7,2882658372
6570,6501871323,513686,6502385009,6,0,0,83456,6,6886836153
6571,6501996533,481344,6502477877,2,0,1,28672,2,3231088495
6572,6502014857,372883,6502387740,1,0,1,8704,1,10147059696
6573,6502027159,206050,6502233209,3,0,0,161280,3,5544504923
6574,6502194978,407160,6502602138,2,0,0,1536,2,4555843075
6575,6502242029,212588,6502454617,3,0,1,7168,3,3788260187
6576,6502249453,212174,6502461627,6,0,1,16384,6,3272319165
6577,6502256565,268652,6502525217,2,0,1,31744,2,60555128
6578,6502261717,363177,6502624894,2,0,1,2048,2,9702456295
6579,6502265440,351101,6502616541,1,0,1,12800,1,1801417241
6580,6502313112,404858,6502717970,7,0,1,13824,7,5029299806
6581,6502352733,334237,6502686970,7,0,0,540672,7,6413814611
6582,6502363208,324108,6502687316,7,0,0,512,7,6427150460
6583,6502400140,282351,6502682491,0,0,1,2048,0,3557388509
6584,6502405836,278934,6502684770,9,0,0,12288,9,9622469869
6585,6502455911,267038,6502722949,4,0,0,157696,4,6259236294
6586,6502472313,333220,6502805533,0,0,0,7168,0,1544131623
6587,6502488311,435157,6502923468,4,0,0,262144,4,9812818440
6588,6502536508,368227,6502904735,3,0,0,275456,3,5459317250
6589,6502580401,330338,6502910739,9,0,0,28672,9,853093255
6590,6502633161,279844,6502913005,8,0,0,3584,8,10258037643
6591,6502638500,287946,6502926446,6,0,1,34816,6,4077991081
6592,6502676645,114760,6502791405,3,0,0,173056,3,4722384588
6593,6502850817,109230,6502960047,8,0,0,1536,8,1579469559
6594,6502861532,64834,6502926366,8,0,0,24576,8,1897885939
6595,6502871990,504472,6503376462,7,0,1,42496,7,7234740460
6596,6502885193,320769,6503205962,2,0,1,2048,2,8506117731
6597,6502921993,401585,6503323578,5,0,0,52224,5,7376591745
6598,6503119065,228594,6503347659,1,0,1,12800,1,10232777905
6599,6503140074,179920,6503319994,1,0,0,366080,1,6164738216
6600,6503191124,284744,6503475868,3,0,1,26112,3,5556038144
6601,6503199168,415813,6503614981,7,0,0,41472,7,9177882609
6602,6503205036,247176,6503452212,9,0,0,644096,9,2205636291
6603,6503263960,459782,6503723742,2,0,1,5632,2,1248029868
6604,6503286915,263486,6503550401,4,0,0,664576,4,3832983417
6605,6503306587,485437,6503792024,1,0,1,512,1,9853948512
6606,6503308112,547823,6503855935,6,0,0,12800,6,969247417
6607,6503374565,461205,6503835770,9,0,1,33792,9,6261835808
6608,6503416114,585025,6504001139,9,0,1,4096,9,8358434035
6609,6503416406,564801,6503981207,3,0,1,22016,3,3380022
6610,6503443992,562533,6504006525,1,0,0,426496,1,9287855341
6611,6503458196,630816,6504089012,9,0,0,263680,9,7029911356
6612,6503601981,471432,6504073413,4,0,1,13312,4,6378417707
6613,6503623174,539543,6504162717,3,0,0,26624,3,3662676118
6614,6503653154,347480,6504000634,4,0,0,313856,4,888971044
6615,6503871855,303425,6504175280,6,0,0,86528,6,4549714287
6616,6503921914,274473,6504196387,6,0,0,28672,6,10730309013
6617,6503952172,247099,6504199271,0,0,0,2048,0,3231376578
6618,6504010600,173410,6504184010,5,0,0,99328,5,8303075243
6619,6504090293,671611,6504761904,7,0,0,28672,7,4571378795
6620,6504093825,221976,6504315801,9,0,0,175616,9,2128072269
6621,6504100573,1038,6504101611,1,0,1,39424,1,10172375309
6622,6504121300,270587,6504391887,3,0,1,26624,3,9668680105
6623,6504142502,101362,6504243864,4,0,1,10240,4,9536346771
6624,6504315896,371291,6504687187,0,0,0,1024,0,6899479708
6625,6504334295,35825,6504370120,1,0,1,6144,1,8820222125
6626,6504364278,423009,6504787287,3,0,0,163840,3,5513002069
6627,6504375361,192780,6504568141,0,0,1,2048,0,9623317556
6628,6504429921,286673,6504716594,5,0,1,25088,5,8101068785
6629,6504463361,12562,6504475923,3,0,0,62976,3,5230337676
6630,6504638214,379593,6505017807,7,0,0,20992,7,4569806904
6631,6504797022,123420,6504920442,7,0,0,200192,7,5725984827
6632,6504949214,2942,6504952156,7,0,1,20992,7,2503592136
6633,6504952335,23721,6504976056,7,0,0,3072,7,6910490973
6634,6504999611,108208,6505107819,7,0,0,39424,7,5133524937
6635,6505000696,133545,6505134241,2,0,1,55296,2,5923647131
6636,6505030903,107572,6505138475,4,0,0,216576,4,5032423975
6637,6505059462,188050,6505247512,0,0,0,4096,0,3480927814
6638,6505124561,144264,6505268825,8,0,1,4096,8,4841001022
6639,6505266627,72020,6505338647,5,0,1,12800,5,6737611827
6640,6505297717,131225,6505428942,3,0,0,116736,3,1601843030
6641,6505324742,75845,6505400587,5,0,0,106496,5,8463753269
6642,6505427147,53749,6505480896,9,0,1,2048,9,6381739839
6643,6505498931,219895,6505718826,4,0,0,91136,4,6642583754
6644,6505499379,294277,6505793656,9,0,0,436224,9,1484454765
6645,6505522978,265994,6505788972,7,0,1,12288,7,9197508089
6646,6505549157,137408,6505686565,3,0,1,117248,3,9377034837
6647,6505559433,313941,6505873374,4,0,0,102912,4,1268553801
6648,6505562792,35282,6505598074,0,0,1,512,0,4666697858
6649,6505569097,315425,6505884522,1,0,1,11264,1,8061280177
6650,6505689965,389565,6506079530,6,0,0,3072,6,1137406757
6651,6505720336,382424,6506102760,6,0,1,22528,6,1459896998
6652,6505731199,230288,6505961487,3,0,1,14336,3,6830731323
6653,6505766786,113651,6505880437,4,0,1,28672,4,1915244119
6654,6505803125,288808,6506091933,9,0,0,36352,9,7761255551
6655,6505907540,344376,6506251916,5,0,1,3072,5,758634556
6656,6506008289,78068,6506086357,1,0,1,4096,1,10504722707
6657,6506038094,325662,6506363756,4,0,0,527360,4,88487659
6658,6506046784,284274,6506331058,7,0,1,14848,7,2250667550
6659,6506091336,255121,6506346457,1,0,0,40448,1,1162721017
6660,6506121155,271705,6506392860,0,0,0,1024,0,4748023313
6661,6506140759,322882,6506463641,7,0,1,16384,7,2390185554
6662,6506186320,209587,6506395907,7,0,1,63488,7,6166570800
6663,6506296862,481604,6506778466,6,0,1,5120,6,3768842243
6664,6506340016,139310,6506479326,4,0,1,14848,4,6173597534
6665,6506356705,186307,6506543012,9,0,1,1024,9,9980567041
6666,6506387889,193553,6506581442,9,0,1,16384,9,5303159044
6667,6506389089,226371,6506615460,1,0,0,225792,1,5020046269
6668,6506410316,127703,6506538019,9,0,1,84480,9,5631194420
6669,6506415704,77442,6506493146,6,0,0,230912,6,6830448956
6670,6506422931,287294,6506710225,2,0,1,52224,2,3894401804
6671,6506435468,285892,6506721360,1,0,1,21504,1,230373092
6672,6506486568,146482,6506633050,2,0,0,18432,2,209808777
6673,6506536840,325199,6506862039,0,0,0,11776,0,10203073705
6674,6506564387,454312,6507018699,0,0,1,65024,0,2977014665
6675,6506580003,293231,6506873234,8,0,1,29696,8,1937728645
6676,6506598951,347618,6506946569,5,0,1,108032,5,2486911732
6677,6506815719,98957,6506914676,1,0,1,8704,1,7261570224
6678,6506889443,24666,6506914109,0,0,1,6656,0,1703353321
6679,6506932710,97312,6507030022,2,0,1,27136,2,8264964528
6680,6506937679,46725,6506984404,5,0,0,44544,5,9657549268
6681,6506979830,142709,6507122539,4,0,0,80896,4,8114678042
6682,6507037305,148381,6507185686,0,0,1,2560,0,3171118541
6683,6507112884,197308,6507310192,8,0,0,324096,8,3143431843
6684,6507126118,182719,6507308837,1,0,1,2048,1,9598748604
6685,6507128139,233524,6507361663,0,0,0,1024,0,10563784167
6686,6507376765,84988,6507461753,5,0,0,138752,5,7268394102
6687,6507412338,92067,6507504405,9,0,0,138752,9,10140338801
6688,6507612080,1990,6507614070,0,0,0,2048,0,4241107812
6689,6507660807,7226,6507668033,0,0,0,7680,0,5451783867
6690,6507705697,45592,6507751289,8,0,1,1024,8,4137100714
6691,6507744000,23204,6507767204,4,0,0,38400,4,4862650790
6692,6507911037,5967,6507917004,1,0,0,14848,1,5661613938
6693,6507923130,13596,6507936726,6,0,1,6656,6,9797814637
6694,6507941051,131045,6508072096,0,0,1,55296,0,7402655996
6695,6507990929,175436,6508166365,9,0,0,23040,9,7114998680
6696,6508261822,56680,6508318502,5,0,1,7168,5,8250539732
6697,6508350658,537512,6508888170,8,0,0,869888,8,7110096251
6698,6508364017,608566,6508972583,8,0,1,122368,8,2748261912
6699,6508501746,470856,6508972602,4,0,0,172544,4,6937561721
6700,6508541440,440661,6508982101,1,0,0,137728,1,216254141
6701,6508557862,600041,6509157903,8,0,0,563200,8,5853029310
6702,6508619695,444063,6509063758,6,0,1,11264,6,4591605523
6703,6508631599,263900,6508895499,1,0,1,30208,1,448284299
6704,6508714826,228644,6508943470,0,0,0,1536,0,2195935678
6705,6508773495,61224,6508834719,1,0,1,20992,1,4453135762
6706,6508799123,384969,6509184092,9,0,1,15360,9,7912615596
6707,6508881024,602219,6509483243,8,0,1,7680,8,5394182908
6708,6508896615,616687,6509513302,2,0,0,2560,2,9544826202
6709,6508937158,105221,6509042379,8,0,0,16896,8,250193769
6710,6509084835,160601,6509245436,0,0,1,27136,0,295810210
6711,6509085387,380076,6509465463,9,0,1,49664,9,7428401107
6712,6509089914,545093,6509635007,6,0,1,7168,6,1983769190
6713,6509105564,96185,6509201749,2,0,0,1536,2,3516665541
6714,6509143076,326775,6509469851,5,0,0,160256,5,1617974148
6715,6509257181,419806,6509676987,6,0,1,19968,6,7688314339
6716,6509280076,365277,6509645353,2,0,1,2048,2,5234046290
6717,6509321665,298621,6509620286,1,0,1,25600,1,488527539
6718,6509323848,359702,6509683550,5,0,0,475648,5,3889781422
6719,6509336961,357130,6509694091,7,0,0,514048,7,7096307872
6720,6509379640,449079,6509828719,9,0,0,31232,9,6382888166
6721,6509384546,412916,6509797462,2,0,1,8192,2,2601917623
6722,6509416176,338625,6509754801,7,0,1,9216,7,9479751316
6723,6509460652,327076,6509787728,5,0,0,24064,5,2273468751
6724,6509508798,326564,6509835362,9,0,0,125952,9,9425729877
6725,6509514824,275057,6509789881,3,0,1,1536,3,9740879011
6726,6509521928,489847,6510011775,2,0,1,17408,2,2355033474
6727,6509541779,244193,6509785972,1,0,1,7168,1,5649241665
6728,6509554437,343191,6509897628,6,0,1,10240,6,3613108660
6729,6509587290,459974,6510047264,5,0,1,28672,5,4456688344
6730,6509627598,555388,6510182986,3,0,0,212992,3,8875504877
6731,6509665080,528291,6510193371,4,0,0,31744,4,1680172961
6732,6509727918,499763,6510227681,4,0,0,769024,4,3060937142
6733,6509888189,373086,6510261275,9,0,1,36352,9,6909722957
6734,6509895711,300758,6510196469,6,0,0,131072,6,2689114325
6735,6509979278,325670,6510304948,8,0,0,37376,8,915777341
6736,6509986342,220180,6510206522,0,0,0,103936,0,8278174715
6737,6510041170,275088,6510316258,7,0,1,2048,7,3790663834
6738,6510092293,227795,6510320088,6,0,0,10240,6,6203598998
6739,6510111521,245308,6510356829,4,0,0,87552,4,3042786510
6740,6510120237,85351,6510205588,7,0,0,92672,7,793362754
6741,6510280860,490248,6510771108,2,0,0,1024,2,1966951534
6742,6510370987,63874,6510434861,7,0,1,6656,7,5284141261
6743,6510381027,135563,6510516590,8,0,0,107520,8,8103763358
6744,6510383369,61073,6510444442,5,0,1,14336,5,7067590239
6745,6510405765,254680,6510660445,1,0,0,211456,1,6021486983
6746,6510425379,298749,6510724128,3,0,1,73728,3,3291933980
6747,6510486771,22858,6510509629,5,0,0,23040,5,4985495361
6748,6510532357,230188,6510762545,8,0,1,1024,8,9435057264
6749,6510541158,1990,6510543148,3,0,1,4608,3,981500097
6750,6510582116,333667,6510915783,3,0,1,42496,3,937461628
6751,6510631349,248560,6510879909,6,0,1,2560,6,3737300295
6752,6510660511,483210,6511143721,1,0,0,40960,1,2739062672
6753,6510810325,157239,6510967564,1,0,1,5632,1,6517998923
6754,6510813726,411742,6511225468,8,0,1,3584,8,9365901372
6755,6510834148,247070,6511081218,8,0,1,10752,8,8025598609
6756,6510841467,284185,6511125652,2,0,0,2048,2,3271386791
6757,6510850629,223875,6511074504,4,0,0,575488,4,3418986096
6758,6510888426,355520,6511243946,9,0,0,59392,9,9042560154
6759,6510951513,333583,6511285096,6,0,1,45568,6,9396085027
6760,6511009282,336995,6511346277,4,0,0,398336,4,479862218
6761,6511078160,381095,6511459255,6,0,0,360448,6,10719710757
6762,6511160937,320233,6511481170,9,0,0,80384,9,6729186016
6763,6511215016,307372,6511522388,6,0,0,131584,6,8797921380
6764,6511227156,336450,6511563606,3,0,0,131584,3,3411109286
6765,6511267725,309739,6511577464,1,0,1,31744,1,7270509466
6766,6511283323,241285,6511524608,6,0,1,74752,6,9738380945
6767,6511325678,176678,6511502356,4,0,1,15872,4,7092618837
6768,6511327936,142633,6511470569,0,0,1,1536,0,2724196089
6769,6511349062,323046,6511672108,9,0,0,95232,9,1179648503
6770,6511419366,104374,6511523740,9,0,0,27136,9,8862113305
6771,6511444920,82063,6511526983,5,0,1,19456,5,5250123387
6772,6511457798,81614,6511539412,4,0,1,11264,4,9970472231
6773,6511490110,160739,6511650849,8,0,0,126464,8,262883174
6774,6511579340,302419,6511881759,7,0,1,10752,7,5120999535
6775,6511594419,91753,6511686172,0,0,0,173056,0,3975711861
6776,6511632385,449115,6512081500,9,0,0,50176,9,7815071570
6777,6511643664,339887,6511983551,8,0,0,43520,8,4750141322
6778,6511681824,561463,6512243287,5,0,0,148480,5,1380209795
6779,6511690636,154161,6511844797,5,0,0,186880,5,660095714
6780,6511817070,41482,6511858552,5,0,0,62976,5,7049240640
6781,6511943898,94337,6512038235,5,0,0,153600,5,4596618787
6782,6512049911,271256,6512321167,5,0,1,65536,5,5763033200
6783,6512111565,244920,6512356485,8,0,0,396800,8,5831419218
6784,6512220176,142108,6512362284,0,0,0,27648,0,6214947819
6785,6512288380,51332,6512339712,4,0,1,6144,4,8735943268
6786,6512317673,213169,6512530842,1,0,0,32256,1,7076751651
6787,6512341216,222862,6512564078,7,0,0,360448,7,10324783955
6788,6512343251,272652,6512615903,7,0,1,24576,7,5387239911
6789,6512344655,193720,6512538375,0,0,1,30208,0,7722292610
6790,6512349477,306735,6512656212,8,0,0,196096,8,3539175585
6791,6512429075,196457,6512625532,8,0,0,11264,8,6603671056
6792,6512453540,194847,6512648387,0,0,0,87040,0,2478483107
6793,6512470754,141176,6512611930,3,0,0,52224,3,1000124548
6794,6512524784,144191,6512668975,2,0,0,9728,2,6669024796
6795,6512526954,135292,6512662246,4,0,0,24576,4,1572192368
6796,6512547195,42679,6512589874,8,0,0,37888,8,9386020470
6797,6512583720,3383,6512587103,2,0,1,44032,2,5180953002
6798,6512704620,531042,6513235662,9,0,0,69632,9,9540454986
6799,6512853841,376712,6513230553,8,0,0,9728,8,4915293899
6800,6512865082,104462,6512969544,0,0,1,16896,0,2452449323
6801,6512877029,158466,6513035495,4,0,0,169984,4,10625282508
6802,6512879944,226499,6513106443,4,0,1,6144,4,10354809359
6803,6512883838,319577,6513203415,6,0,0,444416,6,7942581679
6804,6512943829,45057,6512988886,8,0,1,14336,8,6296228347
6805,6513068164,5708,6513073872,0,0,1,44544,0,7972011227
6806,6513174628,3418,6513178046,3,0,0,53248,3,9732029829
6807,6513194753,526323,6513721076,0,0,1,3072,0,2400290464
6808,6513272221,429058,6513701279,9,0,0,14336,9,9342365776
6809,6513336293,348961,6513685254,2,0,0,3584,2,7252000732
6810,6513441491,196301,6513637792,4,0,1,22016,4,445617530
6811,6513593649,51136,6513644785,8,0,1,4096,8,37228571
6812,6513670526,6484,6513677010,3,0,1,15872,3,5604749401
6813,6513704561,86980,6513791541,6,0,0,15872,6,5919388748
6814,6513849516,13766,6513863282,0,0,0,26624,0,6914682514
6815,6513885179,1038,6513886217,1,0,0,1024,1,6627542030
6816,6513959608,105868,6514065476,1,0,1,47616,1,9775693436
6817,6514014974,105925,6514120899,4,0,0,176128,4,8645472949
6818,6514077417,166416,6514243833,5,0,0,273920,5,1780412320
6819,6514158686,122358,6514281044,7,0,0,129024,7,2060137575
6820,6514165358,99010,6514264368,7,0,1,28672,7,2084294589
6821,6514192761,125029,6514317790,7,0,0,43008,7,8301247616
6822,6514192766,130192,6514322958,0,0,0,83456,0,8422868873
6823,6514193709,185453,6514379162,6,0,0,29184,6,4416667001
6824,6514200755,124942,6514325697,1,0,1,66560,1,7457539033
6825,6514235761,83742,6514319503,4,0,0,118784,4,7550565246
6826,6514240984,242597,6514483581,8,0,1,5120,8,5754550092
6827,6514257029,301087,6514558116,6,0,1,47104,6,8592395813
6828,6514302985,101620,6514404605,3,0,0,91648,3,4479446999
6829,6514334644,257662,6514592306,9,0,1,512,9,463454597
6830,6514401754,499047,6514900801,3,0,1,17408,3,8538307867
6831,6514453732,221906,6514675638,8,0,1,27136,8,9660425288
6832,6514457290,212995,6514670285,3,0,0,164352,3,607456011
6833,6514534147,333204,6514867351,2,0,1,66560,2,5571824855
6834,6514541045,53971,6514595016,7,0,1,22528,7,10006329057
6835,6514563957,289170,6514853127,4,0,0,344576,4,3232732029
6836,6514603176,462388,6515065564,7,0,1,52224,7,9959417591
6837,6514605378,348865,6514954243,0,0,1,36864,0,5263302352
6838,6514652608,325975,6514978583,1,0,1,2048,1,5982682952
6839,6514732976,453166,6515186142,2,0,0,3584,2,6416060638
6840,6514835507,287658,6515123165,9,0,0,470016,9,3542717753
6841,6514864009,352421,6515216430,6,0,0,307200,6,11365528
6842,6514867355,348756,6515216111,3,0,1,71680,3,8878168157
6843,6514966379,482778,6515449157,3,0,0,316928,3,2828851052
6844,6515044449,305695,6515350144,5,0,0,50176,5,3546439798
6845,6515153751,90345,6515244096,0,0,1,3584,0,4886033753
6846,6515230533,229123,6515459656,8,0,1,2048,8,10004813468
6847,6515259810,103946,6515363756,7,0,0,18432,7,2428352141
6848,6515292892,103932,6515396824,8,0,0,168960,8,8655913286
6849,6515293879,167425,6515461304,9,0,0,12800,9,5040798454
6850,6515295996,422244,6515718240,4,0,1,20480,4,10031787197
6851,6515418197,27224,6515445421,2,0,1,19968,2,9425182196
6852,6515481829,390045,6515871874,9,0,1,6144,9,4230510103
6853,6515515918,292877,6515808795,7,0,1,67584,7,6808901874
6854,6515625564,396693,6516022257,8,0,0,48640,8,3227690296
6855,6515756767,216354,6515973121,9,0,1,3072,9,3253237407
6856,6515849933,351576,6516201509,6,0,0,351232,6,2264928328
6857,6515857857,280025,6516137882,3,0,0,416256,3,2327901428
6858,6515927945,355820,6516283765,9,0,1,33280,9,7085856481
6859,6515941145,322300,6516263445,1,0,1,28672,1,1205030724
6860,6515949428,211111,6516160539,4,0,0,196096,4,4786795297
6861,6515992775,335570,6516328345,4,0,0,180736,4,6272184853
6862,6516015598,428688,6516444286,6,0,0,117760,6,1567540290
6863,6516015801,354246,6516370047,7,0,0,26624,7,6474743898
6864,6516018852,354735,6516373587,8,0,1,51712,8,7108079650
6865,6516088568,282634,6516371202,2,0,0,1024,2,6929002397
6866,6516109591,217519,6516327110,7,0,1,11776,7,9711032811
6867,6516128092,42044,6516170136,9,0,1,58368,9,7440716582
6868,6516158941,355737,6516514678,9,0,1,1024,9,9579791049
6869,6516215740,65942,6516281682,5,0,0,198656,5,7702449914
6870,6516300022,415268,6516715290,2,0,1,22016,2,5781004227
6871,6516395081,542158,6516937239,3,0,0,6144,3,6953729315
6872,6516420541,138497,6516559038,7,0,1,1536,7,8872730132
6873,6516423201,159499,6516582700,7,0,1,93696,7,9957877799
6874,6516455385,351059,6516806444,6,0,0,111616,6,7996452549
6875,6516463696,480957,6516944653,1,0,1,15360,1,1960387100
6876,6516549472,334576,6516884048,3,0,0,210432,3,10607942539
6877,6516554391,398437,6516952828,0,0,0,82944,0,9092783012
6878,6516627559,344298,6516971857,2,0,1,23552,2,5398099344
6879,6516816727,157949,6516974676,0,0,1,9216,0,3743652804
6880,6516970671,562,6516971233,6,0,1,6656,6,8105074588
6881,6516996264,173541,6517169805,2,0,0,512,2,4122329889
6882,6517140947,34363,6517175310,9,0,1,18944,9,10116038257
6883,6517145367,73132,6517218499,1,0,1,10752,1,881593981
6884,6517178136,121520,6517299656,5,0,0,56832,5,2721761328
6885,6517202385,100876,6517303261,8,0,1,31232,8,3796887717
6886,6517269303,43900,6517313203,2,0,1,512,2,5290516906
6887,6517418895,177058,6517595953,1,0,0,291328,1,6895658403
6888,6517433064,198872,6517631936,6,0,0,114688,6,10731796549
6889,6517481882,191374,6517673256,9,0,0,132096,9,761231534
6890,6517487663,212334,6517699997,6,0,0,87040,6,5562156966
6891,6517536912,377043,6517913955,9,0,0,492544,9,1308502260
6892,6517546538,370003,6517916541,1,0,0,4096,1,3865393964
6893,6517592780,336696,6517929476,3,0,1,29696,3,7002358079
6894,6517715768,232032,6517947800,5,0,0,100352,5,1863300849
6895,6517896802,125141,6518021943,9,0,0,206848,9,7009331577
6896,6517913716,248145,6518161861,2,0,1,5632,2,433531395
6897,6517953838,353468,6518307306,4,0,0,566272,4,8338249258
6898,6518044238,245303,6518289541,1,0,1,9216,1,7364016851
6899,6518063859,113104,6518176963,0,0,1,3584,0,7220152069
6900,6518219482,87444,6518306926,9,0,1,35840,9,4788986120
6901,6518234721,71503,6518306224,0,0,1,5120,0,2531074328
6902,6518235830,384473,6518620303,1,0,0,133632,1,9362842748
6903,6518273241,228093,6518501334,1,0,0,48128,1,4473608174
6904,6518333548,214425,6518547973,0,0,0,115712,0,1750845613
6905,6518391150,235847,6518626997,3,0,1,22016,3,2661138736
6906,6518432061,294247,6518726308,1,0,1,20992,1,3174464226
6907,6518457789,246686,6518704475,6,0,0,484352,6,47385855
6908,6518512467,301375,6518813842,4,0,1,26624,4,5217864068
6909,6518554834,221595,6518776429,7,0,1,15872,7,6912432134
6910,6518595307,199125,6518794432,8,0,0,208384,8,1677687558
6911,6518619403,138856,6518758259,2,0,0,2560,2,8182812901
6912,6518682898,118874,6518801772,2,0,0,5120,2,9181812719
6913,6518713607,74460,6518788067,5,0,0,43008,5,8820734391
6914,6518715631,56759,6518772390,3,0,1,15872,3,7861384421
6915,6518758367,354480,6519112847,2,0,0,512,2,1837543176
6916,6518797266,74775,6518872041,8,0,0,68608,8,9578015958
6917,6518815062,368034,6519183096,7,0,1,87040,7,7586169187
6918,6518833419,174763,6519008182,1,0,1,11776,1,8139774516
6919,6518901801,34817,6518936618,6,0,1,1024,6,453216187
6920,6518938868,344746,6519283614,8,0,0,125440,8,7143382641
6921,6518958424,77100,6519035524,6,0,0,257024,6,547867999
6922,6518966945,47963,6519014908,0,0,1,14848,0,8902730179
6923,6519039739,437580,6519477319,7,0,1,53760,7,3202877905
6924,6519103964,361685,6519465649,9,0,0,18432,9,6103147951
6925,6519115364,428078,6519543442,4,0,0,130048,4,7243409990
6926,6519119369,419669,6519539038,3,0,1,9728,3,2118520336
6927,6519145577,278915,6519424492,7,0,0,13312,7,6412267650
6928,6519180512,147577,6519328089,0,0,0,448000,0,6797678243
6929,6519230908,151692,6519382600,2,0,1,8704,2,7535129551
6930,6519334981,405872,6519740853,5,0,0,90112,5,8269892728
6931,6519356583,89380,6519445963,7,0,0,90112,7,1606709522
6932,6519438581,310112,6519748693,0,0,1,12800,0,10711209109
6933,6519445636,146767,6519592403,6,0,0,87040,6,8644002471
6934,6519471714,50737,6519522451,7,0,0,214528,7,481578622
6935,6519577113,292106,6519869219,4,0,1,29184,4,8334203775
6936,6519607657,245575,6519853232,6,0,1,8192,6,8206484994
6937,6519620121,145881,6519766002,6,0,0,81920,6,10435184848
6938,6519681420,196903,6519878323,2,0,1,12800,2,9609154059
6939,6519682548,292619,6519975167,4,0,1,6656,4,5303249046
6940,6519748603,200103,6519948706,7,0,1,4096,7,4260849096
6941,6519911619,63704,6519975323,6,0,0,103936,6,6545787594
6942,6519939373,53321,6519992694,8,0,1,11264,8,8546411723
6943,6519949994,146269,6520096263,0,0,0,87040,0,6543527068
6944,6519954817,246958,6520201775,6,0,0,365056,6,7032717358
6945,6519968828,235213,6520204041,6,0,0,3584,6,10108692127
6946,6519978907,226760,6520205667,6,0,0,2560,6,6117298432
6947,6520004830,165761,6520170591,1,0,1,17408,1,5469061172
6948,6520025613,132883,6520158496,8,0,1,17408,8,7542395186
6949,6520065046,312889,6520377935,0,0,1,34816,0,4832312076
6950,6520135676,374470,6520510146,1,0,1,27648,1,3139845199
6951,6520141815,221353,6520363168,3,0,1,35840,3,3073059119
6952,6520194301,362839,6520557140,4,0,1,28672,4,2393079679
6953,6520292075,217894,6520509969,3,0,1,17408,3,6371826109
6954,6520429710,5338,6520435048,6,0,1,49152,6,3379365415
6955,6520505185,170308,6520675493,2,0,0,512,2,8040111911
6956,6520542768,66717,6520609485,4,0,0,113152,4,7113878961
6957,6520768001,56850,6520824851,4,0,0,97280,4,6523889721
6958,6520805749,13766,6520819515,1,0,1,18944,1,1217767486
6959,6520864344,140081,6521004425,1,0,0,26624,1,787265598
6960,6520890734,63358,6520954092,0,0,0,106496,0,3225062381
6961,6520991506,46943,6521038449,8,0,1,512,8,446712989
6962,6521010051,108832,6521118883,4,0,1,57344,4,7298588835
6963,6521017373,258058,6521275431,1,0,0,422400,1,8584905365
6964,6521043848,231929,6521275777,6,0,0,512,6,3997866564
6965,6521116276,184859,6521301135,7,0,1,10240,7,3493460127
6966,6521174649,201605,6521376254,8,0,1,31232,8,8859980560
6967,6521222959,271334,6521494293,4,0,1,14336,4,9004474877
6968,6521375238,116825,6521492063,5,0,0,194048,5,5106423144
6969,6521431789,60620,6521492409,2,0,0,512,2,3260566422
6970,6521498461,198600,6521697061,9,0,1,23040,9,9145778242
6971,6521503291,140562,6521643853,9,0,0,326656,9,8095251480
6972,6521565629,4846,6521570475,1,0,1,2560,1,8408412651
6973,6521567128,292556,6521859684,3,0,0,19456,3,4161273533
6974,6521725949,237379,6521963328,6,0,0,5120,6,5059657119
6975,6521742423,85933,6521828356,5,0,0,143872,5,3355953554
6976,6521772923,111203,6521884126,3,0,1,2560,3,4605296470
6977,6521988252,1514,6521989766,8,0,1,14848,8,2951028512
6978,6521998251,32554,6522030805,6,0,0,1536,6,5704356723
6979,6522019999,91276,6522111275,9,0,0,53248,9,4743436409
6980,6522073497,104891,6522178388,1,0,0,174080,1,4459011307
6981,6522112788,84383,6522197171,1,0,1,44032,1,9690532691
6982,6522183778,55424,6522239202,1,0,0,140800,1,9915382616
6983,6522217883,52298,6522270181,2,0,0,8192,2,7338876476
6984,6522231429,263818,6522495247,5,0,0,33280,5,8190439294
6985,6522257238,161100,6522418338,2,0,1,14848,2,1283030244
6986,6522362110,85651,6522447761,1,0,1,24576,1,7550124866
6987,6522378779,156526,6522535305,4,0,1,2560,4,1649403189
6988,6522423393,418596,6522841989,0,0,0,678400,0,3404298316
6989,6522529512,322573,6522852085,6,0,1,512,6,3982747979
6990,6522599187,310095,6522909282,5,0,0,215552,5,5667324387
6991,6522654228,209102,6522863330,8,0,1,1024,8,8999378965
6992,6522655524,116025,6522771549,3,0,1,2560,3,4487427025
6993,6522703726,276172,6522979898,6,0,0,5632,6,8520892427
6994,6522706796,294528,6523001324,6,0,1,12288,6,413674217
6995,6522814001,316751,6523130752,2,0,1,3072,2,5880246249
6996,6522848760,197766,6523046526,4,0,1,16896,4,10419233197
6997,6522908392,243966,6523152358,4,0,1,15872,4,4717047185
6998,6522926208,380102,6523306310,4,0,0,764928,4,882789285
6999,6522967484,225893,6523193377,4,0,1,58880,4,10239306493
7000,6523104246,469908,6523574154,4,0,0,192000,4,1310557068
7001,6523122172,349101,6523471273,7,0,1,1536,7,3995281111
7002,6523166365,328814,6523495179,9,0,0,134656,9,8339357957
7003,6523347232,231663,6523578895,5,0,0,278016,5,9395399407
7004,6523549327,85933,6523635260,5,0,0,143872,5,8318074788
7005,6523600138,213770,6523813908,8,0,0,346112,8,5119372340
7006,6523664801,461167,6524125968,7,0,0,685056,7,1819713052
7007,6523776496,199659,6523976155,9,0,1,33792,9,1860796593
7008,6523930495,399437,6524329932,0,0,0,6656,0,8319445138
7009,6524020242,227942,6524248184,3,0,1,7680,3,3573316408
7010,6524071588,143824,6524215412,7,0,0,373760,7,8140173779
7011,6524104466,317923,6524422389,1,0,1,14848,1,5274925684
7012,6524143324,277416,6524420740,1,0,1,19456,1,10285818888
7013,6524176802,355810,6524532612,5,0,0,68096,5,2262798669
7014,6524236028,301447,6524537475,8,0,1,77312,8,8653088469
7015,6524294825,258172,6524552997,8,0,1,6144,8,10282315888
7016,6524306372,158004,6524464376,3,0,1,23040,3,4593247879
7017,6524366666,340047,6524706713,7,0,1,9728,7,8681831008
7018,6524475113,284028,6524759141,1,0,1,7680,1,2600756813
7019,6524631857,300538,6524932395,0,0,1,123904,0,10170660733
7020,6524739659,193003,6524932662,8,0,0,312320,8,9086573062
7021,6524757996,133575,6524891571,1,0,1,18944,1,818039411
7022,6524763038,178214,6524941252,0,0,1,164352,0,316409207
7023,6524791994,110959,6524902953,9,0,1,35328,9,2628652954
7024,6524800073,12346,6524812419,6,0,0,1536,6,9250348521
7025,6524824403,243720,6525068123,7,0,1,45568,7,7509653482
7026,6524846722,189057,6525035779,9,0,1,46592,9,7656985778
7027,6524891677,459619,6525351296,5,0,0,172544,5,3947755654
7028,6524936244,470452,6525406696,7,0,1,6144,7,586833206
7029,6524991301,93817,6525085118,2,0,0,1024,2,934906294
7030,6525150489,429921,6525580410,7,0,1,5120,7,9943856885
7031,6525200031,120680,6525320711,7,0,1,9216,7,481219793
7032,6525242759,122995,6525365754,2,0,1,6656,2,1103958076
7033,6525303614,63213,6525366827,1,0,1,2048,1,270404827
7034,6525370156,97912,6525468068,0,0,1,21504,0,8508476854
7035,6525398591,43454,6525442045,9,0,1,12288,9,2602136953
7036,6525428389,93465,6525521854,3,0,0,71168,3,286949472
7037,6525504611,81657,6525586268,2,0,1,8704,2,9005445583
7038,6525524635,156033,6525680668,0,0,0,257024,0,8185208378
7039,6525558909,148090,6525706999,8,0,0,84992,8,7321307782
7040,6525628116,80829,6525708945,4,0,0,3072,4,9242473199
7041,6525628360,107018,6525735378,8,0,0,85504,8,10404186979
7042,6525747904,3418,6525751322,3,0,1,8192,3,6242819131
7043,6525775522,117291,6525892813,8,0,1,22016,8,6899242740
7044,6525798407,193161,6525991568,9,0,1,6656,9,5681181609
7045,6525819517,185440,6526004957,4,0,1,53248,4,8588465896
7046,6525876680,40698,6525917378,4,0,0,3584,4,3876975667
7047,6525990468,295886,6526286354,9,0,0,47616,9,9364046510
7048,6526037081,139301,6526176382,1,0,1,47616,1,9066500631
7049,6526103900,116355,6526220255,4,0,1,3584,4,1524673302
7050,6526107568,120067,6526227635,1,0,1,19968,1,3937541838
7051,6526154144,212995,6526367139,9,0,0,344576,9,8586839300
7052,6526256816,32037,6526288853,9,0,1,74240,9,10114100939
7053,6526325450,201955,6526527405,4,0,1,36864,4,6586844887
7054,6526378714,306638,6526685352,0,0,1,78848,0,10686841682
7055,6526477852,55300,6526533152,1,0,0,52224,1,5468389213
7056,6526563684,278483,6526842167,7,0,0,94208,7,4292141412
7057,6526707442,100252,6526807694,0,0,1,29184,0,3945484087
7058,6526716875,196791,6526913666,3,0,0,323072,3,623432132
7059,6526717383,198549,6526915932,7,0,0,3584,7,2960118051
7060,6526739256,264910,6527004166,5,0,0,283136,5,1691384647
7061,6526751135,294587,6527045722,0,0,0,569856,0,5566057993
7062,6526761077,296529,6527057606,3,0,1,18432,3,2114528355
7063,6526830981,422118,6527253099,9,0,1,25600,9,6719899985
7064,6526840196,501975,6527342171,6,0,1,35840,6,5310155777
7065,6526899319,107836,6527007155,1,0,1,5120,1,10599596789
7066,6526915218,70869,6526986087,2,0,1,1024,2,8186180717
7067,6527013783,383268,6527397051,4,0,1,57856,4,7414655327
7068,6527062759,368409,6527431168,9,0,1,10752,9,1652837428
7069,6527142623,257545,6527400168,2,0,1,6144,2,10553224575
7070,6527172767,570903,6527743670,0,0,1,92160,0,436995758
7071,6527180755,292249,6527473004,7,0,0,117760,7,783778201
7072,6527192132,219109,6527411241,2,0,1,14336,2,2094327466
7073,6527196428,391325,6527587753,3,0,1,75264,3,5656348208
7074,6527220628,264202,6527484830,7,0,0,4608,7,10188942695
7075,6527285381,242568,6527527949,1,0,0,359936,1,4866892511
7076,6527299901,285524,6527585425,0,0,0,173568,0,5305934533
7077,6527321546,646844,6527968390,6,0,0,512,6,6055379470
7078,6527388312,123279,6527511591,7,0,0,369152,7,9456448335
7079,6527602143,114994,6527717137,1,0,0,164864,1,3417844679
7080,6527602348,92476,6527694824,9,0,1,2048,9,9137105960
7081,6527611734,172237,6527783971,2,0,0,2048,2,7224089679
7082,6527634508,73312,6527707820,8,0,0,9216,8,327331594
7083,6527681065,307675,6527988740,3,0,0,278528,3,5149917176
7084,6527790017,739518,6528529535,1,0,1,512,1,5675001349
7085,6527827441,227387,6528054828,1,0,0,119296,1,293882706
7086,6527894196,43883,6527938079,2,0,1,12800,2,1998681464
7087,6528103998,272690,6528376688,6,0,1,8192,6,4774408888
7088,6528111950,165259,6528277209,8,0,0,75264,8,4570490228
7089,6528230674,134352,6528365026,0,0,1,44544,0,7298151650
7090,6528252777,208931,6528461708,8,0,1,5632,8,9115372759
7091,6528264220,377233,6528641453,5,0,0,614400,5,186244493
7092,6528270005,375314,6528645319,8,0,0,6144,8,5839893599
7093,6528295379,331570,6528626949,4,0,1,11264,4,4560795288
7094,6528315029,281670,6528596699,3,0,0,14336,3,1440679855
7095,6528330581,331673,6528662254,1,0,0,50176,1,5908105328
7096,6528338734,419166,6528757900,1,0,1,3072,1,6098113744
7097,6528378357,418510,6528796867,8,0,1,18432,8,2852617162
7098,6528432733,333769,6528766502,8,0,0,343552,8,2444339692
7099,6528498151,279181,6528777332,3,0,0,35328,3,2957165725
7100,6528502019,302258,6528804277,5,0,0,88064,5,7287012956
7101,6528502960,278416,6528781376,7,0,1,7168,7,10336076246
7102,6528547161,337301,6528884462,0,0,0,77312,0,10040328418
7103,6528582142,294919,6528877061,8,0,0,164352,8,8899904001
7104,6528586089,253267,6528839356,4,0,1,8704,4,868208026
7105,6528660740,87633,6528748373,2,0,1,36352,2,804621494
7106,6528731896,357052,6529088948,1,0,1,5120,1,4671076196
7107,6528803304,60862,6528864166,6,0,1,12800,6,6672223390
7108,6528808424,258953,6529067377,0,0,1,143872,0,3097076009
7109,6528826385,278730,6529105115,4,0,0,111616,4,4473667956
7110,6528902781,324360,6529227141,4,0,1,62464,4,4599671963
7111,6528918768,125141,6529043909,7,0,0,98304,7,8290193757
7112,6529055324,82482,6529137806,0,0,0,206848,0,1537329520
7113,6529105033,395533,6529500566,8,0,1,45568,8,6269996942
7114,6529113536,303941,6529417477,1,0,0,57856,1,9946482975
7115,6529332330,32037,6529364367,3,0,1,17920,3,3241791374
7116,6529360822,148325,6529509147,9,0,1,91136,9,5901794659
7117,6529377799,562,6529378361,8,0,0,52224,8,4480852916
7118,6529421549,171026,6529592575,9,0,1,8704,9,3253143067
7119,6529479958,34363,6529514321,3,0,1,10752,3,6649038534
7120,6529485282,43624,6529528906,2,0,0,512,2,7134775162
7121,6529513330,355013,6529868343,3,0,1,14336,3,5546232773
7122,6529571457,225869,6529797326,3,0,0,56832,3,4965214299
7123,6529632902,301358,6529934260,8,0,0,74752,8,10349635279
7124,6529699193,120580,6529819773,3,0,0,168960,3,5080306373
7125,6529783365,306187,6530089552,8,0,0,496128,8,6287131489
7126,6529814715,274991,6530089706,5,0,0,8704,5,5717696714
7127,6529830021,161110,6529991131,2,0,1,35328,2,3051716464
7128,6529837624,188084,6530025708,5,0,0,563200,5,8679565689
7129,6529870539,448384,6530318923,6,0,0,5120,6,473670136
7130,6529964918,447159,6530412077,2,0,1,43520,2,9266081812
7131,6530048723,417470,6530466193,7,0,1,31232,7,8168231130
7132,6530076608,258640,6530335248,3,0,1,18432,3,3148956465
7133,6530090769,173551,6530264320,0,0,1,19968,0,3454328756
7134,6530100582,186225,6530286807,9,0,0,187904,9,9176159565
7135,6530119286,245478,6530364764,8,0,0,169472,8,2716565596
7136,6530135227,279282,6530414509,1,0,1,4608,1,5440604712
7137,6530145889,149199,6530295088,3,0,1,24064,3,5354776235
7138,6530173855,157245,6530331100,7,0,1,11776,7,5568425171
7139,6530249933,481347,6530731280,3,0,0,10752,3,10593629725
7140,6530262471,250142,6530512613,8,0,0,73728,8,1540085098
7141,6530272695,379995,6530652690,5,0,0,337920,5,4085559273
7142,6530278496,352800,6530631296,0,0,0,355328,0,1443943689
7143,6530285765,346517,6530632282,6,0,0,1536,6,3129483101
7144,6530336222,328912,6530665134,3,0,1,20480,3,7736024411
7145,6530439205,298053,6530737258,7,0,0,440320,7,1709105849
7146,6530470423,240316,6530710739,8,0,0,9728,8,4612592565
7147,6530493573,14541,6530508114,0,0,1,134144,0,6144075399
7148,6530523723,470455,6530994178,3,0,1,15360,3,2794179753
7149,6530533959,240235,6530774194,0,0,0,27648,0,706394381
7150,6530636306,626412,6531262718,6,0,1,22528,6,9771278993
7151,6530774405,600953,6531375358,1,0,0,28160,1,2615981131
7152,6530821842,161014,6530982856,6,0,1,5120,6,1178793737
7153,6530964453,74258,6531038711,1,0,1,2560,1,4199678955
7154,6531035140,442306,6531477446,6,0,1,43520,6,10452178622
7155,6531180256,322649,6531502905,7,0,0,124416,7,847322865
7156,6531385550,87225,6531472775,3,0,0,146432,3,6561162954
7157,6531412743,125223,6531537966,5,0,0,179712,5,5253954659
7158,6531424201,129420,6531553621,0,0,0,58368,0,9888766449
7159,6531456980,150732,6531607712,8,0,0,174080,8,7185021097
7160,6531518268,90517,6531608785,4,0,1,9728,4,4250042983
7161,6531533158,195344,6531728502,3,0,0,59904,3,2640477796
7162,6531596003,62432,6531658435,7,0,1,20992,7,9060700585
7163,6531732165,168781,6531900946,8,0,1,46080,8,9304264839
7164,6531736406,326483,6532062889,3,0,1,12800,3,8080180821
7165,6531788172,41904,6531830076,3,0,1,6656,3,3345751831
7166,6531950201,286726,6532236927,4,0,0,68096,4,4032900509
7167,6532053858,562,6532054420,3,0,1,3072,3,3931073394
7168,6532059811,52360,6532112171,7,0,1,1024,7,8270993316
7169,6532094190,106251,6532200441,6,0,0,512,6,3768137774
7170,6532179841,102436,6532282277,7,0,1,36352,7,3359296266
7171,6532186779,224670,6532411449,9,0,0,364032,9,6751617289
7172,6532213784,144679,6532358463,6,0,1,30208,6,2716944303
7173,6532269356,188639,6532457995,8,0,0,4096,8,669237638
7174,6532302728,334646,6532637374,4,0,1,14848,4,5811574928
7175,6532368532,157468,6532526000,0,0,1,395264,0,562606706
7176,6532525820,460428,6532986248,6,0,1,8192,6,3916536896
7177,6532542073,288302,6532830375,4,0,1,4608,4,7307351626
7178,6532589161,241225,6532830386,9,0,0,252416,9,6076718131
7179,6532595176,228094,6532823270,9,0,1,67584,9,7779458806
7180,6532602303,165658,6532767961,5,0,0,44544,5,6150537567
7181,6532664750,255835,6532920585,3,0,0,19968,3,5496481249
7182,6532681327,307354,6532988681,8,0,0,958976,8,8279378184
7183,6532695944,246443,6532942387,9,0,0,394752,9,4832703783
7184,6532697868,324795,6533022663,8,0,0,84480,8,8700688308
7185,6532748266,594662,6533342928,4,0,0,287744,4,897246129
7186,6532768341,492158,6533260499,7,0,1,9216,7,2427085262
7187,6532778194,703596,6533481790,2,0,1,3072,2,6471751047
7188,6532784597,727901,6533512498,8,0,1,10240,8,599788914
7189,6532787540,267362,6533054902,2,0,0,512,2,9495425243
7190,6532839663,349986,6533189649,7,0,1,30720,7,1388123267
7191,6532850843,724321,6533575164,1,0,0,137728,1,4153775915
7192,6532862385,765020,6533627405,0,0,1,47104,0,4904403059
7193,6532864410,726092,6533590502,8,0,0,28160,8,9840176635
7194,6533043349,705236,6533748585,8,0,0,284672,8,6079465858
7195,6533102190,697570,6533799760,2,0,0,5120,2,4723654177
7196,6533150381,357834,6533508215,9,0,1,9728,9,6938676330
7197,6533167051,321949,6533489000,7,0,0,8704,7,2768554941
7198,6533204681,607172,6533811853,2,0,1,7680,2,9902696995
7199,6533223728,551557,6533775285,8,0,1,14848,8,717050255
7200,6533312548,486850,6533799398,9,0,1,24576,9,5459450650
7201,6533332259,353925,6533686184,5,0,0,113664,5,2206657568
7202,6533387707,300423,6533688130,8,0,0,3072,8,1900841359
7203,6533416597,259117,6533675714,7,0,1,72704,7,1082021521
7204,6533430959,179525,6533610484,6,0,0,3072,6,4180028891
7205,6533511217,150462,6533661679,6,0,0,1024,6,4993949415
7206,6533551212,136577,6533687789,1,0,0,44032,1,7112460405
7207,6533571613,64886,6533636499,3,0,0,23040,3,3311956634
7208,6533649615,101809,6533751424,7,0,0,22016,7,850760861
7209,6533649801,85777,6533735578,5,0,0,128512,5,1553916265
7210,6533667113,65166,6533732279,4,0,0,14336,4,1600707976
7211,6533724026,84390,6533808416,9,0,0,110080,9,3840938375
7212,6533726000,477739,6534203739,7,0,0,76800,7,5572912446
7213,6533900699,235614,6534136313,8,0,1,11264,8,5764712279
7214,6534162710,2466,6534165176,6,0,0,2560,6,5428669813
7215,6534222270,63704,6534285974,8,0,1,20480,8,942861883
7216,6534254492,208979,6534463471,0,0,0,103936,0,969623921
7217,6534434274,74258,6534508532,3,0,0,124416,3,7090517595
7218,6534481039,77740,6534558779,9,0,1,77824,9,2330342441
7219,6534537726,166234,6534703960,5,0,0,267776,5,9162677389
7220,6534626209,295260,6534921469,2,0,1,10752,2,189019620
7221,6534647347,246271,6534893618,5,0,1,32256,5,7778090811
7222,6534651138,217558,6534868696,0,0,1,118784,0,8148888088
7223,6534714000,56075,6534770075,9,0,0,356864,9,8238688575
7224,6534721931,219345,6534941276,2,0,1,19968,2,10185291973
7225,6534754904,491898,6535246802,9,0,1,10240,9,1190459154
7226,6534887488,391263,6535278751,4,0,1,30720,4,5334926032
7227,6534914986,134118,6535049104,7,0,1,27648,7,6190303553
7228,6534951926,430342,6535382268,6,0,1,61440,6,6452092496
7229,6535002124,184322,6535186446,8,0,0,95744,8,4575988862
7230,6535012060,359228,6535371288,4,0,0,176640,4,2413315269
7231,6535078217,431751,6535509968,7,0,0,291840,7,1237291886
7232,6535110798,228304,6535339102,9,0,1,27648,9,217592443
7233,6535122869,356770,6535479639,5,0,1,39424,5,3082388091
7234,6535130571,194532,6535325103,7,0,1,20992,7,2372850446
7235,6535257597,274457,6535532054,5,0,1,27136,5,7724334244
7236,6535294374,238264,6535532638,3,0,1,21504,3,8485894322
7237,6535294893,444906,6535739799,9,0,1,3584,9,3967784756
7238,6535326386,95113,6535421499,2,0,1,18944,2,10257095194
7239,6535332336,83678,6535416014,2,0,1,6656,2,10227191437
7240,6535399357,276262,6535675619,2,0,1,28672,2,1965665955
7241,6535444609,44658,6535489267,2,0,1,38912,2,4165178227
7242,6535494797,6274,6535501071,4,0,0,155136,4,1500614907
7243,6535507858,387195,6535895053,2,0,0,2560,2,6524788241
7244,6535584079,248827,6535832906,9,0,1,3072,9,7364829140
7245,6535592499,302826,6535895325,1,0,1,5632,1,8206553268
7246,6535612479,152429,6535764908,1,0,0,76800,1,10522413123
7247,6535655605,311652,6535967257,2,0,0,6656,2,7287572326
7248,6535743920,182878,6535926798,4,0,0,295936,4,9049521070
7249,6535761292,126523,6535887815,7,0,1,16896,7,8136762679
7250,6535773567,235107,6536008674,0,0,1,115712,0,9364717279
7251,6535801555,376323,6536177878,7,0,0,14336,7,7634905607
7252,6535897972,427946,6536325918,8,0,0,693248,8,10596465243
7253,6535944541,348624,6536293165,0,0,1,219648,0,670287338
7254,6535954406,154544,6536108950,6,0,1,25600,6,7829854645
7255,6535993257,120439,6536113696,3,0,0,59904,3,5672195569
7256,6536132157,92874,6536225031,3,0,1,68608,3,114498635
7257,6536198167,606059,6536804226,0,0,0,43520,0,8244973449
7258,6536233578,619561,6536853139,2,0,0,2048,2,4096189112
7259,6536262219,486038,6536748257,2,0,0,13312,2,3769670953
7260,6536743257,111659,6536854916,8,0,1,26624,8,9475904088
7261,6536788520,228285,6537016805,0,0,0,534528,0,4361659221
7262,6536854473,327641,6537182114,4,0,1,3072,4,776140938
7263,6536908930,347000,6537255930,0,0,0,448000,0,8457800107
7264,6537120765,171250,6537292015,8,0,0,115200,8,5809715882
7265,6537237927,165471,6537403398,4,0,1,41984,4,1924744277
7266,6537255550,137482,6537393032,0,0,0,268800,0,1577079726
7267,6537288045,53590,6537341635,0,0,0,7168,0,8265332094
7268,6537288731,41175,6537329906,8,0,1,55296,8,512014623
7269,6537338155,287028,6537625183,7,0,1,30208,7,8103828873
7270,6537375163,340842,6537716005,3,0,0,5120,3,5131113951
7271,6537390484,43624,6537434108,2,0,0,4608,2,5041496542
7272,6537595046,25686,6537620732,7,0,0,74752,7,8520195774
7273,6537615250,355713,6537970963,6,0,0,3584,6,2492475087
7274,6537856206,31779,6537887985,9,0,0,51712,9,3514992822
7275,6537858464,40555,6537899019,1,0,0,36352,1,7385644217
7276,6537879874,104121,6537983995,7,0,1,6144,7,1382505813
7277,6537998496,105526,6538104022,8,0,1,12800,8,1286825409
7278,6538004528,157008,6538161536,8,0,1,8704,8,3361368029
7279,6538082783,102280,6538185063,7,0,1,35840,7,826613814
7280,6538130343,86248,6538216591,4,0,1,23552,4,6652631559
7281,6538235791,60862,6538296653,9,0,0,98304,9,4739889342
7282,6538245437,277397,6538522834,5,0,0,420352,5,3321826676
7283,6538261808,179105,6538440913,1,0,0,36864,1,3447892084
7284,6538352634,272163,6538624797,5,0,1,9216,5,6212943124
7285,6538359170,114858,6538474028,9,0,1,51712,9,5698898
7286,6538376188,239117,6538615305,3,0,1,25088,3,6176000484
7287,6538420393,164437,6538584830,1,0,0,14336,1,9417164425
7288,6538457245,106617,6538563862,9,0,0,266752,9,3923467189
7289,6538493581,180020,6538673601,2,0,1,19456,2,8584320779
7290,6538526714,145601,6538672315,7,0,0,47616,7,659475510
7291,6538545269,95367,6538640636,9,0,0,193536,9,5828711224
7292,6538560554,125181,6538685735,4,0,1,18944,4,4306848091
7293,6538596489,2466,6538598955,2,0,0,1536,2,1452124298
7294,6538598549,418949,6539017498,7,0,0,111616,7,7943811946
7295,6538625403,181225,6538806628,7,0,1,8704,7,6956377275
7296,6538732453,3974,6538736427,6,0,0,2560,6,1465518429
7297,6538802665,290001,6539092666,2,0,0,4096,2,3897506437
7298,6538900548,63187,6538963735,8,0,0,102912,8,4719270642
7299,6538914115,52287,6538966402,7,0,1,57344,7,4021087367
7300,6538917046,254366,6539171412,1,0,1,8704,1,2413051396
7301,6538922746,261112,6539183858,7,0,1,31232,7,9148659513
7302,6538968538,247790,6539216328,6,0,1,7680,6,2981346845
7303,6538991711,340062,6539331773,4,0,0,84992,4,8386526495
7304,6539096568,159336,6539255904,3,0,1,5632,3,3913501864
7305,6539149036,195555,6539344591,7,0,1,70656,7,1112071781
7306,6539322188,66208,6539388396,5,0,1,8192,5,8060138670
7307,6539368581,189028,6539557609,2,0,1,159232,2,1041999474
7308,6539397204,171787,6539568991,6,0,1,24064,6,9714093191
7309,6539428905,140253,6539569158,3,0,1,512,3,9039016610
7310,6539436596,133041,6539569637,1,0,1,1536,1,1027865502
7311,6539540620,76817,6539617437,5,0,0,471040,5,10066697613
7312,6539542721,305173,6539847894,4,0,1,9216,4,7514694262
7313,6539579810,287079,6539866889,3,0,0,76288,3,4234191955
7314,6539612175,261154,6539873329,5,0,1,4608,5,9443581735
7315,6539728710,222802,6539951512,1,0,1,14848,1,8155633081
7316,6539963484,81440,6540044924,1,0,1,512,1,2537539253
7317,6539976108,429150,6540405258,4,0,0,698880,4,4581657599
7318,6540016398,395171,6540411569,8,0,0,22016,8,1810123703
7319,6540016630,485283,6540501913,9,0,1,38400,9,9265565957
7320,6540200292,157049,6540357341,5,0,0,648192,5,3333235406
7321,6540235984,411720,6540647704,0,0,0,512,0,10176142499
7322,6540270653,376374,6540647027,3,0,0,135168,3,3565914119
7323,6540271156,282338,6540553494,5,0,1,17408,5,5408247920
7324,6540324924,383640,6540708564,9,0,0,103936,9,5990908586
7325,6540333691,361345,6540695036,1,0,1,6144,1,6252585853
7326,6540377798,428828,6540806626,4,0,1,6656,4,2282439157
7327,6540395799,353439,6540749238,6,0,1,79360,6,5804509956
7328,6540411622,23462,6540435084,6,0,1,3072,6,5708669639
7329,6540593046,465009,6541058055,7,0,1,14848,7,7166571041
7330,6540667598,334465,6541002063,9,0,1,30208,9,4680752457
7331,6540671119,326349,6540997468,0,0,1,34816,0,5542270112
7332,6540733054,291738,6541024792,7,0,1,5120,7,57849868
7333,6540734498,367136,6541101634,2,0,1,19968,2,8884143986
7334,6540805307,182392,6540987699,8,0,0,38912,8,2331123886
7335,6540856810,310799,6541167609,2,0,1,3072,2,10224902497
7336,6540890400,155087,6541045487,0,0,0,251904,0,7542605026
7337,6540899103,154214,6541053317,9,0,1,7168,9,4940965729
7338,6540981892,156550,6541138442,4,0,0,258048,4,8380619365
7339,6541037964,34329,6541072293,9,0,1,4608,9,6973659290
7340,6541055069,256408,6541311477,4,0,1,54272,4,3655632617
7341,6541090029,274928,6541364957,8,0,1,11264,8,7613269238
7342,6541101616,71762,6541173378,0,0,1,253952,0,1454063975
7343,6541115045,389315,6541504360,3,0,0,35840,3,10300173182
7344,6541187346,306600,6541493946,9,0,1,9728,9,5064346895
7345,6541321660,407360,6541729020,9,0,0,116224,9,4243652378
7346,6541331303,166105,6541497408,4,0,0,215552,4,4506895532
7347,6541365656,281131,6541646787,0,0,0,277504,0,8659598772
7348,6541386775,302789,6541689564,3,0,0,181248,3,2702201118
7349,6541387303,335550,6541722853,2,0,1,12800,2,2199496113
7350,6541431290,343953,6541775243,4,0,0,171520,4,3269382629
7351,6541448774,328735,6541777509,6,0,0,3584,6,1774517124
7352,6541488460,294643,6541783103,4,0,0,26624,4,9305476162
7353,6541502517,342848,6541845365,1,0,0,199680,1,9889227703
7354,6541541925,435824,6541977749,7,0,1,7680,7,8573765726
7355,6541820927,306155,6542127082,0,0,1,313344,0,5932014680
7356,6541893358,230414,6542123772,5,0,1,16896,5,7184272373
7357,6541944441,499712,6542444153,4,0,1,4608,4,787393847
7358,6541994742,322410,6542317152,7,0,1,8704,7,2782718067
7359,6542004948,197150,6542202098,7,0,1,22016,7,3958085108
7360,6542026352,386535,6542412887,5,0,0,535040,5,9306214172
7361,6542065411,327900,6542393311,3,0,0,24576,3,10697287842
7362,6542132403,294026,6542426429,7,0,1,7168,7,6323275864
7363,6542153872,173915,6542327787,4,0,1,18944,4,6501240394
7364,6542187148,172717,6542359865,6,0,0,2560,6,10328735434
7365,6542191277,160115,6542351392,0,0,1,464896,0,1408892485
7366,6542198971,2466,6542201437,5,0,0,34304,5,9148213430
7367,6542257012,13079,6542270091,8,0,0,144384,8,2209680546
7368,6542372553,566683,6542939236,5,0,1,12288,5,10217806484
7369,6542394165,184312,6542578477,5,0,1,4096,5,8060953411
7370,6542428109,365065,6542793174,6,0,0,2560,6,8378666489
7371,6542431170,390432,6542821602,6,0,1,7680,6,1042059657
7372,6542450764,614896,6543065660,0,0,0,22016,0,7694079163
7373,6542513954,339957,6542853911,5,0,1,35328,5,4853378526
7374,6542573659,267948,6542841607,7,0,0,98304,7,5200961921
7375,6542722848,62396,6542785244,8,0,0,9728,8,5124213604
7376,6542830032,562,6542830594,2,0,0,512,2,1181074841
7377,6542844006,74775,6542918781,5,0,1,126976,5,3680202970
7378,6542857723,193737,6543051460,3,0,0,125440,3,8475868768
7379,6542880606,90006,6542970612,3,0,1,7168,3,10343364686
7380,6542947764,34363,6542982127,7,0,0,138240,7,4256687025
7381,6542976292,39880,6543016172,6,0,1,22016,6,9171520731
7382,6543026370,251961,6543278331,9,0,1,12288,9,6345828395
7383,6543030275,139180,6543169455,8,0,1,35328,8,2998519948
7384,6543048641,197959,6543246600,9,0,0,56832,9,546854213
7385,6543048821,204863,6543253684,5,0,0,27136,5,830569567
7386,6543069567,291209,6543360776,3,0,1,20992,3,3314973147
7387,6543133004,396537,6543529541,3,0,0,642048,3,2268178748
7388,6543144350,311880,6543456230,8,0,1,22016,8,4667882318
7389,6543223255,406317,6543629572,5,0,0,18432,5,1619450889
7390,6543292545,167896,6543460441,9,0,1,3584,9,6120695157
7391,6543313782,344902,6543658684,3,0,1,33792,3,5282951207
7392,6543393980,64050,6543458030,5,0,0,87040,5,5151757286
7393,6543432942,562,6543433504,0,0,1,524800,0,5833567182
7394,6543649239,602872,6544252111,4,0,0,89600,4,7262022303
7395,6543714675,189592,6543904267,2,0,0,512,2,10122319985
7396,6543737456,744383,6544481839,4,0,1,29696,4,5445434782
7397,6543846233,308531,6544154764,0,0,0,57856,0,1738087189
7398,6544036303,15575,6544051878,2,0,1,11776,2,9668361814
7399,6544076099,77100,6544153199,8,0,0,30208,8,10133245719
7400,6544115045,37333,6544152378,0,0,0,130048,0,6349375979
7401,6544171491,1038,6544172529,0,0,0,55296,0,8283149740
7402,6544240919,239795,6544480714,6,0,0,1024,6,6909951666
7403,6544247034,146590,6544393624,5,0,1,7680,5,1337799526
7404,6544344481,166416,6544510897,4,0,0,273920,4,6568003578
7405,6544353748,158327,6544512075,5,0,0,13824,5,7651108144
7406,6544434633,147697,6544582330,6,0,1,34304,6,5798444756
7407,6544613906,41904,6544655810,1,0,1,20992,1,8007887194
7408,6544617412,11012,6544628424,2,0,1,4608,2,5542837090
7409,6544628894,183013,6544811907,8,0,0,68096,8,8437357061
7410,6544688909,208649,6544897558,7,0,0,17920,7,10488615089
7411,6544714898,116050,6544830948,3,0,0,192512,3,10444338465
7412,6544715450,116804,6544832254,6,0,0,2048,6,10110073388
7413,6544861116,2466,6544863582,2,0,0,2560,2,2091111748
7414,6544948032,2466,6544950498,2,0,0,2560,2,343571112
7415,6545009802,45592,6545055394,9,0,1,1024,9,3735519990
7416,6545021128,216490,6545237618,0,0,1,177664,0,3040118630
7417,6545110820,139765,6545250585,7,0,1,42496,7,3929511414
7418,6545188952,137156,6545326108,1,0,0,1201152,1,8605134985
7419,6545213049,276364,6545489413,6,0,1,27136,6,1167958799
7420,6545319955,458937,6545778892,9,0,0,91648,9,2216581731
7421,6545399413,434317,6545833730,9,0,1,5120,9,365632154
7422,6545408786,307998,6545716784,1,0,0,29184,1,3283888256
7423,6545447434,592582,6546040016,6,0,1,35840,6,3587063366
7424,6545530607,803438,6546334045,3,0,1,19968,3,7107680671
7425,6545532912,698459,6546231371,8,0,1,6656,8,8168222525
7426,6545592581,345182,6545937763,9,0,0,288256,9,1208439265
7427,6545610340,615734,6546226074,4,0,0,2560,4,2856830941
7428,6545661617,519559,6546181176,3,0,1,15360,3,9726258113
7429,6545677401,503426,6546180827,8,0,1,9728,8,154444678
7430,6545884435,262604,6546147039,8,0,1,1536,8,6026538993
7431,6545886008,274621,6546160629,7,0,0,158720,7,5517087470
7432,6545970586,195842,6546166428,1,0,0,27648,1,9990285447
7433,6546050652,76555,6546127207,3,0,1,11264,3,7647701760
7434,6546121747,107921,6546229668,8,0,0,111616,8,578310604
7435,6546133841,225472,6546359313,9,0,0,143872,9,4110727473
7436,6546149745,358825,6546508570,8,0,1,9728,8,7172133381
7437,6546262646,105238,6546367884,1,0,1,8704,1,9977455610
7438,6546336825,40704,6546377529,0,0,0,171520,0,7027552198
7439,6546385591,202189,6546587780,2,0,1,2560,2,4551179354
7440,6546394798,207996,6546602794,4,0,1,20992,4,858009317
7441,6546411881,359444,6546771325,8,0,0,33792,8,7662987993
7442,6546432854,346422,6546779276,8,0,1,27136,8,8783248301
7443,6546578872,198859,6546777731,6,0,1,8192,6,868027375
7444,6546628666,180670,6546809336,5,0,0,327168,5,7495729179
7445,6546650721,317792,6546968513,3,0,0,6144,3,532450260
7446,6546820662,76013,6546896675,5,0,0,126976,5,5049608726
7447,6546871734,2466,6546874200,3,0,1,26112,3,2751912088
7448,6546919097,21137,6546940234,2,0,0,2560,2,938721074
7449,6547001251,4485,6547005736,5,0,1,65024,5,4878511498
7450,6547043848,212562,6547256410,1,0,0,34304,1,6991781426
7451,6547056601,112960,6547169561,6,0,1,24576,6,2568552405
7452,6547062766,222097,6547284863,6,0,0,3584,6,8887642872
7453,6547192179,3418,6547195597,8,0,1,38912,8,9684064210
7454,6547246444,114521,6547360965,6,0,0,3584,6,4162669597
7455,6547264861,52360,6547317221,5,0,1,3072,5,8644976162
7456,6547291057,3894,6547294951,3,0,1,6144,3,9369256318
7457,6547337498,62512,6547400010,2,0,0,4096,2,9338263485
7458,6547369272,47284,6547416556,5,0,1,1536,5,422480356
7459,6547391976,125560,6547517536,0,0,1,33280,0,1116670241
7460,6547400355,147458,6547547813,9,0,0,243712,9,7087149879
7461,6547447218,121998,6547569216,5,0,0,69632,5,3278403586
7462,6547520337,16214,6547536551,4,0,1,5632,4,3051182791
7463,6547553156,157577,6547710733,1,0,0,8704,1,7412220791
7464,6547573557,265481,6547839038,4,0,1,19968,4,6956552133
7465,6547986996,23633,6548010629,0,0,0,42496,0,1033657384
7466,6547990762,86371,6548077133,6,0,1,13824,6,4366468343
7467,6548022638,95541,6548118179,7,0,0,159232,7,10577789209
7468,6548186611,26217,6548212828,0,0,0,47616,0,7494855924
7469,6548264721,34104,6548298825,7,0,1,29184,7,7327481851
7470,6548303095,144067,6548447162,8,0,0,56320,8,4835418877
7471,6548331928,157044,6548488972,3,0,1,7680,3,5960760860
7472,6548335449,175697,6548511146,5,0,1,23552,5,5014327571
7473,6548522738,144704,6548667442,7,0,0,235008,7,946883254
7474,6548543520,187635,6548731155,6,0,1,16896,6,9146529749
7475,6548661402,201865,6548863267,3,0,1,46080,3,5414540685
7476,6548709909,169007,6548878916,4,0,1,36352,4,2494565738
7477,6548788223,177123,6548965346,1,0,1,4096,1,459220631
7478,6548801212,216322,6549017534,5,0,1,29184,5,633255860
7479,6549041048,50668,6549091716,7,0,1,2560,7,3794104647
7480,6549090597,4846,6549095443,2,0,0,5120,2,3665397087
7481,6549114185,50824,6549165009,7,0,1,3072,7,4060145501
7482,6549162508,125658,6549288166,5,0,0,207872,5,10662933175
7483,6549193330,287633,6549480963,0,0,0,413184,0,180671098
7484,6549200189,281120,6549481309,3,0,0,512,3,2543394357
7485,6549342679,169992,6549512671,3,0,0,100864,3,10099562698
7486,6549481358,124883,6549606241,3,0,0,206336,3,7653799194
7487,6549487109,119798,6549606907,2,0,0,1024,2,3970553404
7488,6549674131,3418,6549677549,2,0,0,3584,2,2627019529
7489,6549789578,4933,6549794511,7,0,0,12800,7,8350206426
7490,6549868628,124712,6549993340,9,0,0,202752,9,10226603466
7491,6549924017,159389,6550083406,7,0,1,18432,7,7361805908
7492,6549978439,105914,6550084353,1,0,1,3072,1,3585679583
7493,6550058798,155775,6550214573,3,0,0,256512,3,3850031424
7494,6550091084,155655,6550246739,8,0,1,51712,8,8511717157
7495,6550111016,196519,6550307535,1,0,0,175616,1,6648915949
7496,6550172888,79317,6550252205,0,0,1,64000,0,238296981
7497,6550224565,116050,6550340615,7,0,0,129024,7,1702227586
7498,6550294853,267630,6550562483,7,0,0,192512,7,10297008736
7499,6550416422,114846,6550531268,6,0,1,14336,6,4323474967
7500,6550441894,74604,6550516498,5,0,1,13312,5,1794338523
7501,6550453495,212308,6550665803,8,0,0,186880,8,3783388743
7502,6550499311,165052,6550664363,8,0,1,3072,8,5165965487
7503,6550538968,231700,6550770668,4,0,0,121856,4,5180045502
7504,6550663171,34016,6550697187,4,0,0,59392,4,9802645299
7505,6550834129,1990,6550836119,0,0,0,2048,0,10127587459
7506,6550840266,83866,6550924132,4,0,1,12288,4,1341249479
7507,6550861735,31771,6550893506,4,0,0,139776,4,10581463092
7508,6550916736,127505,6551044241,6,0,0,4608,6,2120144961
7509,6550931502,125400,6551056902,4,0,0,207360,4,3708399455
7510,6550935371,152483,6551087854,3,0,0,98816,3,7365488835
7511,6550977517,250524,6551228041,8,0,0,328704,8,4938998426
7512,6550987756,338580,6551326336,7,0,0,323072,7,6758738778
7513,6551014840,311957,6551326797,4,0,0,10240,4,6394227082
7514,6551055348,205267,6551260615,8,0,1,58880,8,4544615491
7515,6551168086,225071,6551393157,9,0,0,157184,9,5863720996
7516,6551169582,133777,6551303359,3,0,0,69120,3,2205308575
7517,6551249636,160476,6551410112,1,0,1,18432,1,1489764678
7518,6551264422,73748,6551338170,3,0,0,5632,3,2104146631
7519,6551290641,66748,6551357389,1,0,0,179712,1,10507224607
7520,6551393332,451066,6551844398,5,0,0,59904,5,5621202110
7521,6551400998,401595,6551802593,7,0,0,1024,7,4110389575
7522,6551476687,194295,6551670982,4,0,0,314880,4,80929043
7523,6551499013,138622,6551637635,3,0,1,4608,3,7705007457
7524,6551535586,143145,6551678731,6,0,0,5120,6,10401037032
7525,6551547947,304903,6551852850,8,0,0,64512,8,7072374833
7526,6551598458,265858,6551864316,8,0,0,434176,8,971959453
7527,6551621312,248496,6551869808,5,0,0,26112,5,1181769723
7528,6551899043,1038,6551900081,1,0,1,11776,1,6076687816
7529,6551926857,218879,6552145736,6,0,0,1024,6,459432594
7530,6551963583,156824,6552120407,3,0,1,16384,3,277121923
7531,6551964853,204825,6552169678,3,0,1,12288,3,2218811725
7532,6552048744,73131,6552121875,1,0,1,2048,1,9034248783
7533,6552104308,169978,6552274286,3,0,1,2560,3,3205625543
7534,6552121057,267123,6552388180,0,0,1,69120,0,4365139105
7535,6552277426,135096,6552412522,7,0,0,219648,7,8819712074
7536,6552288727,117540,6552406267,4,0,1,45056,4,1087902003
7537,6552327163,117600,6552444763,5,0,0,113152,5,4467046276
7538,6552417743,282764,6552700507,4,0,1,13824,4,8722416010
7539,6552439572,70987,6552510559,8,0,0,195584,8,7410157260
7540,6552579050,266698,6552845748,8,0,0,114688,8,7965256099
7541,6552628454,95113,6552723567,7,0,0,155136,7,6951116512
7542,6552636040,136424,6552772464,4,0,1,2048,4,6873966038
7543,6552703872,72537,6552776409,6,0,1,23552,6,8904710592
7544,6552706972,111497,6552818469,7,0,0,117760,7,1751624180
7545,6552713382,94548,6552807930,4,0,0,132608,4,7973746547
7546,6552719228,92071,6552811299,7,0,1,2560,7,245174088
7547,6552733877,51855,6552785732,2,0,0,5632,2,9510703200
7548,6552737340,247536,6552984876,0,0,0,1536,0,8630520046
7549,6552788898,4158,6552793056,4,0,0,37888,4,7368245171
7550,6552806455,255619,6553062074,6,0,1,16896,6,10321537645
7551,6552962329,10753,6552973082,6,0,0,11264,6,5534811085
7552,6552973064,291263,6553264327,1,0,0,17408,1,8007546278
7553,6553006379,120381,6553126760,4,0,1,8192,4,10543470483
7554,6553091782,65425,6553157207,3,0,0,110592,3,10101246984
7555,6553184407,47284,6553231691,5,0,1,23040,5,6079761003
7556,6553251490,61378,6553312868,3,0,1,1536,3,1720433017
7557,6553257338,181292,6553438630,6,0,1,17920,6,9303161426
7558,6553293571,182589,6553476160,9,0,0,99328,9,1347005143
7559,6553388936,102137,6553491073,3,0,0,165376,3,6707009314
7560,6553422487,203175,6553625662,4,0,1,52224,4,4447287628
7561,6553460431,201368,6553661799,3,0,1,65024,3,7899016834
7562,6553494936,253790,6553748726,6,0,1,57344,6,10153773578
7563,6553698463,19852,6553718315,0,0,1,103424,0,4260417553
7564,6553728885,133765,6553862650,1,0,0,9728,1,6405893351
7565,6553797765,34474,6553832239,3,0,0,34816,3,1046128609
7566,6553841883,63446,6553905329,1,0,0,103424,1,7180494083
7567,6553918564,102137,6554020701,9,0,0,165376,9,5436264552
7568,6554035183,226133,6554261316,5,0,0,370176,5,3658770246
7569,6554051846,301390,6554353236,6,0,1,4096,6,486802405
7570,6554081749,412853,6554494602,1,0,0,1184256,1,7839900054
7571,6554150998,261578,6554412576,7,0,1,2048,7,7968521502
7572,6554251556,535378,6554786934,4,0,1,16384,4,2308081137
7573,6554260826,797733,6555058559,2,0,0,2560,2,3554843527
7574,6554316935,620282,6554937217,2,0,0,8192,2,10052046132
7575,6554365240,569319,6554934559,3,0,0,4608,3,29526864
7576,6554377997,523920,6554901917,6,0,0,1024,6,5400076809
7577,6554399894,511829,6554911723,1,0,0,424448,1,6631440098
7578,6554403622,619640,6555023262,1,0,1,2560,1,7191942378
7579,6554423355,596845,6555020200,0,0,0,1024,0,8160545057
7580,6554573701,244814,6554818515,9,0,0,371200,9,785879878
7581,6554704469,328413,6555032882,5,0,0,39424,5,8092109495
7582,6554720256,559989,6555280245,2,0,1,2048,2,812930090
7583,6554767227,440870,6555208097,3,0,0,374784,3,5900146567
7584,6554799895,492318,6555292213,8,0,1,9216,8,3013276708
7585,6554931646,328565,6555260211,6,0,0,11264,6,6571235787
7586,6555040385,224652,6555265037,2,0,0,7680,2,2046988836
7587,6555107585,204725,6555312310,4,0,0,160768,4,10011443770
7588,6555132596,195785,6555328381,1,0,1,5632,1,3355783869
7589,6555168931,218959,6555387890,9,0,0,177152,9,9483585955
7590,6555219104,108930,6555328034,3,0,0,236544,3,8723285886
7591,6555252941,78299,6555331240,5,0,1,9216,5,5375137403
7592,6555331504,325717,6555657221,2,0,1,11264,2,6726612611
7593,6555339758,257405,6555597163,3,0,0,34304,3,4354791589
7594,6555371260,1514,6555372774,9,0,0,12288,9,8854112045
7595,6555384681,268170,6555652851,1,0,1,3072,1,877251091
7596,6555453513,84729,6555538242,4,0,1,33792,4,2735687023
7597,6555466189,29618,6555495807,7,0,1,7680,7,3382008571
7598,6555557238,258720,6555815958,1,0,1,55296,1,77915258
7599,6555564287,248395,6555812682,6,0,0,1536,6,7270263425
7600,6555579079,9412,6555588491,5,0,0,138240,5,10065587163
7601,6555586449,388611,6555975060,3,0,1,1024,3,7897020131
7602,6555612251,323315,6555935566,2,0,1,14336,2,7564421330
7603,6555627507,202243,6555829750,8,0,1,4608,8,8244487692
7604,6555636776,290053,6555926829,2,0,0,4096,2,4482795347
7605,6555705743,319182,6556024925,2,0,0,512,2,9191717225
7606,6555708850,273745,6555982595,8,0,1,33280,8,5961665261
7607,6555732069,267313,6555999382,8,0,0,442880,8,3898701325
7608,6555738847,239085,6555977932,0,0,0,512,0,1579120546
7609,6555767421,420547,6556187968,2,0,0,512,2,3424194686
7610,6555841229,147716,6555988945,7,0,1,48128,7,10494018943
7611,6555859776,151324,6556011100,6,0,0,1536,6,2804013975
7612,6555872745,269568,6556142313,1,0,0,54784,1,10344117378
7613,6555909288,234537,6556143825,0,0,1,59904,0,709734819
7614,6555933337,76228,6556009565,7,0,0,379904,7,10467539710
7615,6555955515,339481,6556294996,3,0,1,16896,3,3002714121
7616,6556028938,129640,6556158578,1,0,1,32256,1,8086181394
7617,6556092312,290129,6556382441,0,0,0,1024,0,3549693969
7618,6556175286,443724,6556619010,5,0,1,7168,5,6269345514
7619,6556471564,91148,6556562712,3,0,1,3072,3,6254434264
7620,6556492157,160141,6556652298,1,0,1,69120,1,9471668325
7621,6556576872,75593,6556652465,5,0,1,512,5,1315935660
7622,6556606754,109760,6556716514,4,0,1,59904,4,8813087531
7623,6556626922,128136,6556755058,4,0,1,25088,4,3296981599
7624,6556643954,115203,6556759157,3,0,0,177664,3,1558363906
7625,6556668023,111718,6556779741,9,0,0,73728,9,1879771156
7626,6556711718,96596,6556808314,2,0,1,2560,2,5985995489
7627,6556713331,165212,6556878543,4,0,1,16384,4,2291015835
7628,6556762565,143843,6556906408,3,0,0,268288,3,992256487
7629,6556784600,232987,6557017587,6,0,0,1024,6,8759732268
7630,6556924055,206658,6557130713,5,0,0,338944,5,8446283544
7631,6557013050,214874,6557227924,1,0,1,5120,1,3211257034
7632,6557090465,201417,6557291882,3,0,1,1536,3,5174591307
7633,6557097357,225446,6557322803,6,0,1,5632,6,10248661835
7634,6557097492,235821,6557333313,9,0,0,365568,9,4464367681
7635,6557129052,287126,6557416178,3,0,0,135168,3,6796372990
7636,6557169732,226298,6557396030,3,0,0,99840,3,1963002848
7637,6557199878,197458,6557397336,2,0,0,2048,2,6648959467
7638,6557252910,166136,6557419046,8,0,0,71168,8,934440269
7639,6557329955,58613,6557388568,0,0,1,71680,0,10650831109
7640,6557362699,154741,6557517440,0,0,0,3584,0,4175944263
7641,6557441931,122408,6557564339,9,0,0,254464,9,9200512540
7642,6557470991,1990,6557472981,2,0,1,1536,2,2317824874
7643,6557474930,232177,6557707107,6,0,0,1024,6,8457057372
7644,6557515289,506836,6558022125,6,0,1,22528,6,9042675838
7645,6557561629,194385,6557756014,1,0,1,18944,1,2841853305
7646,6557642218,364668,6558006886,6,0,0,2048,6,1858838831
7647,6557678697,378050,6558056747,7,0,1,25088,7,8216379067
7648,6557772912,160298,6557933210,3,0,1,27648,3,3266354539
7649,6557789364,238881,6558028245,7,0,1,7168,7,172517480
7650,6557913263,307221,6558220484,3,0,0,498176,3,181860838
7651,6558023011,270718,6558293729,4,0,0,244224,4,1198349977
7652,6558085574,210741,6558296315,0,0,0,4096,0,1089070265
7653,6558090868,166631,6558257499,9,0,1,14848,9,10603864967
7654,6558130350,153878,6558284228,2,0,0,1024,2,7367461950
7655,6558150053,77100,6558227153,7,0,1,10240,7,2228263450
7656,6558167643,283576,6558451219,8,0,1,4608,8,4482871568
7657,6558281011,66088,6558347099,5,0,0,130048,5,9544622963
7658,6558306841,317405,6558624246,1,0,1,6656,1,4233382871
7659,6558308367,177544,6558485911,9,0,0,52224,9,6221396143
7660,6558327792,299822,6558627614,3,0,1,22528,3,1286883731
7661,6558435658,255821,6558691479,7,0,0,414720,7,1048669097
7662,6558510408,181737,6558692145,2,0,0,1024,2,4492125788
7663,6558580983,57633,6558638616,3,0,1,5632,3,5380439706
7664,6558628092,75895,6558703987,3,0,1,1024,3,5510293252
7665,6558634973,247790,6558882763,6,0,0,10240,6,4079143640
7666,6558678740,178779,6558857519,3,0,1,3072,3,405420950
7667,6558827445,34104,6558861549,1,0,1,6656,1,4877768416
7668,6558837879,66988,6558904867,8,0,0,56320,8,10451717556
7669,6558903541,186842,6559090383,8,0,1,10752,8,5676837783
7670,6558982161,180128,6559162289,8,0,1,512,8,1036911821
7671,6559005478,96317,6559101795,2,0,1,73728,2,7024249846
7672,6559067173,80696,6559147869,1,0,1,35328,1,1555259694
7673,6559080128,257351,6559337479,9,0,0,160768,9,6780646097
7674,6559122490,138345,6559260835,4,0,0,95232,4,1777681327
7675,6559124495,48846,6559173341,5,0,0,164352,5,3388208964
7676,6559228210,82783,6559310993,9,0,1,4608,9,5674565452
7677,6559260194,294057,6559554251,8,0,0,79872,8,2633927694
7678,6559347661,91670,6559439331,2,0,1,7680,2,10726541945
7679,6559369316,117775,6559487091,1,0,1,19456,1,5282259980
7680,6559514117,55744,6559569861,9,0,1,4096,9,1924347218
7681,6559553325,114820,6559668145,1,0,1,3584,1,7731765567
7682,6559635795,76583,6559712378,5,0,0,129024,5,6354661467
7683,6559777226,104204,6559881430,4,0,0,169472,4,9886257262
7684,6559778242,108782,6559887024,9,0,0,18432,9,1271375778
7685,6559783037,162994,6559946031,3,0,0,180224,3,10547796944
7686,6560017536,43712,6560061248,1,0,0,71680,1,6587487744
7687,6560088526,1514,6560090040,6,0,0,1536,6,271561342
7688,6560089013,3418,6560092431,8,0,1,4096,8,7902903636
7689,6560107595,77099,6560184694,8,0,1,47104,8,8171278714
7690,6560118699,128795,6560247494,2,0,0,3584,2,6941278432
7691,6560195949,107734,6560303683,7,0,0,179712,7,9006708155
7692,6560197150,112230,6560309380,1,0,0,27136,1,509772042
7693,6560308435,107217,6560415652,4,0,0,178688,4,6498009446
7694,6560333177,134909,6560468086,4,0,0,174592,4,2585141990
7695,6560376817,96415,6560473232,6,0,0,8192,6,4664911280
7696,6560408493,2466,6560410959,5,0,1,29696,5,4168596964
7697,6560544378,184432,6560728810,7,0,0,2560,7,8305488718
7698,6560553220,13249,6560566469,8,0,1,49152,8,10535902993
7699,6560612754,562,6560613316,5,0,0,25600,5,8929215070
7700,6560679490,163674,6560843164,6,0,0,512,6,7800725500
7701,6560806674,65452,6560872126,3,0,1,10752,3,770639864
7702,6560851307,1514,6560852821,4,0,1,31744,4,2001300998
7703,6560886787,43712,6560930499,2,0,0,1536,2,1084443096
7704,6560895966,110843,6561006809,1,0,0,71680,1,2135905364
7705,6561030873,55744,6561086617,6,0,1,4096,6,697525664
7706,6561035485,385378,6561420863,8,0,0,623616,8,6264623009
7707,6561076880,374054,6561450934,9,0,1,7168,9,3364247458
7708,6561088607,268375,6561356982,0,0,1,26112,0,3618297990
7709,6561214136,180967,6561395103,4,0,0,196608,4,8057454946
7710,6561323431,477970,6561801401,1,0,1,2560,1,921559235
7711,6561352889,212109,6561564998,9,0,0,263680,9,7202636099
7712,6561354047,100907,6561454954,4,0,0,157696,4,9466676085
7713,6561368166,232536,6561600702,6,0,1,512,6,10659184479
7714,6561370185,257609,6561627794,6,0,1,17920,6,4344301343
7715,6561427829,185453,6561613282,2,0,0,2560,2,10559719625
7716,6561441166,150847,6561592013,9,0,1,6656,9,3844870494
7717,6561468372,145929,6561614301,4,0,1,512,4,304843617
7718,6561498418,32983,6561531401,4,0,0,114688,4,2601986165
7719,6561505922,267191,6561773113,6,0,0,4096,6,5725173502
7720,6561526837,371711,6561898548,4,0,1,11776,4,883872841
7721,6561569023,55558,6561624581,0,0,1,391680,0,8113853762
7722,6561639142,23902,6561663044,3,0,1,9728,3,9476019867
7723,6561665077,562,6561665639,7,0,0,57344,7,10603329260
7724,6561714642,457552,6562172194,7,0,0,94720,7,2114027461
7725,6561743975,123420,6561867395,0,0,1,439808,0,1335728512
7726,6561748564,130347,6561878911,0,0,0,3584,0,5345871247
7727,6561783428,684123,6562467551,0,0,1,19456,0,9926995061
7728,6561854701,475657,6562330358,6,0,0,512,6,6080595795
7729,6561883458,622918,6562506376,7,0,0,200192,7,7205457818
7730,6561903065,370086,6562273151,5,0,1,9728,5,6807098572
7731,6561913230,400652,6562313882,1,0,0,126464,1,10366819614
7732,6561943854,741810,6562685664,9,0,1,19968,9,10083800224
7733,6562009092,489808,6562498900,8,0,1,43008,8,8828595763
7734,6562090493,411070,6562501563,7,0,1,8704,7,6523945459
7735,6562216603,273088,6562489691,6,0,1,13824,6,8552935596
7736,6562228494,228264,6562456758,3,0,0,231424,3,4159740004
7737,6562251391,191132,6562442523,1,0,1,56320,1,9175025338
7738,6562273329,217619,6562490948,2,0,0,1536,2,10270931549
7739,6562305185,135298,6562440483,0,0,1,68608,0,4248670001
7740,6562310472,352737,6562663209,0,0,0,4608,0,3300048619
7741,6562387517,404910,6562792427,9,0,0,10752,9,7992797269
7742,6562466736,190898,6562657634,3,0,0,247296,3,5526454395
7743,6562522655,135325,6562657980,2,0,0,512,2,1706321812
7744,6562629919,250455,6562880374,9,0,1,9216,9,2428860615
7745,6562727108,155863,6562882971,9,0,0,253440,9,10033877031
7746,6562749992,153955,6562903947,5,0,1,11264,5,7507015912
7747,6562760890,117346,6562878236,4,0,0,103424,4,2182513168
7748,6562798165,97869,6562896034,6,0,0,1024,6,6796775490
7749,6562809172,235210,6563044382,8,0,1,4096,8,2720584598
7750,6562818628,236178,6563054806,6,0,0,1536,6,4817045001
7751,6562902382,125715,6563028097,7,0,1,57856,7,6326845216
7752,6563100728,343616,6563444344,8,0,1,18432,8,6740577778
7753,6563235170,2866,6563238036,1,0,1,44544,1,1526357830
7754,6563293868,43196,6563337064,0,0,0,8704,0,1306703678
7755,6563304899,156657,6563461556,5,0,1,33792,5,7939340785
7756,6563311253,212912,6563524165,9,0,0,70656,9,8177437248
7757,6563404850,122645,6563527495,3,0,0,198656,3,6445469325
7758,6563440442,90599,6563531041,2,0,0,5632,2,1755930827
7759,6563564841,223219,6563788060,8,0,1,53760,8,2249823286
7760,6563669443,166158,6563835601,3,0,0,273408,3,3485788821
7761,6563701083,197497,6563898580,1,0,0,211456,1,5555365704
7762,6563839798,63928,6563903726,2,0,0,8192,2,5831526427
7763,6563850764,85245,6563936009,3,0,0,105472,3,5632288890
7764,6563875477,81730,6563957207,1,0,0,76800,1,10561988509
7765,6563876797,186208,6564063005,8,0,1,9216,8,3882771188
7766,6563888181,48976,6563937157,4,0,1,6656,4,2301556390
7767,6564008736,227804,6564236540,8,0,1,13312,8,1910739237
7768,6564033639,129264,6564162903,8,0,1,2048,8,5248196466
7769,6564136755,25387,6564162142,3,0,0,43520,3,6157688996
7770,6564146084,17364,6564163448,0,0,0,2048,0,4310299658
7771,6564146641,20353,6564166994,3,0,0,5632,3,5379363166
7772,6564196356,124108,6564320464,9,0,0,204800,9,1584200918
7773,6564231106,110454,6564341560,2,0,0,76288,2,697618191
7774,6564351203,40612,6564391815,1,0,1,19968,1,7897811368
7775,6564382026,148439,6564530465,4,0,0,65536,4,459125524
7776,6564459447,120471,6564579918,7,0,0,329728,7,7924848663
7777,6564496925,203645,6564700570,1,0,1,4608,1,6457606146
7778,6564631793,126727,6564758520,6,0,1,11264,6,8150883040
7779,6564671624,164437,6564836061,1,0,0,266752,1,1247048831
7780,6564676034,163893,6564839927,3,0,0,6144,3,6893879751
7781,6564705169,136384,6564841553,6,0,0,2560,6,2430817038
7782,6564730477,194208,6564924685,8,0,1,47616,8,8061067794
7783,6564781334,275641,6565056975,3,0,1,12800,3,2214351052
7784,6565124279,54832,6565179111,3,0,1,6144,3,10087222548
7785,6565147555,279083,6565426638,5,0,0,456704,5,228018444
7786,6565219515,108056,6565327571,7,0,1,10240,7,6557910564
7787,6565319568,271767,6565591335,3,0,0,1536,3,5257291252
7788,6565446758,12562,6565459320,4,0,1,3584,4,9573483631
7789,6565470427,121704,6565592131,6,0,1,11776,6,7752678801
7790,6565476403,163550,6565639953,2,0,1,17408,2,81720506
7791,6565545804,197372,6565743176,8,0,0,20992,8,286569284
7792,6565623470,41387,6565664857,8,0,0,67072,8,1616199356
7793,6565642532,50566,6565693098,2,0,1,2048,2,1378484554
7794,6565778707,192148,6565970855,0,0,1,169472,0,9688321981
7795,6566001629,33846,6566035475,9,0,0,55808,9,7777811582
7796,6566029113,2466,6566031579,4,0,1,6144,4,4146652037
7797,6566064177,200017,6566264194,6,0,0,2560,6,5573749401
7798,6566098703,247933,6566346636,2,0,0,406016,2,1545822108
7799,6566107402,243100,6566350502,6,0,0,6144,6,2627855513
7800,6566138712,2466,6566141178,5,0,1,15360,5,9516278036
7801,6566242781,243393,6566486174,4,0,1,27648,4,8447109378
7802,6566265492,4846,6566270338,2,0,1,11264,2,665471763
7803,6566293311,206386,6566499697,2,0,1,73728,2,2599175629
7804,6566371303,215941,6566587244,1,0,1,7168,1,10496238287
7805,6566372315,114604,6566486919,6,0,0,2560,6,1899288792
7806,6566384674,276616,6566661290,1,0,1,512,1,10718282599
7807,6566394251,185420,6566579671,6,0,1,99840,6,7736823047
7808,6566413924,2466,6566416390,5,0,1,4096,5,10723693425
7809,6566417615,227656,6566645271,6,0,0,5120,6,6152030177
7810,6566431734,148938,6566580672,2,0,1,10752,2,204320763
7811,6566450344,280709,6566731053,2,0,1,1024,2,4171909704
7812,6566471310,246513,6566717823,5,0,1,40960,5,6274773198
7813,6566581445,266266,6566847711,0,0,0,2560,0,6936413272
7814,6566630885,186167,6566817052,3,0,1,44544,3,3306455660
7815,6566795919,70972,6566866891,1,0,1,8704,1,9839631613
7816,6566836121,66284,6566902405,1,0,1,8192,1,1092103897
7817,6566837087,134321,6566971408,1,0,0,218112,1,968653508
7818,6566977722,243359,6567221081,3,0,1,89088,3,2864005981
7819,6567094115,73056,6567167171,0,0,1,103936,0,2727102936
7820,6567171029,200952,6567371981,8,0,1,1024,8,3611897818
7821,6567233410,55395,6567288805,0,0,1,18944,0,7500739794
7822,6567239683,62317,6567302000,2,0,0,66560,2,4082927306
7823,6567248166,143680,6567391846,3,0,1,2048,3,10429375081
7824,6567308423,93562,6567401985,0,0,1,100352,0,5160319480
7825,6567315469,62340,6567377809,2,0,0,152064,2,9025106135
7826,6567357725,184779,6567542504,9,0,0,36352,9,8979085783
7827,6567402474,1514,6567403988,6,0,1,102400,6,3081995872
7828,6567434147,72977,6567507124,9,0,1,4608,9,7058556132
7829,6567444243,22858,6567467101,5,0,1,57856,5,5079610268
7830,6567515369,284494,6567799863,3,0,1,3584,3,9104495671
7831,6567517990,215746,6567733736,0,0,1,243200,0,6305487346
7832,6567560885,37532,6567598417,0,0,1,47104,0,9689611408
7833,6567579012,441932,6568020944,1,0,0,1536,1,4227183689
7834,6567590961,240888,6567831849,7,0,1,13824,7,2517218878
7835,6567613955,321644,6567935599,1,0,1,46080,1,2993314881
7836,6567617386,328491,6567945877,0,0,1,136704,0,8216891379
7837,6567624531,528622,6568153153,4,0,0,40960,4,7384918719
7838,6567627278,551646,6568178924,2,0,1,59392,2,5685141837
7839,6567772050,420166,6568192216,0,0,0,8704,0,7811270269
7840,6567782704,194523,6567977227,8,0,1,18432,8,9215642277
7841,6567844912,262358,6568107270,3,0,1,6144,3,9047809654
7842,6567880090,169039,6568049129,6,0,1,13312,6,455324002
7843,6568063225,167137,6568230362,1,0,1,47104,1,1922012437
7844,6568130677,105238,6568235915,7,0,0,171520,7,8883075431
7845,6568150273,67212,6568217485,1,0,1,22528,1,7611255634
7846,6568179430,195299,6568374729,5,0,0,43008,5,9725139096
7847,6568196805,131973,6568328778,6,0,1,6144,6,10109405004
7848,6568217821,97853,6568315674,8,0,1,41984,8,307100683
7849,6568226653,241392,6568468045,3,0,1,3584,3,7408916929
7850,6568336815,265312,6568602127,9,0,1,11776,9,7219512755
7851,6568424393,60376,6568484769,4,0,1,9216,4,4675347636
7852,6568715980,136041,6568852021,4,0,0,224768,4,9980395890
7853,6568809827,2466,6568812293,7,0,1,24064,7,8356349563
7854,6568915938,272363,6569188301,3,0,0,2560,3,7561717257
7855,6568976860,149556,6569126416,4,0,1,47104,4,5210993709
7856,6569092195,126433,6569218628,7,0,0,209408,7,8427329306
7857,6569103575,151957,6569255532,8,0,0,127488,8,5322678656
7858,6569109087,218610,6569327697,2,0,1,9216,2,46070382
7859,6569255286,22946,6569278232,8,0,1,4096,8,3502631469
7860,6569314613,127824,6569442437,5,0,0,37888,5,10667810939
7861,6569321759,55817,6569377576,9,0,1,23552,9,7480857711
7862,6569329933,104144,6569434077,8,0,1,3584,8,3424196373
7863,6569344329,155266,6569499595,7,0,0,95232,7,201774281
7864,6569357008,189004,6569546012,9,0,0,318464,9,4115070138
7865,6569361696,212540,6569574236,2,0,1,1024,2,7966148868
7866,6569364466,267754,6569632220,7,0,0,201728,7,1088177032
7867,6569401260,143039,6569544299,8,0,1,6144,8,8728652856
7868,6569495492,330039,6569825531,8,0,0,22016,8,3012925045
7869,6569501564,348608,6569850172,6,0,1,9728,6,9614298766
7870,6569753242,125229,6569878471,1,0,1,40448,1,6596829011
7871,6569815470,72915,6569888385,5,0,0,203776,5,552421834
7872,6569869090,45329,6569914419,0,0,0,2048,0,9306675299
7873,6569898942,257211,6570156153,0,0,0,3584,0,7404147823
7874,6569974981,198485,6570173466,1,0,1,22016,1,3724599012
7875,6569977132,287400,6570264532,7,0,0,469504,7,10661465878
7876,6570053690,220584,6570274274,3,0,1,1536,3,8318087427
7877,6570116819,251858,6570368677,7,0,0,343040,7,214100431
7878,6570126791,72154,6570198945,2,0,1,38400,2,202701674
7879,6570302220,303528,6570605748,9,0,0,18944,9,4007255375
7880,6570372710,1038,6570373748,3,0,1,5632,3,2532419428
7881,6570452352,110557,6570562909,0,0,0,1024,0,2094234786
7882,6570465386,116671,6570582057,9,0,1,6656,9,8030875804
7883,6570479246,5450,6570484696,8,0,1,512,8,3354536098
7884,6570506914,23374,6570530288,2,0,1,2560,2,10520132321
7885,6570508610,288937,6570797547,0,0,1,247296,0,8959382163
7886,6570599425,562,6570599987,4,0,0,13824,4,5752513036
7887,6570600684,4158,6570604842,2,0,1,35840,2,5336543952
7888,6570615152,77672,6570692824,0,0,1,193536,0,912382513
7889,6570629358,223259,6570852617,4,0,0,41984,4,5745197143
7890,6570647425,366364,6571013789,6,0,1,1024,6,2710798044
7891,6570656494,285237,6570941731,4,0,1,16896,4,4174928166
7892,6570663452,115533,6570778985,1,0,0,512,1,10281808624
7893,6570720269,116170,6570836439,6,0,0,11264,6,9992751138
7894,6570776260,357038,6571133298,8,0,0,191488,8,5616802713
7895,6570776289,320855,6571097144,1,0,0,1024,1,4244750098
7896,6570834720,101432,6570936152,2,0,1,27136,2,3393250628
7897,6570875928,150935,6571026863,4,0,0,50688,4,10411446780
7898,6570894931,44114,6570939045,7,0,1,126464,7,1022368011
7899,6570927700,242831,6571170531,5,0,1,91648,5,6153303796
7900,6570943014,39066,6570982080,6,0,0,1536,6,8001713549
7901,6571087110,278648,6571365758,9,0,1,61440,9,8359056598
7902,6571098707,207537,6571306244,1,0,0,512,1,8525142718
7903,6571173828,132561,6571306389,5,0,1,3072,5,4292587793
7904,6571231086,1990,6571233076,1,0,1,18944,1,10559039100
7905,6571326692,119842,6571446534,3,0,0,2048,3,979580361
7906,6571349716,105824,6571455540,5,0,1,43520,5,7934737736
7907,6571379719,99184,6571478903,9,0,1,30720,9,6295093758
7908,6571431022,360600,6571791622,7,0,0,588800,7,7336383607
7909,6571458161,350345,6571808506,8,0,0,64512,8,9549269770
7910,6571525559,187995,6571713554,3,0,1,15360,3,4911203767
7911,6571555242,146856,6571702098,3,0,1,26112,3,5931349485
7912,6571579862,139016,6571718878,2,0,1,34304,2,6785757275
7913,6571620857,295948,6571916805,3,0,0,512,3,4635568592
7914,6571664902,298756,6571963658,1,0,0,4608,1,4736323522
7915,6571674688,353731,6572028419,3,0,0,3072,3,2242876547
7916,6571704638,144874,6571849512,0,0,1,319488,0,8844134596
7917,6571718211,467495,6572185706,0,0,1,24576,0,4234364006
7918,6571764765,461421,6572226186,5,0,0,238592,5,5688109787
7919,6571794933,299608,6572094541,5,0,1,36352,5,1684031619
7920,6571880035,175233,6572055268,8,0,0,373760,8,4935337707
7921,6572004421,164101,6572168522,5,0,0,95232,5,5352975900
7922,6572015564,51332,6572066896,1,0,0,5632,1,235699615
7923,6572038081,471870,6572509951,4,0,1,512,4,8931139452
7924,6572158582,233916,6572392498,5,0,1,34816,5,958244873
7925,6572159095,73741,6572232836,9,0,0,49664,9,2821790455
7926,6572202999,58988,6572261987,1,0,1,7168,1,8275861107
7927,6572304273,267103,6572571376,7,0,0,123392,7,10304156171
7928,6572319692,248529,6572568221,2,0,0,11264,2,3026261037
7929,6572365572,121612,6572487184,5,0,0,196608,5,5418347292
7930,6572368842,119008,6572487850,0,0,0,1024,0,10379705529
7931,6572416687,225415,6572642102,9,0,0,350720,9,1723567528
7932,6572449947,194421,6572644368,3,0,0,3584,3,1713636746
7933,6572453552,167972,6572621524,5,0,1,34304,5,8009169553
7934,6572483117,181424,6572664541,5,0,0,32256,5,3970435386
7935,6572500822,124448,6572625270,9,0,0,99840,9,9076000022
7936,6572647519,436237,6573083756,1,0,1,3584,1,9241994361
7937,6572748680,316282,6573064962,7,0,0,698368,7,2515041389
7938,6572807060,428891,6573235951,7,0,1,22528,7,7673932359
7939,6572827464,356352,6573183816,6,0,1,11776,6,816036468
7940,6572873546,396675,6573270221,4,0,0,295936,4,9258458029
7941,6572961030,310817,6573271847,3,0,0,2560,3,10699569632
7942,6572987938,285855,6573273793,1,0,0,3072,1,4025409539
7943,6573117439,274371,6573391810,9,0,1,7168,9,7915174075
7944,6573190870,53837,6573244707,0,0,1,172544,0,3617223759
7945,6573236476,7226,6573243702,2,0,1,4608,2,2238215118
7946,6573321344,330657,6573652001,8,0,1,30208,8,1883397286
7947,6573346446,286474,6573632920,2,0,0,88064,2,7596211948
7948,6573377254,139010,6573516264,9,0,1,54272,9,4426582783
7949,6573392505,259841,6573652346,9,0,1,9728,9,8548309971
7950,6573408890,2118,6573411008,3,0,0,7680,3,6121798348
7951,6573471124,327200,6573798324,5,0,0,146432,5,7442263812
7952,6573538118,321352,6573859470,5,0,1,11776,5,9399856434
7953,6573549808,230850,6573780658,9,0,1,24064,9,8057613332
7954,6573636007,303959,6573939966,1,0,0,1024,1,4490700405
7955,6573829235,83696,6573912931,9,0,0,136192,9,2489668390
7956,6573915718,133184,6574048902,6,0,1,50688,6,7552154713
7957,6573948714,42820,6573991534,8,0,1,41472,8,1510902333
7958,6573949500,3418,6573952918,0,0,1,91136,0,8867603319
7959,6574006093,182724,6574188817,8,0,0,62464,8,8361082595
7960,6574082457,199801,6574282258,6,0,0,3584,6,1399375713
7961,6574097112,94508,6574191620,4,0,0,157184,4,3182192345
7962,6574113061,81785,6574194846,0,0,0,5120,0,1026928432
7963,6574136310,46408,6574182718,8,0,1,10240,8,7144931952
7964,6574143666,2942,6574146608,2,0,1,20480,2,4452951257
7965,6574151344,175253,6574326597,3,0,0,4608,3,2990239899
7966,6574266902,185740,6574452642,3,0,0,3072,3,674167250
7967,6574337778,86224,6574424002,0,0,1,18432,0,1229808021
7968,6574360303,137817,6574498120,4,0,1,28672,4,9114641268
7969,6574405037,139721,6574544758,0,0,1,43008,0,2903336908
7970,6574458906,279342,6574738248,5,0,0,457216,5,9165324050
7971,6574526921,211891,6574738812,2,0,0,10752,2,8409667774
7972,6574650644,91714,6574742358,3,0,0,5632,3,3605726831
7973,6574713857,562,6574714419,8,0,1,23552,8,8398887803
7974,6574750959,20362,6574771321,3,0,0,512,3,5637331756
7975,6574757535,1990,6574759525,7,0,0,32768,7,4643602428
7976,6574785262,2866,6574788128,9,0,1,81408,9,6307497033
7977,6574850748,54266,6574905014,1,0,0,2048,1,3187300306
7978,6574852730,199509,6575052239,6,0,0,8704,6,5992772424
7979,6574858727,278101,6575136828,9,0,0,92160,9,10426559173
7980,6575033178,20620,6575053798,8,0,1,12800,8,8343085344
7981,6575066888,122035,6575188923,2,0,0,33280,2,6125849888
7982,6575133092,2466,6575135558,8,0,1,61440,8,475090669
7983,6575164570,166434,6575331004,3,0,0,2560,3,5354364224
7984,6575197180,102357,6575299537,6,0,0,143360,6,1278088252
7985,6575240023,7873,6575247896,5,0,1,6656,5,8977556362
7986,6575296502,160953,6575457455,0,0,0,5120,0,9629982283
7987,6575312126,206488,6575518614,0,0,1,208384,0,4913760712
7988,6575336936,126168,6575463104,5,0,0,335360,5,4443668304
7989,6575414216,353618,6575767834,4,0,1,21504,4,1156818403
7990,6575437934,158345,6575596279,3,0,1,2560,3,1195280432
7991,6575459805,237943,6575697748,8,0,0,138240,8,5533709718
7992,6575507410,378747,6575886157,8,0,0,202752,8,8023127202
7993,6575535659,258505,6575794164,2,0,0,364544,2,10609807249
7994,6575578019,162327,6575740346,9,0,1,38400,9,508857323
7995,6575632503,172228,6575804731,3,0,0,1024,3,4796999286
7996,6575634148,207031,6575841179,8,0,0,38912,8,2676358775
7997,6575636175,187919,6575824094,2,0,1,1024,2,6713149933
7998,6575677444,210478,6575887922,1,0,1,56320,1,7729963363
7999,6575682753,300627,6575983380,8,0,0,276480,8,2827121663
8000,6575703811,419899,6576123710,0,0,0,3072,0,9638326862
8001,6575744436,182843,6575927279,8,0,0,212480,8,5508549957
8002,6575770899,171790,6575942689,4,0,1,13824,4,1019030810
8003,6575815086,389236,6576204322,4,0,0,113664,4,3029481439
8004,6575826150,210616,6576036766,3,0,0,1536,3,4044183
8005,6575897716,397285,6576295001,5,0,1,13824,5,7859646590
8006,6575948709,269734,6576218443,5,0,0,441856,5,3701534745
8007,6575975458,245891,6576221349,3,0,0,4608,3,8326682240
8008,6576021181,226704,6576247885,4,0,0,94208,4,6524361112
8009,6576106298,188551,6576294849,7,0,1,3584,7,8346843875
8010,6576227502,104204,6576331706,2,0,0,169472,2,4524574068
8011,6576234381,2942,6576237323,9,0,1,10752,9,7118682156
8012,6576392548,205679,6576598227,3,0,0,3072,3,7866472095
8013,6576521606,3894,6576525500,4,0,1,20480,4,6403335784
8014,6576580124,93854,6576673978,3,0,0,4096,3,6104826859
8015,6576606379,82567,6576688946,3,0,1,1536,3,6902216964
8016,6576740542,1990,6576742532,3,0,0,2048,3,3570898460
8017,6576869837,2466,6576872303,0,0,0,2560,0,10293446785
8018,6576922161,280144,6577202305,0,0,1,296960,0,9554401079
8019,6576952244,253192,6577205436,4,0,1,10240,4,155170934
8020,6577176918,30500,6577207418,3,0,0,2048,3,6809997439
8021,6577253353,69280,6577322633,8,0,1,8192,8,3825075649
8022,6577372053,175508,6577547561,5,0,0,288256,5,4811920367
8023,6577401718,107095,6577508813,3,0,1,18944,3,6339623052
8024,6577410646,101807,6577512453,0,0,1,51200,0,9674881419
8025,6577439850,94032,6577533882,6,0,1,5632,6,10191743263
8026,6577441132,13596,6577454728,1,0,0,1024,1,4005024586
8027,6577446766,179885,6577626651,5,0,0,512,5,3001168762
8028,6577454797,237433,6577692230,5,0,0,9216,5,8080764098
8029,6577522392,178655,6577701047,6,0,1,3072,6,2970197629
8030,6577575950,307795,6577883745,2,0,0,23040,2,8988976799
8031,6577646276,91947,6577738223,9,0,1,4096,9,9166562184
8032,6577651561,115426,6577766987,5,0,1,51712,5,9388881588
8033,6577702091,132240,6577834331,8,0,1,18432,8,9516375247
8034,6577705201,237644,6577942845,7,0,0,363520,7,9997065316
8035,6577740589,223966,6577964555,4,0,0,71168,4,6533441531
8036,6577759687,208734,6577968421,3,0,0,6144,3,6909984584
8037,6577832914,138733,6577971647,0,0,0,5120,0,6267524001
8038,6577869387,105968,6577975355,1,0,1,1024,1,4917402006
8039,6577944628,26475,6577971103,6,0,1,512,6,2343305758
8040,6578014589,105150,6578119739,2,0,0,48128,2,1327134154
8041,6578086503,277012,6578363515,6,0,0,174592,6,439341364
8042,6578199711,319842,6578519553,9,0,0,522752,9,7826602572
8043,6578204188,316031,6578520219,1,0,0,1024,1,5030135915
8044,6578300595,3418,6578304013,9,0,1,2560,9,6252123615
8045,6578330760,265470,6578596230,3,0,1,21504,3,3294956326
8046,6578533864,328966,6578862830,3,0,0,3584,3,4180400673
8047,6578564035,137592,6578701627,6,0,0,227840,6,8053701533
8048,6578576666,48813,6578625479,3,0,1,36864,3,2482309358
8049,6578664668,1990,6578666658,4,0,0,48640,4,5723984502
8050,6578830107,285862,6579115969,7,0,1,9216,7,8329341004
8051,6578842252,1990,6578844242,5,0,0,2048,5,10236042186
8052,6578871233,21912,6578893145,1,0,0,2048,1,8936799721
8053,6578928627,18584,6578947211,1,0,1,512,1,2136240167
8054,6578933131,135452,6579068583,4,0,0,35840,4,9170669367
8055,6578938047,43900,6578981947,3,0,0,15872,3,2045170895
8056,6578973949,2942,6578976891,0,0,1,108544,0,10448893788
8057,6579031555,5798,6579037353,1,0,0,3072,1,3760732055
8058,6579114588,292559,6579407147,3,0,0,6144,3,6010846075
8059,6579124260,147717,6579271977,4,0,0,244224,4,934223768
8060,6579140174,36227,6579176401,7,0,1,8192,7,4018800035
8061,6579254423,166085,6579420508,7,0,0,43520,7,3224161278
8062,6579335312,30487,6579365799,7,0,1,30720,7,873001709
8063,6579347129,194748,6579541877,4,0,1,11776,4,4055661134
8064,6579363316,3418,6579366734,7,0,0,49152,7,1580953287
8065,6579565975,293221,6579859196,1,0,0,3584,1,8746953595
8066,6579727839,2942,6579730781,3,0,0,3072,3,2086872683
8067,6579746804,32554,6579779358,8,0,1,11776,8,2829269356
8068,6579798057,118656,6579916713,8,0,0,53248,8,7198314791
8069,6580155336,57436,6580212772,7,0,1,4608,7,1301219028
8070,6580245286,562,6580245848,9,0,1,43520,9,8057319561
8071,6580251912,104620,6580356532,3,0,0,512,3,5472213763
8072,6580369895,118504,6580488399,5,0,1,89088,5,688311130
8073,6580397487,95541,6580493028,9,0,0,159232,9,7657176188
8074,6580411919,198993,6580610912,1,0,1,12800,1,7337772111
8075,6580520347,104721,6580625068,2,0,1,29184,2,5354677922
8076,6580584174,58965,6580643139,6,0,0,170496,6,6750235620
8077,6580656261,262476,6580918737,2,0,0,93184,2,2495124071
8078,6580750210,99784,6580849994,5,0,1,512,5,247570713
8079,6580752480,108184,6580860664,3,0,1,43520,3,987059962
8080,6580754051,130196,6580884247,0,0,1,45056,0,5502970248
8081,6580761216,145612,6580906828,9,0,1,27648,9,3691705642
8082,6580772055,142635,6580914690,2,0,1,54272,2,7343691633
8083,6580800155,152158,6580952313,3,0,1,10240,3,1774159857
8084,6580831159,243005,6581074164,9,0,1,37376,9,8079802165
8085,6580854354,155152,6581009506,8,0,1,30208,8,3747211953
8086,6580863064,235705,6581098769,4,0,1,4608,4,10730863528
8087,6581033184,1038,6581034222,2,0,1,11264,2,4496098071
8088,6581060059,68680,6581128739,8,0,1,41472,8,7797245539
8089,6581094964,122007,6581216971,0,0,0,1024,0,1412593166
8090,6581182010,69952,6581251962,5,0,1,10240,5,3621633487
8091,6581238306,102592,6581340898,6,0,1,36864,6,6180313484
8092,6581328546,1990,6581330536,2,0,1,9216,2,768333682
8093,6581366208,66520,6581432728,0,0,0,2048,0,6794686211
8094,6581390512,100720,6581491232,1,0,1,30720,1,8844682529
8095,6581509182,78232,6581587414,9,0,1,17408,9,9612866856
8096,6581535323,86248,6581621571,0,0,1,23552,0,1586375048
8097,6581688254,112262,6581800516,6,0,0,181760,6,4379178694
8098,6581716731,158100,6581874831,0,0,1,322560,0,507849232
8099,6581726197,382205,6582108402,4,0,1,34304,4,6389968431
8100,6581802588,209067,6582011655,9,0,0,261120,9,4171258814
8101,6581867602,386809,6582254411,3,0,1,2560,3,9763053745
8102,6581893476,261787,6582155263,4,0,1,11776,4,1932802177
8103,6582012827,120783,6582133610,6,0,0,33280,6,8703410740
8104,6582090302,129759,6582220061,6,0,1,30720,6,327949386
8105,6582136912,86592,6582223504,2,0,1,11264,2,2798299635
8106,6582166986,83437,6582250423,2,0,0,135680,2,752858725
8107,6582229240,61895,6582291135,4,0,0,100352,4,2625669546
8108,6582321826,2466,6582324292,0,0,0,2560,0,1061169498
8109,6582330107,4370,6582334477,4,0,0,4608,4,5955719692
8110,6582351517,1990,6582353507,0,0,0,2048,0,6628771279
8111,6582419971,2942,6582422913,3,0,0,3072,3,10458841432
8112,6582617606,64650,6582682256,8,0,0,109056,8,7086134780
8113,6582670293,52029,6582722322,8,0,0,84480,8,2965068995
8114,6582708531,13854,6582722385,8,0,1,14848,8,10402622321
8115,6582835940,190199,6583026139,2,0,0,23552,2,9756814553
8116,6582887475,41645,6582929120,8,0,0,67584,8,4484122662
8117,6582922802,63874,6582986676,4,0,0,107520,4,5127852258
8118,6582932936,101798,6583034734,2,0,1,7680,2,5556263363
8119,6582988885,54783,6583043668,7,0,1,2560,7,814351197
8120,6583092394,165812,6583258206,6,0,0,93184,6,3705025427
8121,6583140741,83042,6583223783,3,0,1,11776,3,9256586807
8122,6583221134,3220,6583224354,1,0,0,512,1,2843420894
8123,6583223552,25442,6583248994,8,0,1,11776,8,8622378966
8124,6583229492,72156,6583301648,4,0,1,2560,4,478583608
8125,6583237007,91483,6583328490,6,0,0,46080,6,3730329740
8126,6583283285,53062,6583336347,2,0,0,86528,2,1163009430
8127,6583310833,20742,6583331575,8,0,1,3584,8,6241557585
8128,6583318511,11012,6583329523,5,0,0,4608,5,1972755304
8129,6583344428,54052,6583398480,7,0,0,17920,7,1201902852
8130,6583445068,107740,6583552808,6,0,1,1024,6,7190000792
8131,6583467543,248589,6583716132,1,0,1,53760,1,6397672557
8132,6583499440,303284,6583802724,0,0,1,231424,0,9495063030
8133,6583535877,321154,6583857031,0,0,1,179712,0,5919493048
8134,6583555666,235360,6583791026,6,0,1,49152,6,783288439
8135,6583560911,115477,6583676388,2,0,1,23552,2,3977280121
8136,6583624802,308485,6583933287,7,0,1,10240,7,956569107
8137,6583746724,329511,6584076235,1,0,1,6656,1,3851634979
8138,6583786609,125526,6583912135,9,0,1,25600,9,6880652427
8139,6583832619,111340,6583943959,8,0,0,121856,8,2534207791
8140,6583977247,63874,6584041121,4,0,0,107520,4,768005103
8141,6584067530,72020,6584139550,9,0,0,116736,9,3446544094
8142,6584077326,131635,6584208961,6,0,1,7168,6,6381251891
8143,6584106897,16609,6584123506,1,0,1,8704,1,5951315331
8144,6584290774,2466,6584293240,2,0,0,32256,2,10523459556
8145,6584307632,6274,6584313906,5,0,0,2560,5,2195420703
8146,6584319255,262797,6584582052,6,0,1,20992,6,2441673420
8147,6584331301,562,6584331863,1,0,0,6656,1,8947119812
8148,6584459422,161863,6584621285,0,0,0,512,0,1072295670
8149,6584519865,103858,6584623723,9,0,0,172032,9,4198046358
8150,6584557243,562,6584557805,5,0,1,19968,5,3497717893
8151,6584571260,562,6584571822,2,0,1,10752,2,8625861214
8152,6584609815,15317,6584625132,9,0,1,6144,9,10124536565
8153,6584624376,128348,6584752724,5,0,1,4096,5,5219789629
8154,6584633215,97362,6584730577,5,0,1,4608,5,4257421522
8155,6584638193,182332,6584820525,0,0,0,512,0,6755125574
8156,6584664500,72279,6584736779,3,0,0,512,3,8534928594
8157,6584675108,30524,6584705632,8,0,0,29696,8,8443379931
8158,6584686296,75808,6584762104,9,0,0,117248,9,6983847067
8159,6584733850,236642,6584970492,7,0,0,19456,7,4102591768
8160,6584755436,1514,6584756950,2,0,0,127488,2,5471905844
8161,6584854206,263290,6585117496,1,0,0,1536,1,3955086147
8162,6584883845,4675,6584888520,9,0,1,14848,9,7664864451
8163,6584927991,167685,6585095676,0,0,1,224768,0,1391003804
8164,6584964877,31779,6584996656,2,0,0,12288,2,3359187452
8165,6585104401,306061,6585410462,6,0,0,51712,6,849221569
8166,6585219054,47284,6585266338,9,0,1,20992,9,2457547080
8167,6585245417,101753,6585347170,6,0,1,1536,6,9872618118
8168,6585251162,110860,6585362022,9,0,1,64000,9,9935294158
8169,6585286976,102064,6585389040,3,0,1,20480,3,6247714228
8170,6585289118,215062,6585504180,6,0,0,348672,6,244308625
8171,6585289832,165886,6585455718,3,0,1,2048,3,643348231
8172,6585341840,138028,6585479868,5,0,0,5632,5,6785090045
8173,6585370364,78133,6585448497,0,0,0,1024,0,7252612007
8174,6585431245,253613,6585684858,5,0,0,1536,5,971137012
8175,6585440582,3418,6585444000,3,0,1,23040,3,4196509241
8176,6585551451,225081,6585776532,1,0,0,3584,1,3684519136
8177,6585626287,59709,6585685996,6,0,1,4608,6,7051603374
8178,6585703173,89476,6585792649,4,0,1,24064,4,2325695434
8179,6585754069,38591,6585792660,9,0,0,54272,9,5982092553
8180,6585765480,81031,6585846511,8,0,1,3584,8,7536809353
8181,6585816077,113239,6585929316,9,0,1,23552,9,3182017360
8182,6585876107,93304,6585969411,7,0,0,151552,7,7636776712
8183,6585887005,104462,6585991467,1,0,1,12800,1,3663532786
8184,6585932687,181956,6586114643,4,0,1,9728,4,7450136083
8185,6585938487,151040,6586089527,8,0,0,169984,8,6624911227
8186,6586143482,20620,6586164102,8,0,0,33280,8,3639391359
8187,6586171061,99004,6586270065,2,0,1,31232,2,915338375
8188,6586195233,85169,6586280402,2,0,1,25088,2,3504952127
8189,6586209079,31779,6586240858,4,0,0,135680,4,10581722982
8190,6586225312,95541,6586320853,6,0,1,43008,6,8328142342
8191,6586313696,293850,6586607546,6,0,0,51712,6,5905221056
8192,6586344753,301897,6586646650,6,0,0,159232,6,3402124496
8193,6586390773,301088,6586691861,0,0,1,122880,0,8127129177
8194,6586539218,319067,6586858285,9,0,0,521216,9,1410918755
8195,6586624066,235525,6586859591,0,0,0,2048,0,4436170494
8196,6586694634,190981,6586885615,9,0,0,91648,9,7019127679
8197,6586779324,107277,6586886601,3,0,0,1536,3,2012120957
8198,6586787171,108960,6586896131,1,0,1,13312,1,670761568
8199,6586788778,4846,6586793624,4,0,0,36864,4,5902266312
8200,6586866349,192333,6587058682,9,0,1,9728,9,5742151375
8201,6586901949,198647,6587100596,5,0,0,5120,5,7599604191
8202,6586913972,206308,6587120280,3,0,1,34816,3,2188674071
8203,6586924246,198385,6587122631,6,0,1,7680,6,849684450
8204,6587041154,91753,6587132907,8,0,0,148480,8,395913498
8205,6587050856,123371,6587174227,9,0,0,132096,9,4022741368
8206,6587115290,64429,6587179719,5,0,0,17920,5,5803871333
8207,6587260203,4416,6587264619,0,0,0,11776,0,534843844
8208,6587323535,97092,6587420627,7,0,0,162304,7,152441119
8209,6587348640,72653,6587421293,5,0,0,1024,5,9997368435
8210,6587442000,16092,6587458092,2,0,0,31232,2,1050171633
8211,6587459668,123784,6587583452,5,0,1,1536,5,9385871792
8212,6587523456,5798,6587529254,2,0,1,8192,2,5794633560
8213,6587562868,47284,6587610152,2,0,1,1536,2,7358031224
8214,6587591914,172776,6587764690,5,0,0,6144,5,9141593686
8215,6587668284,110497,6587778781,0,0,1,28672,0,7367771331
8216,6587788059,2466,6587790525,0,0,1,218112,0,5716243395
8217,6587796397,206968,6588003365,3,0,0,2560,3,10448478363
8218,6587874530,120508,6587995038,6,0,0,128000,6,1422658687
8219,6587974818,21250,6587996068,1,0,0,1024,1,8901623502
8220,6588003570,76828,6588080398,1,0,1,12800,1,4040219129
8221,6588005057,145881,6588150938,8,0,0,541184,8,6630485743
8222,6588026402,128703,6588155105,4,0,0,75776,4,9108337233
8223,6588055957,334495,6588390452,3,0,1,14336,3,3242249330
8224,6588073183,334143,6588407326,8,0,1,2048,8,4579373952
8225,6588121149,301351,6588422500,4,0,0,198144,4,2712262168
8226,6588130398,293728,6588424126,5,0,0,2560,5,10578450540
8227,6588133672,237806,6588371478,4,0,1,17920,4,5376238168
8228,6588197662,1990,6588199652,8,0,0,46080,8,3473137099
8229,6588198630,445482,6588644112,3,0,1,30208,3,8486199532
8230,6588286969,8360,6588295329,5,0,1,5120,5,8356131194
8231,6588340531,131697,6588472228,2,0,1,27136,2,5215751264
8232,6588441857,291872,6588733729,4,0,1,9216,4,2966619193
8233,6588485616,291824,6588777440,3,0,0,2048,3,7003231158
8234,6588499345,477606,6588976951,0,0,0,6656,0,5765466907
8235,6588719425,1038,6588720463,1,0,1,11264,1,9283561674
8236,6588760492,73288,6588833780,3,0,1,3584,3,6576959164
8237,6588781520,59407,6588840927,3,0,0,1024,3,716181835
8238,6588835429,60282,6588895711,4,0,1,8192,4,9369398035
8239,6588899333,2866,6588902199,0,0,0,8704,0,8244215915
8240,6588905172,1990,6588907162,0,0,1,11264,0,9076847989
8241,6588956177,79686,6589035863,1,0,0,2048,1,8402178295
8242,6588989005,94205,6589083210,6,0,0,534528,6,3299183343
8243,6589070499,209174,6589279673,5,0,1,22016,5,8624931253
8244,6589092681,327641,6589420322,9,0,1,8704,9,7145945727
8245,6589106035,233273,6589339308,9,0,1,8192,9,5525318902
8246,6589114223,215860,6589330083,2,0,0,98304,2,2155039928
8247,6589131982,257615,6589389597,5,0,0,512,5,2431937717
8248,6589146491,359304,6589505795,1,0,1,5120,1,8429061389
8249,6589192819,1514,6589194333,0,0,1,66048,0,5600608335
8250,6589266173,320204,6589586377,2,0,1,22528,2,5492939050
8251,6589325633,124248,6589449881,3,0,1,30720,3,5308363895
8252,6589390970,255920,6589646890,8,0,1,7168,8,9472790794
8253,6589444159,66717,6589510876,3,0,0,1536,3,2066327114
8254,6589483648,257904,6589741552,4,0,0,113152,4,7176693919
8255,6589489142,77041,6589566183,8,0,1,38912,8,5534762063
8256,6589506507,166353,6589672860,8,0,0,92160,8,2078550195
8257,6589679983,113983,6589793966,7,0,0,188416,7,5223433984
8258,6589745024,91389,6589836413,2,0,0,137728,2,9022913233
8259,6589760456,29118,6589789574,2,0,1,7168,2,3741689905
8260,6589812441,39856,6589852297,4,0,0,8192,4,3472068594
8261,6589812635,85933,6589898568,2,0,0,35840,2,10033792710
8262,6589877653,244047,6590121700,7,0,0,143872,7,10366507496
8263,6589898531,311925,6590210456,9,0,1,20480,9,10483350252
8264,6590204341,111819,6590316160,2,0,1,47104,2,10281649164
8265,6590348526,4158,6590352684,1,0,0,11264,1,273101741
8266,6590503561,23633,6590527194,6,0,0,42496,6,2705347248
8267,6590507418,20762,6590528180,0,0,0,1536,0,10000896078
8268,6590517320,40870,6590558190,4,0,0,66048,4,9864682142
8269,6590570893,99398,6590670291,6,0,1,20992,6,10032678025
8270,6590632094,75903,6590707997,5,0,1,11776,5,5394476597
8271,6590757871,5708,6590763579,6,0,1,14336,6,5969814509
8272,6590791221,72688,6590863909,6,0,0,14336,6,3733776443
8273,6590844099,61288,6590905387,3,0,1,17408,3,9035501422
8274,6590850082,79976,6590930058,1,0,1,85504,1,4218285041
8275,6590857472,5450,6590862922,6,0,1,7168,6,951071005
8276,6590931473,191278,6591122751,2,0,1,33280,2,3730446382
8277,6590985837,143127,6591128964,3,0,0,13824,3,3614550796
8278,6591085140,64516,6591149656,5,0,1,7680,5,73749683
8279,6591178283,289725,6591468008,7,0,0,474112,7,6139283240
8280,6591282857,188377,6591471234,0,0,0,5120,0,1601161106
8281,6591362540,135332,6591497872,6,0,0,86528,6,8979388871
8282,6591434617,4675,6591439292,6,0,1,47616,6,5016134501
8283,6591493784,194453,6591688237,9,0,1,1024,9,3085234271
8284,6591532506,105218,6591637724,7,0,0,12288,7,2155237407
8285,6591536722,342358,6591879080,3,0,0,409088,3,6933410856
8286,6591548129,249484,6591797613,1,0,1,10240,1,2535680979
8287,6591606399,203459,6591809858,9,0,1,6144,9,3676560024
8288,6591614313,207573,6591821886,4,0,0,101888,4,8338388149
8289,6591641607,244706,6591886313,2,0,1,3072,2,7339067165
8290,6591651622,180694,6591832316,8,0,0,132608,8,9783247708
8291,6591657238,91009,6591748247,9,0,1,31232,9,10118072756
8292,6591720129,301198,6592021327,6,0,0,133632,6,4653855894
8293,6591811440,49686,6591861126,0,0,0,2560,0,9886828068
8294,6591813583,164041,6591977624,3,0,1,47104,3,7740638004
8295,6591835926,508984,6592344910,7,0,1,10752,7,7173863669
8296,6591873961,288428,6592162389,6,0,0,76800,6,5633450894
8297,6592029491,81370,6592110861,7,0,0,131584,7,9890940662
8298,6592072520,167381,6592239901,6,0,1,54272,6,6622480695
8299,6592211566,33587,6592245153,4,0,0,55296,4,10129696669
8300,6592280829,3894,6592284723,9,0,1,32256,9,1183373778
8301,6592286396,562,6592286958,4,0,1,20992,4,3510511051
8302,6592288232,134676,6592422908,1,0,0,4096,1,9312509616
8303,6592365607,135516,6592501123,0,0,0,512,0,9535283813
8304,6592514809,32812,6592547621,6,0,1,20992,6,8249132871
8305,6592545392,80860,6592626252,8,0,0,53760,8,6477633181
8306,6592569466,70972,6592640438,9,0,1,8704,9,2063328582
8307,6592600961,192745,6592793706,7,0,0,311808,7,5919604417
8308,6592802683,24238,6592826921,3,0,0,40448,3,1615443527
8309,6592854978,4846,6592859824,9,0,0,5120,9,2155658119
8310,6592953822,74380,6593028202,2,0,1,4096,2,2453626701
8311,6593011334,157528,6593168862,9,0,1,14848,9,6805227026
8312,6593123043,165212,6593288255,7,0,0,268288,7,1969059610
8313,6593179530,43366,6593222896,0,0,1,117248,0,1254209283
8314,6593185757,175080,6593360837,1,0,1,13312,1,7109976342
8315,6593186038,301862,6593487900,7,0,1,24576,7,9715834003
8316,6593286324,302853,6593589177,3,0,0,74240,3,5739218919
8317,6593294020,353006,6593647026,2,0,0,551424,2,9849992637
8318,6593358328,251727,6593610055,6,0,1,2560,6,74386838
8319,6593395645,238026,6593633671,5,0,0,512,5,5133736886
8320,6593436087,122770,6593558857,3,0,0,95232,3,5436830484
8321,6593555849,190592,6593746441,5,0,0,7168,5,8893049437
8322,6593556344,112882,6593669226,2,0,0,220672,2,6226677120
8323,6593595439,183364,6593778803,2,0,1,5632,2,7295702958
8324,6593644393,73649,6593718042,0,0,1,134656,0,5782142081
8325,6593649812,435531,6594085343,2,0,0,58880,2,10631489941
8326,6593714966,84670,6593799636,6,0,0,91136,6,2795556497
8327,6593725041,135008,6593860049,3,0,0,68096,3,3692946454
8328,6593821558,24238,6593845796,8,0,0,222720,8,8111721912
8329,6593915904,448406,6594364310,2,0,1,13312,2,271893793
8330,6594012077,115491,6594127568,3,0,0,40448,3,660641541
8331,6594012646,304796,6594317442,9,0,0,168448,9,5456043014
8332,6594049900,1038,6594050938,9,0,1,120832,9,1930523625
8333,6594219439,1990,6594221429,7,0,1,35328,7,9264274156
8334,6594256477,333306,6594589783,8,0,1,42496,8,449997839
8335,6594256554,205964,6594462518,0,0,0,1024,0,615459707
8336,6594329754,273498,6594603252,5,0,0,2048,5,5733513268
8337,6594459885,87484,6594547369,9,0,0,146944,9,7496312367
8338,6594514676,51292,6594565968,5,0,1,4608,5,5780887001
8339,6594528239,83615,6594611854,6,0,0,132608,6,7809857395
8340,6594620022,4933,6594624955,2,0,0,12800,2,8828538648
8341,6594667160,7702,6594674862,5,0,0,8192,5,9280281439
8342,6594714521,20878,6594735399,7,0,1,26624,7,9572702222
8343,6594778384,323152,6595101536,8,0,0,33792,8,5803157019
8344,6594883266,155346,6595038612,5,0,1,1536,5,8016942128
8345,6594892806,19504,6594912310,9,0,0,252416,9,9249800561
8346,6595029314,562,6595029876,5,0,0,1024,5,8219017934
8347,6595053634,253811,6595307445,2,0,1,14336,2,2511854168
8348,6595083701,166279,6595249980,1,0,0,512,1,190349904
8349,6595305993,53140,6595359133,8,0,1,5632,8,5937024792
8350,6595306589,66458,6595373047,6,0,0,112640,6,6353933929
8351,6595309581,68612,6595378193,6,0,0,8192,6,2178307698
8352,6595310360,270970,6595581330,0,0,1,165376,0,4068959968
8353,6595334324,178448,6595512772,8,0,0,446464,8,267659953
8354,6595369747,284734,6595654481,2,0,1,2048,2,1161256859
8355,6595384191,218578,6595602769,3,0,1,1024,3,7315440732
8356,6595410798,264372,6595675170,6,0,0,40960,6,230924594
8357,6595421251,316939,6595738190,8,0,1,38912,8,5216187197
8358,6595429424,143670,6595573094,8,0,1,1024,8,8829855800
8359,6595609825,412578,6596022403,9,0,0,232960,9,5007166584
8360,6595768439,13508,6595781947,0,0,1,22528,0,6043871365
8361,6595811395,75550,6595886945,7,0,1,24064,7,10047524686
8362,6595844213,11452,6595855665,4,0,0,26112,4,6710869070
8363,6595857611,182138,6596039749,7,0,0,126976,7,8345701649
8364,6595922055,231969,6596154024,3,0,0,512,3,3289224685
8365,6596046676,4933,6596051609,4,0,0,12800,4,3747117904
8366,6596084386,121250,6596205636,5,0,1,13312,5,1055767940
8367,6596139711,74087,6596213798,9,0,0,120832,9,9637716093
8368,6596243826,35825,6596279651,7,0,0,62976,7,8235930440
8369,6596366159,33241,6596399400,0,0,1,235008,0,3209589880
8370,6596395567,60862,6596456429,9,0,1,389120,9,6108135554
8371,6596415509,60543,6596476052,3,0,0,57856,3,5323071635
8372,6596447410,49932,6596497342,9,0,1,159232,9,2221368953
8373,6596492067,56655,6596548722,0,0,1,698880,0,10247777875
8374,6596565834,21561,6596587395,8,0,1,2048,8,2681654218
8375,6596596032,1990,6596598022,7,0,0,98304,7,10592066307
8376,6596597017,462307,6597059324,1,0,0,11264,1,3742618305
8377,6596623283,360522,6596983805,6,0,0,58368,6,10099774762
8378,6596637553,166416,6596803969,7,0,0,75776,7,5297712113
8379,6596675873,105018,6596780891,1,0,0,5120,1,5824999441
8380,6596698041,562,6596698603,1,0,0,2048,1,5941408654
8381,6596737982,736961,6597474943,5,0,1,68096,5,5141751854
8382,6596779634,848779,6597628413,0,0,1,15872,0,3733144237
8383,6596781536,76791,6596858327,9,0,0,273920,9,4173595146
8384,6596845200,76432,6596921632,5,0,0,3584,5,8149903849
8385,6596943255,278752,6597222007,0,0,1,23040,0,1788320755
8386,6596992976,447220,6597440196,0,0,0,512,0,5005870441
8387,6597058698,511250,6597569948,3,0,1,11264,3,6403130502
8388,6597074531,91125,6597165656,1,0,1,40960,1,8595554403
8389,6597116512,184191,6597300703,1,0,1,3072,1,9472059954
8390,6597125960,97751,6597223711,7,0,1,3584,7,6318239298
8391,6597138158,200045,6597338203,0,0,0,8192,0,4354590382
8392,6597138528,250999,6597389527,1,0,0,512,1,224801112
8393,6597158634,1102808,6598261442,2,0,0,37888,2,8580488569
8394,6597161682,532835,6597694517,2,0,1,14336,2,3631590703
8395,6597224923,277646,6597502569,7,0,0,122880,7,2910225644
8396,6597279527,328673,6597608200,7,0,1,2560,7,1049371694
8397,6597329731,552945,6597882676,3,0,0,147968,3,2177608507
8398,6597442505,203502,6597646007,6,0,0,403456,6,472562933
8399,6597467222,394380,6597861602,7,0,0,300032,7,6808309238
8400,6597469794,421680,6597891474,0,0,1,29696,0,7608840040
8401,6597498391,484516,6597982907,4,0,1,14848,4,4789827898
8402,6597591366,361358,6597952724,1,0,0,1536,1,6289705363
8403,6597665649,360422,6598026071,9,0,0,244736,9,8559612035
8404,6597685303,290597,6597975900,9,0,1,288256,9,9489648691
8405,6597734049,289314,6598023363,4,0,1,24576,4,862354021
8406,6597736460,228438,6597964898,5,0,0,1536,5,6380325116
8407,6597771925,100009,6597871934,6,0,1,77824,6,4655253457
8408,6597774647,444992,6598219639,9,0,0,127488,9,9003276419
8409,6597783382,511130,6598294512,1,0,1,66560,1,3163715794
8410,6597838109,699417,6598537526,5,0,0,4096,5,141192784
8411,6597971927,398825,6598370752,3,0,0,17408,3,7474060376
8412,6597985914,339412,6598325326,3,0,0,549376,3,9723865723
8413,6598008445,287773,6598296218,0,0,1,619008,0,9014035914
8414,6598045338,636559,6598681897,0,0,0,1536,0,8984370813
8415,6598091571,342773,6598434344,8,0,1,35840,8,9413413661
8416,6598096988,284485,6598381473,6,0,0,28672,6,8645387388
8417,6598153971,302849,6598456820,7,0,0,347648,7,9099514748
8418,6598172614,26932,6598199546,6,0,0,119808,6,5716042974
8419,6598313415,35308,6598348723,2,0,1,47616,2,6730585225
8420,6598449504,12639,6598462143,8,0,0,12800,8,294864976
8421,6598477876,142378,6598620254,1,0,0,61952,1,8573572363
8422,6598502491,124262,6598626753,9,0,0,3072,9,7163889648
8423,6598549910,114817,6598664727,8,0,0,230400,8,6153381662
8424,6598565016,1004697,6599569713,6,0,1,17408,6,8772011384
8425,6598569332,453441,6599022773,5,0,0,2048,5,6327514235
8426,6598580197,719561,6599299758,4,0,1,38912,4,2920369498
8427,6598594535,437304,6599031839,9,0,0,50688,9,2409640787
8428,6598595691,424123,6599019814,9,0,0,371712,9,9592816549
8429,6598608883,254391,6598863274,7,0,0,119808,7,4998217708
8430,6598616633,416879,6599033512,5,0,1,1536,5,3722868802
8431,6598667415,99762,6598767177,7,0,1,29696,7,5676038810
8432,6598727601,500733,6599228334,5,0,1,26624,5,7711516943
8433,6598778626,470577,6599249203,7,0,0,8192,7,5532945815
8434,6598860681,578310,6599438991,5,0,1,18944,5,2098103356
8435,6598936600,382357,6599318957,8,0,0,8704,8,6990795332
8436,6598993458,431767,6599425225,4,0,1,27648,4,3307311093
8437,6599025555,1514,6599027069,0,0,1,171520,0,6361965377
8438,6599284279,167937,6599452216,0,0,1,35328,0,1507175838
8439,6599377091,562,6599377653,1,0,1,40448,1,6517089242
8440,6599433544,685836,6600119380,0,0,0,1536,0,4317682377
8441,6599474419,31003,6599505422,0,0,0,512,0,8479019559
8442,6599483354,305091,6599788445,5,0,1,19968,5,3851260543
8443,6599485970,115750,6599601720,3,0,1,38400,3,624864436
8444,6599583842,11012,6599594854,7,0,1,13312,7,6721667182
8445,6599627722,231820,6599859542,2,0,0,50176,2,6504082856
8446,6599692581,265398,6599957979,2,0,0,17920,2,120516073
8447,6599788830,2466,6599791296,9,0,1,241664,9,5957675563
8448,6599814845,15058,6599829903,5,0,0,2560,5,6689754170
8449,6599869197,5322,6599874519,4,0,0,29184,4,9458429266
8450,6599901466,50995,6599952461,7,0,0,5632,7,10455939210
8451,6599937214,25730,6599962944,6,0,1,32256,6,4478913150
8452,6599937608,400149,6600337757,9,0,0,82432,9,532835071
8453,6599963219,94809,6600058028,5,0,0,512,5,8597870865
8454,6600094197,153613,6600247810,6,0,0,82944,6,8043176362
8455,6600128453,360205,6600488658,3,0,0,151040,3,2990259028
8456,6600130563,167056,6600297619,3,0,0,49664,3,1663115299
8457,6600159516,207740,6600367256,9,0,0,194560,9,6485446265
8458,6600341317,26285,6600367602,0,0,0,512,0,6145011144
8459,6600356686,64391,6600421077,1,0,0,108544,1,3993978252
8460,6600497918,44488,6600542406,7,0,1,4608,7,2217719021
8461,6600552444,171020,6600723464,5,0,1,3072,5,8361384802
8462,6600562220,5798,6600568018,4,0,1,54272,4,7136558949
8463,6600563724,170128,6600733852,4,0,0,73216,4,2656320778
8464,6600702713,157866,6600860579,9,0,1,65536,9,8797530956
8465,6600704439,322669,6601027108,5,0,0,6144,5,1453143368
8466,6600772329,122555,6600894884,7,0,1,32768,7,4046778907
8467,6600828166,130343,6600958509,3,0,1,42496,3,4211880681
8468,6600857246,122646,6600979892,7,0,1,25600,7,6498080715
8469,6600992661,4846,6600997507,8,0,0,5120,8,4100316421
8470,6601089876,73411,6601163287,1,0,1,37376,1,6843795216
8471,6601098945,102748,6601201693,8,0,1,6144,8,7955065095
8472,6601141929,57904,6601199833,4,0,1,6144,4,10459427192
8473,6601155056,44788,6601199844,3,0,0,70656,3,8358867987
8474,6601179834,122645,6601302479,7,0,0,198656,7,8465093838
8475,6601191127,137683,6601328810,9,0,0,93184,9,5021217741
8476,6601212097,201880,6601413977,2,0,0,239104,2,3539972508
8477,6601291239,139008,6601430247,4,0,0,61440,4,4332212491
8478,6601340017,93045,6601433062,6,0,1,15872,6,6987359511
8479,6601401287,229077,6601630364,9,0,1,123904,9,3833075538
8480,6601468250,299678,6601767928,7,0,0,151040,7,2804842865
8481,6601522122,76097,6601598219,4,0,1,27648,4,10614880968
8482,6601625035,266571,6601891606,6,0,1,512,6,6915671461
8483,6601709887,12991,6601722878,3,0,1,10240,3,972463062
8484,6601779165,46644,6601825809,2,0,1,1024,2,7593678862
8485,6601806509,131018,6601937527,9,0,0,25088,9,6649449561
8486,6601838569,9554,6601848123,4,0,0,7680,4,8647867514
8487,6601850054,187700,6602037754,9,0,0,308736,9,130530075
8488,6601870264,194743,6602065007,9,0,0,89600,9,3560060824
8489,6601890118,138758,6602028876,9,0,1,625664,9,6455497491
8490,6601931961,182797,6602114758,3,0,1,3072,3,7607914651
8491,6601973317,110810,6602084127,3,0,0,151552,3,1526040951
8492,6601981376,38659,6602020035,3,0,0,175616,3,5177860518
8493,6601998380,52029,6602050409,4,0,1,77824,4,5478613619
8494,6602075175,44817,6602119992,3,0,0,71680,3,585078930
8495,6602148632,378576,6602527208,5,0,0,2048,5,3089016970
8496,6602225881,119570,6602345451,8,0,1,5632,8,264178577
8497,6602246421,788161,6603034582,3,0,0,84480,3,5315391932
8498,6602258779,703654,6602962433,5,0,0,8192,5,9986573408
8499,6602281803,194870,6602476673,0,0,1,582144,0,3103206309
8500,6602467310,204208,6602671518,0,0,1,1080320,0,8857162413
8501,6602489725,135174,6602624899,2,0,1,24064,2,4799295506
8502,6602510662,60265,6602570927,0,0,1,43008,0,2160246489
8503,6602512019,562,6602512581,5,0,0,5120,5,8357835851
8504,6602554436,687039,6603241475,8,0,0,93696,8,1374665548
8505,6602590384,183164,6602773548,3,0,1,13312,3,2787744320
8506,6602633890,184748,6602818638,8,0,0,33280,8,8940153328
8507,6602709055,182593,6602891648,1,0,0,9216,1,7500093127
8508,6602781014,189162,6602970176,0,0,0,512,0,489435276
8509,6602785729,522261,6603307990,2,0,0,181248,2,7116584825
8510,6602787153,878982,6603666135,0,0,0,3072,0,1007842046
8511,6602820114,517796,6603337910,6,0,0,53760,6,3050881047
8512,6602871200,1325025,6604196225,4,0,0,120832,4,2818336260
8513,6602872491,908890,6603781381,6,0,0,594944,6,5100109421
8514,6602883456,854298,6603737754,6,0,0,296448,6,9069228753
8515,6602938059,799629,6603737688,0,0,0,512,0,9278691482
8516,6602992739,691763,6603684502,7,0,0,46080,7,6169204198
8517,6603100616,588056,6603688672,5,0,0,6144,5,8301676675
8518,6603204350,1294859,6604499209,5,0,0,2560,5,1857323913
8519,6603246045,559487,6603805532,7,0,0,182272,7,5393542701
8520,6603327247,478304,6603805551,1,0,0,32256,1,1078633980
8521,6603450794,354768,6603805562,2,0,0,157184,2,8926931269
8522,6603494151,661856,6604156007,2,0,0,572416,2,8296047295
8523,6603494979,661284,6604156263,5,0,0,9216,5,8804904409
8524,6603563678,598282,6604161960,1,0,0,18944,1,5309230754
8525,6603817154,348672,6604165826,8,0,0,6144,8,1991915691
8526,6603902269,279724,6604181993,2,0,0,52736,2,7140043102
8527,6604014829,168752,6604183581,0,0,0,15872,0,7874724605
8528,6604022356,246308,6604268664,2,0,1,16896,2,8516411796
8529,6604025098,302382,6604327480,3,0,0,289280,3,5916988658
8530,6604147285,135354,6604282639,0,0,1,330240,0,6566558338
8531,6604223036,647553,6604870589,0,0,0,220160,0,9772785253
8532,6604354309,440540,6604794849,9,0,0,585728,9,1518867730
8533,6604365718,26494,6604392212,1,0,1,30208,1,7886403776
8534,6604685518,10381,6604695899,9,0,1,624640,9,5198076951
8535,6604719177,495433,6605214610,0,0,1,104448,0,10403367683
8536,6604768951,71245,6604840196,5,0,0,512,5,9150146330
8537,6604786172,112779,6604898951,5,0,0,1536,5,2566931182
8538,6604837928,106442,6604944370,1,0,0,115200,1,714023211
8539,6604958118,97040,6605055158,7,0,1,30208,7,8694404501
8540,6604963234,85933,6605049167,2,0,0,182784,2,2346530555
8541,6605010619,575328,6605585947,5,0,1,10240,5,8570074351
8542,6605069960,180814,6605250774,8,0,0,177152,8,3120544549
8543,6605074439,305183,6605379622,6,0,1,17920,6,300149790
8544,6605080950,172590,6605253540,3,0,0,15872,3,2658563358
8545,6605093681,101499,6605195180,9,0,1,108544,9,7241275440
8546,6605176257,406335,6605582592,2,0,0,143872,2,33184548
8547,6605192623,1008144,6606200767,8,0,0,248320,8,6662289163
8548,6605222352,744783,6605967135,0,0,0,70144,0,9885188824
8549,6605293789,304403,6605598192,5,0,0,512,5,8175340309
8550,6605400381,231533,6605631914,4,0,1,6144,4,4695270631
8551,6605473262,644205,6606117467,6,0,0,176640,6,4558730867
8552,6605473471,64738,6605538209,8,0,1,17920,8,9480628184
8553,6605479506,482438,6605961944,2,0,1,5120,2,9931968718
8554,6605528492,524295,6606052787,2,0,1,62464,2,10338445010
8555,6605589967,36083,6605626050,9,0,1,611840,9,2436930497
8556,6605756372,5450,6605761822,6,0,1,14848,6,6220952836
8557,6605844543,574838,6606419381,3,0,0,105984,3,1341300936
8558,6605891830,457569,6606349399,3,0,1,7168,3,3230094334
8559,6605925002,299515,6606224517,3,0,1,12800,3,1931149121
8560,6605928963,406787,6606335750,7,0,1,24576,7,7978346589
8561,6605968416,924484,6606892900,8,0,0,63488,8,10616803810
8562,6606053446,593360,6606646806,6,0,0,13824,6,7706657842
8563,6606060226,454979,6606515205,9,0,0,728064,9,8670802695
8564,6606070290,465054,6606535344,8,0,1,22528,8,5316248216
8565,6606114005,447036,6606561041,9,0,0,173056,9,5750664389
8566,6606150694,446944,6606597638,7,0,0,117760,7,8569125291
8567,6606235458,363398,6606598856,3,0,1,18944,3,10618873902
8568,6606241236,383729,6606624965,5,0,1,1536,5,4599700225
8569,6606258521,365038,6606623559,9,0,0,82944,9,559067526
8570,6606281445,348732,6606630177,8,0,0,23552,8,505520145
8571,6606331885,298958,6606630843,1,0,0,1024,1,7603794085
8572,6606459114,180030,6606639144,4,0,1,4096,4,2873136586
8573,6606476939,142699,6606619638,7,0,0,83968,7,8437788218
8574,6606485950,98946,6606584896,5,0,1,75776,5,5154372017
8575,6606546656,25958,6606572614,0,0,0,105984,0,4794342574
8576,6606550163,289772,6606839935,8,0,1,4608,8,6579547595
8577,6606590973,290356,6606881329,1,0,0,10752,1,4808628524
8578,6606656305,393537,6607049842,8,0,1,1536,8,7695034517
8579,6606660273,207382,6606867655,0,0,1,44544,0,7152944863
8580,6606696575,121790,6606818365,3,0,0,47104,3,8890837207
8581,6606771063,144962,6606916025,0,0,1,55808,0,6561954739
8582,6606781830,32148,6606813978,4,0,1,3072,4,5714203302
8583,6606820326,331432,6607151758,3,0,0,235520,3,7893600928
8584,6606931354,392562,6607323916,9,0,1,275456,9,8136982042
8585,6606944072,1038,6606945110,2,0,0,35840,2,8624522735
8586,6607163523,572833,6607736356,1,0,1,8704,1,6997717240
8587,6607218598,208519,6607427117,5,0,1,47104,5,8576603138
8588,6607295835,343494,6607639329,9,0,1,512,9,1994461014
8589,6607350401,124217,6607474618,5,0,0,1024,5,5757667230
8590,6607397372,334988,6607732360,4,0,1,5120,4,8266760442
8591,6607414119,562,6607414681,5,0,1,54272,5,6969441555
8592,6607493798,94273,6607588071,8,0,1,6656,8,4326540628
8593,6607571043,190803,6607761846,2,0,1,9728,2,7138175308
8594,6607571274,88575,6607659849,5,0,0,512,5,4870514263
8595,6607611063,315230,6607926293,0,0,1,149504,0,7123174107
8596,6607618543,562320,6608180863,0,0,1,569856,0,8369081231
8597,6607666155,512518,6608178673,3,0,1,1024,3,6793658084
8598,6607695344,261719,6607957063,0,0,1,88576,0,1022887949
8599,6607749766,467322,6608217088,8,0,0,755712,8,1407179718
8600,6607765643,457739,6608223382,6,0,0,32256,6,8080109077
8601,6607790069,433467,6608223536,2,0,0,8704,2,975027592
8602,6607862101,565336,6608427437,9,0,0,245248,9,1375329535
8603,6607898425,434885,6608333310,7,0,1,11776,7,530122712
8604,6607955358,2942,6607958300,3,0,1,30208,3,5783124124
8605,6608233219,424255,6608657474,5,0,1,512,5,4493185064
8606,6608235981,133912,6608369893,1,0,1,30720,1,3918653144
8607,6608285650,234645,6608520295,7,0,1,23040,7,6106603790
8608,6608296355,316557,6608612912,1,0,0,3072,1,9413351716
8609,6608515081,61637,6608576718,4,0,1,53760,4,3756785822
8610,6608516492,62238,6608578730,2,0,0,99840,2,10575389319
8611,6608516877,1990,6608518867,5,0,0,1536,5,4722518936
8612,6608601670,216055,6608817725,6,0,1,11264,6,9979586104
8613,6608666565,1990,6608668555,5,0,1,1024,5,1688150322
8614,6608703055,194950,6608898005,3,0,1,13312,3,7096457338
8615,6608708282,43971,6608752253,5,0,0,2048,5,9389610281
8616,6608746603,134007,6608880610,1,0,0,2048,1,5201559966
8617,6608775954,194446,6608970400,1,0,0,72192,1,2485031328
8618,6608986744,94249,6609080993,7,0,0,156672,7,7650649382
8619,6609022570,60689,6609083259,8,0,0,3584,8,6197211552
8620,6609119290,304624,6609423914,9,0,1,122880,9,3464592120
8621,6609293973,129960,6609423933,8,0,0,175616,8,7299513748
8622,6609390318,113851,6609504169,0,0,1,108032,0,5395210320
8623,6609405130,241516,6609646646,7,0,0,158208,7,209279738
8624,6609423906,183258,6609607164,3,0,0,312832,3,7404635922
8625,6609482728,146066,6609628794,3,0,0,10752,3,4113766138
8626,6609519089,345669,6609864758,8,0,1,19968,8,10535210589
8627,6609551691,156717,6609708408,3,0,0,102912,3,9344059717
8628,6609655901,163209,6609819110,4,0,1,1024,4,2109618576
8629,6609711568,361783,6610073351,2,0,1,8192,2,10145228320
8630,6609751346,53837,6609805183,1,0,1,6144,1,124178207
8631,6609785883,158786,6609944669,4,0,1,8192,4,7274757655
8632,6609829028,67784,6609896812,7,0,0,88064,7,4304620628
8633,6609842479,154399,6609996878,9,0,0,89088,9,5145663167
8634,6609889502,61378,6609950880,8,0,0,99328,8,7376235533
8635,6610040736,3894,6610044630,8,0,0,4096,8,6943393954
8636,6610044365,30487,6610074852,0,0,1,9728,0,567539636
8637,6610051796,106140,6610157936,0,0,0,49152,0,5751967841
8638,6610065063,160588,6610225651,6,0,1,26112,6,1803702193
8639,6610124101,15833,6610139934,0,0,1,311808,0,2511321775
8640,6610239882,342194,6610582076,0,0,0,30720,0,6942742986
8641,6610388010,172517,6610560527,1,0,1,24576,1,5109775201
8642,6610395295,165243,6610560538,8,0,0,155648,8,1650472291
8643,6610439230,226184,6610665414,4,0,1,33792,4,108626227
8644,6610683430,107116,6610790546,5,0,1,51712,5,5435126303
8645,6610978837,48976,6611027813,6,0,1,2048,6,8571738691
8646,6610984221,499079,6611483300,0,0,0,808448,0,1616363486
8647,6611007604,387451,6611395055,0,0,1,662016,0,2541488130
8648,6611144164,384705,6611528869,8,0,1,32768,8,10515242944
8649,6611148767,289509,6611438276,2,0,0,171520,2,1306296623
8650,6611162445,289729,6611452174,9,0,0,44032,9,8874819621
8651,6611182284,324859,6611507143,8,0,1,9216,8,5019463072
8652,6611289003,243150,6611532153,6,0,0,100864,6,8506838220
8653,6611290166,279194,6611569360,5,0,0,14848,5,2025215952
8654,6611318015,273993,6611592008,9,0,0,211456,9,7289977038
8655,6611434983,233503,6611668486,4,0,1,16384,4,6893216024
8656,6611452130,676468,6612128598,2,0,0,168960,2,10640307942
8657,6611452956,645305,6612098261,0,0,0,102400,0,10096971946
8658,6611506704,233157,6611739861,6,0,1,71680,6,8881866617
8659,6611556425,248009,6611804434,4,0,0,203264,4,5518447802
8660,6611609177,63601,6611672778,2,0,0,168960,2,2042946580
8661,6611621168,73558,6611694726,3,0,0,95744,3,8545223054
8662,6611822358,1131478,6612953836,3,0,0,64000,3,9200318342
8663,6611824255,654253,6612478508,6,0,0,40448,6,4713224564
8664,6611851220,309748,6612160968,7,0,0,380928,7,655384204
8665,6611877364,482163,6612359527,8,0,0,326656,8,7426935148
8666,6611957029,523693,6612480722,0,0,0,425472,0,3935885344
8667,6611966928,563035,6612529963,4,0,1,23552,4,1229762270
8668,6612184817,336873,6612521690,5,0,0,2560,5,8714484279
8669,6612191283,217368,6612408651,7,0,1,19968,7,4707244016
8670,6612204056,106183,6612310239,8,0,1,18432,8,2384511017
8671,6612217687,129122,6612346809,0,0,1,52224,0,9243971498
8672,6612304668,172784,6612477452,5,0,0,512,5,8333265446
8673,6612477574,504831,6612982405,9,0,0,176640,9,4306497163
8674,6612486201,327586,6612813787,6,0,0,110080,6,7896220204
8675,6612489300,643560,6613132860,9,0,0,158208,9,2244030032
8676,6612512333,299765,6612812098,1,0,0,371200,1,7112807634
8677,6612597488,209459,6612806947,2,0,0,192512,2,5913346427
8678,6612699238,731443,6613430681,2,0,0,38400,2,4990562496
8679,6612709077,267425,6612976502,9,0,0,226304,9,4236787541
8680,6612733472,284248,6613017720,8,0,0,131584,8,7770606060
8681,6612790909,222375,6613013284,8,0,1,25088,8,114883616
8682,6612796216,321678,6613117894,5,0,0,12288,5,7031028443
8683,6612835480,364012,6613199492,7,0,1,17408,7,7510424623
8684,6612837197,514037,6613351234,1,0,0,919040,1,10425034029
8685,6612841264,408694,6613249958,5,0,1,50688,5,826511153
8686,6612901421,637313,6613538734,3,0,1,2048,3,7032996246
8687,6612929513,580382,6613509895,9,0,0,114688,9,1278539276
8688,6612958707,486124,6613444831,9,0,1,151552,9,8360187174
8689,6613014766,395079,6613409845,0,0,1,521728,0,1565888934
8690,6613045587,334981,6613380568,4,0,0,78848,4,889801216
8691,6613080175,274625,6613354800,8,0,1,4608,8,1880109795
8692,6613173695,324252,6613497947,4,0,0,134656,4,4874963723
8693,6613205776,953173,6614158949,7,0,1,4096,7,10272249243
8694,6613250218,468666,6613718884,6,0,0,61440,6,6622875612
8695,6613277796,618867,6613896663,3,0,1,7168,3,4678097558
8696,6613312840,767812,6614080652,5,0,0,3584,5,1539950817
8697,6613353462,894828,6614248290,0,0,0,397312,0,5060770276
8698,6613359671,615343,6613975014,6,0,0,44032,6,5831697512
8699,6613367103,565359,6613932462,9,0,1,187904,9,327765173
8700,6613373418,553661,6613927079,4,0,1,2048,4,3554091944
8701,6613407116,448294,6613855410,0,0,1,40960,0,1613503657
8702,6613409666,699446,6614109112,4,0,0,24064,4,6893115710
8703,6613421375,401121,6613822496,3,0,0,16896,3,4757917301
8704,6613503652,415544,6613919196,5,0,1,14336,5,2378258340
8705,6613526753,368441,6613895194,7,0,0,5632,7,9952404028
8706,6613576132,662697,6614238829,6,0,0,144896,6,1567802014
8707,6613606250,1157293,6614763543,4,0,0,76800,4,10121446573
8708,6613654979,465258,6614120237,5,0,0,2560,5,7546900876
8709,6613661741,421762,6614083503,4,0,1,2048,4,7101245523
8710,6613687964,482586,6614170550,1,0,1,11776,1,4184422319
8711,6613719781,195471,6613915252,5,0,1,28160,5,5639819847
8712,6613801366,169746,6613971112,4,0,1,39936,4,4201467628
8713,6613975090,500661,6614475751,3,0,0,231424,3,7470713969
8714,6613996780,164560,6614161340,1,0,1,20480,1,7138953476
8715,6614079204,992198,6615071402,5,0,1,3584,5,8614303309
8716,6614095895,281208,6614377103,6,0,1,18944,6,7215375349
8717,6614119942,292484,6614412426,7,0,0,200192,7,2285806067
8718,6614134459,53748,6614188207,3,0,1,19968,3,7256792446
8719,6614137478,430467,6614567945,9,0,0,15360,9,7259684750
8720,6614313134,2866,6614316000,0,0,1,147456,0,2110531840
8721,6614358943,389054,6614747997,3,0,0,84992,3,10103972723
8722,6614485644,107475,6614593119,1,0,0,8704,1,5217599639
8723,6614543677,55817,6614599494,6,0,0,179200,6,9237790352
8724,6614548413,28261,6614576674,1,0,1,25088,1,3995885946
8725,6614559984,4370,6614564354,3,0,1,39936,3,2172109532
8726,6614614415,491354,6615105769,8,0,1,1536,8,10502290750
8727,6614655453,49643,6614705096,6,0,0,95232,6,8001086413
8728,6614688398,231159,6614919557,1,0,0,17408,1,2803013678
8729,6614710727,316998,6615027725,2,0,1,41472,2,7214439951
8730,6614742784,53579,6614796363,8,0,0,4608,8,4554859991
8731,6614779762,122327,6614902089,0,0,0,45056,0,10642787996
8732,6614825817,429079,6615254896,9,0,0,87552,9,7564862180
8733,6614834944,312284,6615147228,4,0,0,170496,4,4761482282
8734,6614855581,12562,6614868143,9,0,1,280576,9,6761750885
8735,6615122144,546017,6615668161,4,0,1,11264,4,3877774262
8736,6615185529,286139,6615471668,6,0,1,38912,6,51305853
8737,6615300824,285601,6615586425,0,0,0,20992,0,10146308360
8738,6615315122,193779,6615508901,1,0,0,313856,1,3373009327
8739,6615430325,120204,6615550529,2,0,0,133632,2,6962240540
8740,6615433930,163257,6615597187,6,0,0,157696,6,2415835474
8741,6615449713,163232,6615612945,4,0,0,50688,4,6292595223
8742,6615493746,141216,6615634962,1,0,0,72704,1,7531436440
8743,6615503393,142399,6615645792,4,0,0,35328,4,2539648641
8744,6615566524,79934,6615646458,5,0,0,1024,5,2660879381
8745,6615737370,75808,6615813178,6,0,1,13312,6,6757402866
8746,6615787325,66242,6615853567,8,0,1,34304,8,2892366736
8747,6615814099,94596,6615908695,3,0,0,127488,3,2515127314
8748,6615830078,293376,6616123454,7,0,0,30720,7,2038936986
8749,6615904436,271171,6616175607,2,0,0,154112,2,488725275
8750,6615943584,133576,6616077160,7,0,1,1024,7,7042626149
8751,6615950751,140521,6616091272,3,0,1,15360,3,10495351562
8752,6616016859,36083,6616052942,5,0,1,18432,5,7956508727
8753,6616211798,320844,6616532642,3,0,0,63488,3,9320446721
8754,6616246607,340119,6616586726,2,0,0,917504,2,6554023429
8755,6616321897,442432,6616764329,1,0,0,126464,1,7464649613
8756,6616349218,567112,6616916330,9,0,1,83968,9,10291349858
8757,6616392671,276142,6616668813,1,0,1,11776,1,5228702254
8758,6616463143,252645,6616715788,5,0,0,93184,5,6752523947
8759,6616515792,529745,6617045537,4,0,0,73216,4,10422693934
8760,6616564951,413606,6616978557,6,0,1,7168,6,4849615088
8761,6616598986,383077,6616982063,3,0,1,4096,3,1257206534
8762,6616639180,286942,6616926122,0,0,0,97792,0,8053755381
8763,6616713282,97910,6616811192,8,0,1,6144,8,1411561410
8764,6616763656,254026,6617017682,9,0,1,40448,9,286152054
8765,6616844687,302272,6617146959,0,0,0,54272,0,2233685622
8766,6616905711,303775,6617209486,2,0,1,40960,2,4788581861
8767,6617113588,125400,6617238988,8,0,0,207360,8,3999236142
8768,6617146109,96425,6617242534,6,0,0,5632,6,9671143810
8769,6617161210,52837,6617214047,6,0,1,34816,6,2169333029
8770,6617192923,50668,6617243591,1,0,0,5120,1,6347568015
8771,6617240516,12045,6617252561,8,0,1,13824,8,8638815674
8772,6617262245,171805,6617434050,7,0,1,2560,7,6574324488
8773,6617285344,150065,6617435409,8,0,1,24064,8,6900255696
8774,6617330068,304290,6617634358,3,0,0,19968,3,5896886679
8775,6617396798,89780,6617486578,2,0,1,2048,2,9849759236
8776,6617414193,151056,6617565249,2,0,1,2560,2,9025735060
8777,6617527199,43900,6617571099,2,0,1,512,2,10392316111
8778,6617563833,55744,6617619577,4,0,1,4096,4,10401764745
8779,6617570925,142678,6617713603,0,0,1,99840,0,1970027482
8780,6617645080,80923,6617726003,5,0,1,9728,5,7386847798
8781,6617720981,185633,6617906614,4,0,0,304640,4,1905105532
8782,6617728284,241002,6617969286,8,0,0,209920,8,4210742242
8783,6617766653,233483,6618000136,9,0,0,106496,9,10510415337
8784,6617826825,205082,6618031907,1,0,0,111104,1,876419045
8785,6617862914,155691,6618018605,7,0,1,7680,7,6276679324
8786,6617902854,202353,6618105207,8,0,0,94720,8,6923924745
8787,6617910527,294347,6618204874,5,0,1,46080,5,476534695
8788,6617925003,189432,6618114435,0,0,1,14336,0,5146867393
8789,6617996995,74604,6618071599,3,0,1,73728,3,8639723716
8790,6618013896,311143,6618325039,4,0,1,65536,4,930139321
8791,6618071222,95982,6618167204,6,0,1,3584,6,8457008865
8792,6618189130,25749,6618214879,5,0,1,15872,5,5511051133
8793,6618201243,123877,6618325120,0,0,0,121856,0,5987737482
8794,6618212167,333199,6618545366,4,0,0,76800,4,7024332932
8795,6618282411,461379,6618743790,9,0,0,24064,9,8876360273
8796,6618313052,111901,6618424953,4,0,1,6144,4,3669119152
8797,6618493330,121943,6618615273,2,0,1,33792,2,893131577
8798,6618527511,1038,6618528549,0,0,1,624640,0,8847681631
8799,6618649479,72279,6618721758,8,0,1,12800,8,1362975400
8800,6618651428,114329,6618765757,8,0,1,35328,8,6238468482
8801,6618678273,106273,6618784546,9,0,0,1024,9,10513021715
8802,6618691174,662207,6619353381,1,0,0,117248,1,8021923599
8803,6618746072,372201,6619118273,9,0,0,185856,9,2283543226
8804,6618775633,544161,6619319794,5,0,0,78336,5,1132627801
8805,6618817528,352539,6619170067,6,0,0,305664,6,8320136130
8806,6618841112,553062,6619394174,1,0,0,183296,1,1778274533
8807,6618842821,358878,6619201699,5,0,1,23552,5,6076630260
8808,6618845623,400547,6619246170,3,0,0,328704,3,2506232161
8809,6618915612,271516,6619187128,1,0,1,66560,1,260545437
8810,6618955940,388476,6619344416,6,0,1,1024,6,8558379012
8811,6618959786,259755,6619219541,8,0,1,48128,8,4988011407
8812,6619004189,404508,6619408697,6,0,0,115200,6,1778600427
8813,6619074401,310979,6619385380,8,0,0,154112,8,1022721728
8814,6619087991,513679,6619601670,5,0,1,29696,5,9319675365
8815,6619110342,399036,6619509378,0,0,0,360448,0,2780871701
8816,6619126654,329708,6619456362,7,0,1,6144,7,763983734
8817,6619148052,502565,6619650617,1,0,1,6144,1,9636290130
8818,6619211851,392821,6619604672,0,0,0,104960,0,3418112890
8819,6619257807,623718,6619881525,5,0,0,344576,5,3049668695
8820,6619261303,382417,6619643720,2,0,1,77824,2,4005911841
8821,6619355221,378309,6619733530,9,0,0,282624,9,8177813275
8822,6619400649,286012,6619686661,2,0,0,140288,2,7545346660
8823,6619460343,239135,6619699478,8,0,1,512,8,7514513485
8824,6619504492,619753,6620124245,4,0,0,38912,4,1518966587
8825,6619554415,227999,6619782414,3,0,1,34304,3,3926699980
8826,6619556963,510211,6620067174,1,0,0,26624,1,480398729
8827,6619653092,265184,6619918276,8,0,0,262144,8,8523277731
8828,6619654287,204908,6619859195,1,0,1,29184,1,6448005312
8829,6619655829,488017,6620143846,9,0,1,240128,9,4772517326
8830,6619711697,182031,6619893728,0,0,0,316416,0,4383663885
8831,6619772332,9186,6619781518,6,0,0,9728,6,3190621858
8832,6619779088,468915,6620248003,5,0,1,105984,5,292250177
8833,6619872563,721894,6620594457,5,0,0,255488,5,228382104
8834,6620046714,290684,6620337398,0,0,0,2048,0,651157650
8835,6620087986,631885,6620719871,5,0,1,3072,5,2885407426
8836,6620116380,294604,6620410984,7,0,0,333312,7,1045453097
8837,6620135875,173736,6620309611,2,0,1,13824,2,7153815670
8838,6620168315,300373,6620468688,4,0,1,1536,4,6501714497
8839,6620171161,344992,6620516153,7,0,1,16384,7,1043547317
8840,6620237259,208268,6620445527,8,0,0,20992,8,6804479318
8841,6620284243,83696,6620367939,2,0,1,4608,2,5309124613
8842,6620373094,47922,6620421016,7,0,1,90112,7,1857524894
8843,6620392395,380030,6620772425,3,0,1,7168,3,5351366919
8844,6620438346,241375,6620679721,8,0,0,136192,8,5384582644
8845,6620456829,277325,6620734154,5,0,1,5632,5,9217673755
8846,6620485052,125141,6620610193,4,0,0,44032,4,6727985864
8847,6620505967,284734,6620790701,5,0,1,2560,5,6894112767
8848,6620622986,187879,6620810865,7,0,0,206848,7,4291719630
8849,6620683377,94079,6620777456,2,0,1,512,2,2990403923
8850,6620785962,548055,6621334017,3,0,0,153088,3,6796658827
8851,6620822766,98394,6620921160,6,0,0,88064,6,270326534
8852,6620837394,83777,6620921171,4,0,0,41472,4,3940487801
8853,6620998197,40612,6621038809,9,0,1,91136,9,1477927583
8854,6621073523,199317,6621272840,7,0,1,15360,7,10454402865
8855,6621077882,27468,6621105350,8,0,1,13824,8,1048914323
8856,6621095446,42084,6621137530,6,0,1,512,6,10248868791
8857,6621108983,240288,6621349271,5,0,0,65536,5,8107521171
8858,6621185913,240152,6621426065,6,0,0,30720,6,6892392059
8859,6621188681,83696,6621272377,6,0,1,24064,6,6085683657
8860,6621196086,287563,6621483649,3,0,0,50688,3,3342124361
8861,6621289637,205609,6621495246,6,0,1,19968,6,8943293785
8862,6621291703,50656,6621342359,7,0,0,136192,7,6991716535
8863,6621346453,301780,6621648233,5,0,0,71168,5,10527597733
8864,6621377706,215233,6621592939,6,0,0,352256,6,5766170514
8865,6621461497,203706,6621665203,2,0,1,5632,2,1484960733
8866,6621469300,33740,6621503040,8,0,1,9728,8,9634924626
8867,6621631474,26217,6621657691,2,0,0,53760,2,386631200
8868,6621650519,277726,6621928245,5,0,0,47616,5,1209795422
8869,6621679724,75033,6621754757,1,0,0,125952,1,688682335
8870,6621682755,52909,6621735664,4,0,1,7168,4,3258651295
8871,6621746138,172726,6621918864,8,0,0,84480,8,4990632948
8872,6621852771,207950,6622060721,5,0,0,341504,5,1785104074
8873,6621870505,251864,6622122369,2,0,0,196608,2,2582063027
8874,6621897890,271444,6622169334,6,0,0,151040,6,2586242315
8875,6621901257,345328,6622246585,4,0,0,246784,4,8798700486
8876,6621905081,420087,6622325168,8,0,0,261632,8,2755038530
8877,6621957271,322687,6622279958,5,0,1,27648,5,6988654092
8878,6621998414,413722,6622412136,7,0,1,6144,7,9793340298
8879,6622002619,425568,6622428187,7,0,0,329216,7,10332004440
8880,6622034860,508387,6622543247,7,0,1,4608,7,2218628982
8881,6622228079,329361,6622557440,7,0,0,558080,7,10487649016
8882,6622247803,369002,6622616805,7,0,1,12800,7,5633718395
8883,6622255734,326080,6622581814,8,0,1,53248,8,122569156
8884,6622297381,435198,6622732579,7,0,1,7680,7,5037724589
8885,6622332999,562097,6622895096,6,0,1,7168,6,10297651705
8886,6622418961,503847,6622922808,1,0,1,21504,1,9538564790
8887,6622463425,597705,6623061130,9,0,1,303104,9,4636141971
8888,6622518743,549106,6623067849,4,0,1,22016,4,235711987
8889,6622605191,534878,6623140069,2,0,1,20992,2,3832519662
8890,6622688457,539277,6623227734,4,0,0,906240,4,10094406693
8891,6622699288,561178,6623260466,0,0,1,214528,0,4035911764
8892,6622710347,529058,6623239405,1,0,1,18944,1,7486071911
8893,6622729800,428523,6623158323,6,0,0,35328,6,3666783694
8894,6622747453,723771,6623471224,2,0,0,448000,2,10328594946
8895,6622753759,675617,6623429376,9,0,1,203776,9,10010190861
8896,6622853103,521471,6623374574,5,0,1,4608,5,1605224165
8897,6622887820,481489,6623369309,8,0,1,25600,8,903140831
8898,6622923609,624961,6623548570,5,0,0,148480,5,5917215895
8899,6622984687,504474,6623489161,4,0,0,68096,4,9720497671
8900,6622988955,476161,6623465116,1,0,0,97792,1,2356058073
8901,6623075114,940608,6624015722,0,0,0,186880,0,4415561391
8902,6623097562,609820,6623707382,1,0,1,12288,1,4955704950
8903,6623131859,566051,6623697910,8,0,0,804352,8,4086452741
8904,6623200125,671039,6623871164,4,0,0,301056,4,8114221812
8905,6623219098,698228,6623917326,4,0,1,3072,4,6326899596
8906,6623230748,690035,6623920783,7,0,0,90112,7,9992294408
8907,6623259288,591554,6623850842,7,0,1,12288,7,7430118582
8908,6623296251,452407,6623748658,2,0,1,60928,2,3288024483
8909,6623336513,346179,6623682692,5,0,0,34816,5,3938446737
8910,6623476006,249292,6623725298,7,0,0,512,7,10721969052
8911,6623588699,86592,6623675291,8,0,0,20480,8,6236680951
8912,6623594027,692324,6624286351,6,0,1,3584,6,5164145386
8913,6623601800,401606,6624003406,0,0,1,48640,0,9033469259
8914,6623718386,762120,6624480506,8,0,0,114688,8,2458087098
8915,6623747278,492046,6624239324,8,0,1,6144,8,7001395387
8916,6623774835,214633,6623989468,2,0,1,3072,2,10542518335
8917,6623883352,333758,6624217110,8,0,0,3584,8,2746682446
8918,6623889052,216692,6624105744,6,0,0,357376,6,8134981374
8919,6623893509,218460,6624111969,0,0,0,23040,0,8799890734
8920,6623896056,430548,6624326604,5,0,1,43008,5,2439812885
8921,6623896260,256751,6624153011,3,0,0,18432,3,2813805510
8922,6623923356,138184,6624061540,7,0,0,199168,7,3077474605
8923,6624111633,463340,6624574973,1,0,1,30208,1,692791237
8924,6624113846,299218,6624413064,2,0,0,165888,2,4759477103
8925,6624167606,347538,6624515144,6,0,1,54272,6,3844790168
8926,6624197991,175249,6624373240,1,0,1,34816,1,10311066030
8927,6624250039,23836,6624273875,8,0,1,18432,8,3548530768
8928,6624343361,399428,6624742789,6,0,0,287744,6,1183881069
8929,6624474705,376888,6624851593,0,0,1,59904,0,5934207322
8930,6624506358,184687,6624691045,2,0,0,29184,2,209500440
8931,6624570212,133850,6624704062,3,0,0,299520,3,4451450351
8932,6624631367,419168,6625050535,2,0,0,32768,2,8260231193
8933,6624692000,22170,6624714170,6,0,1,20992,6,1631176995
8934,6624817399,304137,6625121536,9,0,1,87040,9,1233669972
8935,6624902689,55041,6624957730,9,0,1,50176,9,846019701
8936,6624925683,340303,6625265986,5,0,0,36352,5,5014305793
8937,6624941499,158757,6625100256,4,0,0,93696,4,907232614
8938,6625069162,354461,6625423623,4,0,1,14336,4,1712100420
8939,6625143706,117859,6625261565,7,0,1,13824,7,7894500874
8940,6625176537,61120,6625237657,9,0,0,196096,9,5722040451
8941,6625194339,262505,6625456844,9,0,1,362496,9,6053157740
8942,6625220494,137592,6625358086,8,0,1,9728,8,10478210582
8943,6625258927,130384,6625389311,5,0,1,7168,5,10386353306
8944,6625292765,88135,6625380900,3,0,1,15872,3,6795992704
8945,6625314554,413802,6625728356,8,0,0,98816,8,8100363187
8946,6625372081,182505,6625554586,9,0,0,227840,9,7128307604
8947,6625380817,309278,6625690095,7,0,1,57344,7,9013985831
8948,6625383795,616903,6626000698,2,0,0,7168,2,106711139
8949,6625446935,347931,6625794866,8,0,0,75264,8,7207695449
8950,6625454103,554521,6626008624,2,0,0,274432,2,3788914078
8951,6625463322,525530,6625988852,1,0,0,275456,1,668883768
8952,6625471218,347088,6625818306,7,0,0,281088,7,8940952974
8953,6625514922,333018,6625847940,3,0,0,125952,3,7944587511
8954,6625528701,322145,6625850846,6,0,0,4608,6,5780001762
8955,6625529590,235324,6625764914,0,0,1,16896,0,5605501415
8956,6625549997,254307,6625804304,7,0,1,57856,7,6377923075
8957,6625610721,300643,6625911364,7,0,1,2560,7,7888140134
8958,6625622140,469930,6626092070,8,0,0,23552,8,6021395326
8959,6625622491,409997,6626032488,5,0,1,7680,5,3557150415
8960,6625629759,212243,6625842002,7,0,0,234496,7,5014306878
8961,6625673644,539951,6626213595,1,0,1,3584,1,6855525576
8962,6625808486,161498,6625969984,7,0,0,262144,7,5869504369
8963,6625912834,155016,6626067850,0,0,0,197120,0,5748451391
8964,6625956630,171997,6626128627,2,0,0,129536,2,1922683815
8965,6625956636,460968,6626417604,4,0,0,56832,4,2799932739
8966,6626003354,286687,6626290041,6,0,0,408576,6,3443858505
8967,6626032051,306699,6626338750,9,0,0,175104,9,9235960290
8968,6626049310,266414,6626315724,3,0,1,3584,3,1929409681
8969,6626084358,266166,6626350524,3,0,0,45568,3,3917054505
8970,6626086719,198694,6626285413,6,0,1,44032,6,9578195306
8971,6626106280,84988,6626191268,8,0,0,70144,8,2296395279
8972,6626211467,448564,6626660031,5,0,1,14336,5,8883223390
8973,6626302040,472631,6626774671,6,0,1,4096,6,8766943776
8974,6626400153,150959,6626551112,9,0,0,138752,9,2715105270
8975,6626408402,45065,6626453467,1,0,0,192000,1,8505100150
8976,6626469991,322440,6626792431,3,0,1,54272,3,2995294093
8977,6626514307,83437,6626597744,0,0,0,512,0,5213075565
8978,6626517481,178250,6626695731,9,0,1,458752,9,1743765457
8979,6626545347,55817,6626601164,8,0,1,13312,8,1834979877
8980,6626665592,555489,6627221081,0,0,1,370176,0,5818547780
8981,6626694524,197419,6626891943,6,0,1,1536,6,2757935535
8982,6626705669,166379,6626872048,2,0,1,5120,2,5944806242
8983,6626711239,619556,6627330795,4,0,1,11264,4,294759822
8984,6626776070,385449,6627161519,5,0,0,135680,5,697378456
8985,6626784466,610541,6627395007,3,0,1,8192,3,7409306469
8986,6626846410,253123,6627099533,4,0,1,7680,4,8215367449
8987,6626863080,161873,6627024953,6,0,0,95232,6,5179014198
8988,6626875570,686922,6627562492,1,0,0,90624,1,7507343969
8989,6626906621,644718,6627551339,5,0,0,74240,5,8562786814
8990,6626932537,288136,6627220673,1,0,0,157184,1,3204942048
8991,6627065312,511917,6627577229,7,0,0,141312,7,3250549404
8992,6627067832,286296,6627354128,2,0,0,103424,2,3153004348
8993,6627072042,576379,6627648421,4,0,0,54272,4,4671380973
8994,6627221047,264353,6627485400,4,0,1,11264,4,8058919488
8995,6627236000,11270,6627247270,9,0,1,227328,9,2705947094
8996,6627261397,534990,6627796387,0,0,1,2560,0,10002558713
8997,6627508874,510384,6628019258,8,0,1,6656,8,10118441474
8998,6627565266,314501,6627879767,5,0,1,32768,5,9473222800
8999,6627598798,278391,6627877189,7,0,1,29184,7,4355101988
9000,6627673590,47408,6627720998,7,0,0,18432,7,1955014924
9001,6627796260,74428,6627870688,4,0,0,73216,4,9516230951
9002,6627816726,356634,6628173360,7,0,0,117760,7,6171053277
9003,6627879415,76583,6627955998,1,0,0,129024,1,5363037979
9004,6627946133,223895,6628170028,1,0,0,362496,1,6044384496
9005,6627975085,200230,6628175315,7,0,0,25088,7,1961182960
9006,6627996930,212995,6628209925,1,0,1,7168,1,681135499
9007,6628107739,64869,6628172608,0,0,0,344576,0,7637118497
9008,6628212378,344440,6628556818,4,0,1,27648,4,9472826500
9009,6628219865,3894,6628223759,0,0,1,29696,0,1450531213
9010,6628267309,232079,6628499388,5,0,0,38400,5,468327160
9011,6628344073,1514,6628345587,4,0,0,4096,4,298842661
9012,6628474090,425661,6628899751,4,0,0,1536,4,4879146051
9013,6628634055,26475,6628660530,8,0,1,27648,8,962292408
9014,6628645016,137163,6628782179,4,0,0,48128,4,2724037875
9015,6628658147,135409,6628793556,0,0,1,34304,0,4462108191
9016,6628721555,131863,6628853418,4,0,1,17920,4,8270304438
9017,6628787758,46467,6628834225,9,0,1,629760,9,2480576267
9018,6628791908,118581,6628910489,3,0,1,30720,3,10367708596
9019,6628950077,37631,6628987708,2,0,1,5632,2,9710279386
9020,6628952515,409995,6629362510,3,0,0,80384,3,4187808950
9021,6628963713,626552,6629590265,2,0,0,171520,2,5186197834
9022,6629047267,465968,6629513235,9,0,1,342528,9,2725720880
9023,6629054981,264182,6629319163,7,0,0,40960,7,2632042747
9024,6629057123,397016,6629454139,0,0,1,96768,0,4023750396
9025,6629160462,309499,6629469961,7,0,1,28160,7,6638819522
9026,6629164939,312585,6629477524,6,0,1,66560,6,288293552
9027,6629196580,567804,6629764384,8,0,1,6144,8,22074211
9028,6629231522,368000,6629599522,7,0,1,32768,7,9101495191
9029,6629247090,393563,6629640653,1,0,0,179200,1,6927802655
9030,6629377121,247975,6629625096,6,0,0,97792,6,5418786465
9031,6629539529,140334,6629679863,0,0,0,93184,0,2822360776
9032,6629611837,63319,6629675156,2,0,1,512,2,8222909822
9033,6629633531,89289,6629722820,8,0,0,65024,8,5767592590
9034,6629641966,101363,6629743329,4,0,1,21504,4,2245053047
9035,6629655613,51512,6629707125,1,0,1,11264,1,803457097
9036,6629702145,220220,6629922365,0,0,1,14336,0,3365551453
9037,6629762669,301758,6630064427,0,0,1,194560,0,3544314103
9038,6629796052,157730,6629953782,7,0,0,83456,7,8362002801
9039,6629908892,368856,6630277748,4,0,1,7168,4,6270388646
9040,6629932133,129375,6630061508,6,0,1,29696,6,10299199557
9041,6629943509,191954,6630135463,8,0,1,6144,8,9600765537
9042,6630112341,40612,6630152953,4,0,1,18432,4,2372611153
9043,6630145867,81616,6630227483,1,0,0,65536,1,8769784621
9044,6630155495,42420,6630197915,6,0,1,25600,6,6288091145
9045,6630203060,129837,6630332897,7,0,0,69120,7,5071553163
9046,6630226537,71503,6630298040,7,0,0,115712,7,5155350705
9047,6630273383,53321,6630326704,7,0,0,87040,7,8512637832
9048,6630338954,61637,6630400591,5,0,0,99840,5,4191610337
9049,6630380083,45175,6630425258,4,0,0,77824,4,6360212938
9050,6630457141,138109,6630595250,4,0,0,228864,4,3399538553
9051,6630470993,165782,6630636775,7,0,0,133120,7,5481812165
9052,6630578531,68971,6630647502,1,0,0,43008,1,10057145778
9053,6630581254,114395,6630695649,4,0,1,9216,4,7123031435
9054,6630605410,53579,6630658989,9,0,1,51200,9,8779626793
9055,6630639532,187942,6630827474,8,0,1,15872,8,7100731245
9056,6630698648,3641,6630702289,2,0,0,87552,2,8227492079
9057,6630736402,194110,6630930512,2,0,1,8704,2,5441646258
9058,6630745362,296746,6631042108,4,0,1,16384,4,3357567860
9059,6630775186,183787,6630958973,4,0,1,3072,4,642237007
9060,6630841800,223328,6631065128,5,0,0,10240,5,591572250
9061,6630871484,220249,6631091733,3,0,0,381952,3,8332365572
9062,6630886012,235571,6631121583,6,0,1,15872,6,4618527217
9063,6630907348,246365,6631153713,7,0,0,157696,7,6764280884
9064,6631151898,54266,6631206164,7,0,1,12800,7,10555668839
9065,6631171997,139906,6631311903,8,0,1,43520,8,8211268131
9066,6631192267,13249,6631205516,1,0,0,92160,1,9930049833
9067,6631287309,234861,6631522170,1,0,0,25600,1,8470786390
9068,6631420118,64479,6631484597,3,0,0,105472,3,1719529161
9069,6631421807,69145,6631490952,3,0,1,93184,3,372376055
9070,6631434948,107526,6631542474,4,0,1,120320,4,6905391162
9071,6631447018,349724,6631796742,3,0,0,101888,3,4696887706
9072,6631479786,175361,6631655147,3,0,0,172032,3,7901924572
9073,6631513905,168032,6631681937,5,0,1,33792,5,672749185
9074,6631635917,415849,6632051766,4,0,1,45056,4,2488579134
9075,6631641809,215635,6631857444,4,0,1,71168,4,5257075972
9076,6631644817,263474,6631908291,1,0,1,5120,1,7854650364
9077,6631664877,401685,6632066562,8,0,1,29184,8,9978153926
9078,6631856128,59473,6631915601,9,0,0,71168,9,1344055703
9079,6631900394,96569,6631996963,0,0,0,131584,0,1862003289
9080,6631926086,178904,6632104990,7,0,1,27648,7,1822059895
9081,6632094974,54266,6632149240,4,0,1,27648,4,2264849314
9082,6632109123,166616,6632275739,4,0,0,92160,4,6717160504
9083,6632115535,183711,6632299246,1,0,1,17920,1,4866703671
9084,6632170514,136075,6632306589,0,0,1,24064,0,4147682766
9085,6632184500,160208,6632344708,2,0,1,9728,2,75918044
9086,6632193208,167872,6632361080,1,0,1,9728,1,1545212328
9087,6632235022,127005,6632362027,8,0,1,3072,8,1175190106
9088,6632303791,78879,6632382670,3,0,1,7168,3,11438557
9089,6632334443,65683,6632400126,1,0,1,25600,1,9691998927
9090,6632355656,71149,6632426805,0,0,0,111104,0,4661438448
9091,6632361122,69315,6632430437,7,0,0,35840,7,3507209308
9092,6632367142,15590,6632382732,6,0,0,6656,6,4654117785
9093,6632426256,123305,6632549561,1,0,0,17408,1,296567904
9094,6632537736,84115,6632621851,1,0,1,6144,1,3659206516
9095,6632552188,82972,6632635160,5,0,1,12800,5,9140605627
9096,6632632246,7226,6632639472,5,0,1,52224,5,3350985335
9097,6632716082,110178,6632826260,3,0,0,7680,3,767291559
9098,6632773164,11270,6632784434,8,0,0,18432,8,3567168608
9099,6632890129,72532,6632962661,3,0,1,13824,3,4286502381
9100,6632912191,116176,6633028367,1,0,1,31744,1,2684528752
9101,6633026097,94630,6633120727,4,0,1,18432,4,4368190167
9102,6633134523,50668,6633185191,8,0,1,2560,8,6888691977
9103,6633199276,100564,6633299840,7,0,1,30208,7,7015819653
9104,6633376165,54525,6633430690,3,0,0,92672,3,10353734789
9105,6633500673,4933,6633505606,3,0,0,12800,3,2617450760
9106,6633571663,114329,6633685992,2,0,0,185856,2,9607412428
9107,6633572171,170336,6633742507,9,0,0,180224,9,112492817
9108,6633579776,152946,6633732722,6,0,1,15872,6,8704699322
9109,6633595872,113812,6633709684,1,0,0,30208,1,9422486088
9110,6633665765,248152,6633913917,3,0,1,36864,3,9560169207
9111,6633700694,255498,6633956192,3,0,0,184832,3,2666743040
9112,6633704267,230142,6633934409,7,0,0,291840,7,7390991663
9113,6633752936,318692,6634071628,2,0,0,369152,2,347644103
9114,6633876470,234424,6634110894,5,0,1,16896,5,1066122916
9115,6633949341,72279,6634021620,1,0,1,16384,1,4355654251
9116,6634048323,85924,6634134247,7,0,1,27136,7,4215255616
9117,6634131822,356450,6634488272,2,0,0,117248,2,6323485726
9118,6634134652,75550,6634210202,9,0,0,62464,9,3123535212
9119,6634160939,99693,6634260632,7,0,1,3584,7,3627607933
9120,6634247297,389928,6634637225,7,0,1,1024,7,4392492279
9121,6634252722,126692,6634379414,2,0,0,126976,2,4773997197
9122,6634268979,303043,6634572022,8,0,1,15360,8,7311213254
9123,6634325728,126498,6634452226,1,0,0,209920,1,9863122942
9124,6634346506,248284,6634594790,0,0,0,73728,0,1900496317
9125,6634396429,3641,6634400070,6,0,1,5632,6,7980218447
9126,6634551211,25442,6634576653,9,0,1,253952,9,3555466586
9127,6634566503,203213,6634769716,2,0,0,10240,2,7960521059
9128,6634571358,3900,6634575258,0,0,0,46080,0,111682553
9129,6634601884,30745,6634632629,5,0,0,10752,5,9436484792
9130,6634615278,82404,6634697682,9,0,0,49664,9,4003322777
9131,6634660609,409819,6635070428,4,0,1,14848,4,5617428129
9132,6634797859,304956,6635102815,3,0,0,133632,3,1521673624
9133,6634800686,204625,6635005311,5,0,1,22528,5,1070574689
9134,6634808759,188324,6634997083,8,0,1,52736,8,2255291305
9135,6634825071,126485,6634951556,0,0,0,264192,0,7061272392
9136,6634886921,251159,6635138080,7,0,0,8192,7,4616517677
9137,6634893503,245429,6635138932,0,0,1,217088,0,1314830930
9138,6634910952,243437,6635154389,6,0,1,62464,6,7153597559
9139,6634940177,237986,6635178163,5,0,1,31232,5,2299898300
9140,6634942973,396142,6635339115,2,0,0,366592,2,5402288506
9141,6634964461,302745,6635267206,5,0,0,58880,5,8228843595
9142,6634965731,495877,6635461608,8,0,1,72192,8,6403377116
9143,6634976771,293295,6635270066,9,0,0,40960,9,949791187
9144,6634982786,207069,6635189855,5,0,0,10752,5,4583205039
9145,6634986911,293816,6635280727,0,0,0,26112,0,3755748551
9146,6635051823,513649,6635565472,3,0,0,361472,3,5684332393
9147,6635085547,548730,6635634277,4,0,1,8192,4,1947681867
9148,6635144964,244432,6635389396,1,0,1,10752,1,10049966975
9149,6635162180,352270,6635514450,5,0,1,38912,5,841658793
9150,6635164687,774145,6635938832,2,0,0,94720,2,10513772433
9151,6635209828,478868,6635688696,3,0,1,11776,3,7701603807
9152,6635271092,547019,6635818111,8,0,1,2048,8,6229789804
9153,6635296867,625861,6635922728,2,0,0,1234944,2,1432319891
9154,6635305930,129622,6635435552,1,0,1,15360,1,3831794304
9155,6635313645,487986,6635801631,4,0,0,201728,4,7159344265
9156,6635431833,331107,6635762940,1,0,1,76800,1,670491498
9157,6635453098,417138,6635870236,1,0,1,9216,1,5689137945
9158,6635492767,791226,6636283993,1,0,1,71168,1,1684239248
9159,6635506371,324404,6635830775,8,0,0,49152,8,3549119525
9160,6635553272,334025,6635887297,8,0,0,43008,8,10006098368
9161,6635669836,666495,6636336331,4,0,1,19968,4,5805623811
9162,6635679539,845628,6636525167,7,0,1,1024,7,4642203959
9163,6635684503,659845,6636344348,8,0,1,23040,8,9078499241
9164,6635780974,623671,6636404645,0,0,1,1223168,0,6970042792
9165,6635784666,450610,6636235276,1,0,1,22528,1,5874076510
9166,6635786462,847759,6636634221,3,0,1,6656,3,6177354642
9167,6635799491,430647,6636230138,2,0,1,45568,2,197932820
9168,6635848956,385705,6636234661,3,0,0,292352,3,176466849
9169,6635916069,279347,6636195416,9,0,0,124928,9,3456307168
9170,6635917104,220176,6636137280,7,0,1,8192,7,8255095087
9171,6636029045,110300,6636139345,4,0,0,31744,4,7131906617
9172,6636094937,101747,6636196684,7,0,0,24064,7,5751814327
9173,6636129583,803990,6636933573,7,0,1,54272,7,3847078815
9174,6636226523,471876,6636698399,5,0,0,79360,5,8642313177
9175,6636282349,1560553,6637842902,3,0,0,160768,3,10298038815
9176,6636315197,839466,6637154663,4,0,0,471552,4,1402208501
9177,6636316904,727407,6637044311,2,0,0,332288,2,6052054918
9178,6636323550,973158,6637296708,0,0,0,62976,0,9331317256
9179,6636325498,766590,6637092088,7,0,1,2048,7,7987434955
9180,6636355298,1269299,6637624597,7,0,0,28672,7,8290008507
9181,6636408682,618960,6637027642,8,0,1,1024,8,4475171512
9182,6636459099,1075326,6637534425,9,0,1,550400,9,1099944868
9183,6636487692,1223750,6637711442,2,0,0,47616,2,4728402065
9184,6636537656,1365956,6637903612,0,0,1,116736,0,9302952287
9185,6636552001,1436311,6637988312,7,0,0,59904,7,4008188163
9186,6636580105,1449859,6638029964,3,0,0,337408,3,5421170163
9187,6636605557,1351998,6637957555,9,0,1,176640,9,7507477936
9188,6636615729,1377356,6637993085,5,0,1,1536,5,2135626520
9189,6636654102,1040074,6637694176,1,0,1,14336,1,766942428
9190,6636657084,1698580,6638355664,9,0,1,1246720,9,10073559531
9191,6636699942,1433865,6638133807,2,0,0,17920,2,1417449355
9192,6636745661,1080382,6637826043,8,0,0,5120,8,2282220706
9193,6636778123,1378364,6638156487,8,0,0,36352,8,3272863435
9194,6636781181,1076520,6637857701,5,0,1,4096,5,10684646212
9195,6636809983,1827074,6638637057,5,0,0,136704,5,8472918904
9196,6636822734,1852537,6638675271,9,0,0,52736,9,2663405499
9197,6636884221,1732711,6638616932,0,0,0,25600,0,4947688672
9198,6636914400,1687003,6638601403,2,0,1,9216,2,89621151
9199,6636928294,1654552,6638582846,6,0,1,20992,6,5845647710
9200,6636930204,1365745,6638295949,6,0,1,10752,6,3433673645
9201,6636980872,1666714,6638647586,5,0,0,64512,5,10335566401
9202,6636997545,1653982,6638651527,5,0,1,25088,5,2528676655
9203,6637005413,1549831,6638555244,1,0,0,861696,1,7864163728
9204,6637100423,1595833,6638696256,3,0,1,12800,3,4003740860
9205,6637110933,1120594,6638231527,0,0,1,144384,0,4048145705
9206,6637126534,1508932,6638635466,7,0,0,74240,7,6256889946
9207,6637285728,1159258,6638444986,1,0,0,300544,1,9123627372
9208,6637287872,464865,6637752737,9,0,1,19968,9,10657986731
9209,6637302264,1196634,6638498898,2,0,1,9216,2,249603312
9210,6637316224,1268094,6638584318,5,0,0,163328,5,9868549218
9211,6637334958,1631193,6638966151,8,0,0,507392,8,4451258246
9212,6637369143,994989,6638364132,5,0,1,31744,5,3174092237
9213,6637396241,734241,6638130482,0,0,1,215552,0,3624463620
9214,6637422590,795761,6638218351,3,0,1,10240,3,2695564336
9215,6637450958,513142,6637964100,6,0,1,5632,6,752262798
9216,6637703956,771062,6638475018,0,0,0,15872,0,672584846
9217,6637768710,1087026,6638855736,6,0,0,132608,6,1386023417
9218,6637789741,2074069,6639863810,2,0,0,97280,2,7280347256
9219,6637794611,1047198,6638841809,0,0,1,173568,0,7803834871
9220,6637838781,2012100,6639850881,4,0,1,6656,4,8021677817
9221,6637879542,754120,6638633662,0,0,1,144896,0,1776972585
9222,6637882415,1402811,6639285226,2,0,0,123904,2,2196444320
9223,6638001882,2033599,6640035481,9,0,1,96256,9,4209672646
9224,6638002285,891362,6638893647,9,0,1,25600,9,1530068585
9225,6638046540,854751,6638901291,5,0,0,220672,5,2697044114
9226,6638052117,1441479,6639493596,6,0,0,40960,6,8679900694
9227,6638055994,996196,6639052190,1,0,1,2048,1,9426718967
9228,6638077881,1066512,6639144393,9,0,0,408064,9,5900078707
9229,6638080211,2157876,6640238087,9,0,1,12800,9,7874442920
9230,6638091425,587881,6638679306,6,0,1,44544,6,1967243409
9231,6638169263,1424713,6639593976,3,0,1,16896,3,9097995647
9232,6638195182,984589,6639179771,4,0,0,391168,4,657397973
9233,6638198380,2456743,6640655123,0,0,0,259072,0,5425745509
9234,6638307170,2087756,6640394926,9,0,1,388608,9,6167489980
9235,6638334220,2024798,6640359018,6,0,1,23552,6,10256266152
9236,6638357059,2042603,6640399662,6,0,0,101376,6,363366885
9237,6638381500,864137,6639245637,0,0,0,84992,0,5077359793
9238,6638389507,1998742,6640388249,2,0,1,9728,2,7668187667
9239,6638443692,1941501,6640385193,7,0,0,55296,7,207193679
9240,6638456848,1953014,6640409862,4,0,1,31744,4,10391977678
9241,6638475025,2087105,6640562130,9,0,1,94720,9,4071692977
9242,6638484074,827240,6639311314,1,0,1,1024,1,1907121172
9243,6638522271,735680,6639257951,8,0,0,76800,8,2851119698
9244,6638536751,699992,6639236743,9,0,0,327680,9,7883269433
9245,6638546026,743876,6639289902,8,0,1,3584,8,3514758783
9246,6638596050,966441,6639562491,1,0,0,592384,1,1560496189
9247,6638635438,1037357,6639672795,9,0,0,73728,9,4175559431
9248,6638741391,2188143,6640929534,1,0,0,53248,1,2760147053
9249,6638772574,1366161,6640138735,3,0,0,446976,3,1024723830
9250,6638799567,558304,6639357871,6,0,0,4608,6,10194399827
9251,6638807101,1220373,6640027474,0,0,1,196096,0,356349054
9252,6638856442,2333315,6641189757,6,0,0,209920,6,7435431392
9253,6638923709,2220034,6641143743,9,0,0,43008,9,4056498793
9254,6638962144,2231586,6641193730,1,0,1,512,1,9768085761
9255,6638984511,2187732,6641172243,5,0,1,36352,5,5457297089
9256,6638994422,2155762,6641150184,1,0,0,49152,1,7405812723
9257,6638997656,450254,6639447910,3,0,0,557568,3,2814622062
9258,6639017261,2272507,6641289768,5,0,0,448512,5,6060607281
9259,6639045768,341410,6639387178,4,0,0,40448,4,4895023879
9260,6639066968,604264,6639671232,3,0,0,3584,3,7236944907
9261,6639093374,2475164,6641568538,2,0,1,33280,2,6350690770
9262,6639103728,2469553,6641573281,2,0,0,237056,2,7307474838
9263,6639155549,2379336,6641534885,8,0,0,293888,8,273800601
9264,6639180352,437715,6639618067,0,0,0,104448,0,4490835663
9265,6639309677,2534946,6641844623,5,0,1,66048,5,4907492042
9266,6639310177,269643,6639579820,8,0,1,2048,8,7848524519
9267,6639340210,2510859,6641851069,5,0,0,56832,5,151463098
9268,6639356051,282264,6639638315,3,0,1,43520,3,9640070383
9269,6639380458,2566700,6641947158,7,0,1,37888,7,2321851714
9270,6639452134,2522712,6641974846,4,0,0,281088,4,58717161
9271,6639452563,2471322,6641923885,6,0,0,222720,6,7999932298
9272,6639491069,629271,6640120340,3,0,1,38400,3,41425719
9273,6639528640,2719982,6642248622,8,0,1,6144,8,10512535672
9274,6639575792,919448,6640495240,2,0,1,49664,2,2462364773
9275,6639691111,868171,6640559282,9,0,0,33280,9,18844245
9276,6639747451,192259,6639939710,9,0,0,13312,9,10504852315
9277,6639785746,2895063,6642680809,9,0,0,13824,9,5072239260
9278,6639908508,2875838,6642784346,2,0,1,13824,2,3785132679
9279,6639957839,2874615,6642832454,4,0,0,30720,4,10135455268
9280,6639971785,740021,6640711806,3,0,0,24064,3,3176032483
9281,6639996189,2923951,6642920140,1,0,0,92672,1,4143393504
9282,6640053987,371311,6640425298,8,0,0,659456,8,7446689758
9283,6640271950,2998807,6643270757,1,0,0,120320,1,2803944961
9284,6640275277,3006138,6643281415,1,0,1,15872,1,108744110
9285,6640306658,2876434,6643183092,4,0,0,221184,4,8084499296
9286,6640415768,2878159,6643293927,0,0,0,390656,0,2040941129
9287,6640435999,375803,6640811802,7,0,0,327680,7,1985105280
9288,6640460588,2977811,6643438399,9,0,1,86528,9,3271703476
9289,6640551281,2758616,6643309897,0,0,0,178688,0,4024541100
9290,6640617094,2703352,6643320446,8,0,1,5632,8,2959759585
9291,6640648569,2666235,6643314804,2,0,0,225792,2,1456651138
9292,6640712535,2505638,6643218173,2,0,0,124928,2,5831371214
9293,6640713553,2502900,6643216453,1,0,0,53760,1,5026203892
9294,6640717395,354237,6641071632,1,0,0,230912,1,7802812305
9295,6640854040,652250,6641506290,7,0,1,64000,7,569996786
9296,6640856670,438598,6641295268,8,0,1,36352,8,5733586288
9297,6640865566,2518877,6643384443,0,0,0,21504,0,6730827085
9298,6640901160,415040,6641316200,1,0,1,36864,1,7320098682
9299,6640912573,426765,6641339338,0,0,0,536064,0,6384793417
9300,6640965390,497209,6641462599,1,0,1,41472,1,3543195478
9301,6641039920,388652,6641428572,6,0,1,1024,6,2031358966
9302,6641040789,599845,6641640634,1,0,1,24576,1,1106713669
9303,6641059575,607345,6641666920,3,0,0,148992,3,10433669709
9304,6641184833,678894,6641863727,8,0,0,446976,8,3961945264
9305,6641198845,3200639,6644399484,2,0,0,26624,2,3956223800
9306,6641247625,627839,6641875464,1,0,1,48640,1,2195102
9307,6641615953,3028725,6644644678,6,0,0,312320,6,3487364692
9308,6641636664,1076744,6642713408,3,0,0,182272,3,10083333101
9309,6641638419,3186617,6644825036,6,0,0,83456,6,3305573431
9310,6641708385,913945,6642622330,8,0,1,2560,8,1461738276
9311,6641715696,388911,6642104607,3,0,0,3072,3,2413844442
9312,6641721364,3169764,6644891128,2,0,0,542720,2,5339254579
9313,6641782087,163205,6641945292,6,0,1,6656,6,6758454703
9314,6641822653,243662,6642066315,0,0,0,66560,0,5121147747
9315,6641855799,365881,6642221680,4,0,1,8192,4,7710937712
9316,6642005534,3321563,6645327097,0,0,0,10752,0,7170073806
9317,6642036787,3295009,6645331796,5,0,1,51200,5,2018243720
9318,6642076457,1246548,6643323005,5,0,1,14848,5,9635830972
9319,6642079491,3289194,6645368685,7,0,0,56320,7,6523868511
9320,6642115126,3280054,6645395180,7,0,0,3584,7,5077919835
9321,6642129732,3292018,6645421750,1,0,1,11264,1,742186782
9322,6642151150,934123,6643085273,6,0,0,164352,6,6989950452
9323,6642170401,3409602,6645580003,6,0,0,104960,6,10228864249
9324,6642341124,3269546,6645610670,2,0,0,28672,2,3443603761
9325,6642346733,572903,6642919636,9,0,1,95744,9,4463594295
9326,6642416512,322738,6642739250,9,0,1,439296,9,245340945
9327,6642447544,619292,6643066836,5,0,1,13312,5,2243348883
9328,6642479093,532150,6643011243,2,0,1,7680,2,5107275371
9329,6642482850,3573509,6646056359,0,0,1,164864,0,1932121642
9330,6642531846,3486716,6646018562,7,0,0,327680,7,8114952274
9331,6642573835,289787,6642863622,3,0,1,10752,3,8047646362
9332,6642575721,3535095,6646110816,7,0,1,63488,7,3571670981
9333,6642581543,3536178,6646117721,0,0,1,172544,0,8383563065
9334,6642589325,384613,6642973938,4,0,1,32768,4,8460908291
9335,6642668531,3232006,6645900537,7,0,1,47616,7,5344553488
9336,6642670476,1032156,6643702632,9,0,1,130048,9,9754346383
9337,6642933059,3290453,6646223512,6,0,0,53760,6,5889432871
9338,6643029616,3321372,6646350988,5,0,0,42496,5,6629436626
9339,6643031592,3250034,6646281626,7,0,0,310272,7,6949111162
9340,6643129834,315337,6643445171,0,0,1,53248,0,10269201549
9341,6643135759,528103,6643663862,9,0,0,179200,9,8214027540
9342,6643164661,3553412,6646718073,4,0,1,40960,4,7461145421
9343,6643372815,357503,6643730318,2,0,1,24064,2,3320542220
9344,6643436661,3456147,6646892808,3,0,1,46592,3,6624315534
9345,6643467347,496822,6643964169,9,0,0,28160,9,7531804258
9346,6643470214,3281943,6646752157,2,0,1,3584,2,2239540041
9347,6643471398,227785,6643699183,7,0,0,16896,7,46732923
9348,6643655758,3260522,6646916280,9,0,1,98816,9,7430671035
9349,6643691141,3227153,6646918294,1,0,0,780800,1,8567589930
9350,6643705951,554265,6644260216,6,0,0,10240,6,9097930184
9351,6643709365,3269538,6646978903,3,0,0,34816,3,3756853081
9352,6643724394,3314381,6647038775,7,0,0,55296,7,8771113325
9353,6643759146,348311,6644107457,6,0,1,9728,6,5455856186
9354,6643793239,3161462,6646954701,1,0,0,68096,1,6660906896
9355,6643846308,482931,6644329239,7,0,1,37888,7,4291616829
9356,6643848946,704693,6644553639,1,0,0,282624,1,66198409
9357,6643924112,3659345,6647583457,0,0,1,246272,0,6365554073
9358,6643994626,3276321,6647270947,6,0,1,14336,6,10056363425
9359,6644014417,3223378,6647237795,9,0,0,39936,9,6137403589
9360,6644046020,1477730,6645523750,1,0,0,55296,1,6769878489
9361,6644101701,641989,6644743690,7,0,0,174592,7,8105514122
9362,6644150620,462751,6644613371,1,0,0,43520,1,7742492635
9363,6644270430,1513911,6645784341,7,0,1,4096,7,9866571272
9364,6644283230,3704188,6647987418,4,0,0,26112,4,1035812812
9365,6644417240,3600040,6648017280,1,0,1,14848,1,4107868116
9366,6644497849,847612,6645345461,9,0,0,30208,9,9876747958
9367,6644503865,3274254,6647778119,8,0,0,401408,8,6363478163
9368,6644611347,3270222,6647881569,5,0,0,96256,5,307966546
9369,6644685423,1326069,6646011492,4,0,1,24576,4,3288444115
9370,6644746662,667012,6645413674,0,0,1,173056,0,1649814341
9371,6644790644,3207318,6647997962,4,0,1,24064,4,8023506898
9372,6644849082,3192969,6648042051,2,0,1,35840,2,2199417822
9373,6644878873,3201960,6648080833,0,0,0,8704,0,8877336315
9374,6644882099,487612,6645369711,5,0,0,144384,5,2083113584
9375,6644919468,3207083,6648126551,1,0,1,7168,1,4577111074
9376,6644931307,3178600,6648109907,0,0,0,94720,0,3078873108
9377,6645016488,548859,6645565347,6,0,0,46592,6,6818975538
9378,6645077562,626588,6645704150,4,0,1,20480,4,306502090
9379,6645126022,3304926,6648430948,9,0,1,1053696,9,6660992446
9380,6645148247,603866,6645752113,1,0,1,4096,1,3358721034
9381,6645154264,3142753,6648297017,8,0,1,18432,8,3789710880
9382,6645207853,3127735,6648335588,3,0,0,274432,3,2040690329
9383,6645213684,512281,6645725965,1,0,1,63488,1,8203465235
9384,6645221850,3171813,6648393663,0,0,1,430592,0,6220956245
9385,6645303357,3133827,6648437184,4,0,0,83968,4,10629844354
9386,6645446162,3006709,6648452871,0,0,1,100352,0,7404425098
9387,6645474417,2816697,6648291114,3,0,0,412160,3,5250421914
9388,6645576528,346511,6645923039,5,0,0,187904,5,9715838293
9389,6645577314,3009806,6648587120,3,0,0,180224,3,5911638369
9390,6645731869,359851,6646091720,5,0,0,75776,5,7239378869
9391,6645808007,766609,6646574616,2,0,0,71680,2,5198226536
9392,6645893970,2962364,6648856334,3,0,1,18944,3,7221709874
9393,6645962242,2694849,6648657091,2,0,1,1536,2,7200838546
9394,6645988056,814543,6646802599,5,0,0,11264,5,9658436372
9395,6646006048,643360,6646649408,0,0,0,240640,0,4320391487
9396,6646129878,381426,6646511304,6,0,1,80896,6,10024206461
9397,6646141803,714991,6646856794,3,0,1,1024,3,7813510068
9398,6646438773,2777603,6649216376,0,0,1,48128,0,245488423
9399,6646479425,2771555,6649250980,2,0,0,62976,2,3686917160
9400,6646527273,2703016,6649230289,9,0,1,110080,9,1346909346
9401,6646544803,321341,6646866144,1,0,0,675328,1,9953187478
9402,6646553293,2649124,6649202417,1,0,1,10752,1,10242285234
9403,6646568591,443434,6647012025,6,0,1,4096,6,8716714178
9404,6646600239,294324,6646894563,7,0,0,579584,7,10107390748
9405,6646629621,551513,6647181134,8,0,0,62976,8,182112586
9406,6646634207,2726915,6649361122,4,0,0,7168,4,5234749966
9407,6646655544,461863,6647117407,8,0,0,29184,8,2759454513
9408,6646699804,593399,6647293203,2,0,0,32768,2,8021294711
9409,6646730756,446881,6647177637,5,0,1,11264,5,5495391189
9410,6646774478,269808,6647044286,2,0,1,50176,2,6221717984
9411,6646807091,2815494,6649622585,0,0,1,80384,0,9682765833
9412,6646822905,2797626,6649620531,8,0,0,164864,8,5814265185
9413,6646925165,399351,6647324516,8,0,1,17920,8,2336527331
9414,6646971013,2989565,6649960578,3,0,1,4096,3,2574454932
9415,6647067477,2969666,6650037143,5,0,0,75776,5,7022989939
9416,6647071041,624964,6647696005,9,0,0,53248,9,8432674983
9417,6647147062,2964055,6650111117,2,0,1,512,2,263581814
9418,6647188153,2805045,6649993198,8,0,1,12288,8,8678804246
9419,6647253259,275601,6647528860,7,0,1,34304,7,2091186264
9420,6647391519,277148,6647668667,2,0,1,52736,2,3206266999
9421,6647411988,926213,6648338201,2,0,0,78336,2,10281638012
9422,6647441534,2980597,6650422131,7,0,1,61440,7,10173069001
9423,6647472500,1106123,6648578623,6,0,1,8192,6,8661740354
9424,6647575539,492871,6648068410,0,0,0,24576,0,5224250725
9425,6647619065,2676545,6650295610,8,0,1,6656,8,3676323863
9426,6647643991,1103060,6648747051,3,0,0,39936,3,8066333080
9427,6647658130,1024245,6648682375,9,0,1,389120,9,8620992676
9428,6647671095,592940,6648264035,7,0,1,10752,7,8800105295
9429,6647684381,901471,6648585852,2,0,0,724992,2,5289140859
9430,6647713876,2767694,6650481570,8,0,0,112128,8,7998196911
9431,6647725765,466728,6648192493,3,0,0,8704,3,2895605433
9432,6647805751,668443,6648474194,1,0,1,3584,1,5781584027
9433,6647858297,2937684,6650795981,6,0,0,140800,6,634845393
9434,6647992383,2932200,6650924583,1,0,1,31232,1,5443028343
9435,6647993788,2932120,6650925908,4,0,1,9216,4,1978828036
9436,6648041057,2924222,6650965279,9,0,1,526848,9,9643201022
9437,6648041991,221902,6648263893,1,0,0,20992,1,2754284112
9438,6648057617,2909229,6650966846,3,0,1,15360,3,10202426651
9439,6648060421,386166,6648446587,0,0,1,149504,0,7424010318
9440,6648083217,509462,6648592679,4,0,0,5632,4,7273070047
9441,6648142771,2873887,6651016658,3,0,1,33280,3,3577438721
9442,6648151575,2649641,6650801216,8,0,1,49664,8,9968837847
9443,6648175442,2657370,6650832812,8,0,0,2048,8,3769430722
9444,6648190304,2368261,6650558565,9,0,0,462848,9,10045519686
9445,6648255515,2232202,6650487717,1,0,0,50176,1,1344556969
9446,6648337556,327381,6648664937,7,0,0,29696,7,3558627370
9447,6648337730,2178841,6650516571,0,0,1,137216,0,9742998302
9448,6648378744,823670,6649202414,5,0,0,65536,5,3198997971
9449,6648381024,173566,6648554590,8,0,0,107008,8,639620190
9450,6648545948,2430173,6650976121,3,0,1,3072,3,9113870992
9451,6648569998,220188,6648790186,1,0,1,14336,1,8119714812
9452,6648585229,2450167,6651035396,7,0,0,19968,7,2625326953
9453,6648602685,2438289,6651040974,6,0,0,5632,6,6807426596
9454,6648604442,2369003,6650973445,9,0,1,50688,9,5739260747
9455,6648663080,2196718,6650859798,1,0,1,28672,1,3398789699
9456,6648682244,2164701,6650846945,1,0,0,84992,1,994679817
9457,6648764175,2073782,6650837957,9,0,0,690176,9,1364893218
9458,6648794004,285690,6649079694,7,0,1,8192,7,7029846878
9459,6648806612,312603,6649119215,1,0,0,39936,1,10141019820
9460,6648948992,407254,6649356246,5,0,0,55296,5,5400639873
9461,6648990709,2310281,6651300990,4,0,1,10752,4,3068181359
9462,6649041680,2261888,6651303568,5,0,0,115200,5,7044770576
9463,6649046355,2187222,6651233577,1,0,0,108544,1,1756526546
9464,6649114902,2171456,6651286358,7,0,0,192512,7,5603451473
9465,6649187319,480068,6649667387,8,0,1,82944,8,2671344430
9466,6649249317,2236685,6651486002,4,0,1,5632,4,543613416
9467,6649278245,2033300,6651311545,1,0,1,21504,1,7125879766
9468,6649306946,2019390,6651326336,6,0,0,158208,6,1769394561
9469,6649386357,360591,6649746948,5,0,1,1024,5,10488005824
9470,6649445629,1981348,6651426977,5,0,0,238080,5,290519700
9471,6649491743,599207,6650090950,6,0,1,16384,6,2104961879
9472,6649530684,384209,6649914893,8,0,0,123392,8,9650359003
9473,6649641975,514502,6650156477,2,0,0,42496,2,3258394852
9474,6649647228,142902,6649790130,7,0,0,78848,7,6875908931
9475,6649705908,297774,6650003682,2,0,0,24064,2,10631522405
9476,6649910304,2432828,6652343132,3,0,1,2560,3,7732717521
9477,6649943844,2436781,6652380625,0,0,1,15360,0,3972038963
9478,6649997439,2338247,6652335686,0,0,1,64000,0,6809031661
9479,6650000896,786647,6650787543,4,0,0,1024,4,6376649731
9480,6650002376,2483399,6652485775,1,0,0,102400,1,5481268870
9481,6650028883,2478735,6652507618,8,0,0,62976,8,10163692973
9482,6650057372,233325,6650290697,6,0,1,23040,6,9418416528
9483,6650073462,2410522,6652483984,7,0,1,22528,7,5545416050
9484,6650088471,234121,6650322592,8,0,0,97280,8,3485487191
9485,6650104982,2249901,6652354883,6,0,1,70144,6,462969399
9486,6650120228,342293,6650462521,8,0,1,39936,8,7800053033
9487,6650122539,2234471,6652357010,9,0,0,281600,9,3537030152
9488,6650178306,2202449,6652380755,9,0,0,601600,9,6859172231
9489,6650289880,2104200,6652394080,5,0,1,6656,5,3363602814
9490,6650294265,2132773,6652427038,2,0,1,38912,2,9877245273
9491,6650320825,2075732,6652396557,4,0,0,3584,4,7086845050
9492,6650342671,1794587,6652137258,3,0,0,17408,3,7244058537
9493,6650405825,1829783,6652235608,5,0,0,151040,5,9369513272
9494,6650412142,298893,6650711035,4,0,1,33792,4,2472927368
9495,6650491520,1832859,6652324379,0,0,0,353280,0,1457556773
9496,6650620186,1800681,6652420867,0,0,0,99328,0,10452696611
9497,6650628287,406684,6651034971,7,0,1,18944,7,1554935222
9498,6650681273,291217,6650972490,1,0,0,92160,1,5004221888
9499,6650694652,1897769,6652592421,5,0,1,3584,5,8799221510
9500,6650721535,311724,6651033259,4,0,0,3584,4,10157664737
9501,6650738421,2101751,6652840172,0,0,1,642048,0,3755629992
9502,6650826272,1961498,6652787770,7,0,0,97280,7,7108788314
9503,6650860877,412568,6651273445,4,0,0,2560,4,1470205599
9504,6650882204,1946017,6652828221,3,0,0,79360,3,712327759
9505,6651038098,239874,6651277972,7,0,0,174592,7,4399418768
9506,6651062588,1950310,6653012898,3,0,0,87552,3,4781790744
9507,6651173828,464083,6651637911,7,0,0,176128,7,7837036289
9508,6651174659,2125837,6653300496,4,0,0,10752,4,8470321673
9509,6651287774,2050462,6653338236,6,0,1,16384,6,4727063853
9510,6651292088,381329,6651673417,8,0,1,1024,8,8736808059
9511,6651295370,2024811,6653320181,3,0,1,13312,3,9975820175
9512,6651516028,1987862,6653503890,1,0,1,3072,1,2546639465
9513,6651553251,493919,6652047170,5,0,1,4608,5,5755813730
9514,6651560545,2042065,6653602610,4,0,0,3072,4,10116406583
9515,6651671139,2009086,6653680225,3,0,1,1536,3,6110289215
9516,6651703365,236437,6651939802,6,0,0,202752,6,4724645366
9517,6651712595,2090981,6653803576,7,0,0,192000,7,6061347794
9518,6651748185,452075,6652200260,2,0,0,479232,2,6116025072
9519,6651754237,2045903,6653800140,4,0,1,10752,4,4595914980
9520,6651816283,796822,6652613105,3,0,0,52736,3,3992948100
9521,6651874115,635397,6652509512,7,0,1,1024,7,4254778519
9522,6652049078,2193870,6654242948,5,0,0,56320,5,4239629323
9523,6652113112,2082649,6654195761,4,0,1,14848,4,8948532337
9524,6652143815,2081829,6654225644,0,0,1,250368,0,6006082248
9525,6652290968,1695954,6653986922,4,0,0,1024,4,7786632819
9526,6652324744,325598,6652650342,9,0,1,76288,9,3728589435
9527,6652343664,1632079,6653975743,0,0,1,49152,0,297559866
9528,6652358521,293107,6652651628,8,0,0,61952,8,4748177271
9529,6652408233,331099,6652739332,4,0,0,4096,4,234330483
9530,6652425130,1745194,6654170324,9,0,1,411648,9,10460091554
9531,6652528023,457147,6652985170,2,0,1,7168,2,5350988922
9532,6652599187,357371,6652956558,9,0,0,41984,9,6531410963
9533,6652621042,1952074,6654573116,9,0,1,113152,9,3425378606
9534,6652681454,1907139,6654588593,7,0,0,99840,7,7278772900
9535,6652688102,1693077,6654381179,6,0,0,216064,6,1064456810
9536,6652689951,1453107,6654143058,1,0,1,2048,1,3711477817
9537,6652821462,1407159,6654228621,0,0,0,28160,0,4333671084
9538,6652907350,1360063,6654267413,7,0,0,257024,7,68500734
9539,6652957588,1199074,6654156662,0,0,1,87552,0,206655407
9540,6653058596,194947,6653253543,3,0,1,6656,3,4487250292
9541,6653059036,1177330,6654236366,4,0,1,68096,4,6313460657
9542,6653114128,364751,6653478879,2,0,1,10752,2,8124529507
9543,6653202271,453848,6653656119,8,0,1,7168,8,8092936413
9544,6653430561,1280351,6654710912,4,0,0,512,4,8953718465
9545,6653437304,1154006,6654591310,7,0,0,369152,7,2613176443
9546,6653497618,1166993,6654664611,2,0,1,45056,2,10599925400
9547,6653508959,644128,6654153087,3,0,1,35328,3,2082793457
9548,6653528235,791776,6654320011,0,0,0,10752,0,9076744357
9549,6653620931,701409,6654322340,5,0,1,5120,5,8216854328
9550,6653626450,626759,6654253209,1,0,0,83968,1,1515783344
9551,6653647663,262140,6653909803,5,0,0,272384,5,3911813745
9552,6653805808,369720,6654175528,3,0,0,255488,3,1336231321
9553,6653884305,198139,6654082444,5,0,0,265728,5,9044260414
9554,6653964232,739072,6654703304,5,0,1,43520,5,3754788745
9555,6653971371,713168,6654684539,7,0,0,179200,7,6960286251
9556,6654010350,265638,6654275988,3,0,1,1536,3,216552246
9557,6654167177,774570,6654941747,6,0,0,9728,6,4062335477
9558,6654188585,369174,6654557759,1,0,1,9216,1,10610531907
9559,6654252607,376994,6654629601,1,0,0,156672,1,1105728895
9560,6654276156,232376,6654508532,6,0,1,26624,6,236617253
9561,6654332700,785872,6655118572,0,0,1,58368,0,6425259432
9562,6654373480,592677,6654966157,9,0,1,137216,9,9997848602
9563,6654401294,601291,6655002585,3,0,0,11776,3,9945941790
9564,6654414768,453372,6654868140,3,0,0,44544,3,6154361232
9565,6654520293,458338,6654978631,6,0,1,7168,6,140645
9566,6654898595,10237,6654908832,2,0,1,36864,2,10004581668
9567,6654988243,83179,6655071422,8,0,1,512,8,3544390206
9568,6655005225,213750,6655218975,8,0,0,16384,8,4057370010
9569,6655015975,357337,6655373312,3,0,0,135168,3,2421496070
9570,6655021844,374681,6655396525,1,0,0,553984,1,8695656197
9571,6655071769,346466,6655418235,8,0,0,79360,8,2821972586
9572,6655097410,346951,6655444361,0,0,0,83968,0,17027781
9573,6655175234,290325,6655465559,1,0,0,68608,1,3514368225
9574,6655253696,210762,6655464458,0,0,1,478720,0,5527888110
9575,6655290882,256497,6655547379,5,0,0,115200,5,1645868219
9576,6655308894,753940,6656062834,6,0,0,223232,6,5563099776
9577,6655401025,621130,6656022155,2,0,1,47616,2,6426135895
9578,6655444368,366613,6655810981,2,0,1,16384,2,8898510611
9579,6655606804,588613,6656195417,4,0,1,33280,4,3545183544
9580,6655661325,388221,6656049546,5,0,1,18944,5,3754125136
9581,6655751848,268151,6656019999,5,0,0,629248,5,4919105260
9582,6655887813,613431,6656501244,0,0,1,3584,0,2265184138
9583,6655896848,391721,6656288569,6,0,0,496128,6,3405586181
9584,6655912318,442279,6656354597,9,0,0,84992,9,10238259900
9585,6655937356,453140,6656390496,2,0,1,4096,2,4458600414
9586,6655945898,451126,6656397024,2,0,0,101888,2,1667520959
9587,6656082421,376214,6656458635,7,0,1,55808,7,10617559213
9588,6656082970,204725,6656287695,1,0,0,199168,1,1355222576
9589,6656178194,134749,6656312943,1,0,1,8192,1,10331507011
9590,6656217933,40964,6656258897,0,0,1,64000,0,9494962978
9591,6656276763,1514,6656278277,1,0,1,512,1,8497756854
9592,6656323352,588055,6656911407,5,0,1,14336,5,10042404925
9593,6656329376,357561,6656686937,0,0,1,58368,0,8385178939
9594,6656382099,308910,6656691009,1,0,1,1024,1,4084674744
9595,6656460012,525423,6656985435,3,0,0,222208,3,529211304
9596,6656535073,508097,6657043170,1,0,1,32768,1,9395858468
9597,6656558982,450190,6657009172,0,0,0,24576,0,2137063068
9598,6656643443,117083,6656760526,5,0,1,512,5,9555068371
9599,6656647864,437771,6657085635,9,0,0,1536,9,5668964730
9600,6656648683,31125,6656679808,0,0,1,700416,0,3373795435
9601,6656831765,382760,6657214525,2,0,1,8704,2,7298864793
9602,6656843547,67993,6656911540,3,0,0,194560,3,467557333
9603,6656941730,12733,6656954463,8,0,0,4608,8,8478973874
9604,6656970537,429625,6657400162,1,0,0,111104,1,9426252551
9605,6657044403,113037,6657157440,8,0,1,11264,8,8518481914
9606,6657075348,76534,6657151882,0,0,0,24576,0,8617357710
9607,6657178700,256349,6657435049,2,0,0,183296,2,10074866151
9608,6657209467,928923,6658138390,8,0,1,17408,8,2212523274
9609,6657215562,272522,6657488084,3,0,0,9728,3,7030457287
9610,6657305095,373473,6657678568,8,0,0,163328,8,9923599680
9611,6657343718,240637,6657584355,1,0,1,4608,1,9809050638
9612,6657405340,258707,6657664047,3,0,1,15872,3,6834776973
9613,6657571835,176541,6657748376,0,0,1,287232,0,9111211509
9614,6657678570,209852,6657888422,2,0,0,290304,2,2554661935
9615,6657692020,423360,6658115380,3,0,0,158208,3,1805685726
9616,6657829755,148804,6657978559,4,0,1,17920,4,8831288536
9617,6657850466,132639,6657983105,2,0,1,13312,2,9263682317
9618,6657931756,274314,6658206070,8,0,0,110080,8,2170922535
9619,6658048302,34363,6658082665,5,0,1,17408,5,9447242062
9620,6658068704,128219,6658196923,8,0,1,9728,8,1199346206
9621,6658088886,120579,6658209465,1,0,1,34304,1,8678041746
9622,6658096107,92787,6658188894,6,0,0,56832,6,10451378191
9623,6658193347,1038,6658194385,5,0,0,150528,5,9320769366
9624,6658288507,327714,6658616221,4,0,0,1024,4,4589356784
9625,6658605720,91386,6658697106,1,0,1,512,1,4212926118
9626,6658614787,12045,6658626832,7,0,1,13312,7,551552780
9627,6658688557,131775,6658820332,8,0,0,19968,8,6148216125
9628,6658851377,115363,6658966740,7,0,0,187904,7,9144227269
9629,6658867100,151431,6659018531,3,0,0,174080,3,8988260773
9630,6658873074,146443,6659019517,4,0,0,1536,4,2476875494
9631,6658880462,88398,6658968860,6,0,1,24576,6,2594623240
9632,6658942256,265784,6659208040,1,0,0,36864,1,9104606708
9633,6659039163,225874,6659265037,8,0,0,369664,8,1173397176
9634,6659046702,232163,6659278865,0,0,0,264192,0,6972140915
9635,6659055888,300924,6659356812,0,0,1,37888,0,7457944347
9636,6659056749,317822,6659374571,9,0,0,88064,9,6197217375
9637,6659074052,454437,6659528489,0,0,1,117248,0,3975581351
9638,6659094876,474107,6659568983,3,0,0,474624,3,2992292343
9639,6659095994,642866,6659738860,5,0,0,66560,5,7594579231
9640,6659174929,356336,6659531265,3,0,1,49664,3,6079010402
9641,6659211903,518141,6659730044,9,0,0,462336,9,10353533338
9642,6659329246,596408,6659925654,6,0,0,155136,6,6103463782
9643,6659349918,442102,6659792020,5,0,0,665600,5,9199444361
9644,6659373697,671343,6660045040,6,0,1,43008,6,3787482710
9645,6659385732,734644,6660120376,0,0,0,318976,0,1555123216
9646,6659421231,756991,6660178222,5,0,0,195072,5,6507157020
9647,6659466043,721938,6660187981,7,0,1,29184,7,4727376880
9648,6659478199,688345,6660166544,6,0,0,80384,6,4084225495
9649,6659516429,348716,6659865145,3,0,1,6656,3,9585827585
9650,6659548696,310258,6659858954,0,0,0,127488,0,3475674958
9651,6659682726,832707,6660515433,5,0,1,8704,5,10384972499
9652,6659903878,225602,6660129480,7,0,0,49664,7,2721476382
9653,6659942900,108978,6660051878,9,0,0,10752,9,3097946608
9654,6660079450,129771,6660209221,7,0,0,166400,7,1999337403
9655,6660197380,724460,6660921840,5,0,0,2048,5,998484363
9656,6660222735,947990,6661170725,8,0,1,20992,8,3362785763
9657,6660228788,216096,6660444884,3,0,0,167936,3,1926773722
9658,6660263551,330519,6660594070,7,0,1,8192,7,6236987220
9659,6660309333,240762,6660550095,1,0,0,350720,1,7953486836
9660,6660312503,307756,6660620259,8,0,0,95232,8,731921250
9661,6660365211,218730,6660583941,7,0,0,102912,7,1613681022
9662,6660373309,288805,6660662114,6,0,0,259584,6,3555697957
9663,6660386142,268464,6660654606,5,0,1,39936,5,9133330212
9664,6660397836,209999,6660607835,5,0,0,6656,5,1234315911
9665,6660539812,210333,6660750145,6,0,0,268800,6,7880393587
9666,6660556362,505450,6661061812,9,0,0,56320,9,6319513773
9667,6660667708,226079,6660893787,1,0,1,7168,1,6408724718
9668,6660724408,431818,6661156226,9,0,1,114176,9,8562506230
9669,6660960009,422166,6661382175,8,0,0,778752,8,2261766909
9670,6660967319,192399,6661159718,6,0,1,7680,6,8927511524
9671,6661004917,478741,6661483658,9,0,1,314368,9,396264424
9672,6661118448,334798,6661453246,9,0,1,171008,9,6868644871
9673,6661196602,215509,6661412111,0,0,0,295936,0,9871703271
9674,6661212142,208769,6661420911,7,0,1,4608,7,2857065032
9675,6661304474,211971,6661516445,4,0,1,49152,4,8767327521
9676,6661347150,142033,6661489183,3,0,0,108544,3,4631930237
9677,6661360406,107324,6661467730,0,0,0,23040,0,818335736
9678,6661397806,807729,6662205535,2,0,1,28672,2,4628293707
9679,6661429220,423587,6661852807,6,0,0,229888,6,10125599869
9680,6661435749,208295,6661644044,3,0,1,52224,3,4446002416
9681,6661532335,416449,6661948784,5,0,1,7680,5,10083424382
9682,6661551871,868396,6662420267,7,0,0,178688,7,2987972973
9683,6661592481,456860,6662049341,8,0,0,28160,8,5653748169
9684,6661613109,282199,6661895308,3,0,0,329728,3,1594811548
9685,6661622759,372232,6661994991,0,0,0,456704,0,10463065332
9686,6661688587,317542,6662006129,1,0,0,44544,1,155547657
9687,6661712483,241065,6661953548,8,0,1,17920,8,7366518192
9688,6661739467,212894,6661952361,2,0,1,11264,2,4192530806
9689,6661773091,744558,6662517649,0,0,0,26112,0,2781862128
9690,6661803208,141904,6661945112,4,0,0,3072,4,1323808620
9691,6661950585,146738,6662097323,2,0,0,162304,2,7293675651
9692,6661953137,423853,6662376990,6,0,0,35328,6,3994948503
9693,6661967741,15058,6661982799,0,0,1,821248,0,8970360761
9694,6662072072,85933,6662158005,1,0,1,29696,1,10698209657
9695,6662125846,410874,6662536720,2,0,1,20992,2,2946381558
9696,6662156705,533373,6662690078,5,0,0,29184,5,1665443030
9697,6662236317,1033386,6663269703,4,0,1,3584,4,6684030660
9698,6662514113,938114,6663452227,6,0,0,143872,6,3672636666
9699,6662800534,238346,6663038880,7,0,1,1536,7,2016713256
9700,6662808599,200042,6663008641,5,0,0,64512,5,9633551823
9701,6662853112,197773,6663050885,1,0,0,21504,1,2926302772
9702,6662856764,206740,6663063504,5,0,0,14848,5,1452471719
9703,6662865082,361327,6663226409,1,0,0,49664,1,5229336883
9704,6662866443,347349,6663213792,3,0,0,260096,3,3639625969
9705,6662889970,214776,6663104746,4,0,1,34816,4,2764938530
9706,6662973473,107217,6663080690,2,0,1,9728,2,9365123560
9707,6663031334,455759,6663487093,8,0,1,6656,8,3435313014
9708,6663192117,377453,6663569570,4,0,1,47104,4,1671116645
9709,6663198210,202991,6663401201,9,0,0,178688,9,4447931865
9710,6663244245,94596,6663338841,9,0,1,108032,9,10446202851
9711,6663248006,60862,6663308868,9,0,1,211456,9,3345564322
9712,6663361573,454877,6663816450,3,0,0,154112,3,2042321386
9713,6663428596,63868,6663492464,7,0,0,98304,7,5304996749
9714,6663556454,530623,6664087077,4,0,1,7168,4,2730033635
9715,6663618934,219103,6663838037,4,0,1,9728,4,2887975957
9716,6663635265,249228,6663884493,2,0,0,56832,2,5857105976
9717,6663651335,367218,6664018553,0,0,0,406016,0,9244756169
9718,6663685549,532883,6664218432,9,0,0,1166848,9,8403977672
9719,6663779592,288875,6664068467,4,0,1,26112,4,2556778777
9720,6664024079,417417,6664441496,6,0,1,1536,6,5665213560
9721,6664037571,813867,6664851438,6,0,1,25600,6,7481689290
9722,6664116107,427856,6664543963,7,0,0,437760,7,2114159962
9723,6664170681,517535,6664688216,3,0,1,53248,3,3317720671
9724,6664316724,319184,6664635908,4,0,0,3584,4,4533735785
9725,6664343190,412365,6664755555,8,0,0,392704,8,10277883781
9726,6664351282,230785,6664582067,1,0,1,26112,1,6697370889
9727,6664623885,43108,6664666993,1,0,0,318976,1,8608017992
9728,6664695941,549617,6665245558,0,0,1,391680,0,1750695121
9729,6664754653,213080,6664967733,3,0,1,22528,3,1463528449
9730,6664840159,135354,6664975513,5,0,0,73728,5,676736389
9731,6664902218,24150,6664926368,2,0,1,512,2,2320009705
9732,6664935079,282181,6665217260,0,0,0,220160,0,4132192687
9733,6664958395,10237,6664968632,4,0,1,9216,4,6962548228
9734,6665120939,641198,6665762137,2,0,0,43520,2,9296115454
9735,6665177527,381563,6665559090,2,0,0,16384,2,10731401425
9736,6665204790,275295,6665480085,8,0,0,445952,8,7648858873
9737,6665242764,145020,6665387784,1,0,1,74752,1,32403090
9738,6665283477,135131,6665418608,3,0,1,6144,3,7978239769
9739,6665291582,326967,6665618549,9,0,1,241664,9,6045721135
9740,6665356570,16609,6665373179,0,0,0,70144,0,7774681047
9741,6665382524,405279,6665787803,8,0,0,52224,8,6095567597
9742,6665570010,26289,6665596299,8,0,1,60416,8,8761704142
9743,6665602903,29202,6665632105,0,0,1,245760,0,4490498894
9744,6665605157,91753,6665696910,2,0,1,38400,2,5338706515
9745,6665607401,316659,6665924060,2,0,0,32256,2,4724543813
9746,6665621773,745994,6666367767,2,0,0,29184,2,10218625062
9747,6665632946,652536,6666285482,6,0,0,24064,6,8088407209
9748,6665791862,497586,6666289448,2,0,0,148480,2,9600876517
9749,6665840469,351344,6666191813,9,0,1,13312,9,10260338965
9750,6665858032,288191,6666146223,9,0,1,328704,9,776514554
9751,6665973422,360982,6666334404,4,0,1,19456,4,3516771104
9752,6666004357,362074,6666366431,7,0,1,16896,7,5910588328
9753,6666006084,261810,6666267894,0,0,1,9216,0,9416411781
9754,6666006313,531767,6666538080,2,0,1,6656,2,3024990374
9755,6666071989,820645,6666892634,8,0,1,8192,8,4223919694
9756,6666106359,423368,6666529727,7,0,0,347136,7,8932748770
9757,6666167496,221871,6666389367,5,0,1,43520,5,3037760794
9758,6666189091,34433,6666223524,9,0,0,87040,9,3077727804
9759,6666252629,29652,6666282281,2,0,1,23040,2,6799563299
9760,6666387871,291352,6666679223,3,0,0,37888,3,7087646921
9761,6666393625,135354,6666528979,7,0,0,12800,7,4947212710
9762,6666428609,215433,6666644042,8,0,0,220160,8,5018235938
9763,6666433387,104979,6666538366,2,0,1,6144,2,6162967257
9764,6666474978,85606,6666560584,2,0,1,12800,2,8759920635
9765,6666558199,92755,6666650954,5,0,0,171008,5,7163296651
9766,6666582078,280919,6666862997,4,0,0,7168,4,6060025938
9767,6666591301,630903,6667222204,7,0,0,53760,7,10164859042
9768,6666788648,268576,6667057224,0,0,0,423936,0,4798018422
9769,6666956419,212252,6667168671,5,0,1,25600,5,3387204964
9770,6667043976,131995,6667175971,0,0,0,213504,0,5284238905
9771,6667146317,32240,6667178557,4,0,0,4096,4,5715472082
9772,6667168485,15666,6667184151,2,0,0,18432,2,9406016163
9773,6667180000,468616,6667648616,1,0,0,762368,1,6633250195
9774,6667262328,520514,6667782842,9,0,0,429568,9,3026429960
9775,6667347076,446084,6667793160,1,0,0,32768,1,339957667
9776,6667393536,410249,6667803785,3,0,0,34304,3,9141134798
9777,6667567669,221636,6667789305,6,0,1,4608,6,1360205483
9778,6667588081,162098,6667750179,1,0,1,4096,1,9141676745
9779,6667607866,296355,6667904221,3,0,0,90112,3,1072091425
9780,6667667750,188345,6667856095,8,0,0,512,8,8204123650
9781,6667722147,104116,6667826263,3,0,1,10752,3,6255634692
9782,6667746104,397905,6668144009,4,0,1,1536,4,5814222283
9783,6667804272,281909,6668086181,4,0,1,5120,4,6967051330
9784,6667849396,212184,6668061580,0,0,0,172544,0,2427328059
9785,6667951437,360928,6668312365,2,0,1,47104,2,9939018503
9786,6667956417,185166,6668141583,5,0,0,586240,5,4802422671
9787,6668022005,359308,6668381313,5,0,0,33280,5,10602684990
9788,6668059286,304140,6668363426,8,0,0,1536,8,4177327386
9789,6668095314,267845,6668363159,1,0,1,52224,1,4100854767
9790,6668108953,200602,6668309555,3,0,1,7168,3,1167231020
9791,6668158918,310908,6668469826,0,0,1,105984,0,7090030176
9792,6668174211,204113,6668378324,6,0,0,154624,6,5522722907
9793,6668202120,142433,6668344553,6,0,0,77312,6,1318229743
9794,6668263819,193083,6668456902,4,0,0,5632,4,7310948435
9795,6668268736,65703,6668334439,2,0,0,207360,2,3214843937
9796,6668396782,356514,6668753296,8,0,0,1024,8,2686351707
9797,6668601267,182478,6668783745,3,0,1,13312,3,7833025332
9798,6668674049,377321,6669051370,6,0,0,611328,6,9745044410
9799,6668778309,234091,6669012400,4,0,1,12800,4,8957867894
9800,6668849460,181195,6669030655,3,0,0,113152,3,6557839561
9801,6668861987,318744,6669180731,4,0,1,512,4,9462666906
9802,6668903022,290773,6669193795,8,0,0,1024,8,10045406735
9803,6669094207,200578,6669294785,9,0,1,41472,9,8761587901
9804,6669192272,136900,6669329172,5,0,1,38912,5,9598095500
9805,6669211141,153537,6669364678,5,0,0,248832,5,4547193139
9806,6669211334,33363,6669244697,1,0,1,51712,1,2182896614
9807,6669332941,289193,6669622134,4,0,0,2560,4,8512097811
9808,6669564570,265946,6669830516,5,0,0,431104,5,4874743901
9809,6669596213,271310,6669867523,0,0,0,128000,0,9328326634
9810,6669702133,182069,6669884202,3,0,0,55296,3,9272797055
9811,6669714816,210911,6669925727,7,0,0,133120,7,9841412725
9812,6669845031,81042,6669926073,6,0,0,512,6,6189958652
9813,6669918335,135355,6670053690,5,0,1,35840,5,7155401206
9814,6670008814,276391,6670285205,2,0,1,24576,2,1230972857
9815,6670079381,185462,6670264843,3,0,0,301056,3,5289324827
9816,6670157025,32812,6670189837,8,0,1,58880,8,9277983460
9817,6670252956,12991,6670265947,5,0,0,53760,5,9082066191
9818,6670270600,228361,6670498961,8,0,1,11264,8,5427921971
9819,6670326681,1038,6670327719,7,0,1,19456,7,6446473217
9820,6670342685,153354,6670496039,5,0,0,25088,5,282672221
9821,6670406228,45433,6670451661,5,0,0,1024,5,5986362968
9822,6670413526,66717,6670480243,7,0,1,69632,7,7023432118
9823,6670449189,314627,6670763816,2,0,0,78336,2,7741476309
9824,6670503082,162189,6670665271,0,0,0,113152,0,6008703719
9825,6670535913,10753,6670546666,6,0,1,2560,6,2713939046
9826,6670691893,11793,6670703686,5,0,0,17408,5,1427917024
9827,6670692159,335475,6671027634,8,0,0,2048,8,9365299412
9828,6670695204,287402,6670982606,0,0,1,114176,0,7329329009
9829,6670700831,207762,6670908593,0,0,1,251904,0,5314491934
9830,6670828426,412120,6671240546,3,0,1,70144,3,5443192821
9831,6670916717,196253,6671112970,5,0,0,243200,5,8183192117
9832,6671048988,90714,6671139702,5,0,0,48640,5,3433153827
9833,6671087250,147029,6671234279,5,0,1,3072,5,11837959
9834,6671250608,94596,6671345204,1,0,0,154112,1,5198169372
9835,6671262402,114983,6671377385,9,0,0,104960,9,3288356851
9836,6671379772,562,6671380334,3,0,1,1536,3,3372211723
9837,6671452923,97675,6671550598,8,0,0,512,8,9394887297
9838,6671545519,110080,6671655599,8,0,1,15360,8,10448860199
9839,6671568204,12733,6671580937,8,0,1,61440,8,3976973193
9840,6671700385,182562,6671882947,0,0,0,24576,0,2009641790
9841,6671711922,115344,6671827266,2,0,1,20480,2,1736584723
9842,6671725249,211128,6671936377,5,0,0,182272,5,241628659
9843,6671917402,6678,6671924080,4,0,0,1024,4,3758345736
9844,6671934545,57436,6671991981,2,0,1,4608,2,7510157908
9845,6672013159,91744,6672104903,1,0,1,16384,1,9832099007
9846,6672059372,54052,6672113424,5,0,1,33792,5,5935819573
9847,6672084588,44124,6672128712,4,0,1,3584,4,7590025236
9848,6672102933,101656,6672204589,7,0,0,68608,7,2452907803
9849,6672137727,102511,6672240238,5,0,0,337920,5,2852111701
9850,6672241582,207046,6672448628,5,0,1,36352,5,5062144672
9851,6672348343,167192,6672515535,5,0,0,275456,5,824426390
9852,6672401324,36083,6672437407,2,0,1,41984,2,8385978974
9853,6672536861,298517,6672835378,9,0,0,63488,9,566878025
9854,6672605829,412218,6673018047,0,0,1,225792,0,691157046
9855,6672663448,487097,6673150545,0,0,1,271360,0,3609216497
9856,6672683830,486534,6673170364,0,0,1,95232,0,3868340761
9857,6672687522,535585,6673223107,2,0,1,28160,2,715988916
9858,6672727982,568304,6673296286,0,0,1,209920,0,3783617546
9859,6672849710,370229,6673219939,0,0,1,31744,0,10627939422
9860,6672886284,198667,6673084951,2,0,1,14336,2,314875715
9861,6672964455,417589,6673382044,2,0,1,69120,2,8443341501
9862,6673058949,323915,6673382864,6,0,1,3584,6,853652821
9863,6673252624,3894,6673256518,5,0,1,40448,5,3942733185
9864,6673329935,139422,6673469357,1,0,0,4096,1,5780820543
9865,6673380268,74182,6673454450,3,0,0,101376,3,7870744291
9866,6673401699,56297,6673457996,8,0,0,5632,8,7154103813
9867,6673424209,35093,6673459302,9,0,0,2048,9,323318096
9868,6673459737,133220,6673592957,7,0,1,22016,7,9980592500
9869,6673464764,237024,6673701788,7,0,1,62976,7,3512551366
9870,6673620786,84765,6673705551,8,0,1,12288,8,1303489952
9871,6673687268,152046,6673839314,0,0,0,217088,0,858105986
9872,6673873374,10495,6673883869,6,0,0,16896,6,3304219066
9873,6673951681,71308,6674022989,6,0,1,14848,6,1059295216
9874,6673955994,78167,6674034161,1,0,1,6144,1,7843875338
9875,6674011981,135878,6674147859,3,0,1,1536,3,1548082383
9876,6674135128,107734,6674242862,9,0,0,179712,9,4326268441
9877,6674365369,70545,6674435914,7,0,1,5632,7,3598834039
9878,6674389643,129149,6674518792,1,0,1,49664,1,7429628735
9879,6674399370,481842,6674881212,5,0,0,784896,5,9714665688
9880,6674406206,448483,6674854689,9,0,1,257024,9,5907065937
9881,6674433715,441327,6674875042,6,0,0,1536,6,292376385
9882,6674441537,599683,6675041220,8,0,0,1024,8,3463757477
9883,6674453178,512818,6674965996,9,0,0,658944,9,4195468046
9884,6674502286,635774,6675138060,8,0,1,30208,8,326959704
9885,6674651152,286108,6674937260,1,0,1,12288,1,7342899713
9886,6674700511,116128,6674816639,7,0,1,27136,7,1962870116
9887,6674767559,96582,6674864141,9,0,1,406528,9,9583885645
9888,6674803190,64257,6674867447,2,0,0,512,2,4971638075
9889,6674819067,42699,6674861766,9,0,1,282112,9,8312330303
9890,6674832826,43394,6674876220,1,0,1,26112,1,10467181571
9891,6674859180,623427,6675482607,6,0,1,48640,6,3148309060
9892,6674862567,254022,6675116589,0,0,1,202752,0,4140654071
9893,6674999706,133507,6675133213,7,0,0,86016,7,493242763
9894,6675019918,597511,6675617429,8,0,0,1024,8,5750149858
9895,6675078472,707578,6675786050,9,0,0,92672,9,126862477
9896,6675102296,227548,6675329844,6,0,0,3584,6,8938197727
9897,6675104187,776145,6675880332,8,0,0,4096,8,153194774
9898,6675136991,256437,6675393428,3,0,0,340992,3,2046840597
9899,6675257517,991326,6676248843,6,0,0,4608,6,8796481895
9900,6675299108,246311,6675545419,5,0,0,111104,5,8150021736
9901,6675329069,975255,6676304324,1,0,1,92672,1,9772949271
9902,6675382286,474535,6675856821,9,0,0,308224,9,5069242090
9903,6675413292,255314,6675668606,7,0,0,160768,7,281953979
9904,6675548317,232414,6675780731,5,0,0,372224,5,9283862990
9905,6675571436,978144,6676549580,6,0,0,1536,6,3436349369
9906,6675647041,208875,6675855916,4,0,1,6656,4,5264186756
9907,6675652514,124544,6675777058,9,0,0,185344,9,6068680994
9908,6675739431,119455,6675858886,6,0,0,4096,6,5841803700
9909,6675739496,310674,6676050170,9,0,1,310784,9,2948612439
9910,6675778988,374435,6676153423,0,0,1,38912,0,1015326695
9911,6675801239,431879,6676233118,5,0,0,181248,5,3209398893
9912,6675807248,326608,6676133856,4,0,1,38912,4,2529444910
9913,6675916708,191860,6676108568,9,0,0,532480,9,6558758413
9914,6675974958,124752,6676099710,3,0,1,67072,3,320753772
9915,6675983007,235813,6676218820,1,0,1,23040,1,4385293644
9916,6676062695,43366,6676106061,3,0,0,37376,3,5405750414
9917,6676075496,689475,6676764971,7,0,1,17408,7,1509025035
9918,6676077393,61454,6676138847,8,0,1,31744,8,4481614341
9919,6676121561,376711,6676498272,7,0,1,61440,7,5870854327
9920,6676130981,499080,6676630061,8,0,0,13824,8,7590937977
9921,6676281610,527576,6676809186,7,0,0,74240,7,9271316844
9922,6676369616,399712,6676769328,6,0,0,2048,6,4167990897
9923,6676386372,141310,6676527682,4,0,1,29696,4,4755412224
9924,6676398177,81743,6676479920,6,0,1,26624,6,8863871123
9925,6676416378,50995,6676467373,9,0,0,212480,9,8803215027
9926,6676427424,52246,6676479670,0,0,1,126464,0,3913664042
9927,6676428682,49181,6676477863,1,0,1,7680,1,6994629021
9928,6676497450,34119,6676531569,3,0,0,78336,3,8900785898
9929,6676560484,340770,6676901254,5,0,1,14848,5,3695938016
9930,6676588113,14541,6676602654,9,0,0,82432,9,9592449268
9931,6676593564,2942,6676596506,9,0,1,679424,9,7121457952
9932,6676612579,470494,6677083073,5,0,0,81920,5,1347463460
9933,6676616630,471595,6677088225,8,0,0,1536,8,5113743853
9934,6676633318,650666,6677283984,6,0,0,2560,6,5420717603
9935,6676763797,306611,6677070408,5,0,0,28160,5,1796457282
9936,6676816907,95780,6676912687,1,0,1,37888,1,772226929
9937,6676827813,834961,6677662774,6,0,0,3072,6,5509827548
9938,6676876649,872640,6677749289,9,0,1,368640,9,10279668698
9939,6677100239,171087,6677271326,2,0,1,18432,2,10700276164
9940,6677114438,754804,6677869242,1,0,0,145408,1,1270229454
9941,6677231126,383237,6677614363,3,0,1,1536,3,921574258
9942,6677242088,284764,6677526852,6,0,1,30720,6,1626416516
9943,6677248235,276208,6677524443,0,0,0,186880,0,8963887722
9944,6677272958,544994,6677817952,1,0,1,21504,1,4273596778
9945,6677308210,348266,6677656476,8,0,1,36864,8,10193451344
9946,6677335911,457694,6677793605,6,0,1,4096,6,4783713888
9947,6677346719,451585,6677798304,0,0,0,118272,0,10343379604
9948,6677363398,242894,6677606292,8,0,1,26624,8,5143465418
9949,6677378011,373300,6677751311,4,0,1,8704,4,3970018426
9950,6677387066,528271,6677915337,1,0,1,26624,1,8755428899
9951,6677411891,431899,6677843790,8,0,1,35328,8,646198636
9952,6677488404,455283,6677943687,7,0,0,122368,7,530758367
9953,6677684052,216632,6677900684,9,0,0,339456,9,9678795521
9954,6677738967,204061,6677943028,5,0,0,145408,5,267139003
9955,6677770947,174330,6677945277,1,0,1,10240,1,3255067391
9956,6677774395,146358,6677920753,1,0,0,18944,1,7437351899
9957,6677828391,2466,6677830857,0,0,0,83456,0,8336238606
9958,6677866267,242318,6678108585,7,0,1,32768,7,1400064759
9959,6677912815,384876,6678297691,3,0,1,4096,3,3426797051
9960,6677927066,7226,6677934292,3,0,1,25600,3,5424248874
9961,6677949717,366255,6678315972,9,0,1,31744,9,8963040250
9962,6677991331,360425,6678351756,4,0,0,2560,4,1243762211
9963,6678023220,262315,6678285535,6,0,1,10752,6,7503022914
9964,6678039619,293005,6678332624,7,0,1,17920,7,3223154443
9965,6678046861,122387,6678169248,6,0,1,14336,6,4429864083
9966,6678097145,72428,6678169573,0,0,1,151552,0,1634215134
9967,6678184906,76727,6678261633,6,0,1,34304,6,1428911070
9968,6678209339,71034,6678280373,2,0,1,1536,2,10187049093
9969,6678225508,357179,6678582687,7,0,1,4608,7,724398726
9970,6678231361,514290,6678745651,8,0,0,7680,8,3254310459
9971,6678238656,239914,6678478570,3,0,0,198144,3,2144011085
9972,6678289281,431274,6678720555,4,0,0,1024,4,5657779027
9973,6678291498,278952,6678570450,9,0,0,23040,9,3983641137
9974,6678322908,156808,6678479716,5,0,0,90112,5,7148117311
9975,6678334318,242695,6678577013,7,0,1,61440,7,7061166600
9976,6678384635,402570,6678787205,1,0,1,65024,1,4867116352
9977,6678391409,146271,6678537680,7,0,0,258560,7,6537930085
9978,6678407277,102733,6678510010,8,0,1,16896,8,6212910804
9979,6678441216,49035,6678490251,5,0,0,111104,5,3447492700
9980,6678484765,279653,6678764418,3,0,0,23040,3,2076129572
9981,6678549015,50477,6678599492,0,0,0,47104,0,1640492578
9982,6678601366,2942,6678604308,3,0,1,27648,3,3998876002
9983,6678613822,13337,6678627159,9,0,0,50176,9,10424108994
9984,6678665138,199310,6678864448,6,0,0,3072,6,4266813583
9985,6678670576,193028,6678863604,3,0,1,73216,3,6818160980
9986,6678673936,161304,6678835240,7,0,0,22528,7,7684081150
9987,6678676702,338365,6679015067,6,0,1,44032,6,6729662233
9988,6678718421,606823,6679325244,3,0,1,32768,3,10063199689
9989,6678741525,345012,6679086537,7,0,1,35328,7,8625314572
9990,6678773238,358016,6679131254,9,0,0,583680,9,3502852512
9991,6678783038,377474,6679160512,7,0,1,3584,7,4899832974
9992,6678783247,380393,6679163640,0,0,0,105984,0,1952757383
9993,6678816520,313252,6679129772,5,0,1,7680,5,5250544644
9994,6678818475,273766,6679092241,5,0,1,56320,5,4155018733
9995,6678881442,299382,6679180824,5,0,0,99328,5,7887994940
9996,6678952085,271258,6679223343,9,0,0,99840,9,1967804554
9997,6678989653,612160,6679601813,7,0,0,204288,7,1595926257
9998,6679019083,626868,6679645951,6,0,0,2048,6,611365143
9999,6679042669,433071,6679475740,7,0,1,28160,7,3982739470
