RequestID,ArrivalTime,DelayTime,FinishTime,InitiatorID,TargetID,IOType,Size,VolumeID,Offset
0,0,22714,22714,0,0,1,36864,6,9602594624
1,1,159231,159232,9,0,0,89088,10,449795165
2,2,106442,106444,8,0,0,1536,12,2477406860
3,3,46305,46308,1,0,1,60928,23,8110211987
4,4,84780,84784,4,0,0,1024,9,6709165383
5,5,102355,102360,3,0,1,117248,28,6862509473
6,6,107180,107186,7,0,1,7680,14,3984398568
7,7,113490,113497,2,0,1,30208,0,4950294596
8,8,114257,114265,6,0,1,11776,19,7305981492
9,9,118762,118771,5,0,1,7168,1,6149075115
10,10090,110307,120397,9,0,1,2560,10,2017826735
11,37460,173797,211257,3,0,1,210944,28,2517568897
12,51381,363126,414507,7,0,0,3072,14,9858947189
13,62460,111728,174188,9,0,0,2048,10,2977487182
14,91540,126233,217773,2,0,1,23040,0,5991034154
15,128410,105018,233428,2,0,1,50176,0,2426141871
16,168860,66156,235016,7,0,1,15872,14,8089268413
17,177940,79093,257033,3,0,1,72704,28,2452777535
18,184160,258119,442279,4,0,0,512,9,4673174021
19,228960,28534,257494,9,0,1,10240,10,561225784
20,233910,24890,258800,9,0,1,2048,10,8844776271
21,235591,210417,446008,7,0,0,512,14,1224693795
22,250940,8116,259056,3,0,1,9216,28,9260596801
23,276640,145912,422552,3,0,1,240640,28,5950388489
24,281130,146248,427378,3,0,1,7680,28,1705518604
25,287580,320714,608294,8,0,0,512,12,7716507150
26,299080,364422,663502,8,0,0,512,12,3815202222
27,307320,355684,663004,9,0,0,73728,10,6984492952
28,318520,112404,430924,7,0,1,5632,14,9504979300
29,319581,275785,595366,3,0,0,1536,28,3457287750
30,376301,243695,619996,7,0,0,5632,14,2427631197
31,378791,143080,521871,3,0,0,4608,28,10120399157
32,397040,39376,436416,6,0,1,17920,19,4844488831
33,408580,31382,439962,6,0,1,5632,19,3538277378
34,417520,24068,441588,5,0,1,2560,1,3443946854
35,436841,159324,596165,7,0,0,2048,14,2968581685
36,450080,50999,501079,0,0,1,82432,6,5610454788
37,457870,49110,506980,6,0,1,19968,19,8161614228
38,460691,227081,687772,7,0,0,1536,14,8274610348
39,475530,33396,508926,2,0,1,3072,0,10315781787
40,497080,12102,509182,9,0,1,9216,10,9103954181
41,523260,140071,663331,4,0,0,1024,9,9401384897
42,530720,7230,537950,0,0,1,7680,6,6739056118
43,543450,210801,754251,8,0,0,2048,12,8567643724
44,586270,84733,671003,3,0,1,138240,28,5076481498
45,591470,402384,993854,3,0,1,591360,28,1630600133
46,639570,425753,1065323,8,0,0,1536,12,3961125643
47,710220,279448,989668,4,0,0,2560,9,9072214780
48,720690,283584,1004274,9,0,1,41472,10,2601711473
49,738680,353521,1092201,3,0,1,289792,28,5823016027
50,745871,554669,1300540,3,0,0,512,28,6986532779
51,747760,350342,1098102,0,0,1,19968,6,9659091123
52,748180,354428,1102608,0,0,1,7168,6,3100575344
53,808380,299413,1107793,5,0,1,16384,1,1152341313
54,825700,283399,1109099,6,0,1,2048,19,426637634
55,837931,528174,1366105,3,0,0,7680,28,9452251672
56,863630,302598,1166228,3,0,1,183296,28,4423280155
57,878240,289268,1167508,0,0,1,14336,6,5012633926
58,889840,293323,1183163,0,0,1,58368,6,717865887
59,900050,334378,1234428,8,0,0,512,12,1601806225
60,941930,421820,1363750,9,0,0,123392,10,6765367348
61,955430,239075,1194505,0,0,1,46080,6,5348536328
62,974680,224651,1199331,9,0,1,7680,10,4821110454
63,993910,411708,1405618,9,0,0,118272,10,8265838400
64,1006730,193472,1200202,0,0,1,12288,6,10572069340
65,1008130,192328,1200458,5,0,1,9216,1,7141941117
66,1015330,185487,1200817,0,0,1,9728,6,6357052555
67,1081330,120473,1201803,5,0,1,1536,1,1781422431
68,1113640,292165,1405805,4,0,0,512,9,659847327
69,1139800,304940,1444740,9,0,0,27136,10,5199313444
70,1144020,59089,1203109,2,0,1,2048,0,248748039
71,1184990,61382,1246372,3,0,1,99328,28,2876836080
72,1199030,59196,1258226,5,0,1,48640,1,4536223784
73,1210980,47502,1258482,0,0,1,9216,6,7905315612
74,1241900,20128,1262028,0,0,1,5632,6,757937044
75,1267030,4374,1271404,2,0,1,4608,0,283735810
76,1385740,46503,1432243,5,0,1,48128,1,582438429
77,1386560,218535,1605095,4,0,0,2560,9,8806475401
78,1419820,24935,1444755,5,0,1,22016,1,9156895239
79,1443830,149034,1592864,4,0,0,512,9,8983411660
80,1457081,201925,1659006,7,0,0,1536,14,6626548601
81,1482600,6229,1488829,2,0,1,15360,0,7999219925
82,1506320,12308,1518628,2,0,1,20480,0,6353356872
83,1525520,13253,1538773,2,0,1,25600,0,10580945806
84,1526370,400786,1927156,9,0,0,32256,10,6405795255
85,1546891,237294,1784185,7,0,0,4608,14,6541773172
86,1561910,1042,1562952,0,0,1,1024,6,4384995088
87,1562959,290535,1853494,5,0,0,119296,1,2260028934
88,1590340,579275,2169615,8,0,0,1024,12,4280726519
89,1628290,111768,1740058,4,0,0,4096,9,5617811635
90,1640620,528660,2169280,9,0,0,210432,10,10214921609
91,1642880,94600,1737480,3,0,1,154112,28,6456530198
92,1691850,216313,1908163,4,0,0,2048,9,5177343082
93,1712689,691001,2403690,5,0,0,420352,1,1455240475
94,1767440,1042,1768482,0,0,1,1024,6,5829519482
95,1805850,5802,1811652,2,0,1,6144,0,561123266
96,1825260,345166,2170426,4,0,0,512,9,7646842099
97,1850481,554870,2405351,7,0,0,2560,14,263979269
98,1875620,1042,1876662,2,0,1,1024,0,10130766381
99,1891850,4850,1896700,0,0,1,5120,6,7297911379
100,1894040,381543,2275583,9,0,0,68096,10,8262446429
101,1901220,4374,1905594,2,0,1,4608,0,7253108306
102,1932139,488391,2420530,5,0,0,49664,1,1782822707
103,1937391,131014,2068405,3,0,0,2560,28,8972562630
104,1947220,11016,1958236,5,0,1,17920,1,5757434045
105,1948420,531725,2480145,9,0,0,195584,10,6766598125
106,1967720,4937,1972657,5,0,1,12800,1,980310639
107,2005291,164666,2169957,7,0,0,1024,14,4004892406
108,2051280,3898,2055178,1,0,1,4096,23,41074889
109,2060900,15837,2076737,3,0,1,30720,28,2259818061
110,2066770,16880,2083650,9,0,1,22528,10,1006238737
111,2076690,327826,2404516,8,0,0,1024,12,6869385113
112,2078050,91580,2169630,3,0,1,124928,28,3056755509
113,2091140,89017,2180157,2,0,1,16384,0,7015353190
114,2170140,234049,2404189,8,0,0,1536,12,7150842686
115,2171180,18872,2190052,5,0,1,29184,1,9606194797
116,2185609,305159,2490768,5,0,0,34816,1,5358690146
117,2249190,4374,2253564,6,0,1,4608,19,10162493143
118,2259940,289192,2549132,1,0,1,236544,23,10614341866
119,2267720,286238,2553958,2,0,1,7680,0,9973085975
120,2303030,262782,2565812,1,0,1,48640,23,7006193756
121,2303920,262878,2566798,5,0,1,1536,1,7651266136
122,2313250,263866,2577116,1,0,1,32768,23,9248488960
123,2321931,210038,2531969,3,0,0,3072,28,8604677313
124,2331640,205458,2537098,4,0,0,512,9,4337569298
125,2346669,247199,2593868,5,0,0,8192,1,10231711922
126,2347160,235653,2582813,5,0,1,18944,1,6052528165
127,2378859,316003,2694862,5,0,0,6656,1,2452581245
128,2384350,204160,2588510,0,0,1,18944,6,6291172975
129,2395900,193276,2589176,5,0,1,1024,1,2482679282
130,2424790,170697,2595487,3,0,1,22016,28,4897718397
131,2425550,175634,2601184,1,0,1,27136,23,4396457599
132,2444170,158602,2602772,1,0,1,15872,23,628008875
133,2480770,133446,2614216,6,0,1,38400,19,6547751473
134,2495351,587769,3083120,7,0,0,3072,14,9443904618
135,2498160,366685,2864845,9,0,0,75776,10,817471243
136,2536090,79202,2615292,9,0,1,13312,10,6333742617
137,2547010,411597,2958607,9,0,0,115200,10,5926549843
138,2564750,51618,2616368,6,0,1,13312,19,1507018069
139,2565291,164723,2730014,3,0,0,7168,28,539355514
140,2566200,56069,2622269,0,0,1,19968,6,2427001912
141,2601940,21200,2623140,0,0,1,12288,6,9494663100
142,2603070,20838,2623908,6,0,1,11776,19,273049675
143,2610410,185983,2796393,1,0,1,302080,23,1663826741
144,2613390,183669,2797059,0,0,1,1024,6,3852058979
145,2634990,162735,2797725,6,0,1,1024,19,5568831420
146,2656061,304433,2960494,7,0,0,6144,14,1370233465
147,2657650,155730,2813380,1,0,1,58368,23,7707149712
148,2676089,188771,2864860,1,0,1,134656,23,2816673351
149,2729250,135625,2864875,0,0,1,6144,6,3998578717
150,2731520,133370,2864890,6,0,1,4608,19,937304232
151,2734420,132953,2867373,0,0,1,17408,6,5892549874
152,2735100,143819,2878919,0,0,1,47104,6,9858245261
153,2742280,137625,2879905,5,0,1,1536,1,8746672127
154,2763159,270241,3033400,5,0,0,53760,1,1733377008
155,2777060,104023,2881083,1,0,1,13824,23,396563878
156,2809300,245612,3054912,3,0,1,401408,28,3155767785
157,2869340,238490,3107830,3,0,1,171520,28,10284247069
158,2880550,243333,3123883,4,0,0,512,9,3328046546
159,2887391,384293,3271684,3,0,0,1024,28,1009010828
160,2957240,155096,3112336,9,0,1,7168,10,9722092293
161,2972500,417491,3389991,8,0,0,1536,12,1562078625
162,3038520,116058,3154578,3,0,1,144896,28,1812944743
163,3044240,115932,3160172,3,0,1,26624,28,3623919779
164,3062480,140241,3202721,3,0,1,138240,28,8074020716
165,3062860,150824,3213684,4,0,0,512,9,4824561299
166,3067630,138957,3206587,6,0,1,6144,19,9254724957
167,3108910,128629,3237539,1,0,1,107008,23,5830473245
168,3113050,491899,3604949,8,0,0,95744,12,2981749994
169,3136220,278845,3415065,4,0,0,2048,9,10120046234
170,3165370,88439,3253809,3,0,1,53248,28,8685770774
171,3198261,285247,3483508,3,0,0,2560,28,5281570219
172,3201480,57475,3258955,0,0,1,8192,6,3599834122
173,3209709,51512,3261221,1,0,1,3584,23,3078316594
174,3225721,256013,3481734,7,0,0,3072,14,25421255
175,3259171,171973,3431144,3,0,0,4608,28,6997354640
176,3275040,585679,3860719,8,0,0,196096,12,1211573698
177,3277490,15321,3292811,0,0,1,29696,6,10003372810
178,3298080,55304,3353384,3,0,1,94208,28,3264899757
179,3307330,319099,3626429,1,0,1,489984,23,7364376057
180,3475850,150925,3626775,6,0,1,512,19,746453425
181,3547490,362117,3909607,8,0,0,23552,12,10737406236
182,3552600,349816,3902416,9,0,0,136704,10,5028540200
183,3564960,651611,4216571,9,0,0,143872,10,6166965163
184,3613960,699875,4313835,4,0,0,1024,9,660608255
185,3643710,427540,4071250,4,0,0,2048,9,2638736590
186,3665869,570232,4236101,5,0,0,63488,1,7808140187
187,3684260,176474,3860734,1,0,1,224768,23,1399430083
188,3691790,168959,3860749,0,0,1,7680,6,2365206443
189,3696780,606181,4302961,8,0,0,164864,12,9157299983
190,3747229,323367,4070596,5,0,0,58880,1,6249583363
191,3757730,151892,3909622,0,0,1,54784,6,8783991862
192,3766191,335871,4102062,7,0,0,2048,14,2583297677
193,3770350,139287,3909637,0,0,1,24064,6,1207144269
194,3781870,434872,4216742,4,0,0,512,9,6453723766
195,3916030,41391,3957421,1,0,1,67072,23,2599209726
196,3935210,135401,4070611,3,0,1,211968,28,567198730
197,3951529,570543,4522072,5,0,0,103936,1,5852227358
198,3969080,333904,4302984,3,0,1,437248,28,2906004889
199,3984550,318449,4302999,3,0,1,5120,28,455914959
200,3991950,311064,4303014,0,0,1,2048,6,9974309272
201,4009290,333355,4342645,4,0,0,1024,9,3235783352
202,4012850,290179,4303029,0,0,1,29696,6,4306392055
203,4061961,460290,4522251,7,0,0,512,14,6553767829
204,4067271,466975,4534246,7,0,0,6656,14,4083413890
205,4156520,545685,4702205,9,0,0,167424,10,659276894
206,4254020,61793,4315813,3,0,1,21504,28,6573261482
207,4329490,7706,4337196,3,0,1,8192,28,1991167804
208,4330770,8052,4338822,3,0,1,2560,28,5320944552
209,4346480,233231,4579711,4,0,0,1536,9,4217901403
210,4406270,382755,4789025,4,0,0,1536,9,328763930
211,4457400,475326,4932726,1,0,0,206848,23,5765718252
212,4467860,721537,5189397,9,0,0,96256,10,9217736873
213,4502359,201281,4703640,5,0,0,4608,1,1077494984
214,4516350,525402,5041752,9,0,0,211456,10,6721906306
215,4546830,395044,4941874,9,0,0,26112,10,7542042832
216,4551181,381911,4933092,7,0,0,1024,14,7640154298
217,4552270,519495,5071765,9,0,0,96256,10,8129668281
218,4593639,383662,4977301,5,0,0,116224,1,5060769538
219,4630471,303424,4933895,7,0,0,2560,14,8984650846
220,4640850,511412,5152262,8,0,0,75264,12,4351093272
221,4666470,614135,5280605,9,0,0,140288,10,10512619782
222,4667820,723622,5391442,4,0,0,3072,9,9634702379
223,4710711,331680,5042391,7,0,0,2048,14,4373149691
224,4756789,772162,5528951,5,0,0,121856,1,3585089953
225,4757190,439049,5196239,4,0,0,1536,9,6087961449
226,4868360,64389,4932749,3,0,1,5632,28,394599050
227,4871350,620442,5491792,8,0,0,104448,12,2392772233
228,4881011,708276,5589287,7,0,0,1024,14,4669717565
229,4891730,150684,5042414,3,0,1,58368,28,8239589845
230,4897859,716766,5614625,5,0,0,71680,1,3674080651
231,4903511,738000,5641511,7,0,0,1024,14,5115178547
232,4984060,89658,5073718,3,0,1,2048,28,9734788284
233,5029920,44144,5074064,7,0,1,512,14,911708417
234,5079500,5326,5084826,3,0,1,5632,28,127523442
235,5094000,13083,5107083,6,0,1,22016,19,8378511937
236,5107801,616969,5724770,7,0,0,2048,14,9015519484
237,5116711,221161,5337872,7,0,0,512,14,8105363877
238,5123519,600612,5724131,5,0,0,193024,1,7991870065
239,5168091,495110,5663201,7,0,0,512,14,814918714
240,5185669,392141,5577810,5,0,0,160256,1,10495032226
241,5250140,596644,5846784,8,0,0,121344,12,650788577
242,5284031,298993,5583024,7,0,0,1024,14,3955241947
243,5290030,519767,5809797,1,0,0,37376,23,3273161593
244,5339180,389737,5728917,4,0,0,8704,9,611837773
245,5359339,302717,5662056,5,0,0,18432,1,875422156
246,5364960,392337,5757297,1,0,0,66560,23,8802461633
247,5398810,13512,5412322,3,0,1,26112,28,2397243963
248,5452870,404708,5857578,8,0,0,5632,12,7426377781
249,5481520,374327,5855847,1,0,0,29696,23,2059068613
250,5484200,93625,5577825,7,0,1,13312,14,10160956404
251,5521490,405158,5926648,8,0,0,62976,12,919841397
252,5544050,70590,5614640,3,0,1,41472,28,424731407
253,5580000,218374,5798374,4,0,0,1024,9,8911392419
254,5659940,64845,5724785,8,0,1,25600,12,6485497647
255,5683889,325770,6009659,5,0,0,25600,1,5396854907
256,5692890,64422,5757312,6,0,1,23552,19,7843445864
257,5715869,267613,5983482,5,0,0,71168,1,9099943979
258,5765190,16354,5781544,7,0,1,31744,14,2518738064
259,5843830,19066,5862896,7,0,1,5632,14,4131780109
260,5862990,205705,6068695,8,0,0,3072,12,5211832712
261,5883980,402001,6285981,9,0,0,165888,10,5135836206
262,5897930,735666,6633596,1,0,0,191488,23,5572085910
263,5906040,202790,6108830,8,0,0,75776,12,10051868525
264,5907961,235819,6143780,2,0,0,60416,0,5823896245
265,5983330,665101,6648431,8,0,0,48640,12,4948147484
266,6051940,306076,6358016,1,0,0,70656,23,2599654357
267,6070031,373253,6443284,2,0,0,126976,0,1330679737
268,6151051,343797,6494848,2,0,0,84480,0,9913999779
269,6230409,617267,6847676,5,0,0,266752,1,562019039
270,6236889,696469,6933358,5,0,0,246272,1,5464038490
271,6287530,391056,6678586,4,0,0,3584,9,8942383508
272,6317011,441861,6758872,7,0,0,1024,14,7827243255
273,6318140,351842,6669982,9,0,0,70656,10,5579660118
274,6379239,556957,6936196,5,0,0,7680,1,1649842132
275,6398110,649851,7047961,8,0,0,129536,12,1104921217
276,6402119,646037,7048156,5,0,0,512,1,3013620561
277,6414470,594008,7008478,8,0,0,233472,12,2935961813
278,6479660,378639,6858299,1,0,0,34816,23,7963646774
279,6574730,362581,6937311,4,0,0,3584,9,2170499020
280,6601130,332711,6933841,1,0,0,1536,23,9627706260
281,6640741,648560,7289301,2,0,0,246784,0,2967254512
282,6708941,473111,7182052,2,0,0,62976,0,8021219396
283,6716600,357990,7074590,8,0,0,25088,12,4136680706
284,6835161,302939,7138100,7,0,0,512,14,5544327963
285,6847870,441766,7289636,1,0,0,1024,23,6607373899
286,6902750,257189,7159939,9,0,0,1024,10,10557142169
287,6905551,527747,7433298,2,0,0,312832,0,6963478803
288,6997989,195328,7193317,5,0,0,3584,1,1672743318
289,7009630,280957,7290587,9,0,0,3072,10,1456760170
290,7032760,129372,7162132,1,0,0,2048,23,1117100793
291,7075210,238110,7313320,4,0,0,2560,9,6684684896
292,7089470,202559,7292029,4,0,0,1536,9,4229214303
293,7092471,223609,7316080,7,0,0,1536,14,7330152571
294,7181829,109717,7291546,5,0,0,3072,1,7075288850
295,7250979,83504,7334483,5,0,0,512,1,5444545685
296,7282380,169513,7451893,8,0,0,60928,12,2199798954
297,7331650,121194,7452844,1,0,0,3072,23,412457392
298,7342390,175015,7517405,8,0,0,12800,12,496601619
299,7360720,121575,7482295,1,0,0,2048,23,334921635
300,7398791,111485,7510276,7,0,0,4608,14,2738385580
301,7426590,192575,7619165,8,0,0,118784,12,5532707208
302,7445651,112110,7557761,7,0,0,4096,14,7883322826
303,7511919,107885,7619804,5,0,0,2048,1,9432708566
304,7516830,197234,7714064,8,0,0,105472,12,8509180427
305,7523211,193052,7716263,2,0,0,7168,0,10078528209
306,7550449,69526,7619975,5,0,0,512,1,2693370642
307,7561790,156984,7718774,8,0,0,8192,12,2086586121
308,7562559,86954,7649513,5,0,0,512,1,9034114407
309,7568851,150250,7719101,7,0,0,1024,14,5878523409
310,7617051,156023,7773074,7,0,0,2048,14,7067875914
311,7641351,131084,7772435,2,0,0,69120,0,6021264339
312,7656760,2870,7659630,0,0,1,8704,6,9784176139
313,7741709,50672,7792381,5,0,0,2560,1,946608502
314,7780040,62516,7842556,1,0,0,6144,23,7237836142
315,7822700,99632,7922332,9,0,0,27136,10,1423967020
316,7891050,67592,7958642,4,0,0,7680,9,3917692033
317,7989029,52676,8041705,5,0,0,4096,1,5989057404
318,8024430,53788,8078218,4,0,0,1536,9,7494341866
319,8030930,228122,8259052,1,0,0,4096,23,4406409205
320,8052600,417070,8469670,6,0,0,462336,19,2159458256
321,8087631,539003,8626634,2,0,0,88576,0,4923823775
322,8109401,549861,8659262,2,0,0,69632,0,7816582375
323,8117390,772669,8890059,8,0,0,200704,12,3768923657
324,8143520,430569,8574089,6,0,0,342528,19,2424656206
325,8209450,367306,8576756,8,0,0,8704,12,2258399180
326,8306080,435532,8741612,6,0,0,66560,19,9072599025
327,8325930,260258,8586188,1,0,0,5120,23,10141954728
328,8375950,328636,8704586,6,0,0,24576,19,2735813706
329,8399261,343302,8742563,7,0,0,3072,14,186731240
330,8451140,208457,8659597,1,0,0,1024,23,4449029413
331,8453549,220635,8674184,5,0,0,1536,1,8792808191
332,8463351,163610,8626961,7,0,0,1024,14,9190164904
333,8496090,455636,8951726,8,0,0,24064,12,7140287766
334,8511830,399476,8911306,9,0,0,69632,10,2390563760
335,8518461,150107,8668568,7,0,0,1024,14,1597951389
336,8535540,131336,8666876,1,0,0,512,23,9107929032
337,8593931,234945,8828876,2,0,0,136192,0,3813246504
338,8642120,527844,9169964,8,0,0,61440,12,8554082208
339,8664111,451085,9115196,2,0,0,221696,0,5930986114
340,8679770,272915,8952685,4,0,0,3072,9,1910524575
341,8740100,250146,8990246,4,0,0,2048,9,5083285271
342,8768471,382644,9151115,2,0,0,117760,0,3588917115
343,8802179,402803,9204982,5,0,0,1024,1,9054672256
344,8806370,104959,8911329,1,0,1,25600,23,346458471
345,8834581,653365,9487946,2,0,0,71680,0,5140308459
346,8854010,597060,9451070,8,0,0,174592,12,1565489667
347,8914269,381564,9295833,5,0,0,1024,1,7323468427
348,8914360,381130,9295490,8,0,0,207360,12,4043326310
349,8920001,460575,9380576,7,0,0,1024,14,10621659558
350,8937170,441036,9378206,8,0,0,209408,12,7843329597
351,8948579,236295,9184874,5,0,0,5632,1,1989736737
352,8954490,511586,9466076,9,0,0,46080,10,3514258397
353,9075689,412584,9488273,5,0,0,1024,1,3967432013
354,9087129,310722,9397851,5,0,0,1024,1,6266361199
355,9087260,292989,9380249,4,0,0,6656,9,3745337845
356,9123090,46905,9169995,1,0,1,25600,23,5561051351
357,9156350,432642,9588992,4,0,0,512,9,2846311689
358,9163030,226017,9389047,6,0,0,27648,19,7780740672
359,9190661,261360,9452021,7,0,0,3072,14,1564431536
360,9225360,171517,9396877,9,0,0,25600,10,4479589252
361,9265460,402241,9667701,8,0,0,160768,12,8830232882
362,9268529,128987,9397516,5,0,0,2048,1,7123259247
363,9284040,279158,9563198,6,0,0,43008,19,10735470102
364,9307879,81183,9389062,1,0,1,74752,23,5787383644
365,9308399,157692,9466091,1,0,1,8192,23,8647872335
366,9313400,424921,9738321,6,0,0,7168,19,9221803419
367,9330700,375267,9705967,8,0,0,12800,12,10462492373
368,9345540,203690,9549230,4,0,0,12288,9,10505371501
369,9375530,326514,9702044,8,0,0,112640,12,4315102920
370,9504411,202219,9706630,7,0,0,2048,14,10728712293
371,9571290,332251,9903541,8,0,0,115712,12,6652518827
372,9600301,154280,9754581,2,0,0,41472,0,10550264680
373,9627270,489031,10116301,6,0,0,171520,19,3959403897
374,9660400,105917,9766317,4,0,0,1024,9,5154975779
375,9673340,332425,10005765,4,0,0,2048,9,52869823
376,9673399,43714,9717113,1,0,1,16896,23,8045199540
377,9676351,798711,10475062,2,0,0,261632,0,10151180797
378,9705321,87207,9792528,7,0,0,4608,14,6833997506
379,9706580,198708,9905288,6,0,0,5632,19,9169748153
380,9723020,185091,9908111,1,0,0,9216,23,6755736612
381,9745540,16756,9762296,6,0,1,8192,19,6518137280
382,9753210,251916,10005126,9,0,0,66048,10,7928125602
383,9766269,606,9766875,1,0,1,512,23,4425351437
384,9804411,208905,10013316,7,0,0,2048,14,9765225396
385,9804800,207877,10012677,4,0,0,4096,9,4722023036
386,9852980,185585,10038565,9,0,0,37376,10,3576859681
387,9853251,281355,10134606,7,0,0,2560,14,5377147664
388,9887120,25112,9912232,2,0,1,11264,0,4803715323
389,9893050,321954,10215004,6,0,0,150528,19,7141993996
390,9914619,566,9915185,1,0,1,512,23,7242282388
391,9924840,11274,9936114,2,0,1,18432,0,6891229255
392,9926199,124995,10051194,5,0,0,1024,1,9126018575
393,9930020,9320,9939340,2,0,1,5120,0,2468983486
394,9971481,553851,10525332,2,0,0,161280,0,5416123860
395,9981040,343726,10324766,9,0,0,86016,10,8977827609
396,9983380,342033,10325413,4,0,0,2048,9,3456068458
397,10035689,6766,10042455,1,0,1,4096,23,8304529987
398,10051760,335912,10387672,6,0,0,140288,19,3924755910
399,10057289,214740,10272029,5,0,0,1536,1,4703909094
400,10072280,323051,10395331,8,0,0,25088,12,1993263962
401,10093440,447195,10540635,8,0,0,50176,12,5036554911
402,10098350,443563,10541913,1,0,0,3072,23,2572838091
403,10106229,369940,10476169,5,0,0,3584,1,3783122895
404,10137920,403042,10540962,1,0,0,1024,23,6562718168
405,10249640,457181,10706821,9,0,0,224768,10,1093309223
406,10277650,434022,10711672,6,0,0,15872,19,3427784155
407,10298449,243947,10542396,5,0,0,1536,1,6234784032
408,10301109,27209,10328318,1,0,1,3072,23,2089210115
409,10333201,470238,10803439,2,0,0,301056,0,5924277307
410,10367471,446787,10814258,2,0,0,35328,0,9592480878
411,10528970,347023,10875993,6,0,0,159232,19,3554002762
412,10536789,375583,10912372,5,0,0,4096,1,6548092522
413,10559181,342408,10901589,2,0,0,81920,0,1533389800
414,10595639,30491,10626130,1,0,1,49152,23,6073221135
415,10671469,142820,10814289,1,0,1,11776,23,6900963074
416,10672599,141705,10814304,1,0,1,3072,23,4281154649
417,10692540,121787,10814327,7,0,1,6656,14,846274519
418,10734140,168037,10902177,1,0,0,1536,23,10699918800
419,10735020,316684,11051704,8,0,0,138752,12,6512636922
420,10784929,335881,11120810,5,0,0,2048,1,9016160092
421,10790009,86311,10876320,5,0,0,1024,1,7953234627
422,10809750,161134,10970884,6,0,0,34816,19,6645188427
423,10883410,210747,11094157,6,0,0,85504,19,10442835833
424,10925361,208285,11133646,7,0,0,1024,14,8078338661
425,10925460,194711,11120171,1,0,0,3072,23,10214087059
426,10942350,273320,11215670,9,0,0,128000,10,8478188073
427,10947030,172190,11119220,6,0,0,39424,19,8142954161
428,10981930,11533,10993463,0,0,1,18944,6,8203985697
429,10990809,2870,10993679,1,0,1,8704,23,3456420249
430,11034390,183487,11217877,1,0,0,7168,23,8337061124
431,11097630,279565,11377195,6,0,0,249856,19,5268134867
432,11123740,6754,11130494,0,0,1,7168,6,9083122176
433,11132240,253090,11385330,6,0,0,26624,19,3232524352
434,11141640,243869,11385509,1,0,0,512,23,1524216617
435,11197890,359642,11557532,8,0,0,127488,12,7893088202
436,11206161,191443,11397604,7,0,0,1024,14,3786271003
437,11223280,533112,11756392,8,0,0,243712,12,2057867261
438,11236999,149937,11386936,5,0,0,4608,1,10289626851
439,11264890,2870,11267760,1,0,1,8704,23,7988963070
440,11273660,4374,11278034,6,0,1,4608,19,289050441
441,11276290,296085,11572375,6,0,0,48640,19,411853887
442,11289570,388970,11678540,6,0,0,8192,19,1532288657
443,11300201,547852,11848053,2,0,0,264192,0,9457979646
444,11334841,157143,11491984,7,0,0,1024,14,3966415308
445,11349811,304597,11654408,2,0,0,4608,0,4769598357
446,11372460,275812,11648272,9,0,0,50176,10,538633680
447,11377510,10953,11388463,1,0,1,1536,23,5225505757
448,11381630,9205,11390835,6,0,1,3584,19,1066674516
449,11445480,311083,11756563,4,0,0,512,9,2860987973
450,11487550,4850,11492400,6,0,1,5120,19,23145113
451,11500960,370850,11871810,8,0,0,77824,12,2542734584
452,11518820,238546,11757366,4,0,0,2560,9,2481178713
453,11546350,32005,11578355,6,0,1,14848,19,9602623782
454,11561690,338527,11900217,8,0,0,93184,12,6652176025
455,11581450,20366,11601816,0,0,1,32768,6,10336663199
456,11627030,340984,11968014,9,0,0,40960,10,2308492896
457,11655580,247156,11902736,1,0,0,8192,23,7117807993
458,11705940,384146,12090086,9,0,0,283648,10,3979307124
459,11713990,134078,11848068,1,0,1,20992,23,6925770550
460,11739880,605423,12345303,6,0,0,105984,19,1478705412
461,11745720,102363,11848083,6,0,1,10752,19,5214854975
462,11751560,713581,12465141,9,0,0,151040,10,3576942925
463,11758490,1073077,12831567,1,0,0,3584,23,5567961870
464,11758720,1262345,13021065,6,0,0,216064,19,2917184963
465,11839300,1501331,13340631,8,0,0,552960,12,8862475612
466,11856480,68464,11924944,6,0,1,36352,19,2871198320
467,11857350,73495,11930845,0,0,1,28160,6,1322281443
468,11887439,45352,11932791,1,0,1,3072,23,5535491814
469,11921180,14837,11936017,1,0,1,5120,23,8566766150
470,11927820,8453,11936273,8,0,1,9216,12,8368803384
471,11928980,1608708,13537688,9,0,0,18944,10,1722925320
472,11945930,560572,12506502,1,0,0,4096,23,242181799
473,11951220,1518,11952738,1,0,1,1536,23,1978767251
474,11963250,797387,12760637,9,0,0,36864,10,8919073507
475,11982829,4374,11987203,1,0,1,4608,23,9935687768
476,11993530,1405811,13399341,6,0,0,191488,19,8663048444
477,11998150,1518,11999668,6,0,1,1536,19,3535427154
478,12014010,836760,12850770,9,0,0,62976,10,746026565
479,12044650,51773,12096423,6,0,1,6656,19,3682685024
480,12071480,25711,12097191,8,0,1,11776,12,3239999857
481,12084119,18130,12102249,1,0,1,15872,23,7566235679
482,12091590,380796,12472386,9,0,0,21504,10,2276666356
483,12096970,422649,12519619,6,0,0,16896,19,7081033162
484,12123000,132774,12255774,0,0,1,215040,6,608304084
485,12134590,331205,12465795,1,0,0,2048,23,8521187492
486,12137200,1544374,13681574,6,0,0,455680,19,6261699843
487,12140510,120090,12260600,9,0,1,7680,10,6526057765
488,12182150,311441,12493591,1,0,0,2048,23,3196730080
489,12198160,73372,12271532,0,0,1,44032,6,9513370367
490,12203070,78780,12281850,6,0,1,40960,19,7628573422
491,12236560,51191,12287751,8,0,1,19968,12,3887539145
492,12241620,906060,13147680,8,0,0,87552,12,10495627439
493,12244600,45737,12290337,1,0,1,4096,23,7450822984
494,12263670,27333,12291003,8,0,1,1024,12,10646503822
495,12299160,5712,12304872,6,0,1,14336,19,5495483536
496,12309910,506477,12816387,1,0,0,9216,23,288618242
497,12313491,1117968,13431459,2,0,0,103936,0,604409753
498,12315729,422036,12737765,5,0,0,512,1,10632262075
499,12327350,608917,12936267,1,0,0,5120,23,5335081039
500,12329260,29985,12359245,8,0,1,23552,12,889158112
501,12344741,1558439,13903180,7,0,0,6656,14,5555875600
502,12395380,69776,12465156,1,0,1,47104,23,7120031850
503,12399050,78019,12477069,0,0,1,114176,6,4048038952
504,12399320,1450514,13849834,9,0,0,135168,10,3128027603
505,12405270,328309,12733579,4,0,0,1024,9,5578011234
506,12434780,964972,13399752,1,0,0,1024,23,8268914037
507,12444291,1054263,13498554,2,0,0,220160,0,3553817372
508,12450710,490122,12940832,4,0,0,1024,9,2890140038
509,12477270,101624,12578894,0,0,1,164352,6,1619754797
510,12493030,579153,13072183,1,0,0,1024,23,2106735721
511,12498390,1214756,13713146,6,0,0,79360,19,2517495067
512,12508960,85589,12594549,0,0,1,58368,6,2944915021
513,12521001,1010876,13531877,2,0,0,109056,0,3512583106
514,12526361,621958,13148319,7,0,0,2048,14,10250203689
515,12544860,235049,12779909,9,0,0,12800,10,7519019203
516,12550039,1648829,14198868,5,0,0,2048,1,7150195740
517,12566970,310895,12877865,1,0,0,1536,23,6579342497
518,12575210,966035,13541245,4,0,0,8704,9,196157382
519,12583050,1309573,13892623,9,0,0,136192,10,8279635855
520,12587250,8285,12595535,9,0,1,1536,10,2179963353
521,12604200,1713943,14318143,6,0,0,199168,19,10579182106
522,12617630,10241,12627871,8,0,1,16384,12,9736910563
523,12628980,1549055,14178035,8,0,0,427520,12,6677802190
524,12651340,128584,12779924,0,0,1,209408,6,8848734339
525,12655410,1601543,14256953,6,0,0,128512,19,937543476
526,12667450,1225882,13893332,4,0,0,1024,9,9923037245
527,12714101,1246800,13960901,2,0,0,31232,0,2246195372
528,12766890,574092,13340982,1,0,0,1024,23,345861854
529,12809540,13770,12823310,6,0,1,26624,19,2462789080
530,12823070,1114338,13937408,8,0,0,75264,12,6404056391
531,12836970,851981,13688951,4,0,0,2048,9,10573472681
532,12837410,908795,13746205,4,0,0,6656,9,3726427766
533,12874991,1486558,14361549,2,0,0,78848,0,4921523731
534,12905500,782017,13687517,9,0,0,19456,10,4860643685
535,12920790,798143,13718933,9,0,0,18944,10,1526643908
536,12928361,964604,13892965,7,0,0,1024,14,4721077311
537,12935830,1262032,14197862,6,0,0,65024,19,4708602486
538,12957280,69606,13026886,1,0,1,14336,23,3925430369
539,12957420,786742,13744162,1,0,0,5120,23,9632850679
540,12962740,86180,13048920,8,0,1,41984,12,7631738058
541,12996989,541394,13538383,5,0,0,2048,1,5973157120
542,13002571,540148,13542719,7,0,0,4608,14,1170695817
543,13012010,526568,13538578,1,0,0,512,23,4440944673
544,13058750,340606,13399356,0,0,1,268288,6,9872863785
545,13065349,334022,13399371,1,0,1,1536,23,5696420314
546,13122570,1214940,14337510,9,0,0,63488,10,89089600
547,13123490,275904,13399394,8,0,1,4608,12,8922341083
548,13148119,251290,13399409,1,0,1,20992,23,10548762605
549,13176580,364720,13541300,5,0,1,22016,1,10495648036
550,13177220,541960,13719180,0,0,1,303616,6,351387068
551,13198539,489773,13688312,5,0,0,2560,1,3396035816
552,13224950,494245,13719195,5,0,1,5120,1,1744838721
553,13234880,964159,14199039,1,0,0,512,23,3784686987
554,13237541,613556,13851097,7,0,0,4096,14,5619116161
555,13266140,453070,13719210,9,0,1,9728,10,644395392
556,13280650,1153953,14434603,6,0,0,209920,19,7515316129
557,13287390,431843,13719233,2,0,1,10240,0,2422177807
558,13299850,419398,13719248,6,0,1,2560,19,4220337509
559,13305710,458335,13764045,0,0,1,218624,6,9820542974
560,13309190,460859,13770049,5,0,1,20480,1,8162169272
561,13318790,1308233,14627023,9,0,0,165888,10,2712831288
562,13336191,1497106,14833297,2,0,0,287232,0,7041805954
563,13345940,871842,14217782,6,0,0,61440,19,2455387062
564,13349750,907686,14257436,1,0,0,1536,23,7882481047
565,13358230,417311,13775541,2,0,1,26112,0,9495587878
566,13376220,402227,13778447,6,0,1,4608,19,8198219418
567,13386300,392813,13779113,6,0,1,11264,19,467070887
568,13395470,388828,13784298,1,0,1,16384,23,3532696666
569,13407470,377174,13784644,2,0,1,512,0,7998387254
570,13410901,1042781,14453682,7,0,0,512,14,2255610192
571,13431310,354640,13785950,5,0,1,2048,1,7259641418
572,13434480,356616,13791096,9,0,1,8192,10,7952027722
573,13452980,338475,13791455,5,0,1,9728,1,10475616446
574,13454680,908944,14363624,6,0,0,6656,19,7545549871
575,13466920,433099,13900019,1,0,0,1536,23,5433746361
576,13477740,330497,13808237,2,0,1,55808,0,1275854700
577,13479540,371572,13851112,2,0,1,39424,0,9708348698
578,13504560,388078,13892638,7,0,1,43520,14,6761511146
579,13518870,933119,14451989,0,0,1,310784,6,9505762802
580,13520300,953840,14474140,4,0,0,512,9,6964519623
581,13530141,840463,14370604,7,0,0,512,14,3998944349
582,13533410,920919,14454329,1,0,0,2048,23,9691184558
583,13544460,907544,14452004,0,0,1,11264,6,5429318272
584,13560771,809630,14370401,2,0,0,18944,0,8989473778
585,13561270,946482,14507752,0,0,1,145920,6,6636359683
586,13562810,944957,14507767,5,0,1,9728,1,7155823518
587,13563730,888220,14451950,9,0,0,56832,10,5014223248
588,13565880,966717,14532597,1,0,0,4608,23,6538444569
589,13566800,1086945,14653745,0,0,1,81920,6,8157727694
590,13594860,1090949,14685809,9,0,1,34304,10,8359070506
591,13595350,1136540,14731890,9,0,1,16896,10,2722034567
592,13598010,600179,14198189,4,0,0,1024,9,5717068673
593,13603930,760489,14364419,1,0,0,2560,23,5893582451
594,13647051,849100,14496151,2,0,0,72192,0,10374881967
595,13669379,695235,14364614,5,0,0,512,1,2655117363
596,13673660,1060496,14734156,0,0,1,3584,6,9971439688
597,13694040,1041396,14735436,7,0,1,14336,14,5770689790
598,13715690,1121225,14836915,6,0,1,5120,19,6749470121
599,13725550,1210428,14935978,6,0,0,33792,19,9503942852
600,13725621,959191,14684812,2,0,0,101888,0,1665602887
601,13747930,1089000,14836930,2,0,1,10752,0,4113598471
602,13757901,963528,14721429,7,0,0,3072,14,1389457827
603,13760540,1076405,14836945,2,0,1,3584,0,3164519575
604,13769370,1067590,14836960,2,0,1,512,0,1610779850
605,13772080,1064820,14836900,9,0,0,11776,10,9356454349
606,13780361,692421,14472782,7,0,0,2048,14,3366534880
607,13784780,1053614,14838394,0,0,1,35840,6,6862661188
608,13802529,1123130,14925659,1,0,1,11264,23,5851505941
609,13816020,1141992,14958012,6,0,1,27136,19,1866717776
610,13850789,623124,14473913,5,0,0,3584,1,8239151164
611,13856831,615312,14472143,2,0,0,51712,0,1029031558
612,13862330,1095697,14958027,6,0,1,35328,19,680675276
613,13872530,1161078,15033608,8,0,0,84992,12,3226684125
614,13876130,1176452,15052582,0,0,1,55296,6,4504928106
615,13892440,1168307,15060747,5,0,1,1024,1,80558993
616,13911240,1149522,15060762,9,0,1,21504,10,1232296943
617,13932761,574920,14507681,7,0,0,6144,14,10392446846
618,13938970,714752,14653722,8,0,0,87552,12,5718185263
619,13953740,1188735,15142475,0,0,1,49152,6,4789512202
620,13954239,499216,14453455,5,0,0,4608,1,8685926235
621,13957789,498583,14456372,5,0,0,6656,1,7139557442
622,13978200,1292610,15270810,0,0,1,94208,6,7699649968
623,13991410,694197,14685607,1,0,0,2560,23,4012976951
624,14011700,1264397,15276097,6,0,1,16896,19,9774942282
625,14013041,912587,14925628,7,0,0,210944,14,2693407665
626,14013790,484092,14497882,4,0,0,5632,9,6178351038
627,14081420,1278034,15359454,9,0,1,12800,10,7877935893
628,14093610,1265859,15359469,5,0,1,20992,1,604408936
629,14150429,535365,14685794,5,0,0,512,1,4460102227
630,14162310,1200804,15363114,9,0,1,45568,10,780685785
631,14182130,1270108,15452238,5,0,1,35840,1,2029563022
632,14243850,1477929,15721779,6,0,1,31744,19,9480992320
633,14247940,710258,14958198,1,0,0,512,23,374778824
634,14249480,611861,14861341,9,0,0,75264,10,1693251565
635,14261860,1553292,15815152,5,0,1,29696,1,1175306738
636,14267109,571270,14838379,5,0,0,4608,1,9134309075
637,14270649,995586,15266235,5,0,0,2048,1,5674809310
638,14273010,684987,14957997,6,0,0,72192,19,492271711
639,14294849,698198,14993047,5,0,0,2048,1,4882033407
640,14296080,1519087,15815167,9,0,1,1024,10,3646043742
641,14300030,1515168,15815198,9,0,1,32768,10,9747748034
642,14310520,749565,15060085,8,0,0,24576,12,9095893946
643,14311320,1503901,15815221,6,0,1,11776,19,691348827
644,14321860,1092017,15413877,4,0,0,1536,9,1400637922
645,14324761,798783,15123544,2,0,0,31232,0,7834429762
646,14336840,1478396,15815236,9,0,1,12800,10,3284481495
647,14336870,1545088,15881958,2,0,1,26112,0,7625527146
648,14338600,1606421,15945021,1,0,1,37376,23,814089100
649,14340429,720303,15060732,5,0,0,2048,1,6465757374
650,14362321,690246,15052567,2,0,0,51200,0,4186103809
651,14376370,1580192,15956562,6,0,1,6144,19,8223322441
652,14400480,1608680,16009160,2,0,1,25600,0,8203730929
653,14428890,1580526,16009416,9,0,1,9216,10,4070109606
654,14429650,1580637,16010287,2,0,1,12288,0,978877183
655,14440970,1625462,16066432,5,0,1,5632,1,9575608505
656,14443610,680885,15124495,1,0,0,3072,23,4975345668
657,14450030,1632329,16082359,9,0,1,19968,10,10652114498
658,14452300,1824250,16276550,9,0,1,13824,10,2480506862
659,14455200,766053,15221253,9,0,0,23552,10,8972083800
660,14463271,891582,15354853,2,0,0,223744,0,4711795174
661,14468690,1807875,16276565,9,0,1,2048,10,8939174398
662,14487340,1790503,16277843,6,0,1,2048,19,10503975042
663,14499890,713977,15213867,6,0,0,150016,19,2380754102
664,14515390,1902686,16418076,5,0,1,46592,1,10246748809
665,14540390,1878672,16419062,9,0,1,1536,10,247212928
666,14542590,1879378,16421968,5,0,1,4608,1,5747704492
667,14551630,1971793,16523423,1,0,1,16896,23,8765806902
668,14583850,637738,15221588,1,0,0,1024,23,7505045887
669,14613570,600492,15214062,1,0,0,512,23,5011078372
670,14642090,3712105,18354195,9,0,1,40960,10,9579123237
671,14661009,23121202,37782211,1,0,1,2560,23,8478604262
672,14682530,23099704,37782234,6,0,1,11776,19,5639419706
673,14696661,926634,15623295,2,0,0,138240,0,7402523835
674,14712229,536654,15248883,5,0,0,4608,1,4020588155
675,14838260,24026519,38864779,9,0,1,20992,10,9855813769
676,14842180,972941,15815121,6,0,0,296960,19,2602540686
677,14865550,493865,15359415,8,0,0,13312,12,9099569595
678,14876860,26957990,41834850,2,0,1,30720,0,5595782810
679,14969000,27070257,42039257,5,0,1,8704,1,6318491278
680,15042001,393728,15435729,2,0,0,45568,0,6013962915
681,15053759,301585,15355344,5,0,0,1536,1,9792737021
682,15058670,663086,15721756,8,0,0,185856,12,9550808705
683,15077870,27109210,42187080,9,0,1,24064,10,3400125333
684,15092740,27554752,42647492,6,0,1,10240,19,8078030185
685,15110460,27538658,42649118,6,0,1,2560,19,5277522174
686,15140801,1027416,16168217,2,0,0,273920,0,4961842638
687,15160629,657742,15818371,5,0,0,10240,1,1559179701
688,15172840,492273,15665113,1,0,0,4608,23,3164440880
689,15185739,352585,15538324,5,0,0,4096,1,10506555467
690,15188430,27469713,42658143,2,0,1,24576,0,593035834
691,15199509,424269,15623778,5,0,0,1536,1,8239963122
692,15219720,27509735,42729455,2,0,1,27136,0,9532327682
693,15228950,27813811,43042761,6,0,1,58880,19,9835536029
694,15238889,678258,15917147,5,0,0,512,1,8144228543
695,15254040,627879,15881919,8,0,0,147968,12,10130256807
696,15288610,27754174,43042784,2,0,1,5632,0,4670013168
697,15317750,27803392,43121142,9,0,1,17920,10,6039669769
698,15320240,953798,16274038,8,0,0,73728,12,9900694383
699,15320810,27871958,43192768,6,0,1,14336,19,5228722710
700,15336951,565458,15902409,7,0,0,67072,14,1511166735
701,15357100,28132712,43489812,9,0,1,33792,10,510436698
702,15367980,28866422,44234402,9,0,1,45056,10,802716515
703,15382000,29030188,44412188,2,0,1,19456,0,5894046919
704,15385329,155131,15540460,5,0,0,1024,1,3532412247
705,15386829,337797,15724626,5,0,0,9216,1,9279150375
706,15514330,730966,16245296,9,0,0,252928,10,9548316561
707,15522171,468195,15990366,2,0,0,3072,0,5643086640
708,15523879,752648,16276527,5,0,0,1536,1,2073588851
709,15528990,29062211,44591201,5,0,1,6144,1,4257040865
710,15555910,29093837,44649747,2,0,1,14848,0,4762314831
711,15556130,793407,16349537,9,0,0,45056,10,9779078568
712,15579249,501891,16081140,5,0,0,6144,1,10430596338
713,15604581,909236,16513817,7,0,0,113152,14,5418004450
714,15617311,1059688,16676999,7,0,0,249344,14,7761172770
715,15635720,29114389,44750109,2,0,1,1536,0,5428965026
716,15658100,29248608,44906708,2,0,1,24576,0,6352499092
717,15659290,615771,16275061,1,0,0,3072,23,7571424703
718,15675340,600680,16276020,1,0,0,3072,23,3701586095
719,15676300,1316203,16992503,1,0,0,203776,23,2377692724
720,15682910,29263484,44946394,9,0,1,22016,10,4387968072
721,15703069,974593,16677662,5,0,0,2048,1,3186711950
722,15714799,563029,16277828,5,0,0,4096,1,30240090
723,15726220,29220197,44946417,5,0,1,10752,1,4479357222
724,15753670,813151,16566821,8,0,0,115712,12,1870083347
725,15807090,29139350,44946440,9,0,1,10752,10,8319420987
726,15818030,1514948,17332978,6,0,0,378368,19,5960799383
727,15824240,427311,16251551,6,0,0,20480,19,9391616147
728,15838630,939805,16778435,8,0,0,98304,12,4866993987
729,15848120,29098343,44946463,5,0,1,1536,1,3743872670
730,15854190,29107295,44961485,2,0,1,25088,0,9387880605
731,15901730,977578,16879308,6,0,0,28160,19,9434077306
732,15949960,1258304,17208264,6,0,0,198144,19,6162532881
733,15973950,1085784,17059734,8,0,0,97792,12,7474996191
734,15986440,28978000,44964440,9,0,1,2560,10,6503686619
735,16009061,1876570,17885631,7,0,0,194560,14,1577346699
736,16028580,28939086,44967666,6,0,1,5120,19,10299812058
737,16038461,1561932,17600393,2,0,0,300032,0,4383231181
738,16040150,29066444,45106594,9,0,1,47616,10,7084903073
739,16048440,29883458,45931898,5,0,1,56832,1,4532602167
740,16051841,864420,16916261,7,0,0,35328,14,6671264965
741,16056510,29895749,45952259,6,0,1,2048,19,3881070065
742,16080690,30400796,46481486,9,0,1,71168,10,9408599788
743,16103980,30449070,46553050,9,0,1,52224,10,6417622531
744,16132610,30420463,46553073,5,0,1,6656,1,2320153021
745,16145890,2198524,18344414,1,0,0,226304,23,1143366570
746,16164610,30388486,46553096,2,0,1,8192,0,6290503499
747,16166690,2939845,19106535,1,0,0,89088,23,7300507192
748,16167211,2338970,18506181,7,0,0,233984,14,9661448754
749,16167660,3078316,19245976,8,0,0,95744,12,6158915070
750,16172450,1944618,18117068,8,0,0,209920,12,1853257732
751,16175360,30476926,46652286,2,0,1,38912,0,1137460808
752,16176121,675074,16851195,7,0,0,3072,14,6816223453
753,16193061,1434210,17627271,7,0,0,61952,14,3887024956
754,16205900,2784607,18990507,8,0,0,272896,12,1969796341
755,16224960,1828101,18053061,6,0,0,188416,19,8025635596
756,16227440,802483,17029923,9,0,0,27136,10,2475792187
757,16229860,2818690,19048550,9,0,0,62976,10,9548572549
758,16242209,2111947,18354156,5,0,0,3584,1,1868912697
759,16256420,2178454,18434874,6,0,0,137728,19,4924545527
760,16295640,1979799,18275439,6,0,0,206336,19,8241978057
761,16298250,30475647,46773897,9,0,1,47104,10,1329766172
762,16311260,2248365,18559625,9,0,0,34816,10,10678756261
763,16348241,2200745,18548986,2,0,0,58880,0,9498303180
764,16356270,2174582,18530852,6,0,0,80896,19,7851304646
765,16361800,2289617,18651417,6,0,0,45568,19,2622039119
766,16414600,30408483,46823083,9,0,1,15360,10,1672809352
767,16434330,30495097,46929427,9,0,1,23040,10,3672492971
768,16437980,30613648,47051628,5,0,1,46080,1,3909703743
769,16449091,1159289,17608380,7,0,0,26112,14,8613030077
770,16450050,767605,17217655,9,0,0,30720,10,7845680302
771,16460220,1273988,17734208,4,0,0,2048,9,7554422687
772,16510120,30631922,47142042,5,0,1,12288,1,1916258297
773,16520021,1397213,17917234,2,0,0,48128,0,5187158879
774,16542170,30637982,47180152,8,0,1,12288,12,1858800437
775,16566921,1616085,18183006,2,0,0,206336,0,6239005652
776,16577470,3297102,19874572,1,0,0,469504,23,6309607040
777,16601870,30578305,47180175,9,0,1,18432,10,1887367131
778,16638140,30542066,47180206,6,0,1,3072,19,5301212534
779,16641370,30538859,47180229,6,0,1,512,19,8589996462
780,16678070,30532001,47210071,9,0,1,16896,10,1553776147
781,16695750,3538231,20233981,8,0,0,223232,12,8513276264
782,16782740,701895,17484635,1,0,0,512,23,4179855103
783,16785250,30799853,47585103,5,0,1,20992,1,5530161787
784,16809789,1386522,18196311,0,0,0,15360,6,4226888388
785,16851480,2475135,19326615,4,0,0,2560,9,7740779067
786,16857960,30734623,47592583,9,0,1,2048,10,7047878238
787,16878009,1007793,17885802,5,0,0,512,1,6186108788
788,16884800,1306816,18191616,9,0,0,26624,10,2667698992
789,16885450,30988061,47873511,9,0,1,7168,10,3506505664
790,16894099,1491482,18385581,5,0,0,1024,1,2447376879
791,16894190,1935878,18830068,8,0,0,11264,12,6895450185
792,16951110,30989129,47940239,5,0,1,19456,1,6465398524
793,16951320,2265469,19216789,6,0,0,69120,19,5654928844
794,16951551,2773323,19724874,2,0,0,130560,0,2875080786
795,17015149,1561518,18576667,0,0,0,29696,6,8787064058
796,17029191,1878153,18907344,7,0,0,81920,14,6438239055
797,17046280,30893982,47940262,9,0,1,4096,10,2547127938
798,17058621,1294412,18353033,2,0,0,28160,0,6055956615
799,17059370,31622429,48681799,6,0,1,59904,19,9627463669
800,17075970,3345740,20421710,8,0,0,352768,12,4488741198
801,17085250,1098239,18183489,4,0,0,1536,9,3139489128
802,17129521,3424013,20553534,7,0,0,215040,14,4469011567
803,17133361,1534346,18667707,2,0,0,7168,0,176199113
804,17157180,2882769,20039949,8,0,0,34304,12,9690663747
805,17166881,1218373,18385254,7,0,0,101888,14,7283488830
806,17183360,31500705,48684065,5,0,1,3584,1,5444677112
807,17189090,31499161,48688251,5,0,1,6656,1,8171147258
808,17193330,31589050,48782380,9,0,1,15872,10,6588058922
809,17256190,31526392,48782582,6,0,1,39936,19,2381235149
810,17257200,3043252,20300452,9,0,0,218112,10,3259269327
811,17257839,2427240,19685079,0,0,0,169984,6,249062405
812,17278990,638415,17917405,4,0,0,512,9,7057961247
813,17310840,2213010,19523850,4,0,0,2560,9,3882821006
814,17319780,31590323,48910103,9,0,1,16896,10,10691900050
815,17324370,1206653,18531023,4,0,0,512,9,4946221993
816,17338860,31571282,48910142,6,0,1,13824,19,5629632809
817,17394400,31515765,48910165,5,0,1,9728,1,4582288826
818,17396320,31582295,48978615,9,0,1,15872,10,10444869869
819,17399881,2331600,19731481,7,0,0,21504,14,1525643250
820,17414481,1861626,19276107,7,0,0,98816,14,10296668779
821,17431421,3536870,20968291,2,0,0,386560,0,6443696488
822,17432370,31638042,49070412,6,0,1,36864,19,2770670361
823,17448000,31638050,49086050,5,0,1,16896,1,3175687824
824,17477180,31609536,49086716,5,0,1,1024,1,3605401501
825,17486690,492628,17979318,4,0,0,1024,9,7744555300
826,17507890,1183280,18691170,1,0,0,22528,23,5231933582
827,17508800,31578902,49087702,9,0,1,1536,10,8811918482
828,17518190,3840814,21359004,1,0,0,296960,23,1669430997
829,17529450,1462532,18991982,4,0,0,4608,9,4734892879
830,17613760,3474822,21088582,8,0,0,394752,12,10029415970
831,17620110,31495537,49115647,9,0,1,44544,10,7312839846
832,17627181,3526565,21153746,2,0,0,26112,0,3445013756
833,17629260,31756824,49386084,5,0,1,26112,1,9642596908
834,17643110,1662142,19305252,4,0,0,2560,9,6803273569
835,17648069,1205277,18853346,5,0,0,2048,1,9088996790
836,17686809,2189278,19876087,5,0,0,4608,1,5201990905
837,17716980,3661086,21378066,8,0,0,23552,12,2204318979
838,17742500,3939712,21682212,8,0,0,59904,12,6889740980
839,17787160,4168754,21955914,9,0,0,180736,10,6043480654
840,17789410,2851928,20641338,6,0,0,164864,19,9361463358
841,17792970,31684505,49477475,8,0,1,40448,12,6436960052
842,17889400,31588098,49477498,9,0,1,2560,10,10670810661
843,17901180,2586819,20487999,8,0,0,104960,12,10554198497
844,17903879,3201183,21105062,5,0,0,1536,1,1908126424
845,17911481,3503503,21414984,2,0,0,5120,0,1150266207
846,17920150,31585499,49505649,9,0,1,12288,10,7529806942
847,17962260,31561060,49523320,5,0,1,8704,1,8704952051
848,17981011,2333192,20314203,2,0,0,45056,0,8197792450
849,18009920,3188545,21198465,8,0,0,53760,12,2938026873
850,18015450,3493757,21509207,4,0,0,512,9,4071724233
851,18017921,4314945,22332866,7,0,0,562688,14,8146483674
852,18029620,3076409,21106029,4,0,0,3072,9,265033862
853,18070830,4421955,22492785,1,0,0,5632,23,3413802146
854,18108510,31553021,49661531,5,0,1,26112,1,4019035861
855,18181000,31497581,49678581,5,0,1,5632,1,4472719567
856,18194261,3845655,22039916,2,0,0,131072,0,1412637720
857,18203220,1782825,19986045,1,0,0,3584,23,197912901
858,18209920,31468684,49678604,9,0,1,5120,10,1202074570
859,18217629,4609151,22826780,0,0,0,395776,6,7675737088
860,18232020,2321865,20553885,4,0,0,1024,9,200611790
861,18237660,1164883,19402543,8,0,0,58880,12,5534711798
862,18245001,2974383,21219384,2,0,0,68608,0,6662836141
863,18293040,31385587,49678627,5,0,1,1024,1,5609101835
864,18295330,31997069,50292399,5,0,1,65024,1,4920205457
865,18302371,3544222,21846593,2,0,0,70656,0,3730597883
866,18307230,3247376,21554606,4,0,0,3584,9,8687404308
867,18314260,31978162,50292422,6,0,1,6656,19,8156014133
868,18368440,3777100,22145540,1,0,0,316416,23,9487813816
869,18373831,4108316,22482147,2,0,0,59904,0,1382758155
870,18428349,346859,18775208,5,0,0,512,1,5913888527
871,18495710,4505184,23000894,9,0,0,472064,10,4589528298
872,18509989,4328062,22838051,0,0,0,36864,6,3726056685
873,18529850,2841025,21370875,9,0,0,38912,10,10201309788
874,18547689,3826251,22373940,5,0,0,1024,1,8516482331
875,18555270,31737175,50292445,3,0,1,18432,28,4540907152
876,18578260,4003984,22582244,8,0,0,174592,12,1772486865
877,18617700,1823861,20441561,1,0,0,65024,23,1499689460
878,18756910,5248132,24005042,2,0,0,201216,0,7788375560
879,18774741,4387620,23162361,7,0,0,155136,14,2545756032
880,18797410,33077323,51874733,5,0,1,40960,1,3359878533
881,18841231,2951496,21792727,2,0,0,111104,0,3844150099
882,18844570,2729311,21573881,4,0,0,5120,9,5217039602
883,18864110,2238231,21102341,6,0,0,45056,19,6128753960
884,18903869,2200047,21103916,5,0,0,5120,1,7936208575
885,18911830,3791116,22702946,8,0,0,30208,12,3296292354
886,18919480,1839788,20759268,4,0,0,1536,9,7111321441
887,18920060,5599274,24519334,8,0,0,129536,12,66871092
888,18958739,4249221,23207960,0,0,0,149504,6,8709802590
889,18975980,4499386,23475366,6,0,0,38400,19,5704318459
890,18978620,4136067,23114687,6,0,0,275968,19,8739808393
891,18987940,2837110,21825050,8,0,0,105984,12,2979414762
892,18994120,1567128,20561248,9,0,0,24064,10,175235497
893,18999000,4272531,23271531,6,0,0,135680,19,3925945206
894,19011850,32895732,51907582,5,0,1,9728,1,3985947618
895,19021361,4007332,23028693,7,0,0,91136,14,6133420377
896,19035040,5142217,24177257,8,0,0,78848,12,8137719690
897,19046740,33159330,52206070,5,0,1,39424,1,5718803363
898,19060540,3466695,22527235,9,0,0,112640,10,4269331543
899,19060580,2548467,21609047,6,0,0,512,19,8192762075
900,19061679,4988579,24050258,0,0,0,4096,6,10716182800
901,19074251,4231459,23305710,7,0,0,112128,14,7412718552
902,19084180,2621802,21705982,6,0,0,1024,19,4604525209
903,19146230,2700690,21846920,4,0,0,1024,9,4532720336
904,19154500,33084073,52238573,3,0,1,14336,28,8336771208
905,19162010,33402929,52564939,5,0,1,28672,1,6682271310
906,19194740,2692076,21886816,6,0,0,3584,19,8634445962
907,19205009,3633837,22838846,5,0,0,2560,1,5437639991
908,19234380,33578332,52812712,3,0,1,19456,28,641742079
909,19236690,5436200,24672890,8,0,0,296960,12,6835079481
910,19271660,4672051,23943711,6,0,0,2560,19,8790430696
911,19314541,5592919,24907460,7,0,0,228864,14,9366129477
912,19314750,5923136,25237886,1,0,0,359424,23,9940480540
913,19316089,5037848,24353937,0,0,0,62976,6,995380980
914,19329130,33483605,52812735,3,0,1,3072,28,8690176598
915,19371920,3001677,22373597,8,0,0,133632,12,5379747309
916,19376870,4566030,23942900,1,0,0,242688,23,1206356052
917,19379140,5612932,24992072,6,0,0,1536,19,6754610994
918,19457550,33393919,52851469,3,0,1,24064,28,4037021098
919,19463370,33388122,52851492,3,0,1,1536,28,9340617850
920,19499941,2991113,22491054,2,0,0,29184,0,838511165
921,19544100,4485661,24029761,8,0,0,80896,12,3766732705
922,19553840,5816568,25370408,9,0,0,82432,10,6093788769
923,19558990,6063070,25622060,1,0,0,420352,23,5208199546
924,19560989,5210548,24771537,0,0,0,39936,6,8994079530
925,19581751,2119508,21701259,7,0,0,62464,14,3227223702
926,19604409,3030052,22634461,0,0,0,9728,6,851440852
927,19606310,33245205,52851515,5,0,1,11264,1,9877009344
928,19665760,33233600,52899360,3,0,1,22528,28,3212477065
929,19666080,33575777,53241857,3,0,1,19456,28,454823983
930,19694520,1718889,21413409,9,0,0,66560,10,4337556447
931,19696810,5401770,25098580,6,0,0,3584,19,5227282745
932,19705689,1398882,21104571,5,0,0,2048,1,1042553332
933,19725089,5575855,25300944,5,0,0,512,1,6469818110
934,19786890,3243698,23030588,6,0,0,6144,19,5948572114
935,19796329,5195260,24991589,0,0,0,225280,6,933759396
936,19799960,3544730,23344690,8,0,0,109568,12,9781556575
937,19804990,33436898,53241888,3,0,1,2048,28,1043103210
938,19820490,4624082,24444572,8,0,0,263680,12,6847994608
939,19835670,33406241,53241911,3,0,1,4608,28,4461742843
940,19837990,2546581,22384571,9,0,0,34816,10,10334219980
941,19838200,33403734,53241934,6,0,1,11776,19,6098705827
942,19838210,33478540,53316750,5,0,1,25600,1,1656765424
943,19850300,4461388,24311688,9,0,0,27648,10,8251806066
944,19854551,6211180,26065731,2,0,0,357376,0,9082126597
945,19857460,4622391,24479851,8,0,0,115712,12,732316177
946,19882729,3567015,23449744,0,0,0,34816,6,9686700407
947,19911410,33409933,53321343,5,0,1,31744,1,3124758560
948,19928840,3534803,23463643,9,0,0,45568,10,2206172111
949,19942921,5551024,25493945,7,0,0,145408,14,7361083073
950,19982200,33339166,53321366,5,0,1,5120,1,6938172966
951,20021571,5322201,25343772,2,0,0,60416,0,5940740760
952,20049550,4061862,24111412,6,0,0,13824,19,4530785094
953,20077551,4612834,24690385,7,0,0,57344,14,1691633937
954,20079071,1447744,21526815,7,0,0,4096,14,11791700
955,20082740,4438225,24520965,9,0,0,5120,10,6241065049
956,20085520,5557795,25643315,4,0,0,69632,9,1123137226
957,20093531,4952844,25046375,2,0,0,178176,0,1362883545
958,20108040,5173573,25281613,8,0,0,143360,12,10640540372
959,20142530,5795695,25938225,6,0,0,448512,19,10599191793
960,20194020,33206952,53400972,5,0,1,16896,1,8025949484
961,20209561,5893321,26102882,7,0,0,121856,14,6006137612
962,20231720,33200350,53432070,5,0,1,16384,1,8566314191
963,20244069,2969478,23213547,5,0,0,512,1,8963660534
964,20264461,5692359,25956820,2,0,0,60928,0,150769910
965,20304790,3056787,23361577,1,0,0,55296,23,1003277739
966,20346330,3444290,23790620,4,0,0,12800,9,9394040674
967,20356659,5368548,25725207,0,0,0,197120,6,3503943385
968,20363051,5377771,25740822,2,0,0,51200,0,6384767527
969,20363680,5413515,25777195,4,0,0,94208,9,6175683992
970,20371910,33496521,53868431,0,0,1,80384,6,6980488968
971,20420729,5697159,26117888,0,0,0,33280,6,2132149212
972,20425410,5711674,26137084,4,0,0,42496,9,5607609695
973,20451051,5296494,25747545,2,0,0,22016,0,915041218
974,20452481,5770684,26223165,2,0,0,117248,0,4500934693
975,20462151,5935289,26397440,7,0,0,158208,14,9455260942
976,20491700,7684166,28175866,8,0,0,74752,12,5439937698
977,20508359,5820153,26328512,5,0,0,2560,1,2882665758
978,20516900,1628835,22145735,6,0,0,512,19,4386261023
979,20517180,33351274,53868454,5,0,1,8704,1,2494962702
980,20533030,33335790,53868820,2,0,1,53248,0,10736458462
981,20533230,3148410,23681640,4,0,0,11264,9,1000198770
982,20534690,4562751,25097441,8,0,0,12288,12,2591119472
983,20547449,5613378,26160827,0,0,0,77824,6,2260789448
984,20551211,4368276,24919487,2,0,0,39424,0,7534311314
985,20557329,6198916,26756245,0,0,0,259072,6,1862623814
986,20563250,5560308,26123558,1,0,0,17920,23,4156655818
987,20605140,7103473,27708613,9,0,0,185344,10,9524487791
988,20641560,6730571,27372131,8,0,0,285184,12,4497503212
989,20648410,2919432,23567842,4,0,0,106496,9,10160685717
990,20685469,5643214,26328683,5,0,0,512,1,8019224368
991,20707940,5479486,26187426,9,0,0,87040,10,5489185470
992,20737970,6144231,26882201,9,0,0,42496,10,5422896264
993,20839070,33029781,53868851,5,0,1,8704,1,3615288343
994,20839689,33070252,53909941,1,0,1,37888,23,9713932081
995,20848361,7543220,28391581,7,0,0,23552,14,9901847317
996,20849340,6019898,26869238,6,0,0,55296,19,3552729590
997,20892631,7260436,28153067,2,0,0,57344,0,6704660834
998,20920050,5600518,26520568,1,0,0,130560,23,1175191698
999,20938140,32971824,53909964,7,0,1,17408,14,2680793071
1000,20950340,5705091,26655431,9,0,0,149504,10,4082345955
1001,20953239,5703619,26656858,5,0,0,4608,1,9372738539
1002,20978651,4822903,25801554,7,0,0,79872,14,7396657206
1003,20990040,32920134,53910174,1,0,1,17920,23,8967808075
1004,21001170,5841292,26842462,1,0,0,177664,23,8854014072
1005,21005551,6574595,27580146,7,0,0,102912,14,5311154664
1006,21007260,4395908,25403168,1,0,0,35328,23,10575554301
1007,21012980,33091770,54104750,4,0,1,44032,9,6609030021
1008,21014691,5870957,26885648,2,0,0,11264,0,2557874156
1009,21034610,7897151,28931761,8,0,0,290304,12,6680100967
1010,21064350,33059714,54124064,3,0,1,7680,28,6759707483
1011,21106310,6318432,27424742,9,0,0,172544,10,7811266172
1012,21111810,3981864,25093674,8,0,0,155136,12,9924900235
1013,21124280,6856783,27981063,4,0,0,307712,9,9172793525
1014,21148070,7411739,28559809,1,0,0,167936,23,5759487897
1015,21161230,2991940,24153170,1,0,0,52736,23,2751878804
1016,21176541,7535004,28711545,2,0,0,259072,0,10577462149
1017,21181170,32942917,54124087,5,0,1,37376,1,5169947854
1018,21203590,33021841,54225431,3,0,1,14336,28,7919354752
1019,21204521,5832865,27037386,7,0,0,98304,14,1922022360
1020,21214610,33010844,54225454,1,0,1,512,23,6421872609
1021,21228740,32996737,54225477,5,0,1,23040,1,7825684081
1022,21363490,6256148,27619638,9,0,0,106496,10,3729999366
1023,21388171,6406495,27794666,7,0,0,42496,14,8920360180
1024,21438569,1923499,23362068,5,0,0,1536,1,3529950764
1025,21474990,32750510,54225500,9,0,1,5632,10,3809250335
1026,21477841,5114110,26591951,2,0,0,107520,0,7370629987
1027,21478770,6553262,28032032,6,0,0,144896,19,650191957
1028,21485591,6142018,27627609,2,0,0,26112,0,1878643008
1029,21514080,7093718,28607798,6,0,0,19456,19,1588144359
1030,21555019,6159739,27714758,5,0,0,2048,1,6754099992
1031,21596071,7407114,29003185,2,0,0,64512,0,8500489950
1032,21625151,7358355,28983506,2,0,0,72704,0,4863097524
1033,21630650,4014460,25645110,4,0,0,5632,9,8271473549
1034,21679489,5959367,27638856,0,0,0,36864,6,9173557151
1035,21695331,6116855,27812186,7,0,0,35840,14,6352792246
1036,21712999,4812952,26525951,0,0,0,17408,6,8892196485
1037,21744530,32480993,54225523,1,0,1,3072,23,7221169022
1038,21758421,4909571,26667992,2,0,0,8704,0,9177098381
1039,21783631,5188173,26971804,7,0,0,24576,14,9537960053
1040,21783989,4334078,26118067,5,0,0,512,1,4780963221
1041,21811270,4507966,26319236,9,0,0,71168,10,10545632027
1042,21883410,7457656,29341066,9,0,0,64000,10,3496714206
1043,21950790,32274756,54225546,1,0,1,22528,23,6421396464
1044,21981870,4485195,26467065,1,0,0,2560,23,2603467342
1045,21982501,4341914,26324415,2,0,0,16896,0,4418790806
1046,21987359,7421652,29409011,0,0,0,24064,6,9512882990
1047,22037650,7636091,29673741,6,0,0,170496,19,10112234460
1048,22039580,6344802,28384382,8,0,0,192512,12,1169514325
1049,22065861,7485237,29551098,7,0,0,165888,14,9378887949
1050,22089890,7520066,29609956,6,0,0,190464,19,9496414562
1051,22101930,7767369,29869299,4,0,0,76800,9,5653632154
1052,22194800,6761008,28955808,4,0,0,78848,9,6455059140
1053,22203270,5245675,27448945,8,0,0,79360,12,4375873108
1054,22235730,6362662,28598392,6,0,0,114176,19,7371157075
1055,22289560,8054502,30344062,8,0,0,153600,12,5124138086
1056,22321270,793752,23115022,9,0,0,1024,10,2295133044
1057,22368280,8260050,30628330,1,0,0,145920,23,5563867066
1058,22401290,3722823,26124113,6,0,0,1536,19,7702655489
1059,22407010,31818738,54225748,5,0,1,24576,1,7921879816
1060,22431700,8580193,31011893,9,0,0,513024,10,194562508
1061,22435590,6407704,28843294,6,0,0,159744,19,3757030995
1062,22462599,4748361,27210960,0,0,0,92160,6,5799332775
1063,22541591,5443903,27985494,7,0,0,14336,14,82418813
1064,22553410,6841039,29394449,8,0,0,175104,12,4050855673
1065,22564500,8645160,31209660,8,0,0,419328,12,1575594167
1066,22586120,31639651,54225771,1,0,1,4096,23,9244159869
1067,22641660,6610138,29251798,4,0,0,129536,9,1391906745
1068,22753151,6798750,29551901,2,0,0,2560,0,2947499618
1069,22761670,31497609,54259279,1,0,1,14336,23,5516835747
1070,22794480,7502751,30297231,1,0,0,368640,23,4249113015
1071,22823770,31436380,54260150,3,0,1,12288,28,7958354505
1072,22830840,8436446,31267286,1,0,0,150016,23,6805616989
1073,22868920,7675569,30544489,1,0,0,138240,23,2670168673
1074,22869570,7567537,30437107,8,0,0,203264,12,2566821016
1075,22922430,31348146,54270576,1,0,1,17408,23,2094015703
1076,22968790,7615057,30583847,8,0,0,71168,12,2326635947
1077,22979670,6935980,29915650,8,0,0,51200,12,4441470033
1078,22986579,8363276,31349855,0,0,0,11264,6,24462113
1079,22989741,7512597,30502338,7,0,0,214016,14,5285828577
1080,23004081,6134859,29138940,7,0,0,57856,14,3914417204
1081,23072790,31210524,54283314,6,0,1,1536,19,10336726942
1082,23094700,7760858,30855558,2,0,0,208384,0,245841144
1083,23108661,8112878,31221539,7,0,0,38912,14,8880963955
1084,23111890,31173012,54284902,6,0,1,15872,19,6479185433
1085,23123900,4330060,27453960,8,0,0,16384,12,878274012
1086,23139000,4686931,27825931,8,0,0,28672,12,9835919795
1087,23147860,5578856,28726716,4,0,0,49664,9,3664227978
1088,23173710,31112472,54286182,6,0,1,14336,19,5866370557
1089,23210200,5958899,29169099,9,0,0,71168,10,1828560290
1090,23226840,6720657,29947497,6,0,0,104448,19,988731170
1091,23241940,8371415,31613355,1,0,0,19456,23,8159125179
1092,23252020,8476199,31728219,9,0,0,57856,10,1510236920
1093,23283740,3605871,26889611,6,0,0,12800,19,9832223318
1094,23306530,7068622,30375152,4,0,0,67072,9,4757772331
1095,23324400,8088909,31413309,9,0,0,79872,10,3446222813
1096,23330810,6854078,30184888,6,0,0,95232,19,7344699976
1097,23340291,7014402,30354693,2,0,0,34816,0,2167012555
1098,23351620,5250227,28601847,8,0,0,11264,12,4569054328
1099,23376101,4350000,27726101,7,0,0,18432,14,2192226081
1100,23377590,8145878,31523468,6,0,0,361472,19,8643457034
1101,23403149,5918394,29321543,0,0,0,110080,6,5590617618
1102,23445721,4436974,27882695,7,0,0,27136,14,4538796061
1103,23492289,5998682,29490971,0,0,0,71680,6,5254955978
1104,23498340,5230271,28728611,1,0,0,6144,23,10191676761
1105,23511920,30777808,54289728,1,0,1,5632,23,6392129588
1106,23566070,7225973,30792043,9,0,0,349696,10,7130497624
1107,23637000,8518695,32155695,9,0,0,320512,10,8672608907
1108,23653370,4979224,28632594,6,0,0,6144,19,3157768962
1109,23656761,4849097,28505858,7,0,0,48640,14,6976983918
1110,23693500,30604138,54297638,6,0,1,18944,19,10665710143
1111,23698270,30613402,54311672,6,0,1,5120,19,7483290089
1112,23718890,6843250,30562140,9,0,0,57856,10,5347881327
1113,23731430,30684533,54415963,0,0,1,96256,6,6305300980
1114,23756320,7954248,31710568,9,0,0,116224,10,5908382526
1115,23762280,30655309,54417589,1,0,1,2560,23,40673332
1116,23762740,8246766,32009506,8,0,0,148480,12,5328980804
1117,23767190,3693673,27460863,1,0,0,22528,23,1956006444
1118,23795100,30747272,54542372,6,0,1,25088,19,5520410186
1119,23796930,30850156,54647086,0,0,1,44544,6,5912878022
1120,23805130,1117804,24922934,1,0,0,11264,23,9451924542
1121,23811840,8436796,32248636,6,0,0,148992,19,5489388338
1122,23813350,31153535,54966885,0,0,1,33792,6,4521831325
1123,23832640,8481391,32314031,6,0,0,5120,19,6500836910
1124,23837270,5124029,28961299,4,0,0,17920,9,6306136409
1125,23837990,7702357,31540347,1,0,0,55296,23,424968212
1126,23842680,7239193,31081873,8,0,0,58880,12,3754556523
1127,23844240,31640529,55484769,0,0,1,79360,6,5445999879
1128,23892510,31593865,55486375,8,0,1,9728,12,7883644310
1129,23899670,5780178,29679848,9,0,0,19968,10,5142464544
1130,23913230,7468232,31381462,1,0,0,24576,23,159978727
1131,23927920,31743462,55671382,1,0,1,64512,23,7628071002
1132,23939610,8990011,32929621,8,0,0,105472,12,1424269035
1133,23946370,7971977,31918347,8,0,0,153600,12,4021822859
1134,23950410,31720995,55671405,8,0,1,7680,12,3048763010
1135,23952380,7636354,31588734,8,0,0,56320,12,9660149664
1136,23952850,7992866,31945716,6,0,0,2560,19,5317222615
1137,23995170,32103001,56098171,0,0,1,284160,6,8700939476
1138,24033900,9791123,33825023,8,0,0,541184,12,7406699631
1139,24044330,32053864,56098194,6,0,1,12288,19,4401975865
1140,24052300,32045917,56098217,1,0,1,5120,23,7603419007
1141,24114970,31983270,56098240,1,0,1,5120,23,3562224441
1142,24126070,31972193,56098263,2,0,1,1536,0,10019672514
1143,24128340,32023353,56151693,0,0,1,171008,6,3326530289
1144,24153300,9098877,33252177,8,0,0,253440,12,2987716596
1145,24191360,8011857,32203217,9,0,0,136192,10,6963548505
1146,24202660,32014289,56216949,0,0,1,73728,6,2919342153
1147,24207970,8398226,32606196,1,0,0,105984,23,3527520779
1148,24228500,8601526,32830026,4,0,0,17920,9,6786429017
1149,24235260,32105339,56340599,1,0,1,10240,23,9517161271
1150,24252380,9156286,33408666,1,0,0,74752,23,6990073857
1151,24256380,32084242,56340622,1,0,1,7168,23,4344512115
1152,24269790,32070855,56340645,3,0,1,4096,28,2027660942
1153,24272651,6781408,31054059,2,0,0,82432,0,5459957607
1154,24274950,32079781,56354731,6,0,1,6144,19,8441799345
1155,24276410,32078344,56354754,6,0,1,10240,19,4797522759
1156,24311430,32043347,56354777,1,0,1,10752,23,10721730962
1157,24312860,32080051,56392911,3,0,1,48128,28,5886926127
1158,24316660,4159779,28476439,6,0,0,14336,19,2042554930
1159,24319850,5739080,30058930,4,0,0,12288,9,2763496858
1160,24330490,32075891,56406381,6,0,1,11264,19,9716872200
1161,24335110,32071294,56406404,3,0,1,4608,28,4625361750
1162,24339250,32067177,56406427,6,0,1,32768,19,9481920711
1163,24352860,32064570,56417430,0,0,1,16384,6,8583200197
1164,24369990,32047696,56417686,6,0,1,9216,19,4526658118
1165,24416400,32222329,56638729,0,0,1,94720,6,1335590974
1166,24417160,9594391,34011551,9,0,0,232960,10,9222721978
1167,24419090,32282751,56701841,8,0,1,15872,12,5029615173
1168,24420549,7538926,31959475,0,0,0,45056,6,6346298971
1169,24440370,32261985,56702355,3,0,1,26624,28,988834370
1170,24446490,32272732,56719222,1,0,1,18944,23,9896336331
1171,24486840,9447117,33933957,2,0,0,353280,0,1627711569
1172,24489280,32363405,56852685,3,0,1,10240,28,4911242822
1173,24490610,32362589,56853199,3,0,1,4608,28,1107250693
1174,24493890,9898977,34392867,9,0,0,106496,10,7489361251
1175,24495160,9773088,34268248,1,0,0,470016,23,6036496383
1176,24526810,8047071,32573881,6,0,0,312832,19,7952065004
1177,24539500,32313722,56853222,1,0,1,8192,23,4009909278
1178,24541260,32311985,56853245,8,0,1,8192,12,10567195846
1179,24547810,32317181,56864991,1,0,1,19456,23,3089400753
1180,24554890,7316634,31871524,4,0,0,299520,9,1375632463
1181,24572140,32625725,57197865,6,0,1,35328,19,1584456575
1182,24578260,32675031,57253291,6,0,1,8704,19,4135530667
1183,24608120,32645194,57253314,8,0,1,20992,12,2385744683
1184,24618650,8860624,33479274,1,0,0,71168,23,8987604169
1185,24632890,32752276,57385166,0,0,1,63488,6,8988910002
1186,24650320,32811870,57462190,3,0,1,10240,28,9810849942
1187,24677330,8346668,33023998,6,0,0,53248,19,2109614138
1188,24728980,32752765,57481745,1,0,1,29696,23,1381022728
1189,24742590,32750945,57493535,1,0,1,2048,23,2734120732
1190,24780990,32713531,57494521,3,0,1,1536,28,294554972
1191,24782170,9819831,34602001,9,0,0,72192,10,10290409461
1192,24789229,9571167,34360396,0,0,0,208896,6,8014365849
1193,24831481,6197439,31028920,7,0,0,55808,14,5809093249
1194,24834050,1273683,26107733,8,0,0,15872,12,5531222617
1195,24913360,7031553,31944913,4,0,0,79360,9,2983742124
1196,24916300,8634260,33550560,4,0,0,199168,9,6567907745
1197,24980641,5129419,30110060,7,0,0,14848,14,7823641344
1198,24997570,32498577,57496147,6,0,1,2560,19,958198332
1199,24999600,32498813,57498413,1,0,1,3584,23,2727424392
1200,25008890,32512143,57521033,8,0,1,30720,12,10194883637
1201,25034360,7124634,32158994,8,0,0,10752,12,2496465679
1202,25059680,8221723,33281403,6,0,0,53248,19,8974480421
1203,25076480,32570443,57646923,3,0,1,9216,28,9832413641
1204,25100711,10042221,35142932,7,0,0,671232,14,10192163349
1205,25101730,10378932,35480662,9,0,0,400896,10,2235743627
1206,25130610,32516336,57646946,8,0,1,12800,12,7899900632
1207,25139380,32901581,58040961,0,0,1,150528,6,9877239694
1208,25151340,32889644,58040984,8,0,1,13824,12,2998035340
1209,25190290,32850725,58041015,8,0,1,7680,12,4970171762
1210,25277891,10544931,35822822,7,0,0,146432,14,8593042030
1211,25287209,8837808,34125017,0,0,0,249344,6,7425335594
1212,25315090,8981635,34296725,1,0,0,40448,23,1808779117
1213,25323580,8958263,34281843,4,0,0,44544,9,5119404457
1214,25348560,7320268,32668828,1,0,0,6656,23,5225034152
1215,25367830,32801338,58169168,1,0,1,65024,23,2558048897
1216,25371090,10301450,35672540,2,0,0,158208,0,3923343196
1217,25375410,10402773,35778183,8,0,0,346624,12,246531151
1218,25384950,9152889,34537839,2,0,0,131584,0,2589931387
1219,25390960,32778239,58169199,4,0,1,10752,9,6594733882
1220,25412690,10171298,35583988,8,0,0,316928,12,8966572222
1221,25413070,8029829,33442899,6,0,0,6144,19,1898229793
1222,25421470,10670036,36091506,8,0,0,123392,12,3936231365
1223,25463030,7802118,33265148,4,0,0,42496,9,9454086591
1224,25476791,10147522,35624313,7,0,0,26112,14,4460887822
1225,25479430,32689792,58169222,1,0,1,6144,23,9636601929
1226,25504791,7310653,32815444,7,0,0,35328,14,2224336229
1227,25506260,32663001,58169261,3,0,1,55296,28,7922854145
1228,25509950,9848541,35358491,6,0,0,199168,19,2671179633
1229,25519131,8765247,34284378,7,0,0,8192,14,284990493
1230,25533620,10601597,36135217,6,0,0,143360,19,7706041380
1231,25560860,32608424,58169284,0,0,1,15872,6,4356461406
1232,25591880,32659662,58251542,0,0,1,44032,6,7719773720
1233,25606530,32665806,58272336,1,0,1,44032,23,10271917587
1234,25624330,32648045,58272375,0,0,1,138752,6,9501621834
1235,25634910,10621651,36256561,8,0,0,226304,12,7806754693
1236,25637020,6283690,31920710,1,0,0,7680,23,6846720791
1237,25711410,32792493,58503903,0,0,1,73728,6,10492968980
1238,25768430,32735496,58503926,6,0,1,8704,19,8096005313
1239,25783930,32720838,58504768,0,0,1,66048,6,9431906264
1240,25788170,32716621,58504791,8,0,1,11264,12,2466639241
1241,25806690,10180367,35987057,8,0,0,66048,12,2551785280
1242,25851889,7706650,33558539,0,0,0,26112,6,5914372756
1243,25861091,8583185,34444276,2,0,0,127488,0,2383923485
1244,25861520,10314795,36176315,1,0,0,126464,23,56150097
1245,25885810,7187822,33073632,4,0,0,9728,9,6432224105
1246,25900740,32604074,58504814,8,0,1,1536,12,1497282490
1247,25903901,10664337,36568238,7,0,0,182272,14,1168008209
1248,25916711,10580423,36497134,7,0,0,419328,14,1531689375
1249,25925749,7562128,33487877,0,0,0,28160,6,1222042799
1250,25926410,8122604,34049014,4,0,0,122880,9,8525101445
1251,25953279,8958753,34912032,0,0,0,48128,6,4679915856
1252,25980400,32524437,58504837,4,0,1,20992,9,8680498694
1253,25990920,8589062,34579982,9,0,0,138240,10,1862434269
1254,26001749,32503111,58504860,1,0,1,8192,23,4684018880
1255,26017230,10036649,36053879,9,0,0,165376,10,6762158104
1256,26062209,32460693,58522902,1,0,1,40960,23,7678863438
1257,26066510,32457698,58524208,4,0,1,2048,9,8322996347
1258,26069880,32507913,58577793,8,0,1,26624,12,8062246537
1259,26086499,32491317,58577816,1,0,1,19456,23,7685144591
1260,26090419,7735875,33826294,0,0,0,4096,6,8006399056
1261,26097631,10271716,36369347,2,0,0,54784,0,8283010813
1262,26103320,32474519,58577839,7,0,1,17408,14,7107863074
1263,26131110,3270538,29401648,6,0,0,23552,19,2472290736
1264,26132420,32445442,58577862,8,0,1,12800,12,4601038268
1265,26133000,32444893,58577893,0,0,1,24576,6,830576751
1266,26146279,32434553,58580832,1,0,1,5120,23,4685270931
1267,26161899,32421391,58583290,1,0,1,28160,23,9881617054
1268,26176210,32435039,58611249,6,0,1,12288,19,8062268711
1269,26184750,32426960,58611710,3,0,1,10240,28,8241182023
1270,26198901,10153731,36352632,2,0,0,160256,0,4782894777
1271,26213950,32412444,58626394,6,0,1,20992,19,7873055930
1272,26233251,10049541,36282792,2,0,0,86016,0,1793381988
1273,26256290,32432852,58689142,8,0,1,39424,12,4279029140
1274,26266310,9921260,36187570,8,0,0,36864,12,8098133750
1275,26326470,32363338,58689808,6,0,1,1024,19,4251904181
1276,26334950,32361880,58696830,8,0,1,7680,12,2031164470
1277,26337471,10687766,37025237,2,0,0,283648,0,5971279666
1278,26357890,32339606,58697496,6,0,1,1024,19,6202297743
1279,26370040,32328442,58698482,8,0,1,1536,12,5732558212
1280,26370940,32332688,58703628,7,0,1,8192,14,7190440867
1281,26387130,33138611,59525741,0,0,1,288768,6,9308824935
1282,26401339,10669660,37070999,0,0,0,145920,6,5619119238
1283,26405860,33119904,59525764,3,0,1,2560,28,8136017357
1284,26421349,9194985,35616334,0,0,0,45056,6,6768755305
1285,26442370,33094615,59536985,7,0,1,55296,14,1627956647
1286,26465840,33081255,59547095,4,0,1,8704,9,9382069254
1287,26477240,10105217,36582457,8,0,0,46592,12,4604149954
1288,26492710,33059877,59552587,8,0,1,8704,12,1853223796
1289,26501380,6244218,32745598,4,0,0,25600,9,4793071469
1290,26515480,8738281,35253761,8,0,0,251904,12,10113506586
1291,26525500,33029673,59555173,7,0,1,4096,14,7503048498
1292,26536661,8148191,34684852,2,0,0,111104,0,1704229977
1293,26545389,33038412,59583801,1,0,1,38912,23,10599168198
1294,26548670,33036757,59585427,4,0,1,2560,9,5744443694
1295,26581919,33019432,59601351,4,0,1,18944,9,710360246
1296,26597770,33012609,59610379,9,0,1,3072,10,4804898131
1297,26606980,33005345,59612325,8,0,1,3072,12,5043665852
1298,26627119,10206271,36833390,0,0,0,457216,6,284556309
1299,26628900,33098843,59727743,0,0,1,73216,6,10324556627
1300,26629110,33098656,59727766,9,0,1,5632,10,3669803623
1301,26668559,33174693,59843252,4,0,1,40448,9,859971171
1302,26674490,8812903,35487393,6,0,0,22016,19,5205327765
1303,26678129,7262403,33940532,0,0,0,21504,6,5876624187
1304,26689780,8912803,35602583,8,0,0,60928,12,7582461651
1305,26706561,9260341,35966902,7,0,0,314880,14,2691668299
1306,26764390,33078885,59843275,6,0,1,22016,19,5927552198
1307,26768260,33075038,59843298,3,0,1,2048,28,4258866016
1308,26781660,10157130,36938790,6,0,0,45056,19,8443329742
1309,26798660,10787665,37586325,9,0,0,47616,10,8060487326
1310,26807170,9476737,36283907,6,0,0,3584,19,10188364946
1311,26838320,33005359,59843679,7,0,1,106496,14,10398609513
1312,26843370,10844205,37687575,1,0,0,3072,23,2610841548
1313,26863820,32980373,59844193,4,0,1,21504,9,945272467
1314,26865330,32981953,59847283,7,0,1,4096,14,914936855
1315,26867039,10558428,37425467,0,0,0,298496,6,3522143754
1316,26877590,32978644,59856234,6,0,1,37376,19,8747072493
1317,26880419,1514017,28394436,0,0,0,9216,6,5342367171
1318,26916119,32994546,59910665,4,0,1,11264,9,311533149
1319,26925060,32985628,59910688,3,0,1,6144,28,7929787187
1320,26926000,32984711,59910711,3,0,1,20992,28,468011719
1321,26985399,32925343,59910742,4,0,1,4096,9,2349398152
1322,26986990,32923783,59910773,0,0,1,19968,6,1012433412
1323,27013169,32905120,59918289,4,0,1,30720,9,7439417931
1324,27021941,8140982,35162923,2,0,0,65536,0,9104490575
1325,27030160,10571180,37601340,4,0,0,49152,9,1779674896
1326,27033670,32889765,59923435,9,0,1,8192,10,1962133514
1327,27034071,9659988,36694059,2,0,0,203264,0,9823115998
1328,27082700,32866314,59949014,5,0,1,39424,1,4555716542
1329,27087120,32863840,59950960,9,0,1,3072,10,8699701896
1330,27092859,32869098,59961957,4,0,1,25600,9,3432861172
1331,27099840,32862373,59962213,3,0,1,9216,28,8540981526
1332,27104679,32863026,59967705,1,0,1,8704,23,5868562388
1333,27112700,4229214,31341914,9,0,0,66560,10,8544168499
1334,27121070,7281804,34402874,1,0,0,32768,23,7501504790
1335,27126229,32848367,59974596,1,0,1,5120,23,1645216355
1336,27144870,10694226,37839096,9,0,0,98816,10,7954630983
1337,27151010,32824918,59975928,9,0,1,22528,10,7937433032
1338,27177990,32837905,60015895,9,0,1,30208,10,9207448678
1339,27191060,32829661,60020721,6,0,1,7680,19,10019222801
1340,27219850,32805057,60024907,3,0,1,6656,28,6215264264
1341,27221310,32804775,60026085,7,0,1,13824,14,249239857
1342,27225140,10296087,37521227,9,0,0,43008,10,4367273825
1343,27244359,10381184,37625543,0,0,0,79360,6,913721632
1344,27255470,32772241,60027711,6,0,1,2560,19,7134524753
1345,27263340,32764717,60028057,6,0,1,512,19,209095254
1346,27266871,9821958,37088829,7,0,0,26624,14,1134339359
1347,27274640,7185891,34460531,6,0,0,53248,19,4023237431
1348,27286149,10221951,37508100,0,0,0,134656,6,1066005566
1349,27297571,10036925,37334496,7,0,0,257024,14,7561433640
1350,27297809,32731631,60029440,4,0,1,14848,9,10166926298
1351,27338620,32895522,60234142,0,0,1,119808,6,3735631836
1352,27383510,10075224,37458734,4,0,0,109056,9,8386366192
1353,27387039,32852544,60239583,4,0,1,25600,9,9061002026
1354,27388120,33045550,60433670,0,0,1,152576,6,2134038177
1355,27435140,10208366,37643506,6,0,0,58880,19,9652951797
1356,27443700,32989993,60433693,7,0,1,10752,14,754830051
1357,27446080,32987636,60433716,7,0,1,21504,14,2825025932
1358,27447190,32986549,60433739,9,0,1,18432,10,3223597167
1359,27455921,11023012,38478933,2,0,0,123904,0,6098100505
1360,27463310,9168778,36632088,8,0,0,162816,12,7659062026
1361,27464840,32968930,60433770,7,0,1,20480,14,422321512
1362,27492900,33035288,60528188,6,0,1,18432,19,8120080709
1363,27498541,10283647,37782188,2,0,0,208384,0,4610681136
1364,27516120,10292813,37808933,6,0,0,87552,19,3178690101
1365,27518290,33040269,60558559,6,0,1,23040,19,5193835423
1366,27550071,8320868,35870939,2,0,0,41472,0,2863282993
1367,27553930,10592812,38146742,4,0,0,82432,9,2242048837
1368,27621720,32969277,60590997,6,0,1,31232,19,10165806066
1369,27682360,32912907,60595267,5,0,1,4096,1,7756252421
1370,27721830,10382894,38104724,6,0,0,205824,19,7309487119
1371,27729761,9937332,37667093,7,0,0,77312,14,4908800457
1372,27731710,10709440,38441150,6,0,0,192512,19,612127195
1373,27757130,32839763,60596893,7,0,1,2560,14,6966892951
1374,27764329,32832820,60597149,1,0,1,9216,23,2651404902
1375,27771861,10270128,38041989,7,0,0,371712,14,1048759740
1376,27786950,7510826,35297776,8,0,0,144384,12,3277078594
1377,27798860,32867390,60666250,7,0,1,8192,14,10264313958
1378,27803419,10445869,38249288,0,0,0,249344,6,7353622165
1379,27807590,32858699,60666289,7,0,1,34304,14,8619708718
1380,27809790,11293962,39103752,9,0,0,117760,10,7496408662
1381,27810400,8493381,36303781,9,0,0,23040,10,10137717584
1382,27819861,9388510,37208371,7,0,0,306688,14,2272352681
1383,27834370,10287225,38121595,1,0,0,55296,23,886698682
1384,27841790,32898776,60740566,0,0,1,164864,6,8320189678
1385,27848160,10885238,38733398,4,0,0,145408,9,5142074609
1386,27861650,32885666,60747316,6,0,1,3584,19,10099641183
1387,27868170,32962005,60830175,6,0,1,15360,19,8892131043
1388,27882470,32947728,60830198,6,0,1,11776,19,1993205852
1389,27882490,32947731,60830221,9,0,1,2048,10,4023532660
1390,27903970,8596963,36500933,8,0,0,12288,12,8770073767
1391,27927949,10718777,38646726,0,0,0,278016,6,3562048427
1392,27935720,32894524,60830244,3,0,1,9728,28,1362490164
1393,27943040,32887227,60830267,5,0,1,3072,1,8885875763
1394,27943530,32886760,60830290,7,0,1,18432,14,8061223844
1395,27976060,10786244,38762304,4,0,0,35840,9,930081082
1396,27996529,32833784,60830313,1,0,1,2048,23,6854832508
1397,28002579,32827757,60830336,1,0,1,10240,23,7162016678
1398,28004759,11037546,39042305,0,0,0,259072,6,4955160599
1399,28006439,10525893,38532332,0,0,0,175104,6,10645236023
1400,28008360,5625273,33633633,4,0,0,88576,9,10563830507
1401,28023209,8819876,36843085,0,0,0,31744,6,4097642927
1402,28033899,32803461,60837360,1,0,1,39936,23,10670797989
1403,28046390,9525404,37571794,4,0,0,165888,9,10053283136
1404,28061869,9866841,37928710,0,0,0,261120,6,9936999300
1405,28101490,32737929,60839419,7,0,1,9728,14,3787354378
1406,28116590,32752816,60869406,7,0,1,16384,14,1345761989
1407,28137469,32737122,60874591,1,0,1,16384,23,3849952489
1408,28165720,32742175,60907895,0,0,1,52224,6,4959687551
1409,28170260,32741821,60912081,3,0,1,6656,28,4840704928
1410,28176420,32735917,60912337,9,0,1,9216,10,2425884611
1411,28179770,32736433,60916203,5,0,1,6144,1,629872762
1412,28179950,32763379,60943329,9,0,1,63488,10,6982790043
1413,28195491,10555870,38751361,2,0,0,58880,0,867580771
1414,28229210,32735841,60965051,0,0,1,5120,6,7859545872
1415,28254499,8670540,36925039,0,0,0,175616,6,7309138109
1416,28258090,32716613,60974703,9,0,1,3072,10,4293935492
1417,28297980,10610190,38908170,1,0,0,142336,23,6366736331
1418,28315530,6861456,35176986,8,0,0,46080,12,8901760582
1419,28318320,7539960,35858280,4,0,0,77824,9,4043934752
1420,28325880,32653009,60978889,6,0,1,6656,19,8812109204
1421,28335460,10984370,39319830,9,0,0,61440,10,3484310720
1422,28377370,32602083,60979453,7,0,1,10752,14,5159025863
1423,28383870,32618990,61002860,7,0,1,39424,14,7860837194
1424,28391050,32649145,61040195,9,0,1,9216,10,5823510377
1425,28394170,6011239,34405409,9,0,0,8192,10,5084934023
1426,28402279,7432266,35834545,0,0,0,38400,6,3876050656
1427,28433370,32617860,61051230,9,0,1,1536,10,4384410432
1428,28447550,32643604,61091154,7,0,1,24064,14,10658563079
1429,28466670,10398078,38864748,1,0,0,68608,23,6018016688
1430,28479920,32617278,61097198,6,0,1,1536,19,1657910353
1431,28524430,32574048,61098478,3,0,1,14336,28,6636998848
1432,28530020,10433326,38963346,8,0,0,73728,12,1843375850
1433,28553601,10371752,38925353,7,0,0,56320,14,4042451295
1434,28567909,10273393,38841302,0,0,0,181760,6,6920982680
1435,28581880,10261941,38843821,8,0,0,8192,12,2897399009
1436,28605309,32495114,61100423,1,0,1,1024,23,10202374444
1437,28642771,10289945,38932716,2,0,0,24064,0,6567280699
1438,28676920,32427049,61103969,3,0,1,5632,28,9364368988
1439,28680420,32423895,61104315,7,0,1,512,14,1590539882
1440,28682921,10903459,39586380,2,0,0,229376,0,7621623175
1441,28708280,32427964,61136244,3,0,1,44544,28,8046720000
1442,28714801,9974270,38689071,7,0,0,65536,14,10698218799
1443,28741080,10424502,39165582,1,0,0,51200,23,7840460320
1444,28754020,10979115,39733135,9,0,0,169984,10,6527741358
1445,28788420,32363714,61152134,7,0,1,12288,14,5727556520
1446,28789960,32368587,61158547,3,0,1,22528,28,4553881517
1447,28824000,8432161,37256161,1,0,0,73728,23,9639228737
1448,28828080,10321871,39149951,9,0,0,151552,10,1831445040
1449,28832580,32449179,61281759,3,0,1,10752,28,7613076390
1450,28849760,32432750,61282510,7,0,1,10752,14,6859254148
1451,28886090,32517408,61403498,7,0,1,9216,14,1480987604
1452,28900410,32507914,61408324,7,0,1,7680,14,8454154404
1453,28920900,32738452,61659352,3,0,1,6656,28,1019695985
1454,28922180,32881918,61804098,6,0,1,10752,19,2676322043
1455,28943240,32860881,61804121,8,0,1,7680,12,2249949550
1456,28958041,10470746,39428787,7,0,0,354816,14,3274027397
1457,28962700,10293654,39256354,6,0,0,92160,19,7635746733
1458,28989040,32815104,61804144,5,0,1,2560,1,9336415868
1459,29011980,10040511,39052491,9,0,0,13312,10,1068070855
1460,29029030,33026889,62055919,0,0,1,74240,6,8291850600
1461,29038450,33017492,62055942,6,0,1,11776,19,5411511745
1462,29058590,33020077,62078667,0,0,1,12800,6,3254620048
1463,29068130,33013123,62081253,7,0,1,4096,14,5323503121
1464,29086130,7785378,36871508,8,0,0,93184,12,738092057
1465,29103180,33145562,62248742,3,0,1,8704,28,4147028481
1466,29104900,8128774,37233674,1,0,0,82944,23,5382495710
1467,29115450,33559343,62674793,0,0,1,255488,6,3480273963
1468,29124621,7388058,36512679,7,0,0,14336,14,2933694250
1469,29129000,33545816,62674816,7,0,1,9216,14,5090519852
1470,29147150,1916760,31063910,7,0,0,32256,14,10188925003
1471,29149590,33525249,62674839,5,0,1,4608,1,5954467
1472,29154690,33554359,62709049,3,0,1,24064,28,5573920704
1473,29166661,6971099,36137760,2,0,0,8192,0,2908858560
1474,29190450,33518622,62709072,6,0,1,8704,19,6809044351
1475,29201170,33507925,62709095,7,0,1,10752,14,9821275148
1476,29208400,8640703,37849103,4,0,0,32768,9,2678862819
1477,29253000,33456142,62709142,5,0,1,48128,1,2519923386
1478,29262280,33464622,62726902,9,0,1,17408,10,1288847841
1479,29262850,33464718,62727568,6,0,1,1024,19,372854762
1480,29269120,33463940,62733060,6,0,1,17920,19,7346175889
1481,29275470,8443195,37718665,9,0,0,71680,10,5275867721
1482,29275950,10335748,39611698,1,0,0,73216,23,5826900102
1483,29277030,7837874,37114904,1,0,0,85504,23,630197767
1484,29282511,10547763,39830274,2,0,0,151552,0,8562989934
1485,29285461,7011269,36296730,2,0,0,41984,0,8268571017
1486,29295289,2255784,31551073,0,0,0,512,6,10318738662
1487,29308740,8377876,37686616,6,0,0,64000,19,4538269630
1488,29309480,33596004,62905484,0,0,1,116736,6,2089088233
1489,29329290,10895820,40225110,1,0,0,309248,23,1265143045
1490,29335300,10546945,39882245,6,0,0,170496,19,5616466008
1491,29343821,6659647,36003468,2,0,0,53760,0,1275773566
1492,29367370,33538784,62906154,9,0,1,39936,10,8456657988
1493,29384029,8789256,38173285,0,0,0,87040,6,7977258247
1494,29393720,7632788,37026508,6,0,0,4096,19,5732074495
1495,29399060,10731803,40130863,1,0,0,381952,23,6452420109
1496,29418860,33487317,62906177,7,0,1,11776,14,4085412387
1497,29422480,33483720,62906200,5,0,1,27648,1,6903707687
1498,29426690,33479876,62906566,7,0,1,31744,14,1561704302
1499,29449131,8247671,37696802,2,0,0,30208,0,8754443865
1500,29488810,8837455,38326265,9,0,0,109568,10,10050556336
1501,29507330,10795412,40302742,6,0,0,38400,19,5485697500
1502,29526700,8849508,38376208,9,0,0,163840,10,7592993868
1503,29532469,7548225,37080694,0,0,0,31744,6,9624741766
1504,29547830,33359512,62907342,3,0,1,5120,28,2877684323
1505,29571430,33337192,62908622,3,0,1,14336,28,8765002809
1506,29586430,7880611,37467041,1,0,0,27136,23,8225150996
1507,29651230,6857058,36508288,6,0,0,24064,19,4844077789
1508,29657780,10859383,40517163,8,0,0,406016,12,5643016538
1509,29704230,33210844,62915074,5,0,1,10240,1,5137417872
1510,29718520,8843475,38561995,7,0,0,97280,14,929016948
1511,29721691,9938702,39660393,2,0,0,159744,0,6927146816
1512,29724010,33205936,62929946,3,0,1,12288,28,4254271100
1513,29724021,10290435,40014456,2,0,0,113152,0,9174199614
1514,29735840,33224150,62959990,3,0,1,11776,28,8403279054
1515,29764000,33196656,62960656,5,0,1,1024,1,8932123966
1516,29770870,33204704,62975574,5,0,1,32768,1,1747607433
1517,29794661,10141832,39936493,2,0,0,2048,0,4816765121
1518,29796790,9962058,39758848,4,0,0,18944,9,5529113456
1519,29804020,10589412,40393432,7,0,0,168448,14,3025671928
1520,29808430,33174915,62983345,9,0,1,20480,10,5024947774
1521,29856960,11186791,41043751,1,0,0,10752,23,8620078057
1522,29894510,10972464,40866974,8,0,0,246272,12,1678264133
1523,29910800,33074286,62985086,6,0,1,24576,19,3921507809
1524,29930830,33065858,62996688,7,0,1,14848,14,7292894362
1525,29942950,33091790,63034740,7,0,1,38400,14,9358480313
1526,29944550,33090213,63034763,3,0,1,3584,28,7323919849
1527,29944970,33089816,63034786,6,0,1,10240,19,6213262432
1528,29956090,10385987,40342077,9,0,0,129024,10,294615176
1529,29977400,33090738,63068138,0,0,1,49152,6,8945859708
1530,30009190,8283668,38292858,4,0,0,126976,9,2406755896
1531,30044899,10246120,40291019,0,0,0,181248,6,4683882444
1532,30081239,10496030,40577269,0,0,0,181248,6,8139642883
1533,30116770,32952136,63068906,7,0,1,11776,14,9483361910
1534,30154110,32927064,63081174,5,0,1,4096,1,3480959701
1535,30172500,8887994,39060494,6,0,0,26112,19,8639018086
1536,30176440,8492640,38669080,1,0,0,59904,23,10104123194
1537,30185890,33001525,63187415,5,0,1,26112,1,4626423380
1538,30219520,33072473,63291993,3,0,1,33280,28,9946536492
1539,30237920,33290749,63528669,0,0,1,88064,6,6516179871
1540,30245300,33284351,63529651,7,0,1,9728,14,4709174234
1541,30255190,33274484,63529674,3,0,1,2560,28,715928465
1542,30295729,10453419,40749148,0,0,0,150528,6,4321035082
1543,30313670,10629478,40943148,6,0,0,165888,19,4589965960
1544,30321330,8061141,38382471,4,0,0,20480,9,5695402981
1545,30341330,8444561,38785891,1,0,0,77312,23,6714995712
1546,30371570,33158127,63529697,3,0,1,7680,28,844140161
1547,30382170,33147550,63529720,7,0,1,2048,14,10314290879
1548,30415190,7838957,38254147,9,0,0,15872,10,2487724894
1549,30428960,33100783,63529743,5,0,1,25088,1,6597911293
1550,30440600,33089166,63529766,3,0,1,12288,28,8717593184
1551,30462970,33066819,63529789,5,0,1,31744,1,6884403682
1552,30489920,33039900,63529820,7,0,1,4608,14,3096309380
1553,30500720,33080298,63581018,7,0,1,9728,14,7420556591
1554,30522670,10741696,41264366,1,0,0,306176,23,2528869275
1555,30523280,33139367,63662647,6,0,1,12800,19,1499082482
1556,30530200,33132470,63662670,3,0,1,5632,28,9126737745
1557,30548879,10776506,41325385,0,0,0,200192,6,7934595346
1558,30555029,11371531,41926560,0,0,0,110080,6,10662317277
1559,30565790,11088963,41654753,1,0,0,128512,23,703833041
1560,30575820,33147744,63723564,5,0,1,64000,1,8063020349
1561,30582000,33189563,63771563,3,0,1,14336,28,5762385387
1562,30620660,10171255,40791915,9,0,0,140288,10,3318317817
1563,30661060,10379392,41040452,4,0,0,248320,9,1178135965
1564,30670780,33104755,63775535,9,0,1,3072,10,1310902916
1565,30685461,10008253,40693714,2,0,0,130560,0,8094258923
1566,30691540,33084559,63776099,6,0,1,10752,19,1238670518
1567,30713310,10234426,40947736,9,0,0,12288,10,821062005
1568,30745890,10690790,41436680,1,0,0,260608,23,7514812066
1569,30786280,33091340,63877620,9,0,1,3584,10,3391311589
1570,30897600,32980043,63877643,3,0,1,4096,28,6944855842
1571,30921490,32956200,63877690,5,0,1,8192,1,10142908051
1572,30924050,32953663,63877713,3,0,1,10240,28,3506218538
1573,30961280,10536754,41498034,1,0,0,179200,23,6175431749
1574,30969930,32908141,63878071,5,0,1,13312,1,4056598333
1575,30986049,9645531,40631580,0,0,0,178176,6,10363891187
1576,30990780,32887314,63878094,5,0,1,26112,1,10333367460
1577,30991460,32886657,63878117,7,0,1,5120,14,2285704474
1578,31010979,8056870,39067849,0,0,0,24064,6,5400031476
1579,31039431,10500301,41539732,2,0,0,34816,0,9833257734
1580,31060469,32879025,63939494,4,0,1,20480,9,3513951345
1581,31069620,32869897,63939517,3,0,1,10240,28,832896573
1582,31114190,32831332,63945522,7,0,1,7680,14,363414861
1583,31141809,10438818,41580627,0,0,0,134144,6,1138972943
1584,31160090,9543163,40703253,8,0,0,31232,12,3512414723
1585,31193119,32752458,63945577,1,0,1,6656,23,10510625877
1586,31207930,32737670,63945600,3,0,1,8192,28,8307496313
1587,31208150,32737473,63945623,6,0,1,3584,19,8122577802
1588,31224740,32720906,63945646,5,0,1,7680,1,1736875059
1589,31269830,32675839,63945669,3,0,1,5120,28,1205139310
1590,31288040,8600624,39888664,1,0,0,20992,23,8522452091
1591,31293070,32652622,63945692,3,0,1,8704,28,5645807414
1592,31297110,10407622,41704732,1,0,0,78848,23,9946964670
1593,31301680,32644035,63945715,7,0,1,1536,14,1761354692
1594,31334330,32611408,63945738,6,0,1,15360,19,9935838794
1595,31371120,32574641,63945761,3,0,1,4096,28,5221290640
1596,31385941,7264864,38650805,2,0,0,13312,0,5842136784
1597,31394330,10792719,42187049,9,0,0,260096,10,7549751763
1598,31399750,7883459,39283209,4,0,0,88064,9,7901831349
1599,31405620,8040818,39446438,1,0,0,57856,23,4071433922
1600,31424760,10468237,41892997,4,0,0,132608,9,2976685514
1601,31442720,32503064,63945784,5,0,1,2560,1,4556463265
1602,31457749,9485578,40943327,0,0,0,512,6,2922703137
1603,31470969,8210351,39681320,0,0,0,68608,6,1732306022
1604,31482140,32469403,63951543,7,0,1,10752,14,2849271468
1605,31484900,32469549,63954449,5,0,1,4608,1,2969391743
1606,31490390,32489574,63979964,3,0,1,25600,28,2963018706
1607,31528730,7976197,39504927,1,0,0,115712,23,2093343405
1608,31545650,32436281,63981931,5,0,1,11264,1,10626267997
1609,31557420,10466191,42023611,6,0,0,71168,19,5804620651
1610,31561340,32422179,63983519,3,0,1,15872,28,4651735032
1611,31568559,7372292,38940851,0,0,0,26624,6,9112410744
1612,31595220,32405261,64000481,3,0,1,7680,28,8583449745
1613,31653889,10608012,42261901,0,0,0,141312,6,3940794907
1614,31655190,32347647,64002837,5,0,1,27648,1,8328377118
1615,31668300,10415916,42084216,8,0,0,147456,12,8338405062
1616,31679420,32326003,64005423,5,0,1,4096,1,692045939
1617,31681540,11047892,42729432,1,0,0,146432,23,2449380860
1618,31736980,10647511,42384491,8,0,0,135680,12,2531502343
1619,31753080,8476585,40229665,8,0,0,14848,12,2401725094
1620,31777290,32257388,64034678,6,0,1,11264,19,8952555760
1621,31781220,32265790,64047010,6,0,1,35840,19,1769649622
1622,31801080,32246765,64047845,7,0,1,512,14,7876411078
1623,31819100,11113082,42932182,8,0,0,320000,12,7651006503
1624,31819980,32230451,64050431,7,0,1,4096,14,847842894
1625,31821430,32287702,64109132,7,0,1,7168,14,6122281540
1626,31827910,32281245,64109155,5,0,1,4608,1,8926006722
1627,31830089,8691933,40522022,0,0,0,15872,6,1164540383
1628,31847140,32262038,64109178,5,0,1,2048,1,6754864151
1629,31870460,32357542,64228002,6,0,1,34304,19,3489971045
1630,31901190,9230301,41131491,6,0,0,10752,19,4828478762
1631,31905610,32324018,64229628,3,0,1,2560,28,4443364496
1632,31905810,8748101,40653911,9,0,0,73216,10,3211253114
1633,31989520,9116292,41105812,6,0,0,7168,19,7215209104
1634,32083010,32189032,64272042,7,0,1,47104,14,5013582124
1635,32091620,32530317,64621937,3,0,1,35840,28,6363846833
1636,32124200,32500724,64624924,3,0,1,2048,28,4812897908
1637,32140020,32487490,64627510,3,0,1,4096,28,2895113821
1638,32181180,11163795,43344975,1,0,0,188928,23,2063939084
1639,32186360,10638604,42824964,4,0,0,75776,9,8181951413
1640,32204440,32582221,64786661,3,0,1,21504,28,10379566519
1641,32207150,10985595,43192745,9,0,0,71168,10,2025268740
1642,32209270,32577414,64786684,5,0,1,10240,1,8668140044
1643,32212200,32602480,64814680,7,0,1,26112,14,3342388480
1644,32219540,10901579,43121119,1,0,0,257024,23,5474730846
1645,32246230,10796508,43042738,6,0,0,169984,19,5659736556
1646,32260050,9183361,41443411,4,0,0,22016,9,4482959781
1647,32278660,7701297,39979957,9,0,0,33792,10,5854460050
1648,32287960,32577933,64865893,3,0,1,20480,28,8317156377
1649,32295160,6753252,39048412,8,0,0,19968,12,4171513867
1650,32317150,9487173,41804323,6,0,0,62464,19,8887610034
1651,32319910,32605348,64925258,3,0,1,26624,28,8707548570
1652,32331231,9708003,42039234,2,0,0,51200,0,56645249
1653,32339590,32586974,64926564,3,0,1,2048,28,8596381319
1654,32345140,32606300,64951440,3,0,1,5120,28,2243074620
1655,32363290,32589430,64952720,7,0,1,14336,14,8721080765
1656,32370720,32587831,64958551,3,0,1,16896,28,7209967013
1657,32373610,10060200,42433810,8,0,0,161792,12,3431452403
1658,32475930,9833129,42309059,9,0,0,110080,10,5971575804
1659,32522130,9971349,42493479,4,0,0,64512,9,2688276453
1660,32553440,10936349,43489789,9,0,0,448512,10,1499471285
1661,32554550,11111619,43666169,9,0,0,300544,10,6131259378
1662,32562160,10608878,43171038,8,0,0,64512,12,5163311544
1663,32592310,8300271,40892581,6,0,0,83968,19,8460411992
1664,32634090,32332039,64966129,3,0,1,4096,28,398266659
1665,32675030,32342991,65018021,6,0,1,25600,19,8692120524
1666,32691020,32327667,65018687,6,0,1,1024,19,3611410216
1667,32720939,11007239,43728178,0,0,0,50688,6,3318905344
1668,32728829,8408178,41137007,0,0,0,10240,6,2887321293
1669,32730860,8369572,41100432,9,0,0,41984,10,1527144076
1670,32760600,6828767,39589367,9,0,0,9728,10,8299719760
1671,32772430,32247025,65019455,7,0,1,11776,14,8640643057
1672,32776710,10936001,43712711,6,0,0,138752,19,442649504
1673,32800670,11010733,43811403,6,0,0,75264,19,1238061276
1674,32801580,8532751,41334331,4,0,0,16384,9,4591597926
1675,32809980,8794226,41604206,1,0,0,77312,23,8240407715
1676,32817561,8711540,41529101,2,0,0,101888,0,1485572539
1677,32840040,32180491,65020531,6,0,1,13312,19,6131351035
1678,32843339,10936194,43779533,0,0,0,168448,6,2984300559
1679,32844960,32218163,65063123,8,0,1,3072,12,205119214
1680,32846210,32368481,65214691,3,0,1,38912,28,2677640746
1681,32849480,32373885,65223365,6,0,1,28160,19,3636851551
1682,32885730,7350042,40235772,4,0,0,19968,9,37607991
1683,32905510,11328869,44234379,6,0,0,75264,19,6888218258
1684,32940569,11143866,44084435,0,0,0,513536,6,820848587
1685,33001630,9989293,42990923,4,0,0,109568,9,5044281338
1686,33006750,8939397,41946147,4,0,0,38400,9,6753732565
1687,33008770,9266726,42275496,6,0,0,44544,19,10021852160
1688,33053920,11256331,44310251,1,0,0,77824,23,10613743804
1689,33061330,32242271,65303601,6,0,1,23552,19,1254084306
1690,33065720,32499432,65565152,0,0,1,54784,6,6721001199
1691,33135040,11066377,44201417,4,0,0,132096,9,165753138
1692,33153240,10400875,43554115,6,0,0,210944,19,4466112487
1693,33164900,11237726,44402626,4,0,0,303104,9,305460580
1694,33168570,32524188,65692758,5,0,1,9216,1,4731863947
1695,33180280,9621573,42801853,4,0,0,105984,9,4011644472
1696,33181350,9653309,42834659,8,0,0,31744,12,7134973939
1697,33203110,10467302,43670412,8,0,0,13824,12,7909163053
1698,33230750,11360428,44591178,4,0,0,161280,9,197787822
1699,33245240,11504846,44750086,6,0,0,329216,19,8733626032
1700,33269240,10861573,44130813,8,0,0,74240,12,2587452501
1701,33365100,10209474,43574574,8,0,0,67072,12,6718643640
1702,33458190,9693169,43151359,4,0,0,47616,9,2275937574
1703,33463410,32543466,66006876,6,0,1,34304,19,4834430033
1704,33494400,32532715,66027115,6,0,1,6656,19,8888799791
1705,33510460,11435911,44946371,4,0,0,130048,9,5069916492
1706,33548941,11412521,44961462,2,0,0,49152,0,8763848616
1707,33559100,11090624,44649724,4,0,0,192000,9,2425663096
1708,33596210,32505957,66102167,6,0,1,10240,19,5376796361
1709,33600049,32546417,66146466,4,0,1,19968,9,250513628
1710,33603980,32732218,66336198,3,0,1,40448,28,2232629485
1711,33606330,10637939,44244269,1,0,0,32256,23,2902087711
1712,33678200,10815744,44493944,9,0,0,249856,10,8596279754
1713,33707140,32737094,66444234,8,0,1,32768,12,7791560846
1714,33734731,11667764,45402495,2,0,0,103424,0,8476713813
1715,33750320,11421166,45171486,8,0,0,94720,12,9039311824
1716,33753140,11289148,45042288,6,0,0,65024,19,9761162113
1717,33794640,11082226,44876866,9,0,0,327680,10,10310271500
1718,33876930,9947132,43824062,1,0,0,41472,23,4284572426
1719,33879830,11738908,45618738,4,0,0,269824,9,7244339975
1720,33895190,11211381,45106571,6,0,0,512,19,8030217570
1721,33898770,32545487,66444257,6,0,1,5632,19,5170719460
1722,33927849,11840427,45768276,0,0,0,149504,6,8744132535
1723,33958701,10202445,44161146,2,0,0,4096,0,9077204886
1724,33965320,11968317,45933637,1,0,0,5632,23,4068297242
1725,33973070,10439095,44412165,1,0,0,31232,23,3043201155
1726,34008620,7320688,41329308,8,0,0,12800,12,9648132765
1727,34018620,10192804,44211424,9,0,0,32768,10,7400618442
1728,34033150,32411130,66444280,6,0,1,12288,19,8670567430
1729,34047840,9088972,43136812,1,0,0,46080,23,2069092146
1730,34078860,10073192,44152052,1,0,0,69632,23,6023838243
1731,34110181,12219956,46330137,2,0,0,293376,0,3944322317
1732,34116010,12012362,46128372,6,0,0,48640,19,3785940191
1733,34159440,32284863,66444303,6,0,1,10752,19,6182778847
1734,34187470,32333971,66521441,5,0,1,29184,1,3402014377
1735,34190430,33222038,67412468,6,0,1,400896,19,6599196377
1736,34220319,9044996,43265315,0,0,0,123392,6,6837478596
1737,34224390,33223380,67447770,6,0,1,53760,19,8617475211
1738,34227460,8965799,43193259,1,0,0,1536,23,9542970305
1739,34253790,9534658,43788448,4,0,0,29184,9,3170290167
1740,34267150,12285861,46553011,4,0,0,157184,9,3940762626
1741,34279530,8660483,42940013,8,0,0,25600,12,5785490041
1742,34312400,33135393,67447793,5,0,1,9216,1,9811251222
1743,34353990,11308760,45662750,9,0,0,75264,10,8450514190
1744,34355970,10186045,44542015,9,0,0,157696,10,4657294476
1745,34423520,7361662,41785182,6,0,0,5120,19,4088001419
1746,34448050,11365223,45813273,1,0,0,37888,23,9835050329
1747,34465580,10303132,44768712,8,0,0,60928,12,8066967375
1748,34468671,11016665,45485336,2,0,0,48640,0,6151579710
1749,34508909,32938907,67447816,1,0,1,3072,23,4051381574
1750,34522950,8599775,43122725,6,0,0,5120,19,2246708607
1751,34526350,11405525,45931875,1,0,0,118272,23,5446244999
1752,34535090,32912749,67447839,6,0,1,121856,19,7187463664
1753,34536240,12471366,47007606,9,0,0,256512,10,10097259675
1754,34586590,12593539,47180129,1,0,0,124928,23,3490530519
1755,34588960,12727775,47316735,8,0,0,307712,12,8922383949
1756,34605420,13226370,47831790,8,0,0,363008,12,4230210893
1757,34623810,32850447,67474257,6,0,1,51712,19,80113049
1758,34644630,32960864,67605494,6,0,1,261120,19,2156458634
1759,34645850,11786506,46432356,6,0,0,335360,19,7852078120
1760,34713090,32999507,67712597,3,0,1,56320,28,8239370094
1761,34747900,33160273,67908173,3,0,1,14848,28,5190224011
1762,34771000,10667866,45438866,6,0,0,119296,19,1332425438
1763,34783700,33124496,67908196,3,0,1,1024,28,10083560262
1764,34786910,33121309,67908219,3,0,1,1024,28,5087670567
1765,34797810,11692755,46490565,8,0,0,29696,12,2884284997
1766,34802420,33180202,67982622,6,0,1,185856,19,3154044248
1767,34804790,13228650,48033440,1,0,0,239616,23,1620021875
1768,34838740,10954987,45793727,4,0,0,83456,9,10025346026
1769,34853620,33134391,67988011,3,0,1,1024,28,3369569012
1770,34872569,11368157,46240726,0,0,0,35840,6,4647585552
1771,34884310,33107491,67991801,3,0,1,15872,28,4758100873
1772,34892489,11688109,46580598,0,0,0,74240,6,6261169220
1773,34918211,10097297,45015508,2,0,0,126976,0,3540643574
1774,34930060,11059405,45989465,9,0,0,56832,10,1586000749
1775,34938960,8414150,43353110,9,0,0,26624,10,2528634181
1776,35014429,9093741,44108170,0,0,0,77824,6,6842556691
1777,35015390,33062602,68077992,6,0,1,55808,19,808250666
1778,35016270,10603427,45619697,4,0,0,3072,9,7970948673
1779,35078951,12997638,48076589,2,0,0,45056,0,5675408910
1780,35085320,11144463,46229783,6,0,0,133632,19,7321339302
1781,35102990,32986748,68089738,5,0,1,512,1,6782233674
1782,35108520,32981249,68089769,5,0,1,19456,1,9303579309
1783,35131350,33271753,68403103,6,0,1,327168,19,1267385670
1784,35149930,33261692,68411622,3,0,1,26112,28,3903918913
1785,35151350,33339787,68491137,9,0,1,76288,10,8737955149
1786,35158730,9747955,44906685,1,0,0,97792,23,2232342248
1787,35176480,11597394,46773874,4,0,0,291328,9,4447055405
1788,35202550,11726846,46929396,1,0,0,219136,23,5524527960
1789,35222220,33296209,68518429,9,0,1,41472,10,9678689488
1790,35223710,12140784,47364494,1,0,0,156672,23,3318075768
1791,35263660,8896215,44159875,1,0,0,25600,23,6377982916
1792,35265980,10104980,45370960,6,0,0,51200,19,4626759867
1793,35271260,11751688,47022948,6,0,0,28160,19,8699347270
1794,35325450,11726155,47051605,4,0,0,52224,9,464418050
1795,35358390,33170082,68528472,3,0,1,12288,28,8779691734
1796,35382930,33164538,68547468,5,0,1,12800,1,4892174541
1797,35409130,12744397,48153527,8,0,0,76288,12,6967132782
1798,35452960,12221107,47674067,1,0,0,257536,23,10108469712
1799,35453860,12112945,47566805,6,0,0,188928,19,4998081110
1800,35454590,33094184,68548774,3,0,1,2048,28,1986313979
1801,35530460,10656452,46186912,6,0,0,93184,19,10240185244
1802,35556901,10475955,46032856,2,0,0,142336,0,2067313506
1803,35600630,9600675,45201305,4,0,0,97792,9,8448068077
1804,35621680,32932906,68554586,5,0,1,9216,1,8623804272
1805,35629111,11812268,47441379,2,0,0,71680,0,739682513
1806,35630580,32932242,68562822,3,0,1,512,28,9237747630
1807,35632530,32931278,68563808,3,0,1,1536,28,4898451189
1808,35639370,9137633,44777003,6,0,0,27136,19,2265732506
1809,35642260,10826357,46468617,6,0,0,82432,19,5648861357
1810,35673800,9432592,45106392,8,0,0,109056,12,477746578
1811,35793570,32773702,68567272,5,0,1,15872,1,2127784482
1812,35806051,12483190,48289241,2,0,0,21504,0,4924650984
1813,35826930,12712496,48539426,4,0,0,55808,9,9839609794
1814,35874081,10631015,46505096,2,0,0,47616,0,4373048580
1815,35913120,32656098,68569218,3,0,1,3072,28,2098201987
1816,35962540,32607984,68570524,3,0,1,2048,28,6945844831
1817,35967711,11972505,47940216,2,0,0,167936,0,2354156075
1818,36007750,11203592,47211342,4,0,0,4096,9,9751581681
1819,36032610,11815115,47847725,9,0,0,52224,10,1806963953
1820,36056919,9165803,45222722,0,0,0,2048,6,7536988033
1821,36069590,9372263,45441853,9,0,0,9728,10,1772665966
1822,36082560,10360918,46443478,9,0,0,6656,10,8726935244
1823,36096130,32484046,68580176,5,0,1,15360,1,6064628173
1824,36101280,32481802,68583082,3,0,1,4608,28,1379965256
1825,36107529,9354627,45462156,0,0,0,66560,6,8280471944
1826,36117530,32465808,68583338,3,0,1,9216,28,4011005919
1827,36136420,9485172,45621592,9,0,0,6144,10,7025925133
1828,36183520,10670786,46854306,6,0,0,102400,19,10483310897
1829,36241500,32398239,68639739,5,0,1,12800,1,8667743909
1830,36315310,32324452,68639762,3,0,1,4608,28,10577787113
1831,36376389,9716972,46093361,0,0,0,60416,6,10301935059
1832,36421579,9380127,45801706,0,0,0,26112,6,10715961832
1833,36441470,11518939,47960409,1,0,0,66048,23,3399830995
1834,36442360,9505184,45947544,8,0,0,45568,12,9794579630
1835,36462610,12515023,48977633,9,0,0,105472,10,10151781496
1836,36480660,9960767,46441427,1,0,0,29696,23,6009013258
1837,36492610,32147175,68639785,5,0,1,24064,1,434678460
1838,36517531,12940687,49458218,2,0,0,166912,0,2572430495
1839,36524390,12257967,48782357,9,0,0,273408,10,1142722125
1840,36557840,12727894,49285734,8,0,0,318464,12,128422877
1841,36584150,32055658,68639808,3,0,1,34304,28,7237391284
1842,36592799,11874018,48466817,0,0,0,183808,6,1271752833
1843,36625289,9932666,46557955,0,0,0,15872,6,9534939358
1844,36685270,31954561,68639831,5,0,1,8192,1,5815112104
1845,36723510,31916344,68639854,5,0,1,10752,1,1515540
1846,36733730,31906147,68639877,5,0,1,6656,1,5532054218
1847,36839609,11730416,48570025,0,0,0,100352,6,6405013032
1848,36841240,9843847,46685087,4,0,0,17920,9,8192745729
1849,36842740,11762743,48605483,1,0,0,37888,23,6605883484
1850,36859000,12039513,48898513,4,0,0,380416,9,5233265277
1851,36924980,31742651,68667631,4,0,1,9728,9,3387085101
1852,36946970,11978662,48925632,8,0,0,50688,12,8882395515
1853,36950559,10191460,47142019,0,0,0,271360,6,205863361
1854,36953429,9909176,46862605,0,0,0,27136,6,2455424469
1855,37043730,9435214,46478944,4,0,0,33792,9,8079406562
1856,37050410,31632297,68682707,4,0,1,28672,9,9864108462
1857,37064140,31635509,68699649,3,0,1,17920,28,1431755671
1858,37081040,31640620,68721660,3,0,1,5632,28,860232677
1859,37099780,31623058,68722838,3,0,1,13824,28,9073091069
1860,37101870,31633736,68735606,5,0,1,26624,1,5827941126
1861,37133880,11936509,49070389,1,0,0,27648,23,3796739654
1862,37143660,9337803,46481463,6,0,0,8192,19,6515861724
1863,37172820,9650240,46823060,6,0,0,161280,19,492966345
1864,37177709,10199444,47377153,0,0,0,41472,6,7590813211
1865,37201110,11987569,49188679,8,0,0,187904,12,1616263323
1866,37238360,31501513,68739873,2,0,1,1024,0,2011620068
1867,37245630,12267178,49512808,6,0,0,3584,19,5338068493
1868,37266370,31536122,68802492,3,0,1,13824,28,2532923880
1869,37271480,31638769,68910249,3,0,1,26112,28,9151071696
1870,37288660,31651083,68939743,5,0,1,14848,1,7806267239
1871,37343540,31598789,68942329,5,0,1,4096,1,9256647633
1872,37359020,12027041,49386061,1,0,0,280064,23,5843045968
1873,37376740,9637605,47014345,4,0,0,22016,9,6030966645
1874,37409310,31533275,68942585,3,0,1,9216,28,5315329885
1875,37425240,31528002,68953242,4,0,1,1536,9,9186505335
1876,37429310,31526247,68955557,5,0,1,14848,1,4991227586
1877,37486590,31501373,68987963,4,0,1,14336,9,10162486072
1878,37524360,31547257,69071617,4,0,1,22016,9,6751798134
1879,37531870,31543959,69075829,3,0,1,6656,28,1322774
1880,37549410,9673546,47222956,1,0,0,5120,23,5263296868
1881,37643060,31485428,69128488,3,0,1,40960,28,4788972671
1882,37658480,12085898,49744378,8,0,0,212992,12,3298308212
1883,37699630,11777822,49477452,1,0,0,13824,23,6792949871
1884,37715270,9869810,47585080,1,0,0,59904,23,10430456895
1885,37733550,31449188,69182738,4,0,1,15360,9,5794228165
1886,37737100,31451877,69188977,2,0,1,3072,0,1379721890
1887,37832840,10040648,47873488,4,0,0,84480,9,1810745119
1888,37868260,9155031,47023291,6,0,0,1024,19,7221827846
1889,37880540,31447164,69327704,4,0,1,29184,9,9935631583
1890,37892340,31646173,69538513,4,0,1,41472,9,1023836608
1891,37898860,31639676,69538536,2,0,1,26624,0,1058691842
1892,37911219,11767339,49678558,0,0,0,55808,6,3942097436
1893,37916620,9119018,47035638,4,0,0,40448,9,1030683223
1894,37972600,31667979,69640579,8,0,1,34816,12,4516399343
1895,37975939,9234109,47210048,0,0,0,97792,6,4919531530
1896,37987580,9233793,47221373,9,0,0,32768,10,9588841136
1897,37989740,9401944,47391684,8,0,0,47616,12,2052603731
1898,37996160,31647018,69643178,4,0,1,1024,9,10562389450
1899,38028009,10492183,48520192,0,0,0,175104,6,4478496824
1900,38033260,31689976,69723236,2,0,1,42496,0,1386991032
1901,38061131,11868719,49929850,2,0,0,148992,0,9667239710
1902,38086030,12205231,50291261,8,0,0,375296,12,7740771948
1903,38088870,31634389,69723259,2,0,1,1536,0,1470715901
1904,38089190,31638171,69727361,4,0,1,4096,9,10087005704
1905,38126810,31643803,69770613,2,0,1,44544,0,5259945247
1906,38131780,31640216,69771996,2,0,1,14848,0,4915075035
1907,38155910,31650193,69806103,3,0,1,2048,28,4401890586
1908,38170420,31635706,69806126,3,0,1,8192,28,4708133118
1909,38184150,11991937,50176087,8,0,0,387072,12,5199832834
1910,38205320,31760929,69966249,9,0,1,18944,10,1356413005
1911,38205510,31760762,69966272,4,0,1,1024,9,5331611471
1912,38264760,31701535,69966295,2,0,1,512,0,1426672883
1913,38283240,9605761,47889001,8,0,0,48128,12,6197046173
1914,38297570,31775044,70072614,2,0,1,15360,0,6092941189
1915,38318830,32104944,70423774,2,0,1,51200,0,177931589
1916,38323480,32100317,70423797,4,0,1,12288,9,3486135547
1917,38343331,10227349,48570680,2,0,0,2048,0,949886003
1918,38346650,12166049,50512699,8,0,0,136704,12,505008328
1919,38375380,9798762,48174142,8,0,0,67584,12,1426072156
1920,38399700,9949317,48349017,1,0,0,5120,23,2193005644
1921,38439439,9434875,47874314,0,0,0,2560,6,4932766911
1922,38446480,9616350,48062830,9,0,0,81408,10,7600148677
1923,38462080,12205386,50667466,8,0,0,190976,12,6163387010
1924,38489420,11864379,50353799,1,0,0,98304,23,9832535327
1925,38497440,31952377,70449817,4,0,1,1024,9,1397205516
1926,38521920,10509734,49031654,6,0,0,1536,19,1027755926
1927,38527120,9510867,48037987,1,0,0,14848,23,6246764792
1928,38556210,12306802,50863012,1,0,0,120832,23,2035043571
1929,38580960,12011297,50592257,4,0,0,40448,9,4836827989
1930,38585360,11738464,50323824,4,0,0,102912,9,8597969034
1931,38600139,12425371,51025510,0,0,0,78336,6,9835076456
1932,38607360,31900208,70507568,2,0,1,20992,0,4180343098
1933,38613100,12719593,51332693,9,0,0,344576,10,7821849913
1934,38638030,31869561,70507591,2,0,1,1536,0,3996270290
1935,38669471,9852928,48522399,2,0,0,7168,0,7316639196
1936,38671900,31866722,70538622,2,0,1,38912,0,224221731
1937,38676150,9996591,48672741,1,0,0,41984,23,3054895101
1938,38707580,31939275,70646855,7,0,1,14848,14,1963562357
1939,38709440,12742010,51451450,8,0,0,163328,12,456583053
1940,38724519,32061141,70785660,4,0,1,2560,9,7915106974
1941,38745190,12945762,51690952,4,0,0,393728,9,1659295241
1942,38750020,12023322,50773342,4,0,0,132608,9,6575627376
1943,38770829,32015599,70786428,4,0,1,11776,9,8353531694
1944,38775820,12184296,50960116,8,0,0,189952,12,2343812590
1945,38808420,32079095,70887515,1,0,1,26112,23,8636768755
1946,38846500,11839397,50685897,1,0,0,60416,23,3394692560
1947,38885080,10158212,49043292,4,0,0,19456,9,5663815639
1948,38890600,10019480,48910080,9,0,0,37888,10,5579251837
1949,38905100,31993920,70899020,2,0,1,9216,0,521625984
1950,38956110,12918600,51874710,9,0,0,160256,10,10495754407
1951,38974159,10324710,49298869,0,0,0,43008,6,184341694
1952,38974841,9807718,48782559,2,0,0,512,0,10058724514
1953,38984170,31995486,70979656,2,0,1,32256,0,4114047836
1954,39031280,9898431,48929711,8,0,0,13312,12,1181815288
1955,39171390,9807202,48978592,6,0,0,3072,19,10078579088
1956,39201680,10205643,49407323,8,0,0,69632,12,2353957610
1957,39240909,10633716,49874625,0,0,0,164352,6,8106410480
1958,39244520,10416988,49661508,4,0,0,239616,9,7180351633
1959,39293750,11866440,51160190,8,0,0,33280,12,571775323
1960,39329300,31666098,70995398,3,0,1,10240,28,1049264291
1961,39363660,11972652,51336312,8,0,0,11776,12,941807973
1962,39387130,10383479,49770609,4,0,0,86016,9,10629592834
1963,39405590,31668165,71073755,0,0,1,46592,6,6514424847
1964,39410070,10063147,49473217,4,0,0,49152,9,513758338
1965,39431460,11762963,51194423,8,0,0,36352,12,6575619749
1966,39446830,31656401,71103231,3,0,1,15872,28,6346723151
1967,39475310,31642626,71117936,3,0,1,1024,28,6304136249
1968,39480990,31638892,71119882,3,0,1,25600,28,108939050
1969,39499549,12706498,52206047,0,0,0,132096,6,4106777910
1970,39523890,9775314,49299204,6,0,0,1024,19,9314864422
1971,39592180,31557789,71149969,3,0,1,7168,28,6390476590
1972,39713480,11759365,51472845,4,0,0,70144,9,1908093152
1973,39852930,11891732,51744662,4,0,0,171520,9,7685058432
1974,39884860,9991356,49876216,4,0,0,5120,9,4069457796
1975,39962670,9583171,49545841,1,0,0,10752,23,10567570528
1976,39982550,12442137,52424687,6,0,0,512,19,7810389788
1977,40018311,9529305,49547616,2,0,0,1536,0,3153209054
1978,40023990,31254822,71278812,8,0,1,11264,12,3432195664
1979,40027580,12130238,52157818,8,0,0,24576,12,3446105726
1980,40030241,9648565,49678806,2,0,0,512,0,624019860
1981,40046880,10400409,50447289,1,0,0,130560,23,3758675615
1982,40053150,12750741,52803891,1,0,0,387072,23,1241626624
1983,40100990,9829195,49930185,6,0,0,1024,19,4059291816
1984,40104670,9475866,49580536,6,0,0,1024,19,2150912084
1985,40111940,31402286,71514226,8,0,1,27136,12,2314514964
1986,40114811,9763768,49878579,2,0,0,7680,0,9757730844
1987,40166490,12159910,52326400,6,0,0,2048,19,10151368302
1988,40171539,10235947,50407486,0,0,0,176128,6,5031791489
1989,40180160,31341756,71521916,8,0,1,4608,12,237403107
1990,40206110,31382642,71588752,8,0,1,46592,12,880545410
1991,40344220,10126804,50471024,1,0,0,77824,23,9146501911
1992,40352861,10609485,50962346,2,0,0,1024,0,2787983083
1993,40390370,10498747,50889117,4,0,0,10240,9,8319279754
1994,40507860,31125296,71633156,3,0,1,46080,28,7720852291
1995,40534851,9252934,49787785,2,0,0,1024,0,5802226024
1996,40545849,9333845,49879694,0,0,0,3584,6,8581729561
1997,40581620,12660206,53241826,8,0,0,418304,12,10320517464
1998,40602259,12512092,53114351,0,0,0,705536,6,6132595695
1999,40612420,9212106,49824526,6,0,0,6144,19,6544140774
2000,40652521,9639855,50292376,2,0,0,3584,0,10274979293
2001,40652911,9860123,50513034,2,0,0,1024,0,10634401655
2002,40695840,30937339,71633179,8,0,1,5120,12,7668704784
2003,40770279,10457395,51227674,0,0,0,109056,6,6162247924
2004,40787300,10396024,51183324,1,0,0,74752,23,6282601967
2005,40901319,10248708,51150027,0,0,0,154624,6,7053406562
2006,40903259,12416634,53319893,0,0,0,10240,6,4070640501
2007,40925450,9654460,50579910,1,0,0,95232,23,3498744196
2008,41090020,9958085,51048105,8,0,0,26112,12,437144754
2009,41112169,10391275,51503444,0,0,0,100352,6,4964174957
2010,41135430,12265519,53400949,4,0,0,261120,9,2252601733
2011,41337790,9533837,50871627,4,0,0,2560,9,9205144772
2012,41370119,12224136,53594255,0,0,0,325120,6,9177320572
2013,41386250,30246952,71633202,8,0,1,15872,12,4995668215
2014,41472880,11837584,53310464,8,0,0,209920,12,3364795471
2015,41500950,8675940,50176890,6,0,0,2560,19,62087928
2016,41542040,9486925,51028965,8,0,0,11264,12,7002932212
2017,41573460,10228009,51801469,4,0,0,186368,9,4649501793
2018,41651030,10172302,51823332,4,0,0,71680,9,9421444542
2019,41669040,11925746,53594786,6,0,0,1536,19,4247990112
2020,41686830,12156697,53843527,1,0,0,456192,23,5005177463
2021,41724441,10179578,51904019,2,0,0,3072,0,3799065824
2022,41749209,11745931,53495140,0,0,0,162304,6,5453037825
2023,41773490,10052369,51825859,1,0,0,8192,23,6763349266
2024,41775451,10121800,51897251,2,0,0,4608,0,10125893300
2025,41891960,9800419,51692379,6,0,0,4608,19,1294948609
2026,41966270,11943648,53909918,4,0,0,134656,9,7039702100
2027,42013250,10225300,52238550,4,0,0,80384,9,8275986911
2028,42035920,9859904,51895824,4,0,0,69120,9,1192159348
2029,42063000,11641508,53704508,4,0,0,252416,9,2286095174
2030,42095590,12009137,54104727,8,0,0,217600,12,348442634
2031,42166720,8795291,50962011,4,0,0,6144,9,5320326731
2032,42253000,8907525,51160525,6,0,0,1024,19,1052921778
2033,42299940,9910553,52210493,6,0,0,6656,19,6175492260
2034,42328430,11896970,54225400,4,0,0,117760,9,38366553
2035,42339349,11288220,53627569,0,0,0,107520,6,4070749811
2036,42341830,10326740,52668570,4,0,0,249344,9,3820945171
2037,42363101,9969443,52332544,2,0,0,2048,0,5594695794
2038,42370161,9996098,52366259,2,0,0,2560,0,6383587755
2039,42374979,10294706,52669685,0,0,0,3584,6,1711256878
2040,42383850,10467596,52851446,1,0,0,126976,23,316093861
2041,42384880,10514417,52899297,8,0,0,154112,12,7705668875
2042,42447649,11954345,54401994,0,0,0,82944,6,4673479505
2043,42658420,11210377,53868797,6,0,0,1024,19,5758641988
2044,42667269,10185049,52852318,0,0,0,2560,6,4308689043
2045,42786620,12001201,54787821,1,0,0,286208,23,3822177403
2046,42798660,11239744,54038404,8,0,0,208384,12,1327569702
2047,42820900,28856652,71677552,3,0,1,9728,28,8071174654
2048,42830899,11317235,54148134,0,0,0,78848,6,9994718421
2049,42837629,28847613,71685242,4,0,1,14848,9,1448171829
2050,42839330,10592717,53432047,4,0,0,101888,9,9095005957
2051,42851250,9143879,51995129,6,0,0,2560,19,4687037779
2052,42875361,10371120,53246481,2,0,0,14848,0,2080912233
2053,42902410,28867384,71769794,3,0,1,100352,28,2256643121
2054,42914509,10402218,53316727,0,0,0,20480,6,1659342425
2055,42918970,11306755,54225725,6,0,0,512,19,5565285904
2056,42920251,11620983,54541234,2,0,0,351232,0,9337491351
2057,42923791,9762141,52685932,2,0,0,53248,0,8275044478
2058,42945349,9125626,52070975,0,0,0,3584,6,4470456499
2059,42947970,11970753,54918723,4,0,0,155136,9,6359388175
2060,42961840,28940756,71902596,3,0,1,27136,28,7915514498
2061,42981129,10464536,53445665,0,0,0,44544,6,9242619404
2062,43035021,11884349,54919370,2,0,0,2048,0,7188964454
2063,43053650,10267670,53321320,6,0,0,4608,19,5534394083
2064,43075860,28826759,71902619,2,0,1,35840,0,8940507755
2065,43115090,28787552,71902642,3,0,1,13312,28,1369353707
2066,43118130,28784535,71902665,4,0,1,5632,9,2594403658
2067,43164750,28737938,71902688,2,0,1,1024,0,1629681949
2068,43197320,29091093,72288413,3,0,1,5120,28,4721830446
2069,43209440,11332909,54542349,6,0,0,3584,19,7312873225
2070,43221070,9584420,52805490,6,0,0,5120,19,3879504324
2071,43228230,29062449,72290679,2,0,1,3584,0,5862824805
2072,43243869,12060044,55303913,0,0,0,567808,6,4401264141
2073,43282420,10585988,53868408,1,0,0,31744,23,3654262621
2074,43307600,29194663,72502263,3,0,1,27648,28,6875098303
2075,43389270,29114755,72504025,3,0,1,1024,28,8084353847
2076,43520000,9292689,52812689,1,0,0,23552,23,6947466716
2077,43523031,11960132,55483163,2,0,0,355328,0,2234681545
2078,43526139,28977909,72504048,4,0,1,1536,9,8254904608
2079,43534230,28971447,72505677,3,0,1,1536,28,9237880189
2080,43612080,28924398,72536478,2,0,1,5120,0,7882726253
2081,43616369,11868377,55484746,0,0,0,5120,6,10597639776
2082,43623950,28919461,72543411,2,0,1,31744,0,5864852838
2083,43654731,28888703,72543434,2,0,1,2560,0,3183286808
2084,43660080,11954417,55614497,1,0,0,205824,23,2249486912
2085,43798770,28744695,72543465,3,0,1,5632,28,3986717746
2086,43804640,28739945,72544585,3,0,1,18944,28,3560029674
2087,43811610,28767252,72578862,1,0,1,6656,23,9643713738
2088,43836401,10287560,54123961,2,0,0,62976,0,5175481450
2089,43885209,28752045,72637254,4,0,1,53760,9,1756911969
2090,43899600,11954417,55854017,1,0,0,161280,23,2788430379
2091,43927280,10262217,54189497,4,0,0,135680,9,9859056010
2092,43927311,28758392,72685703,2,0,1,23040,0,1461139630
2093,43941331,9913303,53854634,2,0,0,36352,0,7443726801
2094,43967190,11785046,55752236,4,0,0,265216,9,9871047609
2095,43974490,28711415,72685905,1,0,1,23552,23,2679161647
2096,43991780,28698473,72690253,3,0,1,3072,28,2447815435
2097,44009861,28691491,72701352,2,0,1,36352,0,2440394120
2098,44057220,28668915,72726135,1,0,1,7680,23,3436073142
2099,44058671,28673058,72731729,2,0,1,18432,0,8863860627
2100,44082889,9775824,53858713,0,0,0,13312,6,6731175721
2101,44124020,29392895,73516915,1,0,1,17408,23,1869035495
2102,44135200,29381738,73516938,1,0,1,7680,23,1373549862
2103,44143570,29632714,73776284,0,0,1,28160,6,7209502626
2104,44164010,29772108,73936118,1,0,1,15872,23,8100323679
2105,44164660,10932817,55097477,4,0,0,30720,9,6886847490
2106,44185171,29752535,73937706,2,0,1,15872,0,6765107031
2107,44188840,29777128,73965968,4,0,1,15360,9,5856980434
2108,44196449,9778440,53974889,0,0,0,121344,6,9047685751
2109,44229310,29863978,74093288,0,0,1,53248,6,10035489127
2110,44229330,30037996,74267326,0,0,1,77312,6,3528722594
2111,44261360,11801150,56062510,1,0,0,346112,23,2313565707
2112,44271710,29995639,74267349,1,0,1,11776,23,5369682113
2113,44281789,30011034,74292823,4,0,1,3072,9,7313961548
2114,44314350,11354950,55669300,1,0,0,179712,23,275409735
2115,44317560,30619474,74937034,0,0,1,487424,6,543240437
2116,44335040,11763108,56098148,4,0,0,101888,9,10241494525
2117,44372620,9537531,53910151,6,0,0,512,19,4301678806
2118,44519279,30417778,74937057,4,0,1,3584,9,4719292250
2119,44533339,30403741,74937080,4,0,1,3072,9,3982762655
2120,44538590,30419619,74958209,0,0,1,109568,6,9526407850
2121,44545759,11258292,55804051,0,0,0,169984,6,5370342734
2122,44559620,30398612,74958232,3,0,1,9728,28,892150447
2123,44616560,30341695,74958255,3,0,1,24576,28,1004310865
2124,44616780,30448116,75064896,0,0,1,298496,6,10628122189
2125,44634980,30429939,75064919,4,0,1,37376,9,8467772417
2126,44636801,30428141,75064942,2,0,1,40960,0,2680690989
2127,44660050,11568481,56228531,1,0,0,33280,23,8606555474
2128,44694011,30370954,75064965,2,0,1,3072,0,6977177000
2129,44714650,30350338,75064988,3,0,1,9216,28,1238806552
2130,44741410,9584157,54325567,4,0,0,6656,9,4015855011
2131,44747330,10048782,54796112,4,0,0,27136,9,9122598303
2132,44774761,9872302,54647063,2,0,0,73216,0,10030016856
2133,44832240,9514837,54347077,6,0,0,512,19,6358436531
2134,44902110,30163080,75065190,1,0,1,17920,23,5934244430
2135,44915790,30149423,75065213,0,0,1,43520,6,10178554618
2136,44922060,30143176,75065236,8,0,1,13312,12,1783654673
2137,44939760,30126801,75066561,3,0,1,2560,28,6963596805
2138,44964270,30104410,75068680,1,0,1,4096,23,8529434798
2139,44964370,9441937,54406307,1,0,0,1536,23,5321953429
2140,44982880,10953068,55935948,1,0,0,268800,23,502339179
2141,45013450,30076635,75090085,0,0,1,76800,6,3261872795
2142,45024810,30108761,75133571,0,0,1,74752,6,5822897651
2143,45045731,9603406,54649137,2,0,0,6656,0,1548828344
2144,45053900,11013173,56067073,4,0,0,14848,9,1388235806
2145,45120651,11285699,56406350,2,0,0,44032,0,6671813662
2146,45121450,30310430,75431880,0,0,1,261120,6,2640715606
2147,45136439,9809078,54945517,0,0,0,31232,6,7577884802
2148,45167280,9442187,54609467,4,0,0,37376,9,1108799227
2149,45178620,9432430,54611050,6,0,0,5120,19,4202108622
2150,45211140,9440360,54651500,1,0,0,7680,23,10249783479
2151,45239710,30687104,75926814,0,0,1,392704,6,3493498847
2152,45263830,30666210,75930040,3,0,1,5120,28,4776467121
2153,45273400,9310295,54583695,6,0,0,1536,19,4839734723
2154,45273900,10877738,56151638,1,0,0,175104,23,2283197688
2155,45308760,30651679,75960439,0,0,1,72704,6,7716202246
2156,45336491,9533623,54870114,2,0,0,53248,0,1159830384
2157,45405610,9422684,54828294,1,0,0,77312,23,9369657982
2158,45405890,10934507,56340397,4,0,0,347648,9,8455301771
2159,45425650,30568543,75994193,0,0,1,34304,6,6182123759
2160,45439760,10735930,56175690,1,0,0,61440,23,7715493551
2161,45583680,30464566,76048246,0,0,1,116736,6,6756361231
2162,45592940,9494265,55087205,6,0,0,2048,19,3305276752
2163,45610330,30599336,76209666,0,0,1,31744,6,9175676285
2164,45639451,10715257,56354708,2,0,0,46080,0,526420906
2165,45671650,30539466,76211116,3,0,1,1536,28,2744747901
2166,45737550,30473589,76211139,3,0,1,13312,28,5964302248
2167,45742661,10834529,56577190,2,0,0,337920,0,10211908139
2168,45782500,30428997,76211497,3,0,1,11264,28,8842288113
2169,45816180,30395831,76212011,6,0,1,106496,19,10673089208
2170,45856650,30355384,76212034,3,0,1,5632,28,4391961017
2171,45904001,30308547,76212548,2,0,1,17920,0,5522679853
2172,45922740,30341802,76264542,0,0,1,166400,6,8983432050
2173,45998710,30271004,76269714,3,0,1,8192,28,10122297075
2174,46003510,8923643,54927153,1,0,0,15872,23,9802982931
2175,46078130,30202503,76280633,0,0,1,29696,6,6084945649
2176,46082750,10553570,56636320,4,0,0,132608,9,2959485442
2177,46102990,30194332,76297322,3,0,1,16384,28,5114984810
2178,46103519,10099168,56202687,0,0,0,12288,6,9199979837
2179,46160460,30182176,76342636,0,0,1,87040,6,2050741144
2180,46228160,9323602,55551762,1,0,0,214528,23,1722375584
2181,46233060,9253292,55486352,4,0,0,5120,9,7091746359
2182,46254541,30096866,76351407,2,0,1,20992,0,6966338456
2183,46274310,30094199,76368509,0,0,1,31232,6,10594707656
2184,46277370,30180270,76457640,0,0,1,188416,6,3033295372
2185,46300551,30165903,76466454,2,0,1,17408,0,4165615661
2186,46307860,9496994,55804854,1,0,0,2560,23,4421027145
2187,46319410,10533252,56852662,1,0,0,402944,23,3429309500
2188,46358790,8983972,55342762,6,0,0,1024,19,10207139296
2189,46426780,9530251,55957031,4,0,0,69120,9,9065075081
2190,46437630,30039037,76476667,0,0,1,28160,6,10532240165
2191,46488150,9183201,55671351,6,0,0,6656,19,10191494989
2192,46506980,30034463,76541443,3,0,1,45056,28,6768622823
2193,46523500,30107120,76630620,0,0,1,165376,6,2946365008
2194,46559291,30073666,76632957,2,0,1,12800,0,5581810779
2195,46572920,30324845,76897765,0,0,1,370688,6,857025965
2196,46590090,30313474,76903564,3,0,1,19456,28,2061224184
2197,46632940,10697245,57330185,1,0,0,70144,23,3920332327
2198,46643810,10554032,57197842,4,0,0,298496,9,5127141736
2199,46720570,30193463,76914033,2,0,1,16384,0,6974559975
2200,46737300,10724867,57462167,1,0,0,99840,23,8207352084
2201,46770530,10875411,57645941,4,0,0,307712,9,7758122061
2202,46772499,9620365,56392864,0,0,0,124928,6,6983570568
2203,46790670,9385355,56176025,6,0,0,1024,19,4310155021
2204,46817110,9885222,56702332,6,0,0,1536,19,4951100951
2205,46824090,30090507,76914597,5,0,1,10752,1,3682826019
2206,46848790,30113657,76962447,0,0,1,115712,6,5614463339
2207,46850280,30149809,77000089,0,0,1,68096,6,3968560981
2208,46876470,30170315,77046785,3,0,1,46592,28,3771901231
2209,46887730,9452846,56340576,6,0,0,512,19,9669156110
2210,46888770,9749936,56638706,4,0,0,7168,9,3460417270
2211,46909230,30142061,77051291,5,0,1,7168,1,4835988007
2212,46928640,30124277,77052917,5,0,1,2560,1,3722238974
2213,46928939,10880965,57809904,0,0,0,435200,6,6806937956
2214,46935470,9505660,56441130,6,0,0,1024,19,4402278159
2215,46946710,30110713,77057423,3,0,1,7168,28,2708590199
2216,46949299,9750000,56699299,0,0,0,66560,6,8901669021
2217,46992340,30071817,77064157,3,0,1,24064,28,4860481343
2218,46998720,9579429,56578149,6,0,0,3072,19,9752300771
2219,47008760,30087841,77096601,5,0,1,19456,1,10495585883
2220,47009120,10244148,57253268,1,0,0,181760,23,4379195734
2221,47028030,30084677,77112707,0,0,1,41472,6,2594823253
2222,47051830,9354776,56406606,6,0,0,512,19,4546691747
2223,47099180,9946533,57045713,6,0,0,2048,19,3348158547
2224,47110080,30015350,77125430,3,0,1,9216,28,8936177300
2225,47113010,9817511,56930521,4,0,0,73216,9,6546521497
2226,47129610,30203248,77332858,6,0,1,373248,19,1498703361
2227,47170350,9927275,57097625,6,0,0,1024,19,9169075533
2228,47196090,30140314,77336404,2,0,1,5632,0,1359315052
2229,47254041,9447777,56701818,2,0,0,8192,0,1505390692
2230,47263030,30078661,77341691,5,0,1,16896,1,10662821652
2231,47350670,9514298,56864968,1,0,0,38400,23,3508966190
2232,47354561,9682875,57037436,2,0,0,41984,0,9420189382
2233,47379140,29983953,77363093,2,0,1,16384,0,2817230404
2234,47391901,10537701,57929602,2,0,0,388608,0,7603567320
2235,47394480,9242019,56636499,6,0,0,512,19,4728354951
2236,47396716,9896684,57293400,6,0,0,2560,19,1044952077
2237,47409750,29953599,77363349,2,0,1,9216,0,1444616370
2238,47411970,29951840,77363810,2,0,1,10240,0,9195625881
2239,47454520,29948681,77403201,2,0,1,40960,0,6576929733
2240,47466410,9386766,56853176,6,0,0,1536,19,6691837216
2241,47492450,29921276,77413726,2,0,1,10752,0,3856992531
2242,47493120,9988602,57481722,1,0,0,29696,23,2918344415
2243,47508920,30016052,77524972,0,0,1,220672,6,8497944776
2244,47570860,29954178,77525038,6,0,1,11264,19,6073625827
2245,47605140,9288459,56893599,6,0,0,3584,19,1119856419
2246,47622551,10504911,58127462,2,0,0,283648,0,2962029812
2247,47626280,9805085,57431365,1,0,0,151552,23,3360400266
2248,47628920,29941111,77570031,2,0,1,53248,0,912028497
2249,47638170,29947190,77585360,5,0,1,7680,1,9636990876
2250,47673530,29934672,77608202,7,0,1,60416,14,5261463326
2251,47693101,9692042,57385143,2,0,0,62464,0,2295106194
2252,47712090,29896135,77608225,7,0,1,9216,14,8690627987
2253,47714289,9651799,57366088,0,0,0,117760,6,1213905954
2254,47732960,29882233,77615193,4,0,1,7680,9,2057835092
2255,47745001,9762400,57507401,2,0,0,14336,0,7892224580
2256,47769070,29848069,77617139,5,0,1,3072,1,7925683391
2257,47775810,10475709,58251519,1,0,0,269824,23,9338979331
2258,47794890,9852703,57647593,6,0,0,2048,19,5703899542
2259,47814510,29816493,77631003,2,0,1,18432,0,8809303962
2260,47820980,29824487,77645467,7,0,1,9728,14,3503378903
2261,47834400,29824048,77658448,2,0,1,53760,0,9975930959
2262,47841430,29976193,77817623,6,0,1,279040,19,4481450686
2263,47861670,29956939,77818609,5,0,1,1536,1,1201038594
2264,47862570,9569138,57431708,6,0,0,1024,19,1743270594
2265,47877380,29945095,77822475,5,0,1,6144,1,4308998986
2266,47885600,29937029,77822629,2,0,1,8704,0,895446155
2267,47894520,29964137,77858657,6,0,1,50688,19,9592012861
2268,47903050,29959627,77862677,5,0,1,14848,1,4666698413
2269,47975130,9981015,57956145,1,0,0,87040,23,3092548991
2270,47995680,29869519,77865199,2,0,1,12800,0,6790908246
2271,47999750,29866755,77866505,3,0,1,2048,28,5462798657
2272,48002320,10269993,58272313,1,0,0,68096,23,5922779847
2273,48003920,29880531,77884451,6,0,1,48128,19,1603282838
2274,48013890,9797285,57811175,6,0,0,4096,19,4592465304
2275,48042180,9958331,58000511,4,0,0,144384,9,2026240787
2276,48046749,10122388,58169137,0,0,0,136704,6,8311150620
2277,48077670,29812670,77890340,4,0,1,22016,9,9011148430
2278,48118730,29772174,77890904,7,0,1,10752,14,3189096292
2279,48123280,29795349,77918629,2,0,1,20992,0,1371042559
2280,48143760,29791093,77934853,5,0,1,1536,1,9264569422
2281,48147620,29810600,77958220,4,0,1,29184,9,4018999739
2282,48152070,29837134,77989204,6,0,1,19968,19,3271337646
2283,48157350,10155467,58312817,6,0,0,3072,19,7583058944
2284,48173900,9473000,57646900,6,0,0,3072,19,1000103573
2285,48177670,9863268,58040938,1,0,0,132608,23,1179054753
2286,48187910,29804200,77992110,2,0,1,4608,0,1140116116
2287,48201240,29805625,78006865,7,0,1,36352,14,9939685329
2288,48208869,10202925,58411794,0,0,0,240128,6,4226348666
2289,48217010,29799020,78016030,7,0,1,10752,14,9152720676
2290,48227640,29801695,78029335,3,0,1,7168,28,9460552056
2291,48231700,29890468,78122168,5,0,1,14336,1,5910843108
2292,48233400,29914556,78147956,5,0,1,16896,1,1918628912
2293,48255760,29947778,78203538,2,0,1,30720,0,7028112251
2294,48268150,9688346,57956496,6,0,0,1024,19,4456229990
2295,48288390,29938181,78226571,3,0,1,17408,28,10703751887
2296,48311980,30071565,78383545,3,0,1,2560,28,7976576638
2297,48343160,30044571,78387731,5,0,1,6656,1,3272354440
2298,48343200,30295384,78638584,6,0,1,102912,19,1764612991
2299,48352410,9942671,58295081,1,0,0,55808,23,4291295844
2300,48360390,30454710,78815100,2,0,1,69632,0,7305024407
2301,48390150,30425932,78816082,4,0,1,27648,9,5585913426
2302,48421690,30394423,78816113,4,0,1,17408,9,455960794
2303,48424061,10079819,58503880,2,0,0,301568,0,6480834782
2304,48499720,30316416,78816136,2,0,1,22528,0,3340227257
2305,48501790,30337914,78839704,6,0,1,27136,19,9858005098
2306,48511171,10623492,59134663,2,0,0,74752,0,5049392121
2307,48518491,10120901,58639392,2,0,0,11264,0,4210621754
2308,48533890,9878083,58411973,6,0,0,512,19,9805231082
2309,48560671,10017099,58577770,2,0,0,167424,0,10563958348
2310,48577420,9927325,58504745,6,0,0,2560,19,8153368804
2311,48598490,30328108,78926598,7,0,1,31744,14,6486744285
2312,48616391,10340702,58957093,2,0,0,47616,0,6550846778
2313,48627369,30299743,78927112,4,0,1,2048,9,2496815074
2314,48637600,30331522,78969122,2,0,1,43520,0,4441716752
2315,48671770,30314258,78986028,6,0,1,95744,19,1279165604
2316,48701110,30337347,79038457,5,0,1,22016,1,9657851357
2317,48712920,30334867,79047787,2,0,1,18432,0,9997605604
2318,48713879,9911210,58625089,0,0,0,10752,6,10668187757
2319,48739410,10039441,58778851,4,0,0,5120,9,336814977
2320,48763091,9826878,58589969,2,0,0,15360,0,4104416789
2321,48791030,30259574,79050604,4,0,1,1024,9,3087958737
2322,48795270,30264693,79059963,3,0,1,36352,28,3654055776
2323,48803029,10618305,59421334,0,0,0,445952,6,10519650429
2324,48805650,30255081,79060731,6,0,1,11776,19,387242433
2325,48815110,30377516,79192626,6,0,1,89600,19,4342665500
2326,48819950,30395838,79215788,7,0,1,20992,14,607228223
2327,48822560,30404554,79227114,3,0,1,16384,28,8882888742
2328,48831360,30410893,79242253,2,0,1,7168,0,5332121601
2329,48832400,30428038,79260438,5,0,1,29184,1,3459273920
2330,48856020,10042224,58898244,4,0,0,167936,9,8132530222
2331,48919661,10166007,59085668,2,0,0,60928,0,7080566352
2332,48938090,10587628,59525718,1,0,0,247296,23,9393572822
2333,48977020,30305850,79282870,3,0,1,14848,28,6790046095
2334,48988170,30309614,79297784,7,0,1,29184,14,1932764763
2335,49020680,30357743,79378423,4,0,1,19968,9,9181788759
2336,49048120,30338078,79386198,4,0,1,33792,9,6568354935
2337,49068480,30367532,79436012,7,0,1,1536,14,7525202834
2338,49222380,30215261,79437641,4,0,1,7680,9,4026881811
2339,49233780,30203884,79437664,4,0,1,6144,9,8768480498
2340,49253730,10031705,59285435,4,0,0,148992,9,3382835504
2341,49268180,30169507,79437687,5,0,1,10240,1,5733343129
2342,49279150,30175150,79454300,4,0,1,6656,9,8891677473
2343,49296349,10546880,59843229,0,0,0,378880,6,5600190112
2344,49299070,30155253,79454323,6,0,1,12800,19,3240931138
2345,49321210,10204889,59526099,6,0,0,1024,19,3559840636
2346,49325040,30144833,79469873,4,0,1,1536,9,8364834062
2347,49340370,30431115,79771485,6,0,1,251392,19,3511776573
2348,49345469,30446896,79792365,4,0,1,26112,9,166663291
2349,49377520,10465957,59843477,6,0,0,512,19,347995773
2350,49384230,30516384,79900614,6,0,1,158720,19,5667591412
2351,49389750,30512170,79901920,4,0,1,2048,9,3776006032
2352,49390000,30572046,79962046,7,0,1,55808,14,6655929434
2353,49401960,30587571,79989531,5,0,1,35840,1,9122887871
2354,49481570,30512787,79994357,3,0,1,7680,28,6449359018
2355,49497180,30518372,80015552,7,0,1,27648,14,10272475509
2356,49504380,31661708,81166088,6,0,1,167936,19,8323823645
2357,49524580,10203140,59727720,1,0,0,322560,23,2824977338
2358,49551520,31947120,81498640,6,0,1,312832,19,2544416327
2359,49581310,10329332,59910642,4,0,0,151552,9,9849993086
2360,49585950,10258220,59844170,6,0,0,1536,19,8056724995
2361,49596630,31902033,81498663,3,0,1,4608,28,5025658487
2362,49603971,10243209,59847180,2,0,0,9728,0,10297792716
2363,49617180,31881506,81498686,5,0,1,2048,1,6974532735
2364,49619920,31878789,81498709,6,0,1,27136,19,3840916780
2365,49624699,31874057,81498756,4,0,1,43520,9,8785412528
2366,49637320,31861459,81498779,3,0,1,5120,28,8652388129
2367,49654510,10189146,59843656,6,0,0,512,19,3427199558
2368,49657120,31841682,81498802,3,0,1,5632,28,8184328898
2369,49660559,31838266,81498825,4,0,1,11264,9,529897876
2370,49682920,31815928,81498848,6,0,1,14848,19,9918236779
2371,49703510,31795361,81498871,7,0,1,3584,14,7314621739
2372,49718239,31780655,81498894,4,0,1,3072,9,3395563862
2373,49740450,32928021,82668471,6,0,1,764928,19,10704628615
2374,49763190,32929374,82692564,5,0,1,46592,1,8199139667
2375,49811530,32909164,82720694,3,0,1,512,28,10530302694
2376,49816090,32904860,82720950,2,0,1,9216,0,10596035622
2377,49837829,10590803,60428632,0,0,0,371712,6,10097060357
2378,49859240,32862376,82721616,9,0,1,1024,10,8868403184
2379,49874340,32862277,82736617,2,0,1,39936,0,2028152736
2380,49927340,32812511,82739851,5,0,1,12288,1,1874617169
2381,49942500,32825189,82767689,9,0,1,2560,10,6941951975
2382,49945190,32823485,82768675,5,0,1,1536,1,6692161513
2383,49954040,32830754,82784794,2,0,1,30720,0,4332739772
2384,49961390,32855279,82816669,2,0,1,35328,0,3833285070
2385,49969340,10179827,60149167,4,0,0,12288,9,1576325188
2386,49978380,32842579,82820959,3,0,1,3072,28,7511447741
2387,49984470,32848741,82833211,3,0,1,41984,28,3995344297
2388,50000350,33026144,83026494,6,0,1,89600,19,3252554193
2389,50004320,33022197,83026517,2,0,1,72704,0,977607902
2390,50018610,33007930,83026540,7,0,1,12288,14,4146603351
2391,50037310,10200639,60237949,1,0,0,3584,23,8083637657
2392,50049460,32979934,83029394,6,0,1,21504,19,6527776292
2393,50051520,32977913,83029433,2,0,1,11776,0,4738931455
2394,50068500,33284352,83352852,6,0,1,377856,19,2200868379
2395,50083971,33305538,83389509,2,0,1,3584,0,6807228132
2396,50121301,10312346,60433647,2,0,0,16384,0,7371406510
2397,50133981,10724265,60858246,2,0,0,30720,0,5200541508
2398,50151800,33276109,83427909,2,0,1,15872,0,8430240945
2399,50174710,33254326,83429036,2,0,1,21504,0,5728167725
2400,50174910,33363431,83538341,9,0,1,4608,10,1251787505
2401,50187450,33392608,83580058,5,0,1,49664,1,5394219971
2402,50209730,33424278,83634008,2,0,1,40960,0,5028508765
2403,50217040,10311125,60528165,1,0,0,81920,23,2440218363
2404,50231309,10598843,60830152,0,0,0,169984,6,652107961
2405,50236250,33400344,83636594,3,0,1,4096,28,3210356699
2406,50249830,33410551,83660381,9,0,1,14848,10,6713566979
2407,50257570,33486001,83743571,5,0,1,512,1,7995281058
2408,50259071,10407156,60666227,2,0,0,220672,0,9850022828
2409,50263581,10447035,60710616,2,0,0,137728,0,7037676372
2410,50295599,33788181,84083780,4,0,1,90112,9,8469600947
2411,50303820,33779983,84083803,9,0,1,2560,10,4097969303
2412,50316680,33787761,84104441,7,0,1,30208,14,10130572754
2413,50319610,33947850,84267460,3,0,1,24576,28,3271789110
2414,50331491,33936315,84267806,2,0,1,512,0,10492281128
2415,50343050,34121016,84464066,1,0,1,39936,23,4049703929
2416,50349120,34114969,84464089,3,0,1,14336,28,7046029847
2417,50357339,10547913,60905252,0,0,0,61440,6,5245137464
2418,50394160,34069952,84464112,9,0,1,5632,10,8380482312
2419,50406770,34057365,84464135,8,0,1,10752,12,6914413801
2420,50426080,34038078,84464158,7,0,1,4608,14,6537872346
2421,50430170,34555049,84985219,6,0,1,227328,19,2735261253
2422,50447990,10483930,60931920,4,0,0,44544,9,8695080235
2423,50473479,34567266,85040745,4,0,1,92160,9,9041874031
2424,50484400,34556368,85040768,8,0,1,20992,12,3988552151
2425,50515500,34525291,85040791,5,0,1,7680,1,6540763413
2426,50516870,34592118,85108988,6,0,1,56320,19,1851628630
2427,50528520,34580491,85109011,9,0,1,4096,10,6649967484
2428,50533320,34577609,85110929,9,0,1,17408,10,8347371741
2429,50554160,34631407,85185567,6,0,1,86528,19,7193478665
2430,50555350,34630240,85185590,3,0,1,10752,28,3423897841
2431,50559430,34626183,85185613,8,0,1,1536,12,5104048336
2432,50570351,34679112,85249463,2,0,1,13312,0,8420157712
2433,50573130,34676356,85249486,9,0,1,19968,10,1400586988
2434,50588270,10667754,61256024,1,0,0,230400,23,7131842816
2435,50599731,34649778,85249509,2,0,1,3072,0,279040621
2436,50602000,34647532,85249532,6,0,1,20992,19,7126666587
2437,50609800,34651954,85261754,9,0,1,47104,10,2778978012
2438,50617230,10745567,61362797,6,0,0,2048,19,9822693169
2439,50618859,11403888,62022747,0,0,0,568320,6,6722192185
2440,50640871,34620906,85261777,2,0,1,15872,0,8123117481
2441,50664310,34597490,85261800,5,0,1,28672,1,9752774603
2442,50665289,34596534,85261823,4,0,1,4096,9,5720672481
2443,50675850,34663423,85339273,2,0,1,59392,0,9070252508
2444,50695610,34672101,85367711,4,0,1,28672,9,3464264603
2445,50697890,34703449,85401339,3,0,1,22528,28,7197865503
2446,50714350,34687012,85401362,8,0,1,5120,12,9831962172
2447,50764060,34716657,85480717,2,0,1,120832,0,1956387844
2448,50797840,34683492,85481332,7,0,1,18944,14,6106469898
2449,50803171,10987933,61791104,2,0,0,223744,0,6243078409
2450,50804359,11251537,62055896,0,0,0,71168,6,509637311
2451,50816460,10316158,61132618,6,0,0,3072,19,4596054210
2452,50846559,34635439,85481998,4,0,1,1024,9,414494420
2453,50846730,34636894,85483624,7,0,1,2560,14,6756655953
2454,50852451,34914330,85766781,2,0,1,524800,0,3934956610
2455,50875070,34899264,85774334,3,0,1,20480,28,985572671
2456,50882641,10735878,61618519,2,0,0,74240,0,1992381620
2457,50894670,34885053,85779723,7,0,1,17408,14,783867605
2458,50896221,10946619,61842840,2,0,0,109056,0,3614795027
2459,50900420,34891977,85792397,3,0,1,60416,28,4039138790
2460,50925080,34886410,85811490,1,0,1,21504,23,914835526
2461,50933359,10870716,61804075,0,0,0,42496,6,8242243551
2462,50936600,34969120,85905720,6,0,1,207872,19,6282721855
2463,50973769,11049781,62023550,0,0,0,2560,6,1936033843
2464,50991120,34916520,85907640,1,0,1,2560,23,7152891052
2465,50994961,11253758,62248719,2,0,0,395264,0,8369943678
2466,51017999,34906414,85924413,4,0,1,30720,9,9134920952
2467,51039449,34885950,85925399,4,0,1,1536,9,1705704787
2468,51060199,34871644,85931843,4,0,1,14336,9,9797985218
2469,51081940,10365871,61447811,6,0,0,512,19,9546952293
2470,51082190,10510660,61592850,6,0,0,512,19,2576130248
2471,51091920,11504632,62596552,1,0,0,425984,23,8430416239
2472,51099620,34835449,85935069,9,0,1,5120,10,3810715795
2473,51100760,34835897,85936657,7,0,1,15872,14,4862210972
2474,51120269,34837952,85958221,4,0,1,34816,9,4833728165
2475,51120580,34856903,85977483,1,0,1,26112,23,9062526364
2476,51128731,10935240,62063971,2,0,0,6656,0,2806185966
2477,51139270,10894919,62034189,4,0,0,34816,9,7423247494
2478,51166130,34813522,85979652,9,0,1,1536,10,10539066528
2479,51178200,34802220,85980420,7,0,1,11776,14,789274533
2480,51204980,34777386,85982366,9,0,1,3072,10,10520491860
2481,51250780,34739942,85990722,8,0,1,3072,12,8429984465
2482,51258991,11415771,62674762,2,0,0,249344,0,7596833286
2483,51263870,11056262,62320132,1,0,0,218112,23,3802711594
2484,51276460,34726770,86003230,1,0,1,37888,23,6255652952
2485,51280000,35009818,86289818,6,0,1,173056,19,6457010856
2486,51299420,10949813,62249233,6,0,0,1536,19,5822070660
2487,51316079,34973762,86289841,4,0,1,9216,9,5546420767
2488,51389999,34899865,86289864,4,0,1,9216,9,1184062282
2489,51392460,34897427,86289887,9,0,1,2048,10,6959161745
2490,51398160,11310866,62709026,1,0,0,112128,23,8908483235
2491,51418840,34934440,86353280,8,0,1,12800,12,2722899527
2492,51432340,11166427,62598767,6,0,0,7168,19,7582009998
2493,51434309,11464265,62898574,0,0,0,469504,6,7770154950
2494,51437250,34916491,86353741,1,0,1,10240,23,2694454070
2495,51447251,11019486,62466737,2,0,0,10240,0,4424102806
2496,51447700,34950036,86397736,7,0,1,28160,14,6435327932
2497,51463410,34957460,86420870,7,0,1,7168,14,8697750403
2498,51471980,11433481,62905461,4,0,0,22528,9,10534506157
2499,51475061,11280414,62755475,2,0,0,59392,0,8852176229
2500,51476060,34946116,86422176,7,0,1,2048,14,361944715
2501,51482610,34940334,86422944,7,0,1,11776,14,5503724806
2502,51491520,34982418,86473938,8,0,1,32768,12,9801098564
2503,51491910,35047173,86539083,3,0,1,29696,28,4496875246
2504,51513160,11392971,62906131,6,0,0,2048,19,3200867222
2505,51515779,35023327,86539106,4,0,1,2048,9,6607139532
2506,51533950,35005179,86539129,9,0,1,3584,10,5176371066
2507,51534600,11371935,62906535,6,0,0,1024,19,6353497700
2508,51537730,35015207,86552937,7,0,1,15360,14,3066518474
2509,51539601,11495116,63034717,2,0,0,108544,0,8495048080
2510,51540050,35014513,86554563,7,0,1,2560,14,7776589406
2511,51543740,35173356,86717096,3,0,1,55808,28,9378155521
2512,51546579,35170540,86717119,4,0,1,23040,9,7664708045
2513,51565850,35151292,86717142,3,0,1,12288,28,8610285476
2514,51575230,36069300,87644530,6,0,1,324096,19,251006334
2515,51585600,36071792,87657392,9,0,1,17408,10,2463055138
2516,51600900,36057017,87657917,6,0,1,3584,19,10324469926
2517,51612620,11354410,62967030,4,0,0,16896,9,328405102
2518,51612790,36178056,87790846,3,0,1,86528,28,8916367259
2519,51614640,36279275,87893915,9,0,1,63488,10,6241375800
2520,51623779,36271762,87895541,4,0,1,2560,9,5897576220
2521,51625779,11902867,63528646,0,0,0,508416,6,7756554329
2522,51679910,36218217,87898127,1,0,1,4096,23,9393226452
2523,51696800,11832828,63529628,6,0,0,3072,19,6403015469
2524,51702160,36209201,87911361,9,0,1,2560,10,815141007
2525,51710189,11568398,63278587,0,0,0,123392,6,1922398098
2526,51728750,36210291,87939041,8,0,1,15872,12,319877860
2527,51799089,11847600,63646689,0,0,0,195584,6,9553436708
2528,51801490,36196702,87998192,6,0,1,91136,19,1638367375
2529,51820190,36528067,88348257,6,0,1,522752,19,986118465
2530,51822130,36565786,88387916,6,0,1,35328,19,5638899579
2531,51824780,12115072,63939852,6,0,0,1024,19,1791868771
2532,51837909,36552251,88390160,4,0,1,2560,9,5545556809
2533,51865700,36559855,88425555,9,0,1,36352,10,2935564656
2534,51901950,12037521,63939471,6,0,0,2048,19,2650229500
2535,51917410,36508168,88425578,7,0,1,1536,14,584507323
2536,51921800,36503801,88425601,7,0,1,5632,14,6652821512
2537,51934650,11727974,63662624,1,0,0,52224,23,1191149159
2538,51935409,36490215,88425624,4,0,1,12800,9,9247326016
2539,51941320,36505830,88447150,9,0,1,20480,10,10243689660
2540,51950030,36554854,88504884,3,0,1,58880,28,7940891154
2541,51960429,36552264,88512693,4,0,1,17408,9,9413116416
2542,51968720,11908877,63877597,1,0,0,330240,23,3436654647
2543,51984219,36550746,88534965,4,0,1,7168,9,10618500931
2544,52009579,36527012,88536591,4,0,1,2560,9,4401332461
2545,52022240,36656856,88679096,9,0,1,161280,10,10626058716
2546,52027301,11911523,63938824,2,0,0,199168,0,1598730411
2547,52046169,36654877,88701046,4,0,1,13312,9,4369250167
2548,52083630,36705662,88789292,7,0,1,81408,14,641753817
2549,52117671,11827820,63945491,2,0,0,18432,0,5369852211
2550,52125730,11752318,63878048,6,0,0,1024,19,10215870843
2551,52128740,36734298,88863038,1,0,1,38400,23,10075833135
2552,52145140,36717921,88863061,1,0,1,4096,23,9453118479
2553,52149300,36765623,88914923,3,0,1,30720,28,8454402008
2554,52185790,36729156,88914946,3,0,1,17920,28,10124920582
2555,52203120,36711849,88914969,6,0,1,20992,19,9452816581
2556,52214280,36743944,88958224,6,0,1,78336,19,797572256
2557,52243910,36727634,88971544,3,0,1,3584,28,5198789880
2558,52251759,36768790,89020549,4,0,1,34304,9,3247154955
2559,52262360,36758753,89021113,7,0,1,10752,14,1570794978
2560,52284350,11824759,64109109,1,0,0,144384,23,6895684738
2561,52292600,36817020,89109620,1,0,1,13824,23,7537121832
2562,52292740,37118907,89411647,6,0,1,387072,19,9881189010
2563,52310270,12159586,64469856,1,0,0,184320,23,10009472700
2564,52310540,37101130,89411670,9,0,1,7680,10,791212326
2565,52387890,37023803,89411693,3,0,1,20480,28,7637347561
2566,52421880,11943611,64365491,1,0,0,66560,23,1424903338
2567,52423250,36988466,89411716,1,0,1,3584,23,6240752975
2568,52425029,12361585,64786614,0,0,0,145920,6,6518393222
2569,52480530,36943793,89424323,9,0,1,34816,10,7924772863
2570,52498320,12123594,64621914,7,0,0,142848,14,746448198
2571,52517891,11827297,64345188,7,0,0,97792,14,3221808346
2572,52583340,36853292,89436632,9,0,1,41472,10,9462835084
2573,52600930,36853321,89454251,6,0,1,61952,19,10157853400
2574,52633060,36828132,89461192,8,0,1,21504,12,3884600877
2575,52637910,36826992,89464902,7,0,1,15872,14,2251132253
2576,52705571,11532929,64238500,2,0,0,23552,0,639747939
2577,52712150,12000139,64712289,4,0,0,230912,9,10221710430
2578,52755780,36716874,89472654,7,0,1,7168,14,457550868
2579,52780410,11959826,64740236,1,0,0,91648,23,8479355391
2580,52829290,36648753,89478043,7,0,1,17408,14,10284475321
2581,52857730,36640172,89497902,9,0,1,16384,10,10139646800
2582,52857900,36646914,89504814,6,0,1,26112,19,6820360838
2583,52901580,36604220,89505800,8,0,1,1536,12,3563966757
2584,52922800,36672563,89595363,6,0,1,207872,19,8389351713
2585,52923171,11322684,64245855,2,0,0,24064,0,7847051818
2586,52956140,36649529,89605669,7,0,1,4096,14,8694307701
2587,52973540,36633000,89606540,7,0,1,12288,14,3041864120
2588,52981170,36762463,89743633,6,0,1,159744,19,860352653
2589,52988470,36811866,89800336,9,0,1,34304,10,4320274841
2590,53001729,36804048,89805777,4,0,1,25600,9,2215134655
2591,53001741,11520205,64521946,7,0,0,11264,14,375040862
2592,53022600,11373298,64395898,6,0,0,2048,19,6014847946
2593,53027700,11163070,64190770,6,0,0,1536,19,738021843
2594,53029090,11862291,64891381,1,0,0,63488,23,6839614846
2595,53072679,36794002,89866681,4,0,1,25600,9,7975110162
2596,53109779,11532115,64641894,0,0,0,47104,6,5143741618
2597,53114760,36756427,89871187,8,0,1,7168,12,8387101292
2598,53125940,36749331,89875271,9,0,1,18432,10,10427586016
2599,53167930,36774561,89942491,6,0,1,61952,19,4562854055
2600,53184431,12822422,66006853,2,0,0,177152,0,9959510557
2601,53185201,12905329,66090530,7,0,0,94208,14,9114915523
2602,53186659,11290084,64476743,0,0,0,22528,6,7455744143
2603,53211141,11931877,65143018,2,0,0,262144,0,8574713536
2604,53215540,36964241,90179781,6,0,1,212992,19,5889845655
2605,53238609,36952968,90191577,4,0,1,11776,9,8765254901
2606,53250260,11230718,64480978,1,0,0,13824,23,960864580
2607,53256090,11958578,65214668,7,0,0,231936,14,5528363952
2608,53263589,36964432,90228021,4,0,1,9216,9,6427225070
2609,53277870,36950174,90228044,9,0,1,2048,10,1484402787
2610,53288730,13045550,66334280,1,0,0,182272,23,1648834143
2611,53290210,11933132,65223342,7,0,0,28160,14,91431785
2612,53313610,11830367,65143977,6,0,0,3072,19,1713235642
2613,53319090,36908977,90228067,8,0,1,2560,12,1974705073
2614,53335650,36892440,90228090,9,0,1,4096,10,1583182475
2615,53355230,36963957,90319187,6,0,1,71168,19,5797951771
2616,53390420,36978090,90368510,8,0,1,1024,12,2233522004
2617,53390859,36977674,90368533,4,0,1,1024,9,2445882850
2618,53397010,36971546,90368556,7,0,1,9216,14,3594852739
2619,53407491,11655609,65063100,2,0,0,133120,0,4029045266
2620,53424250,12268485,65692735,4,0,0,74752,9,7649289525
2621,53498690,11243441,64742131,7,0,0,6144,14,7481194676
2622,53528770,36859202,90387972,7,0,1,25600,14,6804511507
2623,53542980,36848598,90391578,7,0,1,9728,14,5928831041
2624,53552980,36857158,90410138,6,0,1,15872,19,2052252777
2625,53567509,36848223,90415732,4,0,1,18432,9,1072042107
2626,53581130,37034849,90615979,6,0,1,125952,19,1014215026
2627,53581720,12907666,66489386,1,0,0,135680,23,5203390679
2628,53619250,36996752,90616002,9,0,1,26112,10,8486131356
2629,53660089,36981102,90641191,4,0,1,149504,9,5409042278
2630,53660630,37002671,90663301,4,0,1,15872,9,6623772191
2631,53681050,12145610,65826660,4,0,0,146432,9,1725064553
2632,53768270,12742386,66510656,4,0,0,4096,9,6436964979
2633,53861979,36802193,90664172,4,0,1,12288,9,3922098144
2634,53873721,11649218,65522939,2,0,0,119808,0,152876097
2635,53913151,12301757,66214908,7,0,0,153088,14,5362574242
2636,53951300,36714178,90665478,1,0,1,2048,23,1203699512
2637,53964190,11360719,65324909,1,0,0,20480,23,1898740731
2638,53967259,11809918,65777177,0,0,0,276992,6,8873102215
2639,53969180,11700756,65669936,7,0,0,170496,14,5397845409
2640,53994050,36855656,90849706,6,0,1,125440,19,3821964558
2641,54084110,36773527,90857637,9,0,1,19456,10,8993501440
2642,54084950,36777872,90862822,7,0,1,16384,14,3183503307
2643,54142210,37035233,91177443,6,0,1,231424,19,2292689944
2644,54150470,37028279,91178749,3,0,1,2048,28,5108683758
2645,54154710,37111344,91266054,1,0,1,9216,23,9931239092
2646,54178860,11351122,65529982,7,0,0,23040,14,66973991
2647,54197130,37068947,91266077,7,0,1,2048,14,3810139674
2648,54198630,37067470,91266100,1,0,1,16896,23,3666337517
2649,54201650,37064473,91266123,6,0,1,512,19,3413199165
2650,54203510,37118851,91322361,4,0,1,50688,9,8645798360
2651,54263260,37059459,91322719,5,0,1,4096,1,2214240981
2652,54265700,37057042,91322742,5,0,1,14848,1,3065123172
2653,54270600,37052165,91322765,5,0,1,1536,1,119916298
2654,54273990,37048798,91322788,5,0,1,1536,1,3862934856
2655,54288090,12156121,66444211,1,0,0,242176,23,4345945952
2656,54304040,11648814,65952854,1,0,0,225792,23,2816286038
2657,54348149,11988026,66336175,0,0,0,6144,6,6808267847
2658,54353241,12551966,66905207,2,0,0,802304,0,3539705326
2659,54353750,12685039,67038789,4,0,0,272384,9,7365798501
2660,54360910,11994343,66355253,7,0,0,62464,14,7263680330
2661,54424080,12647024,67071104,4,0,0,105984,9,4152009797
2662,54436380,36886431,91322811,1,0,1,512,23,5829193678
2663,54467390,36855444,91322834,1,0,1,1536,23,5681820667
2664,54484079,36838778,91322857,4,0,1,2048,9,5806524493
2665,54485151,12024226,66509377,2,0,0,65536,0,7634537191
2666,54487109,36853141,91340250,4,0,1,44544,9,5555187622
2667,54495280,12460494,66955774,1,0,0,165888,23,6783678479
2668,54552210,36795041,91347251,1,0,1,14848,23,2864560449
2669,54554830,36796133,91350963,1,0,1,13824,23,487541034
2670,54559470,36847743,91407213,6,0,1,57344,19,1690121515
2671,54584130,36823749,91407879,7,0,1,11264,14,5140346171
2672,54584791,12061348,66646139,7,0,0,30208,14,6840106503
2673,54592529,36849788,91442317,4,0,1,34816,9,4267291722
2674,54598240,36856385,91454625,1,0,1,5120,23,8842698543
2675,54604350,12756101,67360451,1,0,0,804864,23,532972265
2676,54626269,36833147,91459416,4,0,1,15872,9,6934361185
2677,54631980,36835082,91467062,1,0,1,10240,23,10389388200
2678,54640969,12806778,67447747,0,0,0,115712,6,63975718
2679,54658201,12816033,67474234,7,0,0,86528,14,8427471650
2680,54671250,36836719,91507969,1,0,1,33792,23,7528349745
2681,54674490,12737955,67412445,1,0,0,96256,23,5149067614
2682,54677869,36835592,91513461,4,0,1,17920,9,4370139244
2683,54766949,36769675,91536624,4,0,1,34304,9,9051074550
2684,54781420,36780875,91562295,1,0,1,3072,23,5763940535
2685,54801060,12582034,67383094,4,0,0,74240,9,10451153267
2686,54806510,37408713,92215223,0,0,1,62976,6,9454632507
2687,54825450,37417380,92242830,1,0,1,30720,23,2320020373
2688,54885380,37498644,92384024,5,0,1,67072,1,2354429267
2689,54917050,37477916,92394966,1,0,1,13312,23,9579348332
2690,54951450,37447433,92398883,5,0,1,4096,1,8037730959
2691,54951650,12956500,67908150,1,0,0,517632,23,983362854
2692,54952110,37521931,92474041,7,0,1,20480,14,8109237902
2693,54954890,37685049,92639939,8,0,1,20992,12,268507679
2694,54978010,37666499,92644509,3,0,1,20480,28,3249183222
2695,55053691,12911202,67964893,2,0,0,84480,0,9849781264
2696,55101440,37597426,92698866,5,0,1,65024,1,9989144826
2697,55126080,12963635,68089715,4,0,0,38400,9,5858446679
2698,55133459,12805671,67939130,0,0,0,101376,6,6078544391
2699,55157450,37541447,92698897,9,0,1,29184,10,1991815647
2700,55171590,12906379,68077969,1,0,0,174080,23,8330125995
2701,55172511,13022330,68194841,7,0,0,46080,14,1803624286
2702,55184290,37570530,92754820,6,0,1,24576,19,1489697750
2703,55194760,37560521,92755281,4,0,1,10240,9,5513264712
2704,55204560,13083391,68287951,1,0,0,1536,23,5304028488
2705,55209450,37550478,92759928,8,0,1,16896,12,4609259658
2706,55241230,13231874,68473104,1,0,0,158720,23,1298330819
2707,55249540,37593465,92843005,7,0,1,27136,14,3128971214
2708,55257860,37585168,92843028,7,0,1,31744,14,7353738246
2709,55273201,12966903,68240104,7,0,0,148480,14,289950716
2710,55300220,37651009,92951229,5,0,1,30208,1,2738170119
2711,55316870,37634382,92951252,1,0,1,6144,23,822946077
2712,55361080,37590195,92951275,8,0,1,14848,12,641664989
2713,55375959,13263749,68639708,0,0,0,182784,6,4569037426
2714,55378390,37810229,93188619,8,0,1,29184,12,190465668
2715,55410609,13080318,68490927,0,0,0,58368,6,6106639127
2716,55411380,37834658,93246038,4,0,1,21504,9,5155339709
2717,55434991,13073304,68508295,7,0,0,19968,14,9392614745
2718,55457891,38531812,93989703,2,0,1,628224,0,543380571
2719,55459170,13031936,68491106,6,0,0,512,19,1909291955
2720,55469120,38520606,93989726,7,0,1,6144,14,10363948284
2721,55475011,13648812,69123823,7,0,0,27648,14,2994725844
2722,55495290,38494467,93989757,4,0,1,17920,9,5320053247
2723,55503470,38486310,93989780,8,0,1,4608,12,6637283447
2724,55542400,13258102,68800502,1,0,0,13824,23,5084546322
2725,55606300,38383503,93989803,1,0,1,5120,23,4223700766
2726,55639960,38349866,93989826,1,0,1,3072,23,3168656713
2727,55672900,38316949,93989849,5,0,1,5120,1,51710608
2728,55687611,38302269,93989880,2,0,1,41472,0,7445738514
2729,55701269,13545093,69246362,0,0,0,40960,6,2144951863
2730,55701810,38288093,93989903,1,0,1,3072,23,8992110590
2731,55745571,38244355,93989926,2,0,1,6656,0,5917912127
2732,55763870,13563811,69327681,1,0,0,63488,23,3622208524
2733,55776460,13762030,69538490,7,0,0,54784,14,3065950725
2734,55780331,13453398,69233729,2,0,0,9216,0,2636820880
2735,55786710,13683230,69469940,1,0,0,380416,23,2696367019
2736,55811900,38178049,93989949,8,0,1,1536,12,5468420221
2737,55825180,38189179,94014359,5,0,1,17408,1,1444478260
2738,55834910,13225877,69060787,4,0,0,104448,9,10012246753
2739,55840040,38177545,94017585,5,0,1,5120,1,9629492023
2740,55888651,38179013,94067664,2,0,1,27648,0,6063461169
2741,55900310,13601268,69501578,4,0,0,36352,9,6658676855
2742,55920280,38147538,94067818,1,0,1,8704,23,1748512325
2743,55936370,38290936,94227306,5,0,1,5632,1,7829226740
2744,55937250,38290079,94227329,8,0,1,5632,12,6443501338
2745,55940930,38286422,94227352,1,0,1,14336,23,3507965260
2746,55970310,38257065,94227375,8,0,1,17408,12,3643746739
2747,55974340,13141036,69115376,7,0,0,47616,14,7349930790
2748,55986051,13196664,69182715,2,0,0,77824,0,5309344183
2749,55998480,13728858,69727338,1,0,0,13312,23,2479612439
2750,56006980,12948554,68955534,1,0,0,5120,23,9157872839
2751,56033991,13594662,69628653,2,0,0,27648,0,1023320425
2752,56065290,38162108,94227398,1,0,1,18432,23,3586805051
2753,56072571,38181532,94254103,2,0,1,30208,0,387809879
2754,56083611,38211286,94294897,2,0,1,3072,0,3657950698
2755,56121210,13843589,69964799,7,0,0,233984,14,7560095490
2756,56142961,38490674,94633635,2,0,1,175104,0,10345038073
2757,56150920,13571490,69722410,7,0,0,196096,14,7825232358
2758,56152620,38490125,94642745,5,0,1,25088,1,10639948947
2759,56161351,38669866,94831217,2,0,1,69120,0,9450452703
2760,56168530,14255221,70423751,4,0,0,129536,9,2927996495
2761,56187350,38680942,94868292,5,0,1,10240,1,4198168627
2762,56198591,38899700,95098291,2,0,1,104960,0,6952046514
2763,56200541,13347223,69547764,2,0,0,5120,0,8483210414
2764,56244089,14110580,70354669,0,0,0,347136,6,2563676241
2765,56311100,38787214,95098314,5,0,1,4608,1,3720509404
2766,56326319,13252304,69578623,0,0,0,1536,6,8549568160
2767,56371160,38728771,95099931,5,0,1,22016,1,6039980062
2768,56374200,13498950,69873150,4,0,0,211968,9,8266770023
2769,56424039,13146438,69570477,0,0,0,3072,6,3735169138
2770,56452670,13270543,69723213,1,0,0,2560,23,986902716
2771,56516350,13360099,69876449,1,0,0,10752,23,8920895283
2772,56550021,39025553,95575574,2,0,1,88064,0,2081606841
2773,56638141,39030261,95668402,2,0,1,12800,0,7288768411
2774,56653580,39082700,95736280,5,0,1,33280,1,423151110
2775,56664609,13848645,70513254,0,0,0,2560,6,2088444526
2776,56666020,13140060,69806080,4,0,0,81408,9,916915859
2777,56678690,12907771,69586461,1,0,0,5120,23,2723232101
2778,56695861,39076563,95772424,2,0,1,26112,0,3131875210
2779,56718960,39105609,95824569,8,0,1,19968,12,2031579900
2780,56741920,13990446,70732366,7,0,0,280576,14,1350461711
2781,56820059,12908261,69728320,0,0,0,3072,6,6628257612
2782,56843160,39081746,95924906,8,0,1,54784,12,9133168415
2783,56870049,13096177,69966226,0,0,0,4608,6,5571935470
2784,56914551,14159181,71073732,2,0,0,240640,0,4553121585
2785,56921930,39002999,95924929,3,0,1,1024,28,920108929
2786,56934269,13849381,70783650,0,0,0,512,6,7924426851
2787,56942330,39002119,95944449,8,0,1,30720,12,4064308375
2788,56952970,13295908,70248878,4,0,0,304128,9,5350526140
2789,56959720,38999102,95958822,5,0,1,9216,1,4846610773
2790,56965370,38995398,95960768,8,0,1,3072,12,8851882486
2791,56966290,39339111,96305401,8,0,1,63488,12,505467757
2792,56967460,14293331,71260791,1,0,0,1024,23,8765689191
2793,56967870,39337554,96305424,5,0,1,4608,1,5250294349
2794,56975440,39330186,96305626,8,0,1,7680,12,2229834185
2795,56994650,13370057,70364707,7,0,0,25088,14,6973397886
2796,57042090,13465455,70507545,4,0,0,130560,9,5697480262
2797,57048699,14202352,71251051,0,0,0,512,6,3966141032
2798,57057270,13299762,70357032,1,0,0,7680,23,3975423881
2799,57104290,39417552,96521842,5,0,1,43008,1,391795793
2800,57113690,39520093,96633783,5,0,1,33280,1,6714245122
2801,57140569,12895651,70036220,0,0,0,512,6,9908466312
2802,57141610,14371112,71512722,7,0,0,465920,14,1390640307
2803,57169901,13476931,70646832,2,0,0,212992,0,8448206683
2804,57176910,39456896,96633806,5,0,1,3072,1,2485780977
2805,57195561,14481968,71677529,7,0,0,145408,14,8749710427
2806,57268720,13668941,70937661,1,0,0,2048,23,1069223298
2807,57280930,13455070,70736000,1,0,0,1536,23,891964360
2808,57292780,39341049,96633829,5,0,1,1024,1,4049776878
2809,57348101,14238990,71587091,7,0,0,129024,14,5918610178
2810,57377530,39256322,96633852,5,0,1,9216,1,77610530
2811,57418000,39229333,96647333,9,0,1,25600,10,3124442490
2812,57434670,39245656,96680326,5,0,1,5632,1,6330326475
2813,57543359,13318696,70862055,0,0,0,2048,6,6163341699
2814,57562161,13666357,71228518,7,0,0,60928,14,2702727507
2815,57582910,39102242,96685152,5,0,1,7680,1,2873346302
2816,57717820,14184753,71902573,7,0,0,435712,14,1817448783
2817,57788610,12946899,70735509,7,0,0,10240,14,2145806176
2818,57850549,13004671,70855220,5,0,0,3072,1,2929086994
2819,57855090,13659113,71514203,1,0,0,512,23,4739022242
2820,57865721,14137009,72002730,7,0,0,326656,14,7034454929
2821,57905450,38834703,96740153,5,0,1,14848,1,540304878
2822,57933431,13613803,71547234,2,0,0,81920,0,6586543969
2823,57937710,38807832,96745542,5,0,1,17408,1,2200081245
2824,57959830,13554007,71513837,1,0,0,3584,23,9393788357
2825,57966910,13554983,71521893,4,0,0,25088,9,3872362185
2826,57984909,13265963,71250872,0,0,0,3072,6,2888951155
2827,58015699,13498325,71514024,0,0,0,512,6,2767788963
2828,58082519,13063429,71145948,5,0,0,1536,1,1633950824
2829,58102250,38653838,96756088,5,0,1,6656,1,589122983
2830,58122130,13130642,71252772,1,0,0,2048,23,4419885163
2831,58147029,13968525,72115554,0,0,0,1024,6,9556498797
2832,58194891,13436472,71631363,2,0,0,139776,0,9145978388
2833,58229731,13020182,71249913,7,0,0,70144,14,1944121925
2834,58238901,13055930,71294831,2,0,0,37888,0,713582226
2835,58289430,14206181,72495611,4,0,0,151552,9,3465834898
2836,58316539,13272190,71588729,0,0,0,4096,6,3614339952
2837,58327260,13304602,71631862,1,0,0,1536,23,4171385809
2838,58328111,13435530,71763641,7,0,0,143360,14,3251105449
2839,58343530,13204226,71547756,1,0,0,512,23,5743033396
2840,58355841,13329378,71685219,2,0,0,25088,0,9205916843
2841,58372851,14076561,72449412,7,0,0,242176,14,7884694886
2842,58385329,12774093,71159422,5,0,0,512,1,1482826624
2843,58398689,13504490,71903179,5,0,0,1536,1,7524307889
2844,58427219,13095032,71522251,5,0,0,1024,1,3682804227
2845,58449150,39023664,97472814,6,0,1,77824,19,7195156580
2846,58463029,13306742,71769771,0,0,0,512,6,4683194034
2847,58510910,38993175,97504085,5,0,1,16896,1,9882674201
2848,58525500,39392025,97917525,0,0,1,397824,6,6368250600
2849,58558179,13029247,71587426,0,0,0,1024,6,2328941610
2850,58589920,39327628,97917548,5,0,1,8704,1,8231656695
2851,58633900,39283671,97917571,4,0,1,512,9,5671872220
2852,58667839,12965294,71633133,5,0,0,4096,1,4054761938
2853,58671640,39247545,97919185,8,0,1,31744,12,267446352
2854,58679730,14008301,72688031,1,0,0,2048,23,3776042601
2855,58687769,12859808,71547577,0,0,0,1024,6,912961854
2856,58708221,13665641,72373862,2,0,0,230912,0,10069423236
2857,58721460,39197748,97919208,4,0,1,8192,9,1138338433
2858,58745319,39175651,97920970,4,0,1,33792,9,5383888037
2859,58756309,13246935,72003244,0,0,0,1024,6,6043340567
2860,58767821,13337102,72104923,2,0,0,25600,0,4848417329
2861,58777671,39199056,97976727,2,0,1,115200,0,2426800929
2862,58835700,39148159,97983859,0,0,1,41984,6,8493152831
2863,58849720,39206142,98055862,5,0,1,43008,1,509172209
2864,58897659,12788246,71685905,5,0,0,2048,1,2272047787
2865,58900409,39155476,98055885,4,0,1,512,9,985871359
2866,58903851,12865741,71769592,7,0,0,19456,14,4353350264
2867,58906889,13096020,72002909,0,0,0,512,6,2146675568
2868,58919730,14324151,73243881,4,0,0,564224,9,9388376127
2869,58927990,39127918,98055908,4,0,1,19456,9,4202248764
2870,58943820,13560182,72504002,1,0,0,5632,23,7732229143
2871,58967991,14054888,73022879,2,0,0,282112,0,10062593581
2872,58990380,39065730,98056110,5,0,1,33792,1,1302538483
2873,58996259,13500958,72497217,0,0,0,3072,6,2868447088
2874,59054881,14318843,73373724,2,0,0,163840,0,6093516700
2875,59068739,13036675,72105414,5,0,0,1536,1,6128990336
2876,59099640,13495007,72594647,4,0,0,50688,9,7473049859
2877,59179820,38887166,98066986,5,0,1,26624,1,4637201775
2878,59244920,12888528,72133448,1,0,0,2560,23,3219802136
2879,59253460,38814397,98067857,7,0,1,12288,14,9077367848
2880,59270840,13231392,72502232,4,0,0,16384,9,6588869876
2881,59302431,13383249,72685680,7,0,0,155136,14,4435672365
2882,59329100,13176554,72505654,1,0,0,1536,23,1568498723
2883,59351659,12914678,72266337,5,0,0,3072,1,1558746317
2884,59358559,13017042,72375601,5,0,0,5632,1,3992903833
2885,59430759,13125820,72556579,5,0,0,3072,1,4822769202
2886,59444890,13091386,72536276,4,0,0,100352,9,10158141360
2887,59557630,12938628,72496258,1,0,0,2048,23,152324681
2888,59592259,12944196,72536455,5,0,0,512,1,6348036086
2889,59621291,13167184,72788475,7,0,0,133632,14,7814685488
2890,59670609,12591715,72262324,5,0,0,2560,1,1885323408
2891,59684271,12859117,72543388,7,0,0,22016,14,8642985058
2892,59696091,13820466,73516557,2,0,0,24576,0,1576334672
2893,59701379,12842577,72543956,0,0,0,1536,6,467047144
2894,59762300,38310269,98072569,4,0,1,17920,9,1883576309
2895,59792940,38307285,98100225,5,0,1,30720,1,4834911205
2896,59809691,13262255,73071946,2,0,0,93696,0,2237330545
2897,59817159,12688004,72505163,5,0,0,3584,1,7754006847
2898,59829080,12960354,72789434,1,0,0,3072,23,8394723479
2899,59856049,12829833,72685882,0,0,0,512,6,8293620329
2900,59904190,12788137,72692327,1,0,0,1024,23,1390346865
2901,59926061,13685925,73611986,7,0,0,41984,14,7958562864
2902,60065709,12760692,72826401,5,0,0,1024,1,2035632557
2903,60068119,12468538,72536657,0,0,0,512,6,940820002
2904,60075180,38034793,98109973,5,0,1,35840,1,5921327041
2905,60127500,13196281,73323781,1,0,0,2048,23,7109064183
2906,60205230,13393933,73599163,8,0,0,115712,12,1466751098
2907,60212689,12411856,72624545,5,0,0,1024,1,560230989
2908,60266489,13347236,73613725,5,0,0,5632,1,9569409061
2909,60287070,12503323,72790393,4,0,0,3072,9,1095476706
2910,60296841,13026293,73323134,2,0,0,157696,0,6690839169
2911,60366941,13503692,73870633,2,0,0,91136,0,6009345111
2912,60435441,12839622,73275063,7,0,0,79360,14,9454714017
2913,60448999,13067893,73516892,5,0,0,1024,1,8426418306
2914,60452319,12293712,72746031,0,0,0,512,6,8967966380
2915,60467111,13041935,73509046,2,0,0,343040,0,7860203713
2916,60480350,12418585,72898935,1,0,0,1024,23,77518522
2917,60540141,13296249,73836390,7,0,0,189440,14,8828272650
2918,60600070,12647803,73247873,1,0,0,2560,23,6309084314
2919,60677551,12726952,73404503,7,0,0,100864,14,200726962
2920,60730340,37444749,98175089,4,0,1,25088,9,6219868255
2921,60832911,12413824,73246735,7,0,0,8192,14,442455952
2922,60849589,12926493,73776082,0,0,0,1024,6,9860376220
2923,60872281,12742738,73615019,2,0,0,3072,0,6437572735
2924,61017639,12226577,73244216,5,0,0,1024,1,1302050352
2925,61043560,11801653,72845213,4,0,0,7168,9,6600056199
2926,61057189,11733695,72790884,0,0,0,1536,6,1072319183
2927,61170190,37344163,98514353,0,0,1,350720,6,9017574629
2928,61203050,12047810,73250860,1,0,0,9728,23,8406789001
2929,61234750,12541511,73776261,1,0,0,512,23,6120206821
2930,61252961,12375406,73628367,2,0,0,1024,0,6880749478
2931,61271440,11752242,73023682,1,0,0,2560,23,3906511096
2932,61287340,12488407,73775747,4,0,0,255488,9,9585535366
2933,61311961,12302099,73614060,2,0,0,1024,0,3829122613
2934,61346750,12671300,74018050,1,0,0,6144,23,3133237832
2935,61355709,12762100,74117809,0,0,0,3584,6,2413912855
2936,61356321,37210849,98567170,2,0,1,78336,0,7511960753
2937,61358809,11888261,73247070,5,0,0,1024,1,2555309285
2938,61363750,12197101,73560851,4,0,0,140800,9,4243708920
2939,61368351,37330020,98698371,2,0,1,125952,0,3065235740
2940,61379931,12493065,73872996,7,0,0,7680,14,824009311
2941,61434661,12343986,73778647,7,0,0,7680,14,5283857394
2942,61440319,12077430,73517749,0,0,0,2560,6,9186944727
2943,61507250,12920855,74428105,4,0,0,217600,9,8082160442
2944,61577190,12688195,74265385,4,0,0,371200,9,6724018190
2945,61606131,12056190,73662321,2,0,0,1536,0,665693250
2946,61687241,11876464,73563705,2,0,0,6656,0,69506601
2947,61700579,11863305,73563884,5,0,0,512,1,5606705664
2948,61732489,12206841,73939330,5,0,0,2048,1,3075409825
2949,61806731,12245976,74052707,7,0,0,48128,14,6575774309
2950,61814270,12478530,74292800,4,0,0,83456,9,5587723224
2951,61840030,12661486,74501516,1,0,0,1536,23,7872354678
2952,61878059,11639869,73517928,5,0,0,512,1,2560537838
2953,61883751,11677903,73561654,7,0,0,2560,14,9099386990
2954,61922329,12184146,74106475,5,0,0,512,1,5966607417
2955,61984891,36860114,98845005,2,0,1,154112,0,8471848957
2956,61984949,11898206,73883155,0,0,0,1024,6,2737012451
2957,61994860,36851595,98846455,0,0,1,2048,6,491203237
2958,61997430,36926559,98923989,0,0,1,169984,6,2375473721
2959,62019201,12555704,74574905,2,0,0,1024,0,9711798899
2960,62055680,12881331,74937011,4,0,0,795136,9,8729543068
2961,62063591,11619608,73683199,2,0,0,2048,0,8530520081
2962,62068171,11768398,73836569,7,0,0,512,14,5864026673
2963,62071980,37002219,99074199,0,0,1,254976,6,6238713411
2964,62167159,12100144,74267303,0,0,0,3072,6,7067079794
2965,62169499,11883387,74052886,0,0,0,512,6,7010480008
2966,62194070,12805548,74999618,4,0,0,135680,9,558966253
2967,62213029,12216838,74429867,0,0,0,1536,6,2160063646
2968,62228301,12201075,74429376,7,0,0,4096,14,1583663789
2969,62259430,36967319,99226749,2,0,1,195584,0,1972408236
2970,62306550,12352488,74659038,1,0,0,512,23,1534620840
2971,62326401,12121552,74447953,7,0,0,2560,14,1611750985
2972,62329550,36897865,99227415,1,0,1,1024,23,4261891809
2973,62375961,12261855,74637816,7,0,0,2560,14,5594833589
2974,62387750,12678445,75066195,1,0,0,3072,23,8967157350
2975,62389769,11903257,74293026,0,0,0,512,6,4890159065
2976,62399581,11480502,73880083,7,0,0,1024,14,5078301430
2977,62432430,36814764,99247194,2,0,1,20992,0,4057498479
2978,62478221,11514886,73993107,7,0,0,3584,14,7564365759
2979,62498920,36749025,99247945,1,0,1,10752,23,8442437557
2980,62526400,12540130,75066530,1,0,0,1024,23,850274927
2981,62569000,36679291,99248291,7,0,1,512,14,388196147
2982,62583510,36705491,99289001,0,0,1,52224,6,9529223782
2983,62590750,36703948,99294698,2,0,1,18944,0,1012755287
2984,62618040,36685886,99303926,1,0,1,18944,23,9989718031
2985,62681310,36663832,99345142,0,0,1,67072,6,3129960239
2986,62687161,11674482,74361643,7,0,0,4608,14,2560848249
2987,62757120,11509224,74266344,1,0,0,3072,23,9320200052
2988,62858020,36507200,99365220,7,0,1,15872,14,4194330102
2989,62863850,36503956,99367806,0,0,1,4096,6,4769173845
2990,62884410,36514379,99398789,0,0,1,50176,6,3515395536
2991,62887080,36524673,99411753,5,0,1,19456,1,5809085031
2992,62892621,11248786,74141407,7,0,0,14336,14,14616364
2993,62930359,11625744,74556103,0,0,0,4608,6,4202329476
2994,62931789,11361572,74293361,5,0,0,1024,1,7039261129
2995,62932190,36537481,99469671,7,0,1,116736,14,9549318724
2996,62939939,11355973,74295912,5,0,0,1024,1,4402190170
2997,62976400,36525835,99502235,5,0,1,31744,1,10258082699
2998,62982660,36520241,99502901,5,0,1,1024,1,2538940121
2999,63000519,11627521,74628040,0,0,0,512,6,3556410517
3000,63029291,12035558,75064849,7,0,0,214016,14,2778860243
3001,63090511,11867028,74957539,7,0,0,67072,14,5091975779
3002,63122709,11383628,74506337,5,0,0,512,1,7064133177
3003,63166800,36512754,99679554,0,0,1,105472,6,6494031645
3004,63168071,11152603,74320674,2,0,0,512,0,6712853593
3005,63174900,36538259,99713159,7,0,1,25088,14,2276604100
3006,63177490,36570805,99748295,2,0,1,13312,0,6984399304
3007,63180989,11367253,74548242,5,0,0,6656,1,7777804027
3008,63186599,11318358,74504957,0,0,0,1024,6,10693772069
3009,63208840,36593349,99802189,2,0,1,25088,0,10537836284
3010,63211980,36705510,99917490,5,0,1,64000,1,7867732375
3011,63215970,36701722,99917692,2,0,1,10240,0,572624974
3012,63218370,36699345,99917715,9,0,1,23552,10,314543629
3013,63230830,36686908,99917738,2,0,1,512,0,7499578179
3014,63233170,36750671,99983841,7,0,1,38912,14,9727822639
3015,63233370,36752116,99985486,5,0,1,10240,1,7349426135
3016,63251480,11363381,74614861,1,0,0,512,23,7139354173
3017,63266981,11286139,74553120,2,0,0,512,0,2431422507
3018,63269040,36717124,99986164,7,0,1,16896,14,7402785304
3019,63270870,36723425,99994295,0,0,1,37888,6,5597943817
3020,63276539,11359805,74636344,0,0,0,2560,6,4780460946
3021,63306789,11312992,74619781,0,0,0,1536,6,2161588550
3022,63308870,36854959,100163829,0,0,1,83968,6,10691723574
3023,63309479,11336957,74646436,0,0,0,512,6,6512365014
3024,63315560,37128941,100444501,0,0,1,392192,6,5648089510
3025,63321990,37122534,100444524,7,0,1,19968,14,420683523
3026,63336820,37109934,100446754,7,0,1,18432,14,4277423297
3027,63336979,11621207,74958186,5,0,0,2048,1,1283144355
3028,63369210,37077567,100446777,2,0,1,3072,0,5994793638
3029,63399370,37048707,100448077,5,0,1,8704,1,10314755436
3030,63404040,37045023,100449063,7,0,1,1536,14,1290925260
3031,63404220,37064822,100469042,2,0,1,19968,0,8803842803
3032,63408120,37067477,100475597,0,0,1,2048,6,2653032450
3033,63426420,37049523,100475943,9,0,1,512,10,8679642262
3034,63443281,37034288,100477569,9,0,1,2560,10,307895047
3035,63447580,11617587,75065167,1,0,0,512,23,1813788533
3036,63454430,37040601,100495031,0,0,1,55296,6,241434263
3037,63474670,37034929,100509599,9,0,1,22016,10,6780040437
3038,63481560,37029665,100511225,9,0,1,2560,10,9442526459
3039,63530121,11932415,75462536,7,0,0,42496,14,193996143
3040,63544360,11815477,75359837,4,0,0,112128,9,2594055388
3041,63571790,36953380,100525170,0,0,1,50688,6,1781120887
3042,63579849,11834349,75414198,5,0,0,1536,1,6179218883
3043,63581609,11603719,75185328,5,0,0,2048,1,764157258
3044,63592970,11917720,75510690,4,0,0,140288,9,2172401900
3045,63601461,11792095,75393556,7,0,0,110592,14,4185268075
3046,63632381,11928383,75560764,2,0,0,2048,0,7831423432
3047,63655161,36873187,100528348,2,0,1,3584,0,5771353043
3048,63709381,12081762,75791143,7,0,0,240640,14,522238867
3049,63709950,12129871,75839821,4,0,0,2048,9,3848153656
3050,63784739,11609620,75394359,0,0,0,2560,6,6434952949
3051,63845970,36685924,100531894,5,0,1,5632,1,2645863078
3052,63910579,11902632,75813211,5,0,0,1536,1,2007676477
3053,63931690,36600870,100532560,7,0,1,11264,14,5169001085
3054,63940290,36623069,100563359,7,0,1,2048,14,9376473375
3055,63959930,36603452,100563382,5,0,1,512,1,9649586083
3056,63966459,11686496,75652955,0,0,0,2048,6,2215633181
3057,63981460,11957495,75938955,1,0,0,13824,23,1444661416
3058,64006030,36557375,100563405,5,0,1,1024,1,540465711
3059,64021601,11538516,75560117,7,0,0,55808,14,9239014615
3060,64031100,36546757,100577857,0,0,1,84480,6,6298735768
3061,64031870,36563449,100595319,9,0,1,44032,10,2730416596
3062,64034849,11626909,75661758,5,0,0,2048,1,8239419251
3063,64036531,12173112,76209643,7,0,0,471552,14,3212002671
3064,64044401,11606262,75650663,2,0,0,4608,0,7853564435
3065,64052030,36560799,100612829,5,0,1,35328,1,4328075917
3066,64090240,36541678,100631918,2,0,1,2560,0,4373443315
3067,64093719,11848529,75942248,5,0,0,512,1,7961177533
3068,64097560,11694386,75791946,1,0,0,2560,23,1262844391
3069,64107589,11799705,75907294,5,0,0,4608,1,1006912414
3070,64123341,11734935,75858276,7,0,0,40960,14,1680952009
3071,64124740,36543826,100668566,9,0,1,58880,10,9070378992
3072,64132720,36699283,100832003,9,0,1,50688,10,9352760679
3073,64136969,11843308,75980277,5,0,0,7168,1,1166533548
3074,64137890,36748606,100886496,5,0,1,7168,1,70331291
3075,64152780,36733739,100886519,5,0,1,512,1,8526068488
3076,64167930,36721131,100889061,2,0,1,6656,0,7515884212
3077,64208269,12003205,76211474,0,0,0,1024,6,2467932330
3078,64216401,11776334,75992735,2,0,0,512,0,9518123201
3079,64231810,36657274,100889084,5,0,1,5632,1,2824550056
3080,64311840,36660266,100972106,7,0,1,29696,14,9910747801
3081,64315789,11896199,76211988,5,0,0,1536,1,4169008326
3082,64317510,36791687,101109197,7,0,1,13312,14,886672920
3083,64327641,11727179,76054820,2,0,0,1024,0,4441628655
3084,64345749,11866776,76212525,0,0,0,1536,6,8399090885
3085,64416060,36870697,101286757,5,0,1,25600,1,4829734650
3086,64418341,11794542,76212883,2,0,0,1024,0,4780857898
3087,64421610,36865170,101286780,0,0,1,4608,6,2571759139
3088,64453150,11804715,76257865,1,0,0,3072,23,9714048487
3089,64472051,11739042,76211093,2,0,0,4608,0,8602180674
3090,64492250,11814650,76306900,1,0,0,512,23,4296574771
3091,64504590,36782213,101286803,5,0,1,18944,1,7809135506
3092,64524390,37033875,101558265,0,0,1,41984,6,8014021018
3093,64546900,37139272,101686172,7,0,1,9216,14,10529638431
3094,64553141,12035813,76588954,7,0,0,116736,14,7214816123
3095,64554779,12040149,76594928,5,0,0,2048,1,10179126474
3096,64586740,37099455,101686195,9,0,1,12288,10,1209967192
3097,64606201,11988080,76594281,7,0,0,17408,14,8067875808
3098,64606760,37079458,101686218,2,0,1,26624,0,1219683664
3099,64610220,37076021,101686241,0,0,1,25600,6,9196719594
3100,64616360,37070083,101686443,9,0,1,5632,10,2567506969
3101,64640470,37045996,101686466,0,0,1,8704,6,8359963392
3102,64640840,37045649,101686489,7,0,1,9216,14,3799370556
3103,64658409,11809479,76467888,5,0,0,3584,1,4231371359
3104,64694360,36992152,101686512,9,0,1,3072,10,1718660226
3105,64700130,37010586,101710716,2,0,1,14336,0,2608167128
3106,64755600,37590048,102345648,0,0,1,707584,6,8247426697
3107,64756470,38266242,103022712,0,0,1,329216,6,8608668827
3108,64829691,11829387,76659078,2,0,0,5632,0,8850815784
3109,64839400,38205845,103045245,7,0,1,14336,14,3784831879
3110,64871210,11948697,76819907,4,0,0,71168,9,3113958087
3111,64891170,38154901,103046071,7,0,1,37888,14,7153083241
3112,64926190,38119904,103046094,1,0,1,11264,23,2550869470
3113,64981750,38064367,103046117,9,0,1,15360,10,9343150357
3114,65025371,38020769,103046140,2,0,1,11776,0,7184495648
3115,65075920,38036484,103112404,0,0,1,64000,6,7229877756
3116,65082661,11689448,76772109,7,0,0,31232,14,8809495454
3117,65092030,11728992,76821022,1,0,0,3584,23,802245077
3118,65118390,37994037,103112427,9,0,1,2048,10,10484718096
3119,65126979,11949077,77076056,0,0,0,2048,6,9163361963
3120,65126980,37985470,103112450,0,0,1,10240,6,3634383592
3121,65158669,11673018,76831687,0,0,0,512,6,7778068689
3122,65212630,12007493,77220123,4,0,0,144896,9,3022377726
3123,65244620,37868040,103112660,7,0,1,10240,14,9791102395
3124,65275510,11716063,76991573,4,0,0,52224,9,3336547
3125,65276190,37918399,103194589,2,0,1,16896,0,4552586142
3126,65276710,37958390,103235100,1,0,1,55296,23,5680402763
3127,65293839,11790828,77084667,0,0,0,512,6,2155548439
3128,65325010,38134139,103459149,0,0,1,118272,6,5661535242
3129,65347680,38962058,104309738,0,0,1,335872,6,9322361783
3130,65366801,11853813,77220614,2,0,0,1536,0,5451176212
3131,65374790,38934971,104309761,1,0,1,10752,23,4281514690
3132,65400341,11948249,77348590,2,0,0,1024,0,8774797806
3133,65419170,38974802,104393972,9,0,1,16896,10,6875354246
3134,65429910,38964085,104393995,7,0,1,512,14,9666495777
3135,65447040,38946978,104394018,9,0,1,4608,10,2381497303
3136,65456660,38937381,104394041,0,0,1,23040,6,5184640263
3137,65492271,11729926,77222197,7,0,0,5120,14,10307842286
3138,65494200,38903037,104397237,7,0,1,3072,14,5711558074
3139,65498110,38900113,104398223,1,0,1,1536,23,2116720316
3140,65523121,11857875,77380996,7,0,0,30208,14,6998485488
3141,65546270,38856779,104403049,0,0,1,7680,6,7795609122
3142,65550050,11883389,77433439,1,0,0,3584,23,390822933
3143,65575490,11877430,77452920,4,0,0,18432,9,9303182752
3144,65595369,11818334,77413703,5,0,0,8704,1,4193621558
3145,65617461,38786894,104404355,2,0,1,2048,0,8210953290
3146,65640791,38766253,104407044,2,0,1,16896,0,1709020963
3147,65658021,38756541,104414562,2,0,1,13824,0,5518853236
3148,65687079,11891260,77578339,5,0,0,6656,1,2399377592
3149,65700820,12152158,77852978,4,0,0,62976,9,7426232139
3150,65705150,38751853,104457003,1,0,1,14848,23,6259842382
3151,65749080,38709203,104458283,9,0,1,14336,10,8936663933
3152,65757011,11851168,77608179,2,0,0,11264,0,7403485098
3153,65761430,12047452,77808882,1,0,0,1536,23,10044778248
3154,65765971,11758978,77524949,2,0,0,2048,0,8283118870
3155,65797369,11741428,77538797,5,0,0,2560,1,8770161296
3156,65814181,11732760,77546941,2,0,0,512,0,8983972547
3157,65817761,38763718,104581479,2,0,1,31232,0,10725245388
3158,65820121,38860651,104680772,2,0,1,45568,0,10235698739
3159,65831859,12076518,77908377,5,0,0,512,1,2050285998
3160,65853181,11861346,77714527,2,0,0,4096,0,8859508890
3161,65861171,38819624,104680795,2,0,1,9216,0,4516291352
3162,65883681,38797137,104680818,2,0,1,4608,0,1474984033
3163,65887131,11797495,77684626,2,0,0,512,0,9949639954
3164,65932309,11923367,77855676,0,0,0,2560,6,4945335086
3165,65944950,11909923,77854873,1,0,0,6144,23,738303986
3166,65975381,11732769,77708150,2,0,0,1024,0,184709961
3167,65989481,39129942,105119423,2,0,1,35328,0,7251903636
3168,65995801,39126008,105121809,2,0,1,8704,0,494540282
3169,66009480,39114715,105124195,9,0,1,16896,10,7600598739
3170,66022099,11795157,77817256,5,0,0,3072,1,3259403621
3171,66028520,39095698,105124218,9,0,1,17408,10,274266096
3172,66051921,11778495,77830416,2,0,0,512,0,2775831310
3173,66057920,39197124,105255044,9,0,1,24576,10,1220599388
3174,66065960,11836301,77902261,1,0,0,5120,23,9514575425
3175,66140730,39595992,105736722,0,0,1,18944,6,3625587658
3176,66143551,39595437,105738988,2,0,1,3584,0,9126532572
3177,66156660,40059871,106216531,9,0,1,41472,10,5395941258
3178,66206930,12356633,78563563,4,0,0,346112,9,6166817046
3179,66220080,11879752,78099832,4,0,0,129024,9,1017398089
3180,66225170,11581152,77806322,1,0,0,1536,23,10408872087
3181,66281801,12009199,78291000,7,0,0,7680,14,693974658
3182,66389860,11902184,78292044,1,0,0,1024,23,1502541698
3183,66417011,11842845,78259856,2,0,0,512,0,8789630732
3184,66460070,11641345,78101415,1,0,0,5120,23,2585537645
3185,66508660,39862590,106371250,9,0,1,16384,10,295821056
3186,66531741,39839532,106371273,2,0,1,3584,0,1541182855
3187,66532860,39838436,106371296,0,0,1,3072,6,2073167700
3188,66536501,39836441,106372942,2,0,1,1536,0,1142129297
3189,66584721,11791015,78375736,7,0,0,181248,14,1679300827
3190,66608029,11633195,78241224,0,0,0,5632,6,10067840715
3191,66649520,12262680,78912200,4,0,0,182784,9,7963369152
3192,66653361,12134214,78787575,7,0,0,249344,14,1079823296
3193,66672899,11592943,78265842,5,0,0,2560,1,8191341664
3194,66679930,39693877,106373807,9,0,1,2048,10,1849516943
3195,66683181,12243394,78926575,7,0,0,47104,14,3028031063
3196,66754481,11657252,78411733,7,0,0,75776,14,299929727
3197,66850341,39766471,106616812,2,0,1,4608,0,1680438626
3198,66853350,11710860,78564210,1,0,0,2048,23,6297285478
3199,66891200,40332305,107223505,3,0,1,52224,28,4736706119
3200,66911350,40516073,107427423,3,0,1,5120,28,5169075037
3201,66924960,40507609,107432569,2,0,1,8192,0,3287993957
3202,66939989,11648447,78588436,5,0,0,1536,1,8986937534
3203,66944340,40651497,107595837,9,0,1,8704,10,7635908725
3204,66976850,12201642,79178492,4,0,0,186880,9,8742145137
3205,66981420,40718378,107699798,9,0,1,9728,10,6168517997
3206,66997410,40888858,107886268,3,0,1,28160,28,4089578868
3207,67005381,11582564,78587945,7,0,0,77824,14,2121590558
3208,67010521,11805538,78816059,2,0,0,3072,0,5953412944
3209,67017100,40915041,107932141,2,0,1,9216,0,7198260867
3210,67043110,40889287,107932397,3,0,1,9216,28,1603900291
3211,67114961,11691669,78806630,7,0,0,62464,14,93447824
3212,67117740,11809349,78927089,1,0,0,1536,23,1451152763
3213,67126240,11304105,78430345,1,0,0,6144,23,1323197130
3214,67158800,40811395,107970195,3,0,1,10752,28,7563955690
3215,67182400,11408243,78590643,1,0,0,7168,23,958862894
3216,67183481,11785618,78969099,7,0,0,137728,14,9507077694
3217,67192830,11622247,78815077,4,0,0,27648,9,4191638806
3218,67213070,40967119,108180189,9,0,1,24576,10,6817082158
3219,67277400,40905695,108183095,3,0,1,4608,28,4722449434
3220,67288449,11528490,78816939,0,0,0,2560,6,1570172224
3221,67302460,41170468,108472928,2,0,1,30720,0,8545423528
3222,67302771,11683234,78986005,2,0,0,3072,0,6081654199
3223,67316910,11383799,78700709,1,0,0,1024,23,7413106843
3224,67332560,11855126,79187686,4,0,0,16384,9,3789984266
3225,67345930,41127021,108472951,9,0,1,14848,10,9470635699
3226,67355971,11752868,79108839,7,0,0,151040,14,5297206579
3227,67390760,11788223,79178983,1,0,0,1536,23,1717365148
3228,67408030,11577016,78985046,4,0,0,33280,9,10199388885
3229,67416329,11597170,79013499,0,0,0,512,6,1708604730
3230,67449249,11520832,78970081,0,0,0,3072,6,1977248818
3231,67451421,11657597,79109018,2,0,0,512,0,6054912309
3232,67469310,41124090,108593400,1,0,1,27136,23,9114333395
3233,67586800,11450599,79037399,1,0,0,1536,23,1856211711
3234,67592680,41068938,108661618,2,0,1,3584,0,8512600638
3235,67637301,11484220,79121521,7,0,0,40960,14,1987382233
3236,67643669,11570459,79214128,0,0,0,1536,6,5035084543
3237,67655709,11526627,79182336,0,0,0,2560,6,4063715999
3238,67707330,41058300,108765630,9,0,1,30720,10,7846973156
3239,67720281,11295102,79015383,2,0,0,5632,0,8534039183
3240,67784240,11563047,79347287,4,0,0,61440,9,5487279130
3241,67805759,11165453,78971212,0,0,0,3584,6,331063067
3242,67831559,11351112,79182671,5,0,0,1024,1,7356501280
3243,67857221,11322105,79179326,7,0,0,1024,14,5843272989
3244,67960470,40805183,108765653,9,0,1,1536,10,5120181502
3245,67986050,40779626,108765676,9,0,1,20480,10,1763939794
3246,68017711,11418278,79435989,7,0,0,145408,14,10649492058
3247,68067750,11227084,79294834,4,0,0,8192,9,1181802527
3248,68117881,11091951,79209832,2,0,0,2560,0,6239996426
3249,68166330,11015203,79181533,4,0,0,7168,9,3240107956
3250,68171810,11282459,79454269,1,0,0,2048,23,1273878147
3251,68184760,40669173,108853933,9,0,1,55808,10,5930912040
3252,68193291,11081798,79275089,2,0,0,2048,0,7248647815
3253,68218150,40637409,108855559,4,0,1,2560,9,4280732547
3254,68228300,40631125,108859425,0,0,1,18432,6,7865117333
3255,68239750,40878351,109118101,6,0,1,51712,19,5886996292
3256,68241491,11056668,79298159,2,0,0,1024,0,7881374865
3257,68305341,11792926,80098267,2,0,0,512,0,1480427761
3258,68310781,11126837,79437618,2,0,0,4096,0,2555431256
3259,68323191,11130431,79453622,7,0,0,52224,14,8755302873
3260,68372741,10869065,79241806,2,0,0,512,0,9952950528
3261,68398100,40720359,109118459,6,0,1,30208,19,1034404064
3262,68410920,40794344,109205264,0,0,1,28672,6,903926608
3263,68469800,11485391,79955191,4,0,0,163328,9,1479209954
3264,68475990,40888836,109364826,6,0,1,203264,19,7440258448
3265,68481439,10973227,79454666,5,0,0,1024,1,935541336
3266,68493970,10963620,79457590,1,0,0,1024,23,4583761786
3267,68503441,11261144,79764585,7,0,0,217600,14,10350639989
3268,68625050,40964132,109589182,6,0,1,120832,19,2217835383
3269,68643801,40945404,109589205,9,0,1,2560,10,7413823052
3270,68677490,40911738,109589228,9,0,1,15872,10,10037670462
3271,68690569,11529384,80219953,0,0,0,512,6,6184857588
3272,68707909,10937695,79645604,5,0,0,2560,1,4044916958
3273,68716310,11052922,79769232,1,0,0,2560,23,2227762713
3274,68727349,10830363,79557712,0,0,0,512,6,116952339
3275,68740550,40956605,109697155,9,0,1,13824,10,2317996942
3276,68776399,10659948,79436347,0,0,0,1024,6,6939913843
3277,68819079,11142757,79961836,0,0,0,512,6,1543608077
3278,68832070,41335612,110167682,9,0,1,415232,10,4051584127
3279,68833371,10795021,79628392,7,0,0,71168,14,1972054469
3280,68848539,10746050,79594589,0,0,0,512,6,8232551231
3281,68905129,10679562,79584691,5,0,0,1536,1,8362404985
3282,68921421,41246284,110167705,9,0,1,25088,10,5491839678
3283,68926500,11034954,79961454,4,0,0,20480,9,4019114226
3284,68933751,10834678,79768429,2,0,0,5632,0,1872513070
3285,68944600,10847944,79792544,4,0,0,512,9,3101625878
3286,68974510,10791837,79766347,1,0,0,512,23,1212977795
3287,68984250,10798022,79782272,4,0,0,35328,9,2909837163
3288,68998169,10678160,79676329,0,0,0,5632,6,8935231536
3289,69007589,10763873,79771462,0,0,0,3072,6,6995476715
3290,69043221,10749081,79792302,2,0,0,3072,0,10736114679
3291,69085810,10705533,79791343,4,0,0,29696,9,7428608239
3292,69118539,10706502,79825041,0,0,0,512,6,2318506139
3293,69190910,41049280,110240190,6,0,1,53760,19,10213838853
3294,69194490,10437233,79631723,4,0,0,5120,9,9687116576
3295,69312949,10457554,79770503,5,0,0,4096,1,612281941
3296,69316101,10450067,79766168,2,0,0,5120,0,4668644248
3297,69344310,41254306,110598616,6,0,1,437760,19,3098599299
3298,69385679,10381003,79766682,0,0,0,1024,6,2522578549
3299,69395981,11021534,80417515,7,0,0,98304,14,3230423453
3300,69413491,41455552,110869043,9,0,1,307200,10,3469279862
3301,69441369,10443005,79884374,0,0,0,512,6,10014328331
3302,69478149,10383212,79861361,0,0,0,1536,6,8247536480
3303,69547581,41321485,110869066,9,0,1,16896,10,7877175226
3304,69583831,10377802,79961633,2,0,0,512,0,1864100117
3305,69638101,11035464,80673565,7,0,0,221696,14,8247326594
3306,69723350,10804152,80527502,4,0,0,70144,9,10687119241
3307,69737090,10224933,79962023,1,0,0,512,23,7375838344
3308,69766030,10116073,79882103,1,0,0,1024,23,4362915104
3309,69840041,10151671,79991712,2,0,0,3584,0,3272248161
3310,69869630,41181715,111051345,6,0,1,364544,19,9488781501
3311,69899261,10444348,80343609,2,0,0,8192,0,6470268876
3312,69909320,41167487,111076807,6,0,1,101376,19,6279111638
3313,69935390,11230675,81166065,4,0,0,651264,9,2145023090
3314,69990559,10144423,80134982,0,0,0,4096,6,9101915922
3315,69996520,41088574,111085094,6,0,1,19456,19,7734329072
3316,70013250,41089119,111102369,6,0,1,3584,19,5502983195
3317,70079470,41031149,111110619,3,0,1,30720,28,5117768533
3318,70089350,10830798,80920148,4,0,0,509440,9,5993621668
3319,70120061,11337914,81457975,7,0,0,481280,14,365094470
3320,70122960,10405345,80528305,4,0,0,2560,9,8643372119
3321,70150610,10535811,80686421,1,0,0,1536,23,4489399199
3322,70195870,10737919,80933789,4,0,0,36864,9,1297841559
3323,70211250,10710481,80921731,1,0,0,5120,23,6506221566
3324,70260490,40855301,111115791,3,0,1,8192,28,8996926804
3325,70268370,40882928,111151298,3,0,1,29696,28,2718413030
3326,70270259,10922283,81192542,0,0,0,512,6,8348545261
3327,70291850,11263398,81555248,4,0,0,179712,9,4902506620
3328,70319850,40875572,111195422,3,0,1,30208,28,8975839887
3329,70328790,40866655,111195445,3,0,1,8192,28,5784353988
3330,70353199,10569335,80922534,0,0,0,2560,6,4386241784
3331,70370510,40824958,111195468,6,0,1,12800,19,8507486144
3332,70390819,10284769,80675588,0,0,0,512,6,10420647701
3333,70459250,40736241,111195491,3,0,1,18944,28,964741156
3334,70474160,40745542,111219702,3,0,1,98816,28,7933571260
3335,70564921,10387813,80952734,2,0,0,512,0,8486706895
3336,70623819,10328736,80952555,0,0,0,5120,6,6623809949
3337,70630589,9949300,80579889,0,0,0,1024,6,1121545351
3338,70643981,10972156,81616137,7,0,0,68608,14,8132452154
3339,70738691,10212281,80950972,7,0,0,56320,14,10636520228
3340,70807571,9654587,80462158,2,0,0,6656,0,10521564745
3341,70818950,40404298,111223248,3,0,1,5632,28,4252811713
3342,70851111,10101818,80952929,2,0,0,512,0,4199724717
3343,70869870,40361737,111231607,3,0,1,25600,28,6380067409
3344,70876369,10290366,81166735,0,0,0,2048,6,751792894
3345,70915660,10578778,81494438,4,0,0,107008,9,4885458576
3346,70956629,10541988,81498617,5,0,0,512,1,3157626971
3347,71036090,40195863,111231953,0,0,1,512,6,3032541822
3348,71047661,10263651,81311312,7,0,0,197632,14,7980665972
3349,71087871,10082966,81170837,7,0,0,12288,14,2056842098
3350,71121611,10045459,81167070,2,0,0,1024,0,7788634951
3351,71123510,40118655,111242165,5,0,1,18944,1,2615904739
3352,71124150,10569993,81694143,4,0,0,121856,9,2460104901
3353,71128690,40114569,111243259,5,0,1,12288,1,7172131813
3354,71180960,10277818,81458778,1,0,0,2560,23,2398847846
3355,71204249,10257383,81461632,5,0,0,2560,1,5154349680
3356,71205779,10256032,81461811,0,0,0,512,6,2336305703
3357,71225519,9993422,81218941,5,0,0,2560,1,4205463763
3358,71272960,10222601,81495561,1,0,0,3584,23,5493379451
3359,71275450,39972701,111248151,5,0,1,10240,1,3731612884
3360,71279600,39978532,111258132,3,0,1,5632,28,941759510
3361,71295789,10165040,81460829,0,0,0,6656,6,3609644843
3362,71358999,10200016,81559015,5,0,0,12288,1,2179746233
3363,71369459,10127240,81496699,5,0,0,3072,1,9887329640
3364,71370339,10128099,81498438,0,0,0,5632,6,3463791630
3365,71383461,10112279,81495740,2,0,0,512,0,883233290
3366,71437670,39820821,111258491,3,0,1,9728,28,6561363105
3367,71491060,39771617,111262677,5,0,1,6656,1,3965610438
3368,71572129,10218260,81790389,5,0,0,3072,1,7755870924
3369,71576770,39700661,111277431,3,0,1,26624,28,3621779395
3370,71650949,10228450,81879399,0,0,0,3584,6,5421819196
3371,71656110,39635248,111291358,2,0,1,4096,0,8435130948
3372,71667130,39624484,111291614,3,0,1,9216,28,6023675838
3373,71669431,9949223,81618654,2,0,0,1024,0,2748390954
3374,71676340,9942961,81619301,1,0,0,2048,23,5688578535
3375,71685971,10807705,82493676,7,0,0,139264,14,5045414468
3376,71722369,10507171,82229540,5,0,0,5120,1,7954657652
3377,71728919,10069352,81798271,5,0,0,1536,1,10383036854
3378,71733361,9898660,81632021,2,0,0,4096,0,2111581929
3379,71754671,10773051,82527722,2,0,0,2048,0,6248742890
3380,71774500,9841972,81616472,1,0,0,1024,23,9315961289
3381,71776880,39537769,111314649,3,0,1,45568,28,9298803324
3382,71805370,10645851,82451221,4,0,0,240640,9,7917726173
3383,71839259,10041411,81880670,0,0,0,4096,6,4718613592
3384,71888059,9736743,81624802,5,0,0,5120,1,2972323497
3385,71940490,9979925,81920415,4,0,0,17408,9,3312978586
3386,71953771,9838905,81792676,2,0,0,1024,0,8046050633
3387,71961101,10146917,82108018,7,0,0,169984,14,10471412938
3388,72071480,9806804,81878284,4,0,0,132608,9,827252931
3389,72074981,39250786,111325767,9,0,1,24064,10,8393915601
3390,72085239,9534795,81620034,5,0,0,512,1,724114988
3391,72128890,39197850,111326740,3,0,1,12800,28,9348692218
3392,72146091,10546271,82692362,7,0,0,78336,14,3741419008
3393,72168990,10541274,82710264,4,0,0,46592,9,3379763362
3394,72171770,39160155,111331925,3,0,1,17408,28,9550223917
3395,72210780,10457668,82668448,4,0,0,286208,9,10084004408
3396,72229430,10740899,82970329,4,0,0,391168,9,8280151811
3397,72296230,39036361,111332591,3,0,1,1024,28,3747895223
3398,72299349,9728041,82027390,0,0,0,1024,6,10567002917
3399,72307580,10219495,82527075,4,0,0,57856,9,2301718782
3400,72316421,10844019,83160440,7,0,0,412160,14,8563149348
3401,72318079,10520206,82838285,0,0,0,5120,6,5951913586
3402,72325030,10394354,82719384,1,0,0,512,23,6327871641
3403,72343350,9970669,82314019,1,0,0,3072,23,6187770574
3404,72350380,39005919,111356299,3,0,1,47104,28,2885736541
3405,72406751,9826170,82232921,2,0,0,2560,0,3360815436
3406,72407800,9899307,82307107,1,0,0,512,23,8050349697
3407,72449060,10044951,82494011,1,0,0,1024,23,4914287260
3408,72453161,10264403,82717564,2,0,0,4096,0,6627994356
3409,72461320,10231221,82692541,1,0,0,512,23,9599142934
3410,72470641,10547158,83017799,7,0,0,150528,14,9058988124
3411,72483259,10234589,82717848,5,0,0,512,1,7020901263
3412,72499760,10274218,82773978,4,0,0,6144,9,6332977156
3413,72519551,10510529,83030080,2,0,0,2048,0,7363120098
3414,72541951,10491919,83033870,2,0,0,10752,0,1925611899
3415,72569020,38808315,111377335,3,0,1,23552,28,2284592613
3416,72612120,38773990,111386110,3,0,1,9728,28,1816002835
3417,72638949,10523278,83162227,0,0,0,5632,6,9999281034
3418,72653409,10364725,83018134,0,0,0,1024,6,7622355871
3419,72701080,38686336,111387416,3,0,1,2048,28,7894226252
3420,72744900,10279809,83024709,4,0,0,21504,9,6522236164
3421,72804530,38584832,111389362,3,0,1,3072,28,9363401245
3422,72813099,10217472,83030571,0,0,0,1536,6,10583761247
3423,72880419,9946443,82826862,5,0,0,2048,1,8525114749
3424,72891989,10137382,83029371,0,0,0,9216,6,5995717903
3425,72896559,10128485,83025044,5,0,0,1024,1,5779600844
3426,72948140,38442195,111390335,3,0,1,12800,28,7729796827
3427,72998740,38436999,111435739,3,0,1,2560,28,3449997032
3428,72999219,9817427,82816646,0,0,0,3072,6,758212260
3429,73064590,10100499,83165089,1,0,0,8192,23,7375689718
3430,73084210,9950627,83034837,1,0,0,3072,23,9385610456
3431,73085141,10170192,83255333,7,0,0,117760,14,3463931800
3432,73088231,10247640,83335871,7,0,0,154112,14,8934504231
3433,73119020,38317487,111436507,7,0,1,11776,14,3236859081
3434,73181819,9790093,82971912,5,0,0,5120,1,5609430506
3435,73205219,10051720,83256939,0,0,0,3584,6,9876207319
3436,73296271,9730200,83026471,2,0,0,4608,0,6948056669
3437,73366420,38152529,111518949,3,0,1,65024,28,6837079352
3438,73372610,9789960,83162570,1,0,0,1024,23,1609709937
3439,73426811,9829013,83255824,2,0,0,1536,0,514996707
3440,73437670,38081302,111518972,3,0,1,33280,28,7889212840
3441,73454350,38064645,111518995,3,0,1,5632,28,8707240899
3442,73534100,37984918,111519018,3,0,1,10752,28,3293284199
3443,73617049,9641785,83258834,0,0,0,6144,6,8348885970
3444,73652700,37867144,111519844,2,0,1,30208,0,7657472692
3445,73666250,9737428,83403678,1,0,0,2048,23,6621466088
3446,73667601,38140678,111808279,9,0,1,189440,10,9131674281
3447,73671210,9867108,83538318,4,0,0,282624,9,246588314
3448,73712719,10033703,83746422,5,0,0,512,1,6635906812
3449,73715070,38100867,111815937,0,0,1,1024,6,6330080080
3450,73715289,9862143,83577432,0,0,0,1536,6,547794668
3451,73724030,38092266,111816296,2,0,1,9728,0,6591073755
3452,73731140,38115539,111846679,0,0,1,15360,6,9519773506
3453,73739820,38118647,111858467,3,0,1,3584,28,3168134274
3454,73781551,9384029,83165580,2,0,0,1536,0,1751228197
3455,73809639,9359459,83169098,0,0,0,1024,6,7322822057
3456,73852200,38008213,111860413,7,0,1,3072,14,1174186805
3457,73853370,38052866,111906236,9,0,1,60928,10,2161561704
3458,73869250,9499983,83369233,1,0,0,512,23,10716574835
3459,73869351,10243560,84112911,7,0,0,26624,14,10517160136
3460,73888019,10216757,84104776,0,0,0,1024,6,8706544152
3461,73904091,10120941,84025032,7,0,0,414720,14,3295386845
3462,73908029,9917529,83825558,5,0,0,2560,1,3243314728
3463,73932350,38022129,111954479,4,0,1,33792,9,8151696472
3464,73942041,10521355,84463396,7,0,0,300544,14,1715764355
3465,73971940,37983994,111955934,3,0,1,10752,28,5345940845
3466,73985810,10382768,84368578,4,0,0,232448,9,2684882315
3467,73988130,37994137,111982267,3,0,1,5632,28,4260075116
3468,74010810,38038123,112048933,9,0,1,28672,10,4668027386
3469,74039420,10042910,84082330,1,0,0,3584,23,10189226894
3470,74066981,10014234,84081215,7,0,0,184320,14,6645397642
3471,74088189,10167567,84255756,0,0,0,10240,6,3838856398
3472,74094591,9989166,84083757,2,0,0,4608,0,1069210865
3473,74099261,10538910,84638171,7,0,0,32768,14,5062218497
3474,74148691,10389036,84537727,2,0,0,4096,0,5555132235
3475,74148791,9674230,83823021,2,0,0,3072,0,5382304131
3476,74156231,9948187,84104418,7,0,0,67584,14,4310663382
3477,74161550,37887414,112048964,4,0,1,17920,9,2592768191
3478,74169440,10294603,84464043,1,0,0,2048,23,6654253538
3479,74177770,37871217,112048987,7,0,1,9728,14,10018492185
3480,74191651,10342886,84534537,2,0,0,230912,0,6732314938
3481,74195231,37952921,112148152,9,0,1,76800,10,2800720186
3482,74198240,10807438,85005678,7,0,0,67072,14,1053154500
3483,74207900,10555392,84763292,7,0,0,13824,14,7307085709
3484,74261390,10723627,84985017,7,0,0,499200,14,4949986719
3485,74276981,10555913,84832894,2,0,0,104960,0,8669546306
3486,74284959,10825947,85110906,0,0,0,6144,6,5909265221
3487,74334270,37914809,112249079,9,0,1,49664,10,5705555012
3488,74347669,10021400,84369069,0,0,0,1536,6,8639062615
3489,74349490,37900103,112249593,7,0,1,3584,14,3576283181
3490,74375860,37958917,112334777,4,0,1,23552,9,7050129625
3491,74382589,10153843,84536432,0,0,0,6144,6,1557352355
3492,74418911,10615806,85034717,2,0,0,95232,0,4645330967
3493,74441709,10598202,85039911,5,0,0,11264,1,10313499189
3494,74447610,37887190,112334800,9,0,1,25088,10,2251712551
3495,74457990,10301067,84759057,7,0,0,150016,14,3182838424
3496,74466080,37877056,112343136,7,0,1,16896,14,2936335877
3497,74507010,37851485,112358495,4,0,1,5632,9,3061448759
3498,74523540,37859164,112382704,4,0,1,81920,9,8175197876
3499,74574100,37814518,112388618,2,0,1,4096,0,1998667063
3500,74579301,10529664,85108965,2,0,0,167424,0,4245742484
3501,74615890,10633550,85249440,7,0,0,209408,14,1315624993
3502,74623630,37864808,112488438,9,0,1,24576,10,1459445628
3503,74627170,37861299,112488469,1,0,1,10240,23,5261402962
3504,74642561,10542959,85185520,2,0,0,244736,0,5495541873
3505,74692919,10292277,84985196,0,0,0,512,6,7587937242
3506,74745860,37742632,112488492,5,0,1,2048,1,7915327082
3507,74747260,10293462,85040722,1,0,0,2560,23,10079255936
3508,74771300,37717215,112488515,7,0,1,9728,14,8250814467
3509,74787870,10248586,85036456,2,0,0,5632,0,3825040334
3510,74792110,37728370,112520480,9,0,1,55296,10,4031099788
3511,74808710,37729796,112538506,2,0,1,20480,0,9702199602
3512,74811160,37790204,112601364,1,0,1,3584,23,6879339138
3513,74829040,10434834,85263874,1,0,0,6656,23,8398427450
3514,74843940,10417783,85261723,4,0,0,39936,9,10071033744
3515,74845640,10555676,85401316,4,0,0,94208,9,914958554
3516,74875250,10464000,85339250,4,0,0,38400,9,4393379708
3517,74879160,37723186,112602346,2,0,1,42496,0,6166106980
3518,74902180,10518134,85420314,1,0,0,1536,23,1025681600
3519,74974691,10392997,85367688,2,0,0,93184,0,6544449720
3520,75019260,10429921,85449181,1,0,0,1024,23,9091417663
3521,75019910,10398430,85418340,1,0,0,512,23,4490337771
3522,75037290,10366747,85404037,1,0,0,8704,23,7688841132
3523,75038330,37600601,112638931,2,0,1,31232,0,3898984537
3524,75048420,37596026,112644446,2,0,1,9728,0,4648664187
3525,75074610,37600172,112674782,7,0,1,2560,14,9025862082
3526,75086390,37588415,112674805,7,0,1,2048,14,6344744814
3527,75095120,37608987,112704107,4,0,1,27136,9,9834036
3528,75144151,10371987,85516138,2,0,0,60928,0,1565936420
3529,75153180,37761203,112914383,4,0,1,218112,9,7908736912
3530,75219379,10273338,85492717,5,0,0,512,1,2070545995
3531,75231940,37926033,113157973,4,0,1,74752,9,2424186975
3532,75251019,10267794,85518813,5,0,0,8704,1,4156517665
3533,75255280,37902724,113158004,9,0,1,56832,10,10211816757
3534,75299960,37954484,113254444,9,0,1,87040,10,1710318796
3535,75317329,37937138,113254467,4,0,1,12288,9,3915679549
3536,75334150,37939484,113273634,9,0,1,75264,10,3497927614
3537,75348720,37935011,113283731,2,0,1,8192,0,8436251965
3538,75381560,38768683,114150243,9,0,1,1105920,10,6285811014
3539,75407430,38825752,114233182,4,0,1,184320,9,1120077490
3540,75468700,38794646,114263346,1,0,1,46080,23,108983303
3541,75491960,10053237,85545197,1,0,0,1024,23,2844918970
3542,75509550,10009598,85519148,1,0,0,1024,23,659032076
3543,75525140,10177937,85703077,7,0,0,29696,14,5915969516
3544,75550980,38713851,114264831,1,0,1,15360,23,4237589110
3545,75557200,38755326,114312526,4,0,1,113152,9,5414171524
3546,75577980,38751092,114329072,1,0,1,28160,23,7205895722
3547,75584950,38760855,114345805,1,0,1,62976,23,9495957241
3548,75600970,10554101,86155071,1,0,0,3584,23,1475621990
3549,75602430,38822362,114424792,9,0,1,121344,10,10595675769
3550,75612620,38919451,114532071,9,0,1,197120,10,4392990518
3551,75621610,38977703,114599313,9,0,1,115712,10,5088555485
3552,75642610,10423967,86066577,7,0,0,32768,14,8832422124
3553,75703041,38898538,114601579,2,0,1,3584,0,9413296354
3554,75714180,11002893,86717073,7,0,0,201728,14,5114724037
3555,75748620,10790440,86539060,7,0,0,53760,14,356198268
3556,75803930,10485865,86289795,2,0,0,241664,0,1598864658
3557,75825890,38795793,114621683,4,0,1,47104,9,1657218028
3558,75835870,38807159,114643029,4,0,1,58880,9,9152479899
3559,75909510,38742132,114651642,1,0,1,2560,23,9554067285
3560,75920911,11032958,86953869,2,0,0,187392,0,10156352033
3561,75930310,38727797,114658107,4,0,1,30720,9,7477036922
3562,75945321,38716332,114661653,2,0,1,5632,0,7281980973
3563,75972240,38695366,114667606,4,0,1,28160,9,6864735676
3564,75978489,10020368,85998857,5,0,0,2048,1,1894030770
3565,76008780,38660926,114669706,1,0,1,11776,23,10019479370
3566,76010130,10293331,86303461,1,0,0,2048,23,10243045465
3567,76023640,10442597,86466237,4,0,0,69120,9,4744509809
3568,76056709,10154095,86210804,5,0,0,3584,1,2726335523
3569,76058621,38617347,114675968,2,0,1,512,0,5232893878
3570,76060780,38640815,114701595,4,0,1,26112,9,2118135290
3571,76087750,38615471,114703221,1,0,1,2560,23,7338853562
3572,76109370,10546216,86655586,7,0,0,198144,14,90806982
3573,76117310,38590097,114707407,8,0,1,6656,12,266275618
3574,76123690,38685113,114808803,9,0,1,184320,10,4615657985
3575,76124710,38685476,114810186,1,0,1,14848,23,9853903103
3576,76156780,38662529,114819309,2,0,1,11776,0,5497843678
3577,76165809,10250171,86415980,0,0,0,1024,6,9158185538
3578,76177200,38670012,114847212,2,0,1,1536,0,4609353147
3579,76214531,10585957,86800488,2,0,0,44032,0,4746936284
3580,76263740,38587658,114851398,8,0,1,6656,12,1030681864
3581,76277730,38586944,114864674,5,0,1,37376,1,981038144
3582,76311970,38605196,114917166,4,0,1,51200,9,1608019943
3583,76325810,38591379,114917189,1,0,1,10240,23,899403747
3584,76358341,38568354,114926695,9,0,1,86528,10,9904854219
3585,76381620,38804345,115185965,9,0,1,314368,10,3422321845
3586,76400610,38824365,115224975,8,0,1,32256,12,2851129923
3587,76403681,10324560,86728241,2,0,0,36352,0,7894025886
3588,76491810,10553070,87044880,4,0,0,67072,9,6403406232
3589,76503909,10013340,86517249,5,0,0,1024,1,5881465100
3590,76507620,39132440,115640060,4,0,1,410624,9,8298050136
3591,76572770,10323980,86896750,4,0,0,46592,9,3355470669
3592,76581510,39112290,115693800,8,0,1,29696,12,6772241026
3593,76600250,39106471,115706721,8,0,1,26624,12,5657760325
3594,76622221,39089685,115711906,2,0,1,16384,0,5897366718
3595,76636090,39131991,115768081,8,0,1,11264,12,7835536644
3596,76637230,39130874,115768104,1,0,1,12800,23,5466313584
3597,76689130,39192710,115881840,8,0,1,21504,12,6170142535
3598,76694800,10059204,86754004,4,0,0,84480,9,4005065268
3599,76729150,10798178,87527328,4,0,0,368640,9,8667825878
3600,76733090,39148773,115881863,8,0,1,19968,12,3362111016
3601,76739041,10098334,86837375,2,0,0,37376,0,5637479926
3602,76754541,39127345,115881886,2,0,1,11776,0,7374852471
3603,76762271,39119638,115881909,2,0,1,18944,0,3493779090
3604,76765660,9988523,86754183,1,0,0,512,23,10471118151
3605,76801210,39080722,115881932,1,0,1,512,23,225608852
3606,76849409,39032546,115881955,1,0,1,2048,23,8869535515
3607,76881519,9983007,86864526,0,0,0,1024,6,2774315016
3608,76909330,38996375,115905705,4,0,1,122368,9,6689780289
3609,76921110,39002337,115923447,4,0,1,30720,9,2016183114
3610,76925950,39035836,115961786,4,0,1,83456,9,4354372170
3611,76936429,10087992,87024421,0,0,0,10240,6,9781205987
3612,76937779,10853044,87790823,5,0,0,4096,1,790646464
3613,76974719,10115362,87090081,5,0,0,56832,1,7595448936
3614,77016659,11036433,88053092,5,0,0,167424,1,10595465078
3615,77028269,10374194,87402463,5,0,0,31744,1,1543356179
3616,77045171,10149506,87194677,2,0,0,46592,0,8347899336
3617,77058961,10585546,87644507,2,0,0,384512,0,1810232179
3618,77090010,9906862,86996872,1,0,0,1024,23,2756331602
3619,77123780,9890827,87014607,7,0,0,10752,14,2913185174
3620,77189770,38849291,116039061,4,0,1,70656,9,5964215330
3621,77242150,10627328,87869478,7,0,0,159232,14,6418260331
3622,77253619,9958146,87211765,5,0,0,22016,1,6905320973
3623,77333100,10456436,87789536,4,0,0,351744,9,3478459635
3624,77338460,10071058,87409518,1,0,0,2560,23,9410629725
3625,77343469,10795493,88138962,5,0,0,280576,1,10624054302
3626,77378169,10279184,87657353,5,0,0,41984,1,1057869999
3627,77417949,10557919,87975868,0,0,0,3072,6,9612098439
3628,77459819,10718353,88178172,5,0,0,128000,1,2966157611
3629,77477269,38634633,116111902,1,0,1,27648,23,4181540310
3630,77506930,38604995,116111925,0,0,1,5632,6,4976395733
3631,77532470,10726260,88258730,7,0,0,227840,14,997354103
3632,77553331,10743330,88296661,7,0,0,124416,14,521671169
3633,77602020,10276373,87878393,4,0,0,29184,9,921888163
3634,77605900,39082451,116688351,4,0,1,218624,9,8647427220
3635,77623910,39064464,116688374,7,0,1,4608,14,4067712080
3636,77626430,39061967,116688397,6,0,1,35840,19,1399301820
3637,77639950,39048470,116688420,7,0,1,1024,14,2011558805
3638,77648350,10649582,88297932,1,0,0,4096,23,1448302341
3639,77651460,39233202,116884662,2,0,1,17920,0,7827201710
3640,77675049,39209644,116884693,4,0,1,40960,9,4560637895
3641,77680399,10373052,88053451,0,0,0,1024,6,3994358584
3642,77739649,10399500,88139149,0,0,0,512,6,10103858240
3643,77786610,39164171,116950781,3,0,1,74752,28,4431277656
3644,77788969,39204290,116993259,1,0,1,6656,23,3044061147
3645,77794659,10384324,88178983,0,0,0,2560,6,6168486977
3646,77803470,10622062,88425532,7,0,0,105472,14,9234796095
3647,77867140,40278796,118145936,4,0,1,330752,9,1087869117
3648,77872409,10553394,88425803,0,0,0,512,6,10479178304
3649,77879910,40266049,118145959,2,0,1,14848,0,9555377787
3650,77879979,40533985,118413964,4,0,1,188416,9,4843501558
3651,77884690,40529297,118413987,7,0,1,8704,14,6232649602
3652,77902331,40511679,118414010,2,0,1,5632,0,781435704
3653,77922651,40491382,118414033,2,0,1,11776,0,9428356261
3654,77934310,10455827,88390137,1,0,0,3072,23,8486286892
3655,77941470,40474192,118415662,6,0,1,56832,19,5172624640
3656,77968880,10709702,88678582,4,0,0,262144,9,6735155570
3657,77976220,40439465,118415685,7,0,1,3072,14,9544145060
3658,78016659,40399049,118415708,1,0,1,3072,23,8891175235
3659,78031989,10831026,88863015,5,0,0,112640,1,17240899
3660,78046751,10868125,88914876,2,0,0,169984,0,7921951114
3661,78047120,40368611,118415731,9,0,1,68608,10,256849134
3662,78065649,10613424,88679073,0,0,0,1536,6,465644642
3663,78067879,40350450,118418329,1,0,1,38912,23,8562825548
3664,78072470,40365777,118438247,7,0,1,39936,14,10472349646
3665,78074720,10714549,88789269,7,0,0,56832,14,8690804173
3666,78075799,10605192,88680991,0,0,0,6144,6,10500512767
3667,78080230,40385328,118465558,4,0,1,77824,9,7183377404
3668,78096641,40482893,118579534,2,0,1,40448,0,1214258944
3669,78098300,40481257,118579557,2,0,1,12800,0,5251831352
3670,78108590,40479304,118587894,9,0,1,77824,10,1324197516
3671,78116400,10946686,89063086,4,0,0,121856,9,6928377321
3672,78125700,40462217,118587917,6,0,1,6656,19,9353155340
3673,78144220,40544534,118688754,4,0,1,281600,9,6862098660
3674,78146519,40560625,118707144,1,0,1,29696,23,3049834837
3675,78175269,10583963,88759232,0,0,0,3072,6,963649202
3676,78181260,40541228,118722488,1,0,1,33280,23,10298337425
3677,78187881,40535371,118723252,2,0,1,10240,0,8094799753
3678,78191860,10917737,89109597,7,0,0,152576,14,9985619011
3679,78196760,10997473,89194233,4,0,0,118784,9,6801491875
3680,78209360,40579471,118788831,9,0,1,123904,10,1585520249
3681,78236600,40566849,118803449,1,0,1,26112,23,569758013
3682,78248461,11163163,89411624,2,0,0,107008,0,5922475613
3683,78257300,40580708,118838008,4,0,1,86528,9,1088313843
3684,78271400,40578038,118849438,7,0,1,13312,14,1384100597
3685,78291251,40563683,118854934,2,0,1,19968,0,7405299998
3686,78295139,40563021,118858160,1,0,1,5120,23,9085940625
3687,78300350,40568487,118868837,1,0,1,25088,23,1113538136
3688,78303900,40566243,118870143,6,0,1,2048,19,4961742660
3689,78304560,11074437,89378997,4,0,0,178176,9,4214519832
3690,78317491,40574540,118892031,2,0,1,31744,0,1799685914
3691,78319240,40588676,118907916,6,0,1,22016,19,3672887161
3692,78329120,40747590,119076710,4,0,1,301056,9,8853800112
3693,78349991,40731251,119081242,2,0,1,7168,0,7717129811
3694,78356070,40726158,119082228,1,0,1,1536,23,6280459868
3695,78368390,40998779,119367169,9,0,1,154112,10,6583997106
3696,78383980,40986095,119370075,1,0,1,4608,23,4683270225
3697,78390599,11183378,89573977,0,0,0,6144,6,1378175032
3698,78400220,41007975,119408195,6,0,1,11776,19,6234146598
3699,78477469,11299505,89776974,5,0,0,3584,1,6942545009
3700,78496161,40914300,119410461,2,0,1,3584,0,4830661390
3701,78503420,11439048,89942468,4,0,0,187904,9,2668338516
3702,78513660,40955236,119468896,4,0,1,67072,9,3087438516
3703,78546760,10962500,89509260,1,0,0,512,23,8366008322
3704,78551790,40997338,119549128,2,0,1,56320,0,7982744482
3705,78564699,11663299,90227998,5,0,0,100352,1,7064763225
3706,78570640,11522169,90092809,7,0,0,209408,14,8148726814
3707,78596410,11170886,89767296,2,0,0,46592,0,2776263626
3708,78604500,41124969,119729469,9,0,1,52736,10,1932965967
3709,78635190,41122246,119757436,1,0,1,3072,23,1373959838
3710,78650700,11095502,89746202,1,0,0,1024,23,8796836240
3711,78694920,41066062,119760982,1,0,1,5632,23,5827627645
3712,78701460,41070766,119772226,6,0,1,26112,19,2459344539
3713,78713560,41068912,119782472,7,0,1,6144,14,3915366131
3714,78736460,41046998,119783458,1,0,1,1536,23,5766933833
3715,78737229,11132980,89870209,0,0,0,512,6,8961768597
3716,78748180,41242183,119990363,4,0,1,314880,9,9134933832
3717,78767250,41231556,119998806,1,0,1,10240,23,9769934996
3718,78771590,11458863,90230453,1,0,0,7680,23,8644096150
3719,78787750,11828206,90615956,4,0,0,302080,9,6262119668
3720,78826340,41179279,120005619,7,0,1,12800,14,781544750
3721,78834620,11533867,90368487,4,0,0,37888,9,6506015554
3722,78861039,11519808,90380847,0,0,0,5120,6,7100648884
3723,78921040,41339530,120260570,9,0,1,224768,10,3106754244
3724,78922940,11600953,90523893,4,0,0,153600,9,596907048
3725,78925030,41415706,120340736,7,0,1,12288,14,7273684965
3726,78932890,41485954,120418844,4,0,1,56832,9,10197017434
3727,78934650,41486938,120421588,9,0,1,19968,10,10360297774
3728,78945730,41787489,120733219,9,0,1,169472,10,5584440737
3729,78952880,41780362,120733242,6,0,1,9728,19,7069765391
3730,78971629,11770626,90742255,5,0,0,142336,1,9054937493
3731,78983011,11932045,90915056,7,0,0,108032,14,2833535728
3732,78999840,41733425,120733265,7,0,1,13824,14,2237802827
3733,79014350,11602143,90616493,1,0,0,1536,23,3274100608
3734,79015360,41775996,120791356,3,0,1,23552,28,2116548614
3735,79025460,41765919,120791379,3,0,1,6144,28,7355198054
3736,79060540,41737801,120798341,3,0,1,7680,28,5137092521
3737,79065020,41743931,120808951,3,0,1,26112,28,4358852918
3738,79067460,11764319,90831779,2,0,0,236032,0,6263751550
3739,79084950,41759704,120844654,7,0,1,56320,14,523218199
3740,79089860,41923978,121013838,6,0,1,52224,19,5642308823
3741,79118510,41905661,121024171,1,0,1,9216,23,6100108458
3742,79132339,11749778,90882117,5,0,0,49664,1,7244498163
3743,79144120,12178194,91322314,4,0,0,184320,9,2270412424
3744,79153000,41872797,121025797,7,0,1,2560,14,1551782288
3745,79163150,41887939,121051089,3,0,1,18432,28,7517672542
3746,79175810,41879145,121054955,6,0,1,6144,19,3297388362
3747,79221080,11839800,91060880,7,0,0,95744,14,78686883
3748,79237480,41836310,121073790,3,0,1,15360,28,9693289514
3749,79253340,11670327,90923667,4,0,0,28160,9,1173719319
3750,79254060,11902439,91156499,4,0,0,151040,9,8441140502
3751,79288421,11869661,91158082,3,0,0,5120,28,5034705529
3752,79296760,11773503,91070263,2,0,0,30720,0,3810717899
3753,79342340,41761809,121104149,6,0,1,4096,19,4254838581
3754,79357160,12041045,91398205,4,0,0,11776,9,2185399960
3755,79361620,11576571,90938191,1,0,0,1024,23,6332382686
3756,79395900,41717720,121113620,4,0,1,22016,9,5620123346
3757,79404400,41722023,121126423,1,0,1,2048,23,1683964532
3758,79412070,11982524,91394594,7,0,0,131584,14,4881975167
3759,79414750,11851281,91266031,7,0,0,225792,14,6409489198
3760,79441930,41688359,121130289,3,0,1,6144,28,964761359
3761,79458910,41717232,121176142,3,0,1,46080,28,4589034773
3762,79478640,11690720,91169360,2,0,0,36352,0,2846045264
3763,79490409,11667852,91158261,5,0,0,512,1,750962491
3764,79490849,11908939,91399788,0,0,0,5120,6,6626544667
3765,79519560,41714801,121234361,4,0,1,79872,9,4781250386
3766,79523370,12039104,91562474,1,0,0,512,23,5406845999
3767,79554290,41721857,121276147,1,0,1,43008,23,2556631422
3768,79559150,41886075,121445225,1,0,1,52224,23,6678102381
3769,79584410,11755785,91340195,2,0,0,49152,0,1962974347
3770,79605690,41845353,121451043,4,0,1,39936,9,9202161149
3771,79616110,11706586,91322696,1,0,0,1024,23,4266060555
3772,79616560,12276144,91892704,2,0,0,104960,0,1295637863
3773,79635870,12025966,91661836,4,0,0,8704,9,8265233949
3774,79635960,41859940,121495900,4,0,1,181248,9,10661117689
3775,79645750,12413996,92059746,7,0,0,70144,14,733806116
3776,79658790,41891307,121550097,4,0,1,82432,9,3422984211
3777,79743410,11906369,91649779,2,0,0,22016,0,4460730979
3778,79779710,41779937,121559647,3,0,1,3584,28,4552040566
3779,79786700,41810746,121597446,3,0,1,4096,28,1662363087
3780,79792620,41804980,121597600,6,0,1,8704,19,8077064244
3781,79820510,11741762,91562272,7,0,0,82432,14,9322914497
3782,79831690,41781906,121613596,3,0,1,31232,28,1699898157
3783,79861390,41753512,121614902,3,0,1,2048,28,7257906867
3784,79880060,12075160,91955220,7,0,0,60928,14,330027964
3785,79894400,41721270,121615670,3,0,1,11776,28,1517988
3786,79928940,12217174,92146114,7,0,0,1536,14,2138354942
3787,79943010,41696716,121639726,1,0,1,7680,23,10512822969
3788,79952620,11578293,91530913,2,0,0,1024,0,6137448302
3789,79952790,12408413,92361203,4,0,0,249856,9,2967211699
3790,79974941,11885760,91860701,7,0,0,38912,14,10000441417
3791,79998320,41663151,121661471,1,0,1,52736,23,8369769268
3792,80030280,41873672,121903952,4,0,1,190464,9,2505397775
3793,80048729,12591163,92639892,5,0,0,544256,1,10286185744
3794,80061020,12220804,92281824,2,0,0,69632,0,5788488485
3795,80073030,41830945,121903975,4,0,1,27136,9,1673398639
3796,80078079,41825919,121903998,1,0,1,16384,23,9983936034
3797,80082221,12616443,92698664,7,0,0,177664,14,8012876160
3798,80141559,12073641,92215200,5,0,0,12288,1,397208711
3799,80176240,41730887,121907127,1,0,1,15360,23,5880789067
3800,80179619,41732334,121911953,1,0,1,7680,23,1434318281
3801,80197350,41948803,122146153,4,0,1,223232,9,8912841232
3802,80209670,12632041,92841711,4,0,0,199168,9,10416185056
3803,80210290,41935894,122146184,6,0,1,3584,19,6377118950
3804,80211751,12247736,92459487,7,0,0,190976,14,3237676923
3805,80231370,41914837,122146207,6,0,1,10752,19,5482307446
3806,80233510,12717696,92951206,4,0,0,95232,9,5837864708
3807,80234630,41911600,122146230,1,0,1,1536,23,7831470137
3808,80269991,12652152,92922143,7,0,0,259584,14,3572760742
3809,80297290,12443492,92740782,4,0,0,55296,9,291790148
3810,80361441,12686614,93048055,7,0,0,11776,14,428081528
3811,80457250,41802500,122259750,4,0,1,142848,9,9937385123
3812,80529850,41780847,122310697,1,0,1,25088,23,351631381
3813,80550659,12093827,92644486,0,0,0,14848,6,3965530510
3814,80552809,12663530,93216339,0,0,0,1024,6,565675419
3815,80553280,41801313,122354593,4,0,1,90624,9,3394944886
3816,80556870,11917148,92474018,2,0,0,47616,0,4590730996
3817,80571580,13026046,93597626,2,0,0,95232,0,564038882
3818,80573529,12878569,93452098,5,0,0,338944,1,8199400579
3819,80614179,12084664,92698843,0,0,0,512,6,2298564673
3820,80614399,41749754,122364153,1,0,1,29184,23,4724229857
3821,80617900,41822178,122440078,4,0,1,126464,9,7657078053
3822,80631250,42349267,122980517,4,0,1,780800,9,3841503786
3823,80637910,42384656,123022566,4,0,1,82944,9,779385221
3824,80638120,12204862,92842982,1,0,0,4096,23,8584679598
3825,80655599,12088170,92743769,0,0,0,9728,6,2025188596
3826,80672610,12615472,93288082,4,0,0,54784,9,4895423452
3827,80673910,42400409,123074319,4,0,1,138752,9,448849695
3828,80778529,13107124,93885653,5,0,0,442880,1,1259273657
3829,80797571,42279719,123077290,2,0,1,30720,0,2269618688
3830,80887950,42204830,123092780,2,0,1,7168,0,2504386475
3831,80951830,13037834,93989664,4,0,0,124928,9,8604859903
3832,81070271,42026375,123096646,2,0,1,6144,0,705104865
3833,81076131,12094423,93170554,7,0,0,18944,14,904637733
3834,81083281,13211593,94294874,7,0,0,130560,14,8593704473
3835,81107110,12223390,93330500,1,0,0,1536,23,10365612872
3836,81121700,41981564,123103264,8,0,1,23552,12,3055580238
3837,81148960,13078323,94227283,2,0,0,475648,0,9203385257
3838,81184790,12548110,93732900,1,0,0,2560,23,4053017496
3839,81215409,11799837,93015246,0,0,0,1024,6,3519535309
3840,81221181,12396989,93618170,7,0,0,2560,14,8972543967
3841,81221371,41885439,123106810,2,0,1,5632,0,10151962817
3842,81250810,41856666,123107476,8,0,1,1024,12,8660339620
3843,81263190,41844850,123108040,8,0,1,10752,12,327742301
3844,81281620,41827086,123108706,8,0,1,1024,12,10282704349
3845,81284520,11839275,93123795,1,0,0,3584,23,3377669382
3846,81306000,41836933,123142933,8,0,1,46592,12,6957958258
3847,81389920,11703928,93093848,1,0,0,1536,23,7162963777
3848,81427510,41760136,123187646,4,0,1,131584,9,3238366943
3849,81429000,12222317,93651317,1,0,0,2048,23,2802464042
3850,81478120,41717719,123195839,2,0,1,29696,0,7135901356
3851,81494150,12104911,93599061,1,0,0,4608,23,7198955571
3852,81496550,12798526,94295076,1,0,0,512,23,6283897107
3853,81510530,12427296,93937826,2,0,0,78848,0,2941493747
3854,81518701,12032313,93551014,7,0,0,43520,14,4807126652
3855,81539590,41693372,123232962,9,0,1,74240,10,3837324627
3856,81557751,12356028,93913779,7,0,0,91648,14,9500801017
3857,81575211,11993376,93568587,7,0,0,56320,14,6763082193
3858,81618931,11986705,93605636,7,0,0,21504,14,4158953032
3859,81623170,12328407,93951577,2,0,0,45056,0,2094720468
3860,81634181,11983186,93617367,7,0,0,28672,14,6895988205
3861,81635540,41630575,123266115,4,0,1,62464,9,6351723032
3862,81639370,12005335,93644705,2,0,0,512,0,8963932975
3863,81709179,11964556,93673735,0,0,0,1024,6,4227844181
3864,81720790,41651892,123372682,4,0,1,206336,9,8814975535
3865,81733040,41727076,123460116,4,0,1,98816,9,5190189153
3866,81733430,12152402,93885832,2,0,0,512,0,1549090776
3867,81778480,12452396,94230876,2,0,0,4608,0,5842903429
3868,81793799,12632199,94425998,5,0,0,170496,1,9505346061
3869,81825741,12529390,94355131,7,0,0,115712,14,7765844832
3870,81845039,12892871,94737910,5,0,0,87040,1,6952401033
3871,81847430,12747246,94594676,4,0,0,168448,9,5346679632
3872,81912500,41559674,123472174,8,0,1,16384,12,3762419537
3873,81936069,13034067,94970136,5,0,0,245760,1,3975255630
3874,81946300,12283149,94229449,4,0,0,6656,9,699830511
3875,81953340,41529568,123482908,5,0,1,27648,1,1859112716
3876,81986470,41512523,123498993,8,0,1,28672,12,7983420636
3877,82011830,41550170,123562000,8,0,1,41472,12,8099025423
3878,82029230,41532793,123562023,8,0,1,7680,12,1699432777
3879,82041471,12591338,94632809,7,0,0,83968,14,10565346722
3880,82065449,12645910,94711359,5,0,0,152064,1,10667028314
3881,82084979,12906708,94991687,5,0,0,70656,1,5712272100
3882,82088669,12337664,94426333,0,0,0,1024,6,2537342416
3883,82146921,41421989,123568910,2,0,1,14336,0,8362836564
3884,82148691,41426088,123574779,2,0,1,4096,0,5126371816
3885,82176860,12178606,94355466,1,0,0,1024,23,7052593618
3886,82191450,12049501,94240951,1,0,0,2560,23,9716912818
3887,82224410,41357034,123581444,8,0,1,10240,12,148214293
3888,82279701,41304329,123584030,2,0,1,4096,0,8114142848
3889,82327510,12306102,94633612,1,0,0,2560,23,7029659609
3890,82346111,12261091,94607202,7,0,0,40448,14,6257153198
3891,82371229,12271485,94642714,5,0,0,29696,1,8159857613
3892,82406770,12095734,94502504,4,0,0,35840,9,1083109744
3893,82457009,11969815,94426824,0,0,0,1536,6,2722532410
3894,82466531,41124886,123591417,2,0,1,25088,0,1238749937
3895,82467519,12277289,94744808,0,0,0,512,6,7618933868
3896,82484600,12110255,94594855,2,0,0,512,0,6605407769
3897,82523531,12519152,95042683,7,0,0,33280,14,4730952496
3898,82524330,12588523,95112853,4,0,0,20480,9,3951619625
3899,82538981,41063874,123602855,2,0,1,38400,0,7251657514
3900,82562251,12670487,95232738,7,0,0,390656,14,6441782362
3901,82565129,12760862,95325991,5,0,0,164352,1,7238159291
3902,82582790,41036939,123619729,4,0,1,4096,9,1643220536
3903,82633870,40990506,123624376,4,0,1,16896,9,4002374481
3904,82635140,40992540,123627680,5,0,1,4096,1,3080327235
3905,82654500,41031985,123686485,9,0,1,128512,10,4302020123
3906,82671101,41017650,123688751,2,0,1,3584,0,1685743064
3907,82757290,40933407,123690697,4,0,1,3072,9,2822906611
3908,82765840,41409828,124175668,4,0,1,414208,9,6609005309
3909,82769350,41462075,124231425,4,0,1,97280,9,3796107261
3910,82788530,41477771,124266301,8,0,1,13312,12,1843256692
3911,82791519,12289855,95081374,5,0,0,38400,1,10003414922
3912,82812440,41462694,124275134,5,0,1,22528,1,10458405146
3913,82812670,41499304,124311974,4,0,1,49664,9,5577802835
3914,82824159,12274109,95098268,0,0,0,2048,6,2850460837
3915,82858600,41744341,124602941,4,0,1,126976,9,6870392317
3916,82917690,12195342,95113032,2,0,0,512,0,10259355353
3917,82929611,12078323,95007934,7,0,0,53248,14,6979865217
3918,82949450,12148171,95097621,4,0,0,53248,9,2459833540
3919,83012390,41590574,124602964,4,0,1,1536,9,7024517323
3920,83037750,41565237,124602987,4,0,1,10240,9,7485306529
3921,83038740,12417889,95456629,4,0,0,173568,9,2669550968
3922,83068539,12286990,95355529,0,0,0,3072,6,6854431530
3923,83074129,12594250,95668379,5,0,0,149504,1,2260117378
3924,83081970,11927079,95009049,4,0,0,3584,9,9718085156
3925,83095570,41507440,124603010,8,0,1,1024,12,9034011722
3926,83157301,12667245,95824546,7,0,0,101888,14,5509361052
3927,83165021,12562060,95727081,7,0,0,192512,14,5965819790
3928,83179000,12280483,95459483,2,0,0,8192,0,3215668003
3929,83236809,12220155,95456964,0,0,0,1024,6,3301236411
3930,83277781,12891358,96169139,7,0,0,632832,14,6556798647
3931,83317290,12012380,95329670,1,0,0,3072,23,1558025107
3932,83335850,12175147,95510997,2,0,0,1024,0,10273559432
3933,83343979,12587450,95931429,0,0,0,2048,6,4904291223
3934,83348189,12173132,95521321,0,0,0,512,6,3847643944
3935,83377029,12851794,96228823,5,0,0,143872,1,9924694963
3936,83383960,12228427,95612387,2,0,0,1024,0,4617984182
3937,83390349,12223490,95613839,0,0,0,512,6,6178290440
3938,83391370,12352298,95743668,6,0,0,5120,19,1223328780
3939,83392820,12776833,96169653,4,0,0,1024,9,4751244219
3940,83393229,12531007,95924236,5,0,0,107008,1,6453574742
3941,83442800,12726518,96169318,4,0,0,512,9,6455574779
3942,83587189,12711747,96298936,5,0,0,219136,1,5239726811
3943,83621570,12106158,95727728,2,0,0,2048,0,1695422701
3944,83625609,12722168,96347777,5,0,0,138240,1,7495324690
3945,83626359,12108427,95734786,0,0,0,6144,6,6662147471
3946,83674470,12070504,95744974,1,0,0,2048,23,9633838774
3947,83689950,12739481,96429431,4,0,0,1536,9,6549734920
3948,83725910,12051242,95777152,2,0,0,512,0,1253054065
3949,83726520,40908539,124635059,5,0,1,57856,1,4041466957
3950,83730961,12454003,96184964,7,0,0,50176,14,5089883280
3951,83744780,12079968,95824748,4,0,0,512,9,1632564327
3952,83845120,12079763,95924883,1,0,0,2048,23,5511732928
3953,83846739,12385071,96231810,5,0,0,9728,1,10213733919
3954,83850270,12583900,96434170,2,0,0,512,0,3702295769
3955,83896929,12407958,96304887,5,0,0,19456,1,10247276315
3956,83911430,12320715,96232145,2,0,0,1024,0,1252899056
3957,83926721,12707039,96633760,7,0,0,154112,14,7873315022
3958,83994129,12527690,96521819,5,0,0,186880,1,5518747224
3959,84010891,12936336,96947227,7,0,0,387072,14,7812390913
3960,84112040,40523042,124635082,5,0,1,10240,1,7467910802
3961,84121810,12183793,96305603,4,0,0,512,9,10054612165
3962,84137259,12825903,96963162,5,0,0,52224,1,5697550751
3963,84174250,40472578,124646828,0,0,1,42496,6,10690345317
3964,84202540,40444343,124646883,5,0,1,16896,1,6011085827
3965,84219589,12130411,96350000,5,0,0,7168,1,6710284098
3966,84261460,12555178,96816638,2,0,0,177152,0,2399775077
3967,84286400,12801126,97087526,2,0,0,116224,0,8747244813
3968,84307929,11997449,96305378,0,0,0,1536,6,3154668643
3969,84308731,12233085,96541816,7,0,0,3584,14,3116341996
3970,84402129,12984695,97386824,5,0,0,494080,1,2842558548
3971,84405810,40241096,124646906,5,0,1,4096,1,2224732566
3972,84415140,40233824,124648964,5,0,1,3584,1,6580691803
3973,84418530,12280667,96699197,1,0,0,2560,23,6458638006
3974,84419169,12749758,97168927,5,0,0,23552,1,6411515320
3975,84473200,12763061,97236261,2,0,0,42496,0,1394024811
3976,84560759,12085978,96646737,5,0,0,6144,1,8956675957
3977,84600230,12823791,97424021,2,0,0,55296,0,1750868375
3978,84609091,40042779,124651870,2,0,1,4608,0,3626358322
3979,84649700,12774664,97424364,4,0,0,1024,9,3256825515
3980,84664919,11975287,96640206,0,0,0,512,6,1813330100
3981,84692269,11944028,96636297,0,0,0,7168,6,3778715500
3982,84701190,12001366,96702556,4,0,0,3072,9,1485194967
3983,84715040,12101777,96816817,4,0,0,512,9,10268454758
3984,84732490,39927081,124659571,5,0,1,12288,1,2416031308
3985,84743431,12236602,96980033,7,0,0,55296,14,10652711361
3986,84756290,39924123,124680413,5,0,1,9216,1,7459826733
3987,84757580,12831617,97589197,1,0,0,512,23,1331032459
3988,84779680,39914491,124694171,5,0,1,18432,1,3955036062
3989,84829050,39866747,124695797,5,0,1,2560,1,4019338711
3990,84841211,12993426,97834637,7,0,0,114176,14,5864442906
3991,84910309,13007169,97917478,5,0,0,180224,1,880844724
3992,84922021,39776362,124698383,2,0,1,4096,0,7576924497
3993,84933769,12843726,97777495,5,0,0,563200,1,6129821101
3994,84938810,12503357,97442167,4,0,0,5632,9,9955253467
3995,84942821,39761463,124704284,2,0,1,19968,0,1516559159
3996,84956419,12964528,97920947,0,0,0,5632,6,6072768988
3997,84995780,13060059,98055839,2,0,0,157696,0,7238561233
3998,85081280,11899400,96980680,4,0,0,2048,9,4320391706
3999,85099330,39610100,124709430,5,0,1,8192,1,4113272675
4000,85106591,39608690,124715281,2,0,1,27648,0,2792371290
4001,85121481,12284398,97405879,7,0,0,62464,14,3825452034
4002,85123991,12373652,97497643,7,0,0,76800,14,9529828838
4003,85232771,12606037,97838808,7,0,0,6144,14,5729090272
4004,85253790,39466023,124719813,5,0,1,11776,1,3824634210
4005,85325039,12850027,98175066,5,0,0,178688,1,6990794434
4006,85339419,12164643,97504062,5,0,0,20992,1,3161599745
4007,85348960,12121576,97470536,2,0,0,9728,0,2765473329
4008,85386410,39366809,124753219,5,0,1,24064,1,2475275214
4009,85558979,12538354,98097333,0,0,0,4608,6,10515783669
4010,85655801,11942465,97598266,7,0,0,23040,14,4308733614
4011,85656840,39103484,124760324,5,0,1,21504,1,4113970360
4012,85705071,39062665,124767736,2,0,1,11776,0,7109161582
4013,85734870,39042286,124777156,5,0,1,7680,1,2717904850
4014,85745720,39032102,124777822,0,0,1,1024,6,9712551139
4015,85799780,12420100,98219880,2,0,0,97792,0,338359090
4016,85829389,11970437,97799826,5,0,0,73216,1,952514025
4017,85836440,38945248,124781688,5,0,1,6144,1,8879716257
4018,85881410,11525740,97407150,1,0,0,4096,23,6720922500
4019,85917940,38864721,124782661,5,0,1,12800,1,4368898787
4020,85931330,11903486,97834816,4,0,0,512,9,10254020187
4021,85976251,11886292,97862543,7,0,0,77824,14,6847030070
4022,85990470,38819969,124810439,5,0,1,12800,1,2379933141
4023,86058170,38770530,124828700,2,0,1,34816,0,1245081463
4024,86059820,38990521,125050341,2,0,1,45056,0,2319014732
4025,86066160,38984204,125050364,2,0,1,10240,0,8667346340
4026,86133850,39003794,125137644,5,0,1,4096,1,8617638455
4027,86139590,11697323,97836913,1,0,0,1536,23,5694167301
4028,86179480,11656942,97836422,4,0,0,4096,9,8623260471
4029,86206090,38937046,125143136,1,0,1,17920,23,4595419416
4030,86279410,11555741,97835151,1,0,0,1024,23,10543981728
4031,86281220,11637934,97919154,4,0,0,5120,9,7176084313
4032,86322239,11599534,97921773,0,0,0,2560,6,8266735740
4033,86326610,38835506,125162116,4,0,1,3584,9,1721241639
4034,86404629,11576159,97980788,0,0,0,2048,6,9089325395
4035,86442410,11744538,98186948,1,0,0,7168,23,10716445304
4036,86492880,38751514,125244394,5,0,1,55296,1,6584734733
4037,86533300,38850845,125384145,2,0,1,11264,0,3306066926
4038,86544710,11527112,98071822,1,0,0,5632,23,10590103978
4039,86549909,11506178,98056087,0,0,0,512,6,2995006166
4040,86578570,38805598,125384168,4,0,1,5632,9,5640345386
4041,86650391,11731268,98381659,7,0,0,142336,14,6168853365
4042,86677950,38706241,125384191,5,0,1,512,1,4230608343
4043,86679870,11638884,98318754,1,0,0,512,23,6310993978
4044,86689710,11807585,98497295,2,0,0,73216,0,4754223053
4045,86716880,11758084,98474964,2,0,0,97792,0,1551517504
4046,86747170,11769078,98516248,1,0,0,6144,23,2467474639
4047,86759219,11556469,98315688,5,0,0,89600,1,5321237632
4048,86785060,38599154,125384214,4,0,1,3072,9,6979993151
4049,86827950,11348566,98176516,4,0,0,4608,9,7333224838
4050,86839330,11342842,98182172,1,0,0,1024,23,8278928388
4051,86857650,11252300,98109950,1,0,0,2048,23,9650108424
4052,86874950,11639380,98514330,2,0,0,55808,0,3516226619
4053,86876790,11344525,98221315,1,0,0,4608,23,4126036574
4054,86892571,11492387,98384958,7,0,0,10752,14,875892635
4055,86908580,38475657,125384237,5,0,1,1024,1,10544923204
4056,86931770,11618674,98550444,2,0,0,2560,0,1506773248
4057,86948580,11465983,98414563,2,0,0,3584,0,7494293287
4058,86977250,38407018,125384268,4,0,1,25600,9,198298884
4059,87001919,11558035,98559954,0,0,0,2560,6,3924207320
4060,87002700,38408648,125411348,5,0,1,12288,1,1970737463
4061,87066560,38473918,125540478,4,0,1,11776,9,4559863432
4062,87067400,38473101,125540501,4,0,1,1024,9,745473655
4063,87079590,38460934,125540524,2,0,1,512,0,10523641623
4064,87093770,38516496,125610266,2,0,1,54272,0,10467205076
4065,87108640,11612984,98721624,2,0,0,4608,0,9461541333
4066,87145821,11552527,98698348,7,0,0,46080,14,8518039745
4067,87163640,38448572,125612212,8,0,1,3072,12,5658138551
4068,87204740,38428802,125633542,5,0,1,46080,1,5698805232
4069,87235410,38413508,125648918,8,0,1,6656,12,9292910529
4070,87235800,38414398,125650198,2,0,1,14336,0,7719173340
4071,87254180,38562912,125817092,2,0,1,69120,0,1032136670
4072,87282541,11562441,98844982,7,0,0,167424,14,8379442804
4073,87358049,11050949,98408998,0,0,0,3072,6,8917547157
4074,87368579,11151871,98520450,0,0,0,1024,6,195880212
4075,87372360,38478034,125850394,4,0,1,14848,9,8148329942
4076,87380089,11411285,98791374,0,0,0,512,6,4177765331
4077,87418389,11256762,98675151,0,0,0,512,6,8062261143
4078,87436710,11174854,98611564,1,0,0,512,23,8431857895
4079,87469951,11408195,98878146,7,0,0,103936,14,10323214730
4080,87478360,11193875,98672235,1,0,0,1024,23,7086904458
4081,87531410,38362948,125894358,5,0,1,9728,1,10554969547
4082,87567861,11278571,98846432,7,0,0,4608,14,3764317328
4083,87633410,38262254,125895664,4,0,1,2048,9,1732534337
4084,87654460,38244110,125898570,5,0,1,4608,1,4403361989
4085,87721070,11157411,98878481,4,0,0,1024,9,9012481218
4086,87738570,38237234,125975804,5,0,1,19968,1,7058916740
4087,87739630,11139038,98878668,1,0,0,512,23,1220207020
4088,87779540,10929998,98709538,4,0,0,1024,9,7494395154
4089,87802440,38246361,126048801,8,0,1,65024,12,677543929
4090,87805870,38243319,126049189,5,0,1,5120,1,5775694769
4091,87811830,10923094,98734924,1,0,0,2560,23,1002990688
4092,87815210,38237845,126053055,8,0,1,6144,12,1641910000
4093,87818511,11066732,98885243,7,0,0,21504,14,9434579979
4094,87818579,11224096,99042675,0,0,0,4096,6,8698326957
4095,87834410,11280908,99115318,2,0,0,512,0,8476778321
4096,87836010,38278832,126114842,8,0,1,34304,12,815086856
4097,87875290,38293054,126168344,4,0,1,52224,9,9512497315
4098,87904080,38271996,126176076,5,0,1,12288,1,5604393910
4099,87910730,11298710,99209440,1,0,0,512,23,9875519050
4100,87912679,11297564,99210243,0,0,0,2560,6,5413079440
4101,87932720,38281341,126214061,7,0,1,44544,14,7576541902
4102,87997400,11009665,99007065,1,0,0,5632,23,8187522344
4103,87997830,38222003,126219833,8,0,1,23040,12,2813581955
4104,88039350,11074923,99114273,2,0,0,1024,0,8492779429
4105,88072279,11136483,99208762,5,0,0,153600,1,253367600
4106,88093519,11115734,99209253,0,0,0,1536,6,4894054649
4107,88140539,11329109,99469648,5,0,0,149504,1,3450097455
4108,88196600,38161723,126358323,4,0,1,31744,9,10583879199
4109,88256340,38249816,126506156,5,0,1,420864,1,7168910520
4110,88261450,11158851,99420301,2,0,0,2560,0,6704511503
4111,88277430,11118495,99395925,4,0,0,4608,9,1846810509
4112,88283000,38257985,126540985,1,0,1,17920,23,7361321953
4113,88288359,11628773,99917132,5,0,0,366592,1,5114006136
4114,88304021,11617016,99921037,7,0,0,10752,14,2414379767
4115,88337320,38382197,126719517,5,0,1,283648,1,935681276
4116,88347609,11214265,99561874,5,0,0,57856,1,7294965157
4117,88370030,38379111,126749141,5,0,1,92672,1,459650962
4118,88387521,11568639,99956160,7,0,0,115200,14,5842075093
4119,88394119,11390767,99784886,0,0,0,6144,6,433290202
4120,88402110,11274908,99677018,2,0,0,1024,0,10137787230
4121,88407620,38341675,126749295,2,0,1,8704,0,6323850569
4122,88413579,11566784,99980363,5,0,0,79360,1,254819074
4123,88428249,11555569,99983818,5,0,0,11264,1,278817671
4124,88456900,11331867,99788767,1,0,0,4608,23,10346773066
4125,88474340,11443329,99917669,1,0,0,512,23,6566436537
4126,88483670,11502471,99986141,4,0,0,2048,9,911008276
4127,88491511,11569748,100061259,7,0,0,162304,14,423856027
4128,88504250,11249706,99753956,4,0,0,1536,9,8897767619
4129,88536970,11728815,100265785,4,0,0,1024,9,6804131534
4130,88538669,11111177,99649846,0,0,0,1536,6,1542278895
4131,88588310,38186691,126775001,4,0,1,23040,9,4259519474
4132,88610230,38303497,126913727,5,0,1,72704,1,2162442473
4133,88637680,38421651,127059331,5,0,1,330240,1,5033479422
4134,88656660,11351195,100007855,2,0,0,1024,0,6213658331
4135,88682309,11235158,99917467,0,0,0,1024,6,3359105044
4136,88715270,38344420,127059690,1,0,1,9728,23,7968231542
4137,88733979,38335240,127069219,1,0,1,22528,23,9782494171
4138,88768989,38301536,127070525,1,0,1,2048,23,6479824985
4139,88783090,38288101,127071191,1,0,1,1024,23,1842762262
4140,88802200,11183247,99985447,4,0,0,1024,9,10585346888
4141,88802770,11182342,99985112,1,0,0,4096,23,3082639754
4142,88809291,11403250,100212541,7,0,0,6144,14,1541873771
4143,88812230,38262507,127074737,1,0,1,5632,23,7524355567
4144,88813331,11628403,100441734,7,0,0,311296,14,4906970190
4145,88821950,38253658,127075608,0,0,1,12288,6,2359158002
4146,88860030,38220430,127080460,0,0,1,7680,6,6505516474
4147,88884251,11462612,100346863,7,0,0,48128,14,6963636351
4148,88890001,11438833,100328834,7,0,0,13312,14,4904706861
4149,88921801,11641535,100563336,7,0,0,99840,14,2075562030
4150,88943139,11203678,100146817,0,0,0,4608,6,9498422753
4151,88956040,38125086,127081126,7,0,1,11264,14,6598266608
4152,88956880,11485345,100442225,4,0,0,1536,9,4540616348
4153,89042820,11400543,100443363,1,0,0,2048,23,8899639857
4154,89100240,38008219,127108459,5,0,1,35840,1,9587150082
4155,89213430,37902320,127115750,7,0,1,10752,14,9176056767
4156,89213840,37909387,127123227,7,0,1,4608,14,4547723030
4157,89253861,11023531,100277392,2,0,0,5120,0,7060165220
4158,89284240,37839448,127123688,7,0,1,10240,14,5377865970
4159,89355269,11221520,100576789,0,0,0,5632,6,9473296992
4160,89424889,37699145,127124034,1,0,1,512,23,6136380756
4161,89470840,37694455,127165295,5,0,1,89600,1,9329647699
4162,89492839,10949877,100442716,0,0,0,1536,6,4442076987
4163,89500070,10755590,100255660,1,0,0,512,23,9079543592
4164,89513130,37703128,127216258,5,0,1,90112,1,9306393405
4165,89529470,37879496,127408966,5,0,1,278528,1,10604040039
4166,89598450,37906516,127504966,5,0,1,81408,1,3057386271
4167,89634670,10809808,100444478,4,0,0,3584,9,9838357913
4168,89637350,37884436,127521786,7,0,1,5632,14,6613391507
4169,89638490,37929843,127568333,5,0,1,98816,1,3205075758
4170,89714640,37884383,127599023,5,0,1,15872,1,2873637137
4171,89717100,10729631,100446731,4,0,0,7168,9,9184028686
4172,89719169,11171186,100890355,0,0,0,4096,6,6667112226
4173,89729231,11156907,100886138,7,0,0,110080,14,3944645783
4174,89774380,37845832,127620212,5,0,1,18944,1,1999728800
4175,89833660,37787858,127621518,1,0,1,2048,23,7029295667
4176,89838160,37785510,127623670,1,0,1,26624,23,7538575486
4177,89849210,10807788,100656998,1,0,0,512,23,9332062479
4178,89853750,37770906,127624656,1,0,1,1536,23,691537880
4179,89882900,11003573,100886473,4,0,0,1024,9,394719031
4180,89884799,10860573,100745372,5,0,0,37376,1,3581756898
4181,89900100,10663640,100563740,2,0,0,1024,0,6603273186
4182,89910490,37714512,127625002,1,0,1,512,23,2826661130
4183,89950439,11336295,101286734,5,0,0,358912,1,10624808155
4184,89971870,37655718,127627588,1,0,1,4096,23,3361494979
4185,89976150,37654344,127630494,1,0,1,4608,23,9262479745
4186,90042159,10569450,100611609,0,0,0,3072,6,1958485794
4187,90083060,11834155,101917215,4,0,0,4096,9,8071455383
4188,90083600,10805438,100889038,2,0,0,8192,0,1441807617
4189,90088779,10748972,100837751,5,0,0,7680,1,3287460694
4190,90112910,10831272,100944182,2,0,0,8192,0,4220683528
4191,90192410,37440030,127632440,3,0,1,3072,28,721506334
4192,90228789,11414585,101643374,5,0,0,269824,1,1441622286
4193,90235270,37638919,127874189,5,0,1,134656,1,7117652733
4194,90287280,37633600,127920880,5,0,1,54272,1,2055459780
4195,90308630,37657875,127966505,5,0,1,77312,1,9443195695
4196,90309690,10777241,101086931,1,0,0,1536,23,6472457032
4197,90311190,11042805,101353995,2,0,0,39424,0,6983463171
4198,90318650,37666996,127985646,5,0,1,51712,1,1340390400
4199,90373780,11057620,101431400,2,0,0,116736,0,8781200511
4200,90424139,11026807,101450946,5,0,0,62464,1,1406870877
4201,90424761,37612497,128037258,9,0,1,24576,10,9669121682
4202,90522600,11393344,101915944,2,0,0,177152,0,1312373367
4203,90567400,11294545,101861945,2,0,0,418816,0,2580826643
4204,90568490,37473662,128042152,3,0,1,16384,28,7555379202
4205,90588060,11098360,101686420,4,0,0,512,9,184655856
4206,90589550,11096599,101686149,2,0,0,140288,0,5727372514
4207,90598840,37677488,128276328,5,0,1,280576,1,543324325
4208,90608839,11363490,101972329,5,0,0,147456,1,6611503680
4209,90616130,37796822,128412952,5,0,1,295936,1,4606287468
4210,90623211,38178419,128801630,9,0,1,336896,10,1330264924
4211,90663200,38138453,128801653,1,0,1,2048,23,6231179183
4212,90708920,38116099,128825019,5,0,1,88576,1,3463436801
4213,90762020,38152766,128914786,5,0,1,209920,1,2793821296
4214,90787930,38153305,128941235,2,0,1,42496,0,6207416623
4215,90841441,11085937,101927378,7,0,0,33280,14,3811962580
4216,90905490,11190834,102096324,2,0,0,83456,0,4144563279
4217,90908740,38042506,128951246,4,0,1,24064,9,10729087340
4218,90910219,11158252,102068471,5,0,0,149504,1,10189165320
4219,90922709,10772133,101694842,0,0,0,4608,6,4444827029
4220,90937700,11085196,102022896,2,0,0,165888,0,7406171926
4221,90958020,37998513,128956533,5,0,1,16896,1,7843118285
4222,90965120,38082768,129047888,5,0,1,184832,1,1500426389
4223,90965230,10594321,101559551,1,0,0,3584,23,7461084311
4224,90988830,10443061,101431891,1,0,0,1536,23,4539689709
4225,91020311,38031098,129051409,9,0,1,1024,10,8392439987
4226,91021950,38030125,129052075,3,0,1,1024,28,2588117318
4227,91025760,38031141,129056901,3,0,1,7680,28,10475034372
4228,91086449,10407979,101494428,0,0,0,7168,6,9176286402
4229,91094581,10975317,102069898,7,0,0,4608,14,3333407416
4230,91120360,11103677,102224037,2,0,0,190464,0,1454371226
4231,91155160,10980412,102135572,1,0,0,4608,23,6595688861
4232,91159509,10974636,102134145,5,0,0,117248,1,5704717873
4233,91249010,37808557,129057567,3,0,1,1024,28,9827693401
4234,91250360,37811304,129061664,3,0,1,17408,28,211260680
4235,91343540,37757992,129101532,7,0,1,48640,14,8236044928
4236,91374199,10885626,102259825,0,0,0,1024,6,7518263778
4237,91402259,10695024,102097283,5,0,0,3072,1,4507442209
4238,91413870,10816274,102230144,2,0,0,19968,0,3072377796
4239,91415340,10750642,102165982,4,0,0,4096,9,1796410106
4240,91475030,37627488,129102518,3,0,1,1536,28,1008423494
4241,91482231,10616167,102098398,7,0,0,3584,14,1831120199
4242,91485979,10677921,102163900,5,0,0,79872,1,9956185951
4243,91520220,37589320,129109540,3,0,1,10240,28,1216834068
4244,91562231,10508626,102070857,7,0,0,3072,14,4028026381
4245,91563919,10572011,102135930,0,0,0,512,6,9193585553
4246,91578450,37532076,129110526,3,0,1,1536,28,749131622
4247,91600600,10538941,102139541,4,0,0,11776,9,8141698901
4248,91614020,10521731,102135751,1,0,0,512,23,208112569
4249,91629849,10610044,102239893,5,0,0,29696,1,4828662425
4250,91647110,37468806,129115916,3,0,1,18432,28,1971294641
4251,91647550,37483212,129130762,3,0,1,4096,28,4488101113
4252,91686291,10478412,102164703,7,0,0,2560,14,6392423741
4253,91752600,10506890,102259490,2,0,0,19456,0,2448930463
4254,91789730,10441092,102230822,1,0,0,1024,23,3087615571
4255,91818630,10564207,102382837,4,0,0,1024,9,4135561393
4256,91844111,10399323,102243434,7,0,0,2048,14,9264012245
4257,91851700,10505513,102357213,1,0,0,7168,23,4684739185
4258,91883910,11138779,103022689,2,0,0,160256,0,5918006233
4259,91899300,37271819,129171119,5,0,1,72704,1,3338530434
4260,91901429,10329058,102230487,0,0,0,1024,6,4464294200
4261,92009670,10566505,102576175,2,0,0,33280,0,3889126045
4262,92054849,11139717,103194566,5,0,0,180736,1,4069994328
4263,92056830,10465687,102522517,1,0,0,4096,23,9077548882
4264,92070559,10301104,102371663,0,0,0,4608,6,2161192959
4265,92083529,10760031,102843560,5,0,0,65536,1,8266427677
4266,92125750,10405872,102531622,4,0,0,4096,9,4278637877
4267,92136230,10837608,102973838,2,0,0,260096,0,7102487599
4268,92152271,37022104,129174375,9,0,1,10752,10,4782026540
4269,92157730,10289615,102447345,1,0,0,3072,23,9725875329
4270,92200939,10842076,103043015,5,0,0,66560,1,10192653394
4271,92208140,10993999,103202139,1,0,0,512,23,7519587478
4272,92245630,10112913,102358543,4,0,0,3072,9,5539708313
4273,92261341,10171607,102432948,7,0,0,1536,14,2072851562
4274,92351939,10124816,102476755,0,0,0,3072,6,9839861732
4275,92366881,10491701,102858582,7,0,0,3584,14,7716415691
4276,92375680,10090056,102465736,4,0,0,6144,9,449420236
4277,92418301,10123105,102541406,7,0,0,3584,14,109563890
4278,92429539,10682663,103112202,5,0,0,94720,1,7496590888
4279,92682801,10084495,102767296,7,0,0,512,14,4424052930
4280,92709330,10178649,102887979,4,0,0,2048,9,4768025398
4281,92797640,10247582,103045222,4,0,0,7168,9,4634853061
4282,92819090,10678481,103497571,2,0,0,125440,0,3238217550
4283,92826569,10030898,102857467,5,0,0,45568,1,9674160231
4284,92830571,10366271,103196842,7,0,0,3584,14,9163866775
4285,92855419,10603707,103459126,5,0,0,246784,1,3797552596
4286,92859931,10252450,103112381,7,0,0,512,14,10400984793
4287,92989361,10130477,103119838,7,0,0,512,14,10087820903
4288,92999400,10046648,103046048,1,0,0,2560,23,965541708
4289,93068140,10015179,103083319,1,0,0,1024,23,4446419946
4290,93081099,10488902,103570001,0,0,0,2560,6,10024025749
4291,93130190,10210152,103340342,1,0,0,2048,23,6961106155
4292,93260080,10926437,104186517,2,0,0,275968,0,84902007
4293,93307990,35899459,129207449,4,0,1,32768,9,1176700966
4294,93322339,9957539,103279878,5,0,0,51712,1,10705426935
4295,93327741,9867986,103195727,7,0,0,1536,14,10259233803
4296,93357370,10140871,103498241,1,0,0,1024,23,4134493756
4297,93384249,10298845,103683094,5,0,0,72192,1,7665398001
4298,93399030,9796206,103195236,1,0,0,2048,23,5629541926
4299,93406680,35801025,129207705,7,0,1,9216,14,9711975733
4300,93417790,35790274,129208064,4,0,1,9728,9,7999348797
4301,93421019,10149317,103570336,0,0,0,1024,6,3530131548
4302,93435689,9802658,103238347,0,0,0,2048,6,2957463850
4303,93437179,10508843,103946022,5,0,0,117760,1,5768318407
4304,93453160,10006168,103459328,4,0,0,512,9,7380425657
4305,93454480,35769141,129223621,7,0,1,12288,14,4383739889
4306,93491659,10077539,103569198,5,0,0,56320,1,2211901722
4307,93642051,10460359,104102410,2,0,0,185856,0,8579919210
4308,93666149,9831757,103497906,0,0,0,1024,6,5280508890
4309,93683171,10043773,103726944,2,0,0,30720,0,9963530747
4310,93693710,9641566,103335276,1,0,0,512,23,7304318832
4311,93741261,10568454,104309715,2,0,0,80896,0,4593098153
4312,93770670,10453106,104223776,4,0,0,3072,9,585715792
4313,93815439,11104472,104919911,5,0,0,260096,1,2479068271
4314,93858241,10535708,104393949,2,0,0,90112,0,1495203783
4315,93865510,9673107,103538617,1,0,0,1536,23,999633094
4316,93908280,11114423,105022703,4,0,0,4608,9,2598682863
4317,93927359,10293033,104220392,0,0,0,111104,6,37743211
4318,93949861,10335183,104285044,2,0,0,167936,0,8502843424
4319,93969900,35256307,129226207,7,0,1,4096,14,2021127479
4320,94003999,10662953,104666952,5,0,0,252416,1,8626182985
4321,94030081,11224605,105254686,2,0,0,239104,0,1781086862
4322,94059229,10885889,104945118,0,0,0,25600,6,6547819344
4323,94063200,9586175,103649375,1,0,0,3584,23,8110291526
4324,94139319,10701321,104840640,5,0,0,131584,1,6673594323
4325,94140489,10080246,104220735,5,0,0,1024,1,1881972981
4326,94147820,10073414,104221234,1,0,0,1536,23,2809417915
4327,94229601,10525016,104754617,2,0,0,109568,0,1945447484
4328,94332260,34908689,129240949,1,0,1,1024,23,1550330697
4329,94356240,10564162,104920402,4,0,0,1536,9,1449730161
4330,94361730,9861087,104222817,1,0,0,5120,23,8516770012
4331,94364640,9494186,103858826,4,0,0,1024,9,650797645
4332,94366650,9484147,103850797,1,0,0,512,23,4533035223
4333,94367180,34878275,129245455,7,0,1,7168,14,1518907919
4334,94394250,34859404,129253654,7,0,1,3072,14,9524913656
4335,94429329,9516872,103946201,5,0,0,512,1,1280140628
4336,94445050,9989958,104435008,1,0,0,1024,23,8940316687
4337,94446399,9920071,104366470,0,0,0,77312,6,7976035619
4338,94447919,10133537,104581456,0,0,0,91136,6,5786194003
4339,94461920,10657480,105119400,4,0,0,203264,9,9669370878
4340,94481610,34795731,129277341,7,0,1,16896,14,10689718016
4341,94528630,10653181,105181811,4,0,0,57856,9,7178196740
4342,94534100,34748071,129282171,7,0,1,10752,14,2509587679
4343,94537700,34753359,129291059,4,0,1,30208,9,12943582
4344,94682020,9998215,104680235,4,0,0,43520,9,9281954495
4345,94732261,10868128,105600389,2,0,0,52224,0,2689156270
4346,94762260,10822194,105584454,1,0,0,1536,23,5184515690
4347,94773949,10640351,105414300,0,0,0,316928,6,7069173294
4348,94784870,34526244,129311114,7,0,1,19968,14,36082548
4349,94790181,9890233,104680414,7,0,0,512,14,8297673133
4350,94795841,9886872,104682713,2,0,0,6144,0,6351486257
4351,94835480,10419541,105255021,1,0,0,1024,23,8785629140
4352,94846730,34468380,129315110,2,0,1,18944,0,3517457036
4353,94933841,9781585,104715426,7,0,0,2048,14,4681740515
4354,94949060,34389288,129338348,6,0,1,43520,19,5850364565
4355,94949991,11145789,106095780,2,0,0,174080,0,10314657001
4356,94966500,9719980,104686480,4,0,0,12288,9,6543647930
4357,94982670,9706974,104689644,1,0,0,1536,23,8209067355
4358,95039591,9641158,104680749,7,0,0,1024,14,4658026656
4359,95108439,10055721,105164160,0,0,0,47104,6,8557582702
4360,95173340,11437966,106611306,4,0,0,456192,9,9135592128
4361,95246230,10244366,105490596,4,0,0,19968,9,4486386903
4362,95252730,10198253,105450983,4,0,0,120320,9,9291144517
4363,95283800,10628878,105912678,4,0,0,48128,9,10733917499
4364,95311990,10473800,105785790,4,0,0,105472,9,2732415159
4365,95376720,9644556,105021276,4,0,0,132608,9,8866656890
4366,95382400,9904147,105286547,1,0,0,2048,23,10084664250
4367,95404521,9881379,105285900,2,0,0,95232,0,9505467836
4368,95455391,10486495,105941886,7,0,0,512,14,70542313
4369,95494120,10315249,105809369,4,0,0,77312,9,4214733525
4370,95514529,10497815,106012344,0,0,0,81408,6,6640058328
4371,95541141,10014525,105555666,7,0,0,512,14,4624183019
4372,95556261,11082281,106638542,2,0,0,70656,0,9538014144
4373,95565539,9928034,105493573,5,0,0,512,1,7906933918
4374,95566300,10866935,106433235,4,0,0,189440,9,1687418562
4375,95579129,9542657,105121786,5,0,0,7680,1,45521508
4376,95664140,10054138,105718278,1,0,0,512,23,4356693847
4377,95686220,33682625,129368845,3,0,1,7680,28,6445393526
4378,95709380,9892280,105601660,1,0,0,4096,23,2471277151
4379,95709850,10998320,106708170,1,0,0,41472,23,6908650300
4380,95710089,9414083,105124172,0,0,0,7680,6,7313421634
4381,95722109,9593725,105315834,5,0,0,2048,1,8399059435
4382,95756239,9695243,105451482,5,0,0,1536,1,488205714
4383,95792451,9462928,105255379,7,0,0,1024,14,9537895949
4384,95799479,10571748,106371227,0,0,0,87552,6,3923200990
4385,95805839,11078898,106884737,0,0,0,269312,6,9959531970
4386,95876580,10467948,106344528,4,0,0,382976,9,1162395873
4387,95901871,9827807,105729678,2,0,0,7680,0,1191280183
4388,95957930,9957322,105915252,4,0,0,5632,9,10723429446
4389,95965271,11148451,107113722,7,0,0,331776,14,292520383
4390,95977380,11722395,107699775,4,0,0,153088,9,7134048002
4391,96002831,10916405,106919236,2,0,0,113152,0,4573652375
4392,96051831,10636269,106688100,7,0,0,152576,14,4608224935
4393,96070541,9824893,105895434,7,0,0,19456,14,7264873412
4394,96113971,9529449,105643420,7,0,0,3584,14,6989817213
4395,96123760,9975631,106099391,4,0,0,11776,9,8062643632
4396,96133249,9884711,106017960,5,0,0,2048,1,10721778421
4397,96215371,11052998,107268369,7,0,0,121856,14,8919317476
4398,96332520,9480624,105813144,1,0,0,12288,23,420634226
4399,96421701,10699399,107121100,2,0,0,19968,0,1935870244
4400,96497280,9953154,106450434,1,0,0,56320,23,2440637952
4401,96509021,11270623,107779644,2,0,0,35840,0,3161563326
4402,96550619,10723993,107274612,5,0,0,6144,1,4854508142
4403,96608249,9534469,106142718,5,0,0,2048,1,75645153
4404,96659510,32714789,129374299,7,0,1,22016,14,3309569984
4405,96684330,10118328,106802658,4,0,0,8192,9,1325122900
4406,96690799,10308179,106998978,0,0,0,206336,6,3061556956
4407,96728420,11444490,108172910,1,0,0,143360,23,5164402112
4408,96758589,9858402,106616991,5,0,0,512,1,8943758069
4409,96786231,11557311,108343542,2,0,0,184320,0,10650148017
4410,96792400,11626148,108418548,4,0,0,187392,9,9972706108
4411,96800779,10371643,107172422,5,0,0,1024,1,9384831269
4412,96806220,10355931,107162151,1,0,0,134656,23,3749672737
4413,96914780,32473509,129388289,3,0,1,24576,28,8459091799
4414,96917240,32473635,129390875,8,0,1,4096,12,3547235682
4415,96922359,9450528,106372887,5,0,0,5120,1,5631368122
4416,96929300,32462241,129391541,3,0,1,11264,28,8896087851
4417,96961610,9655179,106616789,4,0,0,17920,9,4594661023
4418,96964690,32427722,129392412,8,0,1,12288,12,3573410972
4419,96981140,32426604,129407744,3,0,1,6144,28,3608577029
4420,96984210,11587920,108572130,1,0,0,110592,23,3254152297
4421,96997161,11766683,108763844,2,0,0,316928,0,764445235
4422,97002051,11591318,108593369,7,0,0,69632,14,6780212004
4423,97026830,32381068,129407898,8,0,1,8704,12,8472237889
4424,97051841,10348925,107400766,7,0,0,6144,14,3121879577
4425,97066330,10048663,107114993,2,0,0,4096,0,4310809406
4426,97110919,9898565,107009484,5,0,0,3584,1,2548809891
4427,97147470,11954806,109102276,1,0,0,731648,23,348325781
4428,97171141,9614441,106785582,2,0,0,73728,0,5151494102
4429,97185451,11476144,108661595,7,0,0,223744,14,10038937968
4430,97225841,9780180,107006021,2,0,0,23040,0,7718570878
4431,97261090,32173607,129434697,8,0,1,21504,12,9548721178
4432,97266120,32173720,129439840,8,0,1,7168,12,4347569886
4433,97278610,32178268,129456878,8,0,1,32256,12,92457388
4434,97287760,32171704,129459464,8,0,1,4096,12,4401159454
4435,97331830,32128940,129460770,3,0,1,2048,28,5400379328
4436,97362160,11102610,108464770,1,0,0,100864,23,10445243411
4437,97364790,32097568,129462358,8,0,1,15872,12,3881557712
4438,97374490,32088739,129463229,3,0,1,12288,28,111305010
4439,97427431,10701776,108129207,2,0,0,294912,0,3714658753
4440,97462530,10378619,107841149,4,0,0,10240,9,9405866892
4441,97493601,9898258,107391859,2,0,0,74752,0,1497873979
4442,97495349,11709892,109205241,0,0,0,221696,6,7507234193
4443,97496641,10763409,108260050,7,0,0,37888,14,7091849687
4444,97524360,31940718,129465078,7,0,1,8704,14,2331178033
4445,97535010,10027404,107562414,2,0,0,153088,0,4915523432
4446,97535859,9812032,107347891,5,0,0,1024,1,549066193
4447,97536459,10694818,108231277,0,0,0,153088,6,8300630303
4448,97547070,10965462,108512532,4,0,0,55296,9,10167898799
4449,97557941,10876074,108434015,7,0,0,50688,14,10485811182
4450,97609171,10636949,108246120,7,0,0,48640,14,6225335577
4451,97612659,11152932,108765591,5,0,0,5632,1,1369462911
4452,97622089,11711797,109333886,0,0,0,298496,6,3351796566
4453,97635170,31834734,129469904,7,0,1,7680,14,9772038474
4454,97641650,31835978,129477628,3,0,1,11776,28,3698875061
4455,97702880,10575883,108278763,1,0,0,7168,23,2442824186
4456,97705219,9882979,107588198,5,0,0,7168,1,7130169715
4457,97859610,10925901,108785511,4,0,0,65024,9,1964439057
4458,97870970,11513828,109384798,1,0,0,30720,23,1038093351
4459,97900310,31582785,129483095,7,0,1,7680,14,9954615610
4460,97918961,10918018,108836979,7,0,0,47104,14,46127864
4461,98029700,9720497,107750197,1,0,0,57856,23,3011993224
4462,98032419,11312004,109344423,0,0,0,5120,6,1872675801
4463,98032910,11084365,109117275,1,0,0,49152,23,8009390532
4464,98069940,11627192,109697132,1,0,0,345600,23,558583782
4465,98198850,9725526,107924376,4,0,0,16896,9,4906698570
4466,98208140,10264765,108472905,1,0,0,26624,23,8674987607
4467,98271039,10847397,109118436,5,0,0,1024,1,5473924570
4468,98336170,31147451,129483621,7,0,1,10240,14,9902894753
4469,98344950,31255301,129600251,7,0,1,30208,14,1782600856
4470,98362370,9986031,108348401,4,0,0,15872,9,1426507592
4471,98398470,31202607,129601077,7,0,1,17920,14,7422262662
4472,98455680,11363334,109819014,2,0,0,399872,0,8753539830
4473,98479630,11403295,109882925,2,0,0,188416,0,9920057187
4474,98496560,31104540,129601100,7,0,1,11264,14,6156459248
4475,98526571,9721912,108248483,7,0,0,7680,14,1814604102
4476,98557980,10109277,108667257,2,0,0,18432,0,6898500988
4477,98573360,31027763,129601123,4,0,1,1536,9,7545118015
4478,98604271,11563380,110167651,2,0,0,404480,0,1080223503
4479,98678850,30922296,129601146,4,0,1,3072,9,5675094035
4480,98714140,30887029,129601169,6,0,1,5120,19,3094335370
4481,98766090,30835102,129601192,4,0,1,3072,9,719709369
4482,98814270,11230110,110044380,1,0,0,139264,23,849456484
4483,98816850,30784365,129601215,0,0,1,512,6,9684012719
4484,98821869,10315801,109137670,0,0,0,62976,6,5807824601
4485,98829980,30786746,129616726,5,0,1,38400,1,1112482298
4486,98832040,30863480,129695520,7,0,1,19456,14,1151865771
4487,98847041,9994325,108841366,7,0,0,8192,14,405819741
4488,98847460,11329472,110176932,2,0,0,30208,0,10357462220
4489,98854440,30847186,129701626,6,0,1,20992,19,681498997
4490,98881569,9904121,108785690,5,0,0,512,1,6760148182
4491,98896240,30910768,129807008,4,0,1,16384,9,3766737661
4492,98920781,10322134,109242915,2,0,0,123392,0,9763516589
4493,98955480,30935126,129890606,4,0,1,4608,9,1970662489
4494,98962810,11012994,109975804,4,0,0,10240,9,176973916
4495,98993520,30897650,129891170,4,0,1,10752,9,9942315206
4496,99043380,30850492,129893872,4,0,1,15872,9,3721197253
4497,99045930,11194229,110240159,4,0,0,207360,9,3902380044
4498,99051360,10769884,109821244,4,0,0,5120,9,9318499252
4499,99062030,30890540,129952570,0,0,1,16896,6,3611607594
4500,99062679,10867909,109930588,5,0,0,1024,1,1244151908
4501,99094419,10023659,109118078,0,0,0,2560,6,4063164523
4502,99105500,30852728,129958228,6,0,1,1536,19,3876810561
4503,99129480,30907888,130037368,4,0,1,51712,9,3944444508
4504,99175940,30862913,130038853,0,0,1,15360,6,957175037
4505,99179459,11149401,110328860,0,0,0,512,6,8143221795
4506,99187750,11140915,110328665,1,0,0,290304,23,8522586390
4507,99212301,10129892,109342193,2,0,0,27136,0,9070604519
4508,99212389,11117765,110330154,0,0,0,1024,6,4366583366
4509,99226790,30819115,130045905,6,0,1,19456,19,3114417711
4510,99235159,10110402,109345561,0,0,0,3072,6,6862537945
4511,99286430,11238389,110524819,1,0,0,4096,23,10255297772
4512,99299049,10043791,109342840,5,0,0,2048,1,9157859044
4513,99326269,10019939,109346208,0,0,0,2048,6,2154182617
4514,99382259,9962343,109344602,0,0,0,512,6,3810431477
4515,99425271,9939532,109364803,2,0,0,60928,0,7691783585
4516,99469751,10905332,110375083,2,0,0,51712,0,5932895705
4517,99472680,30705025,130177705,6,0,1,46592,19,3778982178
4518,99483391,11437464,110920855,2,0,0,39936,0,4724483501
4519,99502040,30676023,130178063,7,0,1,46592,14,8253870291
4520,99571740,11216496,110788236,4,0,0,174080,9,7391527517
4521,99618400,30561113,130179513,6,0,1,21504,19,5164384498
4522,99623360,30686578,130309938,4,0,1,1536,9,9009441573
4523,99639640,11228569,110868209,4,0,0,188416,9,5416292790
4524,99656840,30653121,130309961,0,0,1,5120,6,2166386371
4525,99656880,9932279,109589159,4,0,0,54784,9,5611850577
4526,99663070,30646914,130309984,4,0,1,9216,9,3609151856
4527,99678300,30631707,130310007,4,0,1,4096,9,10364669385
4528,99694279,10307646,110001925,0,0,0,1536,6,3779633960
4529,99708699,10110962,109819661,5,0,0,2048,1,2108300729
4530,99721340,30588690,130310030,7,0,1,15360,14,9744166075
4531,99725349,10097330,109822679,0,0,0,4608,6,7211480053
4532,99793809,11278782,111072591,5,0,0,1024,1,5285301748
4533,99807259,10606224,110413483,0,0,0,4096,6,4973772301
4534,99811420,30498633,130310053,6,0,1,11776,19,1041915571
4535,99852010,30458401,130310411,7,0,1,16384,14,945153578
4536,99855571,11194636,111050207,2,0,0,236032,0,2892007187
4537,99872700,10095694,109968394,4,0,0,75264,9,322285344
4538,99884249,11216800,111101049,0,0,0,2560,6,10698711278
4539,99905000,10096099,110001099,1,0,0,82944,23,5958485097
4540,99910930,10589075,110500005,1,0,0,2560,23,1370588096
4541,99949001,10520013,110469014,2,0,0,98304,0,3698588503
4542,99968890,30341544,130310434,4,0,1,3072,9,2505993124
4543,99991950,30319154,130311104,7,0,1,18432,14,445795129
4544,100032630,30318446,130351076,6,0,1,52736,19,7706727854
4545,100033729,9967705,110001434,0,0,0,1024,6,5114485578
4546,100040680,30315222,130355902,6,0,1,7680,19,9878392230
4547,100120549,10209270,110329819,5,0,0,3072,1,5812016183
4548,100131171,10666292,110797463,2,0,0,30208,0,5614514701
4549,100198330,10239041,110437371,1,0,0,3072,23,6138549365
4550,100284280,10239268,110523548,4,0,0,59392,9,10213565406
4551,100312910,30047178,130360088,7,0,1,6656,14,3344842219
4552,100324310,10010237,110334547,4,0,0,7168,9,4464159478
4553,100362330,10371884,110734214,4,0,0,257536,9,5939523539
4554,100376330,30020676,130397006,6,0,1,22528,19,10729633093
4555,100421350,29993396,130414746,3,0,1,20992,28,9845872531
4556,100427170,30018286,130445456,9,0,1,10752,10,3979001035
4557,100435820,30021039,130456859,0,0,1,5120,6,8250621587
4558,100437420,30062204,130499624,0,0,1,38400,6,1966333110
4559,100458380,30050576,130508956,9,0,1,26112,10,7635925780
4560,100458870,30097404,130556274,3,0,1,64000,28,7526967801
4561,100486439,10383430,110869869,0,0,0,2560,6,6644554230
4562,100496471,10698928,111195399,2,0,0,134656,0,373959658
4563,100504290,30055990,130560280,6,0,1,2560,19,2470191441
4564,100532570,30029976,130562546,7,0,1,3584,14,9605907879
4565,100564611,10246151,110810762,2,0,0,43520,0,6360552544
4566,100675160,29888052,130563212,7,0,1,1024,14,3740470096
4567,100713340,29850231,130563571,3,0,1,9728,28,7414557596
4568,100724210,29878970,130603180,0,0,1,45568,6,2460030603
4569,100724359,10196831,110921190,5,0,0,1024,1,7436513040
4570,100757260,29884340,130641600,3,0,1,20480,28,5437708929
4571,100793089,9942084,110735173,5,0,0,3072,1,6060831041
4572,100796070,29863632,130659702,3,0,1,45056,28,399890776
4573,100807769,10061251,110869020,0,0,0,2560,6,8092935024
4574,100808391,29878148,130686539,9,0,1,8192,10,10066612059
4575,100816240,29903729,130719969,7,0,1,3072,14,8594685706
4576,100837061,29882939,130720000,9,0,1,41472,10,9246136843
4577,100871520,29854948,130726468,7,0,1,58880,14,6167510306
4578,100881570,29938791,130820361,0,0,1,7680,6,10675261238
4579,100903040,10148282,111051322,1,0,0,3584,23,704996896
4580,100907329,10365923,111273252,5,0,0,9728,1,8778657705
4581,100956520,29863864,130820384,0,0,1,17408,6,4295527655
4582,100977239,10125107,111102346,5,0,0,1024,1,9741293616
4583,101002110,29818297,130820407,5,0,1,12800,1,3034927818
4584,101026360,29794070,130820430,3,0,1,2560,28,10156353084
4585,101048971,29771482,130820453,9,0,1,23552,10,3380401617
4586,101078920,29741556,130820476,3,0,1,49664,28,4852640974
4587,101105970,29714529,130820499,7,0,1,3584,14,5078153668
4588,101114120,29712160,130826280,0,0,1,37376,6,8385429905
4589,101198630,29661817,130860447,6,0,1,10240,19,4152335581
4590,101217310,29704381,130921691,7,0,1,7680,14,7086221846
4591,101258620,29663094,130921714,7,0,1,1536,14,10349051329
4592,101264550,29671430,130935980,7,0,1,64512,14,2433991193
4593,101286830,10025777,111312607,1,0,0,4608,23,5618804980
4594,101374810,29588317,130963127,6,0,1,5632,19,3093724870
4595,101389589,9806549,111196138,0,0,0,2048,6,10382493726
4596,101478650,29494853,130973503,3,0,1,6656,28,648961125
4597,101486700,9756536,111243236,1,0,0,1536,23,950907544
4598,101522939,10195916,111718855,5,0,0,3584,1,6331779099
4599,101530410,9786954,111317364,1,0,0,1024,23,7287892345
4600,101566170,29411199,130977369,3,0,1,6144,28,5781810005
4601,101579229,9940592,111519821,0,0,0,2560,6,10087416794
4602,101603350,29479659,131083009,7,0,1,12288,14,8886521618
4603,101624200,29458832,131083032,3,0,1,11264,28,4802361103
4604,101646150,9921058,111567208,1,0,0,2048,23,5160808385
4605,101660430,29445793,131106223,7,0,1,51200,14,6923906799
4606,101687900,10266556,111954456,4,0,0,150016,9,4934935837
4607,101746730,10042174,111788904,4,0,0,146432,9,4103344299
4608,101871260,9647666,111518926,4,0,0,108032,9,5854713072
4609,101913639,9461046,111374685,5,0,0,1024,1,8444084360
4610,101915720,29219086,131134806,4,0,1,3584,9,596239546
4611,101970889,9324473,111295362,5,0,0,512,1,8948291507
4612,102008210,9627910,111636120,1,0,0,1536,23,6678312495
4613,102069269,9373838,111443107,0,0,0,3072,6,6676922448
4614,102164070,9670677,111834747,1,0,0,2048,23,2394587985
4615,102194849,9614180,111809029,5,0,0,512,1,1405231532
4616,102196220,28944385,131140605,8,0,1,19456,12,3753566136
4617,102238459,9367759,111606218,5,0,0,4096,1,10444388320
4618,102286330,9281699,111568029,1,0,0,1536,23,6170110390
4619,102411679,9283868,111695547,5,0,0,512,1,5734390174
4620,102442660,8916683,111359343,1,0,0,1024,23,9937859119
4621,102450530,28690434,131140964,3,0,1,9728,28,8279065337
4622,102453320,28695238,131148558,4,0,1,1024,9,4516813601
4623,102454710,28695474,131150184,3,0,1,2560,28,4533570633
4624,102497800,28729919,131227719,0,0,1,79360,6,8583453203
4625,102511580,28719685,131231265,0,0,1,5632,6,6965685533
4626,102551090,28693637,131244727,0,0,1,7680,6,3675671092
4627,102559359,9037312,111596671,5,0,0,2560,1,9748068353
4628,102573620,9475282,112048902,4,0,0,218624,9,10396183152
4629,102574911,9407325,111982236,7,0,0,79872,14,2318938555
4630,102625560,28622073,131247633,0,0,1,4608,6,9256682489
4631,102717730,28577462,131295192,0,0,1,13312,6,2351047694
4632,102721250,28573965,131295215,4,0,1,38400,9,1191001944
4633,102728770,28566468,131295238,4,0,1,3584,9,3170009272
4634,102763529,8839200,111602729,0,0,0,1536,6,2288045910
4635,102774600,9047435,111822035,1,0,0,2560,23,10131124177
4636,102775300,28534113,131309413,0,0,1,19968,6,3921017361
4637,102850380,28460019,131310399,0,0,1,1536,6,9697958612
4638,102858050,28453220,131311270,0,0,1,12288,6,1054976932
4639,102869779,8958356,111828135,0,0,0,512,6,2816654925
4640,102870970,9353926,112224896,1,0,0,15360,23,2984136674
4641,102911220,28401036,131312256,6,0,1,1536,19,835285709
4642,102972200,28440229,131412429,3,0,1,22528,28,1886996768
4643,102977300,28857521,131834821,0,0,1,11264,6,6241249854
4644,103022530,29002003,132024533,3,0,1,20992,28,12711104
4645,103032060,28993241,132025301,0,0,1,11776,6,2548392112
4646,103062069,8819631,111881700,0,0,0,8192,6,8272387714
4647,103086081,28939968,132026049,9,0,1,1024,10,8810534433
4648,103122939,8704128,111827067,5,0,0,2048,1,9967154257
4649,103128780,28899535,132028315,0,0,1,3584,6,10027782250
4650,103144270,29040937,132185207,3,0,1,29184,28,2877768181
4651,103148320,9340095,112488415,1,0,0,326656,23,7655806941
4652,103200629,8889922,112090551,5,0,0,6144,1,2605964744
4653,103224580,9376761,112601341,4,0,0,159744,9,8801433050
4654,103253711,9348830,112602541,3,0,0,512,28,10432390784
4655,103294710,28890520,132185230,0,0,1,18944,6,3770446606
4656,103310731,28926337,132237068,9,0,1,33792,10,9947535373
4657,103336290,28912056,132248346,0,0,1,9216,6,9413386913
4658,103376591,28871778,132248369,9,0,1,12800,10,61880239
4659,103389710,28858682,132248392,6,0,1,6144,19,6552109110
4660,103416170,8832886,112249056,1,0,0,56832,23,7846465085
4661,103419170,8908385,112327555,1,0,0,107008,23,6930415301
4662,103455799,8624353,112080152,5,0,0,3584,1,6379991469
4663,103471230,9230113,112701343,1,0,0,10752,23,7139859577
4664,103471849,8703979,112175828,5,0,0,512,1,2636055034
4665,103477649,9250729,112728378,0,0,0,2560,6,9669038825
4666,103479759,8769811,112249570,5,0,0,1536,1,1830059473
4667,103581500,28666923,132248423,0,0,1,13824,6,467323305
4668,103588679,8774304,112362983,0,0,0,3072,6,10147026047
4669,103597640,28650806,132248446,0,0,1,14336,6,9358284973
4670,103664400,28656040,132320440,0,0,1,7168,6,10417936890
4671,103710830,28609673,132320503,1,0,1,29184,23,6518403972
4672,103726809,8825837,112552646,0,0,0,4096,6,5068955200
4673,103773980,28575585,132349565,1,0,1,23040,23,776275207
4674,103788130,9126230,112914360,1,0,0,54272,23,10171224248
4675,103792630,8542124,112334754,4,0,0,23552,9,8572442413
4676,103813200,28590940,132404140,1,0,1,36864,23,2831551488
4677,103817540,9080261,112897801,4,0,0,266240,9,2513362268
4678,103841640,9160442,113002082,4,0,0,65024,9,9619702259
4679,103900800,28517753,132418553,6,0,1,28160,19,7693299965
4680,103901570,8889534,112791104,1,0,0,119808,23,3198504614
4681,103927399,9075174,113002573,5,0,0,1536,1,9273351577
4682,103951420,28468439,132419859,0,0,1,2048,6,908887798
4683,103966950,8707809,112674759,4,0,0,55808,9,3125482958
4684,103971369,8630954,112602323,0,0,0,3072,6,6503770498
4685,103981240,28441845,132423085,0,0,1,5120,6,2674372137
4686,103993700,28435833,132429533,0,0,1,18944,6,5461878647
4687,103996450,28540349,132536799,0,0,1,48640,6,728965119
4688,104096210,28471634,132567844,1,0,1,63488,23,10160137721
4689,104231660,28470919,132702579,0,0,1,10752,6,137843492
4690,104285110,28453190,132738300,6,0,1,18432,19,10392739486
4691,104321030,28418896,132739926,8,0,1,2560,12,5934000683
4692,104380550,28418942,132799492,0,0,1,43008,6,2576073394
4693,104402700,28396815,132799515,1,0,1,16384,23,9532781549
4694,104420000,28379538,132799538,0,0,1,5632,6,7218025734
4695,104424510,28384413,132808923,1,0,1,26624,23,9987913586
4696,104425940,28428044,132853984,1,0,1,3072,23,234964828
4697,104432290,8307749,112740039,4,0,0,22528,9,9247750784
4698,104476851,28377479,132854330,9,0,1,512,10,5719383571
4699,104481580,28459649,132941229,1,0,1,12800,23,1475295791
4700,104493010,28546257,133039267,0,0,1,33792,6,776806489
4701,104504410,8750011,113254421,1,0,0,110592,23,9500167651
4702,104516641,28603417,133120058,9,0,1,512,10,486566871
4703,104517640,28602441,133120081,8,0,1,11264,12,5568616868
4704,104542030,8614649,113156679,4,0,0,197120,9,6645070322
4705,104557269,8600681,113157950,0,0,0,4096,6,10188037366
4706,104568170,8853993,113422163,4,0,0,433152,9,4187807735
4707,104573351,28685679,133259030,9,0,1,15360,10,4329398138
4708,104582169,8358202,112940371,0,0,0,1536,6,80122012
4709,104625820,28658091,133283911,1,0,1,6144,23,8717234154
4710,104656500,28627450,133283950,6,0,1,45056,19,2856318000
4711,104664340,28633772,133298112,1,0,1,11264,23,8719260592
4712,104682370,28631820,133314190,6,0,1,13824,19,7684792387
4713,104689600,28773483,133463083,6,0,1,1536,19,6608680729
4714,104708250,28754856,133463106,0,0,1,4096,6,1304724899
4715,104717679,8723718,113441397,5,0,0,3072,1,4574725627
4716,104766061,28697068,133463129,9,0,1,4096,10,2663465611
4717,104826669,8615687,113442356,5,0,0,3072,1,8206645802
4718,104829110,8611328,113440438,1,0,0,59904,23,9373551463
4719,104882740,28580412,133463152,1,0,1,4608,23,3839105651
4720,104900830,28562345,133463175,8,0,1,17408,12,8787195026
4721,104906970,28613838,133520808,0,0,1,57344,6,8508028167
4722,104921170,28599661,133520831,0,0,1,3584,6,4406646722
4723,104941690,28579164,133520854,6,0,1,2048,19,5200717887
4724,104966390,8619735,113586125,4,0,0,9216,9,4789360655
4725,105021550,28499327,133520877,1,0,1,20992,23,10423633028
4726,105021960,28573375,133595335,0,0,1,3584,6,7198868444
4727,105051371,28543987,133595358,9,0,1,6656,10,10348822686
4728,105084809,28591451,133676260,1,0,1,32768,23,4464325185
4729,105094271,28582012,133676283,9,0,1,9728,10,5069078401
4730,105126380,8838669,113965049,4,0,0,551936,9,4776787316
4731,105152960,28523346,133676306,1,0,1,11264,23,7652339714
4732,105168910,28544462,133713372,5,0,1,87552,1,7250343381
4733,105179530,28533865,133713395,8,0,1,9728,12,3227725744
4734,105212770,8798566,114011336,1,0,0,150528,23,3273069414
4735,105219870,28493548,133713418,3,0,1,1536,28,7657410234
4736,105240091,28473350,133713441,9,0,1,46592,10,4070485816
4737,105278399,28438520,133716919,1,0,1,21504,23,10551272575
4738,105316730,9106754,114423484,4,0,0,104960,9,3284716538
4739,105327830,9141910,114469740,4,0,0,512,9,8120319636
4740,105346670,28418326,133764996,3,0,1,91136,28,4250726012
4741,105350430,9110590,114461020,1,0,0,38912,23,9632673280
4742,105429089,28337392,133766481,1,0,1,15360,23,4461438745
4743,105444640,28341893,133786533,1,0,1,7680,23,9902459424
4744,105475380,9276428,114751808,4,0,0,89088,9,8068443819
4745,105496350,28310098,133806448,3,0,1,8192,28,5055024995
4746,105520820,28285659,133806479,8,0,1,12800,12,3670151306
4747,105545400,28261102,133806502,8,0,1,7168,12,8666968029
4748,105573830,9342666,114916496,4,0,0,74240,9,10502557873
4749,105591060,28215465,133806525,6,0,1,15872,19,7597398099
4750,105598360,28250271,133848631,8,0,1,36864,12,5025238407
4751,105607221,28246592,133853813,9,0,1,8192,10,7876488795
4752,105627720,28234245,133861965,3,0,1,14848,28,3582985121
4753,105635270,28234427,133869697,8,0,1,16384,12,3995243159
4754,105648309,9181938,114830247,0,0,0,1536,6,1516681863
4755,105649730,28246324,133896054,3,0,1,12800,28,1290574611
4756,105654819,9262324,114917143,0,0,0,2048,6,2916624592
4757,105696550,9292488,114989038,4,0,0,18944,9,2704728277
4758,105746989,9190284,114937273,0,0,0,512,6,7848422037
4759,105791399,9069619,114861018,0,0,0,4608,6,8479988086
4760,105796930,28142950,133939880,9,0,1,7168,10,10572543091
4761,105803470,28138356,133941826,3,0,1,3072,28,7679348954
4762,105917540,28031378,133948918,8,0,1,11264,12,7829538703
4763,105938270,28010994,133949264,8,0,1,512,12,1626063231
4764,105976460,9180542,115157002,1,0,0,115712,23,3178491297
4765,105988580,9543097,115531677,9,0,0,128000,10,927455729
4766,105999859,9373999,115373858,5,0,0,512,1,2295403331
4767,106003480,9182462,115185942,4,0,0,51712,9,9098422688
4768,106010709,9193233,115203942,0,0,0,512,6,3313829398
4769,106017230,27934940,133952170,8,0,1,4608,12,10694757049
4770,106017460,27973588,133991048,9,0,1,17920,10,4301214786
4771,106047740,27943395,133991135,3,0,1,5632,28,3810860587
4772,106081029,8923523,115004552,0,0,0,3072,6,4648463019
4773,106082510,27979534,134062044,9,0,1,25600,10,8875008504
4774,106111400,27951626,134063026,3,0,1,27136,28,8196321483
4775,106119490,9421570,115541060,1,0,0,30720,23,8557443513
4776,106156501,9723889,115880390,7,0,0,353280,14,8258741382
4777,106159249,8998244,115157493,0,0,0,1536,6,8239617782
4778,106183920,9440671,115624591,4,0,0,65536,9,6713981000
4779,106197720,27865329,134063049,8,0,1,22528,12,8116162999
4780,106287430,9711131,115998561,4,0,0,101888,9,11554256
4781,106300650,9800910,116101560,4,0,0,5632,9,8543925695
4782,106393710,9165747,115559457,1,0,0,57856,23,5630718266
4783,106437539,8941688,115379227,5,0,0,4608,1,7714307979
4784,106445880,9322178,115768058,4,0,0,145920,9,4186203665
4785,106455900,9441522,115897422,4,0,0,50688,9,9883117911
4786,106462769,9792734,116255503,5,0,0,2560,1,10320279251
4787,106498080,27564992,134063072,8,0,1,3072,12,10467835052
4788,106562090,9891575,116453665,9,0,0,97280,10,6934624411
4789,106572440,9618913,116191353,4,0,0,26624,9,1451909676
4790,106583480,27488133,134071613,6,0,1,52736,19,567434543
4791,106731429,9150388,115881817,5,0,0,4608,1,9882741481
4792,106806590,27338207,134144797,8,0,1,42496,12,1697956344
4793,106826250,27324346,134150596,8,0,1,19456,12,1257704058
4794,106865460,9234361,116099821,4,0,0,122880,9,9311577160
4795,106881579,9349461,116231040,0,0,0,1536,6,5797092065
4796,106907330,9565463,116472793,9,0,0,49152,10,6080774343
4797,106911159,9148622,116059781,5,0,0,1536,1,148242818
4798,106915970,27278291,134194261,8,0,1,38400,12,8735342487
4799,106956959,9155145,116112104,0,0,0,512,6,2509240557
4800,106962330,9922309,116884639,1,0,0,405504,23,88311104
4801,107007790,9676615,116684405,4,0,0,89600,9,5692463164
4802,107086340,9025539,116111879,1,0,0,33792,23,9714311956
4803,107142870,9514212,116657082,8,0,0,168960,12,1525888024
4804,107164790,9423149,116587939,9,0,0,62976,10,7209580166
4805,107191159,9282749,116473908,5,0,0,3584,1,7204099741
4806,107222370,9728380,116950750,1,0,0,89088,23,8194284607
4807,107265839,9322279,116588118,5,0,0,512,1,3378636247
4808,107294499,8915111,116209610,5,0,0,1024,1,2632878848
4809,107323140,26873272,134196412,8,0,1,26624,12,5276286310
4810,107362800,9325528,116688328,1,0,0,12800,23,7697515534
4811,107380469,8838981,116219450,0,0,0,3072,6,208112409
4812,107444020,26768023,134212043,8,0,1,9216,12,126767470
4813,107449960,9071579,116521539,4,0,0,8704,9,6646146586
4814,107452789,9063168,116515957,5,0,0,4096,1,9851556960
4815,107478990,9747458,117226448,1,0,0,104448,23,3944185618
4816,107655360,9337876,116993236,1,0,0,139264,23,1153475019
4817,107669370,9640774,117310144,4,0,0,57856,9,4693315142
4818,107771190,9414602,117185792,4,0,0,33792,9,3056551657
4819,107782810,26496619,134279429,8,0,1,70144,12,6348093139
4820,107806310,9113038,116919348,1,0,0,113664,23,9107194740
4821,107852270,9554505,117406775,4,0,0,64000,9,274141693
4822,107863769,8558392,116422161,5,0,0,512,1,6727436889
4823,107907749,9593688,117501437,0,0,0,512,6,5844835409
4824,108048020,8957438,117005458,4,0,0,39936,9,3619372414
4825,108077000,9094238,117171238,9,0,0,152576,10,4912745033
4826,108099520,8824063,116923583,9,0,0,13824,10,9157707668
4827,108165600,8595464,116761064,4,0,0,21504,9,6352383096
4828,108175110,26109504,134284614,8,0,1,16384,12,9156159953
4829,108200990,8878085,117079075,9,0,0,13312,10,2178002408
4830,108202930,8534866,116737796,4,0,0,5120,9,2384933599
4831,108243090,9446861,117689951,1,0,0,68608,23,6906894568
4832,108285310,8978254,117263564,9,0,0,59904,10,5367723466
4833,108312010,9183616,117495626,9,0,0,175104,10,775675781
4834,108320210,9122041,117442251,1,0,0,30208,23,4735082301
4835,108386220,25899380,134285600,3,0,1,1536,28,7037440651
4836,108419300,8600221,117019521,1,0,0,46080,23,9471351586
4837,108516520,8658953,117175473,1,0,0,13824,23,6153417776
4838,108518670,25769836,134288506,8,0,1,4608,12,7796620779
4839,108581950,8828280,117410230,1,0,0,11264,23,4718820054
4840,108589510,9404863,117994373,1,0,0,517120,23,8283450726
4841,108594780,8934508,117529288,1,0,0,56832,23,5438371742
4842,108611880,25682015,134293895,7,0,1,17408,14,1393568731
4843,108628530,25722819,134351349,8,0,1,17920,12,7463299675
4844,108673810,9595861,118269671,4,0,0,177152,9,1331444014
4845,108818519,8367616,117186135,0,0,0,1024,6,8295801812
4846,108826560,9587381,118413941,9,0,0,407552,10,4068515288
4847,108829380,25525835,134355215,2,0,1,6144,0,5904614435
4848,108837800,8580877,117418677,1,0,0,27648,23,9807870873
4849,108838130,9273465,118111595,1,0,0,351232,23,6252721913
4850,108896810,9682701,118579511,1,0,0,282624,23,5453891406
4851,108902260,9216915,118119175,9,0,0,2048,10,7278680381
4852,108906900,9364065,118270965,9,0,0,1536,10,7149057294
4853,109011780,8581547,117593327,4,0,0,2560,9,3790724612
4854,109069149,8508521,117577670,5,0,0,3584,1,2137745105
4855,109107190,25323077,134430267,2,0,1,5120,0,3967545401
4856,109128280,9458788,118587068,4,0,0,24576,9,1072373338
4857,109166700,8979018,118145718,4,0,0,87040,9,8363473980
4858,109248060,25182230,134430290,2,0,1,1024,0,5155983423
4859,109251020,8894893,118145913,9,0,0,512,10,6252443951
4860,109262390,8550917,117813307,1,0,0,6656,23,993285097
4861,109266010,8558492,117824502,9,0,0,7168,10,3450867866
4862,109284910,8832168,118117078,4,0,0,17920,9,5582915143
4863,109310490,25135425,134445915,0,0,1,49664,6,8779065670
4864,109346490,25100768,134447258,0,0,1,4096,6,2312602778
4865,109525270,8592767,118118037,9,0,0,3072,10,741567952
4866,109542030,25079574,134621604,2,0,1,42496,0,4852905333
4867,109561920,8629055,118190975,4,0,0,100352,9,556152801
4868,109570519,8548009,118118528,0,0,0,1536,6,4825385671
4869,109573041,25048586,134621627,2,0,1,11776,0,8100726862
4870,109620779,8570843,118191622,5,0,0,2048,1,10628131397
4871,109625470,8369082,117994552,9,0,0,512,10,593862699
4872,109716519,8279057,117995576,5,0,0,512,1,8344900241
4873,109784010,8369616,118153626,1,0,0,5632,23,286994563
4874,109826780,8770260,118597040,9,0,0,9216,10,2989122379
4875,109887890,24733760,134621650,0,0,1,8704,6,9277960206
4876,109896560,24725113,134621673,8,0,1,29184,12,1942584744
4877,109905209,8365265,118270474,0,0,0,2560,6,8917283254
4878,109979450,8608421,118587871,4,0,0,2560,9,3385400669
4879,110013560,24608136,134621696,0,0,1,6144,6,3023337224
4880,110098801,24522918,134621719,2,0,1,15360,0,2918034948
4881,110150650,8264030,118414680,1,0,0,2048,23,2751027551
4882,110160181,24461561,134621742,2,0,1,6656,0,7124788257
4883,110165270,8250369,118415639,9,0,0,3072,10,9156067310
4884,110178670,24443095,134621765,0,0,1,35840,6,7884279482
4885,110199910,8218340,118418250,9,0,0,8192,10,4037602211
4886,110228640,8196408,118425048,9,0,0,512,10,5364435500
4887,110234489,8353763,118588252,0,0,0,1024,6,1889158940
4888,110253300,24376107,134629407,8,0,1,6656,12,991781684
4889,110286291,24343782,134630073,2,0,1,1024,0,8189309996
4890,110339700,24291999,134631699,2,0,1,2560,0,4488216790
4891,110409951,24222619,134632570,2,0,1,12288,0,6698177182
4892,110439890,24230482,134670372,8,0,1,20992,12,9634905925
4893,110463569,8223190,118686759,5,0,0,3584,1,10468221962
4894,110467709,8184572,118652281,0,0,0,3584,6,9133223073
4895,110491270,24201611,134692881,0,0,1,25600,6,9270435841
4896,110491700,24232879,134724579,0,0,1,29184,6,8637719372
4897,110549720,24178405,134728125,8,0,1,5632,12,1263682469
4898,110556240,24181766,134738006,8,0,1,14848,12,6460720007
4899,110565080,24176905,134741985,4,0,1,14848,9,1351888182
4900,110577470,8131510,118708980,4,0,0,1536,9,4649224558
4901,110613510,7975857,118589367,1,0,0,3584,23,1349349024
4902,110625810,24129412,134755222,0,0,1,29184,6,9856519404
4903,110635030,8112783,118747813,4,0,0,1024,9,10496368429
4904,110657700,7986189,118643889,9,0,0,1024,10,8506114348
4905,110694909,8063809,118758718,0,0,0,512,6,9436161295
4906,110717180,24086537,134803717,8,0,1,62464,12,5278377844
4907,110770320,24054916,134825236,2,0,1,7680,0,6786104774
4908,110805169,8027550,118832719,5,0,0,3072,1,8114388657
4909,110808010,24056610,134864620,0,0,1,49152,6,9337350388
4910,110811609,7870336,118681945,5,0,0,6656,1,4219840924
4911,110821690,7990059,118811749,4,0,0,1024,9,8134458364
4912,110829250,24214331,135043581,0,0,1,29184,6,4143342969
4913,110868790,24176709,135045499,8,0,1,24576,12,9488853599
4914,110878270,24202506,135080776,8,0,1,56320,12,4126392470
4915,110883610,7873210,118756820,9,0,0,3072,10,8113974961
4916,110904270,24178862,135083132,8,0,1,27648,12,10114300258
4917,110927169,7926616,118853785,0,0,0,512,6,7377597598
4918,110999530,24085241,135084771,8,0,1,13824,12,9422735427
4919,111053599,7803652,118857251,5,0,0,2560,1,6198194421
4920,111075620,24009817,135085437,4,0,1,1024,9,1042095213
4921,111101200,23988103,135089303,8,0,1,6144,12,4457070508
4922,111147580,8011733,119159313,1,0,0,90112,23,2205261232
4923,111201229,7635438,118836667,5,0,0,1024,1,1502539804
4924,111209730,23945841,135155571,8,0,1,6656,12,3158894778
4925,111223160,23940257,135163417,8,0,1,2560,12,8833941213
4926,111233539,7615876,118849415,5,0,0,2048,1,6929629164
4927,111264470,7664779,118929249,9,0,0,11776,10,2533176672
4928,111282029,7575401,118857430,5,0,0,512,1,1037028264
4929,111311789,7958351,119270140,0,0,0,2560,6,5097111566
4930,111320610,23842830,135163440,0,0,1,39936,6,5663032662
4931,111323550,7675725,118999275,4,0,0,1024,9,6086923925
4932,111349609,7599375,118948984,0,0,0,1536,6,3239988700
4933,111360980,23813270,135174250,2,0,1,58880,0,9403594077
4934,111373620,23829909,135203529,8,0,1,29696,12,5779363399
4935,111390449,7869665,119260114,5,0,0,17408,1,10059006274
4936,111405830,7897177,119303007,9,0,0,1024,10,6336885678
4937,111441230,23767317,135208547,0,0,1,19456,6,8324039730
4938,111442290,7747310,119189600,1,0,0,99328,23,8109992198
4939,111460670,23767432,135228102,8,0,1,3072,12,8749404638
4940,111486920,8378211,119865131,1,0,0,253440,23,4904205277
4941,111500230,7955803,119456033,4,0,0,1024,9,10629030203
4942,111501860,7594868,119096728,9,0,0,1536,10,1903969106
4943,111539189,7995703,119534892,5,0,0,65536,1,3999767607
4944,111544149,8132603,119676752,0,0,0,512,6,1178689025
4945,111623280,7567591,119190871,4,0,0,4096,9,871009000
4946,111630469,8457109,120087578,5,0,0,211456,1,5339665353
4947,111649120,23585703,135234823,2,0,1,24064,0,3319755468
4948,111689690,23554892,135244582,0,0,1,2560,6,4168918919
4949,111703940,7810961,119514901,1,0,0,116224,23,6750819340
4950,111741810,23512335,135254145,0,0,1,25088,6,7046412792
4951,111779070,23491529,135270599,2,0,1,24064,0,9075652059
4952,111787960,7888255,119676215,1,0,0,173056,23,5350430126
4953,111845520,23429265,135274785,0,0,1,6656,6,9599329291
4954,111861159,7711853,119573012,0,0,0,512,6,10086747234
4955,111897870,8317622,120215492,1,0,0,393216,23,9875085407
4956,111917410,23357721,135275131,2,0,1,512,0,9557517890
4957,111984930,23351445,135336375,0,0,1,47616,6,4597842790
4958,112010579,7665815,119676394,0,0,0,512,6,6566089420
4959,112038710,7579043,119617753,4,0,0,512,9,7557972751
4960,112068250,7608323,119676573,9,0,0,512,10,6995428494
4961,112094020,23247181,135341201,0,0,1,7680,6,2162162670
4962,112117330,23238576,135355906,2,0,1,34304,0,3947806076
4963,112131680,23225711,135357391,2,0,1,15360,0,5316044152
4964,112147380,7611636,119759016,9,0,0,3584,10,6345927323
4965,112180280,23216952,135397232,0,0,1,46592,6,6237011567
4966,112182140,23223579,135405719,2,0,1,24064,0,7741824150
4967,112230830,23176195,135407025,0,0,1,2048,6,9978781967
4968,112265140,23146711,135411851,8,0,1,7680,12,10263364932
4969,112278310,23137727,135416037,8,0,1,6656,12,2925490926
4970,112279689,7696594,119976283,0,0,0,512,6,5035179642
4971,112302800,23114825,135417625,0,0,1,15872,6,6348033501
4972,112375099,7496763,119871862,0,0,0,22016,6,9618935696
4973,112379820,23042951,135422771,0,0,1,8192,6,9360626469
4974,112438060,7434449,119872509,9,0,0,2048,10,4747546539
4975,112438930,22984405,135423335,8,0,1,10752,12,1562074710
4976,112453979,7801339,120255318,5,0,0,129536,1,5592075294
4977,112458160,7524891,119983051,4,0,0,2560,9,559583377
4978,112465820,7750007,120215827,9,0,0,1024,10,726746324
4979,112486959,7918540,120405499,5,0,0,212480,1,3099215732
4980,112500200,22926361,135426561,8,0,1,5120,12,4112035147
4981,112521810,22905097,135426907,0,0,1,512,6,9211014118
4982,112563840,7854973,120418813,4,0,0,2048,9,3418529028
4983,112576780,7678717,120255497,9,0,0,512,10,2061699825
4984,112795629,7545084,120340713,0,0,0,197120,6,5519121143
4985,112823129,7890365,120713494,0,0,0,187392,6,4053061650
4986,112894559,7523607,120418166,5,0,0,41472,1,6910235444
4987,112901670,22526978,135428648,8,0,1,24576,12,5120361058
4988,112967929,7664584,120632513,0,0,0,263168,6,10052765048
4989,113010610,7771063,120781673,9,0,0,512,10,8332513035
4990,113066549,7666647,120733196,0,0,0,15360,6,5559078203
4991,113087659,8088460,121176119,0,0,0,124416,6,9722470887
4992,113127399,7528771,120656170,5,0,0,39936,1,2588165002
4993,113149989,7641344,120791333,0,0,0,29696,6,9728752965
4994,113198529,7529964,120728493,5,0,0,49152,1,7292532833
4995,113200009,7709681,120909690,5,0,0,157696,1,9832547771
4996,113286600,7447164,120733764,4,0,0,1536,9,5789189907
4997,113385360,22046346,135431706,3,0,1,2048,28,7032616663
4998,113399190,22034782,135433972,3,0,1,3584,28,4680338943
4999,113434780,7198068,120632848,9,0,0,1024,10,434118788
5000,113468010,21966308,135434318,1,0,1,512,23,7104423166
5001,113473130,21964734,135437864,3,0,1,5632,28,4968685870
5002,113479500,21964631,135444131,8,0,1,20992,12,738593271
5003,113521049,7924153,121445202,0,0,0,526336,6,871314948
5004,113542170,21962975,135505145,0,0,1,7680,6,10208136794
5005,113547829,21957339,135505168,1,0,1,2048,23,4841122818
5006,113608899,7886962,121495861,5,0,0,145408,1,8490774726
5007,113618200,21886991,135505191,0,0,1,5120,6,3265364388
5008,113645120,21860094,135505214,8,0,1,8192,12,913532915
5009,113689760,21815477,135505237,8,0,1,2560,12,7485582334
5010,113727000,21778260,135505260,0,0,1,1536,6,4046377648
5011,113748529,7702491,121451020,0,0,0,18944,6,2626832597
5012,113777550,7409926,121187476,4,0,0,3072,9,9084038548
5013,113815649,7771281,121586930,0,0,0,8704,6,3584904677
5014,113853500,7374166,121227666,4,0,0,2560,9,1500909652
5015,113872411,21632872,135505283,2,0,1,13824,0,337598469
5016,113898860,21606446,135505306,2,0,1,16384,0,9656026109
5017,113982530,21630951,135613481,0,0,1,51712,6,10329643993
5018,114010240,7196207,121206447,4,0,0,1024,9,4547904742
5019,114026910,7178690,121205600,4,0,0,512,9,2083570292
5020,114042099,21706685,135748784,1,0,1,91136,23,226703261
5021,114043330,21705477,135748807,3,0,1,15360,28,841976691
5022,114043610,21742117,135785727,0,0,1,44032,6,1523863495
5023,114050600,21759536,135810136,8,0,1,2048,12,9341005462
5024,114064130,7201789,121265919,9,0,0,4096,10,9630902279
5025,114079100,21739728,135818828,3,0,1,13824,28,1697463025
5026,114251049,21572964,135824013,1,0,1,16384,23,6182502265
5027,114265419,7497114,121762533,0,0,0,194560,6,7947900544
5028,114274300,7177234,121451534,4,0,0,1536,9,768820635
5029,114302210,21618266,135920476,3,0,1,15872,28,2973283082
5030,114385320,21535179,135920499,2,0,1,2048,0,2715870352
5031,114385800,21534722,135920522,4,0,1,8192,9,8761974212
5032,114408169,7495760,121903929,5,0,0,119296,1,904405897
5033,114460350,7049754,121510104,4,0,0,4096,9,10112075348
5034,114463431,21457114,135920545,2,0,1,25088,0,5116612004
5035,114497570,21422998,135920568,3,0,1,14848,28,9681388034
5036,114510690,21409901,135920591,2,0,1,36352,0,9372165270
5037,114535940,7080158,121616098,9,0,0,512,10,2070350141
5038,114539140,21381474,135920614,3,0,1,10752,28,7025321325
5039,114547539,7549249,122096788,0,0,0,250880,6,4509592884
5040,114556769,7294627,121851396,0,0,0,44032,6,5062220671
5041,114617170,21303467,135920637,2,0,1,25600,0,4724359759
5042,114620219,7566701,122186920,5,0,0,35328,1,3685428784
5043,114628710,21312983,135941693,0,0,1,24576,6,1410040886
5044,114630029,7516101,122146130,0,0,0,160768,6,3215139344
5045,114653050,21322760,135975810,0,0,1,15360,6,9995302846
5046,114716980,21261350,135978330,9,0,1,18944,10,9741038608
5047,114751660,21251549,136003209,2,0,1,41984,0,3338622767
5048,114795589,7425693,122221282,0,0,0,86528,6,1580629737
5049,114817329,7334540,122151869,5,0,0,18432,1,7315558115
5050,114838950,7118506,121957456,4,0,0,1536,9,5005346192
5051,114913580,7239560,122153140,4,0,0,4096,9,2799504746
5052,114932800,7164323,122097123,9,0,0,1024,10,1710737686
5053,114955740,21085813,136041553,2,0,1,30208,0,8724686450
5054,114969360,21095639,136064999,0,0,1,14848,6,2115017410
5055,115000890,7220571,122221461,9,0,0,512,10,7472057389
5056,115007249,6804231,121811480,0,0,0,2560,6,3091111376
5057,115009250,21064406,136073656,0,0,1,9216,6,4918307519
5058,115056959,7381638,122438597,5,0,0,205312,1,4485162459
5059,115066040,21021368,136087408,8,0,1,16896,12,8373516260
5060,115131689,20963681,136095370,1,0,1,5632,23,7330114697
5061,115140609,20958627,136099236,1,0,1,6144,23,272782993
5062,115174940,20928482,136103422,2,0,1,6656,0,222805510
5063,115190640,20922566,136113206,0,0,1,5632,6,8289731449
5064,115245490,20927689,136173179,8,0,1,30720,12,7590614594
5065,115279589,7030906,122310495,5,0,0,109056,1,7306733801
5066,115317120,7040473,122357593,9,0,0,1024,10,554786370
5067,115322690,20852004,136174694,7,0,1,6656,14,6571542207
5068,115336190,20839375,136175565,7,0,1,12288,14,672490909
5069,115370489,20824964,136195453,1,0,1,10240,23,2513879021
5070,115381800,6990732,122372532,9,0,0,3584,10,9039683956
5071,115402030,20794396,136196426,8,0,1,12800,12,3218889497
5072,115433600,6877074,122310674,4,0,0,512,9,1906608333
5073,115509179,6989183,122498362,5,0,0,45568,1,6624129186
5074,115513969,7070622,122584591,5,0,0,84992,1,4379477235
5075,115516480,20778578,136295058,5,0,1,159232,1,3932120199
5076,115553800,20754247,136308047,0,0,1,20480,6,7558708638
5077,115554530,20758906,136313436,7,0,1,17408,14,7732950990
5078,115565630,20781447,136347077,8,0,1,54784,12,770562642
5079,115580309,6930868,122511177,0,0,0,41984,6,4508883157
5080,115611690,6929185,122540875,9,0,0,2048,10,7649358296
5081,115635260,20850957,136486217,5,0,1,224256,1,10620124180
5082,115673160,20824374,136497534,7,0,1,26112,14,7112924912
5083,115695190,20806850,136502040,2,0,1,7168,0,8587963635
5084,115702309,20801037,136503346,0,0,1,2048,6,10165231001
5085,115702809,7096046,122798855,5,0,0,195072,1,6754041385
5086,115703299,20801993,136505292,1,0,1,3072,23,5972697111
5087,115722600,20798168,136520768,8,0,1,25088,12,2971569756
5088,115732709,20789365,136522074,1,0,1,2048,23,2553780743
5089,115798040,20725020,136523060,7,0,1,1536,14,2905477693
5090,115812491,20711235,136523726,2,0,1,1024,0,9346811978
5091,115822370,6976843,122799213,4,0,0,512,9,5693651268
5092,115865390,20659962,136525352,6,0,1,2560,19,2970751857
5093,115882890,6916144,122799034,4,0,0,512,9,3408201896
5094,115896320,20630970,136527290,7,0,1,3072,14,4852143176
5095,115922950,20610497,136533447,7,0,1,37376,14,5042700364
5096,115970810,20568327,136539137,7,0,1,2048,14,5092754147
5097,115974060,7041728,123015788,9,0,0,1024,10,1691308432
5098,115979930,20586298,136566228,7,0,1,57344,14,920471620
5099,116010530,20595872,136606402,8,0,1,1536,12,5715348873
5100,116015360,7456791,123472151,4,0,0,39424,9,5605981268
5101,116107509,20618850,136726359,0,0,1,55808,6,918979384
5102,116144121,20680379,136824500,2,0,1,21504,0,10735784867
5103,116162289,7144933,123307222,5,0,0,43008,1,8174103824
5104,116164790,20764528,136929318,7,0,1,17408,14,4605323569
5105,116203040,7158215,123361255,9,0,0,1024,10,9131293849
5106,116222359,7237734,123460093,5,0,0,97792,1,6318846904
5107,116246399,7315578,123561977,5,0,0,36352,1,3825976810
5108,116283399,20692418,136975817,1,0,1,23040,23,8329264868
5109,116332329,20675826,137008155,1,0,1,14336,23,678423907
5110,116375459,7123511,123498970,0,0,0,39936,6,4252158961
5111,116390940,6996731,123387671,9,0,0,512,10,8811758955
5112,116419339,20588847,137008186,0,0,1,6656,6,1877897140
5113,116444829,7301226,123746055,0,0,0,39424,6,6624349904
5114,116456810,20551399,137008209,7,0,1,10752,14,5269374475
5115,116529019,20499408,137028427,1,0,1,1024,23,6713490787
5116,116533969,20494804,137028773,0,0,1,512,6,62083117
5117,116540209,7193811,123734020,5,0,0,55296,1,8788484162
5118,116546319,7475772,124022091,0,0,0,32256,6,3673580545
5119,116583899,20445327,137029226,0,0,1,10240,6,5739384809
5120,116652560,20399516,137052076,2,0,1,2048,0,4670160059
5121,116664740,20391522,137056262,2,0,1,6656,0,1147210748
5122,116697030,7115621,123812651,9,0,0,5632,10,4789949166
5123,116703329,20353284,137056613,1,0,1,9728,23,1669317308
5124,116708460,7469843,124178303,9,0,0,2048,10,8037984080
5125,116770360,7219097,123989457,4,0,0,57344,9,2153493672
5126,116785220,20282561,137067781,7,0,1,5120,14,9956989484
5127,116817900,20653962,137471862,7,0,1,30208,14,7801344593
5128,116837460,20675164,137512624,7,0,1,9216,14,8307735405
5129,116863740,20648907,137512647,7,0,1,28160,14,2535959718
5130,116871610,21022967,137894577,7,0,1,9728,14,6516543758
5131,116875469,7061423,123936892,0,0,0,25088,6,61509953
5132,116894459,7610445,124504904,5,0,0,521216,1,212629423
5133,117027849,20887681,137915530,0,0,1,24064,6,7578259487
5134,117028129,20905568,137933697,0,0,1,4096,6,2092843897
5135,117053859,20885992,137939851,1,0,1,8192,23,9858550318
5136,117139640,6950374,124090014,4,0,0,10752,9,1276974115
5137,117169149,7433769,124602918,0,0,0,216576,6,3223459061
5138,117199979,7435057,124635036,5,0,0,34304,1,1602004814
5139,117225569,20717508,137943077,1,0,1,5120,23,896292012
5140,117225699,20775197,138000896,0,0,1,36864,6,8442693827
5141,117348660,7188247,124536907,4,0,0,104960,9,9988556609
5142,117362919,20652588,138015507,0,0,1,13824,6,6105713700
5143,117456969,7167592,124624561,0,0,0,70656,6,7159046361
5144,117457510,6634304,124091814,9,0,0,1536,10,5027323941
5145,117501200,20572332,138073532,7,0,1,34816,14,8542846995
5146,117551330,20607920,138159250,2,0,1,23552,0,4007968711
5147,117581670,20577603,138159273,7,0,1,2048,14,7342457778
5148,117683191,20476105,138159296,2,0,1,3584,0,6387242754
5149,117684599,20474720,138159319,1,0,1,512,23,7991237799
5150,117717089,6929716,124646805,5,0,0,38400,1,8777680890
5151,117730549,7318810,125049359,0,0,0,289792,6,5912563719
5152,117853581,20305761,138159342,2,0,1,2048,0,6705650968
5153,117856961,20302404,138159365,2,0,1,33280,0,963134203
5154,117875551,20283837,138159388,2,0,1,3584,0,769235478
5155,117876859,7367504,125244363,0,0,0,52224,6,2338864248
5156,117951150,6833639,124784789,9,0,0,512,10,10261182290
5157,117965451,20193960,138159411,2,0,1,14336,0,2383725274
5158,117982069,7401866,125383935,5,0,0,228864,1,6310075540
5159,118033190,6673606,124706796,4,0,0,2560,9,6597173622
5160,118047280,7336842,125384122,9,0,0,512,10,7482084118
5161,118058299,7232138,125290437,5,0,0,151040,1,8556806523
5162,118089531,20088583,138178114,2,0,1,5632,0,6749185712
5163,118097989,20084631,138182620,1,0,1,7168,23,971793527
5164,118120241,20063344,138183585,2,0,1,12800,0,4530763302
5165,118130019,7357409,125487428,5,0,0,117760,1,4070597130
5166,118153921,20139020,138292941,2,0,1,33792,0,4401096834
5167,118183149,20110151,138293300,1,0,1,9728,23,10596687458
5168,118228340,7196486,125424826,4,0,0,1536,9,1574780061
5169,118310929,6777018,125087947,0,0,0,6656,6,10048721750
5170,118311729,6774167,125085896,5,0,0,48640,1,3360470019
5171,118351569,19997590,138349159,1,0,1,13824,23,9722007844
5172,118424349,19932219,138356568,1,0,1,3072,23,4614635755
5173,118454451,19906303,138360754,2,0,1,6656,0,9221924733
5174,118497899,6816273,125314172,5,0,0,77824,1,7320268690
5175,118594929,19814793,138409722,1,0,1,17408,23,3236705322
5176,118632450,6268308,124900758,9,0,0,5632,10,7232694383
5177,118759610,19815802,138575412,5,0,1,68096,1,10279346923
5178,118769179,6771276,125540455,5,0,0,166912,1,10644445998
5179,118809800,6371352,125181152,9,0,0,7680,10,8997184161
5180,118812320,6237998,125050318,9,0,0,3072,10,6826867751
5181,118848789,6562201,125410990,5,0,0,11776,1,5676864616
5182,118853600,6799721,125653321,9,0,0,1536,10,6206908165
5183,118863399,19712036,138575435,1,0,1,8704,23,7476905888
5184,118878160,6533165,125411325,9,0,0,1024,10,335095978
5185,118971109,19604349,138575458,1,0,1,45568,23,7234465522
5186,118984660,6503103,125487763,4,0,0,1024,9,6664772374
5187,119029859,6554289,125584148,5,0,0,79360,1,6237163382
5188,119095879,6652229,125748108,5,0,0,264192,1,1056769443
5189,119160769,6263566,125424335,0,0,0,42496,6,1232391662
5190,119216620,6011808,125228428,9,0,0,2048,10,7895281189
5191,119245439,6189722,125435161,0,0,0,33792,6,10629039820
5192,119268739,19306742,138575481,1,0,1,55296,23,3733721519
5193,119275119,6132260,125407379,5,0,0,75776,1,10509256163
5194,119425849,19152634,138578483,1,0,1,19456,23,10665069550
5195,119443169,6532612,125975781,5,0,0,221184,1,8341322932
5196,119602720,18975778,138578498,3,0,1,5632,28,8538768353
5197,119681590,18896923,138578513,4,0,1,1536,9,10575852702
5198,119682950,18895578,138578528,4,0,1,15360,9,8697025173
5199,119704549,18877597,138582146,1,0,1,5632,23,1710826799
5200,119780409,6331845,126112254,5,0,0,91136,1,1678871930
5201,119789179,18812499,138601678,1,0,1,20480,23,2979298853
5202,119840420,18835492,138675912,4,0,1,30720,9,10535305131
5203,119883280,18846939,138730219,4,0,1,20480,9,4272519427
5204,119935310,18805062,138740372,4,0,1,8704,9,7065492717
5205,120038680,18893631,138932311,4,0,1,19456,9,3028647518
5206,120078000,5578081,125656081,9,0,0,512,10,9541115147
5207,120080420,18851906,138932326,6,0,1,12288,19,7423746422
5208,120143320,5620769,125764089,4,0,0,2560,9,4260196863
5209,120144259,5617600,125761859,5,0,0,45056,1,4502883950
5210,120149590,5459149,125608739,4,0,0,512,9,1363746614
5211,120175909,5641160,125817069,5,0,0,48128,1,145507168
5212,120226600,5395967,125622567,4,0,0,2048,9,770403650
5213,120229099,18723849,138952948,1,0,1,14848,23,3091108610
5214,120229500,18723487,138952987,4,0,1,44544,9,3456596976
5215,120264200,5561422,125825622,4,0,0,1024,9,5061602159
5216,120287710,18668427,138956137,4,0,1,10240,9,1829835258
5217,120299590,5242049,125541639,4,0,0,3584,9,8881922460
5218,120332989,5679668,126012657,0,0,0,71168,6,10690265891
5219,120373020,18583132,138956152,7,0,1,6656,14,1022948661
5220,120493759,5356612,125850371,0,0,0,47104,6,5987116699
5221,120507600,5294782,125802382,9,0,0,5120,10,6734556503
5222,120581400,18374791,138956191,6,0,1,38400,19,4759090738
5223,120585789,18370417,138956206,1,0,1,3584,23,7455809282
5224,120606119,18350102,138956221,1,0,1,18944,23,9626132528
5225,120610270,5153016,125763286,9,0,0,4608,10,7133834091
5226,120643759,18450248,139094007,1,0,1,14336,23,616208686
5227,120647299,5710993,126358292,5,0,0,200704,1,2754857449
5228,120650440,18443582,139094022,4,0,1,35328,9,8408185433
5229,120658850,18435251,139094101,4,0,1,35840,9,791269165
5230,120689069,18405047,139094116,1,0,1,4096,23,6379356441
5231,120722950,18371181,139094131,3,0,1,30720,28,2380308667
5232,120795070,5253700,126048770,4,0,0,3072,9,5740292761
5233,120832369,18261785,139094154,1,0,1,3072,23,3965468788
5234,120837929,18256248,139094177,1,0,1,30208,23,1105688657
5235,120843540,5169296,126012836,9,0,0,512,10,764737285
5236,120853579,5194224,126047803,0,0,0,114688,6,7901894105
5237,120859579,5347517,126207096,5,0,0,21504,1,261857911
5238,120869111,18225081,139094192,9,0,1,14848,10,10178179294
5239,120871700,5242940,126114640,4,0,0,1536,9,301987636
5240,120917989,5454093,126372082,5,0,0,45056,1,5966753769
5241,120964250,5149899,126114149,9,0,0,6144,10,9142728527
5242,121069741,18024474,139094215,2,0,1,17920,0,1451731997
5243,121108011,17986219,139094230,2,0,1,17408,0,3806467940
5244,121126470,4988349,126114819,4,0,0,512,9,8363323914
5245,121144949,5152168,126297117,5,0,0,142336,1,3713078499
5246,121154830,17939415,139094245,6,0,1,6656,19,7410855271
5247,121155511,17938749,139094260,2,0,1,1536,0,4165561858
5248,121169269,17925014,139094283,1,0,1,9216,23,2757484284
5249,121177249,5076477,126253726,0,0,0,81920,6,8987406191
5250,121214040,17981517,139195557,6,0,1,20992,19,3680266364
5251,121235710,17959878,139195588,6,0,1,27136,19,4163695222
5252,121254050,17941561,139195611,6,0,1,27136,19,3925019716
5253,121310900,17884734,139195634,6,0,1,32256,19,2986033679
5254,121318300,5160713,126479013,4,0,0,1024,9,897809968
5255,121321431,17874226,139195657,2,0,1,8704,0,3234520861
5256,121322710,17872962,139195672,6,0,1,1024,19,541976743
5257,121345891,17849796,139195687,2,0,1,43520,0,412945486
5258,121374370,5051329,126425699,4,0,0,1024,9,9256967371
5259,121374521,17821181,139195702,2,0,1,3072,0,9465752435
5260,121412229,17783488,139195717,1,0,1,3072,23,3882241333
5261,121445299,4971580,126416879,0,0,0,38912,6,8356886109
5262,121477870,17746581,139224451,9,0,1,32256,10,7928203361
5263,121485370,5047334,126532704,4,0,0,3072,9,4012631542
5264,121504610,17719856,139224466,4,0,1,512,9,5921290558
5265,121524100,17700381,139224481,9,0,1,9728,10,6262219500
5266,121582421,17642075,139224496,2,0,1,2560,0,2679270485
5267,121589640,17634871,139224511,6,0,1,2048,19,6986789699
5268,121598760,4852013,126450773,9,0,0,1536,10,6515489737
5269,121666080,17558446,139224526,9,0,1,29184,10,5034097909
5270,121791420,5123110,126914530,4,0,0,2560,9,10694089079
5271,121814050,4887743,126701793,9,0,0,1024,10,3406173942
5272,121816741,17407800,139224541,2,0,1,17920,0,9931618243
5273,121858910,17365646,139224556,6,0,1,15360,19,1328985620
5274,121869199,5044505,126913704,0,0,0,258048,6,840695016
5275,121883310,17379811,139263121,9,0,1,91648,10,3631569916
5276,121928899,4772559,126701458,5,0,0,56320,1,3752870499
5277,121939320,17327987,139267307,2,0,1,6656,0,8639054373
5278,121939420,4975289,126914709,9,0,0,512,10,1299670798
5279,121958870,17328502,139287372,4,0,1,4608,9,660595601
5280,121979560,17322581,139302141,7,0,1,41472,14,3620088203
5281,121980730,17332600,139313330,9,0,1,29696,10,6646947529
5282,122033490,17280301,139313791,4,0,1,10240,9,6722618494
5283,122035800,17292675,139328475,7,0,1,4608,14,2870157249
5284,122039471,17300522,139339993,2,0,1,17408,0,9012859964
5285,122069390,17279601,139348991,4,0,1,24576,9,2049461793
5286,122085030,17283507,139368537,6,0,1,23552,19,4402183517
5287,122095431,17287940,139383371,2,0,1,21504,0,1269479201
5288,122144769,4947748,127092517,0,0,0,22016,6,7362475881
5289,122146641,17258393,139405034,2,0,1,24576,0,10558281071
5290,122215129,5001106,127216235,5,0,0,64000,1,3634231186
5291,122220710,4832861,127053571,4,0,0,17408,9,2234423737
5292,122220850,17220126,139440976,6,0,1,64512,19,9618629935
5293,122234169,5119953,127354122,5,0,0,107008,1,6286132928
5294,122262491,17212546,139475037,2,0,1,45056,0,1178866580
5295,122264320,17216525,139480845,4,0,1,20480,9,4551860096
5296,122287070,17222852,139509922,6,0,1,57344,19,1126252146
5297,122321700,17192061,139513761,4,0,1,26624,9,458069383
5298,122333139,5037487,127370626,0,0,0,48640,6,662178217
5299,122350440,17167543,139517983,4,0,1,4608,9,234975154
5300,122402430,17115707,139518137,9,0,1,8704,10,7476268161
5301,122412280,4942021,127354301,4,0,0,512,9,6532279025
5302,122423609,5294506,127718115,5,0,0,238080,1,5553807472
5303,122425990,17106514,139532504,6,0,1,5632,19,2231883382
5304,122429951,17122892,139552843,2,0,1,17408,0,2237634792
5305,122458609,4945624,127404233,5,0,0,12288,1,9507849712
5306,122505371,17068706,139574077,2,0,1,44544,0,9804017198
5307,122510570,4871955,127382525,4,0,0,1536,9,4606292735
5308,122520500,5544569,128065069,4,0,0,4608,9,2548172056
5309,122525410,17048923,139574333,4,0,1,9216,9,10727104866
5310,122558399,4978102,127536501,5,0,0,36352,1,2470261243
5311,122582560,5280975,127863535,4,0,0,304128,9,7188428424
5312,122584719,5186129,127770848,5,0,0,37376,1,9963609379
5313,122622210,16962030,139584240,6,0,1,24576,19,9925036280
5314,122664100,16922406,139586506,4,0,1,3584,9,8893081617
5315,122676010,5290472,127966482,4,0,0,65024,9,10596842592
5316,122688989,5185177,127874166,0,0,0,34816,6,2850830795
5317,122710101,16879119,139589220,2,0,1,14848,0,4202685208
5318,122733920,16856171,139590091,7,0,1,12288,14,1589748252
5319,122736880,16853570,139590450,6,0,1,9728,19,3671018498
5320,122757770,5149370,127907140,9,0,0,17408,10,8657830217
5321,122766260,16827762,139594022,4,0,1,5632,9,1564023030
5322,122793139,5244096,128037235,0,0,0,74240,6,9807703399
5323,122797349,5266293,128063642,5,0,0,38912,1,6415353853
5324,122848341,16750187,139598528,2,0,1,7168,0,6047285257
5325,122874680,5065800,127940480,9,0,0,2048,10,7789537496
5326,122894980,16720804,139615784,6,0,1,17408,19,4339095581
5327,122918261,16702349,139620610,2,0,1,7680,0,919499297
5328,122953789,5318413,128272202,5,0,0,220672,1,9965327642
5329,122978670,16646766,139625436,9,0,1,7680,10,9962583394
5330,123017171,16610531,139627702,9,0,1,3584,10,6917634066
5331,123025700,16605653,139631353,6,0,1,5120,19,7456284012
5332,123026520,16608802,139635322,6,0,1,18944,19,8836692372
5333,123062520,5210485,128273005,9,0,0,2560,10,2767118854
5334,123082450,5122493,128204943,4,0,0,48640,9,5746152969
5335,123087601,16573192,139660793,2,0,1,7168,0,3562928434
5336,123096660,16567415,139664075,8,0,1,14336,12,4975744166
5337,123116950,16553714,139670664,7,0,1,18944,14,5555162253
5338,123119580,16560525,139680105,6,0,1,3584,19,2547171210
5339,123135400,5138252,128273652,9,0,0,2048,10,3433001126
5340,123146950,16535101,139682051,8,0,1,3072,12,9723499840
5341,123169171,16517642,139686813,2,0,1,16384,0,2621960173
5342,123198270,16497943,139696213,7,0,1,14336,14,5236064315
5343,123200490,16514990,139715480,6,0,1,7680,19,7525324230
5344,123240220,16481732,139721952,8,0,1,3072,12,5206109461
5345,123240980,5086439,128327419,9,0,0,1536,10,1211484491
5346,123247691,16477807,139725498,2,0,1,5632,0,5805557959
5347,123274010,16458299,139732309,7,0,1,18944,14,2108708639
5348,123315709,5485898,128801607,0,0,0,545792,6,1247583365
5349,123353230,16380385,139733615,7,0,1,2048,14,9130032042
5350,123359951,16386224,139746175,9,0,1,46080,10,1244871179
5351,123366400,16400074,139766474,7,0,1,7680,14,634996181
5352,123393731,16373089,139766820,2,0,1,512,0,349044260
5353,123432420,16335066,139767486,7,0,1,1024,14,2798278087
5354,123437309,5387687,128824996,0,0,0,60416,6,3659209943
5355,123468449,6131763,129600212,0,0,0,358400,6,2984715835
5356,123471489,5659250,129130739,5,0,0,42496,1,1220200088
5357,123472731,16305371,139778102,2,0,1,41984,0,6814010756
5358,123488290,16295725,139784015,8,0,1,7168,12,655411163
5359,123491320,16300549,139791869,7,0,1,11264,14,5301718542
5360,123572870,16224593,139797463,8,0,1,18432,12,2604456691
5361,123583330,5612418,129195748,9,0,0,1024,10,8523988333
5362,123619281,16202438,139821719,9,0,1,20480,10,8523447436
5363,123636871,16209357,139846228,2,0,1,77824,0,4090887
5364,123637860,16241010,139878870,7,0,1,1536,14,6861156881
5365,123658380,16224676,139883056,9,0,1,6656,10,9313080907
5366,123667630,16215772,139883402,9,0,1,512,10,6886811333
5367,123727950,16156937,139884887,9,0,1,15360,10,5274272814
5368,123730820,16165695,139896515,6,0,1,3584,19,1375264886
5369,123737090,16159771,139896861,9,0,1,512,10,6564653192
5370,123779171,16124053,139903224,2,0,1,30208,0,4468386680
5371,123795980,16152707,139948687,6,0,1,22528,19,482754758
5372,123802750,16163726,139966476,8,0,1,7168,12,791335386
5373,123837329,5836872,129674201,0,0,0,107008,6,1994346638
5374,123842770,16188246,140031016,9,0,1,34304,10,1902490167
5375,123861019,5740035,129601054,0,0,0,2560,6,7505570214
5376,123928671,16102601,140031272,2,0,1,9216,0,8065226534
5377,123950550,16083436,140033986,9,0,1,9216,10,6997211109
5378,123951561,16185082,140136643,2,0,1,2560,0,6157667711
5379,124019170,16117488,140136658,8,0,1,512,12,9876317256
5380,124034760,16101913,140136673,6,0,1,30208,19,191170441
5381,124045790,5417415,129463205,9,0,0,1536,10,9530429063
5382,124047760,16088928,140136688,8,0,1,9216,12,6053040463
5383,124085539,5336267,129421806,0,0,0,5632,6,8410267718
5384,124089581,16047138,140136719,2,0,1,19968,0,1034136030
5385,124097770,16038964,140136734,9,0,1,8192,10,5660246066
5386,124142319,5709774,129852093,0,0,0,68608,6,8148020928
5387,124170160,15966589,140136749,9,0,1,6656,10,1225684267
5388,124174229,5441475,129615704,5,0,0,44032,1,4695945716
5389,124219540,15917224,140136764,7,0,1,13312,14,672025527
5390,124242690,15894089,140136779,6,0,1,2048,19,4206359921
5391,124244809,5932873,130177682,0,0,0,243200,6,2417489658
5392,124270409,5408495,129678904,5,0,0,15360,1,1320181402
5393,124317180,15819614,140136794,7,0,1,34816,14,6874259477
5394,124337030,15799795,140136825,7,0,1,15872,14,4567566016
5395,124352900,5263763,129616663,9,0,0,3072,10,8803421086
5396,124370570,15766270,140136840,9,0,1,8704,10,5913694228
5397,124370840,15773191,140144031,8,0,1,7168,12,4393175376
5398,124377350,15780404,140157754,9,0,1,17408,10,9279501951
5399,124417249,5461727,129878976,5,0,0,6144,1,1544393004
5400,124441549,6378789,130820338,0,0,0,298496,6,4530012048
5401,124442320,15720580,140162900,9,0,1,8192,10,2597879394
5402,124462290,15705436,140167726,6,0,1,7680,19,5972939053
5403,124466581,6428232,130894813,2,0,0,74752,0,159315660
5404,124486270,15682532,140168802,7,0,1,13312,14,3415134657
5405,124489810,15680272,140170082,8,0,1,14336,12,7707387552
5406,124503439,5807642,130311081,5,0,0,2048,1,5421328600
5407,124509379,5799733,130309112,5,0,0,355840,1,2843871153
5408,124521270,15665063,140186333,8,0,1,31232,12,519582742
5409,124526940,15673652,140200592,9,0,1,24064,10,126115302
5410,124565710,15659215,140224925,8,0,1,40960,12,1017557124
5411,124597020,15650758,140247778,8,0,1,36864,12,8896399535
5412,124600160,5253026,129853186,9,0,0,2048,10,6934640489
5413,124630140,15621833,140251973,8,0,1,1536,12,4900947169
5414,124654270,15604040,140258310,6,0,1,18944,19,7114033329
5415,124656060,5654328,130310388,9,0,0,1024,10,3830665922
5416,124660880,15598455,140259335,6,0,1,20992,19,6537629061
5417,124678150,15586102,140264252,8,0,1,1024,12,8087290784
5418,124686560,15579433,140265993,6,0,1,24576,19,5370028332
5419,124732420,5177580,129910000,9,0,0,2560,10,2569109992
5420,124737649,6335455,131073104,5,0,0,150016,1,4103303366
5421,124747029,5809222,130556251,0,0,0,51200,6,9550563770
5422,124754530,15524137,140278667,8,0,1,1536,12,3713579588
5423,124757079,6460395,131217474,5,0,0,87040,1,10293586833
5424,124764400,15548261,140312661,9,0,1,17920,10,1873517121
5425,124767900,15544776,140312676,6,0,1,4608,19,3012163464
5426,124781390,15531301,140312691,8,0,1,512,12,8785125411
5427,124804940,15512629,140317569,8,0,1,24576,12,6190967902
5428,124816290,5582206,130398496,9,0,0,2560,10,4217035055
5429,124820849,5865667,130686516,5,0,0,82432,1,7001796761
5430,124846180,15478456,140324636,3,0,1,23040,28,489286445
5431,124888590,15448440,140337030,6,0,1,28672,19,5237456070
5432,124947460,15398910,140346370,8,0,1,2560,12,5566666695
5433,124959479,5892571,130852050,0,0,0,65024,6,3218892438
5434,124996160,5313755,130309915,9,0,0,2560,10,9989566707
5435,125066499,5653447,130719946,0,0,0,109568,6,4927510872
5436,125089300,15259656,140348956,8,0,1,16384,12,3027434875
5437,125094560,15274987,140369547,4,0,1,5120,9,7979886232
5438,125133789,6161380,131295169,0,0,0,151040,6,1146492473
5439,125133810,5044230,130178040,9,0,0,1024,10,9507500222
5440,125144800,15234508,140379308,3,0,1,23040,28,9164467287
5441,125165290,15220611,140385901,8,0,1,18944,12,6670736028
5442,125175540,5003950,130179490,9,0,0,4608,10,3111973483
5443,125180580,15235880,140416460,4,0,1,39936,9,1044444746
5444,125185760,15243049,140428809,3,0,1,10240,28,1150827673
5445,125225470,15213600,140439070,8,0,1,10752,12,411424082
5446,125233000,15212535,140445535,8,0,1,30720,12,7344593049
5447,125295480,15154561,140450041,9,0,1,7168,10,7735133478
5448,125407270,15046637,140453907,1,0,1,6144,23,901399198
5449,125428140,15028033,140456173,4,0,1,3584,9,4055350165
5450,125437760,15022599,140460359,8,0,1,6656,12,5487633010
5451,125473340,5391161,130864501,9,0,0,1024,10,5543750600
5452,125482980,5473242,130956222,9,0,0,1536,10,8850422214
5453,125489060,14972631,140461691,8,0,1,22528,12,4688809540
5454,125502180,14960817,140462997,6,0,1,2048,19,7537693729
5455,125527690,14937253,140464943,6,0,1,3072,19,6724990420
5456,125538480,14935899,140474379,4,0,1,23552,9,53806390
5457,125577440,14899205,140476645,9,0,1,3584,10,3050923024
5458,125594070,14886605,140480675,4,0,1,5120,9,739950583
5459,125594690,14890491,140485181,8,0,1,7168,12,497507680
5460,125624059,5311882,130935941,0,0,0,46592,6,10002102095
5461,125665349,14819986,140485335,1,0,1,8704,23,9654345450
5462,125682690,14816399,140499089,4,0,1,8704,9,3351264569
5463,125690620,14808828,140499448,6,0,1,9728,19,1528397936
5464,125712701,14789337,140502038,2,0,1,1024,0,6320244500
5465,125723650,14778747,140502397,8,0,1,9728,12,5910902810
5466,125771630,14764244,140535874,4,0,1,36352,9,2075900661
5467,125822140,14714080,140536220,4,0,1,512,9,5990545228
5468,125932340,14604226,140536566,8,0,1,512,12,2145073033
5469,126003820,14551261,140555081,8,0,1,26624,12,5202441108
5470,126074909,4520611,130595520,5,0,0,32768,1,8408569737
5471,126109760,14467019,140576779,9,0,1,27648,10,1531721950
5472,126110900,14519710,140630610,6,0,1,38912,19,4378123113
5473,126178320,14455890,140634210,8,0,1,3584,12,350725326
5474,126264670,14377067,140641737,9,0,1,16384,10,9805058445
5475,126300110,14363017,140663127,9,0,1,57344,10,6241560927
5476,126304160,14442723,140746883,4,0,1,54272,9,2988973149
5477,126316720,14430178,140746898,4,0,1,5120,9,1236077492
5478,126341220,14405693,140746913,4,0,1,20992,9,4095037138
5479,126412380,14334956,140747336,9,0,1,12800,10,8588935670
5480,126452779,4574594,131027373,0,0,0,66560,6,1696788543
5481,126485730,14291637,140777367,8,0,1,25088,12,8529059415
5482,126496110,14298852,140794962,8,0,1,6144,12,7314032871
5483,126555659,4366009,130921668,5,0,0,88064,1,10266253638
5484,126577559,4820768,131398327,5,0,0,73728,1,10371441984
5485,126618309,4572622,131190931,0,0,0,110080,6,3894388126
5486,126706490,14094774,140801264,9,0,1,21504,10,8890419391
5487,126802539,4278544,131081083,0,0,0,26112,6,677005905
5488,126882029,4493811,131375840,5,0,0,78336,1,3209890327
5489,126888890,13914228,140803118,3,0,1,9728,28,8875447917
5490,126920689,4491701,131412390,5,0,0,46080,1,8616045252
5491,127012460,13802004,140814464,8,0,1,26112,12,2205949326
5492,127031790,13812603,140844393,4,0,1,22016,9,1952555549
5493,127051731,13795014,140846745,9,0,1,10240,10,7024084250
5494,127056880,13790736,140847616,4,0,1,12288,9,2296019298
5495,127059840,13793985,140853825,9,0,1,21504,10,4438718766
5496,127068190,13786301,140854491,3,0,1,1024,28,6860281818
5497,127096650,13758353,140855003,8,0,1,18432,12,93930702
5498,127099689,3996470,131096159,0,0,0,43008,6,5831717164
5499,127106390,13768497,140874887,8,0,1,23040,12,7856664671
5500,127110270,13786826,140897096,4,0,1,3072,9,8080974466
5501,127169230,13734323,140903553,8,0,1,29696,12,6763126528
5502,127169609,3913377,131082986,5,0,0,6144,1,10302005163
5503,127202550,13709741,140912291,4,0,1,2560,9,1839377825
5504,127242699,4255475,131498174,0,0,0,47616,6,9822362043
5505,127252780,13681839,140934619,4,0,1,11264,9,1400245972
5506,127259270,13692494,140951764,4,0,1,48128,9,7671527113
5507,127265060,13710545,140975605,4,0,1,27648,9,8124685400
5508,127267881,13709350,140977231,9,0,1,2560,10,1132487014
5509,127285891,13696961,140982852,9,0,1,14336,10,5167497800
5510,127321970,13661446,140983416,4,0,1,10752,9,9595462005
5511,127380399,4196699,131577098,0,0,0,178176,6,7068529498
5512,127383880,13601802,140985682,8,0,1,3584,12,7414007059
5513,127393840,13594428,140988268,9,0,1,4096,10,1948431985
5514,127408189,4296031,131704220,0,0,0,59904,6,3654600596
5515,127491231,13498317,140989548,9,0,1,14336,10,8284748311
5516,127493730,13501515,140995245,8,0,1,18944,12,5448175984
5517,127503571,13527484,141031055,9,0,1,512,10,2516326291
5518,127513549,4456897,131970446,5,0,0,284672,1,6167203004
5519,127580979,13463323,141044302,0,0,1,26624,6,5558954648
5520,127597620,13452526,141050146,8,0,1,16384,12,9250154415
5521,127652469,4118386,131770855,0,0,0,218624,6,2131903885
5522,127661150,13396139,141057289,8,0,1,4096,12,855872292
5523,127701439,4535606,132237045,5,0,0,169984,1,605149078
5524,127768069,13295326,141063395,1,0,1,20992,23,3288049974
5525,127862001,13258021,141120022,9,0,1,48128,10,2939879244
5526,127896301,13223736,141120037,9,0,1,11264,10,8014910501
5527,127936070,4249098,132185168,8,0,0,438784,12,9816809323
5528,127996921,13140991,141137912,9,0,1,40448,10,6021700751
5529,127997351,13141867,141139218,9,0,1,2048,10,9976885415
5530,127998169,4351373,132349542,5,0,0,95232,1,5105102402
5531,128021459,4298942,132320401,0,0,0,236032,6,7844339093
5532,128022020,13130389,141152409,9,0,1,16384,10,8336029208
5533,128091681,13092658,141184339,9,0,1,31232,10,6493142984
5534,128147150,13037804,141184954,9,0,1,18944,10,8354643528
5535,128368799,4325214,132694013,5,0,0,142848,1,4555690427
5536,128542269,4406048,132948317,5,0,0,17408,1,4956464564
5537,128563429,12706164,141269593,0,0,1,139776,6,163627235
5538,128573410,12704495,141277905,9,0,1,6144,10,10707353759
5539,128614289,3922487,132536776,0,0,0,226816,6,3094055757
5540,128681590,12633514,141315104,6,0,1,22528,19,2967062538
5541,128684449,12641531,141325980,0,0,1,19456,6,5104732081
5542,128690059,12644320,141334379,0,0,1,34816,6,5599102783
5543,128714961,12620724,141335685,2,0,1,2048,0,2231262145
5544,128817689,3430634,132248323,0,0,0,36864,6,7629060276
5545,128890301,12450569,141340870,9,0,1,16384,10,1082513936
5546,128927540,12434300,141361840,6,0,1,10240,19,8745035052
5547,128983160,12378695,141361855,0,0,1,6144,6,7625612822
5548,128994409,4225091,133219500,5,0,0,326144,1,8202974134
5549,129027061,12334809,141361870,9,0,1,12800,10,6937029721
5550,129039360,12452903,141492263,5,0,1,142848,1,1755599326
5551,129066021,12471281,141537302,9,0,1,71168,10,3586874153
5552,129097399,4186481,133283880,0,0,0,63488,6,10473845801
5553,129115959,12483777,141599736,1,0,1,10240,23,9670640455
5554,129257010,12342757,141599767,6,0,1,14848,19,3725347177
5555,129294999,12304783,141599782,0,0,1,1024,6,3722619425
5556,129342550,12257247,141599797,3,0,1,18944,28,2608395409
5557,129364110,12244010,141608120,6,0,1,35328,19,10197029193
5558,129410300,12210344,141620644,9,0,1,18944,10,5061525031
5559,129456890,12171002,141627892,6,0,1,7168,19,2327362542
5560,129493099,3306370,132799469,5,0,0,79872,1,50236691
5561,129554740,12077018,141631758,6,0,1,6144,19,5759472312
5562,129648550,11989660,141638210,6,0,1,10240,19,1116900444
5563,129672779,11968977,141641756,0,0,1,5632,6,4062882477
5564,129673980,11971642,141645622,6,0,1,6144,19,88980846
5565,129675959,3787101,133463060,5,0,0,427008,1,3529011874
5566,129704620,11942116,141646736,6,0,1,12288,19,4091322887
5567,129736709,11910693,141647402,0,0,1,11264,6,2758598679
5568,129759890,11908365,141668255,0,0,1,25088,6,4875203022
5569,129761599,11909601,141671200,0,0,1,13824,6,1209306157
5570,129764231,11908595,141672826,2,0,1,2560,0,10385650624
5571,129793050,11899681,141692731,6,0,1,28160,19,8404714041
5572,130085739,2899752,132985491,5,0,0,91648,1,10541819140
5573,130132489,2987546,133120035,0,0,0,167424,6,10298808982
5574,130142619,3116388,133259007,5,0,0,129536,1,5605806658
5575,130151409,11577607,141729016,1,0,1,27648,23,841011982
5576,130157029,3363756,133520785,5,0,0,148992,1,4338048274
5577,130165939,11563538,141729477,0,0,1,10240,6,2586194062
5578,130207889,3468348,133676237,0,0,0,265216,6,3766562014
5579,130232561,11513088,141745649,2,0,1,15872,0,3720113516
5580,130244600,11503635,141748235,6,0,1,4096,19,7827140755
5581,130302349,2962164,133264513,5,0,0,17920,1,7517708532
5582,130311860,11450628,141762488,6,0,1,14336,19,7229414256
5583,130320269,3275043,133595312,0,0,0,244224,6,8612696388
5584,130408619,3066747,133475366,5,0,0,39936,1,8137587883
5585,130443011,11322063,141765074,2,0,1,4096,0,5674211462
5586,130474960,11306354,141781314,6,0,1,10240,19,1385066516
5587,130485929,3227412,133713341,5,0,0,121344,1,10100118686
5588,130555441,11242472,141797913,2,0,1,51200,0,7864735229
5589,130681650,11516357,142198007,5,0,1,571392,1,3177150961
5590,130712140,11491699,142203839,6,0,1,2560,19,5839223664
5591,130712961,11491646,142204607,2,0,1,11776,0,9460727663
5592,130721690,11500967,142222657,6,0,1,22528,19,8384714756
5593,130736350,11500224,142236574,4,0,1,14848,9,5235807486
5594,130738039,2978857,133716896,5,0,0,11264,1,237739030
5595,130755460,11489111,142244571,0,0,1,12288,6,2245879428
5596,130761960,11538229,142300189,0,0,1,22528,6,115511823
5597,130785259,3205766,133991025,5,0,0,110592,1,9385717549
5598,130815480,11484732,142300212,4,0,1,49664,9,8376601363
5599,130908151,11409807,142317958,2,0,1,3072,0,5746797729
5600,130913840,11405091,142318931,4,0,1,12800,9,10092013629
5601,130983889,2772397,133756286,5,0,0,129024,1,310285743
5602,130999399,11340068,142339467,0,0,1,9216,6,9513053556
5603,131016079,11324803,142340882,0,0,1,1536,6,6567518115
5604,131038030,11303825,142341855,6,0,1,12800,19,5138041794
5605,131096569,11254443,142351012,0,0,1,17408,6,10023793840
5606,131107020,11248035,142355055,6,0,1,2048,19,1922941826
5607,131148229,2658196,133806425,5,0,0,63488,1,9031229095
5608,131163819,11197392,142361211,0,0,1,9728,6,2221699599
5609,131217080,11153954,142371034,6,0,1,11776,19,5443546674
5610,131230681,11143901,142374582,2,0,1,5632,0,4278914020
5611,131234729,11154249,142388978,0,0,1,8192,6,2621042443
5612,131238270,11152696,142390966,1,0,1,43008,23,2860030541
5613,131250430,11144806,142395236,7,0,1,21504,14,7706953735
5614,131256000,11150067,142406067,6,0,1,15360,19,7147980986
5615,131312320,11096622,142408942,1,0,1,11776,23,4451272790
5616,131316810,11111248,142428058,7,0,1,45056,14,1730033534
5617,131346439,2650959,133997398,0,0,0,20480,6,3844777422
5618,131405659,11024936,142430595,0,0,1,3584,6,10325506292
5619,131423219,2638786,134062005,5,0,0,211968,1,10008576282
5620,131434541,10996618,142431159,2,0,1,10752,0,1898502240
5621,131443830,11018779,142462609,1,0,1,24576,23,8732241904
5622,131490681,10972594,142463275,2,0,1,11264,0,3018240637
5623,131638920,10826301,142465221,7,0,1,3072,14,826588292
5624,131643331,10842551,142485882,9,0,1,19968,10,7994576133
5625,131669491,10831485,142500976,9,0,1,37376,10,9439524971
5626,131704299,10805208,142509507,0,0,1,3072,6,3955603486
5627,131727459,2339826,134067285,5,0,0,8704,1,9333991949
5628,131736399,2326604,134063003,5,0,0,3072,1,9253848243
5629,131741920,10768458,142510378,7,0,1,12288,14,1671251715
5630,131774609,10743499,142518108,0,0,1,2560,6,1419422395
5631,131788299,10734994,142523293,0,0,1,16384,6,2756105555
5632,131791981,10734938,142526919,9,0,1,21504,10,3033776615
5633,131802950,10728795,142531745,1,0,1,7680,23,9234444835
5634,131820780,10733981,142554761,6,0,1,68608,19,4342964186
5635,131918840,10641208,142560048,1,0,1,16896,23,7136059832
5636,131981560,10632141,142613701,5,0,1,89088,1,6922119216
5637,132028149,2402095,134430244,0,0,0,237568,6,4900993118
5638,132035920,10581571,142617491,1,0,1,15872,23,1178904630
5639,132083510,10755323,142838833,5,0,1,363008,1,5188474816
5640,132117950,10800742,142918692,5,0,1,100864,1,3493627407
5641,132121680,10910980,143032660,5,0,1,93696,1,6979281264
5642,132123280,10909395,143032675,6,0,1,35328,19,10718912541
5643,132141091,10891599,143032690,2,0,1,6656,0,7373118454
5644,132156570,10938739,143095309,5,0,1,142336,1,8244125484
5645,132168441,10935382,143103823,2,0,1,13312,0,7046603762
5646,132235650,10868532,143104182,7,0,1,9728,14,8440987518
5647,132242300,10902061,143144361,7,0,1,58880,14,5194798889
5648,132259459,2186409,134445868,0,0,0,28160,6,1126131286
5649,132269759,2351822,134621581,0,0,0,337408,6,4692221725
5650,132280559,10876246,143156805,0,0,1,22016,6,403348926
5651,132281970,10880327,143162297,0,0,1,17920,6,750318230
5652,132346740,10817183,143163923,0,0,1,2560,6,4046559785
5653,132349891,10817578,143167469,2,0,1,5632,0,2442235941
5654,132399310,11197547,143596857,5,0,1,660992,1,476536448
5655,132408200,11188672,143596872,0,0,1,4096,6,4799843419
5656,132459750,11137137,143596887,5,0,1,43520,1,8666285377
5657,132473050,11137510,143610560,0,0,1,48128,6,9449877396
5658,132475031,11138435,143613466,2,0,1,4608,0,8184524478
5659,132482940,11135813,143618753,1,0,1,16896,23,135906111
5660,132490419,1946846,134437265,0,0,0,22528,6,5902650004
5661,132490560,11133019,143623579,0,0,1,7680,6,10629866349
5662,132506180,11163470,143669650,5,0,1,91648,1,5439514426
5663,132525460,11155507,143680967,7,0,1,26112,14,10336536847
5664,132529630,11152963,143682593,0,0,1,2560,6,10379018231
5665,132539980,11251874,143791854,5,0,1,269312,1,10264362982
5666,132554190,11262099,143816289,1,0,1,16896,23,5025256352
5667,132559551,11258326,143817877,9,0,1,15872,10,2907589306
5668,132569940,11252123,143822063,6,0,1,6656,19,6112135431
5669,132575460,11252212,143827672,0,0,1,13824,6,1789148782
5670,132580090,11393195,143973285,5,0,1,265728,1,4244066390
5671,132584750,11416110,144000860,0,0,1,5120,6,8121297726
5672,132621669,2421889,135043558,0,0,0,368640,6,1696557969
5673,132644000,11366315,144010315,1,0,1,7680,23,6286040691
5674,132665351,11349150,144014501,9,0,1,6656,10,877623601
5675,132675500,11340640,144016140,7,0,1,24064,14,6656884223
5676,132683270,11334176,144017446,6,0,1,2048,19,4717377181
5677,132713800,11338711,144052511,0,0,1,54784,6,3386739030
5678,132715121,11337749,144052870,9,0,1,9728,10,132141159
5679,132724721,11335182,144059903,9,0,1,13824,10,9974453595
5680,132766119,2280651,135046770,5,0,0,4096,1,5408684508
5681,132798211,11262972,144061183,2,0,1,14336,0,9640708241
5682,132952960,11231625,144184585,5,0,1,138752,1,3349888618
5683,132955630,11228970,144184600,1,0,1,36864,23,4242334990
5684,133017820,11182392,144200212,5,0,1,59904,1,662353882
5685,133077719,1999297,135077016,0,0,0,512,6,205853758
5686,133236040,11155422,144391462,5,0,1,244224,1,1323949346
5687,133315210,11079771,144394981,1,0,1,2560,23,345156680
5688,133367739,1691135,135058874,0,0,0,31744,6,10622289173
5689,133395820,11005376,144401196,1,0,1,24576,23,6547638303
5690,133418579,1736969,135155548,0,0,0,210432,6,265200411
5691,133428539,1648298,135076837,5,0,0,58880,1,7332123644
5692,133460111,11075586,144535697,2,0,1,190464,0,7885036208
5693,133486499,1558977,135045476,5,0,0,6144,1,4420583791
5694,133539220,11122854,144662074,2,0,1,185344,0,3850918965
5695,133565120,11204230,144769350,5,0,1,207360,1,2192029331
5696,133588709,1916413,135505122,0,0,0,178176,6,9080768995
5697,133591429,1571965,135163394,0,0,0,25600,6,4475354516
5698,133604580,11316851,144921431,5,0,1,200704,1,7764604770
5699,133635509,1751198,135386707,5,0,0,31232,1,7665508597
5700,133651609,1522618,135174227,0,0,0,35328,6,4849741883
5701,133670790,11468734,145139524,5,0,1,459264,1,10204024944
5702,133677861,11501987,145179848,2,0,1,116736,0,4910418263
5703,133690690,11541024,145231714,5,0,1,88064,1,7253775771
5704,133722360,11510634,145232994,1,0,1,14336,23,397551742
5705,133742169,2233618,135975787,0,0,0,75264,6,9021082031
5706,133831389,1917372,135748761,5,0,0,45056,1,215609327
5707,133867100,11371693,145238793,1,0,1,19456,23,4398703538
5708,133925919,1994534,135920453,0,0,0,207360,6,6299450195
5709,133929609,1772260,135701869,5,0,0,20480,1,852579404
5710,134024009,1650934,135674943,5,0,0,137216,1,1360060568
5711,134031060,11216535,145247595,1,0,1,20992,23,7388392264
5712,134040179,1817071,135857250,0,0,0,78848,6,5101917573
5713,134221140,11027441,145248581,3,0,1,1536,28,1633541634
5714,134223120,11044665,145267785,5,0,1,40960,1,5866272223
5715,134241381,11031691,145273072,9,0,1,16896,10,9420818612
5716,134253261,11056654,145309915,2,0,1,104960,0,344768043
5717,134279501,11104704,145384205,2,0,1,143872,0,1739350678
5718,134308691,11079700,145388391,9,0,1,18944,10,5105500482
5719,134324491,11067766,145392257,9,0,1,6144,10,660856435
5720,134338820,11056983,145395803,7,0,1,5632,14,3211201930
5721,134371250,11031632,145402882,7,0,1,33792,14,7237881174
5722,134382191,11052232,145434423,2,0,1,66560,0,6992150044
5723,134430640,11005012,145435652,7,0,1,22016,14,2240334696
5724,134463370,11005540,145468910,7,0,1,83968,14,2320732890
5725,134472660,11156257,145628917,5,0,1,283136,1,6247183275
5726,134475571,11184408,145659979,2,0,1,84480,0,3520091411
5727,134481090,11244807,145725897,5,0,1,150528,1,9461889541
5728,134514461,11217952,145732413,9,0,1,23040,10,8119596074
5729,134528610,11208949,145737559,8,0,1,8192,12,3276345092
5730,134539310,11339147,145878457,5,0,1,254976,1,1304353909
5731,134546040,11352797,145898837,7,0,1,5120,14,9988517174
5732,134565960,11337703,145903663,3,0,1,7680,28,9354703689
5733,134584161,11323368,145907529,9,0,1,6144,10,6942790599
5734,134600050,11341710,145941760,5,0,1,55808,1,163111320
5735,134601370,11392497,145993867,5,0,1,152064,1,7510408359
5736,134624860,11400544,146025404,3,0,1,32256,28,4018847153
5737,134639860,11435167,146075027,5,0,1,51712,1,7459812923
5738,134648730,11426643,146075373,7,0,1,512,14,10019487769
5739,134657471,11456446,146113917,2,0,1,36864,0,3953959161
5740,134681679,1431512,136113191,0,0,0,21504,6,3573783728
5741,134697809,1475355,136173164,5,0,0,110080,1,6489857493
5742,134705360,11410503,146115863,4,0,1,3072,9,7932297432
5743,134712281,11403928,146116209,9,0,1,512,10,800075132
5744,134756999,11362564,146119563,4,0,1,14336,9,6291756968
5745,134757019,1284511,136041530,5,0,0,74240,1,7212211933
5746,134834780,11398493,146233273,5,0,1,277504,1,9881690992
5747,134842060,11399026,146241086,5,0,1,36864,1,4730772240
5748,134852731,11461442,146314173,2,0,1,38400,0,4300119753
5749,134950960,11373955,146324915,5,0,1,69120,1,2430696115
5750,135012829,1052147,136064976,0,0,0,76800,6,8883493387
5751,135013280,11330363,146343643,4,0,1,23552,9,1316159644
5752,135033330,11352072,146385402,3,0,1,49664,28,5655560925
5753,135073750,11646851,146720601,5,0,1,582656,1,6169348711
5754,135081241,11639514,146720755,9,0,1,8704,10,599713721
5755,135089351,11678636,146767987,2,0,1,68096,0,7702905068
5756,135121410,11648523,146769933,4,0,1,3072,9,6423338108
5757,135135990,11635428,146771418,7,0,1,15360,14,662515153
5758,135160320,11638033,146798353,7,0,1,68096,14,10037127086
5759,135190631,11951256,147141887,2,0,1,576512,0,2748188235
5760,135222120,11921073,147143193,4,0,1,2048,9,9173591115
5761,135257250,11900845,147158095,4,0,1,39936,9,798202329
5762,135266410,11892991,147159401,4,0,1,2048,9,10109546170
5763,135279060,11921442,147200502,7,0,1,84992,14,8117343107
5764,135282301,11921427,147203728,9,0,1,5120,10,6694102193
5765,135301860,11903174,147205034,7,0,1,2048,14,6431673359
5766,135306921,11898267,147205188,9,0,1,8704,10,7376402237
5767,135309549,2361923,137671472,5,0,0,175616,1,8753529157
5768,135339771,11897768,147237539,2,0,1,104448,0,7745181549
5769,135346810,11895875,147242685,4,0,1,8192,9,5764610196
5770,135365439,11887866,147253305,4,0,1,18432,9,10486277008
5771,135366319,2098157,137464476,5,0,0,366592,1,10544257252
5772,135368110,11913119,147281229,7,0,1,28160,14,3527374769
5773,135384770,11897765,147282535,9,0,1,2048,10,6954416758
5774,135414200,11870281,147284481,6,0,1,3072,19,4931229328
5775,135421309,1586823,137008132,0,0,0,105984,6,8379432772
5776,135464110,11820627,147284737,1,0,1,9216,23,2754006692
5777,135503640,11783363,147287003,1,0,1,3584,23,2910406207
5778,135506849,2099998,137606847,5,0,0,100352,1,208967728
5779,135543340,11751780,147295120,9,0,1,20992,10,9294290967
5780,135543660,11791683,147335343,5,0,1,112640,1,1821133580
5781,135554320,11782099,147336419,7,0,1,13312,14,6758298901
5782,135600559,1203119,136803678,5,0,0,5120,1,1356082029
5783,135622560,11714525,147337085,9,0,1,1024,10,7983344872
5784,135631329,1881272,137512601,0,0,0,133632,6,2069074212
5785,135649980,11688283,147338263,9,0,1,13824,10,9444364728
5786,135653199,1674419,137327618,5,0,0,451072,1,3623490546
5787,135697231,11657969,147355200,2,0,1,52736,0,5887502564
5788,135699240,11659186,147358426,1,0,1,5120,23,4717738020
5789,135702860,11691134,147393994,5,0,1,57344,1,8328370780
5790,135703219,1858123,137561342,5,0,0,159744,1,8048936114
5791,135708450,11714025,147422475,7,0,1,5120,14,7894352379
5792,135719339,1256455,136975794,0,0,0,113664,6,9349674374
5793,135748690,11674131,147422821,7,0,1,512,14,8508787255
5794,135752961,11672280,147425241,9,0,1,12288,10,8328772683
5795,135822260,11605887,147428147,1,0,1,4608,23,5846642221
5796,135845051,11596282,147441333,2,0,1,54784,0,9907554926
5797,135856660,11588002,147444662,1,0,1,17920,23,7446201984
5798,135870200,11574808,147445008,3,0,1,512,28,3536964334
5799,135879440,11577832,147457272,5,0,1,50176,1,3041840854
5800,135899100,11580862,147479962,1,0,1,17408,23,1783941537
5801,135910331,11899244,147809575,2,0,1,345600,0,4572343840
5802,135918040,11891550,147809590,7,0,1,14336,14,8666718608
5803,136026800,11782845,147809645,5,0,1,82432,1,1441138410
5804,136060650,11749010,147809660,3,0,1,4608,28,5417298531
5805,136112830,11711101,147823931,3,0,1,49152,28,10470541773
5806,136124270,11705409,147829679,3,0,1,27136,28,9699497946
5807,136213600,11628771,147842371,1,0,1,32256,23,2911922761
5808,136264199,1736674,138000873,5,0,0,152576,1,2974390663
5809,136273631,11588771,147862402,9,0,1,54272,10,2155096404
5810,136274210,11659111,147933321,5,0,1,163328,1,8166185818
5811,136281530,11672258,147953788,7,0,1,1024,14,7246595925
5812,136288790,11665664,147954454,7,0,1,1024,14,4314398390
5813,136305369,1270839,137576208,0,0,0,2560,6,9986573787
5814,136326220,11629220,147955440,3,0,1,1536,28,4893227178
5815,136333339,11628207,147961546,1,0,1,20992,23,5174359022
5816,136359960,11606412,147966372,1,0,1,19968,23,1496770692
5817,136406550,11562728,147969278,4,0,1,4608,9,203502965
5818,136411420,11559689,147971109,9,0,1,15872,10,2351992897
5819,136444291,11540706,147984997,2,0,1,34816,0,7005210980
5820,136449669,903088,137352757,0,0,0,82432,6,9557291635
5821,136527610,11483725,148011335,9,0,1,43008,10,2576502761
5822,136528519,639943,137168462,0,0,0,1024,6,4860338557
5823,136570839,1588388,138159227,0,0,0,178688,6,2111217236
5824,136578599,893232,137471831,0,0,0,24064,6,6684572185
5825,136637851,11388739,148026590,2,0,1,23552,0,2182803830
5826,136653039,922366,137575405,5,0,0,46080,1,6792381928
5827,136746521,11347263,148093784,2,0,1,183808,0,10462903117
5828,136835410,11275150,148110560,4,0,1,1024,9,8211996025
5829,136847729,863702,137711431,0,0,0,131072,6,794958469
5830,136878320,11238807,148117127,7,0,1,31232,14,6653550452
5831,136881300,11253470,148134770,1,0,1,30208,23,7221951966
5832,136888130,11250669,148138799,7,0,1,5632,14,3435824808
5833,136972850,11168855,148141705,7,0,1,4608,14,8474074741
5834,136993480,11156375,148149855,1,0,1,13824,23,4721415339
5835,137007989,1234084,138242073,5,0,0,152064,1,9597941825
5836,137014290,11136871,148151161,1,0,1,2048,23,7885548584
5837,137030150,11125197,148155347,1,0,1,6656,23,1323327344
5838,137030410,11129297,148159707,1,0,1,29184,23,174854433
5839,137074959,1500430,138575389,5,0,0,415744,1,7084298620
5840,137085400,11104554,148189954,3,0,1,70144,28,673675969
5841,137088639,1843657,138932296,5,0,0,628736,1,7253922204
5842,137146050,11047284,148193334,1,0,1,13824,23,7382643884
5843,137161549,1794573,138956122,5,0,0,10240,1,7493592168
5844,137179680,11014422,148194102,4,0,1,11776,9,4085934132
5845,137235060,10963868,148198928,1,0,1,7680,23,8054285954
5846,137248951,10977240,148226191,2,0,1,55808,0,2730962953
5847,137269889,1312242,138582131,0,0,0,11776,6,6860085252
5848,137272060,10959773,148231833,3,0,1,9728,28,4198106823
5849,137284360,10952619,148236979,8,0,1,8192,12,2859989819
5850,137301930,10935715,148237645,7,0,1,11264,14,2439990426
5851,137321529,1256939,138578468,5,0,0,9728,1,9172861173
5852,137340301,11121183,148461484,2,0,1,415744,0,9758937805
5853,137374590,11100931,148475521,4,0,1,4096,9,242502846
5854,137400580,11081611,148482191,4,0,1,31744,9,1879985952
5855,137423150,11064142,148487292,7,0,1,2048,14,2884060848
5856,137532770,10956148,148488918,6,0,1,2560,19,9597932719
5857,137567260,10923022,148490282,7,0,1,1536,14,4397603839
5858,137603660,10888888,148492548,3,0,1,3584,28,9160001564
5859,137618690,10883229,148501919,8,0,1,23040,12,4607848254
5860,137635851,10869333,148505184,9,0,1,14336,10,3231210006
5861,137658660,10856855,148515515,4,0,1,19968,9,9409586341
5862,137701419,1392573,139093992,0,0,0,452096,6,4084419175
5863,137748060,10777049,148525109,6,0,1,18944,19,9983596348
5864,137796100,10732555,148528655,6,0,1,5632,19,9760780233
5865,137825770,10704831,148530601,4,0,1,3072,9,8943426068
5866,137856929,772484,138629413,0,0,0,47616,6,6631984350
5867,137877550,10653819,148531369,1,0,1,11776,23,6405029641
5868,137907490,10629064,148536554,3,0,1,16384,28,4601078934
5869,138002890,10536790,148539680,3,0,1,12288,28,8020387363
5870,138009090,10540136,148549226,9,0,1,37888,10,5586605286
5871,138043990,10516315,148560305,3,0,1,13824,28,6195810212
5872,138069259,1126283,139195542,0,0,0,332288,6,7204833184
5873,138073520,10494547,148568067,3,0,1,25600,28,5434754526
5874,138108390,10463904,148572294,1,0,1,5632,23,1901222196
5875,138126091,10446664,148572755,9,0,1,10240,10,567497436
5876,138176609,776324,138952933,0,0,0,67584,6,4665800736
5877,138177360,10419282,148596642,9,0,1,46080,10,6015615167
5878,138191580,10419980,148611560,3,0,1,14848,28,8459780069
5879,138242359,982077,139224436,0,0,0,94208,6,4389637922
5880,138275270,10345622,148620892,1,0,1,14848,23,10325602317
5881,138286590,10334968,148621558,5,0,1,1024,1,623862512
5882,138289450,10334260,148623710,9,0,1,26624,10,9689435266
5883,138297310,10342526,148639836,9,0,1,1024,10,10406424868
5884,138382100,10266211,148648311,5,0,1,25088,1,9212176146
5885,138433720,10219737,148653457,1,0,1,8192,23,9095388490
5886,138446080,10214430,148660510,1,0,1,30720,23,1678514081
5887,138462440,10205428,148667868,1,0,1,4096,23,2412239756
5888,138501750,10223671,148725421,5,0,1,128000,1,7983273813
5889,138504030,10304878,148808908,5,0,1,38400,1,148079558
5890,138575340,10234874,148810214,6,0,1,2048,19,7536542222
5891,138600520,10401158,149001678,5,0,1,211456,1,9472377254
5892,138739000,10262693,149001693,6,0,1,4608,19,5957564013
5893,138772881,10228827,149001708,2,0,1,13824,0,8529004213
5894,138800491,10456973,149257464,2,0,1,571904,0,9517380279
5895,138814420,10462560,149276980,5,0,1,62976,1,5854655201
5896,138865970,10428601,149294571,1,0,1,11264,23,2701146963
5897,138871600,10426197,149297797,1,0,1,5120,23,9352520147
5898,138871960,10433556,149305516,3,0,1,24576,28,8891950544
5899,138908231,10494333,149402564,2,0,1,243200,0,7754379212
5900,138935990,10510063,149446053,3,0,1,89600,28,250247586
5901,138991400,10461425,149452825,6,0,1,10752,19,2312341650
5902,138996950,10456221,149453171,1,0,1,512,23,11553840
5903,139015200,10441517,149456717,6,0,1,5632,19,8256286525
5904,139044980,10415283,149460263,6,0,1,5632,19,6684849500
5905,139066801,10459892,149526693,2,0,1,163328,0,195036199
5906,139067790,10460286,149528076,6,0,1,14848,19,5633841752
5907,139072740,10476647,149549387,6,0,1,24064,19,9245069914
5908,139078479,582299,139660778,0,0,0,54272,6,9699625668
5909,139107080,10480566,149587646,5,0,1,91136,1,9469037847
5910,139109660,10489892,149599552,1,0,1,40448,23,1042192401
5911,139153290,10476539,149629829,5,0,1,63488,1,8311456920
5912,139155310,10475550,149630860,3,0,1,1536,28,8989697431
5913,139186010,10451234,149637244,3,0,1,28672,28,6986986398
5914,139208670,10458792,149667462,1,0,1,22016,23,5066450092
5915,139248020,10421434,149669454,1,0,1,3072,23,2817250678
5916,139344130,10415167,149759297,5,0,1,216064,1,9671696638
5917,139369120,10410995,149780115,1,0,1,48128,23,3044575753
5918,139370640,10413661,149784301,3,0,1,6656,28,7781662619
5919,139389050,10396877,149785927,1,0,1,2560,23,1234238413
5920,139419731,10517409,149937140,2,0,1,337408,0,7187078394
5921,139443980,10493826,149937806,6,0,1,11264,19,2938762830
5922,139472321,10692275,150164596,2,0,1,506368,0,5282430625
5923,139505309,631319,140136628,0,0,0,223232,6,2634474729
5924,139541669,526928,140068597,0,0,0,105472,6,8845972187
5925,139602521,10577375,150179896,2,0,1,48128,0,2303834435
5926,139619730,10561242,150180972,0,0,1,13312,6,8094291116
5927,139626380,10567817,150194197,1,0,1,10240,23,9644543026
5928,139683731,10536529,150220260,2,0,1,69632,0,7912802295
5929,139712940,10507666,150220606,0,0,1,512,6,4227603400
5930,139737929,574717,140312646,0,0,0,61440,6,8233153272
5931,139856110,10375903,150232013,0,0,1,37888,6,2354981445
5932,139878320,10356763,150235083,9,0,1,4096,10,2405332383
5933,139904300,10331756,150236056,9,0,1,12800,10,1369020608
5934,139908880,10327522,150236402,0,0,1,512,6,3487501488
5935,139940011,10297057,150237068,9,0,1,1024,10,8027716767
5936,139968870,10274304,150243174,9,0,1,20992,10,6501434708
5937,140036270,10241734,150278004,5,0,1,87552,1,9480243787
5938,140051770,10229852,150281622,0,0,1,11264,6,10691907871
5939,140070121,10296170,150366291,2,0,1,167936,0,1598560189
5940,140108871,10366177,150475048,2,0,1,266240,0,37997237
5941,140110350,10399859,150510209,0,0,1,56832,6,1635293069
5942,140166839,470592,140637431,0,0,0,8192,6,1144815001
5943,140181540,10330642,150512182,0,0,1,11776,6,7022932728
5944,140217820,10333375,150551195,5,0,1,65024,1,4974953858
5945,140237780,10324665,150562445,0,0,1,17408,6,8274327900
5946,140293630,10315681,150609311,5,0,1,118272,1,9960407816
5947,140340171,10287301,150627472,2,0,1,40448,0,4188670313
5948,140388479,358381,140746860,0,0,0,165888,6,8081979927
5949,140423890,10210341,150634231,0,0,1,18432,6,3296584320
5950,140423980,10222465,150646445,0,0,1,36352,6,9993451778
5951,140544330,10124886,150669216,9,0,1,52224,10,10106908639
5952,140566180,10103395,150669575,8,0,1,9728,12,3861894940
5953,140583020,10096405,150679425,5,0,1,5120,1,8469642865
5954,140676550,10007428,150683978,8,0,1,11264,12,914392015
5955,140685340,10000123,150685463,9,0,1,15360,10,1779040733
5956,140686941,10031634,150718575,2,0,1,81408,0,2717386453
5957,140705639,414368,141120007,0,0,0,130048,6,2478262729
5958,140749990,9973731,150723721,8,0,1,8192,12,7085485879
5959,140765001,9963905,150728906,9,0,1,16384,10,7715358806
5960,140852130,9888990,150741120,8,0,1,23552,12,2679150397
5961,140898399,463426,141361825,0,0,0,55296,6,5854271366
5962,140902699,495050,141397749,0,0,0,98304,6,1526986535
5963,140932561,9811145,150743706,9,0,1,4096,10,9043601896
5964,140961530,9786516,150748046,6,0,1,15360,19,9851133323
5965,140971351,155515,141126866,3,0,0,7680,28,10645635582
5966,141119531,9633904,150753435,9,0,1,17408,10,3736751771
5967,141125711,9857598,150983309,2,0,1,457728,0,3533456178
5968,141168381,9977565,151145946,2,0,1,406016,0,856935629
5969,141177869,421828,141599697,5,0,0,186880,1,1846523577
5970,141195320,9957244,151152564,0,0,1,15872,6,5342404556
5971,141217160,9941252,151158412,0,0,1,9728,6,7423251282
5972,141261881,9909463,151171344,9,0,1,23040,10,8120657274
5973,141298929,482370,141781299,0,0,0,50176,6,7760839158
5974,141440471,9868683,151309154,2,0,1,348672,0,10560398449
5975,141496980,9818760,151315740,8,0,1,28160,12,3458566052
5976,141508560,9820639,151329199,0,0,1,3072,6,7529172373
5977,141562340,9767218,151329558,6,0,1,9728,19,946610936
5978,141577701,9765654,151343355,2,0,1,40960,0,8328903950
5979,141586969,368063,141955032,0,0,0,48128,6,7064759678
5980,141663071,119745,141782816,3,0,0,4096,28,7049654990
5981,141679119,442056,142121175,0,0,0,88576,6,4952232549
5982,141683921,359112,142043033,3,0,0,3072,28,5448636734
5983,141700941,9651873,151352814,9,0,1,13312,10,10389323396
5984,141709030,9667984,151377014,0,0,1,34816,6,8360233509
5985,141772110,9609418,151381528,6,0,1,15360,19,5476892490
5986,141782029,518145,142300174,0,0,0,180224,6,1534507417
5987,141790781,207948,141998729,3,0,0,512,28,5809737619
5988,141828620,9553894,151382514,6,0,1,1536,19,2885145060
5989,141867511,185501,142053012,3,0,0,1024,28,9750707054
5990,141869831,9647130,151516961,2,0,1,336384,0,10429511741
5991,141870760,9666240,151537000,7,0,1,5632,14,3039909110
5992,141906720,9641007,151547727,8,0,1,27648,12,1064856537
5993,141940840,9610113,151550953,0,0,1,5120,6,339359410
5994,141970821,9582398,151553219,2,0,1,3584,0,10669026407
5995,141999260,9556724,151555984,6,0,1,29696,19,6010985633
5996,142057771,9527782,151585553,2,0,1,35328,0,1046914723
5997,142082681,9504178,151586859,9,0,1,2048,10,5269489162
5998,142101481,9488284,151589765,9,0,1,4608,10,10647974900
5999,142125379,263584,142388963,0,0,0,35328,6,6864371235
6000,142164400,9426031,151590431,0,0,1,1024,6,6357912602
6001,142184520,9410737,151595257,6,0,1,7680,19,1615635992
6002,142208800,9388403,151597203,0,0,1,3072,6,4136273585
6003,142219250,9383099,151602349,6,0,1,8192,19,3310796015
6004,142220981,9384095,151605076,2,0,1,13824,0,4896382986
6005,142260430,9347232,151607662,0,0,1,4096,6,5012894481
6006,142345171,9274321,151619492,2,0,1,43520,0,4096940589
6007,142351690,9267956,151619646,9,0,1,8704,10,9398625518
6008,142371100,9251132,151622232,9,0,1,4096,10,8421701989
6009,142374551,273054,142647605,3,0,0,2048,28,1065142576
6010,142382340,9245935,151628275,9,0,1,19456,10,345504187
6011,142398690,9231173,151629863,8,0,1,15872,12,1739364509
6012,142411149,505658,142916807,0,0,0,57344,6,1849373504
6013,142426150,9211676,151637826,8,0,1,20480,12,3548951070
6014,142522730,9130171,151652901,9,0,1,33792,10,2708681499
6015,142534890,9130124,151665014,0,0,1,14336,6,8854532316
6016,142554340,9120326,151674666,0,0,1,15360,6,9806368301
6017,142564630,9113160,151677790,9,0,1,16896,10,1919552026
6018,142569130,9110913,151680043,9,0,1,27136,10,8666811365
6019,142589981,166528,142756509,3,0,0,1024,28,8764914462
6020,142600890,9083383,151684273,0,0,1,2048,6,3016150390
6021,142614020,418625,143032645,1,0,0,137728,23,7578373676
6022,142628920,9058579,151687499,0,0,1,5120,6,5302508262
6023,142645381,9042464,151687845,2,0,1,512,0,198119484
6024,142731021,192212,142923233,3,0,0,4096,28,6934132459
6025,142777370,8910834,151688204,7,0,1,9728,14,6733574819
6026,142862590,8826307,151688897,0,0,1,9216,6,4998849756
6027,142957930,8736254,151694184,0,0,1,16896,6,176554015
6028,143027390,8669726,151697116,6,0,1,4608,19,2017256412
6029,143037060,8661439,151698499,0,0,1,14848,6,6497916076
6030,143054741,8660311,151715052,2,0,1,24576,0,649992612
6031,143057791,8663892,151721683,2,0,1,23552,0,7770505901
6032,143079681,110391,143190072,3,0,0,1024,28,2446581848
6033,143101680,8636522,151738202,6,0,1,15872,19,2202463341
6034,143104281,323190,143427471,3,0,0,2048,28,3933169844
6035,143233719,363115,143596834,0,0,0,167424,6,5377008014
6036,143247870,8490678,151738548,8,0,1,512,12,1028389142
6037,143263870,8482527,151746397,6,0,1,45568,19,9229328322
6038,143265681,275024,143540705,3,0,0,2048,28,7222525585
6039,143275960,8495477,151771437,7,0,1,56832,14,9938288899
6040,143375860,8398713,151774573,0,0,1,3584,6,7167659995
6041,143399430,8388575,151788005,8,0,1,17408,12,6527541928
6042,143405720,8386151,151791871,6,0,1,6144,19,43211664
6043,143407380,8386757,151794137,0,0,1,3584,6,9336256491
6044,143407709,196364,143604073,0,0,0,10240,6,8525473569
6045,143439500,8359463,151798963,6,0,1,7680,19,1501191977
6046,143443220,8361605,151804825,0,0,1,20480,6,8157674912
6047,143454740,8372035,151826775,0,0,1,27648,6,3108893677
6048,143472251,316315,143788566,3,0,0,11776,28,7521364827
6049,143479681,296040,143775721,3,0,0,7680,28,2599986441
6050,143508970,8320071,151829041,0,0,1,3584,6,2176563778
6051,143560740,8306213,151866953,0,0,1,56832,6,6720400503
6052,143579690,8290466,151870156,0,0,1,9728,6,7240345862
6053,143637629,546941,144184570,0,0,0,131584,6,2015225190
6054,143641679,328890,143970569,0,0,0,3584,6,25271671
6055,143687981,8186144,151874125,2,0,1,20480,0,7124717574
6056,143703960,8185933,151889893,6,0,1,16896,19,7256242784
6057,143739830,8156164,151895994,6,0,1,20480,19,5174731532
6058,143743600,8154833,151898433,1,0,1,13824,23,4821912386
6059,143767090,8157476,151924566,1,0,1,49664,23,7294835961
6060,143819670,8130015,151949685,1,0,1,17408,23,8543137909
6061,143863641,162971,144026612,3,0,0,6144,28,6436491923
6062,143912700,8042131,151954831,0,0,1,8192,6,948777890
6063,143919680,8051608,151971288,4,0,1,24576,9,2407538684
6064,143974599,374548,144349147,0,0,0,112128,6,9484135032
6065,144041879,428211,144470090,0,0,0,138752,6,1518408283
6066,144048110,7924164,151972274,1,0,1,1536,23,202376544
6067,144082529,543229,144625758,0,0,0,158720,6,4292255234
6068,144084640,7889580,151974220,4,0,1,3072,9,656090868
6069,144135600,7842486,151978086,6,0,1,6144,19,8465912365
6070,144139400,7847217,151986617,1,0,1,11776,23,2717544732
6071,144173830,7816333,151990163,4,0,1,5632,9,10050197339
6072,144224600,7771567,151996167,5,0,1,28672,1,8742506340
6073,144255840,7744029,151999869,6,0,1,20992,19,8985281413
6074,144267729,359308,144627037,0,0,0,4096,6,8297427137
6075,144314320,7693638,152007958,0,0,1,4608,6,3617069834
6076,144385489,508521,144894010,0,0,0,177152,6,860722984
6077,144468680,7542904,152011584,6,0,1,8704,19,6054791420
6078,144556421,194810,144751231,3,0,0,3072,28,1534925422
6079,144587270,7455453,152042723,0,0,1,30720,6,1231048841
6080,144599460,7444827,152044287,6,0,1,6144,19,631289194
6081,144694520,7368461,152062981,6,0,1,40448,19,754935599
6082,144699310,7388561,152087871,4,0,1,26624,9,1293852183
6083,144721699,7366531,152088230,4,0,1,9728,9,9645059209
6084,144736330,7400521,152136851,4,0,1,69120,9,6293967354
6085,144793330,7344801,152138131,6,0,1,14336,19,7671275641
6086,144854041,257761,145111802,3,0,0,9216,28,3596605619
6087,144949190,7190887,152140077,4,0,1,3072,9,7101299889
6088,145114490,7049037,152163527,6,0,1,32256,19,6894399258
6089,145153519,374032,145527551,0,0,0,24064,6,4325556900
6090,145259771,118194,145377965,3,0,0,1536,28,10176423473
6091,145270490,6897042,152167532,4,0,1,2560,9,6344662747
6092,145347610,6820588,152168198,6,0,1,11264,19,398877586
6093,145413920,6767541,152181461,4,0,1,32256,9,7450475664
6094,145446019,359082,145805101,0,0,0,76288,6,1136307908
6095,145539310,6645697,152185007,6,0,1,5632,19,3452376057
6096,145541930,6643845,152185775,6,0,1,11776,19,4826341004
6097,145586780,6605511,152192291,6,0,1,23040,19,9642756482
6098,145599299,714859,146314158,0,0,0,227328,6,7881240200
6099,145608149,241530,145849679,0,0,0,79872,6,4794715191
6100,145833890,6380686,152214576,6,0,1,32768,19,7893177913
6101,145874640,6363117,152237757,6,0,1,30720,19,8540790317
6102,145969791,215377,146185168,3,0,0,7168,28,2133316810
6103,146050579,417287,146467866,0,0,0,29184,6,1920654453
6104,146072420,6167283,152239703,4,0,1,3072,9,5495082675
6105,146105749,595531,146701280,0,0,0,290304,6,272286997
6106,146133350,6136687,152270037,4,0,1,76800,9,9808711238
6107,146147401,375243,146522644,3,0,0,3584,28,951180757
6108,146203370,6094873,152298243,6,0,1,46080,19,8845439347
6109,146299200,6013925,152313125,3,0,1,10240,28,8173166413
6110,146322300,5993091,152315391,4,0,1,3584,9,7223716691
6111,146348730,5985735,152334465,6,0,1,38912,19,10438711258
6112,146360060,5976991,152337051,4,0,1,4096,9,10413508035
6113,146387090,5951907,152338997,4,0,1,3072,9,1163140144
6114,146451041,252438,146703479,3,0,0,7168,28,5544140993
6115,146468391,5897518,152365909,2,0,1,50176,0,1057106775
6116,146470500,5899080,152369580,6,0,1,5120,19,10694436219
6117,146507260,5902497,152409757,4,0,1,63488,9,3178554591
6118,146592889,470098,147062987,0,0,0,214528,6,9560987564
6119,146707770,5707008,152414778,4,0,1,11776,9,4759781256
6120,146710741,353041,147063782,3,0,0,2560,28,8118428091
6121,146815231,319699,147134930,3,0,0,1536,28,3913530323
6122,147032120,5383017,152415137,3,0,1,9728,28,724467240
6123,147047870,5368573,152416443,4,0,1,2048,9,118987560
6124,147126891,310171,147437062,3,0,0,3072,28,92194970
6125,147207261,274381,147481642,3,0,0,1536,28,9053071025
6126,147220430,5202426,152422856,8,0,1,7168,12,7261207709
6127,147232730,5192174,152424904,5,0,1,26112,1,6779667361
6128,147270570,5156600,152427170,5,0,1,3584,1,2423536152
6129,147270579,538981,147809560,0,0,0,305152,6,9582599470
6130,147271780,5158616,152430396,5,0,1,5120,1,3457804607
6131,147272000,5159827,152431827,5,0,1,512,1,4655383623
6132,147323260,5110193,152433453,4,0,1,2560,9,8614627693
6133,147458060,4978619,152436679,6,0,1,5120,19,4401972580
6134,147546130,4891727,152437857,5,0,1,13824,1,5815575640
6135,147561370,4883601,152444971,8,0,1,13824,12,5012852331
6136,147579460,4904177,152483637,5,0,1,45056,1,632373001
6137,147630841,304573,147935414,3,0,0,1024,28,3339893038
6138,147638960,4845138,152484098,8,0,1,10240,12,7439535362
6139,147666191,285851,147952042,3,0,0,2048,28,3155415715
6140,147682310,4803094,152485404,5,0,1,2048,1,1531654262
6141,147758651,323778,148082429,3,0,0,1536,28,10422199715
6142,147765520,4748894,152514414,5,0,1,44032,1,2797755261
6143,147780441,176053,147956494,3,0,0,1536,28,4639695269
6144,147782780,4743724,152526504,8,0,1,5632,12,1104995540
6145,147783710,4744420,152528130,5,0,1,2560,1,224991269
6146,147792850,4747371,152540221,5,0,1,34816,1,1483019463
6147,147801631,385509,148187140,3,0,0,5632,28,3889274362
6148,147815160,4739497,152554657,8,0,1,16896,12,9428326859
6149,147830230,4732198,152562428,5,0,1,32768,1,2633680227
6150,147839920,4722662,152562582,5,0,1,8704,1,2575331529
6151,147880110,4685058,152565168,4,0,1,16384,9,8296622880
6152,147887390,4679724,152567114,4,0,1,3072,9,7982771442
6153,147910150,4663275,152573425,4,0,1,22016,9,3292015459
6154,147924110,4691100,152615210,4,0,1,33792,9,9510297213
6155,147975330,4654081,152629411,5,0,1,38912,1,6808110712
6156,147977880,4655077,152632957,5,0,1,5632,1,4716803135
6157,148003810,4636559,152640369,5,0,1,11776,1,7048135760
6158,148045630,4599245,152644875,4,0,1,7168,9,1911117227
6159,148075140,4583932,152659072,5,0,1,30720,1,6360240400
6160,148164509,157285,148321794,0,0,0,7680,6,8473331261
6161,148296641,174331,148470972,3,0,0,512,28,10170359970
6162,148325089,529998,148855087,0,0,0,77312,6,5084540771
6163,148340020,4319308,152659328,4,0,1,9216,9,7244808410
6164,148432880,4229342,152662222,5,0,1,17920,1,5678837119
6165,148488530,4174768,152663298,4,0,1,13312,9,8657475647
6166,148491570,4174314,152665884,8,0,1,4096,12,8511034569
6167,148514899,486764,149001663,0,0,0,252416,6,7895791038
6168,148588420,4093230,152681650,8,0,1,19968,12,7541554007
6169,148598180,4088859,152687039,5,0,1,17408,1,4925399879
6170,148600210,4092321,152692531,4,0,1,17920,9,6842238714
6171,148607371,195313,148802684,3,0,0,2560,28,5043670513
6172,148612350,4089790,152702140,5,0,1,9216,1,6175457662
6173,148613670,4097538,152711208,5,0,1,1536,1,5255803342
6174,148702520,4009252,152711772,4,0,1,10752,9,6537092945
6175,148756180,3955938,152712118,5,0,1,512,1,5501631251
6176,148783570,3930225,152713795,7,0,1,2560,14,3553319201
6177,148789190,3924861,152714051,8,0,1,9216,12,578023053
6178,148801380,3929231,152730611,4,0,1,3072,9,10112008399
6179,148890690,3840280,152730970,8,0,1,9728,12,455557815
6180,148899821,215753,149115574,3,0,0,2048,28,773305658
6181,148917730,3819467,152737197,5,0,1,17408,1,731425749
6182,148978860,3763483,152742343,4,0,1,8192,9,9737546423
6183,149003009,3740102,152743111,4,0,1,11776,9,9671024605
6184,149027130,3720487,152747617,9,0,1,7168,10,3176408983
6185,149033710,3714573,152748283,9,0,1,1024,10,207237394
6186,149041410,3707859,152749269,8,0,1,1536,12,5657203730
6187,149043360,3710441,152753801,8,0,1,7168,12,6624638165
6188,149046501,287731,149334232,3,0,0,1024,28,84355719
6189,149112820,3662120,152774940,8,0,1,47616,12,3547792617
6190,149117351,195496,149312847,3,0,0,512,28,1186825389
6191,149202340,3604175,152806515,9,0,1,38400,10,6546497014
6192,149245500,3561579,152807079,8,0,1,10752,12,5278167230
6193,149274360,3541450,152815810,9,0,1,22016,10,9802462460
6194,149336710,3482548,152819258,4,0,1,28160,9,1775127171
6195,149360470,3472973,152833443,4,0,1,2048,9,7173581965
6196,149449570,3385499,152835069,9,0,1,2560,10,3455430857
6197,149490100,3348835,152838935,4,0,1,6144,9,910310160
6198,149501250,3359471,152860721,9,0,1,30208,10,985672808
6199,149516230,3348357,152864587,5,0,1,6144,1,8132537021
6200,149517480,3352292,152869772,5,0,1,16384,1,336771992
6201,149546240,3327398,152873638,7,0,1,6144,14,10381824637
6202,149554300,3332242,152886542,8,0,1,40960,12,2918882195
6203,149560891,375222,149936113,3,0,0,2048,28,8979297210
6204,149647579,3243469,152891048,4,0,1,7168,9,2240663904
6205,149656381,319936,149976317,3,0,0,5632,28,8099290506
6206,149709870,3193451,152903321,4,0,1,5120,9,6357364538
6207,149764211,198570,149962781,3,0,0,1536,28,7779779051
6208,149811760,3105036,152916796,1,0,1,22528,23,3546505856
6209,149865280,3053104,152918384,8,0,1,15872,12,5633554045
6210,149912541,247031,150159572,3,0,0,1024,28,6933903885
6211,149925261,237221,150162482,3,0,0,6656,28,1068036465
6212,149956310,2977890,152934200,5,0,1,23040,1,3066920021
6213,149972521,249025,150221546,3,0,0,512,28,7290683469
6214,150008270,2926289,152934559,5,0,1,9728,1,5089312251
6215,150009770,2937227,152946997,9,0,1,512,10,6703147747
6216,150015710,2947492,152963202,4,0,1,28160,9,839000344
6217,150019090,2945630,152964720,5,0,1,2048,1,7550294717
6218,150035690,2930016,152965706,8,0,1,1536,12,1758277518
6219,150054500,2920577,152975077,8,0,1,23040,12,6010733725
6220,150073240,2903015,152976255,8,0,1,13824,12,10659050496
6221,150076260,2907996,152984256,1,0,1,12800,23,7061017417
6222,150140780,2848302,152989082,5,0,1,7680,1,10231174452
6223,150187350,2813937,153001287,1,0,1,17408,23,425009091
6224,150193260,2815439,153008699,1,0,1,11776,23,6088091606
6225,150197369,2814236,153011605,4,0,1,4608,9,8393777890
6226,150245720,2768471,153014191,3,0,1,4096,28,6600673915
6227,150290430,2729612,153020042,8,0,1,27648,12,5688068872
6228,150343660,2676638,153020298,1,0,1,9216,23,5874811790
6229,150437020,2595759,153032779,4,0,1,5120,9,3516441973
6230,150486660,2548065,153034725,3,0,1,3072,28,9289427221
6231,150534870,2522015,153056885,8,0,1,9216,12,10336969936
6232,150617871,193538,150811409,3,0,0,1024,28,2331785291
6233,150627890,2436228,153064118,1,0,1,19968,23,23371039
6234,150760050,2308574,153068624,4,0,1,7168,9,3320206396
6235,150764310,2311291,153075601,1,0,1,33280,23,9677794231
6236,150915531,149716,151065247,3,0,0,512,28,9106852336
6237,150975910,2100255,153076165,3,0,1,10752,28,3760410026
6238,150994360,2082266,153076626,3,0,1,10240,28,6371643796
6239,151000580,2077378,153077958,8,0,1,12288,12,9296279398
6240,151025940,2054284,153080224,8,0,1,3584,12,8836466933
6241,151160060,1928536,153088596,0,0,1,13312,6,2105624146
6242,151205781,1885266,153091047,2,0,1,11264,0,5384374461
6243,151265940,1838090,153104030,3,0,1,7168,28,1709307247
6244,151283200,1848856,153132056,8,0,1,32256,12,7918116586
6245,151295110,1840492,153135602,4,0,1,5632,9,684545244
6246,151319360,1822093,153141453,3,0,1,35840,28,6425849421
6247,151322441,1826130,153148571,2,0,1,15872,0,4035650297
6248,151374901,1794739,153169640,2,0,1,7168,0,9992779610
6249,151384281,1794053,153178334,2,0,1,19968,0,7481131101
6250,151467421,1711899,153179320,2,0,1,1536,0,9478571188
6251,151477660,1702121,153179781,4,0,1,10240,9,5115113130
6252,151498980,1685627,153184607,7,0,1,7680,14,1246060993
6253,151500519,1684754,153185273,4,0,1,11264,9,7956620502
6254,151509761,234852,151744613,3,0,0,2048,28,9233670343
6255,151531061,1678405,153209466,2,0,1,20992,0,8918471094
6256,151556710,1655982,153212692,0,0,1,5120,6,3444528443
6257,151584930,1639063,153223993,0,0,1,8704,6,5625995095
6258,151620721,1609533,153230254,2,0,1,29696,0,7274820504
6259,151633290,1604065,153237355,0,0,1,24576,6,7795696651
6260,151667281,375427,152042708,3,0,0,99328,28,1060973343
6261,151739670,1511291,153250961,4,0,1,3584,9,2312585981
6262,151799240,1455933,153255173,0,0,1,6656,6,5626631731
6263,151842731,378190,152220921,3,0,0,18432,28,6494651534
6264,151881910,1374236,153256146,1,0,1,12800,23,1725127269
6265,151889441,320953,152210394,3,0,0,512,28,629330903
6266,152058881,289931,152348812,3,0,0,3072,28,10574904676
6267,152104551,261729,152366280,3,0,0,512,28,306512609
6268,152148000,1128945,153276945,5,0,1,22528,1,4644076209
6269,152188040,1109657,153297697,3,0,1,35328,28,1811735561
6270,152200730,1105735,153306465,3,0,1,16896,28,5673851564
6271,152201010,1135175,153336185,0,0,1,39424,6,1287670467
6272,152216241,320205,152536446,3,0,0,2048,28,9541557699
6273,152245340,1095351,153340691,5,0,1,7168,1,5410201857
6274,152301150,1060545,153361695,3,0,1,62976,28,1212272389
6275,152322640,1057566,153380206,0,0,1,4096,6,1221846916
6276,152375571,175180,152550751,3,0,0,512,28,3455659288
6277,152444940,936252,153381192,3,0,1,1536,28,3323158924
6278,152449681,197610,152647291,3,0,0,1536,28,1611522881
6279,152507530,874648,153382178,8,0,1,1536,12,7802150087
6280,152515030,867814,153382844,8,0,1,11264,12,6780553890
6281,152557540,352061,152909601,9,0,0,512,10,2777218329
6282,152572910,810088,153382998,8,0,1,8704,12,6213068249
6283,152592361,170758,152763119,3,0,0,1024,28,4648482611
6284,152640270,751783,153392053,8,0,1,11776,12,5697811340
6285,152670840,721367,153392207,8,0,1,8704,12,47557200
6286,152699109,718047,153417156,4,0,1,59392,9,2369301028
6287,152738491,52981,152791472,3,0,0,512,28,9674010249
6288,152750649,668240,153418889,4,0,1,9728,9,3698335111
6289,152799861,194956,152994817,3,0,0,2560,28,4110609465
6290,152806530,617180,153423710,5,0,1,1024,1,9086833522
6291,152844270,586645,153430915,8,0,1,14848,12,2096516508
6292,152854170,585211,153439381,9,0,1,20480,10,3304741835
6293,152884131,106360,152990491,3,0,0,1024,28,7452905189
6294,152899450,541672,153441122,8,0,1,24576,12,3645687270
6295,152964329,514118,153478447,4,0,1,19968,9,5797982845
6296,153011469,467644,153479113,4,0,1,1024,9,3188264554
6297,153030391,417459,153447850,3,0,0,2560,28,4490724284
6298,153050800,437641,153488441,8,0,1,24064,12,8662048413
6299,153053240,435560,153488800,9,0,1,9728,10,8742650526
6300,153179060,319435,153498495,3,0,1,14336,28,8656423285
6301,153205560,302092,153507652,9,0,1,11264,10,3534112544
6302,153230280,279896,153510176,3,0,1,1024,28,8903639432
6303,153364160,150766,153514926,3,0,1,17408,28,4075070449
6304,153385521,297966,153683487,3,0,0,1536,28,861201857
6305,153398290,116892,153515182,9,0,1,9216,10,9442587012
6306,153426240,98114,153524354,3,0,1,1024,28,3863066769
6307,153456980,69320,153526300,3,0,1,3072,28,1000837855
6308,153491600,35468,153527068,3,0,1,11776,28,802749793
6309,153504750,33580,153538330,0,0,1,27648,6,173389767
6310,153715890,1518,153717408,3,0,1,1536,28,6677907018
6311,154002671,259495,154262166,3,0,0,4608,28,1221187771
6312,154034271,211485,154245756,3,0,0,512,28,10023696997
6313,154087021,182273,154269294,3,0,0,1024,28,9558131041
6314,154286329,10757,154297086,4,0,1,17408,9,2232680066
6315,154397819,31007,154428826,4,0,1,50176,9,6573609030
6316,154495949,5454,154501403,4,0,1,13824,9,6898695652
6317,154567790,1042,154568832,0,0,1,1024,6,3168715650
6318,154643011,116371,154759382,3,0,0,1024,28,1535238001
6319,154728050,3898,154731948,6,0,1,4096,19,3266419317
6320,154747381,43904,154791285,3,0,0,512,28,2220086864
6321,154749469,5196,154754665,4,0,1,13312,9,6803714678
6322,154853101,47288,154900389,3,0,0,1536,28,565501511
6323,154924831,43904,154968735,3,0,0,512,28,8286994428
6324,155140399,303307,155443706,0,0,0,238592,6,7443291876
6325,155176261,153578,155329839,3,0,0,2048,28,6560572647
6326,155190589,1042,155191631,4,0,1,1024,9,3668369863
6327,155226000,2470,155228470,1,0,1,2560,23,10664922125
6328,155267439,3387,155270826,4,0,1,9728,9,698623266
6329,155303729,1994,155305723,4,0,1,2048,9,10274677623
6330,155377920,76577,155454497,6,0,1,17408,19,3091860065
6331,155429990,25173,155455163,0,0,1,1024,6,2348487694
6332,155440910,16839,155457749,6,0,1,4096,19,6572303534
6333,155459909,15579,155475488,4,0,1,30208,9,717256707
6334,155460690,16283,155476973,6,0,1,15360,19,334335681
6335,155591010,2470,155593480,3,0,1,2560,28,599249050
6336,155652650,4162,155656812,6,0,1,11264,19,2437538054
6337,155678560,5802,155684362,3,0,1,6144,28,9987723583
6338,155842959,1994,155844953,4,0,1,2048,9,3087202319
6339,155859301,50040,155909341,3,0,0,512,28,8822807532
6340,155892641,45596,155938237,3,0,0,1024,28,4137607930
6341,155910650,33245,155943895,6,0,1,57856,19,5482626062
6342,156031461,48980,156080441,3,0,0,2048,28,7450526933
6343,156044441,48980,156093421,3,0,0,2048,28,9577614430
6344,156059739,12825,156072564,4,0,1,21504,9,4380880723
6345,156061690,13140,156074830,3,0,1,3584,28,3753277189
6346,156078110,13341,156091451,1,0,1,22528,23,2999763751
6347,156119579,5326,156124905,4,0,1,5632,9,4006324766
6348,156161240,33503,156194743,6,0,1,58368,19,8484460019
6349,156174630,25605,156200235,1,0,1,26112,23,6453210167
6350,156199590,22950,156222540,6,0,1,37888,19,9502134020
6351,156211300,11496,156222796,1,0,1,9216,23,5866008253
6352,156241860,21141,156263001,6,0,1,34304,19,7172313247
6353,156423420,4679,156428099,6,0,1,12288,19,6492326676
6354,156437510,13600,156451110,1,0,1,23040,23,7663297900
6355,156502850,14804,156517654,6,0,1,28672,19,1697752912
6356,156513030,6007,156519037,8,0,1,14848,12,6235894335
6357,156526600,12566,156539166,6,0,1,20992,19,8531115410
6358,156533010,8422,156541432,8,0,1,3584,12,4389020574
6359,156580000,6278,156586278,1,0,1,6656,23,3629226069
6360,156599770,13253,156613023,8,0,1,25600,12,8971527961
6361,156620320,4850,156625170,6,0,1,5120,19,3713953834
6362,156729961,59132,156789093,3,0,0,5120,28,616994164
6363,156761260,5802,156767062,8,0,1,6144,12,1555719923
6364,156911670,3422,156915092,1,0,1,3584,23,5271848219
6365,156912230,21722,156933952,6,0,1,34304,19,877312631
6366,156918539,17999,156936538,4,0,1,4096,9,75008331
6367,156956869,7230,156964099,4,0,1,7680,9,8502292908
6368,156980640,3898,156984538,3,0,1,4096,28,8853630756
6369,157043361,69869,157113230,3,0,0,2048,28,2070174800
6370,157081600,4850,157086450,1,0,1,5120,23,8833087677
6371,157116421,50672,157167093,3,0,0,2560,28,4050376771
6372,157168559,10499,157179058,4,0,1,16896,9,892327056
6373,157194420,5326,157199746,1,0,1,5632,23,7759391865
6374,157197221,48980,157246201,3,0,0,2048,28,5348482046
6375,157202029,15062,157217091,4,0,1,29184,9,7245990897
6376,157232669,31266,157263935,4,0,1,50688,9,7291984372
6377,157258630,15321,157273951,6,0,1,29696,19,367425740
6378,157293250,22433,157315683,8,0,1,36864,12,8288817670
6379,157307280,13690,157320970,1,0,1,25088,23,3733681291
6380,157312560,13902,157326462,9,0,1,17920,10,10654029806
6381,157329361,207172,157536533,3,0,0,2048,28,1224856571
6382,157330220,4679,157334899,4,0,1,12288,9,4266709462
6383,157345151,97786,157442937,3,0,0,3072,28,1223749640
6384,157345399,4850,157350249,4,0,1,5120,9,5282385542
6385,157353960,51774,157405734,4,0,1,83968,9,8855300675
6386,157397860,8233,157406093,3,0,1,9728,28,2930195605
6387,157401850,6509,157408359,1,0,1,3584,23,9994562935
6388,157416040,3898,157419938,9,0,1,4096,10,10728386674
6389,157418590,24670,157443260,3,0,1,44544,28,5700592489
6390,157456031,187905,157643936,3,0,0,2560,28,8839763273
6391,157459220,5454,157464674,5,0,1,13824,1,5944192214
6392,157460330,19247,157479577,4,0,1,31232,9,5730756443
6393,157484970,3904,157488874,1,0,1,10752,23,10400584783
6394,157485161,183351,157668512,3,0,0,4096,28,6073458294
6395,157499740,3898,157503638,6,0,1,4096,19,5640330496
6396,157557500,5971,157563471,3,0,1,14848,28,8704222690
6397,157569450,5326,157574776,4,0,1,5632,9,9168683732
6398,157578080,1042,157579122,1,0,1,1024,23,570042209
6399,157584520,6278,157590798,4,0,1,6656,9,9343159830
6400,157602670,1994,157604664,6,0,1,2048,19,8856301528
6401,157672941,116333,157789274,3,0,0,2560,28,4420070672
6402,157703020,4420,157707440,4,0,1,11776,9,121723033
6403,157730150,2470,157732620,8,0,1,2560,12,5197641784
6404,157745580,566,157746146,6,0,1,512,19,3930920658
6405,157916640,3422,157920062,4,0,1,3584,9,5550627945
6406,157953880,12737,157966617,1,0,1,24576,23,5257123371
6407,158025760,566,158026326,3,0,1,512,28,8249655794
6408,158149060,3645,158152705,3,0,1,10240,28,1776742968
6409,158158720,4937,158163657,8,0,1,12800,12,509434671
6410,158185790,6488,158192278,3,0,1,15872,28,2936160648
6411,158196140,31524,158227664,1,0,1,51200,23,6607358205
6412,158222270,14804,158237074,1,0,1,28672,23,1185122377
6413,158241010,4937,158245947,3,0,1,12800,28,2314169772
6414,158247520,566,158248086,1,0,1,512,23,915972104
6415,158391211,85989,158477200,3,0,0,2048,28,6445521800
6416,158464580,3128,158467708,8,0,1,9216,12,7444759208
6417,158491330,14029,158505359,9,0,1,27136,10,3518132328
6418,158497340,12845,158510185,3,0,1,7680,28,9011718049
6419,158550629,4162,158554791,4,0,1,11264,9,5064332351
6420,158562121,6488,158568609,2,0,1,15872,0,4946757272
6421,158575950,13770,158589720,8,0,1,26624,12,10332639366
6422,158614580,4420,158619000,9,0,1,11776,10,6765779920
6423,158637990,4679,158642669,3,0,1,12288,28,4092594136
6424,158674680,2470,158677150,9,0,1,2560,10,5734261313
6425,158693170,4850,158698020,3,0,1,5120,28,773953360
6426,158726371,6754,158733125,2,0,1,7168,0,2930877386
6427,158742820,1518,158744338,9,0,1,1536,10,9737947928
6428,158808440,4162,158812602,4,0,1,11264,9,5949375447
6429,158920690,13512,158934202,4,0,1,26112,9,4029483554
6430,158933841,47036,158980877,3,0,0,1024,28,1323722228
6431,158948751,55916,159004667,3,0,0,2048,28,4066074308
6432,159022580,5326,159027906,9,0,1,5632,10,519137830
6433,159103399,20624,159124023,4,0,1,33280,9,9678785581
6434,159136230,6278,159142508,3,0,1,6656,28,3309334783
6435,159141580,35571,159177151,3,0,1,62464,28,10604601657
6436,159142451,45530,159187981,2,0,1,43520,0,10491716168
6437,159160411,34086,159194497,2,0,1,23040,0,10347190560
6438,159195920,3422,159199342,9,0,1,3584,10,3234901575
6439,159204591,142826,159347417,3,0,0,1024,28,4781064121
6440,159216110,5712,159221822,8,0,1,14336,12,9505837049
6441,159263020,1518,159264538,4,0,1,1536,9,300598379
6442,159283260,1994,159285254,3,0,1,2048,28,3127036968
6443,159335020,25962,159360982,9,0,1,47104,10,2108352511
6444,159351529,10119,159361648,4,0,1,1024,9,4327319648
6445,159358650,7824,159366474,9,0,1,7680,10,591477106
6446,159358680,27789,159386469,8,0,1,46080,12,9008824719
6447,159381830,23120,159404950,3,0,1,41472,28,7244369338
6448,159403240,5971,159409211,9,0,1,14848,10,6984001732
6449,159517090,13770,159530860,9,0,1,26624,10,6231101194
6450,159521860,11906,159533766,8,0,1,4608,12,2608946700
6451,159528750,5170,159533920,9,0,1,8704,10,4585619420
6452,159536820,6278,159543098,9,0,1,6656,10,3879518486
6453,159624760,566,159625326,8,0,1,512,12,9986171988
6454,159633700,24242,159657942,8,0,1,40448,12,4797771943
6455,159644920,17848,159662768,8,0,1,7680,12,7125937402
6456,159701081,159543,159860624,3,0,0,512,28,1768026533
6457,159729830,1994,159731824,9,0,1,2048,10,3061491253
6458,159744300,1042,159745342,9,0,1,1024,10,7186692706
6459,159773690,3898,159777588,3,0,1,4096,28,10665907337
6460,159820610,1994,159822604,3,0,1,2048,28,8829567933
6461,159988320,6278,159994598,8,0,1,6656,12,3572488634
6462,160007430,11016,160018446,5,0,1,17920,1,8281035471
6463,160053521,15837,160069358,2,0,1,30720,0,234700041
6464,160119701,195629,160315330,3,0,0,2048,28,9394354620
6465,160154680,23120,160177800,9,0,1,41472,10,8487072952
6466,160161341,22872,160184213,2,0,1,30720,0,5265983586
6467,160184580,15579,160200159,9,0,1,30208,10,7779404466
6468,160185550,17195,160202745,5,0,1,4096,1,5897047684
6469,160222121,150620,160372741,3,0,0,4608,28,6732905461
6470,160241740,7230,160248970,9,0,1,7680,10,10113874163
6471,160243360,7876,160251236,8,0,1,3584,12,2857586417
6472,160281710,16354,160298064,8,0,1,31744,12,9101611684
6473,160321591,43904,160365495,3,0,0,512,28,369273624
6474,160409960,2946,160412906,9,0,1,3072,10,5523927331
6475,160420760,15579,160436339,5,0,1,30208,1,7049433106
6476,160465771,15579,160481350,2,0,1,30208,0,117839986
6477,160472420,9391,160481811,9,0,1,10240,10,6068484595
6478,160485120,5802,160490922,9,0,1,6144,10,2454499007
6479,160491940,11791,160503731,5,0,1,19456,1,10467001582
6480,160492471,12131,160504602,2,0,1,12288,0,158978790
6481,160523490,566,160524056,8,0,1,512,12,9895188558
6482,160574640,1518,160576158,8,0,1,1536,12,9938729445
6483,160636970,5326,160642296,9,0,1,5632,10,7883549413
6484,160683360,6754,160690114,7,0,1,7168,14,8337045763
6485,160701720,4162,160705882,5,0,1,11264,1,2987259699
6486,160703580,6817,160710397,9,0,1,13312,10,3733758886
6487,160801210,10499,160811709,7,0,1,16896,14,4496660518
6488,160806040,8575,160814615,7,0,1,4608,14,6531826183
6489,160839340,24412,160863752,8,0,1,44032,12,10128846022
6490,160885811,68704,160954515,3,0,0,1536,28,5282366581
6491,160909620,566,160910186,8,0,1,512,12,6871142634
6492,160921851,43904,160965755,3,0,0,512,28,9964540442
6493,161080031,48980,161129011,3,0,0,2048,28,5197248171
6494,161105621,47288,161152909,3,0,0,1536,28,4700002853
6495,161105911,43904,161149815,3,0,0,512,28,7236168297
6496,161158570,14117,161172687,8,0,1,24064,12,6638004476
6497,161189561,5196,161194757,2,0,1,13312,0,5011471826
6498,161311440,12995,161324435,8,0,1,25088,12,505058487
6499,161319130,6931,161326061,5,0,1,2560,1,4768038446
6500,161323001,43904,161366905,3,0,0,512,28,4839666536
6501,161338940,13770,161352710,7,0,1,26624,14,1817096177
6502,161359050,7230,161366280,8,0,1,7680,12,761625004
6503,161442230,20366,161462596,5,0,1,32768,1,6080336224
6504,161445390,23107,161468497,8,0,1,19968,12,2343553128
6505,161450101,21622,161471723,2,0,1,5120,0,457196411
6506,161450419,22789,161473208,4,0,1,15360,9,4773091303
6507,161495180,2946,161498126,8,0,1,3072,12,10588877042
6508,161530170,10241,161540411,8,0,1,16384,12,4600046707
6509,161594390,3898,161598288,1,0,1,4096,23,8366893839
6510,161599391,5802,161605193,2,0,1,6144,0,4671579447
6511,161617280,11533,161628813,8,0,1,18944,12,4438089951
6512,161655850,2946,161658796,6,0,1,3072,19,8295458545
6513,161677570,14287,161691857,8,0,1,27648,12,1546695189
6514,161729250,566,161729816,6,0,1,512,19,9388394532
6515,161761560,22691,161784251,1,0,1,37376,23,5413715390
6516,161873000,4679,161877679,7,0,1,12288,14,7522611736
6517,161882660,1518,161884178,8,0,1,1536,12,6232182125
6518,161886410,3422,161889832,8,0,1,3584,12,3997061488
6519,161963721,3645,161967366,2,0,1,10240,0,6305113443
6520,162037020,5196,162042216,8,0,1,13312,12,3618740829
6521,162080869,1518,162082387,4,0,1,1536,9,8325873345
6522,162082151,43904,162126055,3,0,0,512,28,9717762090
6523,162098031,52364,162150395,3,0,0,3072,28,1861401526
6524,162124640,11533,162136173,7,0,1,18944,14,8285760433
6525,162132061,14029,162146090,2,0,1,27136,0,809575452
6526,162149301,93934,162243235,3,0,0,2560,28,5554204365
6527,162164720,4679,162169399,7,0,1,12288,14,9310203388
6528,162168060,3399,162171459,6,0,1,3072,19,1928893159
6529,162168840,6485,162175325,4,0,1,6144,9,1057740025
6530,162177191,60968,162238159,3,0,0,1024,28,4112715099
6531,162229189,30491,162259680,4,0,1,49152,9,6775547112
6532,162251350,14129,162265479,7,0,1,19456,14,4694134216
6533,162251539,19817,162271356,4,0,1,27136,9,252975057
6534,162271591,6754,162278345,2,0,1,7168,0,3544054499
6535,162350700,11533,162362233,4,0,1,18944,9,4559760925
6536,162497110,5454,162502564,4,0,1,13824,9,8789006281
6537,162589660,44492,162634152,5,0,1,73216,1,10052563597
6538,162631440,3378,162634818,6,0,1,1024,19,2786003571
6539,162634921,7230,162642151,2,0,1,7680,0,6460896304
6540,162655510,6278,162661788,7,0,1,6656,14,4272384236
6541,162655631,196700,162852331,3,0,0,12288,28,6678731950
6542,162668291,5196,162673487,2,0,1,13312,0,5679188811
6543,162674481,104922,162779403,3,0,0,20480,28,4064903349
6544,162716990,3422,162720412,8,0,1,3584,12,4226974684
6545,162759220,7230,162766450,7,0,1,7680,14,8587620983
6546,162797721,203603,163001324,3,0,0,197632,28,1488338596
6547,162937580,63759,163001339,1,0,1,12800,23,2730833519
6548,162993760,20912,163014672,8,0,1,22528,12,6313665728
6549,163004900,17202,163022102,6,0,1,23552,19,6105569160
6550,163096531,301794,163398325,3,0,0,183808,28,3086901592
6551,163128670,11016,163139686,8,0,1,17920,12,5974953882
6552,163195460,12049,163207509,8,0,1,19968,12,3343544847
6553,163249581,3422,163253003,2,0,1,3584,0,9914438882
6554,163350721,168600,163519321,3,0,0,97280,28,1981206256
6555,163405441,408930,163814371,3,0,0,414208,28,8953935496
6556,163484171,330379,163814550,3,0,0,512,28,1366777493
6557,163491900,32781,163524681,8,0,1,5632,12,758132795
6558,163492431,39397,163531828,2,0,1,17408,0,7126712401
6559,163494980,37002,163531982,8,0,1,8704,12,8844937854
6560,163538420,6278,163544698,6,0,1,6656,19,10581117701
6561,163609091,23466,163632557,2,0,1,38912,0,10489575918
6562,163610200,25263,163635463,9,0,1,4608,10,7039387577
6563,163673021,7706,163680727,2,0,1,8192,0,6274592550
6564,163689600,140046,163829646,8,0,1,29184,12,3303364375
6565,163748811,81501,163830312,2,0,1,1024,0,5062844824
6566,163770501,235044,164005545,3,0,0,135168,28,10064890946
6567,163781370,51528,163832898,9,0,1,4096,10,10736406596
6568,163845350,12566,163857916,6,0,1,20992,19,6902967478
6569,163886281,129419,164015700,3,0,0,33280,28,9220495485
6570,163899301,566,163899867,2,0,1,512,0,708570164
6571,163913630,4850,163918480,8,0,1,5120,12,7872369216
6572,164037710,7706,164045416,9,0,1,8192,10,8561255649
6573,164039110,46741,164085851,6,0,0,1024,19,5166537449
6574,164046120,4162,164050282,6,0,1,11264,19,2169030078
6575,164047560,35286,164082846,8,0,1,57856,12,7488901653
6576,164066550,123902,164190452,8,0,1,199680,12,958273242
6577,164069451,127210,164196661,2,0,1,21504,0,5775919408
6578,164076760,121079,164197839,9,0,1,13824,10,6037738658
6579,164079000,129361,164208361,9,0,1,41984,10,259193158
6580,164140330,72217,164212547,6,0,1,6656,19,4461041253
6581,164159121,382905,164542026,3,0,0,132608,28,5576768009
6582,164166361,50052,164216413,2,0,1,6144,0,32296135
6583,164186031,32968,164218999,2,0,1,4096,0,9896674978
6584,164191270,207229,164398499,6,0,0,6656,19,4565118498
6585,164206020,197829,164403849,8,0,1,325120,12,6668894285
6586,164225850,179945,164405795,6,0,1,3072,19,3941764215
6587,164253410,158901,164412311,9,0,1,31232,10,976007823
6588,164287890,289043,164576933,6,0,0,1024,19,9019546975
6589,164324390,222346,164546736,6,0,0,512,19,8298724819
6590,164365211,181354,164546565,3,0,0,14848,28,7914473865
6591,164423571,170917,164594488,3,0,0,10752,28,6009926377
6592,164479020,142381,164621401,6,0,0,7680,19,3203209086
6593,164571940,23466,164595406,8,0,1,38912,12,8973628944
6594,164574180,154890,164729070,8,0,1,236032,12,7802491033
6595,164605401,543415,165148816,3,0,0,443904,28,10181739799
6596,164643661,87995,164731656,2,0,1,4096,0,10484949894
6597,164654670,88328,164742998,6,0,1,37888,19,4618056185
6598,164661401,896708,165558109,3,0,0,427520,28,9295802052
6599,164674871,636978,165311849,3,0,0,252928,28,1684385060
6600,164679570,84626,164764196,8,0,1,76800,12,7446500508
6601,164679680,84772,164764452,6,0,1,9216,19,9962788171
6602,164701720,109083,164810803,8,0,1,147968,12,6468916219
6603,164741861,72488,164814349,2,0,1,5632,0,2773211160
6604,164792871,797389,165590260,3,0,0,105472,28,6893479263
6605,164818100,147979,164966079,8,0,1,244736,12,5869285668
6606,164838970,309917,165148887,8,0,1,336896,12,4419769253
6607,164864100,284802,165148902,6,0,1,1024,19,1671529907
6608,164968890,180035,165148925,9,0,1,43008,10,5062905147
6609,164995761,617290,165613051,3,0,0,74752,28,4738634212
6610,165046830,179040,165225870,8,0,1,129536,12,10632427891
6611,165046990,183066,165230056,9,0,1,6656,10,10008765238
6612,165048580,264391,165312971,6,0,0,3584,19,5851746691
6613,165055690,256174,165311864,9,0,1,150016,10,806534288
6614,165058960,931972,165990932,9,0,1,1226240,10,10494071452
6615,165071201,922317,165993518,2,0,1,4096,0,6656706159
6616,165096960,901384,165998344,5,0,1,7680,1,3783986288
6617,165104401,521304,165625705,3,0,0,34304,28,4701342860
6618,165146330,858632,166004962,5,0,1,23552,1,3107048698
6619,165176380,916565,166092945,9,0,1,296448,10,10000717322
6620,165215010,926046,166141056,8,0,1,154624,12,6452857183
6621,165222700,929648,166152348,9,0,1,53248,10,4843145034
6622,165249430,903072,166152502,5,0,1,8704,1,1648636161
6623,165286250,866508,166152758,5,0,1,9216,1,2710388572
6624,165352510,848820,166201330,9,0,1,142336,10,4081325681
6625,165354830,850686,166205516,6,0,1,6656,19,6521512963
6626,165421610,863473,166285083,9,0,1,262656,10,3384046224
6627,165448690,837059,166285749,6,0,1,11264,19,8525714463
6628,165452030,379015,165831045,6,0,0,8704,19,8151284066
6629,165540790,746585,166287375,6,0,1,2560,19,1204671418
6630,165557400,828207,166385607,9,0,1,305152,10,8785677749
6631,165610030,777523,166387553,5,0,1,3072,1,10216321427
6632,165630370,758745,166389115,5,0,1,11264,1,8575772106
6633,165632201,777413,166409614,3,0,0,31744,28,5406954832
6634,165632341,1130663,166763004,3,0,0,362496,28,5059120735
6635,165666910,742719,166409629,9,0,1,26112,10,1038937787
6636,165955520,405419,166360939,6,0,0,2048,19,7770179981
6637,165984071,807982,166792053,3,0,0,87552,28,523812390
6638,166034850,374794,166409644,5,0,1,11264,1,7464631223
6639,166079960,443053,166523013,9,0,1,407040,10,8879315616
6640,166081300,442213,166523513,6,0,1,9216,19,6021870764
6641,166089550,436229,166525779,5,0,1,3584,1,4902225140
6642,166101920,521698,166623618,6,0,0,1536,19,1397578083
6643,166121430,409841,166531271,6,0,1,17920,19,173185877
6644,166195980,335957,166531937,5,0,1,1024,1,140217713
6645,166216011,549245,166765256,3,0,0,6144,28,9562399471
6646,166224030,538997,166763027,9,0,1,302592,10,9150367765
6647,166267430,495612,166763042,6,0,1,2048,19,4307729256
6648,166303600,461679,166765279,9,0,1,83456,10,9076955476
6649,166345510,113355,166458865,6,0,0,5120,19,4497640915
6650,166382510,382784,166765294,4,0,1,14336,9,4246126905
6651,166412430,352879,166765309,6,0,1,1024,19,1476582518
6652,166412760,352572,166765332,5,0,1,76800,1,4184897451
6653,166418320,347027,166765347,5,0,1,22016,1,5646961725
6654,166452550,312812,166765362,5,0,1,1024,1,8256894208
6655,166458110,360790,166818900,9,0,1,152576,10,1447577849
6656,166482040,388118,166870158,9,0,1,150528,10,6457464847
6657,166529540,233829,166763369,6,0,0,1024,19,5939910812
6658,166577071,307558,166884629,9,0,1,23552,10,4288592641
6659,166658649,234549,166893198,4,0,1,19456,9,7551530508
6660,166689800,205611,166895411,6,0,1,14848,19,628286933
6661,166728810,360438,167089248,6,0,0,12288,19,6055342932
6662,166763510,132887,166896397,5,0,1,1536,1,414370443
6663,166838560,509739,167348299,6,0,0,186880,19,1345344196
6664,166859611,526338,167385949,3,0,0,123392,28,8406733167
6665,166862751,44017,166906768,9,0,1,6144,10,10176651301
6666,166866291,42423,166908714,9,0,1,3072,10,5052071171
6667,166972331,483564,167455895,3,0,0,52736,28,1636094960
6668,166976190,2470,166978660,5,0,1,2560,1,1467090214
6669,166997310,1994,166999304,1,0,1,2048,23,8883014155
6670,167007770,5326,167013096,6,0,1,5632,19,4790024482
6671,167016630,12737,167029367,6,0,1,24576,19,8079842912
6672,167027900,4053,167031953,4,0,1,4096,9,682246754
6673,167044311,3387,167047698,9,0,1,9728,10,1838370100
6674,167083240,1042,167084282,6,0,1,1024,19,2993147216
6675,167087280,7762,167095042,5,0,1,6144,1,3695576252
6676,167115370,4162,167119532,5,0,1,11264,1,7928024794
6677,167115710,7039,167122749,6,0,1,4096,19,4272563828
6678,167136450,13341,167149791,1,0,1,22528,23,5206039167
6679,167155440,6754,167162194,4,0,1,7168,9,714905816
6680,167156040,10020,167166060,9,0,1,6144,10,5953331465
6681,167207340,1518,167208858,6,0,1,1536,19,312047586
6682,167263980,3128,167267108,4,0,1,9216,9,7507858547
6683,167282770,65568,167348338,6,0,1,51712,19,1122327775
6684,167290860,102278,167393138,1,0,1,7680,23,2483486215
6685,167293230,100254,167393484,4,0,1,512,9,5328659319
6686,167309930,88973,167398903,4,0,1,16896,9,3033884004
6687,167393730,364517,167758247,6,0,0,25600,19,7616804965
6688,167423560,5802,167429362,9,0,1,6144,10,3005147061
6689,167446961,340932,167787893,3,0,0,82432,28,9312918764
6690,167469330,265781,167735111,6,0,0,70656,19,3814670444
6691,167536630,7706,167544336,4,0,1,8192,9,2556083807
6692,167574710,3422,167578132,1,0,1,3584,23,4664779429
6693,167583640,14287,167597927,3,0,1,27648,28,2073514934
6694,167585701,856936,168442637,3,0,0,342528,28,7469051394
6695,167587660,714596,168302256,6,0,0,410112,19,2239272538
6696,167596191,464643,168060834,3,0,0,97792,28,9550434727
6697,167619480,11016,167630496,1,0,1,17920,23,9164749283
6698,167654380,24670,167679050,3,0,1,44544,28,9484854294
6699,167662150,20126,167682276,1,0,1,5120,23,1750937769
6700,167670900,12682,167683582,4,0,1,2048,9,8179819016
6701,167723900,14166,167738066,6,0,1,3072,19,7122531197
6702,167726861,383629,168110490,3,0,0,8704,28,7449568963
6703,167741820,2470,167744290,3,0,1,2560,28,8930214125
6704,167809180,25962,167835142,4,0,1,47104,9,3814254723
6705,167816230,23418,167839648,4,0,1,7168,9,2865755156
6706,167818751,794770,168613521,2,0,0,210944,0,4486076901
6707,167831721,683331,168515052,3,0,0,237568,28,4534651988
6708,167852340,22950,167875290,6,0,1,37888,19,2192557916
6709,167920331,701489,168621820,3,0,0,27136,28,6520056727
6710,167940690,20624,167961314,4,0,1,33280,9,10139140645
6711,167959650,5196,167964846,4,0,1,13312,9,2425011239
6712,167976560,4850,167981410,3,0,1,5120,28,8431595637
6713,168020520,777586,168798106,6,0,0,206848,19,205432904
6714,168050370,24314,168074684,6,0,1,23552,19,10494033495
6715,168081230,14117,168095347,3,0,1,24064,28,1314306287
6716,168107320,6278,168113598,4,0,1,6656,9,10106676826
6717,168141981,394685,168536666,3,0,0,5120,28,7311059795
6718,168144020,20366,168164386,6,0,1,32768,19,8936810094
6719,168174720,1042,168175762,4,0,1,1024,9,5142932767
6720,168220370,89601,168309971,4,0,1,8192,9,3729192660
6721,168288611,639454,168928065,3,0,0,83456,28,5384618449
6722,168316680,4420,168321100,3,0,1,11776,28,7332133358
6723,168327740,788204,169115944,6,0,0,233984,19,280098608
6724,168357131,542167,168899298,3,0,0,195072,28,10123216608
6725,168365070,153353,168518423,3,0,1,9728,28,6847624447
6726,168435961,86964,168522925,2,0,1,5120,0,5532234060
6727,168496361,638185,169134546,3,0,0,34304,28,730844372
6728,168501291,767766,169269057,3,0,0,252416,28,5312351463
6729,168512991,10920,168523911,2,0,1,1536,0,4043878866
6730,168554930,81911,168636841,6,0,1,29184,19,10245795756
6731,168558820,86913,168645733,4,0,1,29184,9,8756120365
6732,168664731,459348,169124079,3,0,0,26624,28,4259714316
6733,168670250,6754,168677004,4,0,1,7168,9,2217882485
6734,168690060,15579,168705639,4,0,1,30208,9,1801318983
6735,168707860,3898,168711758,6,0,1,4096,19,8347103850
6736,168749440,79665,168829105,4,0,1,50176,9,9631217104
6737,168807471,23580,168831051,2,0,1,3072,0,1099661385
6738,168825841,366293,169192134,3,0,0,90624,28,1252650589
6739,168858130,44288,168902418,6,0,1,9216,19,7680240072
6740,168993221,1994,168995215,2,0,1,2048,0,2236336536
6741,169002620,4937,169007557,6,0,1,12800,19,8120048489
6742,169069510,204266,169273776,6,0,0,15360,19,3134434272
6743,169113990,27319,169141309,4,0,1,7168,9,9106745325
6744,169128791,371438,169500229,3,0,0,156160,28,6897381728
6745,169206900,67902,169274802,4,0,1,1024,9,8186285073
6746,169239060,37882,169276942,4,0,1,8704,9,5897454019
6747,169253670,176193,169429863,6,0,0,19456,19,1457271202
6748,169267551,14369,169281920,2,0,1,13312,0,281265947
6749,169286171,1042,169287213,2,0,1,1024,0,4092705573
6750,169347710,4937,169352647,4,0,1,12800,9,7607395111
6751,169368580,5454,169374034,4,0,1,13824,9,6221990994
6752,169405991,2946,169408937,2,0,1,3072,0,4261436573
6753,169430360,533692,169964052,6,0,0,84480,19,680445780
6754,169442800,353168,169795968,6,0,0,253952,19,8614086377
6755,169455031,46249,169501280,2,0,1,1024,0,5317657744
6756,169457221,367013,169824234,3,0,0,25088,28,5533537549
6757,169505230,385004,169890234,6,0,0,73216,19,8229066314
6758,169508790,307785,169816575,6,0,0,67584,19,491732105
6759,169551610,386687,169938297,6,0,0,157696,19,6942528416
6760,169665131,303304,169968435,3,0,0,14336,28,9064273555
6761,169674121,401665,170075786,3,0,0,43520,28,937066431
6762,169679011,23725,169702736,2,0,1,39424,0,836771279
6763,169688601,18001,169706602,2,0,1,6144,0,2190603333
6764,169932340,37129,169969469,4,0,1,1024,9,2683467268
6765,169972880,120001,170092881,6,0,0,19456,19,3107074376
6766,170034350,251606,170285956,6,0,0,131584,19,196884898
6767,170037901,13770,170051671,2,0,1,26624,0,2814156082
6768,170064631,169324,170233955,3,0,0,85504,28,449113737
6769,170074221,22981,170097202,2,0,1,34816,0,9883239093
6770,170138161,401103,170539264,3,0,0,367616,28,2455230384
6771,170240501,566,170241067,2,0,1,512,0,1390624100
6772,170329790,343503,170673293,6,0,0,278016,19,4003124311
6773,170340761,3898,170344659,2,0,1,4096,0,2242805457
6774,170430400,111843,170542243,0,0,1,8704,6,9800560872
6775,170452341,93582,170545923,2,0,1,4096,0,6270009571
6776,170473921,75323,170549244,2,0,1,14848,0,8099810222
6777,170510220,50918,170561138,1,0,1,22528,23,7302095708
6778,170526021,41635,170567656,2,0,1,25088,0,4477808995
6779,170534570,138902,170673472,6,0,0,512,19,4789660754
6780,170606271,283382,170889653,3,0,0,167424,28,6640652574
6781,170633940,47247,170681187,0,0,1,8192,6,4907828933
6782,170645221,36222,170681443,2,0,1,9216,0,9243214965
6783,170687650,4679,170692329,0,0,1,12288,6,4441541745
6784,170831291,136334,170967625,3,0,0,92160,28,7716225595
6785,170887441,4198,170891639,2,0,1,2048,0,4314462045
6786,170987421,5326,170992747,2,0,1,5632,0,7737574581
6787,170991171,251986,171243157,3,0,0,195584,28,7676851096
6788,171079321,340076,171419397,3,0,0,208896,28,5880860422
6789,171085301,1042,171086343,2,0,1,1024,0,7961839688
6790,171120490,3387,171123877,1,0,1,9728,23,4316688842
6791,171121220,234514,171355734,6,0,0,98304,19,5885094139
6792,171183111,60061,171243172,2,0,1,4096,0,3067308072
6793,171189650,108301,171297951,1,0,1,93184,23,6206454922
6794,171308531,4937,171313468,2,0,1,12800,0,341582951
6795,171421250,105716,171526966,6,0,0,47104,19,5012156736
6796,171455200,265423,171720623,6,0,0,74752,19,1564183045
6797,171471450,1994,171473444,6,0,1,2048,19,8856500892
6798,171494790,3645,171498435,1,0,1,10240,23,7556809888
6799,171495810,7475,171503285,1,0,1,5632,23,9271790811
6800,171499901,5650,171505551,2,0,1,3584,0,7627821458
6801,171523091,263430,171786521,3,0,0,199168,28,2355070462
6802,171611480,4420,171615900,1,0,1,11776,23,8365315250
6803,171613089,5450,171618539,1,0,1,3584,23,8913755427
6804,171622291,16096,171638387,2,0,1,31232,0,1380958454
6805,171640931,1042,171641973,2,0,1,1024,0,1565867460
6806,171680819,1042,171681861,1,0,1,1024,23,9919605887
6807,171707319,79217,171786536,1,0,1,17408,23,10449613790
6808,171745120,45570,171790690,4,0,1,11264,9,1488138765
6809,171807360,170291,171977651,6,0,0,71168,19,9757112222
6810,171845729,4374,171850103,1,0,1,4608,23,103057883
6811,171877409,4374,171881783,1,0,1,4608,23,355570186
6812,171882860,15579,171898439,6,0,1,30208,19,4271062821
6813,171900559,2946,171903505,1,0,1,3072,23,2457216765
6814,172045080,213076,172258156,6,0,0,181248,19,2350569499
6815,172068351,329479,172397830,3,0,0,250368,28,10396147078
6816,172123631,402801,172526432,3,0,0,3072,28,1341616667
6817,172161741,363740,172525481,3,0,0,233472,28,601635029
6818,172180809,3898,172184707,1,0,1,4096,23,372312307
6819,172205409,57935,172263344,1,0,1,13312,23,4119901484
6820,172304979,1518,172306497,1,0,1,1536,23,28010475
6821,172389480,142115,172531595,6,0,0,16896,19,6136637975
6822,172560489,14287,172574776,1,0,1,27648,23,598696209
6823,172593979,14117,172608096,1,0,1,24064,23,2897590764
6824,172718090,6754,172724844,6,0,1,7168,19,10139432870
6825,172768629,12308,172780937,1,0,1,20480,23,633502283
6826,172795960,97604,172893564,6,0,0,20480,19,7735325209
6827,172824531,267249,173091780,3,0,0,53760,28,10106119638
6828,172825730,232312,173058042,6,0,0,171008,19,6843142145
6829,172877421,192492,173069913,3,0,0,38912,28,9626921368
6830,172959070,4937,172964007,9,0,1,12800,10,8135496942
6831,172978981,263396,173242377,3,0,0,41472,28,4889838278
6832,173167560,197612,173365172,6,0,0,187392,19,10026709057
6833,173179620,290009,173469629,6,0,0,55808,19,1799391528
6834,173286100,166486,173452586,6,0,0,84992,19,1309309938
6835,173307710,173954,173481664,6,0,0,39424,19,2104035536
6836,173312550,89235,173401785,9,0,1,64512,10,2630616002
6837,173342440,428849,173771289,1,0,0,262144,23,4390411184
6838,173429671,203473,173633144,3,0,0,13824,28,2539429220
6839,173437081,381982,173819063,3,0,0,156672,28,3754238309
6840,173438530,43149,173481679,9,0,1,3072,10,9971436445
6841,173509010,1518,173510528,9,0,1,1536,10,8072662688
6842,173690210,81102,173771312,9,0,1,7680,10,7566660362
6843,173695471,187370,173882841,3,0,0,26112,28,4546433360
6844,173889590,52364,173941954,6,0,0,3072,19,5476915085
6845,174110161,97604,174207765,3,0,0,20480,28,5717928283
6846,174122330,48980,174171310,6,0,0,2048,19,4573984198
6847,174277949,1994,174279943,1,0,1,2048,23,7092898007
6848,174315151,111644,174426795,3,0,0,66560,28,64933963
6849,174375070,24412,174399482,0,0,1,44032,6,1984694640
6850,174380750,105876,174486626,6,0,0,22016,19,4281171155
6851,174430420,176818,174607238,6,0,0,113152,19,2899395393
6852,174434720,2946,174437666,0,0,1,3072,6,5868584482
6853,174534600,108992,174643592,6,0,0,57856,19,2671483267
6854,174563530,133882,174697412,6,0,0,75264,19,9278088920
6855,174611870,5196,174617066,0,0,1,13312,6,8240200928
6856,174643840,98162,174742002,6,0,0,21504,19,569023919
6857,174752560,3645,174756205,0,0,1,10240,6,2149007425
6858,174826840,64654,174891494,8,0,1,109056,12,11653708
6859,174853490,252599,175106089,6,0,0,178176,19,7034745374
6860,174954181,159887,175114068,3,0,0,26112,28,1384033697
6861,174969900,23983,174993883,0,0,1,39936,6,6092886695
6862,174975050,19499,174994549,9,0,1,1024,10,1869766544
6863,175004051,117470,175121521,3,0,0,14848,28,7276582670
6864,175056100,65436,175121536,0,0,1,11264,6,10288310884
6865,175111030,218024,175329054,6,0,0,40960,19,4900555181
6866,175158820,122096,175280916,6,0,0,100864,19,8644789781
6867,175187510,216592,175404102,6,0,0,125952,19,4929949320
6868,175201580,4679,175206259,0,0,1,12288,6,9474333105
6869,175203361,155987,175359348,3,0,0,8192,28,5769330744
6870,175294981,116468,175411449,3,0,0,24064,28,4225008485
6871,175459081,100724,175559805,3,0,0,30720,28,9563952896
6872,175464960,172419,175637379,6,0,0,57344,19,6093230569
6873,175634960,7737,175642697,4,0,1,5632,9,1417352110
6874,175681190,77168,175758358,6,0,0,18944,19,565225198
6875,175724671,95060,175819731,3,0,0,18432,28,3318292610
6876,175726571,2470,175729041,2,0,1,2560,0,5130738241
6877,175732790,64742,175797532,8,0,1,105984,12,2843500566
6878,175752311,47807,175800118,2,0,1,4096,0,3864599927
6879,175766941,283043,176049984,3,0,0,201216,28,2111179257
6880,175794020,375935,176169955,6,0,0,72704,19,1690610707
6881,175816320,6531,175822851,4,0,1,9216,9,10307664023
6882,175886160,518652,176404812,6,0,0,43520,19,4293930036
6883,175893441,35054,175928495,2,0,1,61440,0,6960591245
6884,175925901,465628,176391529,3,0,0,410624,28,3257135918
6885,175987761,62238,176049999,2,0,1,2560,0,10731044083
6886,176086910,346168,176433078,6,0,0,66560,19,4062352309
6887,176151861,260922,176412783,3,0,0,26112,28,7994898332
6888,176170140,25446,176195586,4,0,1,46080,9,10251474548
6889,176173580,23184,176196764,4,0,1,13824,9,2389609862
6890,176221751,221030,176442781,3,0,0,31744,28,174216950
6891,176286341,172772,176459113,3,0,0,7680,28,7161560580
6892,176328140,127620,176455760,4,0,1,25088,9,1874394015
6893,176363420,92904,176456324,4,0,1,10752,9,7728974186
6894,176407890,57353,176465243,4,0,1,18944,9,9018516596
6895,176436120,34615,176470735,3,0,1,17920,28,6969569053
6896,176489640,13770,176503410,4,0,1,26624,9,3304021941
6897,176491130,15506,176506636,4,0,1,5120,9,3024852759
6898,176491801,275633,176767434,3,0,0,219136,28,6518906105
6899,176530010,2870,176532880,3,0,1,8704,28,10358935619
6900,176543760,377628,176921388,6,0,0,189952,19,5926866917
6901,176695580,125158,176820738,6,0,0,8704,19,6058855809
6902,176727230,54225,176781455,4,0,1,27136,9,372930142
6903,176804790,127705,176932495,6,0,0,36352,19,10098287278
6904,176832761,136393,176969154,3,0,0,34816,28,571913915
6905,176868710,66715,176935425,4,0,1,3072,9,186637367
6906,176904400,93928,176998328,6,0,0,10240,19,463537237
6907,176913659,23072,176936731,4,0,1,2048,9,9520115572
6908,176926760,14157,176940917,4,0,1,6656,9,6585157659
6909,176934361,8041,176942402,2,0,1,15360,0,4393820532
6910,176940980,14029,176955009,3,0,1,27136,28,600544095
6911,176961610,23115,176984725,8,0,1,30208,12,10409604938
6912,176996380,186890,177183270,8,0,1,300032,12,3297194175
6913,177014720,195086,177209806,4,0,1,86016,9,9569553536
6914,177074600,141005,177215605,8,0,1,19456,12,6307545734
6915,177104591,510324,177614915,3,0,0,71168,28,7274669726
6916,177123050,437911,177560961,6,0,0,69632,19,1310721970
6917,177128291,411423,177539714,3,0,0,99840,28,3249856130
6918,177139801,76675,177216476,2,0,1,12288,0,4984056448
6919,177145320,102620,177247940,8,0,1,109568,12,2994917247
6920,177165721,98591,177264312,2,0,1,61952,0,3548764182
6921,177200031,65561,177265592,2,0,1,14336,0,7108568498
6922,177255770,112007,177367777,8,0,1,181248,12,1576796964
6923,177273900,95823,177369723,4,0,1,3072,9,10244425092
6924,177306450,79031,177385481,3,0,1,50688,28,3194987360
6925,177320040,70587,177390627,8,0,1,8192,12,8556842168
6926,177343950,47855,177391805,4,0,1,13824,9,1963655479
6927,177373490,341784,177715274,6,0,0,75776,19,5150015116
6928,177390620,7230,177397850,4,0,1,7680,9,7294822317
6929,177409980,56079,177466059,8,0,1,95744,12,7747838877
6930,177451170,141866,177593036,8,0,1,229376,12,4073377585
6931,177453510,596406,178049916,6,0,0,145408,19,6186435461
6932,177475271,393400,177868671,3,0,0,110592,28,6218236130
6933,177523121,91809,177614930,2,0,1,22528,0,5342403215
6934,177553610,61335,177614945,8,0,1,36864,12,9275098529
6935,177563531,575800,178139331,3,0,0,240128,28,5538632516
6936,177570960,79946,177650906,8,0,1,116224,12,2778775699
6937,177587941,69378,177657319,2,0,1,22528,0,6548639070
6938,177635201,25344,177660545,2,0,1,5120,0,10092519826
6939,177662581,2946,177665527,2,0,1,3072,0,7283991255
6940,177754430,295501,178049931,8,0,1,432128,12,6396502187
6941,177755510,294436,178049946,8,0,1,14336,12,6249770023
6942,177957390,358313,178315703,6,0,0,259584,19,7225075263
6943,177996491,53470,178049961,2,0,1,13312,0,7397919325
6944,178064200,75146,178139346,8,0,1,17408,12,10536205582
6945,178089990,350862,178440852,6,0,0,62976,19,8333971975
6946,178281570,39468,178321038,4,0,1,5632,9,10688698471
6947,178315441,8183,178323624,2,0,1,4096,0,7694423309
6948,178341640,104378,178446018,8,0,1,173056,12,6210627253
6949,178405840,41254,178447094,3,0,1,13312,28,7858438671
6950,178451881,348886,178800767,3,0,0,81920,28,9168830299
6951,178453890,4850,178458740,3,0,1,5120,28,1618425936
6952,178478030,33075,178511105,8,0,1,54272,12,6339573066
6953,178498640,34537,178533177,4,0,1,60416,9,9397901851
6954,178532940,20366,178553306,3,0,1,32768,28,6100614978
6955,178575530,3898,178579428,3,0,1,4096,28,9899092854
6956,178619161,36863,178656024,2,0,1,65024,0,7849745138
6957,178639611,520951,179160562,3,0,0,503296,28,6882456666
6958,178704130,31266,178735396,3,0,1,50688,28,1228300286
6959,178745460,3128,178748588,8,0,1,9216,12,7560376157
6960,178759260,10499,178769759,3,0,1,16896,28,10017871207
6961,178778901,22424,178801325,2,0,1,512,0,10256215719
6962,178819280,4850,178824130,3,0,1,5120,28,2534146683
6963,178824610,5326,178829936,3,0,1,5632,28,9273115162
6964,178852870,33762,178886632,7,0,1,58880,14,8791822855
6965,178877500,9696,178887196,7,0,1,10752,14,4348583819
6966,178882540,278061,179160601,8,0,1,244736,12,5878469408
6967,178924550,256269,179180819,6,0,0,12288,19,7014290186
6968,178965060,195556,179160616,3,0,1,7168,28,6074976996
6969,179015360,159172,179174532,0,0,1,26624,6,10291626648
6970,179026700,154911,179181611,7,0,1,24576,14,919089241
6971,179030260,161423,179191683,6,0,1,29696,19,8831067122
6972,179036660,284682,179321342,6,0,0,6144,19,2412510834
6973,179057960,141050,179199010,0,0,1,23040,6,6697012206
6974,179081060,186149,179267209,8,0,1,125440,12,9277455419
6975,179094201,380380,179474581,3,0,0,82432,28,2440441007
6976,179129480,138715,179268195,7,0,1,1536,14,4618416073
6977,179135260,144686,179279946,0,0,1,39936,6,8972205064
6978,179165520,492412,179657932,6,0,0,95744,19,5851145644
6979,179212920,68511,179281431,7,0,1,15360,14,5094096741
6980,179227180,54712,179281892,7,0,1,10240,14,4233405357
6981,179228350,58829,179287179,7,0,1,25088,14,5467500375
6982,179240300,51065,179291365,0,0,1,6656,6,9094425703
6983,179245391,51773,179297164,2,0,1,27648,0,6127146004
6984,179274791,656831,179931622,3,0,0,443392,28,1055293946
6985,179280230,22221,179302451,7,0,1,25088,14,10553640254
6986,179290341,12981,179303322,2,0,1,12288,0,4459813221
6987,179307201,10757,179317958,2,0,1,17408,0,5788495226
6988,179366880,11533,179378413,3,0,1,18944,28,7526815455
6989,179379080,21399,179400479,8,0,1,34816,12,786387446
6990,179425921,2946,179428867,2,0,1,3072,0,5243158240
6991,179442620,533657,179976277,6,0,0,146432,19,2698921408
6992,179444000,30596,179474596,0,0,1,36352,6,10536629466
6993,179477441,1042,179478483,2,0,1,1024,0,6448045952
6994,179523831,1994,179525825,2,0,1,2048,0,1321898070
6995,179534701,12308,179547009,2,0,1,20480,0,8198165969
6996,179559600,3898,179563498,3,0,1,4096,28,483445360
6997,179618670,44233,179662903,8,0,1,72704,12,9861675470
6998,179680410,327432,180007842,6,0,0,103424,19,3921128226
6999,179718440,4162,179722602,3,0,1,11264,28,6900363305
7000,179728200,7706,179735906,5,0,1,8192,1,906346788
7001,179744830,45179,179790009,0,0,1,77824,6,7657729031
7002,179745111,285563,180030674,3,0,0,24576,28,10105745762
7003,179745870,230430,179976300,8,0,1,218112,12,146254969
7004,179750250,226065,179976315,7,0,1,12800,14,5052900705
7005,179822081,330086,180152167,3,0,0,43008,28,9884304835
7006,179825780,192778,180018558,7,0,1,17408,14,4041254869
7007,179880660,139178,180019838,3,0,1,14336,28,7016564229
7008,179902540,308919,180211459,6,0,0,26112,19,6507472074
7009,179943430,76754,180020184,0,0,1,512,6,4035921801
7010,179945530,324511,180270041,6,0,0,50176,19,10367924751
7011,179982710,38481,180021191,7,0,1,9728,14,9172394554
7012,179994360,50391,180044751,0,0,1,39936,6,5620916671
7013,179996910,52987,180049897,4,0,1,8192,9,6305716946
7014,180004940,45623,180050563,5,0,1,1024,1,10035667071
7015,180007650,43477,180051127,3,0,1,10752,28,1109646485
7016,180042790,12523,180055313,7,0,1,6656,14,7514106433
7017,180046780,10159,180056939,4,0,1,2560,9,8294535673
7018,180055350,82408,180137758,8,0,1,133632,12,10497735569
7019,180072070,80112,180152182,0,0,1,36352,6,8394651452
7020,180089460,62737,180152197,4,0,1,1536,9,8945821465
7021,180119521,463084,180582605,3,0,0,161792,28,6234338432
7022,180125150,27062,180152212,3,0,1,15360,28,2858449400
7023,180181809,35312,180217121,1,0,1,61952,23,7955397648
7024,180186901,244475,180431376,3,0,0,73216,28,4199171002
7025,180246040,24016,180270056,4,0,1,20480,9,2983140205
7026,180264530,9163,180273693,4,0,1,10240,9,2985427274
7027,180272990,21109,180294099,8,0,1,33792,12,5796961324
7028,180293180,3898,180297078,7,0,1,4096,14,7489381529
7029,180299520,3422,180302942,9,0,1,3584,10,10535238730
7030,180305560,4374,180309934,7,0,1,4608,14,2229230402
7031,180321380,21141,180342521,4,0,1,34304,9,1073250068
7032,180331140,13967,180345107,3,0,1,4096,28,9171102855
7033,180339860,13083,180352943,4,0,1,22016,9,1657121482
7034,180349569,12308,180361877,1,0,1,20480,23,6884434433
7035,180352050,11107,180363157,7,0,1,14336,14,7998655091
7036,180369440,7230,180376670,5,0,1,7680,1,10530333464
7037,180374430,338386,180712816,6,0,0,168448,19,9854932495
7038,180376960,2946,180379906,3,0,1,3072,28,4062475038
7039,180384019,6278,180390297,1,0,1,6656,23,6463552697
7040,180401449,1994,180403443,1,0,1,2048,23,3668815037
7041,180418010,36495,180454505,3,0,1,41472,28,9647206076
7042,180422710,374781,180797491,6,0,0,44032,19,7042953230
7043,180455069,3898,180458967,1,0,1,4096,23,3093079942
7044,180487510,6754,180494264,8,0,1,7168,12,4387277296
7045,180512590,14029,180526619,3,0,1,27136,28,2079935292
7046,180565150,23718,180588868,7,0,1,15360,14,7277971551
7047,180568730,22404,180591134,3,0,1,3584,28,9402766102
7048,180575969,16471,180592440,1,0,1,2048,23,3088218760
7049,180591960,6754,180598714,7,0,1,7168,14,2161093501
7050,180622870,2470,180625340,5,0,1,2560,1,3980143361
7051,180627510,12737,180640247,9,0,1,24576,10,4892640434
7052,180678620,35247,180713867,3,0,1,1024,28,10182798955
7053,180706370,22346,180728716,6,0,1,30208,19,10256051921
7054,180720820,360481,181081301,6,0,0,108032,19,7725121934
7055,180771809,566,180772375,1,0,1,512,23,7525603284
7056,180794900,6481,180801381,7,0,1,4096,14,9937876396
7057,180817330,1518,180818848,5,0,1,1536,1,8298658196
7058,180837410,196108,181033518,8,0,1,318464,12,5889737399
7059,180877570,162259,181039829,9,0,1,30208,10,7244885758
7060,180882780,157715,181040495,3,0,1,1024,28,1698640261
7061,180899659,143422,181043081,1,0,1,4096,23,8229548175
7062,180906550,174766,181081316,6,0,1,34816,19,9903135992
7063,180922410,158921,181081331,7,0,1,512,14,7797748763
7064,180928570,152776,181081346,4,0,1,3072,9,1778364127
7065,180967380,113981,181081361,3,0,1,2560,28,7537643360
7066,180978110,211395,181189505,6,0,0,56832,19,1591465677
7067,180992240,89136,181081376,5,0,1,2560,1,2921253623
7068,181100979,5196,181106175,1,0,1,13312,23,8573501747
7069,181121290,24154,181145444,4,0,1,43520,9,3360269364
7070,181134300,11503,181145803,5,0,1,9728,1,458829254
7071,181165439,4679,181170118,1,0,1,12288,23,5381212477
7072,181175020,20279,181195299,6,0,1,6144,19,3873634951
7073,181213480,12049,181225529,3,0,1,19968,28,9424910451
7074,181267219,4374,181271593,1,0,1,4608,23,5488456560
7075,181280410,3898,181284308,6,0,1,4096,19,7610625069
7076,181357810,12995,181370805,3,0,1,25088,28,1357694460
7077,181372320,3645,181375965,7,0,1,10240,14,8328922167
7078,181399469,3128,181402597,1,0,1,9216,23,725044152
7079,181453670,34795,181488465,3,0,1,60928,28,4438339570
7080,181525660,1042,181526702,6,0,1,1024,19,8183748068
7081,181541480,4850,181546330,5,0,1,5120,1,1360562964
7082,181556810,3898,181560708,6,0,1,4096,19,9806593484
7083,181580480,142836,181723316,6,0,0,65536,19,9714115483
7084,181606199,43887,181650086,1,0,1,75264,23,10683645453
7085,181700920,1042,181701962,6,0,1,1024,19,5721384874
7086,181719291,255750,181975041,3,0,0,263168,28,4059152770
7087,181740790,3645,181744435,9,0,1,10240,10,2893827276
7088,181784921,753094,182538015,3,0,0,246784,28,3689153542
7089,181791240,13341,181804581,4,0,1,22528,9,6982796917
7090,181791520,411788,182203308,6,0,0,135680,19,2655582363
7091,181818950,10499,181829449,9,0,1,16896,10,1057816249
7092,181846769,15062,181861831,1,0,1,29184,23,1090929359
7093,181850059,12233,181862292,1,0,1,10240,23,4743520224
7094,181870920,1042,181871962,4,0,1,1024,9,5798542254
7095,181906300,69817,181976117,5,0,1,1024,1,2533485518
7096,181927200,53383,181980583,3,0,1,13312,28,4910677558
7097,181938290,679480,182617770,6,0,0,261632,19,3465178772
7098,181987560,1141558,183129118,6,0,0,717312,19,3945939965
7099,182014990,188357,182203347,8,0,1,292864,12,2083273948
7100,182086730,116632,182203362,3,0,1,10240,28,351386212
7101,182087520,115857,182203377,3,0,1,512,28,402649136
7102,182118030,102242,182220272,8,0,1,94720,12,5078631278
7103,182129970,90763,182220733,5,0,1,10240,1,1771969959
7104,182133810,91109,182224919,7,0,1,6656,14,1022920284
7105,182136450,89954,182226404,9,0,1,15360,10,5778496403
7106,182141051,1008568,183149619,3,0,0,66560,28,9461830594
7107,182147869,80481,182228350,1,0,1,3072,23,3969151526
7108,182157110,76386,182233496,9,0,1,8192,10,7177088635
7109,182166840,82209,182249049,8,0,1,57856,12,2658978305
7110,182173291,1169558,183342849,3,0,0,32256,28,2723714355
7111,182184970,65155,182250125,4,0,1,13312,9,9265639664
7112,182216610,37701,182254311,4,0,1,6656,9,4364352758
7113,182230730,25527,182256257,3,0,1,3072,28,2239511487
7114,182241960,20710,182262670,5,0,1,22528,1,9404867268
7115,182296160,21916,182318076,3,0,1,35840,28,6917435940
7116,182351740,34108,182385848,6,0,1,56320,19,2958568914
7117,182358701,358697,182717398,3,0,0,69120,28,4177437682
7118,182388530,6278,182394808,4,0,1,6656,9,210438357
7119,182404290,43200,182447490,8,0,1,70656,12,2809553686
7120,182431570,18186,182449756,9,0,1,3584,10,9306482717
7121,182473571,1200947,183674518,3,0,0,499200,28,8777779915
7122,182478810,143598,182622408,8,0,1,12288,12,10693049205
7123,182500939,122135,182623074,1,0,1,1024,23,851025405
7124,182542210,86053,182628263,9,0,1,6656,10,8926779111
7125,182558849,74240,182633089,4,0,1,7680,9,8245951529
7126,182567450,67905,182635355,3,0,1,3584,28,4647769156
7127,182574260,67730,182641990,5,0,1,28160,1,4942934267
7128,182583830,60746,182644576,9,0,1,4096,10,5707336181
7129,182612060,32670,182644730,9,0,1,8704,10,7143418619
7130,182612920,265076,182877996,8,0,1,390144,12,3000105477
7131,182613550,269631,182883181,3,0,1,16384,28,3796636618
7132,182638140,255768,182893908,4,0,1,34816,9,9786006321
7133,182667730,227766,182895496,3,0,1,15872,28,4491578108
7134,182706229,199892,182906121,1,0,1,42496,23,4999519007
7135,182713600,196707,182910307,8,0,1,6656,12,3891333426
7136,182742249,386884,183129133,1,0,1,13312,23,9284689960
7137,182766000,363148,183129148,9,0,1,10240,10,572524372
7138,182775940,353247,183129187,8,0,1,124928,12,10168944456
7139,182790389,338813,183129202,1,0,1,34816,23,8294792916
7140,182841759,287458,183129217,1,0,1,31232,23,3822416444
7141,182869000,260248,183129248,5,0,1,28160,1,9872494980
7142,182888830,240441,183129271,9,0,1,39424,10,7884836576
7143,182890080,239206,183129286,4,0,1,13312,9,227311860
7144,182892480,236821,183129301,5,0,1,26112,1,2355858065
7145,182899110,230206,183129316,9,0,1,24064,10,5370830729
7146,182905860,254217,183160077,9,0,1,16896,10,8571954785
7147,182908710,252545,183161255,4,0,1,13824,9,1450561456
7148,182940470,224180,183164650,4,0,1,14336,9,8074800171
7149,182965800,199196,183164996,9,0,1,512,10,1208104489
7150,182970229,198429,183168658,1,0,1,13312,23,4868817843
7151,182978510,193382,183171892,5,0,1,4608,1,8452422496
7152,183006550,166648,183173198,3,0,1,2048,28,8619532070
7153,183132520,50432,183182952,5,0,1,22528,1,9620240003
7154,183169770,13528,183183298,5,0,1,512,1,1740743880
7155,183182150,5971,183188121,4,0,1,14848,9,1392639686
7156,183196019,23466,183219485,1,0,1,38912,23,10655638416
7157,183236300,6278,183242578,8,0,1,6656,12,1961431142
7158,183239320,123683,183363003,8,0,1,200704,12,6020947021
7159,183252960,135964,183388924,8,0,1,91136,12,4483393888
7160,183279801,669903,183949704,3,0,0,406528,28,4434447525
7161,183298700,116350,183415050,8,0,1,92160,12,8539888074
7162,183298959,116347,183415306,1,0,1,9216,23,6291282135
7163,183299320,414893,183714213,6,0,0,130048,19,1631407109
7164,183325260,90302,183415562,5,0,1,9216,1,10376961831
7165,183328140,99071,183427211,8,0,1,47616,12,7827646049
7166,183364160,64037,183428197,8,0,1,1536,12,276821360
7167,183370490,59013,183429503,9,0,1,2048,10,724198364
7168,183462480,13253,183475733,5,0,1,25600,1,4731699710
7169,183479790,1994,183481784,3,0,1,2048,28,4469047861
7170,183481900,1518,183483418,9,0,1,1536,10,560173150
7171,183489310,16096,183505406,9,0,1,31232,10,10203145780
7172,183524451,452833,183977284,7,0,0,90112,14,7626162983
7173,183543960,174135,183718095,8,0,1,4096,12,7606031980
7174,183563850,385933,183949783,8,0,1,358912,12,7277318468
7175,183566729,383069,183949798,1,0,1,14336,23,3915798207
7176,183571920,377893,183949813,3,0,1,2048,28,4195064445
7177,183588149,389150,183977299,1,0,1,2560,23,8614434675
7178,183620819,356495,183977314,1,0,1,27648,23,5482503878
7179,183644490,332839,183977329,3,0,1,3072,28,9790572042
7180,183686540,290804,183977344,9,0,1,9728,10,811287305
7181,183704879,272520,183977399,1,0,1,8192,23,2301806068
7182,183740260,260768,184001028,8,0,1,39424,12,4289403293
7183,183741191,265841,184007032,2,0,1,20480,0,1802624467
7184,183772500,277155,184049655,8,0,1,88576,12,10494150928
7185,183784140,272133,184056273,0,0,1,23552,6,1193629802
7186,183849410,209769,184059179,8,0,1,4608,12,1199488993
7187,183907000,377882,184284882,1,0,0,38400,23,6688422614
7188,183982790,81983,184064773,8,0,1,18432,12,10536502626
7189,183983220,87762,184070982,0,0,1,21504,6,7567672665
7190,184003359,72769,184076128,1,0,1,8192,23,3982037954
7191,184020351,397415,184417766,3,0,0,7680,28,5545482325
7192,184081200,7706,184088906,3,0,1,8192,28,7493616770
7193,184083840,86454,184170294,8,0,1,144896,12,3743986917
7194,184105870,342306,184448176,6,0,0,2560,19,1792164422
7195,184108630,63290,184171920,9,0,1,2560,10,8697277140
7196,184116431,330950,184447381,7,0,0,61440,14,10509933124
7197,184131430,46596,184178026,0,0,1,20992,6,8109308230
7198,184202631,628753,184831384,3,0,0,185344,28,5160569432
7199,184207910,510370,184718280,6,0,0,143360,19,8708460890
7200,184224771,315080,184539851,7,0,0,68608,14,3106754590
7201,184238970,11274,184250244,9,0,1,18432,10,1680625689
7202,184273619,11838,184285457,1,0,1,512,23,7914427698
7203,184283870,22835,184306705,0,0,1,35328,6,5342672973
7204,184299260,52549,184351809,8,0,1,85504,12,14577912
7205,184342610,114762,184457372,8,0,1,189952,12,10351263571
7206,184349600,109360,184458960,9,0,1,15872,10,4552217536
7207,184385869,73450,184459319,1,0,1,9728,23,8392088002
7208,184422430,41075,184463505,0,0,1,6656,6,7747926229
7209,184457550,26738,184484288,9,0,1,48640,10,3949706162
7210,184463801,284797,184748598,3,0,0,50688,28,10564092405
7211,184473880,11394,184485274,6,0,1,1536,19,8516759920
7212,184476990,13110,184490100,0,0,1,7680,6,8770289133
7213,184481460,163149,184644609,8,0,1,264192,12,6918106850
7214,184485609,159871,184645480,1,0,1,12288,23,8531623226
7215,184538410,107736,184646146,9,0,1,1024,10,5247933755
7216,184558780,97991,184656771,9,0,1,34304,10,82201806
7217,184584020,76617,184660637,9,0,1,6144,10,2701924665
7218,184658140,300601,184958741,6,0,0,87040,19,1219585986
7219,184662980,4679,184667659,9,0,1,12288,10,900997547
7220,184715300,33313,184748613,6,0,1,37888,19,7259937395
7221,184810000,87597,184897597,8,0,1,112128,12,6903503248
7222,184811570,86283,184897853,6,0,1,9216,19,1347971828
7223,184839910,78834,184918744,8,0,1,75264,12,10341903357
7224,184844110,319975,185164085,6,0,0,13312,19,3437780006
7225,184927040,31716,184958756,8,0,1,27136,12,6076970505
7226,184945111,317430,185262541,7,0,0,128000,14,3341365759
7227,185116640,399900,185516540,6,0,0,50176,19,2131628499
7228,185135941,184986,185320927,3,0,0,91648,28,742285227
7229,185161670,4877,185166547,6,0,1,2560,19,8400071748
7230,185167780,24154,185191934,6,0,1,43520,19,2464205629
7231,185185740,10060,185195800,6,0,1,6144,19,5897528916
7232,185224940,50418,185275358,9,0,1,21504,10,7701745010
7233,185400680,4162,185404842,6,0,1,11264,19,1526467263
7234,185481511,161684,185643195,3,0,0,37888,28,6527080404
7235,185500000,22174,185522174,9,0,1,36352,10,9576232890
7236,185526350,16354,185542704,8,0,1,31744,12,1083477144
7237,185529570,39576,185569146,8,0,1,54272,12,150246341
7238,185551681,340355,185892036,3,0,0,133120,28,7465758615
7239,185553530,54617,185608147,8,0,1,89600,12,3568690475
7240,185557320,55973,185613293,6,0,1,8192,19,5183109164
7241,185680931,398113,186079044,3,0,0,114176,28,10098073017
7242,185791980,3898,185795878,6,0,1,4096,19,6662974069
7243,185823350,115828,185939178,6,0,0,4096,19,1461355375
7244,185832561,204003,186036564,3,0,0,95744,28,9015943949
7245,185836060,1518,185837578,9,0,1,1536,10,6761429319
7246,185982450,108489,186090939,6,0,0,38912,19,4451560848
7247,186028060,267676,186295736,6,0,0,159232,19,3929332584
7248,186045531,258496,186304027,3,0,0,27136,28,6989225898
7249,186061400,34719,186096119,6,0,1,13312,19,3482520412
7250,186063841,177906,186241747,3,0,0,89088,28,8540497306
7251,186075120,21665,186096785,9,0,1,1024,10,5742638252
7252,186176130,1994,186178124,6,0,1,2048,19,8218161411
7253,186188401,1518,186189919,2,0,1,1536,0,7545367953
7254,186250951,311744,186562695,3,0,0,185856,28,1083687957
7255,186300690,27741,186328431,6,0,1,44032,19,1533542928
7256,186330370,355872,186686242,6,0,0,145408,19,10424011309
7257,186364131,5196,186369327,2,0,1,13312,0,3052181456
7258,186428641,11274,186439915,2,0,1,18432,0,9824905889
7259,186561040,4517,186565557,9,0,1,8704,10,4910467688
7260,186632571,286094,186918665,3,0,0,280064,28,5935725141
7261,186654420,34760,186689180,9,0,1,3072,10,7128806607
7262,186756351,313300,187069651,3,0,0,194560,28,294236068
7263,186786569,174871,186961440,0,0,0,140288,6,9783143091
7264,186856581,107313,186963894,2,0,1,2560,0,10182376837
7265,186885450,80141,186965591,6,0,1,9728,19,6802157753
7266,186904080,67576,186971656,5,0,1,15872,1,8491317035
7267,186964230,31277,186995507,6,0,1,46080,19,2558922476
7268,187012761,80649,187093410,2,0,1,39424,0,1668532945
7269,187033311,60445,187093756,2,0,1,512,0,4156736993
7270,187046921,57972,187104893,2,0,1,36864,0,5873424186
7271,187080520,35734,187116254,6,0,1,41472,19,9753293138
7272,187136980,2870,187139850,6,0,1,8704,19,3060329544
7273,187175390,185208,187360598,8,0,1,300544,12,9791289145
7274,187319920,41856,187361776,6,0,1,13824,19,7021203515
7275,187324130,38312,187362442,6,0,1,1024,19,8791395176
7276,187361080,6278,187367358,9,0,1,6656,10,2354155832
7277,187415210,12737,187427947,6,0,1,24576,19,1926475677
7278,187423590,8543,187432133,6,0,1,6656,19,1121815532
7279,187435490,33245,187468735,6,0,1,57856,19,1374557082
7280,187457010,52808,187509818,8,0,1,86016,12,6662709118
7281,187509209,4850,187514059,1,0,1,5120,23,1687642
7282,187512440,15321,187527761,9,0,1,29696,10,5518942028
7283,187514980,13549,187528529,7,0,1,11776,14,4270715969
7284,187547980,4850,187552830,9,0,1,5120,10,9632807760
7285,187607230,13770,187621000,9,0,1,26624,10,390617853
7286,187611240,14266,187625506,9,0,1,7168,10,9074965048
7287,187625940,211204,187837144,6,0,0,81920,19,444079375
7288,187640530,5326,187645856,6,0,1,5632,19,10123689338
7289,187765670,4679,187770349,9,0,1,12288,10,8840862486
7290,187774700,222320,187997020,6,0,0,160768,19,4122523137
7291,187802650,1994,187804644,6,0,1,2048,19,1659534024
7292,187853610,566,187854176,9,0,1,512,10,1946681512
7293,187875810,566,187876376,6,0,1,512,19,6386547972
7294,187925951,191060,188117011,3,0,0,165888,28,10106600261
7295,187933510,218799,188152309,6,0,0,53760,19,7253231173
7296,188117790,195116,188312906,6,0,0,179200,19,2309467008
7297,188149061,176972,188326033,3,0,0,43008,28,1676610574
7298,188156149,21658,188177807,1,0,1,35328,23,5117308765
7299,188176340,11791,188188131,9,0,1,19456,10,7850991905
7300,188248471,201393,188449864,3,0,0,40448,28,6301573936
7301,188257631,284264,188541895,3,0,0,145408,28,5601589692
7302,188259680,71249,188330929,6,0,1,12800,19,4307072022
7303,188441091,319644,188760735,3,0,0,180224,28,6535058287
7304,188454591,351282,188805873,3,0,0,135680,28,10625940898
7305,188476929,3645,188480574,4,0,1,10240,9,5190676343
7306,188489590,2946,188492536,6,0,1,3072,19,7868603310
7307,188510719,44938,188555657,4,0,1,26624,9,10114490771
7308,188595030,1518,188596548,9,0,1,1536,10,4434333033
7309,188634550,7230,188641780,4,0,1,7680,9,4399502836
7310,188688281,263809,188952090,3,0,0,178688,28,9657940151
7311,188691360,4374,188695734,4,0,1,4608,9,8431617132
7312,188692990,67760,188760750,4,0,1,33792,9,7881553911
7313,188737731,155368,188893099,3,0,0,13312,28,871673312
7314,188792650,29828,188822478,6,0,1,32256,19,5291860611
7315,188849491,130919,188980410,3,0,0,12288,28,375834592
7316,188897310,54803,188952113,0,0,1,13312,6,5115275627
7317,188898770,53953,188952723,6,0,1,512,19,5524880982
7318,188927890,27551,188955441,6,0,1,9216,19,10384819220
7319,188928481,137027,189065508,3,0,0,49152,28,10232321346
7320,188937660,42765,188980425,0,0,1,38400,6,7014487297
7321,189071250,5454,189076704,6,0,1,13824,19,5746784919
7322,189087190,1518,189088708,9,0,1,1536,10,9158407694
7323,189119609,5326,189124935,4,0,1,5632,9,271137992
7324,189125510,4937,189130447,6,0,1,12800,19,8068246466
7325,189268860,12995,189281855,4,0,1,25088,9,8159016543
7326,189282249,1518,189283767,4,0,1,1536,9,5492105243
7327,189440770,126152,189566922,6,0,0,114176,19,7108194086
7328,189444120,1042,189445162,9,0,1,1024,10,7814755852
7329,189461700,11533,189473233,0,0,1,18944,6,8378120113
7330,189537890,41090,189578980,0,0,1,19968,6,2432339447
7331,189539520,43006,189582526,6,0,1,5632,19,1042422606
7332,189655691,251313,189907004,3,0,0,196096,28,4564235732
7333,189684470,14287,189698757,0,0,1,27648,6,6647623409
7334,189732700,46729,189779429,6,0,1,80896,19,5016301496
7335,189774570,132457,189907027,8,0,1,164352,12,5456950892
7336,189798170,108872,189907042,6,0,1,8192,19,10295136175
7337,189816760,460122,190276882,6,0,0,47616,19,2779516460
7338,189845461,445476,190290937,3,0,0,46080,28,3776494753
7339,189874491,387868,190262359,3,0,0,130048,28,10445155479
7340,189927861,608734,190536595,3,0,0,273920,28,9512364018
7341,189937230,5326,189942556,0,0,1,5632,6,7574952328
7342,189939540,797133,190736673,6,0,0,318464,19,8489070677
7343,189939560,12587,189952147,7,0,1,20992,14,9268225175
7344,189950669,10241,189960910,4,0,1,16384,9,8495299769
7345,189983309,14029,189997338,4,0,1,27136,9,4183827126
7346,190004220,5196,190009416,4,0,1,13312,9,4321794318
7347,190008140,4083,190012223,6,0,1,4096,19,1684413976
7348,190035370,14545,190049915,8,0,1,28160,12,2150823154
7349,190068120,20366,190088486,0,0,1,32768,6,1988595698
7350,190079760,56596,190136356,9,0,1,96768,10,6973900317
7351,190091619,45301,190136920,1,0,1,10752,23,10337972905
7352,190092820,337586,190430406,8,0,1,518656,12,9070326379
7353,190092860,546766,190639626,6,0,0,162816,19,853122855
7354,190110500,321289,190431789,4,0,1,14848,9,8077301320
7355,190166060,266497,190432557,4,0,1,11776,9,5383065045
7356,190197630,238473,190436103,9,0,1,5632,10,5427420049
7357,190204381,550482,190754863,3,0,0,59392,28,9097859675
7358,190295240,146355,190441595,8,0,1,26112,12,6359563430
7359,190297950,150366,190448316,5,0,1,24064,1,6036981468
7360,190312450,136737,190449187,7,0,1,12288,14,8266406965
7361,190324610,212000,190536610,4,0,1,7680,9,2785366650
7362,190342711,553003,190895714,3,0,0,191488,28,3461782070
7363,190347680,188945,190536625,6,0,1,3072,19,2821638910
7364,190405470,131170,190536640,6,0,1,2048,19,8359767894
7365,190428760,107895,190536655,6,0,1,2560,19,7014981453
7366,190431090,105580,190536670,6,0,1,1024,19,7190380094
7367,190444820,91865,190536685,6,0,1,10240,19,7517321906
7368,190489559,52614,190542173,4,0,1,13824,9,9863545077
7369,190494950,49368,190544318,4,0,1,9728,9,6161159357
7370,190529970,206782,190736752,8,0,1,220160,12,4135519902
7371,190540010,221141,190761151,6,0,1,15360,19,7343912322
7372,190550899,213899,190764798,4,0,1,13312,9,156700720
7373,190551850,472002,191023852,6,0,0,9216,19,4385017176
7374,190559410,216814,190776224,8,0,1,20992,12,9014992411
7375,190601150,176252,190777402,4,0,1,13824,9,9927045962
7376,190667880,112428,190780308,4,0,1,4608,9,7744137047
7377,190668010,821864,191489874,8,0,1,1160704,12,7428670111
7378,190675890,345139,191021029,6,0,0,74240,19,3558453548
7379,190692980,798174,191491154,9,0,1,14336,10,2940366779
7380,190711390,791413,191502803,4,0,1,47616,9,7246542829
7381,190728400,775274,191503674,6,0,1,12288,19,9652786313
7382,190735690,773783,191509473,7,0,1,19456,14,7626154854
7383,190878630,637154,191515784,7,0,1,22016,14,10248446413
7384,190924550,648363,191572913,8,0,1,183296,12,3142730572
7385,190934380,638892,191573272,6,0,1,9728,19,7759776505
7386,190953040,620898,191573938,7,0,1,11264,14,1428335801
7387,190964820,619948,191584768,9,0,1,43520,10,7787882898
7388,190988180,572929,191561109,6,0,0,125440,19,4106072243
7389,190988680,848104,191836784,6,0,0,290304,19,3224589809
7390,190996670,599235,191595905,8,0,1,45056,12,1722009271
7391,191056140,540751,191596891,7,0,1,1536,14,7677369726
7392,191113311,271648,191384959,3,0,0,5120,28,3924738459
7393,191206911,711596,191918507,3,0,0,13824,28,639736433
7394,191284780,328586,191613366,8,0,1,62464,12,3586653297
7395,191302000,311827,191613827,8,0,1,10240,12,2273564758
7396,191310510,309833,191620343,6,0,1,31232,19,3019069052
7397,191356210,267039,191623249,8,0,1,4608,12,3016494475
7398,191361070,267466,191628536,7,0,1,25088,14,6295891054
7399,191361840,267567,191629407,6,0,1,12288,19,7377823495
7400,191387500,245133,191632633,8,0,1,5120,12,8171950625
7401,191475460,194282,191669742,8,0,1,128512,12,8061097681
7402,191516561,326806,191843367,3,0,0,21504,28,3646520621
7403,191526850,146758,191673608,8,0,1,6144,12,1995787050
7404,191541330,134224,191675554,7,0,1,3072,14,6167092839
7405,191691901,364285,192056186,3,0,0,51200,28,8504230348
7406,191764080,83150,191847230,6,0,1,10752,19,10367072114
7407,191787300,63206,191850506,6,0,1,10752,19,7895477623
7408,191901980,1994,191903974,6,0,1,2048,19,8349966794
7409,191912360,690432,192602792,1,0,0,363008,23,4664763332
7410,191919150,3898,191923048,6,0,1,4096,19,4907580964
7411,191961381,766437,192727818,3,0,0,299008,28,10707972249
7412,191986290,1994,191988284,7,0,1,2048,14,5254762499
7413,192002460,392979,192395439,6,0,0,8192,19,2238061187
7414,192050310,39371,192089681,7,0,1,58368,14,7116082591
7415,192075530,24571,192100101,6,0,1,41472,19,389840549
7416,192088890,17010,192105900,6,0,1,19456,19,8596124469
7417,192103170,533505,192636675,6,0,0,111104,19,6226170643
7418,192122270,4374,192126644,3,0,1,4608,28,2058206211
7419,192167280,5802,192173082,3,0,1,6144,28,2751720679
7420,192184821,189162,192373983,3,0,0,18432,28,6671416192
7421,192239470,53237,192292707,6,0,1,90112,19,5171928452
7422,192246270,52543,192298813,6,0,1,20992,19,2500098970
7423,192251000,58131,192309131,6,0,1,32768,19,5574986576
7424,192271970,43574,192315544,6,0,1,22528,19,3371859570
7425,192274430,47732,192322162,6,0,1,23552,19,4227640801
7426,192349990,4420,192354410,7,0,1,11776,14,9273071799
7427,192415840,350542,192766382,6,0,0,110592,19,3842058221
7428,192429190,7230,192436420,6,0,1,7680,19,4537235510
7429,192458420,5802,192464222,4,0,1,6144,9,1278010395
7430,192501690,226159,192727849,6,0,1,59392,19,9578135650
7431,192528340,199524,192727864,6,0,1,13824,19,680855610
7432,192575830,190599,192766429,3,0,1,63488,28,1190548849
7433,192663870,103513,192767383,6,0,1,1024,19,7230491062
7434,192675380,114393,192789773,7,0,1,41472,14,6394515114
7435,192675470,115929,192791399,7,0,1,2560,14,7061989307
7436,192737160,60960,192798120,7,0,1,32256,14,8884903801
7437,192767310,32436,192799746,7,0,1,2560,14,8217787406
7438,192788740,246881,193035621,6,0,0,18432,19,10225978797
7439,192790230,15213,192805443,6,0,1,27136,19,4561172880
7440,192802360,3237,192805597,3,0,1,8704,28,7965251895
7441,192852360,4850,192857210,7,0,1,5120,14,2057343559
7442,192880620,339666,193220286,6,0,0,11264,19,9996751249
7443,192880650,11285,192891935,7,0,1,18432,14,4139644439
7444,192899440,22433,192921873,6,0,1,36864,19,2874403045
7445,192901390,545634,193447024,6,0,0,285696,19,1260145498
7446,192995390,3898,192999288,6,0,1,4096,19,5477938108
7447,193001040,358921,193359961,6,0,0,115712,19,329399529
7448,193004980,566,193005546,6,0,1,512,19,5969510272
7449,193009070,12825,193021895,5,0,1,21504,1,9325647253
7450,193046180,5454,193051634,3,0,1,13824,28,7565262800
7451,193076770,6278,193083048,6,0,1,6656,19,5091629175
7452,193087321,422534,193509855,3,0,0,16384,28,4093530624
7453,193102810,46212,193149022,8,0,1,79872,12,8184444619
7454,193145541,501624,193647165,3,0,0,7168,28,9294203907
7455,193190620,24154,193214774,7,0,1,43520,14,9135980607
7456,193242050,50741,193292791,7,0,1,81920,14,3638046609
7457,193272631,283248,193555879,3,0,0,76288,28,4257022597
7458,193293741,172714,193466455,3,0,0,13824,28,7316326081
7459,193322610,1994,193324604,6,0,1,2048,19,414640565
7460,193349120,102362,193451482,7,0,1,4608,14,7456150802
7461,193351090,102658,193453748,7,0,1,3584,14,4119357821
7462,193391770,81817,193473587,6,0,1,39936,19,5654056161
7463,193404130,406593,193810723,6,0,0,22016,19,6684193516
7464,193443300,45210,193488510,8,0,1,48640,12,407597203
7465,193462090,26766,193488856,7,0,1,512,14,9144578872
7466,193482470,99824,193582294,6,0,0,4096,19,5967958815
7467,193482650,321350,193804000,6,0,0,246272,19,3020227957
7468,193523290,4937,193528227,3,0,1,12800,28,7102145706
7469,193569181,335144,193904325,3,0,0,20992,28,9240026190
7470,193628410,5326,193633736,3,0,1,5632,28,8577269709
7471,193676940,3422,193680362,3,0,1,3584,28,3519406459
7472,193695631,433112,194128743,3,0,0,388096,28,4141309187
7473,193805220,32233,193837453,6,0,1,48640,19,2720560759
7474,193920791,254003,194174794,3,0,0,151040,28,6015589493
7475,194076880,120564,194197444,6,0,1,37376,19,1566835378
7476,194112840,85065,194197905,6,0,1,10240,19,9296809900
7477,194192731,5840,194198571,2,0,1,1024,0,5306281920
7478,194217351,2470,194219821,2,0,1,2560,0,6896057590
7479,194218870,33762,194252632,7,0,1,58880,14,3282571647
7480,194251940,30491,194282431,3,0,1,49152,28,5087443517
7481,194366420,5712,194372132,7,0,1,14336,14,7346618272
7482,194434770,3898,194438668,3,0,1,4096,28,6032183441
7483,194445150,3898,194449048,3,0,1,4096,28,8898788145
7484,194471690,374355,194846045,6,0,0,281600,19,3365844681
7485,194494860,141373,194636233,6,0,0,39936,19,1549941386
7486,194497990,14804,194512794,3,0,1,28672,28,5397810156
7487,194561300,5326,194566626,3,0,1,5632,28,3442569905
7488,194583560,13083,194596643,3,0,1,22016,28,715708697
7489,194612680,2946,194615626,3,0,1,3072,28,1117937515
7490,194620630,230602,194851232,6,0,0,16896,19,6116187817
7491,194659060,1042,194660102,7,0,1,1024,14,3120273159
7492,194694020,10499,194704519,3,0,1,16896,28,5937217855
7493,194738430,1042,194739472,6,0,1,1024,19,5241219838
7494,194740971,271442,195012413,3,0,0,270848,28,140028638
7495,194773480,81098,194854578,7,0,1,9728,14,8508748657
7496,194784790,70134,194854924,7,0,1,512,14,10712655777
7497,194799930,68498,194868428,3,0,1,24064,28,10115966256
7498,194858530,168102,195026632,6,0,0,46592,19,7524771993
7499,194858900,13714,194872614,3,0,1,6656,28,6725763982
7500,194893971,342524,195236495,3,0,0,61440,28,7906134828
7501,194922440,7230,194929670,7,0,1,7680,14,10191921512
7502,194941571,263454,195205025,3,0,0,171008,28,1286485380
7503,195003490,26262,195029752,3,0,1,9216,28,3024772014
7504,195072571,397783,195470354,3,0,0,258560,28,995917037
7505,195077140,3422,195080562,3,0,1,3584,28,5727947661
7506,195077850,14031,195091881,3,0,1,23040,28,3180353474
7507,195096820,23725,195120545,7,0,1,39424,14,2788835867
7508,195152510,52530,195205040,7,0,1,77824,14,5045320737
7509,195209090,27420,195236510,7,0,1,18432,14,8775051261
7510,195322060,6754,195328814,3,0,1,7168,28,3561481343
7511,195351040,3645,195354685,7,0,1,10240,14,6443511745
7512,195366270,1042,195367312,7,0,1,1024,14,10314316038
7513,195529720,62072,195591792,6,0,0,9728,19,1252487061
7514,195607150,11791,195618941,7,0,1,19456,14,8315502049
7515,195685560,82532,195768092,6,0,0,16384,19,4102118005
7516,195736740,110198,195846938,6,0,0,52224,19,1381564985
7517,195753000,30749,195783749,5,0,1,49664,1,1053788855
7518,195775970,163473,195939443,6,0,0,69120,19,1046465407
7519,195795411,164213,195959624,3,0,0,32768,28,7172223843
7520,195806100,5802,195811902,5,0,1,6144,1,2578848781
7521,195822640,24313,195846953,7,0,1,32768,14,7180769174
7522,195859440,4679,195864119,5,0,1,12288,1,6733689046
7523,195867970,11274,195879244,3,0,1,18432,28,8945881533
7524,195903610,3898,195907508,3,0,1,4096,28,5836644259
7525,195918500,22929,195941429,7,0,1,2048,14,7055683457
7526,195994901,10757,196005658,2,0,1,17408,0,7896419267
7527,196007380,14545,196021925,5,0,1,28160,1,8921588589
7528,196013920,12831,196026751,3,0,1,7680,28,1016993231
7529,196022830,34537,196057367,7,0,1,60416,14,10326203304
7530,196032080,30472,196062552,0,0,1,24576,6,741683289
7531,196067771,247967,196315738,3,0,0,59392,28,4349528184
7532,196113010,4162,196117172,3,0,1,11264,28,7661732
7533,196136290,1042,196137332,7,0,1,1024,14,9327703297
7534,196142620,642111,196784731,6,0,0,93696,19,5301824350
7535,196167500,7706,196175206,0,0,1,8192,6,8395891266
7536,196188280,2470,196190750,6,0,1,2560,19,585437670
7537,196206470,345801,196552271,6,0,0,292864,19,602026263
7538,196225760,530385,196756145,6,0,0,89088,19,177045002
7539,196235230,13253,196248483,3,0,1,25600,28,5776576206
7540,196243110,329488,196572598,6,0,0,66560,19,6674873421
7541,196259660,5802,196265462,7,0,1,6144,14,7848721097
7542,196260840,4776,196265616,5,0,1,8704,1,4920601538
7543,196274230,10757,196284987,3,0,1,17408,28,4530734846
7544,196284990,5331,196290321,7,0,1,5632,14,9781833125
7545,196296810,23637,196320447,6,0,1,42496,19,5608969562
7546,196328300,732253,197060553,6,0,0,379392,19,7255345609
7547,196340650,2870,196343520,7,0,1,8704,14,6638619040
7548,196347080,7706,196354786,7,0,1,8192,14,2628380262
7549,196356510,20366,196376876,5,0,1,32768,1,9238966890
7550,196412490,5804,196418294,7,0,1,6144,14,6207540545
7551,196418230,2470,196420700,0,0,1,2560,6,5879162620
7552,196432370,391120,196823490,6,0,0,6656,19,10443788561
7553,196434580,13770,196448350,5,0,1,26624,1,7614079638
7554,196476219,110108,196586327,1,0,1,26624,23,282732559
7555,196489160,97526,196586686,3,0,1,9728,28,3861116359
7556,196499600,89032,196588632,7,0,1,3072,14,10083973298
7557,196507691,437243,196944934,3,0,0,205824,28,5195735173
7558,196573240,24736,196597976,0,0,1,22528,6,7934503918
7559,196583280,19202,196602482,3,0,1,7168,28,9846338897
7560,196634240,1518,196635758,5,0,1,1536,1,1289812691
7561,196666070,5971,196672041,4,0,1,14848,9,8293731740
7562,196723100,33068,196756168,0,0,1,19968,6,3140588487
7563,196727749,88465,196816214,4,0,1,51200,9,10029686626
7564,196781060,39660,196820720,7,0,1,7168,14,3958875818
7565,196792071,285057,197077128,3,0,0,54272,28,5813104409
7566,196882380,194787,197077167,6,0,1,17920,19,3253615737
7567,196967861,241108,197208969,3,0,0,57344,28,10684177188
7568,196970320,110179,197080499,7,0,1,9728,14,7118222929
7569,197057170,26843,197084013,0,0,1,10752,6,1767086828
7570,197069880,16375,197086255,0,0,1,8704,6,4451337647
7571,197111850,14117,197125967,5,0,1,24064,1,8909665157
7572,197118440,10433,197128873,3,0,1,4608,28,9239987447
7573,197142950,3645,197146595,0,0,1,10240,6,4837794051
7574,197172530,566,197173096,7,0,1,512,14,6501117165
7575,197197820,26978,197224798,5,0,1,30720,1,5901847756
7576,197213620,11946,197225566,7,0,1,11776,14,9259346216
7577,197219150,9642,197228792,7,0,1,5120,14,9814869863
7578,197242240,566,197242806,6,0,1,512,19,5295136226
7579,197242551,360190,197602741,3,0,0,58368,28,4331363102
7580,197266871,193239,197460110,3,0,0,41472,28,5135311770
7581,197285090,6754,197291844,7,0,1,7168,14,4160338601
7582,197291090,1740,197292830,5,0,1,1536,1,2422950985
7583,197327660,13770,197341430,6,0,1,26624,19,8370217269
7584,197359731,162667,197522398,3,0,0,35328,28,2206325043
7585,197379390,3422,197382812,5,0,1,3584,1,2880281844
7586,197382060,310612,197692672,6,0,0,33792,19,8230479897
7587,197393560,5326,197398886,5,0,1,5632,1,1189368758
7588,197396770,12308,197409078,0,0,1,20480,6,9091178024
7589,197407141,134965,197542106,3,0,0,34304,28,9834914511
7590,197427101,191378,197618479,3,0,0,33280,28,3951883230
7591,197427669,3898,197431567,4,0,1,4096,9,10279739309
7592,197428870,5923,197434793,3,0,1,5120,28,8215962588
7593,197433800,26325,197460125,4,0,1,30720,9,4499526478
7594,197480070,6488,197486558,6,0,1,15872,19,6020733580
7595,197523690,2470,197526160,6,0,1,2560,19,5472848934
7596,197569340,13253,197582593,3,0,1,25600,28,644028652
7597,197573759,9180,197582939,4,0,1,512,9,6855547764
7598,197578710,5855,197584565,7,0,1,2560,14,2956977006
7599,197632150,1518,197633668,7,0,1,1536,14,6246749868
7600,197686920,141897,197828817,6,0,0,65536,19,3206980580
7601,197691070,236451,197927521,6,0,0,35328,19,9528693615
7602,197710010,12995,197723005,3,0,1,25088,28,6973143864
7603,197722420,6278,197728698,6,0,1,6656,19,9746974069
7604,197775220,24154,197799374,5,0,1,43520,1,1303975851
7605,197782490,178718,197961208,6,0,0,109568,19,7421099271
7606,197898930,4162,197903092,0,0,1,11264,6,497221733
7607,197899219,28325,197927544,4,0,1,34304,9,7384524102
7608,197919360,41863,197961223,6,0,1,3584,19,2303506006
7609,197988440,34367,198022807,6,0,1,56832,19,5597177269
7610,198014260,9315,198023575,3,0,1,11776,28,789993850
7611,198111430,23378,198134808,0,0,1,41984,6,8381480882
7612,198158809,1042,198159851,4,0,1,1024,9,1605649381
7613,198189550,566,198190116,5,0,1,512,1,1977248021
7614,198200470,13512,198213982,5,0,1,26112,1,8356333293
7615,198221050,1518,198222568,5,0,1,1536,1,6244438912
7616,198237660,5326,198242986,5,0,1,5632,1,721400310
7617,198240980,5196,198246176,3,0,1,13312,28,6770245326
7618,198261680,10241,198271921,5,0,1,16384,1,8051174774
7619,198283439,1994,198285433,4,0,1,2048,9,10213426724
7620,198319800,164441,198484241,8,0,1,266752,12,5001802538
7621,198360809,134774,198495583,4,0,1,37888,9,1825331845
7622,198373770,127817,198501587,5,0,1,28672,1,1625009316
7623,198397100,172638,198569738,6,0,0,111104,19,4139508881
7624,198404760,103036,198507796,9,0,1,21504,10,3176389150
7625,198500890,10132,198511022,5,0,1,5120,1,10121209937
7626,198624230,5971,198630201,0,0,1,14848,6,6496343949
7627,198726079,5712,198731791,4,0,1,14336,9,9039601734
7628,198733450,5326,198738776,0,0,1,5632,6,1739197835
7629,198742461,13253,198755714,2,0,1,25600,0,697527742
7630,198796810,106964,198903774,6,0,0,51200,19,7087968541
7631,198822141,145923,198968064,3,0,0,29184,28,4406038742
7632,198826620,3645,198830265,0,0,1,10240,6,1819167507
7633,198948339,4937,198953276,4,0,1,12800,9,6385417795
7634,198954970,13109,198968079,5,0,1,8192,1,4453797672
7635,198970661,208986,199179647,3,0,0,108544,28,7169663033
7636,199001700,3904,199005604,5,0,1,10752,1,893285293
7637,199040360,1994,199042354,3,0,1,2048,28,7457882130
7638,199055560,3387,199058947,0,0,1,9728,6,9175492378
7639,199069469,23208,199092677,1,0,1,38400,23,2347477838
7640,199074110,233544,199307654,6,0,0,131072,19,8474688560
7641,199083180,23120,199106300,0,0,1,41472,6,8278208630
7642,199084160,23216,199107376,3,0,1,13312,28,8178072569
7643,199086490,21552,199108042,3,0,1,11264,28,7525866896
7644,199100420,8083,199108503,5,0,1,10240,1,8796226847
7645,199101430,9339,199110769,7,0,1,3584,14,8192129579
7646,199156060,49042,199205102,3,0,1,46080,28,4459203302
7647,199164310,379166,199543476,6,0,0,187904,19,6148663179
7648,199232060,1994,199234054,3,0,1,2048,28,6385197604
7649,199263210,3904,199267114,5,0,1,10752,1,9386647851
7650,199269301,349732,199619033,3,0,0,224256,28,7090076856
7651,199285340,33881,199319221,3,0,1,18944,28,5327549836
7652,199294389,39953,199334342,4,0,1,33792,9,4798937351
7653,199404900,5196,199410096,5,0,1,13312,1,6128265219
7654,199425010,16354,199441364,5,0,1,31744,1,2587993180
7655,199492641,247644,199740285,3,0,0,57856,28,593498747
7656,199493040,126008,199619048,5,0,1,47616,1,10430561665
7657,199496039,123024,199619063,4,0,1,22528,9,10257827093
7658,199523871,140424,199664295,3,0,0,41472,28,6726436066
7659,199593840,39502,199633342,0,0,1,27648,6,1610226701
7660,199679750,3904,199683654,0,0,1,10752,6,1256900133
7661,199687070,139219,199826289,6,0,0,40448,19,5707027307
7662,199726990,38491,199765481,6,0,1,45568,19,4262477511
7663,199730780,47293,199778073,5,0,1,43008,1,265661411
7664,199765370,14329,199779699,5,0,1,2560,1,9998280476
7665,199794611,192050,199986661,3,0,0,155136,28,1220272517
7666,199853510,3898,199857408,6,0,1,4096,19,3490859971
7667,199896720,89956,199986676,6,0,1,71680,19,7529485358
7668,199925950,60741,199986691,0,0,1,2560,6,7254242888
7669,199932879,53827,199986706,4,0,1,34816,9,4604459729
7670,199994210,10757,200004967,6,0,1,17408,19,9714469310
7671,199999970,6623,200006593,5,0,1,2560,1,10525521379
7672,200153819,12825,200166644,4,0,1,21504,9,8991651576
7673,200214240,267668,200481908,6,0,0,264704,19,3427682292
7674,200237599,11533,200249132,4,0,1,18944,9,2537153673
7675,200280750,4850,200285600,0,0,1,5120,6,9672745752
7676,200317090,168304,200485394,6,0,0,11264,19,3739920118
7677,200351730,5802,200357532,6,0,1,6144,19,7804630506
7678,200370271,117954,200488225,3,0,0,9216,28,9575811406
7679,200373691,264528,200638219,3,0,0,134656,28,4479809660
7680,200397359,84564,200481923,4,0,1,29184,9,895995863
7681,200412809,78862,200491671,4,0,1,9728,9,212173839
7682,200418089,75153,200493242,4,0,1,2048,9,7647162225
7683,200419660,75082,200494742,6,0,1,8704,19,4846862399
7684,200424250,76503,200500753,5,0,1,15360,1,1763988844
7685,200445860,55559,200501419,6,0,1,1024,19,8503895955
7686,200457751,110386,200568137,3,0,0,1024,28,9628255406
7687,200459690,70575,200530265,5,0,1,49664,1,1274765861
7688,200466890,64553,200531443,5,0,1,13824,1,326560199
7689,200597800,44590,200642390,0,0,1,11264,6,5798510176
7690,200622450,24406,200646856,5,0,1,13312,1,1464408086
7691,200658610,154952,200813562,6,0,0,67072,19,5017137588
7692,200672720,4850,200677570,0,0,1,5120,6,27602054
7693,200702130,340114,201042244,6,0,0,124416,19,7340281658
7694,200715120,6754,200721874,0,0,1,7168,6,3198288576
7695,200766510,237811,201004321,6,0,0,207360,19,3394587473
7696,200815450,13858,200829308,6,0,1,23552,19,10278227801
7697,200863770,5802,200869572,5,0,1,6144,1,2407724065
7698,200908291,6278,200914569,2,0,1,6656,0,842492174
7699,200908560,11155,200919715,5,0,1,8192,1,1066200684
7700,200930120,126414,201056534,6,0,0,29696,19,8604391132
7701,200984980,58791,201043771,5,0,1,1536,1,1979787994
7702,201022339,25061,201047400,1,0,1,12288,23,10224750931
7703,201045100,101755,201146855,6,0,0,20480,19,10314603185
7704,201116691,21658,201138349,2,0,1,35328,0,7470911235
7705,201123020,23850,201146870,5,0,1,5120,1,545837233
7706,201144291,15566,201159857,2,0,1,25088,0,3700718359
7707,201179901,276333,201456234,3,0,0,210432,28,803504552
7708,201189100,12825,201201925,6,0,1,21504,19,6227599523
7709,201192861,12290,201205151,2,0,1,5120,0,6982264304
7710,201202269,6428,201208697,1,0,1,5632,23,3855301407
7711,201228241,4679,201232920,2,0,1,12288,0,3384182841
7712,201298830,3904,201302734,6,0,1,10752,19,3659869410
7713,201313690,10757,201324447,6,0,1,17408,19,1109416389
7714,201328341,249472,201577813,3,0,0,64512,28,6887020692
7715,201341791,3898,201345689,2,0,1,4096,0,7364912735
7716,201361520,4420,201365940,6,0,1,11776,19,6730107784
7717,201470570,7230,201477800,6,0,1,7680,19,6845274100
7718,201503180,285492,201788672,6,0,0,232960,19,6600575670
7719,201557890,19938,201577828,6,0,1,15360,19,537897412
7720,201574580,13997,201588577,5,0,1,17408,1,4183253404
7721,201586170,131507,201717677,6,0,0,14848,19,9234625862
7722,201586231,11274,201597505,2,0,1,18432,0,6959859725
7723,201590460,15319,201605779,6,0,1,23552,19,7148378914
7724,201591800,374413,201966213,6,0,0,48640,19,5208495436
7725,201613519,11274,201624793,1,0,1,18432,23,179165515
7726,201630230,250693,201880923,6,0,0,112640,19,5099603230
7727,201667840,122103,201789943,6,0,0,4096,19,6117692359
7728,201701811,378950,202080761,3,0,0,77824,28,1671308205
7729,201705090,7230,201712320,5,0,1,7680,1,1467630551
7730,201725940,248987,201974927,8,0,1,300032,12,8126155582
7731,201769870,679218,202449088,6,0,0,73216,19,4057974898
7732,201783220,643545,202426765,6,0,0,559616,19,4186483135
7733,201783459,192134,201975593,1,0,1,1024,23,3454067511
7734,201953051,28853,201981904,2,0,1,22016,0,349823824
7735,201966930,15742,201982672,9,0,1,11776,10,2695624410
7736,201979681,13083,201992764,2,0,1,22016,0,3151878068
7737,202014209,4162,202018371,1,0,1,11264,23,3950449145
7738,202077299,5924,202083223,1,0,1,2560,23,10325939043
7739,202103420,414190,202517610,6,0,0,223232,19,8619216678
7740,202108990,4374,202113364,7,0,1,4608,14,1335918767
7741,202127980,4162,202132142,7,0,1,11264,14,8382580228
7742,202178971,270608,202449579,3,0,0,1536,28,3604842448
7743,202189970,13858,202203828,8,0,1,23552,12,6334303064
7744,202338819,179341,202518160,4,0,1,512,9,9953711100
7745,202437861,472004,202909865,3,0,0,321536,28,5481542782
7746,202461131,66960,202528091,2,0,1,16384,0,9638412289
7747,202477840,68897,202546737,7,0,1,43008,14,8543151670
7748,202493000,54505,202547505,9,0,1,11776,10,3471066176
7749,202496459,56435,202552894,1,0,1,17408,23,5958062253
7750,202526581,31702,202558283,2,0,1,17408,0,3305930
7751,202544300,19168,202563468,8,0,1,24576,12,10482725702
7752,202546700,18048,202564748,8,0,1,14336,12,2598704903
7753,202616311,6278,202622589,2,0,1,6656,0,9792424143
7754,202635500,3904,202639404,8,0,1,10752,12,6697447679
7755,202676340,6278,202682618,0,0,1,6656,6,4329640869
7756,202678870,21399,202700269,7,0,1,34816,14,7909624133
7757,202706809,1994,202708803,1,0,1,2048,23,7512222263
7758,202774500,1042,202775542,7,0,1,1024,14,1008587564
7759,202807389,102491,202909880,1,0,1,20480,23,1576446886
7760,202837080,77146,202914226,9,0,1,11264,10,4424004210
7761,202839371,100604,202939975,2,0,1,48128,0,3294505679
7762,202844650,96631,202941281,7,0,1,2048,14,3758539093
7763,202856250,96885,202953135,7,0,1,40448,14,5441448662
7764,202867650,89031,202956681,0,0,1,5632,6,8707943041
7765,202884530,77438,202961968,0,0,1,16896,6,1238386858
7766,202884720,80794,202965514,8,0,1,5632,12,9445897351
7767,202887400,78460,202965860,0,0,1,512,6,5254985602
7768,202891771,75395,202967166,2,0,1,2048,0,5723557691
7769,202956180,17707,202973887,7,0,1,24064,14,3378588899
7770,202961269,12977,202974246,1,0,1,9728,23,5283911928
7771,202969031,136881,203105912,3,0,0,1536,28,4636257611
7772,202995920,3422,202999342,0,0,1,3584,6,8318530982
7773,203001189,5802,203006991,1,0,1,6144,23,8798139397
7774,203014901,2470,203017371,2,0,1,2560,0,5232504949
7775,203102570,11274,203113844,8,0,1,18432,12,749860261
7776,203183330,2470,203185800,7,0,1,2560,14,3780906815
7777,203192570,1518,203194088,8,0,1,1536,12,10467551589
7778,203242171,1042,203243213,2,0,1,1024,0,2614055614
7779,203255400,16354,203271754,8,0,1,31744,12,5006450281
7780,203294650,12308,203306958,8,0,1,20480,12,9212274814
7781,203300680,7251,203307931,9,0,1,12800,10,3167555261
7782,203306350,16354,203322704,0,0,1,31744,6,8992251906
7783,203363931,85753,203449684,3,0,0,16896,28,5206209935
7784,203376461,6754,203383215,2,0,1,7168,0,10204894541
7785,203379340,24154,203403494,7,0,1,43520,14,3246219006
7786,203392361,171173,203563534,3,0,0,81920,28,1464747255
7787,203395189,9688,203404877,1,0,1,14848,23,4550963192
7788,203424419,228669,203653088,5,0,0,49152,1,69183673
7789,203430671,201038,203631709,3,0,0,32256,28,9014474303
7790,203442891,375553,203818444,3,0,0,244736,28,10518550412
7791,203452330,5196,203457526,9,0,1,13312,10,3822548324
7792,203476910,36604,203513514,0,0,1,64512,6,9503929111
7793,203485020,31720,203516740,0,0,1,5120,6,7485199529
7794,203518389,4679,203523068,1,0,1,12288,23,785357110
7795,203526810,5326,203532136,7,0,1,5632,14,7257442266
7796,203590970,15321,203606291,9,0,1,29696,10,6173994160
7797,203608500,23983,203632483,0,0,1,39936,6,586322801
7798,203629631,23472,203653103,2,0,1,23552,0,8818027786
7799,203650669,84834,203735503,1,0,1,133632,23,50206664
7800,203658680,78411,203737091,8,0,1,15872,12,7580680946
7801,203659410,78667,203738077,0,0,1,1536,6,4086619017
7802,203679200,482889,204162089,8,0,0,212480,12,4713366637
7803,203693389,125070,203818459,1,0,1,113152,23,3540147621
7804,203704640,113834,203818474,8,0,1,27136,12,4222309088
7805,203718169,109083,203827252,1,0,1,142336,23,350580648
7806,203727630,101107,203828737,9,0,1,15360,10,9586049558
7807,203742090,88235,203830325,7,0,1,15872,14,3056938308
7808,203754450,77463,203831913,0,0,1,15872,6,4666023314
7809,203769059,71454,203840513,1,0,1,20480,23,1059693978
7810,203815699,28680,203844379,4,0,1,6144,9,4399614458
7811,203826201,404382,204230583,3,0,0,58368,28,350354586
7812,203827670,42773,203870443,0,0,1,59392,6,2887444165
7813,203871570,7706,203879276,8,0,1,8192,12,1776745466
7814,203958800,96062,204054862,1,0,1,160256,23,3863426131
7815,203961349,98659,204060008,4,0,1,8192,9,4621137154
7816,203996690,84926,204081616,1,0,1,70656,23,10300276550
7817,204014079,72363,204086442,4,0,1,7680,9,9678463408
7818,204033300,59453,204092753,5,0,1,22016,1,7343438285
7819,204059140,102972,204162112,5,0,1,20992,1,7386784223
7820,204098630,131968,204230598,1,0,1,90112,23,10114064046
7821,204115469,115144,204230613,4,0,1,9728,9,7644313694
7822,204120020,110608,204230628,1,0,1,39936,23,6092326876
7823,204134800,98629,204233429,5,0,1,19968,1,88556805
7824,204157630,180435,204338065,1,0,1,210944,23,973538889
7825,204206909,135662,204342571,4,0,1,7168,9,302618553
7826,204209980,134537,204344517,8,0,1,3072,12,9213586534
7827,204213201,404013,204617214,3,0,0,94720,28,843556789
7828,204321110,305533,204626643,9,0,0,18432,10,7728161610
7829,204332651,22184,204354835,2,0,1,32768,0,4550743356
7830,204344310,162126,204506436,9,0,0,512,10,8857213266
7831,204349641,8420,204358061,2,0,1,5120,0,8438077303
7832,204379290,6754,204386044,5,0,1,7168,1,5988986872
7833,204404539,3898,204408437,4,0,1,4096,9,6346205314
7834,204409620,5326,204414946,0,0,1,5632,6,8004267579
7835,204429240,197574,204626814,9,0,0,512,10,2786891583
7836,204574020,1042,204575062,0,0,1,1024,6,470274297
7837,204634750,12049,204646799,5,0,1,19968,1,4143744304
7838,204644670,11791,204656461,7,0,1,19456,14,1102575190
7839,204666869,41391,204708260,1,0,1,67072,23,300714659
7840,204694270,14656,204708926,0,0,1,1024,6,9876368243
7841,204729920,13341,204743261,1,0,1,22528,23,4886596258
7842,204773700,200033,204973733,9,0,0,4608,10,3319450015
7843,204793040,84128,204877168,1,0,1,140288,23,5343329166
7844,204797430,81044,204878474,0,0,1,2048,6,2934215227
7845,204814141,192184,205006325,3,0,0,1024,28,2634613382
7846,204823160,65939,204889099,1,0,1,42496,23,6368576336
7847,204905980,5454,204911434,6,0,1,13824,19,3269231576
7848,204917710,24412,204942122,1,0,1,44032,23,5700689580
7849,204961130,4937,204966067,8,0,1,12800,12,3758366515
7850,204962930,119236,205082166,1,0,1,194560,23,3271407227
7851,204971300,289816,205261116,9,0,0,9216,10,657377807
7852,204972760,250301,205223061,1,0,1,326656,23,1846055289
7853,205036200,187207,205223407,5,0,1,512,1,4563226558
7854,205079140,147493,205226633,6,0,1,5120,19,3627902731
7855,205127300,99589,205226889,9,0,1,9216,10,10265976723
7856,205152950,80352,205233302,1,0,1,22528,23,10528107478
7857,205175130,60438,205235568,8,0,1,3584,12,5356100479
7858,205194391,45363,205239754,2,0,1,6656,0,4636041105
7859,205231580,11080,205242660,5,0,1,4608,1,3915668111
7860,205273300,74091,205347391,1,0,1,120832,23,8300342508
7861,205293250,55767,205349017,6,0,1,2560,19,9536372220
7862,205293370,62163,205355533,1,0,1,23040,23,1334930319
7863,205339699,114245,205453944,1,0,1,188928,23,2534045324
7864,205391160,67969,205459129,6,0,1,24576,19,2135403979
7865,205422950,40045,205462995,8,0,1,6144,12,3991529639
7866,205437261,138929,205576190,3,0,0,28672,28,5916973646
7867,205451090,337818,205788908,1,0,0,173056,23,8207883711
7868,205465800,566,205466366,9,0,1,512,10,206077156
7869,205508620,6754,205515374,5,0,1,7168,1,8546310136
7870,205519260,13512,205532772,9,0,1,26112,10,3128327481
7871,205521700,14938,205536638,9,0,1,6144,10,4470422717
7872,205526930,10054,205536984,6,0,1,512,19,10653637230
7873,205573130,6439,205579569,5,0,1,9728,1,3612441803
7874,205610320,5454,205615774,5,0,1,13824,1,1218143050
7875,205611680,8703,205620383,5,0,1,6144,1,1912880149
7876,205619729,235833,205855562,1,0,1,382464,23,4483027601
7877,205627990,230478,205858468,0,0,1,4608,6,5014699096
7878,205629950,233024,205862974,6,0,1,7168,19,1710449531
7879,205637630,226829,205864459,5,0,1,15360,1,1212723990
7880,205665381,381367,206046748,3,0,0,25088,28,5832868145
7881,205680770,187235,205868005,0,0,1,5632,6,2040581625
7882,205682370,191024,205873394,9,0,1,17408,10,4641784717
7883,205718040,161972,205880012,6,0,1,23552,19,3883369572
7884,205731750,153408,205885158,8,0,1,8192,12,4438667564
7885,205766640,129655,205896295,5,0,1,36864,1,9351780288
7886,205797750,102731,205900481,6,0,1,6656,19,781621105
7887,205858160,42987,205901147,0,0,1,1024,6,8829602264
7888,205858299,154021,206012320,1,0,1,249344,23,9020485961
7889,205936140,77486,206013626,9,0,1,2048,10,9646715904
7890,205949589,133808,206083397,1,0,1,217088,23,9439648234
7891,205987260,229242,206216502,9,0,0,2560,10,2653182739
7892,205989889,321283,206311172,1,0,1,478208,23,5208641271
7893,205991690,323668,206315358,0,0,1,6656,6,98801411
7894,206002330,315294,206317624,5,0,1,3584,1,87854421
7895,206039129,300205,206339334,1,0,1,79360,23,9593696096
7896,206091189,264210,206355399,1,0,1,52224,23,5748763359
7897,206091359,301354,206392713,1,0,1,121344,23,2449812467
7898,206117981,412642,206530623,3,0,0,25088,28,6997403560
7899,206125219,329654,206454873,1,0,1,207360,23,3255325015
7900,206125810,271224,206397034,9,0,0,512,10,2767826655
7901,206136371,164221,206300592,3,0,0,2048,28,1241386026
7902,206204549,272444,206476993,1,0,1,81408,23,5097375309
7903,206205621,648268,206853889,3,0,0,75776,28,8843662834
7904,206212211,454341,206666552,3,0,0,10752,28,2781622384
7905,206377660,220352,206598012,9,0,0,1024,10,2492302250
7906,206405810,213257,206619067,1,0,1,345088,23,2999435006
7907,206432250,191323,206623573,5,0,1,7168,1,5461616329
7908,206479630,160008,206639638,5,0,1,52224,1,5458183164
7909,206535460,319536,206854996,9,0,0,3584,10,6224698128
7910,206621981,450099,207072080,3,0,0,259072,28,10255716939
7911,206819800,7230,206827030,5,0,1,7680,1,9226964078
7912,206859570,20366,206879936,9,0,1,32768,10,374281738
7913,206862990,18892,206881882,5,0,1,3072,1,1532415098
7914,206879120,13341,206892461,6,0,1,22528,19,5617400366
7915,206905240,1042,206906282,9,0,1,1024,10,1320067492
7916,206949831,335011,207284842,3,0,0,59904,28,3439246655
7917,206964580,3128,206967708,5,0,1,9216,1,2036739952
7918,206974110,6278,206980388,5,0,1,6656,1,3300453942
7919,207074751,346118,207420869,3,0,0,4096,28,1368176158
7920,207147701,415237,207562938,3,0,0,317952,28,4024805580
7921,207165170,3904,207169074,5,0,1,10752,1,5260139587
7922,207172770,7706,207180476,6,0,1,8192,19,324016204
7923,207187390,4850,207192240,5,0,1,5120,1,8127702887
7924,207206451,370230,207576681,3,0,0,45056,28,10652574461
7925,207249030,16354,207265384,5,0,1,31744,1,10657361734
7926,207322080,16354,207338434,6,0,1,31744,19,9121395034
7927,207342450,234714,207577164,9,0,0,1536,10,8358525999
7928,207426890,13858,207440748,6,0,1,23552,19,8356363763
7929,207534630,43159,207577789,5,0,1,512,1,10287153036
7930,207537180,45525,207582705,6,0,1,5632,19,10426465093
7931,207564330,20961,207585291,6,0,1,4096,19,9902852205
7932,207575190,19698,207594888,6,0,1,28160,19,942672940
7933,207598510,180388,207778898,9,0,0,512,10,6147437658
7934,207610040,2870,207612910,6,0,1,8704,19,3778311048
7935,207623111,423716,208046827,3,0,0,468480,28,8795638223
7936,207736340,3422,207739762,7,0,1,3584,14,8282673963
7937,207762161,309985,208072146,3,0,0,82944,28,8013122794
7938,207892520,5326,207897846,5,0,1,5632,1,4108010376
7939,207911710,162915,208074625,6,0,1,2560,19,1892353705
7940,208001070,96107,208097177,5,0,1,40448,1,103410798
7941,208014090,89296,208103386,6,0,1,21504,19,6765763960
7942,208024290,80082,208104372,7,0,1,1536,14,2876332595
7943,208037320,72953,208110273,9,0,1,19968,10,9228318186
7944,208043940,70199,208114139,7,0,1,6144,14,10277453297
7945,208119240,24929,208144169,5,0,1,45056,1,6399976104
7946,208152920,13341,208166261,7,0,1,22528,14,7853992910
7947,208185620,23378,208208998,7,0,1,41984,14,6845355356
7948,208205810,43370,208249180,1,0,1,74240,23,59086601
7949,208251401,184632,208436033,3,0,0,11264,28,745570718
7950,208271810,2470,208274280,6,0,1,2560,19,1319887580
7951,208290870,135617,208426487,1,0,1,220672,23,8776018758
7952,208291931,357450,208649381,3,0,0,6656,28,1505300488
7953,208297450,254081,208551531,9,0,0,512,10,1500663754
7954,208371631,64417,208436048,2,0,1,23552,0,5911969662
7955,208383430,263908,208647338,9,0,0,79872,10,1071664382
7956,208433790,22874,208456664,9,0,1,33280,10,9556468334
7957,208477589,54100,208531689,1,0,1,88576,23,9339589660
7958,208525411,326162,208851573,3,0,0,103936,28,10610414410
7959,208572000,13600,208585600,7,0,1,23040,14,6020272600
7960,208592009,7706,208599715,1,0,1,8192,23,6275157746
7961,208602600,7706,208610306,9,0,1,8192,10,6463755165
7962,208835469,46845,208882314,1,0,1,49664,23,7295127793
7963,208901000,6278,208907278,9,0,1,6656,10,6247248583
7964,208905390,2234,208907624,9,0,1,512,10,4899527900
7965,208911340,3128,208914468,9,0,1,9216,10,10229859704
7966,208943900,11791,208955691,7,0,1,19456,14,5462899369
7967,208960100,207143,209167243,9,0,0,128512,10,1627886432
7968,208965811,162261,209128072,3,0,0,90112,28,5493340937
7969,209007080,4374,209011454,7,0,1,4608,14,2315948554
7970,209045060,178629,209223689,9,0,0,113152,10,6393266624
7971,209046601,236698,209283299,3,0,0,75776,28,7011852690
7972,209080559,172499,209253058,1,0,1,279040,23,10534248995
7973,209096410,162857,209259267,9,0,1,21504,10,4636597985
7974,209126029,157285,209283314,1,0,1,21504,23,6976092666
7975,209197680,398923,209596603,9,0,0,138752,10,9664844377
7976,209218820,395549,209614369,9,0,0,36352,10,6436651054
7977,209257061,235102,209492163,3,0,0,147968,28,2024073338
7978,209296651,339306,209635957,3,0,0,39936,28,10399007794
7979,209383199,125145,209508344,1,0,1,206848,23,3676981968
7980,209636611,269891,209906502,3,0,0,56832,28,6578733644
7981,209640791,229429,209870220,3,0,0,90112,28,10539661099
7982,209707699,31007,209738706,1,0,1,50176,23,1633061581
7983,209772109,35571,209807680,1,0,1,62464,23,5095826536
7984,209879190,6278,209885468,9,0,1,6656,10,4272542072
7985,209886461,361981,210248442,3,0,0,196608,28,7786804255
7986,209891440,18476,209909916,9,0,1,3584,10,10266918095
7987,209925490,471794,210397284,9,0,0,452096,10,1613255929
7988,210014119,7706,210021825,1,0,1,8192,23,918282282
7989,210101249,52549,210153798,1,0,1,85504,23,4406424253
7990,210233981,220296,210454277,3,0,0,47616,28,6406017966
7991,210287770,112945,210400715,9,0,1,3584,10,6120637510
7992,210377949,76343,210454292,1,0,1,67584,23,1035199563
7993,210402261,248349,210650610,3,0,0,25088,28,2135714115
7994,210586359,16096,210602455,1,0,1,31232,23,7926185257
7995,210620271,249371,210869642,3,0,0,258560,28,3792972676
7996,210637520,13105,210650625,0,0,1,14336,6,6692551575
7997,210714730,43200,210757930,1,0,1,70656,23,3946621814
7998,210762930,520496,211283426,9,0,0,274432,10,7681336480
7999,210821689,213161,211034850,1,0,1,268288,23,8742986022
8000,210885579,150859,211036438,1,0,1,15872,23,4586376250
8001,210914631,262829,211177460,3,0,0,154624,28,2841883829
8002,211020290,446757,211467047,9,0,0,273920,10,6963557039
8003,211039020,5802,211044822,0,0,1,6144,6,8482380040
8004,211081970,1994,211083964,9,0,1,2048,10,1252857997
8005,211088220,4162,211092382,9,0,1,11264,10,3727767315
8006,211160611,310203,211470814,3,0,0,12288,28,9894016454
8007,211160820,17699,211178519,9,0,1,1024,10,2029657681
8008,211335610,447739,211783349,6,0,0,303616,19,5844868132
8009,211385560,192967,211578527,9,0,0,66048,10,3260320621
8010,211443780,30490,211474270,9,0,1,3584,10,5088993634
8011,211457400,20736,211478136,9,0,1,6144,10,4165203378
8012,211468070,18995,211487065,9,0,1,25600,10,6761144764
8013,211477859,9974,211487833,1,0,1,11776,23,2539843594
8014,211528130,4374,211532504,7,0,1,4608,14,8031655741
8015,211741570,236263,211977833,9,0,0,177152,10,4679565162
8016,211847831,159361,212007192,3,0,0,96256,28,5677407406
8017,211868790,305692,212174482,6,0,0,232448,19,865319048
8018,211895690,4937,211900627,3,0,1,12800,28,700369594
8019,211930280,79341,212009621,3,0,1,2560,28,4534006277
8020,211956460,56067,212012527,3,0,1,4608,28,3592412229
8021,212044381,130460,212174841,3,0,0,1024,28,3291372755
8022,212054850,10499,212065349,7,0,1,16896,14,10039802335
8023,212106050,268704,212374754,6,0,0,72704,19,8490785538
8024,212110520,329343,212439863,6,0,0,110080,19,4887941316
8025,212124090,94218,212218308,9,0,1,71168,10,1962309792
8026,212124260,96954,212221214,7,0,1,4608,14,7320386368
8027,212131151,221436,212352587,3,0,0,118272,28,3805629621
8028,212165550,352434,212517984,9,0,0,52736,10,834689890
8029,212195150,31249,212226399,3,0,1,16384,28,9423047261
8030,212268060,566,212268626,9,0,1,512,10,2179818574
8031,212284250,4162,212288412,9,0,1,11264,10,6433942245
8032,212298920,100054,212398974,9,0,0,1024,10,7909253428
8033,212385130,1518,212386648,3,0,1,1536,28,6616201242
8034,212402470,37408,212439878,9,0,1,5632,10,3582270655
8035,212414320,199800,212614120,6,0,0,30208,19,5613569022
8036,212451770,242710,212694480,9,0,0,171008,10,7744764830
8037,212480850,1994,212482844,9,0,1,2048,10,10111452672
8038,212543420,1518,212544938,9,0,1,1536,10,8364170953
8039,212560180,442032,213002212,9,0,0,316416,10,3714554683
8040,212574760,39375,212614135,9,0,1,59904,10,1740502560
8041,212575120,39030,212614150,5,0,1,2560,1,2829532656
8042,212586290,281294,212867584,6,0,0,53248,19,7706771800
8043,212713510,367692,213081202,6,0,0,165376,19,1431258855
8044,212736801,293998,213030799,3,0,0,93696,28,5107417660
8045,212747430,340987,213088417,6,0,0,23552,19,2007191116
8046,212824170,498523,213322693,6,0,0,250880,19,1060776221
8047,212926471,422601,213349072,3,0,0,86528,28,4749414602
8048,212932519,155913,213088432,4,0,1,5120,9,4313341250
8049,212934599,161659,213096258,4,0,1,26112,9,8498757574
8050,212978001,423042,213401043,3,0,0,170496,28,5325504141
8051,213129761,278668,213408429,3,0,0,7168,28,4395801262
8052,213132739,5712,213138451,4,0,1,14336,9,10466931473
8053,213144239,14804,213159043,4,0,1,28672,9,3845468416
8054,213222860,183346,213406206,6,0,0,16896,19,8601082786
8055,213243720,189319,213433039,9,0,0,45056,10,5671756185
8056,213297149,135905,213433054,4,0,1,29696,9,2376462582
8057,213346900,109970,213456870,9,0,0,2560,10,7317046380
8058,213349230,238873,213588103,9,0,0,104960,10,8042942605
8059,213388769,44300,213433069,4,0,1,30208,9,5627705946
8060,213576920,253194,213830114,9,0,0,44032,10,5678606345
8061,213580459,9179,213589638,4,0,1,1536,9,5833865228
8062,213614400,180104,213794504,9,0,0,155136,10,3026453291
8063,213748689,81448,213830137,4,0,1,37888,9,2730255518
8064,213775059,55101,213830160,4,0,1,18432,9,950735395
8065,213781960,252328,214034288,6,0,0,67584,19,10433855071
8066,213817160,370019,214187179,9,0,0,128512,10,202080878
8067,213817731,217820,214035551,3,0,0,4096,28,7660966087
8068,213824050,480167,214304217,9,0,0,330240,10,1872989496
8069,213874540,329042,214203582,6,0,0,53760,19,4739362265
8070,213887540,578665,214466205,6,0,0,2560,19,5502922174
8071,213918370,427842,214346212,6,0,0,137728,19,10188969255
8072,213950590,4850,213955440,6,0,1,5120,19,9110533194
8073,213998150,394432,214392582,6,0,0,17408,19,7910891215
8074,214041810,345445,214387255,9,0,0,134656,10,7968568436
8075,214059459,375298,214434757,5,0,0,100864,1,2264087212
8076,214097130,368218,214465348,9,0,0,100352,10,7001612219
8077,214151981,320533,214472514,3,0,0,20480,28,6717117477
8078,214261161,541250,214802411,3,0,0,128512,28,1612059946
8079,214288580,111371,214399951,7,0,1,24576,14,7137573945
8080,214321970,143393,214465363,0,0,1,35840,6,9137325381
8081,214332210,133168,214465378,6,0,1,8192,19,7668202791
8082,214343890,122346,214466236,7,0,1,74240,14,8370464372
8083,214352580,223765,214576345,6,0,0,79360,19,8456539049
8084,214362530,103721,214466251,7,0,1,3072,14,8551262132
8085,214378150,333459,214711609,9,0,0,52224,10,3941394272
8086,214409070,74444,214483514,7,0,1,17920,14,8308567687
8087,214429901,290303,214720204,3,0,0,28160,28,9768563103
8088,214430560,56820,214487380,0,0,1,6144,6,7245467206
8089,214433480,55846,214489326,7,0,1,3072,14,10323437484
8090,214441389,48808,214490197,4,0,1,12288,9,8488579928
8091,214445920,154717,214600637,6,0,0,16896,19,885652293
8092,214457520,528941,214986461,9,0,0,161792,10,5346387966
8093,214463650,431749,214895399,9,0,0,272384,10,7257178621
8094,214468689,24414,214493103,4,0,1,4608,9,10208364820
8095,214536640,3645,214540285,6,0,1,10240,19,5729718771
8096,214542491,543307,215085798,3,0,0,35840,28,7685938687
8097,214549570,768410,215317980,9,0,0,408576,10,8494398722
8098,214574380,2999,214577379,0,0,1,1024,6,1110907431
8099,214606180,4850,214611030,0,0,1,5120,6,7197459360
8100,214662310,2946,214665256,6,0,1,3072,19,7915192803
8101,214726540,262440,214988980,8,0,0,8192,12,1403838606
8102,214793310,597120,215390430,8,0,0,95744,12,8846561933
8103,214816850,823276,215640126,9,0,0,263680,10,8835397301
8104,214908110,1994,214910104,0,0,1,2048,6,5417269308
8105,214949260,610503,215559763,6,0,0,93184,19,1330229832
8106,214964970,366769,215331739,8,0,0,45056,12,10308722395
8107,215010700,763341,215774041,9,0,0,175616,10,2337407705
8108,215063460,22353,215085813,7,0,1,19968,14,8073471996
8109,215069629,16199,215085828,4,0,1,16384,9,117646728
8110,215089060,21399,215110459,0,0,1,34816,6,4191587474
8111,215120971,346673,215467644,3,0,0,111104,28,323123388
8112,215171800,321254,215493054,9,0,0,52224,10,2716799050
8113,215240180,406201,215646381,6,0,0,20480,19,4875148389
8114,215280700,677627,215958327,8,0,0,289792,12,6204881238
8115,215288740,48187,215336927,7,0,1,13312,14,5533407295
8116,215376061,410639,215786700,3,0,0,41472,28,9644609367
8117,215414939,1042,215415981,4,0,1,1024,9,9381940527
8118,215416740,822216,216238956,6,0,0,88064,19,1149998759
8119,215432420,35247,215467667,6,0,1,6144,19,1816297749
8120,215433940,38633,215472573,6,0,1,12800,19,9716807980
8121,215478490,15122,215493612,0,0,1,512,6,1985623917
8122,215522840,333161,215856001,6,0,0,74240,19,7554787941
8123,215532160,293087,215825247,9,0,0,126464,10,9300060254
8124,215618969,35152,215654121,4,0,1,8192,9,55470597
8125,215632700,401136,216033836,9,0,0,206848,10,707594193
8126,215643991,185803,215829794,3,0,0,14848,28,5598705235
8127,215654840,12825,215667665,0,0,1,21504,6,1763243128
8128,215664809,33591,215698400,1,0,1,55296,23,4910716890
8129,215735330,424671,216160001,8,0,0,202240,12,9360212884
8130,215788879,67137,215856016,4,0,1,4096,9,7066692902
8131,215844680,113678,215958358,1,0,1,51200,23,3389003279
8132,215848490,225002,216073492,6,0,0,2048,19,9863146471
8133,215865380,95834,215961214,3,0,1,8704,28,7437271107
8134,215883540,79450,215962990,0,0,1,2048,6,10083894132
8135,215959959,4017,215963976,4,0,1,1536,9,9426913270
8136,215990360,53751,216044111,3,0,1,16384,28,6282581505
8137,216012680,32814,216045494,0,0,1,14848,6,1108482464
8138,216014799,59078,216073877,4,0,1,49152,9,2113201557
8139,216040960,43644,216084604,1,0,1,34816,23,3692101993
8140,216050820,38290,216089110,0,0,1,7168,6,5627494019
8141,216071330,23784,216095114,0,0,1,20480,6,5146434748
8142,216072981,198013,216270994,3,0,0,37888,28,3552157866
8143,216110981,477515,216588496,3,0,0,43520,28,3768101640
8144,216119740,344919,216464659,9,0,0,129536,10,6593875083
8145,216134000,291176,216425176,8,0,0,114688,12,4422264382
8146,216168510,10499,216179009,0,0,1,16896,6,6646080445
8147,216172440,101362,216273802,9,0,0,7168,10,5789205818
8148,216189760,49211,216238971,0,0,1,41984,6,1799037780
8149,216191240,318680,216509920,8,0,0,75264,12,9752381947
8150,216234210,15769,216249979,0,0,1,17920,6,6225648345
8151,216258320,472074,216730394,8,0,0,86016,12,6013012731
8152,216346130,118568,216464698,1,0,1,182272,23,5878712815
8153,216348130,542200,216890330,9,0,0,184320,10,8460854539
8154,216425250,329308,216754558,6,0,0,17408,19,7537491659
8155,216443040,27140,216470180,3,0,1,13824,28,3903207997
8156,216459731,442329,216902060,3,0,0,38400,28,1882324590
8157,216478861,478914,216957775,3,0,0,182784,28,5519039749
8158,216514549,11533,216526082,4,0,1,18944,9,6199022094
8159,216528220,4850,216533070,0,0,1,5120,6,2971162473
8160,216567530,476120,217043650,9,0,0,185856,10,7675968837
8161,216572429,16082,216588511,4,0,1,25600,9,8226934864
8162,216605180,1042,216606222,5,0,1,1024,1,7635375174
8163,216653470,397683,217051153,8,0,0,24576,12,9926872478
8164,216657060,424852,217081912,8,0,0,83456,12,6559050098
8165,216771170,524837,217296007,8,0,0,186880,12,7703103702
8166,216810930,307378,217118308,8,0,0,16896,12,178939436
8167,216826590,63755,216890345,8,0,1,30720,12,7777069080
8168,216869140,218730,217087870,9,0,0,19456,10,284400856
8169,216895461,288379,217183840,3,0,0,70656,28,8628004668
8170,216911960,323138,217235098,8,0,0,20992,12,4844751155
8171,216940100,38599,216978699,8,0,1,33792,12,2163159007
8172,217020610,35773,217056383,3,0,1,13312,28,9408324992
8173,217043441,269125,217312566,3,0,0,54272,28,7137837023
8174,217045879,36048,217081927,4,0,1,28160,9,129438360
8175,217098070,225191,217323261,1,0,1,365056,23,9328959368
8176,217112650,232116,217344766,3,0,1,78336,28,9920157999
8177,217159171,698706,217857877,3,0,0,14848,28,8643594233
8178,217216940,370819,217587759,8,0,0,81920,12,8660058944
8179,217219541,506127,217725668,3,0,0,203776,28,10657704837
8180,217219730,136275,217356005,9,0,1,45568,10,2643452794
8181,217254970,696646,217951616,8,0,0,25600,12,8343110514
8182,217292070,68761,217360831,3,0,1,7680,28,56962817
8183,217298171,531112,217829283,3,0,0,146432,28,7685234262
8184,217357870,630757,217988627,8,0,0,114688,12,3677360600
8185,217362411,230819,217593230,3,0,0,4608,28,241196105
8186,217375309,30749,217406058,1,0,1,49664,23,8051511320
8187,217375450,30954,217406404,1,0,1,512,23,9875044059
8188,217401740,6610,217408350,3,0,1,3072,28,3983654224
8189,217420070,433260,217853330,1,0,0,78848,23,6055535696
8190,217432250,1518,217433768,9,0,1,1536,10,9187136449
8191,217441460,13083,217454543,8,0,1,22016,12,9518148170
8192,217446340,618732,218065072,1,0,0,34816,23,8866654613
8193,217448380,40616,217488996,8,0,1,65536,12,5622945126
8194,217541180,2946,217544126,8,0,1,3072,12,692362129
8195,217602610,3128,217605738,3,0,1,9216,28,10456565319
8196,217624050,313046,217937096,6,0,0,139264,19,3189235529
8197,217690770,45647,217736417,9,0,1,17408,10,6831515622
8198,217740661,265880,218006541,3,0,0,13824,28,2459086137
8199,217797150,61335,217858485,9,0,1,13312,10,107694354
8200,217852540,8751,217861291,8,0,1,3584,12,2981539980
8201,217872510,2946,217875456,3,0,1,3072,28,7322218361
8202,217874830,62281,217937111,8,0,1,32768,12,4266504346
8203,217900770,304004,218204774,8,0,0,11776,12,3643696070
8204,217912490,39141,217951631,5,0,1,18944,1,10215534596
8205,217928621,269518,218198139,3,0,0,22528,28,9633181955
8206,217980680,34160,218014840,1,0,1,47616,23,10525261449
8207,218004450,11056,218015506,8,0,1,1024,12,3231754201
8208,218019340,309159,218328499,6,0,0,124416,19,4798209635
8209,218021360,7706,218029066,9,0,1,8192,10,7345486073
8210,218026620,4162,218030782,9,0,1,11264,10,4948205788
8211,218041201,353261,218394462,3,0,0,140800,28,2926453400
8212,218061210,35895,218097105,3,0,1,52224,28,2956666045
8213,218075830,328351,218404181,1,0,0,31744,23,1742672573
8214,218076601,26508,218103109,2,0,1,20480,0,4423384105
8215,218078360,273172,218351532,1,0,0,44544,23,9766653057
8216,218084110,24184,218108294,9,0,1,24576,10,9782540734
8217,218094570,20342,218114912,8,0,1,23552,12,1280246331
8218,218112080,225850,218337930,6,0,0,25088,19,4128379414
8219,218119790,12308,218132098,8,0,1,20480,12,113522454
8220,218131710,2946,218134656,9,0,1,3072,10,6922128763
8221,218211541,211866,218423407,3,0,0,14848,28,2568904292
8222,218241070,2470,218243540,7,0,1,2560,14,1613827010
8223,218317500,20445,218337945,3,0,1,2048,28,2718845
8224,218325490,26057,218351547,9,0,1,21504,10,8714566242
8225,218354930,52632,218407562,9,0,1,3584,10,10001288639
8226,218358390,58633,218417023,9,0,1,19456,10,7489206352
8227,218374880,43219,218418099,9,0,1,13312,10,380949636
8228,218390450,361789,218752239,1,0,0,154624,23,712081793
8229,218445290,229984,218675274,1,0,0,57856,23,7578315389
8230,218472680,232432,218705112,8,0,0,53248,12,4518054672
8231,218548030,13341,218561371,3,0,1,22528,28,6850832899
8232,218552440,10877,218563317,8,0,1,3072,12,8100218691
8233,218640020,142011,218782031,6,0,0,55808,19,6590190943
8234,218642140,3387,218645527,3,0,1,9728,28,143515260
8235,218656089,96181,218752270,1,0,1,143360,23,2256315071
8236,218670950,125735,218796685,3,0,1,76288,28,2330618884
8237,218734000,704443,219438443,6,0,0,11776,19,4087647172
8238,218748880,52631,218801511,8,0,1,7680,12,6134057456
8239,218765590,190266,218955856,3,0,1,281600,28,10144187079
8240,218771940,212220,218984160,1,0,0,77824,23,9691408385
8241,218779870,413608,219193478,9,0,0,45056,10,8438809533
8242,218791010,907338,219698348,9,0,0,62464,10,5946446776
8243,218794440,492618,219287058,8,0,0,55296,12,4037180190
8244,218835559,124483,218960042,4,0,1,6656,9,10026271055
8245,218844860,139315,218984175,9,0,1,12800,10,8349829045
8246,218861411,573429,219434840,3,0,0,442880,28,107327686
8247,218884660,99530,218984190,8,0,1,8192,12,5945151836
8248,218892740,786506,219679246,6,0,0,377344,19,6655630168
8249,218894530,89675,218984205,8,0,1,9216,12,6365070600
8250,218904280,964767,219869047,1,0,0,43008,23,8886982341
8251,218918480,1407718,220326198,8,0,0,279040,12,5696866987
8252,218923630,79589,219003219,3,0,1,126976,28,544292078
8253,219005271,1461854,220467125,3,0,0,119296,28,361128282
8254,219005910,1146525,220152435,9,0,0,158208,10,1829023314
8255,219043150,7706,219050856,9,0,1,8192,10,270742110
8256,219050860,142633,219193493,3,0,1,215552,28,6858364693
8257,219070180,123328,219193508,9,0,1,2560,10,6920196064
8258,219088580,104943,219193523,8,0,1,12800,12,3609595564
8259,219153190,40348,219193538,9,0,1,2048,10,880315405
8260,219193400,1383814,220577214,8,0,0,90112,12,3494024890
8261,219225290,43458,219268748,8,0,1,71168,12,764474467
8262,219257150,422135,219679285,3,0,1,550400,28,7125112657
8263,219298600,940953,220239553,8,0,0,38400,12,3657597148
8264,219299200,399171,219698371,3,0,1,189952,28,727619513
8265,219310880,387506,219698386,8,0,1,11776,12,9690637476
8266,219329641,884713,220214354,3,0,0,43520,28,2481647265
8267,219350050,348351,219698401,8,0,1,15872,12,5786924162
8268,219358860,351699,219710559,3,0,1,181248,28,3975326193
8269,219380100,1050646,220430746,6,0,0,102912,19,5736827359
8270,219399890,997544,220397434,9,0,0,233472,10,6547903973
8271,219417790,1091641,220509431,6,0,0,138752,19,8086257241
8272,219447740,263383,219711123,9,0,1,10752,10,3435805194
8273,219466100,604094,220070194,6,0,0,38912,19,9048877320
8274,219499690,1114162,220613852,6,0,0,61952,19,1136050904
8275,219501590,213079,219714669,9,0,1,5632,10,6018694044
8276,219561640,591614,220153254,9,0,0,2560,10,8867480467
8277,219569350,145678,219715028,8,0,1,9728,12,10199495224
8278,219578640,142904,219721544,9,0,1,23040,10,4487375268
8279,219605720,126778,219732498,9,0,1,43520,10,870222457
8280,219607360,126316,219733676,9,0,1,13824,10,1284345091
8281,219636650,100252,219736902,8,0,1,5120,12,7456698060
8282,219684230,910699,220594929,9,0,0,57856,10,7827215042
8283,219704360,1215035,220919395,8,0,0,60928,12,6732396948
8284,219777080,2470,219779550,8,0,1,2560,12,9652705847
8285,219826830,42232,219869062,3,0,1,58368,28,7193774580
8286,219827261,885231,220712492,3,0,0,38400,28,5075499438
8287,219827730,830705,220658435,6,0,0,83968,19,10064065568
8288,219837060,32017,219869077,9,0,1,12288,10,2439591706
8289,219867350,6569,219873919,9,0,1,5120,10,7291518946
8290,219871201,14117,219885318,2,0,1,24064,0,4982153634
8291,219896229,10499,219906728,4,0,1,16896,9,6483390118
8292,219903951,14804,219918755,2,0,1,28672,0,5300693233
8293,219907600,16647,219924247,9,0,1,17920,10,3834406219
8294,219916840,10313,219927153,9,0,1,4608,10,5487671319
8295,219922800,6619,219929419,8,0,1,3584,12,9493251967
8296,219965671,7706,219973377,2,0,1,8192,0,8014520866
8297,220025611,4850,220030461,2,0,1,5120,0,10395092561
8298,220032860,366515,220399375,6,0,0,6144,19,2927683849
8299,220038381,511354,220549735,3,0,0,102400,28,8262780007
8300,220039540,1009497,221049037,6,0,0,87040,19,3922560924
8301,220061690,19770,220081460,3,0,1,18432,28,8861495291
8302,220073691,15947,220089638,2,0,1,26624,0,4113236582
8303,220074450,86376,220160826,3,0,1,129536,28,3873230218
8304,220096050,1108093,221204143,6,0,0,40448,19,9803207403
8305,220111710,214543,220326253,3,0,1,267776,28,6131295318
8306,220112311,213957,220326268,2,0,1,4608,0,2959433482
8307,220185199,141084,220326283,4,0,1,10752,9,6855335139
8308,220192479,204970,220397449,4,0,1,2048,9,1992904479
8309,220202990,803413,221006403,9,0,0,283136,10,7580750479
8310,220208621,188843,220397464,2,0,1,4096,0,2214975542
8311,220286879,180261,220467140,4,0,1,14848,9,7314859373
8312,220306000,1350351,221656351,9,0,0,322560,10,4527971599
8313,220314861,1182655,221497516,3,0,0,206848,28,8011628875
8314,220316430,297445,220613875,3,0,1,338432,28,1107643436
8315,220317471,1117006,221434477,3,0,0,84480,28,7034956189
8316,220330000,328450,220658450,3,0,1,93184,28,5819986714
8317,220354400,1527024,221881424,1,0,0,161280,23,8568462740
8318,220383451,275014,220658465,2,0,1,16384,0,10274223157
8319,220418200,240280,220658480,8,0,1,11264,12,8048934464
8320,220423310,1408943,221832253,9,0,0,223232,10,10386598743
8321,220461029,197466,220658495,4,0,1,20992,9,409997864
8322,220479080,1224742,221703822,9,0,0,155648,10,795751808
8323,220508391,150119,220658510,2,0,1,6144,0,4721002632
8324,220512261,146264,220658525,2,0,1,26624,0,6214027411
8325,220516480,142060,220658540,8,0,1,11264,12,7237898169
8326,220516919,141636,220658555,4,0,1,1024,9,8726331218
8327,220528920,1374218,221903138,8,0,0,49152,12,1943851445
8328,220531410,866086,221397496,9,0,0,131584,10,4193381893
8329,220543680,1547332,222091012,6,0,0,89088,19,6751003368
8330,220552600,1698671,222251271,9,0,0,325632,10,9529016182
8331,220568949,100336,220669285,4,0,1,40448,9,4717013899
8332,220611420,1958451,222569871,1,0,0,370176,23,7394025902
8333,220682290,497640,221179930,1,0,0,20992,23,6293216051
8334,220689040,7348626,228037666,1,0,1,308736,23,9258584300
8335,220689361,2216094,222905455,3,0,0,72704,28,3765277645
8336,220719110,1858108,222577218,8,0,0,24064,12,9646471529
8337,220736850,1700437,222437287,9,0,0,121344,10,32566723
8338,220752360,1588166,222340526,6,0,0,292864,19,6271220774
8339,220760780,1206185,221966965,8,0,0,209408,12,4764524699
8340,220838770,7198911,228037681,7,0,1,24576,14,9259729444
8341,220850940,7186764,228037704,8,0,1,7680,12,3492949483
8342,220856581,1857200,222713781,3,0,0,132608,28,385425975
8343,220861051,1484810,222345861,3,0,0,17408,28,5687316132
8344,220883440,1573628,222457068,1,0,0,44544,23,2157333909
8345,220894301,7143418,228037719,2,0,1,5632,0,2803343112
8346,220958470,1013042,221971512,8,0,0,14848,12,7235512293
8347,220989101,7048633,228037734,2,0,1,9216,0,2194524257
8348,221004090,2113570,223117660,1,0,0,175104,23,187859209
8349,221054591,7222852,228277443,2,0,1,512,0,1551146782
8350,221055191,7222267,228277458,2,0,1,26624,0,1175089565
8351,221099810,2435755,223535565,9,0,0,147968,10,2374223255
8352,221168620,719527,221888147,8,0,0,22016,12,2971067471
8353,221174601,2110945,223285546,3,0,0,117248,28,5135572716
8354,221242280,1431082,222673362,9,0,0,42496,10,3528231320
8355,221263220,1935887,223199107,6,0,0,267264,19,10549141478
8356,221264860,2497302,223762162,8,0,0,315904,12,3016796434
8357,221283891,1505521,222789412,3,0,0,37888,28,7430559078
8358,221359240,2513228,223872468,6,0,0,104448,19,5895110463
8359,221379320,6925546,228304866,7,0,1,24064,14,7861938354
8360,221397210,1440399,222837609,1,0,0,100352,23,2682189647
8361,221407380,6897501,228304881,7,0,1,7168,14,2880933840
8362,221447521,1759097,223206618,3,0,0,24576,28,5762875306
8363,221457430,1875276,223332706,1,0,0,17920,23,1902657169
8364,221475280,2611434,224086714,9,0,0,300032,10,9089686670
8365,221510530,1739277,223249807,8,0,0,86528,12,9699789310
8366,221528540,7854809,229383349,7,0,1,5120,14,4100294207
8367,221580340,1710065,223290405,6,0,0,15872,19,2429394231
8368,221613500,1132596,222746096,8,0,0,105984,12,4136810878
8369,221614710,965191,222579901,6,0,0,8704,19,5935028831
8370,221619511,1922161,223541672,3,0,0,19968,28,2714253187
8371,221625620,1697731,223323351,1,0,0,103424,23,1733281526
8372,221640150,7745145,229385295,7,0,1,3072,14,6199097759
8373,221650001,1840457,223490458,3,0,0,248320,28,6267122129
8374,221659240,2603040,224262280,6,0,0,325632,19,8196337633
8375,221778041,2358548,224136589,3,0,0,27136,28,5108226
8376,221790410,1428391,223218801,1,0,0,39936,23,8637734701
8377,221864790,8193677,230058467,7,0,1,46592,14,7250144724
8378,221923161,1911681,223834842,3,0,0,218112,28,5449545070
8379,221923200,2462280,224385480,6,0,0,33792,19,1667799395
8380,221944430,802173,222746603,1,0,0,1536,23,259470638
8381,221953300,1338524,223291824,9,0,0,4608,10,568887874
8382,221986300,8310152,230296452,7,0,1,19968,14,4753992844
8383,221994830,1602137,223596967,9,0,0,109568,10,286814943
8384,222064810,930832,222995642,6,0,0,43008,19,8829097842
8385,222097950,1742679,223840629,9,0,0,18944,10,9624729912
8386,222157650,2208408,224366058,6,0,0,60928,19,3900342986
8387,222176570,2292707,224469277,9,0,0,43008,10,7768564979
8388,222182230,8231870,230414100,9,0,1,3072,10,4485238212
8389,222270070,8159373,230429443,9,0,1,20480,10,3017984150
8390,222330460,8272925,230603385,7,0,1,30208,14,780754384
8391,222358710,1254964,223613674,9,0,0,54784,10,319058922
8392,222401540,8244496,230646036,9,0,1,19456,10,10501906407
8393,222411550,1577306,223988856,8,0,0,167936,12,2216783105
8394,222419670,2708656,225128326,1,0,0,102400,23,1403275552
8395,222432680,2460328,224893008,8,0,0,55296,12,403490212
8396,222441290,1906181,224347471,6,0,0,279552,19,6914164225
8397,222500560,2232591,224733151,8,0,0,197120,12,3075613198
8398,222514151,1589598,224103749,3,0,0,55808,28,3164013762
8399,222569610,8085368,230654978,9,0,1,9216,10,8727723418
8400,222693920,1179499,223873419,6,0,0,3072,19,6227086682
8401,222715601,1873396,224588997,3,0,0,223232,28,195773289
8402,222720290,8263174,230983464,9,0,1,38912,10,2391158937
8403,222725750,2685050,225410800,8,0,0,423424,12,3204046444
8404,222737270,8246209,230983479,7,0,1,7680,14,3838726849
8405,222781580,8411615,231193195,9,0,1,38400,10,10442152935
8406,222783120,8817814,231600934,9,0,1,1536,10,6834701940
8407,222928920,1827498,224756418,8,0,0,76288,12,1140131902
8408,222959710,2536219,225495929,9,0,0,51200,10,9796319582
8409,223015649,2443214,225458863,5,0,0,157696,1,9360211382
8410,223027240,2647293,225674533,8,0,0,120320,12,8972174650
8411,223117620,8483329,231600949,7,0,1,5632,14,6868737432
8412,223181781,2578237,225760018,3,0,0,124416,28,8453199045
8413,223198879,1677242,224876121,5,0,0,185344,1,3032597580
8414,223232500,1915790,225148290,8,0,0,63488,12,191177828
8415,223292380,8308584,231600964,7,0,1,6144,14,8283917630
8416,223301849,1317988,224619837,5,0,0,52224,1,9881180748
8417,223311481,2653299,225964780,3,0,0,119808,28,10711900791
8418,223330260,787856,224118116,6,0,0,47104,19,8332554892
8419,223357039,2900451,226257490,5,0,0,363520,1,7436910529
8420,223365841,1009320,224375161,3,0,0,29696,28,7796046340
8421,223368450,2111808,225480258,6,0,0,70144,19,4832164527
8422,223405929,3139627,226545556,5,0,0,239104,1,6879170526
8423,223429310,2891617,226320927,8,0,0,145408,12,10577674691
8424,223453840,1458701,224912541,6,0,0,57856,19,1689657920
8425,223558970,2913719,226472689,6,0,0,155136,19,2516914978
8426,223611270,8138796,231750066,0,0,1,6656,6,10583208158
8427,223668350,720421,224388771,9,0,0,10752,10,7072773600
8428,223670660,8419058,232089718,7,0,1,65024,14,8039151362
8429,223686149,3267794,226953943,5,0,0,18432,1,6775124279
8430,223708350,3564167,227272517,9,0,0,468992,10,1215598041
8431,223717221,3006281,226723502,3,0,0,127488,28,3198627333
8432,223751130,2899014,226650144,8,0,0,79360,12,981398016
8433,223755810,3039556,226795366,1,0,0,97792,23,1319439688
8434,223832310,8257423,232089733,0,0,1,9216,6,4168247017
8435,223850220,8313266,232163486,0,0,1,22016,6,8957157512
8436,223852820,8311207,232164027,7,0,1,9728,14,10692359
8437,223870150,4368715,228238865,6,0,0,659968,19,7556004928
8438,223935160,1927053,225862213,8,0,0,335360,12,3548949399
8439,223954910,8841509,232796419,7,0,1,75776,14,4628433580
8440,223961180,3347397,227308577,9,0,0,50176,10,8059818347
8441,223966430,3114527,227080957,8,0,0,414720,12,6961977609
8442,223995149,2430257,226425406,5,0,0,190976,1,7901287006
8443,223995290,3279849,227275139,6,0,0,4608,19,1981793654
8444,224090520,3918232,228008752,6,0,0,46080,19,9423706486
8445,224101820,8894854,232996674,0,0,1,26112,6,4134689046
8446,224137060,8913198,233050258,7,0,1,512,14,1117214119
8447,224141780,3688886,227830666,8,0,0,257536,12,8925824022
8448,224215970,4061442,228277412,6,0,0,126464,19,1570857496
8449,224265021,3702361,227967382,3,0,0,54272,28,4391797676
8450,224269331,2415312,226684643,3,0,0,113152,28,8146407523
8451,224275160,2463856,226739016,1,0,0,22528,23,2216458702
8452,224277470,10188715,234466185,0,0,1,47616,6,6228013556
8453,224282060,10184148,234466208,7,0,1,4096,14,2289238761
8454,224305559,1821469,226127028,5,0,0,13824,1,4945306154
8455,224401191,1966012,226367203,3,0,0,11264,28,9227134259
8456,224404340,3896549,228300889,9,0,0,76800,10,10104032855
8457,224406050,11190374,235596424,0,0,1,14336,6,2511928391
8458,224414730,11735994,236150724,0,0,1,74752,6,4690340971
8459,224447821,2298246,226746067,3,0,0,23040,28,3658704266
8460,224456160,4009726,228465886,1,0,0,331776,23,6599061686
8461,224457550,11718632,236176182,0,0,1,5632,6,2366451796
8462,224505439,2120510,226625949,5,0,0,161792,1,2368302121
8463,224520321,2056309,226576630,3,0,0,95232,28,2981537746
8464,224535370,11642402,236177772,7,0,1,1024,14,7928085937
8465,224551670,4041262,228592932,8,0,0,5632,12,8838397349
8466,224559200,11718039,236277239,0,0,1,52736,6,7799353771
8467,224625500,3918199,228543699,6,0,0,90112,19,10686813814
8468,224626319,1650249,226276568,5,0,0,60416,1,10719649777
8469,224650170,11835247,236485417,5,0,1,512,1,4714653845
8470,224658589,11915545,236574134,4,0,1,19968,9,3806716874
8471,224671349,12868224,237539573,1,0,1,88576,23,5760104496
8472,224718790,13011502,237730292,7,0,1,1536,14,6267197512
8473,224743950,2965406,227709356,8,0,0,62976,12,10549477897
8474,224814580,2459132,227273712,1,0,0,3584,23,3852809967
8475,224815709,13079371,237895080,1,0,1,111104,23,5193290240
8476,224817710,13077385,237895095,0,0,1,5632,6,9267957991
8477,224852200,1979373,226831573,8,0,0,118784,12,3966314630
8478,224858239,13081291,237939530,4,0,1,22016,9,1145244314
8479,224934860,1612739,226547599,9,0,0,6656,10,3198077135
8480,224951019,1997293,226948312,5,0,0,114688,1,9888042985
8481,224975080,13042791,238017871,0,0,1,47104,6,3537677006
8482,225018250,1239895,226258145,1,0,0,2048,23,3053145755
8483,225020839,13139401,238160240,4,0,1,28160,9,1242575228
8484,225028330,3801504,228829834,6,0,0,257024,19,8823591896
8485,225118470,1613659,226732129,8,0,0,28160,12,1534925642
8486,225120400,13749287,238869687,7,0,1,27648,14,9033217137
8487,225125831,3726022,228851853,3,0,0,72192,28,5879906253
8488,225132800,3774556,228907356,6,0,0,23552,19,5178315653
8489,225170341,1955715,227126056,3,0,0,147968,28,4623249723
8490,225210900,2082350,227293250,6,0,0,59392,19,1743679519
8491,225235340,13691847,238927187,7,0,1,4608,14,3891813524
8492,225245750,3713135,228958885,8,0,0,126464,12,3875185234
8493,225299320,13627882,238927202,7,0,1,1024,14,8009617089
8494,225350249,13576968,238927217,4,0,1,4096,9,10448963931
8495,225355720,1518106,226873826,8,0,0,11776,12,1021158119
8496,225361031,3722846,229083877,3,0,0,5632,28,8508761531
8497,225371511,2579320,227950831,3,0,0,186368,28,7532321402
8498,225379229,13584568,238963797,4,0,1,28160,9,3163372194
8499,225379719,1474669,226854388,5,0,0,74752,1,5994499431
8500,225401370,1468837,226870207,1,0,0,51712,23,3579693064
8501,225421190,1938347,227359537,1,0,0,96768,23,1384375227
8502,225435621,2254444,227690065,3,0,0,203776,28,1812660024
8503,225449040,3602983,229052023,6,0,0,33280,19,3838346960
8504,225456729,3957560,229414289,5,0,0,40960,1,6731956437
8505,225456730,3722937,229179667,9,0,0,295424,10,3557835547
8506,225473730,1655868,227129598,8,0,0,8704,12,9233760544
8507,225543360,13420452,238963812,5,0,1,5632,1,2175542269
8508,225573651,2281210,227854861,3,0,0,79360,28,5148969593
8509,225597990,13450288,239048278,6,0,1,11776,19,7232121471
8510,225602220,13457053,239059273,6,0,1,22016,19,8396064677
8511,225604559,3701492,229306051,5,0,0,78336,1,7724036261
8512,225630410,13465341,239095751,7,0,1,10240,14,6932411284
8513,225655530,13460089,239115619,7,0,1,31232,14,9191572418
8514,225667430,13542777,239210207,6,0,1,17408,19,8739947075
8515,225718139,13492083,239210222,4,0,1,8192,9,563950062
8516,225743390,2578243,228321633,1,0,0,44544,23,2254150944
8517,225760399,13513057,239273456,4,0,1,6656,9,9620605746
8518,225907130,2087567,227994697,9,0,0,89600,10,6779248522
8519,225934540,13338931,239273471,0,0,1,9728,6,648149639
8520,225983220,1399295,227382515,8,0,0,65536,12,5403826411
8521,225985410,3292272,229277682,6,0,0,512,19,3979147957
8522,226014990,1574937,227589927,8,0,0,137216,12,6713107816
8523,226015220,13306657,239321877,7,0,1,35328,14,5111031278
8524,226028850,13340957,239369807,3,0,1,32768,28,9142963243
8525,226037561,1324955,227362516,3,0,0,9728,28,3339653104
8526,226041860,3619899,229661759,8,0,0,136192,12,5540897623
8527,226050499,2587532,228638031,5,0,0,147968,1,4846625208
8528,226115679,3783731,229899410,5,0,0,48640,1,3762019991
8529,226129910,2178136,228308046,6,0,0,2560,19,3184558504
8530,226134591,13402486,239537077,2,0,1,31232,0,7939705385
8531,226136340,2203754,228340094,6,0,0,512,19,2342697591
8532,226138840,2202892,228341732,6,0,0,2560,19,10092999014
8533,226142060,3565132,229707192,1,0,0,8704,23,6148030639
8534,226147960,2593406,228741366,1,0,0,140288,23,8211262548
8535,226149390,2155437,228304827,6,0,0,10240,19,6855318688
8536,226185850,13354773,239540623,6,0,1,5632,19,2670736976
8537,226196241,2388813,228585054,3,0,0,135680,28,63797319
8538,226197410,13628456,239825866,3,0,1,53248,28,5192258263
8539,226202870,3671474,229874344,1,0,0,96256,23,8212839956
8540,226222221,13787068,240009289,2,0,1,15872,0,5534632674
8541,226238401,1618231,227856632,3,0,0,5632,28,8617370847
8542,226240570,714012,226954582,6,0,0,2048,19,4806094123
8543,226273519,2205486,228479005,5,0,0,43008,1,2011004308
8544,226324500,13684804,240009304,6,0,1,10752,19,7927573077
8545,226331640,795211,227126851,6,0,0,2560,19,6501708869
8546,226348540,1386938,227735478,9,0,0,82944,10,9514644205
8547,226353170,2314702,228667872,8,0,0,25600,12,2264060489
8548,226354069,13655250,240009319,4,0,1,9216,9,4736572359
8549,226467411,2412225,228879636,3,0,0,91136,28,5927867086
8550,226515531,3547201,230062732,3,0,0,5120,28,4680723389
8551,226622270,2129237,228751507,9,0,0,31744,10,6031787766
8552,226622650,13386684,240009334,7,0,1,22016,14,8130510639
8553,226625070,2258348,228883418,8,0,0,8704,12,210202645
8554,226628620,13427590,240056210,7,0,1,512,14,5290127188
8555,226637175,3482004,230119179,1,0,0,44544,23,6431367255
8556,226703441,13352784,240056225,2,0,1,3584,0,4554474599
8557,226710350,3277931,229988281,9,0,0,75776,10,5247283259
8558,226728350,13327890,240056240,7,0,1,5120,14,4447204908
8559,226792110,14252996,241045106,3,0,1,431104,28,3039578434
8560,226805790,14242965,241048755,7,0,1,18432,14,6034107392
8561,226810510,14267293,241077803,7,0,1,27136,14,2649834031
8562,226831490,14247619,241079109,7,0,1,2048,14,3599037416
8563,226835220,2497834,229333054,9,0,0,88576,10,5723613598
8564,226839239,14249022,241088261,4,0,1,7680,9,7813640636
8565,226849290,2357404,229206694,1,0,0,88576,23,10477876337
8566,226859020,1178631,228037651,9,0,0,94720,10,5766863077
8567,226890310,1416941,228307251,6,0,0,512,19,10686895335
8568,226895070,2536370,229431440,8,0,0,38400,12,3539752502
8569,226959770,3336667,230296437,9,0,0,70656,10,504801643
8570,226966860,14122707,241089567,7,0,1,2048,14,2519345412
8571,226979430,1359846,228339276,1,0,0,57856,23,8931343165
8572,226984650,14151194,241135844,3,0,1,55808,28,10466600206
8573,226998700,3060874,230059574,9,0,0,3584,10,9067229740
8574,227001350,14355103,241356453,3,0,1,9216,28,5292841483
8575,227043450,14313026,241356476,3,0,1,72704,28,5643379521
8576,227092990,1423158,228516148,9,0,0,121856,10,2861320098
8577,227098660,1492493,228591153,9,0,0,19968,10,9728406733
8578,227106539,3122497,230229036,5,0,0,3584,1,1827429950
8579,227129770,1210153,228339923,6,0,0,2048,19,2404183695
8580,227143710,14286584,241430294,6,0,1,5632,19,2792797422
8581,227150091,1509966,228660057,3,0,0,68096,28,5697896678
8582,227170890,1859040,229029930,6,0,0,16384,19,373051524
8583,227183820,1123260,228307080,6,0,0,7168,19,7527283379
8584,227264650,445501,227710151,6,0,0,2560,19,9143860847
8585,227266560,2538352,229804912,9,0,0,29696,10,452737015
8586,227269231,14161078,241430309,2,0,1,512,0,7862912091
8587,227289251,2415274,229704525,3,0,0,30208,28,7366034177
8588,227291101,2187926,229479027,3,0,0,2048,28,7511076663
8589,227307340,14122984,241430324,3,0,1,5632,28,4890738432
8590,227354190,14834634,242188824,3,0,1,457216,28,6791999487
8591,227354370,3107266,230461636,8,0,0,83456,12,8780052978
8592,227381540,18632359,246013899,3,0,1,459264,28,253070520
8593,227399020,3173587,230572607,1,0,0,47104,23,613546478
8594,227401060,900632,228301692,9,0,0,2560,10,4442519302
8595,227436490,18593741,246030231,7,0,1,1536,14,7898698115
8596,227459400,18572777,246032177,7,0,1,3072,14,10576746057
8597,227462920,18571523,246034443,7,0,1,3584,14,1029325921
8598,227489530,3282415,230771945,1,0,0,130560,23,5029936971
8599,227498810,1381941,228880751,6,0,0,3584,19,4381929078
8600,227543000,18507545,246050545,6,0,1,512,19,345475460
8601,227563191,2401987,229965178,3,0,0,166400,28,3104242855
8602,227587590,19923794,247511384,3,0,1,164352,28,4653941230
8603,227618180,1072731,228690911,6,0,0,3072,19,8787724603
8604,227647949,2410487,230058436,5,0,0,229376,1,6490067655
8605,227656040,20455645,248111685,3,0,1,137216,28,6943479950
8606,227660840,20683296,248344136,3,0,1,43008,28,6667552096
8607,227666811,3393003,231059814,3,0,0,174592,28,9754560789
8608,227705310,2522440,230227750,9,0,0,199168,10,1490520911
8609,227718149,3500468,231218617,5,0,0,53248,1,3240536844
8610,227753650,21209747,248963397,3,0,1,241152,28,9263116258
8611,227767960,1753051,229521011,8,0,0,81408,12,738069059
8612,227773971,21189441,248963412,2,0,1,22016,0,3358942702
8613,227826200,813094,228639294,6,0,0,4096,19,4472541968
8614,227877280,4212423,232089703,8,0,0,249856,12,3103896193
8615,227910320,3839723,231750043,9,0,0,221184,10,1456503350
8616,227933029,21030398,248963427,4,0,1,2048,9,4179414977
8617,227954599,21008843,248963442,4,0,1,11264,9,7990969279
8618,227987699,3205481,231193180,5,0,0,72192,1,3210539650
8619,227989759,3901938,231891697,0,0,0,286720,6,9643446565
8620,227994480,3596580,231591060,1,0,0,149504,23,1543777691
8621,228028820,2611434,230640254,9,0,0,2048,10,2084643114
8622,228091630,2437777,230529407,9,0,0,71680,10,3946986670
8623,228098149,20891375,248989524,4,0,1,6656,9,3029969391
8624,228108200,20904316,249012516,3,0,1,30208,28,1550621825
8625,228139179,2500109,230639288,5,0,0,117760,1,10422130039
8626,228164181,2221615,230385796,3,0,0,157184,28,8061755389
8627,228166260,21104229,249270489,3,0,1,194560,28,7924824123
8628,228261220,3284273,231545493,1,0,0,105472,23,6880690255
8629,228291010,2630697,230921707,9,0,0,224256,10,9512424219
8630,228307320,21105022,249412342,3,0,1,76800,28,3375610548
8631,228315929,4150816,232466745,5,0,0,167936,1,6077644918
8632,228325910,3128304,231454214,6,0,0,3072,19,2400977577
8633,228342770,990767,229333537,6,0,0,1536,19,817627338
8634,228357351,21055014,249412365,2,0,1,13824,0,8954718448
8635,228374519,21040302,249414821,4,0,1,2048,9,3810880582
8636,228389799,2572559,230962358,5,0,0,50688,1,6449313505
8637,228393599,21021581,249415180,4,0,1,9728,9,4193750409
8638,228412531,21052814,249465345,2,0,1,6144,0,10592073367
8639,228439389,21025971,249465360,4,0,1,6144,9,9941604109
8640,228445361,1228581,229673942,2,0,0,39936,0,5927035998
8641,228482280,1914942,230397222,8,0,0,32768,12,736708680
8642,228532120,2639049,231171169,9,0,0,220160,10,3770238919
8643,228574589,2408844,230983433,5,0,0,69120,1,7190560628
8644,228576889,2697360,231274249,5,0,0,11776,1,6452987820
8645,228577400,1307175,229884575,9,0,0,32256,10,2573897735
8646,228591660,3615464,232207124,1,0,0,107520,23,2790838842
8647,228601740,1534133,230135873,6,0,0,5120,19,1424349969
8648,228649420,3995601,232645021,1,0,0,371200,23,8661195024
8649,228710520,3705026,232415546,8,0,0,392192,12,6001714592
8650,228751020,2243917,230994937,1,0,0,512,23,10048952948
8651,228802831,3993573,232796404,3,0,0,108544,28,9745423748
8652,228887430,2565817,231453247,8,0,0,48640,12,9119105161
8653,228898180,1421395,230319575,9,0,0,62464,10,8456997517
8654,228911130,1813156,230724286,9,0,0,30208,10,1294688350
8655,228911320,1149837,230061157,6,0,0,5120,19,403833758
8656,228930779,4342964,233273743,5,0,0,20992,1,5078470689
8657,228934020,4417319,233351339,9,0,0,51200,10,3284648713
8658,228944409,4052250,232996659,5,0,0,16896,1,402020905
8659,228973681,20501820,249475501,2,0,1,7680,0,7525170808
8660,229001230,1993536,230994766,8,0,0,13312,12,5274029672
8661,229030519,3132289,232162808,5,0,0,123392,1,5721811541
8662,229050759,2950162,232000921,5,0,0,12800,1,7329259432
8663,229062071,2705828,231767899,3,0,0,50688,28,3731330424
8664,229068919,2576684,231645603,5,0,0,146432,1,5266889106
8665,229083550,1519812,230603362,9,0,0,100864,10,4190438645
8666,229089880,3708013,232797893,6,0,0,512,19,9882288584
8667,229105810,4443715,233549525,9,0,0,151040,10,7536560225
8668,229106721,20369446,249476167,2,0,1,1024,0,3185609403
8669,229188331,20309989,249498320,2,0,1,18432,0,2252123993
8670,229219251,20327018,249546269,2,0,1,13824,0,8732165547
8671,229261401,20287183,249548584,2,0,1,3072,0,9622707512
8672,229322839,3545440,232868279,5,0,0,181248,1,4710775366
8673,229376811,20209521,249586332,2,0,1,16896,0,9328814881
8674,229404800,1530376,230935176,8,0,0,38912,12,3391982031
8675,229419870,3377812,232797682,1,0,0,4096,23,1182133644
8676,229425491,20195797,249621288,2,0,1,27648,0,5085440312
8677,229451101,20176340,249627441,2,0,1,17408,0,4641877546
8678,229470610,20161337,249631947,5,0,1,7168,1,2535619342
8679,229583371,20050842,249634213,2,0,1,3584,0,4472922794
8680,229641451,3408784,233050235,3,0,0,18944,28,3169809040
8681,229679890,548031,230227921,8,0,0,512,12,1923114263
8682,229741099,1205800,230946899,5,0,0,38400,1,9294101197
8683,229774020,2757838,232531858,1,0,0,82944,23,5023210142
8684,229816991,19822407,249639398,2,0,1,16384,0,5871263065
8685,229819090,568125,230387215,6,0,0,4608,19,9300155616
8686,229819101,19827003,249646104,2,0,1,8192,0,3733804318
8687,229844980,4328554,234173534,1,0,0,499712,23,3886932648
8688,229885501,19761001,249646502,2,0,1,8704,0,8864760064
8689,229899280,740335,230639615,6,0,0,1024,19,2631980167
8690,229907031,19743017,249650048,2,0,1,5632,0,6311738927
8691,229942511,1969325,231911836,3,0,0,66048,28,10158953922
8692,229956489,3032464,232988953,5,0,0,336896,1,10562194363
8693,229981920,19752227,249734147,5,0,1,27136,1,8439849766
8694,229993090,1928696,231921786,8,0,0,5120,12,4076516995
8695,230025290,1168232,231193522,6,0,0,1024,19,3834197257
8696,230050871,1550048,231600919,3,0,0,32256,28,4200202025
8697,230088229,19696508,249784737,1,0,1,61440,23,5687901277
8698,230207240,714794,230922034,6,0,0,1024,19,6709516950
8699,230242140,743694,230985834,1,0,0,7680,23,2725500115
8700,230253479,1689284,231942763,5,0,0,65024,1,2176607451
8701,230268570,261320,230529890,6,0,0,1536,19,1687361143
8702,230269651,19539338,249808989,2,0,1,4096,0,4098581456
8703,230366830,556475,230923305,6,0,0,4096,19,5192516047
8704,230392810,19417715,249810525,8,0,1,23552,12,9607604896
8705,230412791,19399680,249812471,2,0,1,3072,0,7599053638
8706,230432131,19383886,249816017,2,0,1,5632,0,9270054703
8707,230488880,19333311,249822191,8,0,1,19456,12,6773241712
8708,230498061,3864886,234362947,3,0,0,222208,28,2104362783
8709,230502100,19499555,250001655,8,0,1,65536,12,9000922178
8710,230549010,2164528,232713538,6,0,0,3072,19,10464873234
8711,230566180,19435490,250001670,8,0,1,12288,12,4505937801
8712,230584321,3881833,234466154,3,0,0,71680,28,2773928725
8713,230636949,3986124,234623073,5,0,0,29696,1,5373133862
8714,230722400,1990171,232712571,8,0,0,128000,12,3749411946
8715,230724829,2449621,233174450,5,0,0,209408,1,10593566888
8716,230748991,4087172,234836163,3,0,0,294400,28,1156319257
8717,230762789,4194628,234957417,5,0,0,136704,1,7671123039
8718,230764191,19237494,250001685,2,0,1,21504,0,729644523
8719,230787590,2256858,233044448,4,0,0,150528,9,8251832164
8720,230796720,2089546,232886266,8,0,0,58880,12,2118205655
8721,230808139,2587674,233395813,5,0,0,42496,1,8627518821
8722,230871680,2394997,233266677,1,0,0,302592,23,6372593983
8723,230915221,19086479,250001700,2,0,1,10240,0,4403007654
8724,230933501,2360600,233294101,3,0,0,65024,28,8776354743
8725,230999799,4198158,235197957,5,0,0,301568,1,7919207713
8726,231026881,19009801,250036682,2,0,1,35840,0,2037018754
8727,231038340,628247,231666587,6,0,0,1024,19,6246092277
8728,231088421,18948276,250036697,2,0,1,14848,0,10510574758
8729,231101869,19073798,250175667,1,0,1,231936,23,454740440
8730,231104330,19079054,250183384,8,0,1,2048,12,8529852308
8731,231118449,1388114,232506563,5,0,0,129024,1,3843172266
8732,231132590,19052100,250184690,8,0,1,2048,12,1794334008
8733,231152710,1610607,232763317,8,0,0,163328,12,9784962703
8734,231156911,19037320,250194231,2,0,1,16384,0,8836067254
8735,231226651,18968656,250195307,2,0,1,13312,0,4000809247
8736,231278290,18948774,250227064,8,0,1,4608,12,3248199222
8737,231331921,3976820,235308741,3,0,0,163328,28,4248599530
8738,231347360,2620512,233967872,1,0,0,90624,23,9776728412
8739,231371790,296437,231668227,6,0,0,3072,19,6201217061
8740,231374540,1955545,233330085,6,0,0,512,19,8801263111
8741,231412971,18814554,250227525,2,0,1,10240,0,7575466680
8742,231445650,1931831,233377481,1,0,0,3584,23,3221911890
8743,231446580,18781304,250227884,8,0,1,9728,12,4548500602
8744,231451231,18782759,250233990,2,0,1,20992,0,1682906037
8745,231472720,2321639,233794359,1,0,0,4608,23,5940678567
8746,231474791,2943121,234417912,3,0,0,14336,28,3735923386
8747,231542050,18693220,250235270,8,0,1,14336,12,9537399160
8748,231549601,2090291,233639892,3,0,0,139776,28,6020473473
8749,231625900,2615469,234241369,8,0,0,91136,12,6942077986
8750,231678620,1752769,233431389,1,0,0,512,23,1282205877
8751,231690221,18565299,250255520,2,0,1,22016,0,609121790
8752,231702191,18556875,250259066,2,0,1,5632,0,6473700478
8753,231723831,18547108,250270939,2,0,1,26112,0,4490892894
8754,231724460,438987,232163447,1,0,0,2048,23,3328464792
8755,231795279,435380,232230659,5,0,0,13312,1,5937808723
8756,231797329,1194143,232991472,5,0,0,8192,1,2509767051
8757,231900069,18421395,250321464,4,0,1,15872,9,1160947369
8758,231914459,18407020,250321479,4,0,1,512,9,7175947914
8759,231945359,18376135,250321494,4,0,1,34304,9,3934018181
8760,232008540,664968,232673508,9,0,0,93184,10,10302248818
8761,232012280,1753797,233766077,8,0,0,182784,12,302920693
8762,232077509,18276333,250353842,4,0,1,29184,9,1322745533
8763,232086890,380338,232467228,9,0,0,1536,10,4026926839
8764,232123699,18232729,250356428,4,0,1,4096,9,2556229484
8765,232124419,18273856,250398275,4,0,1,22016,9,6820348317
8766,232137789,18306451,250444240,4,0,1,23040,9,9208936373
8767,232144519,3674205,235818724,5,0,0,510464,1,1130425940
8768,232159030,894067,233053097,8,0,0,9216,12,4766275020
8769,232168879,18275925,250444804,4,0,1,10752,9,2440187532
8770,232210630,3638787,235849417,8,0,0,15360,12,2037800742
8771,232225670,1984890,234210560,8,0,0,120832,12,10206245238
8772,232230910,1086926,233317836,9,0,0,77824,10,6659406413
8773,232262450,550590,232813040,9,0,0,49664,10,7601183266
8774,232290210,2306947,234597157,1,0,0,2560,23,7317614774
8775,232343409,1147020,233490429,5,0,0,19456,1,9186087859
8776,232352630,1244643,233597273,9,0,0,146432,10,7559362911
8777,232364510,694097,233058607,6,0,0,1536,19,9657889776
8778,232384070,1408862,233792932,8,0,0,88064,12,5779649731
8779,232459061,17989737,250448798,2,0,1,16896,0,364587702
8780,232479680,17969784,250449464,8,0,1,1024,12,1391102460
8781,232484940,2374676,234859616,1,0,0,1024,23,7558404271
8782,232496621,17953714,250450335,2,0,1,12288,0,5704935646
8783,232501780,772454,233274234,6,0,0,1536,19,6240385118
8784,232518929,479640,232998569,5,0,0,6144,1,9460298987
8785,232529479,2576579,235106058,5,0,0,197120,1,4015439494
8786,232543810,18049460,250593270,7,0,1,11264,14,7948842097
8787,232546360,884858,233431218,8,0,0,66560,12,5333950197
8788,232565580,18027705,250593285,7,0,1,23040,14,3586822678
8789,232576770,1867529,234444299,8,0,0,86528,12,5603810924
8790,232591030,1822499,234413529,9,0,0,141824,10,5036202220
8791,232607160,1034175,233641335,1,0,0,4608,23,8048073669
8792,232627420,1667808,234295228,8,0,0,176640,12,2694943563
8793,232638510,628806,233267316,1,0,0,2048,23,9954490562
8794,232646171,3529996,236176167,3,0,0,83456,28,2349518494
8795,232657241,3826258,236483499,3,0,0,673792,28,2285449692
8796,232662071,3343803,236005874,3,0,0,118784,28,4752712738
8797,232670290,17923010,250593300,5,0,1,12288,1,1964462007
8798,232705280,1891066,234596346,8,0,0,120832,12,3847974021
8799,232723420,3469769,236193189,8,0,0,24576,12,7981820213
8800,232724731,17868584,250593315,2,0,1,6144,0,2891942602
8801,232728470,17864860,250593330,7,0,1,8704,14,3472020980
8802,232780770,1231678,234012448,1,0,0,1536,23,10497893708
8803,232802960,655291,233458251,6,0,0,6656,19,7341737973
8804,232830339,17763006,250593345,4,0,1,16384,9,1969386243
8805,232836370,3737709,236574079,9,0,0,270336,10,7351832640
8806,232844399,1369179,234213578,5,0,0,9216,1,8830875866
8807,232851150,17743810,250594960,7,0,1,15360,14,5490762608
8808,232863889,17741556,250605445,4,0,1,33280,9,5918893454
8809,232883081,17805810,250688891,2,0,1,74240,0,9439530820
8810,232906820,2689589,235596409,8,0,0,161280,12,725571679
8811,232961660,3645624,236607284,8,0,0,97280,12,879252000
8812,232971599,2401383,235372982,5,0,0,31232,1,8965483982
8813,232974071,2689106,235663177,3,0,0,38912,28,4696601399
8814,233057510,1639953,234697463,1,0,0,5632,23,5471680019
8815,233086340,17713499,250799839,7,0,1,2048,14,5004279232
8816,233132610,1726430,234859040,6,0,0,9216,19,9925183643
8817,233132829,17667524,250800353,4,0,1,24576,9,7185938106
8818,233153360,17696123,250849483,7,0,1,41472,14,3124864028
8819,233158780,2751915,235910695,8,0,0,44544,12,1152177480
8820,233207360,17642309,250849669,7,0,1,39424,14,4704295596
8821,233230339,781618,234011957,5,0,0,29696,1,4144213326
8822,233237910,1997034,235234944,8,0,0,121344,12,3516380325
8823,233257210,1268800,234526010,1,0,0,5632,23,1949503430
8824,233257929,3547548,236805477,5,0,0,68608,1,8677722645
8825,233286181,3659582,236945763,3,0,0,104448,28,2114810506
8826,233345311,1187886,234533197,3,0,0,6656,28,2090634723
8827,233426750,3739495,237166245,9,0,0,111104,10,4488277881
8828,233428960,1408186,234837146,6,0,0,3072,19,972042616
8829,233448190,762557,234210747,1,0,0,512,23,7665571803
8830,233461950,17387742,250849692,7,0,1,1536,14,642752275
8831,233486749,17362958,250849707,4,0,1,1536,9,3791675800
8832,233509799,17346433,250856232,4,0,1,12288,9,10170655818
8833,233512120,1445508,234957628,6,0,0,512,19,4540609530
8834,233514680,659049,234173729,6,0,0,512,19,7949358695
8835,233524521,17333495,250858016,2,0,1,13312,0,6033740162
8836,233545151,17354877,250900028,2,0,1,18944,0,245176981
8837,233573010,17328503,250901513,7,0,1,15360,14,4763652141
8838,233578840,1467143,235045983,9,0,0,74240,10,7530502772
8839,233591940,1119451,234711391,9,0,0,35840,10,8888209602
8840,233594279,3867030,237461309,5,0,0,161792,1,10165319384
8841,233633869,17268208,250902077,4,0,1,10752,9,10620455910
8842,233640261,3688794,237329055,3,0,0,200704,28,7371916544
8843,233640681,17263518,250904199,2,0,1,20480,0,2462935402
8844,233671660,1564703,235236363,6,0,0,4608,19,1513187116
8845,233676349,17235903,250912252,4,0,1,19456,9,2338186863
8846,233687510,17233842,250921352,7,0,1,5120,14,2652018960
8847,233710419,1798524,235508943,5,0,0,103424,1,5895975152
8848,233755710,2270109,236025819,1,0,0,1536,23,2184755926
8849,233773661,1669810,235443471,3,0,0,151552,28,6246773229
8850,233811879,1431091,235242970,5,0,0,21504,1,7591615970
8851,233818271,17103427,250921698,2,0,1,512,0,5436513846
8852,233822800,2021679,235844479,9,0,0,84480,10,73760386
8853,233856379,1794927,235651306,5,0,0,135680,1,7172385341
8854,233895540,17054257,250949797,6,0,1,49664,19,6354103987
8855,233924080,3879869,237803949,9,0,0,72192,10,8742547920
8856,233934570,3696561,237631131,8,0,0,206848,12,2978818587
8857,233964310,17123260,251087570,3,0,1,91648,28,9766373151
8858,234005340,17101921,251107261,6,0,1,19456,19,6352952165
8859,234045711,2851675,236897386,3,0,0,45568,28,3637441205
8860,234062779,1834257,235897036,5,0,0,156160,1,1605092088
8861,234073330,1932871,236006201,1,0,0,1024,23,438123323
8862,234100050,2077707,236177757,9,0,0,5120,10,2549915697
8863,234109240,877450,234986690,6,0,0,3584,19,2767055261
8864,234156760,1178672,235335432,9,0,0,87552,10,4918070974
8865,234176840,16932470,251109310,6,0,1,15872,19,3582006594
8866,234192791,1776876,235969667,3,0,0,163840,28,8733451084
8867,234209000,2011449,236220449,1,0,0,512,23,1894542871
8868,234245860,16864218,251110078,7,0,1,11776,14,7311347168
8869,234252980,4122055,238375035,8,0,0,380416,12,7716373534
8870,234266551,1884142,236150693,3,0,0,207360,28,7160384113
8871,234311030,16820946,251131976,7,0,1,31232,14,10102762998
8872,234311640,3848585,238160225,8,0,0,233984,12,5179643539
8873,234323910,1275086,235598996,1,0,0,5632,23,8905489600
8874,234395789,16743222,251139011,4,0,1,11776,9,8823700985
8875,234421060,16801519,251222579,6,0,1,30208,19,359928689
8876,234444520,16778074,251222594,7,0,1,1536,14,9411157695
8877,234465109,16759255,251224364,4,0,1,43520,9,2650768004
8878,234480200,4069361,238549561,9,0,0,476160,10,1018458336
8879,234513630,16715622,251229252,8,0,1,60928,12,9709683302
8880,234525999,3185799,237711798,5,0,0,264704,1,9948563421
8881,234532790,16697435,251230225,6,0,1,12800,19,6257666320
8882,234533380,16717133,251250513,8,0,1,1024,12,987063263
8883,234558320,1286362,235844682,1,0,0,512,23,1165216899
8884,234562540,1354946,235917486,1,0,0,1536,23,10229971560
8885,234595430,1413205,236008635,1,0,0,4096,23,9276193659
8886,234604100,1403208,236007308,1,0,0,3584,23,9429813189
8887,234611170,16639497,251250667,7,0,1,8704,14,3227958160
8888,234624530,16643610,251268140,7,0,1,16896,14,2811993413
8889,234645520,798278,235443798,1,0,0,1024,23,4129916746
8890,234652180,16617036,251269216,8,0,1,13312,12,9684272087
8891,234713200,16557642,251270842,0,0,1,2560,6,9004825075
8892,234713950,16558838,251272788,7,0,1,3072,14,8095879506
8893,234723769,16555914,251279683,4,0,1,512,9,9678503295
8894,234747709,1737693,236485402,5,0,0,6144,1,9845095155
8895,234749940,603265,235353205,6,0,0,512,19,1959175817
8896,234768710,4195056,238963766,8,0,0,62976,12,2699717317
8897,234779680,2094730,236874410,9,0,0,91136,10,2274604049
8898,234803529,4066143,238869672,5,0,0,623104,1,8048192368
8899,234841930,2550694,237392624,1,0,0,3584,23,8159794569
8900,234897990,16398068,251296058,7,0,1,20992,14,8380257271
8901,234919520,16381364,251300884,8,0,1,7680,12,4038418473
8902,234919920,16381950,251301870,7,0,1,1536,14,2722363410
8903,234920560,3271855,238192415,8,0,0,64512,12,7825861741
8904,234929820,2582711,237512531,9,0,0,166400,10,1937407875
8905,234930620,2531172,237461792,9,0,0,1536,10,1939851064
8906,234940220,2451289,237391509,8,0,0,197120,12,5041447214
8907,234952419,3056474,238008893,5,0,0,12800,1,4341344185
8908,234962580,16349249,251311829,8,0,1,36352,12,3568532163
8909,234971110,16357771,251328881,8,0,1,17408,12,3509297003
8910,235098051,2632170,237730221,3,0,0,60416,28,1514308379
8911,235132800,2407116,237539916,1,0,0,1024,23,2711325434
8912,235134450,16200025,251334475,7,0,1,18432,14,1590174122
8913,235135620,16199833,251335453,8,0,1,11776,12,3734728966
8914,235190300,16146594,251336894,7,0,1,13824,14,6546450489
8915,235240740,3807523,239048263,6,0,0,3072,19,1466912314
8916,235303691,3376098,238679789,3,0,0,49664,28,9321589161
8917,235331029,2212646,237543675,5,0,0,12288,1,7417806608
8918,235369810,541524,235911334,1,0,0,2048,23,5550096170
8919,235375660,2191308,237566968,6,0,0,1536,19,118869478
8920,235378930,2516135,237895065,9,0,0,209920,10,2079436813
8921,235394090,15950681,251344771,7,0,1,5632,14,7633560018
8922,235434790,15910967,251345757,8,0,1,1536,12,4722739017
8923,235450580,623059,236073639,9,0,0,21504,10,10192926240
8924,235451230,3458891,238910121,9,0,0,17408,10,4683390882
8925,235498820,15847705,251346525,6,0,1,11776,19,7444181623
8926,235566730,15780563,251347293,7,0,1,11776,14,645957979
8927,235574970,15780624,251355594,6,0,1,25600,19,10014965865
8928,235575629,3368934,238944563,5,0,0,33792,1,4412846030
8929,235581569,15774589,251356158,4,0,1,10752,9,6811751953
8930,235596060,16004866,251600926,3,0,1,276480,28,5951392854
8931,235603690,16000073,251603763,7,0,1,2560,14,1477176488
8932,235627790,15983462,251611252,3,0,1,35840,28,8473650869
8933,235659509,1580809,237240318,5,0,0,58368,1,9722895443
8934,235691819,15926017,251617836,4,0,1,8704,9,5165419363
8935,235707909,16014786,251722695,4,0,1,23552,9,2039521314
8936,235724120,3597726,239321846,8,0,0,158720,12,9544528052
8937,235730600,15992110,251722710,7,0,1,39936,14,6378804050
8938,235766680,15956045,251722725,6,0,1,9216,19,5806460644
8939,235767300,462399,236229699,6,0,0,7168,19,8652316971
8940,235796811,1168165,236964976,3,0,0,39424,28,5208393126
8941,235804920,686768,236491688,8,0,0,20480,12,2649748407
8942,235828490,15933863,251762353,3,0,1,137728,28,10365197092
8943,235852530,15931459,251783989,3,0,1,12288,28,7038038387
8944,235879970,15909469,251789439,6,0,1,3072,19,6528371468
8945,235907970,3365471,239273441,9,0,0,207360,10,1241662875
8946,235919190,1620344,237539534,9,0,0,88576,10,3036935539
8947,235932260,15872676,251804936,6,0,1,17920,19,1971334219
8948,235939659,637962,236577621,5,0,0,11264,1,9986735456
8949,235945380,3552922,239498302,8,0,0,32256,12,9186833855
8950,235995120,2669522,238664642,9,0,0,91648,10,1818990804
8951,236018960,15880391,251899351,7,0,1,115200,14,1330157457
8952,236025070,2379332,238404402,8,0,0,96256,12,7934206497
8953,236041621,3412004,239453625,3,0,0,62976,28,998822242
8954,236058160,3726782,239784942,8,0,0,77312,12,9028155748
8955,236066811,3652417,239719228,3,0,0,363008,28,7974574774
8956,236085051,1167149,237252200,3,0,0,31744,28,1787395217
8957,236085959,760668,236846627,5,0,0,66048,1,3206818697
8958,236090431,1654470,237744901,3,0,0,6656,28,1316096058
8959,236097610,869877,236967487,6,0,0,8192,19,3957656928
8960,236139559,1603275,237742834,5,0,0,13312,1,6200953933
8961,236155080,16059694,252214774,3,0,1,263680,28,3422583627
8962,236182051,1040468,237222519,3,0,0,17408,28,3109025317
8963,236187220,1551543,237738763,9,0,0,27648,10,6597263260
8964,236195200,16134274,252329474,3,0,1,32768,28,7015406051
8965,236197079,1891839,238088918,5,0,0,114688,1,7556550264
8966,236234320,16095169,252329489,7,0,1,2560,14,4035460515
8967,236277440,1118007,237395447,9,0,0,9216,10,2713125328
8968,236285379,3662245,239947624,5,0,0,313856,1,4109826672
8969,236302320,16027192,252329512,3,0,1,17920,28,4518825425
8970,236356819,974599,237331418,5,0,0,7680,1,6679354210
8971,236366800,15962727,252329527,6,0,1,13824,19,9308361268
8972,236370911,3647330,240018241,3,0,0,29184,28,5309371274
8973,236400581,712587,237113168,3,0,0,59392,28,10149643167
8974,236431570,15897980,252329550,7,0,1,23040,14,7816243561
8975,236443310,1802035,238245345,8,0,0,109568,12,470590288
8976,236450540,15879033,252329573,6,0,1,16384,19,6779149510
8977,236464860,2439942,238904802,9,0,0,115200,10,9706267481
8978,236483770,1570189,238053959,9,0,0,77824,10,3921724898
8979,236486090,15913519,252399609,7,0,1,220160,14,9994859083
8980,236512740,679795,237192535,6,0,0,3072,19,8392180853
8981,236532890,15915720,252448610,7,0,1,62464,14,10075199354
8982,236573990,1422467,237996457,9,0,0,3072,10,6235478666
8983,236587710,15864446,252452156,6,0,1,5632,19,7527258076
8984,236589630,15864152,252453782,3,0,1,2560,28,4175844783
8985,236630879,2296261,238927140,5,0,0,55808,1,2020213776
8986,236641490,1109262,237750752,9,0,0,18944,10,7609721810
8987,236642819,15811309,252454128,4,0,1,512,9,3805255208
8988,236683060,15774934,252457994,3,0,1,6144,28,1041582874
8989,236693970,15770130,252464100,6,0,1,20992,19,3755481268
8990,236705021,1931682,238636703,3,0,0,247808,28,3285838831
8991,236710569,15754299,252464868,4,0,1,11776,9,3809219684
8992,236724921,687077,237411998,3,0,0,54272,28,6435349873
8993,236737300,15733009,252470309,3,0,1,25600,28,5320246461
8994,236798010,15680862,252478872,6,0,1,4096,19,4712870154
8995,236804480,15685206,252489686,3,0,1,20480,28,4789521471
8996,236849989,15653731,252503720,4,0,1,23552,9,5837057880
8997,236868279,3187916,240056195,5,0,0,76288,1,10625497623
8998,236891269,2158428,239049697,5,0,0,4608,1,7523642488
8999,236900719,3055188,239955907,5,0,0,27136,1,10709005929
9000,236901600,15603426,252505026,3,0,1,2048,28,9863198051
9001,236921019,15584353,252505372,4,0,1,512,9,10625004565
9002,236933360,15573497,252506857,7,0,1,15360,14,83941081
9003,237031331,892792,237924123,3,0,0,11776,28,372835606
9004,237143710,2066482,239210192,8,0,0,164352,12,9251104540
9005,237177029,1034901,238211930,5,0,0,64000,1,3485483335
9006,237186240,15335931,252522171,6,0,1,22528,19,10342445945
9007,237208460,15316617,252525077,8,0,1,4608,12,5113156443
9008,237216670,15308766,252525436,6,0,1,9728,19,5727987740
9009,237220990,1826322,239047312,8,0,0,197632,12,4049028229
9010,237225970,15301617,252527587,6,0,1,26624,19,2434326467
9011,237247120,15289429,252536549,6,0,1,9216,19,8156454817
9012,237252990,15285341,252538331,6,0,1,1536,19,5019779169
9013,237255790,15287367,252543157,6,0,1,7680,19,7489564846
9014,237291310,1269858,238561168,9,0,0,37888,10,3791077509
9015,237299571,15245468,252545039,8,0,1,11776,12,1486228155
9016,237303160,2774563,240077723,8,0,0,4608,12,7201035445
9017,237401950,15269662,252671612,7,0,1,118784,14,3870454619
9018,237402260,15381954,252784214,7,0,1,132096,14,9846787906
9019,237411769,15386086,252797855,4,0,1,40448,9,8875956647
9020,237485180,15323274,252808454,8,0,1,9216,12,702841189
9021,237489910,15336254,252826164,6,0,1,19456,19,2386543480
9022,237568500,15263332,252831832,7,0,1,12288,14,9322698924
9023,237611149,15230156,252841305,4,0,1,28672,9,2538964235
9024,237617200,15228304,252845504,8,0,1,17920,12,3934899253
9025,237626810,1307442,238934252,9,0,0,23040,10,2771588690
9026,237641000,2571033,240212033,8,0,0,10752,12,10204851855
9027,237642330,1727462,239369792,8,0,0,157184,12,4485783879
9028,237649569,15216273,252865842,4,0,1,43520,9,954676496
9029,237649590,1510439,239160029,8,0,0,90624,12,2841881032
9030,237666700,15200422,252867122,6,0,1,14336,19,6167536888
9031,237685509,2758625,240444134,5,0,0,194560,1,2921039162
9032,237696560,15254019,252950579,7,0,1,126976,14,243422867
9033,237717890,15245578,252963468,8,0,1,19456,12,3832505514
9034,237741150,15228271,252969421,6,0,1,17920,19,7186568380
9035,237756980,15239437,252996417,7,0,1,58880,14,513899993
9036,237763799,15304957,253068756,4,0,1,81408,9,7903919699
9037,237822851,436253,238259104,3,0,0,45056,28,7251651978
9038,237898790,3071549,240970339,9,0,0,389120,10,468980946
9039,237904360,2848581,240752941,9,0,0,165376,10,10703250047
9040,237946121,1488301,239434422,3,0,0,163328,28,3611782206
9041,237963249,15156485,253119734,4,0,1,512,9,6082432829
9042,237994949,15130584,253125533,4,0,1,19456,9,7288708967
9043,238064569,15080990,253145559,4,0,1,1024,9,7066641344
9044,238067720,15079251,253146971,8,0,1,5120,12,88846929
9045,238080100,15072172,253152272,6,0,1,6656,19,1098404114
9046,238144210,3212220,241356430,9,0,0,649728,10,9486738864
9047,238185811,3244468,241430279,3,0,0,242176,28,2614938105
9048,238190689,14963747,253154436,4,0,1,15360,9,9807122657
9049,238212750,14947537,253160287,7,0,1,27648,14,7556828316
9050,238224721,1536650,239761371,3,0,0,138240,28,6099862231
9051,238249440,14938593,253188033,8,0,1,9216,12,8568484466
9052,238262740,1561849,239824589,8,0,0,43520,12,2970201203
9053,238280560,14955386,253235946,8,0,1,20992,12,7652627255
9054,238293400,14947052,253240452,6,0,1,7168,19,1328953233
9055,238301521,1707753,240009274,3,0,0,175104,28,1049822978
9056,238308750,15073326,253382076,7,0,1,50176,14,1021350682
9057,238353330,15028777,253382107,3,0,1,512,28,8630775419
9058,238381189,15000941,253382130,4,0,1,8192,9,8758009966
9059,238398760,14991208,253389968,6,0,1,28672,19,1620319335
9060,238426181,957689,239383870,3,0,0,46080,28,130468973
9061,238446920,3091752,241538672,9,0,0,115712,10,494885165
9062,238508340,14968261,253476601,7,0,1,112640,14,1557032463
9063,238570510,15294874,253865384,7,0,1,599552,14,4872856988
9064,238708200,1759037,240467237,8,0,0,75776,12,6197109268
9065,238721470,15146500,253867970,7,0,1,4096,14,8053240425
9066,238840559,962814,239803373,5,0,0,60416,1,4115084669
9067,238887900,14983296,253871196,8,0,1,5120,12,9708157433
9068,238954970,1235871,240190841,8,0,0,269312,12,1631328066
9069,238957409,1660618,240618027,5,0,0,153088,1,1798531601
9070,238974640,14911962,253886602,8,0,1,19456,12,7571562770
9071,238980240,1340820,240321060,9,0,0,97792,10,658193238
9072,238984390,14928239,253912629,6,0,1,36864,19,8434363751
9073,239151519,369248,239520767,5,0,0,14336,1,4042910442
9074,239153030,304830,239457860,5,0,0,13824,1,1652552400
9075,239163800,14917319,254081119,7,0,1,171008,14,6080066945
9076,239216889,2459877,241676766,5,0,0,58880,1,3701618365
9077,239246171,1605585,240851756,3,0,0,90624,28,1338339072
9078,239284231,779458,240063689,3,0,0,13312,28,3781744645
9079,239331030,2528498,241859528,5,0,0,237056,1,4183034610
9080,239359400,1292026,240651426,9,0,0,109568,10,4595871991
9081,239409440,14710262,254119702,0,0,1,32256,6,1803043638
9082,239413360,619560,240032920,9,0,0,48128,10,8382819413
9083,239415649,2581446,241997095,5,0,0,92160,1,2961419964
9084,239441040,2527952,241968992,9,0,0,106496,10,7036530832
9085,239444830,14811778,254256608,7,0,1,243712,14,8248080128
9086,239472670,2086609,241559279,9,0,0,67584,10,9825871330
9087,239487610,14838829,254326439,7,0,1,164864,14,2513034538
9088,239499220,14996955,254496175,7,0,1,279552,14,6053556734
9089,239535791,568371,240104162,3,0,0,79360,28,5087603376
9090,239629200,2539258,242168458,8,0,0,87040,12,8337529225
9091,239710581,2404596,242115177,3,0,0,313344,28,10539703545
9092,239813350,14779132,254592482,7,0,1,202752,14,6955054830
9093,240002000,331243,240333243,8,0,0,39936,12,605512355
9094,240016220,2125703,242141923,8,0,0,74240,12,9859760595
9095,240037889,987088,241024977,5,0,0,136192,1,8912976765
9096,240182900,2036043,242218943,9,0,0,70656,10,10647021248
9097,240247171,2275702,242522873,3,0,0,512512,28,947400452
9098,240267980,14342591,254610571,9,0,1,42496,10,3300622071
9099,240342479,2257676,242600155,5,0,0,122368,1,2838296204
9100,240398031,410750,240808781,3,0,0,46080,28,10536168867
9101,240432311,551155,240983466,3,0,0,43008,28,3031400389
9102,240468131,2173879,242642010,3,0,0,137216,28,5574158322
9103,240542080,616371,241158451,8,0,0,47616,12,7455761828
9104,240691560,13919267,254610827,3,0,1,9216,28,6982260979
9105,240714570,788823,241503393,9,0,0,146432,10,3055659192
9106,240728400,1168302,241896702,9,0,0,84992,10,4968260320
9107,240768920,13842893,254611813,8,0,1,1536,12,2381564771
9108,240837380,733154,241570534,9,0,0,36864,10,6988755889
9109,240905880,752931,241658811,8,0,0,230912,12,551694942
9110,240989601,453686,241443287,3,0,0,42496,28,4897719553
9111,241050601,408161,241458762,3,0,0,50688,28,8429951574
9112,241083161,787622,241870783,7,0,0,36864,14,690791009
9113,241110631,676646,241787277,3,0,0,137216,28,10019537888
9114,241119921,1528680,242648601,3,0,0,21504,28,5569897384
9115,241173951,762562,241936513,7,0,0,130560,14,1472587535
9116,241226390,1588029,242814419,9,0,0,99840,10,10239587921
9117,241378840,1560302,242939142,8,0,0,247296,12,1542006745
9118,241397839,1842223,243240062,5,0,0,97792,1,6954491904
9119,241435920,752865,242188785,8,0,0,66560,12,9008773299
9120,241465140,13150859,254615999,8,0,1,6656,12,2913050408
9121,241587860,13039181,254627041,8,0,1,4608,12,8653673695
9122,241732950,12898597,254631547,8,0,1,7168,12,2340285448
9123,241755590,255592,242011182,9,0,0,46080,10,8168761923
9124,241784779,1856363,243641142,5,0,0,293376,1,5246379690
9125,241811841,307439,242119280,7,0,0,13312,14,7117918079
9126,241827130,12809269,254636399,8,0,1,7680,12,9821422136
9127,241852759,710081,242562840,5,0,0,131072,1,6879222331
9128,241873591,1279370,243152961,3,0,0,396800,28,10199753585
9129,241889971,1478249,243368220,7,0,0,109568,14,4436797138
9130,241925660,782446,242708106,9,0,0,74752,10,8115307490
9131,241936940,1561440,243498380,8,0,0,18944,12,9439907157
9132,241941020,921629,242862649,8,0,0,17920,12,4746721331
9133,241987541,1215051,243202592,3,0,0,162816,28,1530299257
9134,242011329,1743387,243754716,5,0,0,266752,1,338106583
9135,242029860,651970,242681830,9,0,0,16896,10,3593353284
9136,242031780,1887155,243918935,9,0,0,83456,10,3889525369
9137,242095360,1704988,243800348,9,0,0,34816,10,9643594045
9138,242102690,12535015,254637705,8,0,1,2048,12,3899021586
9139,242137390,12501621,254639011,8,0,1,2048,12,7818963556
9140,242152750,1137603,243290353,8,0,0,30208,12,6844219093
9141,242154599,797662,242952261,5,0,0,43008,1,8156474442
9142,242163551,1079350,243242901,7,0,0,9216,14,9351153614
9143,242175160,2330220,244505380,8,0,0,115712,12,3003175414
9144,242176070,12464247,254640317,0,0,1,2048,6,5589547240
9145,242208200,2241831,244450031,9,0,0,878592,10,7168687367
9146,242233319,1652925,243886244,5,0,0,111104,1,2120853769
9147,242234281,1911464,244145745,3,0,0,165376,28,8556601378
9148,242261640,1135611,243397251,8,0,0,95232,12,7294209600
9149,242300060,12353797,254653857,9,0,1,38400,10,7191257303
9150,242304291,905960,243210251,7,0,0,25088,14,6706174495
9151,242331570,12519986,254851556,7,0,1,266752,14,1897301818
9152,242340210,1684149,244024359,8,0,0,32768,12,6012292848
9153,242362111,2175108,244537219,7,0,0,104448,14,2170417536
9154,242420611,2227409,244648020,7,0,0,143872,14,3505750360
9155,242467621,1627721,244095342,3,0,0,100864,28,2415758090
9156,242493040,12387044,254880084,7,0,1,53760,14,2702014872
9157,242504409,1965700,244470109,5,0,0,5632,1,3134280237
9158,242521260,1661036,244182296,8,0,0,119808,12,9648134936
9159,242533001,2017549,244550550,3,0,0,43520,28,4100589420
9160,242632930,1185720,243818650,9,0,0,10752,10,4087361840
9161,242635140,2047251,244682391,8,0,0,15360,12,8783014305
9162,242643850,12333438,254977288,8,0,1,46080,12,5426114278
9163,242667530,12311553,254979083,7,0,1,99840,14,6910158093
9164,242740500,12247582,254988082,8,0,1,22016,12,7237531758
9165,242744530,12358247,255102777,7,0,1,162304,14,2316047982
9166,242764900,12337892,255102792,5,0,1,15872,1,1091038214
9167,242839971,12267075,255107046,2,0,1,9216,0,4737886321
9168,242881440,12310273,255191713,7,0,1,171520,14,500919352
9169,242885470,12323617,255209087,8,0,1,61952,12,231323171
9170,242905961,2177152,245083113,3,0,0,173056,28,4599157586
9171,242948820,12272564,255221384,8,0,1,2048,12,6985953975
9172,242984269,1948958,244933227,5,0,0,251904,1,2199307690
9173,243007569,1596544,244604113,5,0,0,175104,1,6371433031
9174,243036530,1431792,244468322,9,0,0,59904,10,1192105502
9175,243106550,12124205,255230755,5,0,1,23040,1,7678433181
9176,243112381,12123520,255235901,2,0,1,8192,0,2026513091
9177,243253720,11999798,255253518,8,0,1,29184,12,8869216416
9178,243273231,11981930,255255161,2,0,1,1024,0,3262380388
9179,243294771,2132322,245427093,3,0,0,402432,28,7816549595
9180,243307730,11947687,255255417,8,0,1,9216,12,424427495
9181,243425301,11833490,255258791,2,0,1,15872,0,7729126978
9182,243466660,11792695,255259355,7,0,1,10752,14,9460889709
9183,243475240,11905941,255381181,7,0,1,247808,14,1498118775
9184,243492041,2236785,245728826,7,0,0,221696,14,7804023488
9185,243520830,1618689,245139519,9,0,0,9216,10,9557165454
9186,243521041,2456666,245977707,3,0,0,502272,28,2334658730
9187,243526310,2038573,245564883,9,0,0,299008,10,2964918398
9188,243600231,2042924,245643155,3,0,0,60416,28,9561918815
9189,243600810,11844234,255445044,7,0,1,128000,14,9446710996
9190,243631739,1157235,244788974,5,0,0,36352,1,8758518260
9191,243662370,11787180,255449550,5,0,1,7168,1,2113943169
9192,243697660,11762356,255460016,5,0,1,20480,1,5591488852
9193,243706780,11777735,255484515,5,0,1,20992,1,5303349450
9194,243714539,2028810,245743349,5,0,0,47616,1,6323375965
9195,243731720,11753781,255485501,8,0,1,1536,12,5028932944
9196,243770111,2448173,246218284,3,0,0,451584,28,8891662474
9197,243803510,1821198,245624708,8,0,0,120320,12,2700026191
9198,243816691,11697573,255514264,2,0,1,11264,0,3641222677
9199,243834231,1603080,245437311,3,0,0,32256,28,3568027125
9200,243942320,992350,244934670,8,0,0,4608,12,10059476746
9201,243977620,2005534,245983154,9,0,0,17408,10,7256248499
9202,243991320,11524492,255515812,3,0,1,2560,28,9249989410
9203,243992120,11526918,255519038,3,0,1,5120,28,6399141268
9204,244055990,11467158,255523148,5,0,1,16384,1,6353578248
9205,244115501,11474429,255589930,2,0,1,104960,0,9887102211
9206,244128680,11477165,255605845,5,0,1,14848,1,6405833336
9207,244134661,11477123,255611784,2,0,1,24064,0,3178642153
9208,244140520,2745216,246885736,9,0,0,321536,10,268618829
9209,244160541,2947556,247108097,7,0,0,383488,14,2992558261
9210,244164560,3157154,247321714,9,0,0,377856,10,6384150608
9211,244166201,11449212,255615413,2,0,1,4608,0,535222100
9212,244203350,11441231,255644581,3,0,1,43520,28,5808994908
9213,244232101,564688,244796789,7,0,0,25600,14,6300686904
9214,244283731,11448114,255731845,2,0,1,44032,0,7564169292
9215,244286351,1141093,245427444,3,0,0,1024,28,6402665189
9216,244303181,11428687,255731868,2,0,1,24064,0,7833239295
9217,244329940,447891,244777831,8,0,0,3072,12,4729234815
9218,244350301,2297001,246647302,7,0,0,89600,14,7608009719
9219,244449300,1789334,246238634,8,0,0,29696,12,8902473869
9220,244475790,1753757,246229547,9,0,0,36864,10,6959126785
9221,244505200,11226683,255731883,7,0,1,9728,14,2707978212
9222,244517001,11214897,255731898,2,0,1,10240,0,1762044752
9223,244520070,2620257,247140327,8,0,0,94720,12,5863546864
9224,244557359,1029231,245586590,5,0,0,71168,1,5005853990
9225,244564810,11167103,255731913,3,0,1,8704,28,153137856
9226,244572010,2419228,246991238,9,0,0,102912,10,4659520367
9227,244595589,11136339,255731928,4,0,1,23040,9,2774749400
9228,244595949,2363902,246959851,5,0,0,243200,1,4962533824
9229,244640450,11091493,255731943,5,0,1,3584,1,4995818060
9230,244745190,10995609,255740799,5,0,1,13312,1,5656631404
9231,244756981,10988004,255744985,2,0,1,6656,0,10396412710
9232,244809211,10937720,255746931,2,0,1,3072,0,3636089453
9233,244811191,1806965,246618156,7,0,0,130560,14,3320203501
9234,244814990,10935487,255750477,5,0,1,5632,1,1602669875
9235,244840249,953106,245793355,5,0,0,7168,1,1049991052
9236,244860710,10978169,255838879,7,0,1,219136,14,10548360645
9237,244882350,11001007,255883357,7,0,1,81408,14,7454283475
9238,244882840,11028592,255911432,3,0,1,57856,28,720869511
9239,244897009,11036270,255933279,4,0,1,41472,9,4443081062
9240,244918799,11027410,255946209,4,0,1,27136,9,356206150
9241,244940100,11017999,255958099,3,0,1,3584,28,10426436916
9242,244949770,2561599,247511369,9,0,0,207872,10,3501619857
9243,244951991,1320921,246272912,7,0,0,17920,14,5590045197
9244,244973960,10985317,255959277,5,0,1,13824,1,9320737817
9245,244979821,11041818,256021639,2,0,1,9216,0,4009401488
9246,244983940,11037714,256021654,5,0,1,6144,1,1221662071
9247,244984360,11037309,256021669,8,0,1,2048,12,8279415426
9248,245005109,1747127,246752236,5,0,0,28672,1,10187739655
9249,245014900,11006792,256021692,8,0,1,19456,12,10370634494
9250,245058599,588315,245646914,5,0,0,12288,1,4847861490
9251,245060900,1186385,246247285,8,0,0,28160,12,7151429595
9252,245093750,10928128,256021878,3,0,1,13312,28,4163892055
9253,245101181,2651230,247752411,7,0,0,466432,14,4683444801
9254,245114549,10920649,256035198,4,0,1,40960,9,5851396249
9255,245172939,10864525,256037464,4,0,1,3584,9,2455278923
9256,245208420,10837237,256045657,8,0,1,21504,12,6940473916
9257,245223330,10825553,256048883,8,0,1,5120,12,1391846094
9258,245224051,1248847,246472898,3,0,0,43008,28,716292100
9259,245225800,10827269,256053069,8,0,1,6656,12,9593747362
9260,245285311,302698,245588009,7,0,0,4608,14,4842596768
9261,245287259,10768396,256055655,4,0,1,4096,9,8910460240
9262,245339580,2108422,247448002,8,0,0,125440,12,1681505457
9263,245341421,10714388,256055809,2,0,1,8704,0,1258687455
9264,245349251,10707838,256057089,2,0,1,14336,0,6810075224
9265,245389900,2019048,247408948,9,0,0,247296,10,5925051772
9266,245394169,10692420,256086589,4,0,1,44544,9,8556242193
9267,245421100,10666475,256087575,3,0,1,1536,28,8189619110
9268,245447411,1696535,247143946,3,0,0,11776,28,7264242547
9269,245464180,10672883,256137063,7,0,1,76288,14,4835773969
9270,245482011,1012512,246494523,3,0,0,28672,28,8967694055
9271,245523740,2281787,247805527,8,0,0,31744,12,6297227661
9272,245547530,10601401,256148931,3,0,1,32768,28,9472709892
9273,245560450,10591837,256152287,3,0,1,29184,28,4043000577
9274,245595541,2294913,247890454,7,0,0,278528,14,6390275821
9275,245637160,10673860,256311020,7,0,1,352256,14,9229038119
9276,245654730,10682869,256337599,3,0,1,40960,28,10209536466
9277,245662090,2385330,248047420,9,0,0,198144,10,6444266561
9278,245691381,1918072,247609453,3,0,0,313344,28,7163711220
9279,245706330,10767421,256473751,7,0,1,273408,14,9377476347
9280,245723480,2034422,247757902,8,0,0,17920,12,6109457302
9281,245738900,10767591,256506491,8,0,1,53248,12,10571535333
9282,245767980,10740693,256508673,8,0,1,12800,12,4423717479
9283,245773930,10748402,256522332,8,0,1,41984,12,1948165862
9284,245775490,10774103,256549593,8,0,1,12800,12,9435928775
9285,245779779,2732734,248512513,5,0,0,168960,1,1551173582
9286,245796969,2809471,248606440,5,0,0,183296,1,9354098780
9287,245801420,1532165,247333585,9,0,0,38912,10,3021003058
9288,245841359,2097470,247938829,5,0,0,158720,1,2235963524
9289,245848680,10710584,256559264,3,0,1,31744,28,8920345480
9290,245854469,2893211,248747680,5,0,0,168448,1,3834387804
9291,245882939,2813402,248696341,5,0,0,141312,1,9902677958
9292,245885150,10714922,256600072,3,0,1,31232,28,9121426636
9293,245891890,10709258,256601148,8,0,1,13312,12,10702257491
9294,245900520,2440606,248341126,9,0,0,621568,10,2199435560
9295,245900870,10703184,256604054,8,0,1,4608,12,162564453
9296,245905331,2518919,248424250,7,0,0,55296,14,9502400913
9297,245909790,10767297,256677087,3,0,1,83456,28,5104418784
9298,245932021,10747652,256679673,2,0,1,4096,0,13033293
9299,245957010,10723841,256680851,3,0,1,13824,28,9916830013
9300,245983310,2360795,248344105,9,0,0,9728,10,1064128187
9301,245985700,10820742,256806442,7,0,1,260096,14,9263244292
9302,245988440,1807400,247795840,9,0,0,33792,10,362337242
9303,246000010,1111442,247111452,8,0,0,10752,12,2858657508
9304,246007761,10808739,256816500,2,0,1,19456,0,8063793086
9305,246099621,10717801,256817422,2,0,1,20480,0,5157743468
9306,246144410,2938747,249083157,8,0,0,114688,12,1793215827
9307,246180801,10637389,256818190,2,0,1,11776,0,5196329386
9308,246183790,1601739,247785529,9,0,0,90624,10,9618722631
9309,246191770,2797739,248989509,8,0,0,85504,12,6865565749
9310,246199291,10619885,256819176,2,0,1,1536,0,9071044631
9311,246199730,10647246,256846976,8,0,1,51200,12,3892192147
9312,246217150,2590256,248807406,9,0,0,54784,10,215085185
9313,246217851,10635385,256853236,2,0,1,27648,0,1833004748
9314,246223690,2628239,248851929,8,0,0,145920,12,9339651308
9315,246238030,1372218,247610248,8,0,0,2560,12,8526892528
9316,246245320,10609222,256854542,7,0,1,2048,14,4664158057
9317,246250260,10606228,256856488,3,0,1,3072,28,7944499732
9318,246251870,3018596,249270466,9,0,0,125952,10,5302254439
9319,246297350,467449,246764799,8,0,0,1024,12,146657071
9320,246309730,10551610,256861340,3,0,1,7680,28,6688403473
9321,246345160,10536691,256881851,7,0,1,12800,14,7596356813
9322,246365490,2003500,248368990,8,0,0,3072,12,5077329509
9323,246377410,2670788,249048198,9,0,0,66560,10,6305230865
9324,246377610,10506085,256883695,7,0,1,25088,14,2746182346
9325,246407160,10492506,256899666,3,0,1,7680,28,2900243990
9326,246415000,10486292,256901292,8,0,1,2560,12,4366330012
9327,246446380,10461044,256907424,3,0,1,9728,28,9053547285
9328,246452180,10457190,256909370,8,0,1,3072,12,4458842813
9329,246493140,10419456,256912596,3,0,1,5120,28,8496182377
9330,246562650,1781665,248344315,8,0,0,512,12,6282993064
9331,246598801,10314410,256913211,2,0,1,18944,0,7191394636
9332,246601429,1859589,248461018,5,0,0,100352,1,7135923630
9333,246668070,2351355,249019425,8,0,0,512,12,8839768400
9334,246684970,724789,247409759,8,0,0,2560,12,6247941929
9335,246695810,818148,247513958,8,0,0,3072,12,441559797
9336,246707749,1945521,248653270,5,0,0,120832,1,8292194912
9337,246714680,798287,247512967,9,0,0,5120,10,3583862736
9338,246722590,10267558,256990148,7,0,1,156160,14,8148538336
9339,246734150,10267038,257001188,8,0,1,22016,12,2344186511
9340,246741070,10283056,257024126,7,0,1,45056,14,6762166004
9341,246884391,1649056,248533447,3,0,0,30720,28,8355849782
9342,246891721,10133711,257025432,2,0,1,2048,0,8138147856
9343,246912870,1611202,248524072,9,0,0,37888,10,3545017641
9344,246918721,10107377,257026098,2,0,1,1024,0,881683268
9345,246924101,10116041,257040142,2,0,1,49152,0,7046222342
9346,246950771,10091317,257042088,2,0,1,3072,0,35553238
9347,246952741,2459586,249412327,7,0,0,125952,14,2585575076
9348,246992580,10058752,257051332,3,0,1,13824,28,2983501690
9349,247012220,10039127,257051347,3,0,1,512,28,2369206228
9350,247079530,9971832,257051362,7,0,1,9728,14,9502711652
9351,247081061,1046573,248127634,7,0,0,22016,14,3523771820
9352,247147850,9908496,257056346,3,0,1,16896,28,4793038673
9353,247166171,1797211,248963382,3,0,0,294400,28,3538860794
9354,247266890,9790122,257057012,0,0,1,11264,6,4196038937
9355,247267690,9828983,257096673,7,0,1,72704,14,1158103920
9356,247281019,1738235,249019254,5,0,0,21504,1,5690914450
9357,247308731,9792128,257100859,2,0,1,6656,0,5554474382
9358,247312269,1685694,248997963,5,0,0,27648,1,9434492475
9359,247343319,1509733,248853052,5,0,0,3584,1,62109349
9360,247423740,9775495,257199235,7,0,1,196608,14,10598213113
9361,247463410,477150,247940560,8,0,0,5632,12,7323414021
9362,247498650,9708637,257207287,9,0,1,12800,10,6135446349
9363,247518381,1493013,249011394,7,0,0,44032,14,6956893601
9364,247542620,9847887,257390507,7,0,1,345088,14,10736046057
9365,247574681,1566563,249141244,7,0,0,190464,14,3812272988
9366,247602860,9825874,257428734,7,0,1,45056,14,1847777748
9367,247610700,9938606,257549306,7,0,1,260608,14,136879957
9368,247697461,9852831,257550292,2,0,1,1536,0,7349380969
9369,247739549,1573254,249312803,5,0,0,50688,1,235811085
9370,247760201,1471866,249232067,7,0,0,297984,14,4126755036
9371,247857450,9794471,257651921,7,0,1,96768,14,7940520395
9372,247873291,9779296,257652587,2,0,1,1024,0,5099429714
9373,247880231,9788115,257668346,2,0,1,40960,0,10182306358
9374,247881779,908912,248790691,5,0,0,140800,1,8158469858
9375,247892231,981428,248873659,7,0,0,67584,14,4118073746
9376,247964440,1063268,249027708,9,0,0,27136,10,10572569384
9377,247978251,638188,248616439,7,0,0,32768,14,6758188988
9378,248014611,9671928,257686539,2,0,1,46080,0,486062852
9379,248023940,1597325,249621265,9,0,0,94720,10,4110561036
9380,248099150,1238183,249337333,9,0,0,38400,10,314519642
9381,248118421,9573695,257692116,2,0,1,11776,0,2700544636
9382,248150480,390571,248541051,8,0,0,512,12,8887905014
9383,248170020,9577488,257747508,7,0,1,122368,14,4456589996
9384,248241360,1543354,249784714,9,0,0,165888,10,1672102226
9385,248273409,1052201,249325610,5,0,0,41984,1,1676695187
9386,248281910,1145653,249427563,9,0,0,16384,10,7990634787
9387,248287300,9797015,258084315,7,0,1,544768,14,8105564023
9388,248336520,9948591,258285111,7,0,1,440320,14,1939883232
9389,248411911,9875697,258287608,2,0,1,14848,0,5804977926
9390,248414041,1521410,249935451,7,0,0,198144,14,10246434475
9391,248421990,9869484,258291474,7,0,1,6144,14,3160243020
9392,248429749,867595,249297344,5,0,0,88064,1,9321798704
9393,248453560,574319,249027879,8,0,0,512,12,3460066593
9394,248474740,9919673,258394413,7,0,1,276480,14,3764856959
9395,248573800,9906221,258480021,7,0,1,182784,14,2958281195
9396,248608831,9878001,258486832,2,0,1,18944,0,1594534363
9397,248614419,850911,249465330,5,0,0,123904,1,5515079681
9398,248616380,396307,249012687,8,0,0,512,12,10198888467
9399,248654161,9859092,258513253,2,0,1,39936,0,9188487199
9400,248696650,315851,249012501,8,0,0,3584,12,5224099223
9401,248734521,9785565,258520086,2,0,1,27648,0,4535020067
9402,248757971,1278688,250036659,7,0,0,114688,14,7509838810
9403,248761960,654692,249416652,8,0,0,1024,12,3989390128
9404,248910260,9625720,258535980,7,0,1,20480,14,9611503566
9405,248949261,9587999,258537260,2,0,1,14336,0,1386900114
9406,248961899,624418,249586317,5,0,0,70656,1,6682480550
9407,249011650,534604,249546254,9,0,0,27136,10,2446464138
9408,249023241,9514378,258537619,2,0,1,9728,0,3854101195
9409,249033479,1102576,250136055,5,0,0,76800,1,6572978218
9410,249067539,666593,249734132,5,0,0,254464,1,1119461115
9411,249127420,9441974,258569394,7,0,1,48128,14,2627042394
9412,249195801,805839,250001640,7,0,0,145920,14,7141923591
9413,249202981,733109,249936090,7,0,0,2048,14,9223734944
9414,249286700,9283565,258570265,8,0,1,12288,12,4595300636
9415,249306330,650835,249957165,9,0,0,69120,10,2146781608
9416,249393170,9191724,258584894,7,0,1,23040,14,627440659
9417,249405080,9222832,258627912,7,0,1,98816,14,6415888388
9418,249409720,465344,249875064,9,0,0,110592,10,3151265909
9419,249497020,9283892,258780912,7,0,1,346112,14,3796729937
9420,249515341,545171,250060512,7,0,0,39424,14,7117883863
9421,249687310,9094329,258781639,8,0,1,12800,12,2062649480
9422,249802850,518599,250321449,9,0,0,126464,10,5946346428
9423,249841070,8940825,258781895,8,0,1,9216,12,4400135105
9424,250006450,467868,250474318,8,0,0,1536,12,3368745640
9425,250060611,8774848,258835459,2,0,1,14848,0,5737600172
9426,250060840,8774634,258835474,8,0,1,2560,12,7146264161
9427,250067051,526180,250593231,7,0,0,370688,14,4298889480
9428,250080831,8754658,258835489,2,0,1,11264,0,8341676173
9429,250097181,8768045,258865226,2,0,1,36352,0,2281312888
9430,250130390,646323,250776713,9,0,0,187904,10,4825780071
9431,250150881,8748153,258899034,2,0,1,51200,0,2617912385
9432,250183311,8717349,258900660,2,0,1,2560,0,1255004266
9433,250184221,8717745,258901966,2,0,1,2048,0,3549221893
9434,250213300,8703384,258916684,8,0,1,25088,12,3880717521
9435,250235000,393156,250628156,9,0,0,50176,10,9649361508
9436,250258291,8662899,258921190,2,0,1,7168,0,3204221140
9437,250312390,487948,250800338,8,0,0,1536,12,2252045883
9438,250351321,8572455,258923776,2,0,1,4096,0,10156651258
9439,250367090,432726,250799816,9,0,0,75776,10,5396166331
9440,250390070,8545356,258935426,8,0,1,47104,12,4245584158
9441,250391700,457954,250849654,8,0,0,512,12,7957225153
9442,250396730,452738,250849468,9,0,0,139776,10,6379967189
9443,250414010,8528331,258942341,8,0,1,7680,12,4946007904
9444,250447580,8593325,259040905,7,0,1,228864,14,3073517106
9445,250459530,8606548,259066078,9,0,1,27136,10,5618142441
9446,250480390,8591692,259072082,9,0,1,20480,10,5632236754
9447,250530740,471930,251002670,9,0,0,18944,10,6155412332
9448,250628740,593816,251222556,9,0,0,272384,10,603052178
9449,250632530,330820,250963350,9,0,0,26112,10,1613175045
9450,250724660,499665,251224325,8,0,0,5632,12,5264625255
9451,250733730,309220,251042950,8,0,0,512,12,7252028014
9452,250747861,8328407,259076268,2,0,1,6656,0,7079192953
9453,250765780,8314828,259080608,9,0,1,15360,10,9317398159
9454,250792601,8288468,259081069,2,0,1,10240,0,10448533307
9455,250797170,8294561,259091731,9,0,1,7168,10,2306496530
9456,250846280,8247717,259093997,9,0,1,3584,10,8960314274
9457,250880570,8219840,259100410,9,0,1,22528,10,8357121955
9458,250997580,8103701,259101281,9,0,1,12288,10,8823620655
9459,251006380,8100700,259107080,9,0,1,19456,10,8465459431
9460,251029210,8092742,259121952,0,0,1,20992,6,10589647142
9461,251067630,8070734,259138364,0,0,1,18432,6,562493025
9462,251087990,8092363,259180353,7,0,1,117760,14,2750003546
9463,251115720,8085879,259201599,7,0,1,51712,14,4870210913
9464,251137790,8069198,259206988,9,0,1,17408,10,6673244359
9465,251168740,469162,251637902,9,0,0,13824,10,5089231594
9466,251174640,548040,251722680,9,0,0,272896,10,10355538281
9467,251177570,180984,251358554,9,0,0,1536,10,9707123854
9468,251208720,206236,251414956,8,0,0,4096,12,7360894681
9469,251375330,516816,251892146,9,0,0,130560,10,972572599
9470,251407920,191897,251599817,8,0,0,1024,12,3202738672
9471,251423550,7793641,259217191,9,0,1,5120,10,2857075380
9472,251434510,7784307,259218817,0,0,1,2560,6,5275257409
9473,251474820,268695,251743515,9,0,0,24576,10,8673177313
9474,251476881,7744202,259221083,2,0,1,3584,0,10236867871
9475,251498700,7744608,259243308,7,0,1,80896,14,8199729720
9476,251566311,7681250,259247561,2,0,1,12288,0,7198568420
9477,251628581,513173,252141754,7,0,0,111104,14,2734172872
9478,251689490,286657,251976147,9,0,0,45056,10,8247506791
9479,251747971,7515020,259262991,2,0,1,512,0,5336763095
9480,251750611,464132,252214743,7,0,0,44032,14,5885220198
9481,251753261,7511676,259264937,2,0,1,3072,0,8937039696
9482,251755150,7520995,259276145,9,0,1,25600,10,1812547310
9483,251785621,543830,252329451,7,0,0,365056,14,2530393025
9484,251798990,534030,252333020,9,0,0,11264,10,10460579969
9485,251805260,7475711,259280971,7,0,1,7680,14,8674945228
9486,251839750,7877975,259717725,7,0,1,363520,14,9972354789
9487,251860150,7857590,259717740,0,0,1,15872,6,4138512286
9488,251916010,137114,252053124,8,0,0,2048,12,1084118228
9489,251962280,7755475,259717755,0,0,1,31232,6,3315589321
9490,251965520,7752250,259717770,0,0,1,8192,6,10517495465
9491,252006500,7711293,259717793,0,0,1,20480,6,5403256566
9492,252012441,7705367,259717808,2,0,1,37888,0,3162366340
9493,252042001,7675822,259717823,2,0,1,6144,0,6256899153
9494,252100681,7617157,259717838,2,0,1,23552,0,8562289626
9495,252163430,7554423,259717853,9,0,1,18432,10,2145754584
9496,252202971,7514897,259717868,2,0,1,9728,0,9708465317
9497,252208461,7509422,259717883,2,0,1,6656,0,10682351657
9498,252228451,555732,252784183,7,0,0,167936,14,260636848
9499,252234480,7488054,259722534,9,0,1,27136,10,638975791
9500,252270850,555299,252826149,9,0,0,45568,10,1783619994
9501,252292511,619952,252912463,7,0,0,57856,14,9105643773
9502,252316380,7422068,259738448,9,0,1,58880,10,7487147165
9503,252338790,363586,252702376,9,0,0,19968,10,5144341779
9504,252438141,7303213,259741354,2,0,1,4608,0,8083289634
9505,252463071,332072,252795143,7,0,0,9216,14,1275244750
9506,252472200,7273603,259745803,0,0,1,8704,6,8064399392
9507,252538060,7236560,259774620,9,0,1,18432,10,9013665551
9508,252574120,7202446,259776566,0,0,1,3072,6,6177787008
9509,252631581,7146931,259778512,2,0,1,3072,0,4402036869
9510,252733450,592724,253326174,9,0,0,229888,10,5243796058
9511,252763731,381813,253145544,7,0,0,41472,14,9617744307
9512,252785961,596092,253382053,7,0,0,183296,14,4714081227
9513,252787521,7007897,259795418,2,0,1,53248,0,5297487592
9514,252873531,6924153,259797684,2,0,1,3584,0,796913556
9515,252890860,585726,253476586,9,0,0,142848,10,7166058176
9516,252930781,6873573,259804354,2,0,1,31744,0,4352624116
9517,252944380,6868589,259812969,9,0,1,22528,10,1672360606
9518,252991360,6828805,259820165,9,0,1,2560,10,8055175376
9519,253057651,332302,253389953,7,0,0,25600,14,3506831465
9520,253163391,468039,253631430,7,0,0,38400,14,2803826068
9521,253195850,194757,253390607,8,0,0,2048,12,10352790876
9522,253205670,506872,253712542,9,0,0,182272,10,479971015
9523,253260801,6608500,259869301,2,0,1,44032,0,2113144130
9524,253277831,6608634,259886465,2,0,1,5632,0,6579875883
9525,253298960,282653,253581613,8,0,0,2560,12,7601182192
9526,253350860,487861,253838721,9,0,0,27648,10,6613197098
9527,253361050,227294,253588344,8,0,0,5120,12,7083300233
9528,253533700,484457,254018157,9,0,0,145920,10,4163914828
9529,253642121,331561,253973682,7,0,0,139264,14,6109254272
9530,253672561,484489,254157050,7,0,0,92160,14,2716463225
9531,253747230,326920,254074150,9,0,0,55808,10,9726680556
9532,253887890,220434,254108324,8,0,0,1024,12,1661669574
9533,254086361,460136,254546497,7,0,0,81920,14,1397111504
9534,254145360,312850,254458210,9,0,0,15360,10,4822731185
9535,254155521,346402,254501923,7,0,0,15360,14,631405285
9536,254199350,321872,254521222,9,0,0,1536,10,7789418061
9537,254224950,173467,254398417,8,0,0,512,12,5903076075
9538,254234400,5859229,260093629,7,0,1,322560,14,2274619246
9539,254259790,286878,254546668,9,0,0,512,10,330737498
9540,254285190,274012,254559202,9,0,0,4608,10,336624126
9541,254433171,669591,255102762,7,0,0,122880,14,4428958979
9542,254443341,326916,254770257,9,0,0,5120,10,7354665634
9543,254487511,489762,254977273,7,0,0,201728,14,7666914588
9544,254496220,5597424,260093644,7,0,1,3072,14,2413699707
9545,254607610,5696628,260304238,7,0,1,411136,14,507511913
9546,254685190,345208,255030398,9,0,0,512,10,2304140831
9547,254714950,392505,255107455,8,0,0,512,12,7225558351
9548,254725431,423051,255148482,7,0,0,111616,14,627374326
9549,254785440,5546186,260331626,7,0,1,27648,14,5714489998
9550,254825350,5510462,260335812,7,0,1,6656,14,5956487917
9551,254838120,5525868,260363988,7,0,1,51712,14,1622711090
9552,254839371,390859,255230230,9,0,0,3072,10,5370153406
9553,254901631,247178,255148809,9,0,0,1024,10,8163956450
9554,255029190,5353416,260382606,7,0,1,1024,14,3160094418
9555,255157621,423870,255581491,7,0,0,70656,14,282308636
9556,255178030,342658,255520688,8,0,0,2048,12,8154446226
9557,255196191,318058,255514249,9,0,0,10752,10,8439831214
9558,255205540,5177089,260382629,7,0,1,3584,14,7875663608
9559,255213601,518221,255731822,7,0,0,201728,14,5968943704
9560,255213801,121577,255335378,9,0,0,2048,10,4582303946
9561,255310760,271214,255581974,8,0,0,1536,12,3843698694
9562,255339700,5042944,260382644,7,0,1,4608,14,10154763509
9563,255345690,5048729,260394419,7,0,1,27136,14,5354374730
9564,255473960,4926360,260400320,8,0,1,19968,12,10679915986
9565,255568900,4837720,260406620,8,0,1,7168,12,6406381667
9566,255581480,4826766,260408246,8,0,1,2560,12,1762125440
9567,255628651,392973,256021624,7,0,0,120320,14,2154087646
9568,255671421,350442,256021863,9,0,0,512,10,7412116179
9569,255686800,4724672,260411472,8,0,1,5120,12,8732465316
9570,255772231,250286,256022517,9,0,0,2048,10,4996598026
9571,255858140,4561205,260419345,8,0,1,20992,12,5307769501
9572,255929340,190188,256119528,8,0,0,4608,12,8879571068
9573,255992771,408187,256400958,9,0,0,7168,10,7161545686
9574,256029850,258866,256288716,8,0,0,2560,12,948992054
9575,256089190,4333061,260422251,7,0,1,4608,14,4150540188
9576,256143810,4319047,260462857,7,0,1,38912,14,7668130751
9577,256155131,266000,256421131,9,0,0,2048,10,7985836872
9578,256183641,186078,256369719,9,0,0,2560,10,8261457154
9579,256226381,558426,256784807,7,0,0,168960,14,10065095320
9580,256266091,363249,256629340,7,0,0,14848,14,2712794039
9581,256318441,245220,256563661,7,0,0,3072,14,24140969
9582,256357010,203333,256560343,8,0,0,2560,12,5310697440
9583,256364330,4103033,260467363,7,0,1,7168,14,8046604981
9584,256475850,3992384,260468234,7,0,1,12288,14,6718906356
9585,256489880,4161300,260651180,7,0,1,33792,14,3608407905
9586,256557110,228500,256785610,8,0,0,2560,12,7556302280
9587,256561660,4089535,260651195,8,0,1,4608,12,9616678584
9588,256564350,4086860,260651210,8,0,1,15872,12,1432412284
9589,256583140,4068420,260651560,8,0,1,12288,12,4191363238
9590,256594040,4057535,260651575,8,0,1,2560,12,4252774835
9591,256618140,4033450,260651590,7,0,1,11264,14,1194292379
9592,256667150,125772,256792922,8,0,0,1024,12,10166332744
9593,256708830,3942775,260651605,7,0,1,1024,14,6948687892
9594,256739781,289601,257029382,9,0,0,3584,10,4951828650
9595,256766231,285086,257051317,7,0,0,18944,14,7321988035
9596,256830640,3820996,260651636,8,0,1,18432,12,5729635760
9597,256892011,187448,257079459,9,0,0,3072,10,4913153727
9598,256894160,3760004,260654164,7,0,1,5120,14,1832745894
9599,256909600,204305,257113905,8,0,0,4096,12,5767176902
9600,256987980,3671010,260658990,7,0,1,7680,14,1521575019
9601,256995580,229491,257225071,8,0,0,1536,12,10325202884
9602,257039551,307135,257346686,7,0,0,66048,14,10007569287
9603,257139510,273559,257413069,8,0,0,2560,12,7115802809
9604,257158030,3505146,260663176,8,0,1,6656,12,1506267014
9605,257226760,3444078,260670838,8,0,1,9728,12,7048985694
9606,257244170,3513302,260757472,7,0,1,60416,14,5249970645
9607,257251390,188030,257439420,8,0,0,512,12,6719786011
9608,257265440,135501,257400941,8,0,0,4608,12,5500871725
9609,257288431,333373,257621804,7,0,0,137728,14,1521688682
9610,257297230,325057,257622287,8,0,0,1536,12,973816744
9611,257323071,299543,257622614,9,0,0,1024,10,2835490847
9612,257327531,357355,257684886,7,0,0,9216,14,10458727649
9613,257457990,3299828,260757818,8,0,1,512,12,5870215213
9614,257498061,233780,257731841,9,0,0,1024,10,10580666816
9615,257554040,178575,257732615,8,0,0,1024,12,6704680735
9616,257554990,3205197,260760187,7,0,1,16384,14,684081597
9617,257572961,131269,257704230,9,0,0,512,10,2474917213
9618,257619641,521540,258141181,7,0,0,176640,14,5163108017
9619,257675261,409039,258084300,7,0,0,15360,14,7527697452
9620,257707070,3088857,260795927,8,0,1,38400,12,9908800199
9621,257736930,3073298,260810228,7,0,1,5120,14,2636059015
9622,257798811,351157,258149968,7,0,0,11776,14,10005577886
9623,257812730,3001364,260814094,7,0,1,6144,14,4190917711
9624,257855270,100337,257955607,8,0,0,1536,12,2390531954
9625,257913140,2934372,260847512,8,0,1,24064,12,8616648918
9626,258113900,2734918,260848818,8,0,1,2048,12,9570795521
9627,258164341,277649,258441990,7,0,0,16896,14,8339275388
9628,258187610,2661554,260849164,8,0,1,512,12,5423298296
9629,258193080,2657672,260850752,8,0,1,15872,12,3347832222
9630,258232030,2620207,260852237,8,0,1,15360,12,5786915804
9631,258232310,2629117,260861427,8,0,1,27648,12,10149140867
9632,258241810,2649179,260890989,0,0,1,9216,6,6611063901
9633,258242070,2732720,260974790,7,0,1,51712,14,4479441377
9634,258253950,2721608,260975558,7,0,1,11776,14,5175353990
9635,258257710,264183,258521893,8,0,0,4608,12,2877904042
9636,258349810,162856,258512666,8,0,0,1024,12,4186459775
9637,258430351,405093,258835444,7,0,0,122368,14,4668378541
9638,258446120,2550975,260997095,7,0,1,2048,14,8391800416
9639,258503940,271569,258775509,8,0,0,512,12,3939166281
9640,258528440,2475837,261004277,8,0,1,34304,12,2784701972
9641,258552230,228667,258780897,8,0,0,3072,12,9345770553
9642,258556481,287577,258844058,9,0,0,6144,10,9257241873
9643,258573830,2506540,261080370,8,0,1,1536,12,3921585405
9644,258662480,2426115,261088595,8,0,1,19456,12,2742287339
9645,258828740,282875,259111615,8,0,0,512,12,2224427400
9646,258840710,2343308,261184018,7,0,1,37888,14,1050654367
9647,258850610,280557,259131167,8,0,0,3584,12,10056077743
9648,258860800,332583,259193383,8,0,0,2560,12,2350913906
9649,258870000,2389552,261259552,8,0,1,2560,12,7786676719
9650,258910000,2349567,261259567,8,0,1,5120,12,6925492928
9651,259025150,371920,259397070,8,0,0,31744,12,354544039
9652,259030431,191820,259222251,9,0,0,512,10,9479947846
9653,259140850,2118732,261259582,9,0,1,13312,10,1850047732
9654,259157511,353790,259511301,7,0,0,41472,14,5907570110
9655,259166860,2092737,261259597,9,0,1,11264,10,9025210476
9656,259169061,548641,259717702,7,0,0,350208,14,4834703894
9657,259212561,2047051,261259612,2,0,1,4608,0,2006730753
9658,259220971,2038656,261259627,2,0,1,512,0,3769354249
9659,259235620,2024038,261259658,8,0,1,3584,12,1733027437
9660,259235660,2049939,261285599,7,0,1,27136,14,7402907188
9661,259262601,2023021,261285622,2,0,1,1024,0,6711294320
9662,259265460,2020177,261285637,9,0,1,10240,10,1238602638
9663,259268030,2017622,261285652,8,0,1,7680,12,6402130269
9664,259291270,2034831,261326101,7,0,1,34816,14,5486043038
9665,259295650,2030466,261326116,9,0,1,8704,10,3860721836
9666,259373501,1952630,261326131,2,0,1,2048,0,10178710888
9667,259406300,1919846,261326146,7,0,1,2560,14,6894862681
9668,259409171,1916990,261326161,2,0,1,19456,0,4764674840
9669,259414340,1911836,261326176,9,0,1,9216,10,10340883264
9670,259432991,334622,259767613,7,0,0,8704,14,1105142178
9671,259508880,211517,259720397,8,0,0,6144,12,10171604264
9672,259513000,1813348,261326348,9,0,1,3072,10,3848942463
9673,259565680,1761014,261326694,7,0,1,512,14,4723305259
9674,259566540,1763700,261330240,9,0,1,5632,10,2759669160
9675,259579030,386238,259965268,8,0,0,157184,12,10553224790
9676,259596711,153747,259750458,9,0,0,512,10,1905391567
9677,259623951,1708875,261332826,2,0,1,4096,0,10248512706
9678,259664011,408913,260072924,9,0,0,3072,10,8221705585
9679,259758090,335524,260093614,8,0,0,50176,12,10078483885
9680,259802541,163366,259965907,7,0,0,2048,14,2406434840
9681,259808010,174115,259982125,8,0,0,49664,12,2008914972
9682,259836091,402359,260238450,7,0,0,17920,14,6204653531
9683,259877301,366605,260243906,9,0,0,3584,10,5204540085
9684,259881130,1464256,261345386,9,0,1,33280,10,3855059887
9685,259943050,1408845,261351895,9,0,1,5632,10,7428791990
9686,259959081,404892,260363973,7,0,0,68096,14,10246708233
9687,259992880,1465193,261458073,9,0,1,36864,10,7161132075
9688,260006090,376501,260382591,8,0,0,49152,12,2469370547
9689,260015291,254923,260270214,7,0,0,11264,14,3425135331
9690,260117941,202706,260320647,9,0,0,7168,10,2000151003
9691,260118530,832013,260950543,8,0,0,53760,12,5323764157
9692,260122210,1335886,261458096,0,0,1,2560,6,3686593094
9693,260225000,707409,260932409,8,0,0,83456,12,5422253794
9694,260236601,1022936,261259537,7,0,0,247808,14,5009529620
9695,260239990,1218121,261458111,7,0,1,6656,14,2177456502
9696,260244221,406944,260651165,7,0,0,190976,14,5428227256
9697,260290641,360896,260651537,9,0,0,1024,10,6694495787
9698,260313180,865332,261178512,8,0,0,287232,12,6135736261
9699,260331851,852136,261183987,7,0,0,17920,14,5599073065
9700,260376890,1081236,261458126,0,0,1,1536,6,5873925948
9701,260405180,1053132,261458312,9,0,1,7168,10,3031770118
9702,260408771,876813,261285584,7,0,0,38400,14,3196749429
9703,260426570,1032100,261458670,9,0,1,26624,10,8337333794
9704,260434840,1023845,261458685,9,0,1,20992,10,5044522971
9705,260516391,417757,260934148,9,0,0,5632,10,5000069743
9706,260542580,731289,261273869,8,0,0,46592,12,5032094184
9707,260543560,915140,261458700,7,0,1,7680,14,407173706
9708,260585960,872755,261458715,9,0,1,2560,10,4282293221
9709,260608050,849369,261457419,8,0,0,291840,12,5780004018
9710,260630270,695816,261326086,8,0,0,108544,12,7385836800
9711,260634760,658239,261292999,8,0,0,24064,12,2296194965
9712,260670101,94679,260764780,9,0,0,512,10,495020004
9713,260678150,782614,261460764,0,0,1,7680,6,9220555242
9714,260753381,704677,261458058,9,0,0,2048,10,6946920284
9715,260794410,668301,261462711,0,0,1,25600,6,7681865854
9716,260809061,653237,261462298,9,0,0,3072,10,5896533546
9717,260872110,664415,261536525,0,0,1,3584,6,4949256301
9718,260908481,550158,261458639,9,0,0,1024,10,9877728923
9719,260935610,602093,261537703,9,0,1,13824,10,7134329765
9720,260948980,595252,261544232,0,0,1,23040,6,10100031979
9721,260991520,561190,261552710,7,0,1,10752,14,4144521539
9722,261060740,664565,261725305,8,0,0,205312,12,7662685576
9723,261066021,392276,261458297,9,0,0,512,10,5081627234
9724,261066951,564242,261631193,7,0,0,106496,14,9721091412
9725,261078300,485206,261563506,0,0,1,32256,6,10696872345
9726,261112480,473287,261585767,9,0,1,16384,10,5761414108
9727,261135780,498874,261634654,9,0,1,34816,10,2437390285
9728,261235441,707336,261942777,7,0,0,81920,14,4672359430
9729,261358690,284794,261643484,0,0,1,19456,6,7075188445
9730,261383780,353451,261737231,9,0,0,3072,10,4914435557
9731,261409140,737603,262146743,8,0,0,106496,12,10430921512
9732,261415341,555213,261970554,9,0,0,3072,10,6915511789
9733,261524920,132336,261657256,0,0,1,6144,6,9386489811
9734,261528010,551285,262079295,8,0,0,296960,12,5521161014
9735,261545521,651759,262197280,7,0,0,110592,14,7862396682
9736,261564140,161180,261725320,7,0,1,25600,14,1110599044
9737,261611660,113675,261725335,7,0,1,3072,14,4880025065
9738,261643441,662020,262305461,7,0,0,76800,14,2639628124
9739,261807441,272033,262079474,9,0,0,512,10,1886125019
9740,261880260,13770,261894030,7,0,1,26624,14,5809039764
9741,261886760,569453,262456213,8,0,0,258560,12,6740497834
9742,261907110,3422,261910532,7,0,1,3584,14,10308371302
9743,261942960,15837,261958797,7,0,1,30720,14,259526869
9744,261960141,271913,262232054,9,0,0,1536,10,8256009852
9745,261984751,3898,261988649,2,0,1,4096,0,3215074841
9746,261991161,92484,262083645,2,0,1,11264,0,6042688705
9747,262015140,79308,262094448,7,0,1,18944,14,7186137219
9748,262060870,39608,262100478,7,0,1,19456,14,9671421759
9749,262085611,161463,262247074,9,0,0,1024,10,1594526748
9750,262111061,419701,262530762,7,0,0,93184,14,3916634614
9751,262146200,10776,262156976,0,0,1,16384,6,2816558574
9752,262150201,47094,262197295,2,0,1,35840,0,9810927013
9753,262210331,12566,262222897,2,0,1,20992,0,3478259710
9754,262212700,244464,262457164,9,0,0,3072,10,5742061813
9755,262246001,285244,262531245,9,0,0,1536,10,5630969947
9756,262285470,26754,262312224,0,0,1,7168,6,7881483893
9757,262290401,297743,262588144,9,0,0,2048,10,3171804803
9758,262355820,6754,262362574,0,0,1,7168,6,6920256520
9759,262360680,3200,262363880,0,0,1,2048,6,4594057109
9760,262483540,267082,262750622,8,0,0,16384,12,1689133045
9761,262492230,3898,262496128,7,0,1,4096,14,8100185325
9762,262524990,12218,262537208,7,0,1,14848,14,201898189
9763,262593000,1042,262594042,8,0,1,1024,12,2290150534
9764,262618060,12308,262630368,8,0,1,20480,12,951746074
9765,262621110,691871,263312981,8,0,0,553984,12,560685126
9766,262641770,3387,262645157,0,0,1,9728,6,6787486398
9767,262721040,21916,262742956,0,0,1,35840,6,2093457956
9768,262745111,629258,263374369,7,0,0,104960,14,195600196
9769,262751810,10757,262762567,7,0,1,17408,14,5678361688
9770,262757291,319834,263077125,9,0,0,4608,10,3608839956
9771,262812190,15579,262827769,8,0,1,30208,12,8262489955
9772,262813131,18184,262831315,2,0,1,5632,0,9031267660
9773,262821960,285113,263107073,8,0,0,33792,12,8138555311
9774,262843010,13858,262856868,7,0,1,23552,14,260320817
9775,262855230,14117,262869347,0,0,1,24064,6,3757008666
9776,262872430,441705,263314135,9,0,0,3584,10,395230008
9777,262874391,5326,262879717,2,0,1,5632,0,9482988539
9778,262874770,14727,262889497,0,0,1,22528,6,8942305047
9779,262909020,13253,262922273,8,0,1,25600,12,8042861744
9780,262934281,440259,263374540,9,0,0,512,10,5756892377
9781,262936130,812854,263748984,8,0,0,391168,12,6433603159
9782,262971460,517599,263489059,8,0,0,87040,12,5891027241
9783,262979991,513303,263493294,7,0,0,13824,14,10575012240
9784,263019910,5971,263025881,7,0,1,14848,14,2053936745
9785,263021590,25772,263047362,7,0,1,40960,14,6334485844
9786,263022210,40991,263063201,7,0,1,47616,14,6285034936
9787,263071030,566,263071596,8,0,1,512,12,3143504495
9788,263072760,6488,263079248,0,0,1,15872,6,1831432135
9789,263124310,188694,263313004,7,0,1,54272,14,6757661359
9790,263155731,706303,263862034,7,0,0,167936,14,2273349589
9791,263177850,142998,263320848,7,0,1,7168,14,1886765378
9792,263224290,104296,263328586,8,0,1,20480,12,2884553889
9793,263272161,56784,263328945,2,0,1,9728,0,7665914329
9794,263445830,151844,263597674,9,0,0,6656,10,2376410862
9795,263463630,52831,263516461,8,0,1,38400,12,6300321827
9796,263524930,483608,264008538,8,0,0,131072,12,3783738332
9797,263527180,360921,263888101,8,0,0,85504,12,934691207
9798,263542341,2946,263545287,2,0,1,3072,0,3655171093
9799,263550040,4162,263554202,8,0,1,11264,12,10162447863
9800,263574850,1518,263576368,7,0,1,1536,14,9020844604
9801,263612330,3387,263615717,7,0,1,9728,14,3678155368
9802,263616511,174313,263790824,9,0,0,2048,10,5966809350
9803,263640421,379988,264020409,7,0,0,38912,14,7783201764
9804,263732160,39549,263771709,7,0,1,37376,14,9979007962
9805,263738190,39625,263777815,8,0,1,29184,12,7181442969
9806,263910381,512021,264422402,7,0,0,228352,14,3294277796
9807,263924210,123683,264047893,9,0,0,2560,10,4392367051
9808,263965481,302522,264268003,7,0,0,76800,14,501980280
9809,264017550,94350,264111900,7,0,1,147968,14,1470179490
9810,264095410,194987,264290397,7,0,1,319488,14,833487329
9811,264140501,151202,264291703,2,0,1,2048,0,8270869226
9812,264236640,47288,264283928,9,0,0,1536,10,3884678915
9813,264272381,25326,264297707,2,0,1,20480,0,6462087623
9814,264370711,522798,264893509,7,0,0,114688,14,6750128665
9815,264391240,270516,264661756,9,0,0,512,10,8201625125
9816,264416550,382757,264799307,8,0,0,96768,12,1262241257
9817,264430420,415965,264846385,8,0,0,83968,12,9122715686
9818,264435871,317964,264753835,9,0,0,8192,10,9908697204
9819,264467560,233652,264701212,8,0,0,66560,12,5925858901
9820,264551381,1518,264552899,2,0,1,1536,0,5477214520
9821,264855591,37933,264893524,2,0,1,23552,0,3893892993
9822,264878871,175669,265054540,7,0,0,30208,14,9016577335
9823,264956050,3898,264959948,0,0,1,4096,6,5679473017
9824,265073280,160375,265233655,8,0,0,74752,12,1647984057
9825,265165800,6278,265172078,0,0,1,6656,6,4155712768
9826,265217791,19501,265237292,2,0,1,10240,0,8838654097
9827,265244710,10499,265255209,8,0,1,16896,12,8189364669
9828,265253301,10757,265264058,2,0,1,17408,0,2544775467
9829,265256200,8844,265265044,0,0,1,1536,6,3799725113
9830,265279130,10241,265289371,0,0,1,16384,6,9082031683
9831,265280220,9305,265289525,8,0,1,8704,12,2775108117
9832,265350010,1518,265351528,0,0,1,1536,6,1495565651
9833,265415920,5196,265421116,0,0,1,13312,6,473813548
9834,265435120,4374,265439494,0,0,1,4608,6,4321598051
9835,265441391,1518,265442909,2,0,1,1536,0,275936447
9836,265476900,13770,265490670,8,0,1,26624,12,1232296819
9837,265566550,185243,265751793,8,0,0,41472,12,7443330626
9838,265575870,2870,265578740,0,0,1,8704,6,2490634577
9839,265593691,353476,265947167,7,0,0,205824,14,9968323400
9840,265677290,2870,265680160,0,0,1,8704,6,2318244809
9841,265705380,115795,265821175,7,0,1,192000,14,10227053202
9842,265746341,224407,265970748,7,0,0,24064,14,579344540
9843,265759640,405555,266165195,8,0,0,304128,12,4476150757
9844,265762430,434448,266196878,8,0,0,103936,12,10204216841
9845,265797140,24496,265821636,7,0,1,10240,14,9173541565
9846,265840531,2946,265843477,2,0,1,3072,0,7327874031
9847,265848291,375145,266223436,7,0,0,87040,14,10009528836
9848,265848561,406246,266254807,7,0,0,102912,14,194892612
9849,265994571,307688,266302259,7,0,0,136704,14,5116608133
9850,266022230,174663,266196893,7,0,1,120320,14,5203252032
9851,266057541,245677,266303218,7,0,0,3072,14,414033618
9852,266126751,245915,266372666,7,0,0,43008,14,4627299893
9853,266272150,36506,266308656,7,0,1,13824,14,10357355986
9854,266291020,27927,266318947,0,0,1,18944,6,2813642217
9855,266316540,5454,266321994,0,0,1,13824,6,717725180
9856,266355540,183658,266539198,7,0,1,297472,14,7149176597
9857,266577921,22174,266600095,2,0,1,36352,0,2110937486
9858,266588180,15141,266603321,0,0,1,5120,6,7981417112
9859,266644271,311921,266956192,7,0,0,67584,14,9928594581
9860,266646590,66062,266712652,8,0,0,1024,12,9076135274
9861,266654030,57113,266711143,7,0,1,97792,14,10641639241
9862,266711720,43370,266755090,7,0,1,74240,14,7311428142
9863,266785250,6229,266791479,0,0,1,15360,6,4528703702
9864,266831531,7230,266838761,2,0,1,7680,0,8324360482
9865,266846791,253036,267099827,7,0,0,137216,14,6698111744
9866,266850460,1994,266852454,0,0,1,2048,6,146591739
9867,266855720,73968,266929688,8,0,0,512,12,1089771143
9868,266884070,153227,267037297,8,0,0,512,12,9807831335
9869,266899080,5326,266904406,0,0,1,5632,6,5009240123
9870,266920500,44145,266964645,7,0,1,75776,14,9097968608
9871,266925120,174722,267099842,7,0,1,193024,14,9785987305
9872,266948680,151987,267100667,8,0,0,2560,12,772566800
9873,266949790,150067,267099857,0,0,1,14848,6,10350604725
9874,266958410,168987,267127397,8,0,0,512,12,8925396927
9875,266972941,607325,267580266,7,0,0,46592,14,2152013191
9876,266997621,102251,267099872,2,0,1,1536,0,7296002531
9877,267123770,6488,267130258,0,0,1,15872,6,6474202366
9878,267134801,431254,267566055,7,0,0,353280,14,3016737449
9879,267156140,76928,267233068,8,0,0,2048,12,5466441625
9880,267175900,13770,267189670,0,0,1,26624,6,3675218373
9881,267285710,295507,267581217,8,0,0,3072,12,9121242209
9882,267610811,116012,267726823,7,0,0,80896,14,4844458250
9883,267692600,34238,267726838,8,0,1,16384,12,4804949575
9884,267788810,13600,267802410,7,0,1,23040,14,6546715286
9885,267832820,3904,267836724,8,0,1,10752,12,10526146621
9886,267907650,45596,267953246,8,0,0,1024,12,10062245660
9887,267915560,45596,267961156,8,0,0,1024,12,7920082833
9888,268011810,43904,268055714,8,0,0,512,12,4931924597
9889,268024280,60824,268085104,8,0,0,5632,12,9874055628
9890,268058130,21916,268080046,8,0,1,35840,12,3062461161
9891,268150151,100256,268250407,7,0,0,29184,14,2048888819
9892,268512801,100100,268612901,7,0,0,28672,14,1525628847
9893,268563511,143038,268706549,7,0,0,36352,14,1718001738
9894,268838720,10241,268848961,7,0,1,16384,14,479474997
9895,268969101,260240,269229341,7,0,0,276992,14,3959987961
9896,269075300,154368,269229668,8,0,0,1024,12,12408945
9897,269117981,120906,269238887,7,0,0,30208,14,9170668803
9898,269338770,45596,269384366,8,0,0,1024,12,4478711791
9899,269380760,48980,269429740,8,0,0,2048,12,3667147043
9900,269597390,12566,269609956,0,0,1,20992,6,10378954201
9901,269800070,47288,269847358,8,0,0,1536,12,126211835
9902,269894970,305888,270200858,8,0,0,381440,12,6668811201
9903,270145710,155396,270301106,8,0,0,29184,12,1602923885
9904,270214890,150968,270365858,8,0,0,80384,12,3817642274
9905,270233580,156473,270390053,8,0,0,79360,12,1083589822
9906,270566980,274712,270841692,8,0,0,284160,12,9999380751
9907,270567420,7230,270574650,8,0,1,7680,12,9920905660
9908,270835130,11404,270846534,8,0,1,5120,12,9322512458
9909,270934370,107900,271042270,8,0,0,54272,12,2288742434
9910,270957690,155974,271113664,8,0,0,105984,12,10049031780
9911,270986800,127199,271113999,8,0,0,1024,12,7491105146
9912,271013540,7230,271020770,8,0,1,7680,12,5332967912
9913,271034980,21827,271056807,8,0,1,28160,12,10325737384
9914,271082180,32344,271114524,8,0,1,512,12,2056323299
9915,271300720,10241,271310961,8,0,1,16384,12,2568462568
9916,271369540,61749,271431289,8,0,0,3584,12,10412105839
9917,271374530,5454,271379984,8,0,1,13824,12,4025842290
9918,271413800,6488,271420288,8,0,1,15872,12,3525962013
9919,271421630,1518,271423148,8,0,1,1536,12,5319501078
9920,271430850,46027,271476877,8,0,0,1024,12,9632428353
9921,271539480,57440,271596920,8,0,0,4608,12,6698733958
9922,271630660,3645,271634305,8,0,1,10240,12,9934129972
9923,271646530,21399,271667929,8,0,1,34816,12,6560873772
9924,271786810,13253,271800063,8,0,1,25600,12,1395331457
9925,271886100,129316,272015416,8,0,0,2048,12,10194282731
9926,271965180,3898,271969078,8,0,1,4096,12,5189658978
9927,271997680,12995,272010675,8,0,1,25088,12,1701431257
9928,272146790,4162,272150952,8,0,1,11264,12,624650478
9929,272569270,4679,272573949,8,0,1,12288,12,6597354359
9930,272595010,3645,272598655,8,0,1,10240,12,5876854255
9931,272658360,4850,272663210,8,0,1,5120,12,5341869638
9932,272731840,47288,272779128,8,0,0,1536,12,7418370486
9933,272748830,79183,272828013,8,0,0,3072,12,516896840
9934,273398989,191372,273590361,0,0,0,166912,6,7695071211
9935,273562360,75437,273637797,8,0,0,2048,12,8314838587
9936,273659800,45596,273705396,8,0,0,1024,12,2084930163
9937,273736640,43904,273780544,8,0,0,512,12,6333137504
9938,273909150,566,273909716,0,0,1,512,6,6631176623
9939,274012370,54056,274066426,8,0,0,3584,12,7895946783
9940,274036989,117151,274154140,0,0,0,63488,6,1915246106
9941,274065630,89645,274155275,8,0,0,1536,12,8608069710
9942,274643899,173600,274817499,0,0,0,143872,6,1342654115
9943,275271270,45596,275316866,8,0,0,1024,12,4946454231
9944,275355860,54368,275410228,8,0,0,4608,12,3896419357
9945,275475799,112424,275588223,0,0,0,69120,6,1015634288
9946,275569699,142484,275712183,0,0,0,107008,6,1991209480
9947,275633610,89817,275723427,8,0,0,512,12,1129604491
9948,275718209,242384,275960593,0,0,0,268800,6,4676270145
9949,275893190,112991,276006181,8,0,0,1024,12,8262164971
9950,275952969,141082,276094051,0,0,0,61440,6,6714375389
9951,275979310,5326,275984636,8,0,1,5632,12,5609179320
9952,276026859,273880,276300739,0,0,0,263680,6,2024405012
9953,276042950,566,276043516,8,0,1,512,12,5890779268
9954,276094969,298956,276393925,0,0,0,180224,6,953655033
9955,276223310,171262,276394572,8,0,0,2048,12,9450966052
9956,276358199,153604,276511803,0,0,0,87040,6,4311579945
9957,276393919,353042,276746961,0,0,0,308224,6,9207675793
9958,276490229,294351,276784580,0,0,0,123392,6,9440496224
9959,276635600,1518,276637118,8,0,1,1536,12,10632042841
9960,276661570,126923,276788493,8,0,1,10752,12,7096398186
9961,276724140,118408,276842548,8,0,0,512,12,4913854314
9962,276739910,91794,276831704,8,0,0,1024,12,7404841924
9963,276750320,122534,276872854,8,0,0,3072,12,6794317937
9964,276752030,49405,276801435,8,0,1,26112,12,1043828917
9965,276786110,78440,276864550,8,0,0,1024,12,8920020037
9966,276842610,52846,276895456,8,0,0,512,12,1595619180
9967,276919499,136376,277055875,0,0,0,132608,6,4555869595
9968,276922890,4679,276927569,8,0,1,12288,12,4551656724
9969,277096510,25187,277121697,8,0,1,45568,12,5113744608
9970,277169360,85187,277254547,8,0,0,2048,12,6420351581
9971,277271139,77612,277348751,0,0,0,15360,6,6577096969
9972,277385150,48980,277434130,8,0,0,2048,12,10367280012
9973,277408729,114363,277523092,0,0,0,66048,6,6968471668
9974,277430389,106134,277536523,0,0,0,44032,6,9840276220
9975,277465640,83035,277548675,8,0,0,1536,12,3457143438
9976,277862730,57440,277920170,8,0,0,4608,12,2948772648
9977,278059890,52364,278112254,8,0,0,3072,12,4286852771
9978,278111629,106021,278217650,0,0,0,46080,6,5668176628
9979,278146280,33503,278179783,8,0,1,58368,12,8258555927
9980,278438059,106340,278544399,0,0,0,49152,6,4185313494
9981,278496150,69909,278566059,8,0,0,2048,12,6606022410
9982,278692150,52364,278744514,8,0,0,3072,12,1749266568
9983,278758599,73316,278831915,0,0,0,16384,6,5289640719
9984,278922909,303860,279226769,0,0,0,374784,6,10680345238
9985,278930360,299240,279229600,8,0,0,9216,12,2000230179
9986,278973570,256669,279230239,8,0,0,2048,12,7654736668
9987,279153880,118477,279272357,8,0,0,1024,12,7920520391
9988,279166500,127547,279294047,8,0,0,512,12,5385510869
9989,279458490,53495,279511985,0,0,1,90624,6,7082245634
9990,279525519,253266,279778785,0,0,0,98304,6,2869205987
9991,279540290,43904,279584194,8,0,0,512,12,1190582579
9992,279543770,76527,279620297,8,0,0,7168,12,6159365307
9993,279573840,1518,279575358,0,0,1,1536,6,8160345020
9994,279671630,6278,279677908,0,0,1,6656,6,4578036912
9995,280260550,54056,280314606,8,0,0,3584,12,8227382303
9996,280531530,4420,280535950,8,0,1,11776,12,4667343025
9997,280629340,55748,280685088,8,0,0,4096,12,6494411915
9998,281230300,47288,281277588,8,0,0,1536,12,4921867187
9999,281351440,45596,281397036,8,0,0,1024,12,9703020577
