RequestID,ArrivalTime,DelayTime,FinishTime,InitiatorID,TargetID,IOType,Size,VolumeID,Offset
0,0,4185,4185,0,0,1,10752,3,2212108760
1,1,88478,88479,5,0,0,10240,10,2586800267
2,2,274870,274872,4,0,0,108032,15,209532615
3,3,194443,194446,8,0,0,83456,8,8885691873
4,4,6681,6685,7,0,1,9216,10,10172201135
5,5,104915,104920,6,0,0,32768,7,9715234723
6,6,18408,18414,9,0,1,19968,12,200987270
7,7,19073,19080,2,0,1,1024,3,10707654814
8,8,20352,20360,3,0,1,14336,17,9314856532
9,9,25177,25186,1,0,1,7680,10,6832708499
10,460,25712,26172,0,0,1,1536,3,3433857586
11,2740,432014,434754,2,0,0,120320,3,5554276529
12,3331,25427,28758,6,0,1,4096,7,1867621763
13,16330,14054,30384,2,0,1,2560,3,6542132380
14,20500,14710,35210,1,0,1,7680,10,7422061754
15,25820,36863,62683,3,0,1,65024,17,6316661588
16,26740,298382,325122,4,0,0,37376,15,7050313732
17,29549,725615,755164,3,0,0,32768,17,5534361076
18,37760,607732,645492,4,0,0,32256,15,3606311918
19,38700,25929,64629,2,0,1,3072,3,3047264495
20,39470,293445,332915,2,0,0,10240,3,7085758149
21,44080,20703,64783,1,0,1,8704,10,4326878216
22,50300,419596,469896,4,0,0,47616,15,2690789854
23,51820,1399981,1451801,4,0,0,40960,15,8179930823
24,54910,311684,366594,4,0,0,37376,15,4912380466
25,58389,1054319,1112708,3,0,0,19968,17,2004285231
26,59950,5819,65769,8,0,1,1536,8,7397826038
27,67150,4374,71524,2,0,1,4608,3,8346999695
28,69310,2870,72180,2,0,1,8704,3,7983078152
29,72301,2470,74771,6,0,1,2560,7,5174426864
30,73519,1197521,1271040,3,0,0,177664,17,10366152169
31,98030,9828,107858,9,0,1,3072,12,2606468208
32,109270,2946,112216,9,0,1,3072,12,10291005743
33,120640,3898,124538,7,0,1,4096,10,7024903745
34,134210,521169,655379,6,0,0,26624,7,7527881258
35,134770,23637,158407,3,0,1,42496,17,7255391733
36,142260,550266,692526,6,0,0,1024,7,4980964285
37,143430,654537,797967,9,0,0,41472,12,6618721080
38,148780,10395,159175,2,0,1,11776,3,3368989861
39,149520,13521,163041,9,0,1,6144,12,7646496497
40,153630,12957,166587,1,0,1,5632,10,6191971776
41,155590,526651,682241,5,0,0,88064,10,8506719112
42,157880,10653,168533,2,0,1,3072,3,4869230511
43,159190,35271,194461,2,0,1,1024,3,9812082528
44,164050,53753,217803,3,0,1,91136,17,3106172304
45,170780,50889,221669,8,0,1,6144,8,6961335194
46,172410,50027,222437,3,0,1,11776,17,2637760645
47,174599,358027,532626,3,0,0,20480,17,9786587440
48,190010,34373,224383,1,0,1,3072,10,3036225572
49,192500,35109,227609,8,0,1,5120,8,2936499588
50,198320,1265702,1464022,6,0,0,2048,7,154094336
51,202119,1621400,1823519,3,0,0,51712,17,5673197996
52,209821,20694,230515,6,0,1,4608,7,2336715504
53,214011,16658,230669,6,0,1,8704,7,3440865750
54,219210,982073,1201283,5,0,0,13312,10,9732401459
55,223920,122908,346828,3,0,1,199168,17,2033899948
56,225190,121984,347174,2,0,1,512,3,10720622417
57,229110,119690,348800,2,0,1,2560,3,8626610900
58,230261,118898,349159,6,0,1,9728,7,1433272142
59,233791,116994,350785,6,0,1,2560,7,3749142040
60,234190,1141999,1376189,2,0,0,51200,3,7727283353
61,239620,1089271,1328891,6,0,0,62976,7,9411708468
62,250670,102061,352731,8,0,1,3072,8,10457776444
63,251360,102357,353717,1,0,1,1536,10,910429837
64,251400,431051,682451,9,0,0,512,12,6783001855
65,253630,874081,1127711,2,0,0,13824,3,217161784
66,257690,96693,354383,7,0,1,1024,10,9186163331
67,260950,94099,355049,3,0,1,1024,17,2052637939
68,264030,102579,366609,3,0,1,9728,17,586898704
69,265280,1648413,1913693,8,0,0,14848,8,6718855653
70,267319,1093255,1360574,3,0,0,103936,17,1128245220
71,268550,791277,1059827,8,0,0,48128,8,941645620
72,272159,1404800,1676959,3,0,0,100864,17,587601769
73,275380,91244,366624,7,0,1,1536,10,45873833
74,281720,84919,366639,7,0,1,12800,10,7292002229
75,282940,1236871,1519811,2,0,0,25088,3,2388935918
76,291461,75193,366654,6,0,1,2048,7,9925558328
77,297500,1871949,2169449,2,0,0,34304,3,8459520957
78,297700,598591,896291,5,0,0,7680,10,7514179654
79,307610,59059,366669,2,0,1,10240,3,7349516163
80,319450,47234,366684,3,0,1,7168,17,3432729423
81,337570,30576,368146,3,0,1,7168,17,4918862974
82,351830,17302,369132,8,0,1,1536,8,10588397869
83,353830,16288,370118,3,0,1,1536,17,10106900130
84,366050,411278,777328,9,0,0,9728,12,8730697223
85,367290,5734,373024,3,0,1,4608,17,7025251019
86,370050,3640,373690,3,0,1,1024,17,4424371407
87,372160,1746765,2118925,4,0,0,60928,15,3179280611
88,375280,491877,867157,9,0,0,10240,12,8331154395
89,378020,6754,384774,9,0,1,7168,12,5879157416
90,381390,4690,386080,7,0,1,2048,10,3216156820
91,389761,1042,390803,6,0,1,1024,7,7764092250
92,401890,775309,1177199,2,0,0,5632,3,1067866464
93,402659,903722,1306381,3,0,0,49152,17,10250985743
94,423101,15209,438310,6,0,1,3584,7,2139140189
95,431680,674929,1106609,5,0,0,27136,10,3597133398
96,432241,7695,439936,6,0,1,2560,7,10463211604
97,433891,7031,440922,6,0,1,1536,7,5759947200
98,434331,9177,443508,6,0,1,4096,7,4526538463
99,442741,2073,444814,6,0,1,2048,7,8898666030
100,444661,566,445227,6,0,1,512,7,10067058625
101,452271,17640,469911,6,0,1,5120,7,5694634782
102,452360,690441,1142801,4,0,0,14848,15,9748412264
103,471401,4850,476251,6,0,1,5120,7,7506786009
104,472720,1837843,2310563,5,0,0,91648,10,1555896385
105,473059,2833364,3306423,3,0,0,109568,17,8256137036
106,476189,1601614,2077803,3,0,0,175104,17,1592979140
107,480540,1994,482534,1,0,1,2048,10,2551350448
108,494800,1115293,1610093,9,0,0,30208,12,5494325313
109,494950,1262433,1757383,2,0,0,67072,3,4896787754
110,499999,387209,887208,3,0,0,8704,17,10634806218
111,509091,5712,514803,6,0,1,14336,7,7147296397
112,513360,455781,969141,6,0,0,59392,7,4801635179
113,517250,2306865,2824115,2,0,0,35840,3,1353047807
114,518060,1079484,1597544,9,0,0,104448,12,8649544073
115,520990,2946,523936,1,0,1,3072,10,7623395726
116,522001,10640,532641,6,0,1,4096,7,4337151565
117,532700,2153555,2686255,5,0,0,256512,10,10425771722
118,540610,1838185,2378795,5,0,0,10752,10,3952662639
119,541750,749624,1291374,5,0,0,4608,10,2520711972
120,547749,1544656,2092405,3,0,0,40960,17,1371993763
121,552490,5802,558292,1,0,1,6144,10,4604136269
122,553570,736369,1289939,5,0,0,61952,10,4479953599
123,554540,2224661,2779201,2,0,0,55296,3,3032655165
124,555130,4148,559278,7,0,1,1536,10,3219736655
125,568660,1903923,2472583,5,0,0,9728,10,114226041
126,580570,12825,593395,1,0,1,21504,10,7213756421
127,586050,1883546,2469596,4,0,0,24064,15,8844992584
128,589600,4141,593741,7,0,1,512,10,4091526248
129,606200,566,606766,3,0,1,512,17,6152494130
130,614310,1042,615352,3,0,1,1024,17,3082757279
131,617130,1518,618648,7,0,1,1536,10,9353408746
132,620870,11274,632144,7,0,1,18432,10,10671739973
133,626779,1014810,1641589,3,0,0,60416,17,7480798277
134,632770,1614961,2247731,4,0,0,48128,15,7153753764
135,635290,864310,1499600,2,0,0,39936,3,3576205911
136,637870,17524,655394,7,0,1,4608,10,8122836009
137,640180,42076,682256,1,0,1,4608,10,7174895850
138,657430,1463078,2120508,6,0,0,5120,7,9497422755
139,658540,1197959,1856499,6,0,0,10240,7,8868276788
140,659140,23886,683026,3,0,1,512,17,2637091244
141,675719,1027534,1703253,3,0,0,27648,17,8733660715
142,681560,2591408,3272968,5,0,0,3072,10,5240376844
143,687660,6278,693938,3,0,1,6656,17,2077245488
144,692630,794772,1487402,9,0,0,36864,12,1605875872
145,698310,4850,703160,7,0,1,5120,10,10513817220
146,699411,4095,703506,5,0,1,512,10,1577215407
147,704199,2140539,2844738,3,0,0,67584,17,6962088651
148,714361,1518,715879,5,0,1,1536,10,3329047393
149,718630,1992855,2711485,9,0,0,24576,12,3093201122
150,734390,1853166,2587556,9,0,0,85504,12,2152391879
151,737050,2470,739520,7,0,1,2560,10,6419559010
152,743490,1957802,2701292,2,0,0,34304,3,3204750422
153,753010,8424,761434,9,0,1,6656,12,2933109105
154,758390,708931,1467321,2,0,0,10752,3,2408522360
155,764900,2470,767370,3,0,1,2560,17,8114254419
156,800600,4850,805450,7,0,1,5120,10,5042876331
157,802880,1462029,2264909,2,0,0,2560,3,10297880545
158,803480,5516,808996,7,0,1,5632,10,5577602450
159,806510,4752,811262,3,0,1,3584,17,5715499175
160,820140,3898,824038,7,0,1,4096,10,4396609959
161,824500,6278,830778,3,0,1,6656,17,9541737434
162,847560,2946,850506,3,0,1,3072,17,3708426181
163,849950,4162,854112,3,0,1,11264,17,7856534924
164,850790,795406,1646196,6,0,0,14848,7,2399649482
165,856310,644249,1500559,2,0,0,3072,3,7566253862
166,860260,1994,862254,1,0,1,2048,10,2181042551
167,862160,1042,863202,3,0,1,1024,17,3493084241
168,863109,446579,1309688,3,0,0,10752,17,7032077348
169,875100,554502,1429602,2,0,0,44032,3,10379157964
170,875970,841455,1717425,5,0,0,3584,10,7241245003
171,886050,2027233,2913283,5,0,0,45568,10,6864181114
172,893370,1849765,2743135,5,0,0,2048,10,10098581705
173,896470,566,897036,1,0,1,512,10,3015339569
174,905530,716357,1621887,5,0,0,1536,10,5790620207
175,910211,3387,913598,5,0,1,9728,10,1757861817
176,919800,1180450,2100250,9,0,0,8704,12,8315043009
177,922210,1073343,1995553,5,0,0,36864,10,9211900093
178,926830,566,927396,1,0,1,512,10,5068312191
179,937970,1518,939488,7,0,1,1536,10,9029377123
180,949939,488212,1438151,3,0,0,4096,17,2770586344
181,963110,1009620,1972730,4,0,0,62464,15,5202591620
182,966890,2286174,3253064,4,0,0,64000,15,1656641288
183,969880,5802,975682,7,0,1,6144,10,4783236466
184,984810,2870,987680,7,0,1,8704,10,2222464431
185,991650,4850,996500,1,0,1,5120,10,4646114401
186,1004380,1440871,2445251,9,0,0,129536,12,9851598317
187,1005230,1119278,2124508,6,0,0,12800,7,1634686476
188,1009730,926070,1935800,5,0,0,62976,10,3477496326
189,1030730,1994,1032724,1,0,1,2048,10,3414553331
190,1038950,721568,1760518,4,0,0,10240,15,8284461454
191,1043500,16350,1059850,7,0,1,5120,10,2184771076
192,1048160,1745493,2793653,9,0,0,2560,12,3507214422
193,1048930,12006,1060936,3,0,1,1024,17,5678683887
194,1053320,1940679,2993999,2,0,0,38912,3,10331185151
195,1054530,17725,1072255,7,0,1,19968,10,9338308810
196,1060009,924289,1984298,3,0,0,14336,17,3606103580
197,1063160,2031116,3094276,4,0,0,158720,15,431973514
198,1063349,537018,1600367,3,0,0,9216,17,3057569294
199,1069159,2872166,3941325,3,0,0,56320,17,2108153941
200,1082099,381276,1463375,3,0,0,37888,17,2717318009
201,1085240,2470,1087710,3,0,1,2560,17,1731792212
202,1085659,1068835,2154494,3,0,0,26624,17,5624718263
203,1087080,1296,1088376,7,0,1,1024,10,4117567093
204,1090980,1517096,2608076,6,0,0,44544,7,8707580134
205,1097490,2237891,3335381,5,0,0,1536,10,3594374488
206,1111920,1822,1113742,2,0,1,1024,3,3196946667
207,1119270,2946,1122216,3,0,1,3072,17,4159929902
208,1124760,899668,2024428,9,0,0,94720,12,204278274
209,1132110,10706,1142816,3,0,1,6656,17,3409766663
210,1134270,487070,1621340,2,0,0,36864,3,6903642516
211,1142410,1777596,2920006,2,0,0,22016,3,6104190873
212,1163869,1321553,2485422,3,0,0,41984,17,6995697656
213,1164890,2905161,4070051,6,0,0,19456,7,8319297488
214,1167420,2350639,3518059,5,0,0,22016,10,4829905491
215,1188230,3422,1191652,2,0,1,3584,3,5622586492
216,1193950,1540982,2734932,4,0,0,76800,15,6457250963
217,1200550,3140519,4341069,5,0,0,55296,10,9073570697
218,1201720,2247520,3449240,5,0,0,13312,10,4789457489
219,1201960,3324111,4526071,9,0,0,26624,12,3397970049
220,1203770,1029231,2233001,4,0,0,8704,15,343331334
221,1215970,2287429,3503399,9,0,0,15360,12,4946689670
222,1217160,2812995,4030155,4,0,0,4096,15,9119751066
223,1226860,2477091,3703951,6,0,0,14848,7,10448712994
224,1228510,1119982,2348492,2,0,0,26624,3,9542768186
225,1235880,2503691,3739571,2,0,0,27136,3,1908672357
226,1245900,2199269,3445169,9,0,0,296448,12,1388575862
227,1280770,3181839,4462609,5,0,0,15872,10,5245010356
228,1281770,914691,2196461,6,0,0,5632,7,8267155338
229,1330640,48203,1378843,8,0,1,2560,8,4354862992
230,1346300,254566,1600866,2,0,0,1536,3,8349774188
231,1347420,34009,1381429,1,0,1,4096,10,131256349
232,1349410,2126722,3476132,6,0,0,11264,7,975454382
233,1350140,34195,1384335,1,0,1,4608,10,5816929060
234,1357200,2639315,3996515,6,0,0,114688,7,3344552214
235,1363510,1378145,2741655,2,0,0,22016,3,6773416967
236,1371650,1318988,2690638,4,0,0,14336,15,2911912520
237,1373520,11161,1384681,8,0,1,512,8,5727458932
238,1407490,4374,1411864,1,0,1,4608,10,1771714912
239,1410490,2457966,3868456,9,0,0,7680,12,7204711440
240,1413979,1631515,3045494,3,0,0,168960,17,9866080582
241,1425390,2104144,3529534,6,0,0,12800,7,8923440398
242,1434630,17186,1451816,1,0,1,7680,10,6429835895
243,1435890,644012,2079902,6,0,0,6656,7,3337116293
244,1445340,2300642,3745982,9,0,0,20992,12,417053801
245,1450550,645302,2095852,2,0,0,11264,3,5895688354
246,1456630,2491606,3948236,2,0,0,22528,3,6782375973
247,1465430,3169109,4634539,5,0,0,40960,10,3928941732
248,1466950,2127861,3594811,4,0,0,60928,15,7765825285
249,1472360,3422,1475782,8,0,1,3584,8,8187028158
250,1472730,14687,1487417,8,0,1,2048,8,734804239
251,1480440,39386,1519826,2,0,1,26624,3,8090900098
252,1505950,2633543,4139493,2,0,0,11776,3,7923242596
253,1506880,12961,1519841,8,0,1,2048,8,5007564263
254,1517910,2489,1520399,2,0,1,512,3,8369830109
255,1522840,1518,1524358,8,0,1,1536,8,9509677537
256,1522930,1600884,3123814,6,0,0,20480,7,8464872884
257,1531470,349512,1880982,5,0,0,3584,10,5624180927
258,1538721,1518,1540239,5,0,1,1536,10,6294212743
259,1549160,1379597,2928757,2,0,0,28672,3,1111280642
260,1549829,2899318,4449147,3,0,0,54784,17,8634877602
261,1553510,1716753,3270263,3,0,0,56320,17,7742131693
262,1564040,533543,2097583,9,0,0,5632,12,9005623558
263,1573200,1389885,2963085,9,0,0,44032,12,9040123282
264,1583600,1158858,2742458,2,0,0,2560,3,6249844804
265,1585010,1991207,3576217,5,0,0,65536,10,6880828885
266,1593870,47734,1641604,2,0,1,2560,3,4014920880
267,1594480,1677046,3271526,5,0,0,4096,10,9660443745
268,1595680,634654,2230334,4,0,0,18432,15,10039981992
269,1596890,44729,1641619,2,0,1,4608,3,6493128292
270,1600050,41584,1641634,3,0,1,1024,17,9000843059
271,1600920,40729,1641649,8,0,1,512,8,241230554
272,1605250,2750081,4355331,9,0,0,27648,12,8417611790
273,1606120,2201101,3807221,4,0,0,1024,15,2295816289
274,1614969,1502521,3117490,3,0,0,8704,17,6524182368
275,1619629,3275154,4894783,3,0,0,34816,17,4011374044
276,1621390,1069419,2690809,4,0,0,512,15,7226790973
277,1628540,2010444,3638984,5,0,0,4096,10,3398241739
278,1630560,831689,2462249,2,0,0,46592,3,9510125170
279,1635060,42424,1677484,2,0,1,512,3,8766476504
280,1668830,1090746,2759576,9,0,0,512,12,7830590368
281,1669270,2572131,4241401,5,0,0,8704,10,4780292630
282,1691719,1802977,3494696,3,0,0,6656,17,5475861191
283,1707779,2320902,4028681,3,0,0,105472,17,7127943250
284,1713460,3980,1717440,1,0,1,3584,10,2714268368
285,1714280,3588,1717868,2,0,1,1536,3,6104337045
286,1744080,19493,1763573,2,0,1,3072,3,1869885282
287,1744240,2319852,4064092,9,0,0,96256,12,6856206705
288,1746370,21164,1767534,1,0,1,14848,10,7794939622
289,1753170,1564883,3318053,2,0,0,37888,3,1512586935
290,1756280,16561,1772841,2,0,1,7168,3,3203982282
291,1758259,1356416,3114675,3,0,0,66560,17,9792702942
292,1780510,2438363,4218873,9,0,0,54784,12,1476102124
293,1782090,2609338,4391428,2,0,0,64000,3,1889720681
294,1792020,2378881,4170901,2,0,0,11264,3,7755124960
295,1793100,2130863,3923963,5,0,0,37888,10,1959713408
296,1797330,1994,1799324,2,0,1,2048,3,7290785695
297,1803289,3427377,5230666,3,0,0,6656,17,3288553639
298,1812599,2344637,4157236,3,0,0,57856,17,10067162594
299,1815350,13036,1828386,2,0,1,5120,3,8113924088
300,1834550,348786,2183336,4,0,0,1024,15,4559312416
301,1851300,5214,1856514,9,0,1,8704,12,3572823055
302,1851340,851691,2703031,6,0,0,5632,7,9449183609
303,1860520,3898,1864418,9,0,1,4096,12,9062660357
304,1862570,2750556,4613126,9,0,0,9728,12,7363996713
305,1872910,1056058,2928968,4,0,0,512,15,10000044522
306,1879400,2354081,4233481,9,0,0,23040,12,10470288361
307,1880690,971898,2852588,6,0,0,18432,7,3275410324
308,1887470,2456618,4344088,6,0,0,9728,7,1746097169
309,1890300,2433555,4323855,5,0,0,78336,10,2369057644
310,1895400,5802,1901202,2,0,1,6144,3,2571651741
311,1905440,2227993,4133433,2,0,0,70144,3,656903166
312,1911520,24295,1935815,2,0,1,6656,3,8720037698
313,1924320,2256820,4181140,4,0,0,1024,15,4768804192
314,1932339,2665850,4598189,3,0,0,16384,17,2169737455
315,1932799,1016824,2949623,3,0,0,39424,17,1797917894
316,1936440,13341,1949781,2,0,1,22528,3,4166141555
317,1941579,2576342,4517921,3,0,0,48640,17,5685338763
318,1943710,7249,1950959,2,0,1,13824,3,3129765313
319,1945100,758882,2703982,2,0,0,3072,3,9872228338
320,1948130,1764905,3713035,9,0,0,1024,12,8041621487
321,1965479,1382760,3348239,3,0,0,32768,17,1658568253
322,1966310,7496,1973806,2,0,1,1024,3,7414530127
323,1972670,6684,1979354,2,0,1,6656,3,4612189625
324,1979910,2155980,4135890,6,0,0,7680,7,6801970038
325,1983310,2409575,4392885,9,0,0,4096,12,1687109499
326,1990030,130533,2120563,2,0,1,3584,3,1507366108
327,2000060,2391562,4391622,9,0,0,512,12,7233502701
328,2005080,115498,2120578,2,0,1,1536,3,3167772984
329,2017049,2673044,4690093,3,0,0,161792,17,4006937144
330,2019940,100653,2120593,2,0,1,5120,3,3683826598
331,2021410,2089965,4111375,6,0,0,99328,7,179788340
332,2027950,2429792,4457742,2,0,0,28160,3,3109283577
333,2041540,1230469,3272009,4,0,0,1536,15,9381651211
334,2057380,2936054,4993434,2,0,0,79360,3,3278075255
335,2057539,2374878,4432417,3,0,0,48128,17,8697537253
336,2059020,65503,2124523,2,0,1,3072,3,1141641333
337,2062090,2696337,4758427,2,0,0,40960,3,7366079639
338,2067790,1658709,3726499,5,0,0,8192,10,8544096325
339,2070350,54440,2124790,2,0,1,9728,3,1057281222
340,2076600,50237,2126837,2,0,1,2560,3,243079958
341,2081830,46313,2128143,2,0,1,2048,3,1195016374
342,2083760,3314213,5397973,5,0,0,260096,10,5694226862
343,2085040,2504611,4589651,5,0,0,63488,10,1722063638
344,2101960,1685910,3787870,6,0,0,26624,7,6944979223
345,2124030,7019,2131049,9,0,1,4608,12,9374440988
346,2124239,2050265,4174504,3,0,0,11776,17,5404842105
347,2124780,1108739,3233519,2,0,0,36352,3,7147257934
348,2146219,3346513,5492732,3,0,0,40448,17,1002685329
349,2157920,2393282,4551202,5,0,0,82432,10,10312430156
350,2179010,1770809,3949819,6,0,0,5120,7,9875345597
351,2182250,1846602,4028852,4,0,0,512,15,5262032370
352,2185370,2295792,4481162,9,0,0,512,12,3993819603
353,2189060,2695092,4884152,6,0,0,50176,7,5149676304
354,2199570,1251784,3451354,9,0,0,512,12,3264305858
355,2200910,2170972,4371882,6,0,0,54272,7,8221039146
356,2209389,2010496,4219885,3,0,0,2560,17,7209282418
357,2215400,1251649,3467049,9,0,0,1024,12,2525463509
358,2231130,1235538,3466668,5,0,0,21504,10,7327237261
359,2243710,1998559,4242269,9,0,0,512,12,3572368737
360,2258920,3904,2262824,3,0,1,10752,17,7215871670
361,2266720,2471511,4738231,2,0,0,25088,3,9207966174
362,2271650,774187,3045837,4,0,0,1024,15,2445805704
363,2273990,2507365,4781355,6,0,0,32768,7,4566502660
364,2302870,1880739,4183609,9,0,0,512,12,9031332363
365,2310950,1977801,4288751,2,0,0,5632,3,3610930060
366,2328190,2264938,4593128,4,0,0,2560,15,6886378991
367,2350560,3264781,5615341,9,0,0,512,12,3173142714
368,2354120,2888441,5242561,5,0,0,14848,10,3859571602
369,2355100,1042,2356142,3,0,1,1024,17,9097076411
370,2378251,2054,2380305,6,0,1,1536,7,4316154750
371,2381520,1730526,4112046,9,0,0,2048,12,4965967335
372,2389360,1900031,4289391,9,0,0,512,12,9352667650
373,2404510,1814534,4219044,9,0,0,512,12,5581449794
374,2412730,3087558,5500288,9,0,0,512,12,2302967002
375,2414489,1665889,4080378,3,0,0,33792,17,10644011072
376,2417119,3050615,5467734,3,0,0,51200,17,5563443143
377,2445019,1233828,3678847,3,0,0,14848,17,4895961824
378,2448960,2102469,4551429,9,0,0,512,12,8828811087
379,2467420,2644752,5112172,2,0,0,103424,3,4015119124
380,2467970,3550821,6018791,6,0,0,23552,7,10243598354
381,2468560,3329530,5798090,5,0,0,173568,10,993104629
382,2468629,3069045,5537674,3,0,0,26112,17,8447318520
383,2473910,2382085,4855995,5,0,0,29184,10,10674928196
384,2476550,1604155,4080705,9,0,0,1024,12,8721844694
385,2524920,11533,2536453,7,0,1,18944,10,6301315489
386,2531580,1635655,4167235,5,0,0,32768,10,9277482388
387,2534660,1155483,3690143,9,0,0,1024,12,4432773214
388,2540120,3034351,5574471,2,0,0,30208,3,3360487185
389,2542860,3187147,5730007,6,0,0,176640,7,6728598010
390,2545030,6278,2551308,3,0,1,6656,17,84094340
391,2546970,9484,2556454,3,0,1,8192,17,5074352393
392,2583620,2349065,4932685,6,0,0,34816,7,10198409902
393,2589200,1445549,4034749,2,0,0,14336,3,8864508507
394,2601800,2267041,4868841,2,0,0,28672,3,5486150190
395,2618370,124103,2742473,3,0,1,5120,17,10722299345
396,2630960,111528,2742488,3,0,1,19456,17,10650747689
397,2657439,2934683,5592122,3,0,0,57856,17,6459749689
398,2679430,2260230,4939660,9,0,0,512,12,4073996775
399,2695040,2609258,5304298,6,0,0,57344,7,5917001466
400,2706650,3187916,5894566,2,0,0,52736,3,10347505761
401,2724840,2775106,5499946,6,0,0,22528,7,4792050806
402,2743770,2276308,5020078,6,0,0,50688,7,8879991190
403,2744970,1206930,3951900,2,0,0,6656,3,1481040546
404,2768450,3309222,6077672,2,0,0,33280,3,10644416700
405,2778030,3189289,5967319,2,0,0,18944,3,3128541266
406,2788709,2776364,5565073,3,0,0,33280,17,10146796622
407,2805310,4850,2810160,9,0,1,5120,12,2433261272
408,2813249,1367509,4180758,3,0,0,19968,17,6146347003
409,2814380,30883,2845263,9,0,1,512,12,1583497707
410,2831800,3020320,5852120,9,0,0,1024,12,7120112324
411,2835170,17433,2852603,9,0,1,6144,12,1720680504
412,2839530,611629,3451159,5,0,0,6144,10,6681850122
413,2845480,2458989,5304469,2,0,0,512,3,3075457412
414,2850770,4295,2855065,9,0,1,2560,12,9137271024
415,2857670,1518,2859188,9,0,1,1536,12,312896157
416,2861109,3645,2864754,4,0,1,10240,15,2878169078
417,2869439,2685479,5554918,3,0,0,30720,17,9170690315
418,2869629,566,2870195,4,0,1,512,15,6007965998
419,2875550,2946,2878496,1,0,1,3072,10,3706727556
420,2880279,2470,2882749,4,0,1,2560,15,624109907
421,2885279,2747861,5633140,3,0,0,58368,17,4272478089
422,2887990,4850,2892840,1,0,1,5120,10,6407746202
423,2910020,1924869,4834889,5,0,0,28160,10,6373032747
424,2916190,2228543,5144733,6,0,0,2048,7,9598338061
425,2916461,16136,2932597,5,0,1,10240,10,6130942440
426,2917840,3840713,6758553,5,0,0,120832,10,9280852837
427,2920289,2755400,5675689,3,0,0,45568,17,5626481722
428,2920870,1671448,4592318,2,0,0,8704,3,7384268082
429,2931180,18474,2949654,1,0,1,17920,10,1595960812
430,2931399,2353708,5285107,3,0,0,27136,17,10218718300
431,2936730,1754657,4691387,2,0,0,3072,3,9811402048
432,2940170,27749,2967919,1,0,1,5120,10,6219036446
433,2948639,2854349,5802988,3,0,0,15360,17,5221633338
434,2955450,14415,2969865,1,0,1,3072,10,3972526355
435,2975580,5454,2981034,9,0,1,13824,12,10489925285
436,2987319,127395,3114714,4,0,1,1024,15,7787588678
437,2988470,126259,3114729,1,0,1,3584,10,9045630146
438,2992690,2459421,5452111,5,0,0,157184,10,5958116963
439,2998740,116004,3114744,1,0,1,3072,10,8488316836
440,3006150,108673,3114823,1,0,1,6144,10,6967837339
441,3013690,103823,3117513,3,0,1,6656,17,5908935709
442,3015380,102148,3117528,1,0,1,512,10,105923427
443,3015823,3305992,6321815,2,0,0,84480,3,566310857
444,3017010,1774203,4791213,5,0,0,32256,10,4340849282
445,3020460,97083,3117543,9,0,1,2048,12,739476303
446,3045380,2833079,5878459,2,0,0,60928,3,1459589485
447,3047550,76279,3123829,1,0,1,15360,10,655891724
448,3069890,1899349,4969239,6,0,0,9216,7,7270023988
449,3070430,53414,3123844,1,0,1,3584,10,1380549753
450,3072060,52090,3124150,1,0,1,10240,10,6645220014
451,3077340,47476,3124816,9,0,1,1024,12,4474474336
452,3081470,1774696,4856166,9,0,0,512,12,559689084
453,3088620,40340,3128960,1,0,1,5120,10,974065539
454,3089790,40796,3130586,2,0,1,2560,3,6547468193
455,3096840,2931389,6028229,2,0,0,30208,3,3057386495
456,3097299,1842190,4939489,3,0,0,11776,17,9462260430
457,3098439,34733,3133172,4,0,1,4096,15,1280102333
458,3099390,34448,3133838,9,0,1,1024,12,2818186770
459,3107820,3307136,6414956,2,0,0,96256,3,10021703788
460,3116750,19994,3136744,1,0,1,4608,10,9053861599
461,3120260,21310,3141570,9,0,1,7680,12,1199458858
462,3126480,954600,4081080,9,0,0,1024,12,2285955388
463,3132369,10277,3142646,4,0,1,13312,15,8827841543
464,3139019,10499,3149518,4,0,1,16896,15,9751457650
465,3145050,5774,3150824,9,0,1,2048,12,1615165562
466,3147500,2591749,5739249,5,0,0,26112,10,6963424523
467,3148609,2466390,5614999,3,0,0,49152,17,9564432414
468,3155499,3354782,6510281,3,0,0,47616,17,4218091953
469,3163219,4420,3167639,4,0,1,11776,15,406083397
470,3166709,4521,3171230,4,0,1,4608,15,7513359129
471,3169289,3567,3172856,4,0,1,2560,15,3543377690
472,3174279,566,3174845,4,0,1,512,15,9969693358
473,3178280,7706,3185986,1,0,1,8192,10,5649479860
474,3179620,7672,3187292,1,0,1,2048,10,1748569112
475,3185060,3538,3188598,1,0,1,2048,10,8625512366
476,3186250,6534,3192784,2,0,1,6656,3,4132469287
477,3192140,2946,3195086,0,0,1,3072,3,4003136958
478,3197840,832486,4030326,9,0,0,512,12,10649692073
479,3202639,1518,3204157,4,0,1,1536,15,2305167834
480,3207720,2470,3210190,0,0,1,2560,3,7143103310
481,3217560,15974,3233534,2,0,1,5632,3,301846735
482,3218200,15349,3233549,0,0,1,1024,3,763650573
483,3218970,1785649,5004619,5,0,0,6144,10,4758689634
484,3228130,1584719,4812849,5,0,0,11264,10,1396286028
485,3230360,76134,3306494,0,0,1,13312,3,174221485
486,3230560,3360775,6591335,4,0,0,1024,15,10064546973
487,3247250,70890,3318140,2,0,1,2560,3,1947023100
488,3254420,63735,3318155,0,0,1,512,3,7281873635
489,3254540,63630,3318170,3,0,1,512,17,9839963076
490,3256260,61925,3318185,9,0,1,2048,12,683553218
491,3256969,2261827,5518796,3,0,0,49152,17,2094081424
492,3257390,60818,3318208,1,0,1,2560,10,8061433287
493,3264980,1425456,4690436,9,0,0,1024,12,4660241360
494,3268849,49904,3318753,4,0,1,512,15,9485999251
495,3272210,50553,3322763,9,0,1,11776,12,10115006609
496,3283530,43366,3326896,1,0,1,5120,10,9346899705
497,3289199,40283,3329482,4,0,1,4096,15,2412285974
498,3289800,1034390,4324190,4,0,0,1024,15,8878539521
499,3289979,1731550,5021529,3,0,0,4608,17,5516490405
500,3295619,34529,3330148,4,0,1,11264,15,8507993262
501,3305480,26294,3331774,1,0,1,2560,10,2398540032
502,3305900,2164269,5470169,6,0,0,7680,7,1909576772
503,3312460,437304,3749764,2,0,0,12288,3,10539111331
504,3313079,20321,3333400,4,0,1,2560,15,4963026716
505,3313880,34382,3348262,2,0,1,18432,3,6553109269
506,3330720,3549682,6880402,2,0,0,31744,3,879158170
507,3338920,9902,3348822,1,0,1,512,10,3942583230
508,3345451,3717,3349168,5,0,1,512,10,5217496583
509,3349200,2612316,5961516,9,0,0,512,12,5171044137
510,3359760,2848229,6207989,5,0,0,101376,10,5019877089
511,3360520,94515,3455035,9,0,1,3584,12,10216591528
512,3363240,95661,3458901,0,0,1,6144,3,10469514922
513,3365089,2680050,6045139,3,0,0,51200,17,1360129420
514,3380930,1571389,4952319,6,0,0,4096,7,230564418
515,3389980,76703,3466683,1,0,1,2560,10,215829002
516,3392200,858795,4250995,4,0,0,512,15,4138288378
517,3399590,524544,3924134,9,0,0,512,12,5026270403
518,3400390,66308,3466698,1,0,1,512,10,10710917480
519,3404740,62324,3467064,2,0,1,7168,3,7507775158
520,3406860,1994419,5401279,6,0,0,10240,7,410496372
521,3410200,56879,3467079,1,0,1,1536,10,3502869701
522,3422590,47001,3469591,9,0,1,5120,12,8794712686
523,3426320,45217,3471537,1,0,1,3072,10,828692724
524,3426851,45352,3472203,6,0,1,1024,7,15996857
525,3431490,735924,4167414,4,0,0,512,15,9608285867
526,3431641,44506,3476147,5,0,1,2560,10,8912219846
527,3431960,45415,3477375,9,0,1,5632,12,10129742812
528,3448840,2512505,5961345,5,0,0,153088,10,3161472866
529,3453740,24941,3478681,2,0,1,2048,3,554518494
530,3454500,1547757,5002257,9,0,0,512,12,1611821657
531,3463230,16834,3480064,0,0,1,14848,3,7317879945
532,3466630,17940,3484570,2,0,1,7168,3,3831877959
533,3473670,2612523,6086193,9,0,0,1024,12,5869054104
534,3474121,15275,3489396,6,0,1,7680,7,4627180930
535,3478890,3556791,7035681,5,0,0,32768,10,4123325910
536,3480601,9141,3489742,6,0,1,512,7,4088043904
537,3496870,2588828,6085698,4,0,0,2048,15,763619129
538,3502761,1196,3503957,5,0,1,512,10,545132878
539,3507411,1042,3508453,5,0,1,1024,10,3239747588
540,3516870,13255,3530125,0,0,1,19968,3,424703315
541,3517110,13579,3530689,9,0,1,10752,12,963931175
542,3518080,2158092,5676172,4,0,0,1536,15,5869495901
543,3519220,2479697,5998917,5,0,0,102912,10,5230305933
544,3531870,2470,3534340,1,0,1,2560,10,823810586
545,3534881,4850,3539731,6,0,1,5120,7,7513380295
546,3536821,4856,3541677,5,0,1,3072,10,362000767
547,3537940,1690683,5228623,2,0,0,3072,3,6375110762
548,3538090,3933,3542023,1,0,1,512,10,6590965654
549,3540161,2528,3542689,5,0,1,1024,10,1813831078
550,3543100,1593849,5136949,5,0,0,512,10,9075962286
551,3549270,1994,3551264,0,0,1,2048,3,4470413647
552,3555350,20882,3576232,2,0,1,1024,3,4431367899
553,3562400,1050912,4613312,9,0,0,512,12,6956799683
554,3569490,2663435,6232925,9,0,0,512,12,934979209
555,3574631,24596,3599227,6,0,1,4608,7,1678586495
556,3606311,3898,3610209,6,0,1,4096,7,6812674817
557,3608420,2625651,6234071,5,0,0,1536,10,1223666502
558,3609470,1883597,5493067,9,0,0,1024,12,7539451221
559,3610330,2474697,6085027,6,0,0,24064,7,4753559304
560,3622050,2291389,5913439,6,0,0,19456,7,1947070425
561,3622310,1518,3623828,2,0,1,1536,3,3363047200
562,3626460,7230,3633690,2,0,1,7680,3,9850819947
563,3627840,2755786,6383626,6,0,0,131072,7,4851229712
564,3632961,1075,3634036,6,0,1,512,7,1576920164
565,3635380,1172247,4807627,6,0,0,3584,7,1114388712
566,3640320,2644173,6284493,6,0,0,29184,7,6564915990
567,3640540,10499,3651039,1,0,1,16896,10,7626808913
568,3642559,1992655,5635214,3,0,0,5632,17,372726172
569,3644120,2892087,6536207,2,0,0,84480,3,9164560105
570,3646780,5454,3652234,9,0,1,13824,12,3301043779
571,3654090,1339679,4993769,5,0,0,1024,10,10084873800
572,3655180,1824862,5480042,2,0,0,30720,3,3168630212
573,3658410,1531364,5189774,5,0,0,512,10,3805661646
574,3670220,1994,3672214,9,0,1,2048,12,2830700389
575,3672821,1042,3673863,6,0,1,1024,7,4513025951
576,3676310,801780,4478090,4,0,0,512,15,6424442315
577,3681871,7230,3689101,6,0,1,7680,7,6761447952
578,3689870,1780626,5470496,5,0,0,1024,10,7799382863
579,3699720,2120133,5819853,2,0,0,16384,3,5773425524
580,3707570,1518,3709088,9,0,1,1536,12,3166880475
581,3711840,4850,3716690,2,0,1,5120,3,4958163141
582,3722691,3823,3726514,6,0,1,3072,7,6491320812
583,3729920,16085,3746005,0,0,1,7168,3,1457033945
584,3732520,18721,3751241,2,0,1,1536,3,9541383509
585,3757340,3422,3760762,9,0,1,3584,12,4158733705
586,3757800,2048239,5806039,2,0,0,9728,3,1137021046
587,3767460,1963810,5731270,9,0,0,4096,12,7531601056
588,3777230,1042,3778272,3,0,1,1024,17,10074686975
589,3783720,6612,3790332,9,0,1,2560,12,7720955211
590,3788470,6023,3794493,0,0,1,6144,3,4858007893
591,3790020,2270670,6060690,4,0,0,512,15,9506111616
592,3795460,2946,3798406,0,0,1,3072,3,9796814897
593,3799761,1518,3801279,6,0,1,1536,7,3246661307
594,3808951,4850,3813801,6,0,1,5120,7,607219455
595,3812580,1252243,5064823,6,0,0,3584,7,10357783532
596,3813310,1716265,5529575,2,0,0,35328,3,3994563374
597,3814551,4374,3818925,6,0,1,4608,7,8445913540
598,3816500,6611,3823111,0,0,1,6656,3,9791871026
599,3820070,6907,3826977,2,0,1,6144,3,3610222895
600,3824500,2266145,6090645,9,0,0,512,12,7832820630
601,3830810,2470,3833280,0,0,1,2560,3,332859896
602,3831031,4515,3835546,6,0,1,3584,7,5348161811
603,3831380,1063590,4894970,5,0,0,512,10,6549116907
604,3851300,566,3851866,9,0,1,512,12,5812386938
605,3855410,5802,3861212,0,0,1,6144,3,7653524255
606,3856540,11931,3868471,2,0,1,8192,3,7174653890
607,3858250,2635286,6493536,2,0,0,59904,3,9492518420
608,3858780,1883768,5742548,6,0,0,10752,7,7158309334
609,3860750,7744,3868494,3,0,1,512,17,2286268940
610,3866400,5009,3871409,2,0,1,3072,3,3891468398
611,3874080,1518,3875598,2,0,1,1536,3,8477051294
612,3874231,5692,3879923,6,0,1,5632,7,9885583829
613,3887390,566,3887956,2,0,1,512,3,5224036787
614,3914300,35534,3949834,3,0,1,512,17,8889042005
615,3917030,32819,3949849,3,0,1,1024,17,4948677339
616,3926650,2348765,6275415,5,0,0,512,10,4659569454
617,3927470,1470674,5398144,5,0,0,512,10,43442343
618,3928839,2082753,6011592,3,0,0,41472,17,7068328947
619,3947059,1456654,5403713,3,0,0,7168,17,6528908587
620,3960420,36110,3996530,0,0,1,2048,3,9573953477
621,3971689,2302120,6273809,3,0,0,75776,17,5264973772
622,3973040,160448,4133488,0,0,1,512,3,4347298022
623,3976340,1242821,5219161,2,0,0,3584,3,4723580800
624,3976720,156783,4133503,1,0,1,3584,10,8746456804
625,3977249,3194950,7172199,3,0,0,51200,17,799369059
626,3985550,153958,4139508,2,0,1,5120,3,5653004316
627,3987131,152416,4139547,6,0,1,7680,7,6411882622
628,3990540,1489853,5480393,5,0,0,1024,10,5151175955
629,3992550,147020,4139570,0,0,1,4096,3,828160138
630,3992970,146615,4139585,0,0,1,6656,3,244414228
631,4014800,159751,4174551,0,0,1,1024,3,4255567547
632,4015100,1386382,5401482,5,0,0,512,10,6218063207
633,4029850,144716,4174566,2,0,1,3072,3,2207914314
634,4030281,144300,4174581,6,0,1,2048,7,6910668567
635,4033970,140642,4174612,9,0,1,1024,12,2153055597
636,4034050,140585,4174635,1,0,1,1024,10,4881852429
637,4034200,146605,4180805,2,0,1,2048,3,147608264
638,4038009,1125004,5163013,3,0,0,5632,17,2472152930
639,4041720,139435,4181155,9,0,1,3072,12,6162455747
640,4044121,137049,4181170,6,0,1,5120,7,4933430573
641,4049540,131645,4181185,2,0,1,2048,3,942866660
642,4061460,2384726,6446186,2,0,0,101376,3,4177167112
643,4061480,119720,4181200,9,0,1,1536,12,10675746326
644,4068019,1435599,5503618,3,0,0,8192,17,7774899492
645,4075110,106105,4181215,9,0,1,3072,12,5157548614
646,4075470,108425,4183895,2,0,1,7168,3,805040575
647,4088141,96420,4184561,6,0,1,11264,7,6150337076
648,4090990,2376861,6467851,6,0,0,38912,7,6616271440
649,4098300,956827,5055127,5,0,0,512,10,9675210349
650,4103630,83197,4186827,3,0,1,3584,17,1641450580
651,4107590,2814194,6921784,4,0,0,1536,15,10256816310
652,4110011,77802,4187813,6,0,1,1536,7,1962491568
653,4139410,2194842,6334252,9,0,0,1024,12,8690342922
654,4141149,2421530,6562679,3,0,0,74752,17,2508574945
655,4147589,1899616,6047205,3,0,0,5632,17,9514053333
656,4147810,40669,4188479,3,0,1,1024,17,10699402661
657,4148760,2126826,6275586,5,0,0,512,10,3354803774
658,4162491,34603,4197094,6,0,1,24576,7,2158699685
659,4163411,35949,4199360,6,0,1,3584,7,10140346568
660,4169090,2422775,6591865,5,0,0,1024,10,8058896006
661,4177111,23222,4200333,6,0,1,12800,7,7710712336
662,4180310,2153132,6333442,6,0,0,12288,7,2278714127
663,4181310,1786212,5967522,9,0,0,512,12,3587499483
664,4185620,2501882,6687502,5,0,0,512,10,2575468730
665,4187730,31329,4219059,3,0,1,6656,17,108899705
666,4197960,2257663,6455623,2,0,0,28672,3,3364910799
667,4198627,696514,4895141,9,0,0,512,12,4115090624
668,4199630,3181465,7381095,2,0,0,172032,3,6829148814
669,4199690,19392,4219082,2,0,1,12288,3,5770697416
670,4204901,18415,4223316,5,0,1,3584,10,3511595193
671,4210910,1259757,5470667,9,0,0,512,12,10172805715
672,4216251,9331,4225582,6,0,1,3584,7,1980020133
673,4217821,15675,4233496,5,0,1,15360,10,6480070273
674,4232850,1680,4234530,3,0,1,1024,17,3453649801
675,4234660,3898,4238558,3,0,1,4096,17,10397412149
676,4239870,1352439,5592309,5,0,0,512,10,4828861088
677,4262850,2328158,6591008,6,0,0,90624,7,2770948444
678,4263840,1985713,6249553,5,0,0,2560,10,9878951786
679,4279290,3038986,7318276,2,0,0,161280,3,6695470735
680,4302490,43964,4346454,3,0,1,5632,17,4170963297
681,4303280,2479896,6783176,6,0,0,46592,7,166691431
682,4303710,388488,4692198,6,0,0,2560,7,6174910547
683,4308861,63036,4371897,6,0,1,6656,7,8676622236
684,4310660,1190447,5501107,9,0,0,2560,12,9469585728
685,4314269,3254506,7568775,3,0,0,102912,17,1745146631
686,4317790,73653,4391443,3,0,1,19968,17,9054763006
687,4326559,2359757,6686316,3,0,0,93184,17,9989209435
688,4344810,49101,4393911,3,0,1,1024,17,10430566828
689,4347991,46266,4394257,5,0,1,512,10,10036333023
690,4358880,945760,5304640,9,0,0,512,12,2649115026
691,4371020,1958625,6329645,6,0,0,24576,7,3164530136
692,4379310,15613,4394923,6,0,1,1024,7,1763699887
693,4380871,16523,4397394,5,0,1,10240,10,662427278
694,4385231,12509,4397740,5,0,1,512,10,10498566034
695,4390760,1511535,5902295,5,0,0,1536,10,1605164609
696,4399211,566,4399777,5,0,1,512,10,8480753139
697,4399501,6754,4406255,5,0,1,7168,10,2338487590
698,4400320,6921,4407241,9,0,1,1536,12,2977270321
699,4402541,6326,4408867,6,0,1,2560,7,336425184
700,4402890,2490319,6893209,5,0,0,41984,10,3252109693
701,4403281,7212,4410493,5,0,1,2560,10,9433170716
702,4406900,1841850,6248750,6,0,0,48128,7,1243591154
703,4407090,7269,4414359,7,0,1,6144,10,8620265806
704,4409120,6110,4415230,0,0,1,12288,3,3509694151
705,4412760,4416,4417176,0,0,1,3072,3,3134044332
706,4412940,19492,4432432,9,0,1,11264,12,4478885634
707,4421640,414763,4836403,4,0,0,512,15,9324416677
708,4432520,1312071,5744591,5,0,0,6656,10,9246243371
709,4447100,16059,4463159,7,0,1,512,10,6831230672
710,4452380,11125,4463505,3,0,1,512,17,4963936564
711,4457820,1107432,5565252,9,0,0,512,12,1668583890
712,4460350,7029,4467379,9,0,1,4608,12,9734118563
713,4461120,6413,4467533,7,0,1,8704,10,5514034665
714,4461240,10671,4471911,6,0,1,5120,7,6058126150
715,4468020,6797,4474817,6,0,1,4608,7,9958381765
716,4470870,4293,4475163,0,0,1,512,3,6062450237
717,4471569,1703844,6175413,3,0,0,26112,17,6080465046
718,4472680,1546306,6018986,9,0,0,512,12,2397428219
719,4475170,1158297,5633467,9,0,0,1024,12,9168372340
720,4477520,15062,4492582,0,0,1,29184,3,8840283664
721,4489991,3257,4493248,6,0,1,1024,7,7664593569
722,4498770,3422,4502192,3,0,1,3584,17,9753401361
723,4502600,2315877,6818477,5,0,0,4608,10,4291335478
724,4502890,15046,4517936,9,0,1,4096,12,9813414096
725,4507980,44699,4552679,3,0,1,1536,17,2087397285
726,4523270,31937,4555207,0,0,1,9728,3,6442028566
727,4523980,1536531,6060511,6,0,0,42496,7,6648342607
728,4524670,36343,4561013,7,0,1,15360,10,3659295510
729,4529290,34336,4563626,3,0,1,11264,17,7304592078
730,4530629,2233595,6764224,3,0,0,18432,17,6579803665
731,4538320,26292,4564612,9,0,1,1536,12,8814466319
732,4548491,20610,4569101,6,0,1,14336,7,10450546250
733,4551330,41003,4592333,3,0,1,6656,17,3893252806
734,4557021,36122,4593143,6,0,1,13824,7,5704515271
735,4563730,29436,4593166,0,0,1,9728,3,9265214347
736,4575761,25358,4601119,5,0,1,3072,10,7880484550
737,4577719,1636081,6213800,3,0,0,18944,17,8293553203
738,4585760,2266582,6852342,6,0,0,63488,7,840791729
739,4587531,19334,4606865,5,0,1,8192,10,2880437771
740,4595080,18061,4613141,9,0,1,5632,12,7233666904
741,4598181,15146,4613327,6,0,1,3584,7,2018109083
742,4598390,16553,4614943,7,0,1,3584,10,3294142346
743,4599731,16198,4615929,6,0,1,1536,7,9566342556
744,4603880,15595,4619475,9,0,1,5632,12,949235769
745,4605850,1889908,6495758,6,0,0,6656,7,8513995881
746,4607010,2366882,6973892,6,0,0,38912,7,8521128765
747,4609170,11931,4621101,0,0,1,2560,3,8342970774
748,4613360,21194,4634554,0,0,1,8192,3,10620508332
749,4620080,14489,4634569,9,0,1,5120,12,1079010600
750,4620981,13603,4634584,5,0,1,11264,10,6796390863
751,4633991,4747,4638738,6,0,1,11264,7,7216035583
752,4634630,769566,5404196,9,0,0,1536,12,8479478314
753,4661670,33934,4695604,9,0,1,3584,12,1202466523
754,4664060,34450,4698510,9,0,1,4608,12,7298652642
755,4669550,29946,4699496,0,0,1,1536,3,8783433308
756,4670999,1672644,6343643,3,0,0,30720,17,8391114098
757,4680210,823579,5503789,4,0,0,512,15,5881415729
758,4698060,3382,4701442,0,0,1,3072,3,6671458258
759,4700220,1532526,6232746,5,0,0,57856,10,10606247466
760,4712100,411095,5123195,4,0,0,512,15,6774566540
761,4713511,1518,4715029,6,0,1,1536,7,8990639264
762,4714080,2255,4716335,9,0,1,2048,12,8082865444
763,4729440,2357789,7087229,4,0,0,512,15,5652762259
764,4741800,1518,4743318,9,0,1,1536,12,1128154944
765,4743900,1994,4745894,7,0,1,2048,10,10102147011
766,4749230,9772,4759002,9,0,1,512,12,1583620997
767,4757331,7539,4764870,6,0,1,6656,7,2433360898
768,4760500,20870,4781370,9,0,1,17408,12,10230816447
769,4761250,1685263,6446513,9,0,0,1024,12,1800928120
770,4772980,2935890,7708870,6,0,0,75776,7,123339576
771,4773909,2624039,7397948,3,0,0,3072,17,37640119
772,4793530,3387,4796917,3,0,1,9728,17,4075699241
773,4801870,1790705,6592575,4,0,0,512,15,8979837935
774,4834959,1287878,6122837,3,0,0,11776,17,8076649691
775,4842640,1408035,6250675,0,0,1,10752,3,3520355434
776,4852680,1398010,6250690,6,0,1,4096,7,10465948352
777,4860810,1614435,6475245,5,0,0,5120,10,5970903310
778,4862070,1521727,6383797,9,0,0,512,12,4556834406
779,4870130,1459530,6329660,7,0,1,5120,10,10121794999
780,4879299,1744183,6623482,3,0,0,41472,17,6667302117
781,4893360,1436315,6329675,0,0,1,12288,3,3125084502
782,4895609,2128722,7024331,3,0,0,57344,17,7596120868
783,4900400,1555565,6455965,3,0,1,9216,17,7246879862
784,4908091,1547889,6455980,6,0,1,512,7,7209506629
785,4913690,1917388,6831078,3,0,1,25600,17,9549245707
786,4917759,1555903,6473662,3,0,0,18944,17,933429774
787,4921210,1293869,6215079,5,0,0,4096,10,9402334432
788,4923211,1907890,6831101,6,0,1,2560,7,6552400587
789,4929450,1901820,6831270,3,0,1,1024,17,274427956
790,4930540,1902036,6832576,0,0,1,2048,3,7832198787
791,4931620,1901302,6832922,9,0,1,512,12,10291747744
792,4932760,1919605,6852365,3,0,1,6144,17,7151089722
793,4953240,1939984,6893224,3,0,1,10240,17,4417289335
794,4954880,1963326,6918206,7,0,1,4608,10,7755807333
795,4958419,839858,5798277,3,0,0,512,17,8044479546
796,4968460,1353682,6322142,9,0,0,1024,12,9065517263
797,4971220,1147327,6118547,5,0,0,48640,10,4514739248
798,4975100,1944144,6919244,7,0,1,10240,10,6530965585
799,4977660,1318400,6296060,5,0,0,37888,10,3049177001
800,4983250,2017911,7001161,3,0,1,14336,17,6298126384
801,4995210,1388758,6383968,9,0,0,512,12,8298123615
802,4995710,1145441,6141151,6,0,0,59392,7,2883782526
803,4999290,1894105,6893395,9,0,0,512,12,2615386085
804,5005100,2144776,7149876,5,0,0,42496,10,1232082995
805,5008240,2052663,7060903,3,0,1,4096,17,9037323822
806,5012670,2234150,7246820,7,0,1,4096,10,3065662829
807,5014580,2232255,7246835,0,0,1,512,3,8217133511
808,5028991,2217859,7246850,6,0,1,2560,7,30478232
809,5034320,2283979,7318299,3,0,1,3072,17,339247590
810,5042390,618618,5661008,4,0,0,2048,15,5773526711
811,5059690,1480190,6539880,4,0,0,1024,15,4133829369
812,5070990,1864649,6935639,6,0,0,43520,7,762825370
813,5072660,2245654,7318314,7,0,1,8704,10,6372722277
814,5100380,2296617,7396997,0,0,1,12800,3,9100187777
815,5101710,1461647,6563357,4,0,0,1536,15,8276936562
816,5106130,2300871,7407001,8,0,1,5632,8,2869637781
817,5109980,1654766,6764746,4,0,0,512,15,9385894397
818,5121899,1263191,6385090,3,0,0,1536,17,264014054
819,5124970,2346922,7471892,9,0,1,5120,12,4711622850
820,5131120,1685938,6817058,5,0,0,110080,10,4238128748
821,5132460,1554847,6687307,4,0,0,3072,15,6899938565
822,5137250,2334657,7471907,0,0,1,6144,3,9253537622
823,5148390,2063704,7212094,5,0,0,4608,10,6755759686
824,5159360,2327904,7487264,0,0,1,512,3,7840071893
825,5162020,2325259,7487279,6,0,1,6144,7,8159805693
826,5176620,2310674,7487294,6,0,1,5632,7,1717311591
827,5176940,2310377,7487317,0,0,1,3072,3,8535161264
828,5182870,1263978,6446848,9,0,0,1024,12,8056710509
829,5184770,2302562,7487332,7,0,1,4096,10,9179125797
830,5184989,1308726,6493715,3,0,0,512,17,3669174170
831,5185539,314578,5500117,3,0,0,512,17,8013011842
832,5212310,2275045,7487355,7,0,1,12288,10,416593631
833,5213649,1019939,6233588,3,0,0,2048,17,5162496115
834,5214870,2273459,7488329,6,0,1,4608,7,2811610992
835,5223300,2268491,7491791,6,0,1,14848,7,8172189716
836,5226781,2343179,7569960,6,0,1,1024,7,1508237754
837,5231760,1153829,6385589,9,0,0,1536,12,2894514168
838,5241990,2295414,7537404,5,0,0,11776,10,4225066314
839,5242820,1452173,6694993,6,0,0,8704,7,8233614084
840,5243160,2326815,7569975,0,0,1,9728,3,5712686610
841,5254040,2321269,7575309,7,0,1,4096,10,4740656381
842,5255530,2319794,7575324,7,0,1,2048,10,4703801711
843,5255760,1352545,6608305,5,0,0,28672,10,8942089459
844,5257390,2324516,7581906,0,0,1,3072,3,1805709936
845,5257600,1785756,7043356,5,0,0,25088,10,1397349447
846,5266090,2170664,7436754,5,0,0,93696,10,3454048217
847,5270069,345101,5615170,3,0,0,512,17,2511206786
848,5271680,2310249,7581929,7,0,1,2560,10,3488646415
849,5282020,2299924,7581944,0,0,1,1536,3,4152534666
850,5284500,2297459,7581959,7,0,1,1024,10,8833178104
851,5285330,1372571,6657901,5,0,0,25088,10,4450427102
852,5293709,526315,5820024,3,0,0,512,17,6466309321
853,5308730,1634568,6943298,6,0,0,25088,7,9617253438
854,5311350,2273459,7584809,9,0,1,5120,12,2518494498
855,5312510,1517743,6830253,6,0,0,35328,7,1261179609
856,5318199,729341,6047540,3,0,0,1024,17,10102679968
857,5326911,2307610,7634521,5,0,1,7680,10,9954148069
858,5327490,2320103,7647593,6,0,0,39936,7,5803792735
859,5334300,2300966,7635266,0,0,1,3072,3,10227944745
860,5335749,1707810,7043559,3,0,0,512,17,4945936677
861,5343640,931596,6275236,5,0,0,4608,10,10671706403
862,5349310,1261521,6610831,4,0,0,2048,15,7267420991
863,5350060,769174,6119234,5,0,0,2048,10,3970814540
864,5352600,2295008,7647608,6,0,1,6656,7,9354232776
865,5366380,2319371,7685751,3,0,1,8192,17,9672141201
866,5380360,2328541,7708901,3,0,1,7680,17,787773210
867,5384800,1770395,7155195,6,0,0,17408,7,4419854600
868,5396510,1474205,6870715,6,0,0,34816,7,2943105277
869,5397300,2311616,7708916,9,0,1,5120,12,5393087813
870,5398140,2346014,7744154,0,0,1,11776,3,7240020397
871,5408610,2350737,7759347,3,0,1,4096,17,7542611435
872,5413790,1823944,7237734,6,0,0,67584,7,8226282539
873,5427090,2332272,7759362,3,0,1,3072,17,1308650116
874,5427320,2359582,7786902,3,0,1,5632,17,2018537529
875,5437110,2349807,7786917,0,0,1,5632,3,8523887065
876,5444230,2342702,7786932,0,0,1,2048,3,6989622877
877,5451711,2403707,7855418,6,0,1,1024,7,7974671657
878,5454510,2401168,7855678,3,0,1,512,17,3342803705
879,5469731,2389813,7859544,6,0,1,6144,7,7587068284
880,5471150,2389060,7860210,9,0,1,1024,12,8712136533
881,5473620,1136572,6610192,6,0,0,6144,7,2279733694
882,5475530,1643807,7119337,6,0,0,66048,7,6761724063
883,5478600,610665,6089265,4,0,0,1024,15,10445030531
884,5486460,1332843,6819303,4,0,0,1024,15,8224013542
885,5491770,1994200,7485970,6,0,0,46080,7,6856105155
886,5492960,2368876,7861836,3,0,1,2560,17,8714185271
887,5508860,2353847,7862707,7,0,1,12288,10,10369603361
888,5523900,599140,6123040,9,0,0,512,12,10067055310
889,5524970,2413563,7938533,7,0,1,9728,10,8917136873
890,5546720,1217831,6764551,4,0,0,1024,15,7631719476
891,5565760,973777,6539537,6,0,0,10240,7,1547036026
892,5572920,2369799,7942719,7,0,1,6656,10,3377279944
893,5575050,1496083,7071133,5,0,0,23552,10,7340654004
894,5613941,2377196,7991137,6,0,1,5120,7,7688030154
895,5620960,915418,6536378,9,0,0,512,12,8186789073
896,5629420,1952471,7581891,5,0,0,21504,10,1569422174
897,5631150,2366721,7997871,3,0,1,512,17,4855643079
898,5636241,2378465,8014706,6,0,1,26112,7,6415341981
899,5636720,2545366,8182086,3,0,1,6656,17,10150319466
900,5642660,2550251,8192911,7,0,1,5120,10,9031549869
901,5649351,2546866,8196217,6,0,1,1024,7,10664003054
902,5652380,376076,6028456,9,0,0,512,12,55416539
903,5659999,1333356,6993355,3,0,0,1536,17,10306459656
904,5661740,2534492,8196232,3,0,1,9728,17,5290545656
905,5680760,2063379,7744139,4,0,0,1536,15,3235784777
906,5706180,1827394,7533574,4,0,0,1024,15,4680129542
907,5709070,2487177,8196247,9,0,1,9216,12,6696481893
908,5711080,1687523,7398603,4,0,0,2048,15,8978497389
909,5718870,2519331,8238201,9,0,1,1024,12,9948310746
910,5724300,2035016,7759316,6,0,0,11264,7,9660239804
911,5739340,2506670,8246010,3,0,1,6144,17,8913292806
912,5745440,2531276,8276716,9,0,1,1536,12,2113949274
913,5750180,2526551,8276731,7,0,1,2048,10,7793480085
914,5757491,2519255,8276746,6,0,1,3072,7,3316388474
915,5767540,277926,6045466,4,0,0,1024,15,8949389650
916,5772960,2503801,8276761,7,0,1,1536,10,5785244027
917,5774401,2502375,8276776,6,0,1,3072,7,6417235062
918,5774861,2501930,8276791,6,0,1,512,7,3100103719
919,5776620,2502073,8278693,3,0,1,6144,17,7107969963
920,5776840,1140597,6917437,4,0,0,512,15,7808193277
921,5795470,2581312,8376782,9,0,1,16896,12,2030324168
922,5808040,2638460,8446500,9,0,1,13312,12,4437786192
923,5810750,604533,6415283,9,0,0,1024,12,3288253882
924,5816439,694013,6510452,3,0,0,512,17,213899153
925,5846160,745370,6591530,4,0,0,512,15,6091485316
926,5847640,608310,6455950,9,0,0,1024,12,2024515992
927,5853119,480806,6333925,3,0,0,1536,17,9105473225
928,5854600,1530667,7385267,5,0,0,4096,10,2157573507
929,5859570,1201318,7060888,9,0,0,1536,12,5150587893
930,5861120,1465329,7326449,6,0,0,26624,7,7291664820
931,5862379,957095,6819474,3,0,0,512,17,2457819366
932,5864280,386380,6250660,9,0,0,3584,12,1908292497
933,5871540,2587368,8458908,3,0,1,4608,17,6886961767
934,5872680,2586243,8458923,3,0,1,1536,17,4391782362
935,5881160,2577778,8458938,9,0,1,5632,12,5630481232
936,5902651,2556350,8459001,6,0,1,9728,7,7237781680
937,5905189,479418,6384607,3,0,0,2048,17,4287370648
938,5920250,2572883,8493133,9,0,1,8704,12,478096979
939,5921719,2026712,7948431,3,0,0,512,17,7524360796
940,5932620,1600260,7532880,5,0,0,49152,10,1596461769
941,5937990,1317740,7255730,4,0,0,512,15,261134115
942,5948481,2544667,8493148,6,0,1,1024,7,9277056488
943,5953670,2541224,8494894,3,0,1,5120,17,6556925476
944,5958840,2536069,8494909,3,0,1,6144,17,5405707331
945,5959850,859110,6818960,4,0,0,1536,15,5621709596
946,5969220,2536513,8505733,3,0,1,4096,17,4469451621
947,5977340,1017239,6994579,9,0,0,512,12,8862042127
948,5988430,2565730,8554160,7,0,1,1024,10,1236636960
949,5999780,595401,6595181,9,0,0,512,12,3206202
950,6005580,2548611,8554191,3,0,1,7168,17,7849202684
951,6008850,2545372,8554222,3,0,1,10752,17,2245429365
952,6009079,1560023,7569102,3,0,0,1024,17,4617743658
953,6014620,2539788,8554408,9,0,1,3584,12,6455892943
954,6015049,816014,6831063,3,0,0,512,17,2556642255
955,6016730,1482104,7498834,6,0,0,23040,7,5218691428
956,6020940,1450929,7471869,5,0,0,115200,10,9305173091
957,6021210,2568196,8589406,7,0,1,1024,10,2858058035
958,6035990,2553439,8589429,7,0,1,3584,10,10596181397
959,6048240,2541244,8589484,7,0,1,1536,10,7680019286
960,6052051,2545267,8597318,5,0,1,12800,10,9870760260
961,6061211,2566897,8628108,5,0,1,3072,10,3707425601
962,6067450,1988078,8055528,5,0,0,26112,10,5273890084
963,6068040,2561694,8629734,9,0,1,2560,12,5577721262
964,6070901,2559499,8630400,5,0,1,1024,10,4989930126
965,6072330,1445559,7517889,6,0,0,62464,7,2225343813
966,6075761,2555715,8631476,5,0,1,13312,10,3098043166
967,6083880,1126795,7210675,6,0,0,31744,7,5984519338
968,6089360,2616357,8705717,9,0,1,4608,12,163347144
969,6090771,2614977,8705748,5,0,1,7168,10,9866437385
970,6092550,2613221,8705771,7,0,1,2560,10,9107860304
971,6095669,1767851,7863520,3,0,0,2560,17,605608900
972,6097190,2608612,8705802,9,0,1,2560,12,10194094184
973,6108491,2597326,8705817,5,0,1,512,10,1428078308
974,6109770,2596062,8705832,7,0,1,2560,10,3474598318
975,6113250,670253,6783503,4,0,0,1024,15,3607250801
976,6113271,2593306,8706577,5,0,1,1536,10,3084344683
977,6114250,946155,7060405,5,0,0,28672,10,10388058586
978,6115521,2596905,8712426,5,0,1,17920,10,9192151756
979,6124660,2588432,8713092,7,0,1,1024,10,1148718985
980,6125230,437620,6562850,9,0,0,512,12,7600923948
981,6126280,1585981,7712261,9,0,0,1024,12,4793217335
982,6127290,2586148,8713438,3,0,1,512,17,8243115689
983,6129151,2585273,8714424,5,0,1,1536,10,9753696754
984,6131110,2591268,8722378,7,0,1,5632,10,6914094588
985,6152470,2607343,8759813,7,0,1,512,10,1011546029
986,6156330,1226652,7382982,5,0,0,6144,10,9557455958
987,6162090,461563,6623653,4,0,0,512,15,1550472091
988,6175820,416528,6592348,4,0,0,1536,15,3843647265
989,6181201,2628673,8809874,5,0,1,8192,10,7223435477
990,6187880,2622009,8809889,7,0,1,512,10,10589149912
991,6192950,2637600,8830550,7,0,1,12288,10,6209534284
992,6195670,2634903,8830573,3,0,1,2560,17,2807128638
993,6197210,2633378,8830588,3,0,1,2048,17,3107918973
994,6211060,2619543,8830603,7,0,1,9216,10,9677879397
995,6213680,748325,6962005,5,0,0,43008,10,6164926514
996,6218210,1467526,7685736,6,0,0,40960,7,5332742079
997,6232300,2598669,8830969,7,0,1,15872,10,9808719533
998,6235950,1147391,7383341,9,0,0,1024,12,2846641645
999,6240060,1007521,7247581,9,0,0,512,12,10523622897
1000,6274740,1336425,7611165,5,0,0,84992,10,6411625302
1001,6311410,935387,7246797,6,0,0,29696,7,10524234323
1002,6317000,2514092,8831092,7,0,1,512,10,10008944120
1003,6320850,1500108,7820958,4,0,0,45056,15,1266892278
1004,6329949,1054047,7383996,3,0,0,2048,17,9878805984
1005,6332450,262536,6594986,6,0,0,7680,7,1540460975
1006,6351360,2488230,8839590,3,0,1,9728,17,5753132531
1007,6353770,1501585,7855355,9,0,0,512,12,7115652367
1008,6356460,1257927,7614387,9,0,0,1536,12,6480719746
1009,6360221,2562833,8923054,5,0,1,13824,10,1028394532
1010,6360851,2575702,8936553,5,0,1,6656,10,3384619036
1011,6370430,1373202,7743632,6,0,0,102912,7,7623396232
1012,6409880,1771972,8181852,5,0,0,60416,10,6922666486
1013,6414430,2523711,8938141,7,0,1,15872,10,5650220030
1014,6414641,2525766,8940407,5,0,1,3584,10,7720273043
1015,6421390,2571884,8993274,3,0,1,6656,17,6894083093
1016,6445910,818567,7264477,9,0,0,512,12,4515180517
1017,6455650,2537639,8993289,3,0,1,2560,17,7675676150
1018,6456009,674605,7130614,3,0,0,512,17,970854487
1019,6462900,2530404,8993304,7,0,1,2048,10,317745101
1020,6468990,1064763,7533753,9,0,0,512,12,4119592696
1021,6480590,2512729,8993319,9,0,1,3584,12,3905200617
1022,6491140,2502210,8993350,7,0,1,6144,10,8336411726
1023,6491560,638883,7130443,5,0,0,35328,10,10530304823
1024,6505750,325142,6830892,5,0,0,2048,10,4453588939
1025,6506090,1770611,8276701,6,0,0,62976,7,724299580
1026,6509370,384688,6894058,9,0,0,2048,12,4761172176
1027,6520250,2483164,9003414,3,0,1,1536,17,1242806737
1028,6525850,2481430,9007280,7,0,1,6144,10,5414059675
1029,6534890,793774,7328664,5,0,0,7168,10,7504523416
1030,6535890,1910579,8446469,4,0,0,189952,15,7407842624
1031,6540130,615260,7155390,9,0,0,512,12,8696655562
1032,6543710,2556735,9100445,0,0,1,1536,3,1399204652
1033,6546371,2559220,9105591,5,0,1,8192,10,10115413637
1034,6560870,2545387,9106257,9,0,1,1024,12,2391304452
1035,6563990,1147936,7711926,9,0,0,512,12,5550793147
1036,6567509,376132,6943641,3,0,0,1024,17,611284011
1037,6567870,2538733,9106603,7,0,1,512,10,2896641248
1038,6570600,2538909,9109509,9,0,1,4608,12,2722962590
1039,6573690,2566743,9140433,3,0,1,1024,17,10147589791
1040,6574750,2565698,9140448,3,0,1,2048,17,1843918174
1041,6578530,2615596,9194126,7,0,1,3072,10,3867993468
1042,6581010,1205861,7786871,4,0,0,33792,15,3847767712
1043,6588060,1188492,7776552,6,0,0,54784,7,1426467070
1044,6607380,1383726,7991106,4,0,0,21504,15,2203245301
1045,6609781,2584360,9194141,5,0,1,5632,10,6178931404
1046,6610031,2603752,9213783,5,0,1,10240,10,8608623944
1047,6621401,2661555,9282956,5,0,1,3584,10,6203725657
1048,6622210,2674438,9296648,7,0,1,12800,10,3706242034
1049,6622970,2832945,9455915,3,0,1,2048,17,9118206772
1050,6623420,773562,7396982,6,0,0,38400,7,9871970965
1051,6633869,899378,7533247,3,0,0,1024,17,10255655431
1052,6642559,569862,7212421,3,0,0,1024,17,2340160598
1053,6642670,2923368,9566038,3,0,1,5632,17,9568837664
1054,6650050,997761,7647811,5,0,0,512,10,3285372417
1055,6653540,2965227,9618767,3,0,1,5120,17,9651647258
1056,6657440,2961342,9618782,7,0,1,5120,10,5391009665
1057,6657870,1570900,8228770,4,0,0,8192,15,8799665104
1058,6661610,1276118,7937728,4,0,0,32256,15,9829839028
1059,6664219,455445,7119664,3,0,0,1024,17,9642228113
1060,6665900,968566,7634466,5,0,0,55296,10,7857290237
1061,6669051,2949746,9618797,5,0,1,1024,10,6135756310
1062,6682010,1073859,7755869,4,0,0,38400,15,3250162616
1063,6691880,921992,7613872,4,0,0,8704,15,2537850212
1064,6700089,1421979,8122068,3,0,0,1536,17,8988698109
1065,6709390,1416144,8125534,6,0,0,7168,7,922972097
1066,6725561,2893275,9618836,5,0,1,2560,10,2021353381
1067,6727470,764306,7491776,4,0,0,11264,15,1580706533
1068,6728730,2890121,9618851,3,0,1,7168,17,1585921219
1069,6731620,2952127,9683747,7,0,1,1536,10,4405515562
1070,6736940,664830,7401770,6,0,0,10240,7,1072735648
1071,6768211,2918142,9686353,5,0,1,7680,10,8976100523
1072,6790230,1114027,7904257,4,0,0,71680,15,6435807002
1073,6797999,1155366,7953365,3,0,0,512,17,8895388601
1074,6830380,656869,7487249,6,0,0,4096,7,2590090803
1075,6833000,1518835,8351835,4,0,0,47104,15,10106067891
1076,6852720,1002456,7855176,4,0,0,69120,15,6246186733
1077,6856020,1151878,8007898,6,0,0,19456,7,462729433
1078,6858701,2917100,9775801,5,0,1,5120,10,5174744753
1079,6877860,2897980,9775840,7,0,1,4608,10,2214766099
1080,6881580,1000822,7882402,6,0,0,33280,7,8723989160
1081,6884221,2891642,9775863,5,0,1,3072,10,5032405526
1082,6899060,2890321,9789381,8,0,1,3072,8,9337147845
1083,6902599,1338038,8240637,3,0,0,512,17,8257417961
1084,6913950,1373338,8287288,5,0,0,28160,10,6839845371
1085,6921110,838735,7759845,4,0,0,1536,15,5425588873
1086,6926220,3064558,9990778,7,0,1,16896,10,4923057996
1087,6927910,1308559,8236469,5,0,0,25088,10,4015238128
1088,6932560,901517,7834077,5,0,0,43008,10,10297235380
1089,6956750,3042610,9999360,7,0,1,2560,10,8746721796
1090,6956981,3053061,10010042,5,0,1,2560,10,4522442568
1091,6966780,3043277,10010057,0,0,1,7168,3,5961912989
1092,6976450,1302228,8278678,5,0,0,6144,10,4968272216
1093,7007500,3083021,10090521,0,0,1,17920,3,10272878804
1094,7008470,3122749,10131219,0,0,1,3584,3,9116403968
1095,7027350,3103884,10131234,0,0,1,512,3,3167252040
1096,7030440,3100809,10131249,7,0,1,2048,10,9699654611
1097,7038050,3093214,10131264,0,0,1,1536,3,650183116
1098,7039950,3091329,10131279,0,0,1,3584,3,356611375
1099,7069640,3090529,10160169,0,0,1,1024,3,2799160570
1100,7082041,3078143,10160184,5,0,1,1536,10,4340098053
1101,7085390,3074825,10160215,7,0,1,1024,10,8903396005
1102,7094840,616899,7711739,5,0,0,9216,10,7888383393
1103,7098660,3061578,10160238,1,0,1,7168,10,4330755759
1104,7114891,3047881,10162772,5,0,1,6144,10,2798284434
1105,7124460,3039359,10163819,0,0,1,512,3,6959012389
1106,7131320,3073116,10204436,7,0,1,5120,10,917194360
1107,7138910,3070352,10209262,0,0,1,7680,3,4780260421
1108,7139450,3071438,10210888,7,0,1,2560,10,10089735950
1109,7145110,3069243,10214353,7,0,1,2048,10,4888193699
1110,7154980,1210153,8365133,4,0,0,512,15,2233673922
1111,7157101,3114601,10271702,5,0,1,17408,10,173506468
1112,7158370,1178264,8336634,4,0,0,512,15,8666416641
1113,7158651,3113066,10271717,5,0,1,4096,10,9339702367
1114,7159960,3196491,10356451,0,0,1,5120,3,2462413214
1115,7170969,398928,7569897,3,0,0,2560,17,7470795595
1116,7183531,3172935,10356466,5,0,1,4096,10,6201409810
1117,7184321,3257199,10441520,5,0,1,8704,10,4121512942
1118,7186411,3258937,10445348,5,0,1,8192,10,6364817682
1119,7197039,378255,7575294,3,0,0,17408,17,1837527460
1120,7221620,3241409,10463029,1,0,1,21504,10,620780987
1121,7233400,3230807,10464207,1,0,1,13824,10,9119416190
1122,7236180,679200,7915380,5,0,0,36352,10,2947733770
1123,7239961,3318521,10558482,5,0,1,8192,10,8725820217
1124,7251810,3314756,10566566,7,0,1,3072,10,2559566692
1125,7252590,235724,7488314,4,0,0,3072,15,8429022535
1126,7270610,3298222,10568832,7,0,1,3584,10,6530875697
1127,7280960,3288858,10569818,1,0,1,1536,10,8558761116
1128,7285659,638332,7923991,3,0,0,28160,17,10309773140
1129,7292550,3303936,10596486,1,0,1,7680,10,8923482662
1130,7306360,3290157,10596517,7,0,1,12800,10,7891812051
1131,7307890,1029562,8337452,4,0,0,512,15,4835909938
1132,7310190,3306481,10616671,0,0,1,3072,3,6246005744
1133,7315820,3300866,10616686,1,0,1,512,10,5642450855
1134,7336230,3280471,10616701,1,0,1,2048,10,2784376096
1135,7342780,3273944,10616724,1,0,1,4096,10,7340935719
1136,7353531,3263216,10616747,5,0,1,2560,10,5028684426
1137,7358129,805300,8163429,3,0,0,92160,17,3453357414
1138,7369129,888022,8257151,3,0,0,2560,17,9450695781
1139,7371940,959189,8331129,5,0,0,136192,10,628961441
1140,7380269,845974,8226243,3,0,0,50176,17,7376282617
1141,7392841,3224143,10616984,5,0,1,3072,10,7285932075
1142,7396690,795707,8192397,5,0,0,33792,10,5869227541
1143,7401711,3219256,10620967,5,0,1,4096,10,9374495248
1144,7418391,3210318,10628709,5,0,1,8192,10,7435186893
1145,7427210,3203445,10630655,0,0,1,3072,3,8895922752
1146,7428619,1066260,8494879,3,0,0,5632,17,8730496848
1147,7448090,1010803,8458893,5,0,0,36352,10,8663042884
1148,7451611,3232947,10684558,5,0,1,10752,10,7315867690
1149,7458381,3241550,10699931,5,0,1,18944,10,3575077807
1150,7474301,3239725,10714026,5,0,1,1024,10,6344232431
1151,7489281,3227971,10717252,5,0,1,5120,10,7350881720
1152,7490571,3250943,10741514,5,0,1,9216,10,7756386802
1153,7504170,3237359,10741529,0,0,1,512,3,7290935640
1154,7506519,470617,7977136,3,0,0,10240,17,2935604148
1155,7509570,3231974,10741544,1,0,1,23552,10,9578057381
1156,7513840,553075,8066915,4,0,0,512,15,3952440940
1157,7514850,978220,8493070,5,0,0,97280,10,2495895887
1158,7519470,3277757,10797227,0,0,1,13312,3,5228880013
1159,7551730,3271885,10823615,0,0,1,10240,3,4069251981
1160,7563940,3260341,10824281,8,0,1,11264,8,9535290757
1161,7577710,3259679,10837389,0,0,1,3584,3,4690443510
1162,7590230,774732,8364962,5,0,0,43008,10,7244349506
1163,7596350,3241705,10838055,8,0,1,11264,8,2754699361
1164,7602280,579743,8182023,4,0,0,512,15,6973778763
1165,7603240,3251387,10854627,6,0,1,6144,7,449050662
1166,7607251,3249642,10856893,5,0,1,3584,10,10473371304
1167,7607591,3250608,10858199,5,0,1,2048,10,1204881363
1168,7620280,3247506,10867786,8,0,1,6656,8,7971068378
1169,7629521,3317306,10946827,5,0,1,2560,10,2140624336
1170,7633530,3313312,10946842,0,0,1,6656,3,5317137063
1171,7641371,3315953,10957324,5,0,1,3072,10,3178520539
1172,7652870,3304469,10957339,0,0,1,3584,3,9383104310
1173,7659200,371463,8030663,4,0,0,1024,15,6986506915
1174,7665739,3291615,10957354,4,0,1,512,15,7341667550
1175,7671269,776525,8447794,3,0,0,3584,17,7295153247
1176,7675510,660953,8336463,4,0,0,1024,15,3529816596
1177,7675820,3281549,10957369,8,0,1,3072,8,7300182423
1178,7676510,3280874,10957384,8,0,1,5120,8,6674251205
1179,7677850,3279549,10957399,8,0,1,1024,8,4253630264
1180,7685570,761109,8446679,4,0,0,512,15,1862857679
1181,7687640,327051,8014691,4,0,0,512,15,540220021
1182,7722741,3234673,10957414,5,0,1,1024,10,4374966278
1183,7742670,3228260,10970930,0,0,1,6656,3,3437314422
1184,7757710,942041,8699751,5,0,0,164864,10,2938135299
1185,7762421,3208524,10970945,5,0,1,3072,10,8968049396
1186,7773170,3197790,10970960,6,0,1,2560,7,8014687015
1187,7775679,778458,8554137,3,0,0,109568,17,1291325041
1188,7781130,411758,8192888,5,0,0,1536,10,9760836921
1189,7796869,792522,8589391,3,0,0,114688,17,546960613
1190,7799901,3171074,10970975,5,0,1,8192,10,1373382604
1191,7806280,3164734,10971014,6,0,1,5632,7,4584748150
1192,7810950,3160079,10971029,0,0,1,3584,3,2078807377
1193,7811900,3159144,10971044,6,0,1,6144,7,8707729176
1194,7824510,3146549,10971059,8,0,1,5120,8,5468080955
1195,7832130,960204,8792334,5,0,0,48128,10,3711929238
1196,7839850,3141330,10981180,6,0,1,11264,7,1169403659
1197,7847260,3151632,10998892,0,0,1,7168,3,5330287521
1198,7854790,3144117,10998907,8,0,1,3584,8,3486745796
1199,7857830,3141092,10998922,3,0,1,2560,17,452951493
1200,7864850,655888,8520738,5,0,0,10752,10,6123114684
1201,7865480,773353,8638833,4,0,0,1024,15,1039256341
1202,7870100,3128869,10998969,8,0,1,5120,8,9562678525
1203,7880590,455546,8336136,5,0,0,16384,10,2432141562
1204,7882670,490949,8373619,4,0,0,1024,15,7059081633
1205,7884910,402557,8287467,4,0,0,512,15,10345297209
1206,7886109,451164,8337273,3,0,0,2048,17,5991690904
1207,7892130,3108481,11000611,2,0,1,7168,3,6197904952
1208,7895419,477857,8373276,3,0,0,26624,17,5473824673
1209,7900720,473921,8374641,4,0,0,2048,15,9644842680
1210,7902991,3100526,11003517,5,0,1,4608,10,6141969118
1211,7911860,3103936,11015796,8,0,1,16384,8,1397149912
1212,7914641,3160694,11075335,6,0,1,10752,7,7958601578
1213,7926790,269412,8196202,5,0,0,10752,10,2611700852
1214,7930570,3144967,11075537,6,0,1,7680,7,1509022966
1215,7955550,1119656,9075206,2,0,0,32256,3,3455867847
1216,7959299,955501,8914800,3,0,0,86528,17,8946433401
1217,7966519,3109041,11075560,4,0,1,8704,15,10518505899
1218,7967199,3108376,11075575,4,0,1,1024,15,2675601487
1219,7973740,779041,8752781,2,0,0,27648,3,3377960622
1220,7976410,849414,8825824,2,0,0,52224,3,3679580184
1221,7978710,3096880,11075590,8,0,1,1536,8,3277254883
1222,7985890,844629,8830519,2,0,0,15360,3,5584334023
1223,7986660,3088945,11075605,6,0,1,1024,7,1742906222
1224,7990990,3090688,11081678,2,0,1,5120,3,1375985183
1225,7994190,3087642,11081832,7,0,1,8704,10,7888144924
1226,8005000,3088165,11093165,8,0,1,2560,8,5973651207
1227,8014390,3095975,11110365,2,0,1,13312,3,9751348771
1228,8020990,352996,8373986,4,0,0,1024,15,2640743864
1229,8023000,3103946,11126946,9,0,1,9728,12,2008523890
1230,8039670,3088582,11128252,0,0,1,2048,3,7898604746
1231,8049031,3084803,11133834,6,0,1,20480,7,2007434161
1232,8050449,759231,8809680,3,0,0,7680,17,10422746127
1233,8052939,3089643,11142582,4,0,1,2560,15,7661809043
1234,8056770,3086798,11143568,2,0,1,1536,3,2749701574
1235,8057830,3092598,11150428,7,0,1,2048,10,6318714739
1236,8067879,3083855,11151734,4,0,1,2048,15,4974104388
1237,8070870,3085777,11156647,7,0,1,3584,10,5680952556
1238,8078770,3104175,11182945,7,0,1,7680,10,9890306702
1239,8080970,3107121,11188091,7,0,1,8192,10,7892869031
1240,8086730,3101707,11188437,8,0,1,512,8,9950860674
1241,8099240,1078288,9177528,2,0,0,64000,3,9789589901
1242,8103910,3088713,11192623,2,0,1,6656,3,6507112604
1243,8111449,351311,8462760,3,0,0,12288,17,7873395486
1244,8112779,3084030,11196809,4,0,1,6656,15,875130899
1245,8138910,3064257,11203167,8,0,1,6144,8,7031061742
1246,8139321,3063861,11203182,6,0,1,1024,7,4740265236
1247,8144320,3061847,11206167,7,0,1,7680,10,4411878169
1248,8147570,3062783,11210353,2,0,1,6656,3,3686654889
1249,8148650,3062049,11210699,8,0,1,512,8,1366007590
1250,8157880,3053805,11211685,0,0,1,1536,3,10044472830
1251,8166880,3049951,11216831,8,0,1,8192,8,8198695453
1252,8169039,3048458,11217497,4,0,1,1024,15,7964243654
1253,8185290,3032463,11217753,8,0,1,9216,8,4870535910
1254,8188630,274769,8463399,4,0,0,2048,15,9267544926
1255,8189680,3030659,11220339,7,0,1,4096,10,183298022
1256,8193240,3031285,11224525,8,0,1,6656,8,4235731556
1257,8207730,3021621,11229351,2,0,1,7680,3,8104545484
1258,8209790,3021187,11230977,0,0,1,2560,3,5138970727
1259,8213290,596569,8809859,4,0,0,512,15,5885623289
1260,8217020,3014418,11231438,2,0,1,10240,3,5232397118
1261,8221530,3034394,11255924,8,0,1,8704,8,7257410365
1262,8249760,3014536,11264296,2,0,1,13312,3,7758159537
1263,8256000,298393,8554393,4,0,0,512,15,9771437352
1264,8272180,3022323,11294503,8,0,1,1536,8,8565568403
1265,8288369,304749,8593118,3,0,0,6656,17,733683604
1266,8301630,529316,8830946,4,0,0,1024,15,2507750845
1267,8322370,2972519,11294889,7,0,1,1536,10,128809798
1268,8323980,2972535,11296515,7,0,1,2560,10,870819619
1269,8328800,2978640,11307440,8,0,1,5632,8,10142317666
1270,8339680,307487,8647167,4,0,0,512,15,9699158244
1271,8341740,2969886,11311626,7,0,1,6656,10,1785232852
1272,8343070,2973702,11316772,8,0,1,8192,8,4753717828
1273,8343479,2984567,11328046,4,0,1,7168,15,560540250
1274,8349860,2992486,11342346,7,0,1,4608,10,7998937495
1275,8355589,257815,8613404,3,0,0,4096,17,5284812625
1276,8365279,828808,9194087,3,0,0,54272,17,9218646685
1277,8369550,408105,8777655,2,0,0,25088,3,7984192812
1278,8377819,2965513,11343332,4,0,1,1536,15,8082051991
1279,8386210,204857,8591067,2,0,0,5120,3,3133847474
1280,8394049,2952883,11346932,4,0,1,4608,15,5127823967
1281,8396150,2954914,11351064,2,0,1,19968,3,7677647521
1282,8403120,2955653,11358773,2,0,1,1024,3,2398506441
1283,8410960,664581,9075541,4,0,0,1024,15,1658828321
1284,8424209,281485,8705694,3,0,0,19456,17,4283163185
1285,8440679,552580,8993259,3,0,0,57344,17,8769095523
1286,8442130,2919869,11361999,7,0,1,5120,10,4269480676
1287,8447420,2919725,11367145,2,0,1,8192,3,9172218187
1288,8457020,2911751,11368771,7,0,1,2560,10,9691616192
1289,8457729,349596,8807325,3,0,0,49152,17,5665355593
1290,8464490,2904627,11369117,2,0,1,512,3,3319972681
1291,8466039,2905984,11372023,4,0,1,4608,15,6066374190
1292,8471230,641447,9112677,4,0,0,1024,15,6955132545
1293,8498960,566379,9065339,2,0,0,95232,3,10396025603
1294,8499630,415357,8914987,4,0,0,512,15,3002078876
1295,8512229,2860870,11373099,4,0,1,13312,15,859031163
1296,8522769,2859780,11382549,4,0,1,512,15,9898005177
1297,8528460,611451,9139911,2,0,0,62976,3,640254007
1298,8529119,789889,9319008,3,0,0,52224,17,7502471865
1299,8536829,919039,9455868,3,0,0,183808,17,8370005409
1300,8537029,2848426,11385455,4,0,1,4608,15,10461270560
1301,8545300,2844341,11389641,7,0,1,6656,10,2085080178
1302,8546400,2849537,11395937,2,0,1,1536,3,401074621
1303,8546679,404225,8950904,3,0,0,4096,17,5003042581
1304,8553211,2843085,11396296,6,0,1,9728,7,2168675627
1305,8560960,2855212,11416172,7,0,1,1024,10,204831628
1306,8574820,687809,9262629,2,0,0,27136,3,4222108004
1307,8609249,2806938,11416187,4,0,1,512,15,4539701121
1308,8639000,2777202,11416202,2,0,1,3072,3,7939133861
1309,8643619,2772598,11416217,4,0,1,2048,15,2929452092
1310,8660370,958350,9618720,2,0,0,119296,3,3119050885
1311,8664000,2758881,11422881,2,0,1,1024,3,1772188446
1312,8665470,2758397,11423867,1,0,1,1536,10,4912446016
1313,8690260,2745019,11435279,7,0,1,6144,10,157231965
1314,8702340,2733925,11436265,2,0,1,1536,3,6357192541
1315,8702420,2751506,11453926,2,0,1,9216,3,246721298
1316,8705650,2773626,11479276,2,0,1,13312,3,5463429447
1317,8710359,2771503,11481862,4,0,1,4096,15,5041178401
1318,8713650,2770158,11483808,1,0,1,3072,10,424869658
1319,8716810,2795974,11512784,7,0,1,1024,10,10354500469
1320,8721851,2807773,11529624,6,0,1,12800,7,10015878713
1321,8723331,2823383,11546714,5,0,1,14848,10,3488467998
1322,8736609,602922,9339531,3,0,0,41472,17,4641024333
1323,8739370,2865331,11604701,1,0,1,2048,10,4514855804
1324,8745400,653316,9398716,2,0,0,32768,3,10592077232
1325,8754610,2851503,11606113,1,0,1,512,10,10478750325
1326,8764501,2842483,11606984,6,0,1,12288,7,5406951894
1327,8784211,2834751,11618962,6,0,1,5120,7,744884260
1328,8799601,2831633,11631234,5,0,1,10752,10,9640350979
1329,8812820,262924,9075744,4,0,0,512,15,7008729145
1330,8820610,745389,9565999,2,0,0,252928,3,5180721679
1331,8821059,2864074,11685133,4,0,1,1024,15,5094807507
1332,8824340,964970,9789310,2,0,0,44032,3,3812072129
1333,8827409,2857739,11685148,4,0,1,1536,15,1266526005
1334,8831961,2862173,11694134,5,0,1,1024,10,6653590819
1335,8845350,367851,9213201,4,0,0,1024,15,8852358793
1336,8850370,2843779,11694149,1,0,1,5632,10,3261978911
1337,8855621,2838837,11694458,5,0,1,3072,10,3515243084
1338,8863720,276674,9140394,4,0,0,1536,15,10671883825
1339,8868300,2845854,11714154,1,0,1,7168,10,4143238549
1340,8874450,201465,9075915,4,0,0,512,15,9052830268
1341,8885610,231831,9117441,2,0,0,1536,3,927887504
1342,8885960,2873712,11759672,7,0,1,1024,10,4480443358
1343,8899100,2860587,11759687,2,0,1,6656,3,4509213404
1344,8903179,2889877,11793056,4,0,1,10240,15,2177354194
1345,8927610,369015,9296625,2,0,0,28672,3,10408282494
1346,8927749,904476,9832225,3,0,0,9216,17,5736765381
1347,8930880,2883465,11814345,7,0,1,22528,10,2456888004
1348,8932430,2896690,11829120,2,0,1,1024,3,4363204230
1349,8948889,296651,9245540,3,0,0,7168,17,5366367561
1350,8953940,2877126,11831066,8,0,1,3072,8,6775582514
1351,8958359,623966,9582325,3,0,0,53248,17,69296366
1352,8959419,2873593,11833012,4,0,1,3072,15,5457636659
1353,8959700,707484,9667184,2,0,0,93184,3,9025995813
1354,8968841,2864427,11833268,5,0,1,9216,10,6405437952
1355,8974389,2859865,11834254,4,0,1,1536,15,3311792965
1356,8974690,2862470,11837160,7,0,1,4608,10,597958865
1357,8982091,2856695,11838786,5,0,1,2560,10,4637610950
1358,8983680,700036,9683716,5,0,0,33280,10,8767518453
1359,8995300,403743,9399043,4,0,0,1024,15,7362600160
1360,9015631,2850359,11865990,5,0,1,2560,10,9822934178
1361,9020419,1336017,10356436,3,0,0,51712,17,8811522106
1362,9022910,179724,9202634,2,0,0,3584,3,1776198980
1363,9030209,2835804,11866013,4,0,1,7168,15,4677293756
1364,9036520,2842650,11879170,2,0,1,18944,3,3554568240
1365,9039291,2839894,11879185,5,0,1,2560,10,9315113052
1366,9042300,2836900,11879200,2,0,1,512,3,5467377574
1367,9048800,696317,9745117,2,0,0,1536,3,8052113884
1368,9067190,2819380,11886570,2,0,1,6656,3,4306720045
1369,9075880,697675,9773555,5,0,0,44544,10,4899273134
1370,9090400,816584,9906984,5,0,0,29696,10,2651486064
1371,9092540,2856676,11949216,2,0,1,12288,3,3981955980
1372,9105630,243822,9349452,4,0,0,1024,15,4178103563
1373,9108480,882259,9990739,2,0,0,99840,3,7447822512
1374,9115420,629035,9744455,5,0,0,150016,10,2334907207
1375,9128249,631703,9759952,3,0,0,48640,17,10026821650
1376,9133501,2897204,12030705,5,0,1,19968,10,6186729316
1377,9133869,1026285,10160154,3,0,0,94720,17,9957238867
1378,9165311,2865409,12030720,5,0,1,2560,10,7790666966
1379,9176499,913991,10090490,3,0,0,84480,17,352329104
1380,9176930,2853813,12030743,2,0,1,3072,3,2193133519
1381,9195620,746474,9942094,2,0,0,15872,3,6665994198
1382,9206631,2824626,12031257,5,0,1,14848,10,545276115
1383,9234520,586281,9820801,2,0,0,62464,3,3130681415
1384,9246620,769134,10015754,4,0,0,512,15,5796610768
1385,9272060,922182,10194242,5,0,0,19456,10,3158136538
1386,9273981,2821452,12095433,5,0,1,5120,10,7076104855
1387,9276831,2818948,12095779,5,0,1,512,10,2664700238
1388,9277580,630222,9907802,4,0,0,512,15,2574961047
1389,9285360,1138254,10423614,5,0,0,197632,10,10194752329
1390,9289700,1018947,10308647,2,0,0,37888,3,4979416964
1391,9308051,2788714,12096765,5,0,1,1536,10,3463429172
1392,9349041,2803131,12152172,5,0,1,22528,10,9760374449
1393,9367940,2788418,12156358,2,0,1,6656,3,1865784735
1394,9379200,2801984,12181184,2,0,1,3584,3,5928776715
1395,9381860,2847302,12229162,2,0,1,13312,3,330519431
1396,9400880,2871524,12272404,2,0,1,6144,3,9496274287
1397,9403910,922856,10326766,5,0,0,59392,10,393967424
1398,9415931,2856496,12272427,5,0,1,1024,10,4668760095
1399,9421810,322816,9744626,4,0,0,512,15,4983133022
1400,9448380,459251,9907631,4,0,0,2048,15,8350116752
1401,9456100,319662,9775762,2,0,0,7168,3,2284754521
1402,9466240,2806218,12272458,2,0,1,5632,3,6281184068
1403,9478850,2836200,12315050,2,0,1,1536,3,2507668089
1404,9485070,940439,10425509,5,0,0,6144,10,3147486679
1405,9487859,441131,9928990,3,0,0,8704,17,3454390947
1406,9497839,943658,10441497,3,0,0,33280,17,7296131374
1407,9510200,372789,9882989,2,0,0,5120,3,5196404786
1408,9517581,2798135,12315716,5,0,1,1024,10,9915513202
1409,9520110,751561,10271671,2,0,0,102912,3,2239505134
1410,9523980,901700,10425680,9,0,0,512,12,7528431828
1411,9528280,666609,10194889,4,0,0,2048,15,10170763000
1412,9528360,1052169,10580529,5,0,0,28672,10,3886908236
1413,9536830,2781152,12317982,2,0,1,3584,3,1391700431
1414,9537500,1079156,10616656,5,0,0,66048,10,6022310457
1415,9548451,2770402,12318853,5,0,1,12288,10,3134231398
1416,9552370,2806052,12358422,1,0,1,9216,10,8238019221
1417,9558030,782635,10340665,2,0,0,45568,3,2645643148
1418,9558219,572969,10131188,3,0,0,75776,17,7691781072
1419,9562379,1122156,10684535,3,0,0,48640,17,8352394101
1420,9576500,344928,9921428,4,0,0,1024,15,7934768233
1421,9583131,2780813,12363944,5,0,1,1024,10,184645743
1422,9588611,2775372,12363983,5,0,1,1024,10,8328926475
1423,9601280,418287,10019567,4,0,0,3584,15,1023417388
1424,9607710,689199,10296909,5,0,0,57856,10,1910817010
1425,9612540,684540,10297080,4,0,0,512,15,9632090631
1426,9625610,384417,10010027,5,0,0,32768,10,4084641824
1427,9626960,920540,10547500,5,0,0,37376,10,7456206156
1428,9638691,2725307,12363998,5,0,1,2048,10,9895671749
1429,9640520,2723562,12364082,2,0,1,5120,3,1245038003
1430,9654820,2714088,12368908,8,0,1,7680,8,7449452894
1431,9663230,2709890,12373120,2,0,1,6656,3,8503986583
1432,9670220,2704206,12374426,8,0,1,2048,8,9231018853
1433,9673870,2704422,12378292,2,0,1,6144,3,1868080429
1434,9676960,919511,10596471,4,0,0,512,15,6899672731
1435,9681550,232556,9914106,4,0,0,512,15,5186046482
1436,9689289,358503,10047792,3,0,0,4608,17,5208279552
1437,9691110,2689448,12380558,8,0,1,3584,8,188369422
1438,9695279,735884,10431163,3,0,0,17920,17,10186727173
1439,9700329,661011,10361340,3,0,0,15360,17,5235171080
1440,9713990,2669154,12383144,8,0,1,4096,8,312934719
1441,9721750,837075,10558825,4,0,0,1024,15,8347424998
1442,9742019,917636,10659655,1,0,0,59904,10,4015168522
1443,9749500,2635745,12385245,8,0,1,2560,8,8703830667
1444,9750331,2704489,12454820,5,0,1,14848,10,8574160373
1445,9751480,2738896,12490376,8,0,1,3584,8,6607535074
1446,9755021,2735370,12490391,5,0,1,4096,10,7320860110
1447,9755670,2738803,12494473,2,0,1,7168,3,6425684250
1448,9756040,2777817,12533857,8,0,1,8704,8,2313195641
1449,9758999,777082,10536081,3,0,0,144896,17,6871726996
1450,9759280,2789102,12548382,8,0,1,3584,8,7376188821
1451,9811000,2768234,12579234,8,0,1,5632,8,8790362831
1452,9819000,2790822,12609822,8,0,1,13312,8,6018407762
1453,9827910,272558,10100468,4,0,0,1024,15,4874992159
1454,9856990,2785365,12642355,9,0,1,2560,12,6855179306
1455,9862529,1136348,10998877,3,0,0,512,17,651936641
1456,9865640,497743,10363383,5,0,0,6656,10,8203866400
1457,9869920,871571,10741491,2,0,0,69632,3,7862017409
1458,9896860,853458,10750318,2,0,0,28160,3,436798304
1459,9900579,194571,10095150,3,0,0,7680,17,9768281087
1460,9918030,2731555,12649585,9,0,1,2048,12,173934179
1461,9928550,629893,10558443,5,0,0,35840,10,3215450783
1462,9929080,2720520,12649600,8,0,1,1024,8,580457265
1463,9935680,835442,10771122,5,0,0,27136,10,8553072833
1464,9939980,2710982,12650962,8,0,1,7680,8,2503671521
1465,9959740,2747764,12707504,8,0,1,2048,8,1116901962
1466,9963320,599098,10562418,4,0,0,1536,15,9432021230
1467,9980680,966132,10946812,2,0,0,187904,3,10628055878
1468,9983640,973669,10957309,2,0,0,34304,3,6787516053
1469,9991400,2784300,12775700,9,0,1,2048,12,533867679
1470,9998470,2782056,12780526,8,0,1,7680,8,3964051606
1471,10025590,2776536,12802126,9,0,1,2048,12,2185726002
1472,10040990,236687,10277677,2,0,0,512,3,7693200531
1473,10061050,2741091,12802141,8,0,1,4096,8,764311775
1474,10075360,1201639,11276999,2,0,0,29696,3,5835423087
1475,10076630,280007,10356637,4,0,0,512,15,8270106104
1476,10081780,2720376,12802156,8,0,1,512,8,2874887593
1477,10093390,2727984,12821374,9,0,1,7680,12,4214115871
1478,10094900,2726521,12821421,9,0,1,512,12,5241128040
1479,10096810,2724634,12821444,9,0,1,6144,12,6683389963
1480,10102800,493500,10596300,2,0,0,51712,3,3555276755
1481,10105730,513823,10619553,5,0,0,2048,10,6277265094
1482,10108080,450940,10559020,5,0,0,512,10,9517307640
1483,10113290,318052,10431342,4,0,0,512,15,265421519
1484,10144769,2755588,12900357,4,0,1,6144,15,3210135096
1485,10149490,849216,10998706,5,0,0,44544,10,4209665124
1486,10155660,632424,10788084,4,0,0,1024,15,8145127
1487,10164220,2738403,12902623,9,0,1,3584,12,1227811628
1488,10173220,317979,10491199,4,0,0,1536,15,2666268982
1489,10188780,2714509,12903289,9,0,1,1024,12,2378594256
1490,10202060,574355,10776415,4,0,0,512,15,3316278082
1491,10208420,2696815,12905235,8,0,1,3072,8,10376824629
1492,10211090,488319,10699409,5,0,0,48640,10,6307829976
1493,10223120,2683143,12906263,0,0,1,1024,3,8508671359
1494,10249800,2674536,12924336,8,0,1,5632,8,9758765625
1495,10262800,2664442,12927242,9,0,1,4608,12,3986030971
1496,10283690,2646194,12929884,9,0,1,1024,12,4102875474
1497,10336980,2616305,12953285,9,0,1,8704,12,823468913
1498,10370050,2584541,12954591,1,0,1,2048,10,3606980382
1499,10378860,443758,10822618,5,0,0,512,10,5071484328
1500,10417060,2547634,12964694,1,0,1,6656,10,4103685152
1501,10431120,353175,10784295,2,0,0,3072,3,2047751330
1502,10433660,266256,10699916,4,0,0,1536,15,1234779918
1503,10449880,2543840,12993720,9,0,1,3072,12,5250773086
1504,10452160,2541575,12993735,9,0,1,6656,12,3839271911
1505,10456260,721307,11177567,5,0,0,33280,10,10045339514
1506,10466540,2572061,13038601,9,0,1,1536,12,10667230189
1507,10478880,2560407,13039287,0,0,1,8192,3,730386705
1508,10487040,225150,10712190,4,0,0,1536,15,4491145476
1509,10500880,240835,10741715,4,0,0,512,15,4263354071
1510,10507690,2531612,13039302,9,0,1,11776,12,5200695203
1511,10512000,830177,11342177,4,0,0,512,15,8488207234
1512,10520241,2561257,13081498,5,0,1,9216,10,9585185803
1513,10526700,336376,10863076,2,0,0,6144,3,736887456
1514,10527760,2554404,13082164,2,0,1,1024,3,8760501904
1515,10528090,2554420,13082510,0,0,1,512,3,2333893282
1516,10534880,125400,10660280,4,0,0,512,15,4514927609
1517,10541410,326361,10867771,5,0,0,15360,10,7991573710
1518,10551110,2534664,13085774,2,0,1,4096,3,5100350270
1519,10578540,514610,11093150,2,0,0,18944,3,8054401736
1520,10580130,218131,10798261,4,0,0,512,15,1038708294
1521,10590250,2518018,13108268,0,0,1,4096,3,9007736143
1522,10612590,2507726,13120316,9,0,1,1536,12,9603330315
1523,10676520,143734,10820254,4,0,0,512,15,5286175389
1524,10677310,2508817,13186127,9,0,1,9728,12,4960542289
1525,10678590,2524890,13203480,0,0,1,9216,3,10390822708
1526,10682220,2526432,13208652,2,0,1,8192,3,4244148058
1527,10698510,2513368,13211878,9,0,1,5120,12,2476238284
1528,10700560,2602193,13302753,9,0,1,9216,12,5009828197
1529,10705290,252319,10957609,4,0,0,512,15,419409515
1530,10708100,2607330,13315430,0,0,1,16896,3,1272534742
1531,10717470,2647112,13364582,2,0,1,8192,3,9208780249
1532,10718160,357160,11075320,5,0,0,62976,10,10020015467
1533,10722150,316386,11038536,5,0,0,4096,10,3542359377
1534,10736900,2722772,13459672,2,0,1,10240,3,8333651693
1535,10743890,215154,10959044,5,0,0,4608,10,1592724868
1536,10751820,2711398,13463218,9,0,1,5632,12,1539969333
1537,10755510,2708694,13464204,2,0,1,1536,3,9676096167
1538,10764920,205995,10970915,5,0,0,38912,10,10560892090
1539,10774280,320382,11094662,4,0,0,1024,15,6428992287
1540,10780230,2686240,13466470,9,0,1,3584,12,551198544
1541,10840070,2629652,13469722,9,0,1,5120,12,1326348188
1542,10846990,228516,11075506,4,0,0,512,15,7384927061
1543,10867070,337531,11204601,5,0,0,4608,10,3898108524
1544,10869000,2610148,13479148,2,0,1,4608,3,5097011405
1545,10879630,2599541,13479171,7,0,1,5632,10,3155161682
1546,10918320,259730,11178050,5,0,0,1536,10,789541237
1547,10919580,2598965,13518545,9,0,1,7168,12,6776767267
1548,10920190,330127,11250317,2,0,0,3584,3,4735313481
1549,10925260,2613302,13538562,9,0,1,512,12,7854173031
1550,10932680,2605897,13538577,9,0,1,9216,12,8023123680
1551,10981090,211411,11192501,4,0,0,512,15,2695193499
1552,10992850,2606302,13599152,9,0,1,12800,12,2575303470
1553,10993230,2606588,13599818,9,0,1,1024,12,10402343348
1554,10995200,2687129,13682329,9,0,1,19456,12,4770683114
1555,10995810,110957,11106767,2,0,0,9216,3,8736198209
1556,11011260,205185,11216445,2,0,0,4096,3,3175863311
1557,11014360,166365,11180725,2,0,0,8704,3,8994781115
1558,11034870,2654100,13688970,2,0,1,6656,3,4025061162
1559,11038470,2656848,13695318,2,0,1,1536,3,6441366243
1560,11044680,260250,11304930,4,0,0,1024,15,3848007404
1561,11059460,431555,11491015,5,0,0,13824,10,3942601345
1562,11061030,2649112,13710142,2,0,1,3072,3,1478706313
1563,11065870,228618,11294488,4,0,0,2048,15,7097414122
1564,11094010,109142,11203152,2,0,0,8192,3,7913521061
1565,11122851,2587855,13710706,6,0,1,10752,7,5380499833
1566,11128220,2621169,13749389,2,0,1,1536,3,3870638310
1567,11131720,315828,11447548,5,0,0,14336,10,7519757128
1568,11159460,256697,11416157,5,0,0,46592,10,3737723237
1569,11170340,2583167,13753507,2,0,1,15360,3,2060621729
1570,11186671,2600025,13786696,6,0,1,3072,7,2125611964
1571,11193090,153827,11346917,4,0,0,3584,15,3218637892
1572,11207410,2579301,13786711,2,0,1,1024,3,8914679890
1573,11241340,288269,11529609,2,0,0,39936,3,658443765
1574,11243730,2542996,13786726,2,0,1,1536,3,9614761684
1575,11262370,2524379,13786749,6,0,1,3072,7,1336278767
1576,11282270,402840,11685110,2,0,0,76800,3,5664180640
1577,11283020,431079,11714099,5,0,0,25600,10,7156737317
1578,11284970,376709,11661679,5,0,0,67584,10,9256853810
1579,11290001,2496763,13786764,6,0,1,1536,7,6943536408
1580,11301220,232642,11533862,5,0,0,9216,10,6202030633
1581,11304870,2497111,13801981,2,0,1,6656,3,10571906075
1582,11342950,416667,11759617,2,0,0,145920,3,6982283272
1583,11350780,426530,11777310,2,0,0,24064,3,5214334460
1584,11358470,2465933,13824403,2,0,1,17408,3,10096513316
1585,11364780,2463505,13828285,7,0,1,2560,10,1503118424
1586,11366470,497462,11863932,2,0,0,80384,3,7364570894
1587,11382770,503785,11886555,2,0,0,24064,3,3440985541
1588,11394720,155513,11550233,5,0,0,5120,10,3144709246
1589,11401860,292219,11694079,8,0,0,29184,8,4751043966
1590,11432430,348979,11781409,4,0,0,1536,15,1675524636
1591,11440090,2407741,13847831,7,0,1,6656,10,4152122465
1592,11458950,300916,11759866,4,0,0,512,15,1284885319
1593,11464430,2393623,13858053,6,0,1,2048,7,5186197274
1594,11474820,404335,11879155,2,0,0,42496,3,7656026536
1595,11488660,398425,11887085,2,0,0,1536,3,6122872545
1596,11492060,457133,11949193,5,0,0,49664,10,4131094630
1597,11496790,369394,11866184,4,0,0,512,15,985693205
1598,11499171,2358897,13858068,6,0,1,2560,7,1654093002
1599,11502340,363635,11865975,2,0,0,6656,3,3924769558
1600,11509490,597335,12106825,2,0,0,10240,3,2290371709
1601,11525831,2335699,13861530,6,0,1,10752,7,10695864471
1602,11552780,2319521,13872301,7,0,1,11776,10,3948686176
1603,11561230,2351393,13912623,7,0,1,6656,10,8117298290
1604,11563900,2351629,13915529,7,0,1,4608,10,6094272322
1605,11570590,189915,11760505,2,0,0,2048,3,2062040546
1606,11573120,404246,11977366,2,0,0,2560,3,6680731444
1607,11576841,2381376,13958217,6,0,1,1024,7,5648390993
1608,11577031,2381209,13958240,6,0,1,4096,7,10471767081
1609,11587660,388879,11976539,8,0,0,89600,8,5966031585
1610,11612300,2345955,13958255,8,0,1,6144,8,1107450680
1611,11620211,2338067,13958278,6,0,1,5120,7,371935700
1612,11623000,2337365,13960365,8,0,1,10240,8,3576363104
1613,11628260,417167,12045427,2,0,0,26624,3,1966889823
1614,11631570,386725,12018295,2,0,0,38400,3,10471150418
1615,11633261,2328730,13961991,6,0,1,2560,7,2029581034
1616,11639480,2343596,13983076,8,0,1,3072,8,3715860276
1617,11641610,2341481,13983091,3,0,1,512,17,5576206567
1618,11648860,2334254,13983114,8,0,1,7680,8,9704142035
1619,11651290,651619,12302909,8,0,0,99840,8,6171102632
1620,11655610,394684,12050294,8,0,0,15872,8,10438310129
1621,11659709,2325428,13985137,4,0,1,5120,15,7041716338
1622,11660339,2327704,13988043,4,0,1,4608,15,9684522287
1623,11663090,2357934,14021024,3,0,1,6656,17,1819435164
1624,11664540,540564,12205104,8,0,0,1024,8,5608916223
1625,11668860,2352510,14021370,3,0,1,512,17,1488704448
1626,11687240,585149,12272389,5,0,0,141824,10,4636812580
1627,11688919,2334077,14022996,4,0,1,2560,15,9085925344
1628,11689050,2346599,14035649,8,0,1,10752,8,856400364
1629,11691610,2353589,14045199,1,0,1,7680,10,532343204
1630,11694610,2359497,14054107,7,0,1,10240,10,3466437202
1631,11701940,2352833,14054773,8,0,1,11264,8,7002346518
1632,11702470,2394910,14097380,8,0,1,4608,8,4312664592
1633,11711450,2385945,14097395,3,0,1,1536,17,10238001931
1634,11713111,2384299,14097410,6,0,1,10240,7,3973964193
1635,11716800,349897,12066697,2,0,0,18432,3,356165813
1636,11729070,2371499,14100569,7,0,1,1024,10,1541283348
1637,11740501,2360414,14100915,6,0,1,512,7,3370853607
1638,11767380,2334713,14102093,7,0,1,13824,10,9445459777
1639,11768649,2373864,14142513,4,0,1,1536,15,5138832824
1640,11770220,264146,12034366,5,0,0,2048,10,2817127997
1641,11794890,2413122,14208012,8,0,1,15360,8,4637862311
1642,11795040,2445592,14240632,7,0,1,28160,10,3896938419
1643,11807270,302550,12109820,2,0,0,9728,3,5506091629
1644,11810930,2446705,14257635,3,0,1,6656,17,8584473538
1645,11812060,2445590,14257650,8,0,1,1024,8,3842852800
1646,11813660,675594,12489254,8,0,0,89088,8,6136104428
1647,11813870,239731,12053601,5,0,0,10752,10,7970804975
1648,11820171,2443593,14263764,6,0,1,4608,7,460002103
1649,11826500,204166,12030666,5,0,0,40448,10,1697268258
1650,11827410,627395,12454805,4,0,0,71168,15,5227110354
1651,11828451,2444816,14273267,6,0,1,1536,7,4425732331
1652,11831370,2467701,14299071,3,0,1,12800,17,10031791173
1653,11844250,2454836,14299086,3,0,1,13824,17,2986821152
1654,11848760,2450349,14299109,0,0,1,1536,3,4980105992
1655,11853811,2445321,14299132,6,0,1,3584,7,6984360554
1656,11861280,219145,12080425,8,0,0,14336,8,2532711279
1657,11866340,2434831,14301171,3,0,1,512,17,7251350921
1658,11880880,2450228,14331108,3,0,1,12288,17,8551160335
1659,11885800,2449105,14334905,3,0,1,5120,17,5842385833
1660,11886000,318769,12204769,5,0,0,49152,10,3234817183
1661,11890480,2493717,14384197,7,0,1,512,10,5964387899
1662,11912590,426987,12339577,4,0,0,66048,15,8128280963
1663,11931050,2458319,14389369,7,0,1,8192,10,1888440377
1664,11936610,520597,12457207,4,0,0,7680,15,10185884343
1665,11940790,2477894,14418684,8,0,1,5120,8,8342754046
1666,11943750,2474949,14418699,8,0,1,2560,8,9193613244
1667,11952470,2466252,14418722,8,0,1,5120,8,5498455712
1668,11955819,2477259,14433078,4,0,1,8192,15,1377889494
1669,11968221,2466163,14434384,6,0,1,2048,7,7045125483
1670,11970550,258589,12229139,4,0,0,65536,15,10468610727
1671,11976781,2481995,14458776,6,0,1,8192,7,589419298
1672,11982800,2476232,14459032,8,0,1,9216,8,10455749150
1673,11985449,2612370,14597819,4,0,1,16896,15,1016459373
1674,11986650,377279,12363929,4,0,0,17920,15,8680791235
1675,11992460,2605374,14597834,7,0,1,3584,10,4959919317
1676,11992550,440532,12433082,4,0,0,66048,15,5534273287
1677,11998970,2598879,14597849,7,0,1,7680,10,9907588050
1678,12006760,2591120,14597880,7,0,1,1024,10,7326137892
1679,12009691,2588204,14597895,6,0,1,4096,7,9667400383
1680,12010510,523324,12533834,5,0,0,30208,10,2710889184
1681,12011759,2586159,14597918,4,0,1,2560,15,335719906
1682,12028480,2569453,14597933,8,0,1,10240,8,1380770280
1683,12039890,2669866,14709756,8,0,1,13824,8,4093110918
1684,12041050,313986,12355036,5,0,0,50688,10,8746095137
1685,12045770,312637,12358407,2,0,0,10752,3,7572866115
1686,12066681,2644369,14711050,6,0,1,1024,7,10091693560
1687,12080749,2630324,14711073,4,0,1,4096,15,176110507
1688,12087700,2660270,14747970,3,0,1,2560,17,9517787197
1689,12088931,2659054,14747985,5,0,1,7168,10,4419054273
1690,12092940,2660831,14753771,3,0,1,3072,17,4258628741
1691,12104640,2656874,14761514,3,0,1,5120,17,4142690315
1692,12104910,716449,12821359,8,0,0,62976,8,4784537865
1693,12107380,2654655,14762035,7,0,1,1024,10,1843666289
1694,12109120,533009,12642129,2,0,0,85504,3,3125769758
1695,12111961,2709157,14821118,6,0,1,6656,7,5118345046
1696,12116190,432177,12548367,2,0,0,46080,3,6116725913
1697,12123200,2697941,14821141,3,0,1,16384,17,8373511091
1698,12130500,2690664,14821164,8,0,1,2560,8,10438658457
1699,12160171,2662645,14822816,5,0,1,3072,10,8321620231
1700,12166310,2667299,14833609,7,0,1,2560,10,9151383392
1701,12173780,2708880,14882660,8,0,1,3072,8,442666236
1702,12174240,316121,12490361,5,0,0,3584,10,10677855521
1703,12174660,435147,12609807,2,0,0,41472,3,9851687516
1704,12174699,2717210,14891909,4,0,1,4608,15,10346812691
1705,12176150,2715782,14891932,8,0,1,4608,8,1627069557
1706,12181600,474779,12656379,8,0,0,5120,8,6726675614
1707,12185950,2705997,14891947,8,0,1,1536,8,1844796512
1708,12187760,2715605,14903365,8,0,1,512,8,9854341181
1709,12187871,2715509,14903380,5,0,1,512,10,3610363758
1710,12188461,2714950,14903411,6,0,1,2560,7,167687537
1711,12190861,2712565,14903426,6,0,1,5632,7,10523983677
1712,12210919,3405374,15616293,4,0,1,175104,15,6523796035
1713,12251110,341333,12592443,2,0,0,16384,3,7914684629
1714,12254150,3527108,15781258,8,0,1,4096,8,9211759602
1715,12256910,3524443,15781353,8,0,1,8704,8,5662961977
1716,12257550,293507,12551057,5,0,0,8704,10,6157515411
1717,12258440,3522936,15781376,7,0,1,2048,10,2731616142
1718,12259491,627611,12887102,7,0,0,56320,10,3122977805
1719,12261810,474616,12736426,2,0,0,23552,3,2945068733
1720,12264450,443039,12707489,5,0,0,55808,10,4322685650
1721,12264790,3516601,15781391,9,0,1,3584,12,6724769935
1722,12265960,3515446,15781406,3,0,1,2560,17,10067676278
1723,12280321,3518345,15798666,6,0,1,9216,7,4971080396
1724,12283070,366476,12649546,8,0,0,23552,8,6504532429
1725,12283470,3601838,15885308,3,0,1,1024,17,6353465705
1726,12292020,3593303,15885323,1,0,1,14848,10,10083628987
1727,12315510,326830,12642340,2,0,0,512,3,716753061
1728,12340930,3552411,15893341,3,0,1,12288,17,7764042523
1729,12341351,3556873,15898224,5,0,1,5120,10,5254740196
1730,12347420,3552110,15899530,8,0,1,2048,8,6497007312
1731,12351170,489892,12841062,5,0,0,3584,10,536392406
1732,12355510,3549911,15905421,1,0,1,2048,10,10250667794
1733,12367220,3542707,15909927,3,0,1,7168,17,10420810591
1734,12367521,211698,12579219,7,0,0,13312,10,7613426389
1735,12372260,666278,13038538,5,0,0,146944,10,9088671225
1736,12376240,425863,12802103,4,0,0,51712,15,2435006754
1737,12385710,3650679,16036389,1,0,1,24064,10,6964123076
1738,12386510,652754,13039264,2,0,0,2048,3,1634089202
1739,12397191,596514,12993705,7,0,0,89600,10,7233141735
1740,12410850,3680933,16091783,1,0,1,4608,10,7414849005
1741,12411290,774750,13186040,5,0,0,45056,10,3895263183
1742,12414910,3713244,16128154,3,0,1,2048,17,2210019652
1743,12418230,529151,12947381,4,0,0,34304,15,10622960325
1744,12421030,3707147,16128177,8,0,1,4096,8,3527254202
1745,12427480,3752606,16180086,8,0,1,10240,8,2492864493
1746,12430311,3762644,16192955,6,0,1,13824,7,8612282670
1747,12439781,3797994,16237775,5,0,1,512,10,5727416300
1748,12441530,3945332,16386862,8,0,1,11264,8,7849051314
1749,12442169,4174109,16616278,4,0,1,59392,15,8883550330
1750,12444540,4186573,16631113,8,0,1,5632,8,10366864664
1751,12446030,4185237,16631267,8,0,1,8704,8,8803842134
1752,12446050,4195037,16641087,8,0,1,12288,8,5727026301
1753,12449021,4249340,16698361,6,0,1,2560,7,1764320606
1754,12452310,4246066,16698376,3,0,1,2048,17,9087130447
1755,12453579,4502652,16956231,4,0,1,59904,15,4883792987
1756,12460660,975265,13435925,2,0,0,57856,3,6420515237
1757,12466241,4490005,16956246,5,0,1,3072,10,3161546736
1758,12466701,452622,12919323,7,0,0,14336,10,4991806835
1759,12469861,4486424,16956285,6,0,1,2048,7,3899354718
1760,12488299,4468548,16956847,4,0,1,5120,15,10011027838
1761,12491220,4540135,17031355,3,0,1,10240,17,7859372823
1762,12491430,340793,12832223,4,0,0,35328,15,9037579380
1763,12502460,4531741,17034201,3,0,1,8192,17,9774525303
1764,12504290,392125,12896415,4,0,0,9728,15,712244349
1765,12505450,4528766,17034216,8,0,1,2048,8,3755185015
1766,12513021,764361,13277382,7,0,0,122880,10,3370134418
1767,12519010,526486,13045496,5,0,0,8192,10,1186598166
1768,12526229,4508002,17034231,4,0,1,8704,15,9154554556
1769,12539890,4521739,17061629,2,0,1,1536,3,9005909992
1770,12547300,610363,13157663,5,0,0,77824,10,6384278822
1771,12567221,387097,12954318,7,0,0,2048,10,4701738108
1772,12569601,293530,12863131,7,0,0,11264,10,4755786910
1773,12574360,4487284,17061644,0,0,1,512,3,1778997698
1774,12582510,4479149,17061659,8,0,1,1024,8,10389254963
1775,12584130,588151,13172281,5,0,0,3072,10,313738863
1776,12588871,4473450,17062321,5,0,1,6656,10,1495220412
1777,12611540,4450967,17062507,2,0,1,3584,3,1255816091
1778,12623081,4439441,17062522,5,0,1,3584,10,5186113587
1779,12623330,4473329,17096659,8,0,1,2560,8,2565813887
1780,12623790,547460,13171250,5,0,0,44544,10,2243048153
1781,12629280,4467725,17097005,8,0,1,512,8,3400619823
1782,12630150,440406,13070556,0,0,0,19456,3,6629705348
1783,12647240,939849,13587089,8,0,0,47616,8,6144299489
1784,12681000,4416978,17097978,8,0,1,12800,8,210137634
1785,12687181,4531284,17218465,5,0,1,9728,10,6277209808
1786,12698520,4532580,17231100,8,0,1,8704,8,4598753934
1787,12701470,1047904,13749374,4,0,0,105472,15,5109544096
1788,12705401,4527005,17232406,5,0,1,2048,10,8206809014
1789,12707441,4527871,17235312,5,0,1,4608,10,2615720079
1790,12707989,4786797,17494786,4,0,1,59392,15,8731695478
1791,12714350,571939,13286289,5,0,0,29184,10,4296583223
1792,12725680,564368,13290048,5,0,0,12288,10,9067911873
1793,12728040,389224,13117264,8,0,0,10240,8,6729834586
1794,12731430,4821002,17552432,8,0,1,1024,8,8828373531
1795,12733040,4819407,17552447,2,0,1,2048,3,7782462045
1796,12738481,4813981,17552462,5,0,1,4608,10,7641994833
1797,12775350,4933265,17708615,0,0,1,13312,3,4605508274
1798,12787441,5025967,17813408,5,0,1,5120,10,5982664698
1799,12798570,5023936,17822506,9,0,1,6656,12,5043027347
1800,12800740,5059967,17860707,8,0,1,3584,8,10453729814
1801,12805000,5090966,17895966,0,0,1,2560,3,207059056
1802,12815770,528799,13344569,8,0,0,29696,8,7456069956
1803,12818800,5078828,17897628,2,0,1,2048,3,9766715721
1804,12820031,5106095,17926126,5,0,1,5632,10,10077876742
1805,12825790,5106316,17932106,2,0,1,9216,3,7524019591
1806,12827111,5138545,17965656,5,0,1,6144,10,3933341179
1807,12832430,5160260,17992690,8,0,1,19456,8,4811153739
1808,12833780,251979,13085759,8,0,0,8192,8,3767206314
1809,12836290,5167226,18003516,2,0,1,1536,3,5750477928
1810,12843820,5159719,18003539,2,0,1,1024,3,6653806401
1811,12849400,5154154,18003554,9,0,1,2048,12,9380233493
1812,12855140,5148429,18003569,0,0,1,1536,3,10709504501
1813,12862070,623355,13485425,5,0,0,18944,10,4213037270
1814,12899440,5130250,18029690,2,0,1,4096,3,9206200484
1815,12906740,395982,13302722,8,0,0,12288,8,3061416194
1816,12906790,5122915,18029705,9,0,1,4096,12,2553197221
1817,12908110,5121797,18029907,2,0,1,4096,3,6354436971
1818,12911100,5158309,18069409,2,0,1,8192,3,1898159547
1819,12921930,5179437,18101367,8,0,1,10240,8,4696518526
1820,12927480,5209674,18137154,2,0,1,6656,3,9356009476
1821,12941500,5195669,18137169,2,0,1,4096,3,10083670646
1822,12943070,5194114,18137184,0,0,1,8192,3,7387769437
1823,12952430,498821,13451251,4,0,0,26624,15,7908514159
1824,12961361,5200718,18162079,5,0,1,4608,10,5301500073
1825,12971111,5213945,18185056,5,0,1,2048,10,6960154243
1826,12984111,5200960,18185071,6,0,1,5120,7,2200968913
1827,12992400,353284,13345684,8,0,0,3584,8,3138261080
1828,12992900,450224,13443124,2,0,0,23552,3,2037051593
1829,12995740,5219524,18215264,8,0,1,512,8,1340686468
1830,12996551,5218736,18215287,6,0,1,3584,7,60543962
1831,13004520,360031,13364551,2,0,0,33280,3,6718993330
1832,13008780,306619,13315399,2,0,0,33280,3,9597050306
1833,13009440,5205878,18215318,2,0,1,1536,3,8674553211
1834,13016430,318345,13334775,5,0,0,34304,10,1165511978
1835,13025321,5199449,18224770,6,0,1,2560,7,9104604798
1836,13031120,5193665,18224785,2,0,1,2048,3,2973190307
1837,13031210,207555,13238765,5,0,0,5120,10,9263399333
1838,13049040,5175760,18224800,0,0,1,4096,3,1455032657
1839,13054030,5173005,18227035,2,0,1,4608,3,8139345901
1840,13058810,5168891,18227701,0,0,1,1024,3,608408106
1841,13059141,5168906,18228047,5,0,1,512,10,2192213287
1842,13072710,5158714,18231424,7,0,1,13312,10,8336900443
1843,13073710,5206448,18280158,8,0,1,3072,8,799885382
1844,13075221,5266255,18341476,6,0,1,512,7,1243792403
1845,13078230,220725,13298955,8,0,0,29184,8,2262105229
1846,13080670,398463,13479133,2,0,0,25088,3,9463642285
1847,13092981,5250121,18343102,5,0,1,2560,10,7393693400
1848,13100610,5242851,18343461,7,0,1,9728,10,9900510231
1849,13113780,287418,13401198,5,0,0,24576,10,2512367376
1850,13123890,5234685,18358575,7,0,1,7168,10,8079979522
1851,13124240,5413516,18537756,0,0,1,12288,3,9983811916
1852,13146840,5390931,18537771,2,0,1,10240,3,3385003547
1853,13146870,5480038,18626908,7,0,1,2048,10,2202054618
1854,13148950,367663,13516613,5,0,0,17408,10,3252372341
1855,13152141,5491645,18643786,6,0,1,2560,7,412957524
1856,13156130,5526852,18682982,2,0,1,17408,3,2684863565
1857,13159100,5553791,18712891,8,0,1,1536,8,3676491357
1858,13159180,5553726,18712906,0,0,1,3584,3,8735224394
1859,13161211,5581571,18742782,5,0,1,13824,10,7778025577
1860,13163600,374939,13538539,2,0,0,42496,3,3584091258
1861,13164441,5621734,18786175,6,0,1,1024,7,8526259437
1862,13167390,458374,13625764,5,0,0,29696,10,10659664227
1863,13167570,509351,13676921,2,0,0,9216,3,323405759
1864,13172870,602032,13774902,8,0,0,70144,8,8884297805
1865,13180630,5606851,18787481,0,0,1,2048,3,4313784487
1866,13193030,5655317,18848347,2,0,1,18432,3,502129486
1867,13195190,312162,13507352,8,0,0,3584,8,2663231443
1868,13199420,5666223,18865643,2,0,1,5120,3,5826678302
1869,13199880,5720592,18920472,2,0,1,5632,3,4040979619
1870,13207960,5712535,18920495,8,0,1,4096,8,2842856225
1871,13217680,288565,13506245,8,0,0,33792,8,780223550
1872,13226560,369019,13595579,8,0,0,15360,8,7756778114
1873,13231071,5704938,18936009,6,0,1,4608,7,1630822962
1874,13237050,442382,13679432,8,0,0,8192,8,9907609069
1875,13273640,5663824,18937464,2,0,1,2560,3,4016864268
1876,13278880,579158,13858038,5,0,0,31232,10,2056624482
1877,13279170,5744358,19023528,2,0,1,14848,3,560867958
1878,13305750,480923,13786673,5,0,0,38400,10,8898355039
1879,13308600,444892,13753492,2,0,0,13312,3,6498855592
1880,13320280,470891,13791171,4,0,0,14336,15,3853434862
1881,13336110,622092,13958202,5,0,0,89600,10,253485721
1882,13338391,5870753,19209144,6,0,1,1536,7,6716159118
1883,13338680,5870810,19209490,2,0,1,512,3,9164373596
1884,13349510,305681,13655191,5,0,0,20992,10,5690031484
1885,13358210,5857360,19215570,0,0,1,3584,3,670928748
1886,13363690,161203,13524893,5,0,0,17408,10,7504948963
1887,13364930,5853639,19218569,0,0,1,3584,3,4614890108
1888,13368720,5851475,19220195,8,0,1,2560,8,8071861417
1889,13370280,303802,13674082,5,0,0,61952,10,10444605937
1890,13378620,423338,13801958,5,0,0,35328,10,2533170381
1891,13383380,516640,13900020,5,0,0,17408,10,1319863220
1892,13389180,5891406,19280586,8,0,1,7680,8,5691418324
1893,13389320,5903160,19292480,6,0,1,4608,7,9300643768
1894,13392110,5900385,19292495,0,0,1,1024,3,9798854802
1895,13399220,734052,14133272,5,0,0,24064,10,8791701580
1896,13408830,5883680,19292510,2,0,1,512,3,7650662095
1897,13421951,5870694,19292645,6,0,1,8192,7,8056226751
1898,13435981,5956568,19392549,6,0,1,2048,7,3318533288
1899,13455861,6015357,19471218,6,0,1,10240,7,10039693548
1900,13459050,6012183,19471233,0,0,1,2048,3,5428452325
1901,13472960,6009691,19482651,0,0,1,17408,3,2383356455
1902,13488790,608575,14097365,4,0,0,129024,15,1840509700
1903,13489300,335088,13824388,4,0,0,34816,15,7904284620
1904,13493720,489341,13983061,5,0,0,38912,10,1301848665
1905,13495220,366295,13861515,2,0,0,11264,3,5392766092
1906,13513450,531734,14045184,8,0,0,26112,8,2429877765
1907,13524360,739389,14263749,8,0,0,19968,8,5957824959
1908,13526100,5962831,19488931,0,0,1,4608,3,10615471155
1909,13537590,670080,14207670,8,0,0,79360,8,1741649116
1910,13542659,6245436,19788095,4,0,1,88064,15,10461743476
1911,13546700,6279548,19826248,8,0,1,12800,8,535395960
1912,13556650,6311098,19867748,6,0,1,1536,7,4903141335
1913,13557019,6496979,20053998,4,0,1,48128,15,1622990715
1914,13562919,6583357,20146276,4,0,1,68608,15,432834004
1915,13586000,6560307,20146307,8,0,1,1536,8,5446190147
1916,13589169,6557496,20146665,4,0,1,47104,15,6755317442
1917,13591069,6555619,20146688,4,0,1,8704,15,4506263883
1918,13599730,6546981,20146711,1,0,1,5120,10,6393984431
1919,13604080,6568596,20172676,6,0,1,1024,7,6341299862
1920,13616970,508939,14125909,2,0,0,34816,3,10436457564
1921,13625060,6547655,20172715,2,0,1,5120,3,368686346
1922,13631610,6541128,20172738,1,0,1,11264,10,7889618260
1923,13639630,574793,14214423,8,0,0,20992,8,7591566177
1924,13655200,6517561,20172761,0,0,1,1536,3,9494984499
1925,13662860,755785,14418645,2,0,0,58880,3,4468355491
1926,13672560,442710,14115270,8,0,0,28160,8,2186122987
1927,13678770,6494014,20172784,8,0,1,512,8,5113470790
1928,13686440,6510181,20196621,0,0,1,28672,3,6130583636
1929,13696660,6499984,20196644,0,0,1,4096,3,5904278508
1930,13698060,6515313,20213373,0,0,1,9216,3,6590753836
1931,13702950,6511729,20214679,8,0,1,2048,8,3218979520
1932,13716760,6521436,20238196,0,0,1,3584,3,9088468314
1933,13728530,6511612,20240142,6,0,1,3072,7,7413032799
1934,13728829,6533724,20262553,4,0,1,21504,15,7685568424
1935,13734670,522950,14257620,8,0,0,23552,8,5018729056
1936,13735010,6527566,20262576,6,0,1,1024,7,3808558040
1937,13746050,6516549,20262599,8,0,1,7680,8,8371702455
1938,13752120,455877,14207997,8,0,0,1024,8,5760213496
1939,13755950,6506672,20262622,8,0,1,2048,8,3879564970
1940,13760390,6502255,20262645,8,0,1,1536,8,1280905674
1941,13770880,366110,14136990,2,0,0,8704,3,5884488967
1942,13774250,6488418,20262668,8,0,1,2048,8,9252195386
1943,13784420,6478271,20262691,8,0,1,2048,8,2351963951
1944,13790130,6479981,20270111,8,0,1,9728,8,9321717357
1945,13795740,6488416,20284156,7,0,1,7168,10,5711882452
1946,13805299,6527840,20333139,4,0,1,74240,15,1120483181
1947,13834110,304793,14138903,4,0,0,5632,15,8567397945
1948,13835369,6729458,20564827,4,0,1,77312,15,3430634348
1949,13869210,728594,14597804,4,0,0,65536,15,655965099
1950,13869260,310734,14179994,8,0,0,34816,8,8955531883
1951,13870690,656557,14527247,8,0,0,36864,8,9431766000
1952,13875260,365357,14240617,5,0,0,12288,10,10470149987
1953,13881410,939685,14821095,2,0,0,121856,3,1205160833
1954,13885859,6797200,20683059,4,0,1,54272,15,2222691607
1955,13890790,408266,14299056,2,0,0,48640,3,594495882
1956,13891070,410086,14301156,8,0,0,5120,8,4334390149
1957,13897829,6872037,20769866,4,0,1,38912,15,8000150128
1958,13902940,6892922,20795862,7,0,1,2048,10,3880764155
1959,13904630,6891255,20795885,6,0,1,1024,7,8955619789
1960,13905530,1074841,14980371,4,0,0,72704,15,7973177985
1961,13906170,593045,14499215,5,0,0,4608,10,8862852004
1962,13907300,468631,14375931,8,0,0,29184,8,645944937
1963,13929439,6874347,20803786,4,0,1,45568,15,920912922
1964,13930980,6888171,20819151,6,0,1,4096,7,4224153469
1965,13948349,6880574,20828923,4,0,1,11264,15,2658235843
1966,13961190,6867756,20828946,7,0,1,8704,10,3688559145
1967,13977420,599138,14576558,2,0,0,105984,3,4624100925
1968,13982749,6883009,20865758,4,0,1,47104,15,6003946532
1969,13993191,6882240,20875431,6,0,1,20992,7,9075561223
1970,14001501,6874916,20876417,5,0,1,1536,10,6026560775
1971,14012120,6878518,20890638,7,0,1,3584,10,5422353366
1972,14041951,6848710,20890661,6,0,1,6656,7,4410724548
1973,14042150,6849203,20891353,7,0,1,6144,10,3973445763
1974,14052789,6945987,20998776,4,0,1,64000,15,10357557413
1975,14099279,6899520,20998799,4,0,1,25088,15,5048346174
1976,14100491,6906725,21007216,6,0,1,7168,7,429178566
1977,14104510,6908129,21012639,7,0,1,2048,10,4852899852
1978,14126730,755268,14881998,2,0,0,91648,3,8868969286
1979,14152230,273855,14426085,8,0,0,7680,8,3544429001
1980,14153821,6859996,21013817,6,0,1,13824,7,448467737
1981,14157860,939920,15097780,5,0,0,77312,10,4389029186
1982,14160939,6871679,21032618,4,0,1,11264,15,8356253576
1983,14180399,6866186,21046585,4,0,1,17408,15,2749914735
1984,14199520,6848051,21047571,7,0,1,1536,10,6265540647
1985,14220259,6898377,21118636,4,0,1,25600,15,6283262887
1986,14222070,418851,14640921,8,0,0,22528,8,5965034809
1987,14223240,6942804,21166044,7,0,1,10752,10,5336829266
1988,14228840,239236,14468076,5,0,0,12288,10,6484596904
1989,14240880,423639,14664519,5,0,0,3072,10,6767298159
1990,14244370,815364,15059734,6,0,0,43520,7,9768103918
1991,14246630,372720,14619350,5,0,0,55296,10,6827690015
1992,14283000,294821,14577821,4,0,0,4096,15,5398381263
1993,14284061,6906927,21190988,6,0,1,12288,7,1316815955
1994,14286749,7078491,21365240,4,0,1,106496,15,4207358814
1995,14290830,7074433,21365263,7,0,1,3072,10,4374539087
1996,14305479,7091076,21396555,4,0,1,30720,15,5791950833
1997,14306510,7090068,21396578,6,0,1,6144,7,8531362543
1998,14309870,292617,14602487,4,0,0,12288,15,6936081802
1999,14316020,7081275,21397295,9,0,1,3072,12,5407145264
2000,14331599,7149598,21481197,4,0,1,128512,15,7070446953
2001,14335701,7148402,21484103,6,0,1,4608,7,3369638207
2002,14337980,371761,14709741,2,0,0,74752,3,2393533391
2003,14341760,7143649,21485409,7,0,1,2048,10,3162397926
2004,14353980,244748,14598728,5,0,0,2560,10,5192845011
2005,14368480,280514,14648994,4,0,0,5632,15,879827192
2006,14373620,7117601,21491221,7,0,1,9216,10,3757337233
2007,14379790,7112199,21491989,7,0,1,11776,10,8450100419
2008,14384980,7108635,21493615,7,0,1,2560,10,8069626757
2009,14386800,385044,14771844,4,0,0,24576,15,2250147279
2010,14399420,7096461,21495881,9,0,1,3584,12,5054281505
2011,14406339,7119740,21526079,4,0,1,58880,15,8149457701
2012,14408900,311175,14720075,5,0,0,6144,10,75352783
2013,14409490,338465,14747955,2,0,0,27648,3,8938253159
2014,14413251,7115199,21528450,6,0,1,9728,7,6456346174
2015,14418420,526035,14944455,4,0,0,45568,15,7515236845
2016,14424040,337451,14761491,8,0,0,19968,8,4848450815
2017,14438500,735633,15174133,2,0,0,20480,3,2988407803
2018,14452330,7083566,21535896,7,0,1,1024,10,5410547117
2019,14455721,7130627,21586348,6,0,1,42496,7,9275884071
2020,14484991,7117348,21602339,6,0,1,8704,7,9006940402
2021,14495540,7117996,21613536,7,0,1,23552,10,366466466
2022,14496560,214467,14711027,8,0,0,4096,8,9779500335
2023,14508330,472688,14981018,8,0,0,2048,8,5265230535
2024,14511240,7112609,21623849,7,0,1,5120,10,8756337075
2025,14517100,612456,15129556,5,0,0,54784,10,5944833024
2026,14517720,7115493,21633213,7,0,1,4096,10,1769863957
2027,14522421,7110815,21633236,6,0,1,4608,7,1625154127
2028,14534840,7098419,21633259,7,0,1,3584,10,8031918802
2029,14568090,681960,15250050,4,0,0,15360,15,10243268341
2030,14568879,7064403,21633282,4,0,1,1536,15,5243052638
2031,14572841,7061058,21633899,6,0,1,2048,7,7098956178
2032,14593939,288698,14882637,3,0,0,2048,17,4207003299
2033,14602390,7034095,21636485,1,0,1,4096,10,2693343746
2034,14611960,291390,14903350,8,0,0,37376,8,6230109165
2035,14619320,656523,15275843,5,0,0,41984,10,8788407986
2036,14624699,204020,14828719,3,0,0,11776,17,360012410
2037,14625109,7118197,21743306,4,0,1,81408,15,7177161512
2038,14629040,262854,14891894,4,0,0,14848,15,155639212
2039,14640409,7165451,21805860,4,0,1,32768,15,6408454908
2040,14643430,512685,15156115,2,0,0,87040,3,3933388366
2041,14649530,306157,14955687,5,0,0,14848,10,3451354416
2042,14650541,7307082,21957623,6,0,1,58880,7,4169261655
2043,14655561,7305288,21960849,6,0,1,5120,7,8658769639
2044,14669510,217845,14887355,8,0,0,15360,8,5487330657
2045,14679910,920377,15600287,4,0,0,96768,15,6509912540
2046,14682199,224253,14906452,3,0,0,4096,17,9002904384
2047,14688961,7278562,21967523,6,0,1,4608,7,2079017130
2048,14697610,470268,15167878,5,0,0,38400,10,7792624484
2049,14704710,363656,15068366,8,0,0,1536,8,7813564593
2050,14718590,1062645,15781235,4,0,0,49664,15,8001478355
2051,14725339,1169105,15894444,3,0,0,1536,17,7734454812
2052,14749010,429145,15178155,8,0,0,8192,8,10078123587
2053,14755600,149581,14905181,8,0,0,5632,8,2892175490
2054,14757419,651989,15409408,3,0,0,103936,17,4689354598
2055,14757630,450387,15208017,4,0,0,14336,15,7704485925
2056,14760470,502566,15263036,5,0,0,1024,10,7999869786
2057,14763680,587599,15351279,2,0,0,12800,3,9100850103
2058,14765450,750730,15516180,4,0,0,27648,15,4506918901
2059,14789091,7178455,21967546,6,0,1,512,7,9211927412
2060,14797950,307645,15105595,8,0,0,25600,8,1577488942
2061,14800280,537138,15337418,2,0,0,48128,3,1846149233
2062,14815680,447021,15262701,5,0,0,41472,10,7536224912
2063,14818560,476288,15294848,8,0,0,43008,8,6736972134
2064,14822410,367794,15190204,8,0,0,16896,8,2585402605
2065,14828460,447718,15276178,2,0,0,1024,3,6782797683
2066,14840920,719549,15560469,2,0,0,68096,3,6723549860
2067,14849140,657064,15506204,5,0,0,28672,10,5333320892
2068,14851060,719720,15570780,2,0,0,33792,3,690671729
2069,14856421,7112002,21968423,5,0,1,13312,10,978598597
2070,14873841,7095658,21969499,6,0,1,13312,7,5471560949
2071,14882671,7105090,21987761,5,0,1,1024,10,353660767
2072,14893950,818613,15712563,5,0,0,1536,10,3577383130
2073,14894271,7094796,21989067,6,0,1,2048,7,7361316010
2074,14896400,541372,15437772,4,0,0,12288,15,144544009
2075,14927770,298031,15225801,4,0,0,12288,15,4026965216
2076,14927921,7117075,22044996,6,0,1,75776,7,7034255729
2077,14952090,664156,15616246,2,0,0,52224,3,1783046966
2078,14959281,7085738,22045019,5,0,1,1024,10,6235459117
2079,14965130,7079912,22045042,2,0,1,4608,3,5837115629
2080,14966590,484787,15451377,2,0,0,27648,3,9324141975
2081,14972929,912348,15885277,3,0,0,35840,17,85613479
2082,14977929,267426,15245355,3,0,0,9728,17,6781520978
2083,14987641,7097892,22085533,6,0,1,71680,7,10436916668
2084,14989481,7131993,22121474,6,0,1,20992,7,5761387849
2085,14993000,7142731,22135731,2,0,1,1536,3,1392439654
2086,14993270,7149211,22142481,0,0,1,2560,3,3294795083
2087,14994450,635671,15630121,5,0,0,9216,10,10516114839
2088,15010770,7142033,22152803,2,0,1,512,3,5963644812
2089,15011910,686048,15697958,4,0,0,67072,15,4037971034
2090,15015500,7137326,22152826,0,0,1,8704,3,4774267383
2091,15020040,7132809,22152849,0,0,1,6144,3,9982816003
2092,15038770,7115361,22154131,3,0,1,3072,17,1186649503
2093,15048660,7106137,22154797,9,0,1,1024,12,2077103323
2094,15061660,7101790,22163450,2,0,1,3584,3,463932779
2095,15067130,7107834,22174964,2,0,1,16384,3,8452177479
2096,15072300,693764,15766064,8,0,0,138240,8,6989686700
2097,15081490,7094140,22175630,2,0,1,1024,3,9317180890
2098,15083581,7095915,22179496,5,0,1,6144,10,9079363220
2099,15087620,529172,15616792,2,0,0,1536,3,187648234
2100,15088110,7094932,22183042,9,0,1,5632,12,9611550298
2101,15097990,7087318,22185308,2,0,1,3584,3,6450275301
2102,15101409,934965,16036374,3,0,0,93184,17,462009446
2103,15117431,7125440,22242871,6,0,1,41984,7,10189521802
2104,15119100,7126677,22245777,8,0,1,4608,8,9274387859
2105,15124010,7122433,22246443,2,0,1,1024,3,10535478585
2106,15130130,744188,15874318,4,0,0,162816,15,4514975465
2107,15146200,839702,15985902,5,0,0,73728,10,10033316022
2108,15147320,1166251,16313571,9,0,0,2048,12,9297525914
2109,15166061,7085973,22252034,5,0,1,13824,10,5098281087
2110,15171050,454194,15625244,5,0,0,9728,10,2989656620
2111,15176180,952808,16128988,8,0,0,2560,8,1778854119
2112,15177020,178092,15355112,4,0,0,2560,15,4428583480
2113,15178140,117296,15295436,2,0,0,512,3,2488075296
2114,15185180,990466,16175646,5,0,0,69120,10,10565587866
2115,15186660,892809,16079469,5,0,0,27136,10,2624426266
2116,15191861,7063213,22255074,5,0,1,1024,10,5301554333
2117,15198541,7056994,22255535,5,0,1,10240,10,5532775810
2118,15199100,317251,15516351,2,0,0,512,3,8709569616
2119,15203470,7101557,22305027,9,0,1,2048,12,8904124313
2120,15206420,1076204,16282624,8,0,0,76800,8,3920602489
2121,15214450,913689,16128139,8,0,0,9216,8,8832888996
2122,15216230,1524650,16740880,4,0,0,61440,15,6954295744
2123,15216840,607855,15824695,8,0,0,32256,8,2557709639
2124,15245951,7063902,22309853,5,0,1,7680,10,1561427675
2125,15256291,7081577,22337868,5,0,1,15360,10,427139406
2126,15257990,813132,16071122,4,0,0,41472,15,6609792829
2127,15264170,852979,16117149,5,0,0,21504,10,2752786377
2128,15267791,7133712,22401503,6,0,1,93184,7,4634055790
2129,15271961,7129888,22401849,5,0,1,512,10,3573531667
2130,15294970,7107545,22402515,7,0,1,1024,10,6197167516
2131,15295990,7110738,22406728,2,0,1,16896,3,802859605
2132,15305370,7120459,22425829,7,0,1,4096,10,10415675068
2133,15307220,7121835,22429055,9,0,1,5120,12,4811156068
2134,15318821,7111220,22430041,5,0,1,1536,10,457354953
2135,15323011,7137183,22460194,6,0,1,51712,7,6939890114
2136,15338140,7127982,22466122,9,0,1,5120,12,3173620081
2137,15360670,7129589,22490259,7,0,1,2560,10,9520728270
2138,15365620,7135677,22501297,7,0,1,8192,10,794221833
2139,15370261,7142327,22512588,6,0,1,37376,7,4357086197
2140,15375220,618668,15993888,5,0,0,4608,10,528289936
2141,15378520,7155546,22534066,7,0,1,4608,10,5405581115
2142,15387450,723132,16110582,4,0,0,16896,15,7762265087
2143,15404360,383809,15788169,2,0,0,1536,3,10100406995
2144,15421650,1103766,16525416,8,0,0,40448,8,4077298852
2145,15422870,7111542,22534412,9,0,1,512,12,2854338578
2146,15429371,7132860,22562231,6,0,1,72192,7,4320401993
2147,15431951,7142111,22574062,5,0,1,2048,10,5379182882
2148,15444870,1253452,16698322,8,0,0,26112,8,1337998997
2149,15445821,7131621,22577442,5,0,1,13824,10,10633751985
2150,15450560,956792,16407352,4,0,0,20992,15,288300230
2151,15482180,7095928,22578108,9,0,1,1024,12,4213726514
2152,15498041,7101140,22599181,6,0,1,17920,7,1640496879
2153,15501860,556555,16058415,5,0,0,46080,10,9598520824
2154,15511100,377118,15888218,5,0,0,9216,10,9487698839
2155,15513890,7093503,22607393,9,0,1,4096,12,2205423930
2156,15518620,7094203,22612823,9,0,1,4608,12,5023676412
2157,15524551,7088295,22612846,5,0,1,9728,10,4671696916
2158,15526980,7093164,22620144,7,0,1,3072,10,89482986
2159,15536081,7088569,22624650,5,0,1,7168,10,4793295747
2160,15551000,1241980,16792980,2,0,0,2560,3,7695187457
2161,15561250,884204,16445454,5,0,0,11776,10,6101442495
2162,15564730,1185837,16750567,4,0,0,31744,15,6578147262
2163,15569660,646628,16216288,4,0,0,53760,15,7042780834
2164,15571071,7054565,22625636,5,0,1,1536,10,8744707145
2165,15582990,409479,15992469,5,0,0,21504,10,10348658302
2166,15596250,1035446,16631696,2,0,0,1024,3,179966113
2167,15598200,7032262,22630462,9,0,1,7680,12,2669897774
2168,15598720,992752,16591472,5,0,0,52736,10,1540195225
2169,15601550,1597214,17198764,5,0,0,171008,10,4488675797
2170,15611910,569104,16181014,2,0,0,1536,3,684425959
2171,15614080,983375,16597455,8,0,0,19456,8,2184817143
2172,15614681,7023193,22637874,5,0,1,11776,10,6160088175
2173,15615430,1267803,16883233,8,0,0,87552,8,5222863570
2174,15617950,7020590,22638540,9,0,1,1024,12,10431211519
2175,15629290,7011516,22640806,9,0,1,3584,12,9592540161
2176,15644161,7016716,22660877,6,0,1,48128,7,5578764069
2177,15649480,550413,16199893,5,0,0,18432,10,6643088468
2178,15658600,630779,16289379,5,0,0,22016,10,10367555742
2179,15666090,7001892,22667982,9,0,1,21504,12,3361487609
2180,15672360,6997248,22669608,9,0,1,2560,12,4493613179
2181,15672550,7009329,22681879,9,0,1,4608,12,9285431639
2182,15677380,7005588,22682968,0,0,1,1536,3,8908112479
2183,15696820,428456,16125276,8,0,0,26624,8,194400293
2184,15708031,7010042,22718073,6,0,1,53248,7,5391803069
2185,15711631,7018963,22730594,6,0,1,27136,7,5810910567
2186,15720680,814111,16534791,4,0,0,30720,15,5968018951
2187,15724150,7030603,22754753,9,0,1,7680,12,3951806694
2188,15726520,7029219,22755739,9,0,1,1536,12,1983259644
2189,15734580,7024065,22758645,9,0,1,4608,12,9569629905
2190,15735200,1157416,16892616,8,0,0,30720,8,10441134480
2191,15745831,7038368,22784199,6,0,1,25088,7,2218723013
2192,15748700,295660,16044360,8,0,0,26112,8,5836842040
2193,15751470,1841551,17593021,4,0,0,7680,15,8761891063
2194,15752990,1278326,17031316,5,0,0,3072,10,3997532826
2195,15753940,7046955,22800895,9,0,1,8704,12,2577474018
2196,15756640,1180046,16936686,5,0,0,79872,10,7206729107
2197,15774790,7127633,22902423,9,0,1,1536,12,6400293386
2198,15787620,7114826,22902446,9,0,1,1024,12,8071655076
2199,15819710,7082759,22902469,9,0,1,13824,12,7631745411
2200,15827230,7075262,22902492,9,0,1,6144,12,701687880
2201,15831240,7071275,22902515,9,0,1,1536,12,274126215
2202,15841091,7065993,22907084,6,0,1,39936,7,5881817685
2203,15844161,7063269,22907430,5,0,1,512,10,6228829534
2204,15865611,7050384,22915995,5,0,1,6656,10,9100794140
2205,15865920,1634922,17500842,8,0,0,16896,8,7660900311
2206,15865951,7084986,22950937,6,0,1,45056,7,7004386718
2207,15867581,7113776,22981357,6,0,1,33280,7,9955499544
2208,15872730,1188322,17061052,5,0,0,43008,10,9606875817
2209,15872900,494882,16367782,5,0,0,47616,10,5073905498
2210,15878450,783292,16661742,8,0,0,61952,8,1189808123
2211,15885571,7194797,23080368,6,0,1,16896,7,1188337798
2212,15887170,1797696,17684866,2,0,0,512,3,7175856103
2213,15888840,1081866,16970706,4,0,0,30208,15,4636500198
2214,15895620,417312,16312932,5,0,0,54784,10,2222081746
2215,15903430,497511,16400941,2,0,0,512,3,4082761554
2216,15907810,1397342,17305152,5,0,0,20480,10,7433205256
2217,15914020,511223,16425243,4,0,0,3584,15,9792607379
2218,15915581,7199854,23115435,6,0,1,28672,7,6942197508
2219,15917670,7197788,23115458,9,0,1,5632,12,2595531832
2220,15927170,426089,16353259,8,0,0,26624,8,9966967872
2221,15931101,7184380,23115481,5,0,1,5632,10,7060826008
2222,15940941,7174563,23115504,8,0,1,2048,8,1060102198
2223,15959250,7156277,23115527,0,0,1,2048,3,237040188
2224,15961710,7160148,23121858,9,0,1,1536,12,7385951416
2225,15969570,986475,16956045,8,0,0,63488,8,6914043430
2226,15977291,7224526,23201817,6,0,1,86016,7,3878206596
2227,15983880,1078612,17062492,2,0,0,512,3,8622657237
2228,16006460,7202222,23208682,0,0,1,4096,3,1557531863
2229,16011720,7197308,23209028,9,0,1,512,12,753975460
2230,16011750,1470183,17481933,5,0,0,68096,10,1832156816
2231,16013571,7198363,23211934,5,0,1,4608,10,5888894162
2232,16018681,7198105,23216786,5,0,1,17920,10,4369317041
2233,16018770,7207734,23226504,0,0,1,3584,3,3983986980
2234,16022170,699975,16722145,4,0,0,46592,15,5275807079
2235,16023911,7207929,23231840,5,0,1,7680,10,7452259249
2236,16026640,820599,16847239,5,0,0,52736,10,989034422
2237,16029911,7202595,23232506,5,0,1,1024,10,8891278246
2238,16060800,361354,16422154,8,0,0,39936,8,10482340930
2239,16064590,7169862,23234452,0,0,1,3072,3,4718258152
2240,16065500,7170232,23235732,6,0,1,14336,7,8026414143
2241,16076130,306289,16382419,5,0,0,21504,10,8996930082
2242,16083580,7166742,23250322,3,0,1,3584,17,822948188
2243,16099880,7153028,23252908,7,0,1,4096,10,5434770544
2244,16101210,7153004,23254214,7,0,1,2048,10,7664820020
2245,16103990,7155692,23259682,0,0,1,18944,3,2637513579
2246,16105509,7175597,23281106,4,0,1,7680,15,660329167
2247,16107130,1256630,17363760,5,0,0,71680,10,8411388556
2248,16110800,444138,16554938,4,0,0,11776,15,1136044067
2249,16114410,1259619,17374029,4,0,0,12288,15,9476805321
2250,16115091,7197668,23312759,6,0,1,39424,7,7069036603
2251,16122150,7193195,23315345,0,0,1,4096,3,8465032965
2252,16129080,345822,16474902,8,0,0,30720,8,9708700153
2253,16138060,896118,17034178,4,0,0,9216,15,8796819236
2254,16138640,374437,16513077,4,0,0,23552,15,3064319593
2255,16139380,7176836,23316216,6,0,1,12288,7,1498695743
2256,16149779,7200615,23350394,4,0,1,37376,15,9761322785
2257,16159061,7239942,23399003,6,0,1,44032,7,4566414137
2258,16165200,1648185,17813385,8,0,0,42496,8,9716503219
2259,16177800,7232464,23410264,0,0,1,1536,3,5196901756
2260,16179080,510445,16689525,4,0,0,91136,15,528159107
2261,16184270,7229220,23413490,7,0,1,5120,10,143663003
2262,16188801,7266578,23455379,6,0,1,53760,7,6504900600
2263,16192319,7279937,23472256,4,0,1,11776,15,10293931279
2264,16193540,7287880,23481420,0,0,1,3584,3,8655522207
2265,16201930,197631,16399561,2,0,0,1024,3,8865969983
2266,16202020,7284546,23486566,0,0,1,8192,3,3060031392
2267,16209389,7426194,23635583,4,0,1,30720,15,5705208960
2268,16212940,7422666,23635606,0,0,1,13824,3,8372573665
2269,16219710,863369,17083079,2,0,0,1024,3,8643925163
2270,16219921,7442274,23662195,6,0,1,9728,7,8019213500
2271,16234100,812710,17046810,2,0,0,2048,3,2316802471
2272,16239050,7439617,23678667,8,0,1,1536,8,6741130310
2273,16242310,7437050,23679360,8,0,1,6656,8,9050550680
2274,16244079,7480218,23724297,4,0,1,13312,15,3053995856
2275,16251019,7497751,23748770,4,0,1,49152,15,8522451287
2276,16251760,7620690,23872450,7,0,1,9728,10,2178229974
2277,16269291,7852266,24121557,6,0,1,124928,7,5187284075
2278,16271901,7910477,24182378,6,0,1,87552,7,2314766517
2279,16271990,418361,16690351,2,0,0,1024,3,10271395599
2280,16283211,7972126,24255337,6,0,1,41984,7,5794110194
2281,16304340,903643,17207983,5,0,0,30208,10,5711455890
2282,16324161,7934402,24258563,5,0,1,5120,10,4884423440
2283,16328150,7932359,24260509,7,0,1,3072,10,173834236
2284,16334050,1518773,17852823,5,0,0,26112,10,5578043088
2285,16351880,678485,17030365,8,0,0,118272,8,6064554673
2286,16361370,1191031,17552401,4,0,0,93696,15,2763088675
2287,16374020,7892238,24266258,7,0,1,5120,10,2266242641
2288,16375360,748394,17123754,4,0,0,61440,15,10490776816
2289,16380651,7963093,24343744,6,0,1,84992,7,8971773772
2290,16385470,675973,17061443,2,0,0,1024,3,5683262108
2291,16402250,411917,16814167,8,0,0,4608,8,6619401567
2292,16409010,637153,17046163,4,0,0,29184,15,2267348841
2293,16427840,262176,16690016,2,0,0,1536,3,262727356
2294,16459170,1427524,17886694,5,0,0,65024,10,7090709945
2295,16481120,7941732,24422852,6,0,1,61952,7,727137405
2296,16497250,254424,16751674,8,0,0,3584,8,6432630594
2297,16499580,562726,17062306,5,0,0,2048,10,8293186764
2298,16532540,1433101,17965641,8,0,0,67584,8,4426447455
2299,16537220,163193,16700413,2,0,0,1024,3,452281687
2300,16550220,7918600,24468820,7,0,1,13824,10,9815211672
2301,16561480,7907363,24468843,6,0,1,1024,7,2005963291
2302,16568310,467964,17036274,5,0,0,6656,10,6947518016
2303,16572100,7896766,24468866,7,0,1,3584,10,6541740980
2304,16572270,7896619,24468889,7,0,1,512,10,625563439
2305,16573170,226081,16799251,5,0,0,1024,10,6653981819
2306,16576670,245717,16822387,8,0,0,26624,8,896611716
2307,16580920,1127297,17708217,2,0,0,512,3,10368419775
2308,16583010,7885902,24468912,7,0,1,512,10,7083775800
2309,16583020,1478742,18061762,2,0,0,1536,3,4370659040
2310,16583090,7978066,24561156,6,0,1,124928,7,1932291984
2311,16605920,471505,17077425,4,0,0,37888,15,987358800
2312,16607750,474994,17082744,5,0,0,17408,10,4800726354
2313,16622130,1370529,17992659,4,0,0,88576,15,846434022
2314,16628270,7937935,24566205,7,0,1,4096,10,10494807637
2315,16636490,7931021,24567511,3,0,1,2048,17,1209207288
2316,16641340,7969796,24611136,7,0,1,10240,10,7175153022
2317,16650680,8151963,24802643,6,0,1,163328,7,1055001656
2318,16660730,8141936,24802666,3,0,1,3584,17,633150391
2319,16667940,587305,17255245,8,0,0,36352,8,4633265670
2320,16672640,283576,16956216,2,0,0,512,3,5357242754
2321,16673050,8129639,24802689,7,0,1,2560,10,5176930170
2322,16686250,8116462,24802712,2,0,1,2560,3,4471430911
2323,16708430,999616,17708046,2,0,0,2048,3,4001402582
2324,16715880,8131703,24847583,7,0,1,1536,10,9319114845
2325,16722700,314556,17037256,4,0,0,2048,15,3131106637
2326,16737120,8110486,24847606,3,0,1,7168,17,5868110609
2327,16742490,8105139,24847629,3,0,1,2560,17,5805568591
2328,16751350,933345,17684695,5,0,0,128512,10,7701758124
2329,16753820,8093832,24847652,7,0,1,7168,10,2127880773
2330,16763520,8084155,24847675,7,0,1,5120,10,1124500609
2331,16765310,271307,17036617,2,0,0,1024,3,316944824
2332,16777670,283944,17061614,2,0,0,512,3,10525578904
2333,16781640,8108833,24890473,3,0,1,4608,17,7900912747
2334,16782670,8107858,24890528,6,0,1,27648,7,2382440361
2335,16784880,433570,17218450,5,0,0,34304,10,1814457825
2336,16788020,8102531,24890551,3,0,1,9728,17,6206628278
2337,16795380,568551,17363931,2,0,0,512,3,1443907571
2338,16813670,1347732,18161402,4,0,0,61440,15,1462411449
2339,16817961,8072613,24890574,5,0,1,11776,10,3441387980
2340,16826490,960813,17787303,5,0,0,12800,10,2111141818
2341,16828010,618713,17446723,5,0,0,1024,10,2740486944
2342,16843880,1067381,17911261,8,0,0,41984,8,4481668232
2343,16847260,200673,17047933,5,0,0,3584,10,4683931724
2344,16850640,8061306,24911946,6,0,1,34816,7,464342186
2345,16862390,8063847,24926237,6,0,1,39424,7,4242493309
2346,16880700,552441,17433141,8,0,0,13824,8,8223636999
2347,16886230,8040353,24926583,3,0,1,512,17,4879593400
2348,16894700,1409037,18303737,5,0,0,77312,10,7705641810
2349,16907750,8020139,24927889,7,0,1,2048,10,6439663081
2350,16943640,7987795,24931435,3,0,1,5632,17,8365149168
2351,16948900,7988129,24937029,3,0,1,18432,17,2252873330
2352,16952801,7999864,24952665,6,0,1,15872,7,9639502017
2353,16960260,7992751,24953011,3,0,1,512,17,8961085194
2354,16963570,293250,17256820,4,0,0,5120,15,2646101137
2355,17005890,933529,17939419,4,0,0,12288,15,7918557653
2356,17006120,581675,17587795,5,0,0,88576,10,6800499368
2357,17006390,919907,17926297,2,0,0,512,3,4144778946
2358,17014150,204950,17219100,5,0,0,1536,10,8134780158
2359,17017540,543049,17560589,5,0,0,26624,10,394199611
2360,17019691,7934626,24954317,6,0,1,2048,7,4888600753
2361,17029810,7925173,24954983,3,0,1,1024,17,112650006
2362,17031590,463165,17494755,4,0,0,12800,15,5927689669
2363,17031730,7939320,24971050,6,0,1,52736,7,108255569
2364,17040290,7939993,24980283,7,0,1,512,10,7849092425
2365,17040470,989026,18029496,8,0,0,84992,8,7697590013
2366,17041121,7940468,24981589,5,0,1,2048,10,675220497
2367,17042490,757932,17800422,5,0,0,43008,10,3763358261
2368,17042910,7960469,25003379,7,0,1,39424,10,4116654914
2369,17053950,1131091,18185041,4,0,0,47104,15,2407378606
2370,17061460,7954322,25015782,2,0,1,19456,3,2636877448
2371,17064161,7963615,25027776,5,0,1,1024,10,2758833313
2372,17065321,7962814,25028135,5,0,1,9728,10,7689858336
2373,17070020,420820,17490840,4,0,0,29184,15,7774904143
2374,17070210,7967566,25037776,7,0,1,24576,10,5619203137
2375,17070481,8008944,25079425,5,0,1,8704,10,4550397139
2376,17084470,7994978,25079448,3,0,1,1536,17,2175561058
2377,17084540,7994931,25079471,7,0,1,1024,10,4378252679
2378,17094970,8127706,25222676,6,0,1,171008,7,7007594948
2379,17099990,607409,17707399,2,0,0,1024,3,7852331712
2380,17100990,489660,17590650,8,0,0,9216,8,375167605
2381,17101440,8126098,25227538,7,0,1,6144,10,3287756453
2382,17110710,268193,17378903,2,0,0,1024,3,1899134802
2383,17110990,8126150,25237140,3,0,1,6144,17,4427677853
2384,17111180,449596,17560776,2,0,0,512,3,10669655245
2385,17114280,8124166,25238446,7,0,1,2048,10,6567655380
2386,17115990,8127602,25243592,7,0,1,8192,10,6147677806
2387,17120870,586202,17707072,8,0,0,66048,8,10406600238
2388,17126100,8118798,25244898,3,0,1,2048,17,121286022
2389,17152790,773150,17925940,8,0,0,48128,8,6818926048
2390,17156580,739371,17895951,2,0,0,1024,3,8521792111
2391,17160701,8084453,25245154,5,0,1,9216,10,5486535435
2392,17161710,8103565,25265275,6,0,1,17920,7,6066750398
2393,17164010,571622,17735632,8,0,0,11776,8,5155703695
2394,17178000,8091781,25269781,3,0,1,7168,17,5981546550
2395,17180789,8142314,25323103,4,0,1,43520,15,4927690808
2396,17185990,8140019,25326009,3,0,1,4608,17,2880843553
2397,17186680,328237,17514917,2,0,0,512,3,7055710600
2398,17195829,8130846,25326675,4,0,1,1024,15,4362444552
2399,17197600,895778,18093378,8,0,0,71680,8,7806645264
2400,17199019,8326387,25525406,4,0,1,156160,15,6282891189
2401,17200261,8332446,25532707,5,0,1,5632,10,2951048918
2402,17209350,8323380,25532730,9,0,1,2560,12,5329802143
2403,17210790,1003936,18214726,8,0,0,97280,8,9145457153
2404,17215520,8483128,25698648,6,0,1,113664,7,2371085861
2405,17215710,547481,17763191,2,0,0,512,3,198062449
2406,17215840,567540,17783380,4,0,0,19456,15,8878684665
2407,17219220,1431059,18650279,4,0,0,2560,15,4991121366
2408,17219550,374110,17593660,2,0,0,2048,3,7328404459
2409,17228470,1177170,18405640,8,0,0,37888,8,4835315363
2410,17249531,8450423,25699954,5,0,1,2048,10,1737489593
2411,17251790,1245641,18497431,8,0,0,44544,8,5995357359
2412,17254769,8504937,25759706,4,0,1,11264,15,9623235342
2413,17263860,8566392,25830252,6,0,1,90112,7,7310817058
2414,17268511,8615963,25884474,6,0,1,7680,7,4721934204
2415,17274910,1098511,18373421,4,0,0,11264,15,9317075641
2416,17276289,8645642,25921931,4,0,1,44032,15,3426381221
2417,17276771,8669004,25945775,5,0,1,1024,10,1128714666
2418,17296319,8711797,26008116,4,0,1,51712,15,6463874957
2419,17311790,332445,17644235,2,0,0,512,3,6864576372
2420,17315820,8723005,26038825,6,0,1,20480,7,5556550190
2421,17317779,8739766,26057545,4,0,1,6656,15,10554477511
2422,17341950,661527,18003477,8,0,0,35328,8,575941179
2423,17354280,263729,17618009,8,0,0,1024,8,2359589198
2424,17356080,498939,17855019,5,0,0,3072,10,232372719
2425,17360220,326697,17686917,8,0,0,6656,8,1250753800
2426,17381220,926588,18307808,4,0,0,13312,15,9467969242
2427,17382491,8676360,26058851,5,0,1,2048,10,488590175
2428,17393851,8669695,26063546,5,0,1,1536,10,30192667
2429,17399250,358079,17757329,5,0,0,53248,10,1830271803
2430,17409430,761244,18170674,5,0,0,28160,10,5354922103
2431,17410120,727019,18137139,8,0,0,74240,8,9662401005
2432,17410609,8653283,26063892,4,0,1,512,15,4026635257
2433,17411280,349496,17760776,8,0,0,11264,8,10473685354
2434,17418961,8645597,26064558,5,0,1,11264,10,8694387032
2435,17421620,1138085,18559705,2,0,0,512,3,6705384417
2436,17423599,8747348,26170947,4,0,1,108032,15,4810700394
2437,17426170,614048,18040218,5,0,0,33792,10,834748969
2438,17427149,8810959,26238108,4,0,1,72192,15,5100114920
2439,17446901,8792513,26239414,5,0,1,2048,10,6468932465
2440,17458410,437206,17895616,5,0,0,23040,10,4379545440
2441,17467760,627241,18095001,8,0,0,5120,8,7588151037
2442,17475850,590364,18066214,2,0,0,1024,3,10683956214
2443,17481829,8758251,26240080,4,0,1,1024,15,5734362597
2444,17487730,727487,18215217,2,0,0,1536,3,3129106460
2445,17489890,398691,17888581,5,0,0,6144,10,10443034024
2446,17500710,8750217,26250927,6,0,1,3072,7,924687965
2447,17503190,658391,18161581,2,0,0,512,3,4325162989
2448,17530021,8748853,26278874,6,0,1,15872,7,4057343231
2449,17533740,1179136,18712876,5,0,0,30720,10,7857129404
2450,17543220,165372,17708592,2,0,0,1024,3,4944659914
2451,17545241,8733656,26278897,5,0,1,10240,10,2405692074
2452,17545941,8732979,26278920,6,0,1,5632,7,9524049869
2453,17566721,8712230,26278951,6,0,1,1536,7,9059401753
2454,17568220,969497,18537717,4,0,0,131584,15,7816923752
2455,17573639,8705335,26278974,4,0,1,20480,15,9851963245
2456,17574380,134422,17708802,2,0,0,512,3,2511704372
2457,17615601,8679220,26294821,5,0,1,5632,10,8464614769
2458,17642280,283831,17926111,2,0,0,512,3,7682713741
2459,17642980,581775,18224755,5,0,0,18944,10,1598177221
2460,17654330,8640514,26294844,2,0,1,3072,3,8576577057
2461,17661081,8658360,26319441,6,0,1,12288,7,10235803953
2462,17664790,8664155,26328945,2,0,1,3072,3,4606305080
2463,17673390,370439,18043829,4,0,0,11776,15,5354577965
2464,17680841,8648450,26329291,5,0,1,512,10,5483013485
2465,17682091,8648506,26330597,6,0,1,2048,7,3011768724
2466,17700760,579383,18280143,4,0,0,92672,15,8053571172
2467,17702399,8697356,26399755,4,0,1,64512,15,1410783463
2468,17709740,1242736,18952476,4,0,0,16896,15,1232174552
2469,17715140,314527,18029667,2,0,0,512,3,856194357
2470,17720611,8679490,26400101,6,0,1,512,7,9380997849
2471,17723630,419029,18142659,4,0,0,17920,15,10550597783
2472,17737870,889023,18626893,4,0,0,65024,15,9175498302
2473,17747121,8656232,26403353,6,0,1,5120,7,2931180887
2474,17756171,8649128,26405299,6,0,1,3072,7,9427039088
2475,17765340,278676,18044016,2,0,0,512,3,9820465314
2476,17774710,323438,18098148,2,0,0,512,3,1782588747
2477,17777270,652358,18429628,8,0,0,10752,8,8354621925
2478,17777860,1455122,19232982,2,0,0,1536,3,10649457368
2479,17799010,230866,18029876,2,0,0,512,3,2220116624
2480,17813960,745542,18559502,8,0,0,71168,8,2024287085
2481,17848010,314054,18162064,2,0,0,1536,3,8075481962
2482,17886190,763198,18649388,4,0,0,15872,15,5726652526
2483,17898100,8507865,26405965,2,0,1,1024,3,3558441882
2484,17958950,499625,18458575,4,0,0,78336,15,6648061537
2485,17972010,438209,18410219,2,0,0,512,3,8813994135
2486,17978190,1480191,19458381,4,0,0,145920,15,1397591278
2487,17986320,573564,18559884,2,0,0,512,3,6187337418
2488,17986400,1358549,19344949,4,0,0,13824,15,10085511859
2489,17988760,655665,18644425,5,0,0,2048,10,8952022027
2490,17989580,364855,18354435,2,0,0,1536,3,5175946847
2491,17992700,8415531,26408231,7,0,1,3584,10,3949939352
2492,17995640,845170,18840810,5,0,0,90112,10,3341969317
2493,18015081,8397362,26412443,6,0,1,6656,7,1811959925
2494,18016000,323985,18339985,8,0,0,17920,8,3437445303
2495,18028440,746547,18774987,4,0,0,36352,15,9453086324
2496,18031851,8382218,26414069,6,0,1,2560,7,6060573745
2497,18037280,531554,18568834,8,0,0,12800,8,4231358450
2498,18039660,8375715,26415375,7,0,1,2048,10,862397508
2499,18041071,8374970,26416041,5,0,1,1024,10,7338701529
2500,18043860,326114,18369974,4,0,0,17408,15,2740769674
2501,18048190,284807,18332997,4,0,0,23040,15,6493081680
2502,18061750,681017,18742767,4,0,0,6656,15,92584280
2503,18072031,8344996,26417027,5,0,1,1536,10,1768609104
2504,18073141,8345192,26418333,5,0,1,2048,10,2306047379
2505,18083340,379018,18462358,4,0,0,12288,15,10462942220
2506,18083720,488357,18572077,8,0,0,1536,8,5844051979
2507,18084370,8335269,26419639,7,0,1,2048,10,4531807144
2508,18087641,8340933,26428574,6,0,1,23040,7,9015417146
2509,18092291,8368014,26460305,5,0,1,4608,10,9293008982
2510,18093821,8366507,26460328,5,0,1,512,10,9333706508
2511,18097860,117629,18215489,2,0,0,512,3,5208098998
2512,18135130,362472,18497602,2,0,0,512,3,4251000785
2513,18135680,705613,18841293,2,0,0,1536,3,634610277
2514,18157920,485851,18643771,4,0,0,55296,15,10348168169
2515,18173081,8287270,26460351,5,0,1,13312,10,5957319319
2516,18174260,199644,18373904,2,0,0,1536,3,3595013346
2517,18178450,634181,18812631,2,0,0,512,3,7157336157
2518,18184270,628166,18812436,5,0,0,44544,10,7137464139
2519,18189260,8275379,26464639,7,0,1,1536,10,5787777996
2520,18195610,8270655,26466265,7,0,1,2560,10,6322489956
2521,18200620,8267271,26467891,7,0,1,2560,10,472461234
2522,18207540,533184,18740724,4,0,0,45056,15,10302128247
2523,18211711,8257051,26468762,5,0,1,12288,10,4452386163
2524,18236730,8235189,26471919,7,0,1,1024,10,3411825517
2525,18257201,8216549,26473750,5,0,1,15872,10,1344374562
2526,18274240,889007,19163247,6,0,0,49152,7,9470057279
2527,18279910,803948,19083858,4,0,0,53760,15,7172513146
2528,18282190,638267,18920457,2,0,0,15872,3,8842204910
2529,18291430,8182884,26474314,2,0,1,10752,3,9653450629
2530,18294740,304783,18599523,4,0,0,7168,15,10341470296
2531,18329850,451604,18781454,2,0,0,20992,3,1549598526
2532,18335280,460858,18796138,5,0,0,25600,10,7599533228
2533,18348580,8145185,26493765,2,0,1,1024,3,3872774125
2534,18355210,369778,18724988,2,0,0,4608,3,2282206122
2535,18371100,564854,18935954,5,0,0,50688,10,2111499438
2536,18382931,8112140,26495071,5,0,1,2048,10,8249665965
2537,18386270,8136205,26522475,2,0,1,18944,3,7333862876
2538,18388711,8136030,26524741,5,0,1,3584,10,1652546614
2539,18396200,519406,18915606,4,0,0,59392,15,5311637097
2540,18400260,880111,19280371,4,0,0,50176,15,8070802292
2541,18407480,270084,18677564,5,0,0,7680,10,9590133261
2542,18425810,8113308,26539118,9,0,1,5120,12,9356440957
2543,18426630,8113794,26540424,2,0,1,2048,3,10279288753
2544,18432180,534327,18966507,4,0,0,17408,15,6774015059
2545,18435620,8108350,26543970,2,0,1,5632,3,10309455484
2546,18439910,8105686,26545596,2,0,1,2560,3,380449152
2547,18442330,8147706,26590036,9,0,1,12800,12,7726823438
2548,18452450,1040246,19492696,8,0,0,9216,8,3997365209
2549,18465710,727691,19193401,2,0,0,81920,3,7323249362
2550,18477760,814697,19292457,6,0,0,38912,7,2953524036
2551,18487270,458534,18945804,2,0,0,6144,3,7086453654
2552,18497000,463489,18960489,2,0,0,2560,3,4743141898
2553,18499320,1160359,19659679,2,0,0,136704,3,2508735957
2554,18500520,8089539,26590059,2,0,1,2048,3,4458547868
2555,18512220,8086332,26598552,3,0,1,17920,17,6980406848
2556,18526270,8072305,26598575,8,0,1,4096,8,5835564052
2557,18527670,8071107,26598777,3,0,1,7168,17,9214412221
2558,18528620,149271,18677891,5,0,0,1024,10,3490600992
2559,18551681,8069702,26621383,8,0,1,5120,8,7197053212
2560,18569461,8051945,26621406,5,0,1,1536,10,4542020290
2561,18576210,1125012,19701222,4,0,0,2560,15,1535730923
2562,18585340,8232803,26818143,3,0,1,140288,17,1244920602
2563,18590110,1091153,19681263,4,0,0,50688,15,2962645068
2564,18593290,8294160,26887450,3,0,1,87552,17,9164163541
2565,18597610,8290042,26887652,9,0,1,3584,12,9854361850
2566,18597720,8317345,26915065,2,0,1,2048,3,4133105078
2567,18607770,8339604,26947374,9,0,1,4096,12,314224795
2568,18608090,8339307,26947397,2,0,1,3072,3,2591489630
2569,18610070,8408450,27018520,3,0,1,88064,17,10089921534
2570,18618110,8408396,27026506,3,0,1,18944,17,9218057853
2571,18618821,8421661,27040482,5,0,1,2560,10,10660000586
2572,18628610,8412218,27040828,7,0,1,512,10,7537831984
2573,18630110,585052,19215162,5,0,0,4608,10,3172498078
2574,18631011,8412723,27043734,5,0,1,4608,10,3686783800
2575,18639940,8404153,27044093,9,0,1,9728,12,2094075370
2576,18641271,8405026,27046297,5,0,1,3072,10,6779398210
2577,18646320,8490108,27136428,3,0,1,83968,17,1361853959
2578,18650590,8485861,27136451,7,0,1,10240,10,357722840
2579,18653491,8515602,27169093,5,0,1,15360,10,10128787209
2580,18654980,8514136,27169116,2,0,1,9216,3,4693134585
2581,18655000,8523246,27178246,9,0,1,9216,12,4822002412
2582,18664500,8542319,27206819,7,0,1,9728,10,6066542363
2583,18669920,8545669,27215589,3,0,1,4608,17,2782228822
2584,18670790,1132472,19803262,5,0,0,40448,10,1371753340
2585,18671991,8545333,27217324,5,0,1,3584,10,445999614
2586,18673260,933523,19606783,8,0,0,120320,8,8772388756
2587,18684900,1326730,20011630,5,0,0,209920,10,7978706869
2588,18686961,8578762,27265723,5,0,1,1536,10,6725407556
2589,18689941,8578048,27267989,5,0,1,3584,10,9192523010
2590,18697250,8571085,27268335,7,0,1,512,10,6001453725
2591,18700451,8571110,27271561,8,0,1,5120,8,2093992941
2592,18702440,1164950,19867390,2,0,0,91648,3,4724624962
2593,18710030,8563797,27273827,9,0,1,3584,12,6288189050
2594,18710620,8563553,27274173,9,0,1,512,12,9106913
2595,18711830,825974,19537804,4,0,0,31232,15,143075272
2596,18719350,665264,19384614,5,0,0,29184,10,8750519641
2597,18722071,8562113,27284184,8,0,1,34816,8,8155098047
2598,18722630,1175927,19898557,4,0,0,46592,15,7447734445
2599,18735660,8555922,27291582,7,0,1,1536,10,10172406241
2600,18744481,8560803,27305284,8,0,1,1536,8,5767528216
2601,18745750,793941,19539691,4,0,0,6144,15,5984205909
2602,18760240,8546990,27307230,3,0,1,3072,17,5761151141
2603,18765900,402518,19168418,4,0,0,16896,15,4958885654
2604,18766180,8565408,27331588,7,0,1,19968,10,2848587490
2605,18778480,8554472,27332952,7,0,1,2048,10,7455466948
2606,18784950,8548815,27333765,9,0,1,12288,12,914021375
2607,18786280,8587325,27373605,7,0,1,4096,10,2960131837
2608,18790740,1355497,20146237,5,0,0,6656,10,4041920226
2609,18792290,8581338,27373628,7,0,1,2048,10,6030066841
2610,18800180,8729980,27530160,3,0,1,89088,17,8276910651
2611,18804070,8726113,27530183,8,0,1,7680,8,6251253027
2612,18809160,1109581,19918741,4,0,0,27136,15,6145722060
2613,18810140,338116,19148256,5,0,0,22016,10,3922520987
2614,18828730,741378,19570108,4,0,0,23552,15,8647747943
2615,18830160,1223815,20053975,2,0,0,58368,3,4585852761
2616,18832710,8701487,27534197,8,0,1,5632,8,7638045711
2617,18836780,8717954,27554734,9,0,1,9216,12,8202508601
2618,18841790,629413,19471203,5,0,0,27136,10,6686342355
2619,18848360,8706397,27554757,9,0,1,3584,12,7528637403
2620,18861140,839279,19700419,6,0,0,50176,7,3336468280
2621,18862080,923161,19785241,4,0,0,37888,15,3042807399
2622,18867140,8687640,27554780,9,0,1,6656,12,5659526737
2623,18869190,8690231,27559421,3,0,1,8192,17,1239634487
2624,18871451,8692476,27563927,5,0,1,7168,10,4278595236
2625,18874200,434745,19308945,2,0,0,8704,3,10267287914
2626,18882100,8686048,27568148,7,0,1,512,10,4397471298
2627,18883321,8689013,27572334,5,0,1,6656,10,6088219479
2628,18895670,8677650,27573320,9,0,1,1536,12,2915476515
2629,18905881,8747187,27653068,5,0,1,7680,10,8566303634
2630,18911530,8746684,27658214,7,0,1,8192,10,8340275766
2631,18921210,8738630,27659840,8,0,1,2560,8,9620922648
2632,18923610,1233732,20157342,2,0,0,34816,3,7491249139
2633,18930950,395506,19326456,4,0,0,15872,15,8460342416
2634,18939710,775619,19715329,4,0,0,12288,15,3598595147
2635,18947221,8712965,27660186,5,0,1,512,10,5020814119
2636,18947661,8714151,27661812,6,0,1,2560,7,2235642418
2637,18950760,8749030,27699790,7,0,1,7168,10,8484461330
2638,18955850,8743963,27699813,9,0,1,2048,12,7755017147
2639,18958470,1371626,20330096,2,0,0,101888,3,10613665181
2640,18966580,8733256,27699836,3,0,1,8704,17,7179167940
2641,18968050,8825215,27793265,3,0,1,33280,17,2206810185
2642,18969000,493920,19462920,8,0,0,14848,8,4777774438
2643,18973580,1288950,20262530,5,0,0,66048,10,2080515750
2644,18979160,1136299,20115459,8,0,0,85504,8,10271444508
2645,18992870,8875236,27868106,3,0,1,19968,17,5845579706
2646,19013260,8854869,27868129,9,0,1,2560,12,7054943729
2647,19018150,8853569,27871719,9,0,1,6656,12,3503672260
2648,19030450,800397,19830847,8,0,0,7168,8,1752903546
2649,19032920,306655,19339575,4,0,0,43008,15,1040813821
2650,19039700,1032347,20072047,5,0,0,33280,10,6215536323
2651,19046280,779937,19826217,5,0,0,75264,10,3646188306
2652,19050320,8821745,27872065,8,0,1,512,8,2240580727
2653,19064810,8857954,27922764,3,0,1,26112,17,3138949980
2654,19087320,432025,19519345,2,0,0,16896,3,8127516137
2655,19093020,8933688,28026708,3,0,1,105472,17,6410836285
2656,19121920,8904811,28026731,8,0,1,512,8,1076810479
2657,19123990,358646,19482636,5,0,0,37376,10,1107530808
2658,19131320,8895434,28026754,9,0,1,3584,12,7014163078
2659,19137430,898738,20036168,5,0,0,35840,10,4215704632
2660,19138990,8887787,28026777,8,0,1,4608,8,5052054059
2661,19140010,8886790,28026800,9,0,1,512,12,8071994581
2662,19152399,9106121,28258520,4,0,1,217088,15,9465460047
2663,19158029,9124580,28282609,4,0,1,24064,15,829197241
2664,19164600,9125244,28289844,8,0,1,4096,8,7439914026
2665,19170390,491100,19661490,8,0,0,5632,8,5206525085
2666,19175050,850175,20025225,8,0,0,44544,8,3411483183
2667,19181460,9110650,28292110,9,0,1,3584,12,2658143580
2668,19186300,601772,19788072,5,0,0,9216,10,8102946068
2669,19193930,734729,19928659,2,0,0,512,3,4291477346
2670,19196320,860361,20056681,8,0,0,8704,8,5129980319
2671,19197469,9258339,28455808,4,0,1,154624,15,10102797092
2672,19200850,9289549,28490399,9,0,1,512,12,6872855671
2673,19213101,9277321,28490422,5,0,1,12800,10,6970323116
2674,19213790,1317112,20530902,5,0,0,51712,10,3808397993
2675,19215390,9500698,28716088,3,0,1,116224,17,8350479475
2676,19216050,9506939,28722989,9,0,1,512,12,5787251398
2677,19216260,399948,19616208,2,0,0,512,3,6400121053
2678,19224741,9498594,28723335,5,0,1,512,10,8503695751
2679,19225339,9582056,28807395,4,0,1,76800,15,6977875479
2680,19234500,9623163,28857663,3,0,1,42496,17,3391737511
2681,19242470,953277,20195747,5,0,0,75264,10,2609461405
2682,19246020,9618763,28864783,8,0,1,3584,8,8488702443
2683,19248530,9620292,28868822,8,0,1,5120,8,7961782432
2684,19252199,9672752,28924951,4,0,1,74240,15,1301263093
2685,19257761,9670096,28927857,5,0,1,4608,10,1244120273
2686,19259320,9670483,28929803,9,0,1,3072,12,6675932073
2687,19261261,9671794,28933055,5,0,1,5120,10,2148066332
2688,19264140,9827661,29091801,3,0,1,114176,17,6327790482
2689,19264950,9826874,29091824,3,0,1,10240,17,4870495699
2690,19265940,9870592,29136532,3,0,1,34304,17,6568374032
2691,19266151,9870404,29136555,5,0,1,1024,10,249656610
2692,19272070,9864508,29136578,8,0,1,3072,8,543791596
2693,19274919,10012792,29287711,4,0,1,146432,15,1745727940
2694,19282900,10010900,29293800,9,0,1,5632,12,6297869686
2695,19312000,884550,20196550,8,0,0,2560,8,8160957828
2696,19323489,10004884,29328373,4,0,1,30208,15,4635498627
2697,19323970,10005389,29329359,9,0,1,1536,12,7924641283
2698,19327780,10008274,29336054,9,0,1,3584,12,1441044086
2699,19336530,531195,19867725,2,0,0,1024,3,1033455079
2700,19336551,10000587,29337138,5,0,1,4096,10,6954592662
2701,19343771,9997272,29341043,5,0,1,15360,10,6872954346
2702,19345410,9995992,29341402,2,0,1,9728,3,5250773920
2703,19375760,9972195,29347955,9,0,1,4096,12,1172624928
2704,19376140,335045,19711185,2,0,0,512,3,9508690744
2705,19380419,10031475,29411894,4,0,1,77824,15,2906627999
2706,19382370,1300487,20682857,8,0,0,12800,8,8246688192
2707,19391320,1018666,20409986,4,0,0,131072,15,684311758
2708,19399651,10012266,29411917,5,0,1,512,10,997861629
2709,19406381,10005559,29411940,6,0,1,512,7,222883455
2710,19415240,9996723,29411963,2,0,1,2560,3,2334116859
2711,19420741,9991245,29411986,6,0,1,3584,7,3281632053
2712,19421459,1090209,20511668,3,0,0,156160,17,5648035297
2713,19422970,9989039,29412009,9,0,1,1536,12,10274764509
2714,19439670,622198,20061868,5,0,0,16896,10,5155492891
2715,19441830,702356,20144186,4,0,0,94208,15,10027006184
2716,19448970,628678,20077648,5,0,0,3584,10,811845118
2717,19449910,9962122,29412032,9,0,1,2560,12,5469072425
2718,19455521,9956534,29412055,5,0,1,512,10,4926441132
2719,19457541,9954537,29412078,5,0,1,512,10,10568156033
2720,19461700,9950401,29412101,8,0,1,5632,8,9683935807
2721,19468760,1063881,20532641,4,0,0,5632,15,7083736038
2722,19468860,400960,19869820,2,0,0,1024,3,7217196810
2723,19476810,9950728,29427538,8,0,1,19968,8,3576370569
2724,19487460,9943206,29430666,8,0,1,21504,8,7495291500
2725,19494680,9947974,29442654,9,0,1,2048,12,1576640996
2726,19506531,9959226,29465757,5,0,1,10752,10,4172954795
2727,19509340,9960283,29469623,2,0,1,6144,3,5478609897
2728,19509670,9960299,29469969,9,0,1,512,12,335729087
2729,19510811,9961348,29472159,6,0,1,13312,7,8805812103
2730,19512369,9987244,29499613,4,0,1,23552,15,10444329094
2731,19521130,9988536,29509666,8,0,1,15872,8,7516405001
2732,19525440,9984249,29509689,0,0,1,3584,3,9657444066
2733,19529059,9980685,29509744,4,0,1,25088,15,10094930729
2734,19530440,9979351,29509791,8,0,1,1536,8,8779876213
2735,19542250,9973560,29515810,3,0,1,12288,17,6144196928
2736,19553980,9966336,29520316,9,0,1,7168,12,2431368124
2737,19558311,9969044,29527355,5,0,1,2048,10,2328912130
2738,19561990,9966133,29528123,2,0,1,11776,3,10222999362
2739,19564610,9994420,29559030,8,0,1,1536,8,9481591802
2740,19577840,293468,19871308,5,0,0,2560,10,8855875563
2741,19577870,10006304,29584174,0,0,1,4096,3,681846044
2742,19580320,10009396,29589716,9,0,1,512,12,211199275
2743,19584611,10006411,29591022,5,0,1,2048,10,5462714897
2744,19586390,10004978,29591368,9,0,1,512,12,2939078669
2745,19587010,10006624,29593634,0,0,1,3584,3,5419185703
2746,19587150,311742,19898892,2,0,0,1024,3,7924793072
2747,19588160,10006460,29594620,9,0,1,1536,12,9557910373
2748,19596489,10030535,29627024,4,0,1,40448,15,4168291416
2749,19653050,493592,20146642,2,0,0,1024,3,4026877559
2750,19674350,9953020,29627370,0,0,1,512,3,3987661436
2751,19697190,9931051,29628241,0,0,1,12288,3,1981737013
2752,19701739,9961375,29663114,4,0,1,37888,15,6786634918
2753,19706380,9958040,29664420,8,0,1,2048,8,5690211998
2754,19706710,9961258,29667968,9,0,1,1024,12,1403507631
2755,19708500,464153,20172653,5,0,0,50176,10,5896922082
2756,19711360,1058483,20769843,8,0,0,116736,8,10226164185
2757,19731130,9940485,29671615,0,0,1,1536,3,9362805644
2758,19736321,9935640,29671961,6,0,1,512,7,6711395246
2759,19736541,9942052,29678593,5,0,1,28160,10,3774792363
2760,19736779,9943402,29680181,4,0,1,15872,15,9686219886
2761,19743900,9947441,29691341,2,0,1,2560,3,655215465
2762,19749940,9951775,29701715,2,0,1,4096,3,6902640489
2763,19750121,9952580,29702701,5,0,1,1536,10,6843690102
2764,19752961,9950406,29703367,5,0,1,1024,10,1866916744
2765,19765770,9939543,29705313,9,0,1,3072,12,3830430424
2766,19799510,9909029,29708539,8,0,1,5120,8,9793660398
2767,19805181,9908210,29713391,6,0,1,7680,7,3204273433
2768,19806769,9921184,29727953,4,0,1,55296,15,3420547178
2769,19819440,9912467,29731907,9,0,1,512,12,3757503353
2770,19827419,10016512,29843931,4,0,1,86528,15,2801635876
2771,19827701,10024585,29852286,5,0,1,1536,10,8537455452
2772,19829040,10023912,29852952,2,0,1,1024,3,10705998127
2773,19831440,10023458,29854898,0,0,1,3072,3,3979215669
2774,19838710,10017174,29855884,2,0,1,1536,3,10221072467
2775,19853150,10004040,29857190,0,0,1,2048,3,1534996674
2776,19863910,775175,20639085,5,0,0,147456,10,5903891871
2777,19874960,859292,20734252,8,0,0,114688,8,6779259629
2778,19875930,534703,20410633,2,0,0,2048,3,8477466458
2779,19878240,9983456,29861696,8,0,1,7168,8,5062945026
2780,19892531,9969831,29862362,5,0,1,1024,10,1889836950
2781,19896060,524806,20420866,5,0,0,1536,10,10187498583
2782,19901550,927342,20828892,8,0,0,23552,8,1120785639
2783,19902140,750384,20652524,5,0,0,44032,10,3441427808
2784,19910841,9952827,29863668,6,0,1,2048,7,775027652
2785,19912210,9951817,29864027,7,0,1,9728,10,6210609593
2786,19939769,9934368,29874137,4,0,1,27136,15,1165665739
2787,19943040,9950058,29893098,1,0,1,5632,10,7101270080
2788,19949530,9944874,29894404,2,0,1,2048,3,7607537112
2789,19954440,9943190,29897630,2,0,1,5120,3,34557333
2790,19954620,9945276,29899896,5,0,1,3584,10,6477856181
2791,19955969,839862,20795831,3,0,0,61440,17,418739504
2792,19960079,458065,20418144,3,0,0,24576,17,1392919608
2793,19962890,840873,20803763,5,0,0,24064,10,1670294975
2794,19963029,552094,20515123,3,0,0,11264,17,5397614961
2795,19963450,456917,20420367,8,0,0,7168,8,2710832719
2796,19970290,9948422,29918712,3,0,1,31744,17,5402011725
2797,19977410,9957350,29934760,0,0,1,4096,3,2091995806
2798,19983629,1015124,20998753,3,0,0,123904,17,3643386245
2799,19988050,593465,20581515,5,0,0,9216,10,239863432
2800,19999640,674747,20674387,5,0,0,71680,10,6355048456
2801,20021700,661694,20683394,8,0,0,1024,8,9843353772
2802,20023309,9917464,29940773,4,0,1,24576,15,755198177
2803,20042550,9938036,29980586,1,0,1,20480,10,3809278977
2804,20054010,9927242,29981252,8,0,1,1024,8,5483989793
2805,20058100,9923498,29981598,8,0,1,512,8,8847030228
2806,20067169,9946312,30013481,4,0,1,10752,15,487203692
2807,20067319,611615,20678934,3,0,0,14848,17,6439806739
2808,20074579,9963713,30038292,4,0,1,29696,15,2361277411
2809,20077530,10077977,30155507,1,0,1,7680,10,2487087122
2810,20087779,689309,20777088,3,0,0,10752,17,3669893486
2811,20088129,10359203,30447332,4,0,1,102912,15,9371692881
2812,20089700,10420760,30510460,3,0,1,25600,17,7144164644
2813,20093699,10424541,30518240,4,0,1,6144,15,1215839950
2814,20099260,754862,20854122,5,0,0,36352,10,4572069703
2815,20099740,10419806,30519546,8,0,1,2048,8,3862859204
2816,20100430,582606,20683036,2,0,0,512,3,4165493916
2817,20105509,785106,20890615,3,0,0,32256,17,10650048235
2818,20108400,10446196,30554596,1,0,1,4096,10,7824446037
2819,20126841,10428421,30555262,5,0,1,1024,10,2133119310
2820,20135639,638150,20773789,3,0,0,12800,17,2779922591
2821,20145910,10410735,30556645,0,0,1,14848,3,1887808651
2822,20147920,648456,20796376,8,0,0,1536,8,10669973038
2823,20153230,772289,20925519,5,0,0,23552,10,6324127249
2824,20154891,10408326,30563217,6,0,1,5632,7,1554622241
2825,20159521,10406930,30566451,6,0,1,9216,7,7891462658
2826,20159959,847131,21007090,3,0,0,27136,17,614219542
2827,20167139,785581,20952720,3,0,0,11776,17,8140828620
2828,20176529,928431,21104960,3,0,0,39936,17,9685789647
2829,20181411,10399787,30581198,6,0,1,4608,7,3298675874
2830,20182829,10398728,30581557,4,0,1,9728,15,8504585847
2831,20183160,10427910,30611070,1,0,1,13824,10,898877802
2832,20183710,10427383,30611093,8,0,1,5120,8,5191557759
2833,20184100,10436434,30620534,1,0,1,4096,10,8718768603
2834,20202509,10475962,30678471,4,0,1,62464,15,2913192926
2835,20203330,1161887,21365217,5,0,0,170496,10,2383439364
2836,20211280,10496257,30707537,1,0,1,3584,10,3408078304
2837,20216330,10494753,30711083,1,0,1,5632,10,9480473691
2838,20220249,1175948,21396197,3,0,0,84480,17,4481483174
2839,20236280,1160992,21397272,8,0,0,1024,8,558187546
2840,20239689,10553923,30793612,4,0,1,66048,15,6657532719
2841,20246730,10546905,30793635,0,0,1,4096,3,3062984289
2842,20254179,1013585,21267764,3,0,0,22528,17,3654547166
2843,20260440,938330,21198770,5,0,0,24064,10,9133344725
2844,20262130,10546595,30808725,0,0,1,7680,3,9447768833
2845,20265469,1140429,21405898,3,0,0,28160,17,8348155115
2846,20265859,10544812,30810671,4,0,1,3072,15,3248461454
2847,20273929,10539008,30812937,4,0,1,3584,15,10455826901
2848,20295310,10521839,30817149,0,0,1,6656,3,3042263578
2849,20301549,10569719,30871268,4,0,1,30208,15,1725186748
2850,20312740,10566157,30878897,5,0,1,10752,10,8191801496
2851,20328299,780896,21109195,3,0,0,13824,17,6061969182
2852,20334129,1036305,21370434,3,0,0,16896,17,3001309650
2853,20336910,955821,21292731,2,0,0,512,3,2969679171
2854,20337910,10544353,30882263,5,0,1,5120,10,5991847700
2855,20352599,888652,21241251,3,0,0,11776,17,6902429491
2856,20353980,10528744,30882724,5,0,1,10240,10,6392261441
2857,20355530,804900,21160430,8,0,0,1024,8,4778007766
2858,20356609,10557453,30914062,4,0,1,9728,15,6411996055
2859,20361590,895707,21257297,8,0,0,1024,8,4487650664
2860,20365730,885234,21250964,5,0,0,22016,10,10341585707
2861,20378889,10585694,30964583,4,0,1,40448,15,3502685081
2862,20381590,869553,21251143,8,0,0,512,8,2594696409
2863,20382570,10582036,30964606,9,0,1,512,12,3678334538
2864,20385480,847484,21232964,8,0,0,1024,8,9311945916
2865,20386180,1010352,21396532,2,0,0,1024,3,3794470679
2866,20394030,874381,21268411,8,0,0,2048,8,3680259375
2867,20408230,10556399,30964629,0,0,1,5120,3,10036573658
2868,20410980,10593631,31004611,0,0,1,4608,3,8718077985
2869,20438980,10634192,31073172,9,0,1,125440,12,5005288428
2870,20445500,10641765,31087265,0,0,1,8192,3,5537710016
2871,20452410,10644104,31096514,0,0,1,4096,3,2228527195
2872,20456640,10640540,31097180,5,0,1,1024,10,8877779984
2873,20463390,10635173,31098563,0,0,1,14848,3,4829792447
2874,20484530,10629531,31114061,9,0,1,23552,12,4443683552
2875,20495800,901137,21396937,8,0,0,1024,8,3247790534
2876,20501330,10616597,31117927,5,0,1,6144,10,1839321324
2877,20506390,1126800,21633190,5,0,0,29184,10,5689704003
2878,20511309,10665064,31176373,4,0,1,50688,15,6962655612
2879,20515510,10661209,31176719,5,0,1,512,10,5568153389
2880,20520230,10657155,31177385,5,0,1,1024,10,5282810276
2881,20521470,10656786,31178256,9,0,1,12288,12,2893285434
2882,20524650,10726969,31251619,9,0,1,24576,12,10442575246
2883,20533600,1141833,21675433,5,0,0,39424,10,6262038724
2884,20541630,10740784,31282414,9,0,1,34304,12,3303746768
2885,20547090,10735347,31282437,5,0,1,2048,10,3619397338
2886,20550449,1186504,21736953,3,0,0,27136,17,2367638874
2887,20553580,985575,21539155,8,0,0,1024,8,5266244398
2888,20556540,10725920,31282460,8,0,1,1536,8,1433568846
2889,20561639,10900093,31461732,4,0,1,198656,15,4767803202
2890,20568120,10895238,31463358,5,0,1,2560,10,5827664560
2891,20570330,10928145,31498475,8,0,1,2048,8,9985039468
2892,20579159,1143700,21722859,3,0,0,72192,17,1418580197
2893,20589209,1319534,21908743,3,0,0,17408,17,1980943781
2894,20590690,1137972,21728662,5,0,0,18944,10,6028122278
2895,20595700,1307716,21903416,2,0,0,512,3,10686071935
2896,20597660,10901174,31498834,9,0,1,9728,12,7935136657
2897,20600800,1282914,21883714,5,0,0,111104,10,8402052474
2898,20604040,1096800,21700840,8,0,0,1024,8,9215986841
2899,20606039,1427507,22033546,3,0,0,67072,17,10008123784
2900,20615250,1287987,21903237,5,0,0,64000,10,8622581792
2901,20615970,10897223,31513193,5,0,1,5632,10,1316702741
2902,20622959,1422014,22044973,3,0,0,37376,17,9920763745
2903,20637600,10887593,31525193,5,0,1,4096,10,9716935270
2904,20639411,10886141,31525552,5,0,1,9728,10,10548335743
2905,20643550,1299746,21943296,2,0,0,1536,3,5468387082
2906,20644949,1367647,22012596,3,0,0,75776,17,7570316606
2907,20647710,1146970,21794680,2,0,0,1536,3,10358025999
2908,20657351,10896066,31553417,5,0,1,2048,10,4825786959
2909,20657719,10965999,31623718,4,0,1,81408,15,706764571
2910,20663640,10994559,31658199,9,0,1,14336,12,5517959023
2911,20669020,11053525,31722545,9,0,1,77824,12,6803920441
2912,20670519,11077360,31747879,4,0,1,31744,15,3705232824
2913,20689210,11059975,31749185,5,0,1,2048,10,8006313381
2914,20705020,1308067,22013087,8,0,0,1536,8,6840870006
2915,20705409,11106278,31811687,4,0,1,51712,15,9799119656
2916,20709529,1257971,21967500,3,0,0,20480,17,10563999711
2917,20726691,11086051,31812742,5,0,1,1536,10,5348171922
2918,20737430,11075978,31813408,8,0,1,1024,8,6725030930
2919,20737730,1478742,22216472,5,0,0,30720,10,2378067825
2920,20748761,11064801,31813562,5,0,1,8704,10,4133423872
2921,20781070,1334944,22116014,5,0,0,18432,10,8450690299
2922,20786699,1446451,22233150,1,0,0,51200,10,484186505
2923,20787880,1445784,22233664,8,0,0,512,8,9901763357
2924,20790199,11184226,31974425,4,0,1,159232,15,10191696995
2925,20793349,1359431,22152780,1,0,0,33280,10,7562390294
2926,20798840,1317509,22116349,2,0,0,1024,3,4883834899
2927,20806970,1483737,22290707,2,0,0,1024,3,6578748591
2928,20824380,1444725,22269105,2,0,0,1536,3,8415222742
2929,20825630,11175764,32001394,1,0,1,2560,10,69964646
2930,20830089,1438525,22268614,1,0,0,36864,10,4934613451
2931,20830230,11173430,32003660,0,0,1,3584,3,377858643
2932,20836150,11169776,32005926,0,0,1,3584,3,6735203603
2933,20842810,11165702,32008512,1,0,1,4096,10,3429330152
2934,20846330,1519261,22365591,5,0,0,23040,10,9679409894
2935,20847710,1328939,22176649,8,0,0,512,8,6684292377
2936,20851740,11182157,32033897,9,0,1,26112,12,8689321616
2937,20865260,11172497,32037757,1,0,1,512,10,4954104471
2938,20878080,1539959,22418039,8,0,0,1024,8,2488214565
2939,20885910,11297899,32183809,9,0,1,136704,12,6813395417
2940,20904549,1433296,22337845,3,0,0,50688,17,9027108388
2941,20905410,1328075,22233485,8,0,0,1024,8,10380606250
2942,20906181,11277651,32183832,5,0,1,3584,10,3916088653
2943,20917670,1378190,22295860,5,0,0,11264,10,4435641164
2944,20937751,11246104,32183855,5,0,1,1536,10,8831070343
2945,20941850,11274329,32216179,9,0,1,38912,12,5010385111
2946,20949260,11278926,32228186,1,0,1,6656,10,2823304340
2947,20956120,1463569,22419689,8,0,0,512,8,6343542863
2948,20963700,11269480,32233180,9,0,1,39424,12,2628964247
2949,20969040,11347305,32316345,9,0,1,89088,12,9993580304
2950,20971701,11345630,32317331,5,0,1,1536,10,10535953054
2951,20976200,1514036,22490236,8,0,0,512,8,888492196
2952,20978480,1544139,22522619,8,0,0,1024,8,2442401785
2953,20980320,11340237,32320557,7,0,1,5120,10,2739812226
2954,20981131,11343932,32325063,5,0,1,7168,10,7149571829
2955,20996060,11329976,32326036,7,0,1,12800,10,9334494551
2956,20998490,11373067,32371557,1,0,1,20480,10,4080629245
2957,20999729,1495389,22495118,3,0,0,15872,17,9301447961
2958,21001741,11374910,32376651,5,0,1,1024,10,10128120408
2959,21015580,1389348,22404928,8,0,0,1536,8,446116232
2960,21020731,11359786,32380517,5,0,1,6144,10,1444470921
2961,21021960,11359018,32380978,1,0,1,10240,10,9942536392
2962,21029010,11359198,32388208,7,0,1,4608,10,1427220535
2963,21029150,1460907,22490057,5,0,0,70144,10,5855833401
2964,21029190,1583610,22612800,5,0,0,15872,10,486756509
2965,21038540,11387434,32425974,7,0,1,4608,10,10038516921
2966,21039599,1475734,22515333,3,0,0,5632,17,6791152546
2967,21057470,11371514,32428984,7,0,1,10752,10,1277724015
2968,21083930,11355360,32439290,0,0,1,19968,3,2468760038
2969,21098330,11344750,32443080,7,0,1,15872,10,5301658324
2970,21113110,1483089,22596199,8,0,0,512,8,6808557130
2971,21113180,1387311,22500491,8,0,0,1024,8,5924361584
2972,21113870,11331796,32445666,0,0,1,4096,3,10209692080
2973,21114390,11454956,32569346,9,0,1,65024,12,818863331
2974,21115100,11509774,32624874,9,0,1,56832,12,2757018998
2975,21115780,11511680,32627460,1,0,1,4096,10,8033255527
2976,21116939,1485347,22602286,1,0,0,6144,10,166629253
2977,21118159,1393295,22511454,3,0,0,5632,17,376655920
2978,21121270,11581850,32703120,9,0,1,13824,12,8013592915
2979,21128510,11574633,32703143,7,0,1,6656,10,8283344398
2980,21132480,1335239,22467719,2,0,0,512,3,1678275379
2981,21133800,11569366,32703166,7,0,1,2048,10,7272425135
2982,21160460,11542729,32703189,0,0,1,512,3,10096430639
2983,21161319,1486530,22647849,3,0,0,2048,17,497994222
2984,21168420,11538247,32706667,7,0,1,4096,10,8636181042
2985,21174870,11531820,32706690,7,0,1,2048,10,5637936892
2986,21176419,1769496,22945915,1,0,0,30720,10,8549930499
2987,21181190,11525531,32706721,7,0,1,5120,10,9466437207
2988,21189420,11523323,32712743,9,0,1,26624,12,9299162825
2989,21189561,11525635,32715196,5,0,1,7168,10,3209944010
2990,21201159,1524247,22725406,3,0,0,6144,17,2495656936
2991,21202200,1764442,22966642,8,0,0,1024,8,6711563527
2992,21215900,1405373,22621273,8,0,0,1024,8,7549192025
2993,21217100,1479935,22697035,8,0,0,1536,8,2856224326
2994,21218671,11529146,32747817,5,0,1,1536,10,7405054776
2995,21225400,11522440,32747840,1,0,1,2048,10,5710133084
2996,21232469,1359948,22592417,3,0,0,3584,17,5118077997
2997,21238890,11516960,32755850,9,0,1,22528,12,1649775657
2998,21240860,11515013,32755873,0,0,1,3584,3,813949434
2999,21241679,1660721,22902400,3,0,0,172544,17,9829887957
3000,21251080,11504816,32755896,8,0,1,1024,8,8012040883
3001,21257570,11505814,32763384,8,0,1,22016,8,8023797720
3002,21262580,1640114,22902694,2,0,0,512,3,6012895339
3003,21274000,1477992,22751992,2,0,0,1536,3,7259401698
3004,21274660,11505777,32780437,8,0,1,5120,8,2154107920
3005,21309790,1525924,22835714,2,0,0,1024,3,1063247794
3006,21310050,11470733,32780783,7,0,1,512,10,2275202688
3007,21321060,1596462,22917522,2,0,0,512,3,3337234028
3008,21322189,1767897,23090086,1,0,0,31232,10,3376617900
3009,21325929,1590043,22915972,1,0,0,25600,10,2158700803
3010,21332320,1631958,22964278,8,0,0,1536,8,8849601312
3011,21332500,11449269,32781769,7,0,1,1536,10,5474265435
3012,21340751,11465423,32806174,5,0,1,16384,10,2468857258
3013,21341950,11555641,32897591,9,0,1,90624,12,575329994
3014,21352979,1655845,23008824,3,0,0,6656,17,5803250795
3015,21358850,11598926,32957776,9,0,1,54784,12,5283149671
3016,21364399,1710151,23074550,3,0,0,130048,17,668397856
3017,21364420,11603411,32967831,8,0,1,512,8,4516915401
3018,21368940,11600197,32969137,7,0,1,2048,10,3962523034
3019,21369100,11601023,32970123,1,0,1,1536,10,9358443096
3020,21369890,1582659,22952549,2,0,0,1024,3,3907458521
3021,21371170,11600579,32971749,0,0,1,2560,3,5166826742
3022,21377920,1636663,23014583,5,0,0,1024,10,9590496231
3023,21381870,1583632,22965502,2,0,0,512,3,9873324077
3024,21384790,11587945,32972735,8,0,1,1536,8,2666910956
3025,21398699,1716526,23115225,1,0,0,82432,10,3544250923
3026,21403191,11575879,32979070,5,0,1,19456,10,10163508256
3027,21403430,11600771,33004201,9,0,1,29184,12,17364901
3028,21404000,11620538,33024538,7,0,1,4096,10,371146193
3029,21404700,11622744,33027444,1,0,1,4608,10,10200121802
3030,21418530,11611180,33029710,1,0,1,3584,10,6798920132
3031,21423600,1499686,22923286,8,0,0,512,8,4781662311
3032,21427870,11602506,33030376,8,0,1,1024,8,1191606073
3033,21433370,1580805,23014175,2,0,0,512,3,3270573262
3034,21444350,11586372,33030722,0,0,1,512,3,1409109719
3035,21452309,1543920,22996229,3,0,0,13312,17,5980256193
3036,21454940,1573861,23028801,8,0,0,512,8,3306128741
3037,21463990,1616557,23080547,8,0,0,512,8,2727175123
3038,21471301,11560727,33032028,5,0,1,2048,10,5145787483
3039,21484930,11556427,33041357,7,0,1,13824,10,3874516427
3040,21498351,11543029,33041380,5,0,1,512,10,7631187731
3041,21505039,1575306,23080345,1,0,0,18944,10,10362893180
3042,21508790,1606622,23115412,8,0,0,512,8,2921341543
3043,21523020,11525820,33048840,8,0,1,18432,8,2280405134
3044,21524370,11551666,33076036,8,0,1,3584,8,3687712115
3045,21527170,1589651,23116821,2,0,0,1536,3,6470336937
3046,21546861,11529841,33076702,5,0,1,1024,10,4277286773
3047,21574441,11506767,33081208,5,0,1,7168,10,8932634040
3048,21574991,11506883,33081874,5,0,1,1024,10,4208151979
3049,21577470,11508270,33085740,0,0,1,6144,3,6789272638
3050,21578310,11507776,33086086,0,0,1,512,3,3563962155
3051,21581120,1593565,23174685,5,0,0,43008,10,7337207770
3052,21584750,11502002,33086752,7,0,1,1024,10,3618527900
3053,21588090,1587554,23175644,5,0,0,3072,10,4028230769
3054,21596590,11492108,33088698,0,0,1,3072,3,4023495915
3055,21601219,1515111,23116330,3,0,0,2560,17,624260891
3056,21623250,11487503,33110753,8,0,1,10240,8,1897876629
3057,21624400,11486376,33110776,8,0,1,17408,8,4172440198
3058,21631510,11479289,33110799,7,0,1,512,10,8730988590
3059,21632750,11478072,33110822,8,0,1,2560,8,5342047163
3060,21635120,11475725,33110845,7,0,1,1024,10,6579104053
3061,21638200,11472668,33110868,7,0,1,2048,10,6497212797
3062,21644820,1549089,23193909,2,0,0,512,3,6158799819
3063,21653039,1640795,23293834,3,0,0,39424,17,10237330679
3064,21653139,1651638,23304777,3,0,0,35840,17,10453532135
3065,21660981,11449910,33110891,5,0,1,1024,10,7099003822
3066,21675539,2111132,23786671,3,0,0,10752,17,2821336734
3067,21686460,1618652,23305112,2,0,0,1024,3,5208794781
3068,21700579,1501215,23201794,3,0,0,9728,17,9948356487
3069,21710360,1848519,23558879,5,0,0,72704,10,9047958835
3070,21713190,1737730,23450920,2,0,0,512,3,7349457794
3071,21714880,11396034,33110914,7,0,1,512,10,4001570242
3072,21717570,1753558,23471128,2,0,0,512,3,4278169632
3073,21723190,1744452,23467642,8,0,0,1536,8,6133439427
3074,21743160,11367777,33110937,7,0,1,2048,10,1258049763
3075,21744819,1933825,23678644,1,0,0,17408,10,634094666
3076,21746350,1684812,23431162,8,0,0,1536,8,1107964223
3077,21748009,1764282,23512291,1,0,0,18432,10,8662684404
3078,21752890,11358070,33110960,0,0,1,512,3,3694518247
3079,21755190,11377282,33132472,7,0,1,512,10,7231218230
3080,21760880,11371938,33132818,0,0,1,512,3,1314450015
3081,21766200,1616182,23382382,8,0,0,512,8,3551476056
3082,21805050,11330994,33136044,0,0,1,5120,3,3217695839
3083,21805631,11331399,33137030,5,0,1,1536,10,6069207688
3084,21807109,1828272,23635381,1,0,0,154112,10,2116320481
3085,21817480,11321176,33138656,0,0,1,2560,3,3043232783
3086,21838729,1823443,23662172,3,0,0,28160,17,5312109273
3087,21864851,11276391,33141242,5,0,1,4096,10,2407370918
3088,21865939,1929343,23795282,3,0,0,28160,17,10003378546
3089,21872840,11273228,33146068,7,0,1,7680,10,1472858149
3090,21873880,11274454,33148334,0,0,1,3584,3,1494883772
3091,21884949,2436162,24321111,3,0,0,55808,17,9112930058
3092,21889199,1629168,23518367,3,0,0,6656,17,9310351328
3093,21890630,11299086,33189716,7,0,1,13312,10,3287406152
3094,21895050,1673230,23568280,2,0,0,1536,3,3801864015
3095,21899590,11290149,33189739,7,0,1,2048,10,1826431211
3096,21901161,11288601,33189762,5,0,1,11776,10,1078836137
3097,21907119,1757283,23664402,3,0,0,7168,17,917949607
3098,21921829,1900394,23822223,3,0,0,15360,17,9540228665
3099,21935050,2045017,23980067,5,0,0,13824,10,4814421911
3100,21935121,11258807,33193928,5,0,1,11264,10,10435628166
3101,21940790,11253161,33193951,7,0,1,15360,10,422002375
3102,21945600,1707969,23653569,5,0,0,58880,10,5070502034
3103,21958430,1720907,23679337,8,0,0,512,8,3998370437
3104,21990850,2034529,24025379,8,0,0,2048,8,6164362113
3105,22019559,1704380,23723939,3,0,0,77824,17,979370586
3106,22019659,2403170,24422829,1,0,0,135680,10,2234514465
3107,22059229,1614088,23673317,3,0,0,29184,17,7298291003
3108,22087669,1869753,23957422,3,0,0,16896,17,5858340321
3109,22089459,1693913,23783372,3,0,0,36352,17,5435274335
3110,22095690,11098284,33193974,1,0,1,5120,10,3407715367
3111,22096099,1761964,23858063,3,0,0,36864,17,42134177
3112,22109930,1569228,23679158,8,0,0,1536,8,9788515862
3113,22112130,1626166,23738296,8,0,0,512,8,5685669441
3114,22116669,1980115,24096784,1,0,0,71168,10,802021999
3115,22128609,2011273,24139882,3,0,0,50176,17,9786126665
3116,22141109,2020308,24161417,3,0,0,49152,17,4476297797
3117,22154820,1480740,23635560,2,0,0,512,3,2224755233
3118,22158659,2452454,24611113,3,0,0,43008,17,9531911977
3119,22164550,1707144,23871694,5,0,0,12800,10,5378323428
3120,22172220,1750321,23922541,5,0,0,18944,10,8344939981
3121,22182039,1702171,23884210,1,0,0,14848,10,7775806742
3122,22182230,1845909,24028139,8,0,0,1024,8,4893597596
3123,22192559,2151162,24343721,3,0,0,23552,17,10017155207
3124,22196710,1527564,23724274,2,0,0,1024,3,6930034613
3125,22202850,1691035,23893885,8,0,0,512,8,365458626
3126,22218120,1943476,24161596,2,0,0,512,3,2668329604
3127,22237260,1747981,23985241,2,0,0,512,3,5044934407
3128,22254459,2435531,24689990,3,0,0,68096,17,10369295474
3129,22259129,1606479,23865608,1,0,0,1536,10,7504690541
3130,22259290,2338688,24597978,5,0,0,91648,10,9319028226
3131,22271960,1714817,23986777,2,0,0,512,3,4604258310
3132,22277679,1972375,24250054,1,0,0,61440,10,9073140884
3133,22299139,1805959,24105098,3,0,0,3072,17,10256076983
3134,22323370,2100129,24423499,8,0,0,2048,8,858433197
3135,22329010,10865011,33194021,8,0,1,18944,8,9597311937
3136,22337899,1608547,23946446,1,0,0,3584,10,8869998951
3137,22346200,10848248,33194448,8,0,1,14848,8,7683036032
3138,22350900,1562982,23913882,2,0,0,512,3,5491156247
3139,22359350,1628963,23988313,8,0,0,512,8,738980636
3140,22389020,1715119,24104139,5,0,0,24064,10,6699847967
3141,22404140,1569410,23973550,5,0,0,6656,10,7398888645
3142,22435760,2366860,24802620,5,0,0,50176,10,10291695704
3143,22445350,10767039,33212389,8,0,1,2048,8,926213941
3144,22447580,10766462,33214042,0,0,1,512,3,6592415974
3145,22449389,1986258,24435647,3,0,0,31744,17,9639423923
3146,22467779,1898646,24366425,1,0,0,24064,10,3836035426
3147,22486780,10769527,33256307,0,0,1,7680,3,4253737427
3148,22499129,2465679,24964808,1,0,0,6656,10,2798248028
3149,22508280,10795551,33303831,8,0,1,512,8,4437135072
3150,22513130,10792327,33305457,8,0,1,2560,8,4605032236
3151,22517410,10788713,33306123,8,0,1,1024,8,9451939270
3152,22523759,2189966,24713725,3,0,0,77824,17,1055889954
3153,22532430,10774679,33307109,0,0,1,1536,3,10014244839
3154,22555410,10756205,33311615,0,0,1,7168,3,7830611799
3155,22556610,10758871,33315481,0,0,1,6144,3,9773862539
3156,22566820,10754358,33321178,8,0,1,18944,8,6581598830
3157,22567190,1608203,24175393,2,0,0,512,3,4184293652
3158,22576239,1706705,24282944,3,0,0,28160,17,10011039249
3159,22595491,10732329,33327820,5,0,1,3584,10,5971517158
3160,22605430,10722413,33327843,8,0,1,1536,8,7325843241
3161,22610070,1603470,24213540,2,0,0,1024,3,8099075524
3162,22613721,10714145,33327866,5,0,1,9216,10,2030440795
3163,22627051,10710796,33337847,5,0,1,1536,10,8337832773
3164,22637881,10700694,33338575,5,0,1,1536,10,7115507799
3165,22647229,1811217,24458446,1,0,0,74752,10,7464996841
3166,22657950,10684171,33342121,0,0,1,5632,3,553575839
3167,22696350,1772447,24468797,5,0,0,33792,10,77271438
3168,22696450,1534861,24231311,2,0,0,512,3,6945055565
3169,22702390,10643597,33345987,8,0,1,6144,8,5886047416
3170,22711680,10638634,33350314,0,0,1,16384,3,7628456113
3171,22713829,1833113,24546942,3,0,0,50176,17,2672002728
3172,22716200,10637340,33353540,8,0,1,5120,8,7293302054
3173,22718449,1784741,24503190,3,0,0,22528,17,7350005645
3174,22720031,10641241,33361272,5,0,1,12288,10,4979631279
3175,22720280,10641556,33361836,8,0,1,10752,8,10310828668
3176,22744890,1745693,24490583,2,0,0,512,3,9588653800
3177,22747131,10637257,33384388,5,0,1,3072,10,7569484924
3178,22776870,10609464,33386334,7,0,1,3072,10,1668832856
3179,22780841,10622694,33403535,5,0,1,15360,10,10043723920
3180,22792709,1728444,24521153,1,0,0,58880,10,7165163736
3181,22796660,1691382,24488042,2,0,0,1536,3,423194004
3182,22804599,2042961,24847560,1,0,0,137216,10,2053421527
3183,22808370,10616757,33425127,8,0,1,4608,8,4623228033
3184,22810570,10981335,33791905,9,0,1,273920,12,5298889887
3185,22819990,10973541,33793531,0,0,1,2560,3,456371136
3186,22820580,2091319,24911899,5,0,0,37376,10,9902104507
3187,22827841,10966676,33794517,5,0,1,1536,10,2333907167
3188,22850320,10945183,33795503,0,0,1,1536,3,4359706394
3189,22854090,11012371,33866461,9,0,1,87552,12,3137975254
3190,22862961,11003859,33866820,5,0,1,9728,10,8719383326
3191,22867430,2023012,24890442,5,0,0,140288,10,3078155550
3192,22868391,11003076,33871467,5,0,1,6144,10,1519178316
3193,22870860,2051653,24922513,8,0,0,512,8,3704454848
3194,22878911,10994182,33873093,5,0,1,2560,10,2406237195
3195,22884829,2013256,24898085,3,0,0,24576,17,1027610865
3196,22886540,1882732,24769272,2,0,0,2560,3,2357108286
3197,22887620,2037965,24925585,8,0,0,512,8,10287534297
3198,22894760,10980863,33875623,8,0,1,512,8,8823093755
3199,22915691,10960598,33876289,5,0,1,11264,10,9132287337
3200,22919840,10959995,33879835,8,0,1,5632,8,4583925191
3201,22926881,10954580,33881461,5,0,1,2560,10,5927481866
3202,22932100,2020300,24952400,8,0,0,512,8,6448188112
3203,22944860,10937677,33882537,8,0,1,13312,8,2455073050
3204,22948850,10940139,33888989,9,0,1,10240,12,4848729457
3205,22949290,10942285,33891575,0,0,1,4096,3,5165625550
3206,22961419,2117804,25079223,1,0,0,39424,10,1392992333
3207,22965050,10937766,33902816,9,0,1,45056,12,7057918200
3208,22969720,10967512,33937232,0,0,1,1024,3,4036130502
3209,22972830,10968514,33941344,0,0,1,4096,3,10324046370
3210,22979950,10963545,33943495,7,0,1,16384,10,2471500865
3211,22980370,10963791,33944161,9,0,1,11264,12,2059353988
3212,22988259,2137453,25125712,1,0,0,42496,10,9569857670
3213,22994451,10958142,33952593,5,0,1,1024,10,8728867577
3214,22994470,10961029,33955499,9,0,1,4608,12,6561995940
3215,22995830,10960975,33956805,2,0,1,2048,3,3889619649
3216,22999046,2242020,25241066,2,0,0,1024,3,8477498535
3217,23003460,10955291,33958751,0,0,1,3072,3,10100692589
3218,23008260,10979800,33988060,0,0,1,8192,3,3697799421
3219,23015641,10973802,33989443,5,0,1,14848,10,8475612446
3220,23020011,10973618,33993629,5,0,1,6656,10,9700502194
3221,23045840,10952641,33998481,9,0,1,7680,12,5436253433
3222,23049200,10951547,34000747,0,0,1,3584,3,1887130862
3223,23051440,11026138,34077578,9,0,1,126976,12,10422818429
3224,23051840,2115349,25167189,2,0,0,1024,3,10395282900
3225,23052051,11044320,34096371,5,0,1,6144,10,847678720
3226,23061119,11057352,34118471,4,0,1,25600,15,2101615417
3227,23064411,11060817,34125228,5,0,1,3584,10,7265826914
3228,23066030,11059221,34125251,3,0,1,23040,17,4952580932
3229,23073369,2185738,25259107,1,0,0,27136,10,10260063319
3230,23074160,2051731,25125891,8,0,0,512,8,8558354034
3231,23087120,1992282,25079402,2,0,0,512,3,1319121276
3232,23099290,2117223,25216513,8,0,0,2560,8,8919164402
3233,23100910,11240526,34341436,3,0,1,261120,17,8377660427
3234,23103809,2063045,25166854,1,0,0,33280,10,5707703282
3235,23105779,11286666,34392445,4,0,1,65024,15,8833131242
3236,23107511,11287200,34394711,5,0,1,15872,10,6434876218
3237,23108130,1983082,25091212,2,0,0,1024,3,9114621240
3238,23113420,2067357,25180777,2,0,0,3072,3,6165358192
3239,23119920,2323196,25443116,5,0,0,57856,10,10238155495
3240,23127700,11270896,34398596,0,0,1,3584,3,1069098228
3241,23136609,2164955,25301564,3,0,0,5632,17,6999860161
3242,23160130,2372554,25532684,5,0,0,12800,10,9205231786
3243,23162359,11269951,34432310,4,0,1,65024,15,6751149405
3244,23162399,2119972,25282371,3,0,0,12800,17,8215166240
3245,23179530,11326662,34506192,3,0,1,44032,17,2833697513
3246,23195959,11310256,34506215,4,0,1,8192,15,6846885805
3247,23200250,2559090,25759340,5,0,0,149504,10,3002077634
3248,23200869,2011868,25212737,1,0,0,1536,10,804094339
3249,23202610,2494576,25697186,5,0,0,18432,10,2474042563
3250,23206920,11299318,34506238,0,0,1,2048,3,3357427699
3251,23209919,2248985,25458904,3,0,0,35840,17,2728509807
3252,23211649,2203566,25415215,1,0,0,23040,10,5508263489
3253,23230990,2269216,25500206,2,0,0,512,3,3801898609
3254,23260940,11252676,34513616,0,0,1,3584,3,4791923538
3255,23261220,2109760,25370980,8,0,0,1024,8,8647532777
3256,23271019,2094006,25365025,3,0,0,5632,17,6864976235
3257,23283060,2176023,25459083,2,0,0,512,3,944502212
3258,23301750,2160896,25462646,5,0,0,4608,10,6141316996
3259,23311899,11269892,34581791,4,0,1,141824,15,3570040711
3260,23314300,11280389,34594689,0,0,1,1024,3,9340849686
3261,23314729,11318730,34633459,4,0,1,43520,15,6475959555
3262,23344650,2291594,25636244,8,0,0,54272,8,7301122608
3263,23360489,11282311,34642800,4,0,1,5632,15,5531165956
3264,23367640,2095341,25462981,2,0,0,1024,3,6818885123
3265,23370905,2389985,25760890,5,0,0,1024,10,7985754829
3266,23373250,11285783,34659033,0,0,1,13824,3,10186824227
3267,23377060,11297637,34674697,0,0,1,7168,3,6913054694
3268,23380979,11293741,34674720,4,0,1,10752,15,3473500588
3269,23397080,2104662,25501742,5,0,0,512,10,3228268412
3270,23407269,2179428,25586697,1,0,0,50176,10,7819776010
3271,23407700,2035751,25443451,8,0,0,1024,8,7840860315
3272,23418810,2044350,25463160,2,0,0,512,3,8345562492
3273,23424510,11250233,34674743,0,0,1,11776,3,3087765564
3274,23425740,2107325,25533065,5,0,0,1024,10,6033820887
3275,23433850,2276168,25710018,8,0,0,23040,8,8676907021
3276,23447700,11231474,34679174,0,0,1,10240,3,115642945
3277,23451390,11228040,34679430,0,0,1,9216,3,9429933026
3278,23470700,11214026,34684726,0,0,1,2048,3,2457531983
3279,23475780,2215767,25691547,8,0,0,61952,8,1746125805
3280,23499199,1995606,25494805,3,0,0,11776,17,2453265096
3281,23504350,2255870,25760220,5,0,0,1024,10,3105656783
3282,23508610,1986374,25494984,2,0,0,512,3,3844336393
3283,23511869,2160779,25672648,1,0,0,34304,10,1142438329
3284,23539980,2302281,25842261,8,0,0,3072,8,1708780335
3285,23546639,2040237,25586876,3,0,0,512,17,577008159
3286,23563310,2321141,25884451,8,0,0,122368,8,9703367454
3287,23578460,2183295,25761755,5,0,0,1024,10,1278957964
3288,23581559,2055488,25637047,1,0,0,2560,10,2988204817
3289,23592450,2347150,25939600,2,0,0,512,3,10190431593
3290,23598110,2297642,25895752,8,0,0,33280,8,1109877395
3291,23606489,11079517,34686006,4,0,1,14336,15,9292295446
3292,23619990,2078344,25698334,5,0,0,1536,10,1665587700
3293,23622430,2176876,25799306,2,0,0,512,3,4407298344
3294,23627529,2133026,25760555,3,0,0,1024,17,2283854422
3295,23631009,2128674,25759683,3,0,0,1024,17,10023575236
3296,23643029,2503669,26146698,1,0,0,135680,10,3054952440
3297,23652210,11040244,34692454,0,0,1,512,3,4789354329
3298,23662659,2097226,25759885,3,0,0,512,17,8926192909
3299,23666980,2136771,25803751,8,0,0,4608,8,9428097563
3300,23675409,11170994,34846403,4,0,1,169472,15,9122049730
3301,23675799,11205155,34880954,4,0,1,7680,15,5359300532
3302,23706060,2214085,25920145,5,0,0,2048,10,1729742741
3303,23727580,11153397,34880977,1,0,1,5632,10,5102386809
3304,23744830,2196306,25941136,2,0,0,512,3,9883719033
3305,23751180,2245821,25997001,8,0,0,43520,8,424758940
3306,23751699,11154920,34906619,4,0,1,50688,15,3978380465
3307,23756799,2010652,25767451,3,0,0,512,17,8222527946
3308,23761640,2198448,25960088,5,0,0,1024,10,8252390154
3309,23774491,11132151,34906642,5,0,1,2048,10,3338153925
3310,23780399,2116000,25896399,3,0,0,2048,17,2235041469
3311,23789639,2489212,26278851,1,0,0,89600,10,5480513941
3312,23791360,2094229,25885589,8,0,0,3584,8,7344498598
3313,23804449,11110001,34914450,4,0,1,33792,15,9508216481
3314,23805840,11112796,34918636,1,0,1,6656,10,9658847322
3315,23809980,11109642,34919622,1,0,1,1536,10,4242501288
3316,23815339,2198438,26013777,3,0,0,1024,17,7507108155
3317,23827099,2135883,25962982,3,0,0,512,17,10061178213
3318,23830849,2340620,26171469,3,0,0,512,17,932743080
3319,23853390,11068670,34922060,1,0,1,2048,10,9350040297
3320,23872090,11050636,34922726,1,0,1,1024,10,7853304696
3321,23886669,2284255,26170924,1,0,0,78848,10,9464358099
3322,23895470,2143332,26038802,2,0,0,512,3,3729164218
3323,23897129,2304478,26201607,3,0,0,512,17,9677336027
3324,23907300,2180839,26088139,2,0,0,1024,3,7080656521
3325,23928490,2242800,26171290,2,0,0,1024,3,5260652705
3326,23934119,2148415,26082534,3,0,0,3584,17,6036082038
3327,23940350,2291724,26232074,5,0,0,1536,10,8899409265
3328,23941579,2205298,26146877,3,0,0,512,17,4780427364
3329,23958679,11148623,35107302,4,0,1,245760,15,4008344739
3330,23975250,11132075,35107325,1,0,1,2048,10,5850356834
3331,23975509,2114129,26089638,1,0,0,2048,10,3436504799
3332,23985189,2293964,26279153,3,0,0,512,17,9819943166
3333,23986729,11159748,35146477,4,0,1,41984,15,4868312502
3334,23999641,11147822,35147463,6,0,1,1536,7,4661720960
3335,24011250,2182539,26193789,5,0,0,512,10,3196238423
3336,24017070,11167343,35184413,8,0,1,4608,8,7360969270
3337,24050760,2150668,26201428,8,0,0,11264,8,8048279156
3338,24069429,2390853,26460282,1,0,0,54272,10,7498011480
3339,24078720,2250064,26328784,8,0,0,28160,8,4137753068
3340,24079250,2123305,26202555,5,0,0,512,10,998166218
3341,24083509,11102082,35185591,4,0,1,13824,15,124924591
3342,24088879,11124102,35212981,4,0,1,44032,15,4179687256
3343,24089949,2257153,26347102,3,0,0,1024,17,6464542350
3344,24091089,2203709,26294798,1,0,0,46080,10,1456851536
3345,24092909,11158171,35251080,4,0,1,17408,15,4787991101
3346,24094940,2302761,26397701,8,0,0,33792,8,8085226677
3347,24107460,2236282,26343742,5,0,0,512,10,3903766832
3348,24112380,2527198,26639578,5,0,0,512,10,7416073623
3349,24125371,11129575,35254946,6,0,1,6144,7,3503231353
3350,24128110,2356423,26484533,2,0,0,1536,3,2861146433
3351,24174790,2596925,26771715,8,0,0,37888,8,9342908047
3352,24175201,11083611,35258812,6,0,1,6144,7,8488850248
3353,24182940,2349155,26532095,8,0,0,15360,8,3463230235
3354,24189971,11073667,35263638,6,0,1,7680,7,1894673608
3355,24194320,2442262,26636582,5,0,0,1024,10,3957019696
3356,24214680,2383670,26598350,8,0,0,27136,8,5882672283
3357,24215189,2406552,26621741,3,0,0,1024,17,2886990956
3358,24215891,11050333,35266224,6,0,1,4096,7,9726257298
3359,24220711,11060070,35280781,6,0,1,3072,7,3515600225
3360,24223399,11135715,35359114,4,0,1,93184,15,3494341563
3361,24234011,11125126,35359137,6,0,1,1536,7,73636869
3362,24245760,2344253,26590013,8,0,0,75776,8,7017892635
3363,24250370,2664493,26914863,8,0,0,39936,8,8583448704
3364,24257910,11101250,35359160,3,0,1,16384,17,4671042490
3365,24264889,11107444,35372333,4,0,1,59904,15,9035594347
3366,24268409,2339588,26607997,1,0,0,1024,10,4343899211
3367,24270500,11187248,35457748,9,0,1,85504,12,5905131596
3368,24273840,2324914,26598754,2,0,0,512,3,7276778096
3369,24274280,2347080,26621360,8,0,0,37888,8,10659745788
3370,24286969,11199541,35486510,4,0,1,32768,15,8960900544
3371,24291120,2503861,26794981,5,0,0,1536,10,4102034300
3372,24302850,11183683,35486533,6,0,1,4608,7,3493911050
3373,24314070,2247208,26561278,2,0,0,1536,3,10407330314
3374,24327300,11164605,35491905,3,0,1,18944,17,6604990040
3375,24338200,11175508,35513708,3,0,1,42496,17,8931421929
3376,24349379,2249150,26598529,3,0,0,512,17,1843070800
3377,24351219,2290595,26641814,3,0,0,3072,17,3134942491
3378,24365499,11192689,35558188,4,0,1,64000,15,7267763150
3379,24367920,2198982,26566902,8,0,0,12800,8,9145008095
3380,24382019,11242086,35624105,4,0,1,58880,15,857444846
3381,24388150,2276785,26664935,5,0,0,1536,10,3213995759
3382,24391940,2326800,26718740,8,0,0,22528,8,8982372366
3383,24392100,2401899,26793999,8,0,0,58880,8,2019547239
3384,24393020,11234892,35627912,3,0,1,26624,17,4959677257
3385,24395970,11239437,35635407,6,0,1,23040,7,8457710339
3386,24415330,11244105,35659435,9,0,1,57856,12,8723185176
3387,24417090,11243011,35660101,6,0,1,1024,7,745286635
3388,24419919,11289391,35709310,4,0,1,56832,15,3112236421
3389,24421069,11319656,35740725,4,0,1,29184,15,4265984033
3390,24425320,11367090,35792410,3,0,1,27136,17,4385988558
3391,24439270,11357326,35796596,3,0,1,6656,17,4032022821
3392,24444750,11352512,35797262,9,0,1,11264,12,6252979676
3393,24451620,11362173,35813793,3,0,1,40960,17,4945981995
3394,24453700,11365842,35819542,9,0,1,3072,12,9100007392
3395,24453800,11416727,35870527,3,0,1,58880,17,3051012621
3396,24457610,2336880,26794490,2,0,0,1536,3,8162931561
3397,24471840,2531230,27003070,8,0,0,29696,8,8321449141
3398,24473750,2192358,26666108,5,0,0,1024,10,4272066849
3399,24473910,11401597,35875507,9,0,1,16384,12,1432341393
3400,24474879,2529017,27003896,3,0,0,512,17,4095859639
3401,24476819,2156252,26633071,1,0,0,1536,10,7101790022
3402,24482170,11395283,35877453,6,0,1,3072,7,9627747421
3403,24507170,11407174,35914344,9,0,1,47104,12,3606040815
3404,24514820,11399870,35914690,6,0,1,512,7,10209344456
3405,24525369,2504000,27029369,1,0,0,1024,10,438731429
3406,24530770,11400334,35931104,3,0,1,35840,17,1231105215
3407,24531340,2226371,26757711,5,0,0,2048,10,4333143805
3408,24535700,11414963,35950663,9,0,1,14336,12,4555619272
3409,24540250,11415600,35955850,9,0,1,12800,12,3966237580
3410,24556249,2244224,26800473,3,0,0,5120,17,7363830157
3411,24560090,2354952,26915042,2,0,0,512,3,5366109387
3412,24575890,2311537,26887427,8,0,0,14336,8,6375215958
3413,24576060,11383656,35959716,0,0,1,6144,3,1047158109
3414,24581900,11379404,35961304,9,0,1,15872,12,1098330686
3415,24585029,2551033,27136062,3,0,0,16384,17,5683648168
3416,24593510,11468389,36061899,3,0,1,94208,17,6581820483
3417,24613220,2190806,26804026,9,0,0,512,12,7113735423
3418,24623000,2264629,26887629,8,0,0,512,8,6862035062
3419,24627780,11465499,36093279,0,0,1,15872,3,3513353626
3420,24628220,11465082,36093302,3,0,1,2560,17,7246609471
3421,24653400,2372090,27025490,9,0,0,512,12,4380944032
3422,24655840,11437485,36093325,0,0,1,512,3,4513336241
3423,24657100,11436248,36093348,0,0,1,512,3,4932565343
3424,24670519,2761818,27432337,3,0,0,7680,17,9688110775
3425,24687090,2108382,26795472,5,0,0,1536,10,8349184050
3426,24704239,2314258,27018497,1,0,0,512,10,5121353479
3427,24716540,11376831,36093371,3,0,1,15360,17,7201016369
3428,24718620,11375767,36094387,9,0,1,20480,12,6481234910
3429,24747860,2199491,26947351,8,0,0,84480,8,8862618428
3430,24753390,2250327,27003717,2,0,0,2048,3,7347628397
3431,24769019,2407481,27176500,3,0,0,10752,17,7012748229
3432,24780030,2168170,26948200,8,0,0,2560,8,1288185645
3433,24810180,1994493,26804673,8,0,0,2048,8,3350883538
3434,24816189,2314188,27130377,3,0,0,75264,17,4743252128
3435,24822470,2195848,27018318,8,0,0,44032,8,2596958936
3436,24823160,2576543,27399703,8,0,0,85504,8,3658109390
3437,24829320,2314849,27144169,9,0,0,3072,12,3195076608
3438,24841170,1986222,26827392,2,0,0,512,3,843704615
3439,24849490,2336385,27185875,8,0,0,12800,8,5288275735
3440,24870090,2276371,27146461,8,0,0,512,8,9478470678
3441,24904430,2374776,27279206,2,0,0,512,3,591919139
3442,24908760,2160896,27069656,8,0,0,1536,8,9904777037
3443,24911259,2137769,27049028,1,0,0,1024,10,8482718889
3444,24916440,2032251,26948691,9,0,0,1536,12,2503388464
3445,24920030,11385896,36305926,3,0,1,208896,17,3212522205
3446,24934950,2195762,27130712,9,0,0,1024,12,6318294603
3447,24938210,2230860,27169070,8,0,0,12800,8,9327367012
3448,24938950,2192097,27131047,9,0,0,1024,12,2890721426
3449,24949950,2265616,27215566,5,0,0,3584,10,9107795894
3450,24959179,2603972,27563151,3,0,0,11264,17,602381357
3451,24971310,2097855,27069165,8,0,0,15872,8,6602349692
3452,24991330,2382252,27373582,8,0,0,24576,8,3378175268
3453,24994750,2305269,27300019,5,0,0,2048,10,2519814920
3454,25015940,2125340,27141280,2,0,0,1024,3,10715159745
3455,25039860,2366359,27406219,5,0,0,512,10,1002141458
3456,25040839,2359378,27400217,1,0,0,1024,10,8550182110
3457,25060870,2031561,27092431,2,0,0,512,3,2464135806
3458,25067550,2138119,27205669,5,0,0,1024,10,9817983766
3459,25070080,2122208,27192288,2,0,0,512,3,517238294
3460,25073119,2071541,27144660,1,0,0,1536,10,6741286284
3461,25077150,2068233,27145383,5,0,0,512,10,1259260801
3462,25078480,2113456,27191936,9,0,0,1024,12,5902638200
3463,25081629,2644545,27726174,3,0,0,36864,17,6031504095
3464,25101740,2142416,27244156,5,0,0,512,10,611907755
3465,25106729,2136359,27243088,1,0,0,2048,10,1969813414
3466,25111980,2356313,27468293,2,0,0,1536,3,3524882794
3467,25141779,1994618,27136397,1,0,0,1024,10,4076796964
3468,25144510,2181146,27325656,9,0,0,512,12,10230757072
3469,25157479,2342608,27500087,3,0,0,22016,17,10472160504
3470,25158589,2010706,27169295,1,0,0,512,10,6348903818
3471,25161010,2131687,27292697,5,0,0,512,10,1312710097
3472,25168490,2503219,27671709,8,0,0,28672,8,347563030
3473,25192050,2249477,27441527,2,0,0,512,3,8718427235
3474,25192089,2338048,27530137,3,0,0,83456,17,9624141520
3475,25196240,1975295,27171535,9,0,0,1024,12,1183589382
3476,25204869,2090580,27295449,3,0,0,4608,17,7819902827
3477,25209180,11096769,36305949,0,0,1,3072,3,9494466080
3478,25211110,2258407,27469517,9,0,0,512,12,6436174962
3479,25216679,2072243,27288922,3,0,0,1024,17,2782332479
3480,25220559,2420987,27641546,1,0,0,2048,10,8821605114
3481,25235890,2368283,27604173,5,0,0,2560,10,3193654781
3482,25238521,11067451,36305972,5,0,1,4608,10,3466721979
3483,25239339,2628409,27867748,3,0,0,37376,17,9649842175
3484,25243540,2662286,27905826,8,0,0,43520,8,2021406411
3485,25253459,2354169,27607628,3,0,0,11264,17,2670795516
3486,25255871,11050124,36305995,5,0,1,5632,10,893649236
3487,25259970,2378192,27638162,9,0,0,1024,12,3044090637
3488,25263339,2158167,27421506,3,0,0,26624,17,10239064738
3489,25274200,2178637,27452837,9,0,0,2048,12,9759394039
3490,25275509,1977707,27253216,3,0,0,8192,17,6519690112
3491,25285481,11020537,36306018,5,0,1,5632,10,2990928757
3492,25286760,2046169,27332929,2,0,0,3072,3,10123084559
3493,25295940,2126533,27422473,5,0,0,512,10,49477054
3494,25296830,2305558,27602388,8,0,0,24576,8,10607561151
3495,25302840,2255952,27558792,8,0,0,5120,8,6240034723
3496,25306660,2184703,27491363,9,0,0,512,12,7875979114
3497,25314290,2085592,27399882,9,0,0,512,12,2357133881
3498,25331069,2223642,27554711,3,0,0,47104,17,3933030990
3499,25340730,2138917,27479647,9,0,0,512,12,10131973784
3500,25346000,2439991,27785991,2,0,0,2048,3,611506067
3501,25364570,2100234,27464804,9,0,0,1024,12,10118094744
3502,25378720,2545877,27924597,9,0,0,4096,12,9087045698
3503,25388930,2201712,27590642,8,0,0,34816,8,2852067416
3504,25432379,2267388,27699767,3,0,0,11776,17,708179060
3505,25444760,2036799,27481559,5,0,0,1536,10,5980636456
3506,25454820,2630057,28084877,5,0,0,1024,10,2283383536
3507,25472110,10833931,36306041,8,0,1,12800,8,3655400929
3508,25481390,1989640,27471030,2,0,0,512,3,4695146919
3509,25482880,2759536,28242416,5,0,0,512,10,5993257795
3510,25483169,2120022,27603191,3,0,0,2560,17,4663511736
3511,25484230,10860332,36344562,7,0,1,1024,10,7853555673
3512,25494840,2290504,27785344,8,0,0,11776,8,4893787302
3513,25498950,2143664,27642614,2,0,0,512,3,6340712190
3514,25502541,10842044,36344585,5,0,1,2048,10,390055105
3515,25518740,2089701,27608441,2,0,0,512,3,1052201341
3516,25527270,10817338,36344608,8,0,1,1536,8,719935216
3517,25536690,2144287,27680977,5,0,0,1536,10,2309718470
3518,25540070,2230724,27770794,9,0,0,512,12,2329018825
3519,25544810,10799821,36344631,8,0,1,10240,8,8072619282
3520,25545089,2070207,27615296,3,0,0,12800,17,7408485640
3521,25570381,10774273,36344654,5,0,1,6144,10,1401505138
3522,25571270,2687929,28259199,2,0,0,512,3,10155678026
3523,25586930,2096280,27683210,5,0,0,512,10,10656205972
3524,25588910,2014460,27603370,5,0,0,512,10,8004363692
3525,25590220,2136468,27726688,9,0,0,1024,12,7470353172
3526,25591199,2116380,27707579,3,0,0,7168,17,4606460758
3527,25601260,2423507,28024767,8,0,0,155136,8,3160889296
3528,25601659,1993218,27594877,3,0,0,13824,17,10204641120
3529,25616430,1939149,27555579,5,0,0,1536,10,7273927233
3530,25625990,2188200,27814190,8,0,0,9728,8,8960568447
3531,25630930,2140043,27770973,5,0,0,512,10,1720115712
3532,25637279,2133336,27770615,3,0,0,52736,17,7695936824
3533,25666791,10677886,36344677,5,0,1,7680,10,9512996975
3534,25673030,10673509,36346539,7,0,1,4096,10,9044083027
3535,25681920,2124372,27806292,4,0,0,16384,15,6461239311
3536,25688400,2343991,28032391,4,0,0,13312,15,6471686947
3537,25707260,2246280,27953540,4,0,0,9728,15,9499996115
3538,25709230,10651299,36360529,7,0,1,9728,10,8452950830
3539,25719350,1958542,27677892,9,0,0,512,12,7126172724
3540,25741921,10622874,36364795,5,0,1,16896,10,4785225020
3541,25744600,10620218,36364818,7,0,1,1536,10,8010737657
3542,25764019,2579259,28343278,3,0,0,27136,17,9158385708
3543,25766851,10599825,36366676,5,0,1,12288,10,41526801
3544,25767430,2272647,28040077,4,0,0,23552,15,8903788884
3545,25772410,2427645,28200055,4,0,0,19456,15,10363601082
3546,25782169,2302194,28084363,3,0,0,125952,17,9937510203
3547,25787780,2348501,28136281,8,0,0,53248,8,3972735150
3548,25791890,2045499,27837389,5,0,0,3584,10,781393499
3549,25797410,10569612,36367022,8,0,1,512,8,4779950744
3550,25797680,10572888,36370568,7,0,1,5632,10,5494132401
3551,25799489,1927690,27727179,3,0,0,1536,17,645791035
3552,25800371,10570556,36370927,5,0,1,9728,10,4592437466
3553,25803810,10567463,36371273,7,0,1,512,10,3785959323
3554,25806360,10565579,36371939,7,0,1,1024,10,10602355178
3555,25813580,10568568,36382148,7,0,1,3584,10,7277973880
3556,25821350,2362649,28183999,9,0,0,2048,12,1448474080
3557,25825699,10704772,36530471,4,0,1,195072,15,9600530196
3558,25830140,10703557,36533697,7,0,1,5120,10,6512411077
3559,25838490,10703579,36542069,7,0,1,13312,10,9426942542
3560,25844810,2103179,27947989,9,0,0,1024,12,6253254020
3561,25849651,10738318,36587969,5,0,1,15872,10,9829572124
3562,25851979,2174706,28026685,3,0,0,5632,17,67254288
3563,25853869,10734123,36587992,4,0,1,20992,15,8435812698
3564,25858430,1867923,27726353,9,0,0,512,12,9019984634
3565,25858591,10729424,36588015,5,0,1,512,10,3164507453
3566,25864700,2402273,28266973,2,0,0,1024,3,1236247020
3567,25868539,2633762,28502301,3,0,0,38912,17,2168397352
3568,25871120,1968876,27839996,5,0,0,2560,10,4327955334
3569,25871820,10716218,36588038,7,0,1,2048,10,671486629
3570,25880241,10707820,36588061,5,0,1,6144,10,4952277604
3571,25895580,2415606,28311186,5,0,0,1024,10,4343487340
3572,25903379,2069372,27972751,3,0,0,512,17,6493160838
3573,25907150,1885546,27792696,9,0,0,1024,12,3668441028
3574,25916320,2108626,28024946,9,0,0,512,12,1777903523
3575,25925830,2190631,28116461,9,0,0,1024,12,2071554758
3576,25927430,10660654,36588084,1,0,1,3584,10,5661968740
3577,25932250,10655857,36588107,8,0,1,512,8,5033692033
3578,25936910,1931173,27868083,5,0,0,1024,10,2057492312
3579,25941370,10646760,36588130,7,0,1,15360,10,344547903
3580,25949670,10718055,36667725,9,0,1,136192,12,865520405
3581,25954760,2315285,28270045,5,0,0,1024,10,4819540467
3582,25959840,10711653,36671493,8,0,1,2560,8,9854128902
3583,25971350,2250924,28222274,5,0,0,3072,10,784866664
3584,25982239,2305127,28287366,3,0,0,13824,17,10245096340
3585,25993680,10685356,36679036,8,0,1,16384,8,6876620773
3586,25996330,2314521,28310851,9,0,0,1024,12,1073049058
3587,26000000,10681302,36681302,8,0,1,3584,8,1812818604
3588,26003610,10687145,36690755,1,0,1,3584,10,3949471505
3589,26010060,2074482,28084542,9,0,0,512,12,1731783614
3590,26018280,10672498,36690778,1,0,1,4608,10,5673844536
3591,26020920,1885709,27906629,5,0,0,2560,10,5470309831
3592,26023940,10669897,36693837,9,0,1,28672,12,7161118249
3593,26030949,2073254,28104203,3,0,0,9216,17,1375026500
3594,26035940,2007113,28043053,5,0,0,3072,10,5416920940
3595,26050200,10649026,36699226,7,0,1,17408,10,8228963601
3596,26052400,10691327,36743727,8,0,1,16896,8,9692640151
3597,26059370,2264698,28324068,5,0,0,37376,10,1140235932
3598,26067030,10678285,36745315,8,0,1,15872,8,4205388078
3599,26072370,2326363,28398733,4,0,0,78336,15,2337185418
3600,26074340,1896875,27971215,2,0,0,512,3,6323522688
3601,26083360,10691755,36775115,9,0,1,55296,12,1464383571
3602,26093090,10682691,36775781,7,0,1,1024,10,2286266830
3603,26104040,10674007,36778047,1,0,1,3584,10,2892262073
3604,26104181,10677092,36781273,5,0,1,5120,10,3271970514
3605,26108290,10681704,36789994,7,0,1,3584,10,8726740533
3606,26108650,10681367,36790017,1,0,1,5120,10,4755843517
3607,26117430,2643938,28761368,2,0,0,512,3,6776034247
3608,26119340,10670700,36790040,1,0,1,3584,10,9122966509
3609,26121900,2188616,28310516,4,0,0,44544,15,469659744
3610,26131590,2358786,28490376,4,0,0,12800,15,4523907042
3611,26135259,2009453,28144712,3,0,0,11776,17,5150631258
3612,26138130,2048629,28186759,9,0,0,1024,12,10088698848
3613,26143860,2104088,28247948,2,0,0,512,3,9912772455
3614,26147109,2095128,28242237,3,0,0,26624,17,1294231370
3615,26147180,2164497,28311677,2,0,0,1536,3,2783780064
3616,26155260,10638917,36794177,0,0,1,8192,3,2318100636
3617,26157490,10640553,36798043,1,0,1,6144,10,6430269739
3618,26160650,2552696,28713346,4,0,0,11264,15,10536601940
3619,26161501,10638808,36800309,5,0,1,3584,10,6509942948
3620,26173010,10627645,36800655,9,0,1,512,12,6217368331
3621,26176340,2306018,28482358,4,0,0,82944,15,4135777876
3622,26176520,2070204,28246724,9,0,0,1536,12,4814922850
3623,26192370,10612471,36804841,8,0,1,6656,8,1980370495
3624,26193040,2366214,28559254,2,0,0,1024,3,2242360746
3625,26211560,10594587,36806147,9,0,1,2048,12,8727807556
3626,26224280,10583173,36807453,1,0,1,2048,10,6172635309
3627,26230140,10579285,36809425,1,0,1,3072,10,5205652860
3628,26234370,10580201,36814571,7,0,1,8192,10,1711120331
3629,26236201,10587733,36823934,5,0,1,27648,10,3221379277
3630,26246530,2021065,28267595,2,0,0,1536,3,3419477205
3631,26252270,2173940,28426210,5,0,0,10240,10,10567098267
3632,26254270,10570125,36824395,9,0,1,10240,12,8784734653
3633,26276850,10547891,36824741,8,0,1,512,8,6098868444
3634,26278770,10553828,36832598,8,0,1,1536,8,4508529622
3635,26281819,2575821,28857640,3,0,0,115712,17,362320977
3636,26282050,10555054,36837104,1,0,1,7168,10,8803431777
3637,26290590,2461996,28752586,5,0,0,68608,10,3071723430
3638,26293111,10544659,36837770,5,0,1,1024,10,1139952497
3639,26329500,1967311,28296811,9,0,0,2048,12,10626897371
3640,26333689,2074271,28407960,3,0,0,30208,17,4677611557
3641,26346580,2422712,28769292,2,0,0,2048,3,2849404221
3642,26352891,10487145,36840036,5,0,1,3584,10,5116234974
3643,26415420,2164059,28579479,9,0,0,512,12,10735244113
3644,26419000,2342726,28761726,2,0,0,512,3,2531943480
3645,26423389,2063056,28486445,3,0,0,13312,17,6541332101
3646,26428890,2445159,28874049,9,0,0,512,12,2197787091
3647,26441321,10405807,36847128,5,0,1,11264,10,3560273104
3648,26442710,2071706,28514416,2,0,0,512,3,5988802932
3649,26481260,2025005,28506265,2,0,0,512,3,7679250155
3650,26487660,10361094,36848754,7,0,1,2560,10,10380033500
3651,26495420,1869634,28365054,2,0,0,1536,3,3092149558
3652,26496839,2594939,29091778,3,0,0,187392,17,5162034794
3653,26505440,2359312,28864752,2,0,0,2048,3,9225557785
3654,26514889,2466062,28980951,3,0,0,123392,17,7944399754
3655,26522690,10326730,36849420,8,0,1,1024,8,1819192049
3656,26529370,2068446,28597816,5,0,0,37888,10,2866755313
3657,26544620,10305466,36850086,7,0,1,1024,10,10123982616
3658,26550970,10299782,36850752,8,0,1,1024,8,10017048691
3659,26552110,2025833,28577943,9,0,0,512,12,1609229633
3660,26583739,2086569,28670308,3,0,0,21504,17,8618225668
3661,26586930,1924414,28511344,2,0,0,512,3,5605171311
3662,26609379,10245239,36854618,4,0,1,6144,15,5253295588
3663,26628730,1924637,28553367,9,0,0,512,12,8692730690
3664,26629160,10234093,36863253,7,0,1,7680,10,5192681058
3665,26630280,10348326,36978606,3,0,1,179200,17,5621150460
3666,26632570,2290366,28922936,5,0,0,24064,10,10137230219
3667,26640090,10392686,37032776,7,0,1,1024,10,5018655102
3668,26646609,10389073,37035682,4,0,1,4608,15,2091575213
3669,26650880,2140811,28791691,5,0,0,35328,10,5267540066
3670,26657629,2103560,28761189,3,0,0,28160,17,568196347
3671,26677380,10358968,37036348,9,0,1,1024,12,6393030724
3672,26683300,2030849,28714149,5,0,0,2560,10,552860546
3673,26723070,10314201,37037271,9,0,1,20480,12,10488254504
3674,26739030,10300827,37039857,7,0,1,4096,10,9590156519
3675,26746689,2117416,28864105,3,0,0,20480,17,8394730727
3676,26766030,10275453,37041483,7,0,1,2560,10,8201472170
3677,26786709,1978285,28764994,3,0,0,6144,17,1483329998
3678,26801130,2100441,28901571,5,0,0,8704,10,1623359376
3679,26805170,1956377,28761547,2,0,0,512,3,6253203922
3680,26809970,10234099,37044069,7,0,1,4096,10,3453203612
3681,26841531,10206724,37048255,5,0,1,6656,10,3147169429
3682,26856420,2131262,28987682,5,0,0,22016,10,8821493636
3683,26871530,10180911,37052441,2,0,1,6656,3,6390211852
3684,26875820,10182777,37058597,7,0,1,3584,10,6978263599
3685,26890610,2234800,29125410,5,0,0,26112,10,7838306485
3686,26901000,2000750,28901750,9,0,0,512,12,10208107129
3687,26907540,10155243,37062783,7,0,1,6656,10,9686023386
3688,26924670,1933172,28857842,2,0,0,512,3,3171551786
3689,26928650,10138332,37066982,7,0,1,17920,10,5599496677
3690,26933880,2070076,29003956,2,0,0,512,3,382628321
3691,26937679,2211410,29149089,3,0,0,40960,17,9822554916
3692,26938489,2219398,29157887,3,0,0,28160,17,7647017981
3693,26966039,2170470,29136509,3,0,0,36352,17,4369347339
3694,26978949,2138482,29117431,3,0,0,83968,17,7442283774
3695,26984100,2049036,29033136,9,0,0,1024,12,5233156000
3696,26985080,10086088,37071168,7,0,1,6656,10,2557289138
3697,26991530,10168112,37159642,9,0,1,81408,12,3909019431
3698,27014329,2397542,29411871,3,0,0,100352,17,9703261280
3699,27018800,2130468,29149268,2,0,0,512,3,8321366380
3700,27027460,2151219,29178679,2,0,0,512,3,5210197206
3701,27030200,10130428,37160628,7,0,1,1536,10,7900946833
3702,27036180,2269157,29305337,2,0,0,512,3,5460566712
3703,27056170,10127587,37183757,9,0,1,13312,12,9946930824
3704,27083240,10153438,37236678,7,0,1,1024,10,4675928017
3705,27093069,2144988,29238057,3,0,0,36352,17,9865351427
3706,27101980,1923822,29025802,2,0,0,512,3,4793028576
3707,27115410,1872607,28988017,9,0,0,1024,12,9799017484
3708,27116530,2216953,29333483,2,0,0,1024,3,2689571254
3709,27128009,2208022,29336031,3,0,0,6656,17,1195877821
3710,27128310,10108391,37236701,7,0,1,512,10,100022719
3711,27134900,10101824,37236724,7,0,1,512,10,8035256532
3712,27151630,2046100,29197730,9,0,0,512,12,3989602717
3713,27155910,2090385,29246295,5,0,0,16896,10,4868550976
3714,27157740,10079007,37236747,7,0,1,5632,10,2103680986
3715,27158080,10078690,37236770,6,0,1,1024,7,3410145494
3716,27163290,10073503,37236793,6,0,1,7680,7,9130990967
3717,27164300,10132084,37296384,6,0,1,5632,7,6331954259
3718,27168070,2025617,29193687,9,0,0,512,12,5787025483
3719,27180340,2140159,29320499,5,0,0,25600,10,8198486528
3720,27195809,2303602,29499411,3,0,0,82944,17,5343230429
3721,27197010,2051973,29248983,2,0,0,512,3,10381415934
3722,27203040,10093367,37296407,7,0,1,4096,10,2160979214
3723,27208340,2112338,29320678,9,0,0,512,12,3204152902
3724,27214760,10081670,37296430,6,0,1,3072,7,10043556798
3725,27219420,2280170,29499590,2,0,0,512,3,7643015209
3726,27219830,10124303,37344133,9,0,1,73216,12,7082697838
3727,27229780,10114376,37344156,9,0,1,4608,12,10220977074
3728,27233600,10110660,37344260,7,0,1,1024,10,1888288015
3729,27242080,10106686,37348766,6,0,1,7168,7,4461810219
3730,27265870,2096640,29362510,9,0,0,512,12,3652440010
3731,27272970,2236494,29509464,5,0,0,32256,10,7008205416
3732,27274580,2091158,29365738,2,0,0,1024,3,948066255
3733,27283190,10068802,37351992,7,0,1,5120,10,8811902813
3734,27298230,10057063,37355293,0,0,1,11776,3,4829634396
3735,27299650,10087632,37387282,7,0,1,6656,10,6089541943
3736,27309671,10085360,37395031,5,0,1,4096,10,7907076937
3737,27312370,10091915,37404285,9,0,1,17408,12,4012088066
3738,27313830,2124803,29438633,2,0,0,1024,3,9513344959
3739,27322840,10240660,37563500,9,0,1,81920,12,1965976189
3740,27327820,2442824,29770644,2,0,0,512,3,354858123
3741,27337080,10339898,37676978,6,0,1,30208,7,4397229321
3742,27338100,10338909,37677009,6,0,1,3072,7,8578846753
3743,27338670,10415997,37754667,9,0,1,59904,12,910301818
3744,27366010,10388680,37754690,6,0,1,512,7,9078976152
3745,27376551,10407503,37784054,5,0,1,3584,10,9757249096
3746,27377620,2132023,29509643,2,0,0,512,3,715754991
3747,27380820,2190455,29571275,2,0,0,512,3,7582350884
3748,27390960,2230993,29621953,5,0,0,19456,10,769126806
3749,27405000,10379077,37784077,7,0,1,512,10,4031407059
3750,27417960,10382275,37800235,9,0,1,34304,12,2262082547
3751,27442950,10425723,37868673,9,0,1,71680,12,6365199321
3752,27445171,10425780,37870951,5,0,1,5120,10,2742269776
3753,27451460,2239296,29690756,9,0,0,512,12,6677251240
3754,27461590,10410667,37872257,7,0,1,2048,10,3342271496
3755,27471210,10403633,37874843,6,0,1,4096,7,2825653620
3756,27474050,2179507,29653557,5,0,0,6656,10,9689873772
3757,27476100,10538219,38014319,9,0,1,88576,12,10294358391
3758,27491450,2020412,29511862,2,0,0,512,3,6678563122
3759,27497180,10596130,38093310,9,0,1,72704,12,6833198402
3760,27500620,10595700,38096320,6,0,1,3584,7,7167687718
3761,27517140,10579203,38096343,6,0,1,5632,7,5085434339
3762,27523210,10718414,38241624,9,0,1,97280,12,9562997556
3763,27523410,10748552,38271962,9,0,1,11264,12,3332822835
3764,27527320,10774928,38302248,9,0,1,24064,12,1653436343
3765,27527410,2434615,29962025,9,0,0,512,12,4281025445
3766,27548411,10754183,38302594,5,0,1,512,10,1196257844
3767,27552540,2334216,29886756,2,0,0,5632,3,2763618682
3768,27555520,2192677,29748197,5,0,0,32768,10,8112706457
3769,27563650,10740250,38303900,7,0,1,2048,10,5822212906
3770,27569020,2269044,29838064,2,0,0,512,3,5186481969
3771,27594870,10710336,38305206,6,0,1,2048,7,2372839655
3772,27603820,10703012,38306832,6,0,1,2560,7,1256550294
3773,27617191,10690627,38307818,5,0,1,1536,10,7813889540
3774,27620570,2109590,29730160,9,0,0,1024,12,6791105357
3775,27642750,10665427,38308177,7,0,1,9728,10,7932339106
3776,27651750,10683694,38335444,0,0,1,3584,3,5374323694
3777,27657301,10678166,38335467,5,0,1,3072,10,8471280906
3778,27666730,2128618,29795348,9,0,0,1536,12,275262896
3779,27671540,10663950,38335490,6,0,1,8192,7,8687106359
3780,27672450,10663063,38335513,6,0,1,1536,7,7432873864
3781,27676690,2367621,30044311,5,0,0,10752,10,7319187181
3782,27677891,10657645,38335536,5,0,1,3072,10,9834461794
3783,27678320,10661992,38340312,7,0,1,3584,10,10241304027
3784,27701990,2292023,29994013,9,0,0,21504,12,2301873720
3785,27716681,10627817,38344498,5,0,1,6656,10,10291702964
3786,27718171,10626673,38344844,5,0,1,512,10,4749891408
3787,27724921,10624113,38349034,5,0,1,3072,10,2985197397
3788,27741431,10607626,38349057,5,0,1,2048,10,4307391038
3789,27751959,10693219,38445178,4,0,1,85504,15,8998275446
3790,27770480,2116680,29887160,2,0,0,512,3,767161792
3791,27775630,2028076,29803706,2,0,0,1024,3,3860476740
3792,27783660,1986458,29770118,9,0,0,512,12,4033138357
3793,27793139,10759718,38552857,4,0,1,131072,15,4950264429
3794,27796470,10757373,38553843,7,0,1,1536,10,6421236676
3795,27800000,10754189,38554189,7,0,1,512,10,9198776692
3796,27803880,10755234,38559114,0,0,1,7168,3,3891018138
3797,27808350,2340044,30148394,2,0,0,1536,3,914751739
3798,27810410,10748951,38559361,0,0,1,1024,3,4955521208
3799,27815460,2119277,29934737,9,0,0,52224,12,3520229824
3800,27826460,10736447,38562907,0,0,1,5632,3,5001032948
3801,27853360,2548547,30401907,5,0,0,122880,10,2963363220
3802,27867770,1999643,29867413,2,0,0,3072,3,6161810870
3803,27868481,2538441,30406922,9,0,0,16384,12,4769031354
3804,27931900,2313614,30245514,2,0,0,1024,3,7085704220
3805,27934610,10685544,38620154,3,0,1,66560,17,7096630838
3806,27944110,2386840,30330950,2,0,0,134656,3,4098577916
3807,27961430,10666474,38627904,3,0,1,17920,17,10548532782
3808,27976530,2625290,30601820,2,0,0,22016,3,1322132818
3809,27994240,2538322,30532562,9,0,0,32768,12,6248886280
3810,28013680,1957447,29971127,5,0,0,9216,10,3015162925
3811,28020070,2261690,30281760,2,0,0,115712,3,5713751342
3812,28033430,2012152,30045582,2,0,0,4096,3,8185107641
3813,28033880,10629295,38663175,8,0,1,10240,8,1872056359
3814,28034100,10629421,38663521,8,0,1,512,8,5764035337
3815,28042490,2626696,30669186,2,0,0,41984,3,8889844307
3816,28050280,10615431,38665711,3,0,1,13312,17,1472901883
3817,28052790,2084471,30137261,2,0,0,44544,3,1945492345
3818,28062320,2282709,30345029,9,0,0,46080,12,9036458766
3819,28070090,2175089,30245179,9,0,0,512,12,1011689696
3820,28108620,2092427,30201047,5,0,0,55808,10,7528762851
3821,28125150,2668431,30793581,5,0,0,50176,10,2835354118
3822,28128800,2039547,30168347,5,0,0,10752,10,2028770970
3823,28131350,10538851,38670201,0,0,1,3072,3,7707130607
3824,28133470,10541877,38675347,8,0,1,8192,8,819856926
3825,28147880,2135970,30283850,2,0,0,5120,3,3122689827
3826,28148720,2212581,30361301,9,0,0,26112,12,10563566885
3827,28162160,10547614,38709774,8,0,1,2048,8,4074753870
3828,28163240,2083233,30246473,5,0,0,3072,10,8502205203
3829,28175410,10534387,38709797,8,0,1,4608,8,8344041458
3830,28191020,2229973,30420993,2,0,0,46080,3,2135456419
3831,28213220,2293731,30506951,9,0,0,49664,12,1037858465
3832,28221460,2389587,30611047,9,0,0,28160,12,494106241
3833,28228990,10480830,38709820,8,0,1,512,8,6913481411
3834,28232820,10479455,38712275,8,0,1,6144,8,7737081479
3835,28242820,2181004,30423824,2,0,0,9216,3,2015484104
3836,28253280,10472198,38725478,1,0,1,1536,10,4995236802
3837,28264400,2598840,30863240,4,0,0,50176,15,7371496795
3838,28275400,10451064,38726464,8,0,1,1536,8,5981424573
3839,28290290,10442471,38732761,8,0,1,3072,8,10706363292
3840,28303430,10429997,38733427,7,0,1,1024,10,2720622322
3841,28304560,2700028,31004588,5,0,0,131072,10,7089791952
3842,28329220,10404873,38734093,8,0,1,1024,8,8036095295
3843,28348970,10386429,38735399,8,0,1,2048,8,7918137328
3844,28353340,2397287,30750627,2,0,0,29696,3,5077103012
3845,28375700,1869300,30245000,5,0,0,90624,10,561718729
3846,28406100,10329658,38735758,2,0,1,9728,3,7635533117
3847,28425060,2622198,31047258,5,0,0,39936,10,8594077952
3848,28448870,10367204,38816074,8,0,1,12288,8,3502665939
3849,28449530,1832737,30282267,9,0,0,1536,12,10471060938
3850,28455070,10362237,38817307,3,0,1,99840,17,4264337900
3851,28487180,10424976,38912156,3,0,1,43008,17,6644837738
3852,28490110,1874334,30364444,2,0,0,10240,3,7131663977
3853,28504850,2002436,30507286,5,0,0,1024,10,5930917754
3854,28516550,10396912,38913462,8,0,1,2048,8,6655905924
3855,28519110,10395338,38914448,3,0,1,1536,17,5067749554
3856,28519490,2538977,31058467,2,0,0,2048,3,2898968156
3857,28535280,2428789,30964069,9,0,0,56832,12,3122505910
3858,28544200,1966237,30510437,2,0,0,9216,3,3934784770
3859,28557100,10471911,39029011,3,0,1,136192,17,764045365
3860,28568250,2466817,31035067,5,0,0,72704,10,9050202583
3861,28587290,10462735,39050025,3,0,1,27648,17,9161399653
3862,28602210,10499783,39101993,8,0,1,2048,8,6643515085
3863,28643820,10481161,39124981,9,0,1,33792,12,372078302
3864,28656650,10512296,39168946,9,0,1,53248,12,1410471454
3865,28667670,10515637,39183307,3,0,1,20992,17,4605530511
3866,28670970,2107300,30778270,2,0,0,90624,3,8022006174
3867,28719930,2021626,30741556,2,0,0,52736,3,9739672244
3868,28726290,2649882,31376172,9,0,0,5632,12,812904058
3869,28728849,10486528,39215377,4,0,1,26624,15,7844989049
3870,28731459,10485887,39217346,4,0,1,2048,15,719258300
3871,28740350,2410756,31151106,2,0,0,76288,3,6185127159
3872,28745509,10495311,39240820,4,0,1,5120,15,8236566356
3873,28745720,10515400,39261120,9,0,1,30720,12,3833154345
3874,28751719,10510989,39262708,4,0,1,15872,15,6949273395
3875,28752750,10530376,39283126,3,0,1,3584,17,8196620445
3876,28756640,10531658,39288298,8,0,1,8192,8,7433328659
3877,28759990,10640825,39400815,3,0,1,84992,17,8719393686
3878,28761980,10638858,39400838,3,0,1,29696,17,6710624934
3879,28764690,10696332,39461022,9,0,1,118272,12,9221909055
3880,28772810,10736955,39509765,3,0,1,47616,17,4954790015
3881,28781810,1917469,30699279,2,0,0,5120,3,3198470467
3882,28783670,10747892,39531562,3,0,1,12288,17,7698347834
3883,28784870,10758002,39542872,8,0,1,13824,8,4089360839
3884,28786910,10760929,39547839,9,0,1,17408,12,2704716721
3885,28790790,10768045,39558835,3,0,1,32768,17,9647528354
3886,28791680,2295562,31087242,9,0,0,16384,12,8640042939
3887,28792070,2136849,30928919,5,0,0,12800,10,9923533544
3888,28796780,10765601,39562381,2,0,1,5632,3,5278568996
3889,28803700,10770686,39574386,8,0,1,9216,8,10595348884
3890,28812570,2469821,31282391,5,0,0,100352,10,4465951156
3891,28817120,2147440,30964560,2,0,0,1536,3,10483404800
3892,28831760,10756962,39588722,8,0,1,7680,8,7152211030
3893,28862910,2189675,31052585,2,0,0,17408,3,246662183
3894,28872370,10733762,39606132,9,0,1,30208,12,8109673927
3895,28898640,10756262,39654902,3,0,1,43520,17,10656597024
3896,28902570,10782560,39685130,2,0,1,4608,3,3174741167
3897,28921520,10765236,39686756,2,0,1,2560,3,4643431133
3898,28922310,2205529,31127839,9,0,0,29696,12,3073675254
3899,28923180,10763922,39687102,9,0,1,512,12,7093220112
3900,28937950,10751098,39689048,2,0,1,3072,3,8808177178
3901,28942130,2211339,31153469,9,0,0,7680,12,6041591577
3902,28942880,10750034,39692914,8,0,1,6144,8,5868630651
3903,28944940,10903082,39848022,9,0,1,115200,12,4378924380
3904,28949780,2063112,31012892,5,0,0,23040,10,1163737490
3905,28956000,2126227,31082227,2,0,0,19968,3,7856428137
3906,28968079,10902267,39870346,4,0,1,2560,15,6379973060
3907,28985330,2128168,31113498,5,0,0,24576,10,4018671506
3908,28992710,2215298,31208008,9,0,0,17408,12,6792938479
3909,29000860,2315998,31316858,2,0,0,47616,3,5764150642
3910,29006249,11021109,40027358,4,0,1,105472,15,538362313
3911,29007390,11061350,40068740,9,0,1,22528,12,566821826
3912,29019660,2351516,31371176,9,0,0,36864,12,6043171436
3913,29021710,11049936,40071646,8,0,1,4608,8,1672717711
3914,29047860,11027012,40074872,2,0,1,5120,3,2654627507
3915,29054550,2247745,31302295,5,0,0,65024,10,4466003534
3916,29076029,10999829,40075858,4,0,1,1536,15,1715244985
3917,29081500,11064458,40145958,3,0,1,29696,17,10359119554
3918,29089880,11056744,40146624,3,0,1,11264,17,10435399970
3919,29091220,11088584,40179804,3,0,1,42496,17,3081534700
3920,29091670,11137024,40228694,9,0,1,24064,12,10729554354
3921,29092770,2311890,31404660,2,0,0,9216,3,9121998809
3922,29098630,11130087,40228717,2,0,1,1536,3,5475183296
3923,29111000,11117740,40228740,8,0,1,9216,8,8580937928
3924,29113790,2747582,31861372,2,0,0,113664,3,1022904800
3925,29124620,11104143,40228763,2,0,1,15360,3,6406527678
3926,29125590,2203623,31329213,2,0,0,40448,3,1584460263
3927,29128840,2424554,31553394,9,0,0,77824,12,6816349759
3928,29132619,11107062,40239681,4,0,1,82432,15,7007527483
3929,29142840,11128931,40271771,8,0,1,1024,8,6708049476
3930,29143530,11147345,40290875,9,0,1,48128,12,3073643077
3931,29144350,2380568,31524918,5,0,0,17408,10,5615405638
3932,29161180,11130041,40291221,3,0,1,512,17,5889162032
3933,29163410,2523980,31687390,5,0,0,2048,10,10106608748
3934,29167230,11125297,40292527,8,0,1,2048,8,2696298217
3935,29177640,11119444,40297084,8,0,1,3072,8,8270335662
3936,29185300,2416534,31601834,5,0,0,119296,10,9654658754
3937,29187730,2235179,31422909,2,0,0,1536,3,10399645200
3938,29189860,2423697,31613557,2,0,0,38400,3,10270065359
3939,29205570,11175430,40381000,3,0,1,93184,17,10288767835
3940,29226850,11154496,40381346,2,0,1,512,3,8742476291
3941,29261371,11122881,40384252,5,0,1,4608,10,8616961702
3942,29269230,2285146,31554376,5,0,0,3072,10,6404916544
3943,29271480,11120632,40392112,3,0,1,7168,17,818486441
3944,29281500,2403675,31685175,2,0,0,75264,3,7274232197
3945,29293910,11103796,40397706,2,0,1,18432,3,5752035156
3946,29309421,11090551,40399972,5,0,1,3584,10,1121401613
3947,29312100,11089498,40401598,2,0,1,2560,3,1801863264
3948,29313261,11089323,40402584,5,0,1,1536,10,376732209
3949,29331021,11083245,40414266,5,0,1,5120,10,8568291765
3950,29331250,11120044,40451294,3,0,1,51200,17,3054497458
3951,29352820,11104043,40456863,3,0,1,21504,17,4851416385
3952,29359930,11103715,40463645,2,0,1,5632,3,2528769639
3953,29364470,2338122,31702592,5,0,0,37376,10,6041108814
3954,29366770,2318896,31685666,5,0,0,1536,10,5533117507
3955,29372390,11111228,40483618,3,0,1,34304,17,5183958693
3956,29384851,11103913,40488764,5,0,1,8192,10,552891147
3957,29395410,2484557,31879967,2,0,0,60928,3,3783586920
3958,29397100,11093751,40490851,8,0,1,1536,8,3891345538
3959,29397520,11098157,40495677,3,0,1,7680,17,9114157738
3960,29408660,11087683,40496343,8,0,1,1024,8,4525664234
3961,29415250,11106959,40522209,9,0,1,60416,12,4709084446
3962,29437460,2218488,31655948,9,0,0,15360,12,10606701168
3963,29446630,11087821,40534451,6,0,1,512,7,4116289445
3964,29450280,2507702,31957982,9,0,0,10752,12,4551165729
3965,29453200,2431772,31884972,9,0,0,15360,12,157386612
3966,29463770,11108800,40572570,9,0,1,76800,12,8264438357
3967,29469160,11116027,40585187,9,0,1,25600,12,6617982157
3968,29476070,11113303,40589373,6,0,1,6656,7,4510978344
3969,29479131,11110908,40590039,5,0,1,1024,10,5091945056
3970,29482990,2471693,31954683,5,0,0,35328,10,10376723091
3971,29486170,2658737,32144907,2,0,0,74240,3,9026952400
3972,29486780,11105525,40592305,8,0,1,3584,8,1631433314
3973,29490470,2737693,32228163,2,0,0,36864,3,9810514047
3974,29500680,2399831,31900511,9,0,0,49152,12,4555234560
3975,29506640,2563839,32070479,9,0,0,11776,12,5092684631
3976,29506920,2708625,32215545,2,0,0,62976,3,4827839195
3977,29513790,2429986,31943776,2,0,0,1536,3,2677238848
3978,29524041,11068610,40592651,5,0,1,512,10,8097811616
3979,29525050,2581609,32106659,5,0,0,39424,10,4567134074
3980,29525130,11072347,40597477,8,0,1,7680,8,7225572929
3981,29532620,2651166,32183786,5,0,0,58880,10,9154473455
3982,29540900,11068125,40609025,9,0,1,46592,12,3445003989
3983,29541970,2753801,32295771,5,0,0,98304,10,2543142082
3984,29572771,11037880,40610651,5,0,1,2560,10,9062110508
3985,29583471,11058255,40641726,5,0,1,20480,10,10501360731
3986,29589160,11053334,40642494,9,0,1,11776,12,7314369060
3987,29591340,11051820,40643160,8,0,1,1024,8,8113552325
3988,29591870,2707044,32298914,9,0,0,10240,12,3867514278
3989,29599720,11147231,40746951,9,0,1,159744,12,1650213036
3990,29607680,2818271,32425951,5,0,0,73216,10,6360130305
3991,29617460,2951863,32569323,5,0,0,150528,10,5253430797
3992,29627320,11130902,40758222,8,0,1,5632,8,1673237122
3993,29644540,11155087,40799627,9,0,1,92672,12,549219071
3994,29652540,11153407,40805947,9,0,1,13824,12,7096792687
3995,29656350,2952683,32609033,9,0,0,23040,12,901871778
3996,29666330,2647165,32313495,5,0,0,7168,10,5077297322
3997,29674030,2678142,32352172,9,0,0,6656,12,6452445299
3998,29674310,2896619,32570929,2,0,0,5120,3,10221683895
3999,29688560,2740401,32428961,2,0,0,9728,3,10382640576
4000,29697430,11109183,40806613,8,0,1,1024,8,2364211211
4001,29704950,11109166,40814116,8,0,1,3584,8,10264932696
4002,29709051,11105731,40814782,5,0,1,1024,10,6012801496
4003,29712810,11105518,40818328,8,0,1,5632,8,4485109711
4004,29716160,11103424,40819584,1,0,1,1536,10,7647329724
4005,29719251,11101319,40820570,5,0,1,1536,10,10543738605
4006,29723701,11099455,40823156,5,0,1,4096,10,681166549
4007,29728420,2948891,32677311,5,0,0,135680,10,5728812783
4008,29752290,2950807,32703097,5,0,0,34816,10,1694837079
4009,29752660,11149026,40901686,9,0,1,102400,12,7255754263
4010,29756280,2834535,32590815,5,0,0,5120,10,9784098880
4011,29767770,11133939,40901709,8,0,1,2048,8,6558173568
4012,29769651,11132081,40901732,5,0,1,2560,10,6273036556
4013,29773170,11128585,40901755,1,0,1,1536,10,9373220734
4014,29777270,3075529,32852799,9,0,0,69632,12,977694711
4015,29780290,2967504,32747794,9,0,0,84480,12,9030823922
4016,29785120,11116658,40901778,1,0,1,15360,10,4472344509
4017,29790290,11112243,40902533,1,0,1,2048,10,1061763359
4018,29823110,2869356,32692466,9,0,0,49664,12,2991097720
4019,29830520,11074599,40905119,1,0,1,4096,10,10360050623
4020,29858680,11052639,40911319,8,0,1,1024,8,9297464282
4021,29865930,2848552,32714482,9,0,0,5632,12,6904147189
4022,29870771,11043454,40914225,5,0,1,4608,10,2912505754
4023,29883490,2872329,32755819,2,0,0,26112,3,3081995117
4024,29901521,11013370,40914891,5,0,1,1024,10,1073969715
4025,29903890,2992112,32896002,5,0,0,78336,10,294746280
4026,29904290,2802354,32706644,5,0,0,11264,10,885315737
4027,29906290,2865991,32772281,9,0,0,23552,12,5915261436
4028,29908471,11006676,40915147,5,0,1,9216,10,7597669227
4029,29912400,11005108,40917508,8,0,1,2560,8,968138261
4030,29921070,2791602,32712672,5,0,0,19456,10,8012487110
4031,29926080,2935965,32862045,5,0,0,3072,10,2461976421
4032,29929601,10994510,40924111,5,0,1,8192,10,2432975761
4033,29939670,2957291,32896961,5,0,0,3072,10,9150471855
4034,29943501,11004506,40948007,5,0,1,16896,10,4966894463
4035,29951820,10998453,40950273,8,0,1,3584,8,5544263486
4036,29961840,3042338,33004178,5,0,0,3584,10,10660477689
4037,29972830,10977789,40950619,1,0,1,512,10,4258442939
4038,29981050,3129680,33110730,5,0,0,68096,10,1412769396
4039,30001510,10949455,40950965,1,0,1,512,10,1188987528
4040,30008660,3005881,33014541,2,0,0,19456,3,1423697485
4041,30018930,3170763,33189693,5,0,0,118784,10,6524668824
4042,30021471,10934320,40955791,5,0,1,7680,10,8632136968
4043,30048150,3145755,33193905,9,0,0,13312,12,6217453965
4044,30052701,10903436,40956137,5,0,1,512,10,1118245149
4045,30056120,10904523,40960643,8,0,1,7168,8,4923185060
4046,30057630,2983704,33041334,5,0,0,27648,10,7032687997
4047,30059590,10902039,40961629,8,0,1,1536,8,338790756
4048,30068050,10894565,40962615,8,0,1,1536,8,1362554192
4049,30074491,10891030,40965521,5,0,1,4608,10,5773549280
4050,30083900,10883567,40967467,8,0,1,3072,8,805790502
4051,30108710,10861689,40970399,8,0,1,4608,8,1039166010
4052,30123051,10847502,40970553,5,0,1,8704,10,3500910773
4053,30133031,10839468,40972499,5,0,1,3072,10,585309131
4054,30165840,2792797,32958637,2,0,0,1024,3,711587308
4055,30176430,2951272,33127702,2,0,0,9728,3,5229001742
4056,30199080,10774405,40973485,8,0,1,1536,8,3060572610
4057,30200750,10780634,40981384,9,0,1,46080,12,1542766913
4058,30258120,2783439,33041559,2,0,0,512,3,393528093
4059,30290520,10692452,40982972,9,0,1,15872,12,6926418974
4060,30326090,2731943,33058033,5,0,0,22528,10,3501270746
4061,30345699,10651309,40997008,4,0,1,27648,15,2957541402
4062,30348510,2693852,33042362,2,0,0,2560,3,7844892232
4063,30362760,10739935,41102695,3,0,1,151552,17,2082341883
4064,30372600,10730118,41102718,0,0,1,2048,3,1203219485
4065,30373480,10729261,41102741,0,0,1,1024,3,10720140594
4066,30376840,2909417,33286257,5,0,0,60416,10,3327798177
4067,30425110,3172717,33597827,5,0,0,8704,10,8140216484
4068,30428590,10677119,41105709,3,0,1,5120,17,7240670478
4069,30441510,10670576,41112086,3,0,1,4608,17,8803558697
4070,30445040,10702841,41147881,8,0,1,8704,8,9448170548
4071,30454570,10710896,41165466,8,0,1,1024,8,2706739122
4072,30463350,3212590,33675940,2,0,0,1024,3,2866762206
4073,30465140,2870165,33335305,2,0,0,1536,3,321514858
4074,30475460,10690029,41165489,8,0,1,10752,8,5370493915
4075,30485340,2852484,33337824,5,0,0,8192,10,8811427611
4076,30515140,2745925,33261065,2,0,0,512,3,6250939631
4077,30528940,10636572,41165512,0,0,1,11776,3,10498175188
4078,30530320,10734999,41265319,3,0,1,70144,17,8837954918
4079,30537560,10727782,41265342,8,0,1,12800,8,2682221662
4080,30540810,10730569,41271379,0,0,1,13312,3,1591399783
4081,30546760,10726245,41273005,0,0,1,2560,3,7306630760
4082,30547641,10726670,41274311,5,0,1,2048,10,4955368121
4083,30548500,10727091,41275591,8,0,1,14336,8,7006599723
4084,30556130,10881558,41437688,3,0,1,295424,17,7332741563
4085,30556160,10884754,41440914,3,0,1,5120,17,6523697280
4086,30565789,2909321,33475110,3,0,0,46592,17,8952154756
4087,30577860,10865000,41442860,3,0,1,3072,17,2374986253
4088,30580470,10866256,41446726,8,0,1,6144,8,4057238427
4089,30587040,10861952,41448992,3,0,1,3584,17,8522225515
4090,30591440,10857808,41449248,8,0,1,9216,8,9006167363
4091,30603430,10847764,41451194,0,0,1,3072,3,980246484
4092,30603790,10850310,41454100,8,0,1,4608,8,7485021584
4093,30613730,10848345,41462075,8,0,1,4096,8,2804986297
4094,30652350,2788771,33441121,5,0,0,22528,10,9576563002
4095,30672820,2810851,33483671,2,0,0,1024,3,10140544030
4096,30683960,10778781,41462741,3,0,1,11264,17,2657420413
4097,30689800,2563345,33253145,2,0,0,1024,3,6460853509
4098,30693110,10776403,41469513,0,0,1,4608,3,6433987413
4099,30700040,10770037,41470077,8,0,1,10752,8,4379270502
4100,30706630,10764753,41471383,0,0,1,2048,3,3345399983
4101,30724690,10747359,41472049,0,0,1,1024,3,606852984
4102,30731770,10740769,41472539,3,0,1,512,17,2796960543
4103,30765860,2659244,33425104,5,0,0,59392,10,10530436975
4104,30782070,2578227,33360297,2,0,0,1024,3,4824081749
4105,30788010,10685297,41473307,3,0,1,11776,17,85802819
4106,30799640,10707887,41507527,3,0,1,3072,17,842013012
4107,30804390,2790762,33595152,5,0,0,107008,10,10217268983
4108,30815960,10692540,41508500,3,0,1,12800,17,2151866756
4109,30823270,10717771,41541041,0,0,1,17408,3,9507569713
4110,30824010,10720454,41544464,3,0,1,1536,17,6149535303
4111,30824570,10723311,41547881,3,0,1,4608,17,1208411130
4112,30825490,10723364,41548854,8,0,1,12800,8,1445524007
4113,30840800,10712511,41553311,8,0,1,10752,8,4457328347
4114,30845180,10708724,41553904,0,0,1,512,3,7688773121
4115,30878420,10676150,41554570,8,0,1,1024,8,7227920447
4116,30882179,10672737,41554916,4,0,1,512,15,8312221991
4117,30897370,2430427,33327797,5,0,0,15872,10,6428050727
4118,30919870,10637632,41557502,8,0,1,4096,8,6412525897
4119,30936440,10622048,41558488,0,0,1,1536,3,2144247357
4120,30945070,10614084,41559154,8,0,1,1024,8,6180893378
4121,30948720,10613660,41562380,3,0,1,5120,17,10376413355
4122,30951550,10616630,41568180,8,0,1,3584,8,5077685199
4123,30952251,10618515,41570766,5,0,1,4096,10,517237865
4124,30959961,10613071,41573032,5,0,1,3584,10,7337466945
4125,30983030,2475842,33458872,5,0,0,6656,10,5079113979
4126,30992270,10583668,41575938,0,0,1,4608,3,10088218246
4127,30995820,10582704,41578524,3,0,1,4096,17,2060160428
4128,31011300,2335021,33346321,2,0,0,512,3,2297352989
4129,31017600,10565750,41583350,3,0,1,7680,17,8924113291
4130,31030100,10553596,41583696,0,0,1,512,3,8105636809
4131,31033650,10550814,41584464,0,0,1,11776,3,9876759969
4132,31038001,10546809,41584810,5,0,1,512,10,4663506791
4133,31045540,10539424,41584964,3,0,1,8704,17,7371923907
4134,31063970,10534960,41598930,9,0,1,19456,12,6878606234
4135,31075630,2522867,33598497,2,0,0,512,3,6583601597
4136,31077050,10522226,41599276,8,0,1,512,8,8696103686
4137,31078010,10521612,41599622,8,0,1,512,8,7849397646
4138,31079690,10522838,41602528,3,0,1,4608,17,5229696000
4139,31090770,10517447,41608217,3,0,1,8192,17,181419720
4140,31091330,2506988,33598318,2,0,0,1536,3,4064975824
4141,31100380,10510423,41610803,3,0,1,4096,17,4157124190
4142,31100900,2391658,33492558,2,0,0,1024,3,4007456672
4143,31118490,2586458,33704948,5,0,0,70656,10,3069161581
4144,31133160,10481189,41614349,0,0,1,5632,3,7983006446
4145,31136150,10482065,41618215,3,0,1,6144,17,8610331450
4146,31137230,10485811,41623041,8,0,1,7680,8,811770609
4147,31151100,2383715,33534815,5,0,0,1536,10,5965979624
4148,31152590,10474803,41627393,8,0,1,6656,8,6611705983
4149,31153540,2494796,33648336,2,0,0,16896,3,4321819588
4150,31153780,10474279,41628059,3,0,1,1024,17,4208764713
4151,31156871,2687630,33844501,7,0,0,41472,10,2527567225
4152,31178360,10450685,41629045,8,0,1,1536,8,4521905943
4153,31182870,10447161,41630031,8,0,1,1536,8,6996433803
4154,31190630,10440387,41631017,3,0,1,1536,17,2472186616
4155,31191550,2475741,33667291,2,0,0,5120,3,717343035
4156,31196130,10438753,41634883,8,0,1,6144,8,5699745279
4157,31207080,10430389,41637469,3,0,1,4096,17,10322942139
4158,31207960,10434087,41642047,8,0,1,6144,8,10374377845
4159,31211281,10437487,41648768,5,0,1,24064,10,10613971404
4160,31220710,2382022,33602732,5,0,0,13824,10,8122634315
4161,31234900,2423445,33658345,2,0,0,4096,3,5399825144
4162,31256470,10414779,41671249,0,0,1,3072,3,3636136547
4163,31257440,10414373,41671813,0,0,1,10752,3,6041610048
4164,31265480,2347369,33612849,5,0,0,30720,10,5918004088
4165,31271740,2402126,33673866,5,0,0,21504,10,9322837709
4166,31309180,10362979,41672159,8,0,1,512,8,96415750
4167,31309560,2366045,33675605,2,0,0,5632,3,2058749995
4168,31315010,10358327,41673337,3,0,1,13824,17,7354774461
4169,31323049,10414770,41737819,4,0,1,116224,15,5705256118
4170,31346690,10414085,41760775,3,0,1,6656,17,9317801616
4171,31346960,2400340,33747300,2,0,0,34304,3,2915879694
4172,31349049,10421450,41770499,4,0,1,5632,15,3951396155
4173,31365930,10406107,41772037,3,0,1,512,17,10018034584
4174,31366910,2688850,34055760,2,0,0,40448,3,10474835825
4175,31371419,10480200,41851619,4,0,1,43520,15,3821732504
4176,31399871,10453374,41853245,5,0,1,2560,10,6380664242
4177,31408410,2439546,33847956,2,0,0,11264,3,6179399847
4178,31413371,10440220,41853591,5,0,1,512,10,10090687775
4179,31419471,10434479,41853950,5,0,1,9728,10,7111078650
4180,31428991,10431593,41860584,5,0,1,13312,10,1235582174
4181,31438790,10441612,41880402,3,0,1,2048,17,2691932830
4182,31459330,2605813,34065143,5,0,0,30720,10,7429476472
4183,31460930,2609696,34070626,2,0,0,17920,3,819843028
4184,31464220,2454452,33918672,2,0,0,34304,3,7871449072
4185,31465051,10416017,41881068,5,0,1,1024,10,10667195365
4186,31489189,10470670,41959859,4,0,1,115712,15,3494304922
4187,31498339,10492007,41990346,4,0,1,19456,15,9407051940
4188,31502140,10488360,41990500,8,0,1,8704,8,10369312674
4189,31504271,10486383,41990654,5,0,1,8704,10,4313576598
4190,31508840,10486320,41995160,3,0,1,7168,17,1971730079
4191,31519770,10492780,42012550,8,0,1,8704,8,4350899684
4192,31524229,10544616,42068845,4,0,1,64512,15,10680903776
4193,31529800,2625534,34155334,5,0,0,23552,10,4548151820
4194,31544970,10528381,42073351,8,0,1,7168,8,604193610
4195,31562140,10521427,42083567,8,0,1,4096,8,382009935
4196,31564830,10527762,42092592,8,0,1,10752,8,429503380
4197,31569340,2517785,34087125,2,0,0,26624,3,1047421371
4198,31596491,10496124,42092615,5,0,1,1024,10,4521612542
4199,31597570,10495076,42092646,3,0,1,10752,17,3141892618
4200,31597749,10517912,42115661,4,0,1,34816,15,1337161856
4201,31599450,10523979,42123429,8,0,1,3584,8,9452219539
4202,31601480,2523725,34125205,8,0,0,16384,8,4446546521
4203,31606051,10518364,42124415,8,0,1,1536,8,6922257257
4204,31618900,2483484,34102384,8,0,0,7168,8,10438167066
4205,31624380,10503581,42127961,3,0,1,5632,17,90824387
4206,31626480,10507434,42133914,8,0,1,28160,8,8747165285
4207,31636480,2671045,34307525,8,0,0,10752,8,2887729046
4208,31657980,10478776,42136756,3,0,1,13312,17,4100724246
4209,31665609,10492878,42158487,4,0,1,33280,15,5906014008
4210,31667829,10506163,42173992,4,0,1,19456,15,5882002679
4211,31682919,10509441,42192360,4,0,1,8704,15,6143955111
4212,31692560,2504537,34197097,2,0,0,30720,3,4858285684
4213,31696101,10513627,42209728,5,0,1,9216,10,717604471
4214,31729180,10481854,42211034,8,0,1,2048,8,8984614973
4215,31731200,10490163,42221363,3,0,1,4096,17,7616220452
4216,31735970,2528070,34264040,2,0,0,6144,3,7771263828
4217,31742519,10484658,42227177,4,0,1,29696,15,1205233590
4218,31765619,10467690,42233309,4,0,1,9728,15,4852257550
4219,31778810,10454845,42233655,3,0,1,512,17,479559916
4220,31787210,2532909,34320119,2,0,0,17408,3,9802508484
4221,31791340,2591655,34382995,2,0,0,43008,3,2080641734
4222,31804780,10534072,42338852,9,0,1,107520,12,7407504183
4223,31817420,10622457,42439877,9,0,1,115200,12,10499541704
4224,31840520,10603223,42443743,3,0,1,6144,17,1253743552
4225,31865990,2503878,34369868,2,0,0,45056,3,8527591332
4226,31893190,10552499,42445689,3,0,1,3072,17,5860246370
4227,31898650,2529229,34427879,2,0,0,26624,3,6110003349
4228,31901600,10544435,42446035,8,0,1,512,8,9362552984
4229,31904660,2447968,34352628,5,0,0,10752,10,3375639066
4230,31919550,10527151,42446701,9,0,1,11264,12,9670745348
4231,31919820,2586349,34506169,8,0,0,64000,8,3898861636
4232,31941010,2572583,34513593,8,0,0,24064,8,1860295867
4233,31956751,10490206,42446957,8,0,1,9216,8,9114477155
4234,31969780,10480773,42450553,0,0,1,4608,3,5909420361
4235,31970690,10481169,42451859,2,0,1,2048,3,7666536576
4236,31984190,2649246,34633436,2,0,0,53248,3,10416704777
4237,31990359,10490755,42481114,4,0,1,48128,15,3843684509
4238,31994159,10502129,42496288,4,0,1,9216,15,1028903423
4239,32000900,2673774,34674674,8,0,0,43008,8,9503899361
4240,32004719,10521518,42526237,4,0,1,46592,15,10176529748
4241,32009230,10529899,42539129,8,0,1,512,8,4959831524
4242,32020050,10521025,42541075,9,0,1,3072,12,10690359393
4243,32022470,2719326,34741796,2,0,0,35328,3,9878866667
4244,32031750,10528047,42559797,9,0,1,60416,12,5848730014
4245,32039429,10563302,42602731,4,0,1,68096,15,7282231476
4246,32045350,2861246,34906596,8,0,0,53760,8,144493208
4247,32080130,2663873,34744003,8,0,0,7168,8,1583260310
4248,32082450,10520537,42602987,9,0,1,9216,12,5413862868
4249,32083309,10665852,42749161,4,0,1,258560,15,1879291219
4250,32120940,2759991,34880931,8,0,0,76288,8,8809152197
4251,32123930,10712920,42836850,9,0,1,102912,12,9701564499
4252,32145469,10834042,42979511,4,0,1,160256,15,1781132877
4253,32153839,10829858,42983697,4,0,1,6656,15,5051403867
4254,32175779,10813512,42989291,4,0,1,18432,15,9149421334
4255,32182300,10809168,42991468,9,0,1,14336,12,5492411142
4256,32204379,10794796,42999175,4,0,1,25600,15,3450048208
4257,32206209,10863021,43069230,4,0,1,133632,15,7745824943
4258,32212100,10868182,43080282,2,0,1,4096,3,242763896
4259,32244460,10840328,43084788,6,0,1,7168,7,10289091114
4260,32253870,10850352,43104222,9,0,1,44544,12,3836855259
4261,32260390,2676657,34937047,8,0,0,10240,8,3143395253
4262,32314340,2861933,35176273,2,0,0,57856,3,6187563897
4263,32327300,10780954,43108254,9,0,1,13312,12,339674414
4264,32338580,10770660,43109240,9,0,1,1536,12,8184427402
4265,32345750,2673878,35019628,8,0,0,46080,8,2134759803
4266,32350559,10759027,43109586,4,0,1,512,15,170034342
4267,32357470,2978666,35336136,8,0,0,103424,8,9626067065
4268,32359610,10754802,43114412,9,0,1,7680,12,8799649706
4269,32360260,10757058,43117318,0,0,1,4608,3,9912006293
4270,32375360,10744224,43119584,9,0,1,3584,12,8888245936
4271,32384229,10738901,43123130,4,0,1,5632,15,9619518286
4272,32424390,2752842,35177232,8,0,0,3072,8,2424934013
4273,32440630,10691702,43132332,9,0,1,14848,12,8130834224
4274,32469600,2505148,34974748,2,0,0,4096,3,9089059903
4275,32470560,10674107,43144667,9,0,1,2048,12,7667341990
4276,32520310,10625663,43145973,9,0,1,2048,12,779468780
4277,32534539,10614340,43148879,4,0,1,4608,15,1896518294
4278,32536950,2570329,35107279,2,0,0,59392,3,3031508789
4279,32540430,10610715,43151145,9,0,1,3584,12,2672662928
4280,32547480,10607211,43154691,9,0,1,5632,12,8507045892
4281,32559130,2799961,35359091,8,0,0,75264,8,969065004
4282,32574870,2717953,35292823,2,0,0,37376,3,267066093
4283,32602310,10553687,43155997,9,0,1,2048,12,852132050
4284,32603960,2761931,35365891,8,0,0,22016,8,9363748077
4285,32609570,10547413,43156983,9,0,1,1536,12,7150464589
4286,32610330,2876157,35486487,8,0,0,20480,8,7803625787
4287,32622390,10539419,43161809,3,0,1,7680,17,2541012748
4288,32625420,2829709,35455129,2,0,0,15872,3,9108971182
4289,32648579,10517340,43165919,4,0,1,16384,15,6710944680
4290,32659040,10511065,43170105,9,0,1,6656,12,8861350103
4291,32682500,10490511,43173011,9,0,1,4608,12,3421502835
4292,32709910,10465687,43175597,2,0,1,4096,3,6912241073
4293,32717100,10459265,43176365,2,0,1,11776,3,7077779588
4294,32730320,10448951,43179271,9,0,1,4608,12,3460127148
4295,32735850,10444407,43180257,6,0,1,1536,7,6721627476
4296,32737760,3047919,35785679,2,0,0,27136,3,7762802409
4297,32778830,10404653,43183483,1,0,1,5120,10,1905369248
4298,32787520,10400815,43188335,9,0,1,7680,12,8901590416
4299,32790730,10398271,43189001,1,0,1,1024,10,8057722267
4300,32796960,2820231,35617191,8,0,0,27136,8,8742170626
4301,32800140,10391447,43191587,1,0,1,4096,10,6701761617
4302,32814160,2783280,35597440,8,0,0,14336,8,9163338909
4303,32818463,2761643,35580106,8,0,0,17920,8,401090896
4304,32823320,10368728,43192048,2,0,1,10240,3,5111119327
4305,32831650,10370212,43201862,1,0,1,17408,10,3272262685
4306,32832930,10369598,43202528,9,0,1,1024,12,3176216210
4307,32841430,10365924,43207354,1,0,1,7680,10,2228247627
4308,32851660,10358600,43210260,9,0,1,4608,12,10727146695
4309,32851860,2853314,35705174,8,0,0,87040,8,7588976720
4310,32857820,10353746,43211566,9,0,1,2048,12,769407921
4311,32871400,3023139,35894539,8,0,0,3072,8,6097684940
4312,32888370,10326742,43215112,9,0,1,5632,12,10285383793
4313,32888710,10327388,43216098,6,0,1,1536,7,6090713393
4314,32895250,10321514,43216764,1,0,1,1024,10,8557055857
4315,32897430,3045810,35943240,8,0,0,26624,8,10283946514
4316,32908950,10312000,43220950,9,0,1,6656,12,1929881137
4317,32910980,10357520,43268500,1,0,1,27648,10,3126401300
4318,32915520,3015561,35931081,2,0,0,48640,3,4672378481
4319,32921220,10347303,43268523,6,0,1,1024,7,1696413834
4320,32922380,3236452,36158832,2,0,0,116224,3,191204311
4321,32925700,3151478,36077178,2,0,0,9216,3,238202458
4322,32930400,10338146,43268546,6,0,1,1024,7,4722465423
4323,32930890,10337679,43268569,2,0,1,512,3,10645849065
4324,32938320,10330272,43268592,1,0,1,1024,10,9300232411
4325,32939160,3249280,36188440,2,0,0,24064,3,4696173487
4326,32946820,3359083,36305903,2,0,0,51200,3,1660076164
4327,32955610,10313005,43268615,1,0,1,3584,10,3425223197
4328,32959870,3133386,36093256,8,0,0,34304,8,5847294349
4329,32970400,10298270,43268670,1,0,1,17920,10,4576953563
4330,32986070,10282623,43268693,1,0,1,3584,10,5188895398
4331,33005900,10262816,43268716,9,0,1,2048,12,390680917
4332,33007470,10261269,43268739,9,0,1,1536,12,481956662
4333,33009590,2983218,35992808,8,0,0,15360,8,214372161
4334,33010710,10258052,43268762,2,0,1,512,3,4875832373
4335,33013320,3405340,36418660,2,0,0,50176,3,3381252481
4336,33021600,3322939,36344539,8,0,0,61952,8,6093347802
4337,33024010,10244775,43268785,1,0,1,1536,10,8637813607
4338,33031430,10237402,43268832,1,0,1,512,10,9504944605
4339,33073390,10195886,43269276,9,0,1,11264,12,668928010
4340,33087630,3500316,36587946,8,0,0,147456,8,1956748175
4341,33105880,10165982,43271862,1,0,1,4096,10,1272688836
4342,33106180,10167308,43273488,1,0,1,2560,10,5572460040
4343,33113630,10162764,43276394,6,0,1,4608,7,10205351919
4344,33116620,10163960,43280580,6,0,1,6656,7,10437060769
4345,33128000,10155166,43283166,9,0,1,4096,12,7737214514
4346,33129160,3231346,36360506,2,0,0,28160,3,3927102487
4347,33136340,3288849,36425189,8,0,0,4608,8,4624229889
4348,33138500,3226264,36364764,2,0,0,13824,3,3596542118
4349,33139360,10143960,43283320,9,0,1,8704,12,3383546334
4350,33142660,10142606,43285266,1,0,1,3072,10,6551894300
4351,33165980,3564931,36730911,8,0,0,32256,8,5027314320
4352,33168620,10117312,43285932,1,0,1,1024,10,2426315967
4353,33171790,10115448,43287238,9,0,1,2048,12,4267243924
4354,33180460,10114040,43294500,0,0,1,7168,3,8125565747
4355,33205440,10092926,43298366,1,0,1,6144,10,928955312
4356,33213570,10086102,43299672,6,0,1,2048,7,5286129014
4357,33216450,10106489,43322939,1,0,1,19456,10,1469049693
4358,33235830,10091615,43327445,9,0,1,7168,12,254031130
4359,33243090,3388596,36631686,2,0,0,19968,3,9198229020
4360,33245781,10087770,43333551,5,0,1,20992,10,7074503730
4361,33251510,10084637,43336147,9,0,1,3072,12,5190144053
4362,33265241,10087573,43352814,5,0,1,25600,10,8502727314
4363,33265860,10089860,43355720,6,0,1,4608,7,179085456
4364,33279510,3186660,36466170,2,0,0,9216,3,5326564227
4365,33286491,10069575,43356066,5,0,1,512,10,328139216
4366,33291120,3225686,36516806,8,0,0,4096,8,5282656219
4367,33293660,10066912,43360572,9,0,1,7168,12,1973403226
4368,33294430,10067218,43361648,6,0,1,13312,7,2711128947
4369,33325700,10050242,43375942,6,0,1,8704,7,2407612379
4370,33334330,10042918,43377248,6,0,1,2048,7,1818017922
4371,33337290,10042864,43380154,6,0,1,4608,7,2380012957
4372,33348990,10031830,43380820,1,0,1,1024,10,7885318201
4373,33361951,10020815,43382766,5,0,1,3072,10,7176375263
4374,33363020,10023292,43386312,9,0,1,5632,12,5459805226
4375,33363860,10023425,43387285,6,0,1,12800,7,4112080919
4376,33368820,3321912,36690732,2,0,0,26112,3,8223527937
4377,33377230,10036651,43413881,1,0,1,17408,10,165890824
4378,33377690,10049537,43427227,6,0,1,1024,7,4852213565
4379,33378580,10048993,43427573,9,0,1,512,12,5851668174
4380,33404430,10023809,43428239,1,0,1,1024,10,8523807912
4381,33428760,10005290,43434050,1,0,1,1536,10,6212525645
4382,33436820,10000456,43437276,7,0,1,5120,10,4163438150
4383,33436900,10003282,43440182,6,0,1,4608,7,6990082840
4384,33449840,9993248,43443088,9,0,1,4608,12,3159020333
4385,33459220,9999105,43458325,1,0,1,6144,10,3122847716
4386,33482040,9977591,43459631,9,0,1,2048,12,4971758987
4387,33483140,9981554,43464694,6,0,1,10240,7,4718863893
4388,33518650,3562223,37080873,8,0,0,19456,8,7546634581
4389,33525960,9941000,43466960,1,0,1,3584,10,3827296689
4390,33533200,9934016,43467216,1,0,1,9216,10,399655713
4391,33533690,9956306,43489996,1,0,1,2048,10,3443545587
4392,33537410,9953572,43490982,2,0,1,1536,3,402512657
4393,33550270,9943618,43493888,6,0,1,4608,7,7916170836
4394,33552780,9942734,43495514,1,0,1,2560,10,5764370019
4395,33561830,3334332,36896162,8,0,0,27136,8,2648386346
4396,33572250,9929909,43502159,6,0,1,13824,7,5210166373
4397,33580160,3209811,36789971,2,0,0,24064,3,6221846511
4398,33590690,9952531,43543221,6,0,1,512,7,1750959134
4399,33597580,3335114,36932694,6,0,0,10752,7,5567458048
4400,33599920,3429860,37029780,6,0,0,5632,7,862736650
4401,33632510,9911057,43543567,6,0,1,512,7,8052727354
4402,33663050,3334896,36997946,2,0,0,31744,3,4485789538
4403,33686580,9857973,43544553,2,0,1,1536,3,7401686484
4404,33688410,9900534,43588944,6,0,1,2048,7,10538265945
4405,33691400,9900450,43591850,6,0,1,4608,7,5068065288
4406,33694070,3688543,37382613,2,0,0,18944,3,9244990349
4407,33715880,9878556,43594436,6,0,1,4096,7,1460116542
4408,33717310,9879712,43597022,2,0,1,4096,3,5061284331
4409,33719150,9880138,43599288,6,0,1,3584,7,1693972918
4410,33720140,9883520,43603660,6,0,1,3072,7,593488068
4411,33720940,3498532,37219472,2,0,0,115200,3,7006160674
4412,33766460,3529722,37296182,2,0,0,59904,3,9191310572
4413,33814900,9789106,43604006,6,0,1,512,7,4007945391
4414,33817580,9789332,43606912,6,0,1,4608,7,2467348761
4415,33829070,9781388,43610458,6,0,1,5632,7,7828276139
4416,33845400,3636850,37482250,2,0,0,24064,3,9509801639
4417,33855040,3484523,37339563,8,0,0,11264,8,10003493440
4418,33898140,9713496,43611636,1,0,1,13824,10,9595467423
4419,33901170,9843438,43744608,1,0,1,1024,10,9507837641
4420,33917840,9835217,43753057,3,0,1,2048,17,3123289874
4421,33917871,9836466,43754337,8,0,1,14336,8,3001010429
4422,33923610,9958619,43882229,0,0,1,3072,3,4038497363
4423,33934830,3529172,37464002,2,0,0,19456,3,6390619842
4424,33941960,3294695,37236655,6,0,0,56320,7,2075694720
4425,33945800,9937255,43883055,9,0,1,1536,12,5349718743
4426,33952550,3049163,37001713,8,0,0,12288,8,7153831179
4427,33967310,9925132,43892442,3,0,1,22016,17,1935919645
4428,34009700,3385308,37395008,8,0,0,20992,8,6838543324
4429,34015490,3493324,37508814,6,0,0,17920,7,5754243883
4430,34015780,9908704,43924484,9,0,1,12288,12,8400889898
4431,34016650,3327460,37344110,6,0,0,14848,7,1804786681
4432,34028850,9895657,43924507,1,0,1,9216,10,6794718237
4433,34036030,3260331,37296361,8,0,0,512,8,10107375920
4434,34049160,9875370,43924530,6,0,1,512,7,20427350
4435,34062340,9862213,43924553,0,0,1,7168,3,8780800301
4436,34076350,3201517,37277867,2,0,0,87552,3,1570039436
4437,34081830,9842746,43924576,1,0,1,3072,10,5441201931
4438,34084020,9880382,43964402,9,0,1,3072,12,4683733177
4439,34095310,9869115,43964425,6,0,1,7168,7,2932951660
4440,34121630,9842818,43964448,9,0,1,1024,12,3508966122
4441,34130660,3546287,37676947,8,0,0,29696,8,4957737790
4442,34135240,9829239,43964479,1,0,1,5120,10,7395716549
4443,34136960,9827574,43964534,6,0,1,4096,7,5609290758
4444,34144090,9830029,43974119,1,0,1,1536,10,9426656748
4445,34148241,9825901,43974142,5,0,1,512,10,6777037983
4446,34169560,3081608,37251168,8,0,0,47104,8,10559539997
4447,34176050,9798115,43974165,9,0,1,4608,12,4279832789
4448,34189991,9784197,43974188,5,0,1,1536,10,8709295775
4449,34190230,9783981,43974211,6,0,1,13824,7,4350887177
4450,34214750,9759484,43974234,6,0,1,13312,7,1677985709
4451,34241860,9747731,43989591,9,0,1,2048,12,3620866763
4452,34255901,9733713,43989614,5,0,1,6656,10,2570110675
4453,34258810,9730851,43989661,1,0,1,7680,10,7855039720
4454,34265590,3489054,37754644,6,0,0,104448,7,8244249820
4455,34273361,9716331,43989692,5,0,1,3072,10,5427260951
4456,34276000,3032554,37308554,2,0,0,19456,3,6343823262
4457,34281871,9707844,43989715,5,0,1,3584,10,839434217
4458,34305580,3467976,37773556,6,0,0,49664,7,916193493
4459,34308100,9681638,43989738,1,0,1,4608,10,6751228322
4460,34325500,9724034,44049534,1,0,1,7680,10,3830533198
4461,34342820,3313622,37656442,6,0,0,55808,7,9542553714
4462,34349390,9700167,44049557,1,0,1,5632,10,5888464462
4463,34359600,3297801,37657401,6,0,0,3072,7,4996710606
4464,34363590,9688509,44052099,6,0,1,512,7,6078831318
4465,34368900,9683222,44052122,6,0,1,512,7,4634293895
4466,34376711,9675434,44052145,5,0,1,8704,10,8815092579
4467,34379790,3259625,37639415,2,0,0,168448,3,3404458987
4468,34380080,9672088,44052168,8,0,1,512,8,7670150614
4469,34393220,9658971,44052191,1,0,1,5632,10,6706739646
4470,34399880,3282768,37682648,2,0,0,18432,3,2769527309
4471,34420830,9644558,44065388,1,0,1,5632,10,6393311292
4472,34422671,9642871,44065542,5,0,1,8704,10,5960482860
4473,34426890,3533406,37960296,2,0,0,22528,3,87401753
4474,34435490,9631358,44066848,1,0,1,2048,10,4479809913
4475,34442670,3225206,37667876,6,0,0,34304,7,5685200280
4476,34444200,9654800,44099000,6,0,1,8704,7,9124346019
4477,34459320,9644094,44103414,1,0,1,7168,10,7824491344
4478,34468160,9645557,44113717,1,0,1,6656,10,5385940932
4479,34471060,9673950,44145010,6,0,1,3584,7,8039879888
4480,34500121,9644912,44145033,5,0,1,5632,10,7029479510
4481,34503140,3059101,37562241,2,0,0,5632,3,9107406487
4482,34508650,9636406,44145056,6,0,1,8704,7,613146369
4483,34509040,3359610,37868650,6,0,0,128000,7,1592322420
4484,34525640,9622168,44147808,1,0,1,1536,10,7443947316
4485,34547100,9605534,44152634,6,0,1,7680,7,8352447491
4486,34548590,3527342,38075932,2,0,0,67072,3,8004939060
4487,34562750,9590550,44153300,1,0,1,1024,10,8063251548
4488,34568370,9589978,44158348,1,0,1,3584,10,6601141410
4489,34585780,9575474,44161254,1,0,1,4608,10,7035912204
4490,34597951,9565249,44163200,5,0,1,3072,10,3376622135
4491,34598750,9577621,44176371,6,0,1,9728,7,4597262901
4492,34601180,3314151,37915331,2,0,0,512,3,7318281915
4493,34620331,9564139,44184470,5,0,1,3072,10,1926731394
4494,34621861,9576538,44198399,5,0,1,5120,10,1059035890
4495,34630831,9568234,44199065,5,0,1,11264,10,10045264665
4496,34649360,3134671,37784031,6,0,0,34304,7,2732979052
4497,34651690,3143651,37795341,2,0,0,11776,3,9834755888
4498,34687860,9520897,44208757,1,0,1,2560,10,7883351384
4499,34693461,9518842,44212303,5,0,1,5632,10,6191622501
4500,34733210,3322263,38055473,6,0,0,71168,7,2716293183
4501,34751051,9461598,44212649,5,0,1,512,10,2026423401
4502,34751730,3173267,37924997,6,0,0,14336,7,740730858
4503,34755051,9458904,44213955,5,0,1,2048,10,1956659896
4504,34768630,3409862,38178492,6,0,0,114688,7,7469998593
4505,34769410,3323869,38093279,2,0,0,56832,3,6281814738
4506,34799780,9415481,44215261,1,0,1,2048,10,4021051537
4507,34804660,3133103,37937763,6,0,0,20992,7,244003977
4508,34813790,9402457,44216247,1,0,1,1536,10,2875974264
4509,34843590,9373323,44216913,1,0,1,1024,10,831741965
4510,34854130,3242167,38096297,6,0,0,9728,7,8039219979
4511,34896960,3438461,38335421,6,0,0,51200,7,7782670748
4512,34905949,3328601,38234550,3,0,0,105472,17,5876867068
4513,34921340,3281043,38202383,6,0,0,78336,7,2141724118
4514,34929570,9288649,44218219,1,0,1,2048,10,9480983862
4515,34940909,9280216,44221125,4,0,1,4608,15,8157474060
4516,34952729,9283786,44236515,4,0,1,7168,15,9814064680
4517,34964671,9271867,44236538,5,0,1,3072,10,7934056224
4518,34969120,3274087,38243207,2,0,0,5120,3,8076190919
4519,34976960,3264633,38241593,6,0,0,23040,7,5845775272
4520,34979450,3369561,38349011,2,0,0,9728,3,665708946
4521,34981190,9255371,44236561,9,0,1,2560,12,7049994351
4522,34989390,9249835,44239225,1,0,1,5632,10,1184868307
4523,34996280,9243291,44239571,9,0,1,512,12,275887114
4524,35028520,9212895,44241415,1,0,1,25088,10,8825445096
4525,35061320,3754731,38816051,2,0,0,203264,3,4188662411
4526,35062400,9186408,44248808,2,0,1,4096,3,10058098649
4527,35067000,9187430,44254430,2,0,1,5120,3,4561700857
4528,35078470,9177906,44256376,2,0,1,3072,3,3547857542
4529,35086270,9171732,44258002,2,0,1,2560,3,3991258897
4530,35086620,3791213,38877833,2,0,0,72192,3,6653663402
4531,35089270,9172278,44261548,2,0,1,5632,3,6224021293
4532,35090940,3381858,38472798,2,0,0,32768,3,10004238574
4533,35094310,3489257,38583567,2,0,0,20480,3,4411338267
4534,35123210,3316461,38439671,2,0,0,34304,3,10010050561
4535,35136119,9130255,44266374,4,0,1,7680,15,908954505
4536,35136430,9131250,44267680,2,0,1,2048,3,4732974141
4537,35140590,9128076,44268666,2,0,1,1536,3,10354743672
4538,35149520,9122052,44271572,6,0,1,4608,7,9898323963
4539,35156750,9115488,44272238,2,0,1,1024,3,7038642862
4540,35179150,3440981,38620131,6,0,0,24064,7,10448466633
4541,35179870,9128459,44308329,1,0,1,11776,10,7825421993
4542,35186100,9127573,44313673,2,0,1,512,3,1351729952
4543,35195530,9125956,44321486,1,0,1,6656,10,750735741
4544,35203670,9125299,44328969,2,0,1,4096,3,7514137781
4545,35218240,3636924,38855164,2,0,0,2560,3,5299215924
4546,35236780,9092535,44329315,2,0,1,512,3,1289170318
4547,35238790,9091511,44330301,2,0,1,1536,3,7634805535
4548,35253170,9077477,44330647,2,0,1,512,3,1204057112
4549,35287840,3803008,39090848,6,0,0,117248,7,5349388912
4550,35289420,9042853,44332273,2,0,1,2560,3,4437278159
4551,35293620,3588693,38882313,2,0,0,3072,3,7129442366
4552,35302010,3407741,38709751,2,0,0,62464,3,5402231883
4553,35309330,3215471,38524801,6,0,0,9216,7,8860076225
4554,35315040,9017899,44332939,2,0,1,1024,3,1587755004
4555,35368590,3532564,38901154,6,0,0,41472,7,7021244214
4556,35381220,3177871,38559091,2,0,0,12800,3,2010409785
4557,35397380,3207497,38604877,6,0,0,19968,7,3990889402
4558,35440330,8939998,44380328,2,0,1,3072,3,10006281398
4559,35479140,8901854,44380994,2,0,1,11264,3,2810906174
4560,35484750,3109341,38594091,2,0,0,4608,3,2260105266
4561,35516470,8905823,44422293,2,0,1,13312,3,6376385036
4562,35517260,3448818,38966078,2,0,0,12288,3,1164522471
4563,35564100,8859026,44423126,2,0,1,13824,3,4367543038
4564,35577400,8846392,44423792,2,0,1,1024,3,4281781661
4565,35577880,8847218,44425098,2,0,1,2048,3,8450841727
4566,35586130,3347296,38933426,6,0,0,26112,7,10555399103
4567,35588470,8846133,44434603,2,0,1,6656,3,3811080863
4568,35590210,3508617,39098827,6,0,0,26112,7,8612843377
4569,35610400,8845169,44455569,7,0,1,1024,10,10263964511
4570,35638361,8871262,44509623,8,0,1,5120,8,4709612950
4571,35640240,8870049,44510289,2,0,1,1024,3,2704668984
4572,35665390,3705560,39370950,2,0,0,221184,3,6475933418
4573,35670800,3542107,39212907,2,0,0,9216,3,7723240525
4574,35678010,8833265,44511275,9,0,1,1536,12,6313351502
4575,35687320,8824941,44512261,2,0,1,1536,3,8620510080
4576,35694670,3706122,39400792,6,0,0,94720,7,8560556985
4577,35706911,8826603,44533514,8,0,1,3584,8,3168832442
4578,35707530,3230729,38938259,6,0,0,4096,7,2642341545
4579,35726121,8807416,44533537,8,0,1,12288,8,5559317782
4580,35736650,8796910,44533560,0,0,1,2048,3,9548371470
4581,35738390,8795193,44533583,0,0,1,3584,3,693510761
4582,35742990,8790616,44533606,7,0,1,2048,10,968938324
4583,35745610,3464466,39210076,2,0,0,79872,3,8085101261
4584,35746950,3654535,39401485,6,0,0,2048,7,9139056957
4585,35754300,8780147,44534447,9,0,1,3584,12,6650751107
4586,35754670,3347300,39101970,6,0,0,10240,7,1749287876
4587,35761280,8776713,44537993,9,0,1,5632,12,1912631464
4588,35789200,8750739,44539939,9,0,1,3072,12,1045994481
4589,35792980,8751943,44544923,9,0,1,6144,12,2005211987
4590,35793991,8778003,44571994,8,0,1,4608,8,1560788051
4591,35794680,8795814,44590494,2,0,1,3072,3,722924907
4592,35800530,8791797,44592327,9,0,1,512,12,9150635422
4593,35820400,8772913,44593313,2,0,1,1536,3,6612195318
4594,35820570,8799738,44620308,2,0,1,3584,3,243670499
4595,35843550,8776781,44620331,9,0,1,4608,12,2387199906
4596,35852970,8883760,44736730,1,0,1,93696,10,3752589030
4597,35872440,3580780,39453220,6,0,0,38912,7,2615367228
4598,35876050,8972388,44848438,1,0,1,58880,10,6158426210
4599,35887170,9036688,44923858,9,0,1,1024,12,2561367871
4600,35889730,9036845,44926575,1,0,1,19968,10,590448
4601,35895090,9076360,44971450,2,0,1,9216,3,5084021883
4602,35898460,3473449,39371909,6,0,0,3072,7,3611422510
4603,35907210,9194266,45101476,1,0,1,38400,10,6604163098
4604,35920510,9195641,45116151,1,0,1,15872,10,8713761573
4605,35947560,3216234,39163794,2,0,0,7168,3,7402108490
4606,35951530,9172543,45124073,9,0,1,8704,12,7471732087
4607,35961351,9177338,45138689,8,0,1,14848,8,4445583664
4608,35967280,3542462,39509742,6,0,0,94720,7,9499070972
4609,35967961,9170751,45138712,8,0,1,512,8,4441354340
4610,35978880,3693785,39672665,6,0,0,38400,7,7134288740
4611,35995430,9143305,45138735,3,0,1,1536,17,7797293697
4612,36004570,3400214,39404784,6,0,0,10752,7,455048132
4613,36023460,3234441,39257901,2,0,0,7168,3,5727342593
4614,36033740,9105529,45139269,2,0,1,2560,3,10575909322
4615,36048960,3392381,39441341,6,0,0,64000,7,4690594124
4616,36050230,9189901,45240131,1,0,1,76288,10,1897659299
4617,36053660,9187186,45240846,9,0,1,512,12,5657213754
4618,36059820,9203411,45263231,2,0,1,4096,3,5356665625
4619,36060290,3452930,39513220,2,0,0,11264,3,7596383167
4620,36073980,9470284,45544264,1,0,1,54784,10,8628087366
4621,36074880,3609170,39684050,6,0,0,31744,7,5633016152
4622,36075511,9475826,45551337,8,0,1,5632,8,7341295930
4623,36081260,9603665,45684925,1,0,1,29184,10,3087727027
4624,36092680,3549616,39642296,6,0,0,35840,7,9891040787
4625,36107720,9598878,45706598,1,0,1,20480,10,7997499137
4626,36113210,9593939,45707149,2,0,1,6656,3,260216623
4627,36123150,9778206,45901356,1,0,1,22528,10,6431474679
4628,36124870,3659585,39784455,2,0,0,59392,3,6734924451
4629,36126820,3674350,39801170,2,0,0,54784,3,398818363
4630,36135190,9766189,45901379,9,0,1,3072,12,8967496198
4631,36140210,3848928,39989138,2,0,0,33280,3,8416182534
4632,36159061,9742341,45901402,5,0,1,4608,10,376935873
4633,36167800,3794577,39962377,6,0,0,96768,7,8700468548
4634,36185250,3499603,39684853,6,0,0,2560,7,1394623461
4635,36187320,3660501,39847821,2,0,0,4096,3,5750184639
4636,36198411,9703014,45901425,8,0,1,2048,8,1344979171
4637,36231850,3737882,39969732,2,0,0,24064,3,118762975
4638,36249250,3729709,39978959,6,0,0,30208,7,1827913649
4639,36292030,3624429,39916459,2,0,0,69632,3,697323458
4640,36317740,9583708,45901448,7,0,1,4096,10,2445743960
4641,36317900,3614962,39932862,6,0,0,53760,7,6115424569
4642,36330660,3767359,40098019,2,0,0,19968,3,1596029233
4643,36338120,3471661,39809781,2,0,0,28160,3,622082865
4644,36372870,3667802,40040672,6,0,0,20480,7,9536441852
4645,36382300,9519171,45901471,6,0,1,2048,7,5808900707
4646,36413510,3406888,39820398,6,0,0,7168,7,10687538604
4647,36414840,3764941,40179781,6,0,0,55296,7,1165368369
4648,36423070,3583955,40007025,2,0,0,5120,3,5246616017
4649,36442200,3453020,39895220,6,0,0,12800,7,5123852558
4650,36443720,9457774,45901494,6,0,1,1024,7,3338175702
4651,36452040,3864587,40316627,6,0,0,62464,7,3042386584
4652,36464410,9437107,45901517,6,0,1,2048,7,207399782
4653,36473830,3754825,40228655,2,0,0,160256,3,6665257085
4654,36518410,9383130,45901540,7,0,1,512,10,3074806559
4655,36534120,3500289,40034409,6,0,0,14336,7,5382834895
4656,36537139,9364424,45901563,4,0,1,512,15,5233994367
4657,36547150,9376143,45923293,6,0,1,1536,7,3898662593
4658,36551950,9371366,45923316,6,0,1,2048,7,2652040876
4659,36559090,9364249,45923339,6,0,1,7680,7,6576506268
4660,36561030,3786851,40347881,2,0,0,7680,3,797639687
4661,36569390,9353972,45923362,6,0,1,1536,7,7826246662
4662,36604780,3628686,40233466,6,0,0,15360,7,5429202631
4663,36607220,9316165,45923385,6,0,1,2560,7,3178108913
4664,36610250,9313158,45923408,6,0,1,6144,7,5720029445
4665,36612400,9311031,45923431,7,0,1,512,10,3969424232
4666,36618600,9304854,45923454,7,0,1,3584,10,3864615353
4667,36627550,3746664,40374214,2,0,0,7168,3,6665391847
4668,36648980,9274505,45923485,6,0,1,4608,7,2308879292
4669,36665570,9257938,45923508,2,0,1,7168,3,1679505224
4670,36666250,9278387,45944637,6,0,1,2048,7,6509434221
4671,36670040,9274620,45944660,7,0,1,1024,10,7254409859
4672,36682530,3747595,40430125,2,0,0,36352,3,2715399117
4673,36682891,9261792,45944683,8,0,1,2048,8,10343708299
4674,36682969,9261809,45944778,4,0,1,2560,15,2057797342
4675,36688470,3631612,40320082,2,0,0,11264,3,10453089486
4676,36694240,9250561,45944801,7,0,1,2560,10,7571334492
4677,36694950,3650568,40345518,6,0,0,33792,7,4063604384
4678,36696841,9247983,45944824,8,0,1,4608,8,1853781694
4679,36697940,9322457,46020397,6,0,1,1024,7,4493051076
4680,36711140,9309280,46020420,6,0,1,2560,7,7481176317
4681,36723650,9296793,46020443,7,0,1,2048,10,7932547228
4682,36735121,9285345,46020466,8,0,1,2048,8,5382837999
4683,36791009,9229536,46020545,4,0,1,6656,15,10074133371
4684,36792921,9227655,46020576,8,0,1,1536,8,4469908906
4685,36801730,9218869,46020599,6,0,1,5120,7,5648763540
4686,36810139,9210483,46020622,4,0,1,512,15,1809879087
4687,36818939,9201706,46020645,4,0,1,3072,15,8675495177
4688,36866230,9154438,46020668,7,0,1,512,10,3678538269
4689,36877370,3783334,40660704,2,0,0,56320,3,2672223863
4690,36896520,9126534,46023054,6,0,1,7680,7,9014814303
4691,36905350,9121222,46026572,1,0,1,102912,10,7354829948
4692,36916520,9110075,46026595,6,0,1,1536,7,1582175206
4693,36956830,9069788,46026618,7,0,1,8704,10,7434999992
4694,36981419,9045254,46026673,4,0,1,1536,15,9143125619
4695,36983219,9043477,46026696,4,0,1,3072,15,9123679211
4696,36983640,9046523,46030163,7,0,1,5632,10,10240168791
4697,36994040,9038709,46032749,7,0,1,4096,10,3932581025
4698,37007811,9049169,46056980,8,0,1,17920,8,8382239341
4699,37009960,9081931,46091891,7,0,1,18432,10,377782569
4700,37016441,9075473,46091914,8,0,1,11264,8,953251330
4701,37024500,9073683,46098183,7,0,1,4096,10,8242650716
4702,37029199,9080187,46109386,4,0,1,1024,15,8898642655
4703,37034680,9080082,46114762,2,0,1,7168,3,1646164378
4704,37035071,9082914,46117985,8,0,1,3072,8,5357243129
4705,37035381,9083910,46119291,8,0,1,2048,8,6645740718
4706,37045490,9074160,46119650,7,0,1,9728,10,9367811822
4707,37048109,9072207,46120316,4,0,1,1024,15,3435026348
4708,37071540,3616158,40687698,2,0,0,7680,3,6466965679
4709,37078039,9042943,46120982,4,0,1,1024,15,9292897235
4710,37103589,9020939,46124528,4,0,1,5632,15,7476483278
4711,37115780,9027570,46143350,6,0,1,5632,7,10624876427
4712,37126529,9067510,46194039,4,0,1,30208,15,4810131218
4713,37141261,9066003,46207264,8,0,1,6144,8,9601580772
4714,37152400,9084011,46236411,6,0,1,4096,7,10183017673
4715,37154851,9083826,46238677,8,0,1,3584,8,4716597203
4716,37161090,9079853,46240943,6,0,1,3584,7,1927348211
4717,37188859,9052648,46241507,4,0,1,10752,15,3629764290
4718,37192340,9053903,46246243,6,0,1,5632,7,2807204998
4719,37204569,9042020,46246589,4,0,1,512,15,6719805420
4720,37220039,9030736,46250775,4,0,1,6656,15,1703103218
4721,37221730,9032591,46254321,7,0,1,5632,10,6791562158
4722,37223060,3678603,40901663,2,0,0,38400,3,5663871856
4723,37223881,9065126,46289007,8,0,1,7168,8,10422561903
4724,37230349,9058681,46289030,4,0,1,1024,15,8343110386
4725,37240541,9048512,46289053,8,0,1,2048,8,5752079381
4726,37243209,9059063,46302272,4,0,1,512,15,7499817000
4727,37245490,3673362,40918852,2,0,0,1024,3,9505686045
4728,37254210,9050772,46304982,7,0,1,6656,10,9520278268
4729,37260369,9048819,46309188,4,0,1,1536,15,3745766578
4730,37268331,9044083,46312414,8,0,1,5120,8,6175765226
4731,37270521,9044159,46314680,8,0,1,3584,8,1581631608
4732,37273850,9045427,46319277,7,0,1,14336,10,1383790689
4733,37277400,9079119,46356519,2,0,1,4608,3,3970361616
4734,37284949,9072236,46357185,4,0,1,1024,15,4457226129
4735,37286271,9085043,46371314,8,0,1,1536,8,5617726134
4736,37297089,9079514,46376603,4,0,1,2048,15,1443100636
4737,37305050,3879503,41184553,5,0,0,12288,10,6737957110
4738,37307681,9141077,46448758,8,0,1,2560,8,10016442168
4739,37313010,9136094,46449104,2,0,1,512,3,658794053
4740,37320310,9129460,46449770,2,0,1,1024,3,7538354124
4741,37325430,3774559,41099989,2,0,0,28672,3,2959918530
4742,37333341,9118920,46452261,8,0,1,1024,8,4864357311
4743,37373500,9079522,46453022,2,0,1,4096,3,4384674897
4744,37379600,9136075,46515675,2,0,1,5632,3,9224893508
4745,37386250,3751118,41137368,2,0,0,12288,3,4603797706
4746,37405480,9139868,46545348,7,0,1,11776,10,9788561311
4747,37409890,3620198,41030088,2,0,0,512,3,3832297369
4748,37430899,9123074,46553973,4,0,1,8704,15,5472355209
4749,37445290,9128024,46573314,7,0,1,7680,10,1456013905
4750,37453860,9119477,46573337,7,0,1,7680,10,5189095971
4751,37456750,9116610,46573360,7,0,1,23040,10,4921360805
4752,37465461,9107922,46573383,8,0,1,512,8,7221791625
4753,37466949,9106457,46573406,4,0,1,1024,15,425031204
4754,37469401,9104028,46573429,8,0,1,3584,8,8988303359
4755,37483081,9091347,46574428,8,0,1,6144,8,7853944700
4756,37492860,9083834,46576694,7,0,1,3584,10,7630790360
4757,37496890,9085091,46581981,7,0,1,16896,10,5457423505
4758,37500600,9325000,46825600,7,0,1,51200,10,8773194715
4759,37502380,3663063,41165443,2,0,0,53760,3,6298235196
4760,37520870,9569401,47090271,7,0,1,101888,10,3289348167
4761,37522189,9568105,47090294,4,0,1,8192,15,5349344239
4762,37557019,9533298,47090317,4,0,1,3584,15,1694420595
4763,37572390,9517950,47090340,1,0,1,65536,10,9054312412
4764,37602319,9488044,47090363,4,0,1,8704,15,3907965834
4765,37634570,9484058,47118628,7,0,1,33280,10,2320295179
4766,37641350,9522949,47164299,7,0,1,53248,10,9282109984
4767,37653640,3611656,41265296,2,0,0,23040,3,2329610285
4768,37668350,3434314,41102664,2,0,0,8704,3,7297346376
4769,37698940,9485076,47184016,9,0,1,1536,12,2223485766
4770,37699760,3527823,41227583,2,0,0,5120,3,9627871801
4771,37702079,9482283,47184362,4,0,1,512,15,9539803893
4772,37718730,9467578,47186308,7,0,1,3072,10,6037664461
4773,37748480,9462028,47210508,9,0,1,2048,12,3119494387
4774,37766130,9444736,47210866,7,0,1,18944,10,2552986500
4775,37791100,9419789,47210889,1,0,1,14336,10,3800516934
4776,37806010,9423306,47229316,7,0,1,25088,10,8555212683
4777,37813660,9447812,47261472,9,0,1,4608,12,6775769590
4778,37831980,9432321,47264301,1,0,1,24576,10,3755710672
4779,37837470,9428457,47265927,9,0,1,2560,12,3276664211
4780,37850779,9418694,47269473,4,0,1,5632,15,4537104527
4781,37884129,9386650,47270779,4,0,1,2048,15,7521972909
4782,37907949,9379255,47287204,4,0,1,12800,15,6191204042
4783,37940110,9347760,47287870,2,0,1,1024,3,4543529075
4784,37942100,3486508,41428608,2,0,0,38912,3,6876362616
4785,37944930,9345526,47290456,2,0,1,4096,3,7721602129
4786,37945880,9351348,47297228,2,0,1,10752,3,4216328047
4787,37946340,9351144,47297484,2,0,1,9216,3,4381124164
4788,37957720,9344910,47302630,2,0,1,8192,3,8828988115
4789,37963070,9341186,47304256,9,0,1,2560,12,9398227850
4790,37971560,9342352,47313912,2,0,1,23040,3,7573168897
4791,37988880,3498983,41487863,2,0,0,23552,3,7108656967
4792,38005510,9421776,47427286,1,0,1,78336,10,9642604044
4793,38013430,9415802,47429232,9,0,1,3072,12,6500259876
4794,38027060,9408921,47435981,9,0,1,512,12,2220841193
4795,38028679,9407325,47436004,4,0,1,512,15,7587664747
4796,38041110,9394917,47436027,9,0,1,9216,12,6675577561
4797,38044920,9423195,47468115,2,0,1,8192,3,5135472547
4798,38060419,9410602,47471021,4,0,1,4608,15,8559743143
4799,38070620,9475917,47546537,1,0,1,96256,10,9324769116
4800,38087490,3434530,41522020,2,0,0,24576,3,9894863783
4801,38097000,9454441,47551441,2,0,1,3584,3,2878759336
4802,38106350,9499111,47605461,9,0,1,16384,12,8545608179
4803,38116069,9494033,47610102,4,0,1,5120,15,10119466444
4804,38125000,9693952,47818952,1,0,1,173056,10,3347603079
4805,38140810,9693153,47833963,9,0,1,2560,12,526532833
4806,38140869,9694080,47834949,4,0,1,1536,15,7190536899
4807,38141370,3756181,41897551,2,0,0,37376,3,705467518
4808,38150090,3838723,41988813,2,0,0,8192,3,3397165659
4809,38171330,9664925,47836255,9,0,1,2048,12,8190529367
4810,38204340,9695860,47900200,1,0,1,79360,10,8686806086
4811,38224070,9703414,47927484,2,0,1,10752,3,8747872113
4812,38240800,9687670,47928470,2,0,1,1536,3,4010226764
4813,38247510,9686106,47933616,2,0,1,8192,3,2476553389
4814,38257309,9677613,47934922,4,0,1,2048,15,3464673293
4815,38273840,9667649,47941489,1,0,1,31232,10,8243695450
4816,38278479,9673788,47952267,4,0,1,3072,15,8277687724
4817,38286380,9694305,47980685,1,0,1,40448,10,6147483951
4818,38294970,9706477,48001447,2,0,1,11264,3,8853815690
4819,38296670,9705443,48002113,2,0,1,1024,3,9272457643
4820,38298350,9711918,48010268,1,0,1,24576,10,5103932724
4821,38304620,9705994,48010614,9,0,1,512,12,4663928885
4822,38309439,9701521,48010960,4,0,1,512,15,4826324483
4823,38320430,9692156,48012586,2,0,1,2560,3,6753254420
4824,38335000,9944215,48279215,1,0,1,186368,10,8005424396
4825,38346669,9961399,48308068,4,0,1,10752,15,4427147234
4826,38370990,3471990,41842980,2,0,0,112640,3,4107978360
4827,38393240,9917734,48310974,9,0,1,4608,12,7839819294
4828,38416420,3291838,41708258,2,0,0,5632,3,1446661964
4829,38446929,9865351,48312280,4,0,1,2048,15,7769386543
4830,38452570,9865509,48318079,1,0,1,27648,10,6135235232
4831,38466760,9883695,48350455,2,0,1,1536,3,3474615034
4832,38475570,9874908,48350478,9,0,1,4608,12,8254484090
4833,38480940,9869561,48350501,9,0,1,8704,12,10396562586
4834,38482189,9875592,48357781,4,0,1,4608,15,6153792273
4835,38490650,3495644,41986294,2,0,0,48128,3,8274836533
4836,38501800,3540352,42042152,4,0,0,16384,15,1058923707
4837,38512230,9888813,48401043,0,0,1,3072,3,969056853
4838,38517020,9889169,48406189,2,0,1,8192,3,4621622529
4839,38534300,9892184,48426484,1,0,1,26624,10,6235291325
4840,38543090,9883417,48426507,9,0,1,2560,12,3041633875
4841,38545920,9959101,48505021,1,0,1,22016,10,7332164265
4842,38557350,9947694,48505044,9,0,1,3072,12,2155707393
4843,38567260,9937807,48505067,2,0,1,1024,3,3387417545
4844,38577210,9943691,48520901,1,0,1,43520,10,3438011631
4845,38587860,9933064,48520924,1,0,1,9728,10,1147616584
4846,38591309,9929654,48520963,4,0,1,4608,15,5598435597
4847,38601180,3245567,41846747,2,0,0,12288,3,7265109500
4848,38602170,9918816,48520986,9,0,1,1024,12,5981984324
4849,38611479,9909865,48521344,4,0,1,4096,15,2989816137
4850,38613379,9910526,48523905,4,0,1,6144,15,280718214
4851,38629870,9898861,48528731,3,0,1,7680,17,5864166536
4852,38637220,9891665,48528885,3,0,1,8704,17,2401213039
4853,38654180,3436806,42090986,4,0,0,15360,15,3684117817
4854,38655660,9873571,48529231,1,0,1,512,10,1255033455
4855,38657339,9872878,48530217,4,0,1,1536,15,4506225328
4856,38657500,9879169,48536669,3,0,1,10240,17,8981255696
4857,38682020,9857555,48539575,9,0,1,4608,12,1623021098
4858,38686750,9878748,48565498,6,0,1,6656,7,338134141
4859,38705910,9859611,48565521,2,0,1,5120,3,5066161168
4860,38708490,9857054,48565544,9,0,1,512,12,10552958133
4861,38710700,9854867,48565567,3,0,1,3072,17,1292109764
4862,38727560,9838030,48565590,6,0,1,4608,7,8265129539
4863,38727759,9837854,48565613,4,0,1,4096,15,7879810406
4864,38730730,9834906,48565636,9,0,1,5632,12,8180424321
4865,38740710,9824949,48565659,2,0,1,2048,3,6891100295
4866,38747260,9820899,48568159,2,0,1,6144,3,2553208332
4867,38754800,9839521,48594321,2,0,1,17920,3,1860105835
4868,38755490,9838942,48594432,2,0,1,17920,3,927605655
4869,38755630,3169615,41925245,4,0,0,22528,15,10008771431
4870,38761041,9833414,48594455,8,0,1,5632,8,901115554
4871,38763600,9832797,48596397,9,0,1,4608,12,130957939
4872,38766710,9833233,48599943,3,0,1,5632,17,7458722689
4873,38768509,9831780,48600289,4,0,1,512,15,9010230022
4874,38777480,3221451,41998931,2,0,0,4608,3,2140232463
4875,38787810,9812825,48600635,6,0,1,512,7,8277408293
4876,38794531,9806770,48601301,8,0,1,1024,8,5323530609
4877,38798240,9803727,48601967,6,0,1,1024,7,4324756286
4878,38801900,9801693,48603593,2,0,1,2560,3,10613425531
4879,38803750,3288819,42092569,4,0,0,5120,15,5773450486
4880,38807490,9796359,48603849,9,0,1,9216,12,5300520989
4881,38819650,9951330,48770980,7,0,1,103936,10,9436363396
4882,38822059,9996613,48818672,4,0,1,1536,15,7989053361
4883,38823960,9998258,48822218,2,0,1,5632,3,6864464288
4884,38841570,10003255,48844825,9,0,1,11264,12,1346546016
4885,38844330,10027040,48871370,3,0,1,2048,17,6112399582
4886,38849911,10024365,48874276,8,0,1,4608,8,8134918675
4887,38850580,3370760,42221340,4,0,0,28160,15,4603082563
4888,38857980,3515737,42373717,2,0,0,13824,3,5114164619
4889,38861230,10031288,48892518,3,0,1,7680,17,6242986878
4890,38865370,10031312,48896682,9,0,1,15360,12,4657775218
4891,38872439,10035284,48907723,4,0,1,2048,15,9107316836
4892,38882510,3309827,42192337,4,0,0,22528,15,1418218231
4893,38885490,10040272,48925762,2,0,1,6656,3,6428799114
4894,38892610,3530089,42422699,4,0,0,82944,15,4201785909
4895,38894970,10030823,48925793,6,0,1,2560,7,3745489032
4896,38895729,10030087,48925816,4,0,1,1024,15,6988778508
4897,38899409,10026609,48926018,4,0,1,5120,15,7190323971
4898,38912920,10025702,48938622,1,0,1,29184,10,7614100493
4899,38913139,10037092,48950231,4,0,1,3072,15,10125864016
4900,38917480,10032774,48950254,3,0,1,1024,17,728229234
4901,38930889,10019396,48950285,4,0,1,16384,15,85837848
4902,38932699,10064837,48997536,4,0,1,2048,15,2895950458
4903,38934800,10062759,48997559,9,0,1,2048,12,8233933167
4904,38940310,10057272,48997582,9,0,1,5632,12,3440508417
4905,38940750,10066550,49007300,9,0,1,1024,12,4582645355
4906,38947260,3531050,42478310,2,0,0,47104,3,8964394239
4907,38952329,10054994,49007323,4,0,1,1536,15,10557023656
4908,38969120,10038226,49007346,6,0,1,10240,7,8789645253
4909,38983740,3402392,42386132,2,0,0,35840,3,10189585646
4910,38991950,10024506,49016456,9,0,1,8192,12,2584620068
4911,39001530,3524684,42526214,4,0,0,43008,15,4929931285
4912,39021260,9995921,49017181,9,0,1,1024,12,10568463849
4913,39023080,9995651,49018731,9,0,1,3072,12,6015740429
4914,39026400,10011241,49037641,3,0,1,16896,17,4031999140
4915,39027000,3481703,42508703,2,0,0,9216,3,6295462931
4916,39041160,10019398,49060558,2,0,1,6656,3,10011428592
4917,39066180,9994401,49060581,9,0,1,3584,12,2706787105
4918,39069640,9990964,49060604,6,0,1,1536,7,7600641503
4919,39072690,10012522,49085212,6,0,1,1536,7,3792783472
4920,39076200,10013518,49089718,0,0,1,7168,3,7148968837
4921,39089330,10004098,49093428,2,0,1,1024,3,10095319549
4922,39103160,9990832,49093992,6,0,1,10752,7,5783180474
4923,39119150,3629988,42749138,4,0,0,10240,15,1511889528
4924,39130909,10023604,49154513,4,0,1,3072,15,1995661083
4925,39138510,10016026,49154536,6,0,1,3072,7,3720522717
4926,39156940,10056875,49213815,1,0,1,102400,10,9745753375
4927,39169580,10048741,49218321,3,0,1,7168,17,8304752669
4928,39179910,10039077,49218987,6,0,1,11264,7,10403139748
4929,39182480,10065400,49247880,1,0,1,32768,10,2214527110
4930,39196860,10088517,49285377,3,0,1,5632,17,8553189878
4931,39197210,10088190,49285400,1,0,1,8704,10,7122604270
4932,39201390,10084033,49285423,2,0,1,7680,3,4635651555
4933,39214500,10076622,49291122,3,0,1,2048,17,6283134495
4934,39226900,3542513,42769413,4,0,0,45056,15,2261128121
4935,39228770,3653903,42882673,4,0,0,49664,15,9435247192
4936,39230370,10061418,49291788,2,0,1,1024,3,5773686733
4937,39230540,10061812,49292352,3,0,1,10752,17,1768414571
4938,39244250,3696280,42940530,2,0,0,56832,3,4760629640
4939,39248130,10052345,49300475,6,0,1,1024,7,4351497629
4940,39250289,3542609,42792898,3,0,0,11776,17,5837868280
4941,39251460,3670313,42921773,2,0,0,12288,3,7528757713
4942,39260680,10103079,49363759,1,0,1,55808,10,8246229220
4943,39268250,10096552,49364802,3,0,1,1024,17,3643303545
4944,39268560,10097548,49366108,1,0,1,2048,10,5847678053
4945,39272860,10120881,49393741,2,0,1,2048,3,7207083141
4946,39282220,10111544,49393764,2,0,1,2560,3,8018572902
4947,39287500,10106287,49393787,3,0,1,1536,17,3895255178
4948,39304880,10091191,49396071,3,0,1,8704,17,6753882387
4949,39306040,10090697,49396737,6,0,1,1024,7,3017756737
4950,39318380,10082543,49400923,3,0,1,6656,17,9182704530
4951,39325580,10141444,49467024,3,0,1,8704,17,8488473709
4952,39353400,10113983,49467383,6,0,1,9728,7,4224339808
4953,39360640,4049977,43410617,4,0,0,22528,15,4608937080
4954,39371450,3897027,43268477,2,0,0,74752,3,1972695986
4955,39375270,3936111,43311381,4,0,0,12288,15,8285993220
4956,39392300,10100157,49492457,2,0,1,2560,3,4136535645
4957,39419230,10081019,49500249,6,0,1,17408,7,9531571855
4958,39447540,10070567,49518107,6,0,1,3072,7,2145647684
4959,39456840,4031361,43488201,4,0,0,47104,15,2839569513
4960,39471600,10051333,49522933,2,0,1,7680,3,7481946628
4961,39494520,10028977,49523497,3,0,1,10752,17,7044918696
4962,39499430,10339634,49839064,1,0,1,128000,10,3496187749
4963,39509210,10329877,49839087,2,0,1,8704,3,3287430248
4964,39513750,10355344,49869094,3,0,1,11776,17,5983877142
4965,39527040,10347046,49874086,6,0,1,6144,7,10268149510
4966,39537000,10363916,49900916,2,0,1,17920,3,4805719564
4967,39541770,10376231,49918001,6,0,1,4608,7,1306133977
4968,39544560,10373464,49918024,2,0,1,9216,3,3156893197
4969,39554470,10372705,49927175,3,0,1,3584,17,7750033055
4970,39564010,10377481,49941491,1,0,1,24576,10,4158973247
4971,39590670,10446696,50037366,1,0,1,77312,10,8073779568
4972,39606780,10430609,50037389,2,0,1,1536,3,9805804455
4973,39609910,10427502,50037412,2,0,1,11264,3,4768323428
4974,39616530,10420905,50037435,6,0,1,1024,7,1635408783
4975,39622050,3999140,43621190,2,0,0,20992,3,8898359244
4976,39630660,4251546,43882206,2,0,0,48128,3,8720549272
4977,39636630,10402004,50038634,2,0,1,3072,3,5171539741
4978,39638000,10403491,50041491,6,0,1,2560,7,5181894316
4979,39647110,3936758,43583868,4,0,0,2048,15,7976061361
4980,39655470,10389247,50044717,1,0,1,5120,10,1838513205
4981,39658340,10388003,50046343,6,0,1,2560,7,4310834667
4982,39668060,10392511,50060571,1,0,1,41472,10,9311164235
4983,39683740,4094861,43778601,4,0,0,79360,15,4793824590
4984,39694060,10432514,50126574,1,0,1,92672,10,3380899503
4985,39695610,10432910,50128520,3,0,1,3072,17,5784498480
4986,39699770,10429096,50128866,2,0,1,512,3,556497682
4987,39702600,10428212,50130812,3,0,1,3072,17,4621346111
4988,39724960,10419259,50144219,0,0,1,2560,3,6754272091
4989,39729930,10416875,50146805,6,0,1,4096,7,9604424611
4990,39734190,10413601,50147791,3,0,1,1536,17,5291393756
4991,39744010,3884691,43628701,4,0,0,24576,15,6237791082
4992,39746200,10406776,50152976,3,0,1,16384,17,6090787576
4993,39747180,4111273,43858453,4,0,0,39424,15,3262798160
4994,39754060,4220036,43974096,4,0,0,13312,15,3757102845
4995,39759380,10396304,50155684,3,0,1,3584,17,3379515461
4996,39767580,10389730,50157310,3,0,1,2560,17,10646833086
4997,39776100,4207049,43983149,2,0,0,29184,3,1002631312
4998,39777070,10382965,50160035,6,0,1,512,7,1589251837
4999,39790330,10441117,50231447,1,0,1,120320,10,375413106
5000,39797110,10486956,50284066,3,0,1,6656,17,2866761390
5001,39800160,4222737,44022897,2,0,0,108544,3,7380338343
5002,39817760,10466329,50284089,3,0,1,13824,17,10436489312
5003,39830240,4134139,43964379,2,0,0,130560,3,2284268448
5004,39831590,10452522,50284112,3,0,1,1536,17,100715636
5005,39855360,10447716,50303076,3,0,1,7168,17,7280965562
5006,39862160,4021074,43883234,2,0,0,512,3,1848787857
5007,39871591,10447654,50319245,8,0,1,512,8,7827401476
5008,39878010,10442861,50320871,1,0,1,2560,10,7249771320
5009,39888920,10483076,50371996,6,0,1,14848,7,7036500993
5010,39898130,10477839,50375969,3,0,1,6144,17,7811646879
5011,39900170,4069847,43970017,4,0,0,17920,15,9457620440
5012,39900250,10476278,50376528,3,0,1,1024,17,2185403718
5013,39907660,10469214,50376874,3,0,1,512,17,9118006315
5014,39912700,10468360,50381060,2,0,1,6656,3,9310730941
5015,39918650,10502758,50421408,3,0,1,10240,17,9560905417
5016,39919280,4140264,44059544,4,0,0,10752,15,6144663277
5017,39924740,10496691,50421431,3,0,1,6144,17,7287310660
5018,39935960,10485494,50421454,3,0,1,11776,17,4842236441
5019,39989540,4052592,44042132,4,0,0,62976,15,9075332397
5020,40001670,10425344,50427014,6,0,1,9728,7,8163574068
5021,40003930,3919408,43923338,4,0,0,73728,15,2154145313
5022,40004410,3581427,43585837,2,0,0,2048,3,6857239128
5023,40009450,10452426,50461876,1,0,1,24576,10,7528802576
5024,40045450,10417399,50462849,1,0,1,12800,10,8309482012
5025,40051460,10427757,50479217,3,0,1,8704,17,7672073752
5026,40064770,3598104,43662874,4,0,0,57856,15,3205664729
5027,40077300,10405143,50482443,6,0,1,5120,7,2577873008
5028,40077430,10416927,50494357,6,0,1,7680,7,5477488932
5029,40087820,3901748,43989568,2,0,0,20992,3,1429839278
5030,40091490,10654920,50746410,1,0,1,160768,10,9453599643
5031,40096950,10699233,50796183,1,0,1,5632,10,7769356296
5032,40104760,10710365,50815125,6,0,1,2560,7,6085772983
5033,40114490,10710595,50825085,3,0,1,6656,17,8493346969
5034,40115110,10710240,50825350,1,0,1,10240,10,5498992090
5035,40115420,10710276,50825696,3,0,1,512,17,10504625207
5036,40133870,4042478,44176348,4,0,0,37376,15,5635933886
5037,40144470,10748680,50893150,3,0,1,4096,17,7284258058
5038,40144770,10748403,50893173,6,0,1,11776,7,4410269735
5039,40148070,3666703,43814773,2,0,0,6144,3,3100815406
5040,40172790,10720920,50893710,3,0,1,22528,17,8770428864
5041,40177950,10715783,50893733,6,0,1,3584,7,7284137509
5042,40210550,3926458,44137008,4,0,0,62976,15,4252456816
5043,40211770,10681986,50893756,3,0,1,3584,17,6051247
5044,40229650,10670244,50899894,3,0,1,11264,17,8465959478
5045,40257110,10643450,50900560,6,0,1,1024,7,5041588827
5046,40264660,3849034,44113694,4,0,0,20992,15,516597193
5047,40265870,3788684,44054554,4,0,0,7680,15,4810988116
5048,40268670,3780817,44049487,4,0,0,24064,15,8672646968
5049,40287390,3637071,43924461,2,0,0,3584,3,370087743
5050,40299600,3601251,43900851,4,0,0,14848,15,1897111572
5051,40320581,10583525,50904106,5,0,1,5632,10,7745255478
5052,40320641,10593095,50913736,5,0,1,6656,10,3342730840
5053,40324220,10662833,50987053,0,0,1,18944,3,8139853821
5054,40340440,10646636,50987076,6,0,1,4096,7,1101371598
5055,40340621,10646478,50987099,5,0,1,2560,10,1644014148
5056,40341080,10657921,50999001,0,0,1,4096,3,3862599663
5057,40346740,10652284,50999024,6,0,1,2560,7,2138644492
5058,40350360,10648687,50999047,6,0,1,8704,7,2222955810
5059,40355920,3738198,44094118,4,0,0,8192,15,9433767805
5060,40359900,10915517,51275417,1,0,1,178688,10,3554013526
5061,40361880,10945993,51307873,6,0,1,3584,7,2849439598
5062,40385410,3759577,44144987,2,0,0,26112,3,8811350965
5063,40393620,10924502,51318122,6,0,1,16384,7,5647559528
5064,40406710,10913422,51320132,1,0,1,10240,10,6848071085
5065,40411440,10951128,51362568,1,0,1,11264,10,2908374186
5066,40417291,10947663,51364954,5,0,1,5632,10,10667266113
5067,40435150,4301453,44736603,4,0,0,54272,15,3582543465
5068,40446350,3437219,43883569,2,0,0,1024,3,2748496268
5069,40453010,10911967,51364977,6,0,1,2560,7,3598464045
5070,40454771,10917428,51372199,5,0,1,3072,10,2122075198
5071,40458510,11104700,51563210,1,0,1,199168,10,8162851153
5072,40469260,3413772,43883032,2,0,0,2560,3,7676883661
5073,40471570,11096355,51567925,0,0,1,1536,3,3227859253
5074,40477140,11101396,51578536,6,0,1,5120,7,8584739933
5075,40485660,11107337,51592997,6,0,1,7168,7,884882862
5076,40495810,11100093,51595903,0,0,1,4608,3,8525097549
5077,40497580,11106495,51604075,0,0,1,2560,3,2891451417
5078,40499250,3552826,44052076,4,0,0,8192,15,165191583
5079,40509010,11096345,51605355,6,0,1,14336,7,9521259498
5080,40511270,11151374,51662644,1,0,1,11776,10,2027433036
5081,40517220,11206662,51723882,1,0,1,35328,10,3389427747
5082,40519130,11305472,51824602,1,0,1,38912,10,633014487
5083,40522330,11381020,51903350,1,0,1,77824,10,6561698327
5084,40534551,11374667,51909218,5,0,1,15360,10,3860669185
5085,40546910,11405101,51952011,6,0,1,2048,7,8578416223
5086,40559890,3727926,44287816,2,0,0,39424,3,9993728734
5087,40589000,11363034,51952034,0,0,1,1024,3,8003055716
5088,40597510,11354547,51952057,6,0,1,1024,7,2042832023
5089,40604890,11347190,51952080,0,0,1,1536,3,8123137505
5090,40612690,3486287,44098977,4,0,0,15872,15,3921541665
5091,40614130,4178699,44792829,4,0,0,15872,15,2077041286
5092,40618560,11333543,51952103,6,0,1,512,7,8605435974
5093,40623350,3697778,44321128,2,0,0,22528,3,7721223938
5094,40632670,3720741,44353411,4,0,0,16896,15,253196359
5095,40639081,11313045,51952126,5,0,1,14848,10,5601229921
5096,40648990,11375060,52024050,6,0,1,7680,7,200327173
5097,40654180,11369893,52024073,1,0,1,6656,10,5977284354
5098,40656520,11367576,52024096,6,0,1,14848,7,5553247064
5099,40664290,11359829,52024119,9,0,1,2048,12,4460121537
5100,40684200,3887543,44571743,2,0,0,18432,3,4929280512
5101,40688770,11335372,52024142,1,0,1,15360,10,6254947864
5102,40696730,11327435,52024165,0,0,1,2048,3,8141099963
5103,40697720,11326468,52024188,2,0,1,6144,3,10381492795
5104,40703270,11338303,52041573,6,0,1,13824,7,5353216319
5105,40724940,11319027,52043967,0,0,1,1536,3,8347003676
5106,40726170,3510322,44236492,4,0,0,26112,15,6520119949
5107,40747050,11507553,52254603,1,0,1,151040,10,7816402953
5108,40749200,11705913,52455113,1,0,1,84480,10,4497273949
5109,40767030,11688106,52455136,1,0,1,12800,10,9574529848
5110,40770960,11684199,52455159,0,0,1,512,3,9979527430
5111,40776860,4270044,45046904,2,0,0,113152,3,5053408001
5112,40779900,11686453,52466353,9,0,1,7680,12,2258920899
5113,40782800,11727485,52510285,1,0,1,51200,10,9203326276
5114,40785000,11888652,52673652,1,0,1,119808,10,821065833
5115,40807360,11866315,52673675,3,0,1,1536,17,1853945974
5116,40809120,3613150,44422270,0,0,0,28672,3,2354929367
5117,40811380,11894519,52705899,1,0,1,15360,10,9837972291
5118,40822080,11885445,52707525,0,0,1,2560,3,9164042659
5119,40822380,11905598,52727978,9,0,1,10240,12,6873432140
5120,40822680,11905321,52728001,0,0,1,5120,3,3063040737
5121,40831850,11905982,52737832,6,0,1,3584,7,9886067073
5122,40833210,3488253,44321463,4,0,0,1024,15,10519389099
5123,40843780,11895038,52738818,9,0,1,1536,12,10310458541
5124,40844860,11895584,52740444,6,0,1,2560,7,906492288
5125,40869470,3488956,44358426,2,0,0,16384,3,5655039610
5126,40871080,11869710,52740790,0,0,1,512,3,9310686366
5127,40872320,3693784,44566104,2,0,0,34816,3,2340037818
5128,40873820,4184963,45058783,4,0,0,38912,15,992670331
5129,40882150,3584986,44467136,2,0,0,15872,3,9808155479
5130,40883880,11857269,52741149,2,0,1,9728,3,10669108815
5131,40886370,3647105,44533475,2,0,0,45568,3,10577490855
5132,40892200,11852516,52744716,9,0,1,4096,12,307815149
5133,40892800,11868095,52760895,0,0,1,5120,3,3971729066
5134,40910020,11851221,52761241,6,0,1,512,7,2380173467
5135,40915581,11850486,52766067,5,0,1,7680,10,372176354
5136,40915850,3379009,44294859,4,0,0,23040,15,2431854099
5137,40921080,11846370,52767450,0,0,1,14848,3,8123806650
5138,40927640,11854411,52782051,0,0,1,8704,3,6137929827
5139,40935560,11849817,52785377,2,0,1,5120,3,3642113674
5140,40944850,11843333,52788183,2,0,1,4608,3,9915504923
5141,40950280,11849749,52800029,2,0,1,2048,3,7761839421
5142,40956030,11847865,52803895,9,0,1,6144,12,4355393854
5143,40958440,3631713,44590153,2,0,0,22528,3,6779121941
5144,40973430,11831131,52804561,0,0,1,1024,3,3468379106
5145,40993800,4339967,45333767,2,0,0,27136,3,9902043533
5146,40996090,3457207,44453297,4,0,0,20480,15,8328629439
5147,41000590,11805277,52805867,0,0,1,2048,3,1929321337
5148,41003550,11811565,52815115,6,0,1,12288,7,5609085300
5149,41024170,11819200,52843370,9,0,1,512,12,8309110248
5150,41027130,11816263,52843393,9,0,1,2560,12,2962124009
5151,41034670,4375459,45410129,2,0,0,24576,3,5542933434
5152,41035480,11825574,52861054,9,0,1,4608,12,4067925916
5153,41042800,11821480,52864280,6,0,1,5120,7,1438605804
5154,41049330,11817856,52867186,6,0,1,4608,7,7045425415
5155,41064850,4039769,45104619,2,0,0,10240,3,7439496632
5156,41089350,11780768,52870118,6,0,1,4608,7,647441240
5157,41098961,3544579,44643540,7,0,0,5120,10,6745202377
5158,41104550,11770394,52874944,7,0,1,7680,10,5156938888
5159,41108310,11767300,52875610,9,0,1,1024,12,10001561329
5160,41109380,11769136,52878516,6,0,1,4608,7,8428557502
5161,41110440,11769702,52880142,6,0,1,2560,7,2298492613
5162,41111380,11773947,52885327,7,0,1,24576,10,2907530375
5163,41113350,11799299,52912649,0,0,1,2560,3,9998103909
5164,41119400,11793710,52913110,0,0,1,10240,3,4142364703
5165,41134560,4380396,45514956,2,0,0,53760,3,1225602379
5166,41135450,11780566,52916016,9,0,1,4608,12,9021804007
5167,41138350,11781212,52919562,9,0,1,5632,12,6906469271
5168,41146300,11774235,52920535,9,0,1,12800,12,3013427966
5169,41147331,3504678,44652009,7,0,0,4608,10,4371224735
5170,41154390,11803186,52957576,6,0,1,11264,7,5780684879
5171,41157610,11858436,53016046,9,0,1,8192,12,896371959
5172,41160720,11855349,53016069,0,0,1,4096,3,7878248794
5173,41165120,11939188,53104308,7,0,1,75264,10,3905551179
5174,41169670,11938103,53107773,7,0,1,8704,10,10178131059
5175,41187210,11964108,53151318,7,0,1,43008,10,10571086499
5176,41189670,11961671,53151341,0,0,1,5632,3,688775268
5177,41197341,11962001,53159342,8,0,1,3072,8,7282257145
5178,41197930,12100256,53298186,7,0,1,132096,10,2965324814
5179,41217200,3921466,45138666,0,0,0,47104,3,4332495060
5180,41222670,12075670,53298340,0,0,1,8704,3,9812126228
5181,41223900,12076066,53299966,9,0,1,2560,12,2423336658
5182,41231479,12077754,53309233,4,0,1,4096,15,5557870896
5183,41233889,12076010,53309899,4,0,1,1024,15,6366507686
5184,41253300,12119489,53372789,0,0,1,45056,3,1534280345
5185,41257249,12121533,53378782,4,0,1,1536,15,10332306427
5186,41283661,3161074,44444735,7,0,0,3584,10,450604335
5187,41284900,12128080,53412980,0,0,1,19968,3,3834311778
5188,41305320,12107683,53413003,7,0,1,10240,10,3651743095
5189,41306730,3248743,44555473,0,0,0,15360,3,2712416857
5190,41309529,12107392,53416921,4,0,1,1024,15,658756782
5191,41310959,12124740,53435699,4,0,1,12800,15,6631862727
5192,41312880,12124765,53437645,6,0,1,3072,7,9705105727
5193,41320980,12121811,53442791,6,0,1,8192,7,756346465
5194,41324091,12119161,53443252,8,0,1,10240,8,1892726491
5195,41330311,12114567,53444878,8,0,1,2560,8,57888864
5196,41344000,12135448,53479448,0,0,1,3072,3,1383224908
5197,41345699,12133772,53479471,4,0,1,512,15,2687791944
5198,41347160,3576675,44923835,4,0,0,102400,15,8473963344
5199,41348480,12131014,53479494,6,0,1,7168,7,880288587
5200,41349160,12130357,53479517,7,0,1,11776,10,6462474992
5201,41349461,12132243,53481704,8,0,1,512,8,7781434771
5202,41363699,12120271,53483970,4,0,1,3584,15,6373350661
5203,41368080,4387933,45756013,2,0,0,105472,3,4050278293
5204,41368090,12118466,53486556,6,0,1,4096,7,4499838530
5205,41370390,12119392,53489782,3,0,1,5120,17,332410189
5206,41376329,12115719,53492048,4,0,1,3584,15,5727066838
5207,41382330,12113904,53496234,6,0,1,6656,7,3747521346
5208,41394081,4290813,45684894,7,0,0,70656,10,7615776935
5209,41400170,3220115,44620285,4,0,0,25600,15,5129808447
5210,41401871,12095349,53497220,8,0,1,1536,8,9723675610
5211,41409160,12089340,53498500,7,0,1,14336,10,8220147508
5212,41412550,12184043,53596593,0,0,1,85504,3,2237339744
5213,41415120,12214048,53629168,0,0,1,49152,3,6285271224
5214,41416759,12221805,53638564,4,0,1,5632,15,8704849642
5215,41417350,3595055,45012405,2,0,0,63488,3,7408138553
5216,41426490,12228756,53655246,0,0,1,12288,3,9160798550
5217,41430570,12354630,53785200,7,0,1,126976,10,544555858
5218,41454691,3785417,45240108,7,0,0,152064,10,2331911962
5219,41460620,12331209,53791829,3,0,1,10752,17,6502885740
5220,41466559,12325936,53792495,4,0,1,11264,15,10235276285
5221,41478251,3493176,44971427,7,0,0,97280,10,906442916
5222,41482240,12349637,53831877,3,0,1,9728,17,7448906286
5223,41499120,3607862,45106982,0,0,0,7680,3,6927427561
5224,41500950,3593928,45094878,0,0,0,101888,3,8809005930
5225,41507420,12324480,53831900,7,0,1,5632,10,9299321413
5226,41507549,12331137,53838686,4,0,1,7680,15,1183474807
5227,41514120,12327472,53841592,6,0,1,4608,7,193050173
5228,41516610,12325443,53842053,6,0,1,10240,7,8767179470
5229,41521140,12330438,53851578,7,0,1,9728,10,5509144400
5230,41524260,12333347,53857607,0,0,1,21504,3,4948345156
5231,41525480,3575973,45101453,2,0,0,21504,3,9286178943
5232,41555220,12338325,53893545,7,0,1,37376,10,860408225
5233,41571770,12327881,53899651,6,0,1,5120,7,2551696711
5234,41573009,12328588,53901597,4,0,1,3072,15,10732241362
5235,41580350,12321593,53901943,0,0,1,512,3,4947829922
5236,41587589,12316300,53903889,4,0,1,3072,15,771276787
5237,41594710,12314411,53909121,0,0,1,11776,3,5398456107
5238,41594850,12324405,53919255,6,0,1,4608,7,3638225872
5239,41597290,12321988,53919278,0,0,1,2048,3,470162938
5240,41600490,3768387,45368877,2,0,0,5632,3,9211777753
5241,41601760,12317541,53919301,3,0,1,10752,17,8983118771
5242,41613330,12316633,53929963,0,0,1,10240,3,606451937
5243,41639171,3520850,45160021,7,0,0,63488,10,8427614486
5244,41640900,12297740,53938640,3,0,1,4096,17,1341559158
5245,41643360,12298826,53942186,3,0,1,5632,17,4295190231
5246,41653550,3609658,45263208,2,0,0,66560,3,1591794567
5247,41654460,4274063,45928523,4,0,0,16384,15,1572940175
5248,41654501,4108087,45762588,7,0,0,21504,10,6870280657
5249,41662900,4238433,45901333,4,0,0,247808,15,10674562173
5250,41664820,3640827,45305647,2,0,0,26112,3,5433539395
5251,41671260,3992083,45663343,4,0,0,148480,15,7780383024
5252,41674980,4150826,45825806,4,0,0,177152,15,2977612601
5253,41687720,3832734,45520454,4,0,0,2048,15,2978457435
5254,41689570,12274634,53964204,0,0,1,26624,3,9221574029
5255,41700851,12263699,53964550,8,0,1,512,8,8100829623
5256,41714780,4308251,46023031,4,0,0,7680,15,2414275548
5257,41716211,3767649,45483860,7,0,0,47104,10,208848461
5258,41719900,12245009,53964909,3,0,1,9728,17,1356845324
5259,41722511,4268356,45990867,7,0,0,151040,10,6711718421
5260,41726161,4197109,45923270,7,0,0,71168,10,8497505214
5261,41734040,12231637,53965677,0,0,1,11776,3,35314340
5262,41742410,3875670,45618080,2,0,0,57856,3,10226382272
5263,41743750,3807564,45551314,2,0,0,5120,3,6885693974
5264,41744780,12237107,53981887,0,0,1,512,3,6499911012
5265,41748501,12235332,53983833,8,0,1,3072,8,2081779527
5266,41756480,3950095,45706575,4,0,0,43520,15,2764005858
5267,41761051,12223128,53984179,8,0,1,512,8,2961650373
5268,41780480,12205965,53986445,3,0,1,3584,17,9627349720
5269,41786931,12202100,53989031,8,0,1,4096,8,1414745832
5270,41799760,12197963,53997723,3,0,1,13824,17,928532816
5271,41803230,4288638,46091868,4,0,0,23552,15,9754173318
5272,41805161,12192908,53998069,8,0,1,512,8,8933512186
5273,41810771,4209603,46020374,7,0,0,96768,10,2707090864
5274,41811951,4132663,45944614,7,0,0,52736,10,6865971986
5275,41813090,12188525,54001615,0,0,1,5632,3,1712541285
5276,41827840,12186923,54014763,6,0,1,5120,7,3427775524
5277,41828799,12185987,54014786,4,0,1,4608,15,643467780
5278,41841320,12173489,54014809,6,0,1,14848,7,4666154292
5279,41853360,12182593,54035953,0,0,1,2048,3,5021300373
5280,41854910,4199155,46054065,2,0,0,54272,3,9121092863
5281,41873660,12163279,54036939,0,0,1,1536,3,7654060152
5282,41890520,12147725,54038245,3,0,1,2048,17,2014874045
5283,41890901,12148650,54039551,8,0,1,2048,8,8102077543
5284,41890940,4135585,46026525,2,0,0,11264,3,6710883484
5285,41892351,12150426,54042777,8,0,1,5120,8,10736094789
5286,41903830,4263431,46167261,4,0,0,61440,15,4918034597
5287,41910109,12133014,54043123,4,0,1,512,15,887756734
5288,41924201,12120228,54044429,8,0,1,2048,8,9880004313
5289,41926560,12124312,54050872,3,0,1,7680,17,9197964883
5290,41944950,12106908,54051858,3,0,1,1536,17,4024566230
5291,41954120,12100644,54054764,0,0,1,4608,3,3573976309
5292,41956720,12098710,54055430,3,0,1,1024,17,3106463810
5293,41976800,12079616,54056416,3,0,1,1536,17,2991666051
5294,41984839,12073523,54058362,4,0,1,3072,15,5071320217
5295,41990239,12073295,54063534,4,0,1,8192,15,4653688531
5296,42004859,12059661,54064520,4,0,1,1536,15,5550921244
5297,42020040,4407275,46427315,0,0,0,59392,3,10164836715
5298,42024969,12041497,54066466,4,0,1,3072,15,448413015
5299,42055030,4286672,46341702,0,0,0,22528,3,4439720971
5300,42059900,12007232,54067132,3,0,1,1024,17,568568057
5301,42060000,12093522,54153522,1,0,1,73216,10,2675856566
5302,42060640,12092905,54153545,0,0,1,1024,3,2822944001
5303,42061150,12092418,54153568,3,0,1,512,17,1601628302
5304,42062350,12091241,54153591,2,0,1,10240,3,8943255477
5305,42063530,4213636,46277166,0,0,0,65024,3,8310031862
5306,42084229,12069385,54153614,4,0,1,2048,15,2749995910
5307,42084350,12091729,54176079,1,0,1,13312,10,8979406936
5308,42084409,12093033,54177442,4,0,1,3584,15,1966400329
5309,42088790,4484501,46573291,0,0,0,53248,3,2473311963
5310,42092160,4196752,46288912,0,0,0,32768,3,8386021564
5311,42101620,12164343,54265963,1,0,1,73728,10,9565224658
5312,42105610,4563781,46669391,2,0,0,120832,3,4382358437
5313,42125251,4239554,46364805,7,0,0,14848,10,3136367000
5314,42141631,4137274,46278905,7,0,0,5632,10,649840293
5315,42148400,12120469,54268869,3,0,1,4608,17,8423332851
5316,42156209,12117166,54273375,4,0,1,7168,15,2550108984
5317,42157870,12119051,54276921,1,0,1,5632,10,1354534287
5318,42161080,12125493,54286573,3,0,1,15360,17,5973347312
5319,42169900,4311656,46481556,0,0,0,31744,3,1906569677
5320,42172660,12388655,54561315,1,0,1,139264,10,5440868612
5321,42176399,12393247,54569646,4,0,1,1024,15,1484488373
5322,42182189,12390434,54572623,4,0,1,4608,15,9698557402
5323,42184519,12391259,54575778,4,0,1,5120,15,9541466149
5324,42193281,4238893,46432174,7,0,0,15872,10,1480779144
5325,42194950,12398322,54593272,0,0,1,11776,3,1793049997
5326,42197681,4254557,46452238,7,0,0,6144,10,3712593102
5327,42203440,12390178,54593618,3,0,1,512,17,5492353688
5328,42205001,12409803,54614804,8,0,1,8192,8,596413755
5329,42211730,4090519,46302249,2,0,0,8192,3,5869403346
5330,42214709,12404921,54619630,4,0,1,7680,15,5951569919
5331,42217020,4192047,46409067,0,0,0,14848,3,4893606124
5332,42219880,12400096,54619976,2,0,1,512,3,5682601821
5333,42224280,12453656,54677936,1,0,1,73216,10,1370533742
5334,42226270,4173817,46400087,0,0,0,50688,3,7113700674
5335,42226810,12612563,54839373,1,0,1,105984,10,6951148251
5336,42226900,12612496,54839396,0,0,1,5632,3,7613716828
5337,42237500,4600603,46838103,4,0,0,40960,15,5416380300
5338,42238660,12600759,54839419,1,0,1,19968,10,415100357
5339,42245990,12634981,54880971,0,0,1,9728,3,10611464452
5340,42256330,12661082,54917412,1,0,1,67072,10,5197024269
5341,42262800,12662753,54925553,1,0,1,22528,10,8773203257
5342,42266670,4597414,46864084,0,0,0,34816,3,7515951904
5343,42270670,12683410,54954080,1,0,1,19456,10,9494065655
5344,42271721,4624865,46896586,7,0,0,95232,10,2880382202
5345,42279389,12682069,54961458,4,0,1,2560,15,1120001277
5346,42282410,12720680,55003090,1,0,1,57856,10,6348357088
5347,42283121,12725101,55008222,8,0,1,4096,8,7712095585
5348,42284530,12739413,55023943,9,0,1,10240,12,1858488212
5349,42289450,12735479,55024929,9,0,1,1536,12,7484880785
5350,42293850,4531727,46825577,4,0,0,69632,15,6945260993
5351,42295350,12741032,55036382,0,0,1,11264,3,380200338
5352,42295490,12798593,55094083,9,0,1,16384,12,3032973005
5353,42300720,4331808,46632528,4,0,0,75776,15,3999400737
5354,42304350,4707033,47011383,4,0,0,178176,15,3278810493
5355,42305860,12788246,55094106,0,0,1,2560,3,2258595349
5356,42307110,12787019,55094129,3,0,1,9216,17,5621530438
5357,42313449,12780703,55094152,4,0,1,5120,15,3889086117
5358,42316940,12782250,55099190,0,0,1,2048,3,1046895522
5359,42318350,12780863,55099213,0,0,1,512,3,6827541411
5360,42321390,12777846,55099236,3,0,1,1536,17,7602079562
5361,42321680,12777579,55099259,9,0,1,13824,12,8174723066
5362,42323850,12776079,55099929,1,0,1,18944,10,9466040359
5363,42324140,4285277,46609417,0,0,0,25600,3,8159703712
5364,42324320,12775648,55099968,2,0,1,1536,3,8486496845
5365,42329200,12770994,55100194,9,0,1,2048,12,5625659921
5366,42331770,12782238,55114008,1,0,1,29696,10,2275253336
5367,42359121,4851722,47210843,7,0,0,1024,10,2773946757
5368,42364030,4380229,46744259,2,0,0,30720,3,1460360511
5369,42381079,12762211,55143290,4,0,1,9728,15,10034270218
5370,42402550,12741086,55143636,3,0,1,512,17,6077984314
5371,42406329,12740533,55146862,4,0,1,5120,15,2882087745
5372,42407700,12829114,55236814,1,0,1,92160,10,2286881335
5373,42409181,12828299,55237480,8,0,1,1024,8,4586445360
5374,42409801,4680439,47090240,7,0,0,112640,10,1225772166
5375,42410190,12864346,55274536,9,0,1,9216,12,10223114479
5376,42412341,12866701,55279042,8,0,1,7168,8,1213313896
5377,42419699,4841750,47261449,3,0,0,79872,17,10287333778
5378,42425480,4472073,46897553,2,0,0,3072,3,4125363408
5379,42425981,12857887,55283868,8,0,1,7680,8,6234139837
5380,42428280,12856254,55284534,3,0,1,1024,17,3054116876
5381,42431669,12855669,55287338,4,0,1,16384,15,2127113860
5382,42438560,12871675,55310235,3,0,1,3584,17,2747415036
5383,42439809,12870449,55310258,4,0,1,10240,15,3176541319
5384,42442040,4320834,46762874,2,0,0,9728,3,2663787636
5385,42443620,4342833,46786453,4,0,0,2048,15,4013226180
5386,42447660,12871271,55318931,1,0,1,6144,10,4842234665
5387,42447929,4230221,46678150,3,0,0,28672,17,8996115321
5388,42454630,4601259,47055889,2,0,0,102400,3,1816715702
5389,42455510,12863444,55318954,9,0,1,11776,12,2895895326
5390,42462861,12856124,55318985,8,0,1,512,8,2256220400
5391,42464550,12905189,55369739,1,0,1,69120,10,6984745197
5392,42473690,12954168,55427858,1,0,1,58880,10,357120989
5393,42479500,12954762,55434262,3,0,1,11264,17,10703141021
5394,42480510,12962307,55442817,0,0,1,10752,3,9957680319
5395,42499850,4524816,47024666,0,0,0,43520,3,2670409755
5396,42500790,12953580,55454370,3,0,1,5632,17,1303991056
5397,42508849,4784600,47293449,3,0,0,9216,17,5786967694
5398,42512440,12942391,55454831,0,0,1,10240,3,8629254370
5399,42513410,4701090,47214500,4,0,0,11776,15,1127167653
5400,42521831,12997197,55519028,8,0,1,7168,8,9520696602
5401,42522890,12996161,55519051,0,0,1,11264,3,6498028437
5402,42524120,4343419,46867539,4,0,0,11264,15,9672652852
5403,42554160,12964914,55519074,0,0,1,3072,3,2340268545
5404,42574210,12978491,55552701,0,0,1,15360,3,6932925645
5405,42577020,13040281,55617301,1,0,1,85504,10,2781491920
5406,42577729,4797326,47375055,3,0,0,44032,17,4730816109
5407,42584141,13067831,55651972,5,0,1,3072,10,284209289
5408,42588780,13065778,55654558,9,0,1,4096,12,1547211284
5409,42604000,13056690,55660690,0,0,1,9728,3,539487898
5410,42605931,13055105,55661036,5,0,1,512,10,2396023232
5411,42606239,4311795,46918034,3,0,0,512,17,6859783437
5412,42619750,4717083,47336833,2,0,0,69632,3,1102191149
5413,42627440,13036502,55663942,3,0,1,4608,17,3956655880
5414,42639661,13026065,55665726,8,0,1,2048,8,6876623510
5415,42640170,13057510,55697680,1,0,1,26624,10,9710236992
5416,42643730,4487812,47131542,4,0,0,41984,15,6840934184
5417,42643910,13062004,55705914,0,0,1,3072,3,4559038712
5418,42644930,13072549,55717479,3,0,1,16896,17,2476767977
5419,42646940,13073765,55720705,9,0,1,5120,12,2941918707
5420,42646950,4460086,47107036,2,0,0,2048,3,6434588828
5421,42651911,13069140,55721051,5,0,1,512,10,3418180475
5422,42656440,13076276,55732716,1,0,1,19456,10,8399226405
5423,42660831,13080669,55741500,5,0,1,1536,10,2592774613
5424,42666311,4544174,47210485,7,0,0,50688,10,5672445206
5425,42667830,13096582,55764412,3,0,1,11776,17,5683048392
5426,42669831,13095462,55765293,5,0,1,6144,10,5031646453
5427,42672710,13095381,55768091,0,0,1,3072,3,1540782212
5428,42676909,4584742,47261651,3,0,0,512,17,9067721340
5429,42679530,13089125,55768655,0,0,1,10752,3,1220826719
5430,42680491,4737801,47418292,7,0,0,58880,10,7439670023
5431,42688171,13089902,55778073,8,0,1,512,8,4293682868
5432,42693090,13088360,55781450,0,0,1,6144,3,4346185748
5433,42694680,13171939,55866619,1,0,1,20992,10,4223917752
5434,42697150,13174295,55871445,0,0,1,7680,3,9205772006
5435,42698381,13175970,55874351,5,0,1,4608,10,8400575568
5436,42702390,4587819,47290209,4,0,0,2048,15,5306668836
5437,42705070,13179292,55884362,1,0,1,24064,10,331347441
5438,42706641,13184084,55890725,8,0,1,4096,8,8118026840
5439,42730300,4756077,47486377,4,0,0,31744,15,1878536210
5440,42731160,13178588,55909748,1,0,1,25600,10,8433509094
5441,42731330,13193625,55924955,1,0,1,41472,10,6878388394
5442,42734361,13209095,55943456,8,0,1,2048,8,5763662677
5443,42745350,13199412,55944762,3,0,1,2048,17,519916314
5444,42759350,13259662,56019012,1,0,1,76288,10,6646031508
5445,42761901,4673722,47435623,7,0,0,12800,10,1453453505
5446,42764311,13256686,56020997,8,0,1,12288,8,7863591512
5447,42764389,4621549,47385938,3,0,0,512,17,2030713006
5448,42767039,4668919,47435958,3,0,0,1024,17,1910693823
5449,42768441,4732114,47500555,7,0,0,1536,10,1671947070
5450,42772191,13280419,56052610,5,0,1,9728,10,1729867525
5451,42773391,13329593,56102984,8,0,1,1536,8,3296516636
5452,42775200,4796968,47572168,0,0,0,2560,3,630648338
5453,42784551,13318456,56103007,5,0,1,2560,10,10415227100
5454,42785840,13317190,56103030,0,0,1,9728,3,1906771458
5455,42797070,4820243,47617313,4,0,0,23040,15,3680037731
5456,42808470,4771828,47580298,0,0,0,24576,3,441669533
5457,42809809,4699060,47508869,3,0,0,4608,17,4490309358
5458,42818000,4769497,47587497,4,0,0,23552,15,972064581
5459,42824620,13325133,56149753,1,0,1,22528,10,6031288323
5460,42824891,13332665,56157556,5,0,1,512,10,5902253401
5461,42826151,13331969,56158120,8,0,1,10752,8,6804575713
5462,42833051,13325735,56158786,5,0,1,1024,10,6858427868
5463,42844281,13321597,56165878,5,0,1,11264,10,3462326736
5464,42851880,4669703,47521583,4,0,0,22528,15,80831833
5465,42853320,13316104,56169424,3,0,1,5632,17,5413656159
5466,42865050,13325548,56190598,0,0,1,3072,3,1826058018
5467,42869401,13321220,56190621,5,0,1,13312,10,670647699
5468,42869651,4801155,47670806,7,0,0,32256,10,5555689621
5469,42871700,4947229,47818929,0,0,0,75264,3,6799988211
5470,42875911,13314733,56190644,5,0,1,13312,10,5747006072
5471,42901281,4979621,47880902,7,0,0,27136,10,4253620462
5472,42911450,13323569,56235019,0,0,1,6144,3,6314117078
5473,42913131,13322554,56235685,5,0,1,1024,10,377217632
5474,42916231,13323960,56240191,5,0,1,7168,10,3656922313
5475,42920420,4923311,47843731,4,0,0,13312,15,1866488777
5476,42921861,13341483,56263344,5,0,1,6656,10,8689654693
5477,42921921,13356210,56278131,8,0,1,13312,8,6724385385
5478,42934460,13344951,56279411,0,0,1,14336,3,1394250929
5479,42934780,13345967,56280747,0,0,1,1024,3,1755913313
5480,42936140,4859266,47795406,2,0,0,16896,3,566022666
5481,42946550,13360222,56306772,1,0,1,19968,10,10642940675
5482,42946570,13361188,56307758,6,0,1,1536,7,6355576532
5483,42946730,13362334,56309064,0,0,1,2048,3,4391878368
5484,42948900,5243700,48192600,0,0,0,60416,3,4273851520
5485,42957020,5015246,47972266,4,0,0,13312,15,7732726485
5486,42957221,13415835,56373056,8,0,1,17408,8,5753430950
5487,42962069,4888871,47850940,3,0,0,1024,17,289697303
5488,42964361,13408718,56373079,8,0,1,2560,8,1717757221
5489,42975030,5076058,48051088,2,0,0,44032,3,7814036
5490,42978501,13394601,56373102,5,0,1,1536,10,8260634292
5491,42979370,13393755,56373125,0,0,1,512,3,1912646405
5492,42979721,5233962,48213683,7,0,0,69120,10,9007803371
5493,42988900,13384248,56373148,0,0,1,12800,3,4711923629
5494,43003841,5275351,48279192,7,0,0,35328,10,8385144379
5495,43006291,5498707,48504998,7,0,0,257536,10,3399565363
5496,43010280,5204861,48215141,4,0,0,3072,15,3578223657
5497,43011001,13362170,56373171,8,0,1,3584,8,3616778803
5498,43014540,13363193,56377733,3,0,1,7680,17,7708574474
5499,43026620,13355731,56382351,1,0,1,12288,10,6575934077
5500,43033710,5316698,48350408,0,0,0,81920,3,4006373576
5501,43033871,13349146,56383017,5,0,1,11264,10,614883368
5502,43044251,13361412,56405663,5,0,1,512,10,4123170257
5503,43047910,13360979,56408889,3,0,1,5120,17,9976250731
5504,43057760,5368701,48426461,4,0,0,56832,15,5171161124
5505,43058180,13351695,56409875,0,0,1,1536,3,4011653973
5506,43061820,13348875,56410695,0,0,1,9728,3,10727010122
5507,43076360,13334681,56411041,0,0,1,512,3,1040503983
5508,43080841,5440037,48520878,7,0,0,51712,10,6306832
5509,43090380,13390623,56481003,1,0,1,44544,10,2997730825
5510,43093960,5500338,48594298,2,0,0,77312,3,931841700
5511,43099160,13385389,56484549,3,0,1,5632,17,3178734437
5512,43105891,13407652,56513543,5,0,1,512,10,2944734152
5513,43107420,5458055,48565475,0,0,0,75264,3,733675981
5514,43112791,13403018,56515809,5,0,1,3584,10,1491072120
5515,43121221,5092953,48214174,7,0,0,1536,10,739860972
5516,43131809,5228652,48360461,3,0,0,1536,17,8740539711
5517,43134980,5567618,48702598,0,0,0,37376,3,8329648811
5518,43142531,13373944,56516475,8,0,1,1024,8,3290404415
5519,43144629,5376692,48521321,3,0,0,1024,17,5530925345
5520,43159270,13386367,56545637,3,0,1,6144,17,3113674751
5521,43161711,13404644,56566355,5,0,1,512,10,7747296328
5522,43166440,13753810,56920250,1,0,1,197632,10,881634081
5523,43172740,13943502,57116242,1,0,1,217600,10,6773944046
5524,43180970,13964944,57145914,1,0,1,11776,10,4163961848
5525,43184120,14129460,57313580,1,0,1,128000,10,892493677
5526,43186610,5810895,48997505,0,0,0,151040,3,3866697472
5527,43197380,14117026,57314406,1,0,1,15360,10,98950217
5528,43197711,14116718,57314429,5,0,1,4096,10,6499747631
5529,43225640,5724568,48950208,0,0,0,32768,3,6242287721
5530,43226129,5699866,48925995,3,0,0,512,17,3112767132
5531,43226479,5536980,48763459,1,0,0,1536,10,2060952426
5532,43260889,5375374,48636263,3,0,0,512,17,9894929295
5533,43268721,14045731,57314452,5,0,1,2560,10,952609832
5534,43281900,14032575,57314475,3,0,1,1536,17,7696853319
5535,43292340,5575360,48867700,0,0,0,31232,3,1624871282
5536,43293090,5444850,48737940,4,0,0,81408,15,3742503254
5537,43295901,14018597,57314498,5,0,1,2048,10,4784582310
5538,43313060,5545101,48858161,0,0,0,21504,3,7532441542
5539,43335719,13978802,57314521,4,0,1,4608,15,2104380289
5540,43341330,5809541,49150871,0,0,0,159232,3,8317054392
5541,43362420,13952124,57314544,0,0,1,512,3,8875565192
5542,43363679,5327508,48691187,3,0,0,2048,17,7210603501
5543,43369960,5555779,48925739,2,0,0,45568,3,1781737703
5544,43391449,5221432,48612881,3,0,0,512,17,7181558424
5545,43394791,13919776,57314567,8,0,1,6656,8,9369776562
5546,43397620,5286686,48684306,4,0,0,11264,15,6024136721
5547,43401160,13913430,57314590,3,0,1,512,17,6380380815
5548,43421709,13893083,57314792,4,0,1,10240,15,10120803946
5549,43429559,13885256,57314815,4,0,1,2560,15,5339452150
5550,43435431,13879407,57314838,8,0,1,13312,8,10452948124
5551,43452680,14000165,57452845,1,0,1,162816,10,9499976972
5552,43453091,14002608,57455699,8,0,1,1024,8,8517506653
5553,43479909,5222924,48702833,3,0,0,512,17,9597796421
5554,43482490,14215901,57698391,1,0,1,189440,10,3071579305
5555,43489071,14209678,57698749,5,0,1,3072,10,8361868184
5556,43508461,14190311,57698772,5,0,1,4608,10,4138752522
5557,43517080,14181715,57698795,2,0,1,2560,3,5760866776
5558,43518109,14182604,57700713,4,0,1,3072,15,3480607309
5559,43531210,14169526,57700736,7,0,1,8192,10,4689753412
5560,43542701,5464576,49007277,7,0,0,31744,10,2982055941
5561,43545711,14155048,57700759,5,0,1,2048,10,8836121912
5562,43547720,14201926,57749646,7,0,1,80384,10,3261698289
5563,43552991,14209920,57762911,8,0,1,2560,8,8847527873
5564,43560490,14202767,57763257,2,0,1,512,3,5228161145
5565,43560920,14205883,57766803,7,0,1,5632,10,2592703649
5566,43563370,14208925,57772295,7,0,1,17920,10,4783652407
5567,43572569,5378051,48950620,3,0,0,1024,17,842678849
5568,43589941,14193134,57783075,5,0,1,10752,10,10620563809
5569,43590460,5564030,49154490,0,0,0,11776,3,9150091660
5570,43595260,14275214,57870474,1,0,1,70656,10,6134440292
5571,43603230,14563472,58166702,1,0,1,134656,10,10033550725
5572,43606040,5410377,49016417,0,0,0,29696,3,7710535319
5573,43607591,5452944,49060535,7,0,0,24064,10,3166773940
5574,43611470,14588733,58200203,7,0,1,27136,10,1268754928
5575,43619010,14581216,58200226,2,0,1,1024,3,6315376640
5576,43625510,5540928,49166438,2,0,0,12288,3,7918812082
5577,43626690,14573559,58200249,3,0,1,4096,17,1075661308
5578,43627439,5389711,49017150,3,0,0,1536,17,9000179769
5579,43630500,14569772,58200272,2,0,1,5120,3,8608003251
5580,43631081,14569214,58200295,5,0,1,2560,10,1941162154
5581,43634321,5403297,49037618,7,0,0,5632,10,4153672497
5582,43634980,14565338,58200318,2,0,1,10240,3,10654530340
5583,43635861,14564480,58200341,5,0,1,1536,10,9246727512
5584,43637031,14563333,58200364,5,0,1,14336,10,4883034024
5585,43641730,14560757,58202487,7,0,1,1536,10,1135695824
5586,43645130,14563054,58208184,7,0,1,18944,10,3718420756
5587,43653250,5509421,49162671,2,0,0,26624,3,4214514949
5588,43654819,5520187,49175006,3,0,0,512,17,4002889972
5589,43659281,14549889,58209170,5,0,1,1536,10,5012715207
5590,43662270,14582197,58244467,7,0,1,59392,10,6500633561
5591,43670930,14573896,58244826,6,0,1,9728,7,5682025604
5592,43674491,14577619,58252110,8,0,1,4096,8,374556452
5593,43677979,5338680,49016659,3,0,0,512,17,9105920527
5594,43678161,14587568,58265729,5,0,1,6144,10,7359302516
5595,43688990,14595591,58284581,1,0,1,78336,10,4132525182
5596,43714310,14583469,58297779,7,0,1,16384,10,7862692273
5597,43715390,14609857,58325247,2,0,1,5120,3,6484013326
5598,43720949,5875733,49596682,3,0,0,512,17,7547104975
5599,43726460,14603524,58329984,2,0,1,5632,3,5529936647
5600,43730500,14601574,58332074,3,0,1,2560,17,628000779
5601,43732011,14603609,58335620,8,0,1,5632,8,5835504629
5602,43734190,14607639,58341829,1,0,1,21504,10,683458806
5603,43739130,14602955,58342085,7,0,1,9216,10,4976772093
5604,43744260,14737834,58482094,7,0,1,72192,10,10441347648
5605,43747520,14762701,58510221,7,0,1,34304,10,7575304337
5606,43757790,14844961,58602751,3,0,1,15872,17,401134151
5607,43757940,5527414,49285354,0,0,0,90624,3,4852811647
5608,43763130,14841089,58604219,1,0,1,22016,10,7102053711
5609,43763220,5794864,49558084,0,0,0,11776,3,1544141241
5610,43768161,14838324,58606485,8,0,1,3584,8,7680215141
5611,43770670,14839041,58609711,1,0,1,5120,10,2777486985
5612,43777450,5614506,49391956,2,0,0,51200,3,10316965473
5613,43777930,14860381,58638311,7,0,1,60928,10,10382977769
5614,43782160,14858097,58640257,2,0,1,3072,3,9121823684
5615,43799190,15017105,58816295,7,0,1,125440,10,1943273878
5616,43805420,6112550,49917970,9,0,0,55296,12,4520988100
5617,43806511,15011410,58817921,8,0,1,2560,8,5858551734
5618,43808791,15064815,58873606,8,0,1,17408,8,5097381974
5619,43816500,15065420,58881920,7,0,1,3072,10,3846413334
5620,43827591,15054360,58881951,8,0,1,3072,8,109426986
5621,43837210,15060845,58898055,1,0,1,56832,10,1127758983
5622,43841330,15081654,58922984,2,0,1,5120,3,1171718627
5623,43844160,5950312,49794472,4,0,0,14336,15,944383954
5624,43849070,15080248,58929318,3,0,1,2048,17,5108983815
5625,43849800,5805369,49655169,9,0,0,17920,12,4765828524
5626,43851930,15078694,58930624,2,0,1,2048,3,6671889735
5627,43857581,5536137,49393718,7,0,0,2048,10,8783713738
5628,43861899,5678927,49540826,3,0,0,512,17,6211521989
5629,43863060,5530011,49393071,9,0,0,3584,12,4905294593
5630,43875400,15058770,58934170,3,0,1,5632,17,2198341988
5631,43878630,5485106,49363736,9,0,0,55808,12,9043055266
5632,43883880,5599133,49483013,0,0,0,3584,3,117311807
5633,43885960,15065235,58951195,1,0,1,14848,10,10471946959
5634,43893890,15091679,58985569,1,0,1,52224,10,4899366614
5635,43896070,5700433,49596503,2,0,0,25088,3,5353667054
5636,43911650,5827951,49739601,4,0,0,113664,15,6558321099
5637,43932630,15111936,59044566,7,0,1,42496,10,5669074250
5638,43938580,15106009,59044589,2,0,1,1536,3,7158338520
5639,43940650,15209333,59149983,7,0,1,174080,10,6565753249
5640,43951241,5885733,49836974,7,0,0,97792,10,789442173
5641,43953100,5494096,49447196,0,0,0,22016,3,6276690137
5642,43957840,15203614,59161454,2,0,1,9216,3,5696074080
5643,43962210,15203750,59165960,2,0,1,7168,3,2850266929
5644,43963080,15228049,59191129,3,0,1,1536,17,3781922430
5645,43969900,5584573,49554473,4,0,0,44544,15,6160703392
5646,43971030,15220970,59192000,1,0,1,12288,10,9116311228
5647,43973540,15264911,59238451,2,0,1,2048,3,5074402378
5648,43974530,5515980,49490510,2,0,0,3584,3,2744604434
5649,43991570,5798511,49790081,8,0,0,49664,8,6884763523
5650,43992430,15247506,59239936,1,0,1,15360,10,1623309595
5651,43995760,5625784,49621544,2,0,0,10240,3,8290028105
5652,43999150,5775597,49774747,8,0,0,512,8,691377437
5653,43999570,5597291,49596861,0,0,0,512,3,7337388127
5654,44000480,6106461,50106941,0,0,0,143872,3,8396528489
5655,44000819,5639607,49640426,3,0,0,512,17,8757717323
5656,44007241,5847968,49855209,7,0,0,45056,10,6187501710
5657,44008930,15365901,59374831,1,0,1,72704,10,1188690713
5658,44016690,15408100,59424790,3,0,1,10240,17,2394134544
5659,44018080,15406733,59424813,2,0,1,6656,3,9937935578
5660,44020181,5942798,49962979,7,0,0,13824,10,8742663886
5661,44029650,15426097,59455747,1,0,1,17920,10,3284399851
5662,44030850,5547026,49577876,8,0,0,1024,8,7109554023
5663,44031250,5743676,49774926,8,0,0,512,8,22184499
5664,44031540,15429284,59460824,7,0,1,29696,10,10159469385
5665,44034870,5739698,49774568,0,0,0,114688,3,9613160788
5666,44036110,5564420,49600530,0,0,0,3584,3,2465795456
5667,44041890,15419604,59461494,2,0,1,11264,3,4473194320
5668,44046380,15415137,59461517,3,0,1,4608,17,2800116687
5669,44054560,5752595,49807155,0,0,0,41472,3,7471823933
5670,44066610,5970733,50037343,9,0,0,55296,12,1587404191
5671,44070201,5771249,49841450,7,0,0,7680,10,8674000600
5672,44082039,5616215,49698254,3,0,0,1536,17,2326798655
5673,44104230,15357326,59461556,1,0,1,18432,10,367142820
5674,44104930,15356841,59461771,3,0,1,5120,17,5850934744
5675,44111800,15351597,59463397,3,0,1,2560,17,10245515482
5676,44127390,15337313,59464703,2,0,1,2048,3,6467405875
5677,44131730,15336519,59468249,7,0,1,5632,10,4716485289
5678,44132100,15339055,59471155,3,0,1,4608,17,2898142222
5679,44136220,15392928,59529148,1,0,1,76288,10,10324097287
5680,44140480,5879992,50020472,9,0,0,33792,12,9386324503
5681,44147359,5788843,49936202,3,0,0,1536,17,4760564664
5682,44150901,15378270,59529171,5,0,1,2048,10,3531695120
5683,44161910,6024936,50186846,9,0,0,4608,12,2621387989
5684,44163670,5675355,49839025,9,0,0,6656,12,854600772
5685,44170420,15393666,59564086,1,0,1,71168,10,2340385060
5686,44172650,15393062,59565712,3,0,1,2560,17,2433422961
5687,44182329,5673059,49855388,3,0,0,512,17,9741806717
5688,44186450,15397192,59583642,1,0,1,31744,10,8017068771
5689,44187290,15431740,59619030,7,0,1,46592,10,3084960092
5690,44190140,15462725,59652865,1,0,1,39936,10,6596218454
5691,44191720,15471606,59663326,2,0,1,1024,3,9248111167
5692,44193980,15475603,59669583,7,0,1,20992,10,6152769806
5693,44212390,6071653,50284043,2,0,0,22016,3,7219382724
5694,44218760,5953439,50172199,4,0,0,3584,15,8668497263
5695,44230960,15517264,59748224,1,0,1,99840,10,996508095
5696,44232120,15603783,59835903,7,0,1,40960,10,8034415569
5697,44234700,15602189,59836889,2,0,1,1536,3,8262879460
5698,44237390,15662734,59900124,7,0,1,73216,10,2541272862
5699,44248320,15748423,59996743,1,0,1,37888,10,8933479732
5700,44261660,15745152,60006812,7,0,1,23040,10,9655365952
5701,44262740,15790468,60053208,1,0,1,36864,10,1067859679
5702,44263020,6021435,50284455,8,0,0,1024,8,1556800129
5703,44270070,6019400,50289470,0,0,0,16384,3,5092611663
5704,44284150,5990331,50274481,0,0,0,127488,3,7315935002
5705,44287290,15776055,60063345,7,0,1,3584,10,4905702041
5706,44288151,15775540,60063691,5,0,1,512,10,10431247497
5707,44312880,15757327,60070207,1,0,1,23040,10,986994859
5708,44313840,15768698,60082538,2,0,1,5120,3,10635177852
5709,44315310,15883131,60198441,1,0,1,134656,10,8562830246
5710,44327359,5780073,50107432,3,0,0,1536,17,3130830190
5711,44333150,6091314,50424464,9,0,0,8192,12,10003714674
5712,44335190,5942122,50277312,0,0,0,9216,3,7991620934
5713,44357600,6102798,50460398,8,0,0,1024,8,6522699292
5714,44375260,6051723,50426983,0,0,0,8192,3,7757539907
5715,44386909,5994108,50381017,3,0,0,1024,17,10208117260
5716,44389430,5977301,50366731,4,0,0,40960,15,1564628192
5717,44389840,15813427,60203267,2,0,1,7680,3,9818919786
5718,44398830,15849824,60248654,7,0,1,42496,10,2038732033
5719,44405880,6244750,50650630,0,0,0,34304,3,3121033772
5720,44406180,6180632,50586812,9,0,0,26624,12,3483711489
5721,44416360,6004846,50421206,2,0,0,81408,3,1743243168
5722,44438970,15816972,60255942,6,0,1,1536,7,4121828797
5723,44442750,15889685,60332435,7,0,1,106496,10,5966257540
5724,44447210,5974735,50421945,8,0,0,1536,8,785970394
5725,44459599,5933280,50392879,3,0,0,2560,17,4826848683
5726,44461110,5914836,50375946,2,0,0,4096,3,8500033602
5727,44465390,15956123,60421513,7,0,1,95744,10,3311226039
5728,44468820,15974289,60443109,2,0,1,2048,3,5111402933
5729,44469490,15985986,60455476,7,0,1,58880,10,9301845798
5730,44484850,15977799,60462649,2,0,1,4096,3,4217606156
5731,44499870,5921515,50421385,8,0,0,512,8,4921061473
5732,44500540,15967255,60467795,6,0,1,8192,7,250617043
5733,44503100,6024691,50527791,0,0,0,45056,3,7286794840
5734,44503510,6206433,50709943,9,0,0,24064,12,7555483718
5735,44506000,15962141,60468141,6,0,1,512,7,6071291665
5736,44506550,16019593,60526143,6,0,1,27136,7,1695225557
5737,44513010,5918622,50431632,2,0,0,14336,3,453310555
5738,44528750,16017824,60546574,7,0,1,20992,10,9058290061
5739,44536239,5991887,50528126,3,0,0,1024,17,7344402207
5740,44542961,16003767,60546728,8,0,1,8704,8,7869023579
5741,44544580,16009817,60554397,7,0,1,29184,10,100334978
5742,44547760,16088217,60635977,7,0,1,42496,10,7025722284
5743,44550741,6188678,50739419,7,0,0,46592,10,10391017661
5744,44557960,6066253,50624213,2,0,0,52736,3,6398175912
5745,44566010,16070512,60636522,2,0,1,6656,3,182641149
5746,44567449,6210299,50777748,3,0,0,1536,17,10179687032
5747,44570650,16065895,60636545,6,0,1,2560,7,8842716385
5748,44578669,6115972,50694641,3,0,0,1536,17,3540024445
5749,44578830,5958310,50537140,2,0,0,11776,3,10597897373
5750,44580250,6460384,51040634,4,0,0,106496,15,6419508865
5751,44592710,16043858,60636568,7,0,1,4096,10,1860189443
5752,44617450,16032112,60649562,9,0,1,3072,12,234683963
5753,44622420,6202642,50825062,0,0,0,18432,3,7122045512
5754,44627120,16036848,60663968,6,0,1,19456,7,997684035
5755,44632259,6033423,50665682,3,0,0,2048,17,8295973884
5756,44637570,16028024,60665594,6,0,1,2560,7,523247142
5757,44637780,6163722,50801502,8,0,0,1024,8,9487278032
5758,44641180,16039758,60680938,6,0,1,3584,7,98680164
5759,44646889,6032410,50679299,3,0,0,512,17,8792586698
5760,44669090,6224037,50893127,8,0,0,1024,8,8696215108
5761,44676940,6322038,50998978,4,0,0,38912,15,530567703
5762,44682669,6317353,51000022,3,0,0,3072,17,8383473023
5763,44687700,6298169,50985869,0,0,0,192512,3,7737360277
5764,44690110,6296741,50986851,8,0,0,1024,8,9344670696
5765,44695460,6197332,50892792,2,0,0,102912,3,5495784919
5766,44719650,15963554,60683204,6,0,1,3584,7,3260923988
5767,44744640,5995426,50740066,8,0,0,2048,8,10540095054
5768,44746820,15938010,60684830,6,0,1,2560,7,6831710497
5769,44753590,6388143,51141733,0,0,0,125440,3,3285393077
5770,44766930,15921766,60688696,6,0,1,6144,7,5089631192
5771,44768360,6397576,51165936,2,0,0,79360,3,8701597598
5772,44776850,15929109,60705959,6,0,1,2560,7,223526720
5773,44778579,6115108,50893687,3,0,0,1024,17,5476613917
5774,44789410,6065486,50854896,2,0,0,13824,3,841261496
5775,44805420,15900562,60705982,6,0,1,1536,7,10512348064
5776,44814780,5900916,50715696,8,0,0,512,8,8951037416
5777,44821200,15886429,60707629,6,0,1,4096,7,7810019910
5778,44821551,15888024,60709575,8,0,1,3072,8,5242714782
5779,44834999,6152031,50987030,3,0,0,512,17,8503259794
5780,44837500,15875647,60713147,2,0,1,5632,3,10213728760
5781,44842999,6050353,50893352,3,0,0,512,17,1294120780
5782,44846430,6331154,51177584,2,0,0,3584,3,8328630198
5783,44857370,15862189,60719559,0,0,1,512,3,1041101707
5784,44858420,6128096,50986516,9,0,0,2048,12,3418430577
5785,44863680,6444170,51307850,2,0,0,97280,3,9524472118
5786,44870160,6049446,50919606,2,0,0,2560,3,5150795909
5787,44874200,6347724,51221924,9,0,0,43520,12,10212314874
5788,44874590,15845955,60720545,6,0,1,1536,7,7537025914
5789,44897950,6109010,51006960,0,0,0,3584,3,3714825105
5790,44900180,15823911,60724091,6,0,1,5632,7,4448866288
5791,44906500,6192789,51099289,0,0,0,3584,3,1050502134
5792,44910280,6263323,51173603,2,0,0,25088,3,2600269136
5793,44919150,15806119,60725269,2,0,1,13824,3,5637038048
5794,44946740,15809314,60756054,2,0,1,4608,3,9928223359
5795,44947180,6297543,51244723,2,0,0,74752,3,3392690489
5796,44947870,15817901,60765771,0,0,1,2560,3,7492447988
5797,44949621,15823782,60773403,5,0,1,1536,10,8173255774
5798,44949740,15824009,60773749,6,0,1,512,7,3999419432
5799,44952819,6365280,51318099,3,0,0,512,17,1645362237
5800,44956590,15820385,60776975,2,0,1,5120,3,378928551
5801,44965380,6352540,51317920,4,0,0,30208,15,3178763012
5802,44971749,6336303,51308052,3,0,0,512,17,4081643599
5803,44980290,6381756,51362046,4,0,0,90624,15,1839405003
5804,44980550,6521321,51501871,9,0,0,3584,12,5735489030
5805,44983581,15794879,60778460,8,0,1,15360,8,7523569689
5806,44989989,6328312,51318301,3,0,0,512,17,2906821880
5807,44990590,15806974,60797564,6,0,1,13312,7,2336960937
5808,44997710,15807043,60804753,2,0,1,4608,3,690450763
5809,45010730,15794369,60805099,2,0,1,512,3,9591775345
5810,45011560,6535300,51546860,2,0,0,14336,3,8648993752
5811,45016340,6402458,51418798,9,0,0,47616,12,7842460418
5812,45023730,6465020,51488750,8,0,0,11264,8,3579941101
5813,45023900,6310511,51334411,8,0,0,18944,8,9428224736
5814,45029951,15775507,60805458,8,0,1,9728,8,1678016322
5815,45043031,15783441,60826472,8,0,1,4608,8,4464743948
5816,45047530,6317401,51364931,9,0,0,7680,12,6383851819
5817,45050199,6312346,51362545,3,0,0,1536,17,8978968925
5818,45051740,6691931,51743671,8,0,0,46080,8,2659495134
5819,45054610,6370763,51425373,9,0,0,21504,12,10574260295
5820,45055230,15771588,60826818,3,0,1,512,17,7737337457
5821,45064720,6400838,51465558,8,0,0,11776,8,8898025922
5822,45074820,6100374,51175194,0,0,0,5120,3,1202454155
5823,45078001,15749483,60827484,5,0,1,1024,10,10063313342
5824,45081970,6290206,51372176,2,0,0,23552,3,2166838756
5825,45085591,15742866,60828457,8,0,1,12800,8,6023325199
5826,45097109,6328451,51425560,3,0,0,512,17,4057864800
5827,45099440,15744294,60843734,2,0,1,1536,3,5979520051
5828,45107570,6513552,51621122,9,0,0,20480,12,1096057346
5829,45112059,6332639,51444698,3,0,0,512,17,7826332686
5830,45117400,6255002,51372402,2,0,0,512,3,3425036816
5831,45124220,15720078,60844298,2,0,1,10752,3,210081155
5832,45130641,15736313,60866954,8,0,1,1024,8,3915163439
5833,45133361,15734259,60867620,8,0,1,1024,8,8207717100
5834,45134031,15734972,60869003,8,0,1,14848,8,3691045632
5835,45151930,6420828,51572758,0,0,0,3072,3,5481983039
5836,45154661,15715392,60870053,8,0,1,12288,8,8260052720
5837,45158610,6443911,51602521,0,0,0,5120,3,6096049932
5838,45163410,6739738,51903148,8,0,0,139264,8,103899063
5839,45173920,15738760,60912680,2,0,1,4096,3,2348663498
5840,45185600,6675085,51860685,8,0,0,31232,8,8253659920
5841,45186150,15726553,60912703,6,0,1,512,7,7963257457
5842,45193060,15756645,60949705,6,0,1,20992,7,5862679960
5843,45219170,6395601,51614771,0,0,0,8704,3,5609783098
5844,45224730,15729290,60954020,6,0,1,1536,7,5816870306
5845,45225620,6625526,51851146,4,0,0,34304,15,9383444823
5846,45238860,6484999,51723859,9,0,0,94720,12,2164873814
5847,45238971,15735957,60974928,5,0,1,24064,10,1510552706
5848,45249391,15725560,60974951,5,0,1,1024,10,5885375538
5849,45250171,15724803,60974974,5,0,1,6144,10,7220252986
5850,45259381,15715616,60974997,5,0,1,5120,10,7441567211
5851,45261480,6690508,51951988,9,0,0,76800,12,1509724404
5852,45262870,15712150,60975020,3,0,1,20480,17,1387817418
5853,45272480,6755787,52028267,0,0,0,13312,3,7778938475
5854,45272740,15707086,60979826,3,0,1,10752,17,2414458703
5855,45278180,15705512,60983692,6,0,1,6144,7,1060040214
5856,45288890,6710934,51999824,0,0,0,98816,3,9975907297
5857,45295279,15690999,60986278,4,0,1,4096,15,7558535677
5858,45311239,15733773,61045012,4,0,1,9728,15,105888881
5859,45313750,6710277,52024027,0,0,0,79360,3,7094810471
5860,45321149,15724221,61045370,4,0,1,7168,15,5420031027
5861,45321950,6436289,51758239,8,0,0,8192,8,8679753189
5862,45323021,15799665,61122686,5,0,1,16384,10,1000312915
5863,45332171,15885247,61217418,5,0,1,12288,10,10181928002
5864,45335240,6590364,51925604,6,0,0,8192,7,3668362175
5865,45344450,6697100,52041550,4,0,0,43520,15,4188905172
5866,45344550,6613059,51957609,4,0,0,17920,15,349077086
5867,45355521,15861920,61217441,5,0,1,2560,10,45944079
5868,45372209,15845255,61217464,4,0,1,1536,15,5154293203
5869,45378089,15876534,61254623,4,0,1,18944,15,3489657457
5870,45378261,15889860,61268121,5,0,1,3072,10,8228990818
5871,45382489,6520838,51903327,3,0,0,512,17,6994169965
5872,45384359,15884428,61268787,4,0,1,1024,15,3205685605
5873,45387739,15883314,61271053,4,0,1,3584,15,3317950474
5874,45394530,6730594,52125124,2,0,0,25600,3,1345239877
5875,45397030,6691796,52088826,0,0,0,2560,3,5130765063
5876,45406670,6637266,52043936,4,0,0,7680,15,10188587725
5877,45408381,15864260,61272641,5,0,1,15872,10,9001319186
5878,45410430,6994950,52405380,4,0,0,50688,15,1526387083
5879,45412970,6633984,52046954,4,0,0,9728,15,9993024904
5880,45426230,7028860,52455090,0,0,0,61952,3,3711632539
5881,45431340,6779746,52211086,9,0,0,39424,12,896040736
5882,45433430,7054459,52487889,8,0,0,32768,8,4841510222
5883,45435100,6793926,52229026,0,0,0,32768,3,5282845297
5884,45435420,15908305,61343725,6,0,1,9728,7,3420314392
5885,45439110,6850162,52289272,8,0,0,41984,8,10623652017
5886,45454331,15890380,61344711,5,0,1,1536,10,5431246650
5887,45456040,15889657,61345697,0,0,1,1536,3,1056830529
5888,45457059,15888792,61345851,4,0,1,8704,15,5685950780
5889,45458870,15918174,61377044,6,0,1,9216,7,3467579728
5890,45463270,6926526,52389796,9,0,0,52736,12,4505389156
5891,45469309,15907758,61377067,4,0,1,8704,15,1135159277
5892,45471440,7089047,52560487,6,0,0,52224,7,5686053582
5893,45480200,6845266,52325466,6,0,0,16384,7,10578156724
5894,45493120,7050785,52543905,9,0,0,32256,12,9579876238
5895,45496330,6806838,52303168,9,0,0,39936,12,1575278871
5896,45505080,6626264,52131344,6,0,0,9216,7,5487279241
5897,45506780,6831657,52338437,8,0,0,42496,8,7251899885
5898,45510860,6925331,52436191,8,0,0,68608,8,7917369364
5899,45535830,7137799,52673629,0,0,0,25088,3,6345012660
5900,45539859,6920831,52460690,3,0,0,512,17,7659600686
5901,45539911,15853475,61393386,5,0,1,13824,10,9244185087
5902,45541760,16006422,61548182,6,0,1,4608,7,2200488429
5903,45546709,16001729,61548438,4,0,1,9216,15,4791108838
5904,45553819,6598996,52152815,3,0,0,512,17,5240228845
5905,45559220,6951042,52510262,0,0,0,57344,3,5581211433
5906,45565800,6912082,52477882,0,0,0,28160,3,1736081065
5907,45575010,6889413,52464423,6,0,0,7680,7,5526186962
5908,45580810,6953244,52534054,8,0,0,51200,8,1654445999
5909,45589540,16000959,61590499,6,0,1,2048,7,9197248675
5910,45597810,15992712,61590522,6,0,1,2048,7,7685310060
5911,45617440,15973284,61590724,6,0,1,8192,7,10578070921
5912,45617850,7028411,52646261,8,0,0,30208,8,3025998307
5913,45620239,6746364,52366603,3,0,0,1536,17,8411297589
5914,45627320,6991718,52619038,8,0,0,34816,8,10132608587
5915,45628980,7036982,52665962,4,0,0,34816,15,4140836848
5916,45639510,7088110,52727620,0,0,0,50176,3,8715646851
5917,45640421,15951643,61592064,5,0,1,7680,10,759362531
5918,45648890,6895662,52544552,9,0,0,2048,12,10080415671
5919,45653681,15938406,61592087,8,0,1,1024,8,7559592561
5920,45654450,15937660,61592110,3,0,1,8192,17,8106205293
5921,45658469,7049742,52708211,3,0,0,512,17,8864221164
5922,45661689,15930444,61592133,4,0,1,8704,15,1336825639
5923,45669100,7227008,52896108,9,0,0,19456,12,9474280084
5924,45671551,15920605,61592156,5,0,1,8704,10,10296945753
5925,45673470,7111884,52785354,9,0,0,7168,12,1444037261
5926,45679300,15924586,61603886,6,0,1,3072,7,4342048095
5927,45682950,6950058,52633008,9,0,0,2048,12,6323351352
5928,45685940,7157407,52843347,0,0,0,69120,3,48471464
5929,45688111,15983188,61671299,5,0,1,5120,10,4965850102
5930,45696610,16034286,61730896,6,0,1,11264,7,9550391303
5931,45698639,16036707,61735346,4,0,1,4608,15,4443443479
5932,45699750,7304839,53004589,9,0,0,82432,12,687534704
5933,45702530,7262596,52965126,6,0,0,23040,7,10416343896
5934,45714179,7013776,52727955,3,0,0,1024,17,9705785618
5935,45725800,7131746,52857546,0,0,0,25088,3,9015369817
5936,45726430,7500307,53226737,4,0,0,33280,15,1757651651
5937,45729659,16008649,61738308,4,0,1,7168,15,8112210740
5938,45730290,7421005,53151295,8,0,0,23040,8,6320994994
5939,45734659,16004635,61739294,4,0,1,1536,15,7230178753
5940,45734670,7369615,53104285,8,0,0,27648,8,6361373087
5941,45753210,7124994,52878204,9,0,0,1024,12,2782153354
5942,45754130,7533696,53287826,9,0,0,8704,12,6196426231
5943,45758700,15980940,61739640,9,0,1,512,12,9006490552
5944,45761869,15981317,61743186,4,0,1,5632,15,9398194181
5945,45773990,15994793,61768783,6,0,1,1024,7,9940586936
5946,45774120,16036004,61810124,7,0,1,18432,10,1286676803
5947,45776700,16034410,61811110,9,0,1,1536,12,100549100
5948,45780680,16060159,61840839,9,0,1,10240,12,7000143899
5949,45790190,16112697,61902887,6,0,1,7680,7,2709583780
5950,45791710,7117105,52908815,9,0,0,5120,12,10241775567
5951,45806060,7209784,53015844,8,0,0,36864,8,9497082398
5952,45813550,7318282,53131832,6,0,0,17920,7,387396748
5953,45815330,16087588,61902918,2,0,1,6656,3,5427954040
5954,45819099,7196924,53016023,3,0,0,512,17,8119627000
5955,45852850,7242988,53095838,4,0,0,47104,15,5603011252
5956,45870930,7469258,53340188,0,0,0,17408,3,7435899932
5957,45872060,16040576,61912636,2,0,1,3072,3,5531455908
5958,45876880,16035779,61912659,9,0,1,2560,12,1521888709
5959,45891750,16021267,61913017,9,0,1,1024,12,6289381312
5960,45905670,7235845,53141515,9,0,0,1024,12,8827939553
5961,45911600,16036562,61948162,2,0,1,21504,3,472113094
5962,45912999,16098918,62011917,4,0,1,15872,15,7866097988
5963,45915760,16096180,62011940,2,0,1,8704,3,8297618553
5964,45916839,16095124,62011963,4,0,1,1536,15,7959874620
5965,45925490,16150624,62076114,1,0,1,10240,10,7135873428
5966,45928080,6982243,52910323,9,0,0,1024,12,8979820770
5967,45929141,16146996,62076137,5,0,1,4096,10,691721418
5968,45938130,7496493,53434623,6,0,0,38400,7,545603347
5969,45941390,7190777,53132167,9,0,0,1024,12,962069575
5970,45942430,7310530,53252960,8,0,0,3072,8,230768320
5971,45943000,7469957,53412957,0,0,0,109568,3,3802955780
5972,45947409,16128751,62076160,4,0,1,9728,15,7948135319
5973,45950399,16138458,62088857,4,0,1,3072,15,6418464198
5974,45959950,16130533,62090483,2,0,1,2560,3,4187117861
5975,45960020,16135609,62095629,6,0,1,8192,7,5534103787
5976,45961290,7055582,53016872,8,0,0,2560,8,6511458104
5977,45962400,7289601,53252001,4,0,0,7680,15,10487607685
5978,45966280,7283023,53249303,4,0,0,68608,15,2963333466
5979,45969010,16162907,62131917,2,0,1,4096,3,7141339451
5980,45971049,16176226,62147275,4,0,1,6144,15,8361720105
5981,45979160,16180162,62159322,9,0,1,4096,12,5861342282
5982,45979869,7269769,53249638,3,0,0,1024,17,9374511319
5983,45992940,7165291,53158231,9,0,0,3072,12,9563238782
5984,46020200,7314661,53334861,4,0,0,28672,15,6928433764
5985,46043350,16116958,62160308,6,0,1,1536,7,9435052382
5986,46045640,7229823,53275463,9,0,0,512,12,588540622
5987,46047590,16114664,62162254,3,0,1,3072,17,7963847840
5988,46049211,16113389,62162600,5,0,1,512,10,10391038571
5989,46050550,16112306,62162856,2,0,1,9216,3,7861234820
5990,46054020,16133523,62187543,1,0,1,7168,10,5153780319
5991,46060230,7234322,53294552,8,0,0,7168,8,4812061330
5992,46080960,16106606,62187566,9,0,1,512,12,8649050210
5993,46082519,16105070,62187589,4,0,1,3072,15,1701165075
5994,46099320,7175629,53274949,6,0,0,23040,7,2617972966
5995,46100290,7379135,53479425,4,0,0,53248,15,5894026394
5996,46106059,16081553,62187612,4,0,1,14336,15,6947107791
5997,46106360,7338215,53444575,6,0,0,3072,7,5121735277
5998,46110100,7165184,53275284,9,0,0,1024,12,9994802625
5999,46113060,7239014,53352074,0,0,0,512,3,10387214824
6000,46116790,16133328,62250118,2,0,1,12288,3,9683020290
6001,46118340,7439591,53557931,9,0,0,1536,12,7141199730
6002,46121490,16128651,62250141,3,0,1,1024,17,8639457694
6003,46138430,7442096,53580526,4,0,0,33792,15,3967011822
6004,46144480,16105684,62250164,9,0,1,1024,12,2947504007
6005,46153049,16097138,62250187,4,0,1,2048,15,4333611423
6006,46154910,16095300,62250210,2,0,1,3584,3,417269510
6007,46156379,16093854,62250233,4,0,1,1536,15,10250326686
6008,46159000,16091256,62250256,2,0,1,2048,3,4956599098
6009,46159270,16142965,62302235,2,0,1,7168,3,6695757176
6010,46160580,16339530,62500110,1,0,1,74752,10,4519350999
6011,46171101,16338846,62509947,5,0,1,512,10,2149086518
6012,46175719,7276355,53452074,3,0,0,512,17,7905075677
6013,46185580,16356896,62542476,1,0,1,25088,10,2895443781
6014,46192040,7524902,53716942,0,0,0,69120,3,9715482136
6015,46198090,16387565,62585655,3,0,1,10240,17,5844232279
6016,46200140,16511124,62711264,2,0,1,17408,3,4069661663
6017,46200771,16510516,62711287,5,0,1,5632,10,5186281482
6018,46203331,16507979,62711310,5,0,1,4096,10,7868274643
6019,46204780,7524197,53728977,4,0,0,39424,15,10257698827
6020,46206690,7393270,53599960,4,0,0,10752,15,1141192429
6021,46207879,7523804,53731683,3,0,0,512,17,7073863204
6022,46212080,7417065,53629145,6,0,0,47616,7,3939787034
6023,46214510,16496823,62711333,2,0,1,11776,3,10179446198
6024,46219220,7335734,53554954,4,0,0,20992,15,6747532185
6025,46219880,7611795,53831675,4,0,0,72704,15,366676408
6026,46220930,7510566,53731496,4,0,0,8192,15,3380223655
6027,46226109,7420777,53646886,3,0,0,512,17,139217004
6028,46227320,16519097,62746417,2,0,1,6656,3,797331905
6029,46229310,16545248,62774558,9,0,1,5120,12,6050178099
6030,46231220,7548502,53779722,9,0,0,1024,12,4714532786
6031,46238689,16535892,62774581,4,0,1,3584,15,4516024162
6032,46239799,16546663,62786462,4,0,1,16384,15,1357894693
6033,46239829,16550499,62790328,4,0,1,6144,15,9173111944
6034,46246590,16547604,62794194,3,0,1,6144,17,2218364251
6035,46247770,16555349,62803119,3,0,1,6656,17,8088390895
6036,46263270,16574473,62837743,2,0,1,3072,3,6398595753
6037,46267950,16573659,62841609,3,0,1,6144,17,6445472272
6038,46288640,7771198,54059838,0,0,0,2560,3,7896391744
6039,46292280,16549675,62841955,3,0,1,512,17,8740407347
6040,46301381,16540920,62842301,5,0,1,512,10,6656431444
6041,46305060,16538867,62843927,3,0,1,2560,17,18356222
6042,46313451,16533382,62846833,5,0,1,4608,10,8415582020
6043,46315150,7536405,53851555,8,0,0,12800,8,5784872775
6044,46319390,16529709,62849099,2,0,1,3584,3,4069423185
6045,46323220,16527505,62850725,3,0,1,2560,17,5825201583
6046,46327920,16557001,62884921,3,0,1,2048,17,5454182237
6047,46332731,16552856,62885587,5,0,1,1024,10,1530047311
6048,46339651,16549482,62889133,5,0,1,5632,10,3898666235
6049,46341360,7430715,53772075,8,0,0,17408,8,6669129525
6050,46342029,7489825,53831854,3,0,0,512,17,6909189242
6051,46359140,7560092,53919232,0,0,0,24064,3,2487834655
6052,46370131,16521268,62891399,5,0,1,3584,10,4100416081
6053,46384500,7306159,53690659,6,0,0,11264,7,3746228198
6054,46393500,7624296,54017796,6,0,0,9728,7,4025177381
6055,46394550,7414950,53809500,6,0,0,22016,7,10419378802
6056,46405450,7187250,53592700,4,0,0,2048,15,2925143548
6057,46412000,16510968,62922968,9,0,1,29696,12,5493551986
6058,46416570,16508041,62924611,9,0,1,5120,12,7530724560
6059,46423441,16504076,62927517,5,0,1,4608,10,1709748582
6060,46440850,16490853,62931703,3,0,1,6656,17,4454158652
6061,46452071,16483818,62935889,5,0,1,6656,10,2627360252
6062,46453880,16483635,62937515,9,0,1,2560,12,4681469870
6063,46457610,16487753,62945363,1,0,1,18432,10,5662164259
6064,46461190,7290124,53751314,0,0,0,7680,3,9389552755
6065,46466641,16480104,62946745,5,0,1,8192,10,7929482056
6066,46471000,16490400,62961400,9,0,1,1024,12,1466494771
6067,46476570,7654362,54130932,4,0,0,6144,15,7857809094
6068,46479850,7673649,54153499,4,0,0,34304,15,1800821003
6069,46480060,16488192,62968252,3,0,1,3584,17,7640054430
6070,46485510,7690055,54175565,0,0,0,15360,3,3104002863
6071,46486530,16698674,63185204,1,0,1,124928,10,8581423971
6072,46507950,16735261,63243211,3,0,1,1024,17,2883722847
6073,46517251,16725983,63243234,5,0,1,1024,10,5007030094
6074,46519590,16832991,63352581,1,0,1,35840,10,6833821727
6075,46532960,7507424,54040384,9,0,0,1024,12,5404503860
6076,46534200,7480524,54014724,4,0,0,42496,15,6752814397
6077,46535940,16816664,63352604,3,0,1,1024,17,5259673104
6078,46542390,7628472,54170862,4,0,0,30208,15,7182656134
6079,46558910,7559143,54118053,8,0,0,7168,8,1622945522
6080,46561029,7646494,54207523,1,0,0,512,10,8105788085
6081,46562300,16790327,63352627,1,0,1,27136,10,7337363162
6082,46565070,16787580,63352650,3,0,1,8192,17,9784846087
6083,46569240,16794064,63363304,9,0,1,7168,12,172634452
6084,46596620,16766707,63363327,3,0,1,1024,17,1719540157
6085,46624820,7880310,54505130,6,0,0,19968,7,8690514324
6086,46637350,7721086,54358436,4,0,0,48128,15,5770529090
6087,46638930,7724053,54362983,6,0,0,14848,7,4000634541
6088,46641080,16722270,63363350,9,0,1,1024,12,904262838
6089,46645910,7429762,54075672,4,0,0,5120,15,8439757937
6090,46650701,16712672,63363373,5,0,1,4096,10,1833581275
6091,46652990,16710422,63363412,1,0,1,30208,10,4571846663
6092,46655630,16707805,63363435,9,0,1,3072,12,7130172429
6093,46670359,7447873,54118232,3,0,0,512,17,4978410800
6094,46674530,16729636,63404166,9,0,1,2560,12,7790696769
6095,46696500,8080205,54776705,6,0,0,41984,7,9286082919
6096,46699200,7630236,54329436,9,0,0,512,12,8008383973
6097,46703770,7390921,54094691,9,0,0,512,12,434009904
6098,46719191,16684998,63404189,5,0,1,5120,10,5968372045
6099,46723511,16680701,63404212,5,0,1,17408,10,10650972714
6100,46724570,7910881,54635451,4,0,0,46592,15,1865036175
6101,46724880,16692014,63416894,3,0,1,6144,17,1853364293
6102,46744240,8018847,54763087,0,0,0,61952,3,5461871665
6103,46748320,7501177,54249497,0,0,0,19456,3,1609892342
6104,46798230,7879683,54677913,9,0,0,1024,12,3691425620
6105,46801409,7282450,54083859,3,0,0,1536,17,8907687943
6106,46815620,7416221,54231841,4,0,0,3584,15,5851813564
6107,46821840,7727205,54549045,0,0,0,38400,3,8532551494
6108,46842071,16644841,63486912,5,0,1,1536,10,2453762894
6109,46849010,16839992,63689002,1,0,1,64000,10,3678825848
6110,46850920,7595070,54445990,4,0,0,30208,15,8204316724
6111,46855140,7320916,54176056,9,0,0,1536,12,7736025632
6112,46864600,8016348,54880948,0,0,0,30720,3,7659881818
6113,46875441,16838823,63714264,8,0,1,2560,8,8167016945
6114,46891220,16829795,63721015,1,0,1,7680,10,4389321370
6115,46903150,7774428,54677578,0,0,0,82432,3,4494491258
6116,46911950,16812611,63724561,9,0,1,5632,12,1700059083
6117,46916610,16872959,63789569,9,0,1,4096,12,5924310611
6118,46920740,7380180,54300920,8,0,0,512,8,2292751183
6119,46925219,7460936,54386155,3,0,0,2560,17,7216098979
6120,46925611,16863981,63789592,8,0,1,3584,8,6781606417
6121,46940431,16849184,63789615,8,0,1,512,8,7651334946
6122,46944110,7628490,54572600,4,0,0,5120,15,8692113150
6123,46948891,16863000,63811891,8,0,1,20992,8,5999428694
6124,46956341,16855573,63811914,8,0,1,3584,8,2325514568
6125,46956760,7630433,54587193,6,0,0,17408,7,8059687999
6126,46978940,16832997,63811937,1,0,1,8704,10,6598237668
6127,46990050,7508973,54499023,4,0,0,56832,15,4339212774
6128,47002510,16814021,63816531,9,0,1,512,12,1184094439
6129,47002650,7903148,54905798,0,0,0,81408,3,9726555173
6130,47003139,7381197,54384336,3,0,0,512,17,5496837407
6131,47004341,16812856,63817197,5,0,1,1024,10,2415431035
6132,47005560,7847734,54853294,0,0,0,1536,3,3117142628
6133,47007071,16810472,63817543,8,0,1,512,8,2027855620
6134,47007280,7545532,54552812,6,0,0,12288,7,3751997661
6135,47025540,7291558,54317098,6,0,0,7680,7,10349410642
6136,47032799,7413736,54446535,3,0,0,512,17,5109383504
6137,47040151,16778058,63818209,8,0,1,1024,8,8136251993
6138,47042329,7193340,54235669,3,0,0,1024,17,10412518325
6139,47051919,16767596,63819515,4,0,1,2048,15,6369050600
6140,47057291,16763893,63821184,5,0,1,1536,10,9785205706
6141,47060670,7574976,54635646,9,0,0,512,12,9374677467
6142,47070120,16796735,63866855,2,0,1,13312,3,3302703890
6143,47071140,7347836,54418976,6,0,0,19968,7,10329226785
6144,47082630,7834751,54917381,0,0,0,37888,3,1382779452
6145,47084020,7913897,54997917,0,0,0,19968,3,9562095683
6146,47092410,16922259,64014669,1,0,1,84480,10,6593481676
6147,47095770,17150622,64246392,1,0,1,135680,10,7441549989
6148,47097441,17148974,64246415,8,0,1,6144,8,10729468379
6149,47103120,7823047,54926167,9,0,0,512,12,3915512181
6150,47116680,7997265,55113945,6,0,0,45056,7,3348484648
6151,47121160,17125278,64246438,9,0,1,9728,12,1907625804
6152,47121271,17125763,64247034,5,0,1,5632,10,6043371811
6153,47121550,7571323,54692873,8,0,0,20992,8,992829898
6154,47121720,17165195,64286915,2,0,1,512,3,2980790767
6155,47121940,7663863,54785803,0,0,0,11264,3,8998883289
6156,47127970,17159931,64287901,3,0,1,1536,17,10136643179
6157,47128160,7955082,55083242,8,0,0,111104,8,3840513234
6158,47131550,17195935,64327485,3,0,1,5120,17,5757011256
6159,47140910,7335227,54476137,0,0,0,9728,3,1982947047
6160,47141530,17225235,64366765,2,0,1,3584,3,645228013
6161,47143451,17223337,64366788,8,0,1,10752,8,7421123704
6162,47145710,7693640,54839350,4,0,0,41472,15,5040033105
6163,47155830,8162875,55318705,8,0,0,27648,8,8838237243
6164,47165220,7429693,54594913,9,0,0,512,12,9405425596
6165,47167150,17318414,64485564,7,0,1,101888,10,5106526753
6166,47167330,7786727,54954057,4,0,0,2048,15,5976117334
6167,47178610,7416124,54594734,9,0,0,1024,12,4918287877
6168,47181430,7780005,54961435,4,0,0,20480,15,1499734381
6169,47182220,17305655,64487875,3,0,1,2048,17,7310848902
6170,47183940,17305011,64488951,2,0,1,13312,3,5076569302
6171,47188460,17469236,64657696,7,0,1,133120,10,6462397960
6172,47191360,17482726,64674086,9,0,1,1024,12,8771555959
6173,47191410,17482699,64674109,2,0,1,1024,3,3019941611
6174,47195029,7540459,54735488,3,0,0,1024,17,2413743063
6175,47195959,7943202,55139161,3,0,0,512,17,5461179241
6176,47198970,17475162,64674132,3,0,1,8192,17,3805274016
6177,47200480,8128255,55328735,9,0,0,1536,12,7791526751
6178,47203841,17470314,64674155,8,0,1,1024,8,9430666575
6179,47209901,17464768,64674669,5,0,1,12800,10,460843672
6180,47210901,17477681,64688582,5,0,1,3584,10,7656945285
6181,47223349,7513519,54736868,3,0,0,512,17,5785626569
6182,47225311,17463937,64689248,5,0,1,1024,10,7092291467
6183,47226150,7762285,54988435,0,0,0,2560,3,2142193366
6184,47226251,17465263,64691514,5,0,1,3584,10,10094314274
6185,47228040,7863189,55091229,0,0,0,26112,3,1629653523
6186,47228560,17463620,64692180,2,0,1,1024,3,10392332707
6187,47234690,17457836,64692526,0,0,1,512,3,9708730021
6188,47243340,7576000,54819340,9,0,0,512,12,2104643531
6189,47247940,17565889,64813829,7,0,1,112640,10,1761097672
6190,47254030,17631327,64885357,7,0,1,31744,10,130950376
6191,47257650,7791717,55049367,8,0,0,11264,8,2472858181
6192,47266010,17619549,64885559,3,0,1,7680,17,1376189167
6193,47267629,7496261,54763890,3,0,0,2560,17,6339774405
6194,47270440,17615142,64885582,2,0,1,2048,3,10023599192
6195,47272549,17613056,64885605,4,0,1,1536,15,8140583186
6196,47284140,17601488,64885628,3,0,1,15360,17,6537842479
6197,47288920,7628671,54917591,9,0,0,512,12,6194935059
6198,47288990,17596840,64885830,7,0,1,15360,10,4419894530
6199,47293420,17592433,64885853,2,0,1,7168,3,1210461603
6200,47297240,7856917,55154157,8,0,0,11264,8,7725164859
6201,47304809,7686230,54991039,3,0,0,1024,17,6210654664
6202,47312290,17576646,64888936,3,0,1,6144,17,10317467904
6203,47320940,7845037,55165977,6,0,0,9728,7,3227983959
6204,47322360,7771700,55094060,8,0,0,9216,8,4847810547
6205,47326921,17562361,64889282,5,0,1,512,10,8911095948
6206,47328730,17560898,64889628,6,0,1,512,7,4011954478
6207,47337560,7641951,54979511,6,0,0,1536,7,5277703081
6208,47341901,17550953,64892854,5,0,1,5120,10,5547417503
6209,47346630,7907712,55254342,4,0,0,32256,15,9753873715
6210,47352520,7747386,55099906,8,0,0,2048,8,10007938957
6211,47355960,17543220,64899180,9,0,1,16896,12,7266170636
6212,47357230,17544856,64902086,2,0,1,4608,3,4611992648
6213,47360210,17542542,64902752,9,0,1,1024,12,4053193560
6214,47372109,17532269,64904378,4,0,1,2560,15,1276306222
6215,47380700,7863791,55244491,6,0,0,17408,7,6606465089
6216,47391669,7708502,55100171,3,0,0,512,17,6041814317
6217,47396910,17552864,64949774,9,0,1,25600,12,8338120139
6218,47397120,17594820,64991940,7,0,1,69120,10,9364799587
6219,47397529,17613591,65011120,4,0,1,1024,15,4095454002
6220,47398920,7700247,55099167,6,0,0,16384,7,3205867429
6221,47415590,17596503,65012093,3,0,1,12800,17,7406264158
6222,47417270,17599969,65017239,3,0,1,8192,17,1127740198
6223,47419221,17663370,65082591,5,0,1,9216,10,156415893
6224,47430140,17652474,65082614,2,0,1,4096,3,6908751393
6225,47440540,7869672,55310212,8,0,0,57344,8,8411338498
6226,47442430,17640207,65082637,3,0,1,5632,17,8910185794
6227,47443900,17638760,65082660,9,0,1,1536,12,2805133971
6228,47449210,8034280,55483490,4,0,0,67072,15,4859348749
6229,47450590,7881598,55332188,8,0,0,3072,8,1152910885
6230,47451230,17631453,65082683,2,0,1,4096,3,1020411685
6231,47455351,17627355,65082706,5,0,1,1024,10,3400985503
6232,47461550,17643497,65105047,3,0,1,20992,17,10487292882
6233,47469830,17642244,65112074,9,0,1,7168,12,8104787530
6234,47478979,7775542,55254521,3,0,0,512,17,6955334688
6235,47496480,17616260,65112740,9,0,1,1024,12,4524083141
6236,47502360,7919966,55422326,6,0,0,27648,7,7633412667
6237,47503979,17613587,65117566,4,0,1,7680,15,7673329576
6238,47519749,17603484,65123233,4,0,1,1024,15,569040284
6239,47526990,17790033,65317023,7,0,1,76800,10,8454924655
6240,47531420,17785626,65317046,2,0,1,2560,3,10432910540
6241,47532080,7864498,55396578,9,0,0,1024,12,4219943477
6242,47534330,17958399,65492729,7,0,1,45568,10,9349654935
6243,47536920,18142375,65679295,1,0,1,143360,10,4100452261
6244,47539430,7845614,55385044,8,0,0,13824,8,10727403419
6245,47550930,7767978,55318908,4,0,0,512,15,5111099920
6246,47552411,18160986,65713397,5,0,1,4096,10,9770385811
6247,47559569,18153851,65713420,4,0,1,6144,15,8462156995
6248,47560960,7767284,55328244,8,0,0,13824,8,10121604994
6249,47571700,8113243,55684943,0,0,0,36352,3,5643145562
6250,47590630,8039514,55630144,4,0,0,30208,15,1583692600
6251,47592809,18120634,65713443,4,0,1,4096,15,10158915201
6252,47606060,18117585,65723645,2,0,1,9728,3,3870969325
6253,47631500,8132889,55764389,8,0,0,69120,8,5571650792
6254,47632430,18091238,65723668,1,0,1,11264,10,854022230
6255,47640080,18099928,65740008,1,0,1,3072,10,9040548399
6256,47643540,7720733,55364273,8,0,0,2048,8,4712407519
6257,47649289,7724383,55373672,3,0,0,512,17,10627264244
6258,47653550,7888789,55542339,4,0,0,19456,15,6679420121
6259,47657530,18101164,65758694,1,0,1,6144,10,2429086215
6260,47662100,7856905,55519005,6,0,0,29696,7,1037271445
6261,47670070,18088647,65758717,2,0,1,2560,3,4157057521
6262,47672161,18086579,65758740,5,0,1,2048,10,8872055648
6263,47672390,7814555,55486945,0,0,0,11264,3,4945321454
6264,47698440,8204486,55902926,0,0,0,9216,3,7805808931
6265,47704129,7829575,55533704,3,0,0,512,17,991965158
6266,47716110,7817415,55533525,6,0,0,25600,7,7320767257
6267,47723530,18035233,65758763,2,0,1,9216,3,4570270120
6268,47734770,18034296,65769066,2,0,1,1536,3,6985711256
6269,47736231,18033821,65770052,5,0,1,1536,10,8282026724
6270,47738030,18047927,65785957,2,0,1,4608,3,2510801658
6271,47742870,18628370,66371240,1,0,1,138752,10,10653455159
6272,47745359,7816728,55562087,3,0,0,512,17,2405141412
6273,47752480,7633171,55385651,9,0,0,512,12,5215309300
6274,47753630,7889591,55643221,8,0,0,20480,8,4399987334
6275,47754250,7895476,55649726,9,0,0,1536,12,5077693965
6276,47756500,18678328,66434828,7,0,1,14848,10,9522054088
6277,47761060,18673791,66434851,1,0,1,12800,10,7299538813
6278,47761890,18681448,66443338,2,0,1,3072,3,7374023047
6279,47767600,7831409,55599009,8,0,0,1536,8,5408952713
6280,47783610,18693843,66477453,7,0,1,28160,10,7973215717
6281,47784621,18697508,66482129,5,0,1,4096,10,488518855
6282,47787120,7791410,55578530,8,0,0,42496,8,2626884975
6283,47789150,8030101,55819251,0,0,0,80896,3,7288637089
6284,47802161,18714490,66516651,5,0,1,512,10,1175953515
6285,47803040,7833918,55636958,8,0,0,7168,8,127581618
6286,47810500,8292461,56102961,8,0,0,133120,8,10156810523
6287,47813650,18715371,66529021,1,0,1,3584,10,8185460820
6288,47818790,18825950,66644740,7,0,1,145920,10,4054496643
6289,47833140,18812906,66646046,3,0,1,2048,17,3419168701
6290,47833431,18819684,66653115,5,0,1,15360,10,9282674869
6291,47835131,18859974,66695105,5,0,1,18432,10,9328421830
6292,47835560,8011448,55847008,9,0,0,512,12,9246010980
6293,47837391,18860146,66697537,5,0,1,4608,10,5517664186
6294,47840581,18893642,66734223,5,0,1,6144,10,9108231316
6295,47846691,18887555,66734246,8,0,1,10752,8,6724860761
6296,47849550,18887233,66736783,1,0,1,7168,10,7923458578
6297,47850900,18886447,66737347,7,0,1,10752,10,5990568295
6298,47851160,18896653,66747813,3,0,1,4096,17,3636680880
6299,47852390,19100089,66952479,1,0,1,165888,10,9562876608
6300,47856770,19098615,66955385,3,0,1,4608,17,1859848447
6301,47861910,7823836,55685746,6,0,0,2560,7,2697670414
6302,47865500,19092151,66957651,7,0,1,3584,10,10042544514
6303,47870041,19088174,66958215,5,0,1,10752,10,2674892511
6304,47871140,8068781,55939921,8,0,0,23040,8,3250164885
6305,47871999,7962591,55834590,3,0,0,1536,17,6059578241
6306,47887720,19072441,66960161,2,0,1,3072,3,9745983181
6307,47891670,19069477,66961147,3,0,1,1536,17,10356350045
6308,47901550,19059943,66961493,3,0,1,512,17,4856228442
6309,47912769,8027331,55940100,3,0,0,512,17,5361722354
6310,47916090,7878001,55794091,0,0,0,1536,3,4328209883
6311,47916630,8456403,56373033,6,0,0,60928,7,9556082361
6312,47922430,19039524,66961954,1,0,1,10240,10,9288551197
6313,47927740,19038284,66966024,2,0,1,4096,3,4624243805
6314,47930600,7847450,55778050,4,0,0,3584,15,5966668104
6315,47931140,19042025,66973165,2,0,1,5632,3,3342695830
6316,47931860,19054585,66986445,1,0,1,27136,10,1491813209
6317,47933350,19077150,67010500,1,0,1,10752,10,9564741482
6318,47940420,8283976,56224396,8,0,0,35328,8,1297142935
6319,47942111,19071882,67013993,5,0,1,7168,10,4672432141
6320,47944470,19126908,67071378,1,0,1,13312,10,3226927928
6321,47947361,19156403,67103764,5,0,1,5120,10,8165796604
6322,47950650,8031619,55982269,6,0,0,6656,7,393392635
6323,47957531,19151559,67109090,5,0,1,6656,10,5924521897
6324,47958889,7966459,55925348,3,0,0,1024,17,5930037285
6325,47963240,8191395,56154635,6,0,0,15360,7,7560302971
6326,47964969,8042750,56007719,3,0,0,1024,17,10299517555
6327,47974060,19137296,67111356,2,0,1,3584,3,4476312813
6328,47977780,8171950,56149730,8,0,0,142336,8,5920679921
6329,47979020,8248638,56227658,0,0,0,7680,3,7214208102
6330,47979360,19136392,67115752,3,0,1,12800,17,6423326443
6331,47989201,19136982,67126183,5,0,1,6656,10,263390688
6332,47989221,19145038,67134259,5,0,1,14336,10,1338483854
6333,47997950,8192625,56190575,6,0,0,69120,7,2599120897
6334,48003250,19142739,67145989,2,0,1,14848,3,9449535791
6335,48004329,8227816,56232145,3,0,0,1536,17,10552425642
6336,48004370,19154330,67158700,3,0,1,6144,17,9620269653
6337,48005350,19195155,67200505,1,0,1,9728,10,4219668763
6338,48007730,8095947,56103677,4,0,0,2048,15,2712718116
6339,48009790,19214623,67224413,1,0,1,26624,10,3169875298
6340,48019680,8243641,56263321,0,0,0,55808,3,3747611949
6341,48020710,8664080,56684790,8,0,0,110592,8,10237293426
6342,48021430,19222717,67244147,7,0,1,7168,10,9801712075
6343,48022180,19227282,67249462,3,0,1,3072,17,8425389450
6344,48050200,19341528,67391728,7,0,1,81920,10,9357671443
6345,48051430,19349860,67401290,7,0,1,11776,10,7366511314
6346,48061261,19350215,67411476,5,0,1,5120,10,4174016977
6347,48082720,19398938,67481658,1,0,1,45056,10,6755361516
6348,48086480,19515617,67602097,7,0,1,55296,10,5130940744
6349,48090621,19515549,67606170,5,0,1,512,10,10561515809
6350,48092790,8253179,56345969,8,0,0,24064,8,542623797
6351,48100150,19509750,67609900,3,0,1,3584,17,1515387273
6352,48102290,19510516,67612806,1,0,1,4608,10,2953731829
6353,48104100,8045832,56149932,4,0,0,512,15,692553203
6354,48111691,8177641,56289332,7,0,0,18432,10,5456778776
6355,48122650,19510941,67633591,3,0,1,11776,17,1075205765
6356,48122979,8263401,56386380,3,0,0,2048,17,5664502443
6357,48123661,19512836,67636497,5,0,1,4608,10,5729497552
6358,48126330,19558885,67685215,1,0,1,52224,10,4989366243
6359,48127510,8522528,56650038,6,0,0,3072,7,5182357247
6360,48129230,19571735,67700965,7,0,1,6144,10,4685813485
6361,48130230,19571081,67701311,7,0,1,512,10,1259362103
6362,48137460,8732651,56870111,6,0,0,226816,7,121009025
6363,48141249,8169389,56310638,3,0,0,1536,17,9714029085
6364,48153460,8721305,56874765,9,0,0,512,12,3173069238
6365,48166940,19681473,67848413,1,0,1,127488,10,6138999896
6366,48169920,19708601,67878521,1,0,1,9728,10,3446271698
6367,48176040,19765076,67941116,7,0,1,37376,10,10158292994
6368,48185910,8122180,56308090,9,0,0,512,12,7017599910
6369,48187680,19759030,67946710,1,0,1,18432,10,5188569207
6370,48190290,8519670,56709960,6,0,0,81408,7,3453451612
6371,48192279,19808630,68000909,1,0,1,10240,10,8433496174
6372,48192630,8193103,56385733,9,0,0,1536,12,9874141169
6373,48203201,19815810,68019011,5,0,1,4096,10,5630515224
6374,48212030,8707272,56919302,8,0,0,63488,8,2412915160
6375,48213230,19957519,68170749,7,0,1,76288,10,809084140
6376,48218251,19955851,68174102,5,0,1,17920,10,7834543290
6377,48220890,19957868,68178758,1,0,1,23040,10,5908871791
6378,48225340,19969634,68194974,1,0,1,7168,10,8353094488
6379,48240510,8305104,56545614,6,0,0,91648,7,2204637234
6380,48241811,19953829,68195640,5,0,1,1024,10,870228526
6381,48257490,8530218,56787708,8,0,0,38912,8,994319990
6382,48273631,19922995,68196626,5,0,1,1536,10,7582054465
6383,48282799,8345818,56628617,3,0,0,512,17,499007786
6384,48300360,9007839,57308199,8,0,0,199168,8,4224099986
6385,48311250,8321414,56632664,9,0,0,2560,12,1743385502
6386,48313990,19897177,68211167,7,0,1,19968,10,8392028501
6387,48315170,8330131,56645301,9,0,0,512,12,8440789319
6388,48322460,8716878,57039338,0,0,0,34816,3,6908708737
6389,48323460,8223136,56546596,6,0,0,3072,7,7330837135
6390,48327720,19888799,68216519,7,0,1,9216,10,1693385377
6391,48329750,8252038,56581788,9,0,0,512,12,4358374860
6392,48330280,8984489,57314769,4,0,0,512,15,4419269303
6393,48341570,8381772,56723342,0,0,0,6656,3,5360148892
6394,48348730,8640610,56989340,6,0,0,55296,7,4754278114
6395,48358440,8526245,56884685,8,0,0,18432,8,4138215241
6396,48360220,8610731,56970951,8,0,0,22016,8,8583092342
6397,48370410,19902111,68272521,7,0,1,11776,10,3438043631
6398,48380390,8352021,56732411,9,0,0,512,12,6010354404
6399,48403960,8244569,56648529,4,0,0,1024,15,5312121939
6400,48414649,8167318,56581967,3,0,0,512,17,4051886303
6401,48421540,8169298,56590838,6,0,0,512,7,3901261646
6402,48422110,19890423,68312533,7,0,1,118272,10,7433983659
6403,48422940,19892819,68315759,6,0,1,5120,7,9824406751
6404,48432940,8458632,56891572,8,0,0,22528,8,2983514671
6405,48436110,8694626,57130736,8,0,0,29184,8,9069120921
6406,48440190,8244935,56685125,4,0,0,1024,15,6590188251
6407,48441560,19890834,68332394,7,0,1,10752,10,5834769519
6408,48457140,19955682,68412822,6,0,1,5632,7,4015519668
6409,48460230,20008567,68468797,6,0,1,71680,7,7706627908
6410,48469520,8400770,56870290,4,0,0,512,15,4489783493
6411,48471190,20002096,68473286,3,0,1,3584,17,8504984366
6412,48492031,19982740,68474771,5,0,1,15360,10,4136129077
6413,48502630,20050230,68552860,6,0,1,102400,7,595647598
6414,48503561,20075303,68578864,6,0,1,8704,7,3400782987
6415,48507451,20162114,68669565,6,0,1,95744,7,8793683164
6416,48521391,20159150,68680541,5,0,1,4096,10,1653770575
6417,48523540,8440680,56964220,8,0,0,59904,8,814781301
6418,48525071,20181589,68706660,6,0,1,6144,7,1729104836
6419,48529100,8364623,56893723,4,0,0,512,15,1995445372
6420,48533750,20173234,68706984,7,0,1,29184,10,3949676973
6421,48556390,8509325,57065715,6,0,0,14336,7,9407593928
6422,48557770,20185958,68743728,7,0,1,35328,10,6361681326
6423,48564490,20179261,68743751,7,0,1,20992,10,7846114829
6424,48572079,8298702,56870781,3,0,0,1536,17,7006983875
6425,48574250,8362020,56936270,4,0,0,1024,15,9522581306
6426,48574910,8482944,57057854,0,0,0,22528,3,6343244075
6427,48581310,8874366,57455676,0,0,0,9216,3,1906144424
6428,48583349,8491718,57075067,3,0,0,512,17,2946470196
6429,48585481,20158293,68743774,5,0,1,6144,10,1830723220
6430,48589690,8485198,57074888,0,0,0,24576,3,78213985
6431,48592089,8414190,57006279,3,0,0,512,17,3231780738
6432,48594390,20164574,68758964,7,0,1,13312,10,6334305733
6433,48605719,8412831,57018550,3,0,0,1024,17,10630396141
6434,48632109,8514296,57146405,3,0,0,1536,17,9758684243
6435,48633290,8356385,56989675,4,0,0,1024,15,9191936645
6436,48638060,8507831,57145891,0,0,0,49664,3,10658676937
6437,48649920,8597572,57247492,8,0,0,25088,8,1904032411
6438,48651250,8516201,57167451,4,0,0,512,15,4696625246
6439,48653850,8466744,57120594,4,0,0,512,15,6872912945
6440,48657330,8651524,57308854,9,0,0,2048,12,5280438585
6441,48669330,8655307,57324637,6,0,0,17920,7,6592717920
6442,48672820,8473920,57146740,4,0,0,1024,15,5918221781
6443,48673240,9022266,57695506,8,0,0,8704,8,9853930643
6444,48675790,8555117,57230907,9,0,0,512,12,7689234057
6445,48677519,8525922,57203441,3,0,0,512,17,7772757577
6446,48677640,20081347,68758987,7,0,1,5632,10,8698436043
6447,48681840,8893760,57575600,8,0,0,63488,8,3815907436
6448,48699460,8637929,57337389,6,0,0,30720,7,3567092741
6449,48703770,20063843,68767613,7,0,1,9728,10,1974910967
6450,48715310,8737512,57452822,6,0,0,59904,7,815733625
6451,48717990,8595567,57313557,0,0,0,15360,3,997138549
6452,48724600,20044319,68768919,3,0,1,2048,17,6289600423
6453,48725170,8679552,57404722,8,0,0,8704,8,6895303437
6454,48727340,8587043,57314383,4,0,0,2560,15,6782371396
6455,48740630,20031733,68772363,7,0,1,17408,10,8610331073
6456,48744070,8593810,57337880,9,0,0,1536,12,2256617987
6457,48776650,20007157,68783807,7,0,1,31232,10,8883229806
6458,48777750,8577556,57355306,4,0,0,1024,15,7026833647
6459,48781010,8878368,57659378,6,0,0,123904,7,700462709
6460,48790790,8605991,57396781,9,0,0,512,12,1634137390
6461,48799790,19994694,68794484,7,0,1,25088,10,7314357622
6462,48800190,20177576,68977766,7,0,1,223232,10,198889986
6463,48820370,9020860,57841230,4,0,0,1024,15,1793485519
6464,48868570,20109219,68977789,1,0,1,4096,10,3176900260
6465,48873970,20103842,68977812,7,0,1,5120,10,3040671519
6466,48892170,8799523,57691693,8,0,0,105984,8,9718706554
6467,48897040,8861617,57758657,0,0,0,16896,3,4279970109
6468,48904510,9152850,58057360,6,0,0,46592,7,10038528496
6469,48910979,8789711,57700690,8,0,0,6144,8,7949708548
6470,48929400,20050249,68979649,1,0,1,3072,10,8474137183
6471,48951280,8798008,57749288,0,0,0,107008,3,8300345888
6472,48960470,20023045,68983515,7,0,1,6144,10,9038637548
6473,48976600,20034593,69011193,7,0,1,78848,10,4126683428
6474,48981110,9076585,58057695,4,0,0,1024,15,4091242337
6475,48983380,20046476,69029856,1,0,1,6656,10,5168929539
6476,48991830,8700198,57692028,9,0,0,1024,12,3072925654
6477,49005539,8693187,57698726,3,0,0,1024,17,10059150047
6478,49013941,20038962,69052903,8,0,1,4608,8,1098089789
6479,49020971,20032758,69053729,8,0,1,1024,8,121413693
6480,49021330,8677038,57698368,8,0,0,8192,8,10160528053
6481,49021980,20078615,69100595,7,0,1,61952,10,905318422
6482,49022350,20078268,69100618,7,0,1,512,10,8200528600
6483,49027910,8721713,57749623,4,0,0,1024,15,3277930671
6484,49034211,20067455,69101666,8,0,1,3584,8,3229904815
6485,49036500,8865114,57901614,6,0,0,37888,7,9336793248
6486,49039470,8656371,57695841,4,0,0,1024,15,10261799975
6487,49052650,20049682,69102332,1,0,1,1024,10,1384188240
6488,49059180,20045086,69104266,7,0,1,16384,10,6304103166
6489,49070320,8622511,57692831,8,0,0,2560,8,5308410082
6490,49075510,20148440,69223950,7,0,1,176640,10,9203655898
6491,49079840,20154299,69234139,1,0,1,3584,10,5449270087
6492,49084580,20152785,69237365,0,0,1,5120,3,10181429099
6493,49091930,9233294,58325224,0,0,0,84480,3,5374673606
6494,49097170,9057399,58154569,6,0,0,7680,7,3640517176
6495,49098811,20139220,69238031,8,0,1,1024,8,8216546621
6496,49098901,20144346,69243247,8,0,1,3584,8,2231209225
6497,49105670,8960393,58066063,8,0,0,24576,8,6254443099
6498,49111070,9035828,58146898,8,0,0,23040,8,9309603614
6499,49127291,20116417,69243708,8,0,1,10240,8,6796035197
6500,49134780,20109184,69243964,0,0,1,9216,3,8992890275
6501,49137530,8905611,58043141,6,0,0,174592,7,692138585
6502,49156080,8960538,58116618,0,0,0,80896,3,4456566862
6503,49157041,20087589,69244630,8,0,1,1024,8,509538274
6504,49157360,8762705,57920065,6,0,0,23040,7,4248152584
6505,49164119,8707368,57871487,3,0,0,512,17,3308540464
6506,49180260,20065356,69245616,9,0,1,1536,12,1592787593
6507,49183030,9016971,58200001,8,0,0,66048,8,6898779342
6508,49219480,9046226,58265706,8,0,0,41472,8,2200137753
6509,49227391,20020491,69247882,8,0,1,3584,8,10706943071
6510,49233541,20016130,69249671,8,0,1,2560,8,6544358091
6511,49283719,8943546,58227265,3,0,0,2048,17,10582587192
6512,49292009,8866894,58158903,3,0,0,512,17,2026082528
6513,49295351,19954503,69249854,8,0,1,512,8,1024293163
6514,49296880,19956200,69253080,0,0,1,5120,3,6184497013
6515,49335610,8722264,58057874,4,0,0,512,15,10520463196
6516,49337359,19916182,69253541,4,0,1,10240,15,5102076058
6517,49339120,8718933,58058053,4,0,0,512,15,3489461245
6518,49344610,8855570,58200180,4,0,0,512,15,8521192421
6519,49355540,8703012,58058552,4,0,0,1536,15,9801257231
6520,49358021,19896186,69254207,8,0,1,1024,8,8129833614
6521,49367671,19887100,69254771,8,0,1,10752,8,5905877190
6522,49369920,9511977,58881897,0,0,0,27136,3,7895814810
6523,49385150,8940588,58325738,4,0,0,1536,15,6384973917
6524,49393571,19875242,69268813,8,0,1,17408,8,9651794724
6525,49394071,19875088,69269159,8,0,1,512,8,1088152917
6526,49397930,9263102,58661032,0,0,0,27648,3,7805599646
6527,49406950,9195770,58602720,6,0,0,24576,7,6979339515
6528,49410190,9463058,58873248,6,0,0,62976,7,7954512952
6529,49413820,9281471,58695291,6,0,0,42496,7,2098486419
6530,49420130,9610483,59030613,0,0,0,124416,3,1878560416
6531,49427280,9349993,58777273,0,0,0,2048,3,10318940312
6532,49428350,9268717,58697067,9,0,0,512,12,6200315517
6533,49430081,19843904,69273985,8,0,1,7680,8,6874311236
6534,49438600,9156609,58595209,8,0,0,48128,8,10159591029
6535,49441241,19852859,69294100,8,0,1,13824,8,2640273168
6536,49444730,8997267,58441997,4,0,0,512,15,4495906115
6537,49456150,9032508,58488658,8,0,0,18944,8,3542644080
6538,49460699,8945731,58406430,3,0,0,512,17,6644551950
6539,49462800,9262328,58725128,6,0,0,89088,7,3697374743
6540,49463390,19831376,69294766,2,0,1,1024,3,395875939
6541,49473420,8973497,58446917,9,0,0,1536,12,929041753
6542,49476700,9328315,58805015,0,0,0,54272,3,8803666009
6543,49484710,9256984,58741694,6,0,0,11264,7,203461587
6544,49486470,8961215,58447685,9,0,0,1536,12,10271326942
6545,49488450,19808262,69296712,2,0,1,3072,3,6037484347
6546,49489140,9114102,58603242,4,0,0,1536,15,3816231221
6547,49493871,19848846,69342717,6,0,1,40960,7,7881357281
6548,49500760,9382150,58882910,8,0,0,3072,8,1990433726
6549,49505300,9177020,58682320,8,0,0,32768,8,7746992055
6550,49511099,9362484,58873583,3,0,0,1024,17,9044633877
6551,49515480,19879641,69395121,1,0,1,8704,10,1469374129
6552,49516230,9181492,58697722,4,0,0,1536,15,4696276724
6553,49516619,9366634,58883253,3,0,0,1024,17,739969473
6554,49518840,19877267,69396107,2,0,1,1536,3,10105204888
6555,49522991,19875382,69398373,8,0,1,3584,8,3019003453
6556,49524409,9010554,58534963,3,0,0,512,17,7354555390
6557,49532160,9567838,59099998,0,0,0,34816,3,9728593762
6558,49537941,20254839,69792780,6,0,1,207872,7,1132800561
6559,49540991,20401144,69942135,6,0,1,52224,7,7290802673
6560,49547040,20398261,69945301,1,0,1,7168,10,2538968142
6561,49551220,9302482,58853702,6,0,0,116736,7,195010979
6562,49552439,9173492,58725931,3,0,0,2560,17,5002915321
6563,49558681,20386643,69945324,8,0,1,2048,8,8195989864
6564,49559910,20385437,69945347,1,0,1,512,10,4522195740
6565,49561431,20383939,69945370,8,0,1,17920,8,3423381837
6566,49566501,20378892,69945393,8,0,1,2048,8,10396398517
6567,49585580,20359836,69945416,3,0,1,3072,17,9650689995
6568,49588700,9396846,58985546,8,0,0,39936,8,9666361741
6569,49591561,20377321,69968882,8,0,1,19968,8,9617532507
6570,49597721,20416785,70014506,6,0,1,30208,7,9454837240
6571,49598850,9255187,58854037,9,0,0,1024,12,355407224
6572,49601970,9174656,58776626,8,0,0,25088,8,10094562759
6573,49602251,20416441,70018692,8,0,1,6656,8,1730320754
6574,49606240,20412606,70018846,1,0,1,8704,10,5666008351
6575,49616211,20407375,70023586,8,0,1,7168,8,7323665365
6576,49623020,20413805,70036825,7,0,1,7168,10,8954439049
6577,49644181,20414218,70058399,8,0,1,512,8,6328894393
6578,49651500,20406922,70058422,1,0,1,5120,10,4099858646
6579,49651660,9539281,59190941,8,0,0,40448,8,4257724905
6580,49660410,20398035,70058445,2,0,1,1536,3,877151123
6581,49663550,9380658,59044208,8,0,0,44544,8,2158842078
6582,49667731,20396822,70064553,6,0,1,74240,7,3471697345
6583,49669391,20413925,70083316,6,0,1,21504,7,8102873058
6584,49669520,20417662,70087182,2,0,1,6144,3,3150913549
6585,49674290,20414838,70089128,1,0,1,3072,10,8417560229
6586,49685591,20406123,70091714,8,0,1,4096,8,6269868084
6587,49693220,20400760,70093980,1,0,1,3584,10,9166890702
6588,49707049,9355841,59062890,3,0,0,512,17,8646088471
6589,49712039,9332504,59044543,3,0,0,1024,17,7351975846
6590,49716230,20379376,70095606,1,0,1,2560,10,287366619
6591,49738280,20359272,70097552,2,0,1,3072,3,1537203025
6592,49741090,9590773,59331863,0,0,0,26112,3,3241605779
6593,49742760,20355458,70098218,2,0,1,1024,3,8692916718
6594,49751050,20349754,70100804,1,0,1,4096,10,4595049622
6595,49755080,9478623,59233703,6,0,0,13312,7,9895035944
6596,49761740,9610317,59372057,8,0,0,38912,8,1776150477
6597,49774291,20329099,70103390,8,0,1,4096,8,8457398647
6598,49776940,9427328,59204268,0,0,0,39936,3,310431453
6599,49780390,9430476,59210866,6,0,0,4608,7,6489912768
6600,49786820,20319476,70106296,2,0,1,4608,3,10122831470
6601,49791170,20316752,70107922,1,0,1,2560,10,5770682553
6602,49794481,20314427,70108908,8,0,1,1536,8,753671584
6603,49801841,20308053,70109894,8,0,1,1536,8,4724501518
6604,49806570,20343089,70149659,2,0,1,28672,3,10643108075
6605,49808740,9646984,59455724,8,0,0,101376,8,8059906176
6606,49815960,9450297,59266257,0,0,0,1024,3,2372644487
6607,49830970,9593462,59424432,6,0,0,126976,7,7605421334
6608,49844420,9365019,59209439,6,0,0,16896,7,589397866
6609,49852711,20449566,70302277,6,0,1,115712,7,8470343950
6610,49863460,9384875,59248335,0,0,0,18944,3,8870850454
6611,49865190,20499725,70364915,1,0,1,5120,10,4712895536
6612,49869330,9591471,59460801,8,0,0,8192,8,7388102654
6613,49871420,9476398,59347818,5,0,0,13312,10,4993173573
6614,49874660,9550107,59424767,9,0,0,1024,12,940421747
6615,49881190,20483748,70364938,2,0,1,512,3,674843625
6616,49889399,9572072,59461471,3,0,0,2048,17,3423054621
6617,49898841,20466120,70364961,8,0,1,10240,8,901566205
6618,49909110,9620015,59529125,8,0,0,10240,8,3067040689
6619,49909360,20455624,70364984,2,0,1,2560,3,4207834573
6620,49913680,20451335,70365015,1,0,1,2560,10,275058995
6621,49919670,9568960,59488630,9,0,0,512,12,2849083678
6622,49920300,9537966,59458266,8,0,0,8192,8,1723363991
6623,49920669,9578131,59498800,3,0,0,512,17,6569348646
6624,49926090,9589955,59516045,0,0,0,37888,3,9030283372
6625,49932210,9367581,59299791,6,0,0,4096,7,6491131013
6626,49935401,20850104,70785505,6,0,1,202752,7,5764637611
6627,49939470,9541383,59480853,9,0,0,512,12,4794544482
6628,49939820,20858250,70798070,1,0,1,512,10,10252832864
6629,49942190,9703019,59645209,8,0,0,512,8,206317599
6630,49942630,20856311,70798941,1,0,1,12288,10,5544486341
6631,49947690,20902892,70850582,3,0,1,3584,17,6704336601
6632,49958921,20891684,70850605,6,0,1,512,7,945679487
6633,49961830,20931744,70893574,1,0,1,12288,10,3405668625
6634,49964111,20943969,70908080,6,0,1,26624,7,9551718074
6635,49967200,20961301,70928501,2,0,1,9216,3,10042838673
6636,49969480,20961287,70930767,3,0,1,3584,17,6445473347
6637,49982619,9686941,59669560,3,0,0,512,17,4041225295
6638,49984330,21070688,71055018,6,0,1,70656,7,3223252959
6639,49989160,9600578,59589738,9,0,0,2048,12,9797257449
6640,49989929,21084108,71074037,4,0,1,2560,15,3331375569
6641,50037039,21039904,71076943,4,0,1,4608,15,7848237704
6642,50038510,9750543,59789053,8,0,0,8192,8,8914420654
6643,50041939,21065299,71107238,4,0,1,3584,15,4935740593
6644,50050540,21131339,71181879,6,0,1,48128,7,1382831072
6645,50051560,21232669,71284229,3,0,1,16384,17,3551905199
6646,50052720,9694609,59747329,9,0,0,512,12,3797975279
6647,50055971,21231484,71287455,6,0,1,5120,7,2909307091
6648,50057041,21272652,71329693,8,0,1,14336,8,9901638217
6649,50058830,9917697,59976527,6,0,0,104448,7,9212751834
6650,50060860,9883820,59944680,8,0,0,35328,8,3383230464
6651,50064720,21285129,71349849,2,0,1,12800,3,8878444103
6652,50066220,21310453,71376673,3,0,1,8192,17,5451137269
6653,50079120,9532766,59611886,5,0,0,14336,10,4944594470
6654,50087190,9624494,59711684,6,0,0,39424,7,6329158233
6655,50087610,21306709,71394319,2,0,1,18432,3,3872382869
6656,50107840,9610263,59718103,0,0,0,20992,3,1725285861
6657,50115410,9641915,59757325,8,0,0,3072,8,3708448498
6658,50115630,9986918,60102548,6,0,0,44544,7,2139372184
6659,50127481,21348588,71476069,6,0,1,7680,7,7181560735
6660,50127639,9767587,59895226,3,0,0,512,17,3868590548
6661,50150190,9675907,59826097,6,0,0,13824,7,9053147333
6662,50155700,21337377,71493077,2,0,1,512,3,7348225464
6663,50163970,9769923,59933893,8,0,0,98816,8,9631815061
6664,50164071,21399365,71563436,6,0,1,15360,7,2945518183
6665,50166729,9830349,59997078,3,0,0,1024,17,5070144276
6666,50171240,9825301,59996541,2,0,0,61952,3,9728247971
6667,50172159,9824561,59996720,3,0,0,512,17,7443700985
6668,50177050,21445443,71622493,2,0,1,16384,3,4489577916
6669,50179530,9713440,59892970,0,0,0,1536,3,4587531622
6670,50183960,9822829,60006789,5,0,0,31744,10,5157641729
6671,50186240,9993075,60179315,5,0,0,104960,10,981911028
6672,50188670,9788972,59977642,8,0,0,3584,8,5623820931
6673,50188851,21480775,71669626,8,0,1,3584,8,5159801099
6674,50196299,21475593,71671892,4,0,1,3584,15,6272681759
6675,50197579,21476259,71673838,4,0,1,3072,15,8340419478
6676,50199271,21474721,71673992,6,0,1,8704,7,8995806772
6677,50201010,10131402,60332412,5,0,0,72704,10,2668934136
6678,50218261,21460557,71678818,8,0,1,7680,8,10273210085
6679,50220110,21498466,71718576,6,0,1,9728,7,10437431047
6680,50227669,9951825,60179494,3,0,0,512,17,9851211860
6681,50227930,9965338,60193268,9,0,0,1024,12,6838223303
6682,50231139,21487639,71718778,4,0,1,6144,15,1037632778
6683,50234510,9958423,60192933,9,0,0,44032,12,6357786486
6684,50234710,10270835,60505545,6,0,0,62976,7,10575957000
6685,50243200,9951651,60194851,9,0,0,5120,12,2635318255
6686,50244941,21587819,71832760,8,0,1,31232,8,10473439846
6687,50249150,21583633,71832783,1,0,1,3584,10,7007432720
6688,50252280,21612997,71865277,2,0,1,2560,3,5384339715
6689,50266480,10333236,60599716,9,0,0,112640,12,7709059579
6690,50299721,21565579,71865300,8,0,1,512,8,1700895522
6691,50301760,9801123,60102883,9,0,0,1024,12,1572033242
6692,50302900,10206412,60509312,5,0,0,12288,10,90788857
6693,50315290,9966415,60281705,8,0,0,51712,8,6552360718
6694,50317960,21547363,71865323,9,0,1,7680,12,1574225230
6695,50321091,21544255,71865346,8,0,1,11264,8,2925917303
6696,50322339,21571655,71893994,4,0,1,3584,15,8199874807
6697,50323610,10009784,60333394,9,0,0,3072,12,6777875653
6698,50326130,10155569,60481699,0,0,0,512,3,8136556838
6699,50326309,21635411,71961720,4,0,1,11776,15,2886236082
6700,50326390,10152529,60478919,4,0,0,2048,15,8560796882
6701,50331821,21629922,71961743,5,0,1,1024,10,4671857159
6702,50348840,10287114,60635954,8,0,0,118272,8,105022822
6703,50356250,9979264,60335514,5,0,0,3072,10,7956033830
6704,50368160,21593606,71961766,1,0,1,17920,10,1234013208
6705,50372140,10427676,60799816,8,0,0,512,8,6898573576
6706,50377190,10030234,60407424,8,0,0,1024,8,315064368
6707,50380930,9985114,60366044,8,0,0,1024,8,10190191535
6708,50384710,10264829,60649539,9,0,0,42496,12,8570571459
6709,50395720,10204175,60599895,4,0,0,512,15,4500341269
6710,50396049,21657719,72053768,4,0,1,3584,15,252267883
6711,50411139,21656120,72067259,4,0,1,26112,15,7346933893
6712,50412000,10152652,60564652,9,0,0,9216,12,7454949001
6713,50413830,10222669,60636499,4,0,0,512,15,211833452
6714,50436209,21749556,72185765,4,0,1,1024,15,10163115035
6715,50436890,10225937,60662827,0,0,0,1024,3,4444273515
6716,50450299,21735489,72185788,4,0,1,3584,15,3002895760
6717,50466500,10169812,60636312,4,0,0,1024,15,3273320551
6718,50469110,21752311,72221421,1,0,1,9216,10,4673915240
6719,50471510,10440968,60912478,5,0,0,115712,10,7209382584
6720,50476159,21745928,72222087,4,0,1,1024,15,2343706412
6721,50485940,10463563,60949503,5,0,0,114688,10,1059853830
6722,50489269,21732972,72222241,4,0,1,8704,15,3384801721
6723,50492820,10560793,61053613,8,0,0,1536,8,5258815309
6724,50499540,10206396,60705936,9,0,0,22016,12,4989345968
6725,50510240,10203119,60713359,0,0,0,512,3,8528861022
6726,50514809,10434873,60949682,3,0,0,512,17,153002553
6727,50542320,10502155,61044475,9,0,0,58368,12,5671664652
6728,50544470,10453737,60998207,8,0,0,1024,8,1695368718
6729,50556700,10418205,60974905,6,0,0,68096,7,3920201300
6730,50559710,21728956,72288666,1,0,1,10752,10,8906579235
6731,50569360,21719976,72289336,1,0,1,512,10,9685459624
6732,50570370,10250804,60821174,8,0,0,512,8,3878261923
6733,50573920,21715439,72289359,0,0,1,3072,3,6756432939
6734,50574110,10493472,61067582,9,0,0,22016,12,4259547255
6735,50579419,21709963,72289382,4,0,1,2560,15,3145129498
6736,50587579,21701826,72289405,4,0,1,4096,15,4249440021
6737,50607920,10204583,60812503,9,0,0,8704,12,4961957344
6738,50608500,10768342,61376842,5,0,0,77824,10,8338548186
6739,50612040,10200642,60812682,8,0,0,512,8,633833956
6740,50636070,10491301,61127371,0,0,0,512,3,9912589635
6741,50641380,10478265,61119645,8,0,0,512,8,2147113264
6742,50641880,21647548,72289428,0,0,1,2048,3,6138495283
6743,50654480,21634971,72289451,3,0,1,3072,17,3160392104
6744,50656729,10256956,60913685,3,0,0,2048,17,9585947478
6745,50657670,10994694,61652364,9,0,0,35840,12,6419778331
6746,50657810,10102703,60760513,8,0,0,512,8,682577400
6747,50661450,10251588,60913038,0,0,0,1024,3,4657763313
6748,50676730,10235927,60912657,4,0,0,512,15,6911993841
6749,50681750,10388319,61070069,0,0,0,1024,3,3170701249
6750,50689540,10429747,61119287,9,0,0,28160,12,10250118351
6751,50695650,10495403,61191053,6,0,0,7680,7,3307187143
6752,50700099,10419367,61119466,3,0,0,512,17,10520880166
6753,50710330,21579144,72289474,0,0,1,3072,3,6815023363
6754,50710709,10268727,60979436,3,0,0,1024,17,8036532090
6755,50711200,21578297,72289497,9,0,1,4096,12,839342663
6756,50716419,10443550,61159969,3,0,0,512,17,484057418
6757,50727100,10369423,61096523,0,0,0,1024,3,6142017992
6758,50727999,10524044,61252043,3,0,0,512,17,10703143477
6759,50734790,21561477,72296267,0,0,1,2048,3,3791558670
6760,50736049,10515815,61251864,3,0,0,1024,17,1540518907
6761,50736070,10532015,61268085,5,0,0,18432,10,1892077665
6762,50736270,10443529,61179799,6,0,0,43520,7,9258269572
6763,50741620,10172244,60913864,4,0,0,512,15,1735915756
6764,50753650,11121065,61874715,5,0,0,91648,10,9874388970
6765,50780279,10265068,61045347,3,0,0,1024,17,1815599309
6766,50782940,10468589,61251529,6,0,0,87552,7,6971102360
6767,50803100,21493377,72296477,0,0,1,3072,3,2648094276
6768,50818970,21480418,72299388,0,0,1,15872,3,7978016273
6769,50825880,10391515,61217395,5,0,0,21504,10,10385784394
6770,50834550,10543164,61377714,4,0,0,2048,15,22574232
6771,50841770,10996918,61838688,5,0,0,87552,10,6266529811
6772,50843510,10201144,61044654,8,0,0,512,8,7811539934
6773,50843960,21553005,72396965,0,0,1,1536,3,2597596070
6774,50846470,10198519,61044989,0,0,0,1024,3,89034217
6775,50847840,10657995,61505835,9,0,0,4608,12,7160574028
6776,50851990,10541194,61393184,9,0,0,35328,12,8241852696
6777,50852480,21546751,72399231,9,0,1,3584,12,7480685015
6778,50862280,10779141,61641421,9,0,0,55296,12,1138990742
6779,50872710,10828727,61701437,5,0,0,22528,10,2374833866
6780,50894409,10238300,61132709,3,0,0,512,17,1378044160
6781,50898190,21505547,72403737,9,0,1,7168,12,2882175910
6782,50907480,10682817,61590297,9,0,0,124416,12,1590029647
6783,50908920,10309370,61218290,4,0,0,512,15,10403497655
6784,50914410,11005721,61920131,4,0,0,512,15,4482716234
6785,50916660,21497970,72414630,0,0,1,14848,3,446064256
6786,50930350,10972335,61902685,6,0,0,58368,7,9877667231
6787,50931470,10461893,61393363,6,0,0,512,7,9205692445
6788,50938679,10722021,61660700,3,0,0,2048,17,10456993502
6789,50940070,10127691,61067761,4,0,0,512,15,4348130655
6790,50950300,11259475,62209775,5,0,0,41472,10,4087383593
6791,50953379,10366115,61319494,3,0,0,512,17,662453609
6792,50963329,10627730,61591059,3,0,0,1024,17,1450619912
6793,50963940,10530895,61494835,6,0,0,512,7,8246626790
6794,50965690,10412528,61378218,8,0,0,512,8,5767852956
6795,50987580,10389441,61377021,4,0,0,512,15,623045166
6796,50990470,10972008,61962478,4,0,0,1536,15,5770889402
6797,50990520,10662514,61653034,6,0,0,512,7,198830101
6798,50990610,21426403,72417013,9,0,1,2048,12,6076269196
6799,50991560,21427079,72418639,0,0,1,2560,3,9692042867
6800,50996850,10738473,61735323,9,0,0,10752,12,7063280662
6801,51027050,10191061,61218111,8,0,0,2048,8,6885094722
6802,51046930,10964629,62011559,5,0,0,139264,10,733015939
6803,51050059,10152713,61202772,3,0,0,512,17,3050556315
6804,51054490,11322007,62376497,6,0,0,512,7,10586393926
6805,51054700,10884226,61938926,5,0,0,27136,10,6903755621
6806,51058190,10595023,61653213,8,0,0,512,8,6697369649
6807,51074950,21346275,72421225,0,0,1,4096,3,3758476594
6808,51096410,21326441,72422851,0,0,1,2560,3,1062363808
6809,51098030,10342503,61440533,5,0,0,32768,10,3323737503
6810,51118750,10756144,61874894,6,0,0,512,7,4228267863
6811,51128730,10495820,61624550,5,0,0,33280,10,9607808590
6812,51136750,21287087,72423837,2,0,1,1536,3,2010934222
6813,51138480,21287623,72426103,0,0,1,3584,3,8239164157
6814,51141460,10820348,61961808,5,0,0,25600,10,7005678760
6815,51144950,10507905,61652855,6,0,0,1536,7,5933370793
6816,51166820,21370465,72537285,0,0,1,512,3,2480990644
6817,51168280,10377463,61545743,5,0,0,24064,10,2429904329
6818,51201550,10178467,61380017,5,0,0,512,10,9876084689
6819,51210080,11240667,62450747,6,0,0,6144,7,7336308561
6820,51215720,10477836,61693556,0,0,0,1536,3,6065038695
6821,51222590,11329454,62552044,6,0,0,4608,7,8402559028
6822,51231380,10543288,61774668,8,0,0,512,8,193684769
6823,51236020,10191292,61427312,9,0,0,16384,12,8767089206
6824,51236051,21310663,72546714,5,0,1,4608,10,7036746998
6825,51242200,10348276,61590476,6,0,0,512,7,8631886413
6826,51249139,10548911,61798050,3,0,0,512,17,2893288763
6827,51284230,10306471,61590701,8,0,0,512,8,3720694999
6828,51288419,10303622,61592041,3,0,0,1024,17,4763795208
6829,51305870,10765495,62071365,9,0,0,55296,12,2590791546
6830,51306150,11054205,62360355,5,0,0,26112,10,7122795358
6831,51313890,10081468,61395358,0,0,0,2560,3,8716588799
6832,51325730,10080634,61406364,0,0,0,1024,3,2685724819
6833,51354360,10743620,62097980,0,0,0,512,3,162095242
6834,51355580,10306893,61662473,8,0,0,512,8,6278219717
6835,51357750,10024647,61382397,6,0,0,512,7,987930425
6836,51375511,10379347,61754858,7,0,0,30208,10,4123189553
6837,51395740,21150997,72546737,9,0,1,11264,12,3084106599
6838,51397141,10481052,61878193,7,0,0,10752,10,7000011547
6839,51397351,10487527,61884878,7,0,0,10240,10,3720336247
6840,51409760,21137000,72546760,9,0,1,5120,12,4239666337
6841,51429300,21117483,72546783,1,0,1,512,10,7016061386
6842,51430120,11262667,62692787,9,0,0,82432,12,8583503935
6843,51441480,10218007,61659487,9,0,0,8192,12,4919636372
6844,51441940,10362566,61804506,4,0,0,1536,15,2715113015
6845,51452830,21093976,72546806,0,0,1,512,3,1483344420
6846,51462670,10213253,61675923,8,0,0,1024,8,5921778760
6847,51467260,21079569,72546829,0,0,1,512,3,10223557502
6848,51467940,21078928,72546868,0,0,1,5632,3,9865232940
6849,51470760,10310505,61781265,5,0,0,6144,10,9180670696
6850,51471000,10716520,62187520,6,0,0,68096,7,9538304595
6851,51472160,10675092,62147252,6,0,0,47104,7,799942151
6852,51477220,10305796,61783016,8,0,0,512,8,3817020538
6853,51482770,21064121,72546891,9,0,1,3584,12,8817418289
6854,51489560,10044380,61533940,9,0,0,2560,12,2122085142
6855,51499640,10095815,61595455,9,0,0,10752,12,2368455706
6856,51505189,10184930,61690119,3,0,0,512,17,5839219678
6857,51515351,10076355,61591706,7,0,0,2048,10,8436772389
6858,51519830,21225428,72745258,6,0,1,53248,7,9460363935
6859,51522940,21375990,72898930,9,0,1,4096,12,1565722583
6860,51529910,10524584,62054494,5,0,0,53248,10,8699584937
6861,51540060,10498187,62038247,9,0,0,65536,12,5867231030
6862,51540679,10298367,61839046,3,0,0,512,17,2477140244
6863,51552350,21349806,72902156,0,0,1,5120,3,1040651567
6864,51556680,21671095,73227775,6,0,1,50688,7,406143272
6865,51558230,21790527,73348757,0,0,1,15360,3,7375744864
6866,51558980,10516776,62075756,9,0,0,14336,12,5066464596
6867,51568871,10343742,61912613,7,0,0,31744,10,7663328867
6868,51574400,10264825,61839225,8,0,0,512,8,6231981234
6869,51574900,21774203,73349103,0,0,1,512,3,4884726194
6870,51589220,10357438,61946658,0,0,0,2048,3,8541672744
6871,51594040,21769031,73363071,9,0,1,19968,12,5355647051
6872,51594420,11448230,63042650,8,0,0,2048,8,2105440599
6873,51597110,21896240,73493350,9,0,1,14336,12,4023992754
6874,51597590,21895783,73493373,0,0,1,3072,3,6974617457
6875,51600311,21893085,73493396,8,0,1,1024,8,3331542350
6876,51606950,21886469,73493419,6,0,1,27648,7,6372173786
6877,51608500,21904187,73512687,0,0,1,10752,3,9533422090
6878,51615259,10481341,62096600,3,0,0,1024,17,1942705818
6879,51626350,10849715,62476065,5,0,0,52736,10,7337948565
6880,51628250,10210617,61838867,9,0,0,512,12,7718508267
6881,51633991,21880642,73514633,8,0,1,3072,8,4403088829
6882,51634010,21881609,73515619,0,0,1,1536,3,284724054
6883,51635050,11111702,62746752,0,0,0,1024,3,4942486083
6884,51638209,10438138,62076347,3,0,0,512,17,4146444132
6885,51659660,10352234,62011894,0,0,0,1024,3,599994579
6886,51664650,10180985,61845635,8,0,0,1024,8,6048771336
6887,51667619,10294368,61961987,3,0,0,512,17,5143013028
6888,51682079,10968826,62650905,3,0,0,512,17,169375451
6889,51688961,10621150,62310111,7,0,0,22528,10,2457563977
6890,51704470,11070065,62774535,9,0,0,87552,12,8727252684
6891,51705590,11479404,63184994,9,0,0,53760,12,7704185610
6892,51705760,21905588,73611348,0,0,1,8704,3,657505078
6893,51718920,10770007,62488927,9,0,0,7168,12,3151971235
6894,51724330,10188664,61912994,4,0,0,1024,15,5135397903
6895,51725550,10286748,62012298,4,0,0,1024,15,5147574293
6896,51728050,21884284,73612334,0,0,1,1536,3,4826154957
6897,51734890,21910267,73645157,9,0,1,4608,12,2285683421
6898,51741380,10334711,62076091,4,0,0,1024,15,1220849173
6899,51744091,10651082,62395173,7,0,0,8192,10,246526555
6900,51750970,21895189,73646159,0,0,1,512,3,534523506
6901,51757340,10145524,61902864,0,0,0,512,3,2859841675
6902,51758880,10181317,61940197,5,0,0,4096,10,6559844605
6903,51765160,21885505,73650665,0,0,1,7168,3,7127984163
6904,51775130,10380459,62155589,9,0,0,25600,12,8995723434
6905,51775250,10372516,62147766,4,0,0,1536,15,5228612982
6906,51777961,10787078,62565039,7,0,0,30208,10,9491883867
6907,51782450,21869291,73651741,9,0,1,13312,12,3554483926
6908,51786400,21873066,73659466,6,0,1,12288,7,1470818846
6909,51787250,21888101,73675351,9,0,1,1536,12,8999944040
6910,51804370,10386784,62191154,0,0,0,512,3,6092667677
6911,51815650,10196827,62012477,8,0,0,512,8,5616896255
6912,51820100,21855610,73675710,9,0,1,9728,12,3131516164
6913,51821240,21947635,73768875,9,0,1,512,12,1379209420
6914,51828860,10455633,62284493,4,0,0,1024,15,3184404633
6915,51830510,21940951,73771461,9,0,1,4096,12,5647130082
6916,51838420,10411675,62250095,5,0,0,57856,10,6824506438
6917,51841381,21975556,73816937,5,0,1,4096,10,2658791041
6918,51842250,10505073,62347323,9,0,0,49152,12,3036242316
6919,51843970,22523744,74367714,6,0,1,89600,7,7881730204
6920,51848890,22518847,74367737,6,0,1,11776,7,2755749894
6921,51859390,10568911,62428301,5,0,0,74752,10,1913098432
6922,51859850,22508268,74368118,6,0,1,32768,7,8974759228
6923,51863129,10228863,62091992,3,0,0,1024,17,6343684250
6924,51867440,22531479,74398919,9,0,1,2048,12,9005238156
6925,51880600,22518358,74398958,6,0,1,27136,7,4002597689
6926,51886420,22580138,74466558,6,0,1,64512,7,4870292491
6927,51886781,22579800,74466581,8,0,1,512,8,9114213785
6928,51900180,10309774,62209954,8,0,0,512,8,3880657296
6929,51907231,22559373,74466604,8,0,1,2048,8,7695653974
6930,51911110,10283116,62194226,4,0,0,512,15,3963702067
6931,51914350,22552277,74466627,0,0,1,4608,3,7307836696
6932,51919030,10612940,62531970,4,0,0,1024,15,9154849626
6933,51921790,10269543,62191333,0,0,0,512,3,10224815617
6934,51925610,11422979,63348589,5,0,0,244736,10,4654691591
6935,51942050,10408697,62350747,9,0,0,2048,12,5812922105
6936,51943650,10749472,62693122,0,0,0,1024,3,4393996996
6937,51946140,22520510,74466650,9,0,1,3072,12,4083010782
6938,51954741,22511932,74466673,8,0,1,1024,8,8663285933
6939,51956620,22510076,74466696,9,0,1,9216,12,6991391901
6940,51966370,10420882,62387252,0,0,0,512,3,10461225016
6941,51966500,22746785,74713285,6,0,1,104960,7,9699335061
6942,51971811,22750897,74722708,8,0,1,8704,8,1651083818
6943,51973300,10773094,62746394,4,0,0,512,15,8153994928
6944,51993200,22741957,74735157,9,0,1,5632,12,6654155856
6945,51997721,22795031,74792752,8,0,1,512,8,8972067362
6946,52006670,22790588,74797258,9,0,1,7168,12,8356662467
6947,52011380,10514678,62526058,5,0,0,18432,10,9975157925
6948,52026949,10401843,62428792,3,0,0,1536,17,1591829061
6949,52032530,10280256,62312786,6,0,0,8704,7,7686391093
6950,52051650,22799944,74851594,6,0,1,16896,7,4345174150
6951,52052470,10667581,62720051,0,0,0,512,3,9990845517
6952,52053790,10856186,62909976,5,0,0,22528,10,5968908881
6953,52054330,22797610,74851940,1,0,1,512,10,3845395254
6954,52056221,10813807,62870028,7,0,0,52736,10,9465498362
6955,52056320,10777015,62833335,0,0,0,1024,3,3847997912
6956,52058851,10254582,62313433,7,0,0,2048,10,9813407271
6957,52059070,10240288,62299358,8,0,0,512,8,5045745183
6958,52059820,22794386,74854206,9,0,1,3584,12,4187838802
6959,52066280,22792992,74859272,2,0,1,512,3,9770118999
6960,52078650,22781288,74859938,0,0,1,1024,3,7253929755
6961,52086740,22788118,74874858,1,0,1,6144,10,4498620730
6962,52100400,10431235,62531635,5,0,0,12288,10,5285621518
6963,52112720,22762161,74874881,2,0,1,13824,3,4820496288
6964,52115330,22759574,74874904,0,0,1,1024,3,15917917
6965,52120601,10339373,62459974,7,0,0,30208,10,7473881855
6966,52130300,10580941,62711241,6,0,0,59392,7,8287755791
6967,52133201,22741726,74874927,8,0,1,512,8,4883146798
6968,52139370,10403075,62542445,6,0,0,34304,7,2667452579
6969,52139950,22735000,74874950,9,0,1,4608,12,3531685049
6970,52154960,10875823,63030783,4,0,0,1536,15,3198388683
6971,52156420,22718553,74874973,1,0,1,1024,10,6590550916
6972,52157970,11010621,63168591,8,0,0,512,8,8679516970
6973,52163501,10759444,62922945,7,0,0,6656,10,9065246903
6974,52178860,10983882,63162742,6,0,0,79360,7,8919927529
6975,52189060,10287527,62476587,0,0,0,512,3,1867429791
6976,52190820,22735028,74925848,6,0,1,27648,7,4255482235
6977,52197300,22729214,74926514,2,0,1,1024,3,1824528532
6978,52199979,10276421,62476400,3,0,0,1024,17,9390976372
6979,52202050,23021684,75223734,6,0,1,101888,7,8885586243
6980,52204259,10447334,62651593,3,0,0,512,17,2503478432
6981,52204430,23019327,75223757,0,0,1,512,3,5866595065
6982,52206561,10539654,62746215,7,0,0,75264,10,8942343498
6983,52208970,23014810,75223780,0,0,1,1536,3,8711673446
6984,52212130,23011673,75223803,1,0,1,3584,10,6408917821
6985,52212780,23137729,75350509,6,0,1,35328,7,1109466689
6986,52220630,23172413,75393043,1,0,1,1536,10,8985247274
6987,52222350,10328267,62550617,0,0,0,1024,3,6837293805
6988,52225849,10659710,62885559,3,0,0,1024,17,7262499265
6989,52228370,23165031,75393401,2,0,1,7168,3,1892319408
6990,52228581,23179102,75407683,8,0,1,4608,8,9729478616
6991,52232360,10316540,62548900,8,0,0,1536,8,10032151743
6992,52233810,10361693,62595503,8,0,0,1024,8,8858461152
6993,52234890,10587883,62822773,0,0,0,512,3,6021990829
6994,52236330,23171376,75407706,2,0,1,512,3,5435084677
6995,52245480,11171391,63416871,6,0,0,41472,7,8792984663
6996,52246110,10531743,62777853,0,0,0,1536,3,9964689866
6997,52250320,23157409,75407729,2,0,1,9216,3,707286570
6998,52252691,23157109,75409800,8,0,1,4096,8,5770410894
6999,52255670,23154476,75410146,1,0,1,512,10,1698019015
7000,52256610,10361827,62618437,6,0,0,8704,7,7000156655
7001,52259070,23287732,75546802,6,0,1,36864,7,1050468035
7002,52261481,10870795,63132276,7,0,0,114688,10,6937796644
7003,52261890,23483246,75745136,6,0,1,88576,7,2827813245
7004,52268330,23676168,75944498,7,0,1,79360,10,8759859688
7005,52274200,10367195,62641395,6,0,0,7168,7,6161296122
7006,52278990,11227155,63506145,6,0,0,31744,7,4352067172
7007,52289190,11168013,63457203,5,0,0,83968,10,3067800114
7008,52294040,23735068,76029108,7,0,1,68608,10,4758897062
7009,52296040,23734553,76030593,1,0,1,15360,10,3987241665
7010,52296760,10914243,63211003,5,0,0,31232,10,6995720223
7011,52296810,10745193,63042003,4,0,0,3072,15,3669543880
7012,52300421,10942432,63242853,7,0,0,93696,10,8862496493
7013,52302261,23736271,76038532,8,0,1,1536,8,3792313179
7014,52315321,11073745,63389066,7,0,0,83968,10,8191384365
7015,52324701,10887105,63211806,7,0,0,2560,10,7625740897
7016,52325910,23715848,76041758,0,0,1,5120,3,9985902723
7017,52328249,10933441,63261690,3,0,0,1024,17,10290403378
7018,52335390,23718721,76054111,7,0,1,14336,10,4705075262
7019,52341140,23796392,76137532,6,0,1,84480,7,4047005575
7020,52341310,10748708,63090018,4,0,0,1536,15,7959408309
7021,52353330,11232780,63586110,4,0,0,3584,15,4449952635
7022,52354370,23784468,76138838,2,0,1,2048,3,2254205932
7023,52357750,10353762,62711512,8,0,0,512,8,8283812579
7024,52359590,23779594,76139184,1,0,1,512,10,5321816746
7025,52359759,11127652,63487411,3,0,0,1536,17,5035698488
7026,52360310,23825220,76185530,7,0,1,21504,10,2232580912
7027,52360680,23838016,76198696,1,0,1,512,10,9309354984
7028,52367420,23831299,76198719,2,0,1,2048,3,9079133452
7029,52369251,23829491,76198742,8,0,1,9216,8,5565161251
7030,52377471,11109239,63486710,7,0,0,96768,10,1714469795
7031,52388960,10959808,63348768,0,0,0,512,3,3637714505
7032,52403321,10948746,63352067,7,0,0,10752,10,1695346576
7033,52414070,10531270,62945340,9,0,0,19456,12,3794319868
7034,52416150,23785323,76201473,0,0,1,6656,3,10177922432
7035,52418070,23938699,76356769,2,0,1,3584,3,5826673790
7036,52423101,23943097,76366198,8,0,1,10240,8,5509623738
7037,52428810,23937411,76366221,2,0,1,1536,3,5134439723
7038,52429280,10603061,63032341,8,0,0,512,8,2682685513
7039,52431400,23934844,76366244,1,0,1,1024,10,8623482848
7040,52434760,23931507,76366267,0,0,1,8192,3,3678430637
7041,52445660,23920630,76366290,2,0,1,4096,3,7332730167
7042,52445670,11267911,63713581,0,0,0,3584,3,3259053690
7043,52455380,10576627,63032007,0,0,0,512,3,8791847373
7044,52460210,24042671,76502881,7,0,1,23040,10,2597035771
7045,52462200,24061818,76524018,0,0,1,6144,3,3279446271
7046,52463911,24060130,76524041,8,0,1,1024,8,4385147842
7047,52489760,10862798,63352558,8,0,0,1536,8,3485327190
7048,52490960,11075345,63566305,9,0,0,38400,12,10322095066
7049,52492570,10645969,63138539,9,0,0,20480,12,1618281605
7050,52493690,10674714,63168404,5,0,0,16384,10,8852824825
7051,52494500,11431235,63925735,6,0,0,80896,7,7168623034
7052,52496909,10746279,63243188,3,0,0,1024,17,1340019531
7053,52497671,11014760,63512431,7,0,0,3584,10,9761454147
7054,52503570,24020494,76524064,0,0,1,1536,3,1370789341
7055,52506250,24017837,76524087,0,0,1,8704,3,9524460759
7056,52511269,10689215,63200484,3,0,0,3584,17,4178777882
7057,52514930,11532054,64046984,6,0,0,105984,7,716168936
7058,52519810,24004300,76524110,2,0,1,2048,3,7433652863
7059,52533980,10829301,63363281,9,0,0,34816,12,10476030160
7060,52539000,23985133,76524133,2,0,1,512,3,3740097453
7061,52541510,24421714,76963224,7,0,1,120320,10,1750508219
7062,52541960,24421287,76963247,0,0,1,2048,3,4935457719
7063,52543651,24419619,76963270,8,0,1,512,8,4293568194
7064,52554740,24477140,77031880,7,0,1,28160,10,24215701
7065,52562850,11026747,63589597,6,0,0,4608,7,4575949075
7066,52562879,10600510,63163389,3,0,0,2048,17,1308055589
7067,52572970,11217315,63790285,0,0,0,512,3,2906068580
7068,52577619,10623465,63201084,3,0,0,512,17,3777912603
7069,52603540,11483555,64087095,4,0,0,512,15,3613558785
7070,52605330,24428817,77034147,7,0,1,25600,10,9652098052
7071,52615220,24468320,77083540,2,0,1,1024,3,288672528
7072,52619770,24464116,77083886,0,0,1,512,3,3923143881
7073,52623690,24461502,77085192,0,0,1,2048,3,9204895720
7074,52627330,10763218,63390548,8,0,0,2560,8,2113195837
7075,52636890,10548283,63185173,8,0,0,512,8,7083922114
7076,52638590,24693726,77332316,7,0,1,139776,10,4776593569
7077,52647870,10756273,63404143,5,0,0,44544,10,5068067779
7078,52649610,24746142,77395752,0,0,1,4608,3,1569211097
7079,52651471,10766226,63417697,7,0,0,2560,10,2500982037
7080,52651800,24743975,77395775,0,0,1,12288,3,6983077891
7081,52653440,24742358,77395798,0,0,1,3072,3,10197411510
7082,52653560,24844384,77497944,7,0,1,84992,10,5121189378
7083,52654540,11309126,63963666,6,0,0,124416,7,3988138424
7084,52657750,10731987,63389737,0,0,0,2048,3,10570322493
7085,52659470,24839780,77499250,0,0,1,2048,3,8543852324
7086,52660280,24846142,77506422,7,0,1,8704,10,9812209710
7087,52667030,11214702,63881732,5,0,0,48640,10,7009125354
7088,52670050,24836958,77507008,1,0,1,3584,10,8499351540
7089,52672000,11342646,64014646,6,0,0,91648,7,2171295222
7090,52672870,10838446,63511316,6,0,0,16896,7,1621678539
7091,52679070,11109821,63788891,6,0,0,153088,7,10678359210
7092,52682011,24825663,77507674,8,0,1,1024,8,8564546618
7093,52683330,24930972,77614302,1,0,1,20480,10,10046396700
7094,52685239,10801650,63486889,3,0,0,512,17,5260372336
7095,52686190,10931382,63617572,5,0,0,39424,10,4075971203
7096,52686950,11559068,64246018,9,0,0,7168,12,5917295877
7097,52689850,24924475,77614325,1,0,1,10240,10,5358611744
7098,52694940,11892899,64587839,4,0,0,512,15,9265014549
7099,52719790,24897389,77617179,7,0,1,32768,10,2471888443
7100,52734600,25051767,77786367,6,0,1,110592,7,5516470231
7101,52735940,25050450,77786390,0,0,1,6656,3,10331366198
7102,52736840,11052698,63789538,5,0,0,2048,10,7002652839
7103,52740300,10678676,63418976,9,0,0,4096,12,8205558216
7104,52747890,25038523,77786413,7,0,1,3584,10,7893674608
7105,52752010,25034426,77786436,1,0,1,6144,10,2874436461
7106,52753500,11113332,63866832,6,0,0,34816,7,5014905497
7107,52754260,25035663,77789923,6,0,1,7680,7,3582684042
7108,52754740,25035542,77790282,0,0,1,9728,3,5942869725
7109,52757160,11673196,64430356,9,0,0,27648,12,3696721908
7110,52759961,25032587,77792548,8,0,1,3584,8,7790071404
7111,52762781,11049055,63811836,7,0,0,70656,10,4122622450
7112,52764930,25086387,77851317,7,0,1,92160,10,5411143805
7113,52766660,25085003,77851663,6,0,1,512,7,2639544571
7114,52769431,10859579,63629010,7,0,0,13312,10,7321518429
7115,52777220,11331015,64108235,6,0,0,14336,7,7731515454
7116,52779260,25075629,77854889,6,0,1,5120,7,607652109
7117,52779560,25083899,77863459,1,0,1,9216,10,9860670988
7118,52785240,11799489,64584729,5,0,0,81408,10,8031803021
7119,52787240,25076885,77864125,0,0,1,1024,3,6993994761
7120,52806410,11012486,63818896,0,0,0,2048,3,3639085943
7121,52807570,11074341,63881911,8,0,0,512,8,9923067622
7122,52816930,25050101,77867031,0,0,1,4608,3,8571972955
7123,52817640,10972466,63790106,0,0,0,1536,3,5284241145
7124,52817730,10924174,63741904,0,0,0,512,3,1752101840
7125,52817850,25235002,78052852,7,0,1,78336,10,485911241
7126,52823180,25232578,78055758,2,0,1,4608,3,10628777459
7127,52829070,25228954,78058024,1,0,1,3584,10,3903575715
7128,52831901,11024300,63856201,7,0,0,69120,10,5774009790
7129,52833199,11754453,64587652,3,0,0,512,17,9062270771
7130,52837600,25224290,78061890,1,0,1,6144,10,4634885278
7131,52841220,11130011,63971231,6,0,0,5120,7,4036733501
7132,52842830,25223566,78066396,6,0,1,7168,7,6142252245
7133,52849710,25269080,78118790,6,0,1,50176,7,5922259141
7134,52851490,25364603,78216093,7,0,1,74240,10,335339623
7135,52853960,11039562,63893522,8,0,0,512,8,8052994050
7136,52862380,11215483,64077863,9,0,0,55808,12,3684528453
7137,52867160,25348956,78216116,1,0,1,3072,10,10461276515
7138,52868110,11101538,63969648,9,0,0,18432,12,7072807344
7139,52871320,11176038,64047358,0,0,0,512,3,6441714726
7140,52877930,25346966,78224896,1,0,1,5120,10,6365363482
7141,52878870,11358990,64237860,5,0,0,12800,10,2560852287
7142,52884990,25340252,78225242,0,0,1,512,3,4378752786
7143,52886849,10943714,63830563,3,0,0,1024,17,324792212
7144,52896591,11347220,64243811,7,0,0,19456,10,2575621186
7145,52896809,11067192,63964001,3,0,0,1024,17,8513651296
7146,52905531,11263132,64168663,7,0,0,36864,10,9434291185
7147,52911790,25439546,78351336,7,0,1,117248,10,7301510064
7148,52917520,25460499,78378019,2,0,1,2048,3,10533306659
7149,52920460,11132381,64052841,5,0,0,17920,10,6874858727
7150,52924300,12361939,65286239,9,0,0,57344,12,3668829174
7151,52931350,25502509,78433859,6,0,1,41472,7,4563305868
7152,52932920,25506801,78439721,1,0,1,3584,10,2588952248
7153,52933460,11433282,64366742,2,0,0,124416,3,4680418282
7154,52933860,25507487,78441347,1,0,1,2560,10,7321818498
7155,52934920,25508693,78443613,0,0,1,3584,3,8340840242
7156,52935940,12146449,65082389,9,0,0,107520,12,8753777319
7157,52942660,11291098,64233758,5,0,0,48128,10,4863545320
7158,52942720,11964978,64907698,6,0,0,3072,7,10103780351
7159,52946751,25505206,78451957,8,0,1,18944,8,426617927
7160,52946870,11727014,64673884,9,0,0,49152,12,5704836264
7161,52947310,25504993,78452303,0,0,1,512,3,4993417566
7162,52949450,11021960,63971410,8,0,0,512,8,3946486914
7163,52953040,11232730,64185770,4,0,0,1536,15,6999692260
7164,52960470,11196112,64156582,6,0,0,21504,7,3451127408
7165,52960760,11256897,64217657,8,0,0,512,8,7956187503
7166,52963590,25505858,78469448,1,0,1,1024,10,2657693150
7167,52965520,25503951,78469471,2,0,1,6144,3,1428274993
7168,52979220,11230948,64210168,0,0,0,1024,3,5484337945
7169,52981600,11265329,64246929,9,0,0,1536,12,10478729706
7170,52982870,11322443,64305313,0,0,0,1536,3,8456291579
7171,52984860,11319962,64304822,2,0,0,22016,3,1754155208
7172,52986310,25483184,78469494,1,0,1,10240,10,8183449914
7173,52988939,11058232,64047171,1,0,0,512,10,3705061852
7174,52997900,25668961,78666861,6,0,1,138240,7,5611794618
7175,52998841,11560368,64559209,7,0,0,202240,10,8550682734
7176,53001540,11384530,64386070,4,0,0,1024,15,7643584977
7177,53002999,11255238,64258237,3,0,0,2048,17,9515130916
7178,53005710,25683497,78689207,1,0,1,1536,10,3941697565
7179,53009170,11224767,64233937,8,0,0,512,8,551788263
7180,53009810,25801933,78811743,6,0,1,79360,7,3262666370
7181,53013169,11417545,64430714,1,0,0,512,10,3590728867
7182,53013470,11232899,64246369,0,0,0,1024,3,8335665509
7183,53015100,11572373,64587473,5,0,0,512,10,10051383885
7184,53022620,25800377,78822997,1,0,1,19968,10,1143222006
7185,53023259,11245827,64269086,3,0,0,512,17,8527127540
7186,53023930,11273016,64296946,0,0,0,1024,3,1640631424
7187,53027740,25899232,78926972,6,0,1,53248,7,7525588461
7188,53028040,11264142,64292182,0,0,0,512,3,10060515982
7189,53028660,11296264,64324924,8,0,0,512,8,1515252334
7190,53029510,11529878,64559388,8,0,0,512,8,4010687208
7191,53041239,11633407,64674646,3,0,0,1536,17,4308714317
7192,53045780,11433663,64479443,8,0,0,512,8,5707172273
7193,53046650,11743449,64790099,5,0,0,512,10,4957947185
7194,53047600,25950443,78998043,6,0,1,76800,7,8466992796
7195,53048720,26032117,79080837,0,0,1,16384,3,1249854090
7196,53054029,11530879,64584908,1,0,0,512,10,3092061462
7197,53055031,11531616,64586647,7,0,0,5632,10,5582550454
7198,53065611,11383773,64449384,7,0,0,2560,10,3788370905
7199,53068150,11342994,64411144,5,0,0,1536,10,8701459923
7200,53071809,11488093,64559902,1,0,0,512,10,6267869537
7201,53076249,11354286,64430535,1,0,0,512,10,1971197762
7202,53079850,11479873,64559723,0,0,0,1024,3,5898152862
7203,53082670,25998190,79080860,0,0,1,5632,3,8936278537
7204,53090430,25990453,79080883,1,0,1,16896,10,10293426922
7205,53090480,11496814,64587294,5,0,0,2048,10,135877221
7206,53107880,11336704,64444584,5,0,0,512,10,1274840089
7207,53111870,25971087,79082957,6,0,1,27648,7,4842730243
7208,53112250,25981712,79093962,1,0,1,3072,10,6402343046
7209,53115520,25978473,79093993,1,0,1,512,10,3461149094
7210,53116510,12244264,65360774,0,0,0,1024,3,261401360
7211,53119170,11332026,64451196,4,0,0,2048,15,5434852886
7212,53119819,11765717,64885536,3,0,0,512,17,6496474670
7213,53126380,26080026,79206406,6,0,1,76288,7,6775557897
7214,53126480,11506274,64632754,6,0,0,31232,7,9401848836
7215,53137060,26175258,79312318,6,0,1,118784,7,4704002596
7216,53140251,26172090,79312341,5,0,1,1024,10,6777553967
7217,53143820,26168544,79312364,0,0,1,1024,3,2818725233
7218,53143970,11508019,64651989,8,0,0,512,8,8139228466
7219,53147010,11527053,64674063,4,0,0,512,15,9631706518
7220,53147721,26164666,79312387,5,0,1,9216,10,2700962058
7221,53162370,11722964,64885334,2,0,0,35840,3,808601095
7222,53173790,26175758,79349548,6,0,1,60416,7,974405564
7223,53182340,11450749,64633089,0,0,0,1024,3,2316813261
7224,53186620,11721569,64908189,4,0,0,1536,15,2161080436
7225,53187410,26192871,79380281,1,0,1,5632,10,4445822666
7226,53187740,11678961,64866701,2,0,0,118272,3,2612529223
7227,53190360,12292472,65482832,2,0,0,101888,3,3784078256
7228,53193820,11455409,64649229,8,0,0,1536,8,9373803550
7229,53199050,26253924,79452974,6,0,1,46592,7,8570131372
7230,53203740,11670472,64874212,6,0,0,24576,7,43314057
7231,53203850,11708772,64912622,5,0,0,3584,10,6281745241
7232,53211570,11789063,65000633,5,0,0,512,10,5845983249
7233,53218370,11563299,64781669,0,0,0,512,3,3335855980
7234,53219870,11993112,65212982,5,0,0,1024,10,7622092323
7235,53222440,26248385,79470825,0,0,1,7168,3,7070635582
7236,53232290,11653517,64885807,4,0,0,512,15,340935393
7237,53232679,11594993,64827672,3,0,0,1024,17,4129895644
7238,53233190,26237658,79470848,0,0,1,4096,3,3110754384
7239,53235370,26242700,79478070,0,0,1,7168,3,7122464240
7240,53252350,26225743,79478093,0,0,1,512,3,8458146009
7241,53258270,11616121,64874391,4,0,0,512,15,4532801234
7242,53267500,11697903,64965403,2,0,0,512,3,535227034
7243,53271710,11552734,64824444,0,0,0,512,3,7901589713
7244,53274890,11863163,65138053,0,0,0,512,3,8996992822
7245,53279300,11647460,64926760,2,0,0,3072,3,6583430864
7246,53279630,11711212,64990842,2,0,0,6656,3,1147397086
7247,53282180,12210907,65493087,5,0,0,512,10,3672943627
7248,53283760,11534425,64818185,0,0,0,512,3,7558679383
7249,53287720,26190396,79478116,0,0,1,3584,3,10062250733
7250,53288460,26189679,79478139,1,0,1,5632,10,1455258865
7251,53292170,26221694,79513864,0,0,1,4096,3,1136213028
7252,53296089,11520716,64816805,3,0,0,1024,17,4566624591
7253,53301830,26213020,79514850,0,0,1,1536,3,10635911689
7254,53301911,26213925,79515836,5,0,1,1536,10,8689513711
7255,53302100,26238635,79540735,6,0,1,75776,7,230159656
7256,53312561,26284395,79596956,5,0,1,23552,10,9569651728
7257,53315581,26282361,79597942,5,0,1,1536,10,4667726747
7258,53323170,11602238,64925408,0,0,0,1024,3,9658950311
7259,53323671,26285512,79609183,5,0,1,6144,10,6895197188
7260,53325900,11865273,65191173,4,0,0,512,15,2373404081
7261,53330980,26282709,79613689,1,0,1,7168,10,5384993710
7262,53337619,11668044,65005663,1,0,0,1536,10,5934992427
7263,53341500,11573414,64914914,4,0,0,1024,15,7139711098
7264,53350470,11861998,65212468,2,0,0,68096,3,181589599
7265,53357130,11929467,65286597,4,0,0,512,15,7875128875
7266,53371450,11766424,65137874,2,0,0,39936,3,6528324854
7267,53389010,11750011,65139021,5,0,0,512,10,7976275025
7268,53392240,11908981,65301221,2,0,0,44544,3,2428447123
7269,53396829,12165797,65562626,3,0,0,1024,17,9900783051
7270,53397320,11696473,65093793,0,0,0,512,3,6021114716
7271,53399150,11961289,65360439,9,0,0,42496,12,10599942906
7272,53401150,26213256,79614406,6,0,1,19456,7,1856275020
7273,53401690,26247887,79649577,0,0,1,1536,3,277178888
7274,53403520,11700462,65103982,0,0,0,512,3,10287320558
7275,53403630,12022328,65425958,9,0,0,89088,12,6326669510
7276,53405869,11806778,65212647,1,0,0,512,10,1512726967
7277,53405950,26243650,79649600,0,0,1,3584,3,8451442008
7278,53406219,11880199,65286418,3,0,0,512,17,9373096970
7279,53409930,11877158,65287088,4,0,0,1536,15,10049368721
7280,53419740,11697363,65117103,8,0,0,512,8,161179561
7281,53420150,11662418,65082568,5,0,0,512,10,7783574391
7282,53420300,12007443,65427743,6,0,0,4608,7,10158034979
7283,53420310,26229313,79649623,1,0,1,3584,10,5968904176
7284,53421990,11895010,65317000,2,0,0,51712,3,7330227325
7285,53464211,11913415,65377626,7,0,0,37376,10,4628362689
7286,53465040,26184606,79649646,6,0,1,5632,7,8210220334
7287,53472990,11978775,65451765,2,0,0,31232,3,9111401800
7288,53484080,11854129,65338209,4,0,0,512,15,1285029682
7289,53487310,11907869,65395179,2,0,0,8192,3,5222127164
7290,53491340,12019882,65511222,9,0,0,12800,12,6549960527
7291,53492720,12100812,65593532,0,0,0,512,3,1481872861
7292,53496100,12015301,65511401,8,0,0,512,8,2549326433
7293,53503069,11784541,65287610,1,0,0,512,10,9458004571
7294,53505420,12033568,65538988,2,0,0,63488,3,5216146782
7295,53512140,11805085,65317225,4,0,0,512,15,4744330031
7296,53512480,11880180,65392660,2,0,0,24064,3,5869506411
7297,53521681,26127988,79649669,5,0,1,6656,10,1671548279
7298,53521851,26147364,79669215,5,0,1,16896,10,6621138000
7299,53522160,11825308,65347468,9,0,0,16896,12,6762747764
7300,53529210,11662298,65191508,4,0,0,1024,15,873928522
7301,53530870,11713087,65243957,0,0,0,1024,3,3438938325
7302,53542059,26127211,79669270,4,0,1,6656,15,5121447781
7303,53545270,11791403,65336673,5,0,0,512,10,9607923247
7304,53546390,11947032,65493422,8,0,0,1024,8,7077553215
7305,53552970,11873167,65426137,9,0,0,512,12,5871845226
7306,53554480,11934303,65488783,8,0,0,19456,8,5093725827
7307,53554820,11884178,65438998,9,0,0,36864,12,10230666094
7308,53558059,11868257,65426316,3,0,0,512,17,9617905290
7309,53566340,12147034,65713374,6,0,0,99328,7,5137270313
7310,53569750,26123059,79692809,0,0,1,3584,3,7015472570
7311,53577210,26186674,79763884,6,0,1,56320,7,2312994494
7312,53577360,11710071,65287431,5,0,0,1024,10,9050015370
7313,53578150,11914556,65492706,2,0,0,12800,3,4498029870
7314,53580191,12098590,65678781,7,0,0,30208,10,10202906721
7315,53581700,11922915,65504615,9,0,0,10240,12,1976280560
7316,53582500,26181845,79764345,6,0,1,10240,7,9901786914
7317,53583121,26228671,79811792,5,0,1,2048,10,2189894792
7318,53586320,12172351,65758671,8,0,0,59392,8,3390005336
7319,53590101,26248282,79838383,5,0,1,19456,10,10495809014
7320,53590150,26249219,79839369,0,0,1,1536,3,6423138850
7321,53596830,26287095,79883925,6,0,1,15872,7,244023569
7322,53601670,11953263,65554933,4,0,0,1536,15,1235028149
7323,53602420,26547955,80150375,6,0,1,216576,7,6358342253
7324,53610891,26539507,80150398,5,0,1,3072,10,2189500525
7325,53611200,26539221,80150421,0,0,1,4096,3,7488028707
7326,53614020,26536424,80150444,0,0,1,1536,3,5764279948
7327,53615270,26558667,80173937,6,0,1,11776,7,8690432877
7328,53625580,11915794,65541374,5,0,0,1536,10,9059368738
7329,53651610,26522350,80173960,0,0,1,2048,3,2034568487
7330,53652431,11864887,65517318,7,0,0,2560,10,4031773814
7331,53673639,11765538,65439177,3,0,0,512,17,9278615276
7332,53687859,11805049,65492908,3,0,0,512,17,7043135976
7333,53690820,11806845,65497665,2,0,0,13824,3,2610579643
7334,53696500,26560365,80256865,6,0,1,76800,7,4524074828
7335,53697050,26559838,80256888,0,0,1,9216,3,4357756532
7336,53698291,26584908,80283199,5,0,1,22528,10,6088993558
7337,53699010,26589348,80288358,6,0,1,19456,7,880528935
7338,53708020,26606228,80314248,0,0,1,6144,3,9501526249
7339,53710390,26603881,80314271,9,0,1,12800,12,4405344604
7340,53710640,11830243,65540883,0,0,0,6144,3,2031652867
7341,53713421,11793089,65506510,7,0,0,6144,10,930900696
7342,53718921,12168612,65887533,7,0,0,82944,10,4412195105
7343,53724780,11998826,65723606,6,0,0,33280,7,7665469952
7344,53726391,26587903,80314294,5,0,1,5120,10,1634662676
7345,53732960,12363863,66096823,5,0,0,512,10,1543992301
7346,53739039,12074226,65813265,3,0,0,512,17,7400792201
7347,53744270,12200716,65944986,0,0,0,16384,3,1348322071
7348,53745810,11850543,65596353,2,0,0,8704,3,2512032577
7349,53746530,12378291,66124821,9,0,0,62976,12,3148113010
7350,53748470,11793395,65541865,8,0,0,1536,8,10378978592
7351,53751700,12168616,65920316,0,0,0,107520,3,10015212754
7352,53752520,12402227,66154747,2,0,0,69632,3,10717952363
7353,53757690,11875992,65633682,2,0,0,19968,3,716307106
7354,53765510,26575974,80341484,0,0,1,2560,3,3239479806
7355,53767599,11911673,65679272,1,0,0,1536,10,4580806906
7356,53770420,26571087,80341507,0,0,1,1536,3,3964473570
7357,53773550,12184783,65958333,5,0,0,512,10,4882205339
7358,53775410,12402388,66177798,2,0,0,22016,3,9978316501
7359,53775420,26566134,80341554,0,0,1,2048,3,1966507553
7360,53777551,26564026,80341577,5,0,1,5632,10,3227367975
7361,53778519,12302912,66081431,3,0,0,512,17,8385828929
7362,53781201,26560399,80341600,5,0,1,7168,10,7335637622
7363,53783980,12147013,65930993,4,0,0,2048,15,9256067159
7364,53790830,12449828,66240658,6,0,0,51200,7,9717423972
7365,53797510,12038660,65836170,6,0,0,49664,7,10062782980
7366,53797700,12489570,66287270,5,0,0,30208,10,4705823952
7367,53798720,12131626,65930346,5,0,0,19456,10,7468951743
7368,53802200,12170095,65972295,6,0,0,13824,7,3360985393
7369,53803111,12051221,65854332,7,0,0,17408,10,1322514433
7370,53804370,12214503,66018873,0,0,0,37888,3,8988129638
7371,53810370,12624435,66434805,6,0,0,93696,7,2169063352
7372,53814030,12177636,65991666,0,0,0,13312,3,2053134894
7373,53814479,12317408,66131887,1,0,0,1024,10,9780226587
7374,53815040,12109355,65924395,6,0,0,13312,7,4863073064
7375,53826869,12449256,66276125,1,0,0,2048,10,1427966200
7376,53828821,12446657,66275478,7,0,0,47104,10,1041862847
7377,53833601,12683027,66516628,7,0,0,97792,10,4006269043
7378,53839850,12291702,66131552,8,0,0,22016,8,1150456126
7379,53842840,12324385,66167225,0,0,0,512,3,696257926
7380,53844750,26515616,80360366,0,0,1,11776,3,10555821040
7381,53846291,26514098,80360389,5,0,1,10240,10,2801241028
7382,53854520,12490688,66345208,5,0,0,55808,10,9908993430
7383,53864820,12453489,66318309,9,0,0,70656,12,934164833
7384,53864880,26495532,80360412,0,0,1,2560,3,9421504175
7385,53881860,12738676,66620536,5,0,0,53760,10,7955329004
7386,53887010,12435690,66322700,0,0,0,14336,3,4567997716
7387,53887050,12641948,66528998,2,0,0,40448,3,7534937164
7388,53891299,12163828,66055127,1,0,0,1536,10,2434775243
7389,53892351,12839752,66732103,7,0,0,90112,10,7690524548
7390,53892660,12289373,66182033,5,0,0,13824,10,2767951720
7391,53894110,12272936,66167046,9,0,0,22016,12,458278347
7392,53903481,12718170,66621651,7,0,0,3584,10,931128499
7393,53907841,26465921,80373762,5,0,1,8192,10,1476677245
7394,53915280,12545442,66460722,5,0,0,22016,10,6104003489
7395,53927469,12453766,66381235,1,0,0,512,10,109859207
7396,53935470,12620468,66555938,8,0,0,10240,8,3381509665
7397,53948510,12628508,66577018,5,0,0,62976,10,3026225835
7398,53949400,12275635,66225035,0,0,0,37888,3,2802987290
7399,53959309,12300045,66259354,3,0,0,1536,17,10275068076
7400,53961730,26431872,80393602,0,0,1,5120,3,9339828748
7401,53965381,26429847,80395228,5,0,1,2560,10,6160564082
7402,53993300,12205518,66198818,5,0,0,2048,10,4950683345
7403,53997821,26398713,80396534,5,0,1,2048,10,7178014156
7404,53998659,12698029,66696688,3,0,0,5120,17,8518668472
7405,54004020,26396060,80400080,0,0,1,5632,3,1438874692
7406,54008640,12570273,66578913,2,0,0,6144,3,2566398929
7407,54013990,12851525,66865515,9,0,0,156672,12,3818556828
7408,54017170,12800586,66817756,5,0,0,83456,10,651916996
7409,54018039,26406172,80424211,4,0,1,512,15,2999334427
7410,54018790,12676292,66695082,5,0,0,75776,10,3237867220
7411,54024640,12647331,66671971,2,0,0,16896,3,7410567702
7412,54024969,26399265,80424234,4,0,1,8704,15,10448378257
7413,54030260,26393997,80424257,9,0,1,5120,12,5220917164
7414,54031160,12953135,66984295,2,0,0,18944,3,4026141874
7415,54045109,12839390,66884499,3,0,0,2560,17,1756886733
7416,54053180,26381248,80434428,0,0,1,18432,3,1008693095
7417,54062840,12695372,66758212,0,0,0,29184,3,9980153282
7418,54065180,12487615,66552795,4,0,0,1024,15,7193636434
7419,54069011,26377815,80446826,5,0,1,3072,10,5900120721
7420,54072601,12483524,66556125,7,0,0,512,10,7273766204
7421,54076830,12574156,66650986,5,0,0,1024,10,4222158533
7422,54078311,26369821,80448132,5,0,1,2048,10,5611776042
7423,54085870,26362608,80448478,0,0,1,512,3,9966268190
7424,54090150,12531836,66621986,2,0,0,1024,3,2016976137
7425,54092420,12451466,66543886,8,0,0,8704,8,10621645394
7426,54096769,13006972,67103741,3,0,0,1536,17,5840368843
7427,54109459,12587408,66696867,3,0,0,512,17,6548911110
7428,54110610,12623076,66733686,0,0,0,5120,3,5380892370
7429,54114699,12619322,66734021,1,0,0,1024,10,2000982332
7430,54117260,26332204,80449464,9,0,1,1536,12,7346740668
7431,54118811,26332919,80451730,5,0,1,3584,10,4500367073
7432,54119920,12983330,67103250,8,0,0,71680,8,5200608086
7433,54120840,26332836,80453676,1,0,1,3072,10,6493092222
7434,54122620,26342304,80464924,1,0,1,3584,10,3551669139
7435,54124770,12758240,66883010,9,0,0,57344,12,518048539
7436,54133160,12770781,66903941,4,0,0,512,15,2787557035
7437,54140660,26510514,80651174,7,0,1,84992,10,60679391
7438,54141330,12741859,66883189,9,0,0,512,12,5815765463
7439,54143839,12628582,66772421,1,0,0,1024,10,6281558350
7440,54148560,12548954,66697514,8,0,0,2048,8,7809757905
7441,54154431,26498369,80652800,5,0,1,2560,10,10188108086
7442,54156960,12821532,66978492,8,0,0,17408,8,10427461329
7443,54161281,26491775,80653056,5,0,1,9216,10,6869482871
7444,54161921,26541864,80703785,5,0,1,8704,10,3110051634
7445,54163230,26540578,80703808,0,0,1,12800,3,2359166878
7446,54169270,12564930,66734200,2,0,0,512,3,3038493211
7447,54170160,26796610,80966770,7,0,1,73728,10,1481341307
7448,54171640,26796424,80968064,0,0,1,3584,3,7861677444
7449,54173659,12710029,66883688,1,0,0,1536,10,10278992675
7450,54178310,26789777,80968087,1,0,1,5632,10,4297556813
7451,54179190,26788920,80968110,7,0,1,22528,10,9232170412
7452,54181280,12791862,66973142,9,0,0,14336,12,9738673776
7453,54189941,12701098,66891039,7,0,0,512,10,2367410255
7454,54193250,13080743,67273993,9,0,0,12800,12,238130535
7455,54202699,13059376,67262075,3,0,0,512,17,8734164361
7456,54207871,26798682,81006553,5,0,1,8704,10,6937139532
7457,54214250,26792326,81006576,9,0,1,8704,12,3382464561
7458,54215770,12685815,66901585,4,0,0,512,15,7935812641
7459,54221250,13040646,67261896,6,0,0,36352,7,3667802872
7460,54225311,26788113,81013424,5,0,1,2048,10,2851281918
7461,54231760,12778717,67010477,5,0,0,5120,10,21684129
7462,54233100,12959224,67192324,0,0,0,56320,3,8058778976
7463,54234260,12698678,66932938,2,0,0,6144,3,8524051217
7464,54238550,26774897,81013447,9,0,1,8704,12,4320307497
7465,54238891,26789830,81028721,5,0,1,3584,10,3391154753
7466,54243210,26786817,81030027,1,0,1,2048,10,10139224827
7467,54244430,26795785,81040215,9,0,1,2560,12,10420389222
7468,54246700,12953291,67199991,9,0,0,25088,12,5508450077
7469,54251670,26842688,81094358,9,0,1,512,12,830241148
7470,54251930,13139128,67391058,0,0,0,159232,3,4772984406
7471,54253080,26853367,81106447,1,0,1,1024,10,7780935730
7472,54253540,26852930,81106470,7,0,1,22016,10,3022063690
7473,54254800,26892739,81147539,7,0,1,14848,10,728382124
7474,54258740,12953261,67212001,4,0,0,1536,15,2428021537
7475,54260880,13328177,67589057,8,0,0,81920,8,2230464537
7476,54263960,12843883,67107843,0,0,0,13312,3,9902049864
7477,54264869,12878000,67142869,1,0,0,512,10,180612677
7478,54264939,12942792,67207731,3,0,0,512,17,2147797353
7479,54268390,26882055,81150445,9,0,1,4608,12,7980287933
7480,54283500,26869211,81152711,1,0,1,3584,10,8419806849
7481,54293730,13014697,67308427,5,0,0,15360,10,7256522985
7482,54295470,26858867,81154337,1,0,1,2560,10,4286332869
7483,54299860,26882695,81182555,9,0,1,1536,12,4404555023
7484,54313400,26870141,81183541,0,0,1,1536,3,5131288914
7485,54317669,12882813,67200482,3,0,0,1536,17,7739223838
7486,54318631,26865269,81183900,5,0,1,9728,10,265472809
7487,54321971,26872017,81193988,5,0,1,1536,10,386573490
7488,54333980,13077473,67411453,2,0,0,33280,3,6529976882
7489,54335120,26860494,81195614,1,0,1,2560,10,9494761955
7490,54338320,26858600,81196920,0,0,1,2048,3,9166351833
7491,54341430,26860316,81201746,0,0,1,7680,3,1894079164
7492,54344220,12925834,67270054,8,0,0,26112,8,8003969774
7493,54344791,12734285,67079076,7,0,0,512,10,10634830277
7494,54347279,12871255,67218534,1,0,0,1024,10,5639448802
7495,54353749,12947536,67301285,1,0,0,512,10,3223783852
7496,54354380,26848672,81203052,7,0,1,2048,10,9430793136
7497,54355580,26863950,81219530,9,0,1,18432,12,751916260
7498,54361480,13120155,67481635,0,0,0,24576,3,5491892797
7499,54362580,26917631,81280211,0,0,1,16896,3,4125920555
7500,54364550,13108002,67472552,2,0,0,71680,3,2299900058
7501,54367050,26915005,81282055,7,0,1,25088,10,5711870114
7502,54371320,26911081,81282401,0,0,1,512,3,1130788686
7503,54375120,26908587,81283707,9,0,1,2048,12,10396305506
7504,54382360,13033351,67415711,9,0,0,13824,12,4146339658
7505,54383511,26911717,81295228,5,0,1,6144,10,3138034448
7506,54384901,26910350,81295251,5,0,1,1536,10,10344212391
7507,54386850,13042976,67429826,8,0,0,22016,8,8350002710
7508,54394280,13006987,67401267,9,0,0,31232,12,3193724805
7509,54394290,26900984,81295274,0,0,1,5120,3,1760736725
7510,54396320,13288872,67685192,5,0,0,13824,10,4096687824
7511,54404490,13399712,67804202,9,0,0,89600,12,8870947001
7512,54407890,13193849,67601739,8,0,0,27136,8,3472567666
7513,54409939,13192135,67602074,3,0,0,1024,17,9211858144
7514,54413830,13258352,67672182,9,0,0,15360,12,1113569388
7515,54417150,26898445,81315595,9,0,1,13312,12,9189072683
7516,54421391,12970314,67391705,7,0,0,2048,10,10501444151
7517,54421610,12871172,67292782,0,0,0,1024,3,2452480141
7518,54425450,26893371,81318821,0,0,1,5120,3,130348567
7519,54441510,13151938,67593448,9,0,0,14336,12,253863344
7520,54457130,13106944,67564074,9,0,0,86016,12,1664120378
7521,54461961,12953945,67415906,7,0,0,512,10,2150506831
7522,54475200,13009046,67484246,4,0,0,3072,15,4228422127
7523,54484511,26837216,81321727,5,0,1,4608,10,7875875727
7524,54486280,26844340,81330620,6,0,1,6144,7,9951714786
7525,54493840,26837766,81331606,0,0,1,1536,3,6688476712
7526,54499269,13017004,67516273,3,0,0,1024,17,10590783327
7527,54519660,13147328,67666988,2,0,0,53760,3,5210912185
7528,54521821,26836260,81358081,5,0,1,9216,10,735833041
7529,54534410,13146547,67680957,8,0,0,28672,8,3799945272
7530,54534601,26881175,81415776,5,0,1,3072,10,10485134743
7531,54536200,26879599,81415799,9,0,1,10240,12,8073255291
7532,54537810,13203330,67741140,2,0,0,5632,3,5024837879
7533,54549280,26866542,81415822,9,0,1,512,12,3241965806
7534,54551920,26863925,81415845,6,0,1,20480,7,2078203636
7535,54553320,26898919,81452239,6,0,1,512,7,494058296
7536,54554100,26899301,81453401,0,0,1,9216,3,5003461454
7537,54555740,26958118,81513858,6,0,1,25088,7,4424831447
7538,54556331,13111148,67667479,7,0,0,1536,10,3041011393
7539,54559560,13316245,67875805,8,0,0,35840,8,3575431436
7540,54560600,26974538,81535138,1,0,1,1536,10,1985090944
7541,54563009,13131698,67694707,1,0,0,512,10,9404904281
7542,54563790,13424364,67988154,2,0,0,132608,3,4460694876
7543,54564420,13045073,67609493,5,0,0,4096,10,1065340979
7544,54565911,26970200,81536111,5,0,1,12800,10,320775373
7545,54567200,13243421,67810621,5,0,0,20992,10,9346078439
7546,54577600,13694898,68272498,5,0,0,34816,10,2960463087
7547,54580130,13487669,68067799,0,0,0,7680,3,7061932863
7548,54580330,13416138,67996468,9,0,0,23040,12,7205455256
7549,54595589,13292990,67888579,3,0,0,1024,17,6388762138
7550,54597290,13325143,67922433,6,0,0,15872,7,9054052512
7551,54599730,26940567,81540297,1,0,1,6656,10,9412453802
7552,54606630,13544036,68150666,5,0,0,210944,10,9197976466
7553,54612650,13452786,68065436,5,0,0,57856,10,9742736142
7554,54613069,13223412,67836481,1,0,0,2560,10,4464111871
7555,54613170,13647738,68260908,0,0,0,71168,3,9319092896
7556,54619970,13376677,67996647,4,0,0,512,15,1756262367
7557,54637960,26909471,81547431,1,0,1,12288,10,2547411561
7558,54641210,27075937,81717147,0,0,1,4608,3,1006484472
7559,54642950,13346475,67989425,5,0,0,4096,10,5456790124
7560,54643399,13353583,67996982,1,0,0,1024,10,3360345677
7561,54644170,13525909,68170079,2,0,0,6144,3,5929210287
7562,54654090,27063080,81717170,2,0,1,512,3,5265952808
7563,54654590,13512947,68167537,0,0,0,55296,3,8709004662
7564,54660300,27056893,81717193,1,0,1,1536,10,8023206775
7565,54670240,27046976,81717216,1,0,1,10752,10,6994179869
7566,54673740,13175525,67849265,4,0,0,512,15,7111978370
7567,54678700,27156836,81835536,6,0,1,5120,7,6777229572
7568,54690080,27433668,82123748,7,0,1,113152,10,7485672445
7569,54700240,27446836,82147076,7,0,1,4096,10,318441509
7570,54702880,13536305,68239185,5,0,0,54272,10,2330184310
7571,54706500,27483628,82190128,1,0,1,1024,10,7035539033
7572,54713140,13457586,68170726,0,0,0,2048,3,917999425
7573,54715059,27476375,82191434,4,0,1,2048,15,6068256184
7574,54718650,27476010,82194660,1,0,1,5120,10,3120550280
7575,54718829,13543038,68261867,1,0,0,3072,10,9395247144
7576,54720760,27475846,82196606,1,0,1,3072,10,781385968
7577,54723000,13450892,68173892,2,0,0,10240,3,6767042563
7578,54726360,27471872,82198232,7,0,1,2560,10,4556102724
7579,54726729,13447342,68174071,1,0,0,512,10,2440822486
7580,54729499,13438685,68168184,1,0,0,2048,10,10363951494
7581,54729590,27470268,82199858,2,0,1,2560,3,4533341733
7582,54733299,27511845,82245144,4,0,1,2560,15,1890219924
7583,54737560,27507607,82245167,1,0,1,1024,10,9263085903
7584,54737820,27507370,82245190,2,0,1,3584,3,7321896196
7585,54747780,27497433,82245213,1,0,1,2560,10,3479200000
7586,54751720,13661079,68412799,2,0,0,48128,3,6007405415
7587,54753040,27519675,82272715,2,0,1,4608,3,10618231922
7588,54753749,27518989,82272738,4,0,1,2048,15,5428764829
7589,54755240,27531132,82286372,7,0,1,48640,10,10552688782
7590,54755830,27642627,82398457,6,0,1,93696,7,3637770396
7591,54768150,13629962,68398112,0,0,0,62976,3,343330488
7592,54768570,27712766,82481336,6,0,1,29696,7,4452493261
7593,54772720,13738700,68511420,5,0,0,11776,10,8336392923
7594,54776970,13576982,68353952,6,0,0,13824,7,10288558373
7595,54778990,13645639,68424629,5,0,0,12288,10,2380715104
7596,54779239,13689535,68468774,3,0,0,512,17,8432327407
7597,54784520,13684075,68468595,8,0,0,55808,8,91701571
7598,54803570,27677998,82481568,2,0,1,4096,3,8077094635
7599,54811719,13552302,68364021,1,0,0,512,10,7822347154
7600,54825910,27658884,82484794,1,0,1,5120,10,1671176132
7601,54831140,13912565,68743705,9,0,0,108544,12,5585021178
7602,54837620,13869017,68706637,0,0,0,78336,3,6613025608
7603,54843780,13732207,68575987,8,0,0,6144,8,6558251204
7604,54845330,13913611,68758941,9,0,0,30720,12,454061049
7605,54845890,27639570,82485460,1,0,1,1024,10,9352747331
7606,54849450,27637188,82486638,7,0,1,13824,10,891859549
7607,54852840,27635424,82488264,1,0,1,2560,10,9809814202
7608,54857620,27683652,82541272,6,0,1,39936,7,4149064065
7609,54863730,27707742,82571472,1,0,1,5120,10,2734453638
7610,54866099,27732868,82598967,4,0,1,8704,15,5072418466
7611,54876870,27733341,82610211,1,0,1,2560,10,1698709914
7612,54882639,27728238,82610877,4,0,1,1024,15,1517962246
7613,54883509,13736876,68620385,1,0,0,1024,10,9934622766
7614,54883639,27740737,82624376,4,0,1,5632,15,2539172104
7615,54885660,13754974,68640634,4,0,0,512,15,2130522268
7616,54887880,13938083,68825963,4,0,0,1024,15,1942947435
7617,54892320,13783197,68675517,4,0,0,512,15,13333379
7618,54899770,27750538,82650308,1,0,1,512,10,2039603638
7619,54903431,27748823,82652254,5,0,1,3072,10,7958706339
7620,54907530,13674834,68582364,4,0,0,512,15,5222080922
7621,54908830,27745370,82654200,2,0,1,3072,3,7380013638
7622,54912940,14064803,68977743,6,0,0,44032,7,5357452517
7623,54921680,27735746,82657426,2,0,1,5120,3,2535311412
7624,54924970,13945615,68870585,5,0,0,10240,10,10195173997
7625,54928169,13894580,68822749,3,0,0,2048,17,10432998785
7626,54931310,27895825,82827135,7,0,1,124928,10,5355649897
7627,54931439,13939805,68871244,3,0,0,1536,17,1093191177
7628,54934250,13874226,68808476,4,0,0,512,15,8715791759
7629,54934370,27919497,82853867,2,0,1,9216,3,3739504385
7630,54934720,13902943,68837663,4,0,0,512,15,7788366831
7631,54936220,14116660,69052880,9,0,0,44032,12,5541520815
7632,54938140,14130985,69069125,6,0,0,17408,7,2210218008
7633,54951170,27918176,82869346,1,0,1,2560,10,4605334600
7634,54952000,27917369,82869369,1,0,1,6144,10,3491147689
7635,54957701,27911691,82869392,5,0,1,12288,10,6335773277
7636,54974530,27894885,82869415,2,0,1,1536,3,2845283783
7637,54986920,28128440,83115360,6,0,1,149504,7,1636303377
7638,54987039,28133838,83120877,4,0,1,3072,15,5104505365
7639,54988391,28135712,83124103,5,0,1,5120,10,1882381967
7640,54989039,14028564,69017603,1,0,0,512,10,9571922820
7641,54994499,14182771,69177270,3,0,0,1536,17,2999144354
7642,55000350,14100222,69100572,5,0,0,11264,10,6435688938
7643,55002349,14311209,69313558,1,0,0,512,10,2092485717
7644,55004080,28121329,83125409,2,0,1,2048,3,8219243653
7645,55008560,28117195,83125755,2,0,1,512,3,8053523959
7646,55013720,14010495,69024215,5,0,0,2048,10,3010421120
7647,55015480,14038226,69053706,0,0,0,2560,3,1379465972
7648,55021241,28104860,83126101,5,0,1,512,10,10154640141
7649,55032070,14026518,69058588,5,0,0,15872,10,7594488842
7650,55044660,28086613,83131273,1,0,1,8192,10,9871090382
7651,55044811,28088408,83133219,5,0,1,3072,10,9942656338
7652,55046520,14412868,69459388,0,0,0,104960,3,8403159872
7653,55056010,28079155,83135165,0,0,1,3072,3,384813573
7654,55056551,14193097,69249648,7,0,0,1024,10,3343455144
7655,55065360,14353969,69419329,6,0,0,53248,7,3900530287
7656,55079531,28056940,83136471,5,0,1,2048,10,1695104802
7657,55085570,14420036,69505606,2,0,0,91136,3,9391254687
7658,55090480,28075196,83165676,6,0,1,25088,7,9692146443
7659,55094850,14035100,69129950,9,0,0,2048,12,9065550354
7660,55095389,14627553,69722942,3,0,0,512,17,4409588081
7661,55097360,28068339,83165699,1,0,1,4096,10,508996643
7662,55099590,14270537,69370127,0,0,0,38912,3,7642253525
7663,55101820,28128369,83230189,7,0,1,38400,10,2620233535
7664,55116540,28122908,83239448,6,0,1,17408,7,1702047480
7665,55118960,14352619,69471579,9,0,0,39936,12,2675444020
7666,55123200,14172947,69296147,4,0,0,512,15,6226685670
7667,55132220,28125045,83257265,2,0,1,8704,3,6028118806
7668,55143080,14482260,69625340,2,0,0,31744,3,1655957086
7669,55148391,28115290,83263681,5,0,1,3072,10,1424937457
7670,55156760,14185934,69342694,5,0,0,42496,10,5662212850
7671,55158100,28145477,83303577,7,0,1,45056,10,4827464688
7672,55163190,14399445,69562635,6,0,0,18432,7,7308737432
7673,55163751,14310235,69473986,7,0,0,512,10,1063664467
7674,55166060,14507327,69673387,5,0,0,15360,10,1784202123
7675,55166470,14964506,70130976,5,0,0,32768,10,931246201
7676,55168790,28148736,83317526,2,0,1,3584,3,5335857850
7677,55173239,14535870,69709109,1,0,0,512,10,7302005678
7678,55174070,14432606,69606676,6,0,0,47104,7,5922491970
7679,55175591,14296167,69471758,7,0,0,512,10,108668378
7680,55175770,14416531,69592301,0,0,0,22528,3,4179666794
7681,55177989,28143403,83321392,4,0,1,6144,15,3456291422
7682,55178059,14447928,69625987,1,0,0,2048,10,5538628613
7683,55182080,28186100,83368180,7,0,1,16384,10,6662741860
7684,55190260,28183976,83374236,7,0,1,28672,10,8769788612
7685,55190630,14478054,69668684,6,0,0,37888,7,4683372623
7686,55193530,28258472,83452002,1,0,1,9216,10,3075852249
7687,55196210,28271337,83467547,1,0,1,2560,10,7618129085
7688,55203290,14504283,69707573,4,0,0,512,15,209552301
7689,55207729,14264699,69472428,1,0,0,512,10,8724117503
7690,55211220,14551874,69763094,9,0,0,18944,12,5660100747
7691,55214970,28252600,83467570,1,0,1,512,10,3006084788
7692,55214971,14257278,69472249,7,0,0,1536,10,1246054281
7693,55217870,14526031,69743901,6,0,0,12288,7,1951475641
7694,55227860,14956362,70184222,6,0,0,81920,7,10368862635
7695,55234410,28441316,83675726,7,0,1,111104,10,365993026
7696,55236720,15022816,70259536,6,0,0,119808,7,1258186928
7697,55240050,14591259,69831309,4,0,0,512,15,5170264648
7698,55242530,14815846,70058376,6,0,0,70656,7,5776838258
7699,55248359,14697392,69945751,3,0,0,1024,17,4761597850
7700,55251930,14333484,69585414,9,0,0,65024,12,2677245902
7701,55252130,14600823,69852953,5,0,0,6656,10,6736452194
7702,55256290,14483844,69740134,0,0,0,3072,3,8911546467
7703,55257000,28457562,83714562,1,0,1,4096,10,4266501826
7704,55262670,14679263,69941933,9,0,0,159232,12,7086346356
7705,55263570,14475605,69739175,2,0,0,34304,3,8054488581
7706,55263959,14682127,69946086,1,0,0,1024,10,8673029583
7707,55267210,28542020,83809230,7,0,1,117248,10,4050999071
7708,55273460,28538676,83812136,2,0,1,4608,3,10168696824
7709,55275880,14728326,70004206,0,0,0,13312,3,3538832069
7710,55282339,15129674,70412013,3,0,0,1536,17,8037145774
7711,55282609,14666111,69948720,1,0,0,1024,10,5299329287
7712,55284511,28531171,83815682,5,0,1,5632,10,7794176335
7713,55286050,14521387,69807437,6,0,0,40448,7,10710077386
7714,55289670,14747132,70036802,9,0,0,35328,12,1795299556
7715,55298509,14574609,69873118,1,0,0,512,10,4212577507
7716,55309800,28509108,83818908,2,0,1,5120,3,937614390
7717,55315791,28504743,83820534,5,0,1,2560,10,5899429365
7718,55326980,14618298,69945278,0,0,0,10240,3,3926734441
7719,55328210,28496510,83824720,1,0,1,6656,10,3424562426
7720,55335300,15024991,70360291,5,0,0,54272,10,7233971129
7721,55338360,28531661,83870021,7,0,1,39424,10,577183262
7722,55340210,14877628,70217838,2,0,0,74752,3,1421885291
7723,55340500,15173134,70513634,0,0,0,26112,3,3060682486
7724,55352201,28535459,83887660,5,0,1,11264,10,6698834345
7725,55353810,28533873,83887683,1,0,1,4096,10,6904681874
7726,55353819,14588293,69942112,1,0,0,512,10,6972941002
7727,55353840,14869169,70223009,6,0,0,16896,7,3559917894
7728,55356060,28653288,84009348,7,0,1,70656,10,899606779
7729,55360530,14907054,70267584,4,0,0,1536,15,6412952602
7730,55361040,28650254,84011294,1,0,1,3072,10,8851838590
7731,55361560,28653280,84014840,2,0,1,5632,3,6210804965
7732,55361931,14908906,70270837,7,0,0,512,10,2071746908
7733,55365340,28697258,84062598,1,0,1,7680,10,10090479908
7734,55365950,28710422,84076372,2,0,1,10240,3,7666214799
7735,55366280,28710123,84076403,2,0,1,11776,3,764622495
7736,55370010,28714730,84084740,2,0,1,3072,3,5189315707
7737,55378620,14888473,70267093,2,0,0,23040,3,7282517957
7738,55378851,14889068,70267919,7,0,0,1024,10,1004925834
7739,55379740,14963992,70343732,9,0,0,29184,12,10534444556
7740,55388420,14935167,70323587,4,0,0,512,15,4983958636
7741,55390340,28694431,84084771,1,0,1,1536,10,10306648321
7742,55390921,28693873,84084794,5,0,1,512,10,7799437687
7743,55394530,28691190,84085720,2,0,1,8704,3,10317628499
7744,55395740,28691606,84087346,1,0,1,2560,10,7220761657
7745,55396370,28694842,84091212,1,0,1,6144,10,10381627502
7746,55400990,15257118,70658108,0,0,0,70656,3,2261507820
7747,55404170,28688028,84092198,1,0,1,1536,10,6324157542
7748,55410451,28685933,84096384,5,0,1,6656,10,1365580116
7749,55418390,28678980,84097370,2,0,1,1536,3,2114832690
7750,55423120,15459020,70882140,5,0,0,103424,10,7016290814
7751,55424519,14940373,70364892,1,0,0,1024,10,1838765287
7752,55428540,15005554,70434094,0,0,0,8704,3,6479394088
7753,55429350,28668686,84098036,1,0,1,1024,10,6391190689
7754,55432320,14932237,70364557,6,0,0,12800,7,9753035732
7755,55433130,28666212,84099342,2,0,1,2048,3,1338164652
7756,55437020,14948209,70385229,2,0,0,55808,3,6565182865
7757,55441290,15269794,70711084,9,0,0,62464,12,1625161409
7758,55443130,28678658,84121788,1,0,1,3584,10,2032488591
7759,55443570,15037078,70480648,2,0,0,12288,3,2766995020
7760,55447690,28674121,84121811,7,0,1,4096,10,5018301625
7761,55454551,28667283,84121834,5,0,1,6144,10,8487519639
7762,55456961,28665547,84122508,5,0,1,5632,10,6640357787
7763,55465889,28656965,84122854,4,0,1,512,15,8524533463
7764,55476370,28699552,84175922,7,0,1,86016,10,10220761700
7765,55477989,15059573,70537562,3,0,0,512,17,9524534343
7766,55484150,15246503,70730653,6,0,0,53760,7,4925673008
7767,55486240,15123413,70609653,0,0,0,33280,3,6596636283
7768,55486740,14873886,70360626,2,0,0,1024,3,2619217757
7769,55490100,28699874,84189974,7,0,1,6144,10,9829379825
7770,55493849,15402641,70896490,3,0,0,1024,17,6518779463
7771,55510360,14927507,70437867,0,0,0,4608,3,2887606462
7772,55510850,15466799,70977649,6,0,0,66048,7,1032896506
7773,55513130,14940720,70453850,2,0,0,2048,3,1507416262
7774,55513400,14746315,70259715,6,0,0,512,7,2583766404
7775,55513769,14746281,70260050,1,0,0,1024,10,4397049742
7776,55515380,14961501,70476881,9,0,0,58880,12,4045224490
7777,55523439,14933243,70456682,3,0,0,512,17,10491340307
7778,55525090,15391896,70916986,6,0,0,24064,7,5361532187
7779,55525310,15165920,70691230,9,0,0,10240,12,9345385321
7780,55531950,15485602,71017552,6,0,0,105984,7,1926882936
7781,55535671,15149679,70685350,7,0,0,1024,10,8435754637
7782,55538979,14960850,70499829,3,0,0,512,17,588765584
7783,55544121,14940206,70484327,7,0,0,1536,10,752132460
7784,55546960,15166487,70713447,0,0,0,7680,3,1461975570
7785,55546981,28644939,84191920,5,0,1,3072,10,4171129239
7786,55548711,14932116,70480827,7,0,0,512,10,2489026189
7787,55550200,28643666,84193866,7,0,1,3072,10,6408576306
7788,55551750,15285370,70837120,9,0,0,94720,12,926231416
7789,55553660,28643179,84196839,9,0,1,1536,12,264603126
7790,55557320,15156930,70714250,2,0,0,2560,3,2573370015
7791,55561431,28644015,84205446,5,0,1,7168,10,4933260918
7792,55566820,15614031,71180851,2,0,0,187392,3,2551462721
7793,55571419,15086868,70658287,3,0,0,512,17,4067714171
7794,55582509,15091680,70674189,1,0,0,512,10,9086067375
7795,55590919,15317340,70908259,1,0,0,512,10,207166947
7796,55593589,28616683,84210272,4,0,1,7680,15,6821086885
7797,55593730,15069416,70663146,6,0,0,15872,7,144688408
7798,55596050,15299770,70895820,2,0,0,6144,3,4077559036
7799,55598400,15028191,70626591,6,0,0,2048,7,1342086556
7800,55617020,15732806,71349826,2,0,0,58880,3,6270846443
7801,55618709,15562633,71181342,1,0,0,1536,10,1691183975
7802,55634210,15216349,70850559,0,0,0,44032,3,2178548251
7803,55637080,15256471,70893551,2,0,0,37376,3,5961961454
7804,55647470,15388669,71036139,2,0,0,60928,3,9062821177
7805,55650531,15243378,70893909,7,0,0,1024,10,7793201816
7806,55654190,15253867,70908057,6,0,0,37888,7,8684149947
7807,55669030,28639704,84308734,7,0,1,107008,10,1034707383
7808,55670390,15436022,71106412,0,0,0,71680,3,6619432853
7809,55672221,15509635,71181856,7,0,0,1024,10,6262750443
7810,55672379,15065432,70737811,3,0,0,1536,17,9152340959
7811,55674670,28634410,84309080,9,0,1,512,12,1302820514
7812,55679639,15216516,70896155,1,0,0,1024,10,1535379468
7813,55680210,15274826,70955036,2,0,0,27136,3,3548236715
7814,55681020,15297538,70978558,4,0,0,1024,15,9442143933
7815,55687689,15229632,70917321,1,0,0,1024,10,6299340220
7816,55688729,15347589,71036318,3,0,0,512,17,3727823333
7817,55701560,15551691,71253251,6,0,0,28672,7,1432054309
7818,55718919,15552524,71271443,3,0,0,1024,17,8167169227
7819,55727319,15547196,71274515,3,0,0,1024,17,10701223634
7820,55730930,15376285,71107215,4,0,0,2560,15,7406102192
7821,55731431,15450090,71181521,7,0,0,512,10,3591985999
7822,55745000,15481997,71226997,5,0,0,95744,10,3515157993
7823,55753980,15667369,71421349,5,0,0,25600,10,4549136919
7824,55757600,15715088,71472688,6,0,0,31232,7,6103442975
7825,55758240,15544582,71302822,4,0,0,512,15,572428899
7826,55766669,15551824,71318493,1,0,0,512,10,10635227481
7827,55768490,15620079,71388569,6,0,0,11264,7,5455517392
7828,55772489,15410037,71182526,3,0,0,2048,17,2166808956
7829,55773381,28539565,84312946,5,0,1,6144,10,2612768679
7830,55780011,28533921,84313932,5,0,1,1536,10,1343168102
7831,55782270,16082984,71865254,5,0,0,106496,10,3880576598
7832,55784220,15569864,71354084,0,0,0,13824,3,9338354286
7833,55792301,28523897,84316198,5,0,1,3584,10,1164931744
7834,55793210,28553297,84346507,2,0,1,9728,3,770772338
7835,55794140,15945047,71739187,5,0,0,10240,10,5176456302
7836,55795800,28551168,84346968,2,0,1,10240,3,6142466776
7837,55800370,15862792,71663162,0,0,0,81408,3,8176275031
7838,55813860,28533774,84347634,2,0,1,1024,3,7759924146
7839,55820399,15551692,71372091,1,0,0,1536,10,7697767339
7840,55824480,28535427,84359907,9,0,1,5120,12,221140312
7841,55830060,15633089,71463149,5,0,0,94720,10,4940673839
7842,55834840,15409652,71244492,0,0,0,57344,3,9254220683
7843,55835540,15482774,71318314,2,0,0,20480,3,330420478
7844,55838049,15983832,71821881,3,0,0,139776,17,188471724
7845,55846020,15627003,71473023,4,0,0,1024,15,8641825641
7846,55848580,28511350,84359930,9,0,1,5632,12,8045711708
7847,55849050,28698184,84547234,7,0,1,182784,10,2151095169
7848,55856950,15861603,71718553,0,0,0,54272,3,2843583698
7849,55857070,15745077,71602147,6,0,0,126976,7,933283487
7850,55861790,15701444,71563234,2,0,0,55808,3,2936827065
7851,55863180,28745100,84608280,7,0,1,39424,10,5826797554
7852,55880570,28748471,84629041,2,0,1,15360,3,646798597
7853,55884071,28747236,84631307,5,0,1,3584,10,8337670003
7854,55892840,28740093,84632933,2,0,1,2560,3,7391442004
7855,55908830,15838024,71746854,2,0,0,25088,3,2286179743
7856,55913190,15917762,71830952,0,0,0,29696,3,1227298238
7857,55917649,15811898,71729547,3,0,0,10752,17,9496061335
7858,55922290,15606433,71528723,4,0,0,512,15,2892614238
7859,55922390,16016423,71938813,2,0,0,146944,3,9590645209
7860,55927270,15683854,71611124,5,0,0,4096,10,8160425359
7861,55937980,15666828,71604808,5,0,0,4608,10,6456067587
7862,55940791,15891299,71832090,7,0,0,512,10,5732384755
7863,55941779,15621634,71563413,1,0,0,512,10,606352543
7864,55948130,15945841,71893971,2,0,0,92672,3,10437801348
7865,55951621,15812025,71763646,7,0,0,512,10,4222854672
7866,55955010,16081407,72036417,0,0,0,8192,3,4036985806
7867,55955869,15676520,71632389,1,0,0,512,10,7501109937
7868,55956681,15876056,71832737,7,0,0,2048,10,1866072083
7869,55964330,15728990,71693320,2,0,0,12800,3,888665343
7870,55968401,15897311,71865712,7,0,0,512,10,3572645519
7871,55971740,28696581,84668321,2,0,1,23040,3,1494520172
7872,55975521,28695706,84671227,5,0,1,4608,10,7702936012
7873,55993840,16040042,72033882,5,0,0,18944,10,8824076878
7874,55995170,15723585,71718755,4,0,0,512,15,8704529342
7875,55998600,15956054,71954654,5,0,0,48128,10,9973816915
7876,56000960,15960737,71961697,5,0,0,23040,10,3036217496
7877,56004630,16001540,72006170,2,0,0,83968,3,4643493622
7878,56011809,15766120,71777929,3,0,0,10240,17,6800023381
7879,56020780,28665910,84686690,7,0,1,7168,10,190183308
7880,56021651,15918316,71939967,7,0,0,1024,10,7615506391
7881,56034100,15721537,71755637,0,0,0,20992,3,7704664642
7882,56038161,28651755,84689916,8,0,1,5120,8,8153306328
7883,56039520,28715335,84754855,7,0,1,53760,10,2785372832
7884,56041499,16254737,72296236,3,0,0,22016,17,6873171025
7885,56055479,16202207,72257686,3,0,0,81920,17,8378344998
7886,56064950,15766961,71831911,4,0,0,3072,15,5672841471
7887,56067090,15913286,71980376,5,0,0,60416,10,865212131
7888,56080360,15947727,72028087,5,0,0,12288,10,2969209294
7889,56084990,28709734,84794724,2,0,1,7680,3,8447642159
7890,56086241,28708842,84795083,5,0,1,9728,10,9530450440
7891,56100279,15973460,72073739,3,0,0,17408,17,4493735301
7892,56111769,15753764,71865533,1,0,0,512,10,4770101893
7893,56116800,28712944,84829744,7,0,1,18944,10,9149983120
7894,56119110,16066632,72185742,6,0,0,23040,7,6361329336
7895,56121861,15840084,71961945,7,0,0,512,10,3581251941
7896,56129870,15894450,72024320,5,0,0,57856,10,2803675375
7897,56140101,15840454,71980555,7,0,0,512,10,5033801197
7898,56146400,16055959,72202359,6,0,0,6656,7,2473808675
7899,56157460,15922698,72080158,5,0,0,20992,10,8690881376
7900,56161381,16135073,72296454,7,0,0,512,10,4377864307
7901,56166111,16154365,72320476,7,0,0,1024,10,10287730288
7902,56166380,28664030,84830410,2,0,1,1024,3,6115744728
7903,56166910,16153231,72320141,2,0,0,42496,3,10263308467
7904,56172230,16291331,72463561,2,0,0,55808,3,6982677538
7905,56172940,15947463,72120403,2,0,0,12288,3,6462739667
7906,56179540,16093613,72273153,2,0,0,50688,3,7483745180
7907,56193870,28750004,84943874,7,0,1,75264,10,2207021266
7908,56202550,28787070,84989620,7,0,1,1024,10,6228760237
7909,56210720,15728896,71939616,6,0,0,2560,7,7478238657
7910,56216381,28773262,84989643,8,0,1,2048,8,5942447265
7911,56225030,16273186,72498216,0,0,0,113664,3,1648975864
7912,56226860,16357090,72583950,5,0,0,58368,10,2924718208
7913,56255021,15801607,72056628,7,0,0,1536,10,5514329734
7914,56265569,16055398,72320967,1,0,0,1536,10,3632419734
7915,56269400,16119951,72389351,5,0,0,21504,10,3200070874
7916,56270381,15736288,72006669,7,0,0,1536,10,10091174670
7917,56275900,16012564,72288464,6,0,0,50176,7,4855271644
7918,56282410,16247185,72529595,5,0,0,102912,10,377299360
7919,56283001,16005642,72288643,7,0,0,512,10,8038212344
7920,56285471,28704195,84989666,5,0,1,6144,10,3433744363
7921,56285960,28726840,85012800,2,0,1,2048,3,2116652301
7922,56289641,28723182,85012823,5,0,1,10240,10,7321224611
7923,56292530,16528071,72820601,2,0,0,17408,3,8304834831
7924,56292910,16493750,72786660,6,0,0,52736,7,9523312589
7925,56317060,28695802,85012862,2,0,1,512,3,7784233227
7926,56317880,16371279,72689159,6,0,0,46592,7,1061692037
7927,56329079,15900022,72229101,3,0,0,2560,17,9305731123
7928,56336651,28676234,85012885,5,0,1,10752,10,9302119157
7929,56356530,28696274,85052804,7,0,1,42496,10,6329829184
7930,56370300,16421687,72791987,2,0,0,17408,3,9827092063
7931,56374470,16616250,72990720,2,0,0,54784,3,1323765665
7932,56375020,16439919,72814939,0,0,0,74752,3,7651514930
7933,56379791,28724304,85104095,5,0,1,5120,10,7236430713
7934,56382930,16545630,72928560,6,0,0,25600,7,6978495836
7935,56407040,16424550,72831590,6,0,0,33792,7,53315427
7936,56408439,16792990,73201429,3,0,0,121856,17,8887428813
7937,56409770,16127492,72537262,5,0,0,25088,10,6203036825
7938,56417450,15771266,72188716,6,0,0,8704,7,5888826372
7939,56420810,15951087,72371897,4,0,0,1024,15,930455975
7940,56424231,28679887,85104118,5,0,1,7168,10,7009914924
7941,56431620,15890323,72321943,4,0,0,1024,15,8768146878
7942,56434621,28669520,85104141,5,0,1,3584,10,1914484765
7943,56435960,16155368,72591328,5,0,0,19968,10,1228264210
7944,56437681,28666483,85104164,5,0,1,3584,10,1091277216
7945,56439879,16145342,72585221,3,0,0,4096,17,10346906924
7946,56440749,15893210,72333959,1,0,0,1024,10,7079432686
7947,56453060,15836253,72289313,0,0,0,2048,3,8389387142
7948,56453270,16362004,72815274,4,0,0,1024,15,7217646829
7949,56453361,28678487,85131848,5,0,1,12800,10,6299616118
7950,56472471,16359766,72832237,7,0,0,2048,10,3169681241
7951,56473401,28678742,85152143,5,0,1,2048,10,2260428245
7952,56474461,16264337,72738798,7,0,0,1024,10,8714852957
7953,56480780,16065732,72546512,2,0,0,30208,3,4255717354
7954,56481361,28671141,85152502,5,0,1,9728,10,1069068442
7955,56494781,28659027,85153808,5,0,1,2048,10,9224789080
7956,56495290,15897575,72392865,5,0,0,1536,10,7494153818
7957,56500740,28655014,85155754,2,0,1,3072,3,10640145068
7958,56502089,16330639,72832728,1,0,0,1536,10,92689259
7959,56508349,16038342,72546691,1,0,0,512,10,3532926412
7960,56510470,16701434,73211904,2,0,0,34304,3,7892128337
7961,56511089,16099824,72610913,3,0,0,7680,17,8782601101
7962,56521609,16747332,73268941,1,0,0,512,10,9062220497
7963,56523529,17054536,73578065,3,0,0,69632,17,2815991752
7964,56530199,16831801,73362000,3,0,0,27648,17,6316710319
7965,56535551,16394280,72929831,7,0,0,4096,10,1758448928
7966,56537531,28628430,85165961,5,0,1,1536,10,6381913862
7967,56538210,28628097,85166307,2,0,1,512,3,9922537952
7968,56540360,16322269,72862629,2,0,0,12288,3,863851545
7969,56543490,16350330,72893820,6,0,0,59392,7,8475028928
7970,56548620,16770096,73318716,6,0,0,37888,7,7236311765
7971,56548989,16309538,72858527,3,0,0,35840,17,6429482463
7972,56549810,16441713,72991523,4,0,0,2560,15,5342917047
7973,56550259,16308603,72858862,1,0,0,1024,10,10099883331
7974,56563830,28604743,85168573,9,0,1,3584,12,3722137937
7975,56564210,16274509,72838719,5,0,0,3072,10,3737030011
7976,56570591,28600888,85171479,8,0,1,4608,8,10050152830
7977,56571479,16261896,72833375,3,0,0,2048,17,5294592058
7978,56575150,16149874,72725024,5,0,0,1024,10,9771644730
7979,56590411,28581734,85172145,5,0,1,1024,10,1022250165
7980,56591321,28591974,85183295,8,0,1,6144,8,3334514010
7981,56592020,16903762,73495782,2,0,0,7680,3,6897319379
7982,56592510,16706770,73299280,5,0,0,2048,10,2301850642
7983,56603320,16401184,73004504,0,0,0,3584,3,8631887132
7984,56605149,15941921,72547070,1,0,0,512,10,2313421378
7985,56609819,16159230,72769049,3,0,0,10240,17,729985420
7986,56610461,28591471,85201932,8,0,1,3072,8,5204152628
7987,56617269,16681364,73298633,3,0,0,35840,17,3742635544
7988,56630339,16241556,72871895,1,0,0,4096,10,4053688084
7989,56638551,28563404,85201955,5,0,1,512,10,3728615802
7990,56645490,16518788,73164278,0,0,0,133632,3,7101592403
7991,56646059,15955378,72601437,1,0,0,1024,10,2133072218
7992,56646181,28555797,85201978,8,0,1,1024,8,8470195451
7993,56649391,15982876,72632267,7,0,0,1024,10,7739425664
7994,56651931,16675041,73326972,7,0,0,512,10,3353987627
7995,56666721,28537200,85203921,8,0,1,23552,8,3939856319
7996,56668549,16285223,72953772,3,0,0,3072,17,1730224559
7997,56670811,28553278,85224089,5,0,1,5632,10,1319880279
7998,56677010,16076704,72753714,6,0,0,4608,7,10478500201
7999,56704490,15960760,72665250,4,0,0,512,15,6215241541
8000,56707509,16801063,73508572,1,0,0,512,10,9145080314
8001,56709970,16542944,73252914,6,0,0,82432,7,1202080127
8002,56711121,28512991,85224112,5,0,1,1536,10,3415327442
8003,56715421,28510363,85225784,5,0,1,8704,10,7884979274
8004,56717849,16722588,73440437,3,0,0,150016,17,1906674993
8005,56720959,16781242,73502201,3,0,0,20992,17,3026216200
8006,56734631,16086461,72821092,7,0,0,1536,10,3043811941
8007,56739670,16655036,73394706,6,0,0,54272,7,4333732756
8008,56739900,16753076,73492976,2,0,0,151040,3,6042488515
8009,56740420,16285094,73025514,6,0,0,18944,7,9342425158
8010,56783040,16517378,73300418,5,0,0,3072,10,7649876739
8011,56819611,16194746,73014357,7,0,0,2048,10,8562909111
8012,56825820,28429263,85255083,7,0,1,21504,10,6098075870
8013,56826940,16881811,73708751,6,0,0,23552,7,8230859454
8014,56827210,16396619,73223829,0,0,0,10240,3,10240550781
8015,56830929,16213707,73044636,1,0,0,1024,10,5008467087
8016,56832650,16809172,73641822,0,0,0,66560,3,3415745185
8017,56838731,15982540,72821271,7,0,0,512,10,4963535012
8018,56840670,28415719,85256389,0,0,1,2048,3,3720670760
8019,56844340,16417200,73261540,4,0,0,512,15,10667007887
8020,56866390,16345693,73212083,4,0,0,512,15,26369127
8021,56867440,16394591,73262031,4,0,0,1536,15,7517570261
8022,56877439,16086821,72964260,1,0,0,512,10,4933623623
8023,56878230,16148280,73026510,5,0,0,2048,10,919050567
8024,56893529,16628148,73521677,1,0,0,512,10,3834310336
8025,56894429,16921830,73816259,3,0,0,53760,17,3626302675
8026,56894600,16647532,73542132,0,0,0,44032,3,9943648481
8027,56904490,16143398,73047888,5,0,0,512,10,295650143
8028,56918031,16381428,73299459,7,0,0,512,10,7507105069
8029,56928959,16332402,73261361,3,0,0,27648,17,8830881101
8030,56933650,16287036,73220686,2,0,0,28160,3,155129717
8031,56933950,17054264,73988214,0,0,0,74752,3,7595478141
8032,56935880,16764547,73700427,2,0,0,12288,3,9715841034
8033,56936189,16566854,73503043,1,0,0,2048,10,4457012247
8034,56939220,16794392,73733612,5,0,0,33792,10,3915046577
8035,56950439,16791282,73741721,3,0,0,4608,17,7042307543
8036,56961740,16307022,73268762,5,0,0,22016,10,3528452445
8037,56968440,17263783,74232223,0,0,0,100864,3,4234959833
8038,56980210,16819646,73799856,5,0,0,91136,10,2116197788
8039,56987489,28323936,85311425,4,0,1,3584,15,6878757341
8040,57004750,16439953,73444703,0,0,0,12288,3,7125991832
8041,57011860,17069371,74081231,2,0,0,10752,3,7994658274
8042,57015161,16708132,73723293,7,0,0,512,10,1619082264
8043,57023730,16423203,73446933,4,0,0,512,15,9691177493
8044,57030690,16197062,73227752,6,0,0,12800,7,4039429671
8045,57051910,16715329,73767239,6,0,0,1536,7,2321679049
8046,57066880,16750034,73816914,4,0,0,2048,15,700374326
8047,57080320,16911684,73992004,4,0,0,1024,15,1404027198
8048,57082870,16506931,73589801,2,0,0,17408,3,9824917420
8049,57085900,17254890,74340790,6,0,0,163840,7,9550316597
8050,57086859,16491564,73578423,1,0,0,512,10,3795289573
8051,57099241,28217066,85316307,8,0,1,3072,8,8746103357
8052,57099831,16402565,73502396,7,0,0,512,10,8033888930
8053,57105090,16400940,73506030,2,0,0,9728,3,837252702
8054,57110619,16336135,73446754,3,0,0,6656,17,1989256272
8055,57127260,16620319,73747579,4,0,0,512,15,1317623202
8056,57143801,16218378,73362179,7,0,0,512,10,6773656277
8057,57179760,17188335,74368095,4,0,0,512,15,3756969704
8058,57179820,17082075,74261895,6,0,0,78848,7,284273167
8059,57190790,16317603,73508393,2,0,0,7680,3,8386037704
8060,57214090,16894271,74108361,5,0,0,34816,10,10076547074
8061,57224450,16353794,73578244,4,0,0,512,15,1979799171
8062,57232199,17135492,74367691,3,0,0,46080,17,8837653237
8063,57235330,16257981,73493311,4,0,0,1024,15,1122906181
8064,57235680,17215700,74451380,2,0,0,64000,3,2480828044
8065,57236310,17321584,74557894,5,0,0,512,10,4281297940
8066,57255319,17161695,74417014,3,0,0,31232,17,7634600981
8067,57263060,16498423,73761483,2,0,0,13824,3,2511867160
8068,57266261,17284040,74550301,7,0,0,7168,10,303578
8069,57271530,16370471,73642001,4,0,0,512,15,483464934
8070,57277149,17436113,74713262,1,0,0,1024,10,135031579
8071,57283180,16157756,73440936,4,0,0,1536,15,9955828903
8072,57290299,28026031,85316330,4,0,1,1024,15,10131678842
8073,57294469,16452105,73746574,1,0,0,512,10,2670620514
8074,57295520,17136337,74431857,5,0,0,48640,10,4360009981
8075,57317719,16528592,73846311,3,0,0,83968,17,8617564796
8076,57327749,16750183,74077932,1,0,0,512,10,6667245751
8077,57345989,27970364,85316353,4,0,1,1024,15,10192702143
8078,57370940,17302394,74673334,6,0,0,79872,7,1992958294
8079,57386070,17214850,74600920,2,0,0,21504,3,4595494118
8080,57390479,17415648,74806127,3,0,0,28672,17,3501612047
8081,57392650,17502431,74895081,6,0,0,19456,7,7912459750
8082,57397470,16864604,74262074,4,0,0,512,15,3531414220
8083,57399529,16455806,73855335,1,0,0,512,10,5942882421
8084,57409489,27906887,85316376,4,0,1,512,15,5772235822
8085,57411130,27905269,85316399,3,0,1,3584,17,9760021452
8086,57411819,27904603,85316422,4,0,1,17920,15,4934583505
8087,57413231,16715619,74128850,7,0,0,47104,10,5808297051
8088,57418751,16600854,74019605,7,0,0,12288,10,3432723335
8089,57425081,17287838,74712919,7,0,0,81920,10,6718405887
8090,57438199,27886711,85324910,4,0,1,9216,15,8849882425
8091,57443419,27885677,85329096,4,0,1,6656,15,8334771626
8092,57447730,16543939,73991669,2,0,0,11264,3,10281030744
8093,57452969,27890684,85343653,4,0,1,1536,15,9779849877
8094,57455830,16496647,73952477,2,0,0,58880,3,766028971
8095,57463399,27880277,85343676,4,0,1,1024,15,1726602288
8096,57465460,16389680,73855140,2,0,0,17408,3,10335656435
8097,57469269,27876049,85345318,4,0,1,4096,15,2007704142
8098,57471699,16761015,74232714,1,0,0,1536,10,8818635509
8099,57487230,16275089,73762319,4,0,0,512,15,10040219080
8100,57498890,17292177,74791067,5,0,0,59904,10,3828720272
8101,57508040,16507798,74015838,2,0,0,4096,3,3708197110
8102,57525340,16295364,73820704,5,0,0,12288,10,5389623617
8103,57540900,16499076,74039976,4,0,0,1536,15,4994338536
8104,57549349,27796315,85345664,4,0,1,512,15,3507056510
8105,57570089,27776241,85346330,4,0,1,1024,15,8186565944
8106,57571691,16278122,73849813,7,0,0,10240,10,4275464872
8107,57573629,16504124,74077753,3,0,0,62464,17,2450237761
8108,57573631,16571801,74145432,7,0,0,45056,10,6765181682
8109,57574579,27789619,85364198,4,0,1,11776,15,3604849131
8110,57578099,16268571,73846670,1,0,0,1024,10,7694591552
8111,57585390,16822085,74407475,5,0,0,22016,10,5400485990
8112,57587440,16404751,73992191,4,0,0,512,15,2664438290
8113,57613141,16740487,74353628,7,0,0,40448,10,4548343855
8114,57619770,16277128,73896898,2,0,0,7680,3,8967993697
8115,57622420,17147241,74769661,2,0,0,7680,3,5531312058
8116,57635020,16522447,74157467,5,0,0,39424,10,8586400847
8117,57656060,16613392,74269452,5,0,0,23552,10,4339279394
8118,57682170,16408193,74090363,5,0,0,17408,10,3574642761
8119,57683930,16714966,74398896,5,0,0,91136,10,7852237109
8120,57684019,27692421,85376440,4,0,1,8704,15,4611049941
8121,57695821,17038710,74734531,7,0,0,27648,10,2528603650
8122,57701380,16779067,74480447,2,0,0,45056,3,362238920
8123,57708840,16553413,74262253,2,0,0,512,3,10337641895
8124,57718819,16649097,74367916,1,0,0,512,10,10577143320
8125,57725900,17097410,74823310,5,0,0,56320,10,1752703913
8126,57726240,16431406,74157646,4,0,0,512,15,648708822
8127,57732010,17103670,74835680,6,0,0,27648,7,6382310727
8128,57746109,27633258,85379367,4,0,1,11776,15,1314947343
8129,57760091,27628608,85388699,5,0,1,14848,10,7825280109
8130,57764069,27626896,85390965,4,0,1,3584,15,5228278346
8131,57766560,17194799,74961359,5,0,0,1536,10,828052223
8132,57772910,16568371,74341281,4,0,0,1536,15,4688220212
8133,57779081,16908855,74687936,7,0,0,23040,10,10670353637
8134,57779770,16511077,74290847,2,0,0,70144,3,8470560697
8135,57783119,27608832,85391951,4,0,1,1536,15,8555657433
8136,57785711,27606906,85392617,5,0,1,1024,10,5971804624
8137,57797809,27595794,85393603,4,0,1,1536,15,1180819775
8138,57805790,27592319,85398109,8,0,1,7168,8,7036055720
8139,57809090,17220122,75029212,4,0,0,2560,15,662476774
8140,57810160,27614840,85425000,0,0,1,512,3,8207103306
8141,57814170,16317511,74131681,2,0,0,9216,3,445647050
8142,57824469,27603117,85427586,4,0,1,4096,15,7219610753
8143,57832410,27596456,85428866,0,0,1,14336,3,9980674549
8144,57834069,27595783,85429852,4,0,1,1536,15,9642260530
8145,57835990,16535115,74371105,5,0,0,9728,10,1198294829
8146,57836710,17186676,75023386,6,0,0,5120,7,7206352945
8147,57842251,27590507,85432758,5,0,1,4608,10,7045538656
8148,57842640,27615236,85457876,0,0,1,4608,3,493190466
8149,57846611,27615131,85461742,5,0,1,6144,10,9058115487
8150,57855841,27617031,85472872,5,0,1,13312,10,8978610665
8151,57861140,27620183,85481323,0,0,1,2560,3,1684037141
8152,57863420,27645894,85509314,8,0,1,11264,8,10350493655
8153,57866860,16599675,74466535,5,0,0,49664,10,5779337521
8154,57870571,17353140,75223711,7,0,0,34304,10,8881702109
8155,57879180,27682659,85561839,8,0,1,10240,8,1813829574
8156,57880251,27699554,85579805,8,0,1,5120,8,1211930391
8157,57890761,27731240,85622001,5,0,1,26624,10,5520172593
8158,57894131,27755328,85649459,8,0,1,18944,8,10377050021
8159,57898931,27780759,85679690,5,0,1,3584,10,7568562786
8160,57900459,27831119,85731578,4,0,1,7680,15,9046099502
8161,57901940,17225108,75127048,5,0,0,55808,10,1156393167
8162,57907559,17007062,74914621,1,0,0,512,10,8154265319
8163,57926209,16988233,74914442,3,0,0,35840,17,4903062564
8164,57928161,16794524,74722685,7,0,0,13312,10,2208010673
8165,57928431,27803170,85731601,8,0,1,7680,8,4221526979
8166,57929640,16664705,74594345,6,0,0,34304,7,467117913
8167,57932820,17463015,75395835,4,0,0,512,15,331459880
8168,57935170,16713805,74648975,6,0,0,15872,7,6928950104
8169,57940539,16588450,74528989,3,0,0,28672,17,6715172669
8170,57946060,16601634,74547694,5,0,0,12288,10,8669258687
8171,57948889,16940241,74889130,3,0,0,36352,17,5948977041
8172,57952141,16815157,74767298,7,0,0,84480,10,7827303182
8173,57952179,16990403,74942582,3,0,0,42496,17,10203882602
8174,57960589,16914246,74874835,1,0,0,1536,10,10067640072
8175,57963301,17146720,75110021,7,0,0,54784,10,7482157559
8176,57967219,16570954,74538173,3,0,0,11264,17,8693884267
8177,57968030,17358972,75327002,6,0,0,165888,7,7673512121
8178,57973071,27759095,85732166,5,0,1,7168,10,4308777094
8179,57976880,17371118,75347998,2,0,0,16384,3,3455600161
8180,57982779,27762867,85745646,4,0,1,8192,15,7189045229
8181,58000790,16826443,74827233,5,0,0,12800,10,4622479251
8182,58002881,27819718,85822599,5,0,1,5120,10,6407008773
8183,58021690,17212462,75234152,5,0,0,32256,10,1061791669
8184,58026450,17001951,75028401,5,0,0,16384,10,9345806933
8185,58028430,17027172,75055602,5,0,0,35840,10,5658325921
8186,58037821,17136511,75174332,7,0,0,44032,10,6092336425
8187,58047089,16878340,74925429,1,0,0,1024,10,651402332
8188,58052289,17288955,75341244,1,0,0,1536,10,267015152
8189,58057330,16917134,74974464,4,0,0,2560,15,4724406215
8190,58059301,27911160,85970461,5,0,1,15872,10,8456874007
8191,58066580,16807764,74874344,6,0,0,41472,7,5693314614
8192,58082340,17310680,75393020,6,0,0,53760,7,2455090937
8193,58084120,16641964,74726084,4,0,0,512,15,9747382618
8194,58084699,17308679,75393378,1,0,0,1024,10,1803020279
8195,58085881,27885886,85971767,8,0,1,2048,8,2903797320
8196,58090010,28027576,86117586,2,0,1,13312,3,8311977093
8197,58092941,28024668,86117609,5,0,1,7168,10,4048418076
8198,58097881,28019751,86117632,5,0,1,5120,10,4380052790
8199,58108379,17021055,75129434,1,0,0,512,10,6531359221
8200,58108639,17350624,75459263,3,0,0,55808,17,5436515642
8201,58115211,28002444,86117655,8,0,1,6144,8,1753534889
8202,58120101,17074751,75194852,7,0,0,4096,10,270216944
8203,58132410,27989327,86121737,2,0,1,512,3,1132103194
8204,58144200,27987612,86131812,2,0,1,25088,3,4873610502
8205,58149691,16871933,75021624,7,0,0,66560,10,8257609876
8206,58170421,28062097,86232518,8,0,1,18944,8,2587351244
8207,58172261,28060659,86232920,8,0,1,512,8,7944231591
8208,58176770,16673905,74850675,4,0,0,512,15,10360995207
8209,58187990,16687318,74875308,4,0,0,1024,15,9205293201
8210,58192119,16865089,75057208,1,0,0,1024,10,8634566315
8211,58196451,28037135,86233586,8,0,1,1024,8,2999219176
8212,58211360,28023212,86234572,2,0,1,1536,3,2579200393
8213,58214500,28061704,86276204,9,0,1,7680,12,10063072117
8214,58215220,16925338,75140558,4,0,0,512,15,9461537555
8215,58224060,16832813,75056873,6,0,0,4096,7,10579251244
8216,58230821,28045406,86276227,5,0,1,512,10,1653332769
8217,58235579,16946649,75182228,3,0,0,24576,17,2087821368
8218,58249790,28026460,86276250,2,0,1,4608,3,6401646520
8219,58252219,28024054,86276273,4,0,1,512,15,9125332160
8220,58253279,16888815,75142094,1,0,0,512,10,7397406482
8221,58253939,17292840,75546779,3,0,0,5120,17,5699926806
8222,58260390,17147270,75407660,2,0,0,31232,3,5870679409
8223,58272580,28003716,86276296,2,0,1,512,3,6142362260
8224,58275800,16937436,75213236,2,0,0,20480,3,10012889446
8225,58278791,27997528,86276319,8,0,1,4608,8,8418925769
8226,58284550,16737253,75021803,4,0,0,512,15,3801692315
8227,58288499,16776220,75064719,3,0,0,24576,17,1489720389
8228,58295069,16838377,75133446,3,0,0,11776,17,5384954267
8229,58295191,27992414,86287605,8,0,1,2048,8,1768560120
8230,58298771,27988857,86287628,5,0,1,512,10,7050834106
8231,58308191,27979460,86287651,5,0,1,4096,10,3394315649
8232,58312951,27991306,86304257,5,0,1,10752,10,2040996752
8233,58317869,16867814,75185683,1,0,0,11264,10,10091161321
8234,58322090,17223106,75545196,5,0,0,100352,10,7070283404
8235,58325010,17189096,75514106,2,0,0,122368,3,9496209936
8236,58326809,17013944,75340753,1,0,0,45056,10,9107762653
8237,58351970,17081027,75432997,5,0,0,17408,10,10400424071
8238,58382921,27927178,86310099,8,0,1,12288,8,8924024329
8239,58384280,16958703,75342983,2,0,0,5632,3,7633639826
8240,58385391,27974777,86360168,5,0,1,8192,10,5541532980
8241,58388390,16740865,75129255,0,0,0,7168,3,10461521812
8242,58390360,16854928,75245288,5,0,0,20480,10,6542134799
8243,58404001,27991359,86395360,8,0,1,13312,8,9216014545
8244,58414000,16734706,75148706,4,0,0,2048,15,6225084167
8245,58416770,16938228,75354998,6,0,0,10752,7,9137798507
8246,58418421,27976962,86395383,5,0,1,4096,10,6815902393
8247,58419350,16856491,75275841,6,0,0,1024,7,1017071412
8248,58423930,16924247,75348177,4,0,0,512,15,2025797847
8249,58426730,16934063,75360793,0,0,0,18944,3,4546318224
8250,58427020,28013121,86440141,7,0,1,29696,10,7839080241
8251,58439830,17409996,75849826,0,0,0,52224,3,5998600555
8252,58440290,28028836,86469126,0,0,1,1024,3,3025405434
8253,58447589,17179226,75626815,3,0,0,45568,17,8799687197
8254,58454081,28018632,86472713,5,0,1,6656,10,2930043317
8255,58454130,17060467,75514597,4,0,0,1536,15,2443842678
8256,58461240,17222506,75683746,5,0,0,3072,10,2624242868
8257,58472530,28000529,86473059,0,0,1,512,3,9734296869
8258,58473059,17153935,75626994,1,0,0,512,10,2111326311
8259,58484311,27988902,86473213,5,0,1,8704,10,9062704248
8260,58484820,17229481,75714301,2,0,0,89600,3,9319988948
8261,58486560,28175493,86662053,7,0,1,6144,10,10579552408
8262,58490370,17393073,75883443,6,0,0,32256,7,6320647654
8263,58494239,17247887,75742126,1,0,0,11264,10,4807804167
8264,58497690,28199942,86697632,2,0,1,5632,3,2940211167
8265,58499389,17220604,75719993,1,0,0,15872,10,8668637742
8266,58500779,17429705,75930484,3,0,0,48640,17,4289104969
8267,58502060,28200078,86702138,8,0,1,7168,8,7463008053
8268,58507670,28319520,86827190,7,0,1,21504,10,2321392889
8269,58513850,17303580,75817430,4,0,0,1024,15,10463596364
8270,58524710,16883978,75408688,2,0,0,3072,3,5476468575
8271,58525750,28301594,86827344,7,0,1,8704,10,3143317969
8272,58527200,17346384,75873584,2,0,0,31744,3,2938085416
8273,58527481,17217632,75745113,7,0,0,9728,10,3226475288
8274,58533550,28294140,86827690,2,0,1,512,3,3513372831
8275,58533740,17454050,75987790,2,0,0,8704,3,9037542416
8276,58534840,17241126,75775966,2,0,0,80384,3,7700909152
8277,58537889,17455072,75992961,1,0,0,16896,10,1792093784
8278,58544559,17812179,76356738,1,0,0,13312,10,10361869267
8279,58552801,17254911,75807712,7,0,0,59392,10,1895710688
8280,58561440,28270436,86831876,9,0,1,6656,12,4453571080
8281,58571210,16991360,75562570,0,0,0,13312,3,3562094004
8282,58589999,17317951,75907950,3,0,0,26112,17,8717941126
8283,58601141,17283261,75884402,7,0,0,3072,10,5111224378
8284,58601730,28256533,86858263,9,0,1,1536,12,3485309210
8285,58605419,17372987,75978406,3,0,0,38400,17,7228279228
8286,58607231,17483303,76090534,7,0,0,54272,10,406978011
8287,58613560,17250329,75863889,0,0,0,46080,3,1949042764
8288,58630499,17872359,76502858,3,0,0,37376,17,3878156270
8289,58630941,17097198,75728139,7,0,0,1536,10,4878736731
8290,58633570,28224716,86858286,9,0,1,5120,12,6105144587
8291,58633850,17564807,76198657,6,0,0,43008,7,9372646035
8292,58636110,28272669,86908779,7,0,1,12800,10,8802600804
8293,58642351,17543156,76185507,7,0,0,6144,10,6805177089
8294,58647920,28513878,87161798,7,0,1,105472,10,5621373402
8295,58652351,17309415,75961766,7,0,0,31232,10,6992769266
8296,58653571,28508250,87161821,8,0,1,3072,8,4971043108
8297,58656859,17286345,75943204,1,0,0,30208,10,9291815120
8298,58669570,17058078,75727648,0,0,0,18432,3,2478597692
8299,58673460,28488392,87161852,9,0,1,13312,12,8579339046
8300,58675590,17889305,76564895,0,0,0,21504,3,3401756603
8301,58678241,28483634,87161875,8,0,1,2048,8,10078644903
8302,58684050,28477848,87161898,7,0,1,1024,10,9644089535
8303,58686720,17496892,76183612,6,0,0,48128,7,4894077918
8304,58693461,28468460,87161921,8,0,1,3072,8,601736962
8305,58696060,17727000,76423060,6,0,0,30208,7,108228556
8306,58698240,28463704,87161944,8,0,1,3072,8,10686597401
8307,58704760,17334327,76039087,5,0,0,1024,10,8412312169
8308,58705519,17238956,75944475,3,0,0,4096,17,10609044102
8309,58707841,17109254,75817095,7,0,0,30720,10,3976753560
8310,58711830,28450137,87161967,7,0,1,7168,10,8355523028
8311,58724590,28437400,87161990,8,0,1,4608,8,6860741949
8312,58730850,17583302,76314152,0,0,0,27648,3,4915957722
8313,58733130,28450699,87183829,7,0,1,54272,10,705076406
8314,58735390,17338585,76073975,5,0,0,36352,10,2202696341
8315,58743210,17765622,76508832,6,0,0,19456,7,4511239434
8316,58752600,17268945,76021545,0,0,0,18432,3,10476119564
8317,58757500,17154958,75912458,4,0,0,2048,15,7904219043
8318,58768250,17280314,76048564,4,0,0,512,15,6695781052
8319,58768501,17353802,76122303,7,0,0,10240,10,2412576299
8320,58769930,28413922,87183852,8,0,1,7168,8,1804962514
8321,58775120,17530585,76305705,5,0,0,36352,10,2534809331
8322,58788810,28395065,87183875,9,0,1,2048,12,7109836888
8323,58789990,17746128,76536118,4,0,0,512,15,2367634695
8324,58791449,17377476,76168925,3,0,0,34304,17,6164351373
8325,58793011,17545897,76338908,7,0,0,56832,10,1993061486
8326,58795159,17561945,76357104,1,0,0,1024,10,2453844509
8327,58802360,28399855,87202215,9,0,1,7168,12,2456916065
8328,58805090,17547569,76352659,6,0,0,45056,7,7398729269
8329,58808200,28394038,87202238,7,0,1,512,10,7252427747
8330,58821979,18141222,76963201,3,0,0,51712,17,2317459369
8331,58823049,17543126,76366175,1,0,0,29696,10,8811542359
8332,58823589,17700398,76523987,1,0,0,49664,10,534017226
8333,58827860,28391748,87219608,9,0,1,7680,12,8948164409
8334,58830021,18159298,76989319,7,0,0,42496,10,443587604
8335,58830070,17845314,76675384,0,0,0,39424,3,2667899164
8336,58848540,17768076,76616616,2,0,0,56320,3,6436303219
8337,58852540,28375114,87227654,8,0,1,512,8,4220018276
8338,58855050,17807302,76662352,5,0,0,11776,10,3747143704
8339,58864490,17626957,76491447,0,0,0,110592,3,6667121778
8340,58865710,17413513,76279223,5,0,0,11776,10,8702889084
8341,58876070,18061181,76937251,2,0,0,43008,3,6350026980
8342,58889931,18222019,77111950,7,0,0,27648,10,6070735659
8343,58892860,28335255,87228115,7,0,1,10240,10,3934244735
8344,58894230,17480166,76374396,6,0,0,6144,7,6876024763
8345,58898590,17882376,76780966,5,0,0,11776,10,7469335059
8346,58902140,17656180,76558320,0,0,0,42496,3,7111882918
8347,58902290,17858957,76761247,2,0,0,62464,3,8722846185
8348,58904580,18016793,76921373,2,0,0,14848,3,380818000
8349,58914380,28326030,87240410,7,0,1,6656,10,10242333742
8350,58914470,17722784,76637254,5,0,0,62464,10,2085964281
8351,58916550,17948867,76865417,6,0,0,19456,7,6174999067
8352,58917130,17670728,76587858,6,0,0,12288,7,7197369592
8353,58922330,28341034,87263364,7,0,1,512,10,202958063
8354,58932570,28331460,87264030,7,0,1,11264,10,6953041795
8355,58941370,28324845,87266215,9,0,1,1024,12,4029078549
8356,58944880,28323601,87268481,9,0,1,3584,12,4335987902
8357,58958110,28311997,87270107,9,0,1,2560,12,2601353427
8358,58968819,17860954,76829773,1,0,0,59392,10,2082537219
8359,58975860,17603575,76579435,0,0,0,16384,3,150143643
8360,58977050,28294683,87271733,7,0,1,2560,10,3433434359
8361,58980450,18210744,77191194,6,0,0,15360,7,6693094842
8362,59003361,17532578,76535939,7,0,0,8704,10,10727119063
8363,59005030,28358204,87363234,7,0,1,6656,10,6438619346
8364,59016200,17701970,76718170,6,0,0,17408,7,7216677898
8365,59017959,18300084,77318043,1,0,0,140288,10,241300804
8366,59018009,17600190,76618199,1,0,0,5120,10,4306449293
8367,59026299,17781156,76807455,1,0,0,39936,10,3843443279
8368,59028910,17570515,76599425,6,0,0,37888,7,4867950939
8369,59038620,28327780,87366400,7,0,1,2560,10,8074538858
8370,59044610,18230666,77275276,0,0,0,45568,3,9708370629
8371,59072490,17575099,76647589,6,0,0,33792,7,5403109724
8372,59094160,17819289,76913449,4,0,0,43520,15,4245748656
8373,59100630,18513649,77614279,5,0,0,278528,10,618738077
8374,59111770,28257741,87369511,3,0,1,15872,17,313187416
8375,59124200,17886358,77010558,2,0,0,69632,3,7899094554
8376,59124520,17709488,76834008,2,0,0,13824,3,971485289
8377,59126660,28248092,87374752,9,0,1,7680,12,10334620418
8378,59136740,17985729,77122469,4,0,0,7168,15,3561978747
8379,59138031,17809383,76947414,7,0,0,33280,10,8958288758
8380,59140060,28237469,87377529,9,0,1,1024,12,8766375097
8381,59153430,28282225,87435655,7,0,1,15872,10,2301827435
8382,59164840,18341559,77506399,4,0,0,10752,15,7246960918
8383,59165220,28288217,87453437,3,0,1,9728,17,1229256208
8384,59169890,28298984,87468874,9,0,1,11264,12,8261237680
8385,59170660,18566778,77737438,4,0,0,58880,15,8484957678
8386,59181130,18065134,77246264,2,0,0,59392,3,1547644325
8387,59184340,28284557,87468897,3,0,1,1536,17,154690155
8388,59186660,28282260,87468920,3,0,1,512,17,1197763793
8389,59194180,18444728,77638908,5,0,0,23552,10,4715669731
8390,59197550,28272250,87469800,3,0,1,2048,17,8066058221
8391,59211630,28275306,87486936,9,0,1,1536,12,5077252493
8392,59214260,28273022,87487282,7,0,1,512,10,6926916649
8393,59220401,17966090,77186491,7,0,0,18432,10,2659662099
8394,59230980,28259528,87490508,9,0,1,5120,12,9638124621
8395,59233320,28297812,87531132,7,0,1,8704,10,6333084423
8396,59235150,18083696,77318846,0,0,0,2560,3,2436962150
8397,59251410,28284760,87536170,3,0,1,2560,17,8962809685
8398,59257430,18000794,77258224,0,0,0,24576,3,857806684
8399,59257650,17892445,77150095,5,0,0,19968,10,9631223594
8400,59258100,28278093,87536193,9,0,1,5632,12,10313980224
8401,59260110,17843393,77103503,4,0,0,31744,15,9744434294
8402,59260620,28275596,87536216,3,0,1,1536,17,5563425649
8403,59272790,17764826,77037616,2,0,0,10752,3,2632992257
8404,59276290,18056003,77332293,4,0,0,44032,15,698517289
8405,59299370,18463349,77762719,4,0,0,39424,15,8321525431
8406,59302910,28233329,87536239,3,0,1,20480,17,1378458362
8407,59304250,28232012,87536262,7,0,1,512,10,2333444392
8408,59313330,28222955,87536285,3,0,1,10240,17,8615427551
8409,59320100,28216208,87536308,8,0,1,4096,8,6732079961
8410,59320700,18104342,77425042,0,0,0,5632,3,3047739251
8411,59336440,17738361,77074801,2,0,0,3072,3,9128181124
8412,59339140,28197191,87536331,1,0,1,5120,10,3710507045
8413,59344559,18051170,77395729,1,0,0,149504,10,5299746308
8414,59345800,17988723,77334523,5,0,0,7168,10,2221335898
8415,59346260,28190094,87536354,9,0,1,512,12,10669410920
8416,59353420,28182957,87536377,8,0,1,5120,8,253552802
8417,59355710,18275376,77631086,0,0,0,45568,3,4393883154
8418,59362530,18443679,77806209,6,0,0,38400,7,2500659003
8419,59373280,28163120,87536400,9,0,1,512,12,8890760622
8420,59393090,28143341,87536431,9,0,1,2560,12,6676761187
8421,59396030,28140424,87536454,3,0,1,6656,17,8344431245
8422,59402120,18372813,77774933,5,0,0,30720,10,10069173114
8423,59425030,18720192,78145222,6,0,0,30720,7,8539947727
8424,59431440,28141814,87573254,8,0,1,5632,8,1690136558
8425,59432850,18271036,77703886,4,0,0,110080,15,3700420842
8426,59438780,28158233,87597013,8,0,1,2560,8,9382592951
8427,59440400,28156869,87597269,3,0,1,9216,17,10203217084
8428,59450570,18335774,77786344,4,0,0,37376,15,6255543089
8429,59455820,28165084,87620904,3,0,1,2048,17,8514696276
8430,59481500,18284050,77765550,4,0,0,9216,15,7421381730
8431,59483570,18044160,77527730,0,0,0,29696,3,4332627355
8432,59501090,28140047,87641137,8,0,1,19456,8,8968196262
8433,59511789,18386586,77898375,1,0,0,97792,10,6248962144
8434,59515580,28129103,87644683,8,0,1,5632,8,2216274766
8435,59518470,18144752,77663222,6,0,0,10240,7,8852647339
8436,59527210,28118779,87645989,9,0,1,2048,12,9802344272
8437,59531490,18085666,77617156,2,0,0,9216,3,7054002405
8438,59535630,18283313,77818943,5,0,0,4096,10,10521972343
8439,59575359,18065132,77640491,1,0,0,5120,10,9026858191
8440,59584580,28089890,87674470,3,0,1,8192,17,5282815481
8441,59586090,28091000,87677090,9,0,1,16896,12,246280391
8442,59590010,18114679,77704689,5,0,0,2560,10,4634396007
8443,59598200,18316110,77914310,0,0,0,52224,3,9816496123
8444,59604150,28103660,87707810,9,0,1,512,12,9778198021
8445,59612760,28095073,87707833,3,0,1,512,17,4367323967
8446,59617690,28100230,87717920,9,0,1,12288,12,3265614863
8447,59622100,28097766,87719866,9,0,1,3072,12,4222072188
8448,59625060,28094960,87720020,1,0,1,8704,10,3673254546
8449,59625200,18590870,78216070,4,0,0,25088,15,1434005508
8450,59629630,28145816,87775446,0,0,1,12288,3,8587109335
8451,59631920,28162047,87793967,9,0,1,4096,12,1520444798
8452,59652319,18615635,78267954,1,0,0,62464,10,6365262304
8453,59653810,18338419,77992229,6,0,0,5120,7,8817913307
8454,59656750,28138203,87794953,9,0,1,1536,12,4447480425
8455,59659740,28138439,87798179,3,0,1,5120,17,9883079723
8456,59659760,28139405,87799165,0,0,1,1536,3,1387640935
8457,59660730,18396648,78057378,5,0,0,512,10,2401806044
8458,59668000,28160175,87828175,9,0,1,10752,12,10396457004
8459,59674720,28218428,87893148,1,0,1,1024,10,2279006744
8460,59683790,18590895,78274685,4,0,0,22016,15,5091551789
8461,59686110,28207061,87893171,9,0,1,4608,12,9610327947
8462,59686470,18229267,77915737,6,0,0,4608,7,7457306729
8463,59721189,18397578,78118767,1,0,0,99840,10,7928811088
8464,59722100,18700410,78422510,2,0,0,62976,3,3445766336
8465,59724350,18456487,78180837,6,0,0,30208,7,7518614048
8466,59724910,18120576,77845486,6,0,0,5120,7,8820992129
8467,59732571,28160623,87893194,5,0,1,4608,10,5767282307
8468,59734020,28176378,87910398,9,0,1,4096,12,1082824586
8469,59739680,18557561,78297241,4,0,0,17408,15,8390877633
8470,59742870,28171842,87914712,9,0,1,18944,12,5521248396
8471,59743690,28265217,88008907,3,0,1,512,17,8552454882
8472,59746810,28262763,88009573,1,0,1,1024,10,10584722044
8473,59749840,28260079,88009919,9,0,1,512,12,7223254444
8474,59758470,18364867,78123337,4,0,0,14848,15,9782666537
8475,59765680,28249065,88014745,1,0,1,7680,10,5991020910
8476,59767980,28255462,88023442,1,0,1,2048,10,9600063633
8477,59787070,18432094,78219164,4,0,0,8192,15,4802666669
8478,59793950,28231118,88025068,9,0,1,2560,12,16433862
8479,59796570,28229484,88026054,9,0,1,1536,12,1600307709
8480,59801500,28227460,88028960,1,0,1,4608,10,357313111
8481,59802330,18667087,78469417,6,0,0,54272,7,10165175272
8482,59808330,18722157,78530487,0,0,0,71680,3,5042162832
8483,59809170,18594129,78403299,2,0,0,54784,3,4300001166
8484,59817450,28459463,88276913,6,0,1,36864,7,9597010361
8485,59822109,18481305,78303414,1,0,0,15872,10,8346127959
8486,59822340,28454596,88276936,7,0,1,8704,10,7939443373
8487,59824060,18758523,78582583,6,0,0,24064,7,7380528945
8488,59828030,18352986,78181016,5,0,0,512,10,694579334
8489,59831180,18402632,78233812,5,0,0,1536,10,1227327013
8490,59831620,18456202,78287822,5,0,0,1024,10,829693034
8491,59842150,18485494,78327644,0,0,0,34816,3,10408951157
8492,59842870,28434089,88276959,9,0,1,1024,12,9872941570
8493,59850569,18778171,78628740,1,0,0,78336,10,4489258254
8494,59850660,28584777,88435437,6,0,1,141312,7,7085832093
8495,59857320,18779266,78636586,5,0,0,1024,10,2829009076
8496,59871430,28633969,88505399,9,0,1,12288,12,2644367023
8497,59877780,28629194,88506974,6,0,1,8192,7,9740445505
8498,59895000,28867753,88762753,6,0,1,75776,7,8765473441
8499,59897130,18609121,78506251,0,0,0,16384,3,10671048837
8500,59915669,18844481,78760150,1,0,0,118272,10,1596802036
8501,59924670,18944326,78868996,4,0,0,84480,15,2183711217
8502,59931720,18994582,78926302,6,0,0,46592,7,695895202
8503,59932190,18791901,78724091,0,0,0,76800,3,1837122629
8504,59936340,18975735,78912075,5,0,0,141312,10,3806723559
8505,59937159,19007695,78944854,1,0,0,1024,10,10213386634
8506,59955710,18680541,78636251,2,0,0,24576,3,347044519
8507,59964190,28815769,88779959,0,0,1,15872,3,1427808555
8508,59966240,19099575,79065815,6,0,0,209920,7,9265875093
8509,59969390,28810592,88779982,7,0,1,9216,10,5874869989
8510,59972820,28807185,88780005,6,0,1,2560,7,10378239491
8511,59975829,18784500,78760329,1,0,0,512,10,7613459763
8512,59981179,19160842,79142021,1,0,0,85504,10,8201058386
8513,59981219,28798809,88780028,4,0,1,10240,15,9206703193
8514,59983809,19185468,79169277,1,0,0,5120,10,4250896196
8515,59986200,19181494,79167694,5,0,0,35840,10,2666779126
8516,59996660,18930289,78926949,5,0,0,2048,10,9477617117
8517,60009040,28784317,88793357,6,0,1,4608,7,1179719831
8518,60009650,28783762,88793412,7,0,1,3072,10,4490975785
8519,60010140,28809214,88819354,0,0,1,3072,3,7999425369
8520,60012100,28810480,88822580,0,0,1,5120,3,553112033
8521,60021950,28804496,88826446,9,0,1,6144,12,3064671889
8522,60025990,19054824,79080814,4,0,0,49152,15,293338060
8523,60029509,28800483,88829992,4,0,1,5632,15,5455661886
8524,60037850,19274445,79312295,0,0,0,58368,3,2104048836
8525,60039650,19292151,79331801,0,0,0,62976,3,5736097521
8526,60044659,28785692,88830351,4,0,1,9728,15,431355176
8527,60044660,28858252,88902912,6,0,1,25088,7,7775251031
8528,60048340,28878593,88926933,0,0,1,11264,3,928723059
8529,60056640,28873199,88929839,7,0,1,4608,10,6807054386
8530,60063360,28870985,88934345,0,0,1,7168,3,2338303419
8531,60066570,19027361,79093931,2,0,0,20992,3,1680667631
8532,60074960,19611984,79686944,0,0,0,47104,3,10025917898
8533,60077000,19005934,79082934,2,0,0,6656,3,8460783140
8534,60087880,19160015,79247895,6,0,0,59904,7,7830373086
8535,60097360,19478757,79576117,5,0,0,25600,10,10310569153
8536,60103649,28837148,88940797,4,0,1,10240,15,683323572
8537,60108611,28834452,88943063,5,0,1,3584,10,2707179135
8538,60110080,28842635,88952715,6,0,1,15360,7,7663199533
8539,60112080,19771822,79883902,6,0,0,51712,7,2151559400
8540,60118519,28838702,88957221,4,0,1,7168,15,5256399345
8541,60130750,18956754,79087504,5,0,0,14848,10,5171005088
8542,60133930,19014354,79148284,4,0,0,20480,15,7999768206
8543,60147090,19330957,79478047,0,0,0,23552,3,8617151527
8544,60154960,19185756,79340716,5,0,0,29184,10,6380395962
8545,60160570,28797317,88957887,7,0,1,1024,10,593775209
8546,60161499,28800254,88961753,4,0,1,6144,15,10533145754
8547,60163180,19307622,79470802,5,0,0,50176,10,6484219490
8548,60163209,19285921,79449130,1,0,0,14336,10,6030660022
8549,60176469,19892968,80069437,1,0,0,48128,10,4737917910
8550,60176540,19473014,79649554,5,0,0,115200,10,2945728097
8551,60176610,28825025,89001635,0,0,1,6144,3,8648430250
8552,60181010,28824171,89005181,0,0,1,5632,3,5471182252
8553,60182390,19223444,79405834,2,0,0,18432,3,7944777676
8554,60196399,28811074,89007473,4,0,1,3584,15,4084922201
8555,60201460,19089179,79290639,6,0,0,3584,7,2881886993
8556,60210560,19458632,79669192,4,0,0,64000,15,5557447005
8557,60211510,19202736,79414246,6,0,0,8704,7,436009472
8558,60211791,28859473,89071264,5,0,1,12800,10,9218226957
8559,60212380,19460189,79672569,5,0,0,10752,10,6589722547
8560,60214850,28856437,89071287,0,0,1,15360,3,10181611700
8561,60215400,28860480,89075880,6,0,1,5120,7,3226268699
8562,60215589,28860314,89075903,4,0,1,5120,15,5253970700
8563,60216149,19938842,80154991,1,0,0,14848,10,4080251911
8564,60216300,28859626,89075926,0,0,1,512,3,1191464595
8565,60218120,19894727,80112847,4,0,0,14336,15,7869740747
8566,60223030,28852919,89075949,0,0,1,2560,3,6948785572
8567,60241779,28834193,89075972,4,0,1,3584,15,5629647714
8568,60252940,28823234,89076174,7,0,1,14336,10,6877541128
8569,60256030,28820167,89076197,2,0,1,8704,3,408933288
8570,60256720,28829443,89086163,2,0,1,13824,3,4423504806
8571,60257620,28859947,89117567,0,0,1,9728,3,4660962130
8572,60261840,28867051,89128891,0,0,1,6144,3,1833285407
8573,60263610,19429176,79692786,5,0,0,4608,10,6881772871
8574,60266590,19883762,80150352,4,0,0,101376,15,8895859900
8575,60270509,28861244,89131753,4,0,1,3584,15,7287817167
8576,60275700,28874531,89150231,2,0,1,16384,3,2062296912
8577,60276370,19897536,80173906,0,0,0,61952,3,139760988
8578,60280900,28884125,89165025,2,0,1,6656,3,2657069475
8579,60284410,28942279,89226689,7,0,1,5120,10,10330533408
8580,60293600,19574523,79868123,0,0,0,80896,3,7074001977
8581,60294140,28943515,89237655,6,0,1,2560,7,9454965348
8582,60299660,19587260,79886920,5,0,0,9728,10,995114082
8583,60305150,28932528,89237678,0,0,1,10240,3,2027024809
8584,60305209,28963910,89269119,4,0,1,4096,15,6737065545
8585,60318740,28950402,89269142,6,0,1,2560,7,441275673
8586,60327250,28941915,89269165,6,0,1,3584,7,905303784
8587,60330630,28941966,89272596,6,0,1,3072,7,8124650653
8588,60332340,19358995,79691335,2,0,0,14336,3,4232537218
8589,60336870,19635513,79972383,6,0,0,37376,7,4237082675
8590,60341020,19426258,79767278,5,0,0,7168,10,6659086026
8591,60350700,19906142,80256842,8,0,0,35328,8,3164852949
8592,60351080,19757376,80108456,6,0,0,82944,7,3546031372
8593,60362770,28940404,89303174,2,0,1,3072,3,2003345056
8594,60365160,28949041,89314201,0,0,1,1024,3,9226935311
8595,60381680,28955199,89336879,6,0,1,3072,7,1319469307
8596,60408830,19584480,79993310,6,0,0,68608,7,3643344819
8597,60409549,28930556,89340105,4,0,1,5120,15,8630314225
8598,60420470,19585187,80005657,0,0,0,40448,3,7368686378
8599,60420670,28921381,89342051,0,0,1,3072,3,158684205
8600,60421170,19656871,80078041,6,0,0,17408,7,8516471527
8601,60421300,28964463,89385763,0,0,1,18432,3,5754334555
8602,60422600,28966320,89388920,0,0,1,9728,3,2408730922
8603,60433210,28956069,89389279,6,0,1,9728,7,4101183943
8604,60434610,19763079,80197689,2,0,0,18432,3,2740657094
8605,60441220,19919123,80360343,6,0,0,61440,7,143678823
8606,60451670,28954487,89406157,0,0,1,3072,3,1057149775
8607,60457170,19884291,80341461,6,0,0,89088,7,7067136566
8608,60464800,19849417,80314217,2,0,0,57344,3,5656559802
8609,60468070,20065906,80533976,8,0,0,6656,8,3843743440
8610,60474710,28934673,89409383,6,0,1,5120,7,7850295907
8611,60487459,20367897,80855356,1,0,0,4096,10,3399327588
8612,60488880,20214882,80703762,2,0,0,15360,3,2207797095
8613,60492459,19931729,80424188,3,0,0,43520,17,3439940373
8614,60493480,28916249,89409729,6,0,1,512,7,7642664871
8615,60495640,28916995,89412635,0,0,1,4608,3,1575348134
8616,60502960,19793762,80296722,2,0,0,26112,3,8258459960
8617,60513609,19759982,80273591,3,0,0,35328,17,8954274871
8618,60514749,19731306,80246055,1,0,0,18944,10,6309737873
8619,60518241,28899418,89417659,5,0,1,8704,10,746790815
8620,60525500,20219936,80745436,5,0,0,64000,10,10176579670
8621,60528960,28913492,89442452,8,0,1,2048,8,2228982282
8622,60530460,19837240,80367700,2,0,0,12288,3,8611162982
8623,60537199,20160893,80698092,3,0,0,49152,17,7295924294
8624,60546651,28898387,89445038,5,0,1,4096,10,7802877245
8625,60546721,28920058,89466779,5,0,1,22016,10,9784812600
8626,60555951,28910851,89466802,8,0,1,4096,8,1522289734
8627,60556720,20262982,80819702,0,0,0,13824,3,2298801088
8628,60560990,20122103,80683093,0,0,0,97280,3,3889646077
8629,60564470,19895400,80459870,0,0,0,13312,3,1432228376
8630,60564870,28902827,89467697,2,0,1,2048,3,9627554001
8631,60566490,19910444,80476934,8,0,0,29184,8,2958638000
8632,60570501,28921185,89491686,5,0,1,512,10,8633070039
8633,60591320,20310252,80901572,5,0,0,68096,10,6169749032
8634,60591450,28960805,89552255,2,0,1,19456,3,233114165
8635,60595780,19927655,80523435,0,0,0,76800,3,796178721
8636,60595830,20182381,80778211,6,0,0,15360,7,7522435955
8637,60603560,28957188,89560748,2,0,1,7680,3,6528469659
8638,60610170,28952811,89562981,2,0,1,512,3,2969519951
8639,60610809,20357232,80968041,1,0,0,4096,10,8908693109
8640,60623210,20150298,80773508,6,0,0,39424,7,6277738652
8641,60624550,20074509,80699059,4,0,0,3072,15,7392707344
8642,60625509,28938458,89563967,4,0,1,1536,15,9241011789
8643,60626050,28938903,89564953,2,0,1,1536,3,3321603604
8644,60630490,28937689,89568179,8,0,1,5120,8,3923769839
8645,60639870,20064897,80704767,6,0,0,3072,7,1685427194
8646,60644910,28974995,89619905,2,0,1,1024,3,5667743284
8647,60646500,20366901,81013401,5,0,0,6656,10,2581706953
8648,60659639,19938149,80597788,1,0,0,23040,10,9626157146
8649,60667370,20694166,81361536,6,0,0,11264,7,5436315959
8650,60669400,20121130,80790530,5,0,0,12288,10,714951582
8651,60683930,28935998,89619928,8,0,1,3584,8,1538628612
8652,60690431,28933284,89623715,8,0,1,7168,8,8395592506
8653,60696850,20269897,80966747,5,0,0,90112,10,3515902496
8654,60699830,20562991,81262821,2,0,0,114688,3,3537066520
8655,60711090,28913611,89624701,2,0,1,1536,3,2355660043
8656,60718600,20381405,81100005,4,0,0,18432,15,5409385255
8657,60721339,20372996,81094335,1,0,0,96768,10,8190671673
8658,60735710,20774583,81510293,8,0,0,1024,8,562037685
8659,60741290,28921680,89662970,8,0,1,4608,8,1307658095
8660,60743170,20614888,81358058,5,0,0,85504,10,5091950861
8661,60744699,20009368,80754067,3,0,0,26624,17,9735269111
8662,60747440,20259090,81006530,2,0,0,38400,3,3908180107
8663,60752970,20662775,81415745,5,0,0,72192,10,7753300433
8664,60755960,20696256,81452216,2,0,0,119296,3,4151417109
8665,60763889,20876764,81640653,1,0,0,90624,10,5666473290
8666,60769130,28895466,89664596,7,0,1,2560,10,5637921974
8667,60771060,20497712,81268772,5,0,0,19456,10,1561774359
8668,60773720,19949544,80723264,8,0,0,35840,8,7927674791
8669,60774810,21111444,81886254,6,0,0,79872,7,4080642416
8670,60777250,28907540,89684790,7,0,1,9728,10,2220656371
8671,60777840,28906973,89684813,7,0,1,512,10,6470515624
8672,60783021,28901815,89684836,8,0,1,2048,8,3254655533
8673,60786010,28898849,89684859,9,0,1,1536,12,1685500207
8674,60790900,20070655,80861555,0,0,0,11776,3,10245844295
8675,60803280,28881602,89684882,7,0,1,1024,10,9479114288
8676,60804261,28880652,89684913,8,0,1,11264,8,7335532119
8677,60809160,28875776,89684936,2,0,1,512,3,7534500896
8678,60811339,20004128,80815467,3,0,0,50176,17,9910590964
8679,60817450,28867509,89684959,6,0,1,2048,7,4686838673
8680,60825230,28859792,89685022,2,0,1,2048,3,8315770484
8681,60825730,28892700,89718430,2,0,1,6144,3,10444570530
8682,60827140,28891313,89718453,9,0,1,8704,12,9728852900
8683,60837390,20628881,81466271,4,0,0,17920,15,6409129005
8684,60837439,20268985,81106424,3,0,0,20992,17,5250047890
8685,60837461,28915878,89753339,8,0,1,3072,8,682520269
8686,60838560,28914802,89753362,6,0,1,5120,7,482821102
8687,60841231,28912670,89753901,5,0,1,4608,10,5541791478
8688,60845480,20522631,81368111,5,0,0,21504,10,1069439335
8689,60853601,28904486,89758087,5,0,1,6656,10,7979436702
8690,60856491,28905142,89761633,5,0,1,5632,10,6244653929
8691,60862750,20202078,81064828,5,0,0,3072,10,4283440780
8692,60863789,28956725,89820514,4,0,1,5120,15,4671476088
8693,60868700,28951837,89820537,6,0,1,1024,7,3688858848
8694,60874539,20420666,81295205,3,0,0,28672,17,5364855276
8695,60874771,28948342,89823113,8,0,1,8192,8,4018710102
8696,60875339,28952959,89828298,4,0,1,16384,15,8989369937
8697,60884031,28975206,89859237,5,0,1,1536,10,3103316917
8698,60885640,28976503,89862143,3,0,1,4608,17,3039388766
8699,60885650,20508076,81393726,4,0,0,83968,15,10662158683
8700,60902560,20710458,81613018,2,0,0,107008,3,9783179658
8701,60908330,28954799,89863129,6,0,1,1536,7,8087882624
8702,60915440,28948675,89864115,6,0,1,1536,7,505170139
8703,60916239,21045851,81962090,3,0,0,16896,17,10687410977
8704,60916279,28950742,89867021,4,0,1,4608,15,302396482
8705,60918719,28950888,89869607,4,0,1,4096,15,4964809602
8706,60920080,28952391,89872471,6,0,1,9216,7,7566862977
8707,60922220,28952128,89874348,3,0,1,2048,17,5358787518
8708,60923550,28954344,89877894,7,0,1,5632,10,1370790380
8709,60923700,20608750,81532450,0,0,0,9728,3,2042163165
8710,60933109,28946411,89879520,4,0,1,2560,15,10602253797
8711,60941710,20893803,81835513,6,0,0,101888,7,4560890714
8712,60941849,28938337,89880186,4,0,1,1024,15,6371781382
8713,60943640,20509738,81453378,5,0,0,3584,10,5111136538
8714,60948030,28932822,89880852,7,0,1,1024,10,1053767723
8715,60952354,20577109,81529463,0,0,0,38400,3,4775698324
8716,60973020,28909945,89882965,2,0,1,512,3,10156728490
8717,60976010,21296682,82272692,0,0,0,90112,3,3012555495
8718,60987449,28964305,89951754,4,0,1,18432,15,2263526388
8719,60991690,28964370,89956060,2,0,1,9216,3,2826289707
8720,60993760,21251361,82245121,5,0,0,148480,10,4509570282
8721,60995550,29013687,90009237,3,0,1,12288,17,3045180586
8722,60999451,29014512,90013963,5,0,1,6144,10,7232902659
8723,61008030,20689174,81697204,5,0,0,16896,10,10484111717
8724,61010020,29003966,90013986,3,0,1,1536,17,5379154738
8725,61011609,20883716,81895325,3,0,0,29696,17,4195312668
8726,61020290,20745751,81766041,2,0,0,10240,3,7089239660
8727,61021161,28997395,90018556,5,0,1,6144,10,5543774541
8728,61022760,20437996,81460756,2,0,0,24064,3,152024133
8729,61037879,28980700,90018579,4,0,1,4608,15,7717332975
8730,61038140,21074299,82112439,6,0,0,14848,7,4777173379
8731,61038470,29010833,90049303,2,0,1,4096,3,10037521172
8732,61038890,29011719,90050609,7,0,1,2048,10,2921428219
8733,61040169,20720441,81760610,3,0,0,76800,17,5995521105
8734,61045210,20969410,82014620,6,0,0,128000,7,1569421229
8735,61048040,21000517,82048557,6,0,0,35328,7,5502587913
8736,61055360,20961623,82016983,6,0,0,7680,7,3155179764
8737,61072750,28978525,90051275,2,0,1,1024,3,435701087
8738,61077849,28975052,90052901,4,0,1,2560,15,398339508
8739,61079520,28975647,90055167,2,0,1,3584,3,6015561115
8740,61080800,20876119,81956919,4,0,0,91136,15,7209351625
8741,61084379,21201954,82286333,3,0,0,44544,17,10385798065
8742,61088829,28969564,90058393,4,0,1,5120,15,8881278620
8743,61090580,29028289,90118869,3,0,1,1536,17,9255988918
8744,61090630,20626494,81717124,5,0,0,59392,10,311002315
8745,61091790,29027102,90118892,7,0,1,1024,10,2667301952
8746,61094909,29024006,90118915,4,0,1,3072,15,3329768960
8747,61100919,20745404,81846323,3,0,0,35328,17,3575974216
8748,61109930,20865667,81975597,6,0,0,12800,7,4303705754
8749,61112470,20785382,81897852,5,0,0,8192,10,6056682520
8750,61115289,29017423,90132712,4,0,1,8704,15,1331505183
8751,61120480,21223245,82343725,4,0,0,33792,15,8176230944
8752,61120621,29037488,90158109,5,0,1,1024,10,2461624659
8753,61127549,29030583,90158132,4,0,1,9216,15,208551053
8754,61135930,21345383,82481313,2,0,0,55808,3,3518851773
8755,61137610,21260824,82398434,0,0,0,32768,3,7226165918
8756,61138580,29036134,90174714,2,0,1,1024,3,3445481087
8757,61147749,21185641,82333390,1,0,0,102912,10,3885504563
8758,61154831,29074505,90229336,5,0,1,6656,10,2397361492
8759,61155811,29073548,90229359,5,0,1,2048,10,8481318292
8760,61160359,21004115,82164474,3,0,0,11776,17,857920107
8761,61162540,29066842,90229382,3,0,1,1536,17,5239637146
8762,61163870,29106651,90270521,9,0,1,23552,12,10589257081
8763,61170921,29112588,90283509,5,0,1,2560,10,1325029826
8764,61178731,29142843,90321574,5,0,1,7680,10,7640348481
8765,61179890,20617136,81797026,4,0,0,5632,15,455195019
8766,61181870,20912739,82094609,4,0,0,107520,15,1948837973
8767,61183070,29140130,90323200,2,0,1,2560,3,7199838400
8768,61183861,29140325,90324186,8,0,1,1536,8,7038873624
8769,61189039,21332687,82521726,3,0,0,25600,17,6940887492
8770,61193410,20855950,82049360,0,0,0,2560,3,7848933180
8771,61194910,20729696,81924606,6,0,0,4096,7,1662226870
8772,61195580,29133432,90329012,2,0,1,7680,3,10304791545
8773,61199200,20908692,82107892,0,0,0,43520,3,4625204482
8774,61201079,29418478,90619557,4,0,1,17920,15,5250588503
8775,61203020,29473447,90676467,3,0,1,6656,17,1007341842
8776,61206259,20831511,82037770,3,0,0,26112,17,2663995836
8777,61207430,21094565,82301995,6,0,0,51200,7,10152127982
8778,61218110,29462863,90680973,2,0,1,7168,3,5072459585
8779,61221580,29477418,90698998,7,0,1,1024,10,2125703580
8780,61229309,20952224,82181533,3,0,0,21504,17,2904795617
8781,61234180,29465484,90699664,3,0,1,1024,17,10515492203
8782,61237020,21151407,82388427,2,0,0,39424,3,3129011222
8783,61237390,20876632,82114022,0,0,0,5120,3,8494212256
8784,61240420,29460422,90700842,7,0,1,13824,10,8035505524
8785,61242510,29555345,90797855,7,0,1,5120,10,2729470520
8786,61242941,29554937,90797878,8,0,1,3584,8,9035363323
8787,61245571,29552330,90797901,8,0,1,512,8,447998850
8788,61245720,29567515,90813235,9,0,1,6656,12,6282767028
8789,61255930,29557328,90813258,7,0,1,2560,10,6660139594
8790,61268580,29552524,90821104,3,0,1,8192,17,6431269545
8791,61268930,29662088,90931018,9,0,1,10240,12,1078687059
8792,61269360,21430543,82699903,0,0,0,32768,3,1774755098
8793,61274130,21267119,82541249,4,0,0,64000,15,9173136149
8794,61277640,29662184,90939824,2,0,1,19456,3,9995903659
8795,61277670,21236233,82513903,0,0,0,48128,3,4126647710
8796,61285840,29654007,90939847,0,0,1,1536,3,208935287
8797,61288600,29651270,90939870,3,0,1,2560,17,2418324283
8798,61295010,21165214,82460224,6,0,0,10240,7,5385014089
8799,61300550,21298394,82598944,2,0,0,47104,3,6815705492
8800,61301270,29644717,90945987,7,0,1,6656,10,9791006837
8801,61304050,21059423,82363473,0,0,0,6144,3,7222368435
8802,61307709,21687141,82994850,3,0,0,35328,17,5309275288
8803,61308810,29637200,90946010,2,0,1,1024,3,10212439542
8804,61311020,29718991,91030011,9,0,1,18944,12,6883803525
8805,61312669,21514443,82827112,3,0,0,6656,17,2354399796
8806,61314059,21614497,82928556,1,0,0,67072,10,6165013965
8807,61314470,21506021,82820491,2,0,0,118784,3,566430379
8808,61321550,29708484,91030034,2,0,1,6656,3,5588486596
8809,61330970,21231461,82562431,6,0,0,46080,7,5381462649
8810,61331020,29699037,91030057,7,0,1,1024,10,3114378693
8811,61333970,21162374,82496344,2,0,0,21504,3,2217010794
8812,61339790,29690290,91030080,2,0,1,1536,3,6060548981
8813,61342280,29687823,91030103,3,0,1,5120,17,9595765908
8814,61347840,21521483,82869323,6,0,0,44544,7,5396496022
8815,61357279,29672847,91030126,4,0,1,7680,15,7204975304
8816,61360920,21492306,82853226,0,0,0,85504,3,9872240983
8817,61361120,21263233,82624353,5,0,0,35328,10,819120145
8818,61365400,29664749,91030149,0,0,1,512,3,4499396367
8819,61366350,21524526,82890876,6,0,0,12800,7,77353688
8820,61369650,21312197,82681847,0,0,0,7680,3,3489723155
8821,61370270,29659902,91030172,7,0,1,5632,10,9296347937
8822,61376430,29653765,91030195,9,0,1,2048,12,9434514971
8823,61378940,21557950,82936890,2,0,0,2560,3,4624552742
8824,61379410,29650808,91030218,3,0,1,4608,17,6320042899
8825,61388120,29646832,91034952,0,0,1,2560,3,8086420360
8826,61389460,29645563,91035023,7,0,1,7680,10,1442680074
8827,61394320,29640726,91035046,0,0,1,512,3,7762692021
8828,61394860,21572382,82967242,0,0,0,88064,3,5341294161
8829,61404639,21179930,82584569,1,0,0,14336,10,5806270166
8830,61404790,29669060,91073850,3,0,1,9216,17,199021531
8831,61411230,29662651,91073881,7,0,1,10240,10,2452353044
8832,61411550,29675224,91086774,2,0,1,4096,3,2308672944
8833,61412920,21336086,82749006,4,0,0,6144,15,7429380841
8834,61417370,29669501,91086871,3,0,1,10752,17,9200954701
8835,61420330,29670407,91090737,3,0,1,6144,17,10561881305
8836,61431160,29788143,91219303,0,0,1,7680,3,3595670750
8837,61433620,29785706,91219326,1,0,1,7680,10,1792168747
8838,61439460,29785285,91224745,7,0,1,512,10,9011108701
8839,61445499,21377667,82823166,3,0,0,8704,17,3861372843
8840,61450820,21254067,82704887,2,0,0,7680,3,1001878541
8841,61457489,21417511,82875000,3,0,0,1024,17,5996340433
8842,61475550,21699688,83175238,5,0,0,31232,10,9413678782
8843,61483180,29750270,91233450,2,0,1,18944,3,2216975571
8844,61483670,21584684,83068354,0,0,0,12288,3,3902216753
8845,61486540,29746933,91233473,3,0,1,2048,17,4993673560
8846,61486960,29746536,91233496,2,0,1,512,3,1632822673
8847,61488179,21529961,83018140,3,0,0,66048,17,540644848
8848,61497101,29736418,91233519,8,0,1,1024,8,9287596742
8849,61504399,21320662,82825061,1,0,0,6144,10,3763688727
8850,61516930,29719434,91236364,7,0,1,8192,10,5195997501
8851,61522200,21408875,82931075,4,0,0,8192,15,8109011541
8852,61524910,29784031,91308941,0,0,1,5632,3,2280132439
8853,61527490,21514221,83041711,6,0,0,5120,7,8242043270
8854,61528000,21637653,83165653,4,0,0,36864,15,860649817
8855,61528580,21679488,83208068,6,0,0,89600,7,6338128929
8856,61532350,29777259,91309609,2,0,1,6144,3,10284105959
8857,61534530,21695457,83229987,5,0,0,61440,10,5730550683
8858,61535600,21994045,83529645,5,0,0,70656,10,8646207734
8859,61536391,29791431,91327822,8,0,1,12288,8,5923955809
8860,61540730,29797027,91337757,3,0,1,2048,17,9052047447
8861,61542411,29795369,91337780,8,0,1,2560,8,1269395842
8862,61542950,29794853,91337803,0,0,1,3072,3,1311383573
8863,61544320,29794524,91338844,0,0,1,4608,3,8721613552
8864,61544889,21814463,83359352,3,0,0,62464,17,459837895
8865,61550610,21603788,83154398,0,0,0,53760,3,1658648467
8866,61552280,22005936,83558216,0,0,0,1536,3,9720884510
8867,61558090,29783980,91342070,7,0,1,5120,10,1089370265
8868,61565480,21615241,83180721,2,0,0,17920,3,7945596438
8869,61568650,29774726,91343376,2,0,1,2048,3,7667468141
8870,61587091,29759511,91346602,8,0,1,5120,8,9345723435
8871,61587920,21410073,82997993,6,0,0,10240,7,5582184574
8872,61591810,29758177,91349987,2,0,1,3584,3,1042099384
8873,61592090,29821343,91413433,3,0,1,512,17,6785911424
8874,61599690,29843833,91443523,3,0,1,7680,17,2301551867
8875,61601860,29869808,91471668,0,0,1,6144,3,2071980294
8876,61607490,29900922,91508412,2,0,1,512,3,5691686359
8877,61608300,29902058,91510358,1,0,1,3072,10,546060629
8878,61608400,29916257,91524657,0,0,1,7680,3,8716922245
8879,61614390,21684575,83298965,4,0,0,4608,15,6355838945
8880,61615550,22086251,83701801,4,0,0,85504,15,1131464009
8881,61623189,29903824,91527013,4,0,1,8704,15,4446482427
8882,61628320,29928606,91556926,0,0,1,2560,3,7581606324
8883,61631870,21598296,83230166,0,0,0,512,3,6942710204
8884,61632260,21663265,83295525,2,0,0,43520,3,9384504687
8885,61637659,21617811,83255470,1,0,0,4096,10,1329790774
8886,61638489,21909743,83548232,1,0,0,60928,10,10069048205
8887,61646170,22026203,83672373,5,0,0,160768,10,1067407731
8888,61647380,29949168,91596548,0,0,1,3584,3,1507527931
8889,61648470,29948101,91596571,0,0,1,13824,3,1120508844
8890,61648569,21818955,83467524,3,0,0,50176,17,9286424599
8891,61648920,21899499,83548419,5,0,0,512,10,4704181406
8892,61654660,21853434,83508094,0,0,0,47104,3,2119883166
8893,61655450,22074798,83730248,4,0,0,30720,15,7744373659
8894,61656710,29939884,91596594,2,0,1,512,3,9089405279
8895,61665560,21951223,83616783,0,0,0,79360,3,623537908
8896,61666290,29930327,91596617,0,0,1,2048,3,4493577592
8897,61669970,29926670,91596640,7,0,1,5120,10,5485071698
8898,61675600,29921063,91596663,2,0,1,3072,3,343436779
8899,61680540,29916146,91596686,3,0,1,512,17,6050596515
8900,61692970,21794680,83487650,2,0,0,4608,3,2203241671
8901,61699550,29897159,91596709,8,0,1,2560,8,7732828458
8902,61700849,21922509,83623358,1,0,0,21504,10,4909084167
8903,61704479,29894803,91599282,4,0,1,5120,15,2138424051
8904,61706430,21969273,83675703,5,0,0,8192,10,5917758573
8905,61707450,29895378,91602828,3,0,1,5632,17,4155692957
8906,61711560,22149444,83861004,5,0,0,5632,10,7443623835
8907,61716519,21863562,83580081,1,0,0,17920,10,5168182631
8908,61720550,29882624,91603174,3,0,1,512,17,6298170913
8909,61733180,29921059,91654239,2,0,1,13824,3,8155022434
8910,61734440,29919822,91654262,2,0,1,13312,3,1961764313
8911,61735309,29943077,91678386,4,0,1,6656,15,532471003
8912,61749110,29929299,91678409,2,0,1,2048,3,6887323891
8913,61754880,29924945,91679825,7,0,1,2560,10,1978710819
8914,61758480,21998520,83757000,5,0,0,29184,10,9973593284
8915,61761089,22179913,83941002,1,0,0,25088,10,910066877
8916,61761550,29932935,91694485,0,0,1,1536,3,7693856155
8917,61764100,21909084,83673184,0,0,0,2560,3,1761958804
8918,61769260,21969810,83739070,8,0,0,27136,8,3190638426
8919,61774110,29928221,91702331,7,0,1,3072,10,754033209
8920,61774540,22001299,83775839,0,0,0,16896,3,7499420044
8921,61776460,22076087,83852547,6,0,0,77824,7,1532641002
8922,61778480,29923882,91702362,7,0,1,2048,10,2556614097
8923,61792999,22094638,83887637,3,0,0,41984,17,4134283778
8924,61793059,22165521,83958580,1,0,0,20480,10,35301461
8925,61793799,22290583,84084382,1,0,0,26112,10,7581853477
8926,61797730,22010035,83807765,4,0,0,4608,15,2765637558
8927,61799010,22108935,83907945,4,0,0,26624,15,7398091262
8928,61809190,29939804,91748994,3,0,1,18944,17,2200077960
8929,61811330,29937687,91749017,2,0,1,1024,3,8890620395
8930,61814179,22262170,84076349,3,0,0,45056,17,2621288530
8931,61817550,22297016,84114566,6,0,0,45056,7,8116637810
8932,61818099,22303666,84121765,3,0,0,23552,17,6212066135
8933,61818840,22243735,84062575,4,0,0,132608,15,2028049360
8934,61827130,29921910,91749040,3,0,1,1536,17,5793660721
8935,61828410,29924272,91752682,2,0,1,1536,3,5449168277
8936,61829220,29927028,91756248,0,0,1,5120,3,1359902848
8937,61831860,29975875,91807735,0,0,1,3584,3,5188708892
8938,61842190,29965568,91807758,0,0,1,9216,3,1051322499
8939,61852770,22672020,84524790,5,0,0,101376,10,3248102716
8940,61857590,29980462,91838052,7,0,1,9216,10,7798053337
8941,61862350,29976688,91839038,3,0,1,1536,17,4807879369
8942,61863990,22220727,84084717,5,0,0,1024,10,9890322148
8943,61865340,29976284,91841624,7,0,1,4096,10,3955185407
8944,61869660,29988991,91858651,3,0,1,7168,17,400371011
8945,61874980,30001497,91876477,3,0,1,1536,17,8351012487
8946,61882210,29995253,91877463,0,0,1,1536,3,7374695769
8947,61885300,29994109,91879409,7,0,1,3072,10,6270076889
8948,61889070,29993245,91882315,2,0,1,4608,3,3528860164
8949,61890500,22717757,84608257,4,0,0,30208,15,1584006317
8950,61893740,30039893,91933633,7,0,1,3072,10,279604154
8951,61897200,22299616,84196816,2,0,0,6656,3,7766495459
8952,61901830,30032469,91934299,2,0,1,1024,3,2053888015
8953,61916249,22373872,84290121,3,0,0,82944,17,1290786036
8954,61922360,30024519,91946879,7,0,1,6144,10,7924543970
8955,61922630,30045765,91968395,2,0,1,4096,3,9360812508
8956,61928060,30040358,91968418,3,0,1,2048,17,6402382619
8957,61935980,30032461,91968441,3,0,1,2048,17,6255276868
8958,61941780,22284922,84226702,5,0,0,19968,10,6755940001
8959,61963980,22590898,84554878,6,0,0,512,7,8591821210
8960,61970180,29998284,91968464,3,0,1,2048,17,4564936575
8961,61977049,22802563,84779612,1,0,0,30720,10,2439138699
8962,61977590,29990897,91968487,2,0,1,6656,3,2494835214
8963,61977919,22469480,84447399,1,0,0,17920,10,6332368836
8964,61979310,30056195,92035505,0,0,1,2560,3,8435049709
8965,61981150,30055123,92036273,3,0,1,11776,17,804135975
8966,61986930,30050009,92036939,0,0,1,1024,3,7670164232
8967,61997390,30039895,92037285,0,0,1,512,3,4537703710
8968,61997430,30040521,92037951,2,0,1,1024,3,5962519144
8969,61997460,22303448,84300908,5,0,0,35328,10,2109956197
8970,62027020,30013197,92040217,3,0,1,3584,17,6513297025
8971,62037170,30015640,92052810,2,0,1,7680,3,6076310183
8972,62047810,30005889,92053699,3,0,1,1024,17,8970868094
8973,62048239,22865553,84913792,1,0,0,17920,10,8490199185
8974,62049380,30005945,92055325,3,0,1,2560,17,9620399934
8975,62055440,22488153,84543593,4,0,0,5120,15,4523410365
8976,62056940,30054450,92111390,3,0,1,512,17,498628689
8977,62072689,22287195,84359884,3,0,0,37376,17,2733393384
8978,62073420,30044218,92117638,3,0,1,6656,17,7089467645
8979,62076810,30040851,92117661,2,0,1,2048,3,109464512
8980,62092340,22532967,84625307,6,0,0,55808,7,646266689
8981,62098950,30066779,92165729,3,0,1,3584,17,8622683853
8982,62111450,22304496,84415946,2,0,0,30720,3,5086474090
8983,62113479,30063436,92176915,4,0,1,11776,15,2509796216
8984,62116410,30061811,92178221,0,0,1,2048,3,3616360843
8985,62120390,30058177,92178567,6,0,1,512,7,161925411
8986,62124780,30055413,92180193,6,0,1,2560,7,1679762770
8987,62141240,30067139,92208379,3,0,1,4096,17,5604993784
8988,62149120,30083941,92233061,2,0,1,1536,3,784747811
8989,62152709,22900072,85052781,3,0,0,117248,17,6196609893
8990,62157649,30075435,92233084,4,0,1,6656,15,7110130321
8991,62160259,30072848,92233107,4,0,1,10752,15,8705374723
8992,62161040,30194244,92355284,3,0,1,1536,17,423328396
8993,62166750,22477648,84644398,6,0,0,26624,7,4771204608
8994,62171850,22479022,84650872,2,0,0,13824,3,4964097990
8995,62176070,22395179,84571249,6,0,0,22016,7,9555601008
8996,62179140,22964740,85143880,2,0,0,35840,3,5104631405
8997,62184090,22495858,84679948,6,0,0,1536,7,7739058813
8998,62188440,30181518,92369958,6,0,1,6144,7,8312458621
8999,62188709,30181272,92369981,4,0,1,1536,15,3962171443
9000,62196520,22705830,84902350,4,0,0,76800,15,8856803211
9001,62197990,30172014,92370004,3,0,1,2560,17,9211283455
9002,62198149,22588662,84786811,3,0,0,23552,17,9576318990
9003,62209130,22669797,84878927,2,0,0,80384,3,7569207438
9004,62211080,22860802,85071882,2,0,0,48128,3,8424781668
9005,62216219,30210537,92426756,4,0,1,1536,15,2386274125
9006,62218369,22885703,85104072,1,0,0,101888,10,2308243977
9007,62241760,30185019,92426779,6,0,1,2048,7,1233672744
9008,62245270,30181532,92426802,3,0,1,1024,17,9593056898
9009,62250509,22677190,84927699,3,0,0,2048,17,4651579868
9010,62260770,30166546,92427316,3,0,1,2560,17,4431069346
9011,62261990,22750787,85012777,6,0,0,75776,7,1432751571
9012,62275100,22476497,84751597,6,0,0,3584,7,7137543531
9013,62284840,30142499,92427339,2,0,1,3072,3,10384337028
9014,62285800,22787197,85072997,5,0,0,3584,10,9630417466
9015,62292250,22764945,85057195,4,0,0,14336,15,10207154171
9016,62292339,30135023,92427362,4,0,1,3072,15,7760096420
9017,62292969,30152200,92445169,4,0,1,4096,15,195334198
9018,62293510,22614791,84908301,5,0,0,19456,10,1408644856
9019,62294709,22929349,85224058,3,0,0,60928,17,715433353
9020,62300640,22688957,84989597,4,0,0,89600,15,2836812009
9021,62304119,30141073,92445192,4,0,1,7168,15,2572779057
9022,62305480,30139735,92445215,0,0,1,15360,3,7085518184
9023,62319870,30138871,92458741,3,0,1,3584,17,7209773287
9024,62320829,22990573,85311402,1,0,0,123392,10,434116378
9025,62327559,30131528,92459087,4,0,1,512,15,7843125250
9026,62327589,30131844,92459433,4,0,1,512,15,5859944734
9027,62328469,30135150,92463619,4,0,1,6656,15,9741666610
9028,62329789,30135776,92465565,4,0,1,3072,15,2525471920
9029,62344109,30123082,92467191,4,0,1,2560,15,5525894077
9030,62344860,30194218,92539078,0,0,1,6656,3,2882576729
9031,62349299,22833973,85183272,3,0,0,16896,17,4751582000
9032,62351750,30187351,92539101,3,0,1,5120,17,6090101020
9033,62354100,23010075,85364175,6,0,0,51712,7,8556224813
9034,62362520,30277395,92639915,0,0,1,3584,3,9732797080
9035,62368379,30274442,92642821,4,0,1,4608,15,1554315096
9036,62371499,30300315,92671814,4,0,1,24064,15,5554840150
9037,62374480,30320392,92694872,0,0,1,1536,3,5718086228
9038,62379189,22822720,85201909,1,0,0,33280,10,3419684030
9039,62380010,30315848,92695858,7,0,1,1536,10,6087815232
9040,62381970,23037017,85418987,5,0,0,37888,10,2501333124
9041,62389939,30340270,92730209,4,0,1,3072,15,9386405963
9042,62390500,23225064,85615564,6,0,0,7680,7,7382291640
9043,62392040,30338835,92730875,0,0,1,1024,3,10444965072
9044,62393280,30338581,92731861,7,0,1,1536,10,4102354594
9045,62404280,30330807,92735087,0,0,1,5120,3,9754180992
9046,62423030,30316363,92739393,0,0,1,12800,3,10323883297
9047,62423809,22824851,85248660,1,0,0,43520,10,939083852
9048,62426369,22825598,85251967,1,0,0,10752,10,8902024189
9049,62436270,22907360,85343630,5,0,0,14336,10,5668799177
9050,62444279,22791098,85235377,3,0,0,30208,17,3722219300
9051,62444460,30295959,92740419,6,0,1,1024,7,3717713440
9052,62446539,23115277,85561816,3,0,0,87552,17,7402655157
9053,62448180,22930004,85378184,4,0,0,5632,15,6038581953
9054,62455089,23011556,85466645,3,0,0,6656,17,9401755534
9055,62467160,30284813,92751973,7,0,1,13824,10,10090521070
9056,62479139,30272857,92751996,4,0,1,2560,15,1741737850
9057,62483260,22833024,85316284,4,0,0,15872,15,3443521038
9058,62489139,30262880,92752019,4,0,1,11776,15,539734341
9059,62496200,30384601,92880801,7,0,1,16384,10,10126168413
9060,62505440,23418450,85923890,4,0,0,46080,15,493535097
9061,62507740,30377567,92885307,6,0,1,7168,7,8851477230
9062,62525279,23238625,85763904,1,0,0,23552,10,9294334100
9063,62535340,22847326,85382666,4,0,0,10240,15,7656884238
9064,62544359,23155919,85700278,1,0,0,17408,10,3210124965
9065,62545540,30346806,92892346,7,0,1,10240,10,5488374234
9066,62546259,30405468,92951727,4,0,1,3072,15,1398065831
9067,62548010,30405983,92953993,0,0,1,3584,3,2797107568
9068,62549599,30507884,93057483,4,0,1,7680,15,1239303396
9069,62563090,30494416,93057506,6,0,1,1024,7,846625336
9070,62569820,30502527,93072347,6,0,1,12800,7,1968239600
9071,62573859,23155481,85729340,1,0,0,32256,10,10692572767
9072,62585270,22816059,85401329,5,0,0,1024,10,472164071
9073,62591589,30483690,93075279,4,0,1,4608,15,7795064565
9074,62595509,30508403,93103912,4,0,1,11776,15,1203976977
9075,62596359,30552756,93149115,4,0,1,4608,15,1127748674
9076,62599930,30549543,93149473,6,0,1,2048,7,3268682737
9077,62603370,30546126,93149496,6,0,1,3072,7,8351180191
9078,62603580,30545939,93149519,7,0,1,512,10,7726380660
9079,62607839,30541703,93149542,4,0,1,11776,15,7815412626
9080,62620359,23414595,86034954,1,0,0,28160,10,1722704452
9081,62628630,30520935,93149565,0,0,1,2048,3,9826277035
9082,62629430,30521633,93151063,7,0,1,512,10,2907109421
9083,62646430,23223577,85870007,4,0,0,28160,15,4200594196
9084,62661800,23380834,86042634,6,0,0,9216,7,9887827997
9085,62665179,22869938,85535117,1,0,0,11264,10,2415363880
9086,62667930,30487192,93155122,0,0,1,10752,3,6597996281
9087,62671280,30512263,93183543,6,0,1,6144,7,1763766206
9088,62676580,22931713,85608293,6,0,0,15872,7,1115756277
9089,62690950,23028539,85719489,6,0,0,62976,7,3205726000
9090,62694150,22965024,85659174,5,0,0,3584,10,6256457888
9091,62706480,23316884,86023364,4,0,0,19968,15,3606786764
9092,62715200,22963976,85679176,6,0,0,34816,7,837052665
9093,62730790,30452776,93183566,7,0,1,512,10,9167732338
9094,62732050,30473389,93205439,7,0,1,14336,10,4434064492
9095,62734590,30472475,93207065,0,0,1,2560,3,5265811959
9096,62735729,23125675,85861404,3,0,0,43520,17,5187174189
9097,62737570,30474641,93212211,0,0,1,8192,3,652517537
9098,62739600,22940067,85679667,2,0,0,1536,3,10136931417
9099,62749690,22981857,85731547,5,0,0,7168,10,1720679697
9100,62755960,23040341,85796301,5,0,0,3072,10,1011066745
9101,62758860,23235654,85994514,6,0,0,55808,7,7866653822
9102,62768510,23257841,86026351,5,0,0,9728,10,6628527753
9103,62776500,23455995,86232495,6,0,0,110592,7,9758915925
9104,62790630,30453295,93243925,7,0,1,3072,10,7890499576
9105,62802910,30441038,93243948,0,0,1,6656,3,2206926538
9106,62803790,30440181,93243971,0,0,1,4608,3,10270002447
9107,62807050,30466350,93273400,6,0,1,6656,7,5849750497
9108,62820809,23001767,85822576,1,0,0,39424,10,1868575499
9109,62829040,30461454,93290494,0,0,1,19456,3,4832543406
9110,62836350,30454167,93290517,6,0,1,4096,7,1686350935
9111,62836919,30453621,93290540,4,0,1,3072,15,7327003826
9112,62843640,22787952,85631592,4,0,0,25088,15,10630963063
9113,62849909,23247327,86097236,3,0,0,17408,17,7131337542
9114,62850120,23079812,85929932,6,0,0,4608,7,7700057417
9115,62867550,23213214,86080764,6,0,0,65536,7,4142318338
9116,62869760,30431715,93301475,6,0,1,3072,7,5385961672
9117,62880179,23237368,86117547,1,0,0,66560,10,3595931081
9118,62896810,23063891,85960701,2,0,0,53248,3,4043142078
9119,62938770,23337411,86276181,2,0,0,44032,3,7730359450
9120,62939319,30366527,93305846,4,0,1,3584,15,371762512
9121,62956690,23060567,86017257,6,0,0,70656,7,1749611114
9122,62985329,30321503,93306832,4,0,1,1536,15,603319257
9123,62987339,22922488,85909827,1,0,0,31744,10,1640603247
9124,62987419,30322319,93309738,4,0,1,4608,15,3756682530
9125,62991810,23532085,86523895,2,0,0,37376,3,10009944689
9126,63007979,23189965,86197944,1,0,0,38912,10,1744563226
9127,63027270,23032382,86059652,4,0,0,20480,15,10441078154
9128,63030140,23309538,86339678,4,0,0,6656,15,8105926043
9129,63033710,23326427,86360137,4,0,0,67072,15,6757450422
9130,63035530,30277140,93312670,6,0,1,4608,7,10198618771
9131,63038689,30299716,93338405,4,0,1,1024,15,6715431524
9132,63042350,23329541,86371891,4,0,0,38400,15,718802377
9133,63042419,22889096,85931515,1,0,0,5120,10,449839924
9134,63056299,23027452,86083751,3,0,0,9728,17,5122854254
9135,63064210,23676813,86741023,2,0,0,41984,3,8301182340
9136,63071700,30270251,93341951,6,0,1,5632,7,2371933780
9137,63080520,23078737,86159257,6,0,0,27136,7,7726938519
9138,63089399,30252898,93342297,4,0,1,512,15,8579045466
9139,63094249,30250314,93344563,4,0,1,3584,15,5714073891
9140,63094809,22871219,85966028,3,0,0,17408,17,9387379909
9141,63105830,22947559,86053389,5,0,0,3072,10,7522520400
9142,63123350,30223799,93347149,6,0,1,4096,7,10621956815
9143,63125269,30228332,93353601,4,0,1,10240,15,9071135373
9144,63142509,23119430,86261939,3,0,0,71168,17,4775300432
9145,63143230,30211997,93355227,6,0,1,2560,7,7945271555
9146,63148610,23155624,86304234,2,0,0,54272,3,9599520918
9147,63159750,30196143,93355893,6,0,1,1024,7,9124446616
9148,63161830,23294790,86456620,2,0,0,13312,3,8293432803
9149,63183029,22908077,86091106,1,0,0,24064,10,4684987874
9150,63183360,22908549,86091909,6,0,0,2560,7,8170048514
9151,63186560,23151067,86337627,4,0,0,45056,15,4321720088
9152,63223179,23595601,86818780,3,0,0,53760,17,8855639492
9153,63226159,23242944,86469103,1,0,0,13824,10,3372125605
9154,63238310,23182096,86420406,4,0,0,27136,15,143681383
9155,63239960,23070116,86310076,2,0,0,18944,3,6541305174
9156,63244880,23701900,86946780,4,0,0,21504,15,642717119
9157,63248189,30107858,93356047,4,0,1,8704,15,3807997262
9158,63249220,30122928,93372148,0,0,1,2048,3,4889343629
9159,63257390,23137947,86395337,5,0,0,56320,10,7406484028
9160,63261889,23000853,86262742,1,0,0,2560,10,6315759948
9161,63269400,23018182,86287582,6,0,0,36864,7,2697513169
9162,63270290,30102524,93372814,8,0,1,1024,8,5804658427
9163,63276409,23305353,86581762,1,0,0,27136,10,2777837907
9164,63281750,30092690,93374440,8,0,1,2560,8,6767651924
9165,63286519,30090872,93377391,4,0,1,2048,15,5988934066
9166,63324810,23248661,86573471,2,0,0,3584,3,6204935437
9167,63328650,30049682,93378332,0,0,1,4096,3,5168523085
9168,63330740,30074726,93405466,8,0,1,7168,8,4757516883
9169,63351300,30074747,93426047,0,0,1,1024,3,5107340023
9170,63363719,30062351,93426070,4,0,1,1536,15,1566051427
9171,63366400,23205956,86572356,4,0,0,126464,15,1210034931
9172,63367709,30059162,93426871,4,0,1,3072,15,4694406063
9173,63369709,30060351,93430060,4,0,1,1536,15,4262279124
9174,63373690,30056716,93430406,0,0,1,512,3,1618956027
9175,63384050,23605521,86989571,2,0,0,16896,3,8684477449
9176,63401549,30033363,93434912,4,0,1,7168,15,6394789235
9177,63422230,23213453,86635683,2,0,0,2560,3,3652667808
9178,63434710,23200170,86634880,4,0,0,11776,15,7033150226
9179,63444529,23277471,86722000,3,0,0,18432,17,1053931441
9180,63461981,29978077,93440058,8,0,1,8192,8,10075486533
9181,63463690,23193850,86657540,2,0,0,35328,3,4042058525
9182,63465579,23561546,87027125,1,0,0,26624,10,4680357834
9183,63477151,29986179,93463330,8,0,1,6144,8,6906001783
9184,63478889,23537114,87016003,3,0,0,34816,17,9332741487
9185,63481270,29989906,93471176,0,0,1,4096,3,3066197079
9186,63487131,29984068,93471199,8,0,1,1024,8,5414161862
9187,63489890,23156736,86646626,5,0,0,35840,10,444627573
9188,63498730,23012615,86511345,6,0,0,8704,7,9381882419
9189,63500779,29970443,93471222,4,0,1,512,15,7892289640
9190,63501930,29969315,93471245,0,0,1,1024,3,6864068721
9191,63513379,23392390,86905769,1,0,0,136192,10,6627598891
9192,63517590,23340650,86858240,6,0,0,41472,7,3143494671
9193,63519631,29951816,93471447,8,0,1,7680,8,2322369835
9194,63534820,23626955,87161775,6,0,0,65536,7,7402494327
9195,63536620,23605156,87141776,6,0,0,74240,7,5943539081
9196,63539490,23369266,86908756,4,0,0,9728,15,6235460070
9197,63545619,29925851,93471470,4,0,1,4608,15,10676593350
9198,63561740,29909753,93471493,3,0,1,1536,17,10419793408
9199,63561920,23117315,86679235,4,0,0,512,15,576810158
9200,63565810,29905706,93471516,0,0,1,6656,3,1797625747
9201,63566600,29904939,93471539,0,0,1,11264,3,10201491225
9202,63572150,29899420,93471570,9,0,1,2560,12,8972956961
9203,63573280,23226718,86799998,5,0,0,7168,10,6126486150
9204,63577180,23642397,87219577,4,0,0,56832,15,7044657865
9205,63577299,23362882,86940181,1,0,0,92672,10,7322430259
9206,63578040,29906702,93484742,0,0,1,2560,3,7268358072
9207,63582680,23143866,86726546,4,0,0,3584,15,8299277367
9208,63589561,29979475,93569036,8,0,1,34304,8,1415626242
9209,63595459,30032187,93627646,4,0,1,1536,15,7734263489
9210,63600560,23518573,87119133,2,0,0,59904,3,994943129
9211,63600620,23644404,87245024,4,0,0,14848,15,1676733461
9212,63607820,30122836,93730656,3,0,1,22528,17,7572492546
9213,63609370,23175064,86784434,6,0,0,32256,7,4173169429
9214,63611709,30119149,93730858,4,0,1,3584,15,4280685926
9215,63615000,30115881,93730881,9,0,1,3584,12,6875308372
9216,63622529,23174466,86796995,3,0,0,7168,17,1119316227
9217,63637031,30093873,93730904,8,0,1,3072,8,1130582137
9218,63637229,23704845,87342074,1,0,0,100352,10,581129086
9219,63637480,30094250,93731730,3,0,1,2560,17,10364251767
9220,63646679,30085074,93731753,4,0,1,1024,15,2463264513
9221,63650050,23317756,86967806,4,0,0,13312,15,4711488824
9222,63657430,23438257,87095687,4,0,0,82432,15,7473005796
9223,63657890,23254032,86911922,6,0,0,10240,7,8457823482
9224,63665649,23700728,87366377,3,0,0,10240,17,1360361465
9225,63666920,23433938,87100858,6,0,0,16896,7,8619484929
9226,63667520,30064256,93731776,9,0,1,2048,12,10736330815
9227,63667650,23516156,87183806,6,0,0,45056,7,542805724
9228,63668160,30063639,93731799,7,0,1,1024,10,4446141795
9229,63669700,30102994,93772694,3,0,1,1024,17,6984161669
9230,63671039,23726488,87397527,3,0,0,32256,17,4759805494
9231,63674280,30098445,93772725,7,0,1,12800,10,10635478586
9232,63676541,30177937,93854478,8,0,1,2560,8,6879873399
9233,63678939,23547986,87226925,3,0,0,15872,17,2893795719
9234,63682940,30171740,93854680,7,0,1,3072,10,94438561
9235,63686240,30168463,93854703,9,0,1,512,12,1355826458
9236,63698029,30156697,93854726,4,0,1,4608,15,10340374849
9237,63717331,30138065,93855396,8,0,1,2560,8,5830919241
9238,63717400,30138019,93855419,7,0,1,5120,10,2361074358
9239,63720080,30137569,93857649,9,0,1,7168,12,4742320849
9240,63726910,23292080,87018990,4,0,0,9728,15,10735940377
9241,63738860,23463332,87202192,6,0,0,57856,7,6250432641
9242,63742930,30115705,93858635,7,0,1,1536,10,8446649341
9243,63743040,30120598,93863638,9,0,1,23552,12,9192306818
9244,63745151,30215604,93960755,8,0,1,1024,8,2668527742
9245,63747539,23559814,87307353,1,0,0,4608,10,7110996509
9246,63754809,23550914,87305723,3,0,0,41472,17,5514702413
9247,63761651,30199348,93960999,8,0,1,10240,8,7806189637
9248,63763700,30267616,94031316,7,0,1,8192,10,8997015397
9249,63765711,30265628,94031339,8,0,1,1024,8,10088979146
9250,63766810,23593851,87360661,6,0,0,60928,7,10065678987
9251,63767330,30264032,94031362,6,0,1,4608,7,1321489885
9252,63769000,30263188,94032188,7,0,1,512,10,4390552959
9253,63773970,30258732,94032702,3,0,1,6656,17,604887489
9254,63774010,30274991,94049001,9,0,1,6144,12,5312612685
9255,63774850,30275457,94050307,3,0,1,2048,17,2010316408
9256,63779000,30341470,94120470,7,0,1,10752,10,7448326666
9257,63780170,30340323,94120493,3,0,1,5632,17,5963523073
9258,63783249,23591480,87374729,1,0,0,9728,10,675589493
9259,63786379,30353304,94139683,4,0,1,3584,15,5581339763
9260,63793300,30425011,94218311,9,0,1,2560,12,70991655
9261,63794839,23674012,87468851,1,0,0,22528,10,4729899441
9262,63798780,30430781,94229561,9,0,1,1024,12,2536833556
9263,63799180,30430842,94230022,7,0,1,10240,10,10689936560
9264,63805470,23675271,87480741,5,0,0,16896,10,6037739825
9265,63810640,30422288,94232928,3,0,1,4608,17,6090507963
9266,63814249,23751976,87566225,1,0,0,13312,10,931038154
9267,63814310,23546998,87361308,6,0,0,2048,7,8533243448
9268,63819390,23956033,87775423,5,0,0,83456,10,2224025059
9269,63831230,30581509,94412739,3,0,1,20992,17,481914922
9270,63849050,30583960,94433010,7,0,1,2048,10,2801522776
9271,63849239,24137594,87986833,3,0,0,6144,17,9729022211
9272,63851700,30581333,94433033,3,0,1,1024,17,10255647954
9273,63854140,30597347,94451487,3,0,1,4608,17,7035173063
9274,63860190,30631177,94491367,3,0,1,4608,17,7749000108
9275,63860630,30632515,94493145,3,0,1,2560,17,5424672856
9276,63873079,24037296,87910375,1,0,0,53760,10,10355648974
9277,63876920,30622199,94499119,7,0,1,9728,10,6859482370
9278,63881330,23630568,87511898,4,0,0,69120,15,2231160723
9279,63882619,23480592,87363211,1,0,0,6144,10,520252871
9280,63885880,30613262,94499142,3,0,1,2560,17,10731545071
9281,63886960,23644149,87531109,6,0,0,62976,7,6154906145
9282,63891201,30607964,94499165,8,0,1,4608,8,7007460852
9283,63900851,30598345,94499196,8,0,1,1024,8,2220678591
9284,63902530,30596689,94499219,3,0,1,6656,17,8259382536
9285,63905040,24333233,88238273,2,0,0,24064,3,2142389830
9286,63907680,30611957,94519637,7,0,1,3072,10,7971318458
9287,63910530,30610089,94520619,7,0,1,2560,10,810982230
9288,63920090,30600552,94520642,9,0,1,512,12,1169484338
9289,63920500,23752676,87673176,2,0,0,64000,3,903654095
9290,63932739,24258166,88190905,1,0,0,137216,10,1776868948
9291,63934240,30586425,94520665,9,0,1,512,12,9522627887
9292,63937720,23598427,87536147,5,0,0,16384,10,4325946886
9293,63937839,30582849,94520688,4,0,1,2560,15,1224448357
9294,63956109,24433971,88390080,3,0,0,34304,17,6137594843
9295,63961480,30567697,94529177,9,0,1,4608,12,6453756572
9296,63965170,30582931,94548101,7,0,1,6144,10,4963157084
9297,63965250,30582874,94548124,7,0,1,5632,10,9097074512
9298,63967999,24262919,88230918,1,0,0,68608,10,590271730
9299,63969129,30593163,94562292,4,0,1,512,15,2051541259
9300,63981790,30584048,94565838,9,0,1,5632,12,6990170972
9301,63983990,30584434,94568424,7,0,1,4096,10,2288281069
9302,63990570,30581400,94571970,7,0,1,5632,10,5706011385
9303,63991570,30587389,94578959,3,0,1,2048,17,1455199881
9304,63993320,24383922,88377242,0,0,0,88576,3,2131572264
9305,64003670,30576275,94579945,1,0,1,1536,10,9716982979
9306,64007540,23700247,87707787,5,0,0,32768,10,10160374061
9307,64015060,23667393,87682453,4,0,0,16384,15,1374290478
9308,64016289,30564527,94580816,4,0,1,12288,15,903927555
9309,64017479,23875646,87893125,3,0,0,36352,17,6413940451
9310,64017950,23569217,87587167,4,0,0,12288,15,4267170120
9311,64020779,30571848,94592627,4,0,1,5120,15,2918820937
9312,64038039,30559414,94597453,4,0,1,7680,15,1050929897
9313,64038440,30576973,94615413,7,0,1,6656,10,10373678061
9314,64040720,30583166,94623886,9,0,1,17920,12,8085338108
9315,64048220,23832893,87881113,4,0,0,25600,15,791318438
9316,64053090,30573382,94626472,7,0,1,4096,10,6538245003
9317,64063239,30582846,94646085,4,0,1,1536,15,5018468678
9318,64071200,30576511,94647711,3,0,1,2560,17,2140993590
9319,64073320,30575377,94648697,3,0,1,1536,17,3510062453
9320,64073940,23758576,87832516,2,0,0,8704,3,2038346952
9321,64075879,30575404,94651283,4,0,1,4096,15,10333832882
9322,64077070,24470917,88547987,2,0,0,1024,3,6140864545
9323,64078430,24320292,88398722,4,0,0,12288,15,2179836466
9324,64094170,24621870,88716040,4,0,0,153600,15,5905340561
9325,64121000,30558748,94679748,6,0,1,15360,7,7414852861
9326,64130249,24632302,88762551,1,0,0,152576,10,4300105262
9327,64135309,24074339,88209648,1,0,0,61440,10,4702750284
9328,64146910,30564452,94711362,9,0,1,5120,12,1622648990
9329,64147170,24440083,88587253,2,0,0,107008,3,5542141633
9330,64151250,24116842,88268092,6,0,0,97792,7,2287004266
9331,64153350,24352026,88505376,2,0,0,27136,3,224004863
9332,64154160,30557225,94711385,1,0,1,2560,10,4116707052
9333,64154209,23520238,87674447,1,0,0,4096,10,2007499910
9334,64155030,23994044,88149074,4,0,0,88064,15,5793405143
9335,64164260,24112630,88276890,4,0,0,5120,15,4010757285
9336,64164949,30583025,94747974,4,0,1,31232,15,1862793164
9337,64166269,30627426,94793695,4,0,1,7168,15,7927121382
9338,64171920,30625961,94797881,9,0,1,6656,12,3799038543
9339,64176029,30622313,94798342,4,0,1,10240,15,6320022369
9340,64179590,30637213,94816803,9,0,1,5120,12,5259795939
9341,64180300,30709535,94889835,1,0,1,9728,10,9687562887
9342,64191860,30698177,94890037,9,0,1,1536,12,7798730689
9343,64196540,30693520,94890060,9,0,1,2048,12,4451797333
9344,64209860,30680223,94890083,2,0,1,2560,3,9478418212
9345,64212769,30680324,94893093,4,0,1,9728,15,973034297
9346,64224960,30717608,94942568,1,0,1,6144,10,5906436911
9347,64229640,30713389,94943029,2,0,1,10240,3,6529716873
9348,64233890,30725375,94959265,2,0,1,10752,3,4345685779
9349,64242860,24254225,88497085,4,0,0,7680,15,10052095995
9350,64246669,24073520,88320189,1,0,0,106496,10,9472796047
9351,64253279,30706009,94959288,4,0,1,512,15,9191422434
9352,64258040,30703058,94961098,1,0,1,1024,10,2381493130
9353,64268859,24006432,88275291,1,0,0,23552,10,141617318
9354,64271800,30763855,95035655,9,0,1,20992,12,10731300608
9355,64283890,24111049,88394939,2,0,0,15872,3,8739186136
9356,64294650,23915333,88209983,6,0,0,1024,7,4359297233
9357,64297560,24465170,88762730,6,0,0,512,7,1574547237
9358,64305840,30729838,95035678,9,0,1,4096,12,8594035169
9359,64309180,24026913,88336093,2,0,0,51200,3,66893770
9360,64311560,30724149,95035709,2,0,1,5632,3,4950787386
9361,64318390,30717342,95035732,9,0,1,7168,12,2236817371
9362,64321979,30731458,95053437,4,0,1,1024,15,6039470603
9363,64323560,30730271,95053831,9,0,1,2048,12,4231646360
9364,64323650,30732624,95056274,2,0,1,3072,3,7548448402
9365,64324799,24054806,88379605,3,0,0,7680,17,225601076
9366,64328910,30733295,95062205,1,0,1,15360,10,7345295212
9367,64333320,30733022,95066342,2,0,1,512,3,949323463
9368,64333900,30733428,95067328,9,0,1,1536,12,8003631025
9369,64336810,24302647,88639457,2,0,0,3584,3,4895784261
9370,64337000,30730994,95067994,1,0,1,1024,10,2555041134
9371,64355480,30713820,95069300,1,0,1,2048,10,2964313590
9372,64356729,24136177,88492906,1,0,0,29696,10,1147852235
9373,64357030,30713243,95070273,1,0,1,12800,10,1594610054
9374,64360829,24493043,88853872,3,0,0,18432,17,2617460220
9375,64371750,24611298,88983048,2,0,0,20480,3,1486427419
9376,64374159,30800326,95174485,4,0,1,2048,15,8116333494
9377,64379540,30795326,95174866,9,0,1,512,12,7126625507
9378,64390310,30784579,95174889,6,0,1,6144,7,7679683755
9379,64390889,24492563,88883452,1,0,0,70656,10,636393197
9380,64392159,23944113,88336272,1,0,0,512,10,8164638572
9381,64415270,30759642,95174912,1,0,1,512,10,5156918730
9382,64416290,30758980,95175270,2,0,1,2048,3,2202949287
9383,64417070,24362866,88779936,4,0,0,56320,15,8040727434
9384,64427369,30749530,95176899,4,0,1,3072,15,700780373
9385,64445140,24198240,88643380,2,0,0,12800,3,1532463589
9386,64455269,30721653,95176922,4,0,1,1536,15,4846846385
9387,64466329,24314346,88780675,1,0,0,2048,10,2077484764
9388,64469630,24159485,88629115,6,0,0,1024,7,1870184109
9389,64469799,24554151,89023950,1,0,0,22528,10,6076324829
9390,64475319,24153453,88628772,3,0,0,136192,17,9226444712
9391,64481790,30695155,95176945,9,0,1,1024,12,5694238905
9392,64493480,30683488,95176968,1,0,1,1024,10,481178854
9393,64500680,24144439,88645119,4,0,0,5632,15,5109225691
9394,64502210,24136132,88638342,4,0,0,30208,15,6551952150
9395,64515990,23926608,88442598,6,0,0,2048,7,5967498368
9396,64526610,24409540,88936150,6,0,0,512,7,7754790452
9397,64535099,24691567,89226666,3,0,0,131072,17,4373195349
9398,64541820,30635171,95176991,1,0,1,1024,10,7803153877
9399,64543580,30635329,95178909,7,0,1,2048,10,441219815
9400,64554739,30637788,95192527,4,0,1,2560,15,9986409883
9401,64562630,24554914,89117544,2,0,0,91648,3,4960872111
9402,64563300,24507941,89071241,4,0,0,155136,15,9124413213
9403,64565219,24228115,88793334,1,0,0,41472,10,8847647275
9404,64570310,30622240,95192550,1,0,1,3584,10,4998567636
9405,64572091,30620578,95192669,8,0,1,10752,8,7811070519
9406,64575410,30709500,95284910,2,0,1,17408,3,7698047810
9407,64581820,30731810,95313630,1,0,1,20992,10,6749171083
9408,64582670,30751872,95334542,2,0,1,1536,3,705438300
9409,64602070,30764898,95366968,9,0,1,2560,12,6058949538
9410,64602131,30770746,95372877,8,0,1,3072,8,6021314519
9411,64603800,24399127,89002927,6,0,0,1024,7,10014178623
9412,64614260,24201799,88816059,6,0,0,512,7,5730194833
9413,64621360,30767359,95388719,2,0,1,7168,3,5031370371
9414,64624189,30764553,95388742,4,0,1,6144,15,8930764070
9415,64626210,30784372,95410582,2,0,1,6656,3,2768368169
9416,64630980,30780268,95411248,1,0,1,1024,10,10317166614
9417,64635260,24291344,88926604,6,0,0,512,7,6375363284
9418,64641709,24486824,89128533,1,0,0,35328,10,737506875
9419,64641730,30772104,95413834,1,0,1,4096,10,7870005790
9420,64648080,24655071,89303151,4,0,0,15872,15,7537457923
9421,64648240,24501944,89150184,2,0,0,60416,3,259140702
9422,64660510,30794230,95454740,9,0,1,5632,12,3884586700
9423,64667970,24408181,89076151,4,0,0,512,15,10707270368
9424,64673301,30795750,95469051,8,0,1,4096,8,4624714607
9425,64674090,30794984,95469074,9,0,1,2048,12,2603276073
9426,64674169,24315707,88989876,3,0,0,1024,17,4540013808
9427,64676311,30820889,95497200,8,0,1,1536,8,2372672644
9428,64683030,30814201,95497231,9,0,1,1536,12,6433214445
9429,64683350,24392507,89075857,4,0,0,14336,15,1403365811
9430,64690579,24578517,89269096,1,0,0,29184,10,1832912282
9431,64694930,24433938,89128868,6,0,0,1024,7,2868492932
9432,64695129,24436593,89131722,1,0,0,9216,10,9779790554
9433,64697230,30800056,95497286,9,0,1,8192,12,9678151436
9434,64699769,30832887,95532656,4,0,1,4096,15,954215772
9435,64704750,25072113,89776863,4,0,0,47104,15,3886693822
9436,64710000,24361466,89071466,6,0,0,512,7,4070753300
9437,64713040,30819639,95532679,9,0,1,11264,12,6919513028
9438,64718020,30822068,95540088,9,0,1,3584,12,10731912224
9439,64719890,24615594,89335484,6,0,0,512,7,9826442393
9440,64728800,30842501,95571301,1,0,1,4608,10,6971093672
9441,64735219,30847324,95582543,4,0,1,512,15,1107019391
9442,64749869,24716887,89466756,3,0,0,35840,17,704348097
9443,64750720,24367026,89117746,6,0,0,512,7,7530570808
9444,64753020,24484612,89237632,4,0,0,35840,15,776191690
9445,64756009,30828160,95584169,4,0,1,2560,15,10114494297
9446,64757280,30846197,95603477,7,0,1,10240,10,3122317285
9447,64758940,25052925,89811865,4,0,0,48128,15,6046783821
9448,64760249,24600010,89360259,1,0,0,41984,10,566347004
9449,64767759,24492406,89260165,1,0,0,73728,10,2031224909
9450,64776170,24652594,89428764,6,0,0,2048,7,3881265462
9451,64776510,24492834,89269344,6,0,0,512,7,9456069793
9452,64780880,24771352,89552232,4,0,0,150016,15,4028496376
9453,64789259,24651494,89440753,3,0,0,33280,17,4497747772
9454,64793280,30820920,95614200,2,0,1,1536,3,10486342492
9455,64793599,30820632,95614231,4,0,1,6656,15,6179946398
9456,64798479,24879401,89677880,1,0,0,33792,10,1454396685
9457,64804429,24750657,89555086,1,0,0,9216,10,10443380524
9458,64805799,30808455,95614254,4,0,1,14848,15,1013867741
9459,64808140,30848629,95656769,7,0,1,5120,10,16350180
9460,64813709,24521596,89335305,3,0,0,41984,17,6683659648
9461,64825419,30838582,95664001,4,0,1,1024,15,499652589
9462,64825480,30838738,95664218,7,0,1,2048,10,2993293665
9463,64829410,30846380,95675790,7,0,1,3584,10,2847382533
9464,64829820,30877655,95707475,1,0,1,11264,10,8220190255
9465,64832320,30890749,95723069,2,0,1,2048,3,6467174384
9466,64833310,30889782,95723092,2,0,1,512,3,7424124776
9467,64840170,30890612,95730782,2,0,1,1536,3,7715611949
9468,64841621,30889184,95730805,8,0,1,3584,8,6407566685
9469,64849549,30881279,95730828,4,0,1,1024,15,5830451061
9470,64852230,24708495,89560725,4,0,0,18432,15,6250208728
9471,64859760,24485296,89345056,6,0,0,2048,7,2461343821
9472,64861140,30870626,95731766,1,0,1,15360,10,611313827
9473,64861230,24716221,89577451,6,0,0,1536,7,3208158829
9474,64863310,30884521,95747831,1,0,1,3584,10,2841713066
9475,64864749,24787452,89652201,1,0,0,3584,10,4267374157
9476,64871690,30876164,95747854,7,0,1,3072,10,6691447597
9477,64874640,30873751,95748391,2,0,1,5632,3,2235214561
9478,64879700,24593468,89473168,6,0,0,1536,7,4414536325
9479,64887040,30862177,95749217,9,0,1,3584,12,6779392652
9480,64892900,24791867,89684767,2,0,0,22528,3,220491128
9481,64894100,24582463,89476563,4,0,0,8192,15,5539837859
9482,64895289,24839946,89735235,3,0,0,46592,17,2535268638
9483,64899180,24693726,89592906,2,0,0,5120,3,1178043868
9484,64910720,30840761,95751481,9,0,1,8192,12,192602838
9485,64915099,30837048,95752147,4,0,1,1024,15,7217967059
9486,64916669,24903822,89820491,1,0,0,27648,10,7627373421
9487,64921720,24696868,89618588,2,0,0,66048,3,7645351684
9488,64934530,30817963,95752493,9,0,1,512,12,2648855538
9489,64939900,24776456,89716356,2,0,0,20992,3,6874307500
9490,64942619,30812780,95755399,4,0,1,4608,15,4598291945
9491,64944130,24809186,89753316,2,0,0,41472,3,8184318335
9492,64944580,30811485,95756065,1,0,1,1024,10,6174298887
9493,64954260,30804071,95758331,7,0,1,3584,10,10397014974
9494,64954870,24883318,89838188,4,0,0,7168,15,7543124407
9495,64957280,30837785,95795065,9,0,1,17408,12,6972616480
9496,64957870,24738929,89696799,2,0,0,7680,3,5363104073
9497,64965960,30832651,95798611,7,0,1,5632,10,5506623469
9498,64968930,30830449,95799379,2,0,1,11776,3,5770199621
9499,64972500,24863481,89835981,6,0,0,3072,7,8724674843
9500,64981880,30831829,95813709,7,0,1,4096,10,2185077050
9501,64982050,30832005,95814055,1,0,1,512,10,3045473544
9502,64985470,30830531,95816001,9,0,1,3072,12,7807668586
9503,64992540,30834695,95827235,1,0,1,12288,10,1649046863
9504,64993850,24625697,89619547,6,0,0,3072,7,5597759843
9505,64996130,30848592,95844722,1,0,1,4096,10,8463356325
9506,64998539,25120128,90118667,1,0,0,156672,10,10506422450
9507,65021670,30846251,95867921,1,0,1,10240,10,9652351690
9508,65024660,30856360,95881020,7,0,1,10752,10,9973693672
9509,65038680,24679727,89718407,4,0,0,6656,15,3228131956
9510,65039620,30842386,95882006,0,0,1,1536,3,3808704476
9511,65040429,24604211,89644640,1,0,0,20480,10,8973833198
9512,65044129,24965085,90009214,1,0,0,111104,10,188052301
9513,65047020,24661538,89708558,4,0,0,1024,15,10059247158
9514,65061140,30822172,95883312,7,0,1,2048,10,4845532107
9515,65080180,30812469,95892649,1,0,1,9216,10,4503587067
9516,65086030,30808207,95894237,2,0,1,15872,3,9942170452
9517,65087890,24531992,89619882,6,0,0,1024,7,3435070020
9518,65088710,30868722,95957432,7,0,1,3584,10,1387619044
9519,65095510,30863548,95959058,9,0,1,2560,12,1315650209
9520,65108880,25137562,90246442,2,0,0,1536,3,6857218574
9521,65109500,24651051,89760551,6,0,0,2048,7,4698753076
9522,65112009,25020680,90132689,3,0,0,18432,17,10029448236
9523,65127649,24890884,90018533,1,0,0,14848,10,7679436784
9524,65129020,24884920,90013940,4,0,0,15360,15,5542356025
9525,65131050,30828354,95959404,9,0,1,512,12,1641526986
9526,65136840,30924918,96061758,2,0,1,18432,3,8996907517
9527,65140440,31022339,96162779,1,0,1,6656,10,4664919244
9528,65140540,31047151,96187691,1,0,1,3072,10,8565598287
9529,65145180,31042534,96187714,1,0,1,9216,10,8064502499
9530,65145310,31042427,96187737,7,0,1,1024,10,8552821821
9531,65147210,24979840,90127050,2,0,0,26624,3,9478003877
9532,65150660,24727204,89877864,6,0,0,512,7,10434424879
9533,65157800,31029960,96187760,2,0,1,512,3,7995094174
9534,65165240,24646804,89812044,6,0,0,512,7,2732118764
9535,65172020,31031721,96203741,9,0,1,7680,12,2325143473
9536,65178170,31025594,96203764,9,0,1,512,12,5083552366
9537,65179370,31024425,96203795,9,0,1,9728,12,3512291909
9538,65184240,31036913,96221153,3,0,1,1536,17,3356323521
9539,65204990,31057647,96262637,9,0,1,9216,12,2480090338
9540,65209710,25454117,90663827,2,0,0,15872,3,3649446058
9541,65212450,31060554,96273004,9,0,1,7680,12,4707984548
9542,65218220,31059079,96277299,2,0,1,5120,3,3491571796
9543,65221400,24936686,90158086,4,0,0,61440,15,6427172614
9544,65230610,31047995,96278605,1,0,1,2048,10,4115348545
9545,65231140,31054349,96285489,1,0,1,512,10,2741882979
9546,65232130,31054025,96286155,2,0,1,1024,3,5004988636
9547,65234510,31052631,96287141,1,0,1,1536,10,7420793315
9548,65235790,24938901,90174691,4,0,0,54272,15,5451927612
9549,65236060,31077479,96313539,9,0,1,12800,12,6816213900
9550,65244730,31072655,96317385,2,0,1,512,3,2979076037
9551,65256520,31061531,96318051,1,0,1,11264,10,10418616862
9552,65259420,31118111,96377531,9,0,1,1536,12,4341209650
9553,65260820,31118196,96379016,2,0,1,15360,3,330622268
9554,65261039,25051044,90312083,3,0,0,55808,17,5132167483
9555,65274130,25366089,90640219,4,0,0,27136,15,10723240974
9556,65274240,31137648,96411888,1,0,1,2560,10,4624406720
9557,65287500,25525712,90813212,4,0,0,50176,15,4134629776
9558,65293670,24989816,90283486,4,0,0,41472,15,1283903503
9559,65295170,31117064,96412234,9,0,1,512,12,5318772396
9560,65319740,31093160,96412900,1,0,1,1024,10,5233684182
9561,65333590,31094964,96428554,1,0,1,4096,10,5876184916
9562,65338460,25078776,90417236,4,0,0,35840,15,6097539485
9563,65342110,25330952,90673062,4,0,0,30208,15,3343706160
9564,65346159,31173363,96519522,4,0,1,4608,15,1573163920
9565,65348470,26123175,91471645,4,0,0,49664,15,3984037883
9566,65348660,31170885,96519545,1,0,1,9216,10,7869609465
9567,65360300,24772607,90132907,6,0,0,512,7,10126794047
9568,65366130,31153438,96519568,2,0,1,2048,3,10055133298
9569,65370090,25463853,90833943,2,0,0,41984,3,652358402
9570,65376640,31142951,96519591,1,0,1,10240,10,4722705833
9571,65385830,24898014,90283844,6,0,0,1024,7,7987600888
9572,65390570,24853389,90243959,6,0,0,1024,7,7075027913
9573,65409420,31114741,96524161,2,0,1,3072,3,2900722859
9574,65416110,31108074,96524184,1,0,1,2048,10,8485643946
9575,65419729,31104478,96524207,4,0,1,1536,15,8789331892
9576,65426720,24823404,90250124,2,0,0,6656,3,59993965
9577,65431979,26092251,91524230,1,0,0,2048,10,2346847294
9578,65444460,24784853,90229313,2,0,0,67584,3,4922425892
9579,65446360,25499604,90945964,4,0,0,12288,15,4946307328
9580,65448850,24797101,90245951,2,0,0,5120,3,5046654017
9581,65449750,24797495,90247245,2,0,0,2560,3,9197156380
9582,65463400,26214955,91678355,6,0,0,1536,7,9738712919
9583,65475190,24643656,90118846,6,0,0,512,7,8890719358
9584,65487200,24688629,90175829,6,0,0,3584,7,2688926527
9585,65491470,25306362,90797832,6,0,0,126976,7,1452381321
9586,65493800,31030462,96524262,1,0,1,7680,10,8790615405
9587,65496480,25437057,90933537,6,0,0,8192,7,3051441364
9588,65513230,31035803,96549033,1,0,1,512,10,788422289
9589,65514770,31105018,96619788,1,0,1,8704,10,7144311193
9590,65522550,24977193,90499743,4,0,0,76288,15,9355196983
9591,65535690,25689032,91224722,6,0,0,15360,7,3944356853
9592,65542080,31090192,96632272,1,0,1,2048,10,8050920637
9593,65564639,25401710,90966349,1,0,0,6144,10,647549262
9594,65567280,31065338,96632618,2,0,1,512,3,10653302666
9595,65568699,25505128,91073827,3,0,0,120832,17,9229026525
9596,65583919,26110543,91694462,3,0,0,29184,17,605494106
9597,65592350,24586006,90178356,6,0,0,8192,7,2254359019
9598,65607059,26200653,91807712,3,0,0,162816,17,9937561314
9599,65611910,25697008,91308918,6,0,0,43008,7,6396159754
9600,65613240,31019724,96632964,2,0,1,512,3,6189791339
9601,65614859,25044109,90658968,1,0,0,57856,10,6822898881
9602,65622180,31012410,96634590,6,0,1,2560,7,8334598938
9603,65625709,24985682,90611391,1,0,0,58368,10,7392937811
9604,65627740,31009462,96637202,6,0,1,4096,7,8616300118
9605,65628640,25803740,91432380,6,0,0,28672,7,1615512576
9606,65641030,31001440,96642470,2,0,1,7168,3,1327931737
9607,65661949,24957577,90619526,1,0,0,26624,10,4055002690
9608,65676390,30971706,96648096,6,0,1,5632,7,7237683851
9609,65680490,25538455,91218945,2,0,0,161280,3,5235311205
9610,65681430,31012073,96693503,1,0,1,512,10,8296229674
9611,65690770,31002756,96693526,1,0,1,512,10,5321084559
9612,65692940,25337040,91029980,2,0,0,19968,3,6688530202
9613,65695130,25328743,91023873,6,0,0,120832,7,8517221300
9614,65697129,25061774,90758903,1,0,0,50176,10,6133750141
9615,65712610,30980939,96693549,2,0,1,512,3,6368998771
9616,65715450,30978122,96693572,1,0,1,2560,10,1068556801
9617,65716689,25209603,90926292,3,0,0,137216,17,8653489520
9618,65719050,31020034,96739084,6,0,1,15360,7,5153247043
9619,65727399,25358049,91085448,3,0,0,37888,17,10685267339
9620,65731740,25124366,90856106,6,0,0,28160,7,1613409733
9621,65733180,31005927,96739107,6,0,1,5632,7,5744776441
9622,65735929,25251105,90987034,1,0,0,27648,10,7476545395
9623,65740850,25492569,91233419,2,0,0,25088,3,8743433505
9624,65743230,31033329,96776559,2,0,1,29184,3,3032149576
9625,65744389,25425393,91169782,3,0,0,21504,17,8621338563
9626,65753819,25281110,91034929,3,0,0,15360,17,4351433947
9627,65757269,25063812,90821081,3,0,0,25600,17,509513604
9628,65757700,31023045,96780745,1,0,1,6656,10,2824167046
9629,65764489,25455172,91219661,3,0,0,1024,17,301896510
9630,65764990,25350044,91115034,2,0,0,42496,3,4084048437
9631,65769390,26105582,91874972,2,0,0,13312,3,5636652339
9632,65769659,25379983,91149642,1,0,0,9728,10,5814552797
9633,65778990,31002421,96781411,6,0,1,1024,7,6661452551
9634,65779300,26189072,91968372,2,0,0,5120,3,7885784649
9635,65786190,25608973,91395163,2,0,0,26624,3,4373590837
9636,65796709,24876540,90673249,3,0,0,512,17,2538342116
9637,65816700,25123101,90939801,2,0,0,19968,3,4369000095
9638,65817270,30966087,96783357,2,0,1,3072,3,5022810122
9639,65820250,25152356,90972606,2,0,0,15872,3,1123609961
9640,65823799,25023704,90847503,1,0,0,30720,10,7227897017
9641,65828639,25454154,91282793,1,0,0,10752,10,2824257890
9642,65829360,30957863,96787223,2,0,1,6144,3,5635909541
9643,65830689,31053081,96883770,4,0,1,13312,15,7797921990
9644,65836160,31047649,96883809,1,0,1,1536,10,4650495125
9645,65838519,25092476,90930995,1,0,0,15360,10,1194808211
9646,65839320,31044512,96883832,1,0,1,4096,10,4228813763
9647,65841920,25860388,91702308,4,0,0,25600,15,382524531
9648,65842920,31040935,96883855,6,0,1,9728,7,8346620844
9649,65845080,31038798,96883878,6,0,1,14336,7,2639305912
9650,65860469,31066993,96927462,4,0,1,1536,15,6052923239
9651,65860629,31104030,96964659,4,0,1,11776,15,8031121770
9652,65860650,31114349,96974999,6,0,1,9216,7,8742886818
9653,65891390,31084595,96975985,2,0,1,1536,3,4187935625
9654,65898569,25188174,91086743,3,0,0,4096,17,957735218
9655,65906220,25757269,91663489,6,0,0,30208,7,10715503950
9656,65915110,31061221,96976331,6,0,1,512,7,4763911121
9657,65920780,31059737,96980517,2,0,1,6656,3,10131446316
9658,65924649,26146835,92071484,1,0,0,10752,10,7893130835
9659,65927809,25297895,91225704,3,0,0,3072,17,6119687666
9660,65932850,31109642,97042492,2,0,1,13312,3,585248760
9661,65933910,31150865,97084775,1,0,1,11776,10,7966681393
9662,65939109,31193399,97132508,4,0,1,512,15,9814586069
9663,65939299,25279981,91219280,3,0,0,1024,17,3914682834
9664,65947319,25145852,91093171,3,0,0,2048,17,7825017098
9665,65959810,26006979,91966789,4,0,0,44032,15,9795676233
9666,65976630,31155901,97132531,1,0,1,512,10,3956047666
9667,65990670,26326232,92316902,4,0,0,112128,15,4716817677
9668,65993090,31139464,97132554,2,0,1,6144,3,7068192619
9669,66006260,31173349,97179609,1,0,1,512,10,3706719637
9670,66024079,31155553,97179632,4,0,1,1024,15,5763861971
9671,66034710,31148203,97182913,3,0,1,10752,17,512056308
9672,66039469,25180550,91220019,3,0,0,512,17,9750088794
9673,66042960,25452911,91495871,6,0,0,79360,7,9652125293
9674,66049710,25361544,91411254,6,0,0,52736,7,9565423042
9675,66052080,31213694,97265774,3,0,1,2048,17,5052614599
9676,66054329,31222753,97277082,4,0,1,3072,15,2048868766
9677,66055979,25533503,91589482,1,0,0,29696,10,3004375444
9678,66065230,25388192,91453422,4,0,0,6144,15,4018171520
9679,66075440,25521085,91596525,4,0,0,23040,15,3227015138
9680,66084010,31209149,97293159,3,0,1,1536,17,2252153368
9681,66090289,25129551,91219840,3,0,0,512,17,2877992563
9682,66093090,25655881,91748971,6,0,0,17408,7,905595018
9683,66100460,31243151,97343611,1,0,1,24064,10,8679055673
9684,66101100,31242534,97343634,2,0,1,4608,3,446134264
9685,66102850,31243015,97345865,1,0,1,4096,10,6695342561
9686,66111050,31268902,97379952,1,0,1,512,10,262594394
9687,66115330,31264645,97379975,2,0,1,2560,3,328892492
9688,66117730,31265567,97383297,3,0,1,1536,17,1119809637
9689,66127469,25210265,91337734,1,0,0,20992,10,2708927652
9690,66127581,31255739,97383320,5,0,1,2560,10,9629026172
9691,66133650,31249693,97383343,2,0,1,3584,3,5669559757
9692,66133949,25864169,91998118,1,0,0,77312,10,9829987998
9693,66134679,25445732,91580411,1,0,0,41472,10,10433425208
9694,66137849,31255402,97393251,4,0,1,1536,15,2127929665
9695,66140760,31285069,97425829,2,0,1,1536,3,349203874
9696,66156649,25983757,92140406,3,0,0,512,17,6582993758
9697,66158840,25958759,92117599,2,0,0,16384,3,1956193407
9698,66169800,31257042,97426842,1,0,1,1536,10,6595872207
9699,66170340,31268706,97439046,3,0,1,6656,17,273418012
9700,66186260,25866527,92052787,6,0,0,32768,7,5564593730
9701,66188769,31263485,97452254,4,0,1,16384,15,6225479250
9702,66201210,31329163,97530373,1,0,1,29696,10,1694015222
9703,66210980,31349332,97560312,1,0,1,1536,10,1957405005
9704,66212820,31349122,97561942,3,0,1,23040,17,3659398056
9705,66229000,31357402,97586402,2,0,1,7680,3,4039437043
9706,66243190,25272541,91515731,2,0,0,5632,3,4915551787
9707,66252340,31334728,97587068,9,0,1,1024,12,10668891647
9708,66253440,25278777,91532217,6,0,0,14848,7,4927959495
9709,66274879,31324204,97599083,4,0,1,5632,15,2894568048
9710,66277619,31322490,97600109,4,0,1,1536,15,5360908122
9711,66298680,26068424,92367104,4,0,0,33792,15,5784219997
9712,66301590,25376274,91677864,4,0,0,47104,15,6985464836
9713,66309220,25344996,91654216,6,0,0,70144,7,2674018900
9714,66316720,31288561,97605281,3,0,1,8192,17,3361890230
9715,66339599,31266988,97606587,4,0,1,2048,15,7930466716
9716,66341810,25008154,91349964,6,0,0,10240,7,6230316067
9717,66341979,31265594,97607573,4,0,1,1536,15,4920815539
9718,66359290,31249909,97609199,1,0,1,2560,10,854605339
9719,66360219,31257352,97617571,4,0,1,13312,15,4425510319
9720,66362570,31279304,97641874,1,0,1,11776,10,8012400625
9721,66363150,31353035,97716185,6,0,1,12288,7,1127455358
9722,66375819,25851112,92226931,1,0,0,60416,10,3422114063
9723,66380949,25115265,91496214,3,0,0,1024,17,9762169493
9724,66412080,25534776,91946856,6,0,0,34816,7,4732674918
9725,66414690,25085019,91499709,6,0,0,512,7,1232633785
9726,66416860,31309169,97726029,3,0,1,1536,17,3485869146
9727,66424529,25020521,91445050,3,0,0,1024,17,6038952984
9728,66429891,31297124,97727015,8,0,1,1536,8,7332625396
9729,66431720,31295961,97727681,3,0,1,1024,17,8784564430
9730,66440540,31287487,97728027,6,0,1,512,7,7964078641
9731,66452590,31296975,97749565,6,0,1,11264,7,5268002556
9732,66452830,25275503,91728333,6,0,0,43520,7,4535311080
9733,66461710,25354830,91816540,6,0,0,22016,7,6232502060
9734,66472130,31277458,97749588,6,0,1,512,7,1728126037
9735,66491450,31258161,97749611,3,0,1,16896,17,6192727100
9736,66504759,25107302,91612061,1,0,0,17920,10,10303310744
9737,66523570,25663334,92186904,4,0,0,13824,15,2858529158
9738,66526090,25217554,91743644,6,0,0,50176,7,1307054717
9739,66532190,31306688,97838878,6,0,1,1024,7,8935925913
9740,66562890,31277602,97840492,3,0,1,18432,17,9966510295
9741,66565720,31274803,97840523,6,0,1,1536,7,4148055130
9742,66572110,25107692,91679802,4,0,0,3584,15,987141782
9743,66584150,31267651,97851801,6,0,1,2048,7,592705845
9744,66610480,31241352,97851832,6,0,1,512,7,5241794889
9745,66617380,31234483,97851863,3,0,1,11776,17,872557721
9746,66621800,25214769,91836569,4,0,0,33792,15,10573807866
9747,66621999,25881034,92503033,3,0,0,512,17,797833025
9748,66630670,31221232,97851902,3,0,1,3584,17,3254161098
9749,66639570,25170239,91809809,6,0,0,6656,7,5485276876
9750,66650480,31221462,97871942,3,0,1,7168,17,9951097297
9751,66656180,31215785,97871965,6,0,1,9728,7,8435990743
9752,66656370,31226387,97882757,3,0,1,11776,17,7142886196
9753,66664849,25366513,92031362,1,0,0,11264,10,5092535119
9754,66707910,31193850,97901760,3,0,1,6656,17,4930373339
9755,66727380,31179777,97907157,6,0,1,2048,7,1373928360
9756,66728160,25090119,91818279,4,0,0,5632,15,10072966403
9757,66734870,25710276,92445146,4,0,0,29696,15,2758609253
9758,66735170,25368439,92103609,4,0,0,4608,15,10531744959
9759,66744699,24970351,91715050,1,0,0,31744,10,665047468
9760,66764830,25244855,92009685,6,0,0,37888,7,3819500429
9761,66773559,25863065,92636624,1,0,0,8704,10,2722126910
9762,66775710,31139525,97915235,6,0,1,512,7,7864717776
9763,66781480,31134421,97915901,3,0,1,11264,17,844177462
9764,66784760,25838855,92623615,6,0,0,2560,7,8726877282
9765,66789790,25374819,92164609,4,0,0,79360,15,2452097840
9766,66802930,25101673,91904603,4,0,0,24064,15,3877053710
9767,66807000,31123463,97930463,6,0,1,3072,7,3527615264
9768,66811549,25025199,91836748,3,0,0,512,17,7633068136
9769,66852440,31078046,97930486,6,0,1,11264,7,3584628721
9770,66859400,26128942,92988342,4,0,0,60416,15,7006354279
9771,66917870,25222357,92140227,6,0,0,31232,7,6590689722
9772,66920100,31029695,97949795,3,0,1,1536,17,6447244981
9773,66926240,24911526,91837766,6,0,0,2048,7,3512944820
9774,66960649,24792010,91752659,1,0,0,11776,10,6978337774
9775,66970280,25223149,92193429,4,0,0,3072,15,9755573428
9776,66994219,26063241,93057460,3,0,0,2048,17,2376642927
9777,67001469,25250948,92252417,3,0,0,512,17,2303974701
9778,67005539,25004325,92009864,3,0,0,512,17,8670578695
9779,67055629,24963930,92019559,1,0,0,31744,10,2618949920
9780,67078889,25238504,92317393,3,0,0,1536,17,1141540715
9781,67090800,25015169,92105969,6,0,0,1024,7,3736892702
9782,67092381,30874636,97967017,5,0,1,20480,10,216911403
9783,67100379,25132659,92233038,1,0,0,19968,10,10334123826
9784,67107140,25395714,92502854,4,0,0,84992,15,210539019
9785,67145939,24928929,92074868,3,0,0,512,17,10565964199
9786,67149970,25419478,92569448,4,0,0,30208,15,2672368430
9787,67168469,25335858,92504327,3,0,0,512,17,3288134033
9788,67175859,30795729,97971588,4,0,1,3072,15,1574455047
9789,67190779,24869519,92060298,1,0,0,12800,10,4928380816
9790,67222810,25625732,92848542,4,0,0,113664,15,10016595099
9791,67232449,30740765,97973214,4,0,1,2560,15,4033593635
9792,67241520,30795199,98036719,9,0,1,2560,12,1648694361
9793,67252359,30790109,98042468,4,0,1,5632,15,3078195433
9794,67263200,24756850,92020050,6,0,0,1536,7,8913515809
9795,67268089,24919150,92187239,3,0,0,1024,17,4550440367
9796,67286580,30757194,98043774,2,0,1,2048,3,5843108130
9797,67325280,25101453,92426733,4,0,0,20480,15,970071057
9798,67325461,30722499,98047960,8,0,1,6656,8,2588143450
9799,67327349,24761344,92088693,3,0,0,1024,17,5034155215
9800,67328721,30730681,98059402,8,0,1,2048,8,6663562067
9801,67331789,25048846,92380635,1,0,0,34816,10,1940538217
9802,67350910,30712998,98063908,1,0,1,7168,10,5880405533
9803,67359369,30713258,98072627,4,0,1,512,15,4857361813
9804,67368559,25067508,92436067,1,0,0,12288,10,4051332516
9805,67376329,24647931,92024260,1,0,0,1536,10,9933012458
9806,67391250,25036043,92427293,6,0,0,1536,7,5221087012
9807,67392110,25548974,92941084,6,0,0,1536,7,8952016020
9808,67393790,30679913,98073703,2,0,1,13312,3,1172437057
9809,67402770,24708597,92111367,6,0,0,512,7,2234479127
9810,67409729,30756382,98166111,4,0,1,11776,15,7310720051
9811,67412819,30761521,98174340,4,0,1,3072,15,2996852937
9812,67415110,24710633,92125743,6,0,0,512,7,2012130254
9813,67422869,30759497,98182366,4,0,1,6144,15,3002542836
9814,67436190,25322650,92758840,6,0,0,512,7,10320431492
9815,67443160,24793246,92236406,4,0,0,10752,15,2856327063
9816,67447511,30735521,98183032,8,0,1,1024,8,6390153180
9817,67448989,30735989,98184978,4,0,1,3072,15,6145398042
9818,67450879,30745646,98196525,4,0,1,14336,15,5179297673
9819,67464990,24925052,92390042,4,0,0,30720,15,8601908628
9820,67473051,30725740,98198791,8,0,1,3584,8,1766429322
9821,67480550,24621525,92102075,6,0,0,2560,7,6982320878
9822,67493590,24926880,92420470,4,0,0,97792,15,5701134447
9823,67500370,24603418,92103788,6,0,0,512,7,1147713779
9824,67523001,30681782,98204783,8,0,1,512,8,8824582828
9825,67539390,30702912,98242302,2,0,1,12800,3,5140083078
9826,67540600,24546347,92086947,6,0,0,1024,7,4161851667
9827,67542191,30700134,98242325,8,0,1,3072,8,2823195260
9828,67551349,30691178,98242527,4,0,1,4096,15,2283096509
9829,67562200,30694475,98256675,2,0,1,10752,3,951189314
9830,67563650,25899657,93463307,4,0,0,66048,15,2103913827
9831,67589769,30708547,98298316,4,0,1,7680,15,1864482463
9832,67590119,25558973,93149092,3,0,0,77824,17,5549298087
9833,67598521,30715004,98313525,8,0,1,5120,8,7333991601
9834,67598639,26130544,93729183,1,0,0,110592,10,3834920146
9835,67612370,30703380,98315750,2,0,1,3072,3,10463738326
9836,67630289,30689673,98319962,4,0,1,6656,15,154552986
9837,67658000,24666727,92324727,6,0,0,1024,7,4266623174
9838,67658611,30664897,98323508,8,0,1,5632,8,8887689834
9839,67663160,30672645,98335805,2,0,1,3072,3,4429957320
9840,67666701,30669450,98336151,8,0,1,512,8,9581619587
9841,67690130,30665673,98355803,2,0,1,5120,3,6254069724
9842,67695020,24927792,92622812,4,0,0,44032,15,1919960620
9843,67695241,30679901,98375142,8,0,1,1536,8,4890950934
9844,67695980,24736272,92432252,4,0,0,14848,15,445422537
9845,67708349,30669428,98377777,4,0,1,2048,15,8432017805
9846,67724999,30659550,98384549,4,0,1,10752,15,4746229360
9847,67731190,24696507,92427697,6,0,0,1024,7,8595057046
9848,67738299,30702582,98440881,4,0,1,12288,15,4999997116
9849,67746920,25378437,93125357,4,0,0,31232,15,2495703400
9850,67759760,30682103,98441863,2,0,1,1536,3,3851866007
9851,67767209,25565164,93332373,1,0,0,54272,10,503740245
9852,67767310,24736838,92504148,4,0,0,3584,15,2311418175
9853,67772519,24597416,92369935,1,0,0,9216,10,756703473
9854,67802490,24524912,92327402,4,0,0,8704,15,10691263198
9855,67811760,24877569,92689329,4,0,0,1536,15,5566963088
9856,67831700,25769973,93601673,4,0,0,103424,15,7722922727
9857,67836110,25407792,93243902,4,0,0,73728,15,9479690112
9858,67852120,30641429,98493549,2,0,1,21504,3,6474722288
9859,67853720,24687313,92541033,6,0,0,1024,7,3499297413
9860,67865570,30664559,98530129,2,0,1,10240,3,635050553
9861,67866111,30671864,98537975,8,0,1,1536,8,7656981540
9862,67875450,30664791,98540241,2,0,1,3584,3,9665255165
9863,67892691,30648856,98541547,8,0,1,2048,8,3195131898
9864,67896239,25507864,93404103,3,0,0,46592,17,2949711982
9865,67897091,30649245,98546336,8,0,1,5632,8,10404349236
9866,67921569,24830381,92751950,3,0,0,28160,17,5647529796
9867,67931059,30618778,98549837,4,0,1,3584,15,8216851713
9868,67938809,30612759,98551568,4,0,1,12800,15,8536326584
9869,67942259,30610282,98552541,4,0,1,12800,15,9584389219
9870,67944061,30620563,98564624,8,0,1,7680,8,2104577071
9871,67945809,30647747,98593556,4,0,1,512,15,1532198426
9872,67950729,30642850,98593579,4,0,1,3584,15,9998135141
9873,67953589,30640013,98593602,4,0,1,1536,15,3692341306
9874,67956060,30643342,98599402,7,0,1,2048,10,7752916191
9875,67958080,24558432,92516512,4,0,0,33792,15,179457669
9876,68020429,30579959,98600388,4,0,1,1536,15,1576975533
9877,68032850,30568524,98601374,2,0,1,1536,3,2625874211
9878,68037560,24409039,92446599,6,0,0,512,7,5863089101
9879,68046149,25580975,93627124,3,0,0,83456,17,5454604600
9880,68061520,30540200,98601720,7,0,1,512,10,3915329629
9881,68061569,30549685,98611254,4,0,1,4096,15,7388375471
9882,68077290,24461765,92539055,4,0,0,19968,15,641466860
9883,68084490,24635643,92720133,4,0,0,22016,15,5991936512
9884,68085090,24721502,92806592,4,0,0,45056,15,2781395949
9885,68091080,30533518,98624598,2,0,1,6144,3,10311267239
9886,68094140,25059691,93153831,6,0,0,512,7,2087192658
9887,68099680,25009999,93109679,6,0,0,512,7,8566005792
9888,68104961,30520623,98625584,5,0,1,1536,10,4749423512
9889,68110390,24630006,92740396,6,0,0,512,7,6659573509
9890,68122979,25572485,93695464,3,0,0,165376,17,7908620808
9891,68152160,24631644,92783804,6,0,0,512,7,2599131723
9892,68161769,30490227,98651996,4,0,1,10240,15,2091216146
9893,68170439,30481580,98652019,4,0,1,512,15,6694140691
9894,68172409,25600206,93772615,3,0,0,86528,17,2053890328
9895,68178150,30473892,98652042,2,0,1,13824,3,4799605651
9896,68184930,24966062,93150992,6,0,0,4608,7,535017364
9897,68197470,30463563,98661033,2,0,1,4608,3,112717881
9898,68201101,30459955,98661056,5,0,1,11264,10,1685540064
9899,68218641,30447669,98666310,5,0,1,1024,10,9078406283
9900,68219420,30490748,98710168,7,0,1,14848,10,9669340523
9901,68231160,25764007,93995167,4,0,0,29696,15,3397891428
9902,68231490,30478701,98710191,7,0,1,1024,10,9372244665
9903,68243409,30466805,98710214,4,0,1,14336,15,6441809434
9904,68246369,30463868,98710237,4,0,1,7168,15,10677585477
9905,68250380,24421411,92671791,4,0,0,35840,15,8967443815
9906,68267470,30442790,98710260,7,0,1,6656,10,2342350282
9907,68268580,30442194,98710774,3,0,1,5632,17,10081305323
9908,68268759,24760133,93028892,3,0,0,6144,17,8595661642
9909,68282461,30441495,98723956,5,0,1,7168,10,5495331070
9910,68288880,30435099,98723979,2,0,1,512,3,9581857292
9911,68289500,24259934,92549434,6,0,0,1536,7,5223738345
9912,68290570,30433432,98724002,2,0,1,2560,3,6108267773
9913,68291450,30432575,98724025,2,0,1,4096,3,5518914257
9914,68291979,24677285,92969264,3,0,0,32256,17,1516718429
9915,68292830,24763983,93056813,4,0,0,34816,15,5949985567
9916,68295170,30428878,98724048,7,0,1,5632,10,8217377536
9917,68304311,30419760,98724071,5,0,1,512,10,6116513711
9918,68322289,24369701,92691990,3,0,0,7168,17,6926506724
9919,68323799,30400295,98724094,4,0,1,4096,15,10682469696
9920,68337141,30399358,98736499,5,0,1,16384,10,10258680512
9921,68338500,30399305,98737805,7,0,1,2048,10,10279825398
9922,68372549,30380929,98753478,4,0,1,3072,15,7249557268
9923,68380950,30372682,98753632,2,0,1,8704,3,1302358014
9924,68383761,30419840,98803601,5,0,1,1024,10,5790756238
9925,68385390,25360838,93746228,4,0,0,43008,15,7448173210
9926,68386171,30417453,98803624,5,0,1,3584,10,5805253809
9927,68405069,25520820,93925889,3,0,0,74752,17,8553372820
9928,68431360,24382527,92813887,6,0,0,512,7,5984990447
9929,68444490,24413458,92857948,0,0,0,27648,3,4071162771
9930,68448099,30371876,98819975,4,0,1,4096,15,9534495530
9931,68474560,25379716,93854276,4,0,0,96256,15,5500546327
9932,68474829,25398443,93873272,3,0,0,5120,17,5131437461
9933,68486140,30334091,98820231,2,0,1,9216,3,1580000615
9934,68489981,30395553,98885534,5,0,1,1536,10,3136359363
9935,68501650,24487191,92988841,6,0,0,1536,7,7154550262
9936,68502790,30385010,98887800,2,0,1,3584,3,5491201261
9937,68510799,24638651,93149450,3,0,0,1024,17,6343175520
9938,68523370,24326131,92849501,6,0,0,3072,7,10220836556
9939,68535430,30353036,98888466,7,0,1,1024,10,1689725569
9940,68539609,24643732,93183341,3,0,0,32768,17,10720220962
9941,68545060,30352427,98897487,7,0,1,22528,10,5895619401
9942,68549500,25590160,94139660,4,0,0,38400,15,8889519159
9943,68552780,30364712,98917492,9,0,1,5120,12,8469592494
9944,68555040,24745351,93300391,0,0,0,32256,3,8013599980
9945,68561260,24729211,93290471,4,0,0,40448,15,7042170171
9946,68563109,25000106,93563215,3,0,0,35328,17,1487405895
9947,68566709,24509187,93075896,3,0,0,512,17,8698727425
9948,68568149,24604605,93172754,3,0,0,1536,17,5966941372
9949,68571460,24487161,93058621,0,0,0,3584,3,6375261292
9950,68578381,30341697,98920078,5,0,1,4096,10,543423969
9951,68603591,30318433,98922024,5,0,1,3072,10,8840509091
9952,68627830,24370550,92998380,4,0,0,31232,15,4001201298
9953,68628890,24408675,93037565,6,0,0,512,7,3368971007
9954,68629160,30297370,98926530,7,0,1,7168,10,6485190587
9955,68631440,30296396,98927836,2,0,1,2048,3,9658246063
9956,68654710,30275712,98930422,7,0,1,4096,10,8724026094
9957,68655370,30283015,98938385,2,0,1,4096,3,2788126530
9958,68658449,24311462,92969911,3,0,0,2048,17,7335059453
9959,68659120,30314247,98973367,7,0,1,10752,10,5533141544
9960,68665459,30373171,99038630,4,0,1,5120,15,3090415806
9961,68675170,30421946,99097116,2,0,1,1536,3,6204339205
9962,68685221,30411918,99097139,5,0,1,8192,10,3828025242
9963,68688271,30533703,99221974,5,0,1,15360,10,812813906
9964,68689689,30583218,99272907,4,0,1,4096,15,6161177940
9965,68695439,30603277,99298716,4,0,1,17920,15,2591845772
9966,68696219,24467339,93163558,3,0,0,2048,17,3982243792
9967,68699850,30612663,99312513,9,0,1,9728,12,10201102744
9968,68714859,30597677,99312536,4,0,1,12288,15,5741622880
9969,68715890,24913526,93629416,4,0,0,5120,15,5350861140
9970,68718990,30609044,99328034,7,0,1,3584,10,698437462
9971,68721669,30662913,99384582,4,0,1,1024,15,2974425675
9972,68724690,24458830,93183520,6,0,0,512,7,2588269401
9973,68727160,30657445,99384605,9,0,1,7680,12,3227187538
9974,68729040,24691938,93420978,8,0,0,46592,8,163574041
9975,68747980,24723173,93471153,0,0,0,25600,3,4957177582
9976,68753640,30630988,99384628,9,0,1,12288,12,2998772761
9977,68755811,30682090,99437901,5,0,1,2560,10,6317230286
9978,68758670,30693044,99451714,2,0,1,7168,3,5217188013
9979,68763380,24597893,93361273,6,0,0,1024,7,9860956478
9980,68770590,30681147,99451737,7,0,1,3072,10,6667186740
9981,68772460,24604908,93377368,0,0,0,6144,3,9597392516
9982,68783730,24784032,93567762,0,0,0,14848,3,4898388770
9983,68790581,30661179,99451760,5,0,1,7680,10,5078659176
9984,68806370,25202906,94009276,4,0,0,43520,15,5820566903
9985,68806920,25069802,93876722,6,0,0,512,7,596039569
9986,68807681,30644102,99451783,5,0,1,3072,10,156866924
9987,68813479,30663778,99477257,4,0,1,4096,15,1325378940
9988,68816110,30661170,99477280,2,0,1,2560,3,10210404738
9989,68819051,30658252,99477303,5,0,1,1024,10,7014362422
9990,68828069,30649257,99477326,4,0,1,512,15,1673148070
9991,68828680,30648669,99477349,7,0,1,1024,10,8779689796
9992,68831250,24594766,93426016,0,0,0,15360,3,3582900810
9993,68837720,25424637,94262357,4,0,0,2048,15,4293113494
9994,68864130,24909421,93773551,0,0,0,2048,3,6549881436
9995,68864359,24626745,93491104,3,0,0,1024,17,5860034489
9996,68871040,30606348,99477388,2,0,1,19968,3,4919216315
9997,68884419,30592992,99477411,4,0,1,1536,15,6225757399
9998,68890770,30586688,99477458,2,0,1,12800,3,1454852900
9999,68912159,24427372,93339531,3,0,0,1024,17,231868589
10000,68912871,30572332,99485203,5,0,1,4608,10,6279700421
10001,68913150,24558755,93471905,0,0,0,1024,3,8900467717
10002,68925310,24479752,93405062,0,0,0,3072,3,9698781210
10003,68930280,25079643,94009923,0,0,0,2048,3,1683216257
10004,68952520,30546351,99498871,9,0,1,17408,12,6911930371
10005,68969849,30532248,99502097,4,0,1,5120,15,5804747361
10006,68977139,24543803,93520942,3,0,0,2048,17,2642806445
10007,68993950,30510733,99504683,2,0,1,4096,3,1313802317
10008,68995481,30551681,99547162,5,0,1,4096,10,4629656517
10009,68996460,24549963,93546423,6,0,0,2560,7,8071333363
10010,69018889,24711253,93730142,3,0,0,3072,17,9327127309
10011,69037790,24490922,93528712,6,0,0,1536,7,4702324878
10012,69044900,24376413,93421313,0,0,0,1024,3,2223658912
10013,69047250,24684457,93731707,0,0,0,2560,3,10245948142
10014,69061210,30489818,99551028,2,0,1,6144,3,1244982321
10015,69061229,30490785,99552014,4,0,1,1536,15,2621432
10016,69071511,30482129,99553640,5,0,1,2560,10,5353437391
10017,69075849,25299045,94374894,3,0,0,512,17,960034951
10018,69084859,30469447,99554306,4,0,1,1024,15,1087554994
10019,69094050,25146505,94240555,0,0,0,1024,3,4739806827
10020,69095399,24532426,93627825,3,0,0,512,17,4413292667
10021,69101640,24671264,93772904,0,0,0,512,3,7422767011
10022,69117880,24353544,93471424,0,0,0,512,3,10575235792
10023,69137690,30418242,99555932,2,0,1,2560,3,6353929901
10024,69140831,30453790,99594621,5,0,1,6144,10,9302017971
10025,69140930,24762160,93903090,4,0,0,65536,15,1094597343
10026,69145210,24654526,93799736,4,0,0,12288,15,1632682771
10027,69148419,24882874,94031293,3,0,0,35328,17,7803262493
10028,69170309,24930272,94100581,3,0,0,89600,17,4101271497
10029,69171030,24684343,93855373,0,0,0,2048,3,8504858619
10030,69173970,25297383,94471353,4,0,0,64000,15,3545638167
10031,69175589,30424178,99599767,4,0,1,8192,15,6350284001
10032,69177400,30452628,99630028,9,0,1,1536,12,3077409690
10033,69177589,24553044,93730633,3,0,0,1536,17,8047535264
10034,69177869,30452182,99630051,4,0,1,2048,15,9951488299
10035,69179159,30450915,99630074,4,0,1,2560,15,5398366023
10036,69179190,30453509,99632699,9,0,1,6656,12,9796721338
10037,69179250,30457943,99637193,9,0,1,1536,12,1541463939
10038,69187820,30453050,99640870,9,0,1,3584,12,4180537439
10039,69192459,24791605,93984064,3,0,0,43008,17,7772286232
10040,69196621,30448578,99645199,5,0,1,11776,10,4976063579
10041,69211129,24326329,93537458,3,0,0,3072,17,9091050437
10042,69224360,24630297,93854657,6,0,0,512,7,4947821661
10043,69224590,24746347,93970937,4,0,0,25600,15,3703539942
10044,69229400,30419806,99649206,2,0,1,5120,3,2873826179
10045,69232400,30430606,99663006,9,0,1,10752,12,3460465654
10046,69234690,24398961,93633651,4,0,0,13824,15,9854801601
10047,69239790,25520698,94760488,6,0,0,512,7,940773528
10048,69246959,24380664,93627623,3,0,0,1536,17,907511183
10049,69249090,24783589,94032679,6,0,0,1536,7,9183992608
10050,69258530,24595925,93854455,0,0,0,512,3,7745273772
10051,69263500,30432809,99696309,9,0,1,3584,12,2261980580
10052,69265100,30458181,99723281,2,0,1,7168,3,1992294199
10053,69266989,30456315,99723304,4,0,1,2560,15,9444947685
10054,69272300,24591315,93863615,6,0,0,1536,7,1512130992
10055,69274720,30448607,99723327,2,0,1,512,3,3758673336
10056,69280809,30442541,99723350,4,0,1,5632,15,10266591673
10057,69291880,24438955,93730835,6,0,0,512,7,1707844030
10058,69306520,30416853,99723373,9,0,1,2048,12,7371527300
10059,69310180,24940569,94250749,4,0,0,12288,15,218134335
10060,69310920,24809519,94120439,4,0,0,40960,15,888026678
10061,69319580,30406859,99726439,9,0,1,5632,12,5746209902
10062,69322260,30404845,99727105,2,0,1,1024,3,1450864501
10063,69329689,30399682,99729371,4,0,1,3584,15,5196230001
10064,69329830,30399887,99729717,9,0,1,512,12,678056961
10065,69340331,30391972,99732303,5,0,1,4096,10,9354776967
10066,69356500,24376601,93733101,0,0,0,2560,3,9889140374
10067,69367370,24572925,93940295,4,0,0,46592,15,3516757408
10068,69370900,24569738,93940638,0,0,0,1024,3,5631537919
10069,69388860,24385190,93774050,6,0,0,1536,7,1415534304
10070,69389130,25110580,94499710,0,0,0,1536,3,8302842976
10071,69393510,25390360,94783870,6,0,0,512,7,10204190099
10072,69413550,30320213,99733763,2,0,1,10752,3,8327229451
10073,69420600,24400759,93821359,4,0,0,11776,15,10211098383
10074,69429761,30306588,99736349,5,0,1,4096,10,2408744460
10075,69464961,30306256,99771217,5,0,1,8704,10,3067675816
10076,69468020,30396501,99864521,9,0,1,16896,12,5639909058
10077,69468780,30396140,99864920,2,0,1,512,3,2719645230
10078,69469220,24263078,93732298,0,0,0,1536,3,10593153660
10079,69475919,25413893,94889812,1,0,0,115200,10,3733868821
10080,69486530,30382256,99868786,9,0,1,6144,12,1083703344
10081,69505820,30366218,99872038,2,0,1,5120,3,5809390935
10082,69508320,30420762,99929082,9,0,1,512,12,5575073896
10083,69521530,25532278,95053808,0,0,0,1024,3,10429056346
10084,69535700,30393405,99929105,9,0,1,3072,12,9397177962
10085,69537590,24388486,93926076,6,0,0,512,7,5931663506
10086,69538690,30390446,99929136,2,0,1,5120,3,9568858647
10087,69539760,30389399,99929159,9,0,1,2048,12,488398406
10088,69544520,24729251,94273771,4,0,0,1024,15,4825629770
10089,69548049,24412683,93960732,1,0,0,2048,10,1759714496
10090,69548860,24601102,94149962,6,0,0,512,7,3759016594
10091,69551970,30377212,99929182,3,0,1,5120,17,4192859568
10092,69558640,24624530,94183170,0,0,0,512,3,5596419005
10093,69559660,30376987,99936647,9,0,1,3072,12,494067078
10094,69565860,24542076,94107936,4,0,0,24064,15,1444633824
10095,69573111,30372727,99945838,5,0,1,2560,10,9081652772
10096,69573441,30407192,99980633,5,0,1,2048,10,3476779918
10097,69574270,30406386,99980656,2,0,1,512,3,1426835081
10098,69577759,24915347,94493106,3,0,0,5632,17,3652757362
10099,69584309,24790406,94374715,1,0,0,171008,10,1080006169
10100,69586721,30393958,99980679,5,0,1,3072,10,10554616788
10101,69606780,30373922,99980702,2,0,1,1024,3,8387982701
10102,69617470,30422117,100039587,0,0,1,13312,3,615694510
10103,69621790,24763758,94385548,4,0,0,33792,15,2569525147
10104,69628580,24367413,93995993,0,0,0,1024,3,2830103011
10105,69655439,30399480,100054919,4,0,1,2048,15,1167334105
10106,69662050,24570625,94232675,6,0,0,1536,7,4540397972
10107,69676790,24355375,94032165,4,0,0,2560,15,4091780114
10108,69690299,30364643,100054942,4,0,1,3072,15,9597047613
10109,69694970,30359995,100054965,9,0,1,1024,12,10451645216
10110,69695129,24852614,94547743,3,0,0,40960,17,8116506459
10111,69699110,30355878,100054988,1,0,1,1024,10,7570151257
10112,69713960,24805654,94519614,4,0,0,64000,15,6338900304
10113,69714920,30365949,100080869,9,0,1,5632,12,3281515310
10114,69718980,24276678,93995658,0,0,0,1536,3,2169429996
10115,69719389,30389468,100108857,4,0,1,9216,15,858668849
10116,69724929,30384274,100109203,4,0,1,512,15,7726077356
10117,69727469,24500114,94227583,1,0,0,11264,10,3838150347
10118,69727769,30383380,100111149,4,0,1,3072,15,5502693252
10119,69734129,25440333,95174462,1,0,0,174080,10,5125185129
10120,69735860,24510018,94245878,0,0,0,512,3,3031940747
10121,69746499,25522715,95269214,1,0,0,24064,10,3767931244
10122,69749410,30365605,100115015,1,0,1,6144,10,390306952
10123,69752450,24547578,94300028,4,0,0,14336,15,8592658960
10124,69766539,24876622,94643161,1,0,0,40448,10,3312601126
10125,69771019,30360717,100131736,4,0,1,5632,15,8741119529
10126,69772469,25406417,95178886,1,0,0,6144,10,7725802353
10127,69781119,30355123,100136242,4,0,1,7168,15,2210561465
10128,69783649,24707695,94491344,1,0,0,65536,10,5515149063
10129,69793669,24886056,94679725,1,0,0,75776,10,6249413987
10130,69795430,24513699,94309129,0,0,0,512,3,3463413452
10131,69796819,30340409,100137228,4,0,1,1536,15,8988899289
10132,69805030,30336384,100141414,2,0,1,6656,3,6145853593
10133,69809380,30332495,100141875,2,0,1,10240,3,1974248733
10134,69827560,24624262,94451822,0,0,0,1024,3,3982234217
10135,69827990,24692877,94520867,0,0,0,512,3,2790227582
10136,69830749,24620715,94451464,3,0,0,60416,17,10362580408
10137,69832820,24715258,94548078,6,0,0,1024,7,3130544996
10138,69833610,30316697,100150307,2,0,1,4096,3,5953268474
10139,69848760,30301570,100150330,0,0,1,1024,3,4052290374
10140,69850350,30300003,100150353,0,0,1,1536,3,2135319752
10141,69853980,30296396,100150376,2,0,1,1536,3,8784533129
10142,69855540,30294859,100150399,2,0,1,2560,3,4932960488
10143,69857999,30306849,100164848,4,0,1,2560,15,1396240572
10144,69867390,24632515,94499905,0,0,0,512,3,7530201623
10145,69878009,24621087,94499096,1,0,0,19456,10,9749989772
10146,69880189,24552798,94432987,3,0,0,52736,17,4864640470
10147,69901950,30300969,100202919,2,0,1,11264,3,4465732661
10148,69910159,24476036,94386195,1,0,0,2048,10,2882171680
10149,69910439,30338656,100249095,4,0,1,512,15,1662259994
10150,69910960,30338481,100249441,0,0,1,512,3,6941468279
10151,69915299,25120333,95035632,1,0,0,26112,10,1965166175
10152,69915449,30339969,100255418,4,0,1,14848,15,1493643405
10153,69920099,25650688,95570787,1,0,0,60416,10,4830667322
10154,69924610,24450619,94375229,0,0,0,1024,3,872720389
10155,69928289,24819662,94747951,3,0,0,40448,17,8572467773
10156,69933249,30407559,100340808,4,0,1,512,15,3244988085
10157,69944120,25659692,95603812,6,0,0,1024,7,10341850483
10158,69944859,24741446,94686305,1,0,0,20992,10,2443255816
10159,69949300,24445002,94394302,0,0,0,1024,3,4314745864
10160,69960209,24968936,94929145,3,0,0,40960,17,5764430334
10161,69970560,30382789,100353349,3,0,1,1536,17,7871066499
10162,69975290,24711350,94686640,0,0,0,1024,3,606682275
10163,69975959,25478758,95454717,3,0,0,78848,17,3471250716
10164,69980140,24540456,94520596,6,0,0,3072,7,556201691
10165,69982310,30373945,100356255,0,0,1,4608,3,833038525
10166,69984720,30392477,100377197,7,0,1,1024,10,10388216486
10167,69985610,25115562,95101172,0,0,0,512,3,6886600007
10168,69988950,30393558,100382508,2,0,1,3584,3,7848107067
10169,69992480,24615161,94607641,6,0,0,512,7,6539379636
10170,69997499,24728437,94725936,1,0,0,2560,10,10253191217
10171,70018110,30421401,100439511,7,0,1,4608,10,8038832482
10172,70024180,30415895,100440075,2,0,1,10752,3,10730376474
10173,70027550,30460547,100488097,2,0,1,512,3,1233399765
10174,70028740,24811708,94840448,4,0,0,13824,15,6500485489
10175,70037389,24921853,94959242,1,0,0,19456,10,5022291059
10176,70042050,30446070,100488120,7,0,1,2048,10,4317973136
10177,70043900,30469093,100512993,0,0,1,2048,3,10491891543
10178,70048390,24739328,94787718,0,0,0,2560,3,1126447901
10179,70058689,24652650,94711339,3,0,0,20992,17,5669374701
10180,70059169,25236350,95295519,3,0,0,3584,17,4680056466
10181,70063570,30449446,100513016,2,0,1,3584,3,6639937898
10182,70063999,24829071,94893070,3,0,0,9728,17,9108559720
10183,70067420,30506723,100574143,0,0,1,1536,3,3004962203
10184,70071140,30503026,100574166,0,0,1,10752,3,4360497071
10185,70075730,30498459,100574189,7,0,1,7168,10,2242794495
10186,70083060,30538029,100621089,0,0,1,7680,3,2894832087
10187,70091590,30541089,100632679,7,0,1,14336,10,7329040518
10188,70099989,30532713,100632702,4,0,1,10240,15,8335684515
10189,70104450,30528275,100632725,0,0,1,512,3,833693976
10190,70112390,24590179,94702569,4,0,0,3584,15,5136754378
10191,70117930,24730653,94848583,4,0,0,26624,15,9358604472
10192,70121250,24661084,94782334,0,0,0,512,3,5148021142
10193,70124610,30510049,100634659,2,0,1,3072,3,9010255992
10194,70125849,24688859,94814708,1,0,0,3072,10,9585239013
10195,70132490,24595029,94727519,4,0,0,5120,15,3976016352
10196,70138049,24596296,94734345,1,0,0,12800,10,9754691210
10197,70140459,24912144,95052603,3,0,0,55296,17,3299985641
10198,70142639,24868455,95011094,1,0,0,38400,10,5032711473
10199,70150280,24699703,94849983,6,0,0,1024,7,1645319432
10200,70154550,24804917,94959467,0,0,0,512,3,697301052
10201,70154800,30479882,100634682,0,0,1,4608,3,10112262779
10202,70157460,30477245,100634705,0,0,1,4608,3,6527407171
10203,70161680,30473048,100634728,6,0,1,11776,7,10710481258
10204,70162290,30472461,100634751,3,0,1,1024,17,2116167257
10205,70162799,24864854,95027653,3,0,0,54272,17,214911272
10206,70164079,30470703,100634782,4,0,1,512,15,7185491569
10207,70170660,25021844,95192504,4,0,0,44544,15,6199961344
10208,70173229,30471115,100644344,4,0,1,1024,15,985197943
10209,70179500,30491487,100670987,2,0,1,10752,3,3360615256
10210,70182300,24920478,95102778,6,0,0,512,7,8964795000
10211,70182920,30569299,100752219,3,0,1,5632,17,6928125996
10212,70184830,24797187,94982017,0,0,0,512,3,8131961628
10213,70188950,24575575,94764525,4,0,0,512,15,1252496813
10214,70191170,24914150,95105320,4,0,0,4096,15,209313823
10215,70195200,30605257,100800457,3,0,1,17920,17,6904543301
10216,70196930,30605153,100802083,2,0,1,2560,3,451887704
10217,70200260,24689754,94890014,0,0,0,512,3,35356048
10218,70200500,30675307,100875807,3,0,1,512,17,3279711103
10219,70206899,24894094,95100993,3,0,0,68096,17,2943733229
10220,70210459,30665371,100875830,4,0,1,2560,15,3191115867
10221,70218110,30657743,100875853,0,0,1,8192,3,6243070778
10222,70221919,24776984,94998903,1,0,0,3584,10,5711997701
10223,70229740,30701321,100931061,0,0,1,5632,3,8290599323
10224,70230400,30794126,101024526,7,0,1,11776,10,9798656653
10225,70238020,30789732,101027752,0,0,1,5120,3,6413960921
10226,70240510,24565206,94805716,6,0,0,512,7,27205535
10227,70242910,30788245,101031155,1,0,1,512,10,9108101096
10228,70252040,30779781,101031821,7,0,1,1024,10,1220398000
10229,70261619,30778474,101040093,4,0,1,512,15,7894143134
10230,70269449,25051864,95321313,1,0,0,512,10,9536581774
10231,70272879,25474929,95747808,1,0,0,46080,10,7620730629
10232,70277140,30765128,101042268,0,0,1,512,3,2080414566
10233,70290749,30753465,101044214,4,0,1,3072,15,1678320274
10234,70296180,24988707,95284887,4,0,0,35328,15,2847509714
10235,70300419,30750307,101050726,4,0,1,512,15,9136277710
10236,70306910,30758341,101065251,3,0,1,6144,17,1598718446
10237,70306980,30758294,101065274,0,0,1,4096,3,2347382697
10238,70313360,30751937,101065297,3,0,1,1536,17,6090623894
10239,70314600,30750720,101065320,2,0,1,2048,3,9489745896
10240,70319909,24586062,94905971,3,0,0,4608,17,8093949834
10241,70328849,30736494,101065343,4,0,1,512,15,3668077696
10242,70330770,30734596,101065366,0,0,1,12800,3,8397759797
10243,70347010,25019935,95366945,2,0,0,73728,3,3172789927
10244,70347330,30759500,101106830,3,0,1,1536,17,250754521
10245,70351489,25116736,95468225,1,0,0,9728,10,5151512307
10246,70352720,30773081,101125801,3,0,1,13312,17,7985279373
10247,70356100,30805476,101161576,0,0,1,7680,3,5673616669
10248,70361220,30800702,101161922,2,0,1,512,3,1058907281
10249,70376549,25088042,95464591,1,0,0,32256,10,928874449
10250,70378260,24798616,95176876,4,0,0,4608,15,5392409757
10251,70384119,30778789,101162908,4,0,1,1536,15,6392202997
10252,70390150,30802283,101192433,7,0,1,11776,10,7653398707
10253,70397629,24802659,95200288,1,0,0,11776,10,10466765591
10254,70404910,24648504,95053414,6,0,0,2560,7,9892246820
10255,70409030,30801665,101210695,7,0,1,8704,10,4876841626
10256,70413570,30802677,101216247,7,0,1,18432,10,7386132783
10257,70421360,24753304,95174664,0,0,0,512,3,8453905659
10258,70429090,24746157,95175247,0,0,0,1024,3,7210874230
10259,70434560,30784273,101218833,2,0,1,4096,3,8813780530
10260,70434660,30848607,101283267,0,0,1,512,3,9462997020
10261,70439510,30843780,101283290,2,0,1,6656,3,7446810418
10262,70451300,30832013,101283313,2,0,1,3584,3,350111723
10263,70459860,30823476,101283336,0,0,1,4096,3,1280633209
10264,70478670,30806157,101284827,0,0,1,7680,3,10544586545
10265,70480269,24575982,95056251,1,0,0,2560,10,2868957628
10266,70485730,24616869,95102599,0,0,0,4608,3,1563661684
10267,70493800,24610249,95104049,4,0,0,4096,15,734565027
10268,70493820,24713625,95207445,0,0,0,512,3,677179872
10269,70501430,25270745,95772175,6,0,0,1024,7,209080433
10270,70509400,30778653,101288053,7,0,1,5120,10,4353696963
10271,70511229,30780777,101292006,4,0,1,5632,15,552371976
10272,70511280,30815430,101326710,2,0,1,4608,3,2997238876
10273,70512330,30828453,101340783,7,0,1,3072,10,8763703845
10274,70512880,30832729,101345609,7,0,1,7680,10,3335939140
10275,70517120,30831075,101348195,9,0,1,4096,12,5560361512
10276,70539929,24733543,95273472,1,0,0,12288,10,3503497890
10277,70575670,24756831,95332501,0,0,0,1024,3,1843535036
10278,70576690,24598153,95174843,6,0,0,512,7,8168977339
10279,70577320,25057250,95634570,0,0,0,1024,3,5846791733
10280,70577530,24597919,95175449,0,0,0,512,3,3638493362
10281,70585950,30764191,101350141,7,0,1,3072,10,5155473453
10282,70607050,30746957,101354007,2,0,1,6144,3,34050095
10283,70610520,24756627,95367147,0,0,0,512,3,5529444292
10284,70615321,30774158,101389479,8,0,1,7168,8,9573660067
10285,70623830,24683943,95307773,6,0,0,512,7,7941713957
10286,70624059,24873118,95497177,1,0,0,92160,10,6162983110
10287,70625629,24763067,95388696,1,0,0,24064,10,7839968337
10288,70628380,24572867,95201247,0,0,0,3072,3,6704026557
10289,70631880,30792192,101424072,2,0,1,2560,3,10205876052
10290,70632791,30791304,101424095,8,0,1,15872,8,3090067550
10291,70645450,24764336,95409786,6,0,0,2048,7,5034184643
10292,70651500,24880299,95531799,4,0,0,98816,15,5843096797
10293,70669520,25003958,95673478,6,0,0,1024,7,10647608322
10294,70701320,24902134,95603454,4,0,0,62464,15,8407066082
10295,70712689,24586934,95299623,1,0,0,1024,10,179190430
10296,70716750,24692044,95408794,4,0,0,20992,15,5720233423
10297,70716770,24552935,95269705,6,0,0,1536,7,9660750231
10298,70720631,30753274,101473905,8,0,1,2560,8,1378236606
10299,70722740,24571664,95294404,4,0,0,4608,15,1024607462
10300,70724890,24468122,95193012,6,0,0,1024,7,9598199436
10301,70727281,30768814,101496095,8,0,1,6656,8,2618061782
10302,70727380,30782161,101509541,2,0,1,4096,3,6109892886
10303,70737381,30772585,101509966,8,0,1,1024,8,6010436598
10304,70741310,30773482,101514792,2,0,1,7680,3,167756925
10305,70743761,30776657,101520418,8,0,1,1536,8,4795685043
10306,70748950,30771814,101520764,7,0,1,512,10,2760630206
10307,70749430,30796463,101545893,2,0,1,7168,3,7353594633
10308,70752000,30793916,101545916,2,0,1,3584,3,2027787830
10309,70768820,30777119,101545939,7,0,1,8192,10,9441475342
10310,70784751,30761211,101545962,8,0,1,1024,8,3131270115
10311,70796620,24816575,95613195,4,0,0,30720,15,2353789353
10312,70814460,24810251,95624711,4,0,0,3072,15,8136577257
10313,70824260,24584713,95408973,6,0,0,512,7,1860080875
10314,70827701,30718292,101545993,8,0,1,7168,8,1849583346
10315,70828399,24742879,95571278,1,0,0,1536,10,2093850462
10316,70844251,30707796,101552047,8,0,1,512,8,500782961
10317,70844599,30710674,101555273,4,0,1,5120,15,3724106393
10318,70845970,24492181,95338151,0,0,0,512,3,1919016793
10319,70852870,24612368,95465238,6,0,0,2048,7,3967321792
10320,70858550,25008338,95866888,6,0,0,1536,7,3808861188
10321,70860440,30696779,101557219,2,0,1,3072,3,6932504965
10322,70864259,24604769,95469028,3,0,0,2560,17,2928300697
10323,70872330,30688276,101560606,7,0,1,4608,10,9885319002
10324,70874309,24776099,95650408,1,0,0,2048,10,4404087302
10325,70876000,25054635,95930635,4,0,0,105472,15,10165681492
10326,70879680,30682253,101561933,2,0,1,2560,3,5654718103
10327,70890460,24607317,95497777,0,0,0,1536,3,6343500018
10328,70894480,24853709,95748189,6,0,0,1024,7,3319656051
10329,70928440,30635759,101564199,2,0,1,3584,3,5887990045
10330,70934921,30632184,101567105,8,0,1,4608,8,8762363369
10331,70939489,30628125,101567614,4,0,1,512,15,4413149360
10332,70939769,30632991,101572760,4,0,1,8192,15,128576964
10333,70962641,30640941,101603582,8,0,1,512,8,789480923
10334,70962999,30662585,101625584,4,0,1,6656,15,347565741
10335,70967771,30657844,101625615,8,0,1,2048,8,6633476578
10336,70969649,30655989,101625638,4,0,1,2048,15,9631110421
10337,70970540,24669700,95640240,4,0,0,17408,15,604240222
10338,70981260,30644401,101625661,2,0,1,2048,3,3852695964
10339,70988659,30637025,101625684,4,0,1,1024,15,3690090077
10340,70990620,24623557,95614177,0,0,0,2048,3,4099919245
10341,71007120,24524866,95531986,6,0,0,512,7,794483378
10342,71017410,24599223,95616633,4,0,0,7680,15,6827996832
10343,71023251,30602456,101625707,8,0,1,4096,8,4036917956
10344,71032751,30614742,101647493,8,0,1,20992,8,2461056437
10345,71057040,30610648,101667688,6,0,1,2048,7,878433926
10346,71061530,24471103,95532633,0,0,0,2048,3,9194364901
10347,71063639,24469219,95532858,1,0,0,512,10,10655462052
10348,71084950,30589945,101674895,2,0,1,9216,3,1904468201
10349,71098070,30590012,101688082,7,0,1,6144,10,6312005512
10350,71100980,24622066,95723046,4,0,0,46592,15,1073504830
10351,71102410,30594882,101697292,2,0,1,4608,3,6677666481
10352,71106081,30592478,101698559,8,0,1,11264,8,3232881601
10353,71111521,30604679,101716200,8,0,1,15360,8,10083254748
10354,71114790,24615969,95730759,4,0,0,25088,15,5891017191
10355,71120090,24493440,95613530,6,0,0,1024,7,8799164909
10356,71121430,24726693,95848123,0,0,0,1024,3,6292716126
10357,71127331,30606552,101733883,8,0,1,5120,8,8384948143
10358,71141900,30594569,101736469,2,0,1,4096,3,6863756287
10359,71146681,30593974,101740655,8,0,1,6656,8,9395695595
10360,71149580,30595581,101745161,2,0,1,7168,3,7082680312
10361,71165199,30583508,101748707,4,0,1,5632,15,7792045966
10362,71169439,24465466,95634905,1,0,0,1024,10,8040082238
10363,71170140,24616663,95786803,0,0,0,3584,3,7547041947
10364,71185410,24478568,95663978,6,0,0,5120,7,5906449176
10365,71187530,24561664,95749194,6,0,0,2560,7,3511470812
10366,71191540,30564036,101755576,1,0,1,10752,10,10088114571
10367,71196469,24751395,95947864,1,0,0,512,10,7306461697
10368,71205591,30552316,101757907,8,0,1,512,8,9198796757
10369,71208861,30550992,101759853,8,0,1,3072,8,5011820228
10370,71223750,30537729,101761479,0,0,1,2560,3,1374117258
10371,71238010,24452901,95690911,0,0,0,1024,3,7564330035
10372,71238050,30526015,101764065,8,0,1,4096,8,3183068451
10373,71239660,30547517,101787177,8,0,1,4096,8,4135981198
10374,71252210,24415319,95667529,6,0,0,1024,7,7827282987
10375,71262660,24603737,95866397,6,0,0,25600,7,9818245591
10376,71279159,30508041,101787200,4,0,1,1536,15,1036384378
10377,71285109,24463259,95748368,1,0,0,512,10,608787040
10378,71294270,30499060,101793330,8,0,1,10240,8,6606294786
10379,71298620,25220879,96519499,6,0,0,194048,7,6473546089
10380,71306830,24496783,95803613,0,0,0,1024,3,7262175365
10381,71307290,30492943,101800233,8,0,1,8704,8,1737193427
10382,71307880,30492609,101800489,2,0,1,9216,3,1241005836
10383,71313270,30495939,101809209,0,0,1,512,3,4346790368
10384,71316890,30501634,101818524,1,0,1,8192,10,7698096361
10385,71318270,30501240,101819510,0,0,1,1536,3,7508420090
10386,71321050,30501686,101822736,0,0,1,5120,3,10369105121
10387,71327770,24619736,95947506,6,0,0,55296,7,4086340356
10388,71330959,30500406,101831365,4,0,1,3584,15,9338472820
10389,71340720,30494197,101834917,3,0,1,9216,17,9885145225
10390,71346190,30497535,101843725,0,0,1,3584,3,5796107514
10391,71360860,30497759,101858619,1,0,1,8704,10,7616606306
10392,71368779,30514289,101883068,4,0,1,3072,15,2157355370
10393,71412590,24560135,95972725,0,0,0,512,3,3089277281
10394,71447511,30453791,101901302,8,0,1,10240,8,4360086826
10395,71475500,24517751,95993251,4,0,0,23552,15,7976878774
10396,71477099,24347083,95824182,1,0,0,2048,10,4515295027
10397,71478740,30472117,101950857,8,0,1,3072,8,5859565199
10398,71478770,30472110,101950880,0,0,1,9216,3,4735901879
10399,71494100,24602554,96096654,0,0,0,1536,3,1325418453
10400,71496250,30454653,101950903,0,0,1,3072,3,9381578782
10401,71496439,30454487,101950926,4,0,1,3584,15,7871144620
10402,71503220,30447729,101950949,1,0,1,3072,10,5391505452
10403,71509710,30441262,101950972,2,0,1,2048,3,10521619313
10404,71514750,24648006,96162756,0,0,0,512,3,10491004091
10405,71517090,30433905,101950995,2,0,1,15872,3,8198688220
10406,71521249,30467633,101988882,4,0,1,7168,15,6788240759
10407,71521800,30473515,101995315,0,0,1,6144,3,7111468776
10408,71527270,30470631,101997901,0,0,1,4096,3,3784168249
10409,71536230,30463297,101999527,2,0,1,2560,3,257088023
10410,71545010,24717269,96262279,4,0,0,80384,15,10310620002
10411,71552030,30448483,102000513,8,0,1,1536,8,10011408839
10412,71554850,30468272,102023122,2,0,1,3584,3,6317608201
10413,71559180,24644538,96203718,0,0,0,1536,3,5987569276
10414,71563139,24624513,96187652,1,0,0,512,10,10427476874
10415,71564110,24383575,95947685,0,0,0,512,3,2721436136
10416,71586821,24530857,96117678,7,0,0,28672,10,5451502320
10417,71589860,30433285,102023145,0,0,1,10752,3,480193468
10418,71596760,30427105,102023865,2,0,1,2560,3,605090445
10419,71604400,24583073,96187473,6,0,0,56832,7,586143844
10420,71606040,30418171,102024211,1,0,1,512,10,2328600667
10421,71609301,24692043,96301344,7,0,0,21504,10,6968552339
10422,71609539,24553038,96162577,1,0,0,117248,10,5010172805
10423,71609809,24811694,96421503,1,0,0,22016,10,914239641
10424,71610300,30419723,102030023,8,0,1,9216,8,5357808540
10425,71611089,30434918,102046007,4,0,1,3072,15,5272671775
10426,71612190,30434278,102046468,1,0,1,10240,10,3362121760
10427,71613050,30438536,102051586,8,0,1,3584,8,4573943568
10428,71621760,24642616,96264376,6,0,0,5632,7,3892129222
10429,71626300,30432623,102058923,0,0,1,10752,3,7143604083
10430,71635980,24368563,96004543,0,0,0,1024,3,3356879128
10431,71639049,24564178,96203227,1,0,0,50688,10,3530695258
10432,71641150,24621464,96262614,0,0,0,1024,3,8994704754
10433,71646441,30417869,102064310,8,0,1,7168,8,6110716103
10434,71651630,30445930,102097560,1,0,1,10240,10,2683925962
10435,71658610,30473689,102132299,1,0,1,14848,10,531171748
10436,71660091,24510043,96170134,7,0,0,24064,10,2103012142
10437,71662051,25028442,96690493,7,0,0,129024,10,8585058020
10438,71670420,24721386,96391806,6,0,0,13312,7,3188127808
10439,71675360,30458245,102133605,2,0,1,2048,3,9623303694
10440,71676171,25050808,96726979,7,0,0,109568,10,805067784
10441,71685420,30448851,102134271,0,0,1,1024,3,10342309805
10442,71690600,24521868,96212468,6,0,0,13312,7,4758237496
10443,71693920,30441977,102135897,2,0,1,2560,3,4182651101
10444,71697350,30439213,102136563,1,0,1,1024,10,10359308440
10445,71698051,30440423,102138474,5,0,1,2048,10,9207698282
10446,71699080,24595689,96294769,6,0,0,24576,7,6150114415
10447,71742130,30397650,102139780,0,0,1,2048,3,8551632020
10448,71745110,25039707,96784817,2,0,0,4608,3,4616919991
10449,71761320,24445462,96206782,4,0,0,9728,15,1722272218
10450,71780070,24533446,96313516,4,0,0,4608,15,7751660032
10451,71812939,24395450,96208389,1,0,0,5120,10,3677573926
10452,71814170,30326276,102140446,1,0,1,1024,10,4148072954
10453,71827020,24697118,96524138,6,0,0,14848,7,3274757187
10454,71836920,30305472,102142392,0,0,1,3072,3,6928442535
10455,71842400,30303218,102145618,0,0,1,5120,3,9565778783
10456,71843070,30334830,102177900,2,0,1,11264,3,2594295021
10457,71845390,24904348,96749738,6,0,0,34816,7,10705578069
10458,71846540,24906809,96753349,6,0,0,11776,7,7009165893
10459,71853870,24686677,96540547,6,0,0,31232,7,8952874317
10460,71856941,30323101,102180042,5,0,1,4096,10,6532158644
10461,71860351,30400009,102260360,5,0,1,11776,10,885382745
10462,71863741,24991545,96855286,7,0,0,58880,10,6768536137
10463,71866550,25002822,96869372,4,0,0,45568,15,6267804434
10464,71866870,25163484,97030354,4,0,0,22016,15,10281331751
10465,71872610,24562500,96435110,4,0,0,6656,15,7559703039
10466,71876320,24944221,96820541,0,0,0,4096,3,2675034281
10467,71894540,30384220,102278760,1,0,1,4096,10,2191006581
10468,71897400,24841661,96739061,4,0,0,38912,15,3409244541
10469,71902630,30376476,102279106,2,0,1,512,3,8275044457
10470,71907701,24976046,96883747,7,0,0,47104,10,6370716481
10471,71907790,30371675,102279465,2,0,1,9728,3,5646979796
10472,71926480,30407307,102333787,2,0,1,2048,3,801048264
10473,71926670,30407623,102334293,1,0,1,512,10,9262411542
10474,71927131,30408788,102335919,5,0,1,2560,10,2749052301
10475,71933010,24615992,96549002,4,0,0,27648,15,10027525065
10476,71933879,24667099,96600978,1,0,0,47104,10,3108574382
10477,71952040,25278732,97230772,6,0,0,58368,7,6074434173
10478,71958930,30381175,102340105,1,0,1,6656,10,9601507579
10479,71967290,30402618,102369908,0,0,1,2560,3,9844066500
10480,71970819,24866504,96837323,1,0,0,46080,10,5649320046
10481,71981979,25150506,97132485,1,0,0,118784,10,6670793156
10482,72002540,30367391,102369931,2,0,1,1024,3,772246615
10483,72003730,24960906,96964636,4,0,0,84480,15,6438786938
10484,72005101,24688379,96693480,7,0,0,9728,10,4773584709
10485,72008330,30374685,102383015,1,0,1,1024,10,4346889787
10486,72009770,30375831,102385601,2,0,1,4096,3,4638901082
10487,72014271,24741472,96755743,7,0,0,6656,10,8938481418
10488,72021610,30365617,102387227,1,0,1,2560,10,1599622669
10489,72031050,30356433,102387483,1,0,1,9216,10,8336034421
10490,72044670,24810795,96855465,0,0,0,512,3,1587774671
10491,72047941,30360659,102408600,5,0,1,1024,10,10008471324
10492,72052131,30394362,102446493,5,0,1,21504,10,4027726945
10493,72081360,30365156,102446516,0,0,1,512,3,6254041289
10494,72083749,30362790,102446539,4,0,1,512,15,5740645138
10495,72090071,30359598,102449669,8,0,1,17408,8,6625172090
10496,72090440,30503262,102593702,2,0,1,2560,3,4995767358
10497,72095050,30498675,102593725,1,0,1,8192,10,6870999418
10498,72102830,24624328,96727158,0,0,0,512,3,943936143
10499,72124400,30469348,102593748,2,0,1,3584,3,8030593139
10500,72127570,24691700,96819270,4,0,0,38912,15,9260429602
10501,72132091,30486039,102618130,5,0,1,2560,10,7244647074
10502,72134781,30491531,102626312,5,0,1,2560,10,1391000857
10503,72139090,30487245,102626335,2,0,1,512,3,5508307780
10504,72148591,30477767,102626358,5,0,1,14848,10,10570987063
10505,72172961,30494168,102667129,5,0,1,4096,10,5463330355
10506,72185511,25147579,97333090,7,0,0,55296,10,3491417241
10507,72194700,30472452,102667152,1,0,1,3072,10,8971733981
10508,72197500,30469675,102667175,1,0,1,512,10,7823710092
10509,72209260,30457938,102667198,0,0,1,512,3,4994041579
10510,72220380,30446841,102667221,0,0,1,7168,3,363145358
10511,72231579,30463599,102695178,4,0,1,5120,15,6140840068
10512,72232760,30470291,102703051,2,0,1,16896,3,8817702628
10513,72242810,30527366,102770176,2,0,1,1024,3,10167438479
10514,72262450,30507749,102770199,1,0,1,5632,10,1760110006
10515,72270210,30500012,102770222,1,0,1,1024,10,573446532
10516,72271171,24482513,96753684,7,0,0,1024,10,9423833331
10517,72275940,30494313,102770253,0,0,1,2560,3,4354685828
10518,72277890,24768975,97046865,4,0,0,12288,15,594036194
10519,72279620,24899966,97179586,6,0,0,123392,7,5683719895
10520,72281271,24814999,97096270,7,0,0,11264,10,9988179333
10521,72283030,25365203,97648233,4,0,0,11264,15,2085657733
10522,72284391,24631514,96915905,7,0,0,25600,10,3381382614
10523,72290920,24793824,97084744,6,0,0,30720,7,7825434024
10524,72291410,30478866,102770276,2,0,1,512,3,5647409954
10525,72292980,25222215,97515195,6,0,0,79872,7,4048950589
10526,72301510,30503872,102805382,2,0,1,23552,3,9520236028
10527,72303030,30549557,102852587,1,0,1,6656,10,3355539172
10528,72308219,30568617,102876836,4,0,1,10752,15,2314196054
10529,72325870,25007867,97333737,0,0,0,2048,3,9979830671
10530,72335621,24673175,97008796,7,0,0,68096,10,6519173144
10531,72336829,24738532,97075361,1,0,0,47616,10,443252696
10532,72344200,30532659,102876859,1,0,1,1024,10,4316130889
10533,72344341,24932718,97277059,7,0,0,29696,10,9764658951
10534,72356370,30520512,102876882,0,0,1,1024,3,2389220796
10535,72363370,30553662,102917032,0,0,1,25600,3,9286489026
10536,72367690,30578389,102946079,0,0,1,4608,3,8031949181
10537,72368760,30584116,102952876,1,0,1,6656,10,6125392809
10538,72368810,30591070,102959880,1,0,1,8192,10,8591130265
10539,72371800,24921336,97293136,4,0,0,26112,15,7506455677
10540,72373530,30639184,103012714,1,0,1,2048,10,5968906585
10541,72375469,30690315,103065784,4,0,1,19968,15,2477443330
10542,72375690,24757199,97132889,0,0,0,1024,3,10126101457
10543,72390900,30680023,103070923,0,0,1,4608,3,732926696
10544,72393140,25408940,97802080,6,0,0,110592,7,3559689299
10545,72393191,30679998,103073189,8,0,1,3584,8,6668845616
10546,72396531,24947057,97343588,7,0,0,32256,10,1618046187
10547,72430280,30643895,103074175,1,0,1,1536,10,1620293355
10548,72449000,24690776,97139776,4,0,0,22528,15,5903016176
10549,72457380,30619061,103076441,2,0,1,3584,3,10719902843
10550,72466270,30613397,103079667,1,0,1,5120,10,1566410858
10551,72473380,30608553,103081933,1,0,1,3584,10,2004252579
10552,72478790,24901139,97379929,5,0,0,78848,10,4139941363
10553,72493060,30601434,103094494,2,0,1,2560,3,6735039472
10554,72503800,30611589,103115389,6,0,1,2048,7,2407816241
10555,72508579,30606833,103115412,4,0,1,512,15,403381491
10556,72523789,24892694,97416483,1,0,0,17408,10,4748880413
10557,72544330,30571105,103115435,2,0,1,4096,3,2301972798
10558,72544510,24803262,97347772,0,0,0,1536,3,8681156237
10559,72544619,30570839,103115458,4,0,1,1536,15,5965251893
10560,72547280,24706984,97254264,6,0,0,34304,7,2714850101
10561,72552990,30562491,103115481,1,0,1,512,10,4881985771
10562,72553289,30562215,103115504,4,0,1,7680,15,173327283
10563,72558080,30557447,103115527,0,0,1,512,3,1541003809
10564,72575630,30539920,103115550,2,0,1,1536,3,2563395668
10565,72577350,24616092,97193442,0,0,0,1024,3,5210029932
10566,72580200,30535373,103115573,0,0,1,512,3,9809796063
10567,72587940,30527656,103115596,2,0,1,2560,3,6140872453
10568,72588430,30527189,103115619,0,0,1,17920,3,2869151113
10569,72593319,24884970,97478289,1,0,0,22528,10,1397881862
10570,72608120,30548529,103156649,2,0,1,1536,3,6467133699
10571,72611751,30544921,103156672,5,0,1,7680,10,3652393684
10572,72624980,30531715,103156695,0,0,1,8192,3,8799713356
10573,72634520,24757456,97391976,4,0,0,5120,15,1936016928
10574,72640869,24889481,97530350,1,0,0,49664,10,8190988864
10575,72643381,30545406,103188787,5,0,1,3584,10,6211314976
10576,72647889,24892335,97540224,1,0,0,32256,10,8430380992
10577,72649720,25040884,97690604,6,0,0,36352,7,733986616
10578,72653450,25096092,97749542,4,0,0,52224,15,8396193351
10579,72664949,30523861,103188810,4,0,1,2048,15,654605085
10580,72686109,24752914,97439023,1,0,0,29696,10,1232019751
10581,72691310,24759268,97450578,6,0,0,14848,7,949982734
10582,72701230,24682044,97383274,4,0,0,10752,15,10447342538
10583,72709460,24932391,97641851,4,0,0,37376,15,1888592861
10584,72714450,30474383,103188833,1,0,1,1536,10,6006284579
10585,72732820,30456036,103188856,6,0,1,2048,7,8082237020
10586,72744450,30444429,103188879,0,0,1,4096,3,6043954338
10587,72755859,24912172,97668031,1,0,0,47104,10,7650777532
10588,72773360,30415550,103188910,3,0,1,1024,17,6912515978
10589,72774300,30416639,103190939,1,0,1,4608,10,10586327005
10590,72778010,24648809,97426819,0,0,0,512,3,2138604292
10591,72778300,25073478,97851778,8,0,0,36864,8,5466295439
10592,72780669,24811780,97592449,1,0,0,6656,10,9798876711
10593,72793060,24767229,97560289,9,0,0,51200,12,1310376025
10594,72794950,30408728,103203678,3,0,1,15872,17,8000028354
10595,72805670,24734733,97540403,0,0,0,512,3,3546545827
10596,72810330,24887219,97697549,4,0,0,17408,15,5038462471
10597,72818220,24892051,97710271,4,0,0,14336,15,8657007834
10598,72820160,30386104,103206264,0,0,1,4096,3,4869454051
10599,72822960,30394618,103217578,1,0,1,1024,10,288601705
10600,72834001,30383608,103217609,8,0,1,3072,8,7247329512
10601,72839750,30403388,103243138,3,0,1,18432,17,577849227
10602,72842490,25087942,97930432,6,0,0,47616,7,6125102388
10603,72844860,30398301,103243161,0,0,1,2048,3,1264335102
10604,72853130,24982559,97835689,0,0,0,512,3,974527696
10605,72866301,30376883,103243184,8,0,1,1024,8,2659939472
10606,72869860,24965650,97835510,4,0,0,104448,15,334150588
10607,72875441,30367883,103243324,8,0,1,6144,8,6061727267
10608,72876361,30429082,103305443,8,0,1,12800,8,9702806088
10609,72878100,30429929,103308029,2,0,1,4096,3,3192208147
10610,72880951,30436663,103317614,8,0,1,5120,8,917391298
10611,72890490,30433858,103324348,3,0,1,4096,17,812906278
10612,72896020,24869000,97765020,4,0,0,24576,15,8711289294
10613,72901130,30429378,103330508,3,0,1,512,17,4249173184
10614,72904090,30429964,103334054,3,0,1,5632,17,1124502863
10615,72914191,30425046,103339237,8,0,1,7680,8,935969551
10616,72915660,30482097,103397757,8,0,1,512,8,6304929565
10617,72919720,24919135,97838855,0,0,0,1024,3,1787632091
10618,72930740,30467040,103397780,1,0,1,9728,10,1574998308
10619,72933239,24905281,97838520,1,0,0,9216,10,8370480398
10620,72945530,30466047,103411577,1,0,1,2560,10,478775771
10621,72952810,30458790,103411600,9,0,1,512,12,3623766160
10622,72953130,24918789,97871919,6,0,0,16896,7,5443108673
10623,72956480,30455143,103411623,9,0,1,1536,12,7539486513
10624,72959679,24843984,97803663,1,0,0,5120,10,6187023007
10625,72961760,24987996,97949756,4,0,0,59392,15,9773432531
10626,72966870,30479611,103446481,9,0,1,8192,12,5352540642
10627,72994870,30451634,103446504,0,0,1,2048,3,4491081046
10628,73000190,30447320,103447510,0,0,1,512,3,9604379047
10629,73003200,30444333,103447533,3,0,1,512,17,10215188005
10630,73012370,30435186,103447556,1,0,1,3072,10,3534515099
10631,73020339,25277954,98298293,1,0,0,112640,10,4580744401
10632,73030200,24980133,98010333,4,0,0,12800,15,5169062932
10633,73035820,30411759,103447579,9,0,1,4608,12,3417399911
10634,73038530,30409072,103447602,1,0,1,11776,10,7887642116
10635,73052920,30394713,103447633,9,0,1,512,12,5349101199
10636,73055810,24784651,97840461,0,0,0,5120,3,3521292364
10637,73066900,25074366,98141266,0,0,0,512,3,7703056922
10638,73105540,30343439,103448979,1,0,1,2560,10,9298338260
10639,73111130,30339027,103450157,0,0,1,13824,3,7111014582
10640,73116880,30375610,103492490,0,0,1,4096,3,4270798485
10641,73119170,30386272,103505442,1,0,1,1536,10,3913632225
10642,73119899,24974849,98094748,1,0,0,45568,10,8165548505
10643,73122090,24844904,97966994,4,0,0,25088,15,9715825267
10644,73129660,30380766,103510426,1,0,1,7680,10,3661157059
10645,73134090,30378444,103512534,9,0,1,3584,12,8066976706
10646,73135690,25106589,98242279,6,0,0,22016,7,6316018922
10647,73135830,24854643,97990473,4,0,0,3072,15,5665213185
10648,73139320,24762417,97901737,4,0,0,18944,15,5546969843
10649,73144340,24913552,98057892,0,0,0,1536,3,7322508737
10650,73146510,24971260,98117770,0,0,0,2048,3,8824966102
10651,73150250,30402833,103553083,9,0,1,5632,12,3336270831
10652,73154010,24950012,98104022,0,0,0,512,3,32889376
10653,73157800,30415739,103573539,0,0,1,7680,3,1854581619
10654,73168454,30416375,103584829,1,0,1,5120,10,1339772888
10655,73170020,25258312,98428332,6,0,0,136192,7,7934960776
10656,73171570,30416511,103588081,0,0,1,5120,3,1578678332
10657,73172090,30417617,103589707,9,0,1,2560,12,9369140145
10658,73181720,24954871,98136591,6,0,0,3584,7,4797831555
10659,73185000,24909927,98094927,0,0,0,512,3,7555028810
10660,73191610,30398353,103589963,7,0,1,9216,10,8353073537
10661,73193090,30397859,103590949,1,0,1,1536,10,6698327197
10662,73196940,25045564,98242504,0,0,0,512,3,1262154178
10663,73200670,24965418,98166088,4,0,0,13312,15,9557095375
10664,73205030,30425719,103630749,9,0,1,6656,12,7482999215
10665,73210510,30420262,103630772,1,0,1,3584,10,1118821290
10666,73211650,25023898,98235548,4,0,0,73216,15,7422306097
10667,73217940,24924171,98142111,0,0,0,1536,3,5434434432
10668,73221790,30409005,103630795,1,0,1,2048,10,7066944055
10669,73229280,25126500,98355780,6,0,0,59392,7,7233152928
10670,73229840,24767948,97997788,0,0,0,512,3,3739478974
10671,73236840,25076654,98313494,4,0,0,34304,15,5109998087
10672,73245069,30385749,103630818,4,0,1,2048,15,1323695315
10673,73246250,25056769,98303019,4,0,0,15360,15,10252585153
10674,73252200,30382104,103634304,0,0,1,15872,3,4817960743
10675,73254830,30401858,103656688,9,0,1,5120,12,9187249836
10676,73262710,30414547,103677257,0,0,1,6656,3,9595768591
10677,73277800,30430238,103708038,1,0,1,5632,10,7885441056
10678,73303000,30408904,103711904,0,0,1,6144,3,3956174974
10679,73304330,30407830,103712160,8,0,1,9216,8,4705646109
10680,73311330,30401176,103712506,0,0,1,512,3,5389773542
10681,73313740,30399022,103712762,1,0,1,9216,10,4032764236
10682,73326180,30420403,103746583,1,0,1,512,10,5697564140
10683,73332340,30414266,103746606,0,0,1,1024,3,7570280254
10684,73339961,30406668,103746629,8,0,1,4096,8,4256326484
10685,73363970,30382682,103746652,1,0,1,1024,10,1139128464
10686,73372580,30382859,103755439,0,0,1,20480,3,7267806121
10687,73385321,30380622,103765943,8,0,1,6144,8,9617140535
10688,73389100,30423626,103812726,9,0,1,16896,12,1193337867
10689,73394941,30426567,103821508,8,0,1,1536,8,4141624569
10690,73400451,30425243,103825694,8,0,1,6656,8,8328541566
10691,73404210,30427549,103831759,8,0,1,7680,8,6131528702
10692,73405620,25246353,98651973,6,0,0,69120,7,6508675339
10693,73407819,25059317,98467136,1,0,0,28160,10,6505240804
10694,73408980,30425124,103834104,0,0,1,1024,3,2516172804
10695,73424270,30418445,103842715,1,0,1,12800,10,992208104
10696,73435000,24946032,98381032,4,0,0,4096,15,1279931764
10697,73441170,24999688,98440858,6,0,0,40448,7,8865514123
10698,73441930,25267880,98709810,4,0,0,104448,15,8683675955
10699,73459919,25070187,98530106,1,0,0,52224,10,7595879598
10700,73467790,25125743,98593533,6,0,0,72704,7,4788897844
10701,73468549,25030808,98499357,1,0,0,7680,10,4481436815
10702,73473850,30370491,103844341,0,0,1,2560,3,4287698200
10703,73476460,30368547,103845007,6,0,1,1024,7,5934985007
10704,73479031,30366962,103845993,8,0,1,1536,8,289890669
10705,73479930,24948581,98428511,0,0,0,512,3,6706304524
10706,73493880,30363128,103857008,0,0,1,5120,3,3094510162
10707,73509871,30351981,103861852,8,0,1,3584,8,9211691678
10708,73512920,30353438,103866358,6,0,1,7168,7,6411765834
10709,73513811,30355133,103868944,8,0,1,4096,8,8449156843
10710,73525360,30363136,103888496,0,0,1,6144,3,4315404532
10711,73525980,24915860,98441840,0,0,0,3072,3,10128835034
10712,73533550,30356022,103889572,6,0,1,13312,7,3642805411
10713,73542290,30355569,103897859,0,0,1,1024,3,8261131844
10714,73543990,30354855,103898845,0,0,1,1536,3,5680857429
10715,73546360,30378214,103924574,0,0,1,4096,3,6804743264
10716,73547160,30379499,103926659,9,0,1,1536,12,207003942
10717,73557620,30372905,103930525,6,0,1,6144,7,3582937383
10718,73563560,30373413,103936973,0,0,1,3584,3,7713279200
10719,73568311,30374216,103942527,8,0,1,4096,8,2699436560
10720,73568611,30374582,103943193,8,0,1,1024,8,6856786846
10721,73571230,25040001,98611231,6,0,0,16384,7,5994954953
10722,73579470,25042390,98621860,0,0,0,2048,3,6916945352
10723,73580680,30363179,103943859,6,0,1,1024,7,8896093160
10724,73582900,30361305,103944205,6,0,1,512,7,7563465761
10725,73585750,24890276,98476026,0,0,0,512,3,916979284
10726,73593950,24848272,98442222,0,0,0,1024,3,7272314527
10727,73599020,30348326,103947346,6,0,1,15872,7,7622101590
10728,73611370,25049640,98661010,6,0,0,23552,7,4520840406
10729,73620789,24939237,98560026,1,0,0,7168,10,6693760925
10730,73628490,30327980,103956470,9,0,1,7168,12,10663588478
10731,73638650,30328222,103966872,0,0,1,5120,3,2088338934
10732,73646531,30322927,103969458,8,0,1,4096,8,7053508762
10733,73653700,30318024,103971724,0,0,1,3584,3,8031733384
10734,73653760,30318310,103972070,0,0,1,512,3,8502428386
10735,73678200,25031945,98710145,0,0,0,1024,3,10601914487
10736,73690680,24877209,98567889,4,0,0,8704,15,723980237
10737,73695360,30283123,103978483,0,0,1,6144,3,4767944988
10738,73722910,30267630,103990540,0,0,1,7168,3,5538658712
10739,73724950,30267856,103992806,6,0,1,3584,7,6460268816
10740,73732190,30263639,103995829,9,0,1,4608,12,5212630498
10741,73736280,30266965,104003245,6,0,1,4096,7,4369806996
10742,73744440,30267732,104012172,6,0,1,3072,7,3790254895
10743,73755030,24968895,98723925,6,0,0,43008,7,4030192662
10744,73756741,30259617,104016358,8,0,1,6656,8,7789333308
10745,73757230,30260434,104017664,6,0,1,2048,7,3701482330
10746,73763660,25403533,99167193,6,0,0,72704,7,6394270075
10747,73765210,30253760,104018970,0,0,1,2048,3,6163900032
10748,73765950,25546540,99312490,0,0,0,512,3,141154038
10749,73767820,25035758,98803578,6,0,0,72192,7,9208222140
10750,73776250,30246932,104023182,8,0,1,6656,8,540846357
10751,73781240,30245808,104027048,0,0,1,6144,3,8432376221
10752,73784830,30243204,104028034,3,0,1,1536,17,10714025307
10753,73795240,30233780,104029020,6,0,1,1536,7,7919775307
10754,73795440,30239251,104034691,3,0,1,22016,17,319485235
10755,73797239,25475645,99272884,1,0,0,155136,10,10104162150
10756,73821050,25087245,98908295,4,0,0,31232,15,8448514984
10757,73822480,30256382,104078862,0,0,1,1536,3,3421250594
10758,73823580,30267204,104090784,8,0,1,8704,8,10652625621
10759,73826850,30277337,104104187,3,0,1,10240,17,5357039093
10760,73832820,30287078,104119898,0,0,1,12800,3,7993401602
10761,73842100,30285165,104127265,0,0,1,5120,3,1966896204
10762,73847729,25464582,99312311,1,0,0,44544,10,2810314109
10763,73867920,30264445,104132365,6,0,1,1536,7,7011929270
10764,73877810,30258101,104135911,6,0,1,5632,7,8147784817
10765,73886480,30250737,104137217,6,0,1,2048,7,5687999187
10766,73899310,30240417,104139727,6,0,1,13824,7,5793689609
10767,73902940,30237453,104140393,6,0,1,1024,7,5444475565
10768,73906530,30239355,104145885,0,0,1,8704,3,9372123087
10769,73908910,25217327,99126237,6,0,0,55808,7,1107304961
10770,73914850,30244145,104158995,8,0,1,512,8,8710371724
10771,73921550,24789201,98710751,0,0,0,1536,3,10368426724
10772,73941570,30217499,104159069,6,0,1,12288,7,2957141074
10773,73942660,30225227,104167887,3,0,1,1536,17,9608047096
10774,73952810,30216665,104169475,3,0,1,15872,17,5175214111
10775,73956470,25481408,99437878,6,0,0,164352,7,3706971006
10776,73958649,25316153,99274802,1,0,0,6144,10,4604975002
10777,73960640,25423919,99384559,6,0,0,23040,7,10696128128
10778,73965780,30221771,104187551,3,0,1,17408,17,3785896793
10779,73980980,30219662,104200642,3,0,1,512,17,4212624718
10780,73983480,25394036,99377516,6,0,0,12288,7,9320208581
10781,73984340,30220808,104205148,6,0,1,7168,7,3928857105
10782,73985550,25111543,99097093,4,0,0,68608,15,8549987104
10783,73986520,25192702,99179222,0,0,0,512,3,274511970
10784,73995880,30212174,104208054,6,0,1,4608,7,10614511254
10785,73996240,25391531,99387771,4,0,0,10240,15,3480063332
10786,74004350,30208210,104212560,3,0,1,7168,17,5433977929
10787,74015330,30199008,104214338,3,0,1,2560,17,8853778558
10788,74016590,25159252,99175842,4,0,0,12800,15,3732339320
10789,74020380,25347667,99368047,6,0,0,129536,7,3993150471
10790,74029350,30189048,104218398,0,0,1,6656,3,1235525749
10791,74035150,25136769,99171919,6,0,0,3072,7,7672785159
10792,74045520,25125440,99170960,6,0,0,12288,7,2067204297
10793,74066020,25385671,99451691,0,0,0,512,3,7330306915
10794,74069300,25304090,99373390,4,0,0,17408,15,7079862925
10795,74072139,25226554,99298693,1,0,0,78336,10,9816354788
10796,74097770,24893713,98991483,6,0,0,16384,7,3467694790
10797,74113070,25215478,99328548,0,0,0,1024,3,3522841547
10798,74137770,30082574,104220344,6,0,1,3072,7,8833793135
10799,74144260,30081127,104225387,0,0,1,5120,3,1311090963
10800,74146240,24912483,99058723,0,0,0,2048,3,624576141
10801,74148510,25336638,99485148,0,0,0,512,3,10208977873
10802,74149010,30081092,104230102,3,0,1,5632,17,5175627381
10803,74150040,30085119,104235159,6,0,1,18944,7,2518645746
10804,74189030,30063108,104252138,0,0,1,2560,3,8123010390
10805,74190830,30066546,104257376,3,0,1,6656,17,3579200654
10806,74213600,25263634,99477234,4,0,0,83456,15,5460074236
10807,74221100,30039528,104260628,3,0,1,5120,17,9538412819
10808,74221390,30045115,104266505,0,0,1,17408,3,652585823
10809,74229140,30042217,104271357,3,0,1,7680,17,10110435279
10810,74236290,30036053,104272343,0,0,1,1536,3,6613519777
10811,74243090,30031199,104274289,3,0,1,3072,17,6605836904
10812,74244300,30030655,104274955,3,0,1,1024,17,3447205361
10813,74252590,30046130,104298720,3,0,1,16896,17,9253938853
10814,74260120,30046764,104306884,9,0,1,5632,12,9681850688
10815,74272920,25419028,99691948,6,0,0,69120,7,9997444005
10816,74281789,25046222,99328011,1,0,0,50688,10,3366204101
10817,74301220,30012069,104313289,6,0,1,1024,7,9626247779
10818,74302540,30018785,104321325,6,0,1,6656,7,7518347670
10819,74307670,30018187,104325857,6,0,1,7168,7,4310681847
10820,74308580,25019633,99328213,0,0,0,512,3,4320642449
10821,74309710,30022391,104332101,6,0,1,5120,7,9844278877
10822,74319210,25132302,99451512,6,0,0,44544,7,3891811784
10823,74327580,30008387,104335967,6,0,1,6144,7,2770331942
10824,74342090,25288319,99630409,0,0,0,1024,3,6324473853
10825,74362790,29977043,104339833,0,0,1,6144,3,8332111803
10826,74365570,25405133,99770703,4,0,0,72704,15,4667631833
10827,74399240,24974485,99373725,4,0,0,1024,15,8524031545
10828,74405480,29946554,104352034,6,0,1,3584,7,6224041358
10829,74419711,29944943,104364654,5,0,1,8192,10,1053183029
10830,74421160,25063809,99484969,4,0,0,24576,15,5645550504
10831,74421710,25475323,99897033,4,0,0,47616,15,2531871651
10832,74429260,29937020,104366280,0,0,1,2560,3,1227848689
10833,74448590,25181415,99630005,6,0,0,79872,7,10264372811
10834,74477749,25245330,99723079,1,0,0,39424,10,7385472973
10835,74478220,29888726,104366946,6,0,1,1024,7,5867077891
10836,74485230,25145826,99631056,0,0,0,2048,3,8235509250
10837,74499470,29871982,104371452,7,0,1,7168,10,3381176161
10838,74505490,29866423,104371913,7,0,1,10240,10,4123726811
10839,74505570,25352010,99857580,4,0,0,41984,15,4516411154
10840,74507930,25132390,99640320,0,0,0,512,3,8053189050
10841,74514010,29861205,104375215,6,0,1,1536,7,5113200826
10842,74517260,29857978,104375238,7,0,1,512,10,6490698759
10843,74551560,25171698,99723258,0,0,0,512,3,147370507
10844,74573540,29804877,104378417,6,0,1,5632,7,1630878421
10845,74582940,29795823,104378763,6,0,1,512,7,1651162991
10846,74583190,25156023,99739213,0,0,0,512,3,1458782743
10847,74592029,25462867,100054896,1,0,0,47104,10,10480710052
10848,74620520,24921229,99541749,0,0,0,512,3,2018708316
10849,74643630,29736106,104379736,6,0,1,12800,7,1502059581
10850,74662990,25344761,100007751,0,0,0,1536,3,3911532531
10851,74665360,25176388,99841748,0,0,0,512,3,9730915447
10852,74714820,29689449,104404269,6,0,1,2560,7,3754946396
10853,74715239,25365607,100080846,1,0,0,5120,10,814690808
10854,74734330,29671885,104406215,6,0,1,3072,7,3591481349
10855,74743400,29663379,104406779,6,0,1,10752,7,8752240210
10856,74751310,25436006,100187316,4,0,0,35840,15,6356141288
10857,74752240,25068002,99820242,4,0,0,46592,15,3785331390
10858,74764540,29647624,104412164,8,0,1,10240,8,8609066811
10859,74774450,29656260,104430710,6,0,1,7168,7,10027473105
10860,74779630,25156978,99936608,4,0,0,20992,15,9157402964
10861,74780181,29652475,104432656,8,0,1,3072,8,7820032931
10862,74846950,29602843,104449793,8,0,1,7680,8,2481933090
10863,74852740,24697775,99550515,0,0,0,512,3,7048821364
10864,74864381,29590177,104454558,8,0,1,10240,8,2279599935
10865,74926450,25338647,100265097,4,0,0,26112,15,6983846864
10866,74936210,29526127,104462337,8,0,1,2560,8,6354466376
10867,74936471,29526839,104463310,5,0,1,12800,10,8059839450
10868,74948220,24746442,99694662,4,0,0,4096,15,9750342947
10869,74949441,29537178,104486619,5,0,1,2560,10,6396205116
10870,74952891,29538234,104491125,5,0,1,7168,10,7088921213
10871,74961160,24810034,99771194,0,0,0,1536,3,8265685625
10872,74961199,25019411,99980610,1,0,0,66560,10,5217646314
10873,74977970,24864767,99842737,0,0,0,2560,3,4146027336
10874,74978951,29532636,104511587,5,0,1,10752,10,6512442223
10875,74981810,24947070,99928880,4,0,0,104448,15,4213523457
10876,74994451,29555788,104550239,5,0,1,45056,10,1054140354
10877,74996450,29560665,104557115,8,0,1,2048,8,10112097072
10878,75000290,24928769,99929059,0,0,0,512,3,9437319003
10879,75026861,29536187,104563048,8,0,1,10752,8,8987971224
10880,75028531,29546880,104575411,5,0,1,26624,10,1689913725
10881,75031079,24984586,100015665,1,0,0,19968,10,9413009567
10882,75032400,29560069,104592469,8,0,1,5632,8,4691566499
10883,75038901,29554810,104593711,8,0,1,1536,8,1455645234
10884,75041990,24945584,99987574,0,0,0,2048,3,4239111068
10885,75045900,29549501,104595401,2,0,1,3072,3,3176222265
10886,75057860,24800367,99858227,0,0,0,2048,3,823463267
10887,75061141,29539862,104601003,5,0,1,512,10,5474745587
10888,75062239,25425827,100488066,1,0,0,100864,10,6450505033
10889,75064141,29539128,104603269,8,0,1,3584,8,1142496901
10890,75065491,29538137,104603628,5,0,1,9728,10,6795263874
10891,75077141,29535419,104612560,5,0,1,3072,10,7211949066
10892,75088181,29540627,104628808,5,0,1,4608,10,10079556404
10893,75090359,24910554,100000913,1,0,0,25600,10,3830276452
10894,75091150,25501782,100592932,4,0,0,61440,15,10448002452
10895,75094420,29535694,104630114,2,0,1,2048,3,1830169459
10896,75095790,29539761,104635551,1,0,1,4096,10,7648387088
10897,75097279,29545044,104642323,4,0,1,10752,15,2247747668
10898,75105781,29541048,104646829,5,0,1,7168,10,9374834091
10899,75117971,29535733,104653704,5,0,1,3584,10,2158034532
10900,75121630,29538643,104660273,2,0,1,2560,3,5244059502
10901,75137910,29528981,104666891,1,0,1,23040,10,6650137861
10902,75141281,29544020,104685301,5,0,1,1536,10,3521154997
10903,75147930,29543484,104691414,8,0,1,4608,8,6899703702
10904,75155450,29541110,104696560,8,0,1,8192,8,3395892797
10905,75160670,29565115,104725785,8,0,1,4608,8,4603726744
10906,75161940,24778424,99940364,0,0,0,3072,3,10614635327
10907,75163270,24876286,100039556,4,0,0,78336,15,7339051719
10908,75164360,29563051,104727411,1,0,1,2560,10,246662444
10909,75176390,29552967,104729357,1,0,1,3072,10,6312585639
10910,75178800,29552503,104731303,2,0,1,3072,3,1239806822
10911,75192010,29544247,104736257,8,0,1,18432,8,4583245159
10912,75223900,29522515,104746415,2,0,1,2048,3,7615871372
10913,75227250,25524938,100752188,4,0,0,73728,15,4183079585
10914,75234160,29512511,104746671,1,0,1,9216,10,1989361728
10915,75246080,29507801,104753881,1,0,1,4096,10,5901570726
10916,75249740,29512122,104761862,2,0,1,15360,3,478650644
10917,75250940,29525718,104776658,8,0,1,18432,8,980762171
10918,75252670,29526254,104778924,8,0,1,3584,8,7054330717
10919,75255420,29547830,104803250,1,0,1,20480,10,10147670998
10920,75255829,24681777,99937606,1,0,0,3072,10,9040068253
10921,75260789,25277545,100538334,1,0,0,26112,10,10242287804
10922,75261320,29543580,104804900,8,0,1,2560,8,6359124199
10923,75268440,24972399,100240839,4,0,0,29696,15,213682119
10924,75269910,24865701,100135611,0,0,0,512,3,8293738984
10925,75270409,24879875,100150284,1,0,0,21504,10,4378439584
10926,75276830,25063955,100340785,0,0,0,3072,3,8359509410
10927,75286921,29519077,104805998,5,0,1,1536,10,7047255590
10928,75292050,25262843,100554893,4,0,0,54272,15,1207447660
10929,75308001,29511347,104819348,5,0,1,15360,10,5874914233
10930,75319090,29511906,104830996,8,0,1,7168,8,4748256080
10931,75320960,24830759,100151719,0,0,0,512,3,6806110242
10932,75325980,29507602,104833582,1,0,1,4096,10,6450804773
10933,75329270,29507858,104837128,1,0,1,5632,10,1122040096
10934,75348411,29488973,104837384,5,0,1,9216,10,2374746911
10935,75356659,24977406,100334065,1,0,0,11264,10,5590938276
10936,75367161,29470582,104837743,5,0,1,9728,10,8856849501
10937,75417901,29429113,104847014,5,0,1,512,10,6143985535
10938,75433540,29414140,104847680,0,0,1,1024,3,8188118674
10939,75437101,29411565,104848666,5,0,1,1536,10,7426849390
10940,75440000,29411598,104851598,8,0,1,4608,8,10680915446
10941,75441390,29438970,104880360,8,0,1,9216,8,1904402679
10942,75459750,25070605,100530355,4,0,0,56832,15,7456938791
10943,75464489,25109615,100574104,1,0,0,62976,10,317912728
10944,75470461,29410053,104880514,5,0,1,8704,10,1524252133
10945,75471140,25149926,100621066,4,0,0,91648,15,1138477412
10946,75487890,24899436,100387326,0,0,0,1536,3,5023440188
10947,75503980,29376880,104880860,8,0,1,512,8,5558278100
10948,75520820,24992150,100512970,4,0,0,52224,15,10254588796
10949,75526721,29381595,104908316,5,0,1,24576,10,5547301523
10950,75534071,29377151,104911222,5,0,1,4608,10,3427492870
10951,75569390,29348131,104917521,8,0,1,512,8,8769624473
10952,75570960,29346817,104917777,8,0,1,9216,8,6330357355
10953,75577989,25297795,100875784,1,0,0,102912,10,3708894683
10954,75596310,29335898,104932208,8,0,1,3072,8,2865434743
10955,75597350,29338404,104935754,8,0,1,5632,8,5964722862
10956,75606800,25025856,100632656,4,0,0,37888,15,5507196128
10957,75613399,25021237,100634636,1,0,0,6144,10,923577779
10958,75625179,25755830,101381009,1,0,0,28672,10,5818657010
10959,75626310,24757593,100383903,4,0,0,1536,15,9585219063
10960,75660590,24723492,100384082,0,0,0,512,3,9006081313
10961,75666730,25047606,100714336,4,0,0,107008,15,4928005270
10962,75688470,24808565,100497035,4,0,0,29184,15,828407292
10963,75690911,29257349,104948260,5,0,1,4096,10,2268875577
10964,75694880,25729153,101424033,9,0,0,26112,12,4392939726
10965,75695930,25369298,101065228,4,0,0,41472,15,2259525579
10966,75700500,29254631,104955131,8,0,1,7168,8,634401702
10967,75701875,29253602,104955477,5,0,1,512,10,9522492668
10968,75712220,24679066,100391286,0,0,0,1536,3,2357922932
10969,75714880,25568364,101283244,4,0,0,10240,15,8852702687
10970,75748200,24844911,100593111,0,0,0,512,3,9632762334
10971,75753190,24686109,100439299,9,0,0,5120,12,4611817043
10972,75811010,24918691,100729701,0,0,0,1024,3,6537266131
10973,75831189,24626122,100457311,1,0,0,13824,10,4601169709
10974,75856700,29101363,104958063,2,0,1,4096,3,3271896119
10975,75858050,29100359,104958409,2,0,1,512,3,5081813351
10976,75880950,29078484,104959434,2,0,1,10752,3,1687067565
10977,75884650,25265724,101150374,4,0,0,37888,15,10286050994
10978,75888860,29071560,104960420,2,0,1,1536,3,7006183887
10979,75965370,24943335,100908705,9,0,0,10240,12,811002264
10980,75981590,28981736,104963326,9,0,1,4608,12,3296315573
10981,75982400,28984152,104966552,9,0,1,5120,12,5238643823
10982,75982519,25057551,101040070,1,0,0,17408,10,4795497356
10983,75998400,24730958,100729358,4,0,0,27648,15,719500078
10984,76001160,24929878,100931038,9,0,0,20992,12,9958582472
10985,76005220,24988248,100993468,4,0,0,11776,15,5372740505
10986,76029580,24749103,100778683,4,0,0,17920,15,10316919356
10987,76032710,28936108,104968818,6,0,1,3584,7,6503232340
10988,76032720,28937084,104969804,9,0,1,1536,12,8615808644
10989,76033119,24687792,100720911,1,0,0,21504,10,8186976070
10990,76040500,28929970,104970470,9,0,1,1024,12,3269407959
10991,76047970,28923576,104971546,2,0,1,13312,3,5122000016
10992,76068070,28909297,104977367,9,0,1,4096,12,6883676494
10993,76068349,24704851,100773200,1,0,0,38912,10,3088922843
10994,76073610,28907623,104981233,9,0,1,6144,12,9294775396
10995,76073940,25029256,101103196,4,0,0,57856,15,5823054532
10996,76095110,24549211,100644321,9,0,0,31232,12,4650893837
10997,76101080,28887697,104988777,9,0,1,3584,12,5205338752
10998,76103700,25369500,101473200,9,0,0,89600,12,8334974523
10999,76115250,28878673,104993923,9,0,1,8192,12,6300597498
11000,76126230,28875886,105002116,9,0,1,512,12,4722884591
11001,76147279,24805095,100952374,1,0,0,25088,10,1123062016
11002,76148909,25290151,101439060,1,0,0,48128,10,7466395857
11003,76166360,25066065,101232425,4,0,0,43008,15,5079183400
11004,76167390,24738172,100905562,9,0,0,32768,12,6555953920
11005,76202660,28800122,105002782,9,0,1,1024,12,10005778652
11006,76213640,25454009,101667649,9,0,0,28672,12,5602468029
11007,76219389,24866124,101085513,1,0,0,66048,10,5203794309
11008,76236790,28766338,105003128,9,0,1,512,12,6408618749
11009,76247280,24939491,101186771,4,0,0,75776,15,1415867947
11010,76258490,28747224,105005714,9,0,1,4096,12,962940497
11011,76275710,24831097,101106807,4,0,0,11776,15,2881864264
11012,76283710,24996056,101279766,4,0,0,139264,15,10049043826
11013,76299580,24892830,101192410,4,0,0,18432,15,8586634247
11014,76305290,24892322,101197612,9,0,0,16896,12,430219216
11015,76308500,28704509,105013009,9,0,1,2048,12,4640398334
11016,76308530,28711332,105019862,2,0,1,10240,3,7827880210
11017,76309370,28711363,105020733,2,0,1,12288,3,8639209089
11018,76328680,25180838,101509518,9,0,0,23552,12,1247204096
11019,76331090,28711166,105042256,9,0,1,1024,12,6321185952
11020,76334650,28710938,105045588,1,0,1,9216,10,5446995788
11021,76351670,28694264,105045934,1,0,1,512,10,121284379
11022,76355369,24641981,100997350,1,0,0,4096,10,7351169123
11023,76358110,28693108,105051218,9,0,1,6656,12,988603419
11024,76359600,28694550,105054150,9,0,1,4608,12,10178262711
11025,76374839,25272575,101647414,1,0,0,71168,10,4110976996
11026,76379070,28693712,105072782,1,0,1,8192,10,2508831272
11027,76379780,25166090,101545870,9,0,0,36864,12,9700338128
11028,76392670,28712404,105105074,9,0,1,15872,12,10215597568
11029,76424480,24557696,100982176,4,0,0,19968,15,9876188489
11030,76438250,28670050,105108300,1,0,1,5120,10,451221321
11031,76459150,28669273,105128423,2,0,1,11264,3,6980683473
11032,76467250,28668504,105135754,2,0,1,5632,3,4313999161
11033,76468300,28668440,105136740,2,0,1,1536,3,3386831699
11034,76498829,25288325,101787154,1,0,0,32256,10,8180523696
11035,76505410,24403638,100909048,4,0,0,1024,15,334629758
11036,76524930,28617942,105142872,9,0,1,9728,12,7931681332
11037,76528430,28621185,105149615,2,0,1,5632,3,1199051238
11038,76533220,28616741,105149961,2,0,1,512,3,4482185560
11039,76533880,28621253,105155133,2,0,1,8192,3,1061207897
11040,76550450,28605989,105156439,9,0,1,2048,12,6972207687
11041,76555020,25303576,101858596,9,0,0,28672,12,1623590603
11042,76562130,28598815,105160945,1,0,1,7168,10,8193284864
11043,76575210,28590561,105165771,9,0,1,7680,12,10597077049
11044,76583150,28583838,105166988,2,0,1,12800,3,9697274779
11045,76590150,24689951,101280101,4,0,0,1024,15,6098311955
11046,76595670,28595092,105190762,1,0,1,4608,10,9828024503
11047,76595910,28595518,105191428,1,0,1,1024,10,6006152166
11048,76601550,28590237,105191787,6,0,1,9728,7,547269096
11049,76602240,24444029,101046269,4,0,0,1024,15,6978185579
11050,76610730,28593851,105204581,8,0,1,3072,8,7972122809
11051,76614020,25336814,101950834,9,0,0,103424,12,7425589736
11052,76619650,28589117,105208767,6,0,1,6656,7,3795929418
11053,76621950,28594252,105216202,8,0,1,14336,8,2302821306
11054,76628700,28589751,105218451,1,0,1,1536,10,4972438144
11055,76629650,24786404,101416054,9,0,0,19456,12,7752538655
11056,76639581,28579856,105219437,5,0,1,1536,10,10024934770
11057,76647030,28573585,105220615,6,0,1,13824,7,6233324696
11058,76656690,28587361,105244051,8,0,1,3584,8,7446276435
11059,76657170,28609757,105266927,2,0,1,512,3,2784992512
11060,76661080,24711068,101372148,4,0,0,512,15,6074351058
11061,76663500,28605053,105268553,1,0,1,2560,10,5796091482
11062,76674670,28597109,105271779,2,0,1,5120,3,4881563594
11063,76677180,28595265,105272445,6,0,1,1024,7,3397097996
11064,76678890,28596141,105275031,1,0,1,4096,10,6641999655
11065,76689949,24935612,101625561,1,0,0,71168,10,9291425580
11066,76691630,28585821,105277451,2,0,1,12288,3,1698304185
11067,76697810,28586993,105284803,1,0,1,7680,10,8468299192
11068,76700129,24709974,101410103,1,0,0,50688,10,8335537248
11069,76701510,25091797,101793307,9,0,0,19968,12,5654408456
11070,76709670,24617531,101327201,4,0,0,1536,15,10324388448
11071,76714200,28570948,105285148,2,0,1,512,3,5946534724
11072,76714960,28578757,105293717,8,0,1,6656,8,1112164457
11073,76739650,24733908,101473558,4,0,0,512,15,8310095440
11074,76740640,28560809,105301449,2,0,1,12288,3,2057622102
11075,76749980,28576627,105326607,1,0,1,22016,10,9636039869
11076,76754210,28574983,105329193,8,0,1,4096,8,2749198781
11077,76801369,24733238,101534607,1,0,0,40960,10,8045058570
11078,76802930,28531115,105334045,2,0,1,7680,3,5955868182
11079,76820179,24569277,101389456,1,0,0,27648,10,1222301896
11080,76825660,28511317,105336977,6,0,1,4608,7,1981664411
11081,76826549,24757300,101583849,1,0,0,19968,10,5692200972
11082,76829060,28509543,105338603,8,0,1,2560,8,5101366665
11083,76831390,28508519,105339909,8,0,1,2048,8,5087193609
11084,76842809,24755415,101598224,1,0,0,47104,10,5507938972
11085,76849360,28491215,105340575,8,0,1,1024,8,6748750524
11086,76849890,28501946,105351836,8,0,1,14336,8,4274032845
11087,76859110,28501892,105361002,1,0,1,2560,10,3071563266
11088,76879890,28481778,105361668,8,0,1,1024,8,7732077714
11089,76893069,28482380,105375449,4,0,1,10752,15,7407387636
11090,76893079,28488491,105381570,4,0,1,3072,15,1647969651
11091,76902870,28484303,105387173,6,0,1,1024,7,1445312991
11092,76913570,28475869,105389439,8,0,1,3584,8,7795884876
11093,76928389,24727863,101656252,1,0,0,28672,10,5075531823
11094,76947940,28443125,105391065,6,0,1,2560,7,3757628471
11095,76954840,28440411,105395251,2,0,1,6656,3,1414416522
11096,76956719,24932375,101889094,1,0,0,6656,10,4096788469
11097,76985740,28448269,105434009,2,0,1,7168,3,971077684
11098,76990870,28443810,105434680,2,0,1,1024,3,7509859347
11099,76996109,28446092,105442201,4,0,1,512,15,1278691856
11100,77004299,24556284,101560583,1,0,0,6144,10,2479108026
11101,77024380,24448999,101473379,5,0,0,512,10,7011954870
11102,77028200,28417790,105445990,6,0,1,512,7,7690839265
11103,77033999,24569552,101603551,1,0,0,17408,10,10255146141
11104,77040450,28412312,105452762,1,0,1,10752,10,8716548140
11105,77047100,28406328,105453428,6,0,1,1024,7,5426064654
11106,77048580,28406154,105454734,1,0,1,2048,10,7271673460
11107,77051780,28412234,105464014,1,0,1,5632,10,9420490853
11108,77053970,28419399,105473369,1,0,1,4608,10,1893034355
11109,77055599,28419382,105474981,4,0,1,1536,15,6534829395
11110,77065120,28415006,105480126,2,0,1,3584,3,9214483366
11111,77068000,28415032,105483032,2,0,1,4608,3,7000426188
11112,77080800,28405778,105486578,1,0,1,5632,10,9353142069
11113,77087110,28399622,105486732,6,0,1,8704,7,8026023746
11114,77094120,28418325,105512445,1,0,1,17408,10,2550543073
11115,77106510,28407306,105513816,2,0,1,13824,3,8210180659
11116,77117109,28406796,105523905,4,0,1,8704,15,9515007109
11117,77120870,28409408,105530278,6,0,1,512,7,7106735185
11118,77124309,28424994,105549303,4,0,1,6656,15,7403174546
11119,77125590,28435093,105560683,6,0,1,13824,7,8599796163
11120,77137969,24592956,101730925,1,0,0,3072,10,6087993395
11121,77151340,28410316,105561656,2,0,1,12800,3,5907027199
11122,77162070,28418696,105580766,1,0,1,4096,10,284807376
11123,77162919,24703947,101866866,1,0,0,24064,10,3606278191
11124,77175970,28413408,105589378,1,0,1,5120,10,2426695271
11125,77199610,28417137,105616747,2,0,1,2048,3,769952385
11126,77207570,28422722,105630292,2,0,1,6144,3,2588152817
11127,77221620,28419992,105641612,1,0,1,2048,10,2057308495
11128,77223010,28420548,105643558,6,0,1,3072,7,6455835410
11129,77225019,24587408,101812427,1,0,0,2048,10,8784658629
11130,77241149,28447391,105688540,4,0,1,7168,15,4908665755
11131,77245030,28443533,105688563,1,0,1,1536,10,4615131035
11132,77272450,28416136,105688586,1,0,1,2560,10,2671213456
11133,77282779,28405830,105688609,4,0,1,12800,15,7055658113
11134,77285610,28403981,105689591,6,0,1,5632,7,1467026205
11135,77288900,28400714,105689614,7,0,1,512,10,2526098404
11136,77289159,24528032,101817191,1,0,0,2560,10,4750107099
11137,77293130,28396507,105689637,6,0,1,512,7,906714682
11138,77296620,28393040,105689660,2,0,1,12800,3,5094743154
11139,77297619,28392890,105690509,4,0,1,5632,15,4078379808
11140,77298240,28392292,105690532,1,0,1,4608,10,4283992770
11141,77299120,28398484,105697604,7,0,1,23552,10,9078999533
11142,77319940,28407638,105727578,1,0,1,5120,10,9844696882
11143,77322910,28420589,105743499,7,0,1,6656,10,7265818544
11144,77326069,28421322,105747391,4,0,1,6144,15,6194182809
11145,77347309,24675774,102023083,1,0,0,73728,10,6202228151
11146,77360640,28394579,105755219,0,0,1,5632,3,9539949730
11147,77387230,28369935,105757165,6,0,1,3072,7,8970853263
11148,77401080,28357391,105758471,1,0,1,2048,10,1769455933
11149,77405290,28355257,105760547,6,0,1,9216,7,2897744398
11150,77412560,28348973,105761533,3,0,1,1536,17,5140299024
11151,77416590,28347209,105763799,1,0,1,3584,10,8288508933
11152,77425270,28346486,105771756,3,0,1,3584,17,9452398888
11153,77432040,28340062,105772102,7,0,1,512,10,3353941808
11154,77465640,28306808,105772448,1,0,1,512,10,6333429753
11155,77478030,28332668,105810698,6,0,1,27136,7,6508457622
11156,77485510,28330818,105816328,6,0,1,4096,7,8539937389
11157,77487540,28331694,105819234,3,0,1,4608,17,3459567290
11158,77497250,28325850,105823100,3,0,1,6144,17,2944328955
11159,77501450,28366495,105867945,3,0,1,7680,17,2934247623
11160,77514660,28353308,105867968,1,0,1,3584,10,1786166168
11161,77518500,28349491,105867991,6,0,1,12288,7,2345594157
11162,77520110,28347912,105868022,7,0,1,2560,10,5254967976
11163,77532550,28336168,105868718,6,0,1,2048,7,10140935277
11164,77550540,28353421,105903961,7,0,1,11776,10,9258617867
11165,77568830,28338046,105906876,6,0,1,2560,7,4934073420
11166,77571120,28342655,105913775,7,0,1,3072,10,4202122471
11167,77573620,28367321,105940941,3,0,1,11776,17,4086412211
11168,77585950,28360137,105946087,7,0,1,8192,10,1358949263
11169,77592319,24254693,101847012,1,0,0,1536,10,8012042492
11170,77595870,28351994,105947864,7,0,1,9216,10,6169857104
11171,77597990,28351764,105949754,7,0,1,1024,10,6232299924
11172,77608310,28364331,105972641,2,0,1,13312,3,4727691590
11173,77608450,28364842,105973292,7,0,1,3584,10,2083430391
11174,77610309,24622537,102232846,1,0,0,8704,10,6520255764
11175,77632000,28354394,105986394,2,0,1,6656,3,9371626520
11176,77632190,28399084,106031274,6,0,1,3072,7,9031474706
11177,77660500,28370797,106031297,2,0,1,5632,3,990330234
11178,77664550,28368442,106032992,2,0,1,6656,3,6912767473
11179,77669281,24428256,102097537,7,0,0,90112,10,2343801722
11180,77675430,28367830,106043260,2,0,1,2048,3,3094443235
11181,77692140,28388652,106080792,2,0,1,21504,3,8494563636
11182,77694980,28385835,106080815,2,0,1,10240,3,8138914182
11183,77696920,28383918,106080838,6,0,1,3072,7,9755034164
11184,77699270,28381699,106080969,6,0,1,5120,7,9692161139
11185,77703870,28380005,106083875,3,0,1,4608,17,2776266248
11186,77705870,28384137,106090007,2,0,1,9728,3,2998882927
11187,77720260,28370413,106090673,3,0,1,11264,17,1117496644
11188,77731380,28368096,106099476,3,0,1,2048,17,6581298687
11189,77743460,28366027,106109487,6,0,1,1536,7,3185500745
11190,77750530,28363143,106113673,6,0,1,6656,7,10241521349
11191,77753069,24283435,102036504,1,0,0,13312,10,9304427357
11192,77775271,24594614,102369885,7,0,0,15872,10,8469856607
11193,77785521,24278766,102064287,7,0,0,9216,10,7422824497
11194,77792750,28344676,106137426,3,0,1,3072,17,7032497328
11195,77796900,28359985,106156885,2,0,1,13312,3,6805625410
11196,77797460,28377696,106175156,6,0,1,1536,7,4470586832
11197,77813579,24364298,102177877,1,0,0,44032,10,1738589149
11198,77822750,28353314,106176064,3,0,1,1536,17,9050953518
11199,77834991,24758688,102593679,7,0,0,82944,10,6900185187
11200,77840040,28363572,106203612,3,0,1,6656,17,5261821558
11201,77859051,24432808,102291859,7,0,0,38912,10,2310764985
11202,77861041,28342773,106203814,5,0,1,3584,10,10605036227
11203,77869871,24576599,102446470,7,0,0,25088,10,801317144
11204,77894019,24514558,102408577,1,0,0,27648,10,8667125957
11205,77896349,24314576,102210925,1,0,0,16384,10,4432761572
11206,77918090,28285747,106203837,6,0,1,1536,7,971413486
11207,77922149,24338188,102260337,1,0,0,56832,10,7329123901
11208,77926279,24371539,102297818,1,0,0,19456,10,6117736205
11209,77943209,24371792,102315001,1,0,0,56320,10,9189007903
11210,77952040,28263833,106215873,3,0,1,25600,17,6094963642
11211,77965980,28249916,106215896,3,0,1,4608,17,3015213846
11212,77979790,28236129,106215919,7,0,1,2560,10,5390515872
11213,78016801,24337920,102354721,7,0,0,7168,10,1116222462
11214,78017351,24859462,102876813,7,0,0,58368,10,4204208793
11215,78020400,28196760,106217160,6,0,1,2560,7,6616959836
11216,78029319,24521470,102550789,1,0,0,8192,10,8203751642
11217,78034869,24388224,102423093,1,0,0,29184,10,3482250327
11218,78051991,24296502,102348493,7,0,0,16896,10,7943314067
11219,78074209,24445844,102520053,1,0,0,22528,10,1144878393
11220,78094140,28123366,106217506,0,0,1,512,3,5260656399
11221,78102420,28116712,106219132,3,0,1,2560,17,7598030967
11222,78109880,28112184,106222064,0,0,1,4608,3,3068396795
11223,78126280,28098383,106224663,3,0,1,15360,17,9232676163
11224,78137130,28091399,106228529,6,0,1,6144,7,4973394239
11225,78137860,28092809,106230669,0,0,1,13312,3,6782999356
11226,78150700,28088930,106239630,2,0,1,3584,3,2009506037
11227,78160169,24609181,102769350,1,0,0,95232,10,6929638229
11228,78161390,28078586,106239976,0,0,1,512,3,9910041886
11229,78177601,24517554,102695155,7,0,0,62464,10,7254228659
11230,78177710,28062612,106240322,6,0,1,512,7,4231482464
11231,78182171,24435936,102618107,7,0,0,79872,10,9218426471
11232,78204310,28075320,106279630,0,0,1,9728,3,10212079497
11233,78210670,28069306,106279976,3,0,1,512,17,224946357
11234,78211760,28069202,106280962,1,0,1,1536,10,10157846279
11235,78217700,28063928,106281628,0,0,1,11264,3,3882200883
11236,78226269,24399996,102626265,1,0,0,26624,10,4840786749
11237,78250119,24300849,102550968,1,0,0,512,10,292965328
11238,78261490,28021764,106283254,1,0,1,2560,10,7775916767
11239,78264989,24406475,102671464,1,0,0,13824,10,1862100696
11240,78283921,24660113,102944034,7,0,0,19456,10,4805595882
11241,78291999,24336254,102628253,1,0,0,6144,10,7300716974
11242,78312231,24428080,102740311,7,0,0,60416,10,1238053208
11243,78316139,24840479,103156618,1,0,0,79360,10,7360258920
11244,78324880,27979149,106304029,7,0,1,8192,10,8915681433
11245,78331720,27982450,106314170,7,0,1,17920,10,7885733169
11246,78342849,24358475,102701324,1,0,0,1024,10,8272827672
11247,78382820,27953652,106336472,3,0,1,1536,17,7363964434
11248,78391480,27946938,106338418,7,0,1,3072,10,2455801109
11249,78396720,27944319,106341039,0,0,1,2048,3,5051690425
11250,78412360,27941241,106353601,3,0,1,12800,17,3159504244
11251,78450581,24466428,102917009,7,0,0,55808,10,2441093637
11252,78450911,24388682,102839593,7,0,0,8704,10,2344618088
11253,78475299,24225674,102700973,1,0,0,18944,10,9779262008
11254,78483961,27875310,106359271,5,0,1,1024,10,5798966623
11255,78485190,27874337,106359527,3,0,1,9216,17,6145561694
11256,78499871,24167227,102667098,7,0,0,48128,10,7282293981
11257,78511211,24325707,102836918,7,0,0,86016,10,5200153659
11258,78516391,24253762,102770153,7,0,0,2560,10,4674182177
11259,78528310,27833163,106361473,7,0,1,3072,10,5812187183
11260,78550350,27813709,106364059,0,0,1,4096,3,10689147920
11261,78550631,24692484,103243115,7,0,0,76800,10,5366161005
11262,78555460,27862568,106418028,0,0,1,24576,3,3552441299
11263,78557991,24094420,102652411,7,0,0,18944,10,9451390818
11264,78563430,27854621,106418051,6,0,1,1024,7,4967063285
11265,78574591,24429664,103004255,7,0,0,512,10,729408798
11266,78591570,27832305,106423875,7,0,1,3072,10,1870902589
11267,78595769,24519597,103115366,1,0,0,65024,10,4133091242
11268,78595849,24388126,102983975,1,0,0,47616,10,3759105604
11269,78596500,27835112,106431612,9,0,1,512,12,2796304076
11270,78599850,27848153,106448003,7,0,1,13824,10,1642990417
11271,78616700,27838371,106455071,9,0,1,7680,12,4099525321
11272,78618440,27837297,106455737,9,0,1,1024,12,2589705613
11273,78625239,24233767,102859006,1,0,0,20992,10,8408482188
11274,78649829,24202735,102852564,1,0,0,42496,10,718258177
11275,78653580,27803028,106456608,9,0,1,12288,12,10093017111
11276,78654900,27803334,106458234,0,0,1,2560,3,829320388
11277,78658029,24232625,102890654,1,0,0,15360,10,3047889073
11278,78658840,27801340,106460180,3,0,1,3072,17,1298035118
11279,78668029,24394121,103062150,1,0,0,84480,10,2635619275
11280,78672121,24515840,103187961,7,0,0,56320,10,3052769956
11281,78687090,27778582,106465672,9,0,1,8704,12,3695795517
11282,78699750,27790346,106490096,3,0,1,3072,17,7946850262
11283,78705170,27791863,106497033,0,0,1,15872,3,6150638474
11284,78705950,27794205,106500155,3,0,1,3072,17,9889768877
11285,78706610,27795030,106501640,9,0,1,15360,12,3091223617
11286,78712310,27819998,106532308,7,0,1,1024,10,10484159806
11287,78721960,27810694,106532654,7,0,1,512,10,1204798489
11288,78727770,27808430,106536200,9,0,1,5632,12,8827855779
11289,78746720,27790466,106537186,9,0,1,1536,12,4675513376
11290,78754840,27785892,106540732,3,0,1,5632,17,5572110142
11291,78757180,27797697,106554877,0,0,1,4608,3,5183073048
11292,78773940,27784209,106558149,9,0,1,3072,12,9112439665
11293,78775900,27785155,106561055,3,0,1,4608,17,6186297332
11294,78790820,27771861,106562681,9,0,1,2560,12,6909544643
11295,78798350,27767877,106566227,0,0,1,5632,3,2486474194
11296,78799360,27767213,106566573,0,0,1,512,3,8153127772
11297,78799840,27768359,106568199,9,0,1,2560,12,8742298512
11298,78805110,27763755,106568865,0,0,1,1024,3,4286676726
11299,78810290,27760841,106571131,3,0,1,3584,17,732283899
11300,78824780,27748937,106573717,0,0,1,4096,3,3672885257
11301,78828579,24617879,103446458,1,0,0,114176,10,8319845550
11302,78857609,27716454,106574063,4,0,1,512,15,7315802768
11303,78862590,27715979,106578569,0,0,1,7168,3,8870748283
11304,78863320,27718834,106582154,9,0,1,14848,12,7364091082
11305,78863621,24353926,103217547,7,0,0,36352,10,1862160771
11306,78867060,27717360,106584420,9,0,1,3584,12,6109175913
11307,78869701,24196060,103065761,7,0,0,11776,10,7848542144
11308,78876061,24312703,103188764,7,0,0,2560,10,10574766766
11309,78879130,27713287,106592417,0,0,1,10240,3,8476560248
11310,78885700,27717794,106603494,7,0,1,5632,10,7031517436
11311,78887060,27719020,106606080,9,0,1,4096,12,6474688072
11312,78892520,27718706,106611226,0,0,1,8192,3,2548030477
11313,78906630,27705799,106612429,0,0,1,12288,3,5755383331
11314,78911540,27705267,106616807,9,0,1,1536,12,1174863310
11315,78915580,27703813,106619393,3,0,1,4096,17,2761848788
11316,78925490,27696352,106621842,7,0,1,1024,10,7754602706
11317,78930329,24434466,103364795,1,0,0,35328,10,3974431671
11318,78933050,27689138,106622188,9,0,1,512,12,3274442028
11319,78937850,27697839,106635689,9,0,1,17920,12,6901054565
11320,78938640,27707466,106646106,9,0,1,512,12,7668645920
11321,78946599,24185816,103132415,1,0,0,18432,10,4182151042
11322,78953650,27694082,106647732,3,0,1,2560,17,10073910848
11323,78955850,27694468,106650318,9,0,1,4096,12,6760052483
11324,78962680,27688855,106651535,7,0,1,12800,10,32562920
11325,78962860,27689341,106652201,0,0,1,1024,3,4088211205
11326,78991930,27660630,106652560,0,0,1,9728,3,4856996447
11327,78992330,27666425,106658755,3,0,1,4608,17,3162317943
11328,78995330,27669060,106664390,3,0,1,2048,17,1813069769
11329,79007870,27657186,106665056,0,0,1,1024,3,5950739905
11330,79008611,24389123,103397734,7,0,0,108032,10,3311852770
11331,79008661,24625620,103634281,7,0,0,11264,10,3031849968
11332,79026159,24590504,103616663,1,0,0,78336,10,664248730
11333,79028130,27641432,106669562,9,0,1,7168,12,10227648159
11334,79056250,27644142,106700392,7,0,1,6656,10,7303084641
11335,79061740,27640278,106702018,3,0,1,2560,17,10429051154
11336,79065259,24346295,103411554,1,0,0,35328,10,6574210907
11337,79068780,27634544,106703324,9,0,1,2048,12,9341926433
11338,79095180,27611370,106706550,9,0,1,5120,12,5680573376
11339,79108920,27627854,106736774,9,0,1,4096,12,7242747216
11340,79111029,24336458,103447487,1,0,0,3072,10,2960956493
11341,79141330,27595549,106736879,9,0,1,4608,12,3130798108
11342,79154480,27586905,106741385,9,0,1,7168,12,6763774697
11343,79156320,27587651,106743971,3,0,1,4096,17,8400707280
11344,79174100,27570217,106744317,7,0,1,512,10,9365123052
11345,79174479,24148524,103323003,1,0,0,10240,10,276577974
11346,79191780,27554304,106746084,7,0,1,12288,10,5588011530
11347,79195820,27553490,106749310,3,0,1,5120,17,642350923
11348,79197990,27556310,106754300,3,0,1,3584,17,1588755983
11349,79242850,27518724,106761574,7,0,1,7680,10,10610830863
11350,79257170,27506670,106763840,9,0,1,3584,12,8477158509
11351,79259531,27506575,106766106,5,0,1,3584,10,9459137101
11352,79289619,24192518,103482137,1,0,0,26112,10,4653527257
11353,79303789,27462663,106766452,4,0,1,512,15,47004085
11354,79304690,27462108,106766798,9,0,1,512,12,2489488755
11355,79323930,27443534,106767464,7,0,1,1024,10,9228542499
11356,79324650,27444120,106768770,7,0,1,2048,10,5859674105
11357,79335830,27460838,106796668,9,0,1,3584,12,6039863892
11358,79341269,24177011,103518280,1,0,0,10752,10,8421913496
11359,79357650,27460610,106818260,9,0,1,5120,12,4788656105
11360,79358891,24041876,103400767,7,0,0,9728,10,3706515246
11361,79361599,24211917,103573516,1,0,0,30720,10,3471963780
11362,79368149,27465450,106833599,4,0,1,512,15,4837670701
11363,79369869,27486736,106856605,4,0,1,16896,15,6542616638
11364,79384640,27472631,106857271,8,0,1,1024,8,1911767323
11365,79391290,27493999,106885289,9,0,1,4096,12,8027763201
11366,79414940,27470372,106885312,9,0,1,3584,12,4500820193
11367,79417090,27468245,106885335,9,0,1,6656,12,3666067299
11368,79463351,24167375,103630726,7,0,0,46080,10,4836009424
11369,79466450,27418908,106885358,9,0,1,5632,12,8529243111
11370,79467061,24179122,103646183,7,0,0,38912,10,496280628
11371,79473921,24202957,103676878,7,0,0,41984,10,9064356423
11372,79492240,27393141,106885381,3,0,1,1536,17,3160076710
11373,79520040,27383874,106903914,3,0,1,13824,17,7484940921
11374,79529280,27374657,106903937,8,0,1,7168,8,2571425608
11375,79533650,27377151,106910801,3,0,1,2560,17,8343223949
11376,79538390,27395187,106933577,8,0,1,22016,8,10618183250
11377,79546450,27396882,106943332,9,0,1,15872,12,1216406375
11378,79549080,27423609,106972689,9,0,1,2560,12,6177968227
11379,79550920,27428663,106979583,7,0,1,512,10,6218197223
11380,79554719,24190991,103745710,1,0,0,104448,10,9297993116
11381,79560849,23949554,103510403,1,0,0,9216,10,2991228857
11382,79581940,27398002,106979942,3,0,1,9728,17,3630909200
11383,79604110,27378098,106982208,3,0,1,3584,17,2701956313
11384,79604839,24247938,103852777,1,0,0,13824,10,2998767434
11385,79608570,27373984,106982554,7,0,1,512,10,2510166793
11386,79615171,24150178,103765349,7,0,0,19968,10,3531673409
11387,79621740,27367786,106989526,8,0,1,9728,8,2019040215
11388,79644050,27360216,107004266,8,0,1,2048,8,9974014040
11389,79645520,27360372,107005892,9,0,1,2560,12,9058804119
11390,79665640,27362155,107027795,3,0,1,6144,17,9221805622
11391,79689021,24059346,103748367,7,0,0,1536,10,2548658670
11392,79689481,24086211,103775692,7,0,0,9728,10,5746646327
11393,79765019,23927082,103692101,1,0,0,48128,10,10197716070
11394,79790870,27252408,107043278,1,0,1,1536,10,4879352602
11395,79793690,27251534,107045224,9,0,1,3072,12,2114426789
11396,79798580,27247310,107045890,7,0,1,1024,10,1927001829
11397,79819410,27228106,107047516,7,0,1,2560,10,7429554302
11398,79821510,27230541,107052051,9,0,1,6656,12,9801608525
11399,79827271,23881857,103709128,7,0,0,512,10,3966265721
11400,79828909,23871440,103700349,1,0,0,512,10,2190628916
11401,79847211,23928972,103776183,7,0,0,1536,10,757746936
11402,79851569,23894656,103746225,1,0,0,1536,10,6517954021
11403,79852080,27205068,107057148,7,0,1,1536,10,670297053
11404,79872089,23830734,103702823,1,0,0,1536,10,6935413442
11405,79897620,27168518,107066138,9,0,1,11776,12,3137067089
11406,79903430,27234419,107137849,9,0,1,7680,12,8574553106
11407,79907979,23838581,103746560,1,0,0,1024,10,1343756188
11408,79916740,27221132,107137872,9,0,1,2048,12,129486959
11409,79952480,27185594,107138074,7,0,1,6656,10,4356941434
11410,79955180,27182917,107138097,7,0,1,4096,10,3811359886
11411,79966030,27172090,107138120,9,0,1,4608,12,466936464
11412,79976649,23770338,103746987,1,0,0,1024,10,3295815992
11413,79985940,27160314,107146254,2,0,1,4096,3,1645757651
11414,79988671,23763370,103752041,7,0,0,512,10,1881532318
11415,79993090,27191971,107185061,9,0,1,1536,12,9533188171
11416,80013770,27171957,107185727,9,0,1,1024,12,3287684119
11417,80018640,27169993,107188633,7,0,1,4608,10,5484613761
11418,80031900,27158999,107190899,7,0,1,3584,10,10195690671
11419,80032240,27169670,107201910,7,0,1,3584,10,7357694589
11420,80036709,23866725,103903434,1,0,0,512,10,9404976152
11421,80061080,27146504,107207584,7,0,1,1024,10,2646083202
11422,80062329,23727659,103789988,1,0,0,512,10,101087622
11423,80113551,23711665,103825216,7,0,0,512,10,7784562513
11424,80130620,27076987,107207607,8,0,1,2048,8,5157780924
11425,80130900,27076730,107207630,8,0,1,512,8,1302792582
11426,80142170,27066694,107208864,7,0,1,4096,10,411618292
11427,80142390,27070660,107213050,9,0,1,6656,12,2307019989
11428,80155721,27057995,107213716,5,0,1,1024,10,2999659314
11429,80168460,27049148,107217608,8,0,1,6144,8,9781147386
11430,80170541,23682727,103853268,7,0,0,1536,10,7705891243
11431,80192059,23699444,103891503,1,0,0,512,10,2571927856
11432,80202970,27026363,107229333,9,0,1,2048,12,2641336247
11433,80205871,23803864,104009735,7,0,0,4096,10,5960010168
11434,80222150,27012009,107234159,7,0,1,7680,10,10284690924
11435,80235610,27005626,107241236,7,0,1,6144,10,3543895380
11436,80241490,27000092,107241582,7,0,1,512,10,271835140
11437,80246739,27006883,107253622,4,0,1,6656,15,7301569620
11438,80255771,23729554,103985325,7,0,0,512,10,277497793
11439,80258419,26996189,107254608,4,0,1,1536,15,9226059917
11440,80261100,26995774,107256874,7,0,1,3584,10,1615903856
11441,80271179,26988601,107259780,4,0,1,4608,15,605253237
11442,80276749,26983377,107260126,4,0,1,512,15,1748359349
11443,80278760,26982672,107261432,8,0,1,2048,8,6661349689
11444,80299021,23637733,103936754,7,0,0,2048,10,5128387779
11445,80314520,26972729,107287249,8,0,1,1536,8,3796887667
11446,80317731,23576579,103894310,7,0,0,512,10,7201022325
11447,80329470,26957810,107287280,7,0,1,6144,10,10384729018
11448,80340259,23533870,103874129,1,0,0,512,10,10561203105
11449,80340380,26946923,107287303,8,0,1,3072,8,3847256646
11450,80349299,23542025,103891324,1,0,0,2048,10,4234661142
11451,80361341,23563939,103925280,7,0,0,512,10,5476226565
11452,80379001,26924650,107303651,5,0,1,3072,10,10619038659
11453,80391140,26920138,107311278,9,0,1,15360,12,4082516438
11454,80394090,26983741,107377831,6,0,1,14848,7,673942653
11455,80398190,26983470,107381660,7,0,1,512,10,4745189352
11456,80412560,26972381,107384941,9,0,1,7680,12,2410591210
11457,80427469,23593148,104020617,1,0,0,512,10,8975584197
11458,80428201,23573623,104001824,7,0,0,512,10,1532160718
11459,80428690,26963000,107391690,8,0,1,512,8,46667149
11460,80430090,26962061,107392151,8,0,1,10240,8,9205363171
11461,80430880,26992633,107423513,9,0,1,1024,12,3434631541
11462,80433970,26995854,107429824,8,0,1,6656,8,9881533073
11463,80443111,23621114,104064225,7,0,0,2048,10,430050222
11464,80465600,26964890,107430490,9,0,1,1024,12,10044816735
11465,80468960,26965396,107434356,9,0,1,6144,12,7954338594
11466,80469700,26975301,107445001,8,0,1,3584,8,5560049163
11467,80469859,23630092,104099951,1,0,0,1024,10,8681079633
11468,80473101,26982257,107455358,5,0,1,24576,10,2629932082
11469,80480169,26978761,107458930,4,0,1,5632,15,613277111
11470,80492439,23543173,104035612,1,0,0,1536,10,9368157502
11471,80504951,23624838,104129789,7,0,0,2048,10,794769231
11472,80512319,23475777,103988096,1,0,0,1536,10,6076471560
11473,80525029,23628352,104153381,1,0,0,512,10,6393363056
11474,80532381,26943736,107476117,5,0,1,3584,10,4454163678
11475,80542810,26933330,107476140,8,0,1,4608,8,3308435104
11476,80555410,26920753,107476163,9,0,1,3072,12,8804600616
11477,80561080,26915114,107476194,8,0,1,5632,8,4647945888
11478,80563931,23483452,104047383,7,0,0,1536,10,2505617614
11479,80586540,26889677,107476217,8,0,1,6144,8,2426089069
11480,80601959,23506272,104108231,1,0,0,1536,10,3043315454
11481,80615820,26860420,107476240,8,0,1,1536,8,7289036866
11482,80615979,23572725,104188704,1,0,0,1536,10,7493455429
11483,80627240,26851392,107478632,9,0,1,6656,12,7918988974
11484,80659601,26827403,107487004,5,0,1,13312,10,8054262797
11485,80663370,26872661,107536031,9,0,1,14336,12,8320446567
11486,80665410,26870967,107536377,8,0,1,512,8,2440715512
11487,80673960,26863083,107537043,8,0,1,1024,8,7531111593
11488,80683031,23327148,104010179,7,0,0,512,10,3864495533
11489,80689690,26856045,107545735,9,0,1,13824,12,2568547892
11490,80695711,23479969,104175680,7,0,0,2048,10,8522965678
11491,80696090,26891049,107587139,9,0,1,5120,12,1733943736
11492,80702830,26888828,107591658,8,0,1,18432,8,3132103988
11493,80711710,26907428,107619138,9,0,1,5120,12,10432877283
11494,80722701,23405648,104128349,7,0,0,512,10,1203873237
11495,80732600,26894657,107627257,9,0,1,5632,12,7259596306
11496,80762890,26910391,107673281,9,0,1,8192,12,9202282963
11497,80768291,26905029,107673320,5,0,1,6656,10,2660829296
11498,80776631,23382341,104158972,7,0,0,2560,10,9453060887
11499,80778751,23537786,104316537,7,0,0,1536,10,2349940482
11500,80781220,26892123,107673343,9,0,1,4608,12,6101212402
11501,80788779,23391075,104179854,1,0,0,512,10,5341772386
11502,80802530,26871015,107673545,9,0,1,2560,12,3708363724
11503,80806810,26867936,107674746,2,0,1,3584,3,8224645862
11504,80808981,23377412,104186393,7,0,0,1024,10,4682528806
11505,80810839,23403476,104214315,1,0,0,512,10,2477567157
11506,80823130,23399789,104222919,4,0,0,1536,15,6118740091
11507,80831371,26843721,107675092,5,0,1,512,10,3261913378
11508,80838801,26836637,107675438,5,0,1,512,10,2425983737
11509,80840090,26836654,107676744,7,0,1,2048,10,4467792075
11510,80853209,23343849,104197058,1,0,0,512,10,1908056752
11511,80854690,26825280,107679970,7,0,1,5120,10,3079334033
11512,80873470,26811326,107684796,9,0,1,7680,12,6979902946
11513,80874149,23402728,104276877,1,0,0,512,10,964077616
11514,80875210,26831377,107706587,7,0,1,5632,10,9015334392
11515,80894170,26815643,107709813,9,0,1,5120,12,563749741
11516,80917800,26793959,107711759,7,0,1,3072,10,2561053076
11517,80918960,26806740,107725700,7,0,1,12800,10,9287835115
11518,80937911,26789516,107727427,5,0,1,2560,10,8869861861
11519,80942540,26785132,107727672,9,0,1,512,12,968129199
11520,80944720,26784898,107729618,7,0,1,3072,10,3906438136
11521,80947591,26812920,107760511,5,0,1,14848,10,5848026947
11522,80949021,26816720,107765741,5,0,1,6144,10,9039032921
11523,80970370,26796037,107766407,7,0,1,1024,10,9997333337
11524,80971391,26796962,107768353,5,0,1,3072,10,5578257288
11525,80983579,23297370,104280949,1,0,0,1024,10,2986503543
11526,80984231,26787028,107771259,5,0,1,4608,10,5495586931
11527,80997589,23377603,104375192,1,0,0,2560,10,8965955157
11528,80999030,26773855,107772885,7,0,1,2560,10,549857406
11529,81007970,26767501,107775471,7,0,1,4096,10,1085341394
11530,81034100,26742037,107776137,7,0,1,11264,10,10516217690
11531,81034890,26742598,107777488,9,0,1,1024,12,10707037200
11532,81039651,23257519,104297170,7,0,0,1536,10,10226903797
11533,81062661,23237598,104300259,7,0,0,512,10,5318294067
11534,81066281,23275985,104342266,7,0,0,512,10,3556414612
11535,81084351,23278052,104362403,7,0,0,512,10,1541495797
11536,81102379,23372014,104474393,1,0,0,1024,10,3575445803
11537,81105290,26689458,107794748,7,0,1,9216,10,1839870541
11538,81110781,23229949,104340730,7,0,0,512,10,3789871504
11539,81115340,26683594,107798934,3,0,1,6656,17,5954301667
11540,81119510,26688087,107807597,9,0,1,8192,12,8307213456
11541,81145250,26676261,107821511,9,0,1,1024,12,4420861345
11542,81147370,26678216,107825586,9,0,1,5120,12,8876247313
11543,81151160,26677332,107828492,7,0,1,4608,10,1113682535
11544,81151840,26677830,107829670,3,0,1,13824,17,10083953054
11545,81153401,23277026,104430427,7,0,0,3072,10,2312124867
11546,81155030,26684351,107839381,3,0,1,3584,17,6828758689
11547,81171109,23226252,104397361,1,0,0,512,10,2922180628
11548,81190099,23201676,104391775,1,0,0,2048,10,10423921163
11549,81208670,26631377,107840047,3,0,1,1024,17,8931704663
11550,81229090,26629565,107858655,3,0,1,2048,17,6315803278
11551,81256210,26602468,107858678,9,0,1,1024,12,4274600773
11552,81283780,26574921,107858701,7,0,1,6144,10,1202752229
11553,81286341,23198550,104484891,7,0,0,3584,10,5694587769
11554,81312101,23223301,104535402,7,0,0,512,10,5726226967
11555,81317819,23083359,104401178,1,0,0,1024,10,5811688520
11556,81319900,26538824,107858724,9,0,1,6144,12,5037274271
11557,81332720,26526780,107859500,3,0,1,2560,17,5167906180
11558,81334399,23061632,104396031,1,0,0,512,10,7898865707
11559,81337160,26527166,107864326,7,0,1,7680,10,1081011215
11560,81344590,26519992,107864582,7,0,1,9216,10,5893506698
11561,81351820,26527543,107879363,3,0,1,5120,17,498580954
11562,81370790,26530752,107901542,9,0,1,8192,12,9876227023
11563,81376070,26535218,107911288,9,0,1,10240,12,2560358577
11564,81379850,26535624,107915474,9,0,1,6656,12,9507592972
11565,81379991,23117784,104497775,7,0,0,1024,10,669310009
11566,81396989,26536167,107933156,4,0,1,12800,15,5997005006
11567,81407339,26527763,107935102,4,0,1,3072,15,1679661665
11568,81407380,26528388,107935768,9,0,1,1024,12,5306113132
11569,81420740,26516014,107936754,3,0,1,1536,17,8743275249
11570,81433010,26505690,107938700,9,0,1,3072,12,4116807397
11571,81433679,26507287,107940966,4,0,1,3584,15,7783656630
11572,81461240,26486953,107948193,3,0,1,7680,17,8652190514
11573,81463289,26500450,107963739,4,0,1,5120,15,10382978007
11574,81466470,26527994,107994464,3,0,1,6656,17,10420490015
11575,81478011,23014471,104492482,7,0,0,512,10,8250439833
11576,81479940,26516470,107996410,9,0,1,3072,12,25170116
11577,81491540,26505216,107996756,9,0,1,512,12,8053851655
11578,81502800,26494942,107997742,3,0,1,1536,17,6564576626
11579,81506729,22937960,104444689,1,0,0,2048,10,9059977628
11580,81513240,26484848,107998088,3,0,1,512,17,7287615959
11581,81520481,23012101,104532582,7,0,0,1024,10,9667452993
11582,81532379,26470215,108002594,4,0,1,7168,15,7710852352
11583,81536681,23057007,104593688,7,0,0,1024,10,4480863588
11584,81539110,26463830,108002940,9,0,1,512,12,9545026794
11585,81581270,26424576,108005846,3,0,1,4608,17,6824720578
11586,81590269,22888372,104478641,1,0,0,1024,10,8450448875
11587,81591940,26415852,108007792,3,0,1,3072,17,9720495766
11588,81605290,26405408,108010698,9,0,1,4608,12,10673570481
11589,81610509,26403095,108013604,4,0,1,4608,15,5577744900
11590,81622231,22883570,104505801,7,0,0,512,10,5601411965
11591,81623609,26414472,108038081,4,0,1,12800,15,6677903147
11592,81636759,22942744,104579503,1,0,0,1024,10,1437135482
11593,81643231,22893118,104536349,7,0,0,1024,10,8756357530
11594,81652181,22937780,104589961,7,0,0,1536,10,7128069680
11595,81653871,22945258,104599129,7,0,0,2560,10,5465865439
11596,81665120,26395386,108060506,9,0,1,24064,12,3474094427
11597,81672200,26408564,108080764,3,0,1,5632,17,677649846
11598,81685141,22968268,104653409,7,0,0,1536,10,6999072059
11599,81703789,26398000,108101789,4,0,1,15872,15,1964144293
11600,81717539,26384404,108101943,4,0,1,8704,15,7450715998
11601,81717759,22910092,104627851,1,0,0,512,10,6714598587
11602,81720590,26399223,108119813,3,0,1,5632,17,8981507810
11603,81730289,26392750,108123039,4,0,1,5120,15,200797783
11604,81734250,26392975,108127225,3,0,1,6656,17,306960124
11605,81760331,22994617,104754948,7,0,0,1536,10,38625234
11606,81784900,26342991,108127891,3,0,1,1024,17,6226847467
11607,81804149,22903860,104708009,1,0,0,1024,10,4686000837
11608,81822810,26337186,108159996,9,0,1,22528,12,5331508129
11609,81825179,26348224,108173403,4,0,1,15360,15,3738595631
11610,81827829,22812852,104640681,1,0,0,512,10,9994646841
11611,81828499,22786879,104615378,1,0,0,512,10,1433919343
11612,81831929,22711624,104543553,1,0,0,512,10,4625826216
11613,81836400,26537880,108374280,9,0,1,19968,12,10566172382
11614,81844660,26529643,108374303,3,0,1,4608,17,2986048145
11615,81853820,26593711,108447531,9,0,1,5120,12,6716910746
11616,81861160,26586394,108447554,9,0,1,3584,12,486904796
11617,81871440,26576145,108447585,9,0,1,17408,12,3047253371
11618,81881800,26593832,108475632,9,0,1,1536,12,5141505986
11619,81889180,26589358,108478538,7,0,1,4608,10,4706860889
11620,81892710,26595221,108487931,9,0,1,512,12,9031980565
11621,81904439,22760395,104664834,1,0,0,512,10,2597392003
11622,81920240,26568037,108488277,3,0,1,512,17,5310511464
11623,81924979,22834306,104759285,1,0,0,2048,10,4117295879
11624,81927439,26561824,108489263,4,0,1,1536,15,525659854
11625,81934621,22758445,104693066,7,0,0,512,10,1811333818
11626,81942701,22918051,104860752,7,0,0,512,10,10479166591
11627,81946990,26555898,108502888,3,0,1,3584,17,521658599
11628,81952641,22853334,104805975,7,0,0,1536,10,164312500
11629,81953810,26549424,108503234,6,0,1,512,7,4939552656
11630,81961309,22812281,104773590,1,0,0,1536,10,4429372408
11631,81964911,22836981,104801892,7,0,0,2560,10,548035044
11632,81977231,22804171,104781402,7,0,0,1536,10,3332565209
11633,81979849,22815295,104795144,1,0,0,512,10,5005469242
11634,81997571,22807306,104804877,7,0,0,1024,10,4130566945
11635,81999580,26507840,108507420,9,0,1,6656,12,6428690283
11636,82000030,26510492,108510522,1,0,1,4608,10,3856043542
11637,82000520,26510348,108510868,9,0,1,512,12,9975430083
11638,82020810,26491044,108511854,9,0,1,1536,12,9419900630
11639,82082150,26430690,108512840,1,0,1,1536,10,7542950166
11640,82092300,26422486,108514786,9,0,1,3072,12,7598353220
11641,82096820,26425071,108521891,3,0,1,2560,17,8757019513
11642,82097561,22721306,104818867,7,0,0,512,10,5987600390
11643,82112890,26411587,108524477,9,0,1,4096,12,6486583024
11644,82115340,26422977,108538317,3,0,1,6656,17,8466658482
11645,82130420,26414692,108545112,3,0,1,1536,17,3667659022
11646,82155910,26411599,108567509,3,0,1,8704,17,10545095788
11647,82157760,26413295,108571055,3,0,1,5632,17,10194835327
11648,82171260,26404621,108575881,1,0,1,7680,10,7427558890
11649,82194119,22656859,104850978,1,0,0,512,10,3923031609
11650,82195209,22646246,104841455,1,0,0,1536,10,7136460693
11651,82200250,26440283,108640533,0,0,1,1536,3,9262464602
11652,82210940,26429616,108640556,0,0,1,1024,3,8182723575
11653,82217730,26441280,108659010,3,0,1,1024,17,8796212623
11654,82218000,26441033,108659033,1,0,1,3072,10,6752078601
11655,82237070,26422321,108659391,0,0,1,20992,3,3627298193
11656,82243770,26418475,108662245,3,0,1,4096,17,5837205045
11657,82252679,22582194,104834873,1,0,0,1024,10,5720118353
11658,82261929,22597911,104859840,1,0,0,2560,10,9301721485
11659,82262860,26399408,108662268,3,0,1,11776,17,6715831945
11660,82264230,26398061,108662291,1,0,1,2048,10,5537538103
11661,82271170,26391144,108662314,9,0,1,3072,12,5167054895
11662,82288810,26387432,108676242,9,0,1,512,12,15727186
11663,82292810,26387644,108680454,9,0,1,6656,12,7133059896
11664,82301870,26489401,108791271,0,0,1,16384,3,6273718494
11665,82323300,26513038,108836338,9,0,1,14848,12,6941851987
11666,82325209,22500749,104825958,1,0,0,1024,10,8412474770
11667,82325740,26510800,108836540,9,0,1,3584,12,8388429614
11668,82328020,26510594,108838614,0,0,1,1024,3,4062424128
11669,82336730,26501907,108838637,0,0,1,1024,3,5229548673
11670,82358931,22615024,104973955,7,0,0,2560,10,1026909217
11671,82359250,26479410,108838660,3,0,1,2560,17,7256580360
11672,82360070,26478613,108838683,9,0,1,4096,12,2513800193
11673,82362910,26475804,108838714,6,0,1,1024,7,1136560372
11674,82366290,26472471,108838761,0,0,1,1536,3,10019371293
11675,82388000,26520142,108908142,0,0,1,5632,3,8581812531
11676,82395280,26512885,108908165,9,0,1,3072,12,1132828191
11677,82403130,26505058,108908188,3,0,1,11776,17,8161992346
11678,82412870,26495341,108908211,0,0,1,1536,3,9874144571
11679,82414801,22575557,104990358,7,0,0,1536,10,767558560
11680,82415280,26492954,108908234,9,0,1,4608,12,6207945949
11681,82423680,26485172,108908852,0,0,1,12800,3,410177055
11682,82460601,22513533,104974134,7,0,0,512,10,8537414805
11683,82474661,22605452,105080113,7,0,0,512,10,9935738824
11684,82476350,26511418,108987768,9,0,1,2048,12,5891955946
11685,82490690,26497437,108988127,0,0,1,9728,3,7879069020
11686,82491950,26538490,109030440,9,0,1,14336,12,4632629111
11687,82492839,22461679,104954518,1,0,0,2048,10,7422188849
11688,82520990,26510588,109031578,9,0,1,3072,12,8668464361
11689,82546751,22474693,105021444,7,0,0,1024,10,5044260338
11690,82553569,22437147,104990716,1,0,0,512,10,2559009109
11691,82558180,26486005,109044185,9,0,1,10240,12,3964690541
11692,82569131,22366110,104935241,7,0,0,512,10,10140153758
11693,82594131,22440735,105034866,7,0,0,512,10,2795971286
11694,82614051,22480325,105094376,7,0,0,1024,10,544838935
11695,82618670,26429716,109048386,0,0,1,9728,3,5167198086
11696,82650039,22388380,105038419,1,0,0,512,10,2015842340
11697,82654291,26414350,109068641,5,0,1,3584,10,4681896246
11698,82667640,26443913,109111553,0,0,1,5120,3,7125131933
11699,82671520,26440187,109111707,3,0,1,8704,17,5305983335
11700,82684859,22514797,105199656,1,0,0,512,10,7884420942
11701,82695689,22404432,105100121,1,0,0,1024,10,696242504
11702,82715760,26468002,109183762,0,0,1,10240,3,10030156958
11703,82727021,22296751,105023772,7,0,0,512,10,4727127765
11704,82732659,22416640,105149299,1,0,0,512,10,6725154028
11705,82733499,22315236,105048735,1,0,0,512,10,1753803669
11706,82739161,22384186,105123347,7,0,0,512,10,306074965
11707,82753840,26444031,109197871,9,0,1,5632,12,9108390615
11708,82782210,26415684,109197894,0,0,1,2048,3,10325280372
11709,82793080,26404845,109197925,9,0,1,7168,12,36697970
11710,82799610,26435621,109235231,9,0,1,2560,12,6732403299
11711,82803880,26431382,109235262,0,0,1,5120,3,9218425764
11712,82817701,22327727,105145428,7,0,0,1536,10,5108441751
11713,82829810,26405475,109235285,0,0,1,2048,3,6225126503
11714,82838909,22362279,105201188,1,0,0,1024,10,3611140083
11715,82855350,26379958,109235308,1,0,1,9216,10,6353750306
11716,82864780,26375750,109240530,0,0,1,10240,3,2023805841
11717,82878199,22240463,105118662,1,0,0,512,10,3076919194
11718,82890290,26352506,109242796,0,0,1,3584,3,1954126832
11719,82926079,22221429,105147508,1,0,0,512,10,7088093952
11720,82926201,22255467,105181668,7,0,0,512,10,7150607805
11721,82946300,26299722,109246022,0,0,1,5120,3,9562611314
11722,82974180,26272508,109246688,8,0,1,1024,8,3761763091
11723,82997689,22068046,105065735,1,0,0,512,10,5256982398
11724,83003740,26291997,109295737,7,0,1,19968,10,7875882703
11725,83051750,26271790,109323540,1,0,1,1024,10,1631549990
11726,83053990,26274703,109328693,7,0,1,512,10,420626130
11727,83061179,22109011,105170190,1,0,0,1024,10,3061450136
11728,83078230,26251129,109329359,0,0,1,1024,3,9300138081
11729,83081430,26249555,109330985,0,0,1,2560,3,9014966448
11730,83096250,26235299,109331549,0,0,1,10752,3,10435046837
11731,83125409,22023300,105148709,1,0,0,2560,10,434372959
11732,83125410,26237458,109362868,0,0,1,5632,3,9182763001
11733,83130260,26232631,109362891,7,0,1,2560,10,7179539415
11734,83135680,22004828,105140508,4,0,0,512,15,3362629521
11735,83154850,26228078,109382928,7,0,1,16384,10,6642206493
11736,83157710,26242783,109400493,7,0,1,2560,10,2726969176
11737,83159220,26241296,109400516,7,0,1,2560,10,703790502
11738,83175580,26226423,109402003,0,0,1,2560,3,7821531952
11739,83185600,26218186,109403786,1,0,1,512,10,10490676992
11740,83193500,26211592,109405092,8,0,1,2048,8,9471847808
11741,83204320,26207262,109411582,8,0,1,10240,8,1743711155
11742,83207780,26214437,109422217,3,0,1,5632,17,10147828273
11743,83216100,26206140,109422240,8,0,1,1024,8,8247411912
11744,83230821,21888474,105119295,7,0,0,512,10,3145047660
11745,83238610,26187963,109426573,7,0,1,10240,10,6873932630
11746,83241520,26200454,109441974,0,0,1,1024,3,2053282608
11747,83241960,26219450,109461410,1,0,1,3584,10,3283497944
11748,83266479,22018283,105284762,1,0,0,1536,10,7662008273
11749,83269241,22034077,105303318,7,0,0,1024,10,2023374119
11750,83272420,26189029,109461449,6,0,1,15872,7,9542381806
11751,83275579,22041309,105316888,1,0,0,1024,10,4141882863
11752,83277860,26183612,109461472,1,0,1,3584,10,1322079834
11753,83283110,26189185,109472295,8,0,1,8192,8,7410848496
11754,83284430,26201171,109485601,0,0,1,5632,3,8995436657
11755,83287250,26203916,109491166,7,0,1,1536,10,10305677651
11756,83292070,26199442,109491512,0,0,1,512,3,1811072075
11757,83315670,26176201,109491871,8,0,1,9728,8,2549122175
11758,83325790,26236344,109562134,0,0,1,1536,3,1994998378
11759,83340600,26232727,109573327,7,0,1,4608,10,6229448532
11760,83341850,26231500,109573350,0,0,1,1024,3,943433013
11761,83346031,21994800,105340831,7,0,0,512,10,605042308
11762,83363420,26210444,109573864,8,0,1,1536,8,3796278876
11763,83378061,22073471,105451532,7,0,0,3584,10,3422028575
11764,83382390,26191497,109573887,1,0,1,10240,10,6182933734
11765,83382919,21936863,105319782,1,0,0,2048,10,1402041444
11766,83384310,26189600,109573910,7,0,1,1024,10,2021120355
11767,83390760,26183173,109573933,1,0,1,10240,10,6969190919
11768,83392770,26217266,109610036,8,0,1,20480,8,2562985763
11769,83401020,26265704,109666724,1,0,1,19968,10,2949003788
11770,83404899,21930060,105334959,1,0,0,1536,10,8683111636
11771,83409080,26302935,109712015,7,0,1,1024,10,9247777645
11772,83410480,26301558,109712038,1,0,1,9216,10,3336241716
11773,83414780,26320985,109735765,8,0,1,11264,8,2006070244
11774,83415769,21924501,105340270,1,0,0,1024,10,6465779438
11775,83428540,26350132,109778672,7,0,1,1536,10,2233848468
11776,83437159,22009779,105446938,1,0,0,1536,10,2016320446
11777,83438949,21877500,105316449,1,0,0,1536,10,2252044562
11778,83446160,26353670,109799830,7,0,1,7168,10,2704149931
11779,83461330,26390531,109851861,1,0,1,7680,10,1821822514
11780,83472590,26455164,109927754,7,0,1,4096,10,10257452285
11781,83489751,21902714,105392465,7,0,0,512,10,7445245203
11782,83497720,26440611,109938331,1,0,1,18432,10,2159842375
11783,83512740,26512219,110024959,8,0,1,512,8,1914396923
11784,83535021,21871681,105406702,7,0,0,2048,10,7759771190
11785,83540651,21852771,105393422,7,0,0,1024,10,551337662
11786,83556280,26468702,110024982,7,0,1,1536,10,2834364615
11787,83576290,26449073,110025363,7,0,1,14848,10,6487856847
11788,83595559,21957952,105553511,1,0,0,3072,10,3195937348
11789,83598950,26426436,110025386,8,0,1,10240,8,647005652
11790,83600501,21959989,105560490,7,0,0,512,10,9839771012
11791,83606730,26440440,110047170,8,0,1,3584,8,8419942270
11792,83610200,26495326,110105526,1,0,1,16896,10,3791288711
11793,83613721,21885711,105499432,7,0,0,1024,10,996628941
11794,83617320,26513227,110130547,7,0,1,1536,10,3571414561
11795,83619980,26513153,110133133,1,0,1,4096,10,10195732862
11796,83639590,26506565,110146155,7,0,1,11264,10,6135036718
11797,83644581,21834932,105479513,7,0,0,512,10,1152689750
11798,83645649,22042868,105688517,3,0,0,135168,17,2452631773
11799,83655850,26546264,110202114,7,0,1,22016,10,10595320630
11800,83678880,26525180,110204060,7,0,1,3072,10,1682575025
11801,83691260,26514106,110205366,7,0,1,2048,10,975504525
11802,83698821,21886587,105585408,7,0,0,512,10,8659589784
11803,83768850,26437592,110206442,7,0,1,13312,10,588550591
11804,83773030,26565129,110338159,7,0,1,4096,10,579956664
11805,83783981,21756081,105540062,7,0,0,512,10,2893036051
11806,83810951,21878617,105689568,7,0,0,3072,10,5441340523
11807,83811439,21687658,105499097,1,0,0,2048,10,6698999468
11808,83909229,21654304,105563533,1,0,0,1024,10,1654370606
11809,83920030,26420078,110340108,8,0,1,6144,8,8660655309
11810,83960850,26379281,110340131,8,0,1,1536,8,961062332
11811,83967099,21504757,105471856,1,0,0,1536,10,6273993152
11812,83979609,21604263,105583872,1,0,0,512,10,2923618960
11813,83990580,26417940,110408520,7,0,1,11776,10,10320646958
11814,84016069,21771719,105787788,1,0,0,512,10,1617406791
11815,84022260,26396066,110418326,6,0,1,6656,7,3113962162
11816,84033359,21709505,105742864,1,0,0,512,10,5526025138
11817,84057770,26362502,110420272,6,0,1,3072,7,2331941172
11818,84058300,26407720,110466020,6,0,1,5120,7,5868421756
11819,84061210,26460451,110521661,6,0,1,15360,7,10184593974
11820,84077970,26596043,110674013,9,0,1,3072,12,2114909482
11821,84083450,26591549,110674999,9,0,1,1536,12,2773275210
11822,84090581,21500776,105591357,7,0,0,2560,10,4089397007
11823,84097530,26577815,110675345,7,0,1,512,10,1710652781
11824,84108680,26568611,110677291,7,0,1,3072,10,5206048254
11825,84118041,21612040,105730081,7,0,0,1024,10,2743080869
11826,84118640,26728687,110847327,8,0,1,8704,8,7748574651
11827,84136690,26718080,110854770,7,0,1,3072,10,6178813603
11828,84137750,26720566,110858316,6,0,1,5632,7,1987640774
11829,84148130,26716913,110865043,9,0,1,1536,12,1292123628
11830,84149610,26766125,110915735,6,0,1,2048,7,1573514742
11831,84153821,21536174,105689995,7,0,0,1024,10,7422538987
11832,84163130,26752628,110915758,6,0,1,4096,7,1678950225
11833,84165200,26806903,110972103,8,0,1,5632,8,4271225853
11834,84167640,27033275,111200915,9,0,1,3072,12,1933177492
11835,84177139,21651642,105828781,1,0,0,1024,10,9408867118
11836,84194699,21410113,105604812,1,0,0,512,10,9955125459
11837,84195840,27005098,111200938,6,0,1,512,7,10633393844
11838,84205010,26995951,111200961,2,0,1,4096,3,5667932201
11839,84211250,26989734,111200984,8,0,1,14848,8,4541772668
11840,84223791,21641612,105865403,7,0,0,114688,10,6867935116
11841,84229490,27195057,111424547,8,0,1,12800,8,3652224169
11842,84245770,27178800,111424570,6,0,1,12288,7,7675187904
11843,84261610,27162983,111424593,8,0,1,2048,8,10343192561
11844,84293250,27132177,111425427,9,0,1,7168,12,10249904643
11845,84361760,27094234,111455994,6,0,1,2560,7,6473330782
11846,84363771,21542709,105906480,7,0,0,4096,10,3120531925
11847,84372669,21428671,105801340,1,0,0,2048,10,1973992084
11848,84373520,27102527,111476047,6,0,1,1024,7,3882720363
11849,84374089,21342839,105716928,1,0,0,1024,10,3695308012
11850,84384491,21396907,105781398,7,0,0,4096,10,6588910871
11851,84387780,27106354,111494134,8,0,1,12800,8,5361354349
11852,84388130,27108453,111496583,9,0,1,2048,12,4878656791
11853,84398869,21291617,105690486,1,0,0,1536,10,4104964545
11854,84418320,27128723,111547043,6,0,1,8192,7,7640717246
11855,84427550,27119516,111547066,6,0,1,2048,7,10611080278
11856,84441859,21363526,105805385,1,0,0,512,10,6539250546
11857,84470080,27092236,111562316,3,0,1,10752,17,3562178444
11858,84490661,21377261,105867922,7,0,0,8192,10,3904413353
11859,84493360,27201477,111694837,9,0,1,8192,12,2298097743
11860,84495070,27297065,111792135,3,0,1,4608,17,3027307884
11861,84509760,27282398,111792158,7,0,1,1024,10,786001233
11862,84514209,21566560,106080769,1,0,0,512,10,9592543308
11863,84518570,27360047,111878617,7,0,1,1536,10,9420713162
11864,84535050,27345833,111880883,7,0,1,3584,10,3082716179
11865,84535809,21347690,105883499,1,0,0,1024,10,852815805
11866,84545071,21670779,106215850,7,0,0,24576,10,207496253
11867,84548120,27333634,111881754,6,0,1,12288,7,158611554
11868,84548490,27431793,111980283,7,0,1,5120,10,916850014
11869,84574380,27437228,112011608,7,0,1,512,10,7039765860
11870,84580060,27431571,112011631,9,0,1,11264,12,547964354
11871,84586891,21385727,105972618,7,0,0,38912,10,8715541214
11872,84592950,27588875,112181825,9,0,1,7168,12,2166312117
11873,84593260,21723436,106316696,4,0,0,1024,15,1583236189
11874,84595310,27586874,112182184,6,0,1,9728,7,4299457753
11875,84597890,27682985,112280875,9,0,1,1536,12,6271224706
11876,84601690,27697639,112299329,6,0,1,1024,7,113381690
11877,84603730,27698921,112302651,3,0,1,9728,17,294010826
11878,84604781,21322614,105927395,7,0,0,14848,10,9823155342
11879,84621540,27681134,112302674,6,0,1,4096,7,9553669909
11880,84624410,27678287,112302697,7,0,1,3072,10,2348771906
11881,84627460,27757404,112384864,9,0,1,2048,12,9073380276
11882,84627579,21403672,106031251,1,0,0,1024,10,828722909
11883,84642720,27745050,112387770,6,0,1,4608,7,4356813580
11884,84664801,21415781,106080582,7,0,0,37888,10,7483936234
11885,84666840,27858231,112525071,9,0,1,11776,12,1337190457
11886,84691630,27834427,112526057,9,0,1,1536,12,10670302626
11887,84694480,27833203,112527683,7,0,1,2560,10,9247933111
11888,84697000,27831669,112528669,3,0,1,1536,17,464820073
11889,84697060,27861234,112558294,7,0,1,3072,10,3331135494
11890,84705850,28031596,112737446,9,0,1,10240,12,2199099612
11891,84709929,21328935,106038864,1,0,0,1024,10,4561989844
11892,84710620,28026849,112737469,3,0,1,1536,17,3731729446
11893,84712070,28239300,112951370,3,0,1,5632,17,5704819350
11894,84724091,21306825,106030916,7,0,0,64000,10,8679151923
11895,84726140,28227816,112953956,0,0,1,4096,3,8322652883
11896,84730571,21327496,106058067,7,0,0,4608,10,3216908937
11897,84733360,28313052,113046412,9,0,1,8704,12,1815083357
11898,84759101,21309914,106069015,7,0,0,9728,10,4896504165
11899,84773390,28420881,113194271,7,0,1,5632,10,3289560215
11900,84787840,28406454,113194294,3,0,1,2560,17,9350520240
11901,84793580,28421219,113214799,9,0,1,1536,12,8262966973
11902,84798650,21404939,106203589,4,0,0,1024,15,7505849224
11903,84804020,28413098,113217118,6,0,1,1536,7,5030137605
11904,84819190,28428842,113248032,7,0,1,3072,10,2759751451
11905,84826250,28424368,113250618,7,0,1,4096,10,5044896798
11906,84831320,28421884,113253204,3,0,1,4096,17,9490733071
11907,84851600,28451637,113303237,7,0,1,11776,10,2789651162
11908,84856909,21380143,106237052,1,0,0,1024,10,7220127595
11909,84857520,28550405,113407925,6,0,1,6656,7,7201962225
11910,84859980,28547968,113407948,7,0,1,3584,10,4620952234
11911,84866110,28541861,113407971,6,0,1,1536,7,1196275677
11912,84866940,28541054,113407994,6,0,1,2560,7,3629423066
11913,84873441,21331823,106205264,7,0,0,4608,10,7881361109
11914,84888240,28519777,113408017,7,0,1,9216,10,3893729983
11915,84906910,28582642,113489552,7,0,1,6144,10,9323413214
11916,84909940,28588737,113498677,7,0,1,2560,10,4057384392
11917,84913540,28585176,113498716,3,0,1,1536,17,7450786410
11918,84916740,28581999,113498739,7,0,1,3072,10,8567670152
11919,84941061,21262193,106203254,7,0,0,72192,10,9205146152
11920,84943030,28571886,113514916,3,0,1,5120,17,7437187174
11921,84945030,28653426,113598456,7,0,1,3584,10,4815215041
11922,84952380,28646099,113598479,6,0,1,4608,7,93532317
11923,84962170,28636332,113598502,7,0,1,512,10,8045820479
11924,84993600,28604925,113598525,3,0,1,2048,17,7287565041
11925,84994580,28636300,113630880,3,0,1,7680,17,2137809933
11926,84994680,28726490,113721170,3,0,1,3584,17,10647713826
11927,84999940,28739262,113739202,3,0,1,15872,17,8970521335
11928,85007720,28773846,113781566,3,0,1,7168,17,2962950963
11929,85040790,28741899,113782689,7,0,1,512,10,3140215967
11930,85049630,28737570,113787200,3,0,1,3584,17,4519093761
11931,85052439,21208698,106261137,1,0,0,512,10,2759333000
11932,85068279,21178222,106246501,1,0,0,2048,10,2540550744
11933,85069530,28719474,113789004,7,0,1,7680,10,7352233255
11934,85071729,21132062,106203791,1,0,0,512,10,2200717927
11935,85077070,28736608,113813678,6,0,1,6144,7,4462443649
11936,85078610,28752917,113831527,3,0,1,9216,17,5664871513
11937,85079880,28859667,113939547,6,0,1,8192,7,4593651856
11938,85091050,28848520,113939570,3,0,1,3072,17,6756285276
11939,85099200,28840393,113939593,3,0,1,20480,17,9424995243
11940,85117840,28877680,113995520,3,0,1,4608,17,1552762085
11941,85122169,21052964,106175133,1,0,0,1024,10,872972980
11942,85129970,28912434,114042404,1,0,1,3584,10,3832085639
11943,85132370,28958322,114090692,1,0,1,2048,10,6574344217
11944,85136150,28956753,114092903,7,0,1,4608,10,1605167325
11945,85140119,21234013,106374132,1,0,0,1536,10,177120229
11946,85153480,28940409,114093889,6,0,1,1536,7,10401754733
11947,85172920,28922045,114094965,1,0,1,13312,10,2407412965
11948,85174020,29002622,114176642,1,0,1,512,10,10502493349
11949,85179020,28997645,114176665,6,0,1,3584,7,1829125379
11950,85180051,21237954,106418005,7,0,0,49664,10,7400602050
11951,85210530,28966158,114176688,0,0,1,11264,3,5865877378
11952,85225861,21159491,106385352,7,0,0,3072,10,7164091623
11953,85226020,29000837,114226857,1,0,1,4096,10,3106736441
11954,85232600,28994280,114226880,7,0,1,512,10,10179354312
11955,85253950,28972953,114226903,6,0,1,2560,7,8221467804
11956,85268520,28958406,114226926,0,0,1,1024,3,6005219330
11957,85273050,28953899,114226949,2,0,1,3072,3,2313969748
11958,85295550,28949432,114244982,3,0,1,6656,17,7668942563
11959,85295970,28949035,114245005,2,0,1,7168,3,9334279428
11960,85298420,29001065,114299485,2,0,1,2048,3,8390113396
11961,85299120,29002631,114301751,2,0,1,3584,3,5524427311
11962,85300030,29005234,114305264,0,0,1,1024,3,1773171430
11963,85300200,29145137,114445337,6,0,1,13824,7,6657846339
11964,85306420,29138940,114445360,0,0,1,2048,3,2676305167
11965,85318380,29127003,114445383,2,0,1,1024,3,2511528199
11966,85335349,29110057,114445406,4,0,1,512,15,1751922753
11967,85339149,29106280,114445429,4,0,1,3072,15,6226861527
11968,85342040,29103412,114445452,6,0,1,6144,7,4599777131
11969,85345200,29136483,114481683,2,0,1,12800,3,595683905
11970,85350820,29190330,114541150,0,0,1,2560,3,3399956412
11971,85357209,21190243,106547452,1,0,0,512,10,8943955062
11972,85358369,29183767,114542136,4,0,1,1536,15,3229530483
11973,85359990,29311123,114671113,6,0,1,8704,7,1910378582
11974,85364469,21018331,106382800,1,0,0,1024,10,6498367569
11975,85365169,21064470,106429639,1,0,0,1024,10,1617182471
11976,85369260,29301876,114671136,6,0,1,512,7,6595453529
11977,85374710,29413825,114788535,2,0,1,4608,3,10695054583
11978,85384430,29506272,114890702,2,0,1,512,3,7618760089
11979,85393629,29497419,114891048,4,0,1,512,15,3986983378
11980,85402730,29489304,114892034,9,0,1,1536,12,6569069798
11981,85404130,29493342,114897472,9,0,1,1536,12,7903128526
11982,85408840,29506737,114915577,0,0,1,22528,3,9150718089
11983,85411210,29617731,115028941,3,0,1,18432,17,5659047939
11984,85432850,29609884,115042734,7,0,1,1024,10,9830317670
11985,85441201,21294903,106736104,7,0,0,86528,10,2439518617
11986,85446240,29618544,115064784,6,0,1,2560,7,3694752484
11987,85446710,29679222,115125932,7,0,1,28160,10,3332589996
11988,85450760,29676318,115127078,9,0,1,7168,12,6426180343
11989,85455220,29755415,115210635,0,0,1,12288,3,8425694165
11990,85456069,29761343,115217412,4,0,1,4608,15,5175748494
11991,85457590,29759845,115217435,9,0,1,2048,12,2198617045
11992,85480070,29737388,115217458,7,0,1,3584,10,2780478029
11993,85483479,29734010,115217489,4,0,1,2560,15,3463766211
11994,85486649,29730871,115217520,4,0,1,3584,15,8361869580
11995,85493800,29723743,115217543,7,0,1,2560,10,9462246465
11996,85502030,29715536,115217566,7,0,1,9216,10,763932935
11997,85503090,29746497,115249587,7,0,1,1536,10,6816568016
11998,85503660,29756737,115260397,0,0,1,7168,3,1312392226
11999,85512690,29747730,115260420,7,0,1,4608,10,9678235356
12000,85515820,29748546,115264366,7,0,1,7168,10,4569179947
12001,85523100,29741289,115264389,7,0,1,1536,10,6895110428
12002,85524380,29740048,115264428,7,0,1,4096,10,806458033
12003,85528600,29735859,115264459,0,0,1,3072,3,1692902219
12004,85537661,21284634,106822295,7,0,0,6144,10,9082852919
12005,85544350,29781331,115325681,9,0,1,20480,12,10143469737
12006,85555469,29798379,115353848,4,0,1,1024,15,10394104845
12007,85562589,29804653,115367242,4,0,1,6656,15,9243438391
12008,85563750,29808507,115372257,0,0,1,11776,3,8891985437
12009,85565449,21171302,106736751,1,0,0,2048,10,1353075696
12010,85586370,29915328,115501698,7,0,1,4096,10,6640004247
12011,85586970,30088545,115675515,9,0,1,6144,12,4982885654
12012,85587079,30088459,115675538,4,0,1,5632,15,4695407141
12013,85596500,30079240,115675740,7,0,1,2048,10,6226096923
12014,85599670,30076093,115675763,6,0,1,5120,7,534282832
12015,85614020,30072085,115686105,9,0,1,2560,12,1648775709
12016,85617519,21040274,106657793,1,0,0,4096,10,669767013
12017,85619129,30088605,115707734,4,0,1,6656,15,5405871326
12018,85630740,30107574,115738314,7,0,1,6144,10,8550260623
12019,85638570,30119354,115757924,7,0,1,2048,10,633682175
12020,85663771,21240064,106903835,7,0,0,51712,10,1347690582
12021,85664090,30093857,115757947,9,0,1,2048,12,2838509125
12022,85671711,21216345,106888056,7,0,0,8704,10,10637396921
12023,85672540,30085430,115757970,7,0,1,512,10,3283108823
12024,85678140,30079853,115757993,0,0,1,512,3,8051078079
12025,85683610,30074406,115758016,9,0,1,15872,12,3271951290
12026,85686510,30192778,115879288,0,0,1,2048,3,1813854555
12027,85697299,30182012,115879311,4,0,1,1024,15,7249119431
12028,85701031,21184235,106885266,7,0,0,84992,10,6978050139
12029,85702210,30180965,115883175,7,0,1,6656,10,9876035506
12030,85704810,30179351,115884161,7,0,1,1536,10,2873285039
12031,85711680,30202372,115914052,9,0,1,1536,12,1375561392
12032,85714669,21110457,106825126,1,0,0,512,10,4632174652
12033,85738990,30175732,115914722,7,0,1,7168,10,7942326279
12034,85766230,30175515,115941745,7,0,1,13312,10,9409904629
12035,85767710,30263953,116031663,9,0,1,6144,12,9038654615
12036,85771739,30389586,116161325,4,0,1,12288,15,4246842415
12037,85777060,30464657,116241717,9,0,1,8192,12,4220371921
12038,85780150,30463513,116243663,6,0,1,3072,7,9668214501
12039,85788200,30457409,116245609,0,0,1,3072,3,4224142644
12040,85791729,21346097,107137826,3,0,0,170496,17,3106306447
12041,85807440,30438835,116246275,6,0,1,1024,7,2159374259
12042,85807530,30447288,116254818,0,0,1,5120,3,9797679416
12043,85816860,30437981,116254841,0,0,1,4608,3,5493256731
12044,85825850,30434346,116260196,0,0,1,5120,3,1386644100
12045,85837760,30512819,116350579,1,0,1,4608,10,7462443896
12046,85855870,30494732,116350602,0,0,1,3584,3,3049511444
12047,85856250,30598589,116454839,9,0,1,2560,12,7156411129
12048,85862530,30592332,116454862,7,0,1,2560,10,7885453872
12049,85889449,21088668,106978117,3,0,0,9728,17,5903169484
12050,85895030,30559863,116454893,1,0,1,1536,10,7497132700
12051,85896670,30558246,116454916,7,0,1,3072,10,3379574355
12052,85902151,30552788,116454939,5,0,1,6144,10,3606202064
12053,85911450,30583838,116495288,1,0,1,512,10,936121806
12054,85915521,30579790,116495311,5,0,1,512,10,8761474312
12055,85923100,30586001,116509101,2,0,1,4096,3,8867308982
12056,85924439,30610308,116534747,4,0,1,5632,15,8964603896
12057,85926150,30608620,116534770,7,0,1,3072,10,1474106824
12058,85928660,30606133,116534793,9,0,1,7680,12,166954753
12059,85936661,30598155,116534816,5,0,1,1536,10,4255452239
12060,85937559,21062922,107000481,1,0,0,1024,10,9588135706
12061,85939671,30718977,116658648,5,0,1,3584,10,6609362808
12062,85946689,20996370,106943059,1,0,0,512,10,2223992950
12063,85950470,30764862,116715332,7,0,1,20992,10,5232351483
12064,85965459,21120396,107085855,3,0,0,53248,17,7003010550
12065,85977739,30737616,116715355,4,0,1,512,15,2722697638
12066,85982420,30732958,116715378,1,0,1,12288,10,9797537342
12067,85988340,30761754,116750094,0,0,1,1024,3,2323063524
12068,85989059,30765541,116754600,4,0,1,7168,15,7386236514
12069,85995950,30841256,116837206,3,0,1,1536,17,4401294897
12070,85996119,30844253,116840372,4,0,1,2048,15,6280909910
12071,85997219,21140832,107138051,1,0,0,512,10,276944648
12072,86001540,30838855,116840395,1,0,1,1024,10,3380249500
12073,86003960,30908501,116912461,0,0,1,16384,3,12000619
12074,86008671,21369137,107377808,7,0,0,135680,10,8502776280
12075,86011771,21195790,107207561,7,0,0,16896,10,1445826679
12076,86014600,30909348,116923948,1,0,1,2560,10,840243998
12077,86023830,30902384,116926214,7,0,1,3584,10,1813710405
12078,86027750,30899450,116927200,0,0,1,1536,3,9414761467
12079,86028760,30899311,116928071,9,0,1,12288,12,1116934971
12080,86035800,30919635,116955435,9,0,1,5120,12,1755397169
12081,86040680,30998268,117038948,9,0,1,17920,12,7018086060
12082,86048180,31010323,117058503,3,0,1,4608,17,9528742217
12083,86058120,31011656,117069776,9,0,1,12288,12,5559776306
12084,86070399,31014961,117085360,4,0,1,7680,15,6721766392
12085,86080739,21109358,107190097,1,0,0,512,10,303853580
12086,86086859,30999474,117086333,4,0,1,12800,15,4653680382
12087,86094450,31120733,117215183,3,0,1,2560,17,2741645760
12088,86095529,31119677,117215206,4,0,1,1536,15,8925368929
12089,86108059,20898563,107006622,1,0,0,2048,10,859318830
12090,86112080,31103640,117215720,7,0,1,3072,10,6752897374
12091,86113249,21173977,107287226,3,0,0,83968,17,1282647856
12092,86129070,31086673,117215743,9,0,1,9216,12,4678396606
12093,86138331,31172268,117310599,5,0,1,3072,10,7483771769
12094,86142310,31169915,117312225,0,0,1,2560,3,1441379482
12095,86143760,31269618,117413378,9,0,1,9216,12,7292218416
12096,86148259,31265142,117413401,4,0,1,4608,15,3196400445
12097,86153590,31267376,117420966,9,0,1,5120,12,9325039857
12098,86160379,21143706,107304085,1,0,0,1024,10,6492153489
12099,86164459,21220459,107384918,3,0,0,6656,17,9497930217
12100,86166731,21126952,107293683,7,0,0,6656,10,7134776122
12101,86166740,31257959,117424699,3,0,1,4096,17,227364709
12102,86177869,21046590,107224459,1,0,0,512,10,5715749946
12103,86189211,31237114,117426325,5,0,1,2560,10,4742920251
12104,86197190,31233961,117431151,7,0,1,7680,10,7323461690
12105,86198620,31272473,117471093,9,0,1,9728,12,6832357635
12106,86201431,21274663,107476094,7,0,0,32768,10,4598294508
12107,86220849,31341822,117562671,4,0,1,6656,15,4576134453
12108,86231579,21150042,107381621,3,0,0,11776,17,4967298299
12109,86237271,21180293,107417564,7,0,0,73728,10,7670275690
12110,86240310,31322384,117562694,7,0,1,7168,10,2694076452
12111,86245171,31344642,117589813,5,0,1,8192,10,4382547062
12112,86251251,21172223,107423474,7,0,0,14336,10,7611641509
12113,86257610,31340221,117597831,9,0,1,10240,12,4407725460
12114,86259080,31359270,117618350,7,0,1,7680,10,1091543800
12115,86263410,31379118,117642528,9,0,1,7680,12,2260192923
12116,86285799,21032311,107318110,3,0,0,1024,17,6538493493
12117,86288469,21089541,107378010,1,0,0,512,10,898031050
12118,86309180,31335294,117644474,9,0,1,3072,12,6690622560
12119,86312589,21105824,107418413,1,0,0,512,10,790290649
12120,86348019,21070215,107418234,1,0,0,1536,10,10177628551
12121,86351400,31319664,117671064,3,0,1,1536,17,437529348
12122,86364580,31352761,117717341,9,0,1,512,12,8288880302
12123,86367720,31364512,117732232,3,0,1,8192,17,177412370
12124,86370349,21061481,107431830,1,0,0,512,10,1826450486
12125,86370571,31363287,117733858,5,0,1,2560,10,3967629123
12126,86370610,31365514,117736124,9,0,1,3584,12,8608254819
12127,86376329,21042754,107419083,1,0,0,1536,10,4029706730
12128,86383631,31354119,117737750,5,0,1,2560,10,7138447135
12129,86386491,21226338,107612829,7,0,0,64512,10,5513623500
12130,86389731,31360559,117750290,5,0,1,2560,10,8403304341
12131,86393791,31384863,117778654,5,0,1,4608,10,6078143783
12132,86396150,31382527,117778677,9,0,1,5120,12,8876498179
12133,86400531,21065556,107466087,7,0,0,18944,10,3724829807
12134,86401520,31399355,117800875,7,0,1,3584,10,7538342060
12135,86406920,31399945,117806865,9,0,1,512,12,6422401488
12136,86423130,31383758,117806888,3,0,1,1024,17,3549133322
12137,86431700,31375211,117806911,9,0,1,512,12,2914080389
12138,86482960,31323974,117806934,7,0,1,3072,10,1301448511
12139,86492870,31314087,117806957,7,0,1,2560,10,1406106383
12140,86493349,20925243,107418592,1,0,0,512,10,6587526258
12141,86496930,31323640,117820570,3,0,1,8704,17,3512686713
12142,86498341,31323535,117821876,5,0,1,2048,10,4371751353
12143,86499300,31334364,117833664,7,0,1,1024,10,9026377221
12144,86505729,20912014,107417743,1,0,0,512,10,3636811280
12145,86515180,31322990,117838170,9,0,1,7168,12,7299554867
12146,86515240,31323276,117838516,9,0,1,512,12,6196703145
12147,86525600,31316001,117841601,3,0,1,512,17,1454042163
12148,86530401,21328231,107858632,7,0,0,32768,10,6883276669
12149,86530500,31312407,117842907,7,0,1,2048,10,2776404073
12150,86531550,31314263,117845813,7,0,1,4608,10,1947508624
12151,86536431,21127733,107664164,7,0,0,108544,10,7853747838
12152,86565531,31370638,117936169,5,0,1,512,10,3494752176
12153,86569011,31367181,117936192,5,0,1,10240,10,1479088414
12154,86569899,21103623,107673522,1,0,0,512,10,5954640607
12155,86571631,21101627,107673258,7,0,0,29184,10,2700635783
12156,86572480,31364382,117936862,3,0,1,5120,17,3560281318
12157,86586660,31350225,117936885,3,0,1,12288,17,4823432731
12158,86590651,21028285,107618936,7,0,0,19968,10,3042583692
12159,86591300,31345608,117936908,3,0,1,1024,17,2756985462
12160,86604331,31334027,117938358,5,0,1,512,10,915204912
12161,86605959,21121445,107727404,1,0,0,512,10,6609740811
12162,86614540,31323841,117938381,3,0,1,10752,17,232260456
12163,86619290,31407300,118026590,3,0,1,1024,17,8284493110
12164,86621329,20944715,107566044,3,0,0,2048,17,1489251030
12165,86623209,20952153,107575362,3,0,0,512,17,967244852
12166,86623881,21058932,107682813,7,0,0,3584,10,9272060874
12167,86639199,21025144,107664343,3,0,0,512,17,9686571477
12168,86639380,31391076,118030456,0,0,1,6144,3,1349346920
12169,86646680,31388282,118034962,3,0,1,7168,17,869329802
12170,86646939,20921633,107568572,1,0,0,1024,10,8826734188
12171,86652070,31435028,118087098,9,0,1,1024,12,5497074352
12172,86654780,31501730,118156510,9,0,1,7680,12,382193153
12173,86661160,31572079,118233239,3,0,1,9216,17,6175349989
12174,86670009,20949106,107619115,3,0,0,512,17,10371697731
12175,86673110,31625331,118298441,9,0,1,1536,12,1251476891
12176,86678360,31644151,118322511,0,0,1,4096,3,2541034736
12177,86687640,31634894,118322534,7,0,1,10240,10,4500879490
12178,86688730,31657070,118345800,9,0,1,1536,12,706012365
12179,86689310,31656513,118345823,3,0,1,1024,17,7673399090
12180,86689510,31663379,118352889,3,0,1,6144,17,7289837162
12181,86691879,21091922,107783801,1,0,0,1024,10,1939490893
12182,86695179,21007778,107702957,3,0,0,3072,17,8771238660
12183,86702630,31679055,118381685,3,0,1,1024,17,3182133338
12184,86703799,21165026,107868825,1,0,0,1024,10,6641900189
12185,86705410,31676298,118381708,0,0,1,1024,3,9411543818
12186,86722740,31710179,118432919,0,0,1,17920,3,8709487519
12187,86729981,21061968,107791949,7,0,0,2560,10,3264947790
12188,86730890,31771506,118502396,3,0,1,20480,17,5858018401
12189,86733480,31874907,118608387,0,0,1,16384,3,7419359955
12190,86734431,21026057,107760488,7,0,0,35840,10,3375707707
12191,86748210,31864307,118612517,9,0,1,1024,12,10001758905
12192,86757941,21133066,107891007,7,0,0,11264,10,2047703241
12193,86759720,31855713,118615433,3,0,1,5120,17,10509311021
12194,86762920,31860980,118623900,7,0,1,2560,10,3882922652
12195,86763640,31863486,118627126,7,0,1,5120,10,2128668466
12196,86795910,31831562,118627472,9,0,1,512,12,3308960170
12197,86802780,31846818,118649598,0,0,1,16384,3,3530857996
12198,86814470,31837074,118651544,7,0,1,3072,10,345756058
12199,86817420,31846255,118663675,3,0,1,512,17,10527008660
12200,86829170,31835491,118664661,9,0,1,1536,12,2054464883
12201,86839600,31827327,118666927,8,0,1,3584,8,9161057259
12202,86841809,21042821,107884630,1,0,0,1024,10,8615105524
12203,86850829,20989397,107840226,3,0,0,512,17,4856442933
12204,86851300,31918062,118769362,3,0,1,512,17,4865039885
12205,86861170,31908215,118769385,9,0,1,4608,12,8875394995
12206,86865200,31908708,118773908,8,0,1,4096,8,4924091328
12207,86872390,31901979,118774369,3,0,1,10240,17,9116204562
12208,86887240,31963269,118850509,0,0,1,7680,3,10382473107
12209,86906949,20916432,107823381,3,0,0,512,17,2494498284
12210,86914170,31941703,118855873,8,0,1,1024,8,10232170009
12211,86928230,31929909,118858139,7,0,1,3584,10,2720318435
12212,86935021,31927845,118862866,5,0,1,5632,10,3299018984
12213,86938140,31974281,118912421,9,0,1,11776,12,9363469581
12214,86938259,20952927,107891186,1,0,0,512,10,1260806068
12215,86941309,21034548,107975857,1,0,0,512,10,7209470550
12216,86958860,31953584,118912444,9,0,1,3072,12,3798304381
12217,86959310,31953157,118912467,8,0,1,10240,8,6922571588
12218,86960659,20911138,107871797,1,0,0,1024,10,1295370300
12219,86961121,20861816,107822937,7,0,0,4096,10,1029972725
12220,86968171,21270255,108238426,7,0,0,68096,10,5886471064
12221,86975750,31965002,118940752,3,0,1,2560,17,9662214485
12222,86994559,21124446,108119005,1,0,0,2048,10,2728782171
12223,86996959,20996764,107993723,1,0,0,512,10,6684807574
12224,87000390,31953680,118954070,8,0,1,512,8,1722327508
12225,87003950,31952706,118956656,0,0,1,4096,3,4815743431
12226,87004040,31957438,118961478,3,0,1,13312,17,3964577304
12227,87007269,21231694,108238963,3,0,0,512,17,2186461748
12228,87015880,31995080,119010960,8,0,1,512,8,5850253113
12229,87029590,31981393,119010983,3,0,1,1536,17,1558490730
12230,87037990,32011415,119049405,3,0,1,2560,17,2024706051
12231,87047230,32002198,119049428,9,0,1,1536,12,6800889451
12232,87068169,20981320,108049489,3,0,0,2048,17,10253161011
12233,87069990,31979461,119049451,3,0,1,3072,17,6234847919
12234,87071819,20943815,108015634,1,0,0,512,10,7519953328
12235,87088360,31971909,119060269,0,0,1,4608,3,4151784087
12236,87093050,31967242,119060292,8,0,1,2560,8,577765854
12237,87101299,21237902,108339201,3,0,0,2048,17,4168317811
12238,87108960,31960450,119069410,8,0,1,21504,8,1403313190
12239,87127380,31950344,119077724,9,0,1,13312,12,829969662
12240,87128721,21069564,108198285,7,0,0,35840,10,4261060678
12241,87148661,21187358,108336019,7,0,0,26624,10,6002100970
12242,87151791,21222287,108374078,7,0,0,48640,10,3430730506
12243,87154471,21250888,108405359,7,0,0,68096,10,1797545716
12244,87161891,20998082,108159973,7,0,0,25600,10,1200361764
12245,87165960,32055943,119221903,9,0,1,11776,12,5111233535
12246,87176759,20770200,107946959,3,0,0,512,17,1468486545
12247,87181320,32247230,119428550,0,0,1,11776,3,3236490360
12248,87184839,21053945,108238784,1,0,0,512,10,10444441493
12249,87190900,32333545,119524445,9,0,1,27136,12,3081583606
12250,87195650,32343212,119538862,3,0,1,8704,17,3970057433
12251,87204980,32495980,119700960,0,0,1,31232,3,756979511
12252,87215551,32485432,119700983,5,0,1,3072,10,2622891787
12253,87231390,32484583,119715973,3,0,1,5120,17,7846462681
12254,87239721,21069042,108308763,7,0,0,1024,10,10470673882
12255,87248119,20788107,108036226,1,0,0,512,10,9240408810
12256,87279509,20804447,108083956,1,0,0,512,10,8742252755
12257,87288640,21158868,108447508,2,0,0,8704,3,414217716
12258,87289400,21069835,108359235,2,0,0,62464,3,6476673860
12259,87295899,21016597,108312496,3,0,0,2560,17,10112751124
12260,87306989,20705729,108012718,1,0,0,1024,10,8326291619
12261,87310921,32405718,119716639,5,0,1,1024,10,6907260037
12262,87323960,32395905,119719865,1,0,1,5120,10,9438714223
12263,87325090,32438912,119764002,2,0,1,11776,3,4690696025
12264,87326129,20724502,108050631,3,0,0,1024,17,2822522223
12265,87332539,32452224,119784763,4,0,1,1536,15,7595078466
12266,87334970,32461399,119796369,3,0,1,18432,17,2655837830
12267,87338650,32457742,119796392,0,0,1,1536,3,1317693972
12268,87343759,20798915,108142674,1,0,0,512,10,9008032125
12269,87346231,32466743,119812974,5,0,1,1536,10,7698666433
12270,87348859,32464146,119813005,4,0,1,3072,15,109812724
12271,87355440,21306782,108662222,2,0,0,9216,3,2153398127
12272,87355509,32457519,119813028,4,0,1,9216,15,5953130591
12273,87364280,21079079,108443359,2,0,0,91136,3,1689973853
12274,87375420,20933008,108308428,2,0,0,19456,3,7990395872
12275,87386969,20987981,108374950,3,0,0,2048,17,7388305035
12276,87387029,32430592,119817621,4,0,1,2560,15,1784510307
12277,87393650,21229030,108622680,2,0,0,39936,3,2449753143
12278,87402811,32414833,119817644,5,0,1,2560,10,5776699163
12279,87407641,32410026,119817667,5,0,1,1536,10,10200647145
12280,87419280,21611137,109030417,2,0,0,99840,3,3495271273
12281,87439899,32396344,119836243,4,0,1,23040,15,805098456
12282,87441580,32402126,119843706,1,0,1,9216,10,4040063666
12283,87444240,32403268,119847508,1,0,1,5120,10,4850096390
12284,87451719,20991999,108443718,3,0,0,1024,17,5148560016
12285,87454541,21381283,108835824,7,0,0,130048,10,1842909779
12286,87459250,32506032,119965282,0,0,1,25600,3,309652801
12287,87461069,20777536,108238605,3,0,0,512,17,1176312514
12288,87481299,20933778,108415077,3,0,0,1536,17,5013705451
12289,87488010,20926576,108414586,2,0,0,30208,3,9112091602
12290,87488061,21152114,108640175,7,0,0,57344,10,3741500124
12291,87492959,32472346,119965305,4,0,1,512,15,7327098859
12292,87500329,21419405,108919734,3,0,0,1024,17,8480457440
12293,87506680,20831858,108338538,2,0,0,8192,3,2991114979
12294,87510191,32455137,119965328,5,0,1,3072,10,2313280663
12295,87520341,32445010,119965351,5,0,1,512,10,3070148119
12296,87526369,20847888,108374257,1,0,0,512,10,4188985818
12297,87532559,32432815,119965374,4,0,1,4096,15,6180226659
12298,87546099,32419298,119965397,4,0,1,8704,15,1055962537
12299,87553539,20913024,108466563,1,0,0,512,10,5082925944
12300,87556170,32409429,119965599,1,0,1,16896,10,5222254643
12301,87568509,32397113,119965622,4,0,1,1024,15,721159593
12302,87588901,32376744,119965645,5,0,1,2048,10,7125993944
12303,87591419,20942360,108533779,1,0,0,1024,10,1226297462
12304,87607591,32358077,119965668,5,0,1,1536,10,7832815573
12305,87671521,20938968,108610489,7,0,0,78848,10,4470116961
12306,87678720,20980267,108658987,2,0,0,60416,3,2262250697
12307,87684259,21031556,108715815,3,0,0,2560,17,123993935
12308,87704060,32261631,119965691,6,0,1,1024,7,4485683762
12309,87705201,21338062,109043263,7,0,0,14848,10,9291684553
12310,87716609,20698959,108415568,1,0,0,1536,10,7536097522
12311,87735829,20904681,108640510,1,0,0,1024,10,5155675786
12312,87738859,20705974,108444833,1,0,0,3584,10,7703089780
12313,87740709,21361095,109101804,3,0,0,512,17,10053247988
12314,87758649,20983291,108741940,1,0,0,1024,10,3002397462
12315,87759751,21148360,108908111,7,0,0,62464,10,3807936040
12316,87792879,20866489,108659368,1,0,0,1024,10,3335414158
12317,87792930,20677944,108470874,2,0,0,1024,3,3126717368
12318,87798421,32201300,119999721,5,0,1,20480,10,9551842152
12319,87808869,20954761,108763630,3,0,0,512,17,7286289177
12320,87821030,32179361,120000391,8,0,1,1024,8,7274079173
12321,87823151,32177263,120000414,5,0,1,2560,10,8555427734
12322,87827101,20887911,108715012,7,0,0,89088,10,5707348418
12323,87827440,21343796,109171236,2,0,0,135680,3,6831940549
12324,87828641,21009950,108838591,7,0,0,6656,10,3843230853
12325,87845730,32154707,120000437,8,0,1,9728,8,3515321771
12326,87850711,32174168,120024879,5,0,1,1024,10,8696306741
12327,87866531,32162854,120029385,5,0,1,7168,10,9792382187
12328,87869431,32164987,120034418,5,0,1,1536,10,3024865687
12329,87875989,20885311,108761300,1,0,0,1024,10,4483234939
12330,87884660,32150424,120035084,8,0,1,1024,8,7705775659
12331,87886120,21052930,108939050,2,0,0,33792,3,7487985996
12332,87917869,20918446,108836315,3,0,0,1536,17,2803086810
12333,87940850,32099060,120039910,8,0,1,7680,8,2747589376
12334,87951610,32149226,120100836,8,0,1,5120,8,2127993700
12335,87955700,32176520,120132220,0,0,1,25088,3,4066794625
12336,87957240,32207079,120164319,9,0,1,9216,12,10107144155
12337,87960060,21335654,109295714,2,0,0,32256,3,565534400
12338,87962269,20892327,108854596,3,0,0,512,17,4689824005
12339,87972430,32222190,120194620,6,0,1,2048,7,5214017094
12340,87973500,32230707,120204207,8,0,1,8192,8,6115984721
12341,87977170,32252277,120229447,3,0,1,3584,17,10497296691
12342,87979059,20804446,108783505,3,0,0,57344,17,6590813070
12343,87979331,32262605,120241936,5,0,1,3072,10,2098767866
12344,87996950,20756254,108753204,2,0,0,3584,3,906039600
12345,88001280,32260514,120261794,8,0,1,2560,8,6345014268
12346,88012251,32256568,120268819,5,0,1,7168,10,5625527360
12347,88012809,20823708,108836517,1,0,0,512,10,8170868145
12348,88013700,20860771,108874471,2,0,0,48128,3,1313523529
12349,88018569,20863280,108881849,3,0,0,22528,17,10544607133
12350,88025249,32245147,120270396,4,0,1,2560,15,6774492102
12351,88028050,32299374,120327424,0,0,1,7680,3,8870471874
12352,88041220,20884875,108926095,2,0,0,11264,3,7836256438
12353,88076360,32267641,120344001,8,0,1,8192,8,9114796341
12354,88089201,20870176,108959377,7,0,0,4608,10,7527376680
12355,88094650,32256649,120351299,6,0,1,10752,7,581220916
12356,88104451,32253094,120357545,5,0,1,5120,10,980797918
12357,88105451,32252117,120357568,5,0,1,9728,10,334197933
12358,88127181,20761867,108889048,7,0,0,23552,10,897873886
12359,88128339,20850665,108979004,3,0,0,39936,17,5407352128
12360,88145300,32238170,120383470,6,0,1,2560,7,8992741068
12361,88146669,32237262,120383931,4,0,1,10240,15,8786730302
12362,88152989,20878566,109031555,3,0,0,3584,17,10196502456
12363,88155249,32229028,120384277,4,0,1,512,15,4760946014
12364,88157309,20824683,108981992,1,0,0,2048,10,1687574531
12365,88164420,32223403,120387823,8,0,1,5632,8,1554341481
12366,88165460,32284882,120450342,0,0,1,22528,3,9338645536
12367,88170149,20931476,109101625,3,0,0,38912,17,2601058797
12368,88182101,21015100,109197201,7,0,0,44032,10,1367909529
12369,88193850,32263002,120456852,8,0,1,17920,8,8764406638
12370,88198251,20911376,109109627,7,0,0,25600,10,1415552801
12371,88200851,21023492,109224343,7,0,0,51712,10,7399790804
12372,88207939,32264533,120472472,4,0,1,512,15,1193192784
12373,88211770,32261048,120472818,2,0,1,512,3,9941771253
12374,88213771,21020611,109234382,7,0,0,32768,10,1564098927
12375,88217480,32316193,120533673,8,0,1,15872,8,152569491
12376,88224111,32341603,120565714,5,0,1,2048,10,10313922523
12377,88227140,32338597,120565737,2,0,1,3072,3,1069547803
12378,88231069,20643893,108874962,1,0,0,1536,10,816658508
12379,88244070,32321690,120565760,8,0,1,1024,8,4065881348
12380,88245370,32320413,120565783,0,0,1,16896,3,10407447596
12381,88251160,32365213,120616373,8,0,1,4096,8,2490345734
12382,88273290,32343122,120616412,6,0,1,2560,7,4074122457
12383,88279540,32336895,120616435,8,0,1,1024,8,4034527595
12384,88279590,32336868,120616458,2,0,1,1536,3,5002296915
12385,88281559,20916289,109197848,3,0,0,2048,17,5317986194
12386,88287720,32328761,120616481,2,0,1,3072,3,994167181
12387,88289050,32327454,120616504,6,0,1,6144,7,3631190534
12388,88289440,32340549,120629989,8,0,1,1024,8,9067893392
12389,88290481,32339531,120630012,5,0,1,7680,10,1524376015
12390,88293531,32336504,120630035,5,0,1,1536,10,3813601365
12391,88300231,32329827,120630058,5,0,1,6144,10,2342043947
12392,88330571,21069899,109400470,7,0,0,56320,10,8645495917
12393,88348480,32281601,120630081,9,0,1,4608,12,7560280894
12394,88352459,21010386,109362845,3,0,0,72192,17,5055092466
12395,88359019,20701722,109060741,1,0,0,512,10,6262728435
12396,88368049,20815690,109183739,3,0,0,40960,17,9320925275
12397,88384841,32245271,120630112,5,0,1,1536,10,1179798262
12398,88386451,20822105,109208556,7,0,0,34816,10,1672465945
12399,88392161,21161282,109553443,7,0,0,49152,10,3710432618
12400,88409930,32220213,120630143,8,0,1,1024,8,689066236
12401,88416700,32213482,120630182,2,0,1,7168,3,8450352996
12402,88419720,21032128,109451848,2,0,0,31744,3,558374025
12403,88421040,32217933,120638973,2,0,1,17920,3,10500143817
12404,88426730,32251111,120677841,8,0,1,1536,8,1666847726
12405,88445141,20937764,109382905,7,0,0,65024,10,8082638988
12406,88447971,32229893,120677864,5,0,1,512,10,1618366487
12407,88458820,32219067,120677887,8,0,1,4096,8,6643555035
12408,88459650,21025928,109485578,2,0,0,5632,3,3823104507
12409,88466991,32210919,120677910,5,0,1,1024,10,8604012698
12410,88500909,32177024,120677933,4,0,1,4096,15,9671273265
12411,88503570,20929592,109433162,2,0,0,12288,3,1719919349
12412,88505459,21056142,109561601,3,0,0,23552,17,4797333695
12413,88513301,20984901,109498202,7,0,0,11776,10,6625958349
12414,88517421,20725246,109242667,7,0,0,5120,10,3504858364
12415,88518670,32177249,120695919,2,0,1,7168,3,10081606529
12416,88522219,32173755,120695974,4,0,1,2048,15,7054645341
12417,88523741,32172256,120695997,5,0,1,3584,10,7715769213
12418,88535680,32160340,120696020,2,0,1,512,3,2112995650
12419,88542110,32155712,120697822,2,0,1,11776,3,97499386
12420,88551440,32196113,120747553,2,0,1,4096,3,5695802289
12421,88568259,20666770,109235029,1,0,0,2048,10,9987336880
12422,88572820,32176603,120749423,2,0,1,12800,3,6506290745
12423,88573959,20661249,109235208,1,0,0,512,10,1925854811
12424,88574809,32180124,120754933,4,0,1,3584,15,5667962998
12425,88581650,32262404,120844054,0,0,1,21504,3,4587936792
12426,88601890,20820304,109422194,2,0,0,31744,3,5025884137
12427,88602439,20839714,109442153,1,0,0,512,10,2644210117
12428,88610609,20640383,109250992,1,0,0,512,10,7367587357
12429,88611921,32236639,120848560,5,0,1,7168,10,1666754127
12430,88615171,32255062,120870233,5,0,1,7168,10,132541177
12431,88618330,32372474,120990804,1,0,1,24064,10,5295199378
12432,88632150,20829237,109461387,2,0,0,31232,3,9795037770
12433,88634870,32361119,120995989,6,0,1,16384,7,8456612758
12434,88643901,32390050,121033951,5,0,1,4608,10,501344059
12435,88652001,32396546,121048547,5,0,1,7680,10,9996910373
12436,88653310,20709760,109363070,2,0,0,512,3,3956261908
12437,88663690,32417622,121081312,1,0,1,2048,10,8868514621
12438,88666590,20775361,109441951,2,0,0,15360,3,3324315568
12439,88672419,32415664,121088083,4,0,1,512,15,9532583757
12440,88679731,32411258,121090989,5,0,1,4608,10,8582896485
12441,88684881,32407414,121092295,5,0,1,2048,10,1272311776
12442,88689050,32427577,121116627,1,0,1,512,10,1267339847
12443,88689661,20848783,109538444,7,0,0,36864,10,10458216691
12444,88692570,32425043,121117613,6,0,1,1536,7,2860040880
12445,88693169,20777506,109470675,1,0,0,1024,10,8291645588
12446,88711340,32407899,121119239,1,0,1,2560,10,3004819688
12447,88721020,32426562,121147582,1,0,1,16384,10,4682094358
12448,88748920,32408060,121156980,2,0,1,2560,3,4856655214
12449,88749731,32407272,121157003,5,0,1,1536,10,2294831993
12450,88752529,32404497,121157026,4,0,1,9216,15,2291644
12451,88754069,20629218,109383287,1,0,0,1024,10,9558641769
12452,88767910,20887224,109655134,2,0,0,8192,3,2916874305
12453,88770650,32424843,121195493,2,0,1,5120,3,7979237878
12454,88772369,20939623,109711992,1,0,0,1024,10,3142693895
12455,88779799,20794042,109573841,1,0,0,1536,10,9121912249
12456,88793670,20790164,109583834,2,0,0,13312,3,3614825722
12457,88800549,20987013,109787562,3,0,0,21504,17,5544696039
12458,88805721,32389795,121195516,5,0,1,512,10,8370122956
12459,88809391,32386148,121195539,5,0,1,9216,10,1963909385
12460,88810441,20743961,109554402,7,0,0,3072,10,4385873281
12461,88822631,32376721,121199352,5,0,1,7680,10,5848770605
12462,88822821,32377363,121200184,5,0,1,2560,10,6510209851
12463,88823440,32378370,121201810,1,0,1,2560,10,6188970017
12464,88841260,20922734,109763994,8,0,0,39936,8,9383072268
12465,88855459,32346697,121202156,4,0,1,512,15,1909924935
12466,88860479,20638214,109498693,1,0,0,1536,10,1750770796
12467,88860541,32343881,121204422,5,0,1,3584,10,7949150606
12468,88864570,32341478,121206048,1,0,1,2560,10,9429299470
12469,88865131,20708173,109573304,7,0,0,27648,10,344942888
12470,88871479,20977569,109849048,1,0,0,1024,10,198840400
12471,88879539,21144594,110024133,3,0,0,53760,17,7805491646
12472,88887440,20824217,109711657,2,0,0,2048,3,5759597574
12473,88890551,32369520,121260071,5,0,1,2560,10,208053789
12474,88901469,20877180,109778649,3,0,0,15360,17,9163406129
12475,88904020,32356074,121260094,2,0,1,5632,3,4057109071
12476,88910260,32349857,121260117,8,0,1,5120,8,5130378019
12477,88915080,32345060,121260140,2,0,1,2048,3,9511191388
12478,88915791,20795219,109711010,7,0,0,35840,10,5847867499
12479,88915889,32344274,121260163,4,0,1,5120,15,4998234242
12480,88938370,20755924,109694294,8,0,0,52224,8,7299226278
12481,88939650,32320536,121260186,2,0,1,512,3,1219654633
12482,88952449,21073116,110025565,3,0,0,512,17,8710874647
12483,88952860,32307349,121260209,1,0,1,2560,10,2687251922
12484,88959491,21303737,110263228,7,0,0,117760,10,8518729262
12485,88965070,20708374,109673444,2,0,0,11264,3,747533327
12486,89000939,20711278,109712217,1,0,0,512,10,8839669093
12487,89001850,32258382,121260232,2,0,1,512,3,6970703542
12488,89003971,21027709,110031680,7,0,0,19968,10,10577694744
12489,89014869,21182013,110196882,3,0,0,68096,17,9948211627
12490,89030021,32230234,121260255,5,0,1,9216,10,2893238623
12491,89030570,21074933,110105503,8,0,0,76288,8,6914889185
12492,89034369,21046310,110080679,3,0,0,48128,17,8163983415
12493,89061650,21268305,110329955,2,0,0,32256,3,8068771973
12494,89072321,21052775,110125096,7,0,0,8192,10,5902057692
12495,89090350,21201293,110291643,8,0,0,93184,8,9737831271
12496,89097429,21047173,110144602,1,0,0,512,10,653470458
12497,89107461,21228936,110336397,7,0,0,1024,10,6063164079
12498,89118340,20708783,109827123,8,0,0,23040,8,9803340934
12499,89133881,32137850,121271731,5,0,1,6144,10,9880393566
12500,89144651,20902496,110047147,7,0,0,50688,10,596830536
12501,89158480,21155985,110314465,8,0,0,1024,8,7103448360
12502,89181970,21221700,110403670,2,0,0,72192,3,6856719756
12503,89183850,20823701,110007551,2,0,0,121344,3,7782091651
12504,89184391,32092486,121276877,5,0,1,8192,10,8819160780
12505,89193121,32099079,121292200,5,0,1,512,10,2533721667
12506,89194190,20916505,110110695,2,0,0,13824,3,1342890912
12507,89198849,21115281,110314130,3,0,0,73728,17,6560857382
12508,89199159,20808571,110007730,1,0,0,512,10,5493916791
12509,89202370,20671724,109874094,2,0,0,20992,3,10524302545
12510,89213170,21288631,110501801,8,0,0,49152,8,7840313794
12511,89217120,32077666,121294786,2,0,1,4096,3,5083165531
12512,89223250,21004075,110227325,2,0,0,45056,3,7643059040
12513,89224881,32073025,121297906,5,0,1,2560,10,1942674363
12514,89239830,32060022,121299852,7,0,1,3072,10,4634452812
12515,89240711,21337509,110578220,7,0,0,20992,10,4916517556
12516,89273790,32026728,121300518,2,0,1,1024,3,1564698401
12517,89277260,21058802,110336062,8,0,0,19968,8,4457268122
12518,89285219,21120970,110406189,3,0,0,8192,17,663802664
12519,89289089,20735847,110024936,1,0,0,2560,10,3116850437
12520,89294409,21066706,110361115,1,0,0,2048,10,9810094607
12521,89297729,20727432,110025161,1,0,0,512,10,7623262302
12522,89304909,20720431,110025340,1,0,0,512,10,5801014366
12523,89309270,32044768,121354038,2,0,1,3072,3,5738361636
12524,89322390,32034874,121357264,2,0,1,5120,3,2176569956
12525,89335411,32030890,121366301,5,0,1,3584,10,8171687659
12526,89340171,20979933,110320104,7,0,0,18432,10,8688158518
12527,89416259,21167457,110583716,1,0,0,1536,10,5423986971
12528,89423270,21242817,110666087,8,0,0,93184,8,3209123671
12529,89437280,31938427,121375707,2,0,1,1536,3,2482923470
12530,89439990,31935740,121375730,2,0,1,3584,3,9796106047
12531,89443659,21090448,110534107,3,0,0,22016,17,2175558355
12532,89444049,20894087,110338136,3,0,0,5632,17,1390312919
12533,89452970,31978366,121431336,2,0,1,3584,3,9752327031
12534,89481689,21411746,110893435,3,0,0,47104,17,1605111961
12535,89481700,21109339,110591039,2,0,0,8192,3,7380387041
12536,89495020,31936339,121431359,2,0,1,3584,3,9457278254
12537,89504169,21232280,110736449,3,0,0,55808,17,3025403513
12538,89509769,21286627,110796396,3,0,0,8192,17,4998298778
12539,89513420,21287857,110801277,2,0,0,13312,3,3022169118
12540,89514999,21019599,110534598,1,0,0,1536,10,9524902607
12541,89518589,20819749,110338338,1,0,0,512,10,2337691490
12542,89532800,31898582,121431382,2,0,1,1024,3,2466924730
12543,89547921,21023880,110571801,7,0,0,28672,10,973318951
12544,89572861,21093405,110666266,7,0,0,512,10,7892111667
12545,89575270,31856135,121431405,2,0,1,3072,3,8771953054
12546,89575640,21189536,110765176,2,0,0,94208,3,3815679398
12547,89591529,21173826,110765355,1,0,0,512,10,1473864449
12548,89593419,21607473,111200892,3,0,0,147968,17,9695278251
12549,89593490,20889472,110482962,4,0,0,512,15,4418007109
12550,89603099,21212092,110815191,1,0,0,512,10,9714472715
12551,89608860,21546925,111155785,9,0,0,161280,12,1053626684
12552,89610849,20729228,110340077,3,0,0,5632,17,3890876628
12553,89617061,21408387,111025448,7,0,0,7680,10,9460121067
12554,89625250,21397835,111023085,8,0,0,33280,8,6491666921
12555,89629609,20914605,110544214,1,0,0,512,10,8422912612
12556,89631250,31800178,121431428,2,0,1,1024,3,4113585480
12557,89633450,20888188,110521638,8,0,0,26624,8,7087422025
12558,89634541,21281171,110915712,7,0,0,33280,10,10046949969
12559,89635930,21667176,111303106,8,0,0,53760,8,5311516536
12560,89640480,21630577,111271057,9,0,0,138752,12,6164925265
12561,89640591,21799835,111440426,7,0,0,49152,10,9643321509
12562,89646979,20775421,110422400,1,0,0,512,10,3555902776
12563,89647949,21728754,111376703,3,0,0,20480,17,10422267310
12564,89658150,21422190,111080340,8,0,0,34816,8,738494545
12565,89689580,21865309,111554889,2,0,0,25600,3,9546390661
12566,89699250,31732201,121431451,2,0,1,9216,3,4686328876
12567,89704869,21083985,110788854,3,0,0,11264,17,10371606861
12568,89710949,21162190,110873139,1,0,0,1024,10,3857078830
12569,89716049,21333262,111049311,3,0,0,25600,17,8404160782
12570,89717840,20997953,110715793,2,0,0,42496,3,6698762895
12571,89720159,21491768,111211927,3,0,0,35840,17,9120176158
12572,89730811,21692894,111423705,7,0,0,153600,10,5668892548
12573,89733249,21591976,111325225,1,0,0,512,10,5739786202
12574,89742391,21853917,111596308,7,0,0,47616,10,2481515490
12575,89765600,31692573,121458173,2,0,1,1536,3,1484028491
12576,89776970,21509733,111286703,2,0,0,50688,3,6622290407
12577,89787899,20878702,110666601,1,0,0,1024,10,654954312
12578,89828381,21496657,111325038,7,0,0,39936,10,5139584859
12579,89833390,31624806,121458196,7,0,1,12288,10,2030748176
12580,89842520,31617667,121460187,9,0,1,3584,12,7798222608
12581,89850570,21936683,111787253,8,0,0,28160,8,1650641279
12582,89855819,21415417,111271236,1,0,0,512,10,3813600577
12583,89864870,21610819,111475689,2,0,0,57344,3,1107048168
12584,89877791,21669229,111547020,7,0,0,160256,10,7184783370
12585,89888510,31573623,121462133,1,0,1,3072,10,7711674618
12586,89889551,21534973,111424524,7,0,0,2560,10,4791799389
12587,89892340,21834137,111726477,8,0,0,30208,8,5938532969
12588,89893210,21473721,111366931,8,0,0,119296,8,3840784514
12589,89913949,21027520,110941469,1,0,0,512,10,1428150246
12590,89929420,21763967,111693387,2,0,0,23552,3,3665868151
12591,89930640,22080945,112011585,2,0,0,86528,3,4020290321
12592,89937660,21374673,111312333,9,0,0,30208,12,4268068877
12593,89956290,22192162,112148452,9,0,0,129536,12,4922231583
12594,89980811,21025663,111006474,7,0,0,26112,10,8681803645
12595,89997250,22240188,112237438,9,0,0,138752,12,6347298754
12596,90012880,31565444,121578324,8,0,1,17408,8,6509497227
12597,90014169,21842941,111857110,3,0,0,10752,17,4223871940
12598,90024080,21804748,111828828,2,0,0,100864,3,10479377631
12599,90034580,31575584,121610164,8,0,1,2560,8,6216782444
12600,90042350,21811461,111853811,9,0,0,81920,12,1829873469
12601,90050100,21723980,111774080,9,0,0,156160,12,5350638806
12602,90053610,31630852,121684462,1,0,1,8192,10,146823786
12603,90066640,31617845,121684485,8,0,1,4096,8,1288887735
12604,90075330,21703320,111778650,2,0,0,3072,3,9724817769
12605,90094850,31610438,121705288,8,0,1,9728,8,9004518043
12606,90112630,21790578,111903208,2,0,0,52224,3,3115121195
12607,90128390,31598124,121726514,8,0,1,4608,8,9465219145
12608,90129810,21350795,111480605,2,0,0,2560,3,9860818179
12609,90133879,21233387,111367266,1,0,0,1024,10,4917132661
12610,90142160,21228101,111370261,9,0,0,9728,12,10691352372
12611,90150969,21225913,111376882,1,0,0,512,10,10722764067
12612,90151420,31586033,121737453,8,0,1,2560,8,8710595756
12613,90157890,21057367,111215257,9,0,0,3072,12,7465204069
12614,90165410,22218950,112384360,9,0,0,50176,12,1288409494
12615,90171199,21141469,111312668,1,0,0,1024,10,2469324005
12616,90171680,22142428,112314108,8,0,0,37376,8,10082193959
12617,90185680,21127167,111312847,4,0,0,512,15,2050698447
12618,90191309,22261937,112453246,3,0,0,58368,17,7816362054
12619,90200909,21745141,111946050,1,0,0,512,10,4749511305
12620,90214780,31572314,121787094,8,0,1,15872,8,1507887267
12621,90223860,20990430,111214290,9,0,0,7680,12,8862915
12622,90225291,21105261,111330552,7,0,0,17408,10,2222925740
12623,90238640,31551360,121790000,8,0,1,4608,8,8892419650
12624,90239530,22336866,112576396,2,0,0,43008,3,9444926872
12625,90245209,21180187,111425396,1,0,0,2560,10,10332094955
12626,90246181,21201041,111447222,7,0,0,11264,10,5788607630
12627,90246269,22163728,112409997,3,0,0,8192,17,9285030226
12628,90246789,22342445,112589234,3,0,0,33280,17,8159829284
12629,90252810,31538061,121790871,8,0,1,12288,8,3373020930
12630,90259830,21434984,111694814,2,0,0,4608,3,10549385330
12631,90276060,21832901,112108961,8,0,0,43520,8,9585803995
12632,90279990,21682409,111962399,2,0,0,12288,3,5600568590
12633,90280529,21089911,111370440,1,0,0,512,10,7196288787
12634,90284400,31507457,121791857,8,0,1,1536,8,8742891388
12635,90306029,21551424,111857453,1,0,0,1024,10,1741326196
12636,90306180,21471511,111777691,9,0,0,11776,12,1712154268
12637,90329970,31496018,121825988,8,0,1,3584,8,2767465069
12638,90330750,31500090,121830840,8,0,1,7680,8,3008399578
12639,90347910,21586700,111934610,2,0,0,5632,3,1692182272
12640,90358080,22303893,112661973,2,0,0,41472,3,5100580669
12641,90362470,21429642,111792112,9,0,0,15872,12,3313061079
12642,90371459,21246805,111618264,1,0,0,1536,10,7928132329
12643,90379279,31453827,121833106,4,0,1,3584,15,2448827812
12644,90382759,21786152,112168911,3,0,0,67072,17,10375599842
12645,90385160,21644590,112029750,2,0,0,59392,3,292879512
12646,90400629,21075395,111476024,1,0,0,1024,10,427135881
12647,90416279,31416981,121833260,4,0,1,8704,15,6647627002
12648,90428751,21870555,112299306,7,0,0,60416,10,2066992064
12649,90430439,31420041,121850480,4,0,1,6656,15,8720760892
12650,90444429,21111895,111556324,3,0,0,4608,17,4664267347
12651,90444679,31455248,121899927,4,0,1,512,15,8212652624
12652,90447760,31452190,121899950,8,0,1,2560,8,7868555638
12653,90448920,21346381,111795301,9,0,0,10240,12,4091982909
12654,90467249,21206725,111673974,1,0,0,1024,10,3578043736
12655,90483720,31416588,121900308,8,0,1,4096,8,7177046042
12656,90484780,31415551,121900331,8,0,1,1536,8,2900805350
12657,90485189,21684689,112169878,1,0,0,3072,10,5570807028
12658,90498330,22271410,112769740,8,0,0,14336,8,8935086489
12659,90501720,31442568,121944288,8,0,1,15360,8,1337233095
12660,90504919,21291996,111796915,1,0,0,1024,10,627967937
12661,90515669,21417202,111932871,3,0,0,97280,17,5896854918
12662,90524220,31421374,121945594,8,0,1,2048,8,1559675522
12663,90525330,21271250,111796580,9,0,0,4096,12,10226611705
12664,90538129,21764499,112302628,3,0,0,10752,17,10384499669
12665,90544099,21800670,112344769,1,0,0,40448,10,44154653
12666,90550390,31396830,121947220,8,0,1,2560,8,5438353433
12667,90555159,22122656,112677815,3,0,0,512,17,2173367993
12668,90555639,21711306,112266945,1,0,0,96768,10,6085765360
12669,90557129,31391717,121948846,4,0,1,2560,15,2951326202
12670,90559749,31468453,122028202,4,0,1,7680,15,5786283055
12671,90571069,21924832,112495901,1,0,0,18432,10,5056333574
12672,90575680,22201259,112776939,2,0,0,23552,3,3918750780
12673,90579029,21701823,112280852,1,0,0,45568,10,5369632835
12674,90592450,21739481,112331931,8,0,0,58368,8,8395489087
12675,90603270,21447407,112050677,2,0,0,68608,3,3516988588
12676,90623130,22285013,112908143,9,0,0,68608,12,9641263407
12677,90626210,31504996,122131206,8,0,1,69632,8,627089024
12678,90627450,31503779,122131229,8,0,1,4608,8,3240129191
12679,90628119,22409804,113037923,1,0,0,70656,10,10647297598
12680,90640819,21913944,112554763,1,0,0,53248,10,3472616370
12681,90645571,22149570,112795141,7,0,0,44544,10,10194722738
12682,90648209,31483043,122131252,4,0,1,3584,15,3785072632
12683,90650709,22535248,113185957,1,0,0,69120,10,33606079
12684,90663919,22312441,112976360,3,0,0,70656,17,9279866423
12685,90670229,23005655,113675884,1,0,0,119808,10,6798228583
12686,90676151,31517310,122193461,5,0,1,5632,10,10151191007
12687,90689570,22908855,113598425,2,0,0,9216,3,9604565387
12688,90708101,31485383,122193484,5,0,1,512,10,6832157117
12689,90708170,21472651,112180821,2,0,0,35840,3,2287076527
12690,90722091,31471416,122193507,5,0,1,1536,10,3082964333
12691,90725289,22772718,113498007,1,0,0,27648,10,9035832739
12692,90728611,21850460,112579071,7,0,0,8704,10,3119838147
12693,90731720,31461810,122193530,1,0,1,4096,10,19723737
12694,90733310,31492604,122225914,8,0,1,17920,8,9636269095
12695,90733660,22410131,113143791,2,0,0,39936,3,2147390320
12696,90745929,21762416,112508345,1,0,0,18944,10,1625875000
12697,90754330,21983093,112737423,2,0,0,143360,3,8803803018
12698,90758140,31467797,122225937,1,0,1,11776,10,9828303864
12699,90782810,31443150,122225960,1,0,1,2560,10,7461628964
12700,90785821,21402992,112188813,7,0,0,11776,10,7678176086
12701,90795759,22308358,113104117,1,0,0,8192,10,2645543866
12702,90797191,22146124,112943315,7,0,0,56832,10,6327119378
12703,90804280,21528142,112332422,9,0,0,1536,12,7860464541
12704,90815020,22015868,112830888,9,0,0,117248,12,7458057813
12705,90820389,21769804,112590193,3,0,0,3072,17,10446576444
12706,90828721,22445839,113274560,7,0,0,69120,10,2810648459
12707,90836639,21526492,112363131,1,0,0,33280,10,5065479774
12708,90841160,31390798,122231958,1,0,1,11776,10,1931092989
12709,90846830,22030255,112877085,2,0,0,46080,3,10296572094
12710,90872810,31382010,122254820,1,0,1,9728,10,2589388502
12711,90883331,31371512,122254843,5,0,1,6656,10,4964805729
12712,90883600,21881749,112765349,8,0,0,43520,8,6781988086
12713,90883819,22742023,113625842,1,0,0,79360,10,5309222026
12714,90890630,31383291,122273921,1,0,1,3072,10,482380293
12715,90896043,31377901,122273944,5,0,1,9216,10,7384577340
12716,90896100,22112129,113008229,9,0,0,102400,12,3261298025
12717,90897209,22297039,113194248,3,0,0,27136,17,4988730160
12718,90902711,22586818,113489529,7,0,0,36864,10,9212740240
12719,90915471,31412237,122327708,5,0,1,11264,10,6154952040
12720,90916640,23018321,113934961,8,0,0,117760,8,559852936
12721,90917190,31410541,122327731,1,0,1,2048,10,10296430673
12722,90936140,22278636,113214776,2,0,0,52224,3,2312328441
12723,90943061,22158537,113101598,7,0,0,19968,10,9676583357
12724,90954790,23009519,113964309,8,0,0,24576,8,3275063931
12725,90965881,22269633,113235514,7,0,0,22016,10,8042150386
12726,90973040,22263049,113236089,8,0,0,1536,8,225514853
12727,90978431,22186443,113164874,7,0,0,69120,10,5762032111
12728,91002920,21680385,112683305,2,0,0,6144,3,3153248555
12729,91023601,23026041,114049642,7,0,0,5120,10,8800182698
12730,91028910,22169931,113198841,9,0,0,14848,12,9619797307
12731,91032011,31300758,122332769,5,0,1,10752,10,30148474
12732,91050271,22249186,113299457,7,0,0,43008,10,7678887241
12733,91070370,31262422,122332792,1,0,1,4096,10,7836148484
12734,91073960,31258855,122332815,1,0,1,2048,10,1867856698
12735,91073981,21847601,112921582,7,0,0,44032,10,7456947121
12736,91076870,31255976,122332846,1,0,1,1536,10,3926920003
12737,91092609,22646570,113739179,1,0,0,13824,10,1841351357
12738,91103540,31229329,122332869,1,0,1,3584,10,7139135630
12739,91106239,22114449,113220688,3,0,0,8192,17,3355401784
12740,91119240,31227769,122347009,1,0,1,11264,10,7535268886
12741,91138110,31235420,122373530,1,0,1,6144,10,4686579499
12742,91143709,21872655,113016364,1,0,0,26624,10,6001251950
12743,91157440,22232343,113389783,2,0,0,70144,3,6185489955
12744,91174270,22971486,114145756,9,0,0,87552,12,5603061590
12745,91182270,21913221,113095491,8,0,0,130048,8,4301281807
12746,91207989,31176339,122384328,4,0,1,17408,15,1982533833
12747,91212049,22302804,113514853,3,0,0,45056,17,9297994200
12748,91231531,31187824,122419355,5,0,1,1536,10,5639348354
12749,91234840,22042551,113277391,8,0,0,9216,8,3473167589
12750,91235230,31184148,122419378,0,0,1,4096,3,2804466160
12751,91240639,22573016,113813655,3,0,0,77312,17,4818110581
12752,91240840,22795547,114036387,9,0,0,23040,12,9953606331
12753,91241760,22236514,113478274,9,0,0,75776,12,9512743107
12754,91282701,22452243,113734944,7,0,0,23040,10,8338485850
12755,91286289,22285882,113572171,1,0,0,37888,10,6146263059
12756,91293689,22523935,113817624,1,0,0,4608,10,1733995994
12757,91307159,22469676,113776835,3,0,0,6656,17,1866026726
12758,91308540,22461205,113769745,9,0,0,41472,12,7794587859
12759,91316019,22279575,113595594,1,0,0,76800,10,9644692329
12760,91326549,22174553,113501102,1,0,0,7680,10,1207525625
12761,91327120,22080782,113407902,8,0,0,59392,8,7023400617
12762,91334611,31084798,122419409,5,0,1,9216,10,9238397608
12763,91354131,31065301,122419432,5,0,1,512,10,1662944848
12764,91355250,21995211,113350461,9,0,0,6656,12,5397870440
12765,91379050,21987839,113366889,8,0,0,5120,8,6764135787
12766,91400951,31018512,122419463,5,0,1,5120,10,7667925314
12767,91402900,22325001,113727901,9,0,0,22016,12,5755781567
12768,91425519,22073135,113498654,3,0,0,2048,17,6710302371
12769,91432229,22744382,114176611,3,0,0,40960,17,2596388738
12770,91448840,22067370,113516210,2,0,0,512,3,7303772706
12771,91450221,30976157,122426378,5,0,1,6656,10,2285214811
12772,91471369,22755465,114226834,3,0,0,75264,17,7702195216
12773,91472389,22314788,113787177,3,0,0,10752,17,8617225533
12774,91478029,22038002,113516031,1,0,0,3584,10,10191945248
12775,91480849,22270879,113751728,1,0,0,35840,10,7018260555
12776,91487561,30947803,122435364,5,0,1,13312,10,9215441564
12777,91507761,30939509,122447270,5,0,1,3072,10,7222683606
12778,91516950,22744707,114261657,8,0,0,29696,8,754384592
12779,91518060,22374392,113892452,8,0,0,37888,8,5248811219
12780,91539949,22455548,113995497,3,0,0,20992,17,6032597211
12781,91553819,22167328,113721147,3,0,0,148480,17,3232164119
12782,91560470,21988874,113549344,8,0,0,9216,8,7193350815
12783,91564389,22858517,114422906,3,0,0,93184,17,9528911193
12784,91576970,30876178,122453148,9,0,1,1024,12,7128332044
12785,91581720,21866607,113448327,9,0,0,4096,12,3048724321
12786,91643441,22237444,113880885,7,0,0,59904,10,421569693
12787,91647980,30809034,122457014,9,0,1,6144,12,10416326211
12788,91653310,30807929,122461239,7,0,1,1024,10,9651276054
12789,91671900,30796891,122468791,7,0,1,1024,10,3119012885
12790,91676970,22600310,114277280,9,0,0,51200,12,7212724439
12791,91702200,22779460,114481660,9,0,0,86528,12,8384328055
12792,91717240,22023545,113740785,9,0,0,5120,12,10314315248
12793,91721190,22720170,114441360,8,0,0,36864,8,5153031346
12794,91733840,21899559,113633399,9,0,0,8192,12,6009477424
12795,91741131,21889726,113630857,7,0,0,16384,10,9186200677
12796,91753830,22001041,113754871,9,0,0,10240,12,184663842
12797,91768420,22126395,113894815,2,0,0,7680,3,3062952209
12798,91769239,22737111,114506350,3,0,0,35328,17,8290238660
12799,91781489,22744913,114526402,1,0,0,20480,10,9932158404
12800,91789130,22150394,113939524,2,0,0,14848,3,2325420534
12801,91806430,30662384,122468814,7,0,1,5120,10,6689435937
12802,91814490,22865093,114679583,9,0,0,27648,12,9866402175
12803,91817670,30652646,122470316,3,0,1,16384,17,6577585052
12804,91825610,30708059,122533669,3,0,1,5120,17,403983225
12805,91826180,30707512,122533692,7,0,1,1536,10,4003233477
12806,91847580,30686135,122533715,7,0,1,4096,10,849310220
12807,91855010,21902068,113757078,8,0,0,7168,8,698104936
12808,91868170,30665568,122533738,7,0,1,5120,10,4560223161
12809,91871150,30720224,122591374,7,0,1,16384,10,2983065487
12810,91871770,30719627,122591397,7,0,1,2048,10,7951490112
12811,91872450,30720633,122593083,2,0,1,9216,3,10506075703
12812,91896191,21920006,113816197,7,0,0,8192,10,4018149644
12813,91897230,22193439,114090669,2,0,0,5120,3,9840773319
12814,91902870,22261230,114164100,9,0,0,4608,12,7330842890
12815,91907160,30690947,122598107,7,0,1,2048,10,4704723773
12816,91911940,30686190,122598130,7,0,1,2560,10,34587002
12817,91912450,30718439,122630889,7,0,1,3584,10,592110654
12818,91912630,30718282,122630912,7,0,1,1024,10,1482275056
12819,91913131,21869535,113782666,7,0,0,2560,10,2533070695
12820,91915430,30715957,122631387,2,0,1,7168,3,4417468195
12821,91915859,22073219,113989078,1,0,0,53760,10,4068830690
12822,91922770,22950240,114873010,9,0,0,26624,12,407084438
12823,91924050,21975000,113899050,9,0,0,13824,12,3615304057
12824,91929720,22027078,113956798,2,0,0,42496,3,8128631368
12825,91937660,23326683,115264343,9,0,0,12800,12,6205414543
12826,91940520,30691213,122631733,2,0,1,512,3,3016258318
12827,91942321,23174517,115116838,7,0,0,58368,10,10137361977
12828,91955351,21815509,113770860,7,0,0,3584,10,1739786032
12829,91957231,22202923,114160154,7,0,0,13824,10,4064155225
12830,91957791,22041028,113998819,7,0,0,10752,10,3016480090
12831,91958150,22712940,114671090,2,0,0,32768,3,6427360451
12832,91960099,22633014,114593113,1,0,0,8192,10,9590970588
12833,91965530,22765541,114731071,9,0,0,6144,12,9765601755
12834,91968840,22187079,114155919,9,0,0,33280,12,4024735071
12835,91972789,22266507,114239296,3,0,0,40448,17,1404967926
12836,91978640,30659225,122637865,3,0,1,9728,17,6425529072
12837,91978759,22415732,114394491,3,0,0,66048,17,4835996143
12838,91987570,23077191,115064761,9,0,0,1536,12,1293291774
12839,91999749,22915805,114915554,3,0,0,30208,17,6274828246
12840,92002809,21999621,114002430,3,0,0,11776,17,6226178461
12841,92021810,22049270,114071080,2,0,0,9216,3,5631722778
12842,92025540,22059052,114084592,2,0,0,8192,3,4817688085
12843,92027750,22292618,114320368,8,0,0,33280,8,123336554
12844,92029770,23416666,115446436,2,0,0,15360,3,7550498974
12845,92034259,21995085,114029344,3,0,0,12288,17,9416278365
12846,92034600,23159430,115194030,9,0,0,86016,12,8876243038
12847,92035059,22301076,114336135,3,0,0,35840,17,3780252681
12848,92042980,23589246,115632226,9,0,0,56832,12,8764502457
12849,92077469,23633252,115710721,3,0,0,9728,17,6434772146
12850,92078000,30560851,122638851,1,0,1,1536,10,2763095807
12851,92083270,22452827,114536097,8,0,0,31744,8,7715700430
12852,92086000,22076673,114162673,8,0,0,8192,8,2592395300
12853,92093300,22393109,114486409,8,0,0,9728,8,6386899902
12854,92093650,30546827,122640477,1,0,1,2560,10,3219006407
12855,92097730,30545392,122643122,2,0,1,512,3,147919525
12856,92100600,30546388,122646988,1,0,1,6144,10,1505813399
12857,92102380,30544954,122647334,3,0,1,512,17,9119954543
12858,92112000,30536000,122648000,1,0,1,1024,10,8300801408
12859,92114180,30535126,122649306,2,0,1,2048,3,9289997298
12860,92120870,30530062,122650932,2,0,1,2560,3,5517355044
12861,92121930,30532868,122654798,3,0,1,6144,17,9037326878
12862,92124840,30636008,122760848,2,0,1,28672,3,4465347542
12863,92126810,30634061,122760871,1,0,1,2048,10,4536478032
12864,92128010,30632884,122760894,1,0,1,1536,10,5945675134
12865,92135410,22476621,114612031,9,0,0,40960,12,3194954601
12866,92137750,22107185,114244935,8,0,0,18432,8,4570831156
12867,92138130,30622787,122760917,1,0,1,512,10,7963631530
12868,92143400,30624868,122768268,1,0,1,4096,10,4920256234
12869,92147371,22814927,114962298,7,0,0,11264,10,3308292723
12870,92149090,22173485,114322575,2,0,0,7168,3,1860887592
12871,92150670,30617621,122768291,2,0,1,14336,3,8424460343
12872,92151261,22509822,114661083,7,0,0,71680,10,1790646195
12873,92152739,22477769,114630508,3,0,0,8192,17,5679535780
12874,92187550,22242555,114430105,2,0,0,23552,3,5999769173
12875,92191021,22292401,114483422,7,0,0,5632,10,5571455804
12876,92198030,30572674,122770704,3,0,1,6656,17,4221405798
12877,92211359,23095108,115306467,3,0,0,62976,17,9312905386
12878,92219310,22321490,114540800,2,0,0,15360,3,8468371804
12879,92220609,22271418,114492027,3,0,0,1024,17,6068369106
12880,92233541,22211765,114445306,7,0,0,10240,10,591668102
12881,92234960,30536820,122771780,3,0,1,13312,17,1380484351
12882,92258270,22256215,114514485,9,0,0,26624,12,8297524874
12883,92269080,30527898,122796978,2,0,1,3584,3,7425638601
12884,92281440,23556164,115837604,9,0,0,15360,12,6969824389
12885,92285950,30522702,122808652,2,0,1,3072,3,611823549
12886,92290411,22296063,114586474,7,0,0,26112,10,7462819198
12887,92293000,30537049,122830049,3,0,1,2560,17,58932868
12888,92296930,30533465,122830395,2,0,1,512,3,5839274941
12889,92304869,22695736,115000605,1,0,0,10240,10,9320183251
12890,92320249,22276616,114596865,1,0,0,11264,10,2551638204
12891,92322121,23549001,115871122,7,0,0,7168,10,7211685032
12892,92335040,30495701,122830741,3,0,1,512,17,7811902414
12893,92344030,30487057,122831087,2,0,1,512,3,8057317855
12894,92353800,30479233,122833033,2,0,1,3072,3,5826282141
12895,92358110,30475269,122833379,2,0,1,512,3,6035536902
12896,92358759,22851853,115210612,3,0,0,35840,17,10095578513
12897,92371370,30463635,122835005,2,0,1,2560,3,7020202564
12898,92373019,23108768,115481787,3,0,0,61440,17,10493651406
12899,92380850,30460115,122840965,3,0,1,11776,17,9270654521
12900,92391270,22050893,114442163,9,0,0,2560,12,7385387321
12901,92395649,22455967,114851616,3,0,0,28160,17,9045988473
12902,92398411,22588346,114986757,7,0,0,56320,10,7096573207
12903,92403019,23204474,115607493,3,0,0,34304,17,1435063487
12904,92403079,22591189,114994268,1,0,0,24576,10,3483204886
12905,92403909,22439104,114843013,3,0,0,157696,17,396494431
12906,92405939,22619992,115025931,3,0,0,40448,17,4744640645
12907,92408970,22549873,114958843,9,0,0,53248,12,506316724
12908,92409329,22681754,115091083,1,0,0,10240,10,4407249041
12909,92412190,30560364,122972554,3,0,1,12800,17,8645844329
12910,92414250,22801088,115215338,8,0,0,15360,8,8434189913
12911,92438661,22618566,115057227,7,0,0,23552,10,1924612075
12912,92443221,30591297,123034518,5,0,1,13312,10,9022280901
12913,92444790,30590087,123034877,2,0,1,9728,3,8424228104
12914,92449311,22493277,114942588,7,0,0,88576,10,666133226
12915,92456870,30740174,123197044,3,0,1,11264,17,5170076822
12916,92464580,22661329,115125909,8,0,0,29696,8,9107569586
12917,92476910,30720157,123197067,2,0,1,3584,3,2312102929
12918,92477100,23838123,116315223,9,0,0,100864,12,7877811051
12919,92486181,23393076,115879257,7,0,0,26624,10,6534816730
12920,92487140,24001362,116488502,9,0,0,110080,12,6881057735
12921,92489259,22678540,115167799,1,0,0,90624,10,5595124998
12922,92491771,30705319,123197090,5,0,1,4608,10,852674156
12923,92500670,22748894,115249564,9,0,0,53248,12,793913183
12924,92502470,22931581,115434051,9,0,0,1536,12,4424420222
12925,92509490,22924070,115433560,8,0,0,34816,8,2823510125
12926,92510281,22689388,115199669,7,0,0,18432,10,6815401647
12927,92525360,22754873,115280233,8,0,0,4096,8,4930180862
12928,92527151,30670141,123197292,5,0,1,13312,10,728188441
12929,92549910,30693750,123243660,7,0,1,7168,10,5487064830
12930,92562331,30681352,123243683,5,0,1,13312,10,110951998
12931,92577669,22435915,115013584,1,0,0,28160,10,6227960344
12932,92578599,22450319,115028918,1,0,0,9728,10,3467777579
12933,92578829,22485441,115064270,1,0,0,23040,10,10709482798
12934,92593840,23021031,115614871,8,0,0,23040,8,4829066893
12935,92610041,30665691,123275732,5,0,1,512,10,9094223412
12936,92616699,23091012,115707711,1,0,0,48640,10,4482633096
12937,92619990,30655765,123275755,3,0,1,2048,17,60025459
12938,92666650,30609128,123275778,3,0,1,2560,17,3006732150
12939,92667020,22593354,115260374,8,0,0,35328,8,1596369874
12940,92686210,30605456,123291666,6,0,1,1536,7,8907776092
12941,92699269,22829170,115528439,1,0,0,71680,10,1196444480
12942,92701591,30591061,123292652,5,0,1,1536,10,9772814553
12943,92705540,22421515,115127055,9,0,0,3584,12,10728135742
12944,92708260,30584853,123293113,7,0,1,10240,10,10394737250
12945,92710220,23875291,116585511,9,0,0,43008,12,6906331047
12946,92711641,30613190,123324831,5,0,1,8704,10,5151971524
12947,92737600,30615293,123352893,7,0,1,1024,10,3914735290
12948,92746990,22327319,115074309,2,0,0,5632,3,8915994694
12949,92761030,30603956,123364986,7,0,1,8704,10,9415386325
12950,92763440,30630862,123394302,7,0,1,4096,10,5850360462
12951,92770169,22447220,115217389,3,0,0,6656,17,8663668463
12952,92771530,23943779,116715309,9,0,0,69632,12,4161275573
12953,92772171,22954536,115726707,7,0,0,31232,10,7839235772
12954,92795151,30599174,123394325,5,0,1,3072,10,9162490878
12955,92803780,30590568,123394348,6,0,1,10240,7,7122627172
12956,92806280,24040698,116846978,8,0,0,21504,8,7397403640
12957,92807410,24098141,116905551,8,0,0,65536,8,4012363505
12958,92811140,23113820,115924960,2,0,0,16384,3,8769045633
12959,92813800,30580571,123394371,7,0,1,5120,10,7899104029
12960,92814840,22574613,115389453,9,0,0,20480,12,2704716825
12961,92819770,30574624,123394394,3,0,1,3584,17,7742722277
12962,92826140,31116757,123942897,8,0,1,181248,8,8633914162
12963,92831511,31111409,123942920,5,0,1,3072,10,6034325135
12964,92833590,22852492,115686082,9,0,0,33792,12,1290197255
12965,92834940,22879392,115714332,2,0,0,11776,3,3969364158
12966,92836560,31106383,123942943,3,0,1,2048,17,7750987579
12967,92839880,22918021,115757901,9,0,0,36352,12,996833567
12968,92841150,31101995,123943145,7,0,1,4608,10,2797713557
12969,92851120,31118856,123969976,8,0,1,70144,8,7107741157
12970,92853839,22505466,115359305,1,0,0,12800,10,9211702978
12971,92869940,31101460,123971400,1,0,1,2048,10,7069515308
12972,92878740,22866588,115745328,8,0,0,13824,8,2120290424
12973,92881790,22959901,115841691,2,0,0,13312,3,9101617014
12974,92883810,22809026,115692836,8,0,0,22016,8,7880518713
12975,92885350,31097708,123983058,1,0,1,7680,10,8476247155
12976,92891700,31111485,124003185,8,0,1,17408,8,5316475719
12977,92892290,31162631,124054921,8,0,1,29696,8,6997272906
12978,92895680,31165540,124061220,3,0,1,1024,17,6284146146
12979,92925870,23105770,116031640,2,0,0,5120,3,9965497509
12980,92940119,24034811,116974930,3,0,0,3584,17,6759466987
12981,92943230,22787712,115730942,8,0,0,13824,8,9073255145
12982,92949630,31122787,124072417,8,0,1,19968,8,3219931409
12983,92951090,31165407,124116497,8,0,1,43008,8,4972786626
12984,92952130,22783047,115735177,6,0,0,13824,7,3602375224
12985,92955240,22708677,115663917,9,0,0,103936,12,2090199964
12986,92956990,31171605,124128595,1,0,1,5120,10,6720312376
12987,92966521,22866380,115832901,7,0,0,35840,10,9437764268
12988,92966541,31172511,124139052,5,0,1,6144,10,158296218
12989,92974080,31164995,124139075,2,0,1,4096,3,7830077955
12990,92974710,31164475,124139185,1,0,1,1536,10,1941113274
12991,92980480,24234680,117215160,9,0,0,230400,12,10151630109
12992,92985980,23028134,116014114,8,0,0,68608,8,4660126942
12993,93001300,31176419,124177719,8,0,1,40448,8,7718222130
12994,93007030,22587335,115594365,2,0,0,40448,3,856841684
12995,93009800,22904197,115913997,9,0,0,55808,12,8796115404
12996,93015520,31166348,124181868,2,0,1,1024,3,9059306048
12997,93016751,22658741,115675492,7,0,0,37888,10,9037020978
12998,93016981,31165553,124182534,5,0,1,1024,10,4269361815
12999,93027960,31172275,124200235,8,0,1,35840,8,338481558
13000,93049330,22865369,115914699,8,0,0,2048,8,4845299184
13001,93052100,31201585,124253685,2,0,1,1024,3,7274739675
13002,93053129,22554699,115607828,3,0,0,1024,17,8889306630
13003,93064200,31208384,124272584,3,0,1,9728,17,3990659830
13004,93075179,22996072,116071251,1,0,0,38400,10,10734632089
13005,93081650,31235494,124317144,2,0,1,11264,3,6281335017
13006,93084880,31232287,124317167,1,0,1,3072,10,2555255501
13007,93086630,31240746,124327376,3,0,1,4608,17,8932236250
13008,93090379,22585338,115675717,1,0,0,512,10,6567673699
13009,93092209,22849513,115941722,3,0,0,52736,17,386040324
13010,93092249,31298520,124390769,4,0,1,21504,15,6505908823
13011,93104199,31288516,124392715,4,0,1,3072,15,9755016843
13012,93104410,31290571,124394981,7,0,1,3584,10,9412082417
13013,93110750,31285537,124396287,7,0,1,2048,10,1668874246
13014,93115880,31280753,124396633,2,0,1,512,3,6726921955
13015,93116070,31314610,124430680,3,0,1,26624,17,742667151
13016,93143620,22753350,115896970,2,0,0,16384,3,1805696689
13017,93147231,23277891,116425122,7,0,0,170496,10,8122842497
13018,93149679,23105116,116254795,1,0,0,25600,10,9366054506
13019,93163271,31320172,124483443,5,0,1,5632,10,7343460625
13020,93164870,31318596,124483466,2,0,1,4096,3,221158492
13021,93166540,31316949,124483489,2,0,1,5632,3,3522144077
13022,93169201,22823986,115993187,7,0,0,11264,10,10087412344
13023,93171490,22565598,115737088,2,0,0,5632,3,1652179573
13024,93174180,31315886,124490066,3,0,1,4096,17,4911295917
13025,93174279,22871597,116045876,3,0,0,15360,17,3587679814
13026,93177550,22983752,116161302,2,0,0,58880,3,6708269602
13027,93180419,31323643,124504062,4,0,1,1024,15,10517232813
13028,93189590,31367850,124557440,8,0,1,19456,8,6543820704
13029,93195310,23159371,116354681,2,0,0,13312,3,9216701034
13030,93198600,23168428,116367028,2,0,0,40448,3,3939817127
13031,93203271,23169872,116373143,7,0,0,19968,10,9201351123
13032,93215779,24197576,117413355,1,0,0,117760,10,2683447768
13033,93218529,23290533,116509062,3,0,0,45056,17,9982892384
13034,93218780,22811277,116030057,9,0,0,52224,12,5000691657
13035,93220280,31352088,124572368,3,0,1,1024,17,3131185730
13036,93232130,31662360,124894490,8,0,1,77824,8,5078008717
13037,93232750,23262515,116495265,2,0,0,22016,3,7173180768
13038,93233440,31661073,124894513,3,0,1,5632,17,4502567308
13039,93234370,23093075,116327445,9,0,0,13824,12,9629371542
13040,93236649,23201920,116438569,3,0,0,44032,17,3210879322
13041,93238270,22730779,115969049,8,0,0,13824,8,8443038561
13042,93242760,23080450,116323210,2,0,0,26112,3,1892734306
13043,93245390,31649146,124894536,3,0,1,10240,17,3350050296
13044,93250040,31646436,124896476,1,0,1,1536,10,2548344174
13045,93252071,23384982,116637053,7,0,0,20480,10,10152579089
13046,93254450,31773639,125028089,2,0,1,52224,3,1295180652
13047,93255320,22982857,116238177,9,0,0,6144,12,2329865293
13048,93258960,31891041,125150001,2,0,1,6656,3,8602613681
13049,93259900,31891087,125150987,2,0,1,1536,3,7516845294
13050,93261080,32284938,125546018,8,0,1,84480,8,6481946906
13051,93263880,32282161,125546041,3,0,1,512,17,4636847470
13052,93265599,23084957,116350556,3,0,0,75776,17,4938508462
13053,93266559,22911866,116178425,1,0,0,2048,10,1500523776
13054,93271819,24274060,117545879,1,0,0,168448,10,8758795508
13055,93275819,23564530,116840349,1,0,0,10240,10,7350572501
13056,93276370,23552499,116828869,2,0,0,70144,3,87367041
13057,93277271,23511772,116789043,7,0,0,16384,10,10012029879
13058,93277740,32306598,125584338,8,0,1,27136,8,1474423586
13059,93279250,23458147,116737397,9,0,0,72192,12,1536666305
13060,93284510,32306270,125590780,8,0,1,8704,8,926464788
13061,93292040,32307522,125599562,1,0,1,6656,10,6671187711
13062,93292930,23308204,116601134,2,0,0,51200,3,8944832047
13063,93306379,32297777,125604156,4,0,1,10752,15,8858463563
13064,93319100,23215608,116534708,8,0,0,83968,8,4038375945
13065,93323580,23131236,116454816,9,0,0,53248,12,6757463766
13066,93323670,32333066,125656736,1,0,1,7168,10,755827861
13067,93332970,32323789,125656759,0,0,1,1024,3,5386756825
13068,93336970,32319812,125656782,1,0,1,2560,10,8814953919
13069,93337989,23540988,116878977,3,0,0,58368,17,7754215759
13070,93342349,23570089,116912438,3,0,0,22528,17,9289254693
13071,93346130,32315222,125661352,3,0,1,512,17,8159325165
13072,93352340,32309035,125661375,1,0,1,4096,10,7501148181
13073,93360510,32337750,125698260,3,0,1,5120,17,8005727486
13074,93366451,23470732,116837183,7,0,0,20480,10,1987669629
13075,93374620,32323663,125698283,3,0,1,1024,17,8277712116
13076,93378329,23291053,116669382,1,0,0,23040,10,2003496454
13077,93381510,32391336,125772846,8,0,1,101888,8,9287793455
13078,93382950,32461654,125844604,7,0,1,4096,10,445790083
13079,93384550,32460400,125844950,1,0,1,512,10,2023853607
13080,93388559,23491377,116879936,1,0,0,3072,10,9866996462
13081,93391320,23618900,117010220,8,0,0,8192,8,6179989039
13082,93398360,23482535,116880895,8,0,0,3072,8,1906246148
13083,93399490,23587896,116987386,8,0,0,15360,8,2995249297
13084,93400940,23637985,117038925,9,0,0,51712,12,7518751220
13085,93403460,32450259,125853719,3,0,1,3072,17,5612383763
13086,93405640,32448102,125853742,1,0,1,9728,10,2527068596
13087,93409660,23544707,116954367,9,0,0,77824,12,2778015815
13088,93417100,32436665,125853765,0,0,1,3072,3,3350446278
13089,93419360,32434428,125853788,7,0,1,4096,10,5948951469
13090,93428679,23681268,117109947,1,0,0,56832,10,4636320915
13091,93435430,23699812,117135242,9,0,0,82944,12,575521137
13092,93441160,32445425,125886585,3,0,1,8704,17,3818192121
13093,93451110,32435498,125886608,7,0,1,5632,10,631000245
13094,93453940,23914186,117368126,2,0,0,9216,3,8324302747
13095,93454970,32431661,125886631,1,0,1,2048,10,3897524652
13096,93464269,32422385,125886654,4,0,1,512,15,3515990207
13097,93467171,23340303,116807474,7,0,0,60416,10,7559967472
13098,93472800,32413877,125886677,3,0,1,3072,17,9029209191
13099,93485180,32401520,125886700,0,0,1,4096,3,4697166896
13100,93490419,23774719,117265138,3,0,0,108032,17,5518295269
13101,93491860,32489498,125981358,0,0,1,83968,3,1484597611
13102,93499880,32483744,125983624,3,0,1,3584,17,7701812214
13103,93520700,23395216,116915916,8,0,0,11264,8,2613464444
13104,93520829,32466876,125987705,4,0,1,2048,15,10394678129
13105,93521110,32677357,126198467,0,0,1,109568,3,8664885478
13106,93545760,32845971,126391731,0,0,1,199680,3,7010914603
13107,93559989,23270931,116830920,3,0,0,6656,17,7742052204
13108,93561680,23985626,117547306,8,0,0,4608,8,1669212090
13109,93564739,23482812,117047551,1,0,0,28160,10,6866468183
13110,93567040,32834984,126402024,3,0,1,7680,17,2346170915
13111,93578950,23282043,116860993,8,0,0,512,8,1039628358
13112,93581139,23784156,117365295,3,0,0,121344,17,1253671499
13113,93581929,24436873,118018802,1,0,0,43008,10,9390362777
13114,93584320,32817858,126402178,0,0,1,8704,3,1591539672
13115,93584489,24467341,118051830,3,0,0,9216,17,5572417277
13116,93586220,23490464,117076684,9,0,0,9728,12,6545912135
13117,93597909,23547028,117144937,3,0,0,31744,17,8222103487
13118,93605609,24627607,118233216,3,0,0,64000,17,7573351318
13119,93609650,24772004,118381654,8,0,0,12800,8,1490385121
13120,93617629,23439307,117056936,3,0,0,18432,17,9730292821
13121,93619119,23461295,117080414,3,0,0,512,17,10372876602
13122,93620681,23850389,117471070,7,0,0,50688,10,8472765019
13123,93628900,32953901,126582801,8,0,1,257536,8,308725730
13124,93630090,32976526,126606616,3,0,1,1536,17,7981310317
13125,93633370,32980998,126614368,0,0,1,7680,3,8547623384
13126,93639880,32974511,126614391,0,0,1,4096,3,1802390088
13127,93645890,32970110,126616000,3,0,1,3072,17,382350815
13128,93651110,33066801,126717911,0,0,1,83968,3,6629274405
13129,93670361,23611046,117281407,7,0,0,16384,10,4822078131
13130,93672769,23821747,117494516,1,0,0,76800,10,8584844996
13131,93691140,24809565,118500705,9,0,0,7680,12,4155827964
13132,93692260,33062928,126755188,8,0,1,12800,8,8358502312
13133,93692401,23678712,117371113,7,0,0,9728,10,5384378314
13134,93701690,23600826,117302516,9,0,0,57856,12,670254346
13135,93705260,33065898,126771158,8,0,1,23040,8,4413659710
13136,93710009,23877574,117587583,1,0,0,41472,10,5294169913
13137,93710991,24186554,117897545,7,0,0,117760,10,8893352302
13138,93713451,23502246,117215697,7,0,0,1536,10,971444722
13139,93728339,23886067,117614406,3,0,0,54272,17,6472923878
13140,93728650,23979707,117708357,9,0,0,49152,12,7647341190
13141,93731421,23682471,117413892,7,0,0,1536,10,7421952185
13142,93736430,33063550,126799980,8,0,1,26624,8,7851317758
13143,93756220,33046346,126802566,3,0,1,4096,17,9161017498
13144,93757361,24043491,117800852,7,0,0,72704,10,7704693463
13145,93764630,23656305,117420935,9,0,0,23040,12,2489719192
13146,93764860,33038372,126803232,8,0,1,1024,8,2569773250
13147,93778470,33288453,127066923,0,0,1,145408,3,7134593159
13148,93789030,23800760,117589790,8,0,0,7168,8,5580640484
13149,93791999,24144147,117936146,3,0,0,14336,17,4708655580
13150,93804020,33371326,127175346,0,0,1,186880,3,7586705643
13151,93807340,33372308,127179648,0,0,1,18432,3,2554421301
13152,93813329,23784463,117597792,3,0,0,26112,17,3504949144
13153,93830920,23850509,117681429,9,0,0,6144,12,3268305887
13154,93836780,33495147,127331927,8,0,1,154112,8,2161617873
13155,93841240,33505374,127346614,3,0,1,2560,17,6686250306
13156,93849935,33502186,127352121,0,0,1,15872,3,6941141703
13157,93852970,33505936,127358906,8,0,1,20992,8,3530496089
13158,93855529,23719379,117574908,1,0,0,10752,10,7603925220
13159,93858410,33510795,127369205,0,0,1,28672,3,5048134722
13160,93859739,23702909,117562648,1,0,0,38912,10,8715880779
13161,93891670,33538962,127430632,8,0,1,72704,8,2779481057
13162,93896570,33537928,127434498,3,0,1,6144,17,7603366486
13163,93912200,33527124,127439324,3,0,1,7680,17,4941639141
13164,93917449,24077127,117994576,1,0,0,64000,10,775731567
13165,93970950,23600659,117571609,9,0,0,29184,12,10733710742
13166,93980800,33506766,127487566,8,0,1,72192,8,327665897
13167,93983960,24628534,118612494,9,0,0,2560,12,5051134688
13168,93984739,23987669,117972408,3,0,0,47104,17,1862505367
13169,93985380,23821446,117806826,8,0,0,19456,8,7220346131
13170,93986790,33508540,127495330,0,0,1,2048,3,10647580906
13171,93995680,23555081,117550761,9,0,0,11264,12,753659986
13172,94002461,23656367,117658828,7,0,0,8192,10,691822760
13173,94007289,24330018,118337307,1,0,0,18944,10,1133039122
13174,94008879,23769752,117778631,1,0,0,86528,10,3324171267
13175,94009631,24759708,118769339,7,0,0,67584,10,9066967243
13176,94023580,33522960,127546540,8,0,1,41472,8,3689705941
13177,94044279,24868119,118912398,3,0,0,36864,17,5091519193
13178,94057620,33491514,127549134,9,0,1,11776,12,6066821494
13179,94071019,25021579,119092598,3,0,0,29184,17,1026030796
13180,94085579,24009767,118095346,3,0,0,25600,17,7481556094
13181,94123711,23806929,117930640,7,0,0,108544,10,8159926719
13182,94128199,23603784,117731983,1,0,0,37888,10,8300913665
13183,94140450,33442607,127583057,6,0,1,8192,7,9318810414
13184,94151120,33439989,127591109,6,0,1,12800,7,5257583824
13185,94162260,33431755,127594015,6,0,1,4608,7,7308060940
13186,94166759,23652538,117819297,1,0,0,28160,10,3929182081
13187,94177620,33420927,127598547,9,0,1,17408,12,1442263370
13188,94178820,33424233,127603053,9,0,1,7168,12,4455449590
13189,94188100,33445023,127633123,6,0,1,17920,7,1772656509
13190,94188989,24255497,118444486,3,0,0,37888,17,2183560928
13191,94195949,23662261,117858210,1,0,0,8704,10,10369878632
13192,94199279,23959406,118158685,1,0,0,1024,10,9529920813
13193,94206170,33508148,127714318,3,0,1,2048,17,8485079538
13194,94207800,33514118,127721918,6,0,1,1024,7,6821929903
13195,94208761,23722994,117931755,7,0,0,3584,10,1422772011
13196,94208870,33513071,127721941,3,0,1,11264,17,109892445
13197,94224110,33539408,127763518,6,0,1,2560,7,6990177520
13198,94240050,33523491,127763541,6,0,1,4096,7,5915142667
13199,94244600,33518964,127763564,3,0,1,19456,17,8757911690
13200,94247300,33516295,127763595,3,0,1,5120,17,10556942590
13201,94257080,23802686,118059766,8,0,0,4608,8,5399585441
13202,94264320,24315783,118580103,9,0,0,92672,12,273240545
13203,94275260,23580275,117855535,9,0,0,2560,12,10153137479
13204,94280080,33483538,127763618,6,0,1,2048,7,9783140249
13205,94297091,24048351,118345442,7,0,0,26624,10,1468739259
13206,94303370,33460271,127763641,6,0,1,4608,7,2175323575
13207,94307240,23767637,118074877,9,0,0,13312,12,10479600692
13208,94310009,24889806,119199815,3,0,0,25088,17,2806116785
13209,94314359,23622480,117936839,1,0,0,2048,10,4037096204
13210,94315781,23689894,118005675,7,0,0,36352,10,10621258789
13211,94322700,33442323,127765023,9,0,1,3584,12,6933424598
13212,94327179,23759896,118087075,1,0,0,34304,10,4151941603
13213,94327500,33440429,127767929,6,0,1,4608,7,4191038526
13214,94328770,33443665,127772435,6,0,1,7168,7,163895791
13215,94336819,24956231,119293050,1,0,0,112128,10,10648531390
13216,94348140,33424961,127773101,9,0,1,1024,12,10621058249
13217,94359459,23578876,117938335,3,0,0,4608,17,9137644912
13218,94360660,33413107,127773767,9,0,1,1024,12,5146571052
13219,94361920,23757451,118119371,6,0,0,28160,7,9555534673
13220,94363180,24385536,118748716,8,0,0,72704,8,1976588700
13221,94380210,33397103,127777313,9,0,1,5632,12,10004964609
13222,94384139,24301497,118685636,1,0,0,10240,10,431857941
13223,94388380,24219797,118608177,6,0,0,53248,7,2679718832
13224,94389180,24043716,118432896,9,0,0,57856,12,3635522154
13225,94418050,24409148,118827198,6,0,0,79872,7,1998213015
13226,94423180,23899308,118322488,6,0,0,78848,7,1253240318
13227,94424901,23744187,118169088,7,0,0,14848,10,2771071200
13228,94442109,23804447,118246556,3,0,0,3072,17,7310013999
13229,94443660,23909206,118352866,6,0,0,23040,7,4607286031
13230,94451249,23808023,118259272,1,0,0,33792,10,8939548314
13231,94452790,33326149,127778939,3,0,1,2560,17,1886223513
13232,94455659,24866857,119322516,1,0,0,1024,10,6435430380
13233,94461751,24130179,118591930,7,0,0,20480,10,7894644863
13234,94483740,33299705,127783445,9,0,1,7168,12,7368852504
13235,94485110,33301241,127786351,3,0,1,4608,17,475023072
13236,94485959,23990674,118476633,1,0,0,12288,10,2363847308
13237,94486220,33303677,127789897,3,0,1,5632,17,104664552
13238,94500600,23877131,118377731,6,0,0,22016,7,4319525251
13239,94503029,23890569,118393598,1,0,0,23552,10,4296217676
13240,94504530,23793888,118298418,9,0,0,39936,12,1736199127
13241,94507420,24576263,119083683,6,0,0,19456,7,7940564248
13242,94511500,33280023,127791523,9,0,1,2560,12,1348065775
13243,94516040,23929101,118445141,6,0,0,2048,7,3443302352
13244,94530020,33319496,127849516,0,0,1,74240,3,10113753416
13245,94551259,23947083,118498342,3,0,0,24064,17,1635203950
13246,94551540,33312560,127864100,9,0,1,4096,12,4093065719
13247,94560070,23635302,118195372,6,0,0,512,7,3703226772
13248,94560489,23628632,118189121,3,0,0,24064,17,9336862553
13249,94571610,33441782,128013392,0,0,1,102400,3,9867613985
13250,94589039,23742098,118331137,3,0,0,28160,17,9711446042
13251,94591960,33433096,128025056,3,0,1,16896,17,2998845352
13252,94607440,23639295,118246735,6,0,0,512,7,8967504136
13253,94610830,33491771,128102601,3,0,1,3584,17,9865324012
13254,94612640,33507324,128119964,9,0,1,6144,12,8814164045
13255,94615390,33504776,128120166,3,0,1,2560,17,594942227
13256,94630049,23715728,118345777,1,0,0,1024,10,9162208233
13257,94637230,33544897,128182127,0,0,1,49152,3,3601088115
13258,94638590,23727692,118366282,6,0,0,512,7,7728474839
13259,94641130,33541020,128182150,9,0,1,4608,12,2721839275
13260,94648611,24362318,119010929,7,0,0,64000,10,712795882
13261,94652420,33564025,128216445,9,0,1,4608,12,9461809706
13262,94652699,33564412,128217111,4,0,1,11264,15,2154131361
13263,94658861,24735858,119394719,7,0,0,63488,10,7125706973
13264,94668429,24014064,118682493,1,0,0,39424,10,5024414195
13265,94670880,23801978,118472858,8,0,0,38912,8,792189968
13266,94687199,24039342,118726541,3,0,0,46592,17,3019568790
13267,94692850,33643849,128336699,0,0,1,95232,3,2196197250
13268,94699120,33642554,128341674,3,0,1,3072,17,5281222953
13269,94705140,23798043,118503183,6,0,0,1536,7,9129182462
13270,94707180,33735046,128442226,0,0,1,12800,3,3449292104
13271,94710990,33792512,128503502,9,0,1,11264,12,719101547
13272,94711699,23815084,118526783,3,0,0,27648,17,5532879265
13273,94713079,24479069,119192148,3,0,0,155136,17,3010961208
13274,94714300,23894064,118608364,6,0,0,512,7,9081482177
13275,94715950,33788858,128504808,3,0,1,2048,17,9412238886
13276,94718710,33786764,128505474,6,0,1,1024,7,4308831871
13277,94719180,33791440,128510620,9,0,1,8192,12,7415206529
13278,94724690,24516440,119241130,8,0,0,62976,8,5810293882
13279,94726341,24102284,118828625,7,0,0,4608,10,7970656001
13280,94726381,23976747,118703128,7,0,0,11776,10,233899367
13281,94729900,24339463,119069363,8,0,0,29696,8,162870864
13282,94729960,33782299,128512259,0,0,1,24064,3,9265046633
13283,94733830,23846452,118580282,6,0,0,512,7,8247480507
13284,94734331,24115240,118849571,7,0,0,5632,10,2204956342
13285,94736420,33788877,128525297,3,0,1,9216,17,3915105844
13286,94739330,33790473,128529803,6,0,1,7168,7,4340456452
13287,94746609,33801635,128548244,4,0,1,7680,15,6506730129
13288,94752760,33798710,128551470,9,0,1,5120,12,1200589311
13289,94754320,33800376,128554696,6,0,1,5120,7,10482210970
13290,94757659,24159511,118917170,1,0,0,15360,10,8523398767
13291,94760649,24116076,118876725,3,0,0,9216,17,5087428084
13292,94763909,24089022,118852931,3,0,0,1536,17,1295649440
13293,94768240,33976967,128745207,0,0,1,61440,3,5879018003
13294,94771250,33973980,128745230,6,0,1,10240,7,5798588545
13295,94771379,34081117,128852496,4,0,1,512,15,4947450498
13296,94777990,34074529,128852519,3,0,1,2048,17,3010137816
13297,94785579,34076050,128861629,4,0,1,8704,15,4119894369
13298,94786860,34078315,128865175,9,0,1,5632,12,3293061482
13299,94791800,24583544,119375344,8,0,0,7680,8,4970097889
13300,94803170,24246212,119049382,9,0,0,125952,12,5110858104
13301,94806429,34098917,128905346,4,0,1,512,15,9323050737
13302,94818100,34088552,128906652,9,0,1,2048,12,410582556
13303,94819680,24059252,118878932,9,0,0,7168,12,2857548592
13304,94821410,34088468,128909878,7,0,1,5120,10,6247062942
13305,94837620,34073641,128911261,9,0,1,14848,12,4280309137
13306,94869629,24612662,119482291,3,0,0,54272,17,7421211545
13307,94874350,34088805,128963155,9,0,1,11264,12,7310042461
13308,94877290,24229995,119107285,8,0,0,48128,8,8655477628
13309,94879460,23974757,118854217,6,0,0,512,7,67512269
13310,94882600,34096985,128979585,3,0,1,5120,17,4610654243
13311,94884131,24193570,119077701,7,0,0,27136,10,1106163686
13312,94890159,24170087,119060246,1,0,0,35328,10,1980801364
13313,94899960,23986380,118886340,8,0,0,11264,8,1899940623
13314,94914289,24201809,119116098,1,0,0,25600,10,2298999679
13315,94926699,24290166,119216865,3,0,0,34816,17,8795886230
13316,94945550,24045856,118991406,9,0,0,40960,12,2768064849
13317,94952900,24420081,119372981,8,0,0,17920,8,362661522
13318,94957409,24248825,119206234,3,0,0,20992,17,3324833893
13319,94969490,23912811,118882301,6,0,0,1024,7,515151265
13320,94969870,34009869,128979739,9,0,1,8704,12,4992232068
13321,94973439,34006646,128980085,4,0,1,512,15,2618252366
13322,94988090,24119382,119107472,6,0,0,512,7,1345064969
13323,94992720,33988543,128981263,9,0,1,13824,12,7556202712
13324,95007670,33984391,128992061,9,0,1,1536,12,4419070881
13325,95014100,24549589,119563689,8,0,0,81408,8,3143761822
13326,95017089,24238439,119255528,3,0,0,20992,17,9447362554
13327,95051019,33988387,129039406,4,0,1,1024,15,5057236381
13328,95064450,33977222,129041672,9,0,1,3584,12,9068950035
13329,95065181,34001852,129067033,5,0,1,11776,10,7927288862
13330,95066749,34116100,129182849,4,0,1,1024,15,953921817
13331,95067090,34144069,129211159,9,0,1,11776,12,3632155115
13332,95070419,24151461,119221880,1,0,0,16384,10,6890167592
13333,95073160,24429716,119502876,8,0,0,65536,8,8746262035
13334,95092261,24156848,119249109,7,0,0,26112,10,7579047508
13335,95104830,24262668,119367498,9,0,0,60928,12,10180534320
13336,95121150,24442734,119563884,6,0,0,512,7,9833910496
13337,95127060,24636732,119763792,9,0,0,83456,12,1410274532
13338,95135170,34076335,129211505,9,0,1,512,12,5671584883
13339,95141611,24449775,119591386,7,0,0,89600,10,6627411732
13340,95144780,24394059,119538839,8,0,0,23040,8,4504130060
13341,95146850,24196143,119342993,6,0,0,1536,7,7024332339
13342,95148220,24699265,119847485,9,0,0,5120,12,1333297285
13343,95157201,24733274,119890475,7,0,0,59392,10,8722121739
13344,95161259,24509056,119670315,1,0,0,75264,10,1061956965
13345,95163230,24170437,119333667,8,0,0,1024,8,2790623868
13346,95165990,24337065,119503055,6,0,0,512,7,10544046690
13347,95166910,23941365,119108275,6,0,0,2560,7,5221518132
13348,95174940,24790319,119965259,9,0,0,99840,12,4823738813
13349,95175821,34039230,129215051,5,0,1,5632,10,8177828941
13350,95178020,24521178,119699198,2,0,0,94720,3,3923438460
13351,95186541,24551800,119738341,7,0,0,38400,10,4098951751
13352,95191731,34108569,129300300,5,0,1,5120,10,4072174670
13353,95195450,24905363,120100813,9,0,0,17408,12,958713557
13354,95196991,34103332,129300323,5,0,1,512,10,3444926716
13355,95196999,24616520,119813519,3,0,0,1536,17,4391226089
13356,95200479,34099867,129300346,4,0,1,1024,15,9002722000
13357,95202739,34097630,129300369,4,0,1,9216,15,6321427649
13358,95203229,24581511,119784740,3,0,0,6656,17,6098499381
13359,95208560,34153807,129362367,9,0,1,3584,12,6415376302
13360,95212179,34152774,129364953,4,0,1,4096,15,9967406671
13361,95221781,24574549,119796330,7,0,0,37888,10,9979911782
13362,95231591,24703225,119934816,7,0,0,129024,10,3125265313
13363,95236100,24764268,120000368,6,0,0,2048,7,9813577879
13364,95241109,24749518,119990627,1,0,0,78336,10,6950933793
13365,95243150,24359823,119602973,6,0,0,512,7,2530883328
13366,95246161,24467659,119713820,7,0,0,1536,10,1088604225
13367,95246259,34118950,129365209,4,0,1,9216,15,10245402531
13368,95261290,24704286,119965576,6,0,0,512,7,8948471517
13369,95265261,24133397,119398658,7,0,0,12800,10,4812922764
13370,95266139,34117718,129383857,4,0,1,11264,15,5444737708
13371,95272460,34112383,129384843,9,0,1,1536,12,2773944072
13372,95274181,34111328,129385509,5,0,1,1024,10,6486195918
13373,95282220,24481751,119763971,6,0,0,512,7,190256934
13374,95298700,34161607,129460307,0,0,1,62976,3,5253710309
13375,95301549,34163904,129465453,4,0,1,8192,15,8787349290
13376,95307941,34176727,129484668,5,0,1,6144,10,3336401976
13377,95314879,24817310,120132189,1,0,0,36864,10,10085068605
13378,95314950,24249113,119564063,8,0,0,512,8,4344509515
13379,95317110,24207312,119524422,9,0,0,34304,12,4550095255
13380,95319490,34203443,129522933,9,0,1,1536,12,85511875
13381,95326020,34196936,129522956,9,0,1,3072,12,2735440486
13382,95329801,34193178,129522979,5,0,1,8192,10,7872881122
13383,95331310,24451379,119782689,8,0,0,54784,8,1163546974
13384,95334941,34188061,129523002,5,0,1,2048,10,1124591751
13385,95334980,24365957,119700937,9,0,0,5632,12,459350526
13386,95345761,34225158,129570919,5,0,1,16384,10,8382819616
13387,95349660,34224070,129573730,9,0,1,4608,12,9499876324
13388,95358330,34262875,129621205,0,0,1,38912,3,5691929701
13389,95373059,34280927,129653986,4,0,1,5120,15,6126084435
13390,95375410,34278599,129654009,9,0,1,3072,12,1280636323
13391,95376680,34325081,129701761,0,0,1,46592,3,7822864102
13392,95377130,24623650,120000780,6,0,0,1024,7,8760202387
13393,95378719,24434232,119812951,1,0,0,54272,10,6798544547
13394,95382129,34322218,129704347,4,0,1,4096,15,5541202453
13395,95382499,24763724,120146223,1,0,0,43520,10,1004412662
13396,95391070,34382842,129773912,0,0,1,14336,3,10118884102
13397,95397360,34399192,129796552,9,0,1,512,12,10081670087
13398,95401889,34400155,129802044,4,0,1,17920,15,544400981
13399,95408169,24409429,119817598,1,0,0,13312,10,8678190034
13400,95412781,34413501,129826282,5,0,1,6656,10,924029421
13401,95415960,34427101,129843061,9,0,1,4608,12,4100878579
13402,95416660,24401186,119817846,6,0,0,512,7,4285830672
13403,95419950,24579748,119999698,8,0,0,29696,8,8233466652
13404,95420350,24400015,119820365,8,0,0,8192,8,881206118
13405,95423160,34443508,129866668,0,0,1,41984,3,487529626
13406,95439071,34442210,129881281,5,0,1,512,10,1382430639
13407,95446720,34434584,129881304,0,0,1,9216,3,10487229477
13408,95447220,34542816,129990036,9,0,1,2560,12,9837277294
13409,95450310,24515560,119965870,6,0,0,512,7,3954572921
13410,95450850,34622339,130073189,0,0,1,68608,3,6008349346
13411,95459911,25156439,120616350,7,0,0,165888,10,10473581653
13412,95474430,34601025,130075455,9,0,1,3584,12,2823388440
13413,95475929,24619557,120095486,3,0,0,45056,17,7813297038
13414,95496570,24686198,120182768,8,0,0,11776,8,3774994968
13415,95496621,24397264,119893885,7,0,0,512,10,4145701048
13416,95506170,34571203,130077373,2,0,1,512,3,3317719062
13417,95506430,34830112,130336542,0,0,1,81920,3,3709874882
13418,95509321,34827244,130336565,5,0,1,1024,10,86769439
13419,95513529,24650767,120164296,1,0,0,27648,10,3495446551
13420,95517640,34994730,130512370,0,0,1,46592,3,3989345326
13421,95520560,34993436,130513996,6,0,1,2560,7,4385660700
13422,95522251,34992091,130514342,5,0,1,512,10,3912533760
13423,95529130,24792768,120321898,6,0,0,1024,7,3574036169
13424,95531641,34984007,130515648,5,0,1,2048,10,3411750784
13425,95539670,24664514,120204184,8,0,0,17408,8,5613939266
13426,95541309,24767013,120308322,3,0,0,5120,17,9804649465
13427,95544020,24685069,120229089,6,0,0,4096,7,4002699076
13428,95544271,35144418,130688689,5,0,1,20992,10,3445533644
13429,95546910,24774329,120321239,6,0,0,1024,7,6043682636
13430,95547369,24714402,120261771,3,0,0,65024,17,9946149468
13431,95549149,35142766,130691915,4,0,1,5120,15,1797005701
13432,95553541,35169611,130723152,5,0,1,8192,10,601864149
13433,95560179,24756797,120316976,3,0,0,22528,17,5911971973
13434,95562920,35231054,130793974,0,0,1,47616,3,1592797988
13435,95567779,24695146,120262925,1,0,0,3584,10,9620788374
13436,95571459,35222538,130793997,4,0,1,4096,15,9564879652
13437,95572300,35221720,130794020,6,0,1,12800,7,9887830627
13438,95579859,35240998,130820857,4,0,1,1024,15,9879920197
13439,95583120,24650874,120233994,8,0,0,14848,8,8287475001
13440,95587211,24533723,120120934,7,0,0,27136,10,7703410614
13441,95588509,24653404,120241913,1,0,0,24576,10,9395938820
13442,95606870,35245244,130852114,6,0,1,3584,7,2427004365
13443,95607901,35244236,130852137,5,0,1,512,10,273745524
13444,95620470,35231690,130852160,6,0,1,3584,7,3677826681
13445,95620680,25057138,120677818,9,0,0,85504,12,7795647107
13446,95624210,25005756,120629966,6,0,0,512,7,5878392205
13447,95625299,35226884,130852183,4,0,1,2048,15,9858174279
13448,95627181,35239400,130866581,5,0,1,1536,10,32848210
13449,95630720,35237210,130867930,9,0,1,512,12,4318291177
13450,95650050,24577768,120227818,8,0,0,55296,8,8811596444
13451,95658750,24660232,120318982,6,0,0,1536,7,6922578628
13452,95661659,35206294,130867953,4,0,1,10240,15,10202617693
13453,95664881,24754596,120419477,7,0,0,45056,10,7037735732
13454,95665570,35311869,130977439,9,0,1,4608,12,6770255654
13455,95665730,35311732,130977462,6,0,1,2048,7,9426393373
13456,95669180,24560244,120229424,6,0,0,1024,7,3153011142
13457,95675149,24748453,120423602,3,0,0,2048,17,64815008
13458,95676480,24592316,120268796,6,0,0,512,7,1292865921
13459,95685909,35304235,130990144,4,0,1,7680,15,3957293758
13460,95686319,24656856,120343175,3,0,0,27648,17,5716142865
13461,95690610,25036947,120727557,9,0,0,23552,12,9003418931
13462,95694810,35295357,130990167,0,0,1,9728,3,5372945664
13463,95699019,35291662,130990681,4,0,1,6144,15,7455051691
13464,95721210,24710411,120431621,9,0,0,14336,12,3985162800
13465,95725191,35295839,131021030,5,0,1,3584,10,2457905924
13466,95727739,24992619,120720358,1,0,0,36352,10,7299084861
13467,95730821,35290232,131021053,5,0,1,512,10,7009506112
13468,95734080,35286996,131021076,6,0,1,5632,7,3252771813
13469,95736909,35284190,131021099,4,0,1,4608,15,5264175120
13470,95736979,24620543,120357522,1,0,0,15360,10,213888481
13471,95741391,35279731,131021122,5,0,1,1536,10,8539254396
13472,95750789,35270356,131021145,4,0,1,512,15,705631348
13473,95750881,35270311,131021192,5,0,1,14848,10,4865582209
13474,95769070,35352308,131121378,0,0,1,64000,3,2875935988
13475,95775050,35500896,131275946,0,0,1,47104,3,509117124
13476,95776170,24692028,120468198,6,0,0,512,7,3281711723
13477,95777321,24566657,120343978,7,0,0,2560,10,3550634102
13478,95787489,24778202,120565691,3,0,0,100352,17,5951308340
13479,95801469,35474835,131276304,4,0,1,5632,15,6129502447
13480,95809681,35478252,131287933,5,0,1,512,10,1217522931
13481,95812620,24518547,120331167,6,0,0,512,7,4250237700
13482,95813091,24609864,120422955,7,0,0,6656,10,6098644525
13483,95815451,24605453,120420904,7,0,0,4608,10,7862415527
13484,95817031,35473808,131290839,5,0,1,4608,10,1855246326
13485,95843270,35467827,131311097,6,0,1,2048,7,4508133851
13486,95843699,35470624,131314323,4,0,1,5120,15,5825676456
13487,95851879,35465383,131317262,4,0,1,3072,15,9156262833
13488,95854431,35462854,131317285,5,0,1,9216,10,4207140510
13489,95888640,24939088,120827728,8,0,0,29696,8,10283810884
13490,95892409,35446180,131338589,4,0,1,512,15,441779774
13491,95898869,35440386,131339255,4,0,1,1024,15,8803116321
13492,95908691,35431230,131339921,5,0,1,1024,10,7059613129
13493,95917330,35429758,131347088,0,0,1,20480,3,8403426284
13494,95923250,24542283,120465533,6,0,0,1024,7,373078437
13495,95930399,24885257,120815656,3,0,0,10240,17,5180390536
13496,95931000,35521207,131452207,0,0,1,95744,3,5370851844
13497,95932420,25006216,120938636,9,0,0,47616,12,6824878116
13498,95935769,35516461,131452230,4,0,1,2560,15,8377785624
13499,95936530,35515723,131452253,6,0,1,2048,7,4290012759
13500,95940510,24689277,120629787,8,0,0,43520,8,3232799988
13501,95958971,35493305,131452276,5,0,1,9216,10,5227638354
13502,95959839,35496265,131456104,4,0,1,5632,15,8296575539
13503,95963560,35681446,131645006,0,0,1,106496,3,9147558763
13504,95966350,35679201,131645551,9,0,1,2048,12,348980645
13505,95969871,35675703,131645574,5,0,1,512,10,2858456837
13506,95971030,35676556,131647586,6,0,1,5632,7,6374319957
13507,95976590,24719306,120695896,9,0,0,58880,12,10311553181
13508,95984620,35765313,131749933,0,0,1,71680,3,3997554461
13509,95988310,35826246,131814556,0,0,1,87552,3,10553057446
13510,96007750,36059350,132067100,0,0,1,194048,3,3161574680
13511,96012320,24880742,120893062,6,0,0,1024,7,7982675604
13512,96016049,36051074,132067123,4,0,1,8192,15,9759772370
13513,96026409,36071208,132097617,4,0,1,1024,15,10600990404
13514,96051311,36049532,132100843,5,0,1,5120,10,6031524462
13515,96053949,25010959,121064908,3,0,0,16896,17,7515480435
13516,96072160,36050145,132122305,8,0,1,30720,8,4347533473
13517,96079270,24737341,120816611,6,0,0,512,7,9948782840
13518,96080539,24801885,120882424,3,0,0,22528,17,4046231580
13519,96090239,25046221,121136460,3,0,0,29184,17,3841543582
13520,96093500,24544193,120637693,9,0,0,24576,12,4470746133
13521,96101620,36026330,132127950,6,0,1,4608,7,7386715951
13522,96103610,36089738,132193348,8,0,1,50176,8,2134469693
13523,96103980,25043579,121147559,8,0,0,36352,8,3186576887
13524,96110439,25149609,121260048,3,0,0,176128,17,4347956749
13525,96122101,25034856,121156957,7,0,0,13312,10,8507133262
13526,96129039,36064332,132193371,4,0,1,512,15,2850415389
13527,96152009,24924622,121076631,3,0,0,38400,17,2677967349
13528,96153201,36040193,132193394,5,0,1,2560,10,3333850283
13529,96159720,36033697,132193417,6,0,1,5120,7,6147995203
13530,96163460,24915690,121079150,8,0,0,512,8,2362303053
13531,96186159,36009644,132195803,4,0,1,3584,15,6990123828
13532,96190029,25078881,121268910,3,0,0,20480,17,2113645025
13533,96190760,24920951,121111711,6,0,0,2048,7,433789256
13534,96190799,36005027,132195826,4,0,1,512,15,7777048683
13535,96204720,35991129,132195849,6,0,1,5120,7,5321808800
13536,96207700,35988172,132195872,6,0,1,13312,7,487413086
13537,96208160,24763619,120971779,9,0,0,5632,12,9522477905
13538,96221171,25154513,121375684,7,0,0,30720,10,9633648758
13539,96244020,24951442,121195462,9,0,0,100864,12,4096429160
13540,96249090,24950239,121199329,8,0,0,1536,8,2266253185
13541,96255589,35946856,132202445,4,0,1,512,15,7215255811
13542,96259220,24623695,120882915,6,0,0,1536,7,10035312080
13543,96272691,24787046,121059737,7,0,0,34816,10,8175303605
13544,96287729,24682311,120970040,3,0,0,95232,17,4981545044
13545,96297061,24901777,121198838,7,0,0,10752,10,7472143829
13546,96299770,24780183,121079953,9,0,0,2560,12,7446000400
13547,96314059,25117230,121431289,3,0,0,182272,17,6247055325
13548,96326830,35897206,132224036,8,0,1,50176,8,6142020752
13549,96331320,24591904,120923224,6,0,0,512,7,8700639674
13550,96334999,24743099,121078098,3,0,0,4608,17,1945595329
13551,96337469,35910707,132248176,4,0,1,4608,15,8300097283
13552,96341420,35925762,132267182,8,0,1,41472,8,1426938790
13553,96343731,35926677,132270408,5,0,1,5120,10,408419806
13554,96359660,35933331,132292991,0,0,1,68608,3,514275766
13555,96365449,25534455,121899904,3,0,0,2048,17,2688678469
13556,96366150,36008069,132374219,8,0,1,68608,8,6208020256
13557,96366771,24661343,121028114,7,0,0,9728,10,3627196641
13558,96371779,36003426,132375205,4,0,1,1536,15,3479220507
13559,96384289,35992222,132376511,4,0,1,2048,15,7304951925
13560,96387510,24585228,120972738,8,0,0,3072,8,5814575398
13561,96392330,24599986,120992316,6,0,0,2560,7,1959416939
13562,96393310,24807684,121200994,6,0,0,1024,7,1632170758
13563,96399121,35978056,132377177,5,0,1,1024,10,6893565995
13564,96399169,35979762,132378931,4,0,1,13312,15,7302679622
13565,96404809,36037766,132442575,4,0,1,31232,15,9137245928
13566,96410480,24611996,121022476,8,0,0,1024,8,2985070357
13567,96415150,36088519,132503669,0,0,1,57856,3,7271895366
13568,96419380,36084312,132503692,0,0,1,1024,3,4494961872
13569,96419730,25106627,121526357,9,0,0,35840,12,2959231387
13570,96430150,36073565,132503715,9,0,1,13824,12,8713748135
13571,96445810,36176645,132622455,0,0,1,93184,3,7700715895
13572,96461019,36189673,132650692,4,0,1,5632,15,1879051017
13573,96462219,36188496,132650715,4,0,1,2048,15,188002589
13574,96464680,24640975,121105655,8,0,0,512,8,7940739368
13575,96468820,36227837,132696657,0,0,1,38400,3,8539624318
13576,96470711,36225969,132696680,5,0,1,1536,10,7044763008
13577,96478980,36258291,132737271,0,0,1,106496,3,5269847330
13578,96482779,24620451,121103230,3,0,0,3072,17,10649106615
13579,96494700,24963450,121458150,9,0,0,87552,12,89762233
13580,96507710,36266246,132773956,0,0,1,44544,3,8112393487
13581,96509620,36412785,132922405,0,0,1,135168,3,2114998739
13582,96522979,36411798,132934777,4,0,1,9216,15,7376803482
13583,96536931,36411790,132948721,5,0,1,5632,10,2973242164
13584,96537191,36411553,132948744,5,0,1,512,10,9318620656
13585,96537930,36475148,133013078,0,0,1,108032,3,4225807628
13586,96543820,36471528,133015348,9,0,1,17920,12,6907461870
13587,96551820,36477369,133029189,9,0,1,3072,12,10557606893
13588,96553090,36531508,133084598,8,0,1,102912,8,8565738376
13589,96555300,36598705,133154005,0,0,1,56320,3,3303579135
13590,96558450,25462358,122020808,9,0,0,230912,12,7420009414
13591,96580330,36616194,133196524,8,0,1,70656,8,6775698251
13592,96580971,36627067,133208038,5,0,1,3584,10,10133698127
13593,96581740,36629204,133210944,8,0,1,4608,8,2856823970
13594,96591050,36712685,133303735,8,0,1,86528,8,7051293281
13595,96594390,24865467,121459857,8,0,0,1024,8,1539193196
13596,96600039,25530965,122131004,3,0,0,113152,17,522290203
13597,96605430,25011436,121616866,8,0,0,512,8,7673262194
13598,96618439,25593210,122211649,3,0,0,59392,17,2993486286
13599,96624911,36685090,133310001,5,0,1,7168,10,7281210107
13600,96631600,25268685,121900285,6,0,0,1024,7,1190721759
13601,96636050,36692205,133328255,0,0,1,48128,3,9914286748
13602,96638731,24820791,121459522,7,0,0,2560,10,7186053644
13603,96653530,24805189,121458719,8,0,0,1536,8,1808512083
13604,96658780,36671881,133330661,6,0,1,2048,7,987123097
13605,96662730,24863962,121526692,8,0,0,1024,8,8839762079
13606,96668380,36667978,133336358,6,0,1,18944,7,7802889619
13607,96674480,36702266,133376746,0,0,1,25600,3,7340957304
13608,96680341,24685937,121366278,7,0,0,24576,10,3245483049
13609,96688700,36704971,133393671,9,0,1,15872,12,7882550669
13610,96691950,36701744,133393694,8,0,1,12800,8,7327795893
13611,96692290,36709102,133401392,0,0,1,33792,3,2841502012
13612,96694139,36749547,133443686,4,0,1,4608,15,7470798124
13613,96705320,36738389,133443709,9,0,1,12288,12,6773418759
13614,96709080,25084668,121793748,8,0,0,1536,8,9576274869
13615,96735519,24948920,121684439,3,0,0,125952,17,4883014862
13616,96740360,24944795,121685155,6,0,0,512,7,9962732031
13617,96749229,36694503,133443732,4,0,1,1024,15,7138090798
13618,96758919,36684836,133443755,4,0,1,512,15,7173095287
13619,96762360,25265819,122028179,9,0,0,24064,12,10054924146
13620,96770860,36672918,133443778,9,0,1,9728,12,3405724034
13621,96777520,24956570,121734090,8,0,0,2560,8,8169667269
13622,96782970,36695830,133478800,9,0,1,3072,12,608229000
13623,96784280,25065998,121850278,9,0,0,50688,12,4471235651
13624,96795830,36688769,133484599,9,0,1,19456,12,6892444599
13625,96798769,25523722,122322491,3,0,0,159232,17,8027609391
13626,96809880,36684330,133494210,9,0,1,4096,12,6983876972
13627,96813100,36697813,133510913,9,0,1,3072,12,9804878398
13628,96813329,36697607,133510936,4,0,1,4096,15,505795555
13629,96824830,36690974,133515804,6,0,1,38400,7,8261419641
13630,96831430,24878779,121710209,8,0,0,1024,8,2725533330
13631,96832120,36695857,133527977,6,0,1,7680,7,363744610
13632,96842411,24688363,121530774,7,0,0,7680,10,2027949103
13633,96844730,36683270,133528000,9,0,1,10752,12,8262367348
13634,96845900,36682123,133528023,6,0,1,512,7,9789322532
13635,96850650,36731060,133581710,0,0,1,34816,3,10675693105
13636,96857529,36737548,133595077,4,0,1,2560,15,10669828080
13637,96860089,36735756,133595845,4,0,1,11776,15,8943437187
13638,96872271,36752391,133624662,5,0,1,2048,10,560790959
13639,96883491,25015766,121899257,7,0,0,143360,10,9244842680
13640,96888351,25013095,121901446,7,0,0,3584,10,9912328405
13641,96892020,24675521,121567541,6,0,0,512,7,5494100956
13642,96899180,24868712,121767892,6,0,0,1024,7,5086823790
13643,96903070,25351727,122254797,9,0,0,74752,12,10054465719
13644,96905950,36722258,133628208,6,0,1,5632,7,9689159553
13645,96912441,36725644,133638085,5,0,1,512,10,6115850593
13646,96913660,36724448,133638108,6,0,1,1024,7,4882044378
13647,96917359,25146355,122063714,3,0,0,61440,17,8054354610
13648,96934139,36703992,133638131,4,0,1,1024,15,8663120364
13649,96934660,36798718,133733378,0,0,1,90112,3,4916129244
13650,96937690,24747286,121684976,8,0,0,1536,8,4339023636
13651,96945689,24970386,121916075,3,0,0,20992,17,7474791657
13652,96963710,37150342,134114052,0,0,1,186368,3,8419688659
13653,96968270,37145805,134114075,9,0,1,1536,12,8977325375
13654,96969230,37144868,134114098,9,0,1,14848,12,6902166364
13655,96972960,37141161,134114121,0,0,1,11776,3,9785523246
13656,96978929,37165888,134144817,4,0,1,9216,15,2074203326
13657,96980649,24942723,121923372,3,0,0,18944,17,8853981996
13658,96986420,37205744,134192164,0,0,1,29184,3,1073571242
13659,96996910,37198480,134195390,9,0,1,5120,12,3958490145
13660,97000150,37199362,134199512,9,0,1,512,12,6232672766
13661,97000890,37203768,134204658,6,0,1,8192,7,43247184
13662,97023711,25323275,122346986,7,0,0,18432,10,1779930132
13663,97027450,24876547,121903997,9,0,0,8192,12,2554224723
13664,97033709,37191143,134224852,4,0,1,8704,15,6237204442
13665,97040801,37193220,134234021,5,0,1,3584,10,3331392751
13666,97049540,37186747,134236287,6,0,1,3584,7,8897537435
13667,97051690,37261841,134313531,0,0,1,31744,3,5179625028
13668,97056580,24793877,121850457,6,0,0,512,7,2605784235
13669,97061269,25170642,122231911,3,0,0,19456,17,8760768746
13670,97061460,37254017,134315477,6,0,1,3072,7,2581728601
13671,97062900,24980769,122043669,9,0,0,50688,12,2823201703
13672,97062940,37258747,134321687,9,0,1,5632,12,8899986216
13673,97064620,37260613,134325233,0,0,1,5632,3,3384563939
13674,97067820,37258399,134326219,6,0,1,1536,7,5935935835
13675,97067899,37262826,134330725,4,0,1,7168,15,1970196130
13676,97069660,37261321,134330981,1,0,1,9216,10,4480296364
13677,97072120,24844768,121916888,6,0,0,512,7,2197393256
13678,97079760,24965203,122044963,6,0,0,2560,7,5053724932
13679,97081730,25111708,122193438,9,0,0,80896,12,10108717915
13680,97081790,37250177,134331967,1,0,1,1536,10,8069418964
13681,97087319,24956841,122044160,3,0,0,1536,17,533519876
13682,97098719,25126369,122225088,3,0,0,44032,17,8828146243
13683,97102259,25313930,122416189,3,0,0,49152,17,5233720853
13684,97107020,37271296,134378316,1,0,1,20992,10,9293310585
13685,97110270,37268069,134378339,1,0,1,6656,10,1603088542
13686,97120070,25471102,122591172,5,0,0,101376,10,1629785250
13687,97125011,25207735,122332746,7,0,0,16384,10,8896626815
13688,97149459,37229082,134378541,4,0,1,9728,15,1904612723
13689,97150150,37228414,134378564,6,0,1,2560,7,1443376566
13690,97150279,37228308,134378587,4,0,1,8704,15,9894475736
13691,97156000,37222610,134378610,6,0,1,2560,7,2982386083
13692,97159450,24971733,122131183,8,0,0,512,8,1808363788
13693,97167030,37329397,134496427,0,0,1,107520,3,5250651563
13694,97169610,37353396,134523006,6,0,1,2048,7,8823845319
13695,97170740,24998027,122168767,9,0,0,57344,12,1266879850
13696,97171470,37367792,134539262,9,0,1,2048,12,5618036568
13697,97172740,37372391,134545131,9,0,1,3584,12,8590848732
13698,97175860,25349339,122525199,5,0,0,14336,10,1931959295
13699,97182620,25043271,122225891,9,0,0,2560,12,6706596740
13700,97185570,37359584,134545154,6,0,1,512,7,9942658397
13701,97187610,25140075,122327685,8,0,0,1024,8,10504070249
13702,97188760,37415120,134603880,0,0,1,42496,3,1472606414
13703,97194510,37411316,134605826,9,0,1,3072,12,7780302006
13704,97197519,25129831,122327350,3,0,0,15872,17,2544654309
13705,97199890,25074008,122273898,5,0,0,62464,10,4565163310
13706,97213120,37394652,134607772,1,0,1,3072,10,3196492294
13707,97213596,37571241,134784837,0,0,1,170496,3,6206389227
13708,97222630,37589160,134811790,0,0,1,10752,3,2885666951
13709,97224440,37587373,134811813,9,0,1,1536,12,8688921410
13710,97225230,37586606,134811836,6,0,1,10752,7,9518844706
13711,97227250,25333011,122560261,6,0,0,3584,7,3653945609
13712,97240800,37577206,134818006,1,0,1,2560,10,1026558523
13713,97241620,37771795,135013415,0,0,1,75776,3,2531456975
13714,97272820,37740618,135013438,9,0,1,3072,12,8346334418
13715,97293270,37738466,135031736,9,0,1,3584,12,4502961704
13716,97295151,25183840,122478991,7,0,0,20480,10,1690803265
13717,97298790,37897807,135196597,0,0,1,202752,3,536499107
13718,97306190,37894273,135200463,6,0,1,6144,7,5142352424
13719,97311980,25089210,122401190,5,0,0,40448,10,3367700517
13720,97318520,37889256,135207776,9,0,1,3584,12,7847149922
13721,97319850,37931814,135251664,9,0,1,4608,12,6658584373
13722,97322920,25601069,122923989,9,0,0,36352,12,10509243844
13723,97325931,25142837,122468768,7,0,0,23040,10,6657672649
13724,97334400,25490175,122824575,6,0,0,3584,7,4726486747
13725,97341590,37910097,135251687,9,0,1,3584,12,1552858217
13726,97342980,37908730,135251710,9,0,1,6656,12,1842997797
13727,97344320,25075012,122419332,5,0,0,10240,10,5367946230
13728,97345030,37919703,135264733,0,0,1,24576,3,5752650289
13729,97346190,37944707,135290897,9,0,1,8192,12,5184957395
13730,97346620,37949783,135296403,0,0,1,28160,3,3885950111
13731,97346990,37950604,135297594,1,0,1,3072,10,2406239972
13732,97350420,25247329,122597749,9,0,0,11776,12,6470140520
13733,97354580,25023712,122378292,8,0,0,1024,8,10091270311
13734,97355050,37944490,135299540,6,0,1,3072,7,4967527020
13735,97356600,25177046,122533646,5,0,0,27648,10,4941175171
13736,97365550,25265316,122630866,6,0,0,36864,7,8387838080
13737,97370400,25188746,122559146,5,0,0,29184,10,6886992933
13738,97372420,25087578,122459998,6,0,0,7680,7,2931182470
13739,97375551,25593363,122968914,7,0,0,4096,10,9300102384
13740,97383250,25214834,122598084,8,0,0,1024,8,306906209
13741,97387440,25357877,122745317,6,0,0,22016,7,9398324401
13742,97400490,25202048,122602538,8,0,0,512,8,1601968601
13743,97404460,25396891,122801351,9,0,0,8192,12,8737701029
13744,97405640,37988653,135394293,0,0,1,32768,3,10570555596
13745,97408330,25183021,122591351,8,0,0,512,8,2239293750
13746,97419759,25272408,122692167,3,0,0,66048,17,3012556448
13747,97436670,38195360,135632030,0,0,1,108032,3,2269486855
13748,97440460,25327785,122768245,6,0,0,21504,7,3595649652
13749,97441310,25265093,122706403,5,0,0,41472,10,8129866058
13750,97444150,38187903,135632053,7,0,1,1024,10,6153103062
13751,97463400,38168855,135632255,7,0,1,5120,10,7003836072
13752,97477080,38155198,135632278,1,0,1,5120,10,6396460500
13753,97478840,38153461,135632301,0,0,1,13824,3,7711210633
13754,97479300,38204755,135684055,9,0,1,14336,12,6782051077
13755,97484010,38200391,135684401,7,0,1,512,10,1119783900
13756,97493900,38192447,135686347,7,0,1,3072,10,9761092460
13757,97509540,38239738,135749278,0,0,1,31232,3,1433609582
13758,97522970,38226331,135749301,7,0,1,2048,10,1036044121
13759,97546420,38202904,135749324,9,0,1,1024,12,5028695420
13760,97552320,38197027,135749347,1,0,1,2048,10,3655138760
13761,97555589,25235711,122791300,3,0,0,23040,17,5992424505
13762,97558320,38191050,135749370,7,0,1,1024,10,6175353611
13763,97566760,38182633,135749393,1,0,1,3584,10,9407361030
13764,97567280,38182136,135749416,2,0,1,20992,3,1180413912
13765,97569310,38180129,135749439,2,0,1,3584,3,4111666322
13766,97570410,38179052,135749462,1,0,1,1024,10,2305386080
13767,97573250,25248849,122822099,5,0,0,10752,10,2099797682
13768,97593790,25603052,123196842,6,0,0,84480,7,8363933841
13769,97596040,25164785,122760825,9,0,0,42496,12,2929371387
13770,97601520,38148354,135749874,6,0,1,4608,7,5627488983
13771,97621520,38129660,135751180,7,0,1,2048,10,310061907
13772,97630550,38122896,135753446,7,0,1,3584,10,5352752488
13773,97634950,25293114,122928064,8,0,0,2048,8,3583848297
13774,97636360,38117432,135753792,9,0,1,512,12,2078883092
13775,97636550,38119188,135755738,6,0,1,3072,7,1588322895
13776,97643650,25386914,123030564,6,0,0,8704,7,6069399514
13777,97645920,38132049,135777969,1,0,1,20992,10,1510953274
13778,97647510,38130482,135777992,1,0,1,8192,10,8369636201
13779,97655180,25474249,123129429,5,0,0,34304,10,5241478054
13780,97660010,25167043,122827053,8,0,0,512,8,7030040102
13781,97662259,25551091,123213350,3,0,0,39936,17,4315968355
13782,97672851,25198444,122871295,7,0,0,10752,10,8418112401
13783,97673020,25444507,123117527,5,0,0,81408,10,7425479921
13784,97679009,25217048,122896057,3,0,0,10240,17,1872941167
13785,97686650,38091365,135778015,1,0,1,8704,10,9177888054
13786,97688390,25382360,123070750,5,0,0,25600,10,7460816498
13787,97694130,25502891,123197021,8,0,0,512,8,10590173917
13788,97695600,38082438,135778038,7,0,1,3072,10,7576280624
13789,97699280,25576429,123275709,9,0,0,1536,12,931148489
13790,97700871,25391829,123092700,7,0,0,26112,10,9782347458
13791,97702220,25572998,123275218,5,0,0,103424,10,3040906325
13792,97703810,38074251,135778061,1,0,1,512,10,4797048877
13793,97705360,38072724,135778084,7,0,1,512,10,7862304064
13794,97706390,25687889,123394279,5,0,0,86528,10,3937711952
13795,97706990,38081229,135788219,7,0,1,13824,10,1690335719
13796,97709040,38080805,135789845,9,0,1,2560,12,9544522466
13797,97714531,25600270,123314801,7,0,0,48128,10,1737344312
13798,97718220,38076451,135794671,6,0,1,7680,7,8494419005
13799,97719180,25504154,123223334,9,0,0,7168,12,2005740691
13800,97722330,38078023,135800353,6,0,1,7168,7,8523809955
13801,97728900,38075319,135804219,6,0,1,6144,7,8628717151
13802,97730640,38080392,135811032,6,0,1,6144,7,10543300197
13803,97734840,38078458,135813298,1,0,1,3584,10,7976907478
13804,97738380,25505257,123243637,5,0,0,66560,10,3318957006
13805,97747270,25116671,122863941,5,0,0,5632,10,4455416300
13806,97750249,26125437,123875686,3,0,0,78336,17,9411094218
13807,97757640,38057284,135814924,9,0,1,2560,12,929029462
13808,97758781,25670213,123428994,7,0,0,55808,10,6003034018
13809,97761020,38058730,135819750,0,0,1,7680,3,8969013227
13810,97765040,25274148,123039188,9,0,0,9728,12,9939058704
13811,97767590,38053786,135821376,3,0,1,2560,17,5008620715
13812,97772850,38048987,135821837,1,0,1,10240,10,2961024905
13813,97775270,25693815,123469085,5,0,0,48128,10,4067305268
13814,97784290,38072396,135856686,0,0,1,62464,3,6920270777
13815,97785300,26022808,123808108,8,0,0,1024,8,5052622070
13816,97790370,38066662,135857032,9,0,1,512,12,1074688537
13817,97791170,38066208,135857378,9,0,1,512,12,9594726169
13818,97792530,25619429,123411959,5,0,0,27648,10,6986310188
13819,97793760,25872820,123666580,5,0,0,47104,10,1689658255
13820,97798420,38060584,135859004,3,0,1,2560,17,8289474243
13821,97803320,25127720,122931040,8,0,0,512,8,3245870425
13822,97812520,38050350,135862870,7,0,1,6144,10,4665748710
13823,97815880,38047144,135863024,6,0,1,8704,7,6579375345
13824,97817950,38046060,135864010,7,0,1,1536,10,6424841049
13825,97822410,38042471,135864881,3,0,1,12288,17,968385634
13826,97831660,25287294,123118954,6,0,0,4608,7,6307771493
13827,97832910,38036017,135868927,3,0,1,5632,17,1157741143
13828,97836090,25898328,123734418,6,0,0,41472,7,43517118
13829,97841809,25557288,123399097,3,0,0,15360,17,4920934718
13830,97844370,38034976,135879346,9,0,1,5632,12,5074249155
13831,97847130,25767387,123614517,6,0,0,71168,7,1837558597
13832,97851020,38044003,135895023,1,0,1,3584,10,6075250688
13833,97851680,38043366,135895046,1,0,1,1024,10,2308390456
13834,97856819,25713301,123570120,3,0,0,93184,17,1892425851
13835,97859180,25338089,123197269,8,0,0,512,8,3183978172
13836,97859320,38035749,135895069,1,0,1,2048,10,9851595201
13837,97861820,38033272,135895092,6,0,1,3072,7,7630844950
13838,97865770,38029345,135895115,6,0,1,1536,7,869744601
13839,97867030,26098188,123965218,8,0,0,512,8,3774687223
13840,97873710,38021428,135895138,9,0,1,2048,12,9231827988
13841,97877670,38017499,135895169,6,0,1,6656,7,3594543426
13842,97877871,25292303,123170174,7,0,0,4608,10,268157495
13843,97889510,38741520,136631030,0,0,1,221696,3,3729010009
13844,97891980,38739081,136631061,6,0,1,5632,7,1860920009
13845,97893009,26009867,123902876,3,0,0,88576,17,5293430334
13846,97894069,25430739,123324808,3,0,0,32768,17,4588509678
13847,97898800,38732284,136631084,1,0,1,512,10,1931093837
13848,97901941,25501547,123403488,7,0,0,14336,10,7481584472
13849,97910960,26164787,124075747,5,0,0,6656,10,3112169454
13850,97914520,25411738,123326258,9,0,0,4608,12,9324734732
13851,97914601,25517224,123431825,7,0,0,9216,10,421440650
13852,97921110,38721564,136642674,0,0,1,11264,3,7349869394
13853,97921830,38734953,136656783,9,0,1,6144,12,6989973052
13854,97931380,38725426,136656806,6,0,1,3072,7,5392437519
13855,97933240,38727060,136660300,9,0,1,5632,12,4447689628
13856,97933570,25715758,123649328,6,0,0,114176,7,1591617484
13857,97937000,38723323,136660323,3,0,1,6144,17,8896880064
13858,97954210,38706136,136660346,0,0,1,1536,3,9470236340
13859,97963670,38696707,136660377,6,0,1,8192,7,1063925498
13860,97976550,25696176,123672726,5,0,0,19456,10,7408280903
13861,97977760,38682640,136660400,9,0,1,2048,12,7280032695
13862,97983990,38676433,136660423,9,0,1,13312,12,22852385
13863,97990480,25691185,123681665,5,0,0,29184,10,2138638017
13864,98002490,25788693,123791183,5,0,0,89088,10,2211659838
13865,98006040,25701339,123707379,5,0,0,16896,10,1395217464
13866,98016060,25636145,123652205,6,0,0,7680,7,8732916914
13867,98016930,38643516,136660446,6,0,1,2560,7,2460088599
13868,98017671,25700374,123718045,7,0,0,27136,10,6298620774
13869,98017920,38642549,136660469,9,0,1,3072,12,148408008
13870,98019610,38640882,136660492,9,0,1,11264,12,7623039680
13871,98021410,38654478,136675888,6,0,1,9728,7,2903637940
13872,98030340,38648134,136678474,3,0,1,4096,17,4996935937
13873,98046730,25761043,123807773,6,0,0,53248,7,1635142079
13874,98052941,25929961,123982902,7,0,0,17920,10,1132875993
13875,98055480,25887642,123943122,8,0,0,512,8,8885882564
13876,98064900,25900139,123965039,6,0,0,40448,7,9387525593
13877,98067940,25874918,123942858,9,0,0,120832,12,6858481262
13878,98073980,38604840,136678820,6,0,1,512,7,10469528945
13879,98081890,38639500,136721390,9,0,1,12800,12,7218233008
13880,98086610,38685487,136772097,9,0,1,17408,12,2249817990
13881,98092420,38679700,136772120,3,0,1,1536,17,10716619746
13882,98092840,38679303,136772143,6,0,1,1024,7,3060237922
13883,98101730,25548112,123649842,8,0,0,512,8,5296263802
13884,98108760,25557999,123666759,8,0,0,512,8,2570980782
13885,98112690,38659476,136772166,3,0,1,4096,17,5443785777
13886,98118280,25531383,123649663,8,0,0,1024,8,3613105053
13887,98122400,25669118,123791518,9,0,0,1024,12,10684340338
13888,98125940,38646584,136772524,3,0,1,9728,17,10474729068
13889,98134080,26004949,124139029,6,0,0,31744,7,2936809449
13890,98136970,38636654,136773624,3,0,1,5120,17,5646073126
13891,98138460,25814224,123952684,5,0,0,31232,10,9085586259
13892,98144340,38632005,136776345,3,0,1,3072,17,10569697339
13893,98170810,38605881,136776691,3,0,1,512,17,4430879037
13894,98175010,25700855,123875865,8,0,0,512,8,1190873515
13895,98183420,25722599,123906019,6,0,0,10240,7,7367961890
13896,98189030,38589287,136778317,6,0,1,2560,7,9418731635
13897,98193280,38588583,136781863,6,0,1,5632,7,4635146622
13898,98196640,38594274,136790914,3,0,1,22528,17,4055216798
13899,98202150,38603276,136805426,9,0,1,8704,12,6091703406
13900,98203770,38604242,136808012,9,0,1,4096,12,2108319429
13901,98203781,25806501,124010282,7,0,0,20480,10,1655763615
13902,98212140,25782528,123994668,6,0,0,34816,7,3832196881
13903,98239670,25917635,124157305,5,0,0,31232,10,9091335339
13904,98240980,38571659,136812639,9,0,1,5632,12,4548201383
13905,98243890,38570375,136814265,9,0,1,2560,12,7456939350
13906,98245760,38675561,136921321,9,0,1,16896,12,10318040847
13907,98253590,25716331,123969921,9,0,0,15360,12,2820359456
13908,98255901,25838154,124094055,7,0,0,6656,10,8397064452
13909,98262430,38658914,136921344,6,0,1,1024,7,6729264114
13910,98281530,38639837,136921367,9,0,1,1536,12,6888199122
13911,98289210,38720452,137009662,0,0,1,32768,3,238418614
13912,98292100,38719188,137011288,9,0,1,2560,12,7737680081
13913,98299890,25999112,124299002,6,0,0,2048,7,6698701194
13914,98300610,38729567,137030177,3,0,1,3584,17,7744704060
13915,98312090,25851634,124163724,9,0,0,20992,12,6028081727
13916,98313700,38773120,137086820,0,0,1,37888,3,9334447439
13917,98320340,38821729,137142069,0,0,1,15872,3,10622629257
13918,98325790,25972565,124298355,9,0,0,39424,12,1432287331
13919,98326670,25926992,124253662,5,0,0,1536,10,7264471757
13920,98337180,38804912,137142092,3,0,1,1024,17,9430134946
13921,98351531,25934789,124286320,7,0,0,36352,10,1769912178
13922,98351900,38790215,137142115,9,0,1,512,12,2212546248
13923,98358191,25914370,124272561,7,0,0,37888,10,8411024401
13924,98361300,38780838,137142138,3,0,1,512,17,8230995052
13925,98365060,25962114,124327174,5,0,0,32768,10,6097216345
13926,98365700,38776461,137142161,3,0,1,3072,17,5957955564
13927,98382210,38795057,137177267,6,0,1,9728,7,7747319559
13928,98399460,38848417,137247877,3,0,1,4096,17,966766743
13929,98405329,25911792,124317121,3,0,0,59392,17,8108676246
13930,98407200,26221995,124629195,5,0,0,60416,10,6478050593
13931,98413079,25914274,124327353,3,0,0,512,17,10113299920
13932,98435530,26171327,124606857,5,0,0,13312,10,10639006520
13933,98435980,38828505,137264485,9,0,1,10752,12,5496644688
13934,98440370,25910070,124350440,5,0,0,24576,10,2631872521
13935,98441200,26237945,124679145,8,0,0,114688,8,1256574122
13936,98442039,26013893,124455932,3,0,0,1024,17,2814238957
13937,98444890,25886128,124331018,5,0,0,9728,10,66926486
13938,98452341,25821358,124273699,7,0,0,3584,10,7592582944
13939,98469939,25858084,124328023,3,0,0,2048,17,2660044493
13940,98492380,38772451,137264831,9,0,1,512,12,6004332797
13941,98501269,25859490,124360759,3,0,0,33792,17,6165126658
13942,98504070,38761747,137265817,9,0,1,1536,12,10479530426
13943,98504640,26210219,124714859,6,0,0,7168,7,9719394577
13944,98504870,25864409,124369279,5,0,0,17920,10,3644383153
13945,98512760,26064319,124577079,6,0,0,7680,7,6033366558
13946,98532251,25892655,124424906,7,0,0,10752,10,3250816019
13947,98559270,26153374,124712644,5,0,0,4608,10,3971815278
13948,98561210,38704761,137265971,9,0,1,8704,12,4960675090
13949,98562480,26228773,124791253,9,0,0,70144,12,6398631504
13950,98576760,25899438,124476198,8,0,0,33792,8,6797150407
13951,98593780,26089756,124683536,9,0,0,14336,12,10637297855
13952,98618920,26240223,124859143,5,0,0,29696,10,1547502484
13953,98627299,25853290,124480589,3,0,0,14336,17,7819205791
13954,98632060,25911920,124543980,5,0,0,3072,10,9924367041
13955,98632780,25878134,124510914,9,0,0,1536,12,6369510364
13956,98637260,38629377,137266637,9,0,1,1024,12,4881370590
13957,98640190,26057721,124697911,8,0,0,47104,8,5524447231
13958,98669311,25814109,124483420,7,0,0,9216,10,3669247266
13959,98675130,26308402,124983532,5,0,0,48128,10,2697427772
13960,98680111,26405981,125086092,7,0,0,27648,10,4738840690
13961,98682619,26028598,124711217,3,0,0,30720,17,6877306981
13962,98684590,26197210,124881800,8,0,0,55296,8,2332698132
13963,98702090,25823610,124525700,6,0,0,22016,7,409419440
13964,98716020,38551923,137267943,2,0,1,2048,3,4646291998
13965,98733420,26493444,125226864,8,0,0,51200,8,10186281734
13966,98757220,38618747,137375967,9,0,1,2560,12,9732135986
13967,98758440,26182189,124940629,9,0,0,38912,12,6194013900
13968,98761640,26039088,124800728,9,0,0,25088,12,6527622796
13969,98763629,26252082,125015711,3,0,0,36352,17,1203915821
13970,98769310,38606680,137375990,9,0,1,1536,12,8993535870
13971,98799351,25952069,124751420,7,0,0,24576,10,992544437
13972,98803031,26010350,124813381,7,0,0,5632,10,121796225
13973,98815350,25886484,124701834,8,0,0,12800,8,10417718494
13974,98820100,26074359,124894459,6,0,0,41472,7,327184527
13975,98846190,26214740,125060930,6,0,0,87552,7,8204807446
13976,98847220,26658642,125505862,5,0,0,29696,10,2481734802
13977,98849391,26155221,125004612,7,0,0,48128,10,7454288704
13978,98853160,38556572,137409732,9,0,1,4608,12,9368280168
13979,98864910,26212735,125077645,6,0,0,54784,7,3679769774
13980,98887900,26350531,125238431,8,0,0,37888,8,4923008373
13981,98897660,38937767,137835427,0,0,1,428544,3,2340311033
13982,98902400,26530183,125432583,6,0,0,58368,7,144795514
13983,98918120,26004060,124922180,9,0,0,33280,12,7240990607
13984,98934740,38903913,137838653,9,0,1,5120,12,5538423180
13985,98960970,25942315,124903285,8,0,0,2048,8,8579826389
13986,98962759,26248482,125211241,3,0,0,62464,17,2632870230
13987,98964840,26140627,125105467,6,0,0,63488,7,121646834
13988,98977110,26470183,125447293,6,0,0,40448,7,3276164035
13989,98987709,26596606,125584315,3,0,0,5120,17,8212193241
13990,98998810,26600729,125599539,9,0,0,28672,12,3148258326
13991,99015700,26304906,125320606,6,0,0,41984,7,10702460710
13992,99049250,26123053,125172303,8,0,0,28160,8,3914831887
13993,99076249,26037977,125114226,3,0,0,28672,17,7859103967
13994,99081649,38757350,137838999,4,0,1,512,15,5727343866
13995,99089850,25938208,125028058,9,0,0,40448,12,7291101584
13996,99093259,38780405,137873664,4,0,1,15872,15,6423578908
13997,99103229,26311547,125414776,3,0,0,14848,17,7664006470
13998,99105610,26440385,125545995,8,0,0,91136,8,737734196
13999,99127191,26195310,125322501,7,0,0,6144,10,590583565
14000,99132380,26192640,125325020,5,0,0,8192,10,526967892
14001,99138270,26118280,125256550,6,0,0,59392,7,5376187899
14002,99141049,38747514,137888563,4,0,1,34304,15,3258461504
14003,99144710,38787831,137932541,0,0,1,72192,3,6729592562
14004,99145850,26510863,125656713,6,0,0,110592,7,2329422533
14005,99146221,26264008,125410229,7,0,0,71680,10,7916969059
14006,99160070,26422654,125582724,9,0,0,120320,12,4952217784
14007,99164220,26524322,125688542,5,0,0,89088,10,4242821532
14008,99174640,26097853,125272493,5,0,0,52224,10,6673798159
14009,99175020,38789443,137964463,0,0,1,49152,3,7199771217
14010,99195691,26502795,125698486,7,0,0,512,10,709737047
14011,99202490,38805949,138008439,0,0,1,39936,3,9182554007
14012,99209870,38889181,138099051,0,0,1,55296,3,6135649138
14013,99224610,26476106,125700716,6,0,0,6144,7,7108180632
14014,99243880,38909340,138153220,0,0,1,47616,3,10266053224
14015,99246250,26039698,125285948,5,0,0,44032,10,5891515066
14016,99257430,26333327,125590757,8,0,0,20992,8,3681057111
14017,99258110,38908945,138167055,0,0,1,1024,3,3106590434
14018,99262390,38910189,138172579,0,0,1,27136,3,2961274179
14019,99263899,38917805,138181704,4,0,1,1536,15,9763533126
14020,99264840,26339285,125604125,8,0,0,14848,8,303701681
14021,99268080,26166866,125434946,6,0,0,7680,7,3696909948
14022,99269469,26560325,125829794,3,0,0,3072,17,4988169666
14023,99277880,38905450,138183330,3,0,1,2560,17,1179542029
14024,99289470,26435711,125725181,5,0,0,15360,10,8715298549
14025,99289910,26624345,125914255,9,0,0,10240,12,7525553838
14026,99290420,38893256,138183676,3,0,1,512,17,3866023760
14027,99291580,38928643,138220223,0,0,1,45568,3,4413920003
14028,99294400,38967509,138261909,0,0,1,6144,3,4202716050
14029,99300660,26454284,125754944,8,0,0,16896,8,5044364923
14030,99317371,38944561,138261932,5,0,1,17920,10,3041131969
14031,99320421,38941534,138261955,5,0,1,512,10,10489251744
14032,99322570,26383161,125705731,8,0,0,16384,8,8608758025
14033,99323890,38938088,138261978,1,0,1,5120,10,2077931993
14034,99324689,26373548,125698237,3,0,0,31744,17,4806372947
14035,99331460,26329869,125661329,6,0,0,14848,7,9421631473
14036,99332470,26557061,125889531,9,0,0,9216,12,2195664801
14037,99338380,26548182,125886562,8,0,0,98304,8,8903819360
14038,99340480,26358341,125698821,9,0,0,1024,12,8987267230
14039,99347130,38914871,138262001,1,0,1,3072,10,8224654816
14040,99361721,38900303,138262024,5,0,1,8704,10,8179901947
14041,99364010,26547102,125911112,9,0,0,41984,12,864774548
14042,99365919,26741173,126107092,3,0,0,28672,17,913224347
14043,99368320,38906998,138275318,0,0,1,37888,3,7701486413
14044,99387670,38890554,138278224,1,0,1,4608,10,797648373
14045,99392690,26673164,126065854,8,0,0,51200,8,9677570848
14046,99393690,38885302,138278992,3,0,1,11776,17,7595961609
14047,99395370,26458326,125853696,6,0,0,27648,7,5428309502
14048,99402260,26696065,126098325,6,0,0,106496,7,4322218522
14049,99402350,38877308,138279658,2,0,1,1024,3,4130111298
14050,99405781,38874543,138280324,5,0,1,1024,10,3382481194
14051,99409580,38883636,138293216,1,0,1,1536,10,8024783235
14052,99411980,26894528,126306508,5,0,0,31232,10,9980246825
14053,99415739,26762176,126177915,3,0,0,55296,17,4196600365
14054,99419420,38874462,138293882,3,0,1,1024,17,7590153635
14055,99427820,38867048,138294868,7,0,1,1536,10,138607035
14056,99430040,38867094,138297134,1,0,1,3584,10,9268668904
14057,99434730,26517550,125952280,9,0,0,86016,12,3922173917
14058,99436990,26928108,126365098,6,0,0,58368,7,10495246645
14059,99444500,38852993,138297493,3,0,1,9728,17,4510304480
14060,99447680,38872099,138319779,2,0,1,1536,3,1318382851
14061,99452630,38868455,138321085,1,0,1,2048,10,307351956
14062,99457761,38872797,138330558,5,0,1,23552,10,9132319739
14063,99458450,26368725,125827175,8,0,0,512,8,3817749405
14064,99461990,38869554,138331544,1,0,1,1536,10,10254527863
14065,99474250,38858280,138332530,2,0,1,1536,3,8739007004
14066,99477561,38855315,138332876,5,0,1,512,10,7550462329
14067,99477590,26629993,126107583,8,0,0,1536,8,6895758883
14068,99479020,38855162,138334182,2,0,1,2048,3,5249005548
14069,99480540,38854308,138334848,3,0,1,1024,17,8791505725
14070,99489050,38871805,138360855,0,0,1,27136,3,2889917596
14071,99499540,38867022,138366562,1,0,1,13312,10,4119293312
14072,99502910,38896512,138399422,0,0,1,28160,3,158698990
14073,99504700,38899228,138403928,7,0,1,7168,10,10280051059
14074,99505270,38901244,138406514,0,0,1,4096,3,7186535328
14075,99505741,26499974,126005715,7,0,0,5120,10,6404325038
14076,99508961,38936070,138445031,5,0,1,6144,10,7070426405
14077,99509110,26613169,126122279,8,0,0,9728,8,9113121536
14078,99512300,26686144,126198444,8,0,0,14336,8,4434615730
14079,99516281,38928904,138445185,5,0,1,8704,10,451517386
14080,99521961,38932856,138454817,5,0,1,5120,10,5589823137
14081,99522050,38933433,138455483,3,0,1,1024,17,8809857820
14082,99526030,39054486,138580516,0,0,1,73728,3,1190206362
14083,99529589,39090453,138620042,4,0,1,1024,15,8384914340
14084,99531390,39088675,138620065,3,0,1,4096,17,9625894429
14085,99542350,39077738,138620088,1,0,1,8704,10,2325998662
14086,99545729,26751240,126296969,3,0,0,28160,17,4901548089
14087,99553840,26592159,126145999,6,0,0,28672,7,10075305375
14088,99565250,26628155,126193405,6,0,0,47616,7,6089454589
14089,99577620,39060868,138638488,3,0,1,5120,17,9393897621
14090,99578910,26727941,126306851,0,0,0,1024,3,8044961998
14091,99587620,26700746,126288366,5,0,0,35328,10,6513761422
14092,99587900,39051254,138639154,2,0,1,1024,3,1523739173
14093,99588430,39053950,138642380,3,0,1,5120,17,8951747131
14094,99593250,39051396,138644646,1,0,1,3584,10,4251289334
14095,99595970,26863934,126459904,5,0,0,11776,10,7856543109
14096,99596510,39146671,138743181,8,0,1,73216,8,2534553340
14097,99597150,26713936,126311086,5,0,0,13824,10,7196878299
14098,99597161,26749810,126346971,7,0,0,8704,10,7520394712
14099,99601240,26765441,126366681,5,0,0,5120,10,2431111403
14100,99608100,39135427,138743527,1,0,1,512,10,796736169
14101,99612421,39133692,138746113,5,0,1,4096,10,872889668
14102,99612440,39143060,138755500,3,0,1,2560,17,7139414491
14103,99614520,39216828,138831348,0,0,1,54784,3,976678657
14104,99618029,39218939,138836968,4,0,1,13312,15,2920768331
14105,99622530,26826700,126449230,8,0,0,2560,8,6810277552
14106,99623720,39214554,138838274,3,0,1,2048,17,2070117981
14107,99632110,26832565,126464675,0,0,0,512,3,8619628082
14108,99636670,39202910,138839580,3,0,1,2048,17,9039649726
14109,99643300,39229260,138872560,0,0,1,10240,3,3452320556
14110,99651109,39226801,138877910,4,0,1,16384,15,2801810195
14111,99652259,39225674,138877933,4,0,1,1024,15,3630524317
14112,99657620,27056375,126713995,6,0,0,78336,7,6145560593
14113,99659819,27202347,126862166,3,0,0,48128,17,2672382086
14114,99661511,26962852,126624363,7,0,0,14336,10,3217878906
14115,99666490,26947855,126614345,8,0,0,22528,8,9078522080
14116,99669460,27085705,126755165,8,0,0,71168,8,9178319818
14117,99677380,39239087,138916467,0,0,1,31232,3,6167954544
14118,99679160,39242461,138921621,3,0,1,1536,17,4748830614
14119,99691830,39242278,138934108,1,0,1,8704,10,5442736149
14120,99696510,27121484,126817994,6,0,0,29184,7,2496829297
14121,99702330,27060425,126762755,6,0,0,4096,7,6341111152
14122,99710371,27171016,126881387,7,0,0,33280,10,4322491963
14123,99712730,39238861,138951591,3,0,1,9728,17,9033395952
14124,99718590,27346259,127064849,9,0,0,236032,12,4583712261
14125,99725790,39229027,138954817,1,0,1,5120,10,5668663589
14126,99728310,27338590,127066900,8,0,0,6656,8,2233851113
14127,99732400,39223800,138956200,8,0,1,14848,8,8764735551
14128,99732710,27334704,127067414,0,0,0,1536,3,8558172452
14129,99734029,39234089,138968118,4,0,1,12800,15,3559174710
14130,99734450,27404348,127138798,8,0,0,52224,8,4839828205
14131,99735540,39292230,139027770,1,0,1,2560,10,4980677065
14132,99740190,39287627,139027817,1,0,1,6144,10,576411085
14133,99743960,39283880,139027840,1,0,1,2048,10,8255472198
14134,99744540,39304010,139048550,0,0,1,36864,3,7170636669
14135,99746070,27327919,127073989,9,0,0,21504,12,3235605981
14136,99749909,39301227,139051136,4,0,1,4096,15,10253445962
14137,99750630,39372635,139123265,0,0,1,98304,3,4048142920
14138,99756090,39371681,139127771,3,0,1,7168,17,8870452420
14139,99757520,27438009,127195529,0,0,0,512,3,9276820593
14140,99758870,27521245,127280115,6,0,0,26112,7,5887912076
14141,99762270,27489427,127251697,5,0,0,30208,10,7882950086
14142,99764131,27582460,127346591,7,0,0,30208,10,1321241366
14143,99771139,39371580,139142719,4,0,1,16384,15,8381771204
14144,99779450,39474037,139253487,8,0,1,123392,8,7910005231
14145,99786520,27618742,127405262,9,0,0,22528,12,8081633465
14146,99792370,39463424,139255794,3,0,1,4096,17,388914546
14147,99801361,27668143,127469504,7,0,0,12800,10,6561900001
14148,99810880,27822220,127633100,5,0,0,62464,10,5124408161
14149,99810950,39447430,139258380,0,0,1,4096,3,1566658353
14150,99814690,39446596,139261286,1,0,1,4608,10,7188242273
14151,99816551,28113924,127930475,7,0,0,32256,10,3772004524
14152,99819290,27727227,127546517,5,0,0,61952,10,2589882612
14153,99825271,27852803,127678074,7,0,0,147456,10,7004278253
14154,99828441,27893454,127721895,7,0,0,13824,10,2099710154
14155,99833850,27847725,127681575,6,0,0,5120,7,3728491829
14156,99838180,39425052,139263232,0,0,1,3072,3,61405457
14157,99845539,39419639,139265178,4,0,1,3072,15,6105120827
14158,99850970,27829022,127679992,4,0,0,512,15,7892629923
14159,99860670,27819143,127679813,8,0,0,5632,8,2007346187
14160,99863060,27933101,127796161,5,0,0,7680,10,6188730523
14161,99864240,27899255,127763495,5,0,0,19968,10,4240337404
14162,99868960,27888428,127757388,6,0,0,44032,7,153920615
14163,99875210,39394488,139269698,1,0,1,2048,10,6806229348
14164,99894900,39375157,139270057,0,0,1,9728,3,5946224419
14165,99908470,39400350,139308820,8,0,1,62464,8,2439221762
14166,99914409,28177477,128091886,3,0,0,37888,17,2079468800
14167,99927051,28214354,128141405,7,0,0,69632,10,217169837
14168,99927700,39427075,139354775,8,0,1,38912,8,1882896246
14169,99946010,28010822,127956832,5,0,0,51712,10,7645818138
14170,99955869,27908208,127864077,3,0,0,33280,17,647392974
14171,99959810,28030123,127989933,0,0,0,512,3,9125165894
14172,99976490,39379425,139355915,1,0,1,10240,10,6809343386
14173,99979100,28183864,128162964,8,0,0,70656,8,9422696550
14174,99985970,39456857,139442827,8,0,1,81408,8,9846049323
14175,99994731,28077210,128071941,7,0,0,43520,10,3647629632
14176,100006400,39440191,139446591,0,0,1,10240,3,6471549164
14177,100009150,27980604,127989754,9,0,0,22528,12,1039231499
14178,100010569,28153689,128164258,3,0,0,3584,17,5454216742
14179,100025330,39445544,139470874,8,0,1,19968,8,4859656367
14180,100029740,28227220,128256960,8,0,0,6144,8,10061495673
14181,100070940,39399957,139470897,0,0,1,7680,3,3107948417
14182,100070960,39410318,139481278,8,0,1,4608,8,1199462094
14183,100076290,39472047,139548337,8,0,1,107008,8,1333322668
14184,100090400,39477908,139568308,0,0,1,3584,3,9317545405
14185,100090670,27920834,128011504,0,0,0,2048,3,1089099326
14186,100103370,39467760,139571130,8,0,1,6144,8,7939974643
14187,100107541,28012400,128119941,7,0,0,2048,10,7501064354
14188,100113780,27843387,127957167,0,0,0,1024,3,7339800759
14189,100118500,28000794,128119294,5,0,0,52224,10,8022417965
14190,100121530,27980557,128102087,9,0,0,22016,12,4900952033
14191,100124900,39447536,139572436,0,0,1,2048,3,2922249015
14192,100125610,39451361,139576971,1,0,1,2048,10,5258250459
14193,100137281,28031376,128168657,7,0,0,14336,10,1996762642
14194,100139930,28023213,128163143,0,0,0,512,3,8736102292
14195,100141540,39441744,139583284,8,0,1,15360,8,4955887075
14196,100142480,39557376,139699856,8,0,1,160256,8,4618598485
14197,100145910,28043127,128189037,8,0,0,22528,8,2164080856
14198,100153120,39553820,139706940,1,0,1,6656,10,2989671656
14199,100156139,28090168,128246307,3,0,0,43008,17,1103421966
14200,100159900,28107350,128267250,8,0,0,13312,8,10713288837
14201,100192209,28441740,128633949,3,0,0,53248,17,1004699228
14202,100196790,39548497,139745287,8,0,1,79872,8,10262519861
14203,100205060,27915083,128120143,0,0,0,512,3,7980175920
14204,100207111,27974985,128182096,7,0,0,44032,10,8301195459
14205,100209820,27892758,128102578,0,0,0,1536,3,8891731117
14206,100210370,39545585,139755955,8,0,1,19456,8,6612993673
14207,100224350,28530419,128754769,8,0,0,31232,8,7095329386
14208,100224900,39537125,139762025,1,0,1,7168,10,9157603020
14209,100234820,28043005,128277825,0,0,0,512,3,899707309
14210,100248021,28598767,128846788,7,0,0,56320,10,4475748777
14211,100272420,39491551,139763971,0,0,1,3072,3,1264862135
14212,100276250,28517409,128793659,8,0,0,92160,8,10543629162
14213,100305351,28136852,128442203,7,0,0,56832,10,9082669178
14214,100329760,28089442,128419202,5,0,0,12800,10,7676919228
14215,100341880,28621244,128963124,5,0,0,60928,10,10073251600
14216,100368490,27877996,128246486,0,0,0,512,3,2660164583
14217,100375120,28259320,128634440,0,0,0,1536,3,9472505062
14218,100381721,28205959,128587680,7,0,0,94208,10,4419879418
14219,100390550,39376647,139767197,9,0,1,5120,12,9377720165
14220,100391940,39376563,139768503,0,0,1,2048,3,8874086551
14221,100400630,28497280,128897910,9,0,0,39936,12,10314678217
14222,100441910,27979967,128421877,8,0,0,8704,8,8034585173
14223,100444400,28738426,129182826,8,0,0,83456,8,6713269634
14224,100460360,39311049,139771409,0,0,1,4608,3,4901074717
14225,100462800,39309480,139772280,0,0,1,12288,3,1700688340
14226,100485460,28245170,128730630,5,0,0,174080,10,7419626277
14227,100488250,27991124,128479374,9,0,0,1024,12,3156294963
14228,100493190,39279436,139772626,0,0,1,512,3,9482102043
14229,100506820,39270723,139777543,0,0,1,1024,3,7960122696
14230,100524240,39253326,139777566,0,0,1,9728,3,9919488712
14231,100525910,39261491,139787401,0,0,1,1024,3,2534625664
14232,100535329,28263813,128799142,3,0,0,17920,17,6850551783
14233,100537340,39250407,139787747,0,0,1,512,3,8836518108
14234,100538319,28227237,128765556,3,0,0,35328,17,7393744630
14235,100565960,28179224,128745184,5,0,0,4096,10,3670290093
14236,100566440,28590935,129157375,9,0,0,133632,12,10252352651
14237,100569150,28756670,129325820,8,0,0,83456,8,10201846811
14238,100575520,28030633,128606153,0,0,0,512,3,8194164931
14239,100575931,28619444,129195375,7,0,0,39936,10,9326979735
14240,100585090,28267383,128852473,0,0,0,512,3,5507976434
14241,100589860,28738635,129328495,9,0,0,8704,12,3386155974
14242,100629640,28114273,128743913,8,0,0,43520,8,2909286111
14243,100630690,28313839,128944529,5,0,0,49152,10,2754316954
14244,100636901,28211158,128848059,7,0,0,4096,10,7395426223
14245,100643790,28404834,129048624,8,0,0,20992,8,6921422050
14246,100654681,28910576,129565257,7,0,0,64000,10,9709106984
14247,100658199,28365318,129023517,3,0,0,56832,17,1621023814
14248,100679530,39108883,139788413,0,0,1,1024,3,8016193544
14249,100680999,28171295,128852294,3,0,0,13824,17,5644605310
14250,100689870,28239660,128929530,9,0,0,41472,12,4876387111
14251,100708460,28149790,128858250,0,0,0,512,3,2961392342
14252,100708590,28708216,129416806,9,0,0,96768,12,9178659504
14253,100718580,28165528,128884108,5,0,0,1536,10,169167402
14254,100732500,28472414,129204914,5,0,0,31232,10,4500853998
14255,100736650,39056898,139793548,7,0,1,13312,10,444281965
14256,100744810,28546084,129290894,8,0,0,21504,8,1493732084
14257,100746320,28865456,129611776,9,0,0,100352,12,8176997940
14258,100747409,29242113,129989522,3,0,0,163840,17,715931554
14259,100750360,28432824,129183184,0,0,0,1024,3,741642931
14260,100765120,29135863,129900983,9,0,0,64512,12,1365510031
14261,100766370,28897022,129663392,8,0,0,30720,8,619532203
14262,100768331,28438174,129206505,7,0,0,5120,10,6605671204
14263,100770670,28800226,129570896,5,0,0,18432,10,3596041100
14264,100773569,28867205,129640774,3,0,0,24576,17,853990995
14265,100784140,39025446,139809586,7,0,1,13824,10,5182171014
14266,100786911,28497408,129284319,7,0,0,145408,10,818128004
14267,100787589,28512688,129300277,3,0,0,30720,17,123607304
14268,100789100,39024698,139813798,7,0,1,6656,10,1610464759
14269,100796100,39018684,139814784,7,0,1,1536,10,6961094541
14270,100799530,39016637,139816167,0,0,1,14848,3,714439458
14271,100826740,39005185,139831925,7,0,1,512,10,5720496554
14272,100840490,28893889,129734379,8,0,0,30720,8,1812449993
14273,100848150,38987641,139835791,7,0,1,6144,10,4904219809
14274,100849110,38987987,139837097,2,0,1,2048,3,5809013957
14275,100849360,28390632,129239992,0,0,0,1536,3,7182895293
14276,100850070,38987373,139837443,7,0,1,512,10,2317768834
14277,100850560,28672350,129522910,9,0,0,122368,12,3982376197
14278,100851390,28372888,129224278,5,0,0,512,10,6748322333
14279,100860990,28484824,129345814,5,0,0,7168,10,4325905150
14280,100869460,38981240,139850700,2,0,1,16384,3,3427763137
14281,100890630,38963296,139853926,2,0,1,5120,3,1099276396
14282,100893770,38963476,139857246,2,0,1,3584,3,8388985400
14283,100922700,29138013,130060713,5,0,0,62464,10,8056490864
14284,100927860,38933892,139861752,7,0,1,7168,10,1197410673
14285,100932210,28770680,129702890,0,0,0,1024,3,71574161
14286,100932559,28397207,129329766,3,0,0,4096,17,10044548104
14287,100935470,38931802,139867272,0,0,1,8192,3,4854409871
14288,100939120,38942460,139881580,6,0,1,14336,7,3934400884
14289,100939599,28693664,129633263,3,0,0,18944,17,6221938152
14290,100942500,38956307,139898807,0,0,1,10240,3,7611607629
14291,100947880,28586820,129534700,5,0,0,8704,10,7524450493
14292,100954860,28393033,129347893,9,0,0,6656,12,2489339632
14293,100955250,28490462,129445712,0,0,0,1024,3,4827741942
14294,100959460,38940973,139900433,2,0,1,2560,3,6270828181
14295,100963480,38947053,139910533,2,0,1,4096,3,2435712957
14296,100964980,38946219,139911199,6,0,1,11264,7,3229434710
14297,100974470,38940275,139914745,7,0,1,5632,10,7915229452
14298,100977470,38940501,139917971,6,0,1,5120,7,5760310026
14299,100987051,28733398,129720449,7,0,0,25088,10,3287019963
14300,100989130,38934947,139924077,2,0,1,20992,3,7029098826
14301,100991310,28662653,129653963,5,0,0,20992,10,4431850812
14302,100993290,38931133,139924423,2,0,1,512,3,8082804806
14303,100997289,28667062,129664351,3,0,0,3072,17,2674647429
14304,100999100,28524393,129523493,8,0,0,1536,8,7603500790
14305,101005430,28453530,129458960,8,0,0,1024,8,5318301002
14306,101009370,28631739,129641109,0,0,0,1024,3,396183531
14307,101011610,38913159,139924769,7,0,1,512,10,9722773591
14308,101012450,28635094,129647544,9,0,0,20992,12,813008448
14309,101013191,29320653,130333844,7,0,0,191488,10,873099071
14310,101017280,28603567,129620847,9,0,0,29696,12,6545885410
14311,101027000,28594182,129621182,0,0,0,1024,3,8285086549
14312,101027450,28390471,129417921,0,0,0,3584,3,4611832714
14313,101032110,28595358,129627468,8,0,0,20480,8,8599493993
14314,101037570,38890745,139928315,7,0,1,5632,10,2948585159
14315,101038810,28661671,129700481,9,0,0,25088,12,7734961862
14316,101049400,38881501,139930901,3,0,1,4096,17,5890533333
14317,101062670,29164080,130226750,9,0,0,45568,12,4910838139
14318,101064150,38871577,139935727,2,0,1,7680,3,5950834334
14319,101068600,38899505,139968105,7,0,1,8192,10,10555412850
14320,101070461,28654535,129724996,7,0,0,14848,10,4504451069
14321,101089980,38878148,139968128,7,0,1,5632,10,10458710359
14322,101093500,29119343,130212843,5,0,0,25088,10,12152415
14323,101126580,38841571,139968151,7,0,1,512,10,1282674423
14324,101146070,38822104,139968174,7,0,1,1024,10,7624251868
14325,101153650,38814547,139968197,0,0,1,10240,3,4468301510
14326,101173500,28561526,129735026,8,0,0,2048,8,8276319443
14327,101184770,28805243,129990013,9,0,0,1536,12,9367223463
14328,101191251,28806764,129998015,7,0,0,26112,10,3610025532
14329,101216920,38751300,139968220,2,0,1,512,3,82777005
14330,101217900,38750343,139968243,6,0,1,2560,7,7989552366
14331,101219340,28661918,129881258,9,0,0,40448,12,2804860634
14332,101227619,28800037,130027656,3,0,0,27136,17,333223263
14333,101240540,28685613,129926153,9,0,0,81408,12,2680385033
14334,101260660,38711162,139971822,7,0,1,8192,10,1386532235
14335,101267180,28748205,130015385,8,0,0,50176,8,7597657559
14336,101280450,28649752,129930202,0,0,0,512,3,5232347085
14337,101284570,38690798,139975368,6,0,1,5632,7,3899067720
14338,101296211,28855911,130152122,7,0,0,39936,10,6161429975
14339,101301579,28698495,130000074,3,0,0,6656,17,10349556228
14340,101308240,38667794,139976034,6,0,1,1024,7,7642268937
14341,101308270,38671042,139979312,6,0,1,1536,7,1741015803
14342,101308291,28958077,130266368,7,0,0,31232,10,1607698689
14343,101309439,28850194,130159633,3,0,0,24576,17,6533519654
14344,101311710,29075358,130387068,9,0,0,54784,12,2611288232
14345,101322350,38659851,139982201,7,0,1,4096,10,4197667813
14346,101330840,38673500,140004340,7,0,1,3072,10,3015205690
14347,101337851,28699656,130037507,7,0,0,32256,10,2703715565
14348,101341900,28790052,130131952,8,0,0,29184,8,1881991386
14349,101346950,28715346,130062296,9,0,0,5120,12,6993675185
14350,101353151,29056896,130410047,7,0,0,75264,10,3479010016
14351,101362600,28770623,130133223,9,0,0,4096,12,610976102
14352,101365700,29045173,130410873,0,0,0,2048,3,1278963489
14353,101371650,38635024,140006674,2,0,1,3072,3,8019949980
14354,101371710,28968778,130340488,5,0,0,12800,10,8053274381
14355,101372520,29183047,130555567,9,0,0,69120,12,8168874707
14356,101384380,38622317,140006697,6,0,1,8704,7,4126944766
14357,101391840,38615573,140007413,7,0,1,12800,10,441300006
14358,101394799,29250751,130645550,3,0,0,13312,17,9986146446
14359,101399150,28762837,130161987,0,0,0,512,3,3365630385
14360,101406290,28495036,129901326,0,0,0,1024,3,8530764088
14361,101412150,29089551,130501701,5,0,0,98816,10,1322698581
14362,101415519,28926708,130342227,3,0,0,5632,17,8955933922
14363,101429280,28737916,130167196,0,0,0,512,3,10470958272
14364,101436670,28790259,130226929,0,0,0,512,3,1085536967
14365,101465260,38542499,140007759,7,0,1,512,10,2957834428
14366,101466780,29035100,130501880,0,0,0,512,3,5252032802
14367,101478160,28778669,130256829,5,0,0,8192,10,9699542190
14368,101482760,28937456,130420216,0,0,0,1536,3,6881486202
14369,101492880,28843639,130336519,5,0,0,8704,10,1942393673
14370,101494680,28915546,130410226,0,0,0,512,3,1553612360
14371,101501261,28869092,130370353,7,0,0,78848,10,10058323478
14372,101513340,38495405,140008745,0,0,1,1536,3,435281914
14373,101518860,29096144,130615004,8,0,0,15360,8,93850368
14374,101525940,38486031,140011971,2,0,1,5120,3,5542656156
14375,101534590,28625534,130160124,9,0,0,1536,12,722185595
14376,101536801,28809505,130346306,7,0,0,13312,10,4211090572
14377,101556099,28521251,130077350,3,0,0,6144,17,8644180677
14378,101560099,28869569,130429668,3,0,0,6144,17,4639121976
14379,101570720,38441588,140012308,2,0,1,8704,3,4875633805
14380,101571470,29032872,130604342,9,0,0,7168,12,7409029771
14381,101575870,29179971,130755841,8,0,0,38912,8,339914057
14382,101612990,29190756,130803746,5,0,0,26112,10,6913744541
14383,101620780,38392514,140013294,7,0,1,1536,10,8190321656
14384,101626240,29115333,130741573,8,0,0,37888,8,7946544668
14385,101627430,38389090,140016520,2,0,1,5120,3,8238051363
14386,101638929,29382062,131020991,3,0,0,98816,17,4909668776
14387,101640710,29211381,130852091,5,0,0,96256,10,6111171474
14388,101641460,38423031,140064491,2,0,1,2560,3,5396980165
14389,101643970,28982975,130626945,5,0,0,5632,10,6010105381
14390,101658631,28875853,130534484,7,0,0,61440,10,10370469288
14391,101660190,38404647,140064837,2,0,1,512,3,5364961595
14392,101661100,38409024,140070124,7,0,1,16896,10,3927973971
14393,101673529,28888769,130562298,3,0,0,22016,17,6216565325
14394,101682590,28927703,130610293,9,0,0,19456,12,1390857922
14395,101699340,29278076,130977416,5,0,0,214016,10,8213754260
14396,101707431,38374669,140082100,5,0,1,1024,10,3448648611
14397,101720970,38365956,140086926,2,0,1,7680,3,6029801786
14398,101728410,29065541,130793951,5,0,0,18944,10,8473189957
14399,101743750,29044406,130788156,9,0,0,105984,12,8845089847
14400,101751570,38338416,140089986,1,0,1,13312,10,10580228338
14401,101753080,29289363,131042443,0,0,0,512,3,8134663938
14402,101754051,38339161,140093212,5,0,1,5120,10,8041370842
14403,101759430,38335088,140094518,2,0,1,2048,3,10487941473
14404,101763111,29146599,130909710,7,0,0,81408,10,990584809
14405,101766850,38347331,140114181,2,0,1,1024,3,6568852973
14406,101770920,38363106,140134026,2,0,1,28160,3,5844767376
14407,101779920,29406439,131186359,5,0,0,82432,10,10632581082
14408,101787330,38348778,140136108,7,0,1,2560,10,6866099771
14409,101787540,29079018,130866558,5,0,0,47104,10,9410201887
14410,101788270,29201851,130990121,8,0,0,41472,8,10347468250
14411,101789320,29121661,130910981,5,0,0,4096,10,7050846309
14412,101791240,38345854,140137094,2,0,1,1536,3,8248060115
14413,101795260,28796266,130591526,0,0,0,512,3,775375334
14414,101795640,38343720,140139360,2,0,1,3584,3,7665758210
14415,101796200,38353313,140149513,2,0,1,5120,3,858272704
14416,101800040,29067656,130867696,8,0,0,3584,8,9316891490
14417,101801240,38349259,140150499,7,0,1,1536,10,8131084908
14418,101804150,38351495,140155645,1,0,1,8192,10,5139069928
14419,101813541,29288115,131101656,7,0,0,29696,10,6482447308
14420,101817180,29050695,130867875,0,0,0,512,3,9662196472
14421,101828770,29052260,130881030,0,0,0,2048,3,4922724166
14422,101839680,38337545,140177225,2,0,1,4096,3,9537580930
14423,101862430,29589746,131452176,9,0,0,111616,12,3492416448
14424,101862800,28932959,130795759,9,0,0,5632,12,2310145746
14425,101877729,29163062,131040791,3,0,0,4608,17,10555947723
14426,101890180,38287404,140177584,2,0,1,9728,3,9621796297
14427,101892631,29138724,131031355,7,0,0,33280,10,6228069663
14428,101895500,38289364,140184864,1,0,1,9728,10,6706627568
14429,101899980,29238612,131138592,8,0,0,15360,8,8158143853
14430,101902230,38285630,140187860,0,0,1,5120,3,3688248724
14431,101903960,38284246,140188206,1,0,1,512,10,746748340
14432,101904200,29217147,131121347,8,0,0,8704,8,2232407809
14433,101905100,38284127,140189227,7,0,1,512,10,10623151526
14434,101906570,29146090,131052660,8,0,0,30208,8,3498606822
14435,101923720,38265530,140189250,7,0,1,1024,10,5338679020
14436,101941630,38249214,140190844,1,0,1,2560,10,1779686593
14437,101948720,29042140,130990860,0,0,0,512,3,8757118830
14438,101950560,38241270,140191830,9,0,1,1536,12,8036151923
14439,101953410,29364662,131318072,0,0,0,1536,3,1769008362
14440,101956170,38236326,140192496,7,0,1,11264,10,6351571863
14441,101956760,29318968,131275728,5,0,0,10752,10,10116643481
14442,101960030,29299116,131259146,9,0,0,2048,12,2226881278
14443,101970480,38277006,140247486,2,0,1,9216,3,6165473331
14444,101971420,29019238,130990658,0,0,0,1536,3,4523774539
14445,101976370,38271474,140247844,1,0,1,13312,10,7838705017
14446,101977130,38277236,140254366,2,0,1,1536,3,3109709656
14447,101979910,38281596,140261506,1,0,1,9728,10,5620701692
14448,101980350,29299721,131280071,8,0,0,12288,8,1056004454
14449,101986430,38329605,140316035,9,0,1,8192,12,6083321817
14450,101989850,38393147,140382997,2,0,1,5120,3,3800828352
14451,101991280,38399296,140390576,7,0,1,30720,10,4342879399
14452,102004829,29113843,131118672,3,0,0,25600,17,4796092569
14453,102012950,38451156,140464106,2,0,1,1536,3,8435723669
14454,102018260,29240239,131258499,9,0,0,69120,12,8587735882
14455,102020800,38446212,140467012,9,0,1,4608,12,5035906914
14456,102029560,29388585,131418145,5,0,0,22016,10,6743560063
14457,102030749,29167465,131198214,3,0,0,13312,17,5719771267
14458,102037090,29235339,131272429,9,0,0,43520,12,2283187328
14459,102044480,29342249,131386729,5,0,0,70144,10,5043345784
14460,102050150,38493951,140544101,9,0,1,7680,12,6237342736
14461,102057551,29451549,131509100,7,0,0,30208,10,8454350530
14462,102058220,38487187,140545407,7,0,1,2048,10,2542353804
14463,102060300,38555564,140615864,2,0,1,5120,3,5816895672
14464,102066180,38549707,140615887,9,0,1,1536,12,9400068259
14465,102067420,38548490,140615910,2,0,1,2560,3,9359892908
14466,102068109,29387635,131455744,3,0,0,4608,17,1481406215
14467,102080000,29069556,131149556,0,0,0,1536,3,3309576123
14468,102092470,29535486,131627956,5,0,0,74240,10,10167375898
14469,102094090,29394735,131488825,9,0,0,92672,12,848357633
14470,102102770,29661768,131764538,9,0,0,36352,12,8248968962
14471,102122120,38493813,140615933,1,0,1,512,10,2534625818
14472,102125970,29191269,131317239,9,0,0,5120,12,9418399388
14473,102126520,38489436,140615956,9,0,1,6656,12,5428792338
14474,102128900,38487087,140615987,1,0,1,4096,10,6593749024
14475,102135160,38488024,140623184,7,0,1,24576,10,8572517867
14476,102140720,29135561,131276281,5,0,0,1024,10,7696092401
14477,102140840,29135083,131275923,0,0,0,512,3,140999734
14478,102148590,29340570,131489160,0,0,0,1024,3,6344523185
14479,102148770,38530226,140678996,2,0,1,1536,3,915016014
14480,102151000,29423476,131574476,9,0,0,15872,12,721044145
14481,102155820,38587753,140743573,7,0,1,17408,10,10648688604
14482,102156890,38587589,140744479,2,0,1,3584,3,4186981993
14483,102168640,38578645,140747285,7,0,1,8704,10,8134360213
14484,102174740,38577051,140751791,9,0,1,7168,12,7414812732
14485,102177480,29467503,131644983,9,0,0,55808,12,5871763479
14486,102179850,38609906,140789756,2,0,1,3584,3,6103553847
14487,102186611,29521598,131708209,7,0,0,64000,10,8919316998
14488,102199130,38593852,140792982,2,0,1,5120,3,7788574468
14489,102202110,38591218,140793328,1,0,1,512,10,1526671640
14490,102209490,38677963,140887453,9,0,1,22528,12,8185701122
14491,102217000,29524662,131741662,5,0,0,104448,10,282807689
14492,102223680,29285755,131509435,5,0,0,1024,10,2679118200
14493,102232640,38655639,140888279,7,0,1,1024,10,2641681664
14494,102234600,29351844,131586444,5,0,0,512,10,8852515712
14495,102249190,38645022,140894212,3,0,1,7680,17,8710712112
14496,102253770,38643988,140897758,9,0,1,5632,12,7791673376
14497,102255650,38645974,140901624,2,0,1,6144,3,2753328640
14498,102269130,38657438,140926568,9,0,1,23552,12,8905373368
14499,102270480,38801174,141071654,7,0,1,1536,10,9925454743
14500,102285820,29359365,131645185,0,0,0,512,3,236254102
14501,102288100,38788771,141076871,3,0,1,13824,17,1783518345
14502,102294000,29270527,131564527,5,0,0,2048,10,864471282
14503,102304510,29341018,131645528,5,0,0,1024,10,7953160985
14504,102304580,38774833,141079413,9,0,1,2560,12,1899969114
14505,102307370,38783656,141091026,9,0,1,2560,12,9612746741
14506,102308950,38782434,141091384,2,0,1,8192,3,3051418513
14507,102327520,38763887,141091407,7,0,1,4608,10,6152449428
14508,102336580,29431724,131768304,5,0,0,1024,10,6374265182
14509,102345130,29574810,131919940,9,0,0,97792,12,3400592217
14510,102355570,38735860,141091430,9,0,1,1536,12,5898393024
14511,102371610,38719851,141091461,9,0,1,1024,12,2679002228
14512,102387060,38704424,141091484,2,0,1,3584,3,374655610
14513,102392471,29317344,131709815,7,0,0,4608,10,1215473345
14514,102412081,29790341,132202422,7,0,0,13824,10,10111988759
14515,102440100,38651407,141091507,3,0,1,2560,17,8397229935
14516,102465901,29601176,132067077,7,0,0,49664,10,9564601078
14517,102466120,38625410,141091530,9,0,1,3072,12,4561423785
14518,102476820,29299743,131776563,5,0,0,1536,10,2270022740
14519,102483489,29865313,132348802,3,0,0,13824,17,10027928361
14520,102493910,38597643,141091553,7,0,1,1536,10,1237986011
14521,102496921,29247884,131744805,7,0,0,10240,10,3418063508
14522,102507959,29934593,132442552,3,0,0,83456,17,9737397751
14523,102514660,38615074,141129734,3,0,1,31744,17,9982498484
14524,102518899,29316644,131835543,3,0,0,33792,17,2078362929
14525,102530589,30032395,132562984,3,0,0,29696,17,4629263339
14526,102533820,38595937,141129757,9,0,1,512,12,6110464516
14527,102545710,38608920,141154630,3,0,1,4096,17,3536449328
14528,102558260,29195179,131753439,9,0,0,10752,12,10040140453
14529,102563080,29473116,132036196,5,0,0,512,10,93453455
14530,102569370,38586102,141155472,9,0,1,8192,12,6541025774
14531,102574090,38581405,141155495,3,0,1,2048,17,9315843175
14532,102575780,29132608,131708388,0,0,0,512,3,7778247395
14533,102578010,38579628,141157638,1,0,1,11264,10,9227963347
14534,102586730,29265276,131852006,5,0,0,512,10,9524426136
14535,102600360,30210064,132810424,9,0,0,117248,12,2969471615
14536,102615550,29580230,132195780,8,0,0,7680,8,5171984785
14537,102621360,38545248,141166608,9,0,1,3072,12,4784954953
14538,102640340,38526664,141167004,9,0,1,12800,12,4699354598
14539,102653429,29503213,132156642,3,0,0,45056,17,675558826
14540,102662170,38509980,141172150,9,0,1,8192,12,9098461183
14541,102665830,30215976,132881806,0,0,0,2560,3,8544803384
14542,102668750,38552227,141220977,9,0,1,11264,12,3434241329
14543,102681700,38540583,141222283,9,0,1,2048,12,3450862534
14544,102689201,29420777,132109978,7,0,0,4608,10,7615237005
14545,102691860,38545436,141237296,2,0,1,5120,3,5561777052
14546,102693679,29499646,132193325,3,0,0,120320,17,3069266349
14547,102693940,38547632,141241572,2,0,1,512,3,4547785159
14548,102698310,38550699,141249009,2,0,1,6144,3,1593136420
14549,102700590,29671836,132372426,5,0,0,1536,10,7149613491
14550,102705190,38560565,141265755,9,0,1,9728,12,2590220426
14551,102709560,38556397,141265957,9,0,1,5632,12,7501959174
14552,102724100,29591305,132315405,5,0,0,1024,10,2023461793
14553,102728890,29774756,132503646,8,0,0,57344,8,6776984700
14554,102729599,29967035,132696634,3,0,0,97792,17,2950932942
14555,102731440,29711314,132442754,5,0,0,512,10,10558939045
14556,102734590,38533932,141268522,2,0,1,512,3,8000125571
14557,102735500,29913586,132649086,0,0,0,1024,3,869335437
14558,102737890,38530655,141268545,3,0,1,512,17,3883306702
14559,102748161,29821265,132569426,7,0,0,18944,10,9773890702
14560,102749310,29652582,132401892,9,0,0,21504,12,4722836924
14561,102751050,38517526,141268576,3,0,1,512,17,5126513515
14562,102753460,29823321,132576781,9,0,0,24064,12,2520242297
14563,102756130,29759838,132515968,8,0,0,13312,8,7174385228
14564,102765690,38502917,141268607,0,0,1,4096,3,8202040997
14565,102776659,29872092,132648751,3,0,0,48640,17,1782438028
14566,102782029,29665867,132447896,3,0,0,15872,17,3549257019
14567,102784860,29871042,132655902,8,0,0,16896,8,9339583397
14568,102792340,38476801,141269141,0,0,1,1024,3,2989159804
14569,102797350,38472969,141270319,0,0,1,13824,3,7890331006
14570,102818829,29655672,132474501,3,0,0,512,17,356201056
14571,102819090,38452391,141271481,3,0,1,512,17,3635490156
14572,102821560,38450907,141272467,6,0,1,1536,7,9114804839
14573,102838300,38435793,141274093,6,0,1,2560,7,7208750745
14574,102847740,29977434,132825174,8,0,0,23552,8,3843254625
14575,102858789,29878459,132737248,3,0,0,38400,17,6866793508
14576,102859791,29756010,132615801,7,0,0,23040,10,5856283367
14577,102863030,38415569,141278599,6,0,1,7168,7,1088439625
14578,102863230,29787439,132650669,8,0,0,5120,8,4941451868
14579,102871951,29829432,132701383,7,0,0,15360,10,2134483594
14580,102884240,29679391,132563631,8,0,0,2048,8,8913097887
14581,102893340,29767570,132660910,0,0,0,1024,3,3985073537
14582,102896170,38386328,141282498,3,0,1,11264,17,1845249335
14583,102899120,38389027,141288147,6,0,1,4096,7,7931415620
14584,102906230,29760115,132666345,0,0,0,1024,3,127010916
14585,102909290,38396851,141306141,2,0,1,2560,3,4486887784
14586,102917070,29894001,132811071,0,0,0,2048,3,6504017389
14587,102917170,29743405,132660575,0,0,0,1024,3,7484198095
14588,102924830,38382617,141307447,2,0,1,2048,3,7437420462
14589,102936500,38372893,141309393,9,0,1,3072,12,8942554827
14590,102939570,38414674,141354244,9,0,1,1536,12,7646583981
14591,102941070,38413197,141354267,0,0,1,1536,3,9664298840
14592,102943221,29870057,132813278,7,0,0,7168,10,5845960539
14593,102944210,38410080,141354290,6,0,1,512,7,3912370602
14594,102954210,29960291,132914501,5,0,0,512,10,4372799209
14595,102960779,29987919,132948698,3,0,0,32256,17,6156886883
14596,102964801,29901234,132866035,7,0,0,122368,10,4012870916
14597,102979300,38375192,141354492,2,0,1,16384,3,376552531
14598,102982500,38376355,141358855,0,0,1,4096,3,2288002223
14599,102984440,30142128,133126568,8,0,0,12800,8,2638993937
14600,102985550,38373651,141359201,3,0,1,512,17,10662038662
14601,102985690,38374817,141360507,3,0,1,2048,17,7602591129
14602,102986480,38415160,141401640,7,0,1,15872,10,5225336360
14603,102991270,38461507,141452777,0,0,1,5120,3,4202361229
14604,102991950,29874264,132866214,0,0,0,512,3,7476824494
14605,103002750,38467192,141469942,7,0,1,7680,10,10698493696
14606,103012799,29861513,132874312,3,0,0,1024,17,1013935965
14607,103016680,29861010,132877690,8,0,0,9216,8,279776553
14608,103025500,38448308,141473808,0,0,1,6144,3,8980817595
14609,103029950,38444204,141474154,9,0,1,512,12,1749723676
14610,103033050,38442090,141475140,3,0,1,1536,17,10081234122
14611,103041960,38437366,141479326,0,0,1,6656,3,5490033581
14612,103042260,38439332,141481592,9,0,1,3584,12,9053104020
14613,103052200,38446428,141498628,9,0,1,3584,12,3984599580
14614,103059201,29969965,133029166,7,0,0,27136,10,8831298916
14615,103061591,29951464,133013055,7,0,0,43008,10,68659491
14616,103069191,38429460,141498651,5,0,1,1024,10,9350371110
14617,103083630,38415044,141498674,3,0,1,512,17,8754919810
14618,103084330,38414367,141498697,9,0,1,3584,12,187653004
14619,103091971,29983077,133075048,7,0,0,10240,10,8286769505
14620,103095280,30247611,133342891,5,0,0,2560,10,7342990852
14621,103100311,30092323,133192634,7,0,0,41984,10,8553629922
14622,103103010,38428434,141531444,2,0,1,24576,3,10620087142
14623,103113540,38542432,141655972,3,0,1,22528,17,1053546602
14624,103121840,38559843,141681683,2,0,1,12288,3,3447903351
14625,103129510,38593622,141723132,0,0,1,5120,3,1026091026
14626,103134330,29917055,133051385,0,0,0,512,3,3102550661
14627,103134600,38589390,141723990,9,0,1,4096,12,10277068937
14628,103147010,38579566,141726576,2,0,1,4096,3,4958210152
14629,103152251,30041654,133193905,7,0,0,4096,10,4058097047
14630,103162900,30058651,133221551,0,0,0,512,3,519182154
14631,103171990,29999837,133171827,5,0,0,1024,10,4372859261
14632,103183509,30193214,133376723,3,0,0,53760,17,4263419749
14633,103189780,30187145,133376925,0,0,0,512,3,6566503839
14634,103197060,30313830,133510890,8,0,0,54272,8,9319859671
14635,103215491,30029297,133244788,7,0,0,41472,10,418308199
14636,103230210,30070449,133300659,8,0,0,14848,8,10056283179
14637,103252710,30264167,133516877,0,0,0,1024,3,630777654
14638,103255929,30137711,133393640,3,0,0,54784,17,7587407462
14639,103291400,30263502,133554902,8,0,0,82432,8,6149703696
14640,103296160,30105201,133401361,8,0,0,25088,8,5882964423
14641,103306480,30629806,133936286,5,0,0,512,10,7056074321
14642,103322730,38413356,141736086,2,0,1,8192,3,1072473147
14643,103326380,38409729,141736109,0,0,1,3072,3,7346847305
14644,103328430,38407702,141736132,2,0,1,1024,3,9022597303
14645,103335000,38401155,141736155,9,0,1,13312,12,7825812322
14646,103347030,38389994,141737024,9,0,1,1024,12,3686430518
14647,103364529,30079134,133443663,3,0,0,35328,17,4278451776
14648,103366650,38372000,141738650,9,0,1,2560,12,4913374317
14649,103375199,30037949,133413148,3,0,0,2048,17,9670461395
14650,103378720,30188363,133567083,8,0,0,4608,8,1740051328
14651,103379190,38411237,141790427,9,0,1,4096,12,5441078379
14652,103379870,38438440,141818310,2,0,1,7680,3,8536012720
14653,103386050,38442766,141828816,9,0,1,12800,12,6280662918
14654,103401531,30126423,133527954,7,0,0,11264,10,10655240391
14655,103409330,38419844,141829174,9,0,1,2560,12,7637750068
14656,103415351,30615041,134030392,7,0,0,86528,10,5767283420
14657,103417701,30266087,133683788,7,0,0,10752,10,2101492401
14658,103420630,38409058,141829688,2,0,1,11264,3,60943226
14659,103424110,38417550,141841660,6,0,1,2048,7,5416149614
14660,103446040,30351616,133797656,8,0,0,13824,8,8751670205
14661,103446950,30269480,133716430,8,0,0,59392,8,9133389849
14662,103453120,30184942,133638062,8,0,0,28160,8,791134625
14663,103456470,38385213,141841683,2,0,1,2048,3,2428186603
14664,103488269,30561646,134049915,3,0,0,64000,17,3017516072
14665,103489510,30109087,133598597,5,0,0,1536,10,7124040975
14666,103507030,30400910,133907940,5,0,0,512,10,8123441463
14667,103509320,38338119,141847439,1,0,1,8192,10,1997606226
14668,103509890,30243174,133753064,5,0,0,3584,10,8355083733
14669,103515300,30201883,133717183,0,0,0,1536,3,3185309937
14670,103516880,38333181,141850061,9,0,1,4608,12,6447204318
14671,103525151,30588870,134114021,7,0,0,129024,10,3833903044
14672,103530800,30143586,133674386,0,0,0,3584,3,1806735827
14673,103534630,30610164,134144794,8,0,0,72704,8,4287555356
14674,103542000,38311521,141853521,7,0,1,15360,10,4914142074
14675,103551030,30057224,133608254,5,0,0,512,10,8235348668
14676,103552920,30700426,134253346,8,0,0,48640,8,7056494560
14677,103556869,30367718,133924587,3,0,0,39936,17,9601555394
14678,103567979,30233434,133801413,3,0,0,10240,17,9897879712
14679,103604910,30272300,133877210,8,0,0,512,8,4309109971
14680,103606061,30330046,133936107,7,0,0,32768,10,9850640488
14681,103619641,30762752,134382393,7,0,0,12288,10,3918365204
14682,103625740,30536592,134162332,5,0,0,512,10,2918802868
14683,103637140,38279974,141917114,7,0,1,2560,10,8408102680
14684,103638290,38280770,141919060,7,0,1,3072,10,1319367737
14685,103642620,30313351,133955971,5,0,0,1024,10,3923907700
14686,103644230,30232801,133877031,6,0,0,19968,7,5848089520
14687,103648390,30342058,133990448,0,0,0,512,3,356134916
14688,103650480,30424206,134074686,5,0,0,1536,10,4190848463
14689,103666340,38266273,141932613,9,0,1,6656,12,8277702683
14690,103693420,30108172,133801592,5,0,0,512,10,2784651396
14691,103705571,30154840,133860411,7,0,0,6144,10,8555352745
14692,103706500,38232109,141938609,9,0,1,1536,12,707364709
14693,103725700,30063675,133789375,0,0,0,512,3,4048711950
14694,103726660,29993439,133720099,0,0,0,1024,3,9998362360
14695,103731850,38211585,141943435,9,0,1,7680,12,7643108862
14696,103773450,38170651,141944101,9,0,1,1024,12,5570846162
14697,103792129,29997067,133789196,3,0,0,7680,17,7735698685
14698,103796070,38174687,141970757,3,0,1,21504,17,3833174242
14699,103804121,30248960,134053081,7,0,0,9216,10,216285950
14700,103813720,30260467,134074187,8,0,0,41984,8,155015541
14701,103822359,30455478,134277837,3,0,0,64512,17,6813652459
14702,103826300,38148323,141974623,9,0,1,6144,12,2532221091
14703,103830369,30348363,134178732,3,0,0,42496,17,2910190440
14704,103839860,30221512,134061372,8,0,0,27136,8,9267965382
14705,103848119,30516244,134364363,3,0,0,100352,17,10615358473
14706,103857220,30193030,134050250,8,0,0,1024,8,3289613416
14707,103911370,30205418,134116788,5,0,0,512,10,5701386136
14708,103912650,30543292,134455942,0,0,0,512,3,4692755259
14709,103920710,30399260,134319970,5,0,0,512,10,7487118571
14710,103922099,30588089,134510188,3,0,0,20992,17,5086762311
14711,103922940,30225644,134148584,8,0,0,12288,8,4129094192
14712,103928690,30483266,134411956,8,0,0,28672,8,5055351030
14713,103946139,38032670,141978809,4,0,1,6656,15,2472096732
14714,103952799,38028596,141981395,4,0,1,4096,15,5671130431
14715,103953441,30231401,134184842,7,0,0,3584,10,1716842579
14716,103956271,30259687,134215958,7,0,0,5632,10,5946272359
14717,103961890,30291635,134253525,5,0,0,512,10,2173804343
14718,103972849,38013372,141986221,4,0,1,7680,15,9163386395
14719,104000460,30284643,134285103,0,0,0,1536,3,1565276500
14720,104007850,30214696,134222546,5,0,0,2048,10,1406750563
14721,104009171,30557447,134566618,7,0,0,58880,10,2715379794
14722,104018510,37977084,141995594,3,0,1,2560,17,1462382966
14723,104030140,30264641,134294781,0,0,0,1024,3,10047581183
14724,104030249,30347865,134378114,3,0,0,45056,17,8995890530
14725,104054509,30424599,134479108,3,0,0,67072,17,395972566
14726,104056990,30335431,134392421,8,0,0,4096,8,364031460
14727,104058860,38128832,142187692,3,0,1,4608,17,1482743321
14728,104068980,30147157,134216137,5,0,0,512,10,9435822696
14729,104132630,30346969,134479599,0,0,0,1536,3,6569233681
14730,104133410,38071810,142205220,3,0,1,4608,17,8288887286
14731,104142650,30091577,134234227,5,0,0,512,10,10421134737
14732,104148100,38057143,142205243,3,0,1,512,17,2871816791
14733,104156889,30435913,134592802,3,0,0,18432,17,3930893581
14734,104173980,30637787,134811767,8,0,0,69632,8,6065307222
14735,104177619,30723494,134901113,3,0,0,18944,17,1525889841
14736,104217950,37987765,142205715,1,0,1,2560,10,5456296382
14737,104218020,30292347,134510367,0,0,0,512,3,3382156612
14738,104232570,38013992,142246562,9,0,1,7168,12,7411952411
14739,104243950,38171424,142415374,1,0,1,18944,10,10093341676
14740,104244310,38249596,142493906,3,0,1,3584,17,3936161341
14741,104254730,38240482,142495212,1,0,1,2048,10,3815254690
14742,104270140,30108378,134378518,0,0,0,512,3,9089895099
14743,104279870,30301095,134580965,8,0,0,2560,8,2973563080
14744,104282330,30095963,134378293,5,0,0,512,10,1615114615
14745,104283370,38213468,142496838,1,0,1,2560,10,9717251528
14746,104285910,38214154,142500064,3,0,1,5120,17,3737060242
14747,104286100,38214118,142500218,9,0,1,8704,12,2101061419
14748,104307060,38197024,142504084,9,0,1,6144,12,10546050466
14749,104308660,38214919,142523579,0,0,1,13824,3,2600074660
14750,104311920,38211682,142523602,2,0,1,1024,3,4699068337
14751,104317489,30227619,134545108,3,0,0,14336,17,547909294
14752,104358450,38165175,142523625,3,0,1,4096,17,7797279637
14753,104358500,30263461,134621961,5,0,0,512,10,5233980545
14754,104359390,38171197,142530587,3,0,1,2048,17,2782529588
14755,104363970,38272973,142636943,3,0,1,512,17,10129474179
14756,104365130,30279212,134644342,5,0,0,512,10,6307641520
14757,104390159,30179446,134569605,3,0,0,9728,17,4513851658
14758,104399400,30085812,134485212,4,0,0,512,15,8106899437
14759,104401801,30383013,134784814,7,0,0,71680,10,4400581132
14760,104419680,30462478,134882158,0,0,0,1024,3,2232874707
14761,104423390,29991321,134414711,4,0,0,512,15,7600016374
14762,104428500,30110111,134538611,5,0,0,512,10,4780467382
14763,104436169,38200797,142636966,4,0,1,5120,15,10659402209
14764,104436660,30323380,134760040,4,0,0,1024,15,5232820341
14765,104437779,30191315,134629094,3,0,0,8704,17,9342293534
14766,104448150,38188839,142636989,9,0,1,512,12,8391333253
14767,104457770,30574145,135031915,5,0,0,512,10,7530361418
14768,104466290,30198506,134664796,5,0,0,1536,10,5337948692
14769,104471670,30230435,134702105,8,0,0,9728,8,10146308795
14770,104490800,30185715,134676515,4,0,0,1024,15,10696431428
14771,104496060,30386277,134882337,5,0,0,512,10,8789024301
14772,104501030,30789844,135290874,8,0,0,79360,8,47307520
14773,104504620,38132392,142637012,1,0,1,1024,10,4753899347
14774,104512480,30406984,134919464,0,0,0,512,3,4724170285
14775,104513851,30146560,134660411,7,0,0,35328,10,9834134454
14776,104516180,38120855,142637035,9,0,1,1536,12,5606419086
14777,104523931,30417670,134941601,7,0,0,20480,10,9852600665
14778,104534880,30591145,135126025,8,0,0,10240,8,6477353575
14779,104539660,38097398,142637058,0,0,1,5632,3,10192748721
14780,104545650,30157319,134702969,5,0,0,1024,10,4395564109
14781,104584040,30228513,134812553,5,0,0,512,10,10436332119
14782,104600600,30431113,135031713,8,0,0,59904,8,10073274473
14783,104601689,30411703,135013392,3,0,0,72192,17,1793954271
14784,104623960,38013612,142637572,1,0,1,1024,10,676829163
14785,104635120,30420547,135055667,4,0,0,512,15,2842630811
14786,104636600,38000995,142637595,3,0,1,1024,17,370209474
14787,104645460,38010589,142656049,9,0,1,4608,12,8895692850
14788,104653109,30298335,134951444,3,0,0,3584,17,9500818539
14789,104662969,30218854,134881823,3,0,0,87552,17,1821961842
14790,104669491,30422912,135092403,7,0,0,29696,10,4578895377
14791,104672571,30721520,135394091,7,0,0,139264,10,2188853048
14792,104688160,30714330,135402490,0,0,0,1536,3,8314307444
14793,104691750,30567813,135259563,4,0,0,512,15,2332408852
14794,104697389,30347741,135045130,3,0,0,512,17,4730151921
14795,104698320,37957752,142656072,9,0,1,4096,12,189270312
14796,104700230,30229132,134929362,5,0,0,1024,10,3221552576
14797,104704630,30140920,134845550,4,0,0,1024,15,1105386275
14798,104713760,30384415,135098175,0,0,0,512,3,8618128386
14799,104724790,30507800,135232590,8,0,0,9216,8,9886193043
14800,104733070,30113860,134846930,5,0,0,512,10,2260417065
14801,104733881,30804137,135538018,7,0,0,101376,10,1316824702
14802,104753830,37902265,142656095,3,0,1,10240,17,7151641517
14803,104758050,30166334,134924384,5,0,0,1536,10,2859910689
14804,104762280,37893838,142656118,9,0,1,1024,12,4338640394
14805,104786280,37869861,142656141,9,0,1,1024,12,9054289122
14806,104789580,30843056,135632636,5,0,0,1024,10,1786891100
14807,104790880,37865284,142656164,9,0,1,1536,12,10435981563
14808,104797000,30337740,135134740,4,0,0,6144,15,6951419887
14809,104804920,30458094,135263014,8,0,0,2560,8,9347827422
14810,104806620,30314669,135121289,5,0,0,1536,10,6545660735
14811,104815501,30235362,135050863,7,0,0,11776,10,5331343958
14812,104836750,30350127,135186877,4,0,0,48640,15,7312956243
14813,104836770,37819425,142656195,3,0,1,7680,17,4870117515
14814,104869000,37795064,142664064,6,0,1,1024,7,4159218484
14815,104876479,30419901,135296380,3,0,0,17920,17,2508610429
14816,104878460,37785627,142664087,9,0,1,7168,12,7315890090
14817,104880990,37783120,142664110,9,0,1,6144,12,7778912406
14818,104888870,37776066,142664936,6,0,1,5120,7,5998550063
14819,104890000,37775934,142665934,6,0,1,3584,7,5765275346
14820,104894160,30237960,135132120,0,0,0,512,3,3958000180
14821,104902290,30729717,135632007,4,0,0,10752,15,10153727971
14822,104915970,30335671,135251641,4,0,0,54272,15,10010482336
14823,104935011,30470371,135405382,7,0,0,6144,10,4110787991
14824,104935960,37751276,142687236,6,0,1,7168,7,7360015985
14825,104946790,30258768,135205558,0,0,0,512,3,9209614308
14826,104962330,37724929,142687259,6,0,1,512,7,1254753810
14827,104981490,30284867,135266357,0,0,0,1536,3,6747387728
14828,104988200,37699082,142687282,3,0,1,6656,17,10407085139
14829,104990280,30466727,135457007,8,0,0,46080,8,2859209389
14830,104995971,30355665,135351636,7,0,0,25600,10,9370074670
14831,104996550,30300032,135296582,5,0,0,512,10,1084358165
14832,105012711,30578214,135590925,7,0,0,173568,10,6440054524
14833,105022590,37664747,142687337,6,0,1,5632,7,1230701823
14834,105029920,30719335,135749255,8,0,0,181248,8,6557724225
14835,105032100,37655260,142687360,3,0,1,1024,17,5993706405
14836,105037289,30591419,135628708,3,0,0,123904,17,10473622063
14837,105040090,30354180,135394270,0,0,0,512,3,8330588503
14838,105044520,30352456,135396976,4,0,0,8704,15,8619830913
14839,105051210,37636173,142687383,3,0,1,2560,17,9317760967
14840,105054009,30627636,135681645,3,0,0,15360,17,7955242449
14841,105054060,30728336,135782396,0,0,0,1024,3,1981282351
14842,105060570,30849819,135910389,8,0,0,49664,8,10023589103
14843,105098320,37589265,142687585,3,0,1,17920,17,7473445048
14844,105111720,30286995,135398715,8,0,0,5632,8,8476772548
14845,105118850,37586440,142705290,6,0,1,1024,7,5184544139
14846,105155210,30594431,135749641,0,0,0,512,3,2322002177
14847,105166340,30272705,135439045,0,0,0,512,3,187477550
14848,105179090,30715910,135895000,8,0,0,50176,8,912156341
14849,105185380,30592566,135777946,8,0,0,55296,8,3900236679
14850,105196000,37509956,142705956,8,0,1,1024,8,2996488178
14851,105198650,37507652,142706302,6,0,1,512,7,1506949308
14852,105206780,37782678,142989458,8,0,1,126976,8,4891214811
14853,105209530,37839268,143048798,8,0,1,18944,8,886670057
14854,105219350,37830150,143049500,6,0,1,3072,7,3134717691
14855,105233050,37818076,143051126,0,0,1,2560,3,10090482586
14856,105239640,37812152,143051792,0,0,1,1024,3,283733347
14857,105240170,30392062,135632232,5,0,0,512,10,10540535138
14858,105249830,38031115,143280945,8,0,1,66560,8,8805474036
14859,105253050,38031857,143284907,6,0,1,1024,7,7309249350
14860,105260310,38028783,143289093,0,0,1,6656,3,7039900222
14861,105261050,38029669,143290719,0,0,1,2560,3,4809259862
14862,105268680,38023025,143291705,0,0,1,1536,3,1876652363
14863,105284230,38149782,143434012,8,0,1,70656,8,6132314070
14864,105287130,30658119,135945249,5,0,0,512,10,4335553061
14865,105293100,38276417,143569517,8,0,1,145920,8,8346374308
14866,105294630,38369826,143664456,8,0,1,53248,8,3518748823
14867,105295190,38409606,143704796,8,0,1,54272,8,5957858634
14868,105313680,38392410,143706090,2,0,1,2560,3,2687496346
14869,105315600,38390521,143706121,0,0,1,8192,3,3792834324
14870,105316801,30763726,136080527,7,0,0,8192,10,2937038230
14871,105317539,30714572,136032111,3,0,0,108032,17,1853117483
14872,105317960,38436615,143754575,0,0,1,7680,3,4203411062
14873,105317970,38436628,143754598,6,0,1,7168,7,3876145942
14874,105320369,30761273,136081642,3,0,0,3584,17,6012126008
14875,105327240,30647154,135974394,0,0,0,512,3,7317642223
14876,105328810,38425811,143754621,0,0,1,1536,3,6476055057
14877,105348400,38425143,143773543,8,0,1,14848,8,2870372819
14878,105355690,38417876,143773566,9,0,1,5120,12,3279135725
14879,105359980,38413609,143773589,8,0,1,1024,8,10702070057
14880,105368320,30699743,136068063,0,0,0,512,3,2814581002
14881,105383020,38390592,143773612,6,0,1,9728,7,59650373
14882,105392010,38388422,143780432,6,0,1,6656,7,8217509152
14883,105432161,31075219,136507380,7,0,0,125952,10,7932250750
14884,105438081,31092901,136530982,7,0,0,27648,10,6028762008
14885,105445169,31206264,136651433,3,0,0,28672,17,1836641797
14886,105447420,38362147,143809567,0,0,1,2560,3,1376615736
14887,105449720,31322346,136772066,8,0,0,99328,8,6711847153
14888,105465970,30807737,136273707,0,0,0,124416,3,2721782537
14889,105479260,38330330,143809590,0,0,1,4608,3,8390245034
14890,105482130,38408631,143890761,8,0,1,20992,8,681655970
14891,105482520,38418326,143900846,0,0,1,1024,3,5082364926
14892,105489500,38411369,143900869,0,0,1,3584,3,7041840436
14893,105493810,38407082,143900892,8,0,1,17408,8,4368313549
14894,105504060,38396855,143900915,8,0,1,12800,8,1007589671
14895,105510340,31120667,136631007,8,0,0,9728,8,9924419507
14896,105513860,30761274,136275134,8,0,0,4608,8,8722350980
14897,105515691,31141069,136656760,7,0,0,17408,10,4675766620
14898,105524380,30508401,136032781,5,0,0,1024,10,10694275337
14899,105527520,31317112,136844632,8,0,0,38400,8,5270028571
14900,105533300,38367638,143900938,0,0,1,2048,3,2866280737
14901,105534880,30626749,136161629,5,0,0,1024,10,9137869984
14902,105541180,38371286,143912466,8,0,1,30208,8,9598748489
14903,105570621,31043952,136614573,7,0,0,20480,10,6335308196
14904,105578390,30454056,136032446,5,0,0,1024,10,9396534500
14905,105585390,38327107,143912497,0,0,1,3072,3,9039365552
14906,105587319,30637629,136224948,3,0,0,17920,17,6963306728
14907,105588060,30785097,136373157,5,0,0,1024,10,6513493652
14908,105588729,30696256,136284985,3,0,0,32256,17,6816290645
14909,105591040,30807611,136398651,5,0,0,512,10,4437436943
14910,105593119,31049532,136642651,3,0,0,37888,17,10286819934
14911,105598791,30557630,136156421,7,0,0,4096,10,9523198644
14912,105605290,30553267,136158557,5,0,0,1024,10,6753823419
14913,105610040,30961369,136571409,0,0,0,132608,3,7615998743
14914,105611200,38301320,143912520,0,0,1,5632,3,842696610
14915,105611509,30911026,136522535,3,0,0,49664,17,1766155056
14916,105618100,30780193,136398293,0,0,0,64512,3,7455152288
14917,105618950,31302348,136921298,0,0,0,211968,3,4289086241
14918,105636840,38288322,143925162,6,0,1,11776,7,9601424731
14919,105638710,30941942,136580652,8,0,0,30208,8,494746946
14920,105662090,38328331,143990421,8,0,1,22016,8,3327951366
14921,105668340,30730132,136398472,5,0,0,512,10,6560991414
14922,105672310,38318142,143990452,0,0,1,512,3,3322599824
14923,105675800,38314675,143990475,0,0,1,4608,3,10383745451
14924,105678090,30929729,136607819,8,0,0,89088,8,9006641555
14925,105683020,38354780,144037800,8,0,1,78336,8,9937205697
14926,105716479,31693230,137409709,1,0,0,110592,10,2620637242
14927,105717681,31346257,137063938,7,0,0,16384,10,4268459933
14928,105724630,38353064,144077694,8,0,1,17920,8,8060028019
14929,105728370,38385016,144113386,1,0,1,4096,10,189552487
14930,105733110,38380299,144113409,0,0,1,1024,3,7908050898
14931,105742300,38371588,144113888,0,0,1,3584,3,10484463545
14932,105756360,31100307,136856667,8,0,0,39424,8,2556062844
14933,105761241,30524867,136286108,7,0,0,3584,10,4881364716
14934,105765621,30976158,136741779,7,0,0,54784,10,6038100631
14935,105769150,38345724,144114874,1,0,1,1536,10,3659069663
14936,105779260,31032957,136812217,5,0,0,1024,10,3149727337
14937,105783070,38358271,144141341,0,0,1,6656,3,1563754165
14938,105786280,30822030,136608310,5,0,0,1536,10,1478290042
14939,105787301,38354063,144141364,5,0,1,1024,10,8871390318
14940,105794890,38346497,144141387,1,0,1,512,10,7435974320
14941,105795920,38357837,144153757,0,0,1,6144,3,3597481176
14942,105797920,30913922,136711842,0,0,0,6144,3,2910200837
14943,105802091,30825929,136628020,7,0,0,44032,10,6702089013
14944,105808240,38835242,144643482,8,0,1,316928,8,10298842117
14945,105812300,38923111,144735411,8,0,1,114176,8,886118833
14946,105821090,38915947,144737037,1,0,1,2560,10,1632031760
14947,105823750,38923131,144746881,1,0,1,13312,10,10122634225
14948,105830940,31723685,137554625,0,0,0,101888,3,3787223963
14949,105841350,38915278,144756628,8,0,1,18432,8,9061694116
14950,105848410,30938958,136787368,0,0,0,11776,3,4565624865
14951,105856520,38901734,144758254,1,0,1,2560,10,7772352028
14952,105864721,38893879,144758600,8,0,1,512,8,5981780756
14953,105870060,38893686,144763746,0,0,1,8192,3,8138724447
14954,105890061,30770208,136660269,7,0,0,11264,10,6473689855
14955,105891010,31736205,137627215,0,0,0,9728,3,5772285214
14956,105897491,30797791,136695282,7,0,0,12288,10,5351815928
14957,105906490,38892672,144799162,8,0,1,6144,8,5781929039
14958,105925280,38874080,144799360,1,0,1,2048,10,6406434057
14959,105929150,38870876,144800026,0,0,1,11264,3,8529350403
14960,105941281,31150980,137092261,7,0,0,512,10,2215413789
14961,105942459,31393526,137335985,3,0,0,201216,17,10662886010
14962,105948540,38868314,144816854,0,0,1,14336,3,3939984717
14963,105951320,30821181,136772501,5,0,0,1024,10,4095696299
14964,105956420,38860895,144817315,0,0,1,10240,3,5791395791
14965,105957490,30834869,136792359,5,0,0,512,10,5735397723
14966,105962240,38944784,144907024,8,0,1,97792,8,1778916763
14967,105967551,31002671,136970222,7,0,0,15360,10,8438582895
14968,105987051,31087697,137074748,7,0,0,24576,10,5131745091
14969,105992740,38933039,144925779,1,0,1,18432,10,6341364615
14970,106025009,31632176,137657185,3,0,0,6144,17,3752022039
14971,106025061,38905864,144930925,5,0,1,8192,10,2355739242
14972,106037491,31388182,137425673,7,0,0,22016,10,1705228312
14973,106040349,31376214,137416563,3,0,0,16896,17,1343023581
14974,106051200,38888746,144939946,7,0,1,17408,10,7488988713
14975,106054940,31122304,137177244,0,0,0,44544,3,6266584680
14976,106060351,38880261,144940612,5,0,1,1024,10,7542575345
14977,106063870,38881248,144945118,1,0,1,7168,10,7717087802
14978,106069561,38880383,144949944,5,0,1,7680,10,2060523251
14979,106069850,38880440,144950290,3,0,1,512,17,8815799248
14980,106080670,38961561,145042231,8,0,1,133632,8,9072038486
14981,106084141,31657039,137741180,7,0,0,113152,10,10223964207
14982,106087371,38982957,145070328,5,0,1,7168,10,6202384595
14983,106093310,31420021,137513331,8,0,0,43008,8,9343388626
14984,106111100,38960214,145071314,8,0,1,1536,8,1798383162
14985,106113849,31296530,137410379,3,0,0,2048,17,7632447652
14986,106115260,30815915,136931175,5,0,0,2048,10,248916355
14987,106125271,38952763,145078034,5,0,1,7680,10,259675692
14988,106127501,38976777,145104278,5,0,1,512,10,7731143590
14989,106129350,31086753,137216103,5,0,0,512,10,7686595937
14990,106134510,38969791,145104301,7,0,1,2048,10,7093359619
14991,106134701,38969623,145104324,5,0,1,512,10,6119838673
14992,106138611,31123825,137262436,7,0,0,40448,10,3549189041
14993,106169280,31256572,137425852,5,0,0,512,10,986567
14994,106177031,31256956,137433987,7,0,0,26624,10,6771322039
14995,106180161,38924186,145104347,5,0,1,14336,10,9310810142
14996,106180990,38994212,145175202,8,0,1,82944,8,4718481733
14997,106198480,38988911,145187391,1,0,1,8192,10,1623130200
14998,106203130,31573741,137776871,5,0,0,2048,10,6482242108
14999,106219601,38968456,145188057,5,0,1,1024,10,3314831451
15000,106222160,30961899,137184059,8,0,0,6144,8,5440204175
15001,106238790,30903256,137142046,0,0,0,19456,3,1897492009
15002,106240231,38953418,145193649,5,0,1,20992,10,8381147998
15003,106241321,38971274,145212595,5,0,1,1536,10,7531800248
15004,106244280,39010655,145254935,8,0,1,12288,8,8441194148
15005,106256730,39006982,145263712,8,0,1,26624,8,2080730273
15006,106263031,39003241,145266272,5,0,1,2560,10,4669701097
15007,106264540,39047940,145312480,1,0,1,2560,10,8751119331
15008,106270650,39052986,145323636,8,0,1,36352,8,6205775093
15009,106279151,39097593,145376744,8,0,1,30208,8,3233651019
15010,106297021,39079746,145376767,5,0,1,8192,10,5507896749
15011,106308800,39082419,145391219,1,0,1,8704,10,4247165850
15012,106319399,31456817,137776216,3,0,0,25088,17,1871095537
15013,106325969,31049975,137375944,3,0,0,131072,17,3770026382
15014,106326071,31085142,137411213,7,0,0,1536,10,4009178799
15015,106328789,30785225,137114014,3,0,0,3072,17,4500350795
15016,106361231,30762592,137123823,7,0,0,512,10,5374570031
15017,106369420,31237806,137607226,0,0,0,66560,3,4890598898
15018,106369841,39046681,145416522,8,0,1,37376,8,2470453203
15019,106379070,39051064,145430134,7,0,1,6144,10,2309699
15020,106381870,31107476,137489346,8,0,0,83968,8,320518259
15021,106386050,30764695,137150745,5,0,0,2048,10,3437700915
15022,106399081,39039050,145438131,5,0,1,2560,10,6708018513
15023,106408800,31163476,137572276,8,0,0,57856,8,1200839122
15024,106409781,39042910,145452691,5,0,1,3072,10,5061226137
15025,106415050,39155253,145570303,7,0,1,10752,10,10192856593
15026,106416071,39158316,145574387,5,0,1,512,10,874319445
15027,106428770,30845884,137274654,4,0,0,10240,15,176096468
15028,106432670,30978722,137411392,5,0,0,512,10,1431186316
15029,106433190,30977524,137410714,5,0,0,1024,10,4195589694
15030,106435030,31012599,137447629,0,0,0,22016,3,53215156
15031,106436220,31004654,137440874,0,0,0,22528,3,2807912242
15032,106447719,39127974,145575693,4,0,1,2048,15,4645819327
15033,106449820,30969106,137418926,0,0,0,7680,3,1934206871
15034,106464699,39111762,145576461,4,0,1,11776,15,10222689563
15035,106465700,31407941,137873641,8,0,0,112640,8,1801808671
15036,106475871,39102978,145578849,8,0,1,1024,8,4689463979
15037,106475899,31292315,137768214,3,0,0,48640,17,5219282403
15038,106484820,31096113,137580933,0,0,0,4608,3,5334958041
15039,106494010,39088065,145582075,1,0,1,5120,10,9871904849
15040,106495690,30995384,137491074,5,0,0,1536,10,5600517272
15041,106498121,30949711,137447832,7,0,0,512,10,577491359
15042,106505740,39078601,145584341,1,0,1,3584,10,4433254435
15043,106505990,39091938,145597928,7,0,1,2560,10,10365065026
15044,106512191,39126674,145638865,5,0,1,19968,10,6010130589
15045,106518050,31131487,137649537,0,0,0,18944,3,6886117618
15046,106522830,39116906,145639736,1,0,1,12288,10,2376641411
15047,106532410,31047096,137579506,8,0,0,21504,8,1007064384
15048,106557901,39177659,145735560,8,0,1,45056,8,7395840989
15049,106563341,39172250,145735591,5,0,1,5632,10,7337709074
15050,106569480,31003443,137572923,8,0,0,2048,8,5180750085
15051,106586400,39170130,145756530,7,0,1,1024,10,9463058751
15052,106590691,39166505,145757196,5,0,1,1024,10,2351558246
15053,106597299,39163763,145761062,4,0,1,6144,15,1262008400
15054,106608349,31004828,137613177,3,0,0,19456,17,5851600672
15055,106615670,39146058,145761728,1,0,1,1024,10,9072223788
15056,106616320,31004142,137620462,2,0,0,4096,3,5251451786
15057,106624490,31064718,137689208,8,0,0,3072,8,6227097889
15058,106629879,39132195,145762074,4,0,1,512,15,8960209127
15059,106632060,39135160,145767220,7,0,1,8192,10,6663502579
15060,106635651,31014065,137649716,7,0,0,512,10,6915389476
15061,106639671,39133744,145773415,5,0,1,9728,10,290447059
15062,106645060,39136671,145781731,1,0,1,512,10,710773459
15063,106646640,31106731,137753371,0,0,0,39936,3,6264660651
15064,106651601,30975793,137627394,7,0,0,512,10,4895962924
15065,106660990,31155836,137816826,8,0,0,32256,8,1758555042
15066,106668711,39114966,145783677,5,0,1,3072,10,2166998550
15067,106671140,39135728,145806868,7,0,1,4096,10,917421042
15068,106689351,39117540,145806891,5,0,1,512,10,6655782504
15069,106689410,39117504,145806914,7,0,1,2560,10,5551176660
15070,106695740,31083494,137779234,0,0,0,7680,3,8509114234
15071,106699880,30913632,137613512,5,0,0,1024,10,6067403666
15072,106711850,39099731,145811581,6,0,1,2048,7,10700893358
15073,106715259,39104815,145820074,4,0,1,1024,15,9272400553
15074,106719659,39104601,145824260,4,0,1,6656,15,10019882480
15075,106728721,31088440,137817161,7,0,0,1024,10,690824469
15076,106738070,39097024,145835094,7,0,1,3584,10,9246405986
15077,106753270,39081847,145835117,1,0,1,4608,10,4048968492
15078,106753471,39081669,145835140,5,0,1,2048,10,10320735538
15079,106763490,39072100,145835590,1,0,1,7680,10,215835831
15080,106791101,30977448,137768549,7,0,0,1024,10,5818275654
15081,106792970,31084172,137877142,0,0,0,9728,3,5545401356
15082,106810080,31198336,138008416,0,0,0,47104,3,267392313
15083,106816140,31058015,137874155,5,0,0,1536,10,9625521973
15084,106817449,39019012,145836461,4,0,1,12288,15,7074700202
15085,106827830,39008977,145836807,6,0,1,512,7,9634578254
15086,106864540,31393267,138257807,8,0,0,114176,8,8440349803
15087,106875290,31207982,138083272,8,0,0,27648,8,7907609293
15088,106876540,31198285,138074825,0,0,0,32256,3,1479419786
15089,106884200,31240163,138124363,0,0,0,12288,3,4192204229
15090,106886820,38950973,145837793,6,0,1,1536,7,9743094517
15091,106892100,38950161,145842261,7,0,1,2560,10,1276880
15092,106892510,38950737,145843247,1,0,1,1536,10,10557267785
15093,106894710,31229832,138124542,5,0,0,512,10,2137814426
15094,106896871,31039201,137936072,7,0,0,3584,10,3414890144
15095,106900920,38943505,145844425,1,0,1,13824,10,7880899891
15096,106903200,38952275,145855475,1,0,1,5632,10,7470920981
15097,106908090,31202444,138110534,0,0,0,37376,3,2114442075
15098,106909120,38949581,145858701,7,0,1,5120,10,2169653669
15099,106934531,31148920,138083451,7,0,0,512,10,163278339
15100,106951460,38907907,145859367,7,0,1,1024,10,7271792997
15101,106955540,31135790,138091330,5,0,0,512,10,10573666938
15102,106958650,31303236,138261886,8,0,0,13312,8,1792020911
15103,106958940,38905279,145864219,7,0,1,7680,10,1328010170
15104,106967840,38896943,145864783,1,0,1,10752,10,1069184503
15105,106968590,38897499,145866089,7,0,1,2048,10,9702072945
15106,106987211,31158999,138146210,7,0,0,1024,10,8377178045
15107,106998130,31174426,138172556,0,0,0,10752,3,3761358045
15108,107006691,31207286,138213977,7,0,0,512,10,8148080638
15109,107022850,38856314,145879164,1,0,1,1024,10,2843861312
15110,107039310,31626607,138665917,0,0,0,48128,3,2865148821
15111,107044390,31316442,138360832,8,0,0,70656,8,5131561058
15112,107047511,31679903,138727414,7,0,0,1536,10,3288820609
15113,107075790,31244837,138320627,5,0,0,512,10,7458175896
15114,107080940,38798570,145879510,1,0,1,512,10,3108904665
15115,107081220,38798956,145880176,1,0,1,11264,10,10479965464
15116,107090771,31285894,138376665,7,0,0,512,10,1462767924
15117,107101671,31380539,138482210,7,0,0,1024,10,1392282153
15118,107111171,31425079,138536250,7,0,0,2048,10,8723569957
15119,107112571,31200162,138312733,7,0,0,1024,10,8429615083
15120,107113600,31249462,138363062,8,0,0,7168,8,2343350838
15121,107119750,38760772,145880522,3,0,1,512,17,8944268067
15122,107126670,31388593,138515263,8,0,0,28672,8,3844872086
15123,107134620,31687704,138822324,0,0,0,73216,3,868931077
15124,107173990,31272433,138446423,0,0,0,1536,3,7627444904
15125,107177110,31498970,138676080,8,0,0,33280,8,7771814905
15126,107183201,31518595,138701796,7,0,0,1024,10,8547728582
15127,107196720,31492643,138689363,8,0,0,43520,8,2408839319
15128,107205531,31188014,138393545,7,0,0,512,10,872938665
15129,107209870,31817877,139027747,8,0,0,44544,8,6391717835
15130,107241720,31534447,138776167,0,0,0,66048,3,2599731541
15131,107257250,38623618,145880868,1,0,1,512,10,8369336925
15132,107258400,31361619,138620019,0,0,0,38912,3,332698981
15133,107273610,31261993,138535603,8,0,0,9728,8,5530252750
15134,107330030,31126757,138456787,5,0,0,2048,10,1656976400
15135,107344680,31220787,138565467,5,0,0,1024,10,6455237483
15136,107345860,38536954,145882814,1,0,1,3072,10,6079861023
15137,107347151,31370648,138717799,7,0,0,512,10,5817946073
15138,107366030,38519454,145885484,1,0,1,1024,10,1276517786
15139,107376090,38519716,145895806,1,0,1,4096,10,7947806211
15140,107377030,38522002,145899032,1,0,1,5120,10,10485547769
15141,107379400,31511036,138890436,8,0,0,40960,8,825609758
15142,107389180,38510838,145900018,1,0,1,1536,10,6006298719
15143,107404820,31371526,138776346,5,0,0,512,10,379596591
15144,107416890,31455647,138872537,0,0,0,68096,3,1187296648
15145,107418080,31412067,138830147,0,0,0,25600,3,4579743033
15146,107424770,38477194,145901964,1,0,1,3072,10,6320197365
15147,107434930,31346783,138781713,0,0,0,17408,3,10572923740
15148,107443690,38478609,145922299,1,0,1,7680,10,3632398258
15149,107444270,31127456,138571726,5,0,0,512,10,10279078883
15150,107452510,31110222,138562732,5,0,0,1024,10,8157209345
15151,107481040,31612754,139093794,0,0,0,120832,3,10096539396
15152,107487710,38465429,145953139,7,0,1,15872,10,100601100
15153,107487800,38497414,145985214,7,0,1,4096,10,8290732702
15154,107492490,38494030,145986520,7,0,1,2048,10,7431860162
15155,107500130,31513687,139013817,0,0,0,116736,3,2189037206
15156,107516010,31185451,138701461,8,0,0,28672,8,8230316993
15157,107524480,38499583,146024063,7,0,1,6144,10,2707370456
15158,107527540,38506554,146034094,1,0,1,8192,10,4964949025
15159,107565260,38765258,146330518,1,0,1,512,10,6050570409
15160,107579871,31202029,138781900,7,0,0,512,10,194754289
15161,107589920,31525003,139114923,0,0,0,58880,3,680513180
15162,107591940,38740524,146332464,7,0,1,3072,10,6969034528
15163,107596141,31312802,138908943,7,0,0,512,10,9327875642
15164,107599410,38737807,146337217,2,0,1,9728,3,8288619525
15165,107603391,38991791,146595182,8,0,1,68608,8,9804988097
15166,107606350,38988855,146595205,7,0,1,512,10,9013094995
15167,107620521,39055709,146676230,8,0,1,35840,8,10611135016
15168,107626531,39050058,146676589,8,0,1,9728,8,10306371866
15169,107634680,39127302,146761982,2,0,1,1024,3,9548989756
15170,107637860,39159580,146797440,2,0,1,2560,3,5993701023
15171,107650710,39146753,146797463,1,0,1,1024,10,3164852526
15172,107671981,39127642,146799623,8,0,1,15360,8,664279989
15173,107683101,31488336,139171437,7,0,0,512,10,687671007
15174,107683681,39165626,146849307,8,0,1,11776,8,10101936547
15175,107685141,39198901,146884042,8,0,1,12288,8,4578290889
15176,107695650,39188415,146884065,1,0,1,9216,10,972403855
15177,107705610,31172277,138877887,8,0,0,17408,8,10074730764
15178,107739240,39144848,146884088,2,0,1,9216,3,2624766689
15179,107739790,31235099,138974889,5,0,0,1024,10,5563883844
15180,107749551,39561609,147311160,8,0,1,146432,8,2072750795
15181,107768020,39543163,147311183,1,0,1,11776,10,9062914885
15182,107773971,39554931,147328902,8,0,1,512,8,65151847
15183,107776200,31237952,139014152,5,0,0,1024,10,9500394908
15184,107804631,39860343,147664974,8,0,1,154624,8,2509979613
15185,107805720,39860880,147666600,2,0,1,2560,3,5082439007
15186,107814550,31113263,138927813,0,0,0,17920,3,2732332618
15187,107818231,39905420,147723651,8,0,1,16384,8,10588196834
15188,107831051,39949761,147780812,8,0,1,62464,8,9069620548
15189,107837259,39943576,147780835,4,0,1,4096,15,8684440914
15190,107856210,31259220,139115430,5,0,0,1536,10,4505272664
15191,107856670,39924188,147780858,1,0,1,9216,10,3866617150
15192,107858730,39946877,147805607,6,0,1,6144,7,9697475130
15193,107861820,39943810,147805630,7,0,1,3584,10,3428278055
15194,107878180,39933427,147811607,1,0,1,1536,10,9843658853
15195,107880471,31148640,139029111,7,0,0,4096,10,9322634760
15196,107904220,31349244,139253464,0,0,0,15360,3,4895151301
15197,107904850,31192110,139096960,8,0,0,9728,8,8264495189
15198,107917620,39897213,147814833,1,0,1,5120,10,5479020884
15199,107927211,39984004,147911215,8,0,1,94208,8,7321572271
15200,107927710,39983528,147911238,7,0,1,1536,10,9514938286
15201,107931170,31162803,139093973,5,0,0,512,10,3864932321
15202,107932890,40003880,147936770,2,0,1,1536,3,9246185472
15203,107938650,39998466,147937116,1,0,1,512,10,7079992494
15204,107947870,39989592,147937462,7,0,1,512,10,366006303
15205,107955000,31080785,139035785,5,0,0,4096,10,1661273220
15206,107965190,40209509,148174699,8,0,1,152576,8,1883328767
15207,107982160,31047130,139029290,5,0,0,512,10,4253240339
15208,107983080,40192285,148175365,2,0,1,1024,3,4715296803
15209,107986310,40192921,148179231,3,0,1,6144,17,2754481998
15210,107989001,40231421,148220422,8,0,1,61952,8,2963289437
15211,107990480,40231248,148221728,7,0,1,2048,10,9498727725
15212,107997461,40402565,148400026,8,0,1,136704,8,8642893651
15213,107997861,31236498,139234359,7,0,0,1536,10,1851741978
15214,107998610,31472241,139470851,0,0,0,79360,3,3769311455
15215,108026580,40403180,148429760,1,0,1,41984,10,8352644651
15216,108028521,40482604,148511125,8,0,1,68608,8,5526730696
15217,108029390,40484961,148514351,2,0,1,5120,3,4046180836
15218,108067420,40460847,148528267,7,0,1,3584,10,10314694932
15219,108073910,40456943,148530853,2,0,1,4096,3,9161309967
15220,108079490,31060330,139139820,0,0,0,6656,3,1031778593
15221,108080290,40451549,148531839,3,0,1,1536,17,2193996805
15222,108082980,40451125,148534105,1,0,1,3584,10,2657446812
15223,108084171,31139289,139223460,7,0,0,2048,10,1857331881
15224,108085421,31234130,139319551,7,0,0,1024,10,608534750
15225,108092700,40442391,148535091,3,0,1,1536,17,6061593325
15226,108098510,31199924,139298434,8,0,0,56320,8,4970641707
15227,108108040,40430277,148538317,7,0,1,5120,10,3349106576
15228,108108090,31123846,139231936,8,0,0,512,8,4403554866
15229,108117420,31232038,139349458,0,0,0,62464,3,9174648784
15230,108119200,40426825,148546025,3,0,1,15360,17,8025184743
15231,108128580,40420671,148549251,3,0,1,5120,17,8656201193
15232,108135480,31262499,139397979,5,0,0,1024,10,214784829
15233,108147571,31069745,139217316,7,0,0,2048,10,6560387760
15234,108158611,40407620,148566231,8,0,1,32768,8,2139143531
15235,108159191,31087544,139246735,7,0,0,512,10,46211261
15236,108175631,40398097,148573728,5,0,1,2048,10,7506299488
15237,108176050,40399810,148575860,2,0,1,512,3,5557362077
15238,108182270,40394563,148576833,2,0,1,12800,3,6340546427
15239,108197290,40382693,148579983,3,0,1,14848,17,3588696823
15240,108200600,31342046,139542646,8,0,0,22016,8,4543677704
15241,108201150,31280089,139481239,0,0,0,32768,3,5268384563
15242,108215950,40366081,148582031,7,0,1,10752,10,8619077701
15243,108228361,40401526,148629887,8,0,1,25600,8,6495029468
15244,108229590,40448969,148678559,2,0,1,1536,3,1968123844
15245,108232230,31209054,139441284,0,0,0,7168,3,1056848034
15246,108241021,31230211,139471232,7,0,0,1024,10,7989041918
15247,108246210,40433015,148679225,1,0,1,1024,10,8819106968
15248,108248260,40455652,148703912,1,0,1,20480,10,5735273207
15249,108249749,40454829,148704578,4,0,1,1024,15,7049240007
15250,108253570,31144074,139397644,5,0,0,2560,10,7938327686
15251,108262770,31363893,139626663,8,0,0,16896,8,1609756853
15252,108278931,40456301,148735232,8,0,1,33792,8,4310301334
15253,108285460,40449795,148735255,2,0,1,3584,3,3613455162
15254,108289291,40573427,148862718,8,0,1,58880,8,1393581055
15255,108289800,40572941,148862741,3,0,1,1024,17,9685185247
15256,108300490,40562282,148862772,1,0,1,1536,10,5939600451
15257,108308540,31312773,139621313,8,0,0,40960,8,7344043511
15258,108313890,31294302,139608192,5,0,0,512,10,5229732677
15259,108334150,31208831,139542981,5,0,0,1024,10,8043480114
15260,108345431,31276061,139621492,7,0,0,512,10,1186733452
15261,108351870,31402469,139754339,8,0,0,24064,8,4096907090
15262,108353250,40560985,148914235,7,0,1,21504,10,10263684372
15263,108359570,40554688,148914258,3,0,1,9728,17,5058002304
15264,108360680,40558468,148919148,7,0,1,4608,10,7541240634
15265,108368200,31200085,139568285,0,0,0,7680,3,5972815349
15266,108368230,31338687,139706917,8,0,0,20992,8,9857334576
15267,108374181,40544990,148919171,8,0,1,1536,8,171088147
15268,108374419,40544775,148919194,4,0,1,512,15,5079390827
15269,108374510,40544894,148919404,2,0,1,26112,3,10628876830
15270,108374750,31397286,139772036,5,0,0,512,10,7188736568
15271,108390320,40554056,148944376,2,0,1,2560,3,10454661227
15272,108390340,31287759,139678099,5,0,0,512,10,216276714
15273,108406820,40538382,148945202,7,0,1,16384,10,4379973836
15274,108411690,40535511,148947201,7,0,1,6144,10,39054998
15275,108424010,31204202,139628212,5,0,0,512,10,3733651789
15276,108433190,40514677,148947867,2,0,1,1024,3,7825965370
15277,108435160,31607822,140042982,8,0,0,9728,8,2978119001
15278,108441580,31335940,139777520,0,0,0,15872,3,4949264870
15279,108458700,31422857,139881557,0,0,0,43008,3,416794363
15280,108459200,40490933,148950133,2,0,1,3584,3,7177224756
15281,108459570,40501489,148961059,7,0,1,2048,10,5439831739
15282,108460120,40505125,148965245,2,0,1,6656,3,3946738519
15283,108466080,31313372,139779452,5,0,0,2048,10,1654061555
15284,108490040,40479391,148969431,7,0,1,6656,10,4460643548
15285,108495031,40508360,149003391,8,0,1,22016,8,4730010070
15286,108495331,40582468,149077799,8,0,1,76800,8,3581020087
15287,108497770,40582615,149080385,0,0,1,4096,3,8276337374
15288,108509370,40573711,149083081,7,0,1,1536,10,5989628769
15289,108512590,40573717,149086307,7,0,1,5120,10,7753723328
15290,108516290,40574523,149090813,7,0,1,7168,10,45165748
15291,108519961,40581823,149101784,5,0,1,512,10,6439258473
15292,108527331,40576399,149103730,8,0,1,3072,8,8469649828
15293,108530381,40858852,149389233,8,0,1,188416,8,7390960329
15294,108531430,40857826,149389256,7,0,1,6144,10,7293569930
15295,108544221,40917605,149461826,8,0,1,45056,8,7048928164
15296,108546900,31700563,140247463,0,0,0,73728,3,6676147960
15297,108550901,40910948,149461849,8,0,1,3072,8,8094370381
15298,108551161,31943807,140494968,7,0,0,1024,10,6438825424
15299,108557190,31522848,140080038,8,0,0,8192,8,10510504123
15300,108570220,31745792,140316012,0,0,0,46080,3,9941070260
15301,108574389,40887483,149461872,4,0,1,17920,15,6313736547
15302,108574830,31680638,140255468,5,0,0,1024,10,10696988943
15303,108582001,40879894,149461895,8,0,1,24064,8,9521868525
15304,108590410,31384579,139974989,5,0,0,4608,10,6535645444
15305,108612150,40872240,149484390,7,0,1,1024,10,9747262260
15306,108613520,40875056,149488576,1,0,1,6656,10,5472219439
15307,108617031,40882433,149499464,5,0,1,10752,10,6164287100
15308,108632341,40867789,149500130,5,0,1,1024,10,3999873500
15309,108638139,40875342,149513481,4,0,1,11264,15,6071278744
15310,108644150,31362501,140006651,5,0,0,1536,10,5732663564
15311,108667420,31300662,139968082,0,0,0,54272,3,80662211
15312,108671191,40842636,149513827,5,0,1,512,10,10383671750
15313,108681640,31677180,140358820,5,0,0,1024,10,3419911761
15314,108686260,31448859,140135119,5,0,0,512,10,3873099605
15315,108689811,31412961,140102772,7,0,0,1024,10,8798813136
15316,108704210,31294412,139998622,5,0,0,1024,10,7265179115
15317,108719510,40795303,149514813,3,0,1,1536,17,5142115914
15318,108725121,31426767,140151888,7,0,0,1536,10,4249752037
15319,108740310,31945718,140686028,5,0,0,512,10,5240352613
15320,108747690,40770989,149518679,7,0,1,6144,10,816424706
15321,108748109,40789867,149537976,4,0,1,22528,15,2264094519
15322,108748381,31457431,140205812,7,0,0,512,10,6371109180
15323,108757771,31340406,140098177,7,0,0,512,10,1280719505
15324,108778251,31210817,139989068,7,0,0,2560,10,4146239785
15325,108780470,31829724,140610194,0,0,0,92160,3,4087144895
15326,108789640,40751562,149541202,6,0,1,5120,7,6088113662
15327,108795110,40746348,149541458,6,0,1,9216,7,8246271038
15328,108797650,40759404,149557054,9,0,1,12800,12,5196205214
15329,108826800,31657422,140484222,8,0,0,42496,8,8019134878
15330,108829980,31354861,140184841,5,0,0,1024,10,8850802333
15331,108847920,40722857,149570777,6,0,1,8704,7,4595052533
15332,108849020,31136165,139985185,8,0,0,4608,8,5488240996
15333,108864400,40710628,149575028,7,0,1,1536,10,3094912456
15334,108866180,31384236,140250416,8,0,0,4608,8,1030854402
15335,108866950,40710664,149577614,7,0,1,4096,10,5300958316
15336,108867760,31321444,140189204,0,0,0,2560,3,9553856021
15337,108872440,40707441,149579881,6,0,1,10752,7,6071734095
15338,108873750,40708077,149581827,7,0,1,3072,10,7504790974
15339,108884659,40701034,149585693,4,0,1,6144,15,5024107493
15340,108892179,40698322,149590501,4,0,1,2560,15,2115025837
15341,108898840,40692327,149591167,7,0,1,1024,10,415772833
15342,108917371,31348946,140266317,7,0,0,4096,10,9230479149
15343,108925550,40670123,149595673,3,0,1,7168,17,3599225352
15344,108929560,40667419,149596979,6,0,1,2048,7,5220755218
15345,108935830,31215567,140151397,5,0,0,1536,10,7056235906
15346,108936410,31589497,140525907,8,0,0,31232,8,7188344151
15347,108936720,31431900,140368620,8,0,0,26624,8,5476681469
15348,108941021,31509697,140450718,7,0,0,2560,10,4690182899
15349,108949720,31773419,140723139,0,0,0,107520,3,2251199387
15350,108950180,40649385,149599565,6,0,1,4096,7,2194871859
15351,108964251,31562303,140526554,7,0,0,2048,10,7060408947
15352,108967170,40633727,149600897,3,0,1,2048,17,8067356058
15353,108969360,40634123,149603483,7,0,1,4096,10,8347789130
15354,108972450,40644895,149617345,6,0,1,10240,7,3663025103
15355,108973170,31322361,140295531,8,0,0,3072,8,4630430508
15356,108992750,31661519,140654269,5,0,0,512,10,2401722128
15357,108994950,40636466,149631416,6,0,1,4096,7,8052724741
15358,109005930,31273135,140279065,5,0,0,512,10,4891506359
15359,109021610,31754719,140776329,4,0,0,44032,15,806867601
15360,109022510,31225311,140247821,5,0,0,1024,10,3848064800
15361,109028271,31171797,140200068,7,0,0,512,10,9587622861
15362,109032990,31695134,140728124,0,0,0,10240,3,5581454322
15363,109036150,31707400,140743550,8,0,0,5120,8,3704952033
15364,109041141,31244380,140285521,7,0,0,1536,10,5479421112
15365,109092660,31242778,140335438,5,0,0,1024,10,3766230850
15366,109095830,31641185,140737015,4,0,0,10752,15,9477016231
15367,109107200,31546890,140654090,0,0,0,50688,3,8950950057
15368,109108680,31527937,140636617,0,0,0,25600,3,5168931549
15369,109119750,40513932,149633682,6,0,1,3584,7,5366040033
15370,109120611,31409417,140530028,7,0,0,2560,10,8124758276
15371,109150390,31776155,140926545,4,0,0,21504,15,6187568533
15372,109151530,40485698,149637228,6,0,1,5632,7,7148290334
15373,109169041,31276976,140446017,7,0,0,2048,10,4046829941
15374,109173890,40468758,149642648,7,0,1,12800,10,2086242600
15375,109183440,31301429,140484869,5,0,0,2048,10,5412459675
15376,109198510,31054466,140252976,5,0,0,512,10,7560104915
15377,109205950,40439924,149645874,7,0,1,5120,10,653008956
15378,109218481,40428379,149646860,8,0,1,1536,8,9607278221
15379,109228980,31306213,140535193,5,0,0,2048,10,5914496952
15380,109248010,31950379,141198389,4,0,0,19456,15,3248822186
15381,109259370,31803635,141063005,0,0,0,42496,3,1279741775
15382,109275140,40372181,149647321,6,0,1,10240,7,7780719872
15383,109275450,31879157,141154607,0,0,0,80384,3,4720409846
15384,109295891,31448848,140744739,7,0,0,512,10,10312110136
15385,109308200,40357923,149666123,7,0,1,17408,10,2601333953
15386,109312060,31664230,140976290,0,0,0,96256,3,5032254898
15387,109332861,31717173,141050034,7,0,0,1536,10,8253956924
15388,109334810,31492497,140827307,8,0,0,40960,8,4142790492
15389,109346120,31762803,141108923,4,0,0,55808,15,8190707353
15390,109358640,31528790,140887430,4,0,0,91136,15,10564921703
15391,109362140,31584537,140946677,8,0,0,38400,8,7516375128
15392,109375460,31625763,141001223,4,0,0,37888,15,9935540494
15393,109385320,40280957,149666277,7,0,1,8704,10,2788357131
15394,109386210,31663333,141049543,0,0,0,157696,3,549422764
15395,109387021,31007030,140394051,7,0,0,1536,10,9780006183
15396,109398440,31361166,140759606,5,0,0,1536,10,8838988296
15397,109402351,31013077,140415428,7,0,0,3072,10,2839668769
15398,109405481,31349673,140755154,7,0,0,2048,10,614460697
15399,109418730,31557895,140976625,5,0,0,1024,10,4456905098
15400,109421370,31160721,140582091,0,0,0,8704,3,6246773812
15401,109425161,31190680,140615841,7,0,0,18432,10,266440130
15402,109427200,40245622,149672822,7,0,1,1024,10,10231185233
15403,109463730,31424884,140888614,5,0,0,1024,10,9546800323
15404,109468530,31647124,141115654,4,0,0,22016,15,1775915000
15405,109476760,40199928,149676688,6,0,1,6144,7,8983807615
15406,109479800,40199794,149679594,1,0,1,4608,10,7223613764
15407,109484020,40196240,149680260,1,0,1,1024,10,2438083300
15408,109490680,31290460,140781140,5,0,0,512,10,5374939407
15409,109491990,31587400,141079390,8,0,0,8192,8,2695673740
15410,109504550,31571807,141076357,0,0,0,15360,3,2165659252
15411,109507290,31276191,140783481,5,0,0,512,10,403404587
15412,109510300,40172866,149683166,6,0,1,4608,7,3774196372
15413,109518030,31836191,141354221,0,0,0,89600,3,200098384
15414,109519140,40167931,149687071,6,0,1,15360,7,3375166676
15415,109526520,31739204,141265724,0,0,0,54784,3,606679657
15416,109527120,40161283,149688403,1,0,1,2048,10,5531661275
15417,109532250,40158099,149690349,6,0,1,3072,7,8429262381
15418,109533030,31649650,141182680,0,0,0,512,3,9439820775
15419,109536221,31383749,140919970,7,0,0,23040,10,3913394852
15420,109544330,31402526,140946856,0,0,0,512,3,9624852904
15421,109546710,40146225,149692935,7,0,1,4096,10,2879119921
15422,109559600,31247994,140807594,5,0,0,512,10,2766427162
15423,109562790,31516802,141079592,5,0,0,512,10,5789348234
15424,109566990,40131091,149698081,6,0,1,8192,7,6921939131
15425,109567040,40135979,149703019,6,0,1,5120,7,1639128654
15426,109568630,40134735,149703365,1,0,1,512,10,1529677
15427,109575941,31515062,141091003,7,0,0,37376,10,5587903031
15428,109580080,40126575,149706655,7,0,1,512,10,6044005900
15429,109586140,40121501,149707641,6,0,1,1536,7,361174866
15430,109594220,40116647,149710867,6,0,1,5120,7,10269826778
15431,109605721,31307056,140912777,7,0,0,18432,10,6392350758
15432,109614430,31477458,141091888,5,0,0,1024,10,5476848792
15433,109621620,31618014,141239634,0,0,0,512,3,7987433021
15434,109624200,31624786,141248986,4,0,0,15360,15,10549755105
15435,109625720,40092447,149718167,6,0,1,26112,7,2052019242
15436,109628200,31154057,140782257,4,0,0,1536,15,5068686367
15437,109629079,40120206,149749285,4,0,1,1024,15,5451354353
15438,109637980,40111328,149749308,7,0,1,14848,10,10663516623
15439,109638339,40117532,149755871,4,0,1,3584,15,1660213108
15440,109648069,40111028,149759097,4,0,1,5120,15,8936653257
15441,109649780,40113183,149762963,3,0,1,6144,17,8135813263
15442,109660900,31415948,141076848,5,0,0,1536,10,755921222
15443,109660990,40107119,149768109,7,0,1,8192,10,6047582887
15444,109672080,31216176,140888256,0,0,0,2560,3,3301391123
15445,109686400,31385231,141071631,8,0,0,18432,8,5141756897
15446,109689530,31733052,141422582,5,0,0,512,10,4539811006
15447,109695990,31502739,141198729,5,0,0,512,10,6391273858
15448,109697860,31368132,141065992,8,0,0,9728,8,6675714892
15449,109698180,40070493,149768673,2,0,1,10752,3,7226535926
15450,109700750,40088692,149789442,7,0,1,1536,10,10208199978
15451,109713291,31407394,141120685,7,0,0,16384,10,4947326218
15452,109714630,31553869,141268499,8,0,0,7680,8,7737932409
15453,109725060,31431128,141156188,0,0,0,512,3,10025955479
15454,109725570,31464457,141190027,5,0,0,512,10,8296578976
15455,109730910,40059198,149790108,7,0,1,1024,10,7627133705
15456,109739860,40055394,149795254,3,0,1,8192,17,1390631841
15457,109740240,40078727,149818967,7,0,1,512,10,2887384437
15458,109746970,31344391,141091361,0,0,0,1024,3,5644783537
15459,109752050,31403383,141155433,5,0,0,2560,10,856219123
15460,109760110,31415237,141175347,0,0,0,512,3,513629057
15461,109760990,40058643,149819633,6,0,1,1024,7,4561235576
15462,109773181,31515998,141289179,7,0,0,1024,10,2172304505
15463,109774990,31354470,141129460,8,0,0,28672,8,4791076886
15464,109776780,31353312,141130092,5,0,0,1024,10,3775811636
15465,109778490,40044049,149822539,6,0,1,4608,7,9063714446
15466,109779860,31386717,141166577,4,0,0,29184,15,6372082515
15467,109793400,40029485,149822885,7,0,1,512,10,5535527976
15468,109798190,40025361,149823551,3,0,1,1024,17,8015129362
15469,109814970,40009252,149824222,0,0,1,1024,3,1685992217
15470,109821560,31393385,141214945,8,0,0,512,8,6042308258
15471,109825710,31440426,141266136,0,0,0,512,3,10323911946
15472,109830760,39996709,149827469,0,0,1,5120,3,666322871
15473,109833940,31143020,140976960,0,0,0,1024,3,2885999457
15474,109857220,39972515,149829735,0,0,1,3584,3,10374820283
15475,109867490,39965914,149833404,7,0,1,4608,10,5172265654
15476,109877790,31511014,141388804,8,0,0,7168,8,8654806445
15477,109878070,31298813,141176883,0,0,0,512,3,2324667788
15478,109881630,31275985,141157615,4,0,0,4608,15,2803405307
15479,109884760,39956966,149841726,0,0,1,15872,3,6598321092
15480,109891760,39980442,149872202,6,0,1,16384,7,855108072
15481,109892820,31262854,141155674,0,0,0,512,3,10658632734
15482,109896640,31259369,141156009,0,0,0,1024,3,8845237332
15483,109900530,39972087,149872617,3,0,1,8704,17,2845929616
15484,109904470,39970472,149874942,0,0,1,4096,3,7368459012
15485,109919780,31209931,141129711,0,0,0,512,3,8144482265
15486,109924850,39953318,149878168,0,0,1,5120,3,4069879416
15487,109930080,39951873,149881953,3,0,1,5632,17,8913945668
15488,109930280,39952100,149882380,3,0,1,1024,17,10265562918
15489,109930470,39994178,149924648,6,0,1,18944,7,5766187643
15490,109932580,31638901,141571481,4,0,0,53248,15,4332613992
15491,109933930,39994904,149928834,3,0,1,6656,17,7789205812
15492,109938700,39992080,149930780,3,0,1,3072,17,4884556581
15493,109956130,31434649,141390779,5,0,0,1536,10,1609928460
15494,109958390,31223314,141181704,0,0,0,512,3,9958485088
15495,109964280,31503160,141467440,4,0,0,1536,15,1309516059
15496,109972270,31526335,141498605,8,0,0,54272,8,3953867314
15497,109980120,39989813,149969933,0,0,1,8704,3,10094654769
15498,109990790,39979604,149970394,6,0,1,10240,7,5138687581
15499,109997479,40021775,150019254,4,0,1,8192,15,593283268
15500,110005241,31717019,141722260,7,0,0,4096,10,7980620402
15501,110007050,31199728,141206778,4,0,0,1024,15,8057278566
15502,110015850,40147043,150162893,6,0,1,15872,7,10691156622
15503,110017100,40167691,150184791,7,0,1,1536,10,2448485332
15504,110050050,31465118,141515168,5,0,0,1024,10,379588507
15505,110052410,40132727,150185137,3,0,1,512,17,4949253780
15506,110064210,40123513,150187723,0,0,1,4096,3,10456140251
15507,110067720,31198214,141265934,4,0,0,512,15,5417562939
15508,110075190,40164811,150240001,3,0,1,15360,17,7118156486
15509,110076400,40163624,150240024,0,0,1,1536,3,7836228350
15510,110077570,40162477,150240047,7,0,1,1536,10,9906282181
15511,110078940,31195912,141274852,0,0,0,1024,3,4500577691
15512,110082190,40157880,150240070,6,0,1,5120,7,3438872416
15513,110084410,40156821,150241231,7,0,1,2048,10,4545386388
15514,110094950,40149187,150244137,7,0,1,4608,10,6504765430
15515,110099420,40159134,150258554,0,0,1,512,3,10015074111
15516,110110850,40147727,150258577,6,0,1,2048,7,3733326226
15517,110119850,31234619,141354469,0,0,0,512,3,6519569288
15518,110130880,40127728,150258608,3,0,1,8192,17,934694718
15519,110136031,31190867,141326898,7,0,0,24064,10,1808498692
15520,110144080,40121757,150265837,3,0,1,4608,17,8111986025
15521,110144590,40129198,150273788,0,0,1,12288,3,4113922550
15522,110150900,31533756,141684656,4,0,0,512,15,6191590018
15523,110151870,40228098,150379968,3,0,1,1024,17,7422368343
15524,110153330,31664287,141817617,8,0,0,86528,8,7347638852
15525,110153690,40226301,150379991,6,0,1,32256,7,6649460189
15526,110154201,31674592,141828793,7,0,0,34304,10,2397274269
15527,110155751,31266652,141422403,7,0,0,15872,10,960181126
15528,110157040,40222974,150380014,3,0,1,5120,17,4310410002
15529,110161140,40218897,150380037,6,0,1,1536,7,8062568451
15530,110171440,40208620,150380060,6,0,1,8704,7,3535131181
15531,110174739,40205344,150380083,4,0,1,1024,15,7510187596
15532,110179430,40200676,150380106,7,0,1,3072,10,6258025935
15533,110185380,40194749,150380129,6,0,1,9216,7,2008006152
15534,110198440,31522370,141720810,8,0,0,85504,8,8669129849
15535,110199300,31217387,141416687,5,0,0,512,10,4982500594
15536,110214420,31506569,141720989,5,0,0,512,10,7217145033
15537,110218250,31572154,141790404,8,0,0,80896,8,1608003730
15538,110220601,31246348,141466949,7,0,0,23552,10,9770761973
15539,110222800,31063307,141286107,0,0,0,1024,3,8898673250
15540,110241700,40138452,150380152,6,0,1,2048,7,10425069587
15541,110241830,31193295,141435125,8,0,0,12288,8,6125026614
15542,110242860,40137315,150380175,3,0,1,5632,17,1521188967
15543,110257020,40123178,150380198,3,0,1,10240,17,6827618921
15544,110257660,31241372,141499032,4,0,0,1024,15,8129667329
15545,110261589,40127624,150389213,4,0,1,4608,15,7814034611
15546,110275700,31256517,141532217,5,0,0,1024,10,4164665423
15547,110281820,40108867,150390687,7,0,1,9728,10,1858151368
15548,110283240,31227683,141510923,8,0,0,6144,8,1569725142
15549,110294310,31310849,141605159,8,0,0,40960,8,2783199617
15550,110297919,40098668,150396587,4,0,1,5120,15,6051215400
15551,110320461,31551030,141871491,7,0,0,1024,10,6547183213
15552,110323170,31261529,141584699,0,0,0,1024,3,322005536
15553,110324420,40073793,150398213,3,0,1,2560,17,10161986396
15554,110328839,40074200,150403039,4,0,1,7680,15,5770434196
15555,110329140,31242832,141571972,0,0,0,1536,3,5206170524
15556,110348020,31521115,141869135,8,0,0,37888,8,4984072977
15557,110361990,31270975,141632965,5,0,0,512,10,7191798872
15558,110369471,40034336,150403807,8,0,1,11776,8,5975738886
15559,110371880,31457271,141829151,0,0,0,1024,3,7657662351
15560,110382360,40035535,150417895,7,0,1,20480,10,4472644279
15561,110393550,31088333,141481883,4,0,0,512,15,931675121
15562,110400189,40020292,150420481,4,0,1,4096,15,10704332060
15563,110401110,31506473,141907583,4,0,0,512,15,732096785
15564,110402090,31333482,141735572,8,0,0,16384,8,2181415553
15565,110407311,31140218,141547529,7,0,0,9216,10,5755322582
15566,110412141,40018562,150430703,5,0,1,6656,10,4651368960
15567,110412840,31168631,141581471,5,0,0,512,10,10026356013
15568,110414540,31127205,141541745,4,0,0,2048,15,331554627
15569,110415800,40021296,150437096,7,0,1,1536,10,10569953443
15570,110416111,40021971,150438082,5,0,1,1536,10,9155303837
15571,110432531,40007497,150440028,5,0,1,3072,10,2650672247
15572,110435840,31228784,141664624,4,0,0,512,15,7905280429
15573,110438659,40005875,150444534,4,0,1,7168,15,8324399802
15574,110439470,40011474,150450944,6,0,1,8192,7,9848613365
15575,110451780,39999526,150451306,7,0,1,2560,10,9849649149
15576,110452790,39999502,150452292,7,0,1,1536,10,4440963994
15577,110453870,31295682,141749552,4,0,0,512,15,4762100298
15578,110454540,30988351,141442891,0,0,0,3072,3,5463026478
15579,110455710,31149940,141605650,0,0,0,1536,3,4757869761
15580,110463701,39989257,150452958,5,0,1,1024,10,10323984533
15581,110469649,40010443,150480092,4,0,1,7680,15,1215766232
15582,110475050,40005065,150480115,1,0,1,5632,10,3058007048
15583,110476499,40003639,150480138,4,0,1,1024,15,213000590
15584,110478420,31368793,141847213,0,0,0,512,3,10383366534
15585,110480861,31606003,142086864,7,0,0,86528,10,5790150197
15586,110484440,31684798,142169238,8,0,0,23040,8,10385392073
15587,110485740,39994421,150480161,7,0,1,8704,10,2339188365
15588,110491010,31327277,141818287,4,0,0,512,15,6361071272
15589,110494970,39988461,150483431,6,0,1,8192,7,10058264954
15590,110495211,31344016,141839227,7,0,0,31232,10,7501598890
15591,110495510,40011871,150507381,6,0,1,8192,7,10424751367
15592,110500710,40008297,150509007,0,0,1,2560,3,7393605617
15593,110506760,31174900,141681660,8,0,0,17920,8,2088419075
15594,110522889,39988090,150510979,4,0,1,3072,15,9412125657
15595,110524040,39988565,150512605,7,0,1,2560,10,6771479229
15596,110526431,39991461,150517892,5,0,1,16896,10,9272968452
15597,110529831,39990967,150520798,5,0,1,4608,10,10026214390
15598,110530660,39998499,150529159,6,0,1,15872,7,5160089389
15599,110532650,39997314,150529964,6,0,1,7168,7,2562612490
15600,110536031,31426339,141962370,7,0,0,11776,10,6855024055
15601,110541450,39989180,150530630,6,0,1,1024,7,2482363717
15602,110542330,31180444,141722774,5,0,0,512,10,10663145001
15603,110544341,31591272,142135613,7,0,0,29696,10,5182919424
15604,110553460,31182603,141736063,0,0,0,1536,3,2337672962
15605,110559700,31188472,141748172,0,0,0,1024,3,9512684370
15606,110562051,39992648,150554699,5,0,1,16384,10,6535939044
15607,110577440,40009492,150586932,0,0,1,5632,3,4319597622
15608,110577610,31144985,141722595,5,0,0,1024,10,6620341734
15609,110591370,39996548,150587918,0,0,1,1536,3,10288787166
15610,110596610,31159711,141756321,5,0,0,3072,10,2384295481
15611,110597800,31231865,141829665,5,0,0,1536,10,4498609047
15612,110601441,39986823,150588264,5,0,1,512,10,5162667577
15613,110609261,40065030,150674291,8,0,1,71680,8,10073738340
15614,110623520,31217938,141841458,8,0,0,7168,8,2138015269
15615,110626850,31220160,141847010,8,0,0,17408,8,8078678074
15616,110637011,40037303,150674314,5,0,1,512,10,290159450
15617,110644609,40030219,150674828,4,0,1,1536,15,7649220677
15618,110647450,31170658,141818108,5,0,0,1536,10,2240755733
15619,110656520,31265612,141922132,5,0,0,1536,10,7169327286
15620,110670540,40007364,150677904,8,0,1,4608,8,5791730167
15621,110673090,31050019,141723109,8,0,0,1024,8,5613929774
15622,110675220,31116010,141791230,8,0,0,2560,8,1298272068
15623,110677590,31894255,142571845,8,0,0,120832,8,8735756061
15624,110703529,39978168,150681697,4,0,1,5120,15,10189692673
15625,110705570,40009408,150714978,7,0,1,3584,10,2025629794
15626,110706241,31645115,142351356,7,0,0,70144,10,8044891289
15627,110713621,40002663,150716284,5,0,1,2048,10,10215362747
15628,110713780,31290882,142004662,4,0,0,4096,15,10162111645
15629,110724990,31283429,142008419,5,0,0,1536,10,4853552156
15630,110733710,31107927,141841637,0,0,0,512,3,6307612445
15631,110742591,31534459,142277050,7,0,0,33792,10,675262347
15632,110749769,39969101,150718870,4,0,1,4096,15,478930920
15633,110763929,31492564,142256493,1,0,0,13824,10,4443555419
15634,110769170,31367269,142136439,5,0,0,1024,10,3140550853
15635,110773351,39946083,150719434,5,0,1,10752,10,6301068765
15636,110784541,31537300,142321841,7,0,0,15360,10,2031283597
15637,110787390,31224426,142011816,0,0,0,1536,3,4421538269
15638,110793380,39949322,150742702,3,0,1,3584,17,8997138980
15639,110801439,39944829,150746268,4,0,1,3072,15,7265466338
15640,110803401,39945133,150748534,5,0,1,3584,10,10563993150
15641,110805010,31042382,141847392,0,0,0,512,3,6179026838
15642,110806589,31381080,142187669,1,0,0,60416,10,7319723064
15643,110809130,39957137,150766267,2,0,1,6656,3,10161136394
15644,110818800,31029740,141848540,4,0,0,512,15,3249458773
15645,110823790,39942500,150766290,7,0,1,2048,10,8422097022
15646,110832170,31373027,142205197,8,0,0,1536,8,6847137818
15647,110833230,31389796,142223026,0,0,0,512,3,9261638719
15648,110846291,39920022,150766313,5,0,1,3584,10,10292658903
15649,110859760,31168655,142028415,0,0,0,1536,3,4112774744
15650,110872420,31136334,142008754,5,0,0,1024,10,1761534656
15651,110875050,31066353,141941403,0,0,0,512,3,10521404479
15652,110881221,39885115,150766336,5,0,1,1536,10,7056126421
15653,110891401,39874958,150766359,5,0,1,2048,10,4618721395
15654,110899701,39868402,150768103,5,0,1,2560,10,10604870267
15655,110901501,31303205,142204706,7,0,0,6656,10,6828412750
15656,110906239,39862850,150769089,4,0,1,1536,15,2468217185
15657,110914170,39918975,150833145,7,0,1,20992,10,8662517270
15658,110914990,31026592,141941582,4,0,0,512,15,6481987900
15659,110918940,39914228,150833168,3,0,1,4608,17,4661484698
15660,110920810,31181880,142102690,4,0,0,1024,15,2619842896
15661,110927890,39913904,150841794,3,0,1,3584,17,8730423922
15662,110940150,31195954,142136104,5,0,0,1536,10,2739056874
15663,110944339,31258316,142202655,1,0,0,43520,10,10230146042
15664,110949180,31176887,142126067,0,0,0,1024,3,4855960818
15665,110971140,39930725,150901865,3,0,1,14336,17,6205454309
15666,110973849,39933799,150907648,4,0,1,18432,15,10322580592
15667,110975310,31405043,142380353,8,0,0,46080,8,7440207974
15668,110977659,39932621,150910280,4,0,1,12288,15,7863028728
15669,110979630,31657290,142636920,0,0,0,213504,3,7084647513
15670,110983730,31448630,142432360,0,0,0,5120,3,6002800564
15671,110990010,31697163,142687173,8,0,0,69632,8,6096517815
15672,110993670,31436616,142430286,0,0,0,47104,3,9088278364
15673,110994740,39925022,150919762,7,0,1,3072,10,10468676620
15674,110996820,31227742,142224562,4,0,0,512,15,1492772188
15675,110999290,39923303,150922593,3,0,1,1024,17,10493780959
15676,111001639,39921620,150923259,4,0,1,1024,15,2026367941
15677,111004299,32337493,143341792,1,0,0,112640,10,2483730761
15678,111004310,39922175,150926485,3,0,1,5120,17,5606197828
15679,111009960,39917511,150927471,3,0,1,1536,17,7171713546
15680,111010521,31833894,142844415,7,0,0,101888,10,9302635776
15681,111012310,31462802,142475112,5,0,0,1024,10,7818110585
15682,111027799,39901298,150929097,4,0,1,2560,15,6719488294
15683,111029400,39903563,150932963,7,0,1,6144,10,7699682146
15684,111030910,39910658,150941568,7,0,1,7168,10,2567064296
15685,111035770,39907424,150943194,3,0,1,2560,17,5275490309
15686,111041040,31374692,142415732,5,0,0,512,10,8753310413
15687,111047730,31616311,142664041,8,0,0,25088,8,7432329839
15688,111052780,31644807,142697587,8,0,0,20992,8,663262471
15689,111054980,31707365,142762345,4,0,0,512,15,10104665347
15690,111060101,39884079,150944180,5,0,1,1536,10,9326091147
15691,111071650,31359127,142430777,4,0,0,1536,15,7666072256
15692,111072591,39875455,150948046,5,0,1,6144,10,7329227966
15693,111085420,31330133,142415553,5,0,0,512,10,7645038152
15694,111088591,39867977,150956568,5,0,1,11776,10,5542575819
15695,111118680,31297231,142415911,5,0,0,512,10,2896558643
15696,111131319,31279477,142410796,1,0,0,99840,10,990111406
15697,111138819,31517207,142656026,1,0,0,60416,10,1206798462
15698,111151230,31283345,142434575,8,0,0,7168,8,8256323344
15699,111155490,31500884,142656374,5,0,0,512,10,10319564203
15700,111182100,39788103,150970203,7,0,1,2048,10,5006907371
15701,111186671,39786118,150972789,5,0,1,4096,10,9788514138
15702,111195310,39782305,150977615,7,0,1,7680,10,2154221400
15703,111195369,31328187,142523556,1,0,0,50176,10,7750624696
15704,111215070,39767051,150982121,3,0,1,7168,17,6011073970
15705,111236919,31178424,142415343,1,0,0,14848,10,399248911
15706,111236951,39747304,150984255,5,0,1,3072,10,4519354498
15707,111241920,31109927,142351847,5,0,0,1536,10,7687228651
15708,111259320,31092862,142352182,4,0,0,1024,15,2678211196
15709,111272241,39713209,150985450,5,0,1,14848,10,6072024116
15710,111273070,39717946,150991016,3,0,1,6656,17,4470353683
15711,111282150,31383745,142665895,0,0,0,3072,3,2417868959
15712,111282880,39709617,150992497,6,0,1,1024,7,428489184
15713,111282940,39737495,151020435,3,0,1,2048,17,3791955783
15714,111285160,39738473,151023633,3,0,1,1024,17,4052219701
15715,111300060,39773144,151073204,7,0,1,16384,10,5567891331
15716,111304611,39768616,151073227,5,0,1,8192,10,6257268639
15717,111319050,31545200,142864250,8,0,0,65024,8,8312168456
15718,111320150,31158874,142479024,5,0,0,2048,10,9940663382
15719,111325821,39747429,151073250,5,0,1,3584,10,4456517078
15720,111354330,31283219,142637549,8,0,0,1536,8,7599636658
15721,111355180,39718093,151073273,3,0,1,2048,17,2518112973
15722,111360970,39712973,151073943,1,0,1,1024,10,8535192609
15723,111362060,39713002,151075062,7,0,1,2560,10,2218346893
15724,111362350,39713378,151075728,1,0,1,1024,10,7458758081
15725,111363270,39762786,151126056,3,0,1,18944,17,7002597668
15726,111366940,39787969,151154909,3,0,1,4096,17,1991576650
15727,111367180,39840935,151208115,1,0,1,512,10,5125684334
15728,111368600,31506803,142875403,0,0,0,6656,3,8915020939
15729,111378399,39830702,151209101,4,0,1,1536,15,1446023054
15730,111390550,31951577,143342127,5,0,0,1024,10,7435134215
15731,111414470,39803299,151217769,1,0,1,11776,10,6743512817
15732,111445520,31998231,143443751,0,0,0,21504,3,2284869037
15733,111447180,31273870,142721050,0,0,0,9216,3,2506709716
15734,111466960,31406392,142873352,8,0,0,28160,8,6253734381
15735,111468469,31526004,142994473,1,0,0,16384,10,6254148491
15736,111491059,39729836,151220895,4,0,1,3072,15,4909622510
15737,111491790,31242356,142734146,0,0,0,512,3,4731226432
15738,111497569,31189993,142687562,1,0,0,512,10,4217519916
15739,111504561,39717320,151221881,5,0,1,1536,10,9950509789
15740,111511110,31153803,142664913,4,0,0,2560,15,7900050158
15741,111519510,31446494,142966004,0,0,0,25088,3,3535259586
15742,111520561,39704546,151225107,5,0,1,5120,10,679669686
15743,111526011,39699442,151225453,5,0,1,512,10,6892893123
15744,111526659,31462768,142989427,1,0,0,76800,10,10268709372
15745,111528430,31885870,143414300,8,0,0,72192,8,4319534000
15746,111534650,31225791,142760441,0,0,0,5120,3,2586507247
15747,111535031,39690986,151226017,5,0,1,10752,10,3387132677
15748,111549770,31360604,142910374,4,0,0,512,15,15382323
15749,111567400,31321372,142888772,5,0,0,512,10,10079996243
15750,111583950,31661148,143245098,4,0,0,512,15,7717424316
15751,111586870,31772440,143359310,0,0,0,56320,3,8368648452
15752,111587480,32076937,143664417,0,0,0,194048,3,5896130534
15753,111605471,39630534,151236005,5,0,1,3072,10,3909419072
15754,111617620,31892908,143510528,5,0,0,1536,10,3599383362
15755,111628400,31463761,143092161,5,0,0,1024,10,474762531
15756,111647300,32265111,143912411,4,0,0,1024,15,10377905944
15757,111679791,39561040,151240831,5,0,1,7680,10,9024842148
15758,111685849,31451107,143136956,1,0,0,9216,10,5643822316
15759,111710491,39531326,151241817,5,0,1,1536,10,5725768133
15760,111720850,31158336,142879186,8,0,0,12288,8,5494382916
15761,111722210,39519966,151242176,2,0,1,9728,3,7846395046
15762,111722560,39526765,151249325,0,0,1,1024,3,3831739722
15763,111728541,39520807,151249348,5,0,1,2560,10,9830331414
15764,111755510,39493869,151249379,2,0,1,6656,3,1905090022
15765,111759120,31432201,143191321,8,0,0,3072,8,7852789242
15766,111791419,31257356,143048775,1,0,0,69632,10,7797632040
15767,111820760,31691194,143511954,5,0,0,512,10,846759482
15768,111853300,39421656,151274956,7,0,1,9216,10,7970352111
15769,111862339,31644963,143507302,1,0,0,76800,10,7389367607
15770,111868350,39408232,151276582,7,0,1,2560,10,6162479800
15771,111869970,39408324,151278294,7,0,1,512,10,749055959
15772,111884290,30904554,142788844,4,0,0,1024,15,9541410858
15773,111897201,39386717,151283918,5,0,1,512,10,6830146176
15774,111901800,31988938,143890738,8,0,0,207872,8,2175267587
15775,111901881,39383343,151285224,5,0,1,2048,10,3221067654
15776,111908451,39377759,151286210,5,0,1,1536,10,5390914578
15777,111913700,31035546,142949246,4,0,0,512,15,1019038075
15778,111917660,39370496,151288156,7,0,1,3072,10,446173788
15779,111924400,31784240,143708640,8,0,0,8192,8,9483134159
15780,111929429,31808853,143738282,1,0,0,89088,10,4834172866
15781,111931790,30932951,142864741,4,0,0,1536,15,908843168
15782,111947170,31717465,143664635,4,0,0,512,15,972083355
15783,111949950,31264822,143214772,4,0,0,3072,15,319177763
15784,111950590,39337912,151288502,7,0,1,512,10,9697922641
15785,111951331,39338477,151289808,5,0,1,2048,10,5715475088
15786,111954020,31290899,143244919,8,0,0,26624,8,3855464124
15787,111958119,31117163,143075282,1,0,0,1536,10,4202047296
15788,111976620,31499714,143476334,5,0,0,2560,10,2178071533
15789,111980160,39310634,151290794,7,0,1,1536,10,3047101125
15790,111982380,31490336,143472716,8,0,0,20480,8,10691049873
15791,112016231,39279410,151295641,5,0,1,27136,10,7480812837
15792,112020511,39308786,151329297,5,0,1,512,10,2791912708
15793,112025960,39304003,151329963,8,0,1,1024,8,9919362266
15794,112028770,39301449,151330219,7,0,1,9216,10,8244303920
15795,112036800,39294085,151330885,7,0,1,1024,10,10674879861
15796,112038991,39292560,151331551,5,0,1,1024,10,1481653110
15797,112051590,31127884,143179474,5,0,0,512,10,6145526922
15798,112073640,31018186,143091826,0,0,0,29184,3,2835596559
15799,112074090,31528505,143602595,8,0,0,86016,8,5528210685
15800,112077999,31115158,143193157,1,0,0,3584,10,1719576420
15801,112082610,31622163,143704773,8,0,0,71168,8,9797692009
15802,112083760,39249417,151333177,1,0,1,2560,10,4719604589
15803,112087660,39253573,151341233,1,0,1,4608,10,8006481549
15804,112094520,31444356,143538876,5,0,0,2048,10,3522073386
15805,112106469,31668726,143775195,1,0,0,5120,10,1554868421
15806,112117590,31296889,143414479,4,0,0,512,15,2370736439
15807,112118850,39225609,151344459,1,0,1,5120,10,3728240582
15808,112122801,39231470,151354271,5,0,1,11776,10,7086563664
15809,112123459,31157463,143280922,1,0,0,17408,10,2387194151
15810,112134040,31471230,143605270,6,0,0,8704,7,6380617002
15811,112150710,31654131,143804841,0,0,0,72192,3,7543640489
15812,112151360,39277786,151429146,8,0,1,13824,8,3263975122
15813,112153090,31282163,143435253,4,0,0,512,15,4911517864
15814,112159451,39269718,151429169,5,0,1,4608,10,2317456557
15815,112165630,31789458,143955088,6,0,0,52736,7,8137897374
15816,112168151,39265744,151433895,5,0,1,6656,10,2892007
15817,112168461,39265457,151433918,5,0,1,3584,10,5315500957
15818,112184090,39249851,151433941,1,0,1,2048,10,3221011229
15819,112196670,39237294,151433964,1,0,1,2560,10,3329980838
15820,112211750,39222237,151433987,8,0,1,7168,8,8365831386
15821,112225110,39208900,151434010,1,0,1,512,10,1038212249
15822,112225750,31457316,143683066,0,0,0,60416,3,6804077165
15823,112234600,31274129,143508729,8,0,0,4608,8,6695569235
15824,112236850,31572919,143809769,4,0,0,512,15,7332692951
15825,112244880,39211331,151456211,8,0,1,45568,8,6661709632
15826,112245750,31527770,143773520,0,0,0,61952,3,2892116267
15827,112246770,31507782,143754552,8,0,0,52224,8,3258601094
15828,112255411,39233356,151488767,5,0,1,1024,10,2762021181
15829,112256070,31449997,143706067,6,0,0,4096,7,10699060437
15830,112275421,39213369,151488790,5,0,1,512,10,7904371253
15831,112276860,39211953,151488813,1,0,1,3584,10,4819458977
15832,112282890,31711554,143994444,8,0,0,1536,8,9727256084
15833,112291820,31693095,143984915,8,0,0,97792,8,4267820659
15834,112291929,31528783,143820712,1,0,0,35840,10,10235800196
15835,112305830,31432787,143738617,0,0,0,1024,3,4886050677
15836,112306670,39220268,151526938,1,0,1,25088,10,9473345744
15837,112308190,39223254,151531444,8,0,1,7168,8,3523770639
15838,112327530,39207996,151535526,7,0,1,2560,10,3056912995
15839,112332040,31568783,143900823,8,0,0,32256,8,5077395223
15840,112339820,31469724,143809544,0,0,0,15360,3,6586921086
15841,112341310,31549630,143890940,4,0,0,512,15,90091514
15842,112341360,31479531,143820891,8,0,0,512,8,4997365353
15843,112351160,39185992,151537152,1,0,1,2560,10,9369818830
15844,112354740,39233580,151588320,8,0,1,39424,8,7901822323
15845,112361420,31550656,143912076,6,0,0,23552,7,7932365640
15846,112367500,31634473,144001973,5,0,0,1536,10,4268830748
15847,112367970,39220696,151588666,7,0,1,512,10,3795109933
15848,112379220,31536390,143915610,6,0,0,7168,7,8931951827
15849,112381810,39210739,151592549,7,0,1,512,10,4564946870
15850,112385790,31604608,143990398,8,0,0,17920,8,4895347310
15851,112388970,31604804,143993774,8,0,0,10752,8,9021808319
15852,112395590,39198905,151594495,8,0,1,3072,8,4167637095
15853,112398330,39205237,151603567,8,0,1,18944,8,4701504856
15854,112398410,39207922,151606332,1,0,1,4096,10,9397982428
15855,112409720,31731598,144141318,8,0,0,47104,8,9899822497
15856,112411700,31677433,144089133,6,0,0,7680,7,6906796631
15857,112411910,31512062,143923972,5,0,0,1024,10,5729974036
15858,112416760,39190878,151607638,7,0,1,2048,10,8674858857
15859,112417660,31487217,143904877,6,0,0,12800,7,5574001429
15860,112417850,39192694,151610544,6,0,1,4608,7,9940842024
15861,112435450,39175914,151611364,8,0,1,19968,8,6465166635
15862,112443320,31622669,144065989,6,0,0,37888,7,3415585548
15863,112459459,31864293,144323752,1,0,0,17408,10,7989584848
15864,112462141,39157420,151619561,5,0,1,7680,10,9509841589
15865,112467630,39391668,151859298,8,0,1,181248,8,2463127986
15866,112476250,31637113,144113363,6,0,0,33280,7,1887454965
15867,112477880,39381441,151859321,2,0,1,2048,3,5000077813
15868,112488670,39370674,151859344,1,0,1,512,10,1689112900
15869,112492739,31598913,144091652,1,0,0,8192,10,6429325026
15870,112494680,31699978,144194658,6,0,0,55808,7,8210453197
15871,112497470,39361897,151859367,9,0,1,3072,12,2999607915
15872,112511470,31483309,143994779,4,0,0,1024,15,4915206985
15873,112515510,31683695,144199205,6,0,0,14848,7,5000001303
15874,112516360,39343030,151859390,7,0,1,2560,10,5170137091
15875,112518851,39340562,151859413,5,0,1,512,10,7973752747
15876,112519300,31634434,144153734,6,0,0,40448,7,7680092480
15877,112520611,39338825,151859436,5,0,1,8704,10,6403383053
15878,112525370,31468583,143993953,5,0,0,512,10,1181973404
15879,112527430,39334744,151862174,8,0,1,16896,8,2618922011
15880,112527630,39348683,151876313,2,0,1,1024,3,2838983520
15881,112528181,39367462,151895643,5,0,1,12800,10,9306350032
15882,112528540,31756584,144285124,4,0,0,1536,15,3879645172
15883,112535070,39396462,151931532,8,0,1,38400,8,2061059100
15884,112537851,39395064,151932915,5,0,1,14848,10,2788660607
15885,112538570,39395465,151934035,7,0,1,512,10,4496948943
15886,112543900,39400353,151944253,2,0,1,14336,3,3478745009
15887,112544001,39405398,151949399,5,0,1,8192,10,5218724670
15888,112555919,31692545,144248464,1,0,0,12288,10,6023537610
15889,112558880,39395073,151953953,1,0,1,7168,10,4187123207
15890,112563340,39403468,151966808,2,0,1,3072,3,6002622718
15891,112568400,31812546,144380946,8,0,0,34816,8,8393414117
15892,112569979,31647687,144217666,1,0,0,3072,10,8823622633
15893,112572920,39394349,151967269,7,0,1,10240,10,842026892
15894,112575290,31983296,144558586,8,0,0,267776,8,7815259250
15895,112578350,31758718,144337068,4,0,0,1024,15,5469464719
15896,112606330,31952435,144558765,4,0,0,512,15,3591340270
15897,112607300,39375408,151982708,2,0,1,1536,3,2799731190
15898,112608530,39374201,151982731,2,0,1,1024,3,8279253576
15899,112616690,39373575,151990265,1,0,1,16384,10,10501411184
15900,112619620,39380846,152000466,8,0,1,20992,8,4717988767
15901,112620971,39379841,152000812,5,0,1,512,10,16395020
15902,112624080,39380278,152004358,7,0,1,5632,10,2967624713
15903,112627160,31758356,144385516,6,0,0,14336,7,7881468891
15904,112635141,39377385,152012526,5,0,1,6656,10,9827047446
15905,112635860,31697980,144333840,5,0,0,512,10,6290846595
15906,112651260,31667046,144318306,0,0,0,4096,3,4236978860
15907,112654890,39359902,152014792,7,0,1,3584,10,1744734338
15908,112655160,39395783,152050943,8,0,1,18432,8,1532888588
15909,112669389,31931885,144601274,1,0,0,53248,10,6305268167
15910,112672320,39382809,152055129,2,0,1,6656,3,9385649463
15911,112674819,31910200,144585019,1,0,0,59392,10,3910049489
15912,112681770,39376905,152058675,2,0,1,5632,3,8651262313
15913,112683620,39375721,152059341,7,0,1,1024,10,8204549473
15914,112684291,39378916,152063207,5,0,1,6144,10,516481521
15915,112690771,39389926,152080697,5,0,1,13824,10,1479669941
15916,112695381,39385339,152080720,5,0,1,4608,10,4048633396
15917,112697400,31750759,144448159,8,0,0,55808,8,1610903843
15918,112702340,31645305,144347645,5,0,0,512,10,1646318200
15919,112703280,39377463,152080743,1,0,1,6656,10,4362591659
15920,112708680,39372086,152080766,1,0,1,512,10,7026726471
15921,112711541,39369248,152080789,5,0,1,1536,10,2041736115
15922,112712110,39368702,152080812,1,0,1,5632,10,9485988501
15923,112721330,39359505,152080835,1,0,1,512,10,2290323634
15924,112722800,31658325,144381125,4,0,0,512,15,9517351969
15925,112726960,39353953,152080913,7,0,1,6656,10,4626547564
15926,112732940,31894177,144627117,9,0,0,11264,12,8948390638
15927,112746780,31820120,144566900,4,0,0,26624,15,9764081993
15928,112747250,39337529,152084779,2,0,1,6144,3,6083464846
15929,112752821,39341229,152094050,5,0,1,5120,10,4371934631
15930,112753200,39351394,152104594,8,0,1,15360,8,858116402
15931,112764510,39699142,152463652,8,0,1,156672,8,1602274942
15932,112765660,39730480,152496140,7,0,1,1536,10,7292822694
15933,112766110,31849795,144615905,4,0,0,2560,15,10563628386
15934,112771860,32027279,144799139,0,0,0,38400,3,3052624396
15935,112772670,31918469,144691139,6,0,0,21504,7,951609437
15936,112773840,39724246,152498086,1,0,1,3072,10,7965102730
15937,112774020,39773023,152547043,8,0,1,6656,8,2435870811
15938,112777700,39769366,152547066,1,0,1,9728,10,2939101365
15939,112790359,32045943,144836302,1,0,0,23552,10,4828528888
15940,112792901,39754188,152547089,5,0,1,9216,10,746435039
15941,112793430,32198105,144991535,9,0,0,99840,12,6534407905
15942,112802499,39744613,152547112,4,0,1,1024,15,10523845267
15943,112820470,39726665,152547135,7,0,1,6656,10,2059761813
15944,112827170,39720123,152547293,1,0,1,3072,10,8820473172
15945,112831869,39745187,152577056,4,0,1,9216,15,1448595727
15946,112833739,39743340,152577079,4,0,1,9216,15,9486021983
15947,112856530,39805767,152662297,7,0,1,6656,10,5859735601
15948,112858380,32245875,145104255,4,0,0,81920,15,1079659773
15949,112863549,32327704,145191253,1,0,0,7680,10,9205557138
15950,112870380,39841219,152711599,7,0,1,10752,10,3003609172
15951,112887400,39831889,152719289,7,0,1,2048,10,8014455362
15952,112902520,39825559,152728079,1,0,1,12800,10,5528823840
15953,112906790,32348122,145254912,4,0,0,138752,15,10511865749
15954,112917451,39810830,152728281,5,0,1,512,10,4587719943
15955,112923790,32363952,145287742,6,0,0,32256,7,7281338246
15956,112946280,39782024,152728304,6,0,1,3584,7,1902317053
15957,112960890,39771851,152732741,8,0,1,13312,8,2465372680
15958,112973580,39759224,152732804,8,0,1,43008,8,9707604950
15959,112980320,39754983,152735303,7,0,1,6144,10,8522799541
15960,112986220,39751844,152738064,7,0,1,2048,10,6091164704
15961,112995830,32380891,145376721,8,0,0,157184,8,9171889741
15962,113011440,32139866,145151306,8,0,0,36864,8,224000298
15963,113013990,39725700,152739690,7,0,1,2560,10,8227458045
15964,113018430,32271051,145289481,0,0,0,5632,3,3200645289
15965,113025930,32365258,145391188,6,0,0,12800,7,6048376076
15966,113028220,32484225,145512445,8,0,0,51200,8,2072356234
15967,113030870,39777008,152807878,7,0,1,5120,10,3402683993
15968,113032110,39776434,152808544,6,0,1,1024,7,2931215880
15969,113036530,32130781,145167311,6,0,0,3072,7,8805853706
15970,113045290,32341975,145387265,9,0,0,13312,12,9379409818
15971,113045640,32509330,145554970,6,0,0,44032,7,6490943715
15972,113054430,39755740,152810170,8,0,1,2560,8,3605694401
15973,113070210,32312976,145383186,4,0,0,20992,15,7550362872
15974,113082739,32355369,145438108,1,0,0,23040,10,2842175980
15975,113082790,39730286,152813076,6,0,1,4608,7,6881169535
15976,113097840,39728093,152825933,0,0,1,9728,3,1884200579
15977,113105620,39723539,152829159,6,0,1,5120,7,6680690308
15978,113107150,39775861,152883011,7,0,1,4096,10,1921373049
15979,113112030,39771004,152883034,8,0,1,12288,8,8516016574
15980,113114410,39796825,152911235,6,0,1,1024,7,7586897219
15981,113119250,32518099,145637349,0,0,0,90112,3,8840660314
15982,113119930,32545616,145665546,8,0,0,71680,8,1107114020
15983,113121649,32435536,145557185,1,0,0,7168,10,4525149973
15984,113121990,39789268,152911258,9,0,1,3072,12,5404518658
15985,113127230,39784230,152911460,9,0,1,4096,12,8670131054
15986,113131400,32410131,145541531,4,0,0,46592,15,10460892278
15987,113132530,39796432,152928962,6,0,1,1024,7,475503854
15988,113141670,32590256,145731926,4,0,0,54784,15,6560497605
15989,113154030,32338078,145492108,4,0,0,7680,15,8346343764
15990,113164831,39764154,152928985,5,0,1,2048,10,10554777924
15991,113166560,32640285,145806845,6,0,0,75776,7,1643089865
15992,113168600,32666471,145835071,9,0,0,34816,12,8816078984
15993,113170311,39758697,152929008,5,0,1,1536,10,9459999227
15994,113179490,32535721,145715211,4,0,0,112640,15,9609929522
15995,113180130,32385868,145565998,6,0,0,2048,7,9423576420
15996,113183100,39788721,152971821,7,0,1,5120,10,7161259890
15997,113191820,39780024,152971844,9,0,1,3584,12,6072107521
15998,113197110,39774757,152971867,6,0,1,512,7,8822754094
15999,113200940,39770950,152971890,8,0,1,16896,8,7812603824
16000,113202250,32533287,145735537,8,0,0,11776,8,1948907684
16001,113202489,32538920,145741409,1,0,0,6656,10,1383581789
16002,113205670,32464115,145669785,8,0,0,5632,8,731422752
16003,113206310,32533048,145739358,0,0,0,12288,3,3528509830
16004,113219910,39770122,152990032,9,0,1,13312,12,4754778639
16005,113230720,39762218,152992938,6,0,1,4608,7,875689441
16006,113231860,32868170,146100030,4,0,0,82944,15,6231737665
16007,113237200,39755994,152993194,7,0,1,9216,10,8815937441
16008,113245830,40064050,153309880,8,0,1,266240,8,4378137395
16009,113262499,33152905,146415404,1,0,0,15872,10,1990273311
16010,113264950,32642738,145907688,9,0,0,14336,12,2544423737
16011,113281991,40080135,153362126,5,0,1,512,10,9461261174
16012,113282520,40079629,153362149,8,0,1,13824,8,10035385672
16013,113285320,32833187,146118507,4,0,0,8192,15,8655352954
16014,113289410,40072762,153362172,6,0,1,12800,7,6076881691
16015,113290440,40076502,153366942,6,0,1,512,7,4269065057
16016,113299620,40072468,153372088,9,0,1,8192,12,8867236133
16017,113299750,32816238,146115988,0,0,0,17920,3,2140332989
16018,113305560,32518478,145824038,0,0,0,1024,3,9278063658
16019,113323840,32952632,146276472,6,0,0,26112,7,3381814653
16020,113325030,40065420,153390450,9,0,1,3072,12,6313686161
16021,113339690,40065088,153404778,7,0,1,512,10,7213203648
16022,113341680,40064724,153406404,9,0,1,2560,12,8943679980
16023,113341930,33142386,146484316,9,0,0,2560,12,6392898001
16024,113352621,40105019,153457640,5,0,1,26624,10,10346764866
16025,113370670,40087001,153457671,3,0,1,2048,17,7448353431
16026,113375260,33173732,146548992,0,0,0,25600,3,1655164554
16027,113377290,33217869,146595159,6,0,0,104448,7,8839323842
16028,113379429,32672459,146051888,1,0,0,1536,10,1453001213
16029,113383089,32921017,146304106,1,0,0,47616,10,6473376809
16030,113384840,40072854,153457694,2,0,1,2048,3,327734066
16031,113388650,40072894,153461544,8,0,1,24064,8,3127408872
16032,113397390,40069300,153466690,2,0,1,8192,3,9602346723
16033,113403391,40064375,153467766,5,0,1,13312,10,8842044760
16034,113403490,32763935,146167425,4,0,0,75776,15,10280735974
16035,113415030,40065980,153481010,8,0,1,35328,8,4306887860
16036,113417820,32701490,146119310,0,0,0,2560,3,7725463524
16037,113418120,32795392,146213512,4,0,0,59392,15,5866765182
16038,113422530,33374887,146797417,6,0,0,116224,7,1017644594
16039,113430129,32740595,146170724,1,0,0,10752,10,7726554069
16040,113434050,40058895,153492945,2,0,1,3584,3,1946739699
16041,113435360,32786599,146221959,0,0,0,27648,3,9977295804
16042,113440090,33499736,146939826,6,0,0,150016,7,5298696416
16043,113462091,40053102,153515193,5,0,1,13312,10,4921587019
16044,113479840,40041111,153520951,2,0,1,4608,3,5881409511
16045,113484540,32741097,146225637,0,0,0,9728,3,9085962078
16046,113486429,32997084,146483513,1,0,0,81408,10,5738827611
16047,113490700,33474421,146965121,8,0,0,82944,8,6112700034
16048,113496380,40043714,153540094,8,0,1,24064,8,5628013666
16049,113510710,33304897,146815607,0,0,0,20480,3,4535249743
16050,113513780,33305906,146819686,0,0,0,13312,3,5677340428
16051,113517420,32593085,146110505,6,0,0,34304,7,352464249
16052,113520880,40023583,153544463,2,0,1,4608,3,7681473029
16053,113535510,33102795,146638305,4,0,0,26624,15,5716077733
16054,113537030,40035736,153572766,2,0,1,1536,3,8160534506
16055,113540939,33179002,146719941,1,0,0,44032,10,7800558563
16056,113540980,40061327,153602307,8,0,1,51712,8,9463720194
16057,113542840,32725653,146268493,4,0,0,55296,15,6566788176
16058,113550680,33203448,146754128,6,0,0,112128,7,3968885822
16059,113554760,33596457,147151217,0,0,0,11776,3,9801104666
16060,113564541,40038752,153603293,5,0,1,1536,10,6871245662
16061,113567599,33194360,146761959,1,0,0,25600,10,6011407777
16062,113591640,33512334,147103974,4,0,0,143360,15,4362880668
16063,113615690,39988909,153604599,2,0,1,2048,3,4755908215
16064,113621039,33273056,146894095,1,0,0,32768,10,597722373
16065,113624340,33562838,147187178,9,0,0,8704,12,3591711722
16066,113624680,33259339,146884019,0,0,0,113664,3,4785989424
16067,113628861,39977784,153606645,5,0,1,12800,10,5008871813
16068,113633471,39979296,153612767,5,0,1,2560,10,6932467213
16069,113635350,33034344,146669694,9,0,0,77824,12,8906638847
16070,113646510,39969483,153615993,2,0,1,5120,3,5867628563
16071,113656281,39965800,153622081,5,0,1,2048,10,3866348477
16072,113656610,39966137,153622747,2,0,1,1024,3,5753803920
16073,113659549,39965784,153625333,4,0,1,4096,15,1338238590
16074,113663971,39963628,153627599,5,0,1,3584,10,9550492469
16075,113675830,39952435,153628265,8,0,1,11264,8,9618334831
16076,113678850,33709793,147388643,6,0,0,54784,7,2031949811
16077,113680140,32990357,146670497,6,0,0,2560,7,2127223050
16078,113683530,33114447,146797977,8,0,0,512,8,3261166621
16079,113685230,33019948,146705178,0,0,0,12800,3,8838566038
16080,113690100,33446079,147136179,9,0,0,1024,12,10711987898
16081,113694020,33759547,147453567,8,0,0,66048,8,5003591918
16082,113694190,32997520,146691710,8,0,0,13824,8,683232483
16083,113695020,33102778,146797798,6,0,0,1024,7,2928133000
16084,113699001,39931850,153630851,5,0,1,4096,10,8935285755
16085,113701079,32732315,146433394,1,0,0,2560,10,1673368672
16086,113702151,39930006,153632157,5,0,1,2048,10,2360422645
16087,113707820,33551594,147259414,8,0,0,89088,8,7239393438
16088,113722831,39910632,153633463,5,0,1,2048,10,2861230317
16089,113723170,33631530,147354700,8,0,0,27648,8,2836651684
16090,113738331,39916920,153655251,5,0,1,35328,10,9684587849
16091,113747569,33239906,146987475,1,0,0,56320,10,5437217896
16092,113780510,39901649,153682159,2,0,1,1024,3,5911530574
16093,113780880,33698394,147479274,8,0,0,1024,8,724000502
16094,113793469,33199645,146993114,1,0,0,18432,10,4509181312
16095,113798650,39886095,153684745,2,0,1,4096,3,8808023117
16096,113807060,33012805,146819865,6,0,0,512,7,7612303602
16097,113809231,39880660,153689891,5,0,1,8192,10,9911493725
16098,113811900,39878247,153690147,2,0,1,9216,3,3460581666
16099,113831510,33138782,146970292,0,0,0,16896,3,4074876792
16100,113842860,33292984,147135844,2,0,0,96256,3,7447533074
16101,113858560,39913642,153772202,2,0,1,512,3,10078277989
16102,113859770,33287820,147147590,0,0,0,37376,3,653056624
16103,113897450,39875418,153772868,1,0,1,1024,10,3463906232
16104,113903590,33296324,147199914,9,0,0,17408,12,646835433
16105,113907970,32797387,146705357,9,0,0,512,12,8175018050
16106,113909169,33197324,147106493,1,0,0,8192,10,10346150828
16107,113921489,33594624,147516113,1,0,0,120832,10,10103534779
16108,113935510,39837704,153773214,2,0,1,512,3,4160288973
16109,113961710,39815427,153777137,2,0,1,5120,3,1913269156
16110,113982220,39806400,153788620,2,0,1,1024,3,5628794511
16111,113983210,32851387,146834597,6,0,0,1024,7,9871712596
16112,113983640,33051222,147034862,9,0,0,4096,12,8906823525
16113,113995340,32844828,146840168,6,0,0,512,7,6678755562
16114,114013670,39774989,153788659,2,0,1,2048,3,656069223
16115,114018170,33292967,147311137,4,0,0,67584,15,6441704384
16116,114019559,33442619,147462178,1,0,0,28160,10,10468580978
16117,114024439,33025367,147049806,1,0,0,5120,10,5523113860
16118,114024769,33623473,147648242,1,0,0,26624,10,9682521819
16119,114031280,33543761,147575041,9,0,0,29184,12,940380140
16120,114034700,33548655,147583355,9,0,0,16384,12,4904311017
16121,114047719,33121581,147169300,1,0,0,43520,10,8341300080
16122,114054070,39738843,153792913,1,0,1,7168,10,4335520055
16123,114058250,32951350,147009600,6,0,0,3072,7,6098723395
16124,114064590,33368830,147433420,4,0,0,38400,15,4254648689
16125,114071700,33115657,147187357,6,0,0,512,7,2240359678
16126,114077150,33488968,147566118,4,0,0,29184,15,8085620964
16127,114077970,33517599,147595569,8,0,0,18944,8,9170681605
16128,114078369,33399455,147477824,1,0,0,41472,10,9871791231
16129,114103300,33453903,147557203,8,0,0,94208,8,10081032863
16130,114110509,33669446,147779955,1,0,0,56320,10,244985548
16131,114111860,33577457,147689317,6,0,0,512,7,9351381269
16132,114115870,33059414,147175284,9,0,0,7168,12,8483104052
16133,114119340,33050139,147169479,6,0,0,512,7,9984664061
16134,114131460,33397000,147528460,8,0,0,40448,8,7437169338
16135,114137849,33046654,147184503,1,0,0,17920,10,934130776
16136,114142710,33468124,147610834,6,0,0,2048,7,283212859
16137,114159390,33234840,147394230,8,0,0,4096,8,3030502351
16138,114181610,33105923,147287533,0,0,0,19968,3,1678044325
16139,114182210,33670333,147852543,8,0,0,68608,8,1710764755
16140,114193530,33631991,147825521,8,0,0,17408,8,6329168655
16141,114208480,33270459,147478939,6,0,0,3584,7,9780936139
16142,114209550,33368790,147578340,9,0,0,10752,12,5451370179
16143,114213910,33414621,147628531,8,0,0,29696,8,6618953899
16144,114233731,39560155,153793886,5,0,1,12800,10,3954991784
16145,114244710,39823761,154068471,8,0,1,231424,8,6556729590
16146,114253000,33509593,147762593,9,0,0,75264,12,8902282730
16147,114268000,33396819,147664819,6,0,0,1024,7,4527786829
16148,114291510,33629717,147921227,8,0,0,12800,8,5232913979
16149,114292280,33317907,147610187,9,0,0,27648,12,9903153728
16150,114302450,33395903,147698353,8,0,0,4096,8,351614024
16151,114311930,33898539,148210469,0,0,0,71680,3,10207430610
16152,114316290,33105407,147421697,9,0,0,30208,12,5262515778
16153,114334480,33255294,147589774,8,0,0,20992,8,7266276461
16154,114360271,39776286,154136557,5,0,1,4096,10,4671286711
16155,114361290,33103875,147465165,9,0,0,9728,12,4056486203
16156,114362340,39776135,154138475,0,0,1,5120,3,4496641936
16157,114364501,39773997,154138498,5,0,1,5632,10,1948686273
16158,114369180,33507710,147876890,8,0,0,12800,8,5515512083
16159,114374339,33349289,147723628,1,0,0,51200,10,4431206268
16160,114384070,39754451,154138521,0,0,1,2560,3,9261573792
16161,114387780,33414473,147802253,9,0,0,70144,12,2747157834
16162,114393990,39744554,154138544,1,0,1,4608,10,6713494821
16163,114394431,39744136,154138567,5,0,1,6656,10,3212079715
16164,114407760,33751253,148159013,0,0,0,50688,3,8349131736
16165,114426500,33379084,147805584,0,0,0,10752,3,9139936505
16166,114426990,39711600,154138590,0,0,1,2048,3,6924843662
16167,114436270,33326502,147762772,6,0,0,512,7,3351785666
16168,114445161,39693452,154138613,5,0,1,5120,10,3092489585
16169,114447750,33332384,147780134,0,0,0,512,3,6925276905
16170,114455820,39683307,154139127,0,0,1,2560,3,6956299625
16171,114458400,33224323,147682723,0,0,0,2560,3,10131213763
16172,114465119,33264795,147729914,1,0,0,20480,10,4960789584
16173,114468221,39670929,154139150,5,0,1,12288,10,3409992903
16174,114480460,33383975,147864435,0,0,0,23552,3,8200264357
16175,114486559,33778319,148264878,1,0,0,94720,10,2035035156
16176,114487729,33293060,147780789,1,0,0,2048,10,6416304170
16177,114489451,39650057,154139508,5,0,1,7168,10,3897054295
16178,114492060,33602228,148094288,6,0,0,1536,7,1369603909
16179,114495200,33623565,148118765,8,0,0,70656,8,7417814945
16180,114542370,33846188,148388558,9,0,0,35840,12,9166885875
16181,114546030,33152767,147698797,6,0,0,512,7,3912597085
16182,114551010,33360182,147911192,0,0,0,16896,3,5261837381
16183,114556790,39588328,154145118,2,0,1,13824,3,1175753901
16184,114568450,39600447,154168897,0,0,1,512,3,9149722028
16185,114585339,33430435,148015774,1,0,0,43008,10,4473959215
16186,114602850,33303171,147906021,9,0,0,7680,12,7522912705
16187,114606890,39562030,154168920,2,0,1,4608,3,10273988996
16188,114612910,39556033,154168943,0,0,1,3072,3,2586803116
16189,114613880,33443463,148057343,8,0,0,3584,8,4584858423
16190,114614869,33478928,148093797,1,0,0,36352,10,5022020382
16191,114621520,39547454,154168974,2,0,1,512,3,9722414108
16192,114647060,39541888,154188948,2,0,1,17408,3,6002352480
16193,114653590,39537304,154190894,0,0,1,3072,3,5188330082
16194,114660060,33318140,147978200,0,0,0,512,3,7330909526
16195,114670100,39525300,154195400,2,0,1,7168,3,7395571689
16196,114672630,33797990,148470620,8,0,0,6144,8,9652083770
16197,114681540,39517086,154198626,3,0,1,5120,17,8738360895
16198,114692120,39509732,154201852,3,0,1,5120,17,7701532000
16199,114698060,39505098,154203158,2,0,1,2048,3,2727401046
16200,114706460,39519715,154226175,0,0,1,6144,3,4239842840
16201,114709090,39517108,154226198,3,0,1,13824,17,2926284543
16202,114729610,33342515,148072125,9,0,0,512,12,10166343008
16203,114735590,33334863,148070453,6,0,0,1024,7,8360150939
16204,114736990,39489231,154226221,2,0,1,10240,3,3925213373
16205,114741800,33601696,148343496,8,0,0,9216,8,4818132279
16206,114745550,33209216,147954766,9,0,0,4096,12,9448989794
16207,114753410,39993696,154747106,3,0,1,220160,17,8176950111
16208,114754090,33839863,148593953,9,0,0,25088,12,4038182430
16209,114757170,33478753,148235923,8,0,0,5120,8,8746816415
16210,114760690,33399796,148160486,6,0,0,1024,7,6255204420
16211,114762630,40014395,154777025,3,0,1,21504,17,8491340324
16212,114775690,34049831,148825521,8,0,0,136192,8,1768276925
16213,114802780,40031839,154834619,2,0,1,1024,3,5229182470
16214,114811300,33325483,148136783,9,0,0,7680,12,2823258075
16215,114811610,40023040,154834650,3,0,1,16896,17,8307928747
16216,114818420,33640255,148458675,0,0,0,10752,3,7026372090
16217,114848130,33529485,148377615,6,0,0,1024,7,9048620047
16218,114848650,33526423,148375073,0,0,0,28160,3,9263594197
16219,114888630,33452035,148340665,0,0,0,60416,3,4500593812
16220,114890510,39961696,154852206,3,0,1,36864,17,7543680141
16221,114909609,33412625,148322234,1,0,0,49152,10,7134614143
16222,114918890,33241261,148160151,6,0,0,1536,7,5475751321
16223,114919700,39966691,154886391,1,0,1,512,10,1557347410
16224,114924129,33859873,148784002,1,0,0,75776,10,10551545810
16225,114926380,33233280,148159660,6,0,0,2048,7,2751730171
16226,114933190,39953224,154886414,8,0,1,3584,8,2540816641
16227,114937649,33981476,148919125,1,0,0,15872,10,6153684737
16228,114959050,33615431,148574481,9,0,0,1536,12,4261280280
16229,114959810,33417470,148377280,9,0,0,7168,12,2296672150
16230,114960970,33384265,148345235,9,0,0,5632,12,8967367218
16231,114969390,39917063,154886453,2,0,1,6656,3,5701179306
16232,114984270,39917767,154902037,2,0,1,1024,3,4687385751
16233,114997260,33369089,148366349,6,0,0,2048,7,5336548828
16234,114997800,39938545,154936345,2,0,1,12288,3,9682063301
16235,114998120,39938891,154937011,8,0,1,1024,8,4276285888
16236,114998540,39939777,154938317,1,0,1,2048,10,8720030994
16237,115008350,33463229,148471579,6,0,0,3072,7,8791939916
16238,115013260,39958704,154971964,3,0,1,31232,17,4597642421
16239,115017539,33584713,148602252,1,0,0,27136,10,1199600748
16240,115023791,33599240,148623031,7,0,0,68096,10,7873321519
16241,115031220,39945604,154976824,2,0,1,512,3,5656668323
16242,115031460,33379595,148411055,6,0,0,1536,7,2850293411
16243,115045250,39941953,154987203,3,0,1,19456,17,7715848040
16244,115045560,33857194,148902754,9,0,0,87552,12,4835590315
16245,115048800,39950674,154999474,9,0,1,11264,12,10288321748
16246,115053630,33681579,148735209,0,0,0,41984,3,3931039508
16247,115058280,33410445,148468725,9,0,0,9216,12,3535718338
16248,115058640,33431826,148490466,6,0,0,512,7,2303774114
16249,115068369,33793835,148862204,1,0,0,120320,10,1671842202
16250,115070350,39929790,155000140,8,0,1,1024,8,6481651037
16251,115073500,39929546,155003046,9,0,1,4608,12,1607535737
16252,115073770,33457655,148531425,6,0,0,512,7,769021534
16253,115074200,39929512,155003712,9,0,1,1024,12,2770210850
16254,115079220,39928678,155007898,2,0,1,6656,3,9443024070
16255,115082099,33837282,148919381,1,0,0,512,10,5818691417
16256,115095760,33780295,148876055,9,0,0,43520,12,3641314134
16257,115107829,33610196,148718025,1,0,0,13824,10,7074611926
16258,115108220,33805984,148914204,9,0,0,36352,12,4014774434
16259,115110880,39899924,155010804,2,0,1,4608,3,7883680515
16260,115113160,34094718,149207878,9,0,0,37888,12,5338277972
16261,115117260,39896770,155014030,7,0,1,5120,10,8430790023
16262,115118760,39899776,155018536,9,0,1,7168,12,1695359461
16263,115126200,39896318,155022518,9,0,1,512,12,10219084789
16264,115134920,40069276,155204196,3,0,1,65536,17,7452677789
16265,115143400,40077327,155220727,2,0,1,20992,3,6448549751
16266,115152250,40069779,155222029,8,0,1,1024,8,9797325322
16267,115166670,40066489,155233159,7,0,1,2048,10,5695144848
16268,115169530,40069754,155239284,9,0,1,13312,12,10175027617
16269,115172490,40070949,155243439,0,0,1,6144,3,4877474740
16270,115172760,40073905,155246665,9,0,1,5120,12,205844812
16271,115195761,40057060,155252821,8,0,1,1536,8,6937540961
16272,115196429,33747924,148944353,1,0,0,35328,10,8509465097
16273,115197940,40054904,155252844,7,0,1,2560,10,9826844569
16274,115207940,40099943,155307883,0,0,1,9728,3,8106016714
16275,115224890,40114115,155339005,9,0,1,26112,12,2675974478
16276,115233370,40167726,155401096,1,0,1,4096,10,8433985303
16277,115252120,40149335,155401455,6,0,1,9728,7,3305479042
16278,115256820,33646269,148903089,6,0,0,1024,7,697869742
16279,115260020,40145301,155405321,1,0,1,6144,10,9336533851
16280,115262601,40172040,155434641,8,0,1,9728,8,3076428716
16281,115262770,40183854,155446624,0,0,1,5120,3,10673131733
16282,115282150,33580545,148862695,6,0,0,1536,7,5994348364
16283,115283180,40194173,155477353,1,0,1,1536,10,3581485394
16284,115291910,40186109,155478019,0,0,1,1024,3,8911020938
16285,115296740,40182355,155479095,0,0,1,13312,3,2766401964
16286,115303950,33694647,148998597,9,0,0,20480,12,9292877691
16287,115304920,40204093,155509013,1,0,1,512,10,1266970744
16288,115306140,40216621,155522761,6,0,1,5120,7,5103161526
16289,115307560,34081650,149389210,0,0,0,77824,3,8058702406
16290,115324340,40199087,155523427,0,0,1,1024,3,8041166460
16291,115336620,33677739,149014359,6,0,0,512,7,7518568033
16292,115342790,40181303,155524093,7,0,1,1024,10,5492894638
16293,115348050,40181944,155529994,1,0,1,19968,10,4504282222
16294,115362060,40198226,155560286,7,0,1,512,10,4100465053
16295,115363380,33581799,148945179,9,0,0,2560,12,8407996236
16296,115368600,33765172,149133772,0,0,0,68608,3,8681236743
16297,115386429,40223493,155609922,4,0,1,14848,15,9265200035
16298,115389300,40220776,155610076,6,0,1,8704,7,3538929567
16299,115394950,40217392,155612342,1,0,1,3584,10,113596425
16300,115407630,33828110,149235740,9,0,0,512,12,1696728271
16301,115417590,40195098,155612688,0,0,1,512,3,9947324317
16302,115422109,34039694,149461803,1,0,0,199168,10,6694039013
16303,115424720,40191194,155615914,0,0,1,5120,3,4928019792
16304,115433209,33633138,149066347,1,0,0,2048,10,3384114195
16305,115445230,40265816,155711046,1,0,1,15360,10,7903434502
16306,115454550,40257478,155712028,1,0,1,6144,10,7581560333
16307,115456280,40267338,155723618,8,0,1,2560,8,3337809725
16308,115468300,33759381,149227681,0,0,0,6144,3,9009271026
16309,115470460,40253181,155723641,0,0,1,2048,3,4956799874
16310,115476680,33696822,149173502,0,0,0,34304,3,5992354214
16311,115492539,33839404,149331943,1,0,0,45568,10,402358537
16312,115493070,40230594,155723664,1,0,1,10752,10,804135164
16313,115494649,33808739,149303388,1,0,0,14336,10,3332717517
16314,115495320,40231214,155726534,0,0,1,2560,3,8710752338
16315,115498079,33819957,149318036,1,0,0,22528,10,8230148434
16316,115525519,33624037,149149556,1,0,0,16896,10,3262689993
16317,115525720,40200845,155726565,6,0,1,1024,7,8048880063
16318,115546450,33819025,149365475,0,0,0,46080,3,3903492228
16319,115555141,40171447,155726588,8,0,1,6144,8,5654011504
16320,115564630,40221768,155786398,8,0,1,7168,8,7914728880
16321,115565420,40224524,155789944,6,0,1,5632,7,4056613103
16322,115566190,40225700,155791890,0,0,1,3072,3,8757144612
16323,115574290,40222106,155796396,6,0,1,7168,7,10736813393
16324,115576530,33980501,149557031,0,0,0,35328,3,3047944730
16325,115579480,40222716,155802196,0,0,1,15872,3,2002262668
16326,115589780,40212467,155802247,6,0,1,2560,7,5006701279
16327,115594521,40210978,155805499,8,0,1,5120,8,3218758333
16328,115596550,40209935,155806485,6,0,1,1536,7,8645734230
16329,115612930,40201534,155814464,7,0,1,6656,10,2659444581
16330,115613641,40200846,155814487,8,0,1,1536,8,8557484165
16331,115616620,40202047,155818667,2,0,1,7168,3,8614022578
16332,115626510,40211904,155838414,2,0,1,3072,3,4235074499
16333,115633400,40205037,155838437,2,0,1,2048,3,7597345512
16334,115639230,40199230,155838460,2,0,1,1536,3,5819655922
16335,115644520,33881774,149526294,0,0,0,10240,3,2311519173
16336,115648681,40204715,155853396,8,0,1,512,8,2153805723
16337,115667750,40185992,155853742,0,0,1,512,3,3838677907
16338,115672250,40181838,155854088,8,0,1,512,8,97295530
16339,115681520,40174194,155855714,2,0,1,2560,3,59885656
16340,115684550,34326440,150010990,0,0,0,84992,3,1472863136
16341,115687390,33774840,149462230,6,0,0,1024,7,4389502017
16342,115699740,40181746,155881486,7,0,1,41472,10,5378948549
16343,115705030,33822328,149527358,6,0,0,1536,7,9440474257
16344,115713220,33964173,149677393,0,0,0,2048,3,10457337611
16345,115717000,40203047,155920047,2,0,1,5632,3,4205003083
16346,115729130,40220070,155949200,7,0,1,19968,10,8456782904
16347,115729660,40377629,156107289,6,0,1,5632,7,3338953656
16348,115732330,40374990,156107320,8,0,1,7680,8,8893332262
16349,115740240,40368058,156108298,8,0,1,1536,8,166651128
16350,115745700,40364544,156110244,1,0,1,3072,10,9660677236
16351,115748720,40423502,156172222,1,0,1,6656,10,116429823
16352,115753060,34146390,149899450,0,0,0,28672,3,8837429807
16353,115760341,40558872,156319213,8,0,1,1024,8,10058056519
16354,115773850,40545386,156319236,9,0,1,2560,12,9705515643
16355,115775261,40543998,156319259,8,0,1,4096,8,6759761617
16356,115783290,40566310,156349600,0,0,1,5632,3,6125904914
16357,115788040,40561583,156349623,6,0,1,3584,7,5159640516
16358,115788821,40560825,156349646,8,0,1,2560,8,569861987
16359,115790510,40585406,156375916,9,0,1,6656,12,6215885367
16360,115794501,40581438,156375939,8,0,1,10240,8,10553421449
16361,115797290,33951972,149749262,0,0,0,25088,3,895305594
16362,115798640,34341553,150140193,0,0,0,3584,3,4680952602
16363,115800600,40575362,156375962,2,0,1,3072,3,9005379575
16364,115809170,40578078,156387248,8,0,1,512,8,7246440283
16365,115812930,40574341,156387271,1,0,1,1536,10,6522147184
16366,115816050,40571244,156387294,1,0,1,1024,10,9021520010
16367,115829890,34046081,149875971,6,0,0,2048,7,8009287742
16368,115844100,40543217,156387317,7,0,1,1024,10,3849091280
16369,115848140,40539216,156387356,2,0,1,5632,3,8346036979
16370,115857220,34060164,149917384,6,0,0,512,7,5191866420
16371,115873240,40514147,156387387,7,0,1,11264,10,3708902157
16372,115886310,40501100,156387410,9,0,1,3072,12,7039715428
16373,115891110,34026095,149917205,9,0,0,35328,12,2102602136
16374,115893130,40988910,156882040,2,0,1,268288,3,358753417
16375,115910090,40978884,156888974,0,0,1,7680,3,1917618849
16376,115931620,40959359,156890979,6,0,1,4608,7,3014937828
16377,115942250,40951635,156893885,7,0,1,4608,10,820289159
16378,115947110,40947748,156894858,6,0,1,12800,7,8936011512
16379,115955400,33979978,149935378,6,0,0,1024,7,5359694090
16380,115964020,41043161,157007181,2,0,1,162304,3,3186005600
16381,115990190,41035715,157025905,8,0,1,2048,8,3505356364
16382,115997280,41035412,157032692,9,0,1,4608,12,6512394223
16383,116015520,41019758,157035278,1,0,1,4096,10,8827340004
16384,116020510,41016394,157036904,6,0,1,2560,7,8287818824
16385,116024990,33856940,149881930,6,0,0,2048,7,1184189454
16386,116027570,41011920,157039490,9,0,1,4096,12,9536805467
16387,116029550,41011886,157041436,1,0,1,3072,10,5413451712
16388,116046920,41001410,157048330,6,0,1,12288,7,5834181451
16389,116054520,33810052,149864572,0,0,0,41984,3,3564379341
16390,116057990,40990363,157048353,7,0,1,512,10,8747911601
16391,116060550,40987826,157048376,3,0,1,5632,17,10203261921
16392,116063640,41003415,157067055,9,0,1,10240,12,1763595384
16393,116068220,40999821,157068041,1,0,1,1536,10,5363541311
16394,116072490,34154517,150227007,0,0,0,35328,3,7266259928
16395,116074060,33944753,150018813,9,0,0,25600,12,5345072527
16396,116082980,40986047,157069027,1,0,1,1536,10,10180920403
16397,116084190,40985823,157070013,1,0,1,1536,10,7572634416
16398,116084790,40985889,157070679,1,0,1,1024,10,82112973
16399,116085840,40985505,157071345,9,0,1,1024,12,8909921217
16400,116092300,40984191,157076491,0,0,1,8192,3,8179822552
16401,116113150,40964647,157077797,7,0,1,2048,10,10357870164
16402,116117010,33997615,150114625,0,0,0,110080,3,8929150282
16403,116118180,33754414,149872594,6,0,0,1024,7,3562762598
16404,116122090,40978768,157100858,7,0,1,9728,10,3119565327
16405,116146000,40960004,157106004,8,0,1,8192,8,7252146898
16406,116159480,40946870,157106350,9,0,1,512,12,2732811199
16407,116159510,40948786,157108296,8,0,1,3072,8,5366601451
16408,116181620,40927022,157108642,3,0,1,512,17,5747549239
16409,116194180,40916408,157110588,0,0,1,3072,3,8828729730
16410,116204850,40907364,157112214,0,0,1,2560,3,9017505278
16411,116208590,40904458,157113048,3,0,1,10752,17,10534968775
16412,116209330,40907264,157116594,9,0,1,5632,12,2997535315
16413,116214010,40904069,157118079,0,0,1,15360,3,780281688
16414,116220990,34037541,150258531,0,0,0,29696,3,3260225257
16415,116227190,40894999,157122189,8,0,1,13312,8,19883159
16416,116231730,40895955,157127685,9,0,1,16896,12,3076583174
16417,116235000,40893671,157128671,0,0,1,1536,3,9150428825
16418,116243300,40885717,157129017,7,0,1,512,10,2894477021
16419,116284110,40847173,157131283,9,0,1,3584,12,369548177
16420,116285520,40849309,157134829,6,0,1,5632,7,5254420550
16421,116290210,40850746,157140956,3,0,1,4096,17,4720966710
16422,116315540,40859123,157174663,8,0,1,27648,8,8263025328
16423,116317550,40860979,157178529,7,0,1,6144,10,1558833073
16424,116321930,34058015,150379945,0,0,0,297984,3,1130898019
16425,116324640,34155429,150480069,0,0,0,79360,3,898112745
16426,116329570,40852155,157181725,0,0,1,512,3,78809958
16427,116348850,33900610,150249460,0,0,0,16896,3,2882816363
16428,116351950,40835329,157187279,3,0,1,2560,17,9634369771
16429,116368460,33777645,150146105,9,0,0,4608,12,248924238
16430,116389890,40802948,157192838,0,0,1,512,3,10437168121
16431,116392480,33676861,150069341,6,0,0,3072,7,6260232129
16432,116393970,33846008,150239978,0,0,0,42496,3,5825724191
16433,116394750,40798754,157193504,9,0,1,1024,12,625984739
16434,116409270,40784900,157194170,9,0,1,1024,12,1658017240
16435,116409510,40787566,157197076,8,0,1,4608,8,6783994013
16436,116418910,40787156,157206066,8,0,1,5120,8,7946980120
16437,116419550,40794066,157213616,9,0,1,512,12,1590847703
16438,116435640,33598283,150033923,6,0,0,512,7,237638734
16439,116441530,40772854,157214384,0,0,1,11776,3,5973070321
16440,116441580,40774110,157215690,8,0,1,2048,8,5646727155
16441,116450370,40787450,157237820,3,0,1,21504,17,967485465
16442,116450880,40787606,157238486,9,0,1,1024,12,5372501864
16443,116451620,33714559,150166179,6,0,0,2048,7,1558348563
16444,116458900,40783798,157242698,6,0,1,6656,7,3408774198
16445,116461250,40782434,157243684,9,0,1,1536,12,10450278157
16446,116464110,33803560,150267670,6,0,0,512,7,2791866239
16447,116479170,40764668,157243838,6,0,1,8704,7,666463172
16448,116486180,40761109,157247289,6,0,1,1024,7,9800804357
16449,116491020,33891229,150382249,9,0,0,6656,12,6559821912
16450,116505790,40769959,157275749,9,0,1,5632,12,3434941302
16451,116513000,33775260,150288260,9,0,0,4608,12,7318939587
16452,116513670,40762102,157275772,9,0,1,8704,12,6881693495
16453,116515520,33875920,150391440,0,0,0,1024,3,1258853741
16454,116519010,40756785,157275795,9,0,1,8704,12,896294420
16455,116541650,40734168,157275818,0,0,1,5632,3,9035644831
16456,116575720,40700121,157275841,9,0,1,512,12,534243258
16457,116580840,40695024,157275864,9,0,1,512,12,903112162
16458,116589030,33974325,150563355,6,0,0,512,7,4128793398
16459,116593980,34080288,150674268,0,0,0,45056,3,2319039131
16460,116594780,33856141,150450921,9,0,0,14336,12,10533366657
16461,116604950,40670937,157275887,6,0,1,2560,7,2361914394
16462,116605350,40670560,157275910,6,0,1,7168,7,1105241059
16463,116639670,40636263,157275933,0,0,1,512,3,5874769983
16464,116647100,40636099,157283199,3,0,1,3072,17,2819224381
16465,116656530,40653628,157310158,0,0,1,11264,3,742789359
16466,116664590,40645591,157310181,6,0,1,1024,7,3650473199
16467,116670990,40639549,157310539,9,0,1,2048,12,2830770485
16468,116672020,40638542,157310562,6,0,1,1536,7,5856885910
16469,116672800,40637785,157310585,0,0,1,1024,3,3440951575
16470,116684380,40626228,157310608,3,0,1,512,17,6642248270
16471,116685320,33843816,150529136,0,0,0,23040,3,2383290181
16472,116685350,40626412,157311762,0,0,1,2560,3,4517329114
16473,116696880,40616188,157313068,3,0,1,2048,17,8711346442
16474,116703310,33892752,150596062,9,0,0,2560,12,1362458639
16475,116703400,40652429,157355829,3,0,1,3584,17,3460859707
16476,116706640,40650815,157357455,1,0,1,2560,10,10598519373
16477,116717350,33762990,150480340,6,0,0,512,7,1428870289
16478,116720490,40638591,157359081,3,0,1,2560,17,7631531541
16479,116720680,40640987,157361667,6,0,1,4096,7,6710412664
16480,116723970,33854429,150578399,9,0,0,12800,12,9145003329
16481,116725160,40637813,157362973,1,0,1,2048,10,10197841971
16482,116732230,40631102,157363332,1,0,1,9728,10,2520226886
16483,116734130,33799433,150533563,6,0,0,512,7,1083941869
16484,116767580,40617499,157385079,3,0,1,512,17,569538581
16485,116790230,40597888,157388118,0,0,1,2048,3,6095883334
16486,116797920,40612426,157410346,9,0,1,1536,12,8643433236
16487,116809670,33799587,150609257,0,0,0,2048,3,8565356879
16488,116812440,40621030,157433470,3,0,1,3072,17,5210512658
16489,116820160,33880697,150700857,0,0,0,27136,3,3554110747
16490,116832680,40602736,157435416,1,0,1,3072,10,10616739119
16491,116842710,33990412,150833122,0,0,0,148480,3,6276137562
16492,116843750,33831055,150674805,6,0,0,1536,7,3126077710
16493,116864910,40582768,157447678,3,0,1,3072,17,3891704274
16494,116872440,40686409,157558849,9,0,1,2560,12,4318576725
16495,116891290,40671105,157562395,0,0,1,5632,3,4919947768
16496,116893830,33660620,150554450,9,0,0,9216,12,9655140470
16497,116905070,40657991,157563061,0,0,1,1024,3,1158994086
16498,116906730,33627620,150534350,6,0,0,1024,7,872107974
16499,116910600,40654087,157564687,9,0,1,2560,12,2129834378
16500,116917740,40647293,157565033,0,0,1,512,3,8680661175
16501,116939670,33904004,150843674,6,0,0,1536,7,3739985731
16502,116951290,33814954,150766244,0,0,0,52736,3,2748705714
16503,116954760,40632556,157587316,3,0,1,7680,17,7190864560
16504,116955690,34028542,150984232,9,0,0,4608,12,8839449647
16505,116956770,33681016,150637786,6,0,0,512,7,7473986866
16506,116967750,33604385,150572135,6,0,0,512,7,10533535416
16507,116968240,40620062,157588302,0,0,1,1536,3,5571760580
16508,116973461,40617747,157591208,5,0,1,4608,10,8510984669
16509,116985380,40609374,157594754,0,0,1,5632,3,3108950963
16510,116998850,40596890,157595740,9,0,1,1536,12,4951754982
16511,117000250,33882543,150882793,9,0,0,10752,12,5702618365
16512,117004539,40702697,157707236,4,0,1,7168,15,6279687807
16513,117004670,40853295,157857965,3,0,1,1024,17,1431410539
16514,117005839,40852157,157857996,4,0,1,4608,15,5238878468
16515,117011160,33670514,150681674,9,0,0,8192,12,5268719859
16516,117018660,33859353,150878013,9,0,0,1024,12,6616366311
16517,117023319,40834700,157858019,4,0,1,2048,15,6162578939
16518,117030840,33710265,150741105,9,0,0,34816,12,516276358
16519,117037930,40977471,158015401,9,0,1,28672,12,5887395111
16520,117040340,40975100,158015440,0,0,1,512,3,6119018977
16521,117053720,33788051,150841771,9,0,0,28160,12,155244651
16522,117060450,33819044,150879494,6,0,0,1024,7,6392284015
16523,117063140,40952323,158015463,9,0,1,10752,12,6354219126
16524,117071420,40944066,158015486,9,0,1,15360,12,2147311162
16525,117077610,33631174,150708784,6,0,0,512,7,2447238955
16526,117081830,33768655,150850485,0,0,0,13824,3,586365213
16527,117099779,40950258,158050037,4,0,1,5632,15,8497585676
16528,117113960,33739081,150853041,6,0,0,2048,7,1334753828
16529,117115790,33957391,151073181,0,0,0,104960,3,731456679
16530,117126620,40923448,158050068,0,0,1,4096,3,8494455439
16531,117127480,40922611,158050091,0,0,1,2048,3,2363659589
16532,117136249,40913865,158050114,4,0,1,3072,15,8680712676
16533,117163549,40886588,158050137,4,0,1,2048,15,10307896238
16534,117167091,40923538,158090629,5,0,1,2560,10,10155462038
16535,117171719,40918933,158090652,4,0,1,8704,15,3729942604
16536,117175330,40984296,158159626,3,0,1,9216,17,8688790646
16537,117175351,40984298,158159649,5,0,1,4608,10,2507127655
16538,117180150,41002945,158183095,9,0,1,28160,12,8336007599
16539,117186541,40997540,158184081,5,0,1,1536,10,5624282846
16540,117187600,41006114,158193714,9,0,1,8704,12,773635185
16541,117193389,41003231,158196620,4,0,1,4608,15,10645780195
16542,117194350,41048868,158243218,3,0,1,6144,17,5303597335
16543,117198300,41078059,158276359,3,0,1,4096,17,10003288787
16544,117203960,33816452,151020412,9,0,0,88064,12,3258334008
16545,117204101,41072289,158276390,5,0,1,3584,10,7948646646
16546,117207401,41069012,158276413,5,0,1,1024,10,9933982376
16547,117209620,33929196,151138816,0,0,0,23552,3,6067723382
16548,117225590,33813811,151039401,6,0,0,2048,7,7999456089
16549,117228740,41047704,158276444,3,0,1,25600,17,3425255596
16550,117237330,41062849,158300179,0,0,1,1536,3,5628615337
16551,117249110,41293304,158542414,9,0,1,123392,12,9747366635
16552,117251550,41481176,158732726,9,0,1,130048,12,6827696392
16553,117257940,33866745,151124685,0,0,0,16896,3,9155811374
16554,117265660,41467089,158732749,3,0,1,10240,17,2393946112
16555,117267449,41493122,158760571,4,0,1,8704,15,8862003934
16556,117276369,41484225,158760594,4,0,1,4096,15,6984202780
16557,117278140,41482477,158760617,0,0,1,2048,3,1890743877
16558,117283771,41476869,158760640,5,0,1,2048,10,7346964179
16559,117297290,41463373,158760663,3,0,1,10752,17,10171693925
16560,117297640,33776280,151073920,6,0,0,2048,7,699067563
16561,117301981,41458705,158760686,5,0,1,512,10,10533022139
16562,117307319,41454606,158761925,4,0,1,4096,15,4249421900
16563,117309860,34141645,151451505,0,0,0,57344,3,6390508637
16564,117314370,41522569,158836939,9,0,1,110080,12,614453311
16565,117327610,33935544,151263154,9,0,0,16384,12,9108595605
16566,117329150,41544239,158873389,1,0,1,5120,10,6206597877
16567,117329460,41547475,158876935,0,0,1,5632,3,3602891518
16568,117339340,33816543,151155883,6,0,0,512,7,9643717582
16569,117339560,41537721,158877281,0,0,1,512,3,1451252231
16570,117341970,33767491,151109461,6,0,0,512,7,3617992144
16571,117347780,41541617,158889397,0,0,1,1536,3,3111961787
16572,117348201,41542502,158890703,5,0,1,2048,10,7564587015
16573,117350670,41540392,158891062,3,0,1,9728,17,1026387234
16574,117350730,41541972,158892702,9,0,1,24064,12,2727350986
16575,117359210,41589667,158948877,9,0,1,13824,12,9547669637
16576,117360280,33796590,151156870,6,0,0,1024,7,9015184498
16577,117371870,41579593,158951463,7,0,1,4096,10,8230022165
16578,117371980,34056964,151428944,0,0,0,243712,3,8939970869
16579,117374180,41580829,158955009,7,0,1,5632,10,5406280530
16580,117378870,41576395,158955265,7,0,1,9216,10,7452589408
16581,117379390,41580727,158960117,0,0,1,7680,3,3468572312
16582,117406360,41556983,158963343,7,0,1,5120,10,6938159736
16583,117409670,33839632,151249302,9,0,0,23040,12,4656306179
16584,117420840,41546369,158967209,3,0,1,6144,17,4770258151
16585,117422791,41551638,158974429,5,0,1,2560,10,10045863617
16586,117428201,41546251,158974452,5,0,1,1536,10,5879756200
16587,117431170,41543797,158974967,7,0,1,8192,10,4832612955
16588,117437450,41575692,159013142,3,0,1,5632,17,6395549011
16589,117440420,41572978,159013398,3,0,1,9216,17,3761610741
16590,117455890,41578275,159034165,0,0,1,6656,3,1360223256
16591,117458740,34030004,151488744,0,0,0,77824,3,786264385
16592,117487460,41546728,159034188,3,0,1,2048,17,4920967476
16593,117492531,41562636,159055167,5,0,1,20992,10,10660726274
16594,117508960,41546553,159055513,7,0,1,512,10,6213126097
16595,117522660,41540265,159062925,2,0,1,11776,3,7836172018
16596,117527341,41688960,159216301,5,0,1,78848,10,9492583246
16597,117534041,42193153,159727194,5,0,1,123392,10,4749839605
16598,117536670,42191190,159727860,7,0,1,1024,10,8187089680
16599,117541781,42297715,159839496,5,0,1,46592,10,2443018648
16600,117566480,33867392,151433872,0,0,0,15360,3,521293580
16601,117566760,42272759,159839519,8,0,1,1024,8,7043970625
16602,117568620,42270922,159839542,0,0,1,5120,3,4595075335
16603,117572570,42266995,159839565,8,0,1,4096,8,6507477760
16604,117575150,42320885,159896035,7,0,1,12288,10,5658901087
16605,117580010,42432977,160012987,7,0,1,3584,10,8897506868
16606,117588840,42424170,160013010,3,0,1,17920,17,6274962220
16607,117596440,33832683,151429123,6,0,0,512,7,5132785728
16608,117611330,42401703,160013033,0,0,1,1024,3,6153215932
16609,117612240,42415035,160027275,3,0,1,4608,17,3599918442
16610,117612270,33660293,151272563,6,0,0,512,7,8570889508
16611,117613130,42424331,160037461,0,0,1,1024,3,1905167796
16612,117618200,33605970,151224170,6,0,0,512,7,1228718551
16613,117634240,42403244,160037484,0,0,1,512,3,2846484064
16614,117642050,34064304,151706354,0,0,0,101888,3,9867079434
16615,117642290,42564706,160206996,2,0,1,62976,3,1837475615
16616,117643150,42563869,160207019,7,0,1,2048,10,4715120759
16617,117643331,42661327,160304658,5,0,1,52224,10,10105363527
16618,117651320,42708264,160359584,7,0,1,1024,10,5862203399
16619,117652620,42707310,160359930,7,0,1,512,10,7537423898
16620,117655491,42707025,160362516,5,0,1,4096,10,1425880793
16621,117655850,42709572,160365422,7,0,1,4608,10,1021174951
16622,117656150,34001159,151657309,9,0,0,43008,12,10300669662
16623,117672550,42730744,160403294,8,0,1,17920,8,826101847
16624,117683530,42729794,160413324,0,0,1,3072,3,122909168
16625,117685560,42740618,160426178,8,0,1,7168,8,9390772136
16626,117688640,42749314,160437954,7,0,1,1536,10,4283026434
16627,117693230,42746350,160439580,8,0,1,2560,8,4527044898
16628,117696980,42744226,160441206,3,0,1,2560,17,7158188860
16629,117709250,42752195,160461445,3,0,1,16384,17,5023253740
16630,117709390,42757374,160466764,2,0,1,14848,3,6461428177
16631,117718480,42751830,160470310,3,0,1,5632,17,8231165965
16632,117720060,42771473,160491533,7,0,1,2560,10,2765761664
16633,117723411,42955245,160678656,5,0,1,109568,10,1972815092
16634,117758950,42919729,160678679,7,0,1,11776,10,7195842342
16635,117759460,42934221,160693681,3,0,1,2560,17,4862571905
16636,117761240,42935027,160696267,3,0,1,4096,17,590839580
16637,117768420,33810225,151578645,0,0,0,20992,3,6925780463
16638,117778330,43021647,160799977,2,0,1,71680,3,3117114618
16639,117782360,43017640,160800000,8,0,1,4096,8,10632854019
16640,117782441,43017582,160800023,8,0,1,2560,8,5778977830
16641,117789030,43011016,160800046,0,0,1,5120,3,7071083793
16642,117798530,43001539,160800069,7,0,1,12288,10,2459339456
16643,117802270,33977279,151779549,8,0,0,34816,8,4362437736
16644,117803621,42996479,160800100,8,0,1,1536,8,4896967002
16645,117805320,42994803,160800123,1,0,1,1536,10,6241323899
16646,117813850,42986296,160800146,3,0,1,4096,17,184024524
16647,117819100,43004155,160823255,1,0,1,6144,10,160086899
16648,117837571,42986964,160824535,8,0,1,14336,8,4173506551
16649,117844310,43042195,160886505,3,0,1,2048,17,1288921346
16650,117848070,43038458,160886528,1,0,1,16384,10,7647225857
16651,117849070,43037481,160886551,7,0,1,1536,10,7790591918
16652,117852670,33902135,151754805,9,0,0,28672,12,7302215986
16653,117856170,43048817,160904987,3,0,1,10752,17,3348041545
16654,117861560,33937098,151798658,9,0,0,27648,12,2663715555
16655,117862540,43042470,160905010,1,0,1,1024,10,6864488153
16656,117875190,33880106,151755296,6,0,0,1536,7,9427973952
16657,117878200,43026833,160905033,1,0,1,1536,10,3935066718
16658,117880090,43129083,161009173,2,0,1,30720,3,7753334627
16659,117886599,43122728,161009327,4,0,1,8704,15,5915351422
16660,117890460,33781978,151672438,9,0,0,512,12,8906407408
16661,117905380,43181626,161087006,9,0,1,38400,12,8025374637
16662,117914480,33617545,151532025,6,0,0,1024,7,5477861310
16663,117925930,43161099,161087029,3,0,1,5632,17,4605587488
16664,117936540,43168087,161104627,2,0,1,7680,3,9001237486
16665,117939401,43165572,161104973,8,0,1,512,8,9263570360
16666,117962090,34020595,151982685,9,0,0,40960,12,7582736022
16667,117965610,33893665,151859275,6,0,0,113152,7,5537224711
16668,117973610,43163399,161137009,3,0,1,5120,17,1647963377
16669,117976330,33751727,151728057,0,0,0,27136,3,6509826948
16670,117981351,43155681,161137032,8,0,1,2048,8,2890619614
16671,117982531,43154524,161137055,8,0,1,4096,8,9592297550
16672,117997460,33912762,151910222,6,0,0,43008,7,651133484
16673,117998310,43138768,161137078,3,0,1,1024,17,6104651141
16674,118029470,43107631,161137101,3,0,1,2048,17,8245517549
16675,118029551,43107573,161137124,8,0,1,5120,8,9503934657
16676,118030770,43185577,161216347,1,0,1,1024,10,3004275546
16677,118033250,34304688,152337938,6,0,0,26624,7,2055711389
16678,118044750,33946949,151991699,6,0,0,4096,7,8154148464
16679,118050020,43166350,161216370,2,0,1,11264,3,2589919645
16680,118070500,43170325,161240825,6,0,1,6656,7,9763439849
16681,118071280,43196137,161267417,2,0,1,36352,3,9720630895
16682,118099270,33771459,151870729,9,0,0,20992,12,2978009523
16683,118107650,33764506,151872156,0,0,0,4608,3,3650205165
16684,118110141,43197772,161307913,8,0,1,13312,8,4021035152
16685,118114860,33803497,151918357,9,0,0,26624,12,273790318
16686,118122071,43189463,161311534,8,0,1,2560,8,3100976772
16687,118128791,43184049,161312840,8,0,1,2048,8,3596985526
16688,118153090,43419891,161572981,2,0,1,214528,3,9680136775
16689,118157390,33796540,151953930,6,0,0,2048,7,4266580042
16690,118168571,43415074,161583645,8,0,1,5632,8,7020978501
16691,118169680,33910994,152080674,9,0,0,56832,12,6324941436
16692,118170000,43476654,161646654,2,0,1,74752,3,3350662453
16693,118171970,43593005,161764975,2,0,1,54272,3,4336961371
16694,118194150,43716207,161910357,2,0,1,172544,3,6575179675
16695,118194580,33795662,151990242,0,0,0,24576,3,4074617291
16696,118205300,34023826,152229126,6,0,0,22016,7,4467009215
16697,118215830,43697056,161912886,0,0,1,4608,3,278835620
16698,118230330,33933977,152164307,6,0,0,8704,7,8136310750
16699,118233160,43711555,161944715,3,0,1,14848,17,3642945927
16700,118233900,43710838,161944738,2,0,1,25600,3,9594588486
16701,118235870,43708891,161944761,0,0,1,1024,3,6280654044
16702,118249810,34117998,152367808,6,0,0,73216,7,9890927842
16703,118264300,34195024,152459324,0,0,0,17920,3,8627848710
16704,118272270,43695000,161967270,2,0,1,20480,3,5809511130
16705,118274370,34272650,152547020,9,0,0,157184,12,7197887578
16706,118329431,43640727,161970158,8,0,1,10752,8,5389791565
16707,118345940,33821822,152167762,9,0,0,11264,12,7042765564
16708,118352951,43619793,161972744,8,0,1,4096,8,9654286887
16709,118353320,33808312,152161632,0,0,0,84480,3,4224109922
16710,118363660,43616172,161979832,2,0,1,24064,3,5264228867
16711,118382131,43615449,161997580,8,0,1,3584,8,4048808301
16712,118382741,43616785,161999526,8,0,1,3072,8,7218946330
16713,118395290,33972861,152368151,6,0,0,1024,7,7523846144
16714,118399110,34328938,152728048,0,0,0,28672,3,4704751545
16715,118414120,43627920,162042040,2,0,1,47616,3,5443279918
16716,118424400,33921077,152345477,9,0,0,24064,12,3482782796
16717,118446620,34335174,152781794,6,0,0,35840,7,5214903268
16718,118450760,34174374,152625134,9,0,0,26624,12,8667655653
16719,118459761,43593540,162053301,8,0,1,14336,8,1356509612
16720,118465980,44009688,162475668,2,0,1,96256,3,7403037374
16721,118470521,44043539,162514060,8,0,1,5632,8,6318291954
16722,118483201,44040435,162523636,8,0,1,2048,8,2887649164
16723,118488800,33908775,152397575,9,0,0,7168,12,4820045760
16724,118491210,34085823,152577033,6,0,0,75264,7,2546072627
16725,118493871,44030111,162523982,8,0,1,512,8,9376943649
16726,118503431,44041373,162544804,8,0,1,6144,8,2946865364
16727,118506640,44057911,162564551,2,0,1,17920,3,1091096121
16728,118516510,33773045,152289555,6,0,0,31744,7,4561060126
16729,118517390,34454408,152971798,6,0,0,39424,7,617655168
16730,118529260,44087588,162616848,2,0,1,32768,3,7688814092
16731,118531581,44087215,162618796,8,0,1,23040,8,7938940955
16732,118537520,33765574,152303094,9,0,0,512,12,7168399889
16733,118547600,34054930,152602530,0,0,0,83456,3,8452310159
16734,118555570,34071303,152626873,0,0,0,5632,3,5029751782
16735,118569021,44071515,162640536,8,0,1,512,8,6762724583
16736,118585070,33789163,152374233,9,0,0,1024,12,3726490936
16737,118590720,33829820,152420540,0,0,0,1536,3,5538524952
16738,118592920,34366843,152959763,0,0,0,100864,3,7801250265
16739,118601600,34078909,152680509,6,0,0,24576,7,10498997721
16740,118614421,44033532,162647953,8,0,1,26112,8,8458921218
16741,118632770,44026224,162658994,3,0,1,6144,17,10157562406
16742,118642820,34216083,152858903,6,0,0,62464,7,5378100602
16743,118669260,44123637,162792897,2,0,1,63488,3,4644575652
16744,118669559,44143995,162813554,4,0,1,15360,15,4382028176
16745,118677300,33762061,152439361,9,0,0,1024,12,10421419616
16746,118693870,33908839,152602709,9,0,0,512,12,4107443078
16747,118695560,34075291,152770851,6,0,0,65536,7,9280200497
16748,118696190,34035725,152731915,6,0,0,11776,7,3313040589
16749,118701499,44112414,162813913,4,0,1,9728,15,3986426184
16750,118710520,33713173,152423693,9,0,0,1024,12,4081698751
16751,118713819,44105893,162819712,4,0,1,1536,15,1366020366
16752,118717980,44103358,162821338,2,0,1,2560,3,5271509552
16753,118762160,33949416,152711576,0,0,0,101888,3,6059646245
16754,118773920,44160815,162934735,2,0,1,96256,3,4106794135
16755,118780809,44158112,162938921,4,0,1,6656,15,9144127230
16756,118782599,44190947,162973546,4,0,1,3072,15,8635688393
16757,118788460,44302634,163091094,2,0,1,97792,3,7279330329
16758,118811130,33917128,152728258,9,0,0,512,12,3166841193
16759,118818280,33968529,152786809,0,0,0,16384,3,10349219392
16760,118833250,33972466,152805716,9,0,0,512,12,7718863842
16761,118838339,44308684,163147023,4,0,1,6656,15,4759006412
16762,118849640,33869626,152719266,6,0,0,25088,7,915516960
16763,118859890,34051322,152911212,0,0,0,44032,3,5478751885
16764,118861281,44297309,163158590,5,0,1,24576,10,7587098502
16765,118863070,34006792,152869862,6,0,0,35840,7,6255017732
16766,118869610,44306107,163175717,0,0,1,6656,3,9834441713
16767,118882860,44293203,163176063,3,0,1,512,17,8289469932
16768,118886269,44291740,163178009,4,0,1,3072,15,9208954530
16769,118895519,44284436,163179955,4,0,1,3072,15,7427269735
16770,118896169,44286372,163182541,4,0,1,4096,15,1199758696
16771,118900390,34072147,152972537,9,0,0,2048,12,4151773343
16772,118918800,44302883,163221683,2,0,1,13824,3,828504907
16773,118925710,33807008,152732718,6,0,0,2560,7,8000397564
16774,118939670,33943318,152882988,6,0,0,27136,7,1147073156
16775,118940850,33931539,152872389,6,0,0,8192,7,490643508
16776,118943310,33896538,152839848,6,0,0,31744,7,6354118790
16777,118958130,33953307,152911437,9,0,0,512,12,1806545604
16778,118964200,33964739,152928939,6,0,0,38912,7,7112249339
16779,118971070,33844883,152815953,9,0,0,512,12,6425952870
16780,118971159,44250870,163222029,4,0,1,512,15,4635468987
16781,118971980,34065703,153037683,9,0,0,1024,12,3086337974
16782,118998220,44322641,163320861,2,0,1,56832,3,5743925521
16783,119023080,44297804,163320884,7,0,1,12288,10,8457921520
16784,119027500,44337566,163365066,2,0,1,36864,3,2152786261
16785,119035721,44339672,163375393,5,0,1,4608,10,2252642452
16786,119036900,44347096,163383996,7,0,1,3072,10,1968510567
16787,119058529,44326543,163385072,4,0,1,13312,15,4648842860
16788,119072921,44318839,163391760,5,0,1,3584,10,10261913221
16789,119078639,44322249,163400888,4,0,1,2560,15,7389295984
16790,119082880,44332652,163415532,2,0,1,46080,3,6669289049
16791,119087610,44345609,163433219,2,0,1,13312,3,8584841229
16792,119097460,34029538,153126998,6,0,0,91136,7,5379733045
16793,119107850,44468705,163576555,2,0,1,93696,3,2819853395
16794,119119440,33767673,152887113,0,0,0,13312,3,4347824684
16795,119121830,44457631,163579461,7,0,1,4608,10,1086489388
16796,119131180,34050934,153182114,6,0,0,71168,7,7414772893
16797,119158890,44443430,163602320,2,0,1,14848,3,7047149942
16798,119171921,44485083,163657004,5,0,1,16896,10,3980938043
16799,119205080,44492886,163697966,2,0,1,6144,3,6750262326
16800,119207870,34061624,153269494,0,0,0,21504,3,8801306709
16801,119209220,33805813,153015033,9,0,0,512,12,6150754845
16802,119230101,44468121,163698222,5,0,1,9216,10,7722462755
16803,119241761,44593829,163835590,5,0,1,43520,10,2820073643
16804,119252900,33804042,153056942,6,0,0,22528,7,1739874868
16805,119253160,44582453,163835613,0,0,1,1024,3,5718535760
16806,119257091,44583724,163840815,5,0,1,29696,10,2430021694
16807,119266200,44591517,163857717,0,0,1,3584,3,7530579206
16808,119288831,44576116,163864947,5,0,1,2560,10,1174790425
16809,119309260,44568242,163877502,0,0,1,7168,3,9421234032
16810,119313591,44688058,164001649,5,0,1,96256,10,10394338970
16811,119320670,44684845,164005515,0,0,1,6144,3,10389628327
16812,119356680,44735506,164092186,0,0,1,2048,3,4297000664
16813,119363910,44794262,164158172,2,0,1,75264,3,4099332548
16814,119381390,33761602,153142992,6,0,0,19968,7,6705746198
16815,119383490,44793604,164177094,0,0,1,5632,3,2398949894
16816,119383951,45032057,164416008,5,0,1,101376,10,2837905241
16817,119389090,33812752,153201842,0,0,0,19968,3,9826287269
16818,119396070,45024821,164420891,7,0,1,5120,10,1349112722
16819,119401650,34000570,153402220,6,0,0,17408,7,7519905683
16820,119415531,45196053,164611584,5,0,1,60928,10,5778984188
16821,119417880,33732404,153150284,9,0,0,2048,12,8004067947
16822,119433910,45177697,164611607,0,0,1,4096,3,4584112315
16823,119437081,45260971,164698052,5,0,1,54784,10,3547321602
16824,119439210,45258865,164698075,0,0,1,1536,3,844836742
16825,119441240,45256858,164698098,0,0,1,11264,3,10642052528
16826,119450600,45257871,164708471,0,0,1,8192,3,1110162414
16827,119455170,33901918,153357088,0,0,0,135680,3,332443891
16828,119471900,45236594,164708494,0,0,1,2048,3,9894623752
16829,119476180,45232353,164708533,0,0,1,4096,3,6743427882
16830,119487851,45229571,164717422,5,0,1,16384,10,9754736801
16831,119504510,33953107,153457617,0,0,0,15360,3,2792028571
16832,119509280,45223872,164733152,3,0,1,14336,17,1487145893
16833,119522110,45211065,164733175,0,0,1,2560,3,1302744629
16834,119526900,33835203,153362103,0,0,0,16384,3,190980843
16835,119532000,45303686,164835686,2,0,1,123904,3,3220448245
16836,119540280,33730797,153271077,0,0,0,5120,3,3945533968
16837,119550131,45452055,165002186,5,0,1,136192,10,5842652568
16838,119560580,45466973,165027553,2,0,1,23552,3,2440465591
16839,119561301,45470464,165031765,5,0,1,16896,10,4290988627
16840,119565981,45472691,165038672,5,0,1,20480,10,9121198546
16841,119574910,33877513,153452423,6,0,0,95232,7,5710095189
16842,119578770,33787627,153366397,0,0,0,8704,3,5088630460
16843,119606221,45567541,165173762,5,0,1,41472,10,4871192727
16844,119614610,33838304,153452914,9,0,0,1536,12,8917226445
16845,119621390,33951353,153572743,0,0,0,60928,3,8971350859
16846,119622470,45680924,165303394,2,0,1,32768,3,8169441986
16847,119622990,45680427,165303417,0,0,1,3584,3,7327847321
16848,119624930,45707119,165332049,2,0,1,50688,3,661596981
16849,119644200,34195134,153839334,6,0,0,32768,7,240508849
16850,119698390,33874555,153572945,9,0,0,512,12,3624542009
16851,119699510,34089087,153788597,0,0,0,16384,3,1166779899
16852,119699860,45694266,165394126,0,0,1,14848,3,9552820193
16853,119714760,45679389,165394149,2,0,1,6144,3,4351558763
16854,119736460,33783141,153519601,0,0,0,2560,3,6848885591
16855,119746690,45771002,165517692,2,0,1,76288,3,8949982339
16856,119750761,45766954,165517715,5,0,1,5120,10,6933964740
16857,119752030,45765708,165517738,0,0,1,8192,3,3727210597
16858,119761590,45794684,165556274,7,0,1,3584,10,2443797876
16859,119775510,45854945,165630455,2,0,1,85504,3,2574598024
16860,119782510,33994604,153777114,6,0,0,3584,7,9533471157
16861,119788570,34069865,153858435,0,0,0,44544,3,7253746764
16862,119798920,34030399,153829319,6,0,0,109568,7,9798146088
16863,119822790,45871972,165694762,2,0,1,42496,3,8092487376
16864,119823680,45917892,165741572,2,0,1,68608,3,6496435673
16865,119828630,34041994,153870624,6,0,0,31232,7,242329602
16866,119830030,34306504,154136534,6,0,0,161792,7,2904394603
16867,119859040,45884017,165743057,2,0,1,15360,3,8488063101
16868,119859300,45975147,165834447,2,0,1,86528,3,177848402
16869,119879970,34159248,154039218,9,0,0,1024,12,6315324440
16870,119902280,45951976,165854256,2,0,1,22016,3,4800243367
16871,119914670,34041531,153956201,0,0,0,77312,3,138123455
16872,119917730,45964016,165881746,3,0,1,2560,17,10311747180
16873,119926560,45958092,165884652,3,0,1,4608,17,9290231415
16874,119947450,45967938,165915388,3,0,1,10240,17,269835919
16875,119951530,46007611,165959141,3,0,1,4096,17,6198378927
16876,119981910,45977254,165959164,3,0,1,11264,17,10103623044
16877,119987470,45971717,165959187,2,0,1,20480,3,1374847827
16878,119991300,33917832,153909132,0,0,0,21504,3,963608837
16879,119998130,46008313,166006443,2,0,1,65024,3,493904428
16880,120015820,46006001,166021821,3,0,1,3584,17,5036482638
16881,120032890,46044496,166077386,2,0,1,78848,3,8219086353
16882,120046230,34271620,154317850,6,0,0,42496,7,6025268122
16883,120047110,46046485,166093595,2,0,1,8704,3,7301097007
16884,120067090,34013546,154080636,0,0,0,6656,3,10160430557
16885,120091890,46006211,166098101,3,0,1,7168,17,2051247234
16886,120092690,34076184,154168874,0,0,0,74752,3,3992062389
16887,120100640,46017926,166118566,9,0,1,22016,12,607162905
16888,120103090,33859795,153962885,9,0,0,2048,12,4747015802
16889,120106170,46014274,166120444,3,0,1,1536,17,9047936636
16890,120116190,46056653,166172843,2,0,1,62464,3,7210722110
16891,120134590,46054933,166189523,3,0,1,5120,17,6719007575
16892,120135430,33903453,154038883,6,0,0,26624,7,398605300
16893,120144020,46083587,166227607,2,0,1,66560,3,10486204560
16894,120163370,46136209,166299579,3,0,1,3584,17,187572237
16895,120173040,46156018,166329058,2,0,1,17408,3,8165403402
16896,120191020,33648805,153839825,9,0,0,1536,12,574177079
16897,120204910,46125121,166330031,2,0,1,12800,3,6390095877
16898,120211160,33745220,153956380,9,0,0,512,12,3237986953
16899,120215720,46153408,166369128,2,0,1,33792,3,30288751
16900,120243420,46175520,166418940,3,0,1,10240,17,8623526050
16901,120255431,46163532,166418963,5,0,1,512,10,5145406848
16902,120264440,46219305,166483745,2,0,1,39936,3,814426682
16903,120279180,46216775,166495955,3,0,1,3584,17,5074754565
16904,120285260,46212961,166498221,2,0,1,3584,3,3930801953
16905,120299370,46201416,166500786,2,0,1,3072,3,8716157079
16906,120301200,46219870,166521070,2,0,1,15360,3,948543684
16907,120313180,46236224,166549404,6,0,1,5120,7,6807306378
16908,120335740,46213938,166549678,7,0,1,2560,10,4173168916
16909,120335770,33802682,154138452,0,0,0,6144,3,7920156807
16910,120343000,33883152,154226152,6,0,0,66560,7,4012788363
16911,120353360,33669814,154023174,0,0,0,7168,3,7957191506
16912,120356240,33705885,154062125,6,0,0,48640,7,598009578
16913,120375380,46177204,166552584,3,0,1,4608,17,2298114530
16914,120375610,46179560,166555170,3,0,1,4096,17,10707591911
16915,120391440,33747664,154139104,9,0,0,1536,12,10284649089
16916,120401800,46194425,166596225,2,0,1,20480,3,526050881
16917,120413970,46201902,166615872,2,0,1,21504,3,846014684
16918,120421370,33718115,154139485,9,0,0,1024,12,8127706418
16919,120423990,46191905,166615895,2,0,1,5120,3,4490737478
16920,120453770,34092642,154546412,6,0,0,2048,7,7454151741
16921,120457430,33830459,154287889,9,0,0,1536,12,6810416643
16922,120474520,33701181,154175701,9,0,0,10240,12,6253957711
16923,120475880,33882128,154358008,6,0,0,39936,7,6801120654
16924,120479170,33982324,154461494,0,0,0,2048,3,8523928415
16925,120483680,46144429,166628109,3,0,1,2048,17,8760848589
16926,120494400,34096096,154590496,6,0,0,44544,7,3023547784
16927,120503330,46124802,166628132,3,0,1,11264,17,5984514584
16928,120522710,46105445,166628155,3,0,1,1024,17,9862765458
16929,120567940,33959993,154527933,0,0,0,9728,3,3347802478
16930,120579850,34160658,154740508,6,0,0,316928,7,84949500
16931,120585150,46075295,166660445,3,0,1,32768,17,7075763097
16932,120585680,46144648,166730328,7,0,1,5632,10,6773013492
16933,120600270,34159027,154759297,0,0,0,39936,3,5641746196
16934,120627080,33894398,154521478,9,0,0,17920,12,8662508993
16935,120635120,34191809,154826929,6,0,0,59392,7,5574137054
16936,120690100,34196268,154886368,9,0,0,70656,12,233845862
16937,120736809,46011999,166748808,4,0,1,22016,15,8041362465
16938,120745190,34102587,154847777,9,0,0,43008,12,6587177035
16939,120761950,33694256,154456206,9,0,0,23040,12,3548356897
16940,120771041,46043803,166814844,5,0,1,23040,10,8926260533
16941,120799500,33619210,154418710,0,0,0,6144,3,1915713717
16942,120809980,46005223,166815203,7,0,1,9728,10,1910018372
16943,120812620,34021976,154834596,9,0,0,25088,12,9463774856
16944,120828570,46076361,166904931,7,0,1,7680,10,1160899033
16945,120832880,46072074,166904954,9,0,1,19968,12,6430806559
16946,120839770,34110999,154950769,0,0,0,27136,3,7006159452
16947,120851300,46053677,166904977,7,0,1,5120,10,6467453399
16948,120852480,46052520,166905000,7,0,1,2048,10,6799449026
16949,120854310,33911406,154765716,9,0,0,20992,12,6715662587
16950,120863880,33773740,154637620,9,0,0,37888,12,5576916139
16951,120880250,33866833,154747083,6,0,0,21504,7,8792801248
16952,120890350,46014673,166905023,7,0,1,1024,10,9204895626
16953,120906440,34297733,155204173,9,0,0,219136,12,10718604240
16954,120941610,33835392,154777002,0,0,0,27136,3,3122875835
16955,120945060,45959986,166905046,7,0,1,1536,10,6467562532
16956,120956470,33852340,154808810,6,0,0,91136,7,1425067859
16957,120967850,33892071,154859921,6,0,0,22016,7,3871773881
16958,120969400,33808896,154778296,0,0,0,4096,3,7766967637
16959,120975690,33793013,154768703,0,0,0,9728,3,6796951656
16960,120983991,45974361,166958352,5,0,1,64000,10,8671386829
16961,121005960,34103526,155109486,0,0,0,52224,3,9666679411
16962,121009880,45967800,166977680,7,0,1,4096,10,1342143780
16963,121027780,45966107,166993887,7,0,1,7168,10,6863741043
16964,121039370,45957103,166996473,7,0,1,4096,10,2861730114
16965,121039860,33945425,154985285,0,0,0,12800,3,7658014169
16966,121057320,45946466,167003786,9,0,1,14336,12,9116094931
16967,121074621,45929831,167004452,8,0,1,1024,8,10654986095
16968,121077310,45945688,167022998,9,0,1,13312,12,4485974787
16969,121084961,45938068,167023029,8,0,1,2048,8,6044610653
16970,121109570,34399420,155508990,9,0,0,31744,12,10035864032
16971,121112110,45910942,167023052,7,0,1,1024,10,4358733175
16972,121114880,33977238,155092118,6,0,0,9216,7,785256704
16973,121121890,33935037,155056927,9,0,0,9216,12,6618303310
16974,121137550,34125787,155263337,6,0,0,15360,7,2819122659
16975,121151210,45871865,167023075,7,0,1,512,10,2441687041
16976,121152890,46020488,167173378,9,0,1,102400,12,4314421445
16977,121154290,46231668,167385958,9,0,1,142336,12,8210443222
16978,121163920,34052155,155216075,9,0,0,38912,12,8110014760
16979,121168750,33818430,154987180,9,0,0,6144,12,6555087612
16980,121170461,46215520,167385981,8,0,1,512,8,2590568512
16981,121178830,34502351,155681181,9,0,0,174080,12,10235039943
16982,121181360,46204644,167386004,7,0,1,13312,10,6102740945
16983,121196580,34554655,155751235,9,0,0,51712,12,2156277244
16984,121201881,46198069,167399950,8,0,1,3072,8,3697805384
16985,121207910,34162692,155370602,6,0,0,81408,7,6645618885
16986,121233100,34581341,155814441,6,0,0,12800,7,2082377169
16987,121255520,33977608,155233128,6,0,0,36352,7,7063383398
16988,121255600,34304663,155560263,8,0,0,10240,8,4146426587
16989,121258900,33854977,155113877,8,0,0,14336,8,3845064989
16990,121261310,33991488,155252798,8,0,0,17408,8,7300901676
16991,121264620,34002640,155267260,9,0,0,12800,12,6368548055
16992,121296550,46152581,167449131,9,0,1,37376,12,1168120985
16993,121321680,33900326,155222006,6,0,0,2048,7,6774781488
16994,121327030,46212372,167539402,9,0,1,109056,12,10682409790
16995,121329860,34136986,155466846,9,0,0,31232,12,4610739125
16996,121331491,46248999,167580490,8,0,1,10240,8,1612235096
16997,121336520,34359972,155696492,0,0,0,50176,3,5296562142
16998,121338650,34605704,155944354,9,0,0,12288,12,9856938200
16999,121340680,46384711,167725391,9,0,1,106496,12,3704503481
17000,121349730,34032368,155382098,9,0,0,31232,12,7074818700
17001,121349850,46375564,167725414,0,0,1,3584,3,2207310662
17002,121352040,35023853,156375893,0,0,0,86016,3,3615829409
17003,121364690,34087735,155452425,6,0,0,7680,7,6299589528
17004,121382080,46358746,167740826,9,0,1,36864,12,3977118965
17005,121385720,46420288,167806008,9,0,1,72192,12,8217428065
17006,121390179,46425105,167815284,4,0,1,17920,15,3215166571
17007,121402210,46415980,167818190,7,0,1,4608,10,3791943120
17008,121402600,35179175,156581775,0,0,0,36352,3,1697889689
17009,121403800,34398373,155802173,8,0,0,7680,8,8305118739
17010,121407940,34315655,155723595,6,0,0,37888,7,8478885699
17011,121417170,34421221,155838391,8,0,0,19968,8,7999950259
17012,121446420,34264603,155711023,6,0,0,47616,7,10514382099
17013,121452510,46368906,167821416,7,0,1,5120,10,7472705799
17014,121461660,34645606,156107266,8,0,0,50688,8,3288025058
17015,121470660,46351102,167821762,3,0,1,512,17,9204857916
17016,121477410,34100349,155577759,6,0,0,43008,7,8805751733
17017,121498010,46325378,167823388,3,0,1,2560,17,639607649
17018,121501120,35218186,156719306,9,0,0,79872,12,2390987183
17019,121509200,46318270,167827470,3,0,1,1536,17,10056888223
17020,121516960,46311816,167828776,3,0,1,2048,17,5945831493
17021,121523700,33997539,155521239,8,0,0,512,8,5839096731
17022,121526960,46337229,167864189,9,0,1,30208,12,1396883791
17023,121529620,46335235,167864855,7,0,1,1024,10,4160574615
17024,121538980,46328461,167867441,6,0,1,4096,7,8162807828
17025,121539620,34960233,156499853,9,0,0,142848,12,3669805394
17026,121540100,46327495,167867595,7,0,1,8704,10,10585124308
17027,121554010,46331182,167885192,6,0,1,10752,7,201909563
17028,121562050,34061120,155623170,0,0,0,7680,3,8235332549
17029,121569800,34142205,155712005,8,0,0,3072,8,3208770723
17030,121574040,46313098,167887138,3,0,1,3072,17,5847112387
17031,121577900,46345271,167923171,9,0,1,36864,12,8692490318
17032,121585670,46342953,167928623,3,0,1,2048,17,8567401732
17033,121589400,46339377,167928777,7,0,1,8704,10,6784577401
17034,121592480,46344389,167936869,9,0,1,20480,12,10167703259
17035,121596430,46341425,167937855,6,0,1,1536,7,10415221749
17036,121602130,34279333,155881463,8,0,0,39936,8,1544484358
17037,121619810,46318711,167938521,7,0,1,1024,10,7373889222
17038,121625950,46314517,167940467,6,0,1,3072,7,10062177621
17039,121627810,46313643,167941453,3,0,1,1536,17,10291894972
17040,121630830,34095665,155726495,8,0,0,9216,8,9481652072
17041,121641320,34433764,156075084,8,0,0,14336,8,2009242044
17042,121646700,46305290,167951990,3,0,1,2048,17,2941702302
17043,121650690,34265030,155915720,6,0,0,24064,7,3344695167
17044,121654610,46300606,167955216,7,0,1,5120,10,10668549850
17045,121657280,34984519,156641799,0,0,0,45056,3,6933805261
17046,121658950,46352116,168011066,9,0,1,58368,12,618901840
17047,121667770,46343642,168011412,3,0,1,512,17,6540362070
17048,121670740,34399953,156070693,8,0,0,43008,8,5218492524
17049,121675980,34080894,155756874,8,0,0,18432,8,7543915839
17050,121676120,46336598,168012718,7,0,1,2048,10,8172361636
17051,121690790,46322914,168013704,0,0,1,1536,3,2029215885
17052,121698870,46319340,168018210,7,0,1,7168,10,8870509770
17053,121702120,46326508,168028628,7,0,1,11776,10,4812908047
17054,121709470,34085423,155794893,9,0,0,4096,12,1691364085
17055,121709560,34584156,156293716,0,0,0,202752,3,744279694
17056,121718640,46310011,168028651,0,0,1,3072,3,6352872621
17057,121722170,46306504,168028674,7,0,1,7168,10,7960790507
17058,121722350,46307418,168029768,6,0,1,2048,7,9382680514
17059,121723950,34619200,156343150,6,0,0,78336,7,1927197633
17060,121733290,46300593,168033883,7,0,1,11264,10,2689430385
17061,121737321,34447709,156185030,7,0,0,12288,10,8581230212
17062,121741590,46304981,168046571,0,0,1,10240,3,3194397127
17063,121751420,34139869,155891289,0,0,0,4608,3,1776792683
17064,121752460,35120642,156873102,6,0,0,87552,7,2829363627
17065,121792120,34510667,156302787,8,0,0,29696,8,9209165584
17066,121811360,34538209,156349569,0,0,0,20992,3,633627966
17067,121816850,46262798,168079648,7,0,1,39424,10,79536400
17068,121819460,34319915,156139375,6,0,0,40448,7,1317807000
17069,121827860,46254969,168082829,7,0,1,512,10,15752188
17070,121828590,46254905,168083495,0,0,1,1024,3,8049386470
17071,121833010,34105423,155938433,9,0,0,29184,12,4405713406
17072,121834360,34574653,156409013,0,0,0,19456,3,9534506350
17073,121838190,46247146,168085336,3,0,1,512,17,9115151037
17074,121867620,34924010,156791630,6,0,0,65536,7,322600339
17075,121872860,46217302,168090162,3,0,1,7680,17,3174248445
17076,121874330,46218738,168093068,0,0,1,4608,3,4130838033
17077,121877530,46218124,168095654,3,0,1,4096,17,2774493925
17078,121878250,34283491,156161741,9,0,0,8704,12,3093502780
17079,121880580,34747468,156628048,8,0,0,66048,8,4157386746
17080,121883900,34503317,156387217,6,0,0,36864,7,468631446
17081,121884030,46217317,168101347,0,0,1,4608,3,9807122612
17082,121886390,46215303,168101693,6,0,1,512,7,170058915
17083,121891710,46215129,168106839,6,0,1,8192,7,2582957665
17084,121891800,46215385,168107185,3,0,1,512,17,1607428911
17085,121903430,46206021,168109451,3,0,1,3584,17,2788776771
17086,121913980,46198057,168112037,6,0,1,4096,7,3658696749
17087,121920430,46203612,168124042,6,0,1,8192,7,2880117182
17088,121924490,46199898,168124388,3,0,1,512,17,8580239848
17089,121927610,34475018,156402628,9,0,0,10752,12,6220500207
17090,121934900,34464389,156399289,0,0,0,38912,3,6084761632
17091,121936490,46189204,168125694,3,0,1,2048,17,2416737210
17092,121937920,34872297,156810217,9,0,0,60928,12,5354238964
17093,121949880,34580559,156530439,8,0,0,29184,8,4097394063
17094,121958200,46171774,168129974,3,0,1,4096,17,626576994
17095,121963460,34492846,156456306,8,0,0,56320,8,3367859342
17096,121966310,34352880,156319190,9,0,0,53760,12,6806717233
17097,121967140,46167366,168134506,6,0,1,7168,7,8909509040
17098,121970840,46165292,168136132,0,0,1,2560,3,7508240697
17099,121974659,46161729,168136388,4,0,1,9216,15,6403839850
17100,121977410,35018493,156995903,9,0,0,72704,12,10537982353
17101,121990279,46166709,168156988,4,0,1,7168,15,2644281098
17102,121993599,46164375,168157974,4,0,1,1536,15,6856930940
17103,121994580,46168540,168163120,6,0,1,8192,7,1363837994
17104,121996299,46172611,168168910,4,0,1,5632,15,5215385190
17105,122013260,46168025,168181285,0,0,1,3072,3,3093936051
17106,122017599,46163709,168181308,4,0,1,4608,15,10221488094
17107,122021270,34914651,156935921,8,0,0,17920,8,10297476826
17108,122026290,34986719,157013009,6,0,0,11776,7,5160868596
17109,122028520,34853497,156882017,0,0,0,29184,3,5008341917
17110,122040809,46144601,168185410,4,0,1,3584,15,4836848118
17111,122041200,34653739,156694939,9,0,0,83968,12,4358774194
17112,122043180,34475945,156519125,9,0,0,19968,12,3601507165
17113,122054770,46130663,168185433,3,0,1,3584,17,224668623
17114,122060580,34608752,156669332,0,0,0,6656,3,4435903059
17115,122062150,34591528,156653678,9,0,0,38912,12,2664999990
17116,122064469,46120987,168185456,4,0,1,4096,15,2232077669
17117,122094520,35092736,157187256,6,0,0,16384,7,1946447102
17118,122097969,46109108,168207077,4,0,1,5632,15,4714640778
17119,122115000,46094023,168209023,6,0,1,3072,7,10153073336
17120,122118360,34489541,156607901,0,0,0,58880,3,1172189481
17121,122124330,46085359,168209689,6,0,1,1024,7,5322240751
17122,122133920,46078355,168212275,6,0,1,4096,7,8169169567
17123,122147060,34860098,157007158,6,0,0,36864,7,5846410180
17124,122153140,46063321,168216461,3,0,1,6656,17,78500113
17125,122153400,46082573,168235973,3,0,1,9216,17,1648497566
17126,122155420,35017190,157172610,6,0,0,45056,7,1325625570
17127,122163440,46119704,168283144,6,0,1,1536,7,10173874762
17128,122172640,34547945,156720585,6,0,0,4096,7,3139843764
17129,122172769,46112961,168285730,4,0,1,4096,15,10507310426
17130,122184670,46102046,168286716,6,0,1,1536,7,67987874
17131,122187950,34479323,156667273,0,0,0,44544,3,4020702265
17132,122196740,46090962,168287702,3,0,1,1536,17,4053237275
17133,122199350,35076376,157275726,9,0,0,73728,12,4298731225
17134,122205061,46123415,168328476,5,0,1,11776,10,1565461096
17135,122206370,46122362,168328732,3,0,1,9216,17,7459311078
17136,122206490,34682437,156888927,0,0,0,22528,3,3382664279
17137,122215050,46183645,168398695,0,0,1,2560,3,8095379930
17138,122235759,46163602,168399361,4,0,1,1024,15,61241117
17139,122237210,46212388,168449598,3,0,1,10240,17,8736901802
17140,122254489,46195775,168450264,4,0,1,11264,15,2086881119
17141,122256989,46283098,168540087,4,0,1,1536,15,6949439052
17142,122257410,46318661,168576071,0,0,1,1024,3,9722018466
17143,122262890,34558857,156821747,9,0,0,23040,12,4483943281
17144,122266590,34663848,156930438,6,0,0,48128,7,9654829797
17145,122267720,46309017,168576737,0,0,1,1024,3,10576460730
17146,122288670,34627081,156915751,8,0,0,11776,8,8762055597
17147,122290850,34648066,156938916,0,0,0,9728,3,9181108313
17148,122291210,46290353,168581563,3,0,1,7680,17,7690385020
17149,122300020,35010496,157310516,0,0,0,1024,3,3425841642
17150,122312559,46338194,168650753,4,0,1,5120,15,4022416482
17151,122314060,46336716,168650776,6,0,1,5632,7,7561788892
17152,122314230,46355712,168669942,0,0,1,11264,3,7443918932
17153,122314420,46489927,168804347,0,0,1,6144,3,1797796401
17154,122320580,34727727,157048307,9,0,0,20480,12,1298709153
17155,122325630,46503992,168829622,3,0,1,2048,17,6476513611
17156,122331530,34905891,157237421,0,0,0,36352,3,1309069597
17157,122333190,46496455,168829645,6,0,1,4096,7,4663864090
17158,122334260,46495408,168829668,0,0,1,1536,3,7635353362
17159,122342860,46501050,168843910,0,0,1,6656,3,6494561414
17160,122352230,46491703,168843933,3,0,1,13312,17,873086819
17161,122369030,46674739,169043769,0,0,1,15872,3,10575539523
17162,122386900,46660415,169047315,6,0,1,5632,7,3947567020
17163,122387991,46660310,169048301,8,0,1,1536,8,5444284616
17164,122399341,46667726,169067067,8,0,1,24064,8,7749373955
17165,122416099,46676029,169092128,4,0,1,3072,15,6374892864
17166,122416311,46675840,169092151,8,0,1,10240,8,4968072995
17167,122431380,46685728,169117108,0,0,1,8704,3,9455094362
17168,122443760,46675934,169119694,6,0,1,4096,7,7484247520
17169,122452591,46697518,169150109,8,0,1,8192,8,1006594021
17170,122458310,34851825,157310135,6,0,0,41984,7,1768144206
17171,122460031,46791899,169251930,8,0,1,3072,8,6145480298
17172,122465520,46789636,169255156,0,0,1,5120,3,4394667528
17173,122467840,46834758,169302598,6,0,1,5120,7,144234827
17174,122483969,46818652,169302621,4,0,1,6144,15,387242900
17175,122488160,34899935,157388095,9,0,0,8192,12,9813292982
17176,122493111,46809541,169302652,8,0,1,1024,8,9115349654
17177,122505430,35231319,157736749,0,0,0,82944,3,1713583285
17178,122509660,46882493,169392153,6,0,1,5120,7,7024694010
17179,122512190,35035627,157547817,0,0,0,84480,3,3736435278
17180,122514019,46882732,169396751,4,0,1,9728,15,4269624957
17181,122528079,46871578,169399657,4,0,1,4608,15,8281844059
17182,122531940,34967061,157499001,8,0,0,25088,8,7058180013
17183,122554780,34913313,157468093,8,0,0,27648,8,6646216340
17184,122555730,46844593,169400323,3,0,1,1024,17,7136114014
17185,122578040,46847436,169425476,3,0,1,9216,17,9720524380
17186,122584291,46883749,169468040,8,0,1,5120,8,5058618516
17187,122586410,46881653,169468063,6,0,1,6656,7,2648864732
17188,122588230,46879856,169468086,3,0,1,1024,17,2256063245
17189,122592390,46875898,169468288,1,0,1,4608,10,6209336194
17190,122598730,46869581,169468311,0,0,1,7680,3,903672692
17191,122599509,46868825,169468334,4,0,1,10752,15,8695704059
17192,122600280,46905305,169505585,6,0,1,2560,7,5273723179
17193,122604010,46917550,169521560,6,0,1,4608,7,9651794415
17194,122613250,46995055,169608305,0,0,1,6144,3,1004934795
17195,122619950,46989661,169609611,6,0,1,2048,7,1712313909
17196,122626980,34797037,157424017,9,0,0,1536,12,6550235288
17197,122629870,46980087,169609957,3,0,1,512,17,5608920797
17198,122636270,46974033,169610303,3,0,1,512,17,5445438752
17199,122648950,35197847,157846797,6,0,0,85504,7,7847573724
17200,122649880,46963649,169613529,0,0,1,5120,3,2375668655
17201,122678180,34732143,157410323,9,0,0,35840,12,10512998422
17202,122678951,46940061,169619012,8,0,1,1536,8,8877927228
17203,122679540,34768115,157447655,9,0,0,37376,12,5359132173
17204,122683870,46936218,169620088,3,0,1,13312,17,8167303144
17205,122701520,34981075,157682595,0,0,0,92160,3,8731866551
17206,122713189,46908845,169622034,4,0,1,3072,15,187031073
17207,122735580,46899681,169635261,0,0,1,21504,3,9348503245
17208,122738501,46912639,169651140,8,0,1,5632,8,6681533962
17209,122741239,46910567,169651806,4,0,1,1024,15,6149856888
17210,122752120,46900672,169652792,6,0,1,1536,7,4646653408
17211,122768650,46884296,169652946,0,0,1,8704,3,2162738407
17212,122782370,35143349,157925719,8,0,0,54784,8,7205480056
17213,122783420,35071512,157854932,8,0,0,26624,8,725207297
17214,122793220,35483116,158276336,6,0,0,102400,7,7775953017
17215,122799280,34998832,157798112,6,0,0,34816,7,10201957475
17216,122807681,46851387,169659068,8,0,1,1536,8,8463962077
17217,122810870,35170564,157981434,8,0,0,182784,8,4194425447
17218,122819230,46840504,169659734,0,0,1,1024,3,4696002190
17219,122823400,35190083,158013483,8,0,0,51712,8,966946759
17220,122836650,35314038,158150688,6,0,0,106496,7,8169589069
17221,122842050,35173328,158015378,8,0,0,6144,8,7195356397
17222,122845410,46814478,169659888,3,0,1,8704,17,6430197222
17223,122845710,46846788,169692498,6,0,1,9216,7,9064251370
17224,122850761,46841776,169692537,8,0,1,7168,8,9672996555
17225,122852640,34800617,157653257,0,0,0,33280,3,8578486052
17226,122853130,35306473,158159603,9,0,0,29184,12,4608453027
17227,122859500,46863547,169723047,0,0,1,1024,3,6611450203
17228,122860610,46862460,169723070,0,0,1,2560,3,9792981915
17229,122861990,46861103,169723093,0,0,1,10240,3,6799667423
17230,122864510,34750213,157614723,6,0,0,30720,7,2376104364
17231,122870530,34881740,157752270,8,0,0,27648,8,3270738961
17232,122879409,46843707,169723116,4,0,1,2048,15,8015505746
17233,122895620,46828265,169723885,7,0,1,1024,10,6850246297
17234,122912799,46811432,169724231,4,0,1,512,15,1617799195
17235,122914721,46811456,169726177,8,0,1,3072,8,2132799697
17236,122919030,46808120,169727150,2,0,1,12800,3,8107701416
17237,122921420,35361911,158283331,9,0,0,22528,12,4609751982
17238,122922169,46805647,169727816,4,0,1,1024,15,796338624
17239,122936481,46837453,169773934,8,0,1,15360,8,10435506980
17240,122936619,46964044,169900663,4,0,1,14848,15,7865072618
17241,122939339,46961347,169900686,4,0,1,8192,15,4506366
17242,122942250,35044199,157986449,9,0,0,16384,12,5146352231
17243,122952470,35065847,158018317,6,0,0,9216,7,5206382597
17244,122955541,46960057,169915598,8,0,1,6144,8,6282259160
17245,122958560,35266643,158225203,9,0,0,3584,12,8855254552
17246,122958850,34794067,157752917,8,0,0,2048,8,5477250583
17247,122964610,35432423,158397033,9,0,0,53760,12,3320169208
17248,122967400,35030304,157997704,0,0,0,36864,3,9101592127
17249,122976370,35114236,158090606,6,0,0,102912,7,6621690850
17250,122983601,46932020,169915621,8,0,1,1536,8,2984312531
17251,122986190,46963243,169949433,3,0,1,13312,17,7272233633
17252,122988310,47082166,170070476,0,0,1,1536,3,2375221445
17253,122991790,47078709,170070499,3,0,1,512,17,3950583055
17254,123000999,47073171,170074170,4,0,1,7680,15,277720811
17255,123008290,34888635,157896925,9,0,0,41984,12,10211964893
17256,123033140,34866460,157899600,0,0,0,8704,3,2888865912
17257,123033640,35508751,158542391,8,0,0,158208,8,2860987886
17258,123034710,47140174,170174884,3,0,1,2048,17,9644585627
17259,123037200,47137707,170174907,3,0,1,13824,17,4124041795
17260,123040740,35202455,158243195,8,0,0,53248,8,6600558948
17261,123046890,47221378,170268268,3,0,1,8704,17,9510461314
17262,123050070,34988065,158038135,9,0,0,35328,12,6615014995
17263,123051711,47226633,170278344,8,0,1,7168,8,1170436890
17264,123061310,47217057,170278367,3,0,1,5120,17,2191908349
17265,123065109,34792833,157857942,3,0,0,1536,17,3031287131
17266,123067750,47210640,170278390,3,0,1,1536,17,5585861616
17267,123071280,34786171,157857451,8,0,0,8192,8,7406389192
17268,123076570,34973444,158050014,8,0,0,38912,8,977198189
17269,123076720,35132459,158209179,9,0,0,4608,12,7707138056
17270,123078201,47253345,170331546,8,0,1,2048,8,6530086290
17271,123081131,47250438,170331569,8,0,1,3584,8,5538333819
17272,123085670,35271229,158356899,6,0,0,13312,7,4997895910
17273,123090070,47241522,170331592,3,0,1,512,17,8089846815
17274,123106909,47224706,170331615,4,0,1,512,15,8283530353
17275,123108121,47223517,170331638,8,0,1,512,8,681618993
17276,123119780,47211881,170331661,3,0,1,4608,17,8568118907
17277,123129820,35037496,158167316,8,0,0,25088,8,6964061046
17278,123152690,35092423,158245113,0,0,0,6144,3,3394995852
17279,123154001,47177683,170331684,8,0,1,1536,8,9620353440
17280,123169800,47161907,170331707,3,0,1,3072,17,8291970010
17281,123181840,34920691,158102531,6,0,0,38912,7,10293321948
17282,123182930,35367775,158550705,8,0,0,27136,8,1800010142
17283,123184991,47146739,170331730,8,0,1,2560,8,9531196471
17284,123188500,47151396,170339896,3,0,1,4096,17,2534579755
17285,123230170,35239994,158470164,0,0,0,20480,3,7513416840
17286,123238230,47253669,170491899,2,0,1,55808,3,2985148880
17287,123260579,47231343,170491922,4,0,1,512,15,5118390166
17288,123266409,47225536,170491945,4,0,1,13824,15,4037481694
17289,123266639,47268156,170534795,4,0,1,2560,15,231054755
17290,123274781,47334307,170609088,8,0,1,7680,8,9090435737
17291,123278480,35042289,158320769,8,0,0,14336,8,248837740
17292,123278750,47330361,170609111,3,0,1,1024,17,6342627794
17293,123298129,47311013,170609142,4,0,1,7680,15,8782941624
17294,123315600,35106964,158422564,9,0,0,22528,12,2741315690
17295,123315940,35287231,158603171,8,0,0,7680,8,4398894034
17296,123321770,35122867,158444637,9,0,0,41472,12,5344553134
17297,123322250,34845565,158167815,0,0,0,1536,3,1177228880
17298,123323250,47285915,170609165,3,0,1,8192,17,1956416223
17299,123332721,47276467,170609188,8,0,1,9728,8,1016290412
17300,123334070,34994331,158328401,0,0,0,4096,3,4481055069
17301,123344420,47345445,170689865,3,0,1,7680,17,8536985454
17302,123346880,47343008,170689888,6,0,1,2048,7,3836726481
17303,123379200,47310711,170689911,6,0,1,1536,7,10415700503
17304,123379580,34839679,158219259,0,0,0,16384,3,10192255561
17305,123386160,34970918,158357078,8,0,0,512,8,4541415444
17306,123395671,47294263,170689934,8,0,1,2560,8,9893459837
17307,123402030,47297934,170699964,3,0,1,2560,17,8295282792
17308,123403230,47296789,170700019,3,0,1,3584,17,3033891606
17309,123418271,47281771,170700042,8,0,1,512,8,7950431626
17310,123421680,35259986,158681666,8,0,0,39936,8,7047213266
17311,123426959,47310832,170737791,4,0,1,8192,15,6395928181
17312,123433170,35327370,158760540,9,0,0,91136,12,5552723652
17313,123437170,34749917,158187087,8,0,0,1536,8,1005239122
17314,123455230,34765768,158220998,9,0,0,5632,12,9347864712
17315,123462040,34964291,158426331,0,0,0,12288,3,8341477353
17316,123466000,35256696,158722696,6,0,0,55808,7,10358055721
17317,123469919,47271038,170740957,4,0,1,11264,15,10044723601
17318,123481230,47259750,170740980,6,0,1,5120,7,10604658190
17319,123482730,47258273,170741003,3,0,1,512,17,6189098510
17320,123483790,34851623,158335413,9,0,0,5632,12,1905741012
17321,123496501,47244525,170741026,8,0,1,9216,8,2735780361
17322,123497340,35235363,158732703,9,0,0,32768,12,3341205297
17323,123499701,47355273,170854974,5,0,1,48128,10,1716707054
17324,123504220,47354018,170858238,6,0,1,6656,7,4179704539
17325,123509221,47351283,170860504,8,0,1,3584,8,275916594
17326,123525220,47336590,170861810,6,0,1,2048,7,2589054900
17327,123541450,47336012,170877462,2,0,1,12800,3,9942147729
17328,123544129,47555280,171099409,4,0,1,11264,15,2558961428
17329,123557291,47542141,171099432,8,0,1,512,8,8588317970
17330,123557471,47541984,171099455,8,0,1,512,8,305681804
17331,123576020,47523458,171099478,6,0,1,5632,7,7537051131
17332,123581100,34820792,158401892,6,0,0,15872,7,919687931
17333,123582260,35204799,158787059,9,0,0,25088,12,10212537189
17334,123582791,47659953,171242744,5,0,1,30208,10,7348597288
17335,123586690,34966183,158552873,9,0,0,5120,12,10688346774
17336,123591961,47650806,171242767,8,0,1,1024,8,5529892923
17337,123592381,47650409,171242790,5,0,1,28672,10,4914715290
17338,123598290,35181102,158779392,8,0,0,14848,8,5710270428
17339,123601440,47790393,171391833,2,0,1,53248,3,6310208583
17340,123604609,47805191,171409800,4,0,1,6144,15,1958302375
17341,123614291,47806310,171420601,5,0,1,39424,10,5033418924
17342,123617499,47855237,171472736,4,0,1,2048,15,3648829020
17343,123622700,35046775,158669475,0,0,0,121344,3,3864796112
17344,123634230,48045092,171679322,2,0,1,56832,3,2594527753
17345,123635360,48087422,171722782,2,0,1,27648,3,6865624669
17346,123639010,34954477,158593487,8,0,0,1024,8,10059115822
17347,123642091,48085619,171727710,8,0,1,5632,8,7267539596
17348,123645410,35036747,158682157,6,0,0,1536,7,2907840431
17349,123650161,48269978,171920139,5,0,1,244224,10,4296913686
17350,123654280,35230983,158885263,6,0,0,12800,7,7590868968
17351,123654891,48279020,171933911,5,0,1,2048,10,5876566012
17352,123656270,35252943,158909213,6,0,0,39424,7,4385074001
17353,123662270,48394370,172056640,2,0,1,118272,3,4144048836
17354,123666540,35255644,158922184,9,0,0,42496,12,993048987
17355,123667131,48389532,172056663,8,0,1,6656,8,8815528736
17356,123683780,35010678,158694458,6,0,0,2048,7,3299058794
17357,123695900,48434642,172130542,2,0,1,59904,3,2157130585
17358,123703399,48427174,172130573,4,0,1,13312,15,1911553775
17359,123703570,48427026,172130596,2,0,1,4096,3,9214948446
17360,123703931,48434207,172138138,5,0,1,40960,10,4693677432
17361,123710431,48438133,172148564,5,0,1,15360,10,5516287327
17362,123712060,35322082,159034142,9,0,0,48128,12,6890899990
17363,123715741,48440593,172156334,8,0,1,15872,8,10306770169
17364,123721811,48450599,172172410,8,0,1,9728,8,9452878141
17365,123723380,35387110,159110490,9,0,0,50176,12,9266766456
17366,123728590,35669308,159397898,8,0,0,16384,8,4765121285
17367,123735761,48481796,172217557,5,0,1,18432,10,10208998340
17368,123738140,35677129,159415269,6,0,0,41984,7,3246195450
17369,123754051,48466424,172220475,5,0,1,20992,10,2132505196
17370,123773040,35551698,159324738,6,0,0,31744,7,5477089320
17371,123779220,48447568,172226788,2,0,1,4608,3,9977184714
17372,123779840,36181465,159961305,8,0,0,79872,8,7107247454
17373,123781290,35313889,159095179,8,0,0,105472,8,6326236142
17374,123782000,35456334,159238334,0,0,0,69632,3,8251110679
17375,123782210,35490118,159272328,6,0,0,24576,7,10504508285
17376,123787840,35186566,158974406,6,0,0,18432,7,2083600940
17377,123789000,35555043,159344043,9,0,0,4608,12,5120907783
17378,123794020,35450237,159244257,9,0,0,1536,12,2168293921
17379,123806330,35707768,159514098,9,0,0,57856,12,8501946025
17380,123807380,35507663,159315043,8,0,0,57856,8,3740870326
17381,123816550,36210702,160027252,9,0,0,46592,12,4317931273
17382,123819270,35747784,159567054,6,0,0,77824,7,3152063525
17383,123822160,48686710,172508870,2,0,1,318976,3,2167756749
17384,123830110,35701171,159531281,6,0,0,56320,7,5250905715
17385,123830730,36182234,160012964,6,0,0,169472,7,5662558011
17386,123833300,35977891,159811191,0,0,0,142848,3,3369359129
17387,123840910,35977792,159818702,6,0,0,24576,7,9499885108
17388,123845490,35767089,159612579,8,0,0,33792,8,6033949896
17389,123847341,48684520,172531861,5,0,1,17408,10,10509249100
17390,123855020,35633760,159488780,8,0,0,53248,8,8107895184
17391,123857351,48696749,172554100,8,0,1,22528,8,8109756152
17392,123865401,48690965,172556366,8,0,1,3584,8,6643497218
17393,123870130,48690422,172560552,0,0,1,6656,3,6265797154
17394,123873620,35468996,159342616,8,0,0,39936,8,8210939819
17395,123886191,48697893,172584084,5,0,1,36864,10,7672167058
17396,123887981,48763081,172651062,5,0,1,100352,10,1978545380
17397,123888440,35645672,159534112,9,0,0,9216,12,1696598996
17398,123903400,35593047,159496447,8,0,0,25088,8,2599185404
17399,123907540,35770757,159678297,9,0,0,176640,12,6132827452
17400,123907660,48744699,172652359,0,0,1,512,3,8804249886
17401,123920380,48733925,172654305,0,0,1,3072,3,3138651836
17402,123925661,48763765,172689426,5,0,1,36864,10,387625817
17403,123933861,48759751,172693612,8,0,1,6656,8,9151777344
17404,123936750,35392821,159329571,6,0,0,8192,7,5252325927
17405,123946650,36179422,160126072,6,0,0,7168,7,704886256
17406,123946880,36114713,160061593,8,0,0,9216,8,6538101192
17407,123954190,35757153,159711343,9,0,0,47104,12,2924875448
17408,123962560,35730915,159693475,6,0,0,2560,7,4482418723
17409,123964920,36072518,160037438,6,0,0,33280,7,7058896
17410,123992950,36164033,160156983,8,0,0,101376,8,5077687294
17411,124001381,48752650,172754031,5,0,1,142336,10,7865458404
17412,124010630,36254836,160265466,9,0,0,27648,12,509123101
17413,124014850,48756969,172771819,0,0,1,11776,3,5052699360
17414,124016131,48760335,172776466,5,0,1,16896,10,8916241103
17415,124033980,36161582,160195562,0,0,0,46592,3,9550358932
17416,124044600,35648072,159692672,8,0,0,47104,8,3913947199
17417,124051840,36307561,160359401,0,0,0,12288,3,3531917240
17418,124053991,35785482,159839473,7,0,0,68096,10,8866128742
17419,124057130,35486189,159543319,6,0,0,19456,7,9442995283
17420,124060821,36292779,160353600,7,0,0,13312,10,1802051125
17421,124064201,48721917,172786118,8,0,1,15360,8,8298972942
17422,124066600,36733354,160799954,9,0,0,56320,12,1615448792
17423,124083221,35975525,160058746,7,0,0,67584,10,1152941799
17424,124086450,36142299,160228749,9,0,0,63488,12,1435761859
17425,124086801,48714582,172801383,5,0,1,34816,10,8072520647
17426,124089930,35982875,160072805,9,0,0,12288,12,4835047825
17427,124090871,48740068,172830939,5,0,1,38400,10,9721160579
17428,124094981,36187456,160282437,7,0,0,47104,10,7138706654
17429,124109170,36014695,160123865,8,0,0,128512,8,8433795937
17430,124110730,35927401,160038131,6,0,0,2048,7,5779424037
17431,124112530,48725821,172838351,7,0,1,11776,10,9309273937
17432,124117620,48780723,172898343,2,0,1,81920,3,5341294681
17433,124124130,36735176,160859306,0,0,0,1024,3,8627359444
17434,124124500,48786822,172911322,0,0,1,9728,3,8728274898
17435,124125390,48790758,172916148,2,0,1,7680,3,1158563840
17436,124146030,36060943,160206973,8,0,0,37376,8,8712075071
17437,124153170,36250101,160403271,6,0,0,86528,7,1962597700
17438,124158861,36145774,160304635,7,0,0,51200,10,2819748237
17439,124165070,48751424,172916494,7,0,1,512,10,4442314577
17440,124168320,36169216,160337536,0,0,0,19968,3,7247796219
17441,124179260,36312226,160491486,9,0,0,61440,12,2787073831
17442,124191550,48749393,172940943,2,0,1,14848,3,4892245102
17443,124195160,36337447,160532607,0,0,0,36352,3,45183447
17444,124197080,36805620,161002700,9,0,0,23040,12,95898300
17445,124205861,36315647,160521508,7,0,0,98304,10,1287268236
17446,124207091,36337083,160544174,7,0,0,37888,10,4453223225
17447,124220280,36068732,160289012,8,0,0,21504,8,17800090
17448,124220860,36397131,160617991,6,0,0,54784,7,7462856011
17449,124222230,48786986,173009216,9,0,1,109056,12,9277173530
17450,124223030,48858007,173081037,2,0,1,66048,3,10224237492
17451,124229210,48885460,173114670,2,0,1,48128,3,1180068475
17452,124229870,35927604,160157474,6,0,0,1536,7,2720676906
17453,124231060,48946621,173177681,2,0,1,70656,3,3318952408
17454,124231480,48946867,173178347,7,0,1,1024,10,7805199358
17455,124232741,36838424,161071165,7,0,0,8192,10,4997946583
17456,124252420,36173735,160426155,0,0,0,41984,3,408307840
17457,124258640,48931136,173189776,7,0,1,9728,10,168191956
17458,124271870,36910271,161182141,0,0,0,61952,3,6674190770
17459,124272540,36180131,160452671,0,0,0,13312,3,1317784360
17460,124274560,36138741,160413301,6,0,0,32768,7,9681364261
17461,124276580,36619464,160896044,9,0,0,10752,12,1443585658
17462,124288731,36259210,160547941,7,0,0,12288,10,853416129
17463,124317430,48907541,173224971,2,0,1,90624,3,3233475018
17464,124324071,36040890,160364961,7,0,0,1024,10,6019810306
17465,124328990,48913106,173242096,7,0,1,1024,10,6317350756
17466,124329671,49073800,173403471,5,0,1,235008,10,8433869060
17467,124333181,49091763,173424944,5,0,1,38912,10,5445845701
17468,124358950,36319683,160678633,0,0,0,58368,3,1167785251
17469,124365680,49093396,173459076,2,0,1,38400,3,6136200055
17470,124379410,49080012,173459422,7,0,1,512,10,1314358890
17471,124387770,49093811,173481581,2,0,1,49664,3,1073737519
17472,124393370,36389401,160782771,8,0,0,104448,8,3205676664
17473,124396610,49088011,173484621,3,0,1,11264,17,10360979829
17474,124403480,49083087,173486567,7,0,1,3072,10,1515887204
17475,124409760,49082752,173492512,3,0,1,5120,17,5805418600
17476,124423160,49069813,173492973,7,0,1,10240,10,3170141053
17477,124423301,36237525,160660826,7,0,0,37376,10,3780867259
17478,124424170,49086473,173510643,2,0,1,20992,3,1880157254
17479,124442440,36694546,161136986,8,0,0,99328,8,7489308455
17480,124465261,49048288,173513549,8,0,1,4608,8,2391020603
17481,124465270,49099062,173564332,7,0,1,10240,10,9291888717
17482,124465930,49154390,173620320,2,0,1,161792,3,485325525
17483,124466490,36251423,160717913,8,0,0,10240,8,9069938994
17484,124475680,36765122,161240802,9,0,0,40448,12,2364219311
17485,124479090,36407392,160886482,8,0,0,59392,8,9080469981
17486,124479160,36589486,161068646,6,0,0,36352,7,8142650214
17487,124484120,49172665,173656785,2,0,1,65536,3,1195979723
17488,124488100,36507557,160995657,8,0,0,10752,8,3335454112
17489,124496020,49161431,173657451,7,0,1,1024,10,4225467688
17490,124497801,36212754,160710555,7,0,0,17920,10,5400155730
17491,124505660,36486698,160992358,0,0,0,87040,3,3705081486
17492,124509740,49152243,173661983,3,0,1,7168,17,9734182551
17493,124510870,36331512,160842382,9,0,0,43008,12,1458584412
17494,124513261,36391703,160904964,7,0,0,22528,10,1766831491
17495,124516620,36568616,161085236,0,0,0,46080,3,5190752278
17496,124535951,36896607,161432558,7,0,0,10240,10,946112043
17497,124536091,49263475,173799566,5,0,1,248832,10,737993960
17498,124537510,36809554,161347064,8,0,0,63488,8,9897433608
17499,124553511,49279274,173832785,5,0,1,60416,10,4571788644
17500,124555871,49302876,173858747,5,0,1,8192,10,8384062545
17501,124564250,36652074,161216324,8,0,0,10752,8,9144654985
17502,124569000,49289770,173858770,3,0,1,1024,17,2647695114
17503,124573210,36256045,160829255,6,0,0,7168,7,8008841980
17504,124576270,36631618,161207888,9,0,0,78848,12,4993420537
17505,124580320,49278473,173858793,7,0,1,6656,10,9826148605
17506,124583770,36579424,161163194,9,0,0,31744,12,8406029708
17507,124587770,36764465,161352235,6,0,0,16896,7,10586200010
17508,124594591,49270401,173864992,8,0,1,8192,8,6573265202
17509,124630931,36423268,161054199,7,0,0,2048,10,9259500988
17510,124636880,49230378,173867258,7,0,1,3584,10,8363895038
17511,124639460,49231024,173870484,3,0,1,5120,17,6304640384
17512,124643460,36510039,161153499,6,0,0,13824,7,10075944925
17513,124647220,49223610,173870830,3,0,1,512,17,2990694883
17514,124652460,36655430,161307890,0,0,0,73216,3,6794882588
17515,124653870,36919088,161572958,0,0,0,30208,3,8067217921
17516,124665570,36856052,161521622,8,0,0,512,8,8746078770
17517,124668041,36710425,161378466,7,0,0,86016,10,2103889161
17518,124669240,49204496,173873736,3,0,1,4608,17,8373146886
17519,124670300,36708977,161379277,9,0,0,2560,12,5184153787
17520,124673900,49202115,173876015,7,0,1,8704,10,3843874725
17521,124687300,49241301,173928601,2,0,1,89600,3,8077385168
17522,124713380,36435868,161149248,6,0,0,38400,7,10485298607
17523,124720750,36521346,161242096,0,0,0,4096,3,2709811717
17524,124724270,49207877,173932147,7,0,1,5632,10,8731451895
17525,124730540,49324285,174054825,2,0,1,206336,3,5849284827
17526,124735960,36351023,161086983,0,0,0,5632,3,5486795065
17527,124737640,49321371,174059011,3,0,1,6656,17,3351750055
17528,124740440,49323717,174064157,3,0,1,8192,17,464880300
17529,124743211,49478219,174221430,5,0,1,210944,10,6038044532
17530,124750451,36774805,161525256,7,0,0,10752,10,758335388
17531,124754911,49468107,174223018,5,0,1,15872,10,1130313408
17532,124761061,49486772,174247833,5,0,1,52736,10,7491304751
17533,124770000,36746272,161516272,0,0,0,46080,3,7621183558
17534,124777590,36489804,161267394,9,0,0,11776,12,9179677628
17535,124778111,49519326,174297437,5,0,1,70144,10,2484263139
17536,124778890,49523373,174302263,7,0,1,7680,10,10191959867
17537,124783740,36683757,161467497,8,0,0,1024,8,3133246063
17538,124793070,49510678,174303748,7,0,1,15360,10,9945033422
17539,124794521,49612491,174407012,5,0,1,180224,10,5826948247
17540,124795810,49637047,174432857,2,0,1,39424,3,6026846621
17541,124798360,36594733,161393093,8,0,0,512,8,3847516947
17542,124800940,49679755,174480695,2,0,1,34816,3,9910631675
17543,124816800,49663918,174480718,7,0,1,3584,10,6592066367
17544,124822850,49657891,174480741,3,0,1,1536,17,9107512344
17545,124837200,49648891,174486091,7,0,1,4608,10,5415784732
17546,124844000,36777486,161621486,0,0,0,28160,3,4454711065
17547,124846260,36790730,161636990,0,0,0,29696,3,4982712172
17548,124850881,49635233,174486114,5,0,1,512,10,9513587445
17549,124852340,36813753,161666093,9,0,0,1024,12,5210691626
17550,124852530,49633607,174486137,6,0,1,512,7,7244996872
17551,124858461,49627699,174486160,5,0,1,4096,10,7074610967
17552,124863260,49622923,174486183,7,0,1,13824,10,6819880583
17553,124867770,36634439,161502209,0,0,0,103424,3,9421820437
17554,124870390,36651567,161521957,8,0,0,1024,8,4233403284
17555,124871070,49615152,174486222,3,0,1,512,17,7105078464
17556,124889410,36632033,161521443,6,0,0,16896,7,944533702
17557,124894220,36796791,161691011,0,0,0,1024,3,5091601437
17558,124899060,36777710,161676770,9,0,0,29184,12,9184654173
17559,124908050,49578203,174486253,6,0,1,2560,7,1070048091
17560,124909370,49576906,174486276,6,0,1,1536,7,1808042867
17561,124920811,49634335,174555146,5,0,1,99328,10,6048845529
17562,124934370,49622320,174556690,3,0,1,1024,17,10272285949
17563,124934880,49637691,174572571,2,0,1,40960,3,7845439645
17564,124936510,49638007,174574517,3,0,1,3072,17,2557995684
17565,124950370,36834571,161784941,6,0,0,10752,7,6303732758
17566,124955070,36482672,161437742,0,0,0,2048,3,8820313889
17567,124962660,36565427,161528087,6,0,0,9216,7,6162796228
17568,124966390,36643562,161609952,6,0,0,66560,7,7212703527
17569,124971970,36763662,161735632,6,0,0,15360,7,8960687447
17570,124980070,36750859,161730929,6,0,0,26624,7,6822237372
17571,124988780,49586723,174575503,2,0,1,1536,3,7381205305
17572,124999270,49581059,174580329,7,0,1,7680,10,6304597528
17573,125002570,36843655,161846225,9,0,0,75776,12,9094927905
17574,125023641,49560542,174584183,5,0,1,19456,10,2762001976
17575,125027610,36917082,161944692,9,0,0,58880,12,4556183501
17576,125028630,36658810,161687440,8,0,0,1024,8,441633519
17577,125029111,49624882,174653993,5,0,1,82432,10,6427641536
17578,125040460,36869874,161910334,0,0,0,14848,3,9096543364
17579,125044560,49612019,174656579,6,0,1,4096,7,2144339907
17580,125046490,36918062,161964552,9,0,0,40960,12,7829818094
17581,125048480,49608765,174657245,6,0,1,1024,7,1125465930
17582,125056880,49600519,174657399,3,0,1,8704,17,6866902478
17583,125057420,49607711,174665131,7,0,1,12288,10,4154936370
17584,125080160,49585317,174665477,3,0,1,512,17,7323970139
17585,125099601,36655419,161755020,7,0,0,2560,10,6377464051
17586,125100890,49568453,174669343,6,0,1,6144,7,3537189739
17587,125110040,49561249,174671289,6,0,1,3072,7,2751768003
17588,125113320,49563666,174676986,6,0,1,18944,7,2253181814
17589,125117410,36799482,161916892,8,0,0,3584,8,5255589820
17590,125121850,36848498,161970348,8,0,0,512,8,7445186769
17591,125124360,36764380,161888740,9,0,0,35840,12,9177868437
17592,125129780,36859895,161989675,8,0,0,1024,8,5958697073
17593,125131730,37097945,162229675,6,0,0,35328,7,6040780127
17594,125135260,49548110,174683370,6,0,1,7680,7,9386289524
17595,125139890,36735667,161875557,8,0,0,1536,8,2192192385
17596,125149420,36892597,162042017,6,0,0,71680,7,7904087965
17597,125157230,36987263,162144493,9,0,0,20480,12,6956650731
17598,125159310,37138427,162297737,9,0,0,154624,12,5248355150
17599,125167380,37083222,162250602,9,0,0,68608,12,7057788766
17600,125181380,49502451,174683831,3,0,1,10240,17,1582277936
17601,125189630,49509362,174698992,3,0,1,8192,17,3707189556
17602,125194630,37136872,162331502,9,0,0,53248,12,7317973883
17603,125197400,37134281,162331681,8,0,0,512,8,8568343924
17604,125203120,37112135,162315255,8,0,0,1024,8,9130654713
17605,125220530,37239755,162460285,9,0,0,19456,12,3635004893
17606,125222240,37347037,162569277,6,0,0,5120,7,4232098677
17607,125224480,37289557,162514037,6,0,0,109056,7,57556904
17608,125236910,37307871,162544781,9,0,0,30208,12,2507478228
17609,125239960,37130121,162370081,9,0,0,4096,12,8273846038
17610,125249500,37119310,162368810,0,0,0,76288,3,8651966957
17611,125258220,37165331,162423551,0,0,0,14848,3,4472259729
17612,125261741,37378772,162640513,7,0,0,49152,10,960798926
17613,125270970,37245377,162516347,0,0,0,4608,3,4561157804
17614,125274300,37290228,162564528,0,0,0,64000,3,7797974853
17615,125274711,37471663,162746374,7,0,0,51712,10,8532919307
17616,125278351,49420664,174699015,5,0,1,4096,10,8615359494
17617,125283950,37446645,162730595,6,0,0,172544,7,977112447
17618,125290220,37691640,162981860,6,0,0,26112,7,9956245690
17619,125291310,37584799,162876109,6,0,0,30208,7,3507529196
17620,125333711,36981209,162314920,7,0,0,56320,10,6295165380
17621,125346820,37438179,162784999,0,0,0,63488,3,8747622891
17622,125372110,37005403,162377513,8,0,0,512,8,4690641561
17623,125389481,49311744,174701225,5,0,1,5632,10,624270567
17624,125396540,49305146,174701686,7,0,1,10240,10,8955943988
17625,125422751,37194058,162616809,7,0,0,26624,10,8618621326
17626,125425450,37334675,162760125,6,0,0,45056,7,627791843
17627,125433910,37133784,162567694,9,0,0,10240,12,160404207
17628,125460620,37147875,162608495,0,0,0,34816,3,3795472497
17629,125487700,37120974,162608674,8,0,0,512,8,5437288811
17630,125499920,37286350,162786270,6,0,0,4096,7,2681836836
17631,125502991,37345962,162848953,7,0,0,36864,10,9837089723
17632,125504680,37482039,162986719,9,0,0,15872,12,5616433421
17633,125524760,49181112,174705872,7,0,1,6656,10,5735089688
17634,125527970,37445553,162973523,0,0,0,111104,3,4831578148
17635,125544771,37345030,162889801,7,0,0,34816,10,1576654244
17636,125549650,37553473,163103123,6,0,0,24576,7,9709480109
17637,125550760,49158658,174709418,7,0,1,5632,10,10207741486
17638,125554300,49157704,174712004,7,0,1,4096,10,4035559108
17639,125560010,37227063,162787073,8,0,0,2560,8,10060660829
17640,125562810,49152740,174715550,6,0,1,5632,7,2248122300
17641,125568970,49147246,174716216,0,0,1,1024,3,9108903690
17642,125571110,49148332,174719442,7,0,1,5120,10,3838089849
17643,125577270,37459472,163036742,0,0,0,28160,3,3117097408
17644,125588830,37303490,162892320,6,0,0,8192,7,6133376782
17645,125597580,37493491,163091071,6,0,0,26112,7,4301832856
17646,125614900,49107128,174722028,7,0,1,4096,10,1747513833
17647,125615920,37655826,163271746,6,0,0,115200,7,888510637
17648,125621330,37139138,162760468,8,0,0,1024,8,2934914840
17649,125631040,49091334,174722374,0,0,1,512,3,3797273742
17650,125634310,49088410,174722720,0,0,1,512,3,8296731264
17651,125635440,37177097,162812537,8,0,0,512,8,8969355724
17652,125641121,37679717,163320838,7,0,0,57344,10,9789138155
17653,125643910,37584520,163228430,9,0,0,12800,12,4879986705
17654,125646970,37267442,162914412,0,0,0,8192,3,3200493765
17655,125648050,37352734,163000784,8,0,0,1024,8,322289414
17656,125670471,37434399,163104870,7,0,0,5632,10,2189614240
17657,125690890,37357731,163048621,0,0,0,38912,3,1859291529
17658,125703030,37270851,162973881,9,0,0,1024,12,810316980
17659,125711610,49025123,174736733,1,0,1,7168,10,9809136211
17660,125747330,49159099,174906429,9,0,1,188416,12,9764615355
17661,125759390,37450037,163209427,6,0,0,27648,7,4140606365
17662,125765680,37843887,163609567,8,0,0,512,8,1978645140
17663,125767730,37327882,163095612,9,0,0,14336,12,2527948409
17664,125792431,37485890,163278321,7,0,0,21504,10,4616833891
17665,125807500,49104273,174911773,0,0,1,1024,3,10455402874
17666,125811360,37403573,163214933,9,0,0,3584,12,7211261457
17667,125817520,49095239,174912759,7,0,1,1536,10,9786085760
17668,125825990,37477337,163303327,0,0,0,80896,3,3607750637
17669,125829810,37614778,163444588,6,0,0,19968,7,238107698
17670,125846080,37778276,163624356,8,0,0,1536,8,3148456941
17671,125852140,37343569,163195709,0,0,0,40448,3,8947244900
17672,125864540,37615973,163480513,9,0,0,67072,12,3162262388
17673,125888670,37325148,163213818,9,0,0,14336,12,3192352017
17674,125904390,49008523,174912913,0,0,1,8704,3,7873406234
17675,125905190,37959734,163864924,9,0,0,23552,12,6400174462
17676,125909320,49004259,174913579,7,0,1,1024,10,2244591897
17677,125914110,49028881,174942991,0,0,1,10240,3,7043499205
17678,125926940,37422863,163349803,6,0,0,42496,7,7525089357
17679,125930230,38006821,163937051,9,0,0,76288,12,5676940402
17680,125935530,37832707,163768237,0,0,0,17920,3,8063695480
17681,125944060,37549424,163493484,9,0,0,42496,12,9162059727
17682,125955721,49020764,174976485,5,0,1,31744,10,9477286318
17683,125957070,37321586,163278656,8,0,0,1024,8,3925914447
17684,125970220,37845645,163815865,9,0,0,77312,12,8119775360
17685,125982590,37338785,163321375,0,0,0,1536,3,5849718491
17686,125982950,37697189,163680139,9,0,0,31232,12,422158529
17687,125994820,49012344,175007164,7,0,1,16896,10,6038050902
17688,125995140,49012047,175007187,0,0,1,1024,3,8783347112
17689,126000390,49006820,175007210,7,0,1,10752,10,3380047263
17690,126006070,37426782,163432852,9,0,0,49152,12,9892078919
17691,126007061,37575703,163582764,7,0,0,6144,10,2231994656
17692,126020960,48986273,175007233,7,0,1,4096,10,1140807930
17693,126025290,48981966,175007256,0,0,1,2560,3,6221240914
17694,126026290,37354128,163380418,9,0,0,2048,12,3237604189
17695,126036720,37918785,163955505,6,0,0,19968,7,6793327083
17696,126039400,48970054,175009454,0,0,1,8192,3,1594609442
17697,126047290,37528119,163575409,9,0,0,76800,12,7484746323
17698,126047920,48961880,175009800,0,0,1,512,3,1245884516
17699,126055081,37600794,163655875,7,0,0,16384,10,5820042627
17700,126068160,48944226,175012386,0,0,1,4096,3,3013019078
17701,126096930,37362703,163459633,8,0,0,1536,8,6077375693
17702,126097440,37592550,163689990,9,0,0,32256,12,7773834061
17703,126112370,37837028,163949398,6,0,0,40448,7,8305448129
17704,126112870,48900822,175013692,1,0,1,2048,10,9882879439
17705,126158650,48859036,175017686,7,0,1,16896,10,9418686866
17706,126163920,48892576,175056496,1,0,1,5120,10,10129401940
17707,126177480,37316191,163493671,8,0,0,512,8,4713806683
17708,126177590,37719903,163897493,8,0,0,2048,8,4893313288
17709,126180330,37660462,163840792,6,0,0,16896,7,6977497507
17710,126189080,48867439,175056519,1,0,1,512,10,7655793491
17711,126189510,37968639,164158149,0,0,0,58368,3,9275724352
17712,126192780,37452164,163644944,8,0,0,512,8,1085825889
17713,126221900,37995072,164216972,0,0,0,88576,3,2185741127
17714,126225050,48831492,175056542,1,0,1,512,10,8519026738
17715,126225360,38220691,164446051,0,0,0,75264,3,2908742399
17716,126230411,38172291,164402702,7,0,0,78848,10,7686070713
17717,126230870,37626816,163857686,6,0,0,55296,7,8621947175
17718,126248890,48807675,175056565,7,0,1,3584,10,10427477514
17719,126250540,48806488,175057028,7,0,1,1024,10,8979104538
17720,126251020,37642849,163893869,6,0,0,15360,7,5415647759
17721,126254280,48806614,175060894,1,0,1,6144,10,8275725820
17722,126259510,48803970,175063480,1,0,1,4096,10,5685710733
17723,126264930,37698710,163963640,9,0,0,26624,12,2661796362
17724,126279580,38277000,164556580,9,0,0,73216,12,8133257897
17725,126301440,37534127,163835567,9,0,0,64000,12,10011062450
17726,126303300,48760526,175063826,7,0,1,512,10,8691851836
17727,126318539,48749793,175068332,4,0,1,7168,15,8859246604
17728,126331690,48737308,175068998,1,0,1,1024,10,7840961695
17729,126343049,48731249,175074298,4,0,1,16896,15,6982669036
17730,126346420,37469624,163816044,0,0,0,512,3,10561456916
17731,126350100,37721452,164071552,6,0,0,95232,7,8936672167
17732,126350150,48725134,175075284,7,0,1,1536,10,7094158159
17733,126351880,48725350,175077230,1,0,1,3072,10,10101541836
17734,126357160,48721056,175078216,1,0,1,1536,10,9388877481
17735,126358411,48722071,175080482,8,0,1,3584,8,5877427747
17736,126358770,37781572,164140342,6,0,0,82944,7,7477222052
17737,126412751,38274312,164687063,7,0,0,71168,10,1816820426
17738,126424689,48656779,175081468,4,0,1,1536,15,7990628997
17739,126425700,48675237,175100937,1,0,1,17408,10,6948308797
17740,126432191,48671012,175103203,8,0,1,3584,8,2128473887
17741,126434391,37740907,164175298,7,0,0,36352,10,6891477015
17742,126434540,38099709,164534249,8,0,0,1024,8,10536535950
17743,126437720,37847185,164284905,8,0,0,99840,8,8100828123
17744,126438620,37637034,164075654,6,0,0,4608,7,4068009879
17745,126446330,48661699,175108029,1,0,1,7680,10,8710860624
17746,126449360,48698050,175147410,3,0,1,6656,17,1220978262
17747,126451260,38082654,164533914,6,0,0,159232,7,10210077749
17748,126453430,37620797,164074227,8,0,0,8704,8,1296619678
17749,126474740,37779722,164254462,8,0,0,15872,8,3141587375
17750,126476489,48670944,175147433,4,0,1,2048,15,2961709116
17751,126482720,48664736,175147456,1,0,1,1536,10,8599437506
17752,126483121,37820714,164303835,7,0,0,14848,10,5000133053
17753,126484311,37931674,164415985,7,0,0,43520,10,8106030466
17754,126491899,48655580,175147479,4,0,1,9216,15,542433309
17755,126507420,48640082,175147502,1,0,1,21504,10,1413359984
17756,126509400,37941666,164451066,6,0,0,16384,7,6805801254
17757,126522141,37777147,164299288,7,0,0,47104,10,5346726704
17758,126528090,48619435,175147525,1,0,1,9728,10,2242942922
17759,126532891,37691794,164224685,7,0,0,14848,10,6819319980
17760,126533289,48614259,175147548,4,0,1,8704,15,2261883705
17761,126537800,37696905,164234705,0,0,0,15872,3,1702300152
17762,126546040,48602358,175148398,3,0,1,2048,17,4288340552
17763,126549329,48616934,175166263,4,0,1,2048,15,8277594066
17764,126552840,37695641,164248481,9,0,0,5632,12,9089860368
17765,126562790,38045784,164608574,9,0,0,144384,12,1667897635
17766,126579861,38118168,164698029,7,0,0,22528,10,10387672688
17767,126586221,48580401,175166622,8,0,1,9728,8,4465025535
17768,126589661,37974898,164564559,7,0,0,26112,10,7622343895
17769,126597141,38060540,164657681,7,0,0,7680,10,3793190587
17770,126597621,48579499,175177120,8,0,1,8192,8,6725823989
17771,126598171,48579935,175178106,8,0,1,1536,8,879468283
17772,126600411,48658044,175258455,5,0,1,59904,10,4252864594
17773,126601621,38053689,164655310,7,0,0,143360,10,3196558468
17774,126603300,38008261,164611561,0,0,0,9728,3,5718899033
17775,126603861,48672554,175276415,5,0,1,1024,10,5946669470
17776,126616740,38088869,164705609,0,0,0,24576,3,9061631510
17777,126648431,48629610,175278041,8,0,1,2560,8,6886114120
17778,126661990,38046458,164708448,9,0,0,9216,12,604865248
17779,126672420,37992936,164665356,6,0,0,25088,7,8807343150
17780,126681880,38009262,164691142,6,0,0,13312,7,3779637441
17781,126687490,38045639,164733129,6,0,0,20480,7,6885184179
17782,126691921,48588706,175280627,5,0,1,4096,10,10479742138
17783,126713860,38031955,164745815,8,0,0,13312,8,6882148986
17784,126728159,48555054,175283213,4,0,1,4096,15,3377425744
17785,126732239,48554279,175286518,4,0,1,2048,15,9043138948
17786,126744921,48602376,175347297,5,0,1,37888,10,7102663447
17787,126750790,38099108,164849898,8,0,0,14848,8,3172154488
17788,126753440,38640663,165394103,9,0,0,183808,12,9811029032
17789,126761090,38283226,165044316,6,0,0,10752,7,880376077
17790,126766450,37992650,164759100,0,0,0,17408,3,6201899083
17791,126767961,48594801,175362762,8,0,1,4096,8,6674001703
17792,126787130,38327474,165114604,6,0,0,97792,7,6236482330
17793,126789919,48599528,175389447,4,0,1,1024,15,4888278567
17794,126791760,38336127,165127887,0,0,0,43520,3,2802032922
17795,126811481,38491890,165303371,7,0,0,53248,10,10191327402
17796,126826541,38033922,164860463,7,0,0,6144,10,1404012004
17797,126827191,38151078,164978269,7,0,0,20480,10,874867088
17798,126830320,48559473,175389793,6,0,1,512,7,1704175355
17799,126839911,38333828,165173739,7,0,0,121344,10,6655937945
17800,126856210,38394291,165250501,9,0,0,35328,12,2226798761
17801,126862939,48527200,175390139,4,0,1,512,15,10635191621
17802,126896250,38577396,165473646,9,0,0,92160,12,859500681
17803,126897540,48493265,175390805,0,0,1,1024,3,85532110
17804,126920270,48476027,175396297,3,0,1,17920,17,6024321261
17805,126933970,38377426,165311396,6,0,0,26112,7,2724004134
17806,126942480,38054849,164997329,9,0,0,60416,12,5224672443
17807,126945989,48455919,175401908,4,0,1,1536,15,10203068310
17808,126953170,38046990,165000160,9,0,0,9216,12,6107427188
17809,126955831,38015042,164970873,7,0,0,6144,10,4730870001
17810,126956189,48460989,175417178,4,0,1,3072,15,3998578441
17811,126957241,48468796,175426037,8,0,1,7680,8,7463025560
17812,126962330,48464053,175426383,3,0,1,512,17,9165435646
17813,126964039,48466850,175430889,4,0,1,7168,15,7772070027
17814,126964350,48475600,175439950,0,0,1,5120,3,9174350689
17815,126972030,38287074,165259104,9,0,0,28160,12,2267512619
17816,126985699,48497200,175482899,4,0,1,2560,15,576925666
17817,126995360,38433935,165429295,6,0,0,82944,7,6031702198
17818,127004800,38512861,165517661,9,0,0,144384,12,9520991090
17819,127005271,48477651,175482922,8,0,1,9728,8,4446460076
17820,127018299,48464646,175482945,4,0,1,1024,15,7193176520
17821,127018820,38801830,165820650,8,0,0,177152,8,3481952486
17822,127029969,48452999,175482968,4,0,1,3584,15,1225242956
17823,127034740,38659999,165694739,9,0,0,8192,12,7439574933
17824,127036920,38519331,165556251,9,0,0,4096,12,7445852930
17825,127037110,38797314,165834424,8,0,0,42496,8,4817408362
17826,127041210,38362790,165404000,0,0,0,32256,3,5286383423
17827,127044671,38510309,165554980,7,0,0,96256,10,6873155444
17828,127051811,48445319,175497130,8,0,1,2560,8,1864912076
17829,127054990,38541997,165596987,0,0,0,34816,3,117650303
17830,127065090,48432706,175497796,3,0,1,11264,17,2712718667
17831,127071011,48437671,175508682,8,0,1,11264,8,8155575828
17832,127081530,48431978,175513508,7,0,1,7680,10,10211390605
17833,127084820,38545612,165630432,0,0,0,40448,3,9246302887
17834,127084979,48472170,175557149,4,0,1,1024,15,4515757953
17835,127087351,38646866,165734217,7,0,0,14848,10,669430237
17836,127100070,48457102,175557172,3,0,1,3584,17,2190213420
17837,127112190,38589915,165702105,9,0,0,6144,12,2491073821
17838,127114629,48442745,175557374,4,0,1,2560,15,9359419896
17839,127119701,48437696,175557397,8,0,1,3072,8,10519145014
17840,127120270,48465900,175586170,3,0,1,8192,17,7343880613
17841,127123030,48463358,175586388,3,0,1,2048,17,8986918454
17842,127123959,48462452,175586411,4,0,1,512,15,7687397356
17843,127129220,48457214,175586434,3,0,1,9728,17,7594616768
17844,127133819,48452638,175586457,4,0,1,1536,15,744410292
17845,127148691,48521849,175670540,8,0,1,22016,8,6280882874
17846,127151091,38808027,165959118,7,0,0,119808,10,6650941910
17847,127160520,38660933,165821453,0,0,0,2560,3,4920134802
17848,127165739,48507509,175673248,4,0,1,6144,15,6255310740
17849,127173740,38815820,165989560,8,0,0,81920,8,3758599540
17850,127179831,48499950,175679781,8,0,1,512,8,9678240
17851,127188620,38705808,165894428,9,0,0,25600,12,9380007767
17852,127197682,38675648,165873330,7,0,0,4608,10,2393142964
17853,127206020,38824755,166030775,9,0,0,8192,12,8533255378
17854,127231580,38729034,165960614,0,0,0,4608,3,2809150989
17855,127234120,48452905,175687025,6,0,1,14848,7,2221476851
17856,127255119,48443332,175698451,4,0,1,512,15,10710463711
17857,127257470,48441004,175698474,3,0,1,7168,17,2406121630
17858,127260350,38890271,166150621,9,0,0,512,12,7048393477
17859,127265880,38804339,166070219,9,0,0,28672,12,2415910153
17860,127279410,39139507,166418917,9,0,0,140288,12,244797436
17861,127287529,38773931,166061460,1,0,0,15360,10,4616729192
17862,127291480,38702159,165993639,9,0,0,13312,12,7223641359
17863,127312189,38851830,166164019,1,0,0,11264,10,3512651951
17864,127315950,38793954,166109904,8,0,0,32256,8,8769179665
17865,127319010,38799533,166118543,8,0,0,15360,8,4714502231
17866,127326611,38999871,166326482,7,0,0,17920,10,7163207459
17867,127336770,48361735,175698505,3,0,1,512,17,7612347530
17868,127338300,39153268,166491568,8,0,0,25600,8,8000761844
17869,127352390,38941381,166293771,9,0,0,1024,12,2876796293
17870,127353230,38909789,166263019,9,0,0,17920,12,9841619954
17871,127361420,38825607,166187027,8,0,0,11776,8,9741107851
17872,127392000,48309615,175701615,3,0,1,7168,17,10611473193
17873,127400020,38779819,166179839,0,0,0,18432,3,5972852897
17874,127405889,48303146,175709035,4,0,1,2560,15,3481602226
17875,127426329,39057393,166483722,1,0,0,45568,10,10050131777
17876,127433120,38677431,166110551,9,0,0,2048,12,8943128907
17877,127437280,39254380,166691660,8,0,0,62976,8,9850262248
17878,127442159,48297951,175740110,4,0,1,7168,15,5390800913
17879,127447780,39101601,166549381,8,0,0,6656,8,5860203764
17880,127458871,38979147,166438018,7,0,0,62464,10,4224823500
17881,127461570,39050859,166512429,0,0,0,17920,3,4302288331
17882,127472571,38892976,166365547,7,0,0,22016,10,698129055
17883,127475090,39140759,166615849,9,0,0,63488,12,1943023578
17884,127517440,38633002,166150442,0,0,0,3072,3,8815811957
17885,127532920,39251170,166784090,9,0,0,113152,12,114381434
17886,127545920,39093958,166639878,9,0,0,38400,12,1646550627
17887,127550629,48189504,175740133,4,0,1,8192,15,1108862006
17888,127553240,48240668,175793908,0,0,1,13312,3,3045621419
17889,127575690,39224796,166800486,9,0,0,19456,12,6762392575
17890,127597530,48260809,175858339,3,0,1,2048,17,6568540282
17891,127597960,38843357,166441317,9,0,0,10752,12,3852412437
17892,127604460,38983815,166588275,8,0,0,3584,8,4826894814
17893,127613370,38904885,166518255,8,0,0,11264,8,5041168405
17894,127621190,38841527,166462717,8,0,0,10752,8,2060837469
17895,127622450,48235912,175858362,3,0,1,13824,17,5068714534
17896,127637090,48316065,175953155,9,0,1,57856,12,153674935
17897,127638810,39384157,167022967,0,0,0,41984,3,369757935
17898,127638830,48314348,175953178,6,0,1,5120,7,5573762132
17899,127642051,39020936,166662987,7,0,0,5120,10,8511285805
17900,127646230,48306971,175953201,3,0,1,2560,17,3766792870
17901,127650589,48302635,175953224,4,0,1,2048,15,5394364376
17902,127669301,48283946,175953247,8,0,1,1536,8,5627329279
17903,127676290,48276980,175953270,6,0,1,5632,7,7264827307
17904,127680860,39113675,166794535,8,0,0,15360,8,3923034200
17905,127683821,38944265,166628086,7,0,0,39936,10,4471948142
17906,127691570,39057215,166748785,0,0,0,33792,3,3218546471
17907,127695740,39167447,166863187,0,0,0,19968,3,3229864793
17908,127700420,39200721,166901141,9,0,0,99328,12,7954790129
17909,127710801,39019504,166730305,7,0,0,23552,10,3492599382
17910,127721010,48232283,175953293,6,0,1,1024,7,3551449274
17911,127721309,48250453,175971762,4,0,1,25600,15,4197889177
17912,127721500,48250621,175972121,6,0,1,9728,7,5628600577
17913,127725000,48266713,175991713,6,0,1,2048,7,10400295813
17914,127725060,48268279,175993339,6,0,1,2560,7,10176939281
17915,127740059,48253946,175994005,4,0,1,1024,15,9526925272
17916,127741550,39233677,166975227,0,0,0,49664,3,1323746311
17917,127749860,48244491,175994351,3,0,1,512,17,8763661178
17918,127753311,48266799,176020110,8,0,1,10240,8,6015671030
17919,127766399,48274797,176041196,4,0,1,1024,15,1644056113
17920,127779299,48261920,176041219,4,0,1,1024,15,6088327014
17921,127790390,48250852,176041242,3,0,1,2048,17,381005511
17922,127810560,39349504,167160064,8,0,0,84992,8,5230730779
17923,127813050,48238533,176051583,3,0,1,15872,17,2440166155
17924,127813760,39057094,166870854,8,0,0,25088,8,5786798106
17925,127827540,48225223,176052763,3,0,1,512,17,5574157021
17926,127827680,48227989,176055669,6,0,1,4608,7,3071669173
17927,127838621,39010030,166848651,7,0,0,44032,10,7727228317
17928,127841041,39332306,167173347,7,0,0,43520,10,612232246
17929,127847910,39162242,167010152,0,0,0,13824,3,3659032389
17930,127857090,38956827,166813917,8,0,0,2048,8,2215513853
17931,127857761,48199214,176056975,8,0,1,2048,8,8493321779
17932,127859650,48311022,176170672,3,0,1,82944,17,4894951017
17933,127874351,48434744,176309095,5,0,1,114176,10,8347630517
17934,127875959,48433159,176309118,4,0,1,5120,15,3931661539
17935,127884791,48424350,176309141,8,0,1,1024,8,2146128512
17936,127890010,39016783,166906793,0,0,0,5632,3,4142349024
17937,127908640,48400524,176309164,6,0,1,512,7,7762544870
17938,127924960,38979948,166904908,8,0,0,12288,8,9930491054
17939,127932400,39304387,167236787,9,0,0,71680,12,9960628381
17940,127934480,39119392,167053872,9,0,0,512,12,7247185267
17941,127935149,48374038,176309187,4,0,1,512,15,6478352366
17942,127945320,39164173,167109493,0,0,0,1024,3,6876062574
17943,127946751,48362459,176309210,5,0,1,4096,10,8135514645
17944,127957820,39376895,167334715,8,0,0,24576,8,4775694089
17945,127973799,48335434,176309233,4,0,1,1024,15,7074243152
17946,127978010,39407925,167385935,9,0,0,58368,12,1498511481
17947,127979251,48363956,176343207,5,0,1,28672,10,406325840
17948,127986890,38989452,166976342,8,0,0,3584,8,1986800961
17949,127991720,39061973,167053693,4,0,0,6656,15,4279720815
17950,127995100,39404811,167399911,9,0,0,45568,12,4947729794
17951,128003900,39499633,167503533,0,0,0,15872,3,3302484864
17952,128006239,48336991,176343230,4,0,1,4096,15,8651765235
17953,128015990,48463598,176479588,3,0,1,129024,17,8775439882
17954,128025650,39301375,167327025,0,0,0,129024,3,3416406677
17955,128025891,48453720,176479611,5,0,1,512,10,10627155014
17956,128027120,39341000,167368120,4,0,0,15360,15,5560463619
17957,128036370,48572576,176608946,3,0,1,123392,17,7669267888
17958,128037330,39175934,167213264,8,0,0,32256,8,9394061706
17959,128039000,48622600,176661600,3,0,1,55808,17,2516305676
17960,128045509,48616114,176661623,4,0,1,2048,15,6213088353
17961,128046130,39480869,167526999,9,0,0,1024,12,10383734670
17962,128054000,39613684,167667684,8,0,0,53760,8,8295383830
17963,128061771,48606727,176668498,5,0,1,12800,10,830047791
17964,128062871,39415151,167478022,7,0,0,20992,10,286638476
17965,128065479,48604325,176669804,4,0,1,2048,15,1921490949
17966,128070050,48604580,176674630,3,0,1,7680,17,283949280
17967,128071071,48622315,176693386,8,0,1,5632,8,989867924
17968,128071271,39292146,167363417,7,0,0,63488,10,9172613544
17969,128076291,48620001,176696292,8,0,1,4608,8,7738210358
17970,128095141,48602777,176697918,8,0,1,2560,8,3364716003
17971,128105721,48595743,176701464,8,0,1,5632,8,8282692270
17972,128105950,39365653,167471603,0,0,0,69120,3,2634135545
17973,128108961,48594129,176703090,8,0,1,2560,8,8335071176
17974,128110650,48592799,176703449,0,0,1,9728,3,8393081591
17975,128113940,39213264,167327204,0,0,0,512,3,3188140894
17976,128115860,39525562,167641422,9,0,0,96768,12,10560350266
17977,128116350,48615273,176731623,0,0,1,512,3,205021988
17978,128117310,48616259,176733569,0,0,1,3072,3,3188990988
17979,128122321,39364624,167486945,7,0,0,29184,10,1212559781
17980,128123301,48683381,176806682,5,0,1,131072,10,8813286827
17981,128152249,48657019,176809268,4,0,1,4096,15,10202834083
17982,128159570,39405580,167565150,0,0,0,12800,3,5480476595
17983,128159790,39418019,167577809,8,0,0,41472,8,6660460796
17984,128172109,48637505,176809614,4,0,1,512,15,580457552
17985,128187789,48622171,176809960,4,0,1,512,15,294712532
17986,128197350,48613276,176810626,0,0,1,1024,3,4359730577
17987,128202830,39522538,167725368,8,0,0,27648,8,290167016
17988,128214920,39559690,167774610,8,0,0,6656,8,7754547105
17989,128216571,48597281,176813852,5,0,1,5120,10,3406759003
17990,128217270,39434003,167651273,0,0,0,32256,3,2490472718
17991,128220951,48596241,176817192,8,0,1,8704,8,3318802293
17992,128222671,48605669,176828340,5,0,1,40960,10,6082941380
17993,128236639,48592047,176828686,4,0,1,512,15,1974822424
17994,128239069,48589873,176828942,4,0,1,9216,15,5313961812
17995,128244241,48616768,176861009,8,0,1,6656,8,6744494508
17996,128245830,39471091,167716921,9,0,0,64512,12,5151226711
17997,128247301,48613731,176861032,8,0,1,4096,8,2290547965
17998,128251631,48609424,176861055,8,0,1,1536,8,1637261064
17999,128263921,48597157,176861078,8,0,1,3072,8,6329884153
18000,128268370,48791384,177059754,2,0,1,113152,3,10606674530
18001,128275590,39523688,167799278,9,0,0,47616,12,5018526949
18002,128280161,39563908,167844069,7,0,0,3584,10,7560540714
18003,128284650,48779290,177063940,0,0,1,6656,3,229292489
18004,128286691,48940777,177227468,5,0,1,142336,10,5130161719
18005,128289610,48937881,177227491,0,0,1,2048,3,93882050
18006,128298461,39576067,167874528,7,0,0,7680,10,8128755118
18007,128310500,39625757,167936257,0,0,0,2560,3,397623830
18008,128333420,48896687,177230107,0,0,1,2560,3,8270654646
18009,128337441,39521856,167859297,7,0,0,16896,10,9227092046
18010,128343700,39538182,167881882,4,0,0,14336,15,1299839199
18011,128353940,39555284,167909224,9,0,0,23552,12,3508565885
18012,128370680,39810582,168181262,0,0,0,35328,3,353442332
18013,128370820,48883488,177254308,2,0,1,23040,3,6787252699
18014,128380549,48874105,177254654,4,0,1,512,15,9159544893
18015,128387509,48868425,177255934,4,0,1,14336,15,4542740413
18016,128391310,40073585,168464895,0,0,0,11776,3,5735561765
18017,128395089,48865362,177260451,4,0,1,13824,15,10129378751
18018,128406150,48855927,177262077,0,0,1,2560,3,8914469825
18019,128408200,39620405,168028605,9,0,0,24064,12,9020593536
18020,128410501,48867749,177278250,5,0,1,9216,10,635754945
18021,128417031,48862397,177279428,8,0,1,13824,8,9808275543
18022,128432480,39512710,167945190,0,0,0,1536,3,5355836599
18023,128445080,39876569,168321649,4,0,0,29696,15,9363460417
18024,128466729,48813365,177280094,4,0,1,1024,15,1229919537
18025,128466829,48814571,177281400,4,0,1,2048,15,4366012366
18026,128471110,40179441,168650551,8,0,0,82432,8,5740963639
18027,128498831,48797082,177295913,5,0,1,20992,10,6393544822
18028,128499301,48796635,177295936,5,0,1,1536,10,8495262951
18029,128506009,48792864,177298873,4,0,1,6144,15,7584596027
18030,128507961,48796058,177304019,5,0,1,8192,10,4273924170
18031,128521971,48816613,177338584,5,0,1,53760,10,6110574271
18032,128531779,48811219,177342998,4,0,1,2048,15,2722777436
18033,128532500,41414679,169947179,8,0,0,101888,8,4836584998
18034,128536501,48870092,177406593,5,0,1,66560,10,9616513450
18035,128537931,39981712,168519643,7,0,0,6144,10,6948002702
18036,128540820,39644567,168185387,9,0,0,13312,12,6582496384
18037,128541590,40151735,168693325,4,0,0,25088,15,6321048357
18038,128555159,48866216,177421375,4,0,1,13824,15,5744182473
18039,128591580,39973200,168564780,0,0,0,19968,3,127881580
18040,128594330,48835983,177430313,0,0,1,7168,3,3838808422
18041,128594480,48846697,177441177,0,0,1,5120,3,1197839868
18042,128610790,48830733,177441523,0,0,1,512,3,8035852499
18043,128627950,48818399,177446349,0,0,1,7680,3,7837590276
18044,128629370,39764076,168393446,6,0,0,11264,7,7004668419
18045,128629380,39929293,168558673,0,0,0,18944,3,8582663997
18046,128633571,39752188,168385759,7,0,0,2048,10,9605662289
18047,128639370,48807645,177447015,0,0,1,1024,3,8646415289
18048,128646739,48801589,177448328,4,0,1,2048,15,8369040184
18049,128649471,41248642,169898113,7,0,0,230400,10,5104221730
18050,128654490,39630134,168284624,4,0,0,3072,15,7634840847
18051,128665731,40365953,169031684,7,0,0,4096,10,5815101120
18052,128680550,39680376,168360926,0,0,0,20480,3,6146576658
18053,128682649,48769218,177451867,4,0,1,5632,15,623169023
18054,128684400,39833348,168517748,4,0,0,45056,15,985921027
18055,128686551,39808128,168494679,7,0,0,60416,10,1760942751
18056,128689189,48765264,177454453,4,0,1,4096,15,4518381532
18057,128697550,39636063,168333613,0,0,0,9216,3,5242381751
18058,128717090,40112509,168829599,9,0,0,81920,12,9980871992
18059,128739491,48721760,177461251,5,0,1,19968,10,5623202651
18060,128746120,40023700,168769820,8,0,0,16384,8,5657385604
18061,128751380,39992330,168743710,0,0,0,43520,3,5891344505
18062,128785560,40116805,168902365,8,0,0,31232,8,1531540880
18063,128802790,40083305,168886095,8,0,0,32768,8,2416537307
18064,128811490,39429886,168241376,4,0,0,2560,15,9034970090
18065,128836761,40085241,168922002,7,0,0,6144,10,9992706986
18066,128837570,40262823,169100393,0,0,0,14848,3,8435415722
18067,128839550,40400188,169239738,9,0,0,36352,12,686374909
18068,128840700,40540874,169381574,0,0,0,11264,3,3928298527
18069,128851630,41218823,170070453,4,0,0,41472,15,10441134452
18070,128873510,39970377,168843887,9,0,0,46592,12,9975664878
18071,128875500,40480246,169355746,0,0,0,512,3,2395712138
18072,128876881,40139163,169016044,7,0,0,93696,10,3541124975
18073,128887570,39714372,168601942,0,0,0,1536,3,8961417078
18074,128906090,39858715,168764805,8,0,0,18944,8,5162575857
18075,128924901,40159381,169084282,7,0,0,29184,10,9691678446
18076,128946790,39479501,168426291,0,0,0,1024,3,2251478065
18077,128959330,40466123,169425453,4,0,0,34816,15,904817050
18078,128960420,39690310,168650730,0,0,0,512,3,2041560131
18079,128964790,48498087,177462877,7,0,1,2560,10,3210970019
18080,128969890,48496853,177466743,7,0,1,6144,10,4395222498
18081,128986010,40259835,169245845,4,0,0,19968,15,10679998428
18082,128987641,39861510,168849151,7,0,0,9216,10,3279164293
18083,128994640,39908224,168902864,9,0,0,1536,12,3221595580
18084,128996940,40830950,169827890,9,0,0,32256,12,7887507809
18085,129003750,48464939,177468689,7,0,1,3072,10,1693517462
18086,129007240,39839080,168846320,8,0,0,7680,8,8153943319
18087,129009521,40293054,169302575,7,0,0,147968,10,10391359133
18088,129011850,40423633,169435483,9,0,0,32768,12,4703579446
18089,129012601,40682767,169695368,7,0,0,9216,10,6755530266
18090,129012741,40005198,169017939,7,0,0,6144,10,3403803416
18091,129020110,39388289,168408399,8,0,0,4096,8,6270480364
18092,129022940,39961604,168984544,0,0,0,512,3,7596871822
18093,129033830,48440146,177473976,7,0,1,17920,10,7488143689
18094,129039630,48449277,177488907,7,0,1,2560,10,7111483475
18095,129050070,48520250,177570320,3,0,1,26624,17,7022990852
18096,129053150,39850993,168904143,4,0,0,4096,15,7394178207
18097,129069261,40252446,169321707,7,0,0,62464,10,1712808136
18098,129069980,41040424,170110404,9,0,0,113152,12,7834891646
18099,129086690,48541097,177627787,3,0,1,132608,17,10249576786
18100,129089831,39802995,168892826,7,0,0,22016,10,5161860157
18101,129096800,48544001,177640801,7,0,1,3072,10,44142599
18102,129099840,39749490,168849330,0,0,0,512,3,1036494983
18103,129116130,40372405,169488535,4,0,0,7680,15,4470581371
18104,129119580,40385982,169505562,4,0,0,55808,15,2458678920
18105,129127199,48518108,177645307,4,0,1,7168,15,2074343235
18106,129127351,40287471,169414822,7,0,0,29696,10,2237795754
18107,129130080,39888217,169018297,0,0,0,512,3,9340878861
18108,129131580,48519664,177651244,7,0,1,11264,10,10584731112
18109,129133410,48562754,177696164,3,0,1,42496,17,6084066999
18110,129133690,48625096,177758786,3,0,1,55808,17,5498224839
18111,129135151,40328279,169463430,7,0,0,91648,10,6788336999
18112,129143990,39776117,168920107,8,0,0,32256,8,42931018
18113,129148110,41000801,170148911,9,0,0,74240,12,1581351910
18114,129162730,48612725,177775455,3,0,1,38912,17,4460377981
18115,129179750,39695670,168875420,9,0,0,7680,12,3799815119
18116,129180760,48704544,177885304,3,0,1,56832,17,8058938775
18117,129192480,48815090,178007570,9,0,1,50176,12,10618765728
18118,129199340,48857004,178056344,3,0,1,38400,17,10422603415
18119,129199590,48929657,178129247,9,0,1,34816,12,6853686393
18120,129202470,49112980,178315450,9,0,1,52736,12,9560510361
18121,129221180,39870925,169092105,4,0,0,25600,15,8465803111
18122,129231900,40093769,169325669,8,0,0,10752,8,9053430773
18123,129244470,39773648,169018118,0,0,0,512,3,4502759873
18124,129251210,40220111,169471321,4,0,0,9728,15,1501808791
18125,129251580,40216397,169467977,4,0,0,14848,15,5890318530
18126,129265980,40426495,169692475,4,0,0,52736,15,9177629079
18127,129267140,49048333,178315473,7,0,1,7168,10,7923067533
18128,129267570,39665055,168932625,0,0,0,512,3,6570157955
18129,129279600,40113435,169393035,9,0,0,1024,12,5076205588
18130,129290510,40282975,169573485,4,0,0,118272,15,8693162402
18131,129297910,49084291,178382201,9,0,1,158208,12,5154843156
18132,129299670,40022684,169322354,0,0,0,2048,3,9925345744
18133,129300040,39729405,169029445,4,0,0,10240,15,2997325407
18134,129312900,49102878,178415778,9,0,1,59904,12,2484759495
18135,129325630,49093444,178419074,3,0,1,16896,17,348581260
18136,129335650,49101739,178437389,3,0,1,4096,17,4718086174
18137,129351341,40916904,170268245,7,0,0,166912,10,3850141556
18138,129367740,49072235,178439975,7,0,1,4096,10,8304716763
18139,129373280,40349744,169723024,8,0,0,66048,8,1537391872
18140,129382390,49058251,178440641,7,0,1,1024,10,3996708093
18141,129383930,40930862,170314792,9,0,0,81408,12,10038385943
18142,129399151,40087021,169486172,7,0,0,48640,10,9700554710
18143,129402760,49038227,178440987,7,0,1,512,10,8449915080
18144,129409380,40880577,170289957,4,0,0,37888,15,2895723574
18145,129453930,48987313,178441243,0,0,1,9216,3,375955547
18146,129461740,49039129,178500869,3,0,1,41472,17,10222642062
18147,129470350,39899771,169370121,8,0,0,2560,8,8457814798
18148,129475280,40905686,170380966,0,0,0,512,3,7332497258
18149,129479810,49064768,178544578,9,0,1,52224,12,1551362257
18150,129483760,49062292,178546052,7,0,1,4608,10,4309181479
18151,129494520,40323519,169818039,9,0,0,32768,12,391214429
18152,129494610,49065898,178560508,9,0,1,47104,12,2954963683
18153,129497190,49075893,178573083,9,0,1,10752,12,7976108758
18154,129497820,40022648,169520468,9,0,0,20480,12,2056305231
18155,129507960,39830991,169338951,8,0,0,12288,8,2529869324
18156,129509900,40066751,169576651,9,0,0,8704,12,2855153833
18157,129510220,49072277,178582497,7,0,1,1536,10,7828497721
18158,129511220,49107743,178618963,3,0,1,58880,17,5318334619
18159,129514470,40604248,170118718,8,0,0,5632,8,10210398992
18160,129517961,40158423,169676384,7,0,0,40960,10,9483453739
18161,129518160,40966338,170484498,8,0,0,90624,8,1682120403
18162,129519500,49101409,178620909,7,0,1,3072,10,1537810674
18163,129528340,40057850,169586190,4,0,0,31232,15,10061639808
18164,129531670,40042306,169573976,0,0,0,1536,3,8992156478
18165,129542539,49084657,178627196,4,0,1,3584,15,4216694174
18166,129565980,49063616,178629596,7,0,1,1024,10,4833245638
18167,129567730,41066753,170634483,8,0,0,82944,8,441454540
18168,129574150,49062320,178636470,3,0,1,32768,17,3849026747
18169,129574230,49097974,178672204,7,0,1,9728,10,4971033117
18170,129576920,40457150,170034070,8,0,0,29184,8,9786713704
18171,129582070,49132570,178714640,9,0,1,23040,12,9624983554
18172,129588690,49128562,178717252,3,0,1,4096,17,1608844153
18173,129615930,49117850,178733780,9,0,1,61952,12,8601801239
18174,129617310,49121616,178738926,7,0,1,8192,10,604640160
18175,129619980,40349053,169969033,4,0,0,24576,15,2829737717
18176,129621650,49120758,178742408,3,0,1,14336,17,3656537237
18177,129621930,49144516,178766446,7,0,1,2560,10,7500978390
18178,129630811,40709062,170339873,7,0,0,26624,10,764392939
18179,129636420,39831845,169468265,0,0,0,512,3,7731837605
18180,129643590,40742547,170386137,9,0,0,16896,12,9989165066
18181,129646610,40268965,169915575,8,0,0,13312,8,6175800568
18182,129647921,40258248,169906169,7,0,0,17920,10,6836838718
18183,129651050,49117035,178768085,9,0,1,24064,12,4544545708
18184,129654440,49130216,178784656,7,0,1,5632,10,3595391855
18185,129655010,49129669,178784679,1,0,1,1024,10,9852447299
18186,129660620,49124082,178784702,6,0,1,6656,7,9931913334
18187,129686370,49098355,178784725,7,0,1,1024,10,375929524
18188,129694580,49158436,178853016,9,0,1,113664,12,6714036034
18189,129700830,49157575,178858405,3,0,1,17408,17,3781896890
18190,129703680,40574462,170278142,4,0,0,20992,15,10021655836
18191,129711070,49170271,178881341,3,0,1,12800,17,6506010447
18192,129711760,49172167,178883927,1,0,1,4096,10,8363632486
18193,129712550,49177074,178889624,3,0,1,18944,17,3108651758
18194,129722330,49178307,178900637,9,0,1,23040,12,3899590176
18195,129724090,40547633,170271723,8,0,0,11264,8,5103262878
18196,129730810,49169981,178900791,3,0,1,8704,17,8501758518
18197,129741230,40170266,169911496,9,0,0,17408,12,1403814069
18198,129741800,40703345,170445145,8,0,0,2560,8,9614094871
18199,129750050,40663129,170413179,9,0,0,8192,12,2283050729
18200,129750951,40783821,170534772,7,0,0,42496,10,551253466
18201,129756471,40144161,169900632,7,0,0,8192,10,4594110165
18202,129766410,40406868,170173278,9,0,0,79872,12,108156516
18203,129778670,40170724,169949394,4,0,0,7168,15,7912924985
18204,129800740,40937028,170737768,4,0,0,77824,15,754387019
18205,129803180,49103000,178906180,1,0,1,17408,10,3526436184
18206,129806060,40175953,169982013,4,0,0,33792,15,2291253411
18207,129815430,49115228,178930658,1,0,1,5632,10,618648364
18208,129817710,49119260,178936970,9,0,1,37888,12,1916237706
18209,129819470,49192687,179012157,3,0,1,92672,17,8319465433
18210,129821040,40250418,170071458,0,0,0,3072,3,9232315569
18211,129825480,40300788,170126268,4,0,0,2048,15,7540645717
18212,129869160,40046952,169916112,8,0,0,1536,8,430580630
18213,129870180,40651621,170521801,8,0,0,55296,8,6227034395
18214,129872070,40244909,170116979,8,0,0,21504,8,10204116792
18215,129876290,40140151,170016441,4,0,0,20480,15,5084255321
18216,129882940,40683795,170566735,0,0,0,512,3,10688898802
18217,129888770,41145978,171034748,8,0,0,13824,8,7771392879
18218,129897550,49129466,179027016,1,0,1,4096,10,9431631272
18219,129933840,49107937,179041777,3,0,1,25600,17,1691004787
18220,129935800,49139938,179075738,3,0,1,73728,17,5129000732
18221,129950860,49143694,179094554,1,0,1,2560,10,4326732170
18222,129972081,41279959,171252040,7,0,0,9216,10,3734672756
18223,129992480,40339035,170331515,8,0,0,54784,8,4763327278
18224,129993810,40223548,170217358,8,0,0,66048,8,5616997089
18225,129998550,49151477,179150027,3,0,1,92672,17,4734286765
18226,129999951,40424335,170424286,7,0,0,36352,10,639694106
18227,130018391,40156470,170174861,7,0,0,5120,10,9382017434
18228,130018771,40016882,170035653,7,0,0,5120,10,8822907861
18229,130032670,49127781,179160451,1,0,1,5632,10,4383805522
18230,130036310,40572755,170609065,8,0,0,99840,8,5535893195
18231,130037950,49122655,179160605,1,0,1,8704,10,794155675
18232,130051990,40514550,170566540,9,0,0,77824,12,4204056974
18233,130073630,40418246,170491876,9,0,0,5120,12,7469205787
18234,130075650,49085941,179161591,1,0,1,1536,10,4172157867
18235,130103010,49108437,179211447,2,0,1,78336,3,6867415154
18236,130106831,40090380,170197211,7,0,0,6656,10,2530728350
18237,130121220,49091484,179212704,1,0,1,2048,10,1285453598
18238,130140510,40270150,170410660,9,0,0,80384,12,3927059324
18239,130142430,40213383,170355813,8,0,0,5632,8,2687812219
18240,130144360,49073490,179217850,1,0,1,8192,10,4779748359
18241,130153261,40385145,170538406,7,0,0,11776,10,4991826229
18242,130156970,40513218,170670188,0,0,0,1024,3,8708906318
18243,130160120,49057986,179218106,1,0,1,9216,10,2254019378
18244,130161370,49061242,179222612,1,0,1,7168,10,3661561458
18245,130161590,40187868,170349458,8,0,0,13824,8,10045175435
18246,130161790,40218997,170380787,4,0,0,59904,15,3902672080
18247,130165460,39960145,170125605,9,0,0,22528,12,5696789863
18248,130187100,40452398,170639498,4,0,0,16384,15,2397118219
18249,130205921,49017997,179223918,8,0,1,2048,8,7154635412
18250,130208030,49020420,179228450,1,0,1,7168,10,9791635280
18251,130210930,40134293,170345223,9,0,0,17408,12,2564134069
18252,130211270,40491470,170702740,4,0,0,8192,15,98761241
18253,130245940,40609011,170854951,9,0,0,10752,12,10661793532
18254,130253600,39921658,170175258,0,0,0,1024,3,1426749123
18255,130254751,40641543,170896294,7,0,0,7680,10,1250545699
18256,130256860,40443081,170699941,8,0,0,32768,8,6768531985
18257,130268300,48970122,179238422,1,0,1,15872,10,2233169359
18258,130275151,40895800,171170951,7,0,0,75776,10,701470067
18259,130284681,48958247,179242928,8,0,1,7168,8,2942554868
18260,130295051,48949503,179244554,8,0,1,2560,8,2842609857
18261,130296470,40403751,170700221,8,0,0,512,8,1442964826
18262,130302191,48943989,179246180,8,0,1,2560,8,5774098942
18263,130304000,48951865,179255865,1,0,1,9728,10,8626312876
18264,130321480,41088297,171409777,4,0,0,33280,15,2140294897
18265,130329981,48927190,179257171,8,0,1,2048,8,2606788412
18266,130330450,48929985,179260435,1,0,1,16384,10,998526555
18267,130335921,41103119,171439040,7,0,0,17920,10,1521457264
18268,130345260,40633072,170978332,0,0,0,3584,3,31987503
18269,130350531,48935535,179286066,8,0,1,5120,8,7296463933
18270,130357191,40914060,171271251,7,0,0,62976,10,218430889
18271,130362221,48925471,179287692,8,0,1,2560,8,9277939438
18272,130383560,39894761,170278321,0,0,0,512,3,4835456248
18273,130386711,40103582,170490293,7,0,0,18944,10,5749857654
18274,130392590,48897688,179290278,0,0,1,4096,3,3914914048
18275,130393231,48898673,179291904,8,0,1,2560,8,4204043780
18276,130405920,48892353,179298273,0,0,1,1024,3,10027434350
18277,130407470,40444182,170851652,4,0,0,172544,15,9446129254
18278,130413291,48885328,179298619,8,0,1,512,8,5957119735
18279,130422980,48876625,179299605,1,0,1,1536,10,4805252711
18280,130425410,48876167,179301577,0,0,1,3072,3,5059861785
18281,130426930,40068589,170495519,4,0,0,2560,15,9891614529
18282,130438530,40140084,170578614,4,0,0,38912,15,9088322209
18283,130459240,48845243,179304483,0,0,1,4608,3,1740949437
18284,130465300,48840169,179305469,0,0,1,1536,3,9175803778
18285,130474180,40269833,170744013,9,0,0,9728,12,10407347132
18286,130491361,40198481,170689842,7,0,0,21504,10,1458372545
18287,130493080,40756129,171249209,9,0,0,20992,12,6893049041
18288,130493180,48829531,179322711,0,0,1,16896,3,8219468043
18289,130497340,40602046,171099386,9,0,0,47616,12,10344961946
18290,130503230,48840318,179343548,1,0,1,11776,10,504889004
18291,130503640,40720806,171224446,4,0,0,104448,15,5911699855
18292,130524691,40560156,171084847,7,0,0,164352,10,1539332890
18293,130526330,40329135,170855465,0,0,0,1536,3,8548483417
18294,130545639,48799497,179345136,4,0,1,15872,15,8822310521
18295,130553770,48796706,179350476,1,0,1,2048,10,6016471288
18296,130561751,40179183,170740934,7,0,0,10240,10,5139839782
18297,130564800,48787622,179352422,0,0,1,3072,3,5568078239
18298,130596820,39904461,170501281,9,0,0,3072,12,1243339797
18299,130599850,48761779,179361629,0,0,1,12288,3,3124791881
18300,130608470,48756065,179364535,1,0,1,4608,10,6942483399
18301,130612390,48753451,179365841,1,0,1,2048,10,6966888565
18302,130614551,40172325,170786876,7,0,0,8704,10,9144278337
18303,130633640,40009501,170643141,9,0,0,11776,12,9772573985
18304,130644431,40353909,170998340,7,0,0,7680,10,7646764048
18305,130655280,48711547,179366827,0,0,1,1536,3,7837668302
18306,130657450,40055822,170713272,9,0,0,17408,12,10332152055
18307,130658250,48709563,179367813,0,0,1,1536,3,1686123180
18308,130672580,40886635,171559215,9,0,0,11776,12,4392237668
18309,130681300,40032463,170713763,4,0,0,1536,15,1713281501
18310,130716050,39826755,170542805,9,0,0,14336,12,8154107043
18311,130727440,40150942,170878382,4,0,0,2048,15,5726503842
18312,130744570,48627109,179371679,0,0,1,6144,3,7592492239
18313,130758470,40196882,170955352,0,0,0,3072,3,913150872
18314,130777750,48594595,179372345,0,0,1,1024,3,983387004
18315,130783840,48588851,179372691,0,0,1,512,3,10725547554
18316,130809361,48564956,179374317,8,0,1,2560,8,2091253079
18317,130815060,48560537,179375597,6,0,1,14336,7,3276141402
18318,130821500,48559681,179381181,0,0,1,4608,3,129411239
18319,130828751,48555978,179384729,8,0,1,5632,8,8681026165
18320,130855331,48530064,179385395,8,0,1,1024,8,9724556413
18321,130863611,40379110,171242721,9,0,0,59904,12,8164038326
18322,130881230,40600830,171482060,0,0,0,1024,3,9754155530
18323,130886899,48500762,179387661,4,0,1,3584,15,8228367478
18324,130887270,40289476,171176746,4,0,0,18944,15,7725158088
18325,130911089,48484944,179396033,4,0,1,13312,15,4220246350
18326,130916100,48480279,179396379,0,0,1,512,3,7937809012
18327,130918570,48479435,179398005,0,0,1,2560,3,1594795492
18328,130921790,48487082,179408872,0,0,1,5120,3,10715508944
18329,130929450,40207973,171137423,0,0,0,1024,3,6793164807
18330,130951470,48457425,179408895,0,0,1,4096,3,9335977280
18331,130953570,48455348,179408918,0,0,1,2048,3,1124851139
18332,130962350,40398478,171360828,4,0,0,30208,15,8629526185
18333,130972431,40058082,171030513,7,0,0,48640,10,1180105049
18334,130989760,48419549,179409309,6,0,1,6656,7,8298764233
18335,130991490,40719390,171710880,4,0,0,102912,15,10545848644
18336,130992520,40835798,171828318,9,0,0,146432,12,883088225
18337,131007131,48406416,179413547,8,0,1,6656,8,3568745930
18338,131015651,48398242,179413893,8,0,1,512,8,3921566573
18339,131018599,48396280,179414879,4,0,1,1536,15,6684955295
18340,131019001,48396224,179415225,8,0,1,512,8,3541879260
18341,131019750,48396461,179416211,6,0,1,1536,7,6397349950
18342,131040780,48380923,179421703,0,0,1,26112,3,1789431752
18343,131046390,48383062,179429452,6,0,1,3072,7,8262760244
18344,131046690,48382785,179429475,6,0,1,4096,7,4629683509
18345,131047191,48388302,179435493,8,0,1,6144,8,10518918165
18346,131049200,48397894,179447094,6,0,1,7680,7,2166702928
18347,131054000,48404734,179458734,8,0,1,6656,8,9832724351
18348,131060510,40667177,171727687,4,0,0,4608,15,4600770742
18349,131060780,39940391,171001171,0,0,0,3072,3,6910776937
18350,131069781,40652978,171722759,9,0,0,38912,12,2944607617
18351,131070221,40986396,172056617,9,0,0,82944,12,6025585473
18352,131084391,40660066,171744457,7,0,0,54784,10,1802555932
18353,131090820,48373776,179464596,8,0,1,6656,8,6100013735
18354,131098920,48367942,179466862,8,0,1,3584,8,1726371774
18355,131111870,40430612,171542482,4,0,0,62976,15,5415522350
18356,131120140,40255178,171375318,0,0,0,1024,3,9024707784
18357,131128110,40550386,171678496,4,0,0,228864,15,9548658953
18358,131134410,39999125,171133535,0,0,0,512,3,6232354892
18359,131136151,40383103,171519254,7,0,0,116224,10,7246303254
18360,131138561,40756835,171895396,9,0,0,36864,12,6873515867
18361,131142350,39997797,171140147,0,0,0,2048,3,9527423564
18362,131144810,48345421,179490231,7,0,1,11264,10,8775378609
18363,131153069,48339748,179492817,4,0,1,4096,15,4819162347
18364,131157840,48335963,179493803,0,0,1,1536,3,7463540155
18365,131161360,48334709,179496069,0,0,1,3584,3,10163017840
18366,131161500,48339741,179501241,6,0,1,8192,7,8545318199
18367,131162240,48339347,179501587,0,0,1,512,3,473170331
18368,131164199,48339014,179503213,4,0,1,2560,15,997775055
18369,131176221,40690192,171866413,7,0,0,124928,10,2853911080
18370,131180130,48327589,179507719,0,0,1,7168,3,1537664199
18371,131203341,48360438,179563779,8,0,1,1024,8,3203740502
18372,131223050,40359456,171582506,4,0,0,29184,15,7929292521
18373,131226610,48337835,179564445,8,0,1,1024,8,3404583401
18374,131228850,39887798,171116648,0,0,0,512,3,9762776857
18375,131231240,40352069,171583309,0,0,0,2560,3,3507614187
18376,131237260,48356347,179593607,6,0,1,1024,7,9084667610
18377,131248001,40431500,171679501,7,0,0,512,10,10556066752
18378,131253269,48341644,179594913,4,0,1,2048,15,4426557765
18379,131262410,40345834,171608244,4,0,0,2048,15,4632896575
18380,131266800,40871307,172138107,4,0,0,24576,15,8072439857
18381,131268459,48326800,179595259,4,0,1,512,15,1188384446
18382,131273910,40509769,171783679,4,0,0,36864,15,7405726112
18383,131290070,40097244,171387314,0,0,0,512,3,602285428
18384,131314739,48282466,179597205,4,0,1,3072,15,10308871105
18385,131314779,48283732,179598511,4,0,1,2048,15,6806358129
18386,131325550,48274907,179600457,0,0,1,3072,3,517508413
18387,131328101,40437961,171766062,7,0,0,14336,10,9941608669
18388,131333671,48269052,179602723,8,0,1,3584,8,1506503237
18389,131337210,40627423,171964633,4,0,0,51200,15,9871244722
18390,131343751,40539891,171883642,9,0,0,45056,12,4183978873
18391,131348441,40413222,171761663,7,0,0,51200,10,2744096317
18392,131358981,40364604,171723585,9,0,0,2560,12,7480380372
18393,131366771,48236938,179603709,8,0,1,1536,8,4374666631
18394,131389650,40129939,171519589,0,0,0,1024,3,1197203295
18395,131398240,40347800,171746040,4,0,0,5120,15,4361968409
18396,131403470,40198162,171601632,0,0,0,512,3,5247643471
18397,131406471,40567735,171974206,7,0,0,1024,10,4681787586
18398,131409840,40460051,171869891,4,0,0,3584,15,2091341787
18399,131414791,48194227,179609018,8,0,1,4096,8,8880415162
18400,131430531,48181033,179611564,8,0,1,4096,8,4566982737
18401,131436100,48175810,179611910,0,0,1,512,3,4611892361
18402,131457120,40222179,171679299,0,0,0,2560,3,10201787411
18403,131457649,48154927,179612576,4,0,1,1024,15,3947302311
18404,131460569,48152673,179613242,4,0,1,1024,15,1441713505
18405,131472349,48142839,179615188,4,0,1,3072,15,9453618423
18406,131480849,48134685,179615534,4,0,1,512,15,4114892360
18407,131482881,40243379,171726260,9,0,0,8704,12,4252306282
18408,131488669,48127531,179616200,4,0,1,1024,15,4538003505
18409,131491090,48212779,179703869,3,0,1,13824,17,4145096487
18410,131511290,48192937,179704227,0,0,1,6144,3,7855822145
18411,131512161,40356615,171868776,7,0,0,7680,10,14110575
18412,131517540,48186710,179704250,0,0,1,1536,3,994307696
18413,131517550,48186723,179704273,6,0,1,512,7,4301226255
18414,131518741,40611778,172130519,7,0,0,136704,10,9078983961
18415,131528270,48176026,179704296,6,0,1,1024,7,3283364087
18416,131534540,40231865,171766405,0,0,0,1024,3,5537182660
18417,131537630,48166689,179704319,0,0,1,2560,3,7454954036
18418,131541990,48261181,179803171,9,0,1,16384,12,6003394942
18419,131545450,48257744,179803194,6,0,1,2048,7,10265114665
18420,131548580,48254637,179803217,6,0,1,4096,7,3586656237
18421,131559810,48243430,179803240,0,0,1,512,3,9406332599
18422,131574459,48228804,179803263,4,0,1,1024,15,3517215525
18423,131577480,48225806,179803286,0,0,1,2560,3,3335333439
18424,131577950,48225359,179803309,0,0,1,6656,3,5412621500
18425,131592190,48211142,179803332,0,0,1,1536,3,3043714332
18426,131600421,40488423,172088844,9,0,0,25088,12,6750662778
18427,131600831,48233219,179834050,8,0,1,6656,8,3009373230
18428,131621930,48213503,179835433,0,0,1,14848,3,6756108370
18429,131633811,40294562,171928373,9,0,0,18432,12,4447792775
18430,131637991,48238332,179876323,8,0,1,512,8,2619451676
18431,131643030,48267080,179910110,0,0,1,8192,3,2260927795
18432,131643520,48318316,179961836,6,0,1,32256,7,98909527
18433,131650981,48452023,180103004,8,0,1,23040,8,632886605
18434,131659331,48477388,180136719,8,0,1,8192,8,5481915234
18435,131679820,40204321,171884141,0,0,0,1536,3,7215178022
18436,131682760,48693418,180376178,0,0,1,6144,3,3635174451
18437,131684480,40294596,171979076,0,0,0,512,3,2158844443
18438,131685140,48723772,180408912,6,0,1,3072,7,5840312002
18439,131693121,40503627,172196748,9,0,0,59392,12,6897004369
18440,131705570,40354350,172059920,4,0,0,8192,15,2856240966
18441,131708800,40501878,172210678,4,0,0,23552,15,8228186060
18442,131712691,48708770,180421461,8,0,1,6656,8,6042619251
18443,131720200,48701284,180421484,0,0,1,3584,3,4587950702
18444,131730320,40473159,172203479,4,0,0,22016,15,8614342381
18445,131740120,49355405,181095525,3,0,1,115200,17,796507131
18446,131752820,49423889,181176709,8,0,1,1536,8,10222448902
18447,131762370,49414362,181176732,6,0,1,4096,7,10644605587
18448,131768450,40443975,172212425,4,0,0,5632,15,4418191658
18449,131773900,49402855,181176755,0,0,1,4608,3,9787239792
18450,131796230,40430535,172226765,4,0,0,18432,15,4123989933
18451,131797730,49379048,181176778,0,0,1,7168,3,4817066722
18452,131798190,49378611,181176801,0,0,1,4608,3,8461174922
18453,131799610,49377214,181176824,6,0,1,10240,7,10213923166
18454,131805080,49398957,181204037,3,0,1,17408,17,4246008630
18455,131814150,49494519,181308669,8,0,1,14336,8,2850924563
18456,131815480,40630176,172445656,4,0,0,25088,15,2426273985
18457,131818240,49492375,181310615,6,0,1,3072,7,506514334
18458,131825241,40491543,172316784,9,0,0,44032,12,8200393839
18459,131841200,40680585,172521785,4,0,0,12800,15,3092499768
18460,131842410,49468769,181311179,6,0,1,10752,7,9084947298
18461,131854430,49553635,181408065,8,0,1,7680,8,5145456840
18462,131855710,49582532,181438242,6,0,1,3072,7,5217707872
18463,131861580,49576685,181438265,6,0,1,1024,7,455738241
18464,131871590,49566698,181438288,8,0,1,16384,8,1031414910
18465,131883541,40709778,172593319,7,0,0,30208,10,5996840358
18466,131884661,40699400,172584061,7,0,0,44544,10,8132246589
18467,131888670,49555110,181443780,0,0,1,2048,3,8177827144
18468,131889030,49638249,181527279,8,0,1,5632,8,252600720
18469,131891801,40389446,172281247,9,0,0,1536,12,2350959246
18470,131894380,49658373,181552753,6,0,1,7680,7,6829026226
18471,131912790,49639986,181552776,0,0,1,3072,3,9866797600
18472,131919100,40622606,172541706,0,0,0,1024,3,7853158485
18473,131927360,49628765,181556125,0,0,1,8192,3,4975624244
18474,131934870,49621921,181556791,6,0,1,1024,7,7640652776
18475,131946451,40994469,172940920,7,0,0,76288,10,2790855449
18476,131968190,49591507,181559697,6,0,1,4608,7,8789285338
18477,131977340,40846561,172823901,4,0,0,2048,15,8983247351
18478,131977860,40997791,172975651,4,0,0,6656,15,9077627530
18479,131982730,49625221,181607951,8,0,1,4096,8,10359042182
18480,131992210,49616407,181608617,3,0,1,1024,17,9448111791
18481,131992380,49618183,181610563,6,0,1,3072,7,573758362
18482,132018220,49596529,181614749,6,0,1,6656,7,3220732293
18483,132025951,40924531,172950482,9,0,0,31232,12,6146267382
18484,132026000,49598935,181624935,0,0,1,1536,3,9373277678
18485,132028290,49649823,181678113,6,0,1,1024,7,10117216464
18486,132048780,49802253,181851033,6,0,1,2560,7,10095828734
18487,132055140,49881719,181936859,3,0,1,16896,17,1134322680
18488,132063350,41010359,173073709,4,0,0,26112,15,3546841649
18489,132077940,49928284,182006224,0,0,1,2560,3,3673708476
18490,132079611,40909319,172988930,9,0,0,31232,12,2192156841
18491,132084560,49921687,182006247,3,0,1,6144,17,8561649
18492,132097961,40966035,173063996,9,0,0,19456,12,7734317877
18493,132100420,49910008,182010428,3,0,1,7168,17,10715011276
18494,132127900,49882874,182010774,0,0,1,512,3,4864828775
18495,132130590,49997520,182128110,8,0,1,12800,8,1359201563
18496,132134921,41088733,173223654,9,0,0,108544,12,56155075
18497,132135541,50044300,182179841,5,0,1,13824,10,4953845409
18498,132142620,40894667,173037287,4,0,0,2048,15,2454186658
18499,132144810,50035595,182180405,0,0,1,10752,3,4272953957
18500,132148590,50254736,182403326,3,0,1,4608,17,93476515
18501,132154720,40896303,173051023,4,0,0,6144,15,7752721663
18502,132162220,50241129,182403349,3,0,1,1024,17,7754839144
18503,132163110,50251008,182414118,6,0,1,5632,7,10386593617
18504,132163560,50250581,182414141,6,0,1,4096,7,6590799117
18505,132172650,50353190,182525840,6,0,1,10240,7,3029612534
18506,132179650,50373356,182553006,3,0,1,7680,17,1386526266
18507,132180610,50372419,182553029,8,0,1,1024,8,5102597174
18508,132182051,41238763,173420814,7,0,0,12800,10,6219771004
18509,132187711,41119422,173307133,9,0,0,16896,12,10044032045
18510,132191771,41063278,173255049,9,0,0,29184,12,10025422043
18511,132193271,41139682,173332953,9,0,0,21504,12,1356063569
18512,132196920,50356132,182553052,3,0,1,4608,17,3231009550
18513,132205170,50350402,182555572,6,0,1,8192,7,8895426035
18514,132211850,50398508,182610358,0,0,1,1024,3,1511847901
18515,132212000,50398381,182610381,0,0,1,4096,3,4860322097
18516,132212341,41351968,173564309,9,0,0,60928,12,10720485011
18517,132240670,50369952,182610622,8,0,1,10240,8,8763813473
18518,132243580,50415574,182659154,8,0,1,11776,8,10551151127
18519,132260660,50417751,182678411,3,0,1,512,17,3933484638
18520,132272699,50405735,182678434,4,0,1,2048,15,10554691214
18521,132274740,50403717,182678457,8,0,1,6144,8,6335719606
18522,132277710,50498838,182776548,3,0,1,512,17,8129356035
18523,132286920,50490806,182777726,9,0,1,13824,12,4859801119
18524,132288950,41305414,173594364,0,0,0,512,3,4991049119
18525,132292979,50610819,182903798,4,0,1,1024,15,7868562947
18526,132302690,50601131,182903821,0,0,1,512,3,1209662767
18527,132304150,50633577,182937727,8,0,1,12288,8,9612648364
18528,132306331,41419440,173725771,9,0,0,5632,12,4116385807
18529,132324760,50761327,183086087,8,0,1,8192,8,2611712509
18530,132329349,50768267,183097616,4,0,1,16384,15,4470164916
18531,132340640,50899772,183240412,9,0,1,37888,12,2896999684
18532,132343450,51030909,183374359,8,0,1,7168,8,4070319198
18533,132346840,51043032,183389872,1,0,1,8704,10,2963623209
18534,132351560,51038335,183389895,1,0,1,512,10,4706986709
18535,132361060,51044637,183405697,9,0,1,7680,12,10698504860
18536,132364811,41493913,173858724,7,0,0,84992,10,5757986182
18537,132373469,51043404,183416873,4,0,1,1024,15,1436401352
18538,132385680,51031216,183416896,8,0,1,512,8,1880565121
18539,132392210,51047352,183439562,8,0,1,6144,8,939489063
18540,132406620,51032965,183439585,8,0,1,11264,8,4366901048
18541,132406670,41643404,174050074,0,0,0,512,3,5947620864
18542,132428841,42051831,174480672,9,0,0,102400,12,5827205781
18543,132432110,41599836,174031946,9,0,0,36352,12,2244207838
18544,132448390,51024258,183472648,3,0,1,8704,17,1533263401
18545,132448490,41758317,174206807,9,0,0,40960,12,4379426728
18546,132453019,51019652,183472671,4,0,1,8704,15,7474469722
18547,132455011,41625960,174080971,7,0,0,15872,10,6825687390
18548,132527429,50945265,183472694,4,0,1,3584,15,1664405384
18549,132532550,50940167,183472717,3,0,1,1536,17,7504658060
18550,132538080,50934660,183472740,9,0,1,5120,12,1832916499
18551,132540481,41511129,174051610,7,0,0,512,10,6761530376
18552,132546979,50925784,183472763,4,0,1,7680,15,418834531
18553,132568211,41669857,174238068,7,0,0,2048,10,4752395707
18554,132570669,50902117,183472786,4,0,1,14848,15,3595227952
18555,132584570,41761873,174346443,4,0,0,21504,15,8931029804
18556,132591350,50890070,183481420,1,0,1,14336,10,1736926722
18557,132596231,41676176,174272407,7,0,0,1536,10,1432454046
18558,132596670,41790335,174387005,0,0,0,3584,3,5271932013
18559,132602530,41886897,174489427,0,0,0,512,3,1323726070
18560,132608009,50875185,183483194,4,0,1,6144,15,8102443770
18561,132615890,41750019,174365909,4,0,0,10752,15,9914061811
18562,132632600,41774389,174406989,4,0,0,52736,15,7055491634
18563,132643230,50870768,183513998,8,0,1,512,8,9439569016
18564,132662230,41691977,174354207,4,0,0,6656,15,3028860186
18565,132687170,50826851,183514021,3,0,1,1024,17,4658966589
18566,132700030,50814014,183514044,3,0,1,4096,17,10147450577
18567,132702600,41783468,174486068,4,0,0,17408,15,5030636392
18568,132719900,50803947,183523847,8,0,1,15360,8,2356012896
18569,132730310,51545143,184275453,9,0,1,180736,12,8396071047
18570,132765630,51661312,184426942,9,0,1,5120,12,4070089581
18571,132766719,51682463,184449182,4,0,1,13312,15,1614728808
18572,132769501,41899635,174669136,9,0,0,9216,12,4605086818
18573,132774329,51741379,184515708,4,0,1,18432,15,1831949110
18574,132774941,51782668,184557609,5,0,1,4096,10,275078054
18575,132783741,41797645,174581386,7,0,0,512,10,8791831266
18576,132784040,41914929,174698969,9,0,0,20480,12,6911879976
18577,132787880,51769752,184557632,8,0,1,2048,8,2029721627
18578,132791279,51766376,184557655,4,0,1,5120,15,7315127703
18579,132796590,51761088,184557678,0,0,1,2048,3,9532929116
18580,132801760,51755941,184557701,8,0,1,3584,8,1271540318
18581,132813990,41922541,174736531,4,0,0,43520,15,1515348664
18582,132815880,51788899,184604779,3,0,1,11264,17,2440308844
18583,132816960,51791365,184608325,1,0,1,5632,10,5403475130
18584,132817870,51797235,184615105,3,0,1,1024,17,460616011
18585,132818580,51884695,184703275,3,0,1,2048,17,3732410877
18586,132828011,42231201,175059212,7,0,0,1024,10,718239391
18587,132830220,41910124,174740344,9,0,0,11776,12,6971331345
18588,132871391,51921255,184792646,5,0,1,47104,10,9305962062
18589,132871410,51921259,184792669,3,0,1,5632,17,10524290202
18590,132876590,51974391,184850981,2,0,1,37376,3,1340743559
18591,132878460,51972544,184851004,8,0,1,512,8,4297931613
18592,132881990,41950545,174832535,0,0,0,1536,3,7277321834
18593,132883201,51967826,184851027,5,0,1,5120,10,5415208501
18594,132887690,51963360,184851050,3,0,1,3584,17,4711567297
18595,132889880,42085935,174975815,9,0,0,102400,12,6667093857
18596,132894740,41914539,174809279,0,0,0,1024,3,22671545
18597,132905300,41831410,174736710,0,0,0,512,3,7665205890
18598,132915430,51935830,184851260,0,0,1,5120,3,9072193435
18599,132917610,52070600,184988210,9,0,1,75264,12,6947102041
18600,132923510,52064723,184988233,8,0,1,8704,8,9488181735
18601,132933180,42506739,175439919,9,0,0,22016,12,5093674381
18602,132933810,52054446,184988256,8,0,1,9728,8,3512532227
18603,132936811,52051468,184988279,5,0,1,34816,10,5379535384
18604,132941010,42066131,175007141,4,0,0,27648,15,7233647516
18605,132941940,52079992,185021932,0,0,1,5632,3,1334982550
18606,132945260,52076695,185021955,0,0,1,512,3,2376700311
18607,132949380,42107093,175056473,4,0,0,27136,15,8023596827
18608,132949671,42026791,174976462,7,0,0,2048,10,782453797
18609,132958430,42080781,175039211,0,0,0,16896,3,5949723369
18610,132958990,52062988,185021978,8,0,1,11776,8,1701494002
18611,132961330,42202414,175163744,4,0,0,4096,15,5291311288
18612,132965170,52056975,185022145,3,0,1,3072,17,2761387193
18613,132973450,42171886,175145336,0,0,0,122368,3,1844055844
18614,132999990,52022821,185022811,0,0,1,1024,3,6663661893
18615,133001590,52025087,185026677,1,0,1,6144,10,8647453158
18616,133023680,52063456,185087136,9,0,1,16384,12,2187359004
18617,133030520,52101684,185132204,9,0,1,29184,12,4046584207
18618,133037281,52182445,185219726,5,0,1,59392,10,4777639962
18619,133043361,41853572,174896933,7,0,0,512,10,3485211387
18620,133047110,52172639,185219749,8,0,1,1024,8,2084085645
18621,133049040,52170732,185219772,0,0,1,9216,3,4984401974
18622,133049940,52169855,185219795,8,0,1,11776,8,6759309661
18623,133051740,42193300,175245040,4,0,0,18944,15,2431542479
18624,133056220,42091167,175147387,0,0,0,6656,3,10425368646
18625,133059770,52168899,185228669,6,0,1,7168,7,9581459240
18626,133062630,52167665,185230295,0,0,1,2560,3,5346531128
18627,133070040,52352978,185423018,9,0,1,53248,12,4664915929
18628,133081770,52341271,185423041,8,0,1,3584,8,9184096101
18629,133100981,52333020,185434001,5,0,1,40960,10,902008366
18630,133110001,52359537,185469538,5,0,1,5632,10,1480562881
18631,133110680,52360620,185471300,8,0,1,3072,8,3171929468
18632,133111150,42371726,175482876,0,0,0,125440,3,7455928206
18633,133113330,52357993,185471323,8,0,1,6144,8,6684903735
18634,133113411,41907984,175021395,7,0,0,1024,10,2327585181
18635,133114700,52356646,185471346,0,0,1,1024,3,6666902226
18636,133123571,42024780,175148351,7,0,0,2560,10,6666709452
18637,133127040,42219254,175346294,4,0,0,82432,15,6468494338
18638,133131461,42580389,175711850,7,0,0,512,10,9132897924
18639,133150640,42415048,175565688,4,0,0,27136,15,3469296780
18640,133166800,52304748,185471548,8,0,1,4096,8,4842851032
18641,133183480,42083504,175266984,4,0,0,8192,15,8794272888
18642,133206410,52265161,185471571,0,0,1,512,3,6942553985
18643,133214750,52256844,185471594,8,0,1,512,8,9479607076
18644,133226440,42416807,175643247,0,0,0,31744,3,5332736369
18645,133248131,52246055,185494186,5,0,1,31232,10,3604796360
18646,133261381,52235948,185497329,5,0,1,13312,10,1510639761
18647,133261791,52293941,185555732,5,0,1,7680,10,3564757972
18648,133272261,41940089,175212350,7,0,0,2048,10,7774230301
18649,133279120,52277278,185556398,8,0,1,11264,8,7247928725
18650,133281371,42065749,175347120,7,0,0,1536,10,7366874290
18651,133307461,52290424,185597885,5,0,1,28160,10,6096035831
18652,133344680,41941815,175286495,4,0,0,10240,15,6115527728
18653,133355030,52545070,185900100,9,0,1,138752,12,88563935
18654,133358750,42499566,175858316,4,0,0,76800,15,2729233269
18655,133362250,52572836,185935086,9,0,1,2560,12,7521593512
18656,133370810,52566037,185936847,8,0,1,2048,8,3059758061
18657,133379020,52562653,185941673,9,0,1,7680,12,1510015893
18658,133384770,52560129,185944899,3,0,1,5120,17,9727608793
18659,133388770,52557115,185945885,0,0,1,1536,3,5952570389
18660,133389280,42167846,175557126,4,0,0,131072,15,118811761
18661,133393861,52552588,185946449,5,0,1,10752,10,4034289140
18662,133398070,41948559,175346629,4,0,0,1024,15,6617298450
18663,133402450,42183697,175586147,0,0,0,67072,3,3690558487
18664,133411880,52537795,185949675,3,0,1,5120,17,8387263688
18665,133413720,42180583,175594303,4,0,0,25088,15,9243984000
18666,133420611,52651005,186071616,5,0,1,30208,10,5060979674
18667,133421151,53004934,186426085,5,0,1,108544,10,5508360302
18668,133437791,52992160,186429951,8,0,1,6144,8,6484629787
18669,133440240,52990377,186430617,7,0,1,1024,10,272865165
18670,133440491,52990472,186430963,8,0,1,512,8,8668741134
18671,133446431,53007145,186453576,5,0,1,25600,10,7965526270
18672,133451680,41927991,175379671,0,0,0,2560,3,6811553340
18673,133453661,53023140,186476801,5,0,1,27136,10,4184418658
18674,133473540,42213462,175687002,4,0,0,10752,15,9300552942
18675,133475880,41902988,175378868,4,0,0,11776,15,8270153736
18676,133478320,53007173,186485493,0,0,1,4096,3,2669390104
18677,133480720,53073069,186553789,9,0,1,92672,12,4120549799
18678,133491931,42094434,175586365,7,0,0,512,10,8309347067
18679,133495990,53126082,186622072,0,0,1,512,3,8016774825
18680,133500060,53127299,186627359,3,0,1,16896,17,1413674213
18681,133512450,53130219,186642669,3,0,1,2560,17,4556902390
18682,133529630,53113295,186642925,0,0,1,9216,3,7824918243
18683,133530960,53112951,186643911,3,0,1,1536,17,758026189
18684,133541981,53115873,186657854,5,0,1,25088,10,8761287208
18685,133573090,53104327,186677417,3,0,1,5120,17,5885273393
18686,133577381,42021981,175599362,7,0,0,2048,10,3662443059
18687,133591210,42063653,175654863,4,0,0,19456,15,7731050368
18688,133595120,42075210,175670330,0,0,0,50688,3,10645147078
18689,133596870,53125271,186722141,8,0,1,2048,8,7691777305
18690,133602190,53119982,186722172,9,0,1,68608,12,2007245872
18691,133617411,53104784,186722195,5,0,1,1024,10,645268372
18692,133633830,53088388,186722218,3,0,1,2048,17,9265324134
18693,133634390,42293533,175927923,4,0,0,66048,15,6736622887
18694,133637101,53160354,186797455,5,0,1,54784,10,7049973293
18695,133644490,53152988,186797478,8,0,1,2048,8,1316050251
18696,133657050,42494248,176151298,4,0,0,18944,15,3489592177
18697,133658500,53139001,186797501,8,0,1,1536,8,6712067057
18698,133659150,53138374,186797524,8,0,1,14336,8,1922477227
18699,133660719,42149097,175809816,1,0,0,30720,10,3869217215
18700,133662400,53135147,186797547,3,0,1,3584,17,10594999934
18701,133666780,53152243,186819023,3,0,1,21504,17,6629444776
18702,133671880,53149729,186821609,3,0,1,4096,17,5626565550
18703,133673180,42066907,175740087,0,0,0,40448,3,7784059096
18704,133675791,42183241,175859032,7,0,0,512,10,7993491992
18705,133691491,53192182,186883673,5,0,1,65536,10,1249937592
18706,133704301,53197425,186901726,5,0,1,33792,10,894839427
18707,133716380,42324793,176041173,4,0,0,58880,15,10082185352
18708,133726410,41972018,175698428,4,0,0,28160,15,3184230751
18709,133727480,42072953,175800433,4,0,0,16896,15,297664599
18710,133729810,42222651,175952461,4,0,0,63488,15,393813188
18711,133739100,53171254,186910354,8,0,1,4096,8,6486893560
18712,133742160,53169919,186912079,8,0,1,2048,8,8772326394
18713,133744140,53169245,186913385,3,0,1,2048,17,7792317440
18714,133773431,53169473,186942904,5,0,1,4096,10,3284766713
18715,133793100,53193623,186986723,8,0,1,23040,8,449344617
18716,133801180,53186209,186987389,0,0,1,1024,3,8658780475
18717,133801901,41784735,175586636,7,0,0,512,10,9774385523
18718,133821461,53248865,187070326,5,0,1,24576,10,2087915317
18719,133850030,41873040,175723070,0,0,0,2048,3,4295147147
18720,133851630,53220949,187072579,6,0,1,6656,7,594400827
18721,133871071,41686280,175557351,7,0,0,512,10,591435476
18722,133873140,53222322,187095462,1,0,1,1024,10,5924882949
18723,133898721,42287500,176186221,7,0,0,1536,10,618136196
18724,133908440,41868743,175777183,4,0,0,1024,15,1552842331
18725,133910821,53233668,187144489,5,0,1,56832,10,127070053
18726,133915981,41942872,175858853,7,0,0,1536,10,4579494323
18727,133919350,53225162,187144512,3,0,1,1536,17,54258823
18728,133929530,41943633,175873163,4,0,0,10240,15,7380704589
18729,133941431,41729078,175670509,7,0,0,512,10,6035678855
18730,133944610,42414399,176359009,0,0,0,51712,3,1849815695
18731,133954270,41978824,175933094,4,0,0,16896,15,9342339567
18732,133961151,42225405,176186556,7,0,0,1024,10,7117777373
18733,133962340,42028364,175990704,4,0,0,6144,15,4248152048
18734,133969460,41747310,175716770,4,0,0,1536,15,4820082057
18735,133986710,41921066,175907776,0,0,0,44544,3,2972599939
18736,133997111,41870477,175867588,7,0,0,1024,10,3942670693
18737,134000410,53146130,187146540,2,0,1,1024,3,9508234096
18738,134003310,53148460,187151770,7,0,1,4096,10,8919304279
18739,134006790,42287431,176294221,4,0,0,81408,15,4637104549
18740,134008350,53143682,187152032,7,0,1,4608,10,828647855
18741,134010811,53220689,187231500,5,0,1,55296,10,7657291573
18742,134014070,41950532,175964602,4,0,0,3072,15,5812191160
18743,134015500,53216023,187231523,3,0,1,11264,17,6874032394
18744,134031060,53200486,187231546,0,0,1,1024,3,1415811874
18745,134033911,41859880,175893791,7,0,0,1024,10,2314879785
18746,134037370,42082734,176120104,0,0,0,17920,3,2970351998
18747,134041321,41911787,175953108,7,0,0,2048,10,4834726439
18748,134048650,53195778,187244428,7,0,1,6144,10,3865764152
18749,134049180,53232227,187281407,2,0,1,44544,3,6786334076
18750,134052121,53329636,187381757,5,0,1,86016,10,5146562613
18751,134054690,53375439,187430129,0,0,1,5632,3,5293114070
18752,134057410,53372742,187430152,2,0,1,10240,3,4225490754
18753,134059420,53371246,187430666,3,0,1,13824,17,8859205759
18754,134063251,41810091,175873342,7,0,0,512,10,6356070514
18755,134071060,53406420,187477480,2,0,1,28672,3,9144433350
18756,134071310,53425156,187496466,2,0,1,36864,3,508235800
18757,134082520,53414612,187497132,0,0,1,1024,3,8569336431
18758,134086101,53438230,187524331,5,0,1,54784,10,9887546425
18759,134087181,53475987,187563168,5,0,1,61440,10,8532261683
18760,134090230,42174453,176264683,4,0,0,38912,15,10143089633
18761,134092720,53499096,187591816,0,0,1,3072,3,2966698438
18762,134106380,42236804,176343184,0,0,0,77824,3,7510541189
18763,134111300,53480539,187591839,7,0,1,3072,10,8255862409
18764,134121250,42024149,176145399,0,0,0,82944,3,4495786710
18765,134122660,42186412,176309072,0,0,0,48640,3,6037952305
18766,134123500,53468362,187591862,3,0,1,4096,17,9615683431
18767,134123520,42074371,176197891,4,0,0,28160,15,8335312152
18768,134143260,53448625,187591885,7,0,1,512,10,6229572833
18769,134163190,53495739,187658929,2,0,1,92160,3,6795902026
18770,134164680,53497475,187662155,3,0,1,5120,17,4456619041
18771,134173370,53497720,187671090,2,0,1,23040,3,8561418810
18772,134174470,53499526,187673996,7,0,1,4608,10,1323438477
18773,134178530,53524043,187702573,7,0,1,19456,10,1835427065
18774,134178790,42300775,176479565,0,0,0,66560,3,9574216894
18775,134187260,53515979,187703239,7,0,1,1024,10,3745368729
18776,134212190,42040614,176252804,0,0,0,24064,3,8601765164
18777,134213440,53493025,187706465,7,0,1,5120,10,6742123644
18778,134217420,53491631,187709051,7,0,1,4096,10,3474840297
18779,134234990,42034396,176269386,4,0,0,15360,15,1284834142
18780,134236240,41924398,176160638,0,0,0,24576,3,10483594296
18781,134239130,53574461,187813591,2,0,1,185856,3,3353983781
18782,134243581,41954529,176198110,7,0,0,512,10,3949275501
18783,134245890,53674035,187919925,2,0,1,205312,3,1359113313
18784,134247410,53710677,187958087,2,0,1,1024,3,3361336559
18785,134253470,53873846,188127316,2,0,1,249344,3,949668860
18786,134254530,53922562,188177092,2,0,1,107520,3,6302738387
18787,134256770,53922407,188179177,0,0,1,4096,3,10295563528
18788,134257830,53921693,188179523,7,0,1,512,10,2594117377
18789,134285300,53897257,188182557,0,0,1,15360,3,5085289175
18790,134294340,53904746,188199086,8,0,1,6144,8,2766898005
18791,134300840,53900192,188201032,7,0,1,3072,10,9276929501
18792,134301010,42345568,176646578,4,0,0,36864,15,9627550089
18793,134301860,53904536,188206396,2,0,1,20480,3,10572197646
18794,134308000,53901302,188209302,7,0,1,4608,10,695051025
18795,134310620,53902868,188213488,0,0,1,6656,3,1085337438
18796,134320130,42282778,176602908,0,0,0,119808,3,10382975783
18797,134322459,53896175,188218634,4,0,1,8192,15,7927383607
18798,134323890,42221138,176545028,4,0,0,7168,15,9370889668
18799,134338850,53880040,188218890,8,0,1,9216,8,10580874535
18800,134339240,53892841,188232081,2,0,1,36864,3,1756364486
18801,134340100,53892647,188232747,8,0,1,1024,8,2629308786
18802,134341831,42017700,176359531,7,0,0,512,10,6776226177
18803,134351200,53881893,188233093,0,0,1,512,3,2539798619
18804,134353820,53881014,188234834,2,0,1,24576,3,6414613473
18805,134353840,53898445,188252285,0,0,1,13824,3,1660777371
18806,134357210,53906790,188264000,0,0,1,7680,3,7278727801
18807,134357520,53906736,188264256,8,0,1,9216,8,952712464
18808,134364430,53928477,188292907,2,0,1,28672,3,6808004938
18809,134371491,53926562,188298053,5,0,1,8192,10,10039490561
18810,134377290,53922709,188299999,0,0,1,3072,3,7521213731
18811,134380221,42223022,176603243,7,0,0,1024,10,8553605026
18812,134392010,53908335,188300345,0,0,1,512,3,6328334131
18813,134400301,41959051,176359352,7,0,0,1024,10,8955687062
18814,134401310,53902261,188303571,7,0,1,5120,10,2944828843
18815,134407310,53988518,188395828,2,0,1,114176,3,5510416166
18816,134410100,53987034,188397134,7,0,1,2048,10,497914483
18817,134418629,53981411,188400040,4,0,1,4608,15,2866977713
18818,134430140,53970246,188400386,7,0,1,512,10,10122808461
18819,134432820,53971432,188404252,0,0,1,6144,3,7054903619
18820,134433489,53971749,188405238,4,0,1,1536,15,1175530189
18821,134446260,54042004,188488264,2,0,1,73728,3,1984232392
18822,134455570,54036238,188491808,8,0,1,3584,8,1064402482
18823,134456199,42003063,176459262,1,0,0,13824,10,9444849150
18824,134456920,54035554,188492474,7,0,1,1024,10,6602910336
18825,134458280,42402650,176860930,4,0,0,95232,15,2941544901
18826,134461271,54034267,188495538,5,0,1,28672,10,2545451813
18827,134462131,54082262,188544393,5,0,1,53760,10,7596086557
18828,134462900,54098506,188561406,0,0,1,512,3,9789948692
18829,134466771,54129887,188596658,5,0,1,55808,10,9951593687
18830,134472970,54124034,188597004,0,0,1,512,3,2358621161
18831,134482310,54117600,188599910,7,0,1,4608,10,970456448
18832,134503400,42224432,176727832,0,0,0,34816,3,3014074346
18833,134503750,42157827,176661577,0,0,0,49152,3,4029734191
18834,134506160,42054197,176560357,4,0,0,512,15,900642055
18835,134511229,54094110,188605339,4,0,1,4096,15,582724728
18836,134516530,54091395,188607925,0,0,1,4096,3,9073489364
18837,134519950,54181276,188701226,2,0,1,118272,3,4307457219
18838,134521220,54193487,188714707,2,0,1,35328,3,9425011552
18839,134521569,42268920,176790489,1,0,0,33792,10,3869425180
18840,134522831,54194142,188716973,5,0,1,3584,10,4962286185
18841,134523210,42581263,177104473,0,0,0,7168,3,8974671067
18842,134524590,54194329,188718919,8,0,1,3072,8,329791592
18843,134534870,54215826,188750696,8,0,1,1536,8,3295394077
18844,134551619,54201023,188752642,4,0,1,3072,15,4087611557
18845,134560479,54195389,188755868,4,0,1,5120,15,2483826762
18846,134569090,54188084,188757174,8,0,1,2048,8,9009154188
18847,134578039,54179801,188757840,4,0,1,1024,15,7207505959
18848,134586499,42709391,177295890,1,0,0,38400,10,4499964635
18849,134593800,42461920,177055720,0,0,0,49664,3,800621125
18850,134595339,54166047,188761386,4,0,1,5632,15,6476501355
18851,134607591,42376091,176983682,7,0,0,2560,10,475284491
18852,134610939,54154953,188765892,4,0,1,7168,15,1623914218
18853,134616020,42954277,177570297,4,0,0,173056,15,3564890502
18854,134616489,54152309,188768798,4,0,1,4608,15,10521538305
18855,134628950,42518804,177147754,4,0,0,48128,15,5474790493
18856,134637450,54145769,188783219,0,0,1,512,3,6954045232
18857,134641811,42280350,176922161,7,0,0,512,10,2801351954
18858,134642360,54142344,188784704,2,0,1,15360,3,3414966125
18859,134643069,42584376,177227445,1,0,0,105984,10,2902242464
18860,134655089,42724142,177379231,1,0,0,31232,10,8310940900
18861,134697199,54139863,188837062,4,0,1,11264,15,3961171888
18862,134697280,54147885,188845165,2,0,1,38912,3,8318271054
18863,134703740,54150420,188854160,0,0,1,4608,3,5819848524
18864,134706881,54237375,188944256,5,0,1,141312,10,3603983853
18865,134723440,42362838,177086278,4,0,0,7680,15,3939029646
18866,134723720,54539144,189262864,2,0,1,156160,3,5611630689
18867,134724890,54694295,189419185,2,0,1,173056,3,4411302723
18868,134732271,54709834,189442105,5,0,1,14848,10,6538294114
18869,134733980,42425497,177159477,0,0,0,38400,3,7852572217
18870,134734240,54710131,189444371,0,0,1,3584,3,2399974364
18871,134744570,54703027,189447597,0,0,1,5120,3,7451675646
18872,134748670,54734356,189483026,2,0,1,41472,3,10039973847
18873,134769720,54793179,189562899,2,0,1,89600,3,4812836832
18874,134770440,42566714,177337154,4,0,0,17920,15,3950173480
18875,134773119,54796152,189569271,4,0,1,4608,15,344921216
18876,134790769,54780448,189571217,4,0,1,3072,15,1842066294
18877,134792869,54779812,189572681,4,0,1,18432,15,4842424781
18878,134793209,54814214,189607423,4,0,1,5120,15,2279263438
18879,134797879,54809567,189607446,4,0,1,8704,15,9943134687
18880,134799709,54807760,189607469,4,0,1,3584,15,1183775236
18881,134807370,42517798,177325168,0,0,0,66048,3,6977850373
18882,134812681,54794811,189607492,5,0,1,4608,10,2224508735
18883,134819740,54787924,189607664,2,0,1,3072,3,8205974158
18884,134825140,42411089,177236229,0,0,0,18432,3,7150826058
18885,134838099,54773431,189611530,4,0,1,6144,15,5828560334
18886,134838410,54785477,189623887,8,0,1,1536,8,174508581
18887,134838600,54785310,189623910,2,0,1,2048,3,1999097713
18888,134846500,54777656,189624156,8,0,1,6144,8,6347006807
18889,134857901,54867132,189725033,5,0,1,116736,10,10359631116
18890,134860420,54875325,189735745,0,0,1,1536,3,1081516438
18891,134860611,54879320,189739931,5,0,1,6656,10,5748123114
18892,134863751,42706904,177570655,7,0,0,1024,10,10229886613
18893,134886641,42618663,177505304,7,0,0,1024,10,9041043084
18894,134891071,42524058,177415129,7,0,0,1024,10,8066220856
18895,134903430,54890695,189794125,0,0,1,6144,3,7984941710
18896,134909730,54884418,189794148,2,0,1,1536,3,9495996024
18897,134917751,54876668,189794419,5,0,1,512,10,9111496441
18898,134918320,54876253,189794573,0,0,1,8704,3,6442914986
18899,134922300,54896993,189819293,8,0,1,512,8,3638359156
18900,134923240,54896399,189819639,8,0,1,512,8,5841199999
18901,134934850,42821895,177756745,0,0,0,33792,3,4983703469
18902,134943630,54878915,189822545,0,0,1,4608,3,5562220191
18903,134956149,42860806,177816955,1,0,0,58880,10,7136143487
18904,134959640,54867731,189827371,7,0,1,7680,10,8930967877
18905,134964951,42433315,177398266,7,0,0,1536,10,8298414850
18906,134965640,54864317,189829957,7,0,1,4096,10,3562748166
18907,134975030,54855273,189830303,7,0,1,512,10,1720899940
18908,134981461,42458524,177439985,7,0,0,512,10,5025480269
18909,134983560,54849649,189833209,0,0,1,4608,3,159213846
18910,134991550,42873530,177865080,4,0,0,30208,15,2004381327
18911,135000160,54851842,189852002,7,0,1,3072,10,4864392283
18912,135012670,54839998,189852668,0,0,1,1024,3,2382908957
18913,135018691,54839123,189857814,5,0,1,8192,10,8039231677
18914,135021581,55462993,190484574,5,0,1,136192,10,8823873601
18915,135029081,55520921,190550002,5,0,1,59904,10,3895110430
18916,135030200,55520058,190550258,0,0,1,9216,3,644922724
18917,135038139,42841160,177879299,1,0,0,46592,10,8377543989
18918,135053800,42802053,177855853,0,0,0,91648,3,8874506156
18919,135067500,42846481,177913981,4,0,0,73728,15,894404058
18920,135074940,55481219,190556159,0,0,1,19968,3,8112970352
18921,135087751,55568031,190655782,5,0,1,16896,10,10212641632
18922,135090669,42737229,177827898,1,0,0,35840,10,6020326922
18923,135093410,55562718,190656128,0,0,1,512,3,6029330578
18924,135097909,42789758,177887667,1,0,0,7680,10,5870767885
18925,135105330,42779943,177885273,4,0,0,17920,15,1559240618
18926,135153780,55503014,190656794,0,0,1,1024,3,5149092088
18927,135159620,55501040,190660660,0,0,1,6144,3,4213938093
18928,135163480,42759127,177922607,4,0,0,8192,15,10734605529
18929,135176200,55485446,190661646,1,0,1,1536,10,6280828923
18930,135179751,55743274,190923025,5,0,1,104448,10,5914740737
18931,135191360,42728728,177920088,0,0,0,19968,3,3830393760
18932,135194960,55728080,190923040,0,0,1,7680,3,212183605
18933,135201690,42732328,177934018,0,0,0,37376,3,8115756850
18934,135202121,55720934,190923055,5,0,1,6656,10,3534175829
18935,135213271,42666519,177879790,7,0,0,1536,10,6075640412
18936,135237530,42841697,178079227,4,0,0,60416,15,3876808100
18937,135238201,55684869,190923070,5,0,1,2048,10,4299522977
18938,135241660,55699224,190940884,0,0,1,3072,3,5249220281
18939,135245760,43069667,178315427,0,0,0,132608,3,6349454715
18940,135271910,55668989,190940899,6,0,1,20480,7,9982377794
18941,135285941,55678509,190964450,5,0,1,28672,10,7393926024
18942,135292121,55678581,190970702,5,0,1,43008,10,9404154631
18943,135292910,42962411,178255321,0,0,0,197120,3,5997302484
18944,135294680,55685676,190980356,1,0,1,5632,10,5466812367
18945,135296839,42812179,178109018,1,0,0,3584,10,6705556645
18946,135312230,55670712,190982942,8,0,1,4096,8,5838823251
18947,135312500,43103255,178415755,0,0,0,99328,3,10604237252
18948,135313600,42961400,178275000,4,0,0,64512,15,2026807059
18949,135317361,55746912,191064273,5,0,1,88064,10,5613587181
18950,135317430,43006186,178323616,4,0,0,26624,15,9499954930
18951,135318920,55802732,191121652,0,0,1,8704,3,1889215855
18952,135322339,55799328,191121667,4,0,1,8192,15,6423214833
18953,135326789,42829004,178155793,1,0,0,3072,10,4965853168
18954,135328700,55792982,191121682,8,0,1,6656,8,1108638265
18955,135331911,42853081,178184992,7,0,0,512,10,8029911956
18956,135332060,55789637,191121697,8,0,1,512,8,7767574312
18957,135338801,55782911,191121712,5,0,1,16384,10,10123580311
18958,135346750,55774977,191121727,8,0,1,2560,8,6847894825
18959,135361301,55762956,191124257,5,0,1,39424,10,9263694444
18960,135363029,43008691,178371720,1,0,0,9216,10,10304557862
18961,135366720,55761292,191128012,1,0,1,1536,10,3207412869
18962,135368640,43011608,178380248,4,0,0,23552,15,10552449647
18963,135381759,43084672,178466431,1,0,0,23040,10,385337428
18964,135385371,55777948,191163319,5,0,1,44032,10,3785202080
18965,135390811,43288480,178679291,7,0,0,512,10,10608755987
18966,135428941,43118770,178547711,7,0,0,2560,10,6856247302
18967,135433050,55763696,191196746,1,0,1,2560,10,2891593637
18968,135433899,43110656,178544555,1,0,0,17408,10,10293837068
18969,135438900,55757861,191196761,6,0,1,1536,7,8862055661
18970,135444189,55752587,191196776,4,0,1,512,15,8417660724
18971,135450800,55745991,191196791,1,0,1,3072,10,2340645154
18972,135453949,43164615,178618564,1,0,0,40448,10,6644251334
18973,135459100,55745065,191204165,6,0,1,27648,7,3524839211
18974,135484401,55726638,191211039,5,0,1,32768,10,3418271030
18975,135489879,55730912,191220791,4,0,1,1536,15,1356457231
18976,135502259,43258336,178760595,1,0,0,9728,10,1498432305
18977,135509030,55712939,191221969,8,0,1,13824,8,3051276223
18978,135510100,43042866,178552966,4,0,0,10752,15,9110666114
18979,135517020,55749288,191266308,0,0,1,11264,3,365647738
18980,135519740,55746583,191266323,8,0,1,11264,8,5643325765
18981,135522730,55743608,191266338,8,0,1,3072,8,5291880483
18982,135523470,55742883,191266353,8,0,1,4096,8,10649335073
18983,135526939,43257694,178784633,1,0,0,49152,10,5337120845
18984,135527770,55738598,191266368,0,0,1,3072,3,4823782504
18985,135528620,55743238,191271858,6,0,1,4096,7,10108262533
18986,135532280,55739593,191271873,6,0,1,5120,7,6089338695
18987,135536110,43383819,178919929,5,0,0,1536,10,7530162533
18988,135536250,55735638,191271888,8,0,1,9728,8,2403433200
18989,135537099,55734804,191271903,4,0,1,3072,15,7927570203
18990,135548330,55732701,191281031,0,0,1,2048,3,4997080275
18991,135552250,55730087,191282337,6,0,1,2048,7,4221402038
18992,135556691,55727272,191283963,5,0,1,2560,10,9862267933
18993,135558600,55728269,191286869,8,0,1,4608,8,1625473665
18994,135565661,55821106,191386767,5,0,1,112128,10,859598926
18995,135587639,55800114,191387753,4,0,1,1536,15,6628741158
18996,135591349,55798350,191389699,4,0,1,3072,15,10629989807
18997,135591610,55800675,191392285,0,0,1,4096,3,2851817515
18998,135599900,55795291,191395191,8,0,1,4608,8,1778357129
18999,135609610,55787847,191397457,6,0,1,3584,7,1591399167
19000,135611710,55790253,191401963,6,0,1,7168,7,6253956509
19001,135615591,55791360,191406951,5,0,1,6656,10,8556020070
19002,135624019,55784558,191408577,4,0,1,2560,15,4840802196
19003,135631470,43364190,178995660,0,0,0,53248,3,6663711766
19004,135634719,55775484,191410203,4,0,1,2560,15,5567518464
19005,135636551,55842590,191479141,5,0,1,134656,10,3204778024
19006,135638780,55842979,191481759,8,0,1,1536,8,1326857074
19007,135639100,43338575,178977675,5,0,0,1536,10,3799258594
19008,135640091,55884307,191524398,5,0,1,76288,10,2579953068
19009,135642170,43369964,179012134,4,0,0,2048,15,10454334864
19010,135642630,55883074,191525704,6,0,1,2048,7,6257010498
19011,135642840,55884170,191527010,1,0,1,2048,10,4418136453
19012,135644531,43407432,179051963,7,0,0,512,10,10238802001
19013,135655600,55874636,191530236,8,0,1,5120,8,4149025477
19014,135658270,55878981,191537251,1,0,1,19968,10,1103308190
19015,135666280,43426288,179092568,4,0,0,19968,15,8750313730
19016,135672670,55868127,191540797,6,0,1,5632,7,6195567927
19017,135674410,43562298,179236708,5,0,0,512,10,3521951259
19018,135677700,43558805,179236505,9,0,0,23552,12,6233806729
19019,135678521,55867422,191545943,5,0,1,8192,10,9263320614
19020,135680280,55866009,191546289,0,0,1,512,3,8455184959
19021,135682341,55908927,191591268,5,0,1,92672,10,6620259281
19022,135684410,55937006,191621416,1,0,1,512,10,5015368556
19023,135689200,55933394,191622594,0,0,1,13824,3,5258403194
19024,135694710,55936242,191630952,0,0,1,1024,3,8023079971
19025,135701690,43499301,179200991,5,0,0,1024,10,8822861641
19026,135707440,43503984,179211424,5,0,0,1024,10,3286961193
19027,135710730,55920376,191631106,0,0,1,8704,3,4826712081
19028,135720639,55914973,191635612,4,0,1,7168,15,8733061716
19029,135722610,55913156,191635766,8,0,1,8704,8,7881666452
19030,135724721,55912351,191637072,5,0,1,2048,10,9309569241
19031,135725110,55914868,191639978,0,0,1,4608,3,2019893716
19032,135734370,55907900,191642270,0,0,1,3584,3,8762964729
19033,135738821,55929791,191668612,5,0,1,48640,10,5567612443
19034,135743370,55926868,191670238,0,0,1,2560,3,9894200993
19035,135744560,43864435,179608995,9,0,0,9728,12,1116140608
19036,135745660,55940408,191686068,8,0,1,18432,8,3888789613
19037,135749781,43587547,179337328,7,0,0,512,10,7272080933
19038,135765861,55947140,191713001,5,0,1,61952,10,7138764583
19039,135768790,43660639,179429429,9,0,0,16896,12,10352285910
19040,135776010,55941250,191717260,1,0,1,4096,10,1007324212
19041,135791329,55927109,191718438,4,0,1,13824,15,3347639246
19042,135800729,43968835,179769564,1,0,0,48128,10,9338899347
19043,135805861,43575297,179381158,7,0,0,512,10,2101462849
19044,135817731,55943902,191761633,5,0,1,108032,10,3328096643
19045,135828330,43580519,179408849,9,0,0,25600,12,9935156116
19046,135829901,43607293,179437194,7,0,0,1024,10,6919614508
19047,135832930,43970218,179803148,9,0,0,69120,12,1238501358
19048,135837590,55925349,191762939,8,0,1,2048,8,2216151111
19049,135843921,43793176,179637097,7,0,0,2048,10,9246954519
19050,135846001,55979829,191825830,5,0,1,100352,10,2743094678
19051,135846110,56003801,191849911,7,0,1,27136,10,5519480917
19052,135846160,56012855,191859015,7,0,1,4608,10,2395116176
19053,135847179,43561918,179409097,1,0,0,512,10,6107981348
19054,135850500,43760663,179611163,5,0,0,512,10,6530576814
19055,135855100,43848746,179703846,0,0,0,166400,3,9475045466
19056,135863800,44012500,179876300,5,0,0,1024,10,8557341119
19057,135864550,55998651,191863201,8,0,1,6656,8,6714896831
19058,135865570,43676399,179541969,5,0,0,512,10,7686957930
19059,135865639,55998433,191864072,4,0,1,12288,15,10129431299
19060,135872320,55995747,191868067,0,0,1,5120,3,6218288197
19061,135877240,55995013,191872253,1,0,1,6656,10,7450413380
19062,135878350,55997449,191875799,1,0,1,5632,10,9966607343
19063,135879240,56009290,191888530,0,0,1,1024,3,8947379744
19064,135882830,56008286,191891116,7,0,1,4096,10,4336467430
19065,135886470,43924076,179810546,5,0,0,1536,10,9778768907
19066,135892060,56002602,191894662,7,0,1,5632,10,6539544359
19067,135894299,56002309,191896608,4,0,1,3072,15,7695118799
19068,135903360,43876991,179780351,9,0,0,35328,12,7372352391
19069,135904710,55993503,191898213,8,0,1,1024,8,5087063145
19070,135906921,55992880,191899801,5,0,1,15872,10,6363024467
19071,135913720,55986427,191900147,1,0,1,512,10,9681790193
19072,135915170,55985963,191901133,1,0,1,1536,10,4667926759
19073,135917290,55985789,191903079,3,0,1,3072,17,2539657832
19074,135918400,55986433,191904833,1,0,1,13312,10,1062353545
19075,135931129,44387674,180318803,1,0,0,138240,10,5073590659
19076,135936951,56016094,191953045,5,0,1,66560,10,3665592806
19077,135939580,43970507,179910087,4,0,0,24064,15,10283635348
19078,135943781,56019583,191963364,5,0,1,37888,10,9384389469
19079,135945341,56067203,192012544,5,0,1,78848,10,9535692613
19080,135951349,56066047,192017396,4,0,1,7680,15,7937851250
19081,135957010,56065980,192022990,1,0,1,18432,10,4667773236
19082,135959330,56064006,192023336,0,0,1,512,3,1365843457
19083,135969711,56121005,192090716,5,0,1,94720,10,5927000837
19084,135987760,56104902,192092662,8,0,1,3072,8,5875776380
19085,135998900,56101257,192100157,0,0,1,11264,3,4841146517
19086,136009210,56092224,192101434,0,0,1,9728,3,6355938822
19087,136022089,56097793,192119882,4,0,1,13312,15,9394649344
19088,136024980,43919901,179944881,5,0,0,1024,10,3042061764
19089,136029189,56113942,192143131,4,0,1,1536,15,7193904071
19090,136030400,43988738,180019138,9,0,0,49664,12,9580366890
19091,136034840,43895430,179930270,0,0,0,34304,3,288874195
19092,136036229,56112048,192148277,4,0,1,8192,15,9992524073
19093,136047010,43604767,179651777,0,0,0,6656,3,7616624208
19094,136055180,56095683,192150863,8,0,1,4096,8,2596912307
19095,136056869,43947114,180003983,1,0,0,34816,10,840874857
19096,136057130,56100075,192157205,1,0,1,2048,10,494050353
19097,136059560,43816405,179875965,4,0,0,59392,15,6505416611
19098,136060229,44068262,180128491,1,0,0,26624,10,9258388776
19099,136066920,56092871,192159791,1,0,1,4096,10,4382782275
19100,136074381,43775553,179849934,7,0,0,1024,10,4519749342
19101,136074990,44305627,180380617,4,0,0,14336,15,7668153648
19102,136089450,56088104,192177554,8,0,1,1024,8,10648132662
19103,136091330,56086788,192178118,8,0,1,10752,8,9965580331
19104,136095790,56082674,192178464,8,0,1,512,8,4585488963
19105,136110590,44241643,180352233,9,0,0,93184,12,4146910706
19106,136112289,43931364,180043653,3,0,0,80384,17,4831240962
19107,136114249,43816200,179930449,1,0,0,512,10,9166611423
19108,136121279,56061307,192182586,4,0,1,15360,15,4678273810
19109,136131950,56055142,192187092,1,0,1,7168,10,3798223375
19110,136136920,56057324,192194244,7,0,1,4096,10,1193799506
19111,136144199,56052311,192196510,4,0,1,3584,15,6996358013
19112,136148799,43992430,180141229,1,0,0,12288,10,7658457908
19113,136158509,43545695,179704204,1,0,0,1024,10,3228222310
19114,136165129,56035567,192200696,4,0,1,6656,15,9035312738
19115,136168540,44313025,180481565,0,0,0,20992,3,2174619787
19116,136175329,43980669,180155998,1,0,0,8192,10,7041936601
19117,136177241,56026041,192203282,8,0,1,4096,8,6963597223
19118,136187110,56017248,192204358,1,0,1,13312,10,413445303
19119,136197570,43849226,180046796,0,0,0,10240,3,1350139024
19120,136202660,56006550,192209210,8,0,1,7680,8,1506050519
19121,136206980,44439410,180646390,0,0,0,84992,3,9780002312
19122,136225530,55987866,192213396,1,0,1,6656,10,3674063718
19123,136235420,55985319,192220739,1,0,1,3584,10,6506130404
19124,136235851,55996844,192232695,8,0,1,6144,8,4440906626
19125,136248631,55986010,192234641,8,0,1,3072,8,6538224641
19126,136259549,43696486,179956035,1,0,0,5632,10,2283822436
19127,136262021,55977446,192239467,8,0,1,7680,8,7353474809
19128,136268889,44444627,180713516,1,0,0,209408,10,8700799057
19129,136284330,44113002,180397332,4,0,0,54784,15,10439029745
19130,136287360,55954719,192242079,2,0,1,4096,3,6632875929
19131,136289350,55955315,192244665,1,0,1,4096,10,7049522098
19132,136301000,44157883,180458883,0,0,0,33280,3,636839532
19133,136305119,55940212,192245331,4,0,1,1024,15,3493629315
19134,136313050,43819832,180132882,4,0,0,14336,15,711667369
19135,136315449,43911917,180227366,1,0,0,59392,10,6714548398
19136,136317250,44006568,180323818,0,0,0,16384,3,8359064735
19137,136323981,44157917,180481898,7,0,0,512,10,8723726683
19138,136333751,44155117,180488868,7,0,0,1024,10,9426383859
19139,136347770,55899507,192247277,1,0,1,3072,10,2929358869
19140,136350260,55898963,192249223,1,0,1,3072,10,5736224668
19141,136372020,43574241,179946261,4,0,0,512,15,5248956607
19142,136374980,55875869,192250849,1,0,1,2560,10,4017109379
19143,136375319,44000828,180376147,1,0,0,74240,10,7883293693
19144,136376540,44203079,180579619,4,0,0,11776,15,7007766612
19145,136409680,43747589,180157269,4,0,0,4096,15,8557232108
19146,136425061,55832791,192257852,8,0,1,20992,8,3238733690
19147,136435590,43917914,180353504,0,0,0,4096,3,76600313
19148,136436350,43985088,180421438,9,0,0,30208,12,9627827381
19149,136458510,55799688,192258198,1,0,1,512,10,4318360234
19150,136470580,43963962,180434542,4,0,0,7680,15,777629139
19151,136471740,55787124,192258864,1,0,1,1024,10,7099551331
19152,136476969,55782805,192259774,4,0,1,11264,15,3281999722
19153,136496849,55767431,192264280,4,0,1,7168,15,10226976330
19154,136499699,55776756,192276455,4,0,1,6656,15,9269538329
19155,136511310,44064698,180576008,9,0,0,81408,12,3333802193
19156,136528681,44185022,180713703,7,0,0,512,10,3385402715
19157,136531689,55745112,192276801,4,0,1,512,15,9050712635
19158,136532821,44315885,180848706,7,0,0,112640,10,4469470118
19159,136534820,44192174,180726994,0,0,0,43520,3,7090369906
19160,136546150,43879257,180425407,4,0,0,12800,15,1177695584
19161,136557040,44257323,180814363,9,0,0,81920,12,8992362667
19162,136560789,55716678,192277467,4,0,1,1024,15,7243952532
19163,136570411,44281952,180852363,7,0,0,2048,10,5134381468
19164,136571039,44277846,180848885,1,0,0,512,10,1395715376
19165,136571490,44217890,180789380,2,0,0,38400,3,3898132784
19166,136587200,44611643,181198843,2,0,0,72192,3,3032794350
19167,136597780,44745137,181342917,2,0,0,7680,3,6520709937
19168,136615739,55662074,192277813,4,0,1,512,15,7805734038
19169,136627341,44022348,180649689,7,0,0,10752,10,4560326282
19170,136651730,44443772,181095502,9,0,0,16384,12,9332409791
19171,136655650,43964821,180620471,0,0,0,122880,3,1351018198
19172,136658229,55622170,192280399,4,0,1,4096,15,9876826137
19173,136672151,44306409,180978560,7,0,0,74240,10,8730614672
19174,136679450,44193264,180872714,0,0,0,45568,3,7231701692
19175,136685590,44401262,181086852,4,0,0,16384,15,5717290815
19176,136690420,44486266,181176686,4,0,0,162304,15,6114381060
19177,136704370,44737404,181441774,0,0,0,1024,3,10242248011
19178,136710770,55571255,192282025,3,0,1,2560,17,6599261096
19179,136711079,55571100,192282179,4,0,1,8704,15,223094211
19180,136712560,44369098,181081658,4,0,0,8704,15,3319484655
19181,136716290,44057328,180773618,9,0,0,7680,12,2841612059
19182,136719470,44016775,180736245,2,0,0,2560,3,269116794
19183,136719640,44333823,181053463,9,0,0,245760,12,2487818800
19184,136719720,55563023,192282743,2,0,1,10752,3,9746663929
19185,136744279,55557161,192301440,4,0,1,17920,15,2825365933
19186,136756790,55549694,192306484,7,0,1,19968,10,5181555395
19187,136765420,44316417,181081837,0,0,0,512,3,38361571
19188,136765550,44761706,181527256,4,0,0,43520,15,5007950373
19189,136781860,44896230,181678090,9,0,0,134144,12,10307770460
19190,136793750,55516920,192310670,3,0,1,6656,17,8317669205
19191,136803161,44259708,181062869,7,0,0,30208,10,9208825078
19192,136813489,44412122,181225611,1,0,0,17408,10,10171807289
19193,136844879,55483468,192328347,4,0,1,15872,15,1708342471
19194,136846340,44940824,181787164,9,0,0,97792,12,4534507173
19195,136855781,44058339,180914120,7,0,0,24064,10,6687436255
19196,136865939,55465634,192331573,4,0,1,5120,15,10573403339
19197,136873670,43978046,180851716,4,0,0,9216,15,5483302631
19198,136883710,55451729,192335439,3,0,1,6144,17,10143684284
19199,136889240,44865020,181754260,9,0,0,156160,12,4468007400
19200,136899860,44179123,181078983,2,0,0,23040,3,455980759
19201,136905070,55432315,192337385,3,0,1,3072,17,951934263
19202,136908620,44163320,181071940,4,0,0,29696,15,5724173730
19203,136917011,44521208,181438219,7,0,0,20480,10,8827348960
19204,136945269,55392577,192337846,4,0,1,10240,15,3762434660
19205,136953920,44136551,181090471,9,0,0,11776,12,10407882089
19206,136958420,44503070,181461490,4,0,0,19456,15,3713789138
19207,136958550,55381882,192340432,3,0,1,4096,17,2104145029
19208,136966249,44322626,181288875,1,0,0,16896,10,3681552143
19209,136982660,55361954,192344614,1,0,1,1024,10,9955255893
19210,136987529,55359351,192346880,4,0,1,3584,15,2971420602
19211,136999180,44583483,181582663,0,0,0,512,3,273615847
19212,137015091,44835919,181851010,7,0,0,79360,10,6303550202
19213,137023540,44030102,181053642,0,0,0,512,3,7327527381
19214,137030730,44173284,181204014,9,0,0,16896,12,10682133659
19215,137031949,44867456,181899405,1,0,0,41984,10,8994267066
19216,137057569,44162715,181220284,1,0,0,53248,10,4446185774
19217,137057759,55292693,192350452,4,0,1,5632,15,7673512725
19218,137071370,55279748,192351118,7,0,1,1024,10,9532462633
19219,137074090,44315677,181389767,4,0,0,106496,15,1795859952
19220,137076760,44355196,181431956,9,0,0,78336,12,7786800007
19221,137088159,44188054,181276213,1,0,0,512,10,5320819414
19222,137127570,55224534,192352104,3,0,1,1536,17,7738725334
19223,137142850,44786934,181929784,9,0,0,34304,12,1851535360
19224,137148250,46004929,183153179,9,0,0,45568,12,183153700
19225,137154040,55199050,192353090,3,0,1,1536,17,27026755
19226,137162200,55192196,192354396,3,0,1,2048,17,1363941296
19227,137178920,44229122,181408042,9,0,0,59904,12,6224810551
19228,137179840,55176822,192356662,3,0,1,3584,17,1878207375
19229,137182399,46188638,183371037,1,0,0,299520,10,6064384424
19230,137195771,45132276,182328047,7,0,0,10752,10,5182659846
19231,137207690,44076014,181283704,2,0,0,3072,3,9939013497
19232,137250100,44058054,181308154,9,0,0,1536,12,6575222123
19233,137255160,44760487,182015647,0,0,0,512,3,10358151400
19234,137266060,44287519,181553579,0,0,0,2560,3,6636373539
19235,137272120,45401877,182673997,2,0,0,48640,3,2682124584
19236,137279450,44581746,181861196,2,0,0,33280,3,8479937870
19237,137286380,44266350,181552730,2,0,0,83456,3,9785352735
19238,137291340,44725373,182016713,0,0,0,1024,3,710425809
19239,137304719,45656290,182961009,1,0,0,48640,10,10017791947
19240,137310959,45762185,183073144,1,0,0,31232,10,3850530765
19241,137313510,44692691,182006201,9,0,0,29696,12,3859019013
19242,137331420,45194218,182525638,9,0,0,20480,12,4923681017
19243,137332581,44292331,181624912,7,0,0,31232,10,9331963369
19244,137336051,45191528,182527579,7,0,0,5632,10,1580091483
19245,137338251,45565524,182903775,7,0,0,134144,10,1826758184
19246,137365291,44592486,181957777,7,0,0,48640,10,6450385798
19247,137372881,44894950,182267831,7,0,0,3584,10,4069603711
19248,137378050,44540018,181918068,2,0,0,26624,3,6280166037
19249,137384580,44414429,181799009,9,0,0,4608,12,7185731526
19250,137392480,45408293,182800773,9,0,0,24064,12,2959289558
19251,137431479,44160481,181591960,1,0,0,2048,10,7057391208
19252,137436860,44525152,181962012,2,0,0,13824,3,3132593183
19253,137444670,46027939,183472609,9,0,0,13312,12,5610476083
19254,137468820,44623435,182092255,9,0,0,90624,12,110571730
19255,137518300,44715416,182233716,2,0,0,9728,3,9480540186
19256,137522450,45664424,183186874,9,0,0,5120,12,1325074168
19257,137548200,44865895,182414095,2,0,0,20480,3,2003813842
19258,137561170,44345653,181906823,9,0,0,9216,12,6982800666
19259,137561380,46471523,184032903,9,0,0,28672,12,7723221786
19260,137602111,44284144,181886255,7,0,0,62976,10,319251875
19261,137636329,44328630,181964959,1,0,0,512,10,9984326127
19262,137650260,45863715,183513975,9,0,0,91648,12,10545974578
19263,137654070,45909015,183563085,2,0,0,75264,3,1160334269
19264,137690491,44212993,181903484,7,0,0,13312,10,3440573059
19265,137704670,44281106,181985776,9,0,0,51712,12,5209366586
19266,137731019,44671793,182402812,1,0,0,48128,10,1883754970
19267,137759511,45928770,183688281,7,0,0,30208,10,9202974756
19268,137772470,44348853,182121323,2,0,0,24064,3,2417246822
19269,137781299,44449430,182230729,1,0,0,34816,10,9398962095
19270,137786109,44322393,182108502,1,0,0,53248,10,10507605598
19271,137793610,44594515,182388125,2,0,0,34304,3,10140430463
19272,137796500,43958095,181754595,0,0,0,1024,3,9992431403
19273,137798849,44476806,182275655,1,0,0,5632,10,1713795525
19274,137818229,45587445,183405674,1,0,0,51712,10,9487305389
19275,137818490,44584813,182403303,0,0,0,1536,3,8187636441
19276,137831780,44694037,182525817,0,0,0,512,3,7466311440
19277,137832210,44719783,182551993,9,0,0,23040,12,8608954040
19278,137843841,46071221,183915062,7,0,0,136704,10,6069188203
19279,137922781,44546204,182468985,7,0,0,74752,10,6895120409
19280,137935110,46002984,183938094,0,0,0,1536,3,4310923841
19281,137938361,44785760,182724121,7,0,0,11264,10,9784363993
19282,137964350,44678511,182642861,2,0,0,103424,3,7156614234
19283,137987171,44362830,182350001,7,0,0,28672,10,6114241058
19284,137992190,44850447,182842637,2,0,0,7680,3,787463215
19285,138005910,43880680,181886590,0,0,0,1024,3,10180166172
19286,138038869,44480506,182519375,1,0,0,112640,10,4828890112
19287,138049080,44503895,182552975,0,0,0,512,3,7808293515
19288,138065571,54291347,192356918,8,0,1,9216,8,2206438013
19289,138066351,54302686,192369037,8,0,1,16896,8,8601371631
19290,138078691,54302774,192381465,8,0,1,6144,8,2562366649
19291,138089081,54293737,192382818,8,0,1,11264,8,3277375686
19292,138115800,44429126,182544926,0,0,0,56832,3,9582249202
19293,138131011,44899255,183030266,7,0,0,13312,10,4293743547
19294,138142250,54241234,192383484,8,0,1,1024,8,8462158868
19295,138161131,54244436,192405567,8,0,1,3072,8,3601017965
19296,138163310,45318079,183481389,2,0,0,28160,3,4224115965
19297,138170810,44092665,182263475,9,0,0,24576,12,9467204173
19298,138171811,54234102,192405913,8,0,1,512,8,793819034
19299,138186111,45979914,184166025,7,0,0,76288,10,339882041
19300,138228370,44324426,182552796,2,0,0,2560,3,9986243004
19301,138231840,44705856,182937696,0,0,0,111104,3,4634296260
19302,138233030,44445358,182678388,2,0,0,14336,3,5697373560
19303,138246599,44432037,182678636,1,0,0,512,10,9778129113
19304,138264950,44473078,182738028,9,0,0,45568,12,4845190184
19305,138291180,44367951,182659131,2,0,0,25600,3,3664680851
19306,138295821,44314514,182610335,7,0,0,34304,10,10397582159
19307,138297670,44503282,182800952,9,0,0,512,12,1738033530
19308,138302601,54105898,192408499,8,0,1,4096,8,7613476452
19309,138313089,44133097,182446186,1,0,0,29696,10,1027641628
19310,138314991,54095774,192410765,8,0,1,3584,8,7823029076
19311,138315231,54097160,192412391,8,0,1,2560,8,6141029649
19312,138318571,54095766,192414337,8,0,1,3072,8,8799595502
19313,138319221,54095462,192414683,8,0,1,512,8,2218984660
19314,138320531,54094818,192415349,8,0,1,1024,8,10672282185
19315,138322810,54096085,192418895,2,0,1,5632,3,9452182353
19316,138357299,45951249,184308548,1,0,0,108544,10,2414319942
19317,138359290,44292018,182651308,9,0,0,27648,12,3281443301
19318,138364540,44622411,182986951,2,0,0,71680,3,3405260924
19319,138382511,54042516,192425027,8,0,1,9728,8,4284458672
19320,138388299,44576789,182965088,1,0,0,13312,10,9395980535
19321,138438570,44700702,183139272,2,0,0,45568,3,9490507637
19322,138441890,44379678,182821568,2,0,0,6144,3,3765955563
19323,138449580,44556429,183006009,2,0,0,14848,3,5330056963
19324,138450249,45316991,183767240,1,0,0,259072,10,248401456
19325,138463251,53962122,192425373,8,0,1,512,8,10614238810
19326,138472149,44517477,182989626,1,0,0,8704,10,5042861861
19327,138490260,44688232,183178492,9,0,0,59392,12,5221462783
19328,138517239,44322332,182839571,1,0,0,33280,10,2537164651
19329,138525381,53900351,192425732,8,0,1,9728,8,75419038
19330,138537581,53889777,192427358,8,0,1,2560,8,9009169159
19331,138552380,45843673,184396053,2,0,0,47616,3,5207460394
19332,138556331,53871373,192427704,8,0,1,512,8,2234668572
19333,138567110,53862220,192429330,7,0,1,2560,10,3201801063
19334,138577420,53853536,192430956,7,0,1,2560,10,4649934709
19335,138579660,53854522,192434182,7,0,1,5120,10,4111355118
19336,138589730,53849755,192439485,1,0,1,6656,10,3736152456
19337,138599710,53840121,192439831,2,0,1,512,3,4771913541
19338,138652559,45833596,184486155,1,0,0,61440,10,3171731706
19339,138669780,53770397,192440177,7,0,1,512,10,1553511862
19340,138672090,53770993,192443083,7,0,1,4608,10,7053537055
19341,138674700,44770384,183445084,2,0,0,17920,3,5986747144
19342,138692790,53751471,192444261,7,0,1,13824,10,5834819452
19343,138698231,53753242,192451473,8,0,1,5120,8,9350136669
19344,138723130,44651206,183374336,2,0,0,10752,3,10469320041
19345,138724890,53728849,192453739,7,0,1,3584,10,8926302726
19346,138729310,44660204,183389514,2,0,0,49664,3,2805480906
19347,138743751,53710244,192453995,8,0,1,9216,8,8540291498
19348,138779270,44218514,182997784,9,0,0,25600,12,8769222009
19349,138791689,45806528,184598217,1,0,0,39936,10,1085334551
19350,138792550,44646989,183439539,2,0,0,74240,3,8678637411
19351,138817240,44008487,182825727,9,0,0,1024,12,2708412506
19352,138828220,44350451,183178671,9,0,0,512,12,6450897856
19353,138833060,44407329,183240389,2,0,0,28160,3,8902991383
19354,138841440,44148521,182989961,9,0,0,1024,12,792429101
19355,138853060,45013097,183866157,2,0,0,121344,3,7887469115
19356,138853871,44971992,183825863,7,0,0,82944,10,5762833669
19357,138872811,44213253,183086064,7,0,0,32256,10,5904302178
19358,138887140,53570401,192457541,1,0,1,5632,10,5487958957
19359,138910291,44751084,183661375,7,0,0,33280,10,4924645730
19360,138912670,53548737,192461407,7,0,1,6144,10,9188279714
19361,138916550,45131669,184048219,2,0,0,35328,3,4196201825
19362,138928330,44102583,183030913,9,0,0,2048,12,10544308388
19363,138959960,44113363,183073323,9,0,0,512,12,5239748651
19364,138963460,44452431,183415891,2,0,0,14336,3,732366133
19365,138964790,53498243,192463033,7,0,1,2560,10,407743308
19366,138965490,53527575,192493065,9,0,1,48128,12,3539784376
19367,138978910,44645786,183624696,2,0,0,109056,3,8004476125
19368,138983820,53520963,192504783,1,0,1,6144,10,10050935542
19369,138987479,45804629,184792108,1,0,0,143872,10,4240160071
19370,138997030,53508739,192505769,1,0,1,1536,10,4162023217
19371,138997969,44391880,183389849,1,0,0,1024,10,6839185955
19372,139002010,53506665,192508675,7,0,1,4608,10,8054227525
19373,139008321,44459406,183467727,7,0,0,74240,10,3974239818
19374,139010720,53498941,192509661,1,0,1,1536,10,10458773267
19375,139010760,53502473,192513233,7,0,1,5632,10,6566891379
19376,139015779,44251227,183267006,1,0,0,25088,10,802800244
19377,139016089,44506581,183522670,1,0,0,27648,10,7225095545
19378,139041490,44481359,183522849,9,0,0,512,12,1406092427
19379,139046460,53468399,192514859,1,0,1,2560,10,3071308562
19380,139046700,53470425,192517125,7,0,1,3584,10,5914101926
19381,139054999,44527471,183582470,1,0,0,34816,10,5435754087
19382,139081349,44330143,183411492,1,0,0,18944,10,2632521435
19383,139083280,53435791,192519071,7,0,1,3072,10,6115396509
19384,139084020,53437317,192521337,1,0,1,3584,10,7411259801
19385,139088410,53433913,192522323,1,0,1,1536,10,3514355821
19386,139096460,45016488,184112948,2,0,0,39936,3,1386303725
19387,139120420,44296430,183416850,2,0,0,3072,3,4914696270
19388,139128390,53395239,192523629,7,0,1,2048,10,4637903765
19389,139132400,53391575,192523975,1,0,1,512,10,7423586668
19390,139138630,44329900,183468530,9,0,0,2560,12,327889641
19391,139141930,53382391,192524321,7,0,1,512,10,7449519794
19392,139145470,53383677,192529147,7,0,1,7680,10,3432021743
19393,139149109,44780047,183929156,1,0,0,22528,10,8132452086
19394,139169829,44603050,183772879,1,0,0,18432,10,7225954164
19395,139174080,44349744,183523824,2,0,0,3072,3,10156316229
19396,139188640,53343733,192532373,7,0,1,5120,10,1018340438
19397,139195280,44318943,183514223,9,0,0,512,12,2576042806
19398,139225061,45283581,184508642,7,0,0,73728,10,6079502314
19399,139226130,53308189,192534319,7,0,1,3072,10,1944711181
19400,139226439,44982976,184209415,1,0,0,68608,10,6214879183
19401,139230320,53305305,192535625,7,0,1,2048,10,39316835
19402,139252789,45684488,184937277,1,0,0,81408,10,375497661
19403,139255020,53282231,192537251,7,0,1,2560,10,452823205
19404,139260311,44568851,183829162,7,0,0,10752,10,2696157111
19405,139261110,53277127,192538237,7,0,1,1536,10,1369515884
19406,139306810,45552943,184859753,9,0,0,2048,12,9356498011
19407,139317380,45240500,184557880,9,0,0,512,12,4696637186
19408,139374700,53163883,192538583,6,0,1,512,7,9290728967
19409,139380129,45470813,184850942,1,0,0,126976,10,6432789227
19410,139428781,45642062,185070843,7,0,0,125440,10,2107842823
19411,139623500,43948339,183571839,9,0,0,2048,12,6842328391
19412,139643340,44294933,183938273,9,0,0,512,12,9482876242
19413,139708251,44342353,184050604,7,0,0,5120,10,7968507317
19414,139722750,44585977,184308727,9,0,0,512,12,7158425452
19415,139724900,44441483,184166383,9,0,0,512,12,8045158436
19416,139727230,44548200,184275430,9,0,0,1024,12,1902481288
19417,139734471,44966878,184701349,7,0,0,280064,10,370547947
19418,139736409,44136970,183873379,1,0,0,23040,10,5929481315
19419,139743310,44201435,183944745,9,0,0,512,12,6881317987
19420,139750060,44271827,184021887,9,0,0,512,12,10374699120
19421,139773370,43856711,183630081,9,0,0,512,12,5404492106
19422,139823621,44904481,184728102,7,0,0,81408,10,9225392027
19423,139853980,52687829,192541809,6,0,1,5120,7,1099074413
19424,139880071,44134146,184014217,7,0,0,512,10,2394303722
19425,139881819,44055784,183937603,1,0,0,27648,10,7231961392
19426,139886019,44036242,183922261,1,0,0,23552,10,5279937418
19427,139898430,52644365,192542795,2,0,1,1536,3,1838930649
19428,139903201,44067082,183970283,7,0,0,10240,10,7810609421
19429,139910990,52632151,192543141,6,0,1,512,7,4088937213
19430,139921679,45298024,185219703,1,0,0,82432,10,5525721657
19431,139987611,44352253,184339864,7,0,0,16896,10,6844023201
19432,139994860,44345339,184340199,9,0,0,1024,12,4487833095
19433,140001440,52543967,192545407,6,0,1,3584,7,1341277799
19434,140022280,43960686,183982966,9,0,0,1024,12,815850440
19435,140057250,43809086,183866336,9,0,0,512,12,8076339732
19436,140064360,52482353,192546713,6,0,1,2048,7,10696839498
19437,140071991,44203104,184275095,7,0,0,87552,10,6118643124
19438,140091290,52457369,192548659,6,0,1,3072,7,2074773791
19439,140096820,52459860,192556680,6,0,1,19968,7,7096233057
19440,140116679,43958505,184075184,1,0,0,11776,10,7571737318
19441,140117701,43895115,184012816,7,0,0,30208,10,6476369566
19442,140122779,44458773,184581552,1,0,0,46592,10,9534317181
19443,140143020,44023184,184166204,9,0,0,512,12,512227679
19444,140160809,44406524,184567333,1,0,0,1536,10,1520280592
19445,140181899,44152786,184334685,1,0,0,77824,10,1083383112
19446,140209031,44101903,184310934,7,0,0,7168,10,685162878
19447,140214240,52344386,192558626,2,0,1,3072,3,6138597871
19448,140222951,45095218,185318169,7,0,0,76800,10,7104628414
19449,140227341,44584703,184812044,7,0,0,63488,10,548270994
19450,140243840,52317372,192561212,6,0,1,4096,7,5865473116
19451,140246920,44211492,184458412,9,0,0,1024,12,4627883195
19452,140248510,43891005,184139515,9,0,0,512,12,6120542440
19453,140255990,43842362,184098352,9,0,0,512,12,5177629393
19454,140259690,52304748,192564438,6,0,1,5120,7,10427313000
19455,140261010,44194330,184455340,9,0,0,1024,12,5581140897
19456,140312251,44546520,184858771,7,0,0,24576,10,1347148050
19457,140333170,44183497,184516667,9,0,0,3072,12,4481121756
19458,140344370,52221054,192565424,2,0,1,1536,3,5862603120
19459,140346000,52224250,192570250,6,0,1,7680,7,8744337514
19460,140382420,43753034,184135454,9,0,0,1024,12,4031128955
19461,140418971,45004024,185422995,7,0,0,117248,10,114559850
19462,140422211,44326038,184748249,7,0,0,66048,10,2874972207
19463,140443820,52131922,192575742,6,0,1,8704,7,3762992719
19464,140448490,52129198,192577688,2,0,1,3072,3,2805323796
19465,140450700,52131174,192581874,6,0,1,6656,7,1849430329
19466,140460610,52126090,192586700,6,0,1,7680,7,95989732
19467,140463521,44151561,184615082,7,0,0,22016,10,9758506604
19468,140464351,44093235,184557586,7,0,0,134144,10,6563950648
19469,140465661,44050024,184515685,7,0,0,23040,10,3041274911
19470,140487360,52105376,192592736,6,0,1,2048,7,2895216800
19471,140494050,52108786,192602836,2,0,1,5120,3,7014963992
19472,140494580,52109242,192603822,2,0,1,1536,3,1096215788
19473,140512090,52098236,192610326,2,0,1,5632,3,9216213433
19474,140516490,52101201,192617691,6,0,1,1024,7,3880098882
19475,140525949,44438807,184964756,1,0,0,90112,10,10224067058
19476,140527760,52090597,192618357,2,0,1,1024,3,4258151051
19477,140529171,44174081,184703252,7,0,0,6144,10,4363285876
19478,140566060,52053168,192619228,2,0,1,12288,3,8851987103
19479,140607869,44464089,185071958,1,0,0,3584,10,9315356694
19480,140612460,52022540,192635000,6,0,1,14848,7,7523749007
19481,140681759,44306428,184988187,1,0,0,76800,10,7146443820
19482,140682270,51955342,192637612,2,0,1,14336,3,7758059143
19483,140690270,51956354,192646624,2,0,1,14336,3,6653921773
19484,140702810,51945760,192648570,6,0,1,3072,7,4208344329
19485,140706129,44315445,185021574,1,0,0,11264,10,8557650158
19486,140707769,44084854,184792623,1,0,0,1536,10,1287986538
19487,140720610,43894986,184615596,9,0,0,1536,12,1905817420
19488,140725090,51925106,192650196,2,0,1,2560,3,2301119415
19489,140727359,44547397,185274756,1,0,0,25088,10,9844924419
19490,140755661,44262458,185018119,7,0,0,89088,10,1991437937
19491,140757300,51893152,192650452,2,0,1,9216,3,8122559305
19492,140762400,51889601,192652001,2,0,1,1536,3,2198127085
19493,140779990,51875237,192655227,2,0,1,5120,3,5125300822
19494,140780440,44031783,184812223,9,0,0,512,12,10149349102
19495,140800840,51854733,192655573,6,0,1,512,7,5902727744
19496,140801000,51856839,192657839,6,0,1,3584,7,6417049710
19497,140807689,44060687,184868376,1,0,0,8704,10,8316673740
19498,140807800,44051306,184859106,9,0,0,1024,12,4404867792
19499,140835140,44016089,184851229,9,0,0,512,12,10129699524
19500,140852770,44169139,185021909,9,0,0,1024,12,4574232196
19501,140887800,51770295,192658095,2,0,1,9216,3,4611412286
19502,140900650,51785523,192686173,2,0,1,1536,3,9177043781
19503,140913180,51776219,192689399,2,0,1,5120,3,7313632113
19504,140920721,44186110,185106831,7,0,0,64512,10,7120303101
19505,140962730,51739023,192701753,2,0,1,7680,3,452470630
19506,140981950,51745661,192727611,6,0,1,25088,7,5447376694
19507,140988141,44557244,185545385,7,0,0,87552,10,10595099924
19508,141022389,43841599,184863988,1,0,0,13824,10,9505444336
19509,141038500,51698300,192736800,6,0,1,10752,7,8179683876
19510,141048390,51689076,192737466,2,0,1,1024,3,3408677575
19511,141076110,51662342,192738452,2,0,1,1536,3,3982895434
19512,141087550,51653168,192740718,6,0,1,3584,7,989743366
19513,141138010,51609642,192747652,6,0,1,20480,7,10586656562
19514,141149540,51602298,192751838,6,0,1,6656,7,7187088611
19515,141155730,51597734,192753464,2,0,1,2560,3,6491652842
19516,141174309,44344377,185518686,1,0,0,44544,10,6247600369
19517,141208060,51559788,192767848,2,0,1,4096,3,701845437
19518,141220869,43866244,185087113,1,0,0,49664,10,9824138647
19519,141326610,51452340,192778950,2,0,1,4608,3,9029355187
19520,141341691,43925398,185267089,7,0,0,74752,10,7808783237
19521,141363499,44498470,185861969,1,0,0,15360,10,7666193667
19522,141377701,43783278,185160979,7,0,0,3072,10,8632912567
19523,141419551,43925519,185345070,7,0,0,14848,10,2657464299
19524,141423989,44045526,185469515,1,0,0,83968,10,9266248355
19525,141430719,44304512,185735231,1,0,0,18944,10,9863363056
19526,141486140,51296356,192782496,2,0,1,5632,3,2087929066
19527,141490850,51301261,192792111,9,0,1,33280,12,8598426727
19528,141497300,51299957,192797257,2,0,1,8192,3,5120653440
19529,141521319,44546663,186067982,1,0,0,73216,10,3383399138
19530,141526710,51270893,192797603,2,0,1,512,3,6732118369
19531,141536940,51268758,192805698,2,0,1,14848,3,7174156199
19532,141540520,51266164,192806684,2,0,1,1536,3,10116427663
19533,141542600,51279147,192821747,9,0,1,55808,12,7896698187
19534,141557571,44137951,185695522,7,0,0,11776,10,9942700074
19535,141561191,44629341,186190532,7,0,0,60928,10,7054843130
19536,141583230,51258250,192841480,9,0,1,512,12,5188541967
19537,141602890,51240216,192843106,2,0,1,2560,3,1586182578
19538,141608820,51234632,192843452,2,0,1,512,3,1072323531
19539,141656080,51189958,192846038,2,0,1,4096,3,1707173385
19540,141659451,43690524,185349975,7,0,0,5120,10,3743045816
19541,141668701,43929118,185597819,7,0,0,13824,10,5483707654
19542,141674980,51173324,192848304,9,0,1,3584,12,5793015315
19543,141706659,44605151,186311810,1,0,0,39424,10,9713846723
19544,141709691,43618641,185328332,7,0,0,33280,10,10248105317
19545,141730539,43617853,185348392,1,0,0,8704,10,7160548098
19546,141734489,43606034,185340523,1,0,0,39936,10,5401020161
19547,141747930,51101040,192848970,2,0,1,1024,3,6592054228
19548,141757270,51092161,192849431,2,0,1,10240,3,8207226334
19549,141759350,51187642,192946992,9,0,1,119808,12,7692843988
19550,141769180,51193483,192962663,9,0,1,32768,12,5172769706
19551,141779660,51196270,192975930,7,0,1,2048,10,7575534727
19552,141785881,43559836,185345717,7,0,0,2048,10,6717849251
19553,141815189,43734743,185549932,1,0,0,14848,10,1181431013
19554,141825231,43767308,185592539,7,0,0,1536,10,4775798003
19555,141838491,43522024,185360515,7,0,0,1024,10,5252301446
19556,141844200,51140408,192984608,2,0,1,7168,3,3395108254
19557,141844786,43626739,185471525,7,0,0,512,10,6398895088
19558,141849260,51136014,192985274,2,0,1,1024,3,1019193792
19559,141866599,43604678,185471277,1,0,0,5632,10,1685724711
19560,141939140,51046288,192985428,2,0,1,8704,3,2069658626
19561,141963740,51042183,193005923,2,0,1,7680,3,2724475247
19562,141986129,44414284,186400413,1,0,0,20480,10,1119174140
19563,141993821,43625209,185619030,7,0,0,512,10,362759116
19564,142035680,50978046,193013726,2,0,1,6144,3,4917792948
19565,142057691,43661608,185719299,7,0,0,1024,10,6491904847
19566,142062199,44452906,186515105,1,0,0,67072,10,8361998796
19567,142069660,50946332,193015992,6,0,1,3584,7,7869927013
19568,142103871,43371434,185475305,7,0,0,1024,10,9501337584
19569,142105319,43709470,185814789,1,0,0,81408,10,7510630188
19570,142121171,43497666,185618837,7,0,0,1024,10,2158061542
19571,142121960,50899524,193021484,2,0,1,8704,3,4790016180
19572,142141129,43699687,185840816,1,0,0,36352,10,6400243423
19573,142179841,43563598,185743439,7,0,0,512,10,5189857759
19574,142265211,43356854,185622065,7,0,0,1536,10,5035422974
19575,142290649,43533367,185824016,1,0,0,30208,10,10129494988
19576,142329821,44301392,186631213,7,0,0,1024,10,4105698307
19577,142332119,43588822,185920941,1,0,0,4096,10,4427043397
19578,142361689,43426211,185787900,1,0,0,6144,10,4967536006
19579,142401029,43593367,185994396,1,0,0,47104,10,2060272842
19580,142409900,50611930,193021830,6,0,1,512,7,7860669697
19581,142428149,44369283,186797432,1,0,0,216576,10,3406838117
19582,142447101,43319323,185766424,7,0,0,1024,10,1021076897
19583,142597221,43123458,185720679,7,0,0,512,10,7278320724
19584,142650901,43539810,186190711,7,0,0,512,10,4781331437
19585,142668250,50353926,193022176,2,0,1,512,3,2690757249
19586,142684951,42928773,185613724,7,0,0,1536,10,8701535572
19587,142715771,42979930,185695701,7,0,0,512,10,1942303559
19588,142817719,43256260,186073979,1,0,0,7680,10,6051139796
19589,142829219,43150802,185980021,1,0,0,90112,10,3058200461
19590,142851039,42975340,185826379,1,0,0,7680,10,9382606156
19591,142863870,43939736,186803606,6,0,0,18944,7,6103138561
19592,142872600,43062463,185935063,6,0,0,23040,7,5634801039
19593,142900480,50122682,193023162,6,0,1,1536,7,1766001441
19594,142925959,43081564,186007523,1,0,0,43008,10,4403712301
19595,142944060,43939590,186883650,6,0,0,36352,7,4929483724
19596,142969840,50054705,193024545,1,0,1,14848,10,4822253236
19597,143007880,43136441,186144321,6,0,0,29696,7,10513971312
19598,143026439,43267444,186293883,1,0,0,22016,10,2555300792
19599,143041710,43071788,186113498,6,0,0,30720,7,8159270574
19600,143050220,49980322,193030542,1,0,1,4608,10,5597547937
19601,143053220,49990800,193044020,1,0,1,12800,10,2364427213
19602,143074379,43456973,186531352,1,0,0,53248,10,3580970462
19603,143081490,49964156,193045646,1,0,1,2560,10,9258778318
19604,143156809,43886483,187043292,1,0,0,171008,10,754577772
19605,143173020,49875257,193048277,1,0,1,10240,10,585927676
19606,143211060,49843954,193055014,1,0,1,512,10,8335614741
19607,143271390,43081116,186352506,6,0,0,2048,7,9056602846
19608,143299429,42791666,186091095,1,0,0,39936,10,7297144646
19609,143301800,43778610,187080410,6,0,0,25600,7,10497637129
19610,143309540,42762053,186071593,6,0,0,11776,7,1272684525
19611,143312410,49743910,193056320,6,0,1,2048,7,5936309700
19612,143316680,49796590,193113270,9,0,1,83968,12,1318071073
19613,143316689,42913151,186229840,1,0,0,23040,10,10044134708
19614,143341220,49778640,193119860,9,0,1,15360,12,2817765155
19615,143358530,49761676,193120206,6,0,1,512,7,3463273752
19616,143361330,49795421,193156751,9,0,1,49152,12,7809852325
19617,143377180,43007587,186384767,6,0,0,90624,7,5493937628
19618,143386860,49779315,193166175,9,0,1,38400,12,9046606214
19619,143390990,49783365,193174355,6,0,1,15360,7,9803514292
19620,143401739,42992411,186394150,1,0,0,30720,10,336994000
19621,143403660,49779107,193182767,6,0,1,2560,7,6731564479
19622,143460420,49740062,193200482,9,0,1,5120,12,10421213168
19623,143461860,49740568,193202428,6,0,1,3072,7,9976804852
19624,143464289,43240786,186705075,1,0,0,47104,10,4509065102
19625,143492140,42835996,186328136,6,0,0,34816,7,2885691936
19626,143494350,49714354,193208704,6,0,1,14336,7,2193705024
19627,143496210,49730932,193227142,6,0,1,5120,7,10727191284
19628,143527880,49703760,193231640,6,0,1,1536,7,2998347606
19629,143531030,49702236,193233266,6,0,1,2560,7,7214697697
19630,143533199,42753953,186287152,1,0,0,72704,10,8712335136
19631,143549629,43127765,186677394,1,0,0,64000,10,822464649
19632,143571270,49685348,193256618,9,0,1,36352,12,3745160391
19633,143592760,49713793,193306553,9,0,1,89088,12,5007322110
19634,143609740,43119076,186728816,6,0,0,7168,7,10062097911
19635,143623770,49702010,193325780,9,0,1,27648,12,2356024979
19636,143650860,49707817,193358677,9,0,1,40960,12,10447637473
19637,143651030,42893535,186544565,6,0,0,27648,7,3793051652
19638,143663660,49697695,193361355,6,0,1,1024,7,3150952234
19639,143678530,49683171,193361701,6,0,1,512,7,974097101
19640,143696500,43025618,186722118,6,0,0,55808,7,4989256454
19641,143722490,49639877,193362367,2,0,1,1024,3,8278898568
19642,143734739,42811409,186546148,1,0,0,5120,10,1090046403
19643,143739330,49624663,193363993,6,0,1,2560,7,8773662322
19644,143757530,49650047,193407577,9,0,1,109056,12,7687975109
19645,143788759,42901941,186690700,1,0,0,43520,10,10152425476
19646,143812770,49602885,193415655,2,0,1,4096,3,1656830895
19647,143815180,49601781,193416961,6,0,1,2048,7,7421834545
19648,143837650,49583497,193421147,2,0,1,6656,3,2244620223
19649,143839150,49584583,193423733,2,0,1,4096,3,5476433181
19650,143840010,42886599,186726609,6,0,0,14336,7,5450551094
19651,143843480,49644275,193487755,9,0,1,93184,12,7955620478
19652,143844610,49646322,193490932,2,0,1,2048,3,10571951421
19653,143849540,43294926,187144466,6,0,0,155648,7,10728426972
19654,143864030,49629168,193493198,6,0,1,3584,7,4333510097
19655,143876090,49653857,193529947,9,0,1,32768,12,1218449899
19656,143927960,49603613,193531573,2,0,1,2560,3,9137033161
19657,143969639,42883505,186853144,1,0,0,45568,10,469663026
19658,143983579,43086724,187070303,1,0,0,88576,10,1840185387
19659,143995999,43155748,187151747,1,0,0,12800,10,8872524890
19660,144046889,43025488,187072377,1,0,0,6656,10,872596790
19661,144094629,42758694,186853323,1,0,0,512,10,8225863055
19662,144097079,42714073,186811152,1,0,0,1024,10,6498710510
19663,144101400,49430839,193532239,1,0,1,1024,10,6148803088
19664,144148509,43168513,187317022,1,0,0,1536,10,2379269486
19665,144168110,49364475,193532585,2,0,1,512,3,9691471438
19666,144185100,49348151,193533251,2,0,1,1024,3,7802431036
19667,144191430,43169568,187360998,6,0,0,117248,7,3426585354
19668,144229830,49306327,193536157,2,0,1,4608,3,4345020779
19669,144233410,49303208,193536618,1,0,1,10240,10,1381962819
19670,144244530,49296205,193540735,2,0,1,4608,3,6568348984
19671,144261619,43109744,187371363,1,0,0,3584,10,9780522587
19672,144265050,49276031,193541081,2,0,1,512,3,7888058568
19673,144279390,49262037,193541427,2,0,1,512,3,7870021025
19674,144339110,43090996,187430106,6,0,0,61952,7,3870850772
19675,144350909,42721647,187072556,1,0,0,512,10,3581877627
19676,144429300,42802177,187231477,6,0,0,41472,7,6012019037
19677,144432969,42731453,187164422,1,0,0,512,10,141321281
19678,144477960,42757072,187235032,6,0,0,10752,7,9860151256
19679,144487800,42481538,186969338,6,0,0,8704,7,2530004392
19680,144487970,49055083,193543053,2,0,1,2560,3,9295477017
19681,144512260,42706558,187218818,6,0,0,37888,7,9183280397
19682,144524330,49019069,193543399,2,0,1,512,3,4088295117
19683,144550420,42650185,187200605,6,0,0,37888,7,2206547376
19684,144564350,48979715,193544065,2,0,1,1024,3,1187902142
19685,144630890,48916401,193547291,2,0,1,5120,3,7207683857
19686,144634770,42526325,187161095,6,0,0,8192,7,5104885589
19687,144637230,48912007,193549237,2,0,1,3072,3,6038817162
19688,144637380,42822641,187460021,6,0,0,37376,7,2899978600
19689,144707800,48846263,193554063,2,0,1,7680,3,9758018123
19690,144715079,42526064,187241143,1,0,0,512,10,4908058612
19691,144715160,48848109,193563269,2,0,1,4096,3,5852256811
19692,144715600,48848015,193563615,2,0,1,512,3,3522926044
19693,144727330,42474546,187201876,6,0,0,4096,7,10224831462
19694,144727900,48837200,193565100,9,0,1,15360,12,2575959421
19695,144755210,42615038,187370248,6,0,0,29184,7,9090381109
19696,144762660,48813947,193576607,9,0,1,10752,12,6077796456
19697,144789289,42442436,187231725,1,0,0,512,10,7853064130
19698,144824630,48754126,193578756,2,0,1,2048,3,1102928870
19699,144831030,48749469,193580499,2,0,1,11264,3,4739899884
19700,144864260,48716585,193580845,2,0,1,512,3,9681902749
19701,144874520,42717273,187591793,6,0,0,76288,7,2047021269
19702,144875910,42499527,187375437,6,0,0,11264,7,7496933590
19703,144883750,48698721,193582471,2,0,1,2560,3,9540361554
19704,144898229,42500854,187399083,1,0,0,2048,10,310102981
19705,144917680,48666097,193583777,2,0,1,2048,3,7094855862
19706,144942240,48644763,193587003,2,0,1,5120,3,9115833055
19707,144949609,42510903,187460512,1,0,0,1536,10,9997176854
19708,144955170,48632499,193587669,2,0,1,1024,3,135408997
19709,145005679,42299203,187304882,1,0,0,512,10,5971582541
19710,145027150,48561185,193588335,2,0,1,1024,3,5361979680
19711,145038320,42356064,187394384,6,0,0,15872,7,1104052266
19712,145049789,42214892,187264681,1,0,0,1024,10,2082141932
19713,145124369,42306274,187430643,1,0,0,1536,10,5162381830
19714,145133019,42169152,187302171,1,0,0,512,10,4798068872
19715,145162369,42198964,187361333,1,0,0,1024,10,3854338958
19716,145168740,42225823,187394563,6,0,0,512,7,383620495
19717,145174780,48413901,193588681,1,0,1,512,10,1404004720
19718,145175300,42256637,187431937,6,0,0,4096,7,9789068177
19719,145212100,42266513,187478613,6,0,0,2048,7,3204874033
19720,145212410,48376937,193589347,1,0,1,1024,10,4384746780
19721,145300490,48289523,193590013,1,0,1,1024,10,714030999
19722,145321590,42141187,187462777,6,0,0,512,7,858853643
19723,145325570,48266389,193591959,2,0,1,3072,3,2841232082
19724,145350979,42191507,187542486,1,0,0,512,10,1864069534
19725,145377910,48217595,193595505,1,0,1,5632,10,4779208154
19726,145392560,48204891,193597451,6,0,1,3072,7,8028024680
19727,145408240,48190287,193598527,2,0,1,13312,3,8003614493
19728,145413540,48193970,193607510,1,0,1,8704,10,8807218265
19729,145413779,42085085,187498864,1,0,0,2048,10,9880213067
19730,145439200,42022353,187461553,6,0,0,1536,7,7623184134
19731,145442410,48171046,193613456,2,0,1,512,3,1851875143
19732,145451060,48162742,193613802,2,0,1,512,3,6364520399
19733,145468299,42016458,187484757,1,0,0,2048,10,5810732336
19734,145472390,48141758,193614148,6,0,1,512,7,252306173
19735,145515180,48099314,193614494,1,0,1,512,10,7977508778
19736,145516750,48099690,193616440,2,0,1,3072,3,3409055687
19737,145517089,42119945,187637034,1,0,0,1536,10,1446068466
19738,145534930,48081856,193616786,1,0,1,512,10,7819620689
19739,145541230,48076542,193617772,2,0,1,1536,3,6290041952
19740,145546540,42078908,187625448,6,0,0,3072,7,3997106081
19741,145556399,42151108,187707507,1,0,0,2048,10,8699314721
19742,145560640,48057798,193618438,1,0,1,1024,10,3262778338
19743,145570310,48051674,193621984,6,0,1,5632,7,6107907278
19744,145574640,42051143,187625783,6,0,0,1024,7,7667242545
19745,145591300,48031990,193623290,6,0,1,2048,7,9174738179
19746,145591510,48034366,193625876,1,0,1,4096,10,2467111674
19747,145592550,48036232,193628782,2,0,1,4608,3,7475293774
19748,145595870,48034538,193630408,6,0,1,2560,7,5430531731
19749,145597680,48034674,193632354,6,0,1,3072,7,4501531757
19750,145609610,48023410,193633020,6,0,1,1024,7,1778595584
19751,145616300,48019306,193635606,1,0,1,4096,10,2636855819
19752,145623039,42076439,187699478,1,0,0,8704,10,5004478616
19753,145625640,48014472,193640112,2,0,1,7168,3,7739922174
19754,145642540,41979669,187622209,6,0,0,512,7,4971778583
19755,145651359,41978503,187629862,1,0,0,13312,10,2170217879
19756,145673880,41975100,187648980,6,0,0,512,7,2800448966
19757,145674800,47965658,193640458,2,0,1,512,3,2854449545
19758,145683209,42111660,187794869,1,0,0,4096,10,9164580117
19759,145683409,42178429,187861838,1,0,0,6656,10,2625390374
19760,145691100,47949512,193640612,2,0,1,8704,3,7131166468
19761,145706890,47935348,193642238,2,0,1,2560,3,2681657918
19762,145711870,47931994,193643864,1,0,1,2560,10,7351253451
19763,145719540,47924580,193644120,2,0,1,9216,3,10204659890
19764,145727729,42251597,187979326,1,0,0,69632,10,2667989273
19765,145755350,47892636,193647986,1,0,1,6144,10,7470232949
19766,145755450,42168244,187923694,6,0,0,512,7,5691957152
19767,145760920,47890612,193651532,6,0,1,5632,7,1278781197
19768,145778850,42022748,187801598,6,0,0,1536,7,5903679673
19769,145779550,47874082,193653632,2,0,1,11776,3,6861502316
19770,145783910,47872308,193656218,2,0,1,4096,3,5363863364
19771,145807749,42299963,188107712,1,0,0,10752,10,8170290669
19772,145816239,42265251,188081490,1,0,0,25088,10,4425517950
19773,145825889,42110709,187936598,1,0,0,1536,10,8741097724
19774,145826270,47834454,193660724,6,0,1,7168,7,925889253
19775,145828260,47832810,193661070,6,0,1,512,7,7605761483
19776,145837040,42095085,187932125,6,0,0,1536,7,9516129988
19777,145847239,42110825,187958064,1,0,0,36864,10,3067227877
19778,145896220,47766502,193662722,1,0,1,2560,10,2544145694
19779,145908590,47758101,193666691,1,0,1,18944,10,3190054114
19780,145917540,47749497,193667037,1,0,1,512,10,10532438415
19781,145920490,42022873,187943363,6,0,0,1024,7,710975843
19782,145953390,47715593,193668983,1,0,1,3072,10,7181392019
19783,145999830,47670139,193669969,1,0,1,1536,10,5108468298
19784,146008980,42171925,188180905,6,0,0,1024,7,8007238197
19785,146015240,47656675,193671915,6,0,1,3072,7,5207291030
19786,146018409,42438877,188457286,1,0,0,125952,10,10166003947
19787,146023010,47649571,193672581,6,0,1,1024,7,8798816012
19788,146043870,47629697,193673567,6,0,1,1536,7,7478265609
19789,146060770,47615703,193676473,1,0,1,4608,10,6366743945
19790,146071030,42106039,188177069,9,0,0,1536,12,1877677916
19791,146105559,42071019,188176578,1,0,0,19968,10,3085741629
19792,146106460,42278417,188384877,9,0,0,512,12,9416968444
19793,146128800,47548019,193676819,6,0,1,512,7,6231309703
19794,146143980,47536065,193680045,1,0,1,5120,10,2773039271
19795,146148550,47534401,193682951,6,0,1,4608,7,433393459
19796,146157460,47525837,193683297,6,0,1,512,7,9684028198
19797,146157480,47526483,193683963,6,0,1,11264,7,159010910
19798,146160830,47527025,193687855,6,0,1,6144,7,3437367099
19799,146204940,47488304,193693244,1,0,1,17408,10,9668893651
19800,146217410,42255210,188472620,6,0,0,1536,7,2436711670
19801,146226649,42103827,188330476,1,0,0,3584,10,2786955314
19802,146230460,42243119,188473579,6,0,0,3072,7,8049452327
19803,146233570,42258417,188491987,6,0,0,512,7,99830264
19804,146273850,47441122,193714972,1,0,1,8704,10,2238290168
19805,146277259,42194870,188472129,1,0,0,48640,10,7499395487
19806,146278480,47437158,193715638,6,0,1,1024,7,4306072377
19807,146282870,47434714,193717584,6,0,1,3072,7,2196570685
19808,146321990,47397220,193719210,1,0,1,2560,10,10272097733
19809,146335730,47383826,193719556,6,0,1,512,7,3706230786
19810,146362019,42161714,188523733,1,0,0,14336,10,3721559130
19811,146363920,42112981,188476901,9,0,0,1024,12,5211985905
19812,146369350,47353112,193722462,1,0,1,4608,10,6656774415
19813,146410330,47315678,193726008,6,0,1,5632,7,3754864233
19814,146413890,47337879,193751769,1,0,1,1536,10,9627831476
19815,146417180,41975590,188392770,9,0,0,512,12,8035259352
19816,146429240,47328226,193757466,6,0,1,27136,7,5314365094
19817,146435519,42156408,188591927,1,0,0,23552,10,2725279463
19818,146436809,42311596,188748405,1,0,0,53760,10,10377727929
19819,146452560,42150422,188602982,9,0,0,1024,12,640193687
19820,146483379,41993187,188476566,1,0,0,9728,10,3289821833
19821,146483700,47290642,193774342,1,0,1,512,10,5003942133
19822,146504030,47270978,193775008,1,0,1,1024,10,1387154171
19823,146504290,42182668,188686958,6,0,0,512,7,9643375065
19824,146507070,42037204,188544274,6,0,0,512,7,989197680
19825,146529710,42085843,188615553,6,0,0,1024,7,2364879566
19826,146531769,42155010,188686779,1,0,0,16896,10,7182145215
19827,146548540,47227774,193776314,1,0,1,2048,10,8000985081
19828,146557160,42256773,188813933,6,0,0,1536,7,3517483839
19829,146557410,47219570,193776980,1,0,1,1024,10,5428556625
19830,146561900,42214423,188776323,9,0,0,1536,12,868618655
19831,146567689,42121164,188688853,1,0,0,6144,10,2375149690
19832,146573119,42229364,188802483,1,0,0,48640,10,461194473
19833,146584170,42143098,188727268,6,0,0,1024,7,10341471497
19834,146597490,42105031,188702521,9,0,0,2560,12,3317095216
19835,146597820,42057881,188655701,6,0,0,512,7,7954096014
19836,146614030,42454269,189068299,6,0,0,1024,7,6754031688
19837,146636110,47152225,193788335,6,0,1,12288,7,4098660882
19838,146637370,47154191,193791561,6,0,1,5120,7,9100246009
19839,146705040,42141459,188846499,6,0,0,512,7,1752316263
19840,146746390,42002662,188749052,6,0,0,2048,7,2402298069
19841,146758079,41973501,188731580,1,0,0,11776,10,3162785614
19842,146779080,42028865,188807945,9,0,0,2048,12,4185581125
19843,146788740,47008953,193797693,6,0,1,9728,7,2981209169
19844,146801770,46996269,193798039,6,0,1,512,7,8326082588
19845,146818700,46979800,193798500,6,0,1,10240,7,8198224383
19846,146824860,42324277,189149137,9,0,0,3072,12,6044972093
19847,146841290,46968762,193810052,6,0,1,3072,7,9143281986
19848,146860650,42097189,188957839,9,0,0,1024,12,8842940094
19849,146872470,46938658,193811128,6,0,1,13312,7,5423819043
19850,146873090,46986059,193859149,6,0,1,19968,7,2953407199
19851,146875560,46985855,193861415,6,0,1,3584,7,65399909
19852,146910300,41854178,188764478,9,0,0,512,12,997800657
19853,146911730,42094885,189006615,9,0,0,512,12,3264858041
19854,146912339,42318898,189231237,1,0,0,3072,10,7499754775
19855,146916290,42018791,188935081,9,0,0,3072,12,1513847507
19856,146932630,42351849,189284479,9,0,0,512,12,823358186
19857,146939029,41979707,188918736,1,0,0,3584,10,7020250912
19858,146948310,46917611,193865921,6,0,1,7168,7,9529424470
19859,146952600,46916983,193869583,6,0,1,17408,7,6494546869
19860,146984490,41934425,188918915,9,0,0,512,12,9040029331
19861,146986340,46883909,193870249,6,0,1,1024,7,3709909205
19862,146987909,42018527,189006436,1,0,0,21504,10,2292810870
19863,146994620,41826760,188821380,6,0,0,1536,7,9246360289
19864,147017410,46853825,193871235,6,0,1,1536,7,1868533887
19865,147061639,41986610,189048249,1,0,0,98304,10,5406349730
19866,147061850,46809731,193871581,6,0,1,512,7,1122449248
19867,147078840,42184001,189262841,6,0,0,512,7,3407709015
19868,147085960,41962468,189048428,9,0,0,512,12,4932436938
19869,147091510,42053237,189144747,6,0,0,512,7,6138313179
19870,147107610,41941153,189048763,9,0,0,1024,12,3176166038
19871,147119720,41755654,188875374,9,0,0,512,12,1332222330
19872,147189559,41988538,189178097,1,0,0,84480,10,1211961985
19873,147201189,42061473,189262662,1,0,0,86016,10,10200867230
19874,147239829,41776396,189016225,1,0,0,7680,10,1961851462
19875,147292160,41848307,189140467,9,0,0,1024,12,5546120961
19876,147296940,41785020,189081960,9,0,0,1536,12,8616627306
19877,147312089,41920731,189232820,1,0,0,5120,10,6526927566
19878,147402439,42623900,190026339,1,0,0,35328,10,4769418567
19879,147468719,41587243,189055962,1,0,0,23552,10,1045700869
19880,147504140,41761266,189265406,9,0,0,1024,12,6013837674
19881,147506240,41640404,189146644,9,0,0,512,12,7750911664
19882,147520360,46363716,193884076,9,0,1,35328,12,753560150
19883,147527689,41702067,189229756,1,0,0,169472,10,21414732
19884,147531530,41618363,189149893,9,0,0,512,12,8168658493
19885,147546530,46369703,193916233,9,0,1,44032,12,1155453694
19886,147562200,41386791,188948991,9,0,0,512,12,9993748157
19887,147566720,46362568,193929288,9,0,1,11264,12,9501427037
19888,147569809,41660469,189230278,1,0,0,512,10,7228234553
19889,147594179,42318058,189912237,1,0,0,14848,10,928773945
19890,147603410,46351950,193955360,9,0,1,30208,12,9828405282
19891,147606669,42057130,189663799,1,0,0,57344,10,5595319345
19892,147611769,41624662,189236431,1,0,0,11776,10,2535132388
19893,147647369,42532180,190179549,1,0,0,43008,10,10085747747
19894,147710369,41554702,189265071,1,0,0,7168,10,1536324550
19895,147720110,46235596,193955706,9,0,1,512,12,5876011562
19896,147729080,46230647,193959727,9,0,1,28672,12,138772228
19897,147732540,41497551,189230091,9,0,0,1024,12,2278914461
19898,147738439,41621281,189359720,1,0,0,18432,10,1824895575
19899,147742230,41800880,189543110,9,0,0,1024,12,9715543673
19900,147758649,42534714,190293363,1,0,0,2048,10,3418251333
19901,147766990,41721377,189488367,9,0,0,512,12,9515135551
19902,147768349,41749246,189517595,1,0,0,70656,10,9571417098
19903,147791439,41536047,189327486,1,0,0,26112,10,4627838760
19904,147805639,42709051,190514690,1,0,0,37888,10,10532795405
19905,147827640,41690446,189518086,9,0,0,1536,12,5946414143
19906,147838209,41698140,189536349,1,0,0,5632,10,176967763
19907,147838710,46225579,194064289,9,0,1,117248,12,6341989315
19908,147845900,41697885,189543785,9,0,0,1536,12,2015794187
19909,147855539,41790765,189646304,1,0,0,23552,10,5275441712
19910,147873809,41536400,189410209,1,0,0,7680,10,274287773
19911,147918779,41705085,189623864,1,0,0,20480,10,8764442380
19912,147947179,42613528,190560707,1,0,0,9216,10,5901040970
19913,148002010,46064545,194066555,1,0,1,3584,10,1979916270
19914,148017010,46049891,194066901,1,0,1,512,10,5551885762
19915,148034189,41634313,189668502,1,0,0,15360,10,8434997974
19916,148085500,45983667,194069167,1,0,1,3584,10,229552109
19917,148137109,41763783,189900892,1,0,0,24064,10,5761105975
19918,148202069,41613641,189815710,1,0,0,12800,10,4257183825
19919,148213040,45859033,194072073,1,0,1,4608,10,9763402256
19920,148225539,41568563,189794102,1,0,0,56832,10,3922008223
19921,148234899,41372501,189607400,1,0,0,44544,10,5843012202
19922,148255190,45817549,194072739,1,0,1,1024,10,9679266521
19923,148261200,45822335,194083535,1,0,1,18432,10,8950774626
19924,148317869,41486146,189804015,1,0,0,3584,10,2670215997
19925,148325530,45758671,194084201,1,0,1,1024,10,2121415628
19926,148341450,45743097,194084547,1,0,1,512,10,103563668
19927,148372940,45714193,194087133,1,0,1,4096,10,10593491902
19928,148390360,45701698,194092058,1,0,1,512,10,9946448121
19929,148461109,41547287,190008396,1,0,0,21504,10,7598734390
19930,148471960,45623990,194095950,1,0,1,6144,10,10428483344
19931,148486600,45612896,194099496,1,0,1,5632,10,9063765325
19932,148487900,45617318,194105218,1,0,1,5632,10,4758225900
19933,148511889,41253946,189765835,1,0,0,18432,10,343949593
19934,148559460,45547029,194106489,1,0,1,11776,10,1091260401
19935,148564030,45548982,194113012,1,0,1,10752,10,537373474
19936,148601879,41399942,190001821,1,0,0,73728,10,10492518571
19937,148663639,41303503,189967142,1,0,0,53760,10,7094484359
19938,148707739,42124857,190832596,1,0,0,257024,10,8122872138
19939,148708499,41411288,190119787,1,0,0,1024,10,9223884086
19940,148746779,41645947,190392726,1,0,0,11264,10,5800090396
19941,148754519,40949686,189704205,1,0,0,3584,10,8229529778
19942,148782009,41408995,190191004,1,0,0,33280,10,1696838825
19943,148825489,41719341,190544830,1,0,0,23040,10,1395104277
19944,148979199,41221032,190200231,1,0,0,30208,10,5649039859
19945,149131069,41861414,190992483,1,0,0,10752,10,2023381051
19946,149236239,40975247,190211486,1,0,0,36864,10,4600287362
19947,149246159,40966606,190212765,1,0,0,4096,10,5623816999
19948,149368089,41326858,190694947,1,0,0,512,10,5544594358
19949,149381219,40968753,190349972,1,0,0,22528,10,4358813565
19950,149420139,40733627,190153766,1,0,0,33792,10,453047733
19951,149509189,40828569,190337758,1,0,0,105472,10,7211534136
19952,149513809,40773450,190287259,1,0,0,29696,10,438084982
19953,149532279,41360125,190892404,1,0,0,35328,10,194680578
19954,149544789,41396080,190940869,1,0,0,58368,10,5147324752
19955,149551719,41057387,190609106,1,0,0,91648,10,3261965511
19956,149562219,40715969,190278188,1,0,0,48640,10,2098446553
19957,149817099,40406141,190223240,1,0,0,34304,10,9782387428
19958,149885289,40569461,190454750,1,0,0,80896,10,220836801
19959,149908759,40434326,190343085,1,0,0,17408,10,3859514350
19960,149961309,40576486,190537795,1,0,0,45568,10,8387309235
19961,150025119,40434178,190459297,1,0,0,14848,10,1075224316
19962,150061639,40292809,190354448,1,0,0,6656,10,7816212911
19963,150095819,40332256,190428075,1,0,0,24064,10,430740774
19964,150107590,44011887,194119477,1,0,1,2560,10,8019137518
19965,150110039,40613155,190723194,1,0,0,57344,10,2286480548
19966,150110140,44011603,194121743,1,0,1,3584,10,10722840200
19967,150115990,44036024,194152014,1,0,1,512,10,9245932139
19968,150148040,44004320,194152360,1,0,1,512,10,8361414917
19969,150156449,40494848,190651297,1,0,0,34816,10,8216163711
19970,150311110,43842236,194153346,1,0,1,1536,10,10190704743
19971,150327609,40537153,190864762,1,0,0,77312,10,10057513413
19972,150331520,43822082,194153602,1,0,1,9216,10,5858561503
19973,150354760,43799188,194153948,1,0,1,512,10,1649172109
19974,150396060,43758874,194154934,1,0,1,1536,10,6768538281
19975,150554510,43604290,194158800,1,0,1,6144,10,5017683869
19976,150592149,40554415,191146564,1,0,0,54272,10,4828106992
19977,150626170,43532976,194159146,1,0,1,512,10,7669208760
19978,150661489,40444377,191105866,1,0,0,128512,10,3918941003
19979,150694879,39448568,190143447,1,0,0,11776,10,8755904097
19980,150719840,43440612,194160452,1,0,1,2048,10,4221335139
19981,150727750,43433688,194161438,1,0,1,1536,10,3756289216
19982,150739029,40225406,190964435,1,0,0,46080,10,7670130745
19983,150739069,39955435,190694504,1,0,0,17920,10,10482018553
19984,150764110,43397674,194161784,1,0,1,512,10,8486486848
19985,150770869,40152141,190923010,1,0,0,64000,10,7355680414
19986,150836459,39917810,190754269,1,0,0,49152,10,8677827769
19987,150853090,43311920,194165010,1,0,1,5120,10,1088994823
19988,150882740,43283576,194166316,1,0,1,2048,10,2734825270
19989,150897189,39827268,190724457,1,0,0,4096,10,8953746081
19990,151036519,40229774,191266293,1,0,0,104960,10,3399738283
19991,151054159,39787032,190841191,1,0,0,28160,10,1982669353
19992,151146039,39975598,191121637,1,0,0,51712,10,840060928
19993,151185139,39363294,190548433,1,0,0,11776,10,7590347613
19994,151466520,42702702,194169222,1,0,1,16896,10,3166687802
19995,151539189,39732654,191271843,1,0,0,17920,10,802627577
19996,151591559,39311936,190903495,1,0,0,36352,10,5879069067
19997,151685149,39196476,190881625,1,0,0,55296,10,3878577805
19998,151867239,39190070,191057309,1,0,0,92672,10,9649727743
19999,151998199,39198532,191196731,1,0,0,19456,10,8595352571
