RequestID,ArrivalTime,DelayTime,FinishTime,InitiatorID,TargetID,IOType,Size,VolumeID,Offset
0,7191114160,97004,7191211164,2,0,0,23552,2,7857477950
1,7191128962,72380,7191201342,4,0,0,13312,4,8689207435
2,7191213433,24670,7191238103,1,0,1,44544,1,5295072551
3,7191262933,89207,7191352140,6,0,0,7680,6,5888115980
4,7191272523,51774,7191324297,0,0,1,83968,0,10398257185
5,7191518601,25187,7191543788,9,0,1,45568,9,7059758004
6,7191535260,8887,7191544147,3,0,1,9728,3,2386651647
7,7191676361,71249,7191747610,8,0,1,115200,8,7665595439
8,7191858220,85937,7191944157,8,0,1,143872,8,7426224793
9,7191903878,51621,7191955499,2,0,1,46080,2,9082692320
10,7191956049,20624,7191976673,9,0,1,33280,9,7407425776
11,7192040687,10757,7192051444,1,0,1,17408,1,3829942574
12,7192219646,45596,7192265242,0,0,0,1024,0,10224466035
13,7192273093,109928,7192383021,1,0,0,60928,1,5718368756
14,7192332475,20366,7192352841,0,0,1,32768,0,3158372449
15,7192360133,48172,7192408305,9,0,0,512,9,6376945939
16,7192410580,102762,7192513342,7,0,0,1024,7,5197894734
17,7192476702,137926,7192614628,8,0,0,105472,8,2986337015
18,7192514242,15321,7192529563,5,0,1,29696,5,2802527842
19,7192539982,74817,7192614799,0,0,0,512,0,3300442873
20,7192783254,47288,7192830542,9,0,0,1536,9,2691044802
21,7192882589,1042,7192883631,1,0,1,1024,1,3628264136
22,7192895078,41132,7192936210,9,0,1,66560,9,1767589239
23,7192920470,191409,7193111879,3,0,0,5632,3,2533066429
24,7192998071,68001,7193066072,7,0,0,1024,7,9228434905
25,7193085135,22174,7193107309,8,0,1,36352,8,3737560780
26,7193100255,76544,7193176799,8,0,0,16896,8,1456505773
27,7193174120,183530,7193357650,6,0,0,43008,6,7706232012
28,7193177442,123496,7193300938,9,0,0,1024,9,4154794399
29,7193211262,89349,7193300611,6,0,0,11776,6,862834373
30,7193401942,12737,7193414679,9,0,1,24576,9,7326371362
31,7193411723,179024,7193590747,8,0,0,6144,8,4183187803
32,7193437322,54368,7193491690,1,0,0,4608,1,1753563609
33,7193452503,31007,7193483510,9,0,1,50176,9,408794234
34,7193458081,100960,7193559041,0,0,0,1536,0,10712706755
35,7193528914,2470,7193531384,4,0,1,2560,4,4784948456
36,7193544352,6278,7193550630,1,0,1,6656,1,9985360930
37,7193562575,6488,7193569063,0,0,1,15872,0,10189260412
38,7193571220,3645,7193574865,5,0,1,10240,5,4171545874
39,7193574858,3387,7193578245,6,0,1,9728,6,8406383407
40,7193604264,113884,7193718148,2,0,0,37376,2,776016734
41,7193610887,45596,7193656483,7,0,0,1024,7,2606726904
42,7193654754,45265,7193700019,7,0,0,512,7,5702435668
43,7193742703,68840,7193811543,6,0,0,11776,6,7804048373
44,7193787772,118667,7193906439,2,0,0,23552,2,2176467249
45,7193870599,3387,7193873986,4,0,1,9728,4,3422080498
46,7193875216,45596,7193920812,0,0,0,1024,0,9380227715
47,7193930741,192464,7194123205,2,0,0,170496,2,8087890396
48,7193996095,6278,7194002373,4,0,1,6656,4,3568165642
49,7194099285,81664,7194180949,2,0,0,5632,2,8404485907
50,7194248669,55748,7194304417,1,0,0,4096,1,6308307181
51,7194250502,46212,7194296714,2,0,1,79872,2,197016265
52,7194330132,118505,7194448637,9,0,0,512,9,578486324
53,7194356540,5712,7194362252,8,0,1,14336,8,9370391663
54,7194532428,101348,7194633776,4,0,0,32768,4,6754231977
55,7194545135,94116,7194639251,8,0,0,17920,8,4099214945
56,7194597276,50210,7194647486,1,0,0,1024,1,8641968583
57,7194706221,115076,7194821297,6,0,0,77824,6,10712521680
58,7194724163,44145,7194768308,8,0,1,75776,8,8841994463
59,7194773111,48365,7194821476,0,0,0,512,0,1899301799
60,7194778072,91028,7194869100,0,0,0,512,0,8145794583
61,7194799459,161567,7194961026,6,0,0,74240,6,1739549116
62,7194905314,2946,7194908260,1,0,1,3072,1,10606187879
63,7194910351,3422,7194913773,3,0,1,3584,3,6573269984
64,7195150522,1994,7195152516,2,0,1,2048,2,7689979611
65,7195185667,196944,7195382611,3,0,0,120320,3,3775079476
66,7195368410,58097,7195426507,9,0,0,512,9,1555031927
67,7195454357,34367,7195488724,5,0,1,56832,5,5087966243
68,7195503400,95312,7195598712,6,0,0,23040,6,8251314893
69,7195503613,202057,7195705670,4,0,0,37888,4,9153174123
70,7195680513,45179,7195725692,1,0,1,77824,1,5831105659
71,7195791750,71766,7195863516,1,0,1,116224,1,1672632967
72,7195811400,53102,7195864502,6,0,1,1536,6,5221226110
73,7195829355,297254,7196126609,6,0,0,33280,6,3663742879
74,7195863851,3128,7195866979,0,0,1,9216,0,8510034443
75,7195872572,73745,7195946317,0,0,1,123392,0,6927191512
76,7195926903,82384,7196009287,0,0,0,512,0,6929643990
77,7195969291,4850,7195974141,6,0,1,5120,6,4182366160
78,7195980363,129579,7196109942,2,0,0,19968,2,4983010805
79,7196002904,97502,7196100406,7,0,0,3072,7,4374037352
80,7196003763,187965,7196191728,1,0,0,60416,1,2711318240
81,7196026522,113846,7196140368,7,0,0,512,7,6624563144
82,7196175231,58655,7196233886,8,0,1,68608,8,76877588
83,7196216362,133355,7196349717,3,0,0,43008,3,1812292229
84,7196363545,123812,7196487357,1,0,0,106496,1,2813302934
85,7196418858,74003,7196492861,0,0,1,123904,0,2660382958
86,7196438009,62182,7196500191,0,0,1,21504,0,7865733044
87,7196449492,125773,7196575265,1,0,0,1536,1,3835878145
88,7196537980,5712,7196543692,5,0,1,14336,5,5974435552
89,7196577771,3904,7196581675,1,0,1,10752,1,9128111813
90,7196647099,3904,7196651003,3,0,1,10752,3,5976085929
91,7196756978,1994,7196758972,6,0,1,2048,6,9019434649
92,7196843331,4850,7196848181,9,0,1,5120,9,3730969282
93,7196894257,62384,7196956641,8,0,0,10752,8,4132451795
94,7196900315,74360,7196974675,4,0,0,9728,4,6610652836
95,7196914111,6754,7196920865,2,0,1,7168,2,3709516485
96,7196947613,103688,7197051301,2,0,0,40448,2,4120223577
97,7196951385,43904,7196995289,9,0,0,512,9,1023692841
98,7197005385,103174,7197108559,2,0,1,167424,2,4385865796
99,7197029149,80383,7197109532,5,0,1,12800,5,555764684
100,7197122796,161335,7197284131,0,0,0,1024,0,8507893718
101,7197135017,14117,7197149134,1,0,1,24064,1,2322268910
102,7197152956,104976,7197257932,7,0,0,1536,7,8812834341
103,7197227122,101882,7197329004,2,0,1,164864,2,3953512372
104,7197230853,191131,7197421984,7,0,0,1024,7,2492179933
105,7197310538,34121,7197344659,1,0,1,58368,1,784693383
106,7197388617,99229,7197487846,3,0,0,19456,3,7361533074
107,7197427467,141734,7197569201,3,0,0,22016,3,2915083195
108,7197453679,50241,7197503920,0,0,0,512,0,8375063210
109,7197493140,95492,7197588632,6,0,0,28672,6,3914115076
110,7197578606,11274,7197589880,5,0,1,18432,5,8811567557
111,7197584328,82879,7197667207,7,0,0,1536,7,6193567697
112,7197605656,66080,7197671736,8,0,0,12800,8,9524919952
113,7197640019,71821,7197711840,7,0,0,1024,7,2606684406
114,7197757648,4374,7197762022,4,0,1,4608,4,1605952231
115,7197847873,43904,7197891777,9,0,0,512,9,3233089865
116,7198137398,109928,7198247326,2,0,0,60928,2,9915339713
117,7198164346,11016,7198175362,0,0,1,17920,0,7853756405
118,7198189187,13770,7198202957,2,0,1,26624,2,2694683785
119,7198208240,59762,7198268002,7,0,0,512,7,4765128247
120,7198220014,46452,7198266466,9,0,0,512,9,4911365192
121,7198322805,34537,7198357342,9,0,1,60416,9,7171597138
122,7198384066,186104,7198570170,6,0,0,11264,6,5164540519
123,7198423313,20882,7198444195,8,0,1,33792,8,9648415188
124,7198643554,2946,7198646500,3,0,1,3072,3,7951798936
125,7198643957,111178,7198755135,8,0,0,36864,8,2726317682
126,7198659060,47288,7198706348,3,0,0,1536,3,6851879689
127,7198722924,34020,7198756944,1,0,1,59392,1,1406577801
128,7198763056,10757,7198773813,9,0,1,17408,9,10458702857
129,7198846513,80060,7198926573,8,0,0,13312,8,2651714153
130,7198961839,4850,7198966689,6,0,1,5120,6,246060258
131,7199046426,183109,7199229535,6,0,0,69632,6,1323548901
132,7199051866,41908,7199093774,5,0,1,68096,5,1774967188
133,7199075898,28194,7199104092,1,0,1,40960,1,359953862
134,7199095432,66052,7199161484,9,0,0,1024,9,3661225017
135,7199128918,117041,7199245959,3,0,0,13824,3,7062433219
136,7199313130,23208,7199336338,5,0,1,38400,5,7786752998
137,7199394403,23637,7199418040,0,0,1,42496,0,4021750721
138,7199429497,4850,7199434347,4,0,1,5120,4,5485691579
139,7199469610,4850,7199474460,6,0,1,5120,6,7127120345
140,7199490402,91928,7199582330,3,0,0,22016,3,3080454243
141,7199528607,13083,7199541690,5,0,1,22016,5,7994045486
142,7199567990,51480,7199619470,7,0,0,512,7,133939554
143,7199569154,24154,7199593308,8,0,1,43520,8,9442760013
144,7199577495,148642,7199726137,2,0,1,232960,2,305124589
145,7199642167,84124,7199726291,6,0,1,8704,6,7373455584
146,7199697937,30300,7199728237,1,0,1,3072,1,4605561527
147,7199744064,43716,7199787780,0,0,1,71680,0,5788705096
148,7199849735,174978,7200024713,7,0,0,512,7,2321871117
149,7199883605,105092,7199988697,2,0,0,45056,2,3866426173
150,7199892778,151666,7200044444,3,0,0,24064,3,3109813131
151,7199895775,23378,7199919153,5,0,1,41984,5,7125567372
152,7199906014,109413,7200015427,8,0,0,5632,8,4787804967
153,7200071890,2870,7200074760,0,0,1,8704,0,8549416357
154,7200077554,3904,7200081458,6,0,1,10752,6,9729338151
155,7200137350,40874,7200178224,1,0,1,66048,1,2252331067
156,7200208967,1518,7200210485,4,0,1,1536,4,4343174012
157,7200302566,92428,7200394994,4,0,0,18944,4,1683339279
158,7200305907,5454,7200311361,1,0,1,13824,1,2656074261
159,7200393522,36535,7200430057,1,0,1,61440,1,5326337824
160,7200394855,82767,7200477622,1,0,0,512,1,4258094229
161,7200421775,9767,7200431542,8,0,1,15360,8,1620726346
162,7200494097,196076,7200690173,2,0,0,87040,2,4946041485
163,7200606530,14287,7200620817,0,0,1,27648,0,10435466818
164,7200741016,129734,7200870750,2,0,0,7168,2,7516015602
165,7200749419,119132,7200868551,2,0,0,91136,2,1474775658
166,7200757608,36863,7200794471,2,0,1,65024,2,9033850973
167,7200822390,566,7200822956,4,0,1,512,4,5263953064
168,7200896666,111020,7201007686,6,0,0,64512,6,2695270379
169,7200901837,111480,7201013317,6,0,0,18432,6,1809307511
170,7200910296,26738,7200937034,2,0,1,48640,2,8140294993
171,7201008841,38318,7201047159,1,0,1,55808,1,3095171337
172,7201143238,42683,7201185921,0,0,1,69632,0,9210832551
173,7201147026,192009,7201339035,8,0,0,110592,8,1438531742
174,7201272342,6278,7201278620,8,0,1,6656,8,2284892723
175,7201281618,57432,7201339050,5,0,1,79360,5,1514421496
176,7201399005,151069,7201550074,4,0,0,72192,4,2582390755
177,7201517022,107744,7201624766,2,0,0,53760,2,3914681422
178,7201528436,150906,7201679342,7,0,0,2048,7,6125550921
179,7201532010,74202,7201606212,9,0,1,95744,9,210760789
180,7201537091,87690,7201624781,0,0,1,7168,0,1348893956
181,7201548451,76345,7201624796,0,0,1,22016,0,8108252195
182,7201566575,136864,7201703439,7,0,0,1024,7,8380002671
183,7201696251,101709,7201797960,0,0,0,1536,0,6641946872
184,7201760209,185336,7201945545,8,0,0,157184,8,7450251615
185,7201776185,54270,7201830455,8,0,1,92160,8,4089567226
186,7201777346,192960,7201970306,0,0,1,269824,0,7597452285
187,7201865631,106301,7201971932,3,0,1,2560,3,10737055555
188,7202142913,101124,7202244037,4,0,0,20992,4,9114146941
189,7202160032,167069,7202327101,6,0,0,64512,6,1630737038
190,7202193704,1994,7202195698,4,0,1,2048,4,9357351151
191,7202370724,74672,7202445396,2,0,0,10752,2,3340965277
192,7202439265,48980,7202488245,1,0,0,2048,1,4937709235
193,7202446258,15837,7202462095,0,0,1,30720,0,7715788326
194,7202448847,105116,7202553963,6,0,0,1536,6,394046541
195,7202473034,1994,7202475028,0,0,1,2048,0,4515624641
196,7202502327,51651,7202553978,0,0,1,82944,0,1953946902
197,7202557637,5326,7202562963,0,0,1,5632,0,6186056205
198,7202626416,61136,7202687552,3,0,0,6656,3,3101770196
199,7202647987,14287,7202662274,9,0,1,27648,9,5400255173
200,7202679800,130734,7202810534,6,0,0,124928,6,8743709851
201,7202685714,124835,7202810549,5,0,1,145408,5,276895488
202,7202685989,125199,7202811188,0,0,0,2048,0,5738839505
203,7202738580,166577,7202905157,8,0,0,17920,8,6849209157
204,7202829164,94383,7202923547,7,0,0,1536,7,6598287164
205,7202835500,77763,7202913263,4,0,0,3072,4,10270207398
206,7202854816,81205,7202936021,1,0,0,1024,1,7632003487
207,7202940696,73487,7203014183,9,0,1,122880,9,8331462373
208,7203008655,222690,7203231345,2,0,0,40448,2,9973655429
209,7203087303,43904,7203131207,1,0,0,512,1,6298731287
210,7203140796,115544,7203256340,3,0,0,79360,3,6749949139
211,7203176385,6754,7203183139,2,0,1,7168,2,5005688375
212,7203264850,40616,7203305466,1,0,1,65536,1,9529749056
213,7203334986,57055,7203392041,1,0,0,1536,1,9488174526
214,7203338304,61785,7203400089,7,0,0,512,7,2334500423
215,7203384385,4162,7203388547,0,0,1,11264,0,826127895
216,7203411779,46994,7203458773,7,0,0,1024,7,2225151207
217,7203437027,63191,7203500218,9,0,1,102912,9,3854977601
218,7203470633,130871,7203601504,6,0,0,14848,6,8906486981
219,7203483756,27394,7203511150,9,0,1,44032,9,2606227728
220,7203703832,188207,7203892039,2,0,0,42496,2,10713290983
221,7203714605,161912,7203876517,9,0,0,512,9,10337813766
222,7203720779,111893,7203832672,8,0,0,32256,8,3554613694
223,7203733517,566,7203734083,6,0,1,512,6,5963932875
224,7203881700,110743,7203992443,2,0,0,29696,2,1860301767
225,7203897726,12566,7203910292,5,0,1,20992,5,6352715542
226,7203925824,209166,7204134990,2,0,0,76288,2,1597498158
227,7203936386,4374,7203940760,8,0,1,4608,8,6831226577
228,7203969165,90304,7204059469,0,0,0,1536,0,8767057492
229,7204105333,5802,7204111135,4,0,1,6144,4,1158572578
230,7204106104,120638,7204226742,3,0,0,72704,3,6390363238
231,7204130508,179298,7204309806,4,0,0,50688,4,8406807868
232,7204139938,87911,7204227849,3,0,0,3584,3,1230218765
233,7204196770,50132,7204246902,7,0,0,512,7,2590457580
234,7204297948,140063,7204438011,4,0,0,117760,4,3360561301
235,7204299127,13642,7204312769,6,0,1,3072,6,8650939124
236,7204380035,57991,7204438026,5,0,1,69120,5,8910577579
237,7204433877,9943,7204443820,3,0,1,6144,3,4213095330
238,7204472115,54787,7204526902,5,0,1,93184,5,1200201418
239,7204517399,11769,7204529168,4,0,1,3584,4,1713632092
240,7204531172,3422,7204534594,4,0,1,3584,4,4112126596
241,7204604152,14287,7204618439,5,0,1,27648,5,6514239195
242,7204683502,12049,7204695551,2,0,1,19968,2,8993096776
243,7204686096,13641,7204699737,4,0,1,6656,4,2136846166
244,7204706022,5196,7204711218,5,0,1,13312,5,213687913
245,7204726424,101660,7204828084,3,0,0,33792,3,296486272
246,7204838122,45596,7204883718,1,0,0,1024,1,6512731254
247,7205088700,1042,7205089742,6,0,1,1024,6,7263044063
248,7205154950,45596,7205200546,1,0,0,1024,1,5311673958
249,7205168986,1994,7205170980,6,0,1,2048,6,8823674347
250,7205277554,12737,7205290291,1,0,1,24576,1,3898220329
251,7205311058,78290,7205389348,7,0,0,512,7,4364277316
252,7205325190,89588,7205414778,2,0,0,14336,2,4301231616
253,7205369509,50672,7205420181,0,0,0,2560,0,6999914663
254,7205408608,104312,7205512920,3,0,0,42496,3,8305227998
255,7205609490,4850,7205614340,3,0,1,5120,3,10679897026
256,7205610852,5443,7205616295,9,0,1,13312,9,5116901380
257,7205655233,3898,7205659131,3,0,1,4096,3,10303551387
258,7205714175,52676,7205766851,3,0,0,4096,3,8200764602
259,7205801751,1518,7205803269,0,0,1,1536,0,5929242570
260,7205894611,43904,7205938515,0,0,0,512,0,1106358434
261,7205902348,115556,7206017904,6,0,0,63488,6,2639968936
262,7205905934,1994,7205907928,3,0,1,2048,3,9043822645
263,7205925374,113878,7206039252,1,0,0,1024,1,1064275740
264,7205998224,93908,7206092132,4,0,0,18432,4,550768954
265,7206010564,12658,7206023222,0,0,1,5632,0,10242074874
266,7206170022,72420,7206242442,6,0,0,5120,6,7190814585
267,7206181334,13770,7206195104,1,0,1,26624,1,3165548877
268,7206206768,43904,7206250672,0,0,0,512,0,9621812526
269,7206222352,236606,7206458958,0,0,0,512,0,6557912495
270,7206267154,93800,7206360954,6,0,0,28160,6,8355590880
271,7206314985,2470,7206317455,6,0,1,2560,6,7072853250
272,7206331831,29138,7206360969,2,0,1,38912,2,3997574991
273,7206383544,55304,7206438848,5,0,1,94208,5,6420373830
274,7206391515,76861,7206468376,2,0,1,95744,2,6956282750
275,7206556491,228337,7206784828,3,0,0,19968,3,2151706443
276,7206567744,107276,7206675020,4,0,0,52224,4,1489785702
277,7206579717,233683,7206813400,6,0,0,53248,6,2947901367
278,7206589199,5326,7206594525,1,0,1,5632,1,7692000210
279,7206640409,73058,7206713467,9,0,1,118784,9,3622279216
280,7206690096,230583,7206920679,3,0,0,11776,3,3886996979
281,7206713155,203921,7206917076,8,0,0,65024,8,3408967286
282,7206725136,224980,7206950116,2,0,0,40960,2,3357249961
283,7206804099,190669,7206994768,4,0,0,49152,4,7346039122
284,7206878494,12308,7206890802,9,0,1,20480,9,6429716833
285,7206883247,8861,7206892108,2,0,1,2048,2,7464655198
286,7206982990,128741,7207111731,6,0,0,11776,6,4515385416
287,7207039097,53669,7207092766,1,0,0,512,1,9005519449
288,7207047758,97613,7207145371,8,0,1,163328,8,6646428681
289,7207050912,95432,7207146344,5,0,1,12800,5,4647544449
290,7207066205,207871,7207274076,7,0,0,512,7,1570998885
291,7207115450,51580,7207167030,5,0,1,66048,5,4774458667
292,7207608687,16354,7207625041,8,0,1,31744,8,5063181382
293,7207668070,43904,7207711974,7,0,0,512,7,6759349881
294,7207685839,48980,7207734819,0,0,0,2048,0,724672553
295,7207821142,45596,7207866738,7,0,0,1024,7,5869441504
296,7207827430,112112,7207939542,2,0,0,68096,2,6326630320
297,7207975034,100412,7208075446,8,0,0,29696,8,7974265955
298,7208061571,566,7208062137,9,0,1,512,9,2171717980
299,7208249168,3898,7208253066,9,0,1,4096,9,2494701270
300,7208393177,48980,7208442157,7,0,0,2048,7,1236691785
301,7208462246,89144,7208551390,3,0,0,17920,3,7582787938
302,7208526220,98696,7208624916,4,0,0,24064,4,2213574931
303,7208563095,47463,7208610558,9,0,0,1024,9,2113388549
304,7208583068,138928,7208721996,4,0,0,43008,4,4145430440
305,7208584074,3645,7208587719,3,0,1,10240,3,1168924707
306,7208624955,33333,7208658288,5,0,1,54784,5,2120972558
307,7208739807,4937,7208744744,4,0,1,12800,4,4190204938
308,7208741043,109531,7208850574,3,0,0,8192,3,5754393866
309,7208783169,112614,7208895783,4,0,0,9216,4,10547787590
310,7208875345,72541,7208947886,0,0,1,117760,0,8851414568
311,7208882443,310071,7209192514,6,0,0,132608,6,4705964219
312,7208909738,41054,7208950792,9,0,1,4608,9,1283951199
313,7208934994,345383,7209280377,2,0,0,80384,2,3281936506
314,7209066372,11274,7209077646,2,0,1,18432,2,5985810761
315,7209072321,128245,7209200566,1,0,0,512,1,5816059050
316,7209147505,1042,7209148547,9,0,1,1024,9,4679173251
317,7209176794,168648,7209345442,3,0,0,72704,3,3069830346
318,7209198791,172562,7209371353,8,0,0,84992,8,3529446810
319,7209233672,142641,7209376313,1,0,1,230912,1,5318370972
320,7209348767,29492,7209378259,3,0,1,3072,3,3071053003
321,7209422890,16096,7209438986,5,0,1,31232,5,879662631
322,7209435565,92510,7209528075,0,0,0,1024,0,8809699759
323,7209493805,43904,7209537709,0,0,0,512,0,7939483743
324,7209759568,5326,7209764894,3,0,1,5632,3,4160794463
325,7209871341,62416,7209933757,1,0,1,101376,1,9375581920
326,7209949689,138827,7210088516,8,0,0,77312,8,7645085759
327,7210083768,120908,7210204676,6,0,0,81408,6,7232496806
328,7210189175,16552,7210205727,4,0,1,1024,4,8717615735
329,7210190221,58376,7210248597,7,0,0,512,7,2556982465
330,7210250472,99944,7210350416,8,0,0,28160,8,3513674100
331,7210302441,54215,7210356656,7,0,0,1024,7,3823068283
332,7210387363,23983,7210411346,0,0,1,39936,0,8147626426
333,7210402020,87288,7210489308,8,0,0,8704,8,6495630080
334,7210421112,71844,7210492956,0,0,0,512,0,6468784870
335,7210453314,4420,7210457734,1,0,1,11776,1,3502278377
336,7210489933,4850,7210494783,8,0,1,5120,8,7352640588
337,7210499525,47288,7210546813,4,0,0,1536,4,2332238015
338,7210574070,129983,7210704053,6,0,0,96768,6,4350942851
339,7210589417,114963,7210704380,9,0,0,1024,9,3124770027
340,7210622162,3387,7210625549,9,0,1,9728,9,3018170338
341,7210659170,178035,7210837205,4,0,0,143360,4,4375456726
342,7210744091,135510,7210879601,8,0,0,63488,8,5487882758
343,7210777651,107992,7210885643,9,0,0,1536,9,5891391075
344,7210824269,68232,7210892501,8,0,1,94208,8,9457281537
345,7210877903,14752,7210892655,4,0,1,8704,4,10519631524
346,7210930682,42424,7210973106,2,0,1,69120,2,8156238173
347,7211139989,24154,7211164143,8,0,1,43520,8,6811967476
348,7211166202,2946,7211169148,4,0,1,3072,4,6365466028
349,7211258540,83612,7211342152,0,0,1,139264,0,79673565
350,7211338329,177787,7211516116,9,0,0,2048,9,6937033800
351,7211339076,34108,7211373184,8,0,1,56320,8,2490181328
352,7211403869,194504,7211598373,7,0,0,512,7,9686355112
353,7211405483,77363,7211482846,5,0,1,130560,5,7715035212
354,7211456932,220555,7211677487,4,0,0,8704,4,2814390007
355,7211475423,12608,7211488031,4,0,1,16384,4,8122717481
356,7211486449,103014,7211589463,4,0,0,7680,4,10493814110
357,7211503227,130059,7211633286,8,0,0,14336,8,859697221
358,7211549611,223552,7211773163,6,0,0,23040,6,2601748761
359,7211565216,1518,7211566734,6,0,1,1536,6,6752495120
360,7211627948,201152,7211829100,8,0,0,30720,8,9964679587
361,7211679645,132995,7211812640,3,0,0,17920,3,5850487595
362,7211776958,87248,7211864206,6,0,0,8704,6,8550191289
363,7211873825,101036,7211974861,2,0,0,31744,2,1218872138
364,7211954104,60824,7212014928,8,0,0,5632,8,8558868071
365,7211990253,62516,7212052769,6,0,0,6144,6,9563064829
366,7212195832,108992,7212304824,2,0,0,57856,2,3255663330
367,7212262554,106964,7212369518,2,0,0,51200,2,1496204599
368,7212300735,6075,7212306810,9,0,1,2048,9,4019761928
369,7212349330,1994,7212351324,4,0,1,2048,4,8908320644
370,7212373304,2470,7212375774,9,0,1,2560,9,7946439364
371,7212516180,178412,7212694592,6,0,0,154624,6,7084992131
372,7212776483,45596,7212822079,9,0,0,1024,9,10524918027
373,7212821567,20882,7212842449,8,0,1,33792,8,3723305711
374,7212824517,86035,7212910552,4,0,0,2560,4,1324412204
375,7212863366,85665,7212949031,9,0,0,1536,9,8829119867
376,7212880144,2946,7212883090,5,0,1,3072,5,2758098263
377,7212892669,1994,7212894663,2,0,1,2048,2,8582914540
378,7212921868,78844,7213000712,7,0,0,512,7,4295544808
379,7212995321,43904,7213039225,1,0,0,512,1,1465455167
380,7213085433,6754,7213092187,9,0,1,7168,9,5610086977
381,7213262396,4679,7213267075,0,0,1,12288,0,4416871768
382,7213365929,43904,7213409833,9,0,0,512,9,549676997
383,7213479271,5454,7213484725,0,0,1,13824,0,8777414316
384,7213593732,88988,7213682720,4,0,0,17408,4,1313041157
385,7213606980,114614,7213721594,8,0,0,12800,8,6112830961
386,7213726314,3422,7213729736,6,0,1,3584,6,7322554975
387,7213765219,4420,7213769639,1,0,1,11776,1,5873024413
388,7213781332,4850,7213786182,6,0,1,5120,6,3604292869
389,7213870650,52364,7213923014,8,0,0,3072,8,10619893536
390,7213889962,566,7213890528,4,0,1,512,4,7361995022
391,7214039303,1042,7214040345,3,0,1,1024,3,6072969974
392,7214094484,185332,7214279816,6,0,0,148992,6,4920554783
393,7214176979,46729,7214223708,1,0,1,80896,1,3359851317
394,7214187567,92420,7214279987,1,0,0,512,1,7820536266
395,7214205726,75926,7214281652,0,0,0,1536,0,7167968021
396,7214253376,210315,7214463691,6,0,0,60416,6,6862523321
397,7214267324,225621,7214492945,3,0,0,81408,3,8397830816
398,7214301374,15579,7214316953,8,0,1,30208,8,37774377
399,7214328217,4850,7214333067,6,0,1,5120,6,1844736704
400,7214338363,187486,7214525849,7,0,0,512,7,467818774
401,7214350483,7230,7214357713,8,0,1,7680,8,10151426162
402,7214458078,7599,7214465677,9,0,1,2048,9,8285505333
403,7214468488,68353,7214536841,7,0,0,512,7,195072423
404,7214613495,67904,7214681399,4,0,0,8704,4,9437092045
405,7214623329,21658,7214644987,1,0,1,35328,1,6505522294
406,7214625056,59109,7214684165,9,0,0,1536,9,3397662970
407,7214654001,45752,7214699753,9,0,0,1536,9,6526330428
408,7214669095,3898,7214672993,3,0,1,4096,3,1859966526
409,7214724967,45596,7214770563,2,0,0,1024,2,7857440096
410,7214750356,6754,7214757110,9,0,1,7168,9,9255071034
411,7214753301,4065,7214757366,3,0,1,9216,3,6865356827
412,7214793401,5326,7214798727,9,0,1,5632,9,7232451893
413,7214822535,14545,7214837080,5,0,1,28160,5,1674491819
414,7214896417,4374,7214900791,8,0,1,4608,8,544311640
415,7214984517,1518,7214986035,4,0,1,1536,4,6063717566
416,7215005254,3645,7215008899,2,0,1,10240,2,10216794594
417,7215078503,45179,7215123682,5,0,1,77824,5,10227619210
418,7215124708,119718,7215244426,4,0,0,13312,4,9426153394
419,7215134148,129760,7215263908,0,0,0,512,0,5679289498
420,7215189942,45596,7215235538,6,0,0,1024,6,5840666468
421,7215236686,2946,7215239632,8,0,1,3072,8,5175156695
422,7215245855,88817,7215334672,4,0,0,8704,4,4547223624
423,7215266392,2470,7215268862,4,0,1,2560,4,9886031755
424,7215306721,1994,7215308715,6,0,1,2048,6,5068634497
425,7215382415,41132,7215423547,8,0,1,66560,8,4637780232
426,7215441336,54784,7215496120,0,0,0,512,0,1913568895
427,7215486529,1042,7215487571,4,0,1,1024,4,9703562566
428,7215509633,21916,7215531549,8,0,1,35840,8,7483304545
429,7215527475,191477,7215718952,3,0,0,5632,3,2181590188
430,7215568728,178673,7215747401,0,0,0,1024,0,1524887259
431,7215574670,1042,7215575712,8,0,1,1024,8,3684651387
432,7215583151,163809,7215746960,3,0,0,16896,3,7402672162
433,7215588728,13341,7215602069,0,0,1,22528,0,3650569180
434,7215617731,2946,7215620677,6,0,1,3072,6,6380540008
435,7215735165,11810,7215746975,0,0,1,7168,0,4443287274
436,7215748220,3387,7215751607,6,0,1,9728,6,2605159477
437,7215750381,46448,7215796829,7,0,0,1024,7,8384673036
438,7215798315,64676,7215862991,2,0,0,8192,2,4610885627
439,7215882790,14287,7215897077,5,0,1,27648,5,270220791
440,7215948854,14117,7215962971,0,0,1,24064,0,1746038794
441,7216434345,5326,7216439671,4,0,1,5632,4,2683708347
442,7216603592,54515,7216658107,7,0,0,512,7,2779395487
443,7216622300,3422,7216625722,9,0,1,3584,9,6487324853
444,7216628949,73833,7216702782,2,0,1,120320,2,1827916826
445,7216716911,1042,7216717953,6,0,1,1024,6,1244895655
446,7216822068,566,7216822634,4,0,1,512,4,213951023
447,7216922075,566,7216922641,4,0,1,512,4,892811505
448,7216945284,106496,7217051780,4,0,0,49664,4,4444427011
449,7217050423,48637,7217099060,1,0,0,1536,1,4049392514
450,7217086640,44060,7217130700,7,0,0,1024,7,3000758142
451,7217142930,91904,7217234834,3,0,0,16896,3,6627615161
452,7217158398,42941,7217201339,0,0,1,70144,0,1993436066
453,7217209449,43904,7217253353,9,0,0,512,9,3861835839
454,7217230562,94177,7217324739,0,0,0,1024,0,8429996636
455,7217329078,7230,7217336308,6,0,1,7680,6,10156430837
456,7217346095,43904,7217389999,1,0,0,512,1,9959393822
457,7217451349,1518,7217452867,6,0,1,1536,6,4420323344
458,7217482452,71132,7217553584,2,0,0,9216,2,9780827355
459,7217544036,43904,7217587940,1,0,0,512,1,4007822579
460,7217733426,15579,7217749005,1,0,1,30208,1,3540237776
461,7217764473,50672,7217815145,7,0,0,2560,7,10311443496
462,7217922953,99944,7218022897,8,0,0,28160,8,6884710969
463,7218087290,84475,7218171765,2,0,1,137728,2,144109727
464,7218127820,113652,7218241472,1,0,0,512,1,5893929132
465,7218262893,43904,7218306797,9,0,0,512,9,10297569366
466,7218305534,47288,7218352822,9,0,0,1536,9,8653907683
467,7218514518,47288,7218561806,0,0,0,1536,0,10304437055
468,7218556133,12049,7218568182,0,0,1,19968,0,3052009492
469,7218587325,7230,7218594555,6,0,1,7680,6,570162826
470,7218595325,113816,7218709141,1,0,1,184832,1,329142397
471,7218619038,175541,7218794579,9,0,0,512,9,10326039498
472,7218621292,90435,7218711727,6,0,1,4096,6,5796849059
473,7218667041,45147,7218712188,1,0,1,10240,1,3284082118
474,7218721431,195013,7218916444,0,0,0,512,0,2708368818
475,7218748545,14287,7218762832,8,0,1,27648,8,4121853781
476,7218758456,120693,7218879149,6,0,0,45056,6,7318889794
477,7218863839,15325,7218879164,2,0,1,28160,2,3990409802
478,7218904387,1042,7218905429,5,0,1,1024,5,10154551426
479,7218969551,84090,7219053641,3,0,0,13824,3,9658605105
480,7218980696,566,7218981262,4,0,1,512,4,2770721116
481,7219228153,10499,7219238652,3,0,1,16896,3,1548349827
482,7219251982,33762,7219285744,0,0,1,58880,0,3346141365
483,7219321298,187919,7219509217,6,0,0,13824,6,4747115888
484,7219352750,43904,7219396654,9,0,0,512,9,4099760540
485,7219471021,6278,7219477299,9,0,1,6656,9,6331241425
486,7219543323,10757,7219554080,0,0,1,17408,0,1019557805
487,7219676328,115076,7219791404,6,0,0,77824,6,5498975493
488,7219690700,133788,7219824488,3,0,0,25088,3,5508572953
489,7219706939,101211,7219808150,8,0,0,5632,8,6937538787
490,7219843513,111956,7219955469,2,0,0,67584,2,2947229434
491,7219857580,4937,7219862517,6,0,1,12800,6,3926377214
492,7219930788,52033,7219982821,5,0,1,84480,5,407267255
493,7219960604,86589,7220047193,9,0,0,1536,9,33384283
494,7219978781,171172,7220149953,7,0,0,512,7,2754695483
495,7219992065,2870,7219994935,4,0,1,8704,4,3872221715
496,7220066237,10241,7220076478,3,0,1,16384,3,2978993648
497,7220141809,180086,7220321895,2,0,0,88064,2,4673447507
498,7220174879,159831,7220334710,4,0,0,41984,4,2311433859
499,7220191476,1042,7220192518,6,0,1,1024,6,10701725776
500,7220252098,6278,7220258376,3,0,1,6656,3,9405897701
501,7220261075,6754,7220267829,3,0,1,7168,3,7381555058
502,7220293144,242895,7220536039,4,0,0,65536,4,7829940882
503,7220298315,67476,7220365791,1,0,0,512,1,10171602995
504,7220398538,109865,7220508403,2,0,0,35328,2,2580157094
505,7220434091,145562,7220579653,3,0,0,56320,3,2596079854
506,7220452406,566,7220452972,6,0,1,512,6,6611253104
507,7220472848,15062,7220487910,1,0,1,29184,1,5068200566
508,7220603747,10757,7220614504,1,0,1,17408,1,6188171061
509,7220632662,2946,7220635608,9,0,1,3072,9,2841091373
510,7220714883,81761,7220796644,1,0,0,1536,1,5494504016
511,7220802641,3422,7220806063,3,0,1,3584,3,7605259377
512,7220842396,25704,7220868100,0,0,1,46592,0,6764470845
513,7220897304,261080,7221158384,6,0,0,146432,6,5729731882
514,7220984327,85125,7221069452,4,0,0,15872,4,8054543750
515,7221141256,27877,7221169133,5,0,1,17408,5,8199432666
516,7221206632,566,7221207198,4,0,1,512,4,2891731102
517,7221244803,131741,7221376544,5,0,1,212992,5,8686489678
518,7221251226,151898,7221403124,0,0,0,512,0,8383278881
519,7221344886,181776,7221526662,7,0,0,1024,7,3364952554
520,7221364201,162788,7221526989,0,0,0,1024,0,1747833940
521,7221402956,726,7221403682,4,0,1,512,4,10726021987
522,7221418117,216487,7221634604,3,0,0,35328,3,9449039447
523,7221549611,47288,7221596899,1,0,0,1536,1,1091487046
524,7221580181,106676,7221686857,8,0,0,45568,8,7574108041
525,7221615368,43904,7221659272,0,0,0,512,0,8446885869
526,7221637109,49763,7221686872,8,0,1,68096,8,477550887
527,7221781036,65946,7221846982,0,0,1,111616,0,5760018302
528,7221813763,60164,7221873927,1,0,1,96256,1,1321842067
529,7221851234,23359,7221874593,0,0,1,1024,0,5057966262
530,7222271517,566,7222272083,9,0,1,512,9,6963753090
531,7222306710,4679,7222311389,5,0,1,12288,5,4037568341
532,7222537589,87008,7222624597,4,0,0,20992,4,7247517796
533,7222592900,6754,7222599654,2,0,1,7168,2,4443681618
534,7222634291,199087,7222833378,2,0,0,67072,2,9774037423
535,7222663037,25704,7222688741,1,0,1,46592,1,10106109899
536,7222765535,204546,7222970081,8,0,0,13824,8,8114989864
537,7222825255,8681,7222833936,5,0,1,512,5,9621113119
538,7222854230,130227,7222984457,7,0,0,512,7,1858100998
539,7222896626,5454,7222902080,8,0,1,13824,8,6275868521
540,7223071039,43904,7223114943,0,0,0,512,0,7291445923
541,7223091473,1042,7223092515,6,0,1,1024,6,1643763813
542,7223096558,43904,7223140462,1,0,0,512,1,10422936457
543,7223127486,1042,7223128528,3,0,1,1024,3,19327152
544,7223157452,110708,7223268160,4,0,0,63488,4,3112522552
545,7223207315,130906,7223338221,0,0,0,512,0,2457208727
546,7223217994,94858,7223312852,0,0,1,154624,0,2071014595
547,7223256820,59258,7223316078,9,0,1,5120,9,6504980782
548,7223400421,1518,7223401939,9,0,1,1536,9,3105319673
549,7223463541,566,7223464107,6,0,1,512,6,5081251120
550,7223567080,4162,7223571242,3,0,1,11264,3,417600541
551,7223643730,48980,7223692710,8,0,0,2048,8,10642918981
552,7223693295,72520,7223765815,9,0,0,512,9,5481311300
553,7223693616,45596,7223739212,0,0,0,1024,0,10379609101
554,7223708132,43904,7223752036,9,0,0,512,9,10195746912
555,7223772850,4850,7223777700,6,0,1,5120,6,7644639413
556,7223819561,74091,7223893652,5,0,1,120832,5,8214161183
557,7223865264,87922,7223953186,0,0,0,1536,0,8529474258
558,7223948571,1994,7223950565,8,0,1,2048,8,2806894111
559,7223958064,58376,7224016440,2,0,0,7680,2,6331862839
560,7224006981,66359,7224073340,0,0,0,1024,0,10352710317
561,7224018253,3898,7224022151,4,0,1,4096,4,1371504780
562,7224028762,52520,7224081282,9,0,0,3584,9,5588231928
563,7224059664,7230,7224066894,0,0,1,7680,0,8435819027
564,7224096060,15837,7224111897,8,0,1,30720,8,6622348777
565,7224121776,217565,7224339341,2,0,0,40960,2,1766902913
566,7224143250,116483,7224259733,4,0,0,79360,4,5950079493
567,7224248186,57235,7224305421,1,0,1,78848,1,8044209167
568,7224277462,62050,7224339512,7,0,0,512,7,866611909
569,7224335542,20316,7224355858,2,0,1,31744,2,7006680477
570,7224394358,5802,7224400160,9,0,1,6144,9,4985794810
571,7224419332,246857,7224666189,3,0,0,53760,3,3941303300
572,7224436549,45596,7224482145,1,0,0,1024,1,7899708878
573,7224482617,7706,7224490323,8,0,1,8192,8,7106510039
574,7224487656,162138,7224649794,3,0,0,111104,3,6786332811
575,7224593761,132235,7224725996,3,0,0,46592,3,2498406660
576,7224743359,111491,7224854850,5,0,1,180224,5,9311135221
577,7224761862,281850,7225043712,2,0,0,25088,2,225199651
578,7224792175,346091,7225138266,6,0,0,102400,6,3338891008
579,7224849534,245580,7225095114,3,0,0,6144,3,4339765647
580,7224859905,3422,7224863327,6,0,1,3584,6,2380302842
581,7224864163,97096,7224961259,8,0,1,162304,8,1078215966
582,7224889214,138437,7225027651,5,0,1,188416,5,7480126870
583,7224930096,98221,7225028317,3,0,1,1024,3,8961445002
584,7225027744,74091,7225101835,2,0,1,120832,2,9415658625
585,7225031843,70965,7225102808,3,0,1,12800,3,6781446950
586,7225063502,394619,7225458121,3,0,0,45568,3,3600748914
587,7225112575,198563,7225311138,8,0,0,20480,8,7064428231
588,7225153068,51774,7225204842,1,0,1,83968,1,8606705695
589,7225205488,15837,7225221325,0,0,1,30720,0,5904945461
590,7225252369,26221,7225278590,5,0,1,47616,5,2506065393
591,7225263562,242195,7225505757,2,0,0,104960,2,8417530622
592,7225275265,239555,7225514820,6,0,0,29696,6,9492837600
593,7225443285,14851,7225458136,6,0,1,4608,6,7396000409
594,7225518472,81338,7225599810,0,0,0,1024,0,3268279388
595,7225523723,135617,7225659340,8,0,1,220672,8,2521161145
596,7225567705,102055,7225669760,0,0,1,41472,0,6625674389
597,7225697560,6278,7225703838,8,0,1,6656,8,9807278784
598,7225718819,136924,7225855743,7,0,0,512,7,4649170505
599,7225812406,7706,7225820112,3,0,1,8192,3,8987991953
600,7225901321,113283,7226014604,8,0,0,61440,8,90738386
601,7225906702,1042,7225907744,4,0,1,1024,4,3701105423
602,7225961537,108836,7226070373,2,0,0,10752,2,8421230397
603,7226049122,65900,7226115022,3,0,0,7168,3,9055644255
604,7226102861,87320,7226190181,8,0,0,22016,8,10232742697
605,7226125194,6278,7226131472,4,0,1,6656,4,4198566616
606,7226252064,47706,7226299770,9,0,0,1024,9,5025802239
607,7226254174,51296,7226305470,9,0,0,4608,9,3650816570
608,7226373262,1994,7226375256,7,0,1,2048,7,2582225850
609,7226378278,3128,7226381406,6,0,1,9216,6,7440112332
610,7226404407,108836,7226513243,4,0,0,57344,4,10365534145
611,7226501643,48196,7226549839,8,0,1,64512,8,5346379169
612,7226527494,242514,7226770008,1,0,0,512,1,9371058192
613,7226559993,110165,7226670158,2,0,0,7168,2,619136866
614,7226566327,4850,7226571177,6,0,1,5120,6,9262612144
615,7226576516,68905,7226645421,0,0,0,1536,0,3852418461
616,7226614226,3422,7226617648,3,0,1,3584,3,9479470629
617,7226617062,233136,7226850198,6,0,0,174080,6,4864730738
618,7226763141,22433,7226785574,2,0,1,36864,2,4815979884
619,7226808815,140695,7226949510,4,0,0,26112,4,556807551
620,7226841636,9621,7226851257,7,0,1,1024,7,4558706443
621,7226855968,1518,7226857486,7,0,1,1536,7,9245963566
622,7226918632,566,7226919198,6,0,1,512,6,4478743841
623,7226951602,95339,7227046941,0,0,0,2048,0,7084977108
624,7226956221,6754,7226962975,6,0,1,7168,6,798136635
625,7226958158,21178,7226979336,0,0,1,33792,0,5696482229
626,7226980873,2870,7226983743,1,0,1,8704,1,94043057
627,7227003965,4162,7227008127,2,0,1,11264,2,5674062014
628,7227031318,96246,7227127564,8,0,0,12288,8,9310007474
629,7227061528,45596,7227107124,7,0,0,1024,7,3245470575
630,7227117854,4374,7227122228,7,0,1,4608,7,9886176458
631,7227209539,104624,7227314163,3,0,0,43520,3,6238648353
632,7227273024,62667,7227335691,7,0,0,1024,7,8077984936
633,7227319382,5971,7227325353,8,0,1,14848,8,1363906240
634,7227327153,4679,7227331832,2,0,1,12288,2,4272832693
635,7227332762,48157,7227380919,9,0,0,1024,9,3082800612
636,7227336478,133509,7227469987,4,0,0,27136,4,9308728596
637,7227378750,21658,7227400408,1,0,1,35328,1,9632381324
638,7227406219,185054,7227591273,9,0,0,1536,9,2551290587
639,7227409397,50672,7227460069,0,0,0,2560,0,10650613758
640,7227466198,7203,7227473401,6,0,1,3584,6,10548813097
641,7227484912,43975,7227528887,5,0,1,72192,5,290733092
642,7227493351,57348,7227550699,5,0,1,71680,5,6198290580
643,7227557154,216230,7227773384,7,0,0,1024,7,6373952704
644,7227578785,1994,7227580779,4,0,1,2048,4,3808364980
645,7227632958,249512,7227882470,4,0,0,131072,4,5288799044
646,7227674024,16354,7227690378,5,0,1,31744,5,8552508936
647,7227675478,21004,7227696482,1,0,1,24576,1,5567845725
648,7227732894,65408,7227798302,0,0,0,1024,0,1845554740
649,7227772530,159911,7227932441,6,0,0,35840,6,9673187927
650,7227803368,88864,7227892232,4,0,0,10752,4,2036822236
651,7227871814,60990,7227932804,0,0,0,512,0,8730981432
652,7227919276,47785,7227967061,1,0,0,1024,1,2725134513
653,7227943132,56079,7227999211,8,0,1,95744,8,10545307094
654,7227968860,58781,7228027641,1,0,0,1536,1,8147466684
655,7227980144,85585,7228065729,1,0,0,512,1,2408474934
656,7228116708,83612,7228200320,0,0,1,139264,0,62697039
657,7228118925,148868,7228267793,1,0,0,5120,1,2490365061
658,7228257253,45596,7228302849,7,0,0,1024,7,10488036044
659,7228331083,3422,7228334505,3,0,1,3584,3,1474183090
660,7228348568,22950,7228371518,8,0,1,37888,8,6243450297
661,7228376843,3898,7228380741,6,0,1,4096,6,10166124891
662,7228571444,1042,7228572486,4,0,1,1024,4,3364771478
663,7228639850,52364,7228692214,0,0,0,3072,0,1752775862
664,7228748925,43904,7228792829,7,0,0,512,7,8055422646
665,7228759611,10757,7228770368,4,0,1,17408,4,2444782844
666,7228776159,45596,7228821755,9,0,0,1024,9,7415151214
667,7228805943,69284,7228875227,2,0,0,8192,2,994435457
668,7228810702,45437,7228856139,5,0,1,78336,5,5516232669
669,7228823515,37130,7228860645,2,0,1,7168,2,883370255
670,7228824969,206410,7229031379,7,0,0,1536,7,1039677007
671,7228936934,12566,7228949500,2,0,1,20992,2,9395168254
672,7228948067,43904,7228991971,0,0,0,512,0,6408503890
673,7228966898,158976,7229125874,2,0,0,22016,2,7577508049
674,7229048955,5802,7229054757,2,0,1,6144,2,3080187675
675,7229273211,90392,7229363603,1,0,0,22016,1,6995685549
676,7229457001,100880,7229557881,2,0,0,31232,2,7229575880
677,7229596433,114920,7229711353,4,0,0,77312,4,8022868684
678,7229596783,54306,7229651089,7,0,0,512,7,2175209847
679,7229624182,12308,7229636490,8,0,1,20480,8,9819087252
680,7229644528,109881,7229754409,8,0,0,39936,8,7661057887
681,7229787459,1994,7229789453,9,0,1,2048,9,1277064379
682,7229792458,204206,7229996664,4,0,0,55296,4,1709203536
683,7229907433,48980,7229956413,0,0,0,2048,0,2793962005
684,7230000522,6754,7230007276,3,0,1,7168,3,9241115994
685,7230068838,92684,7230161522,8,0,0,19456,8,8553833663
686,7230229495,13512,7230243007,8,0,1,26112,8,11673135
687,7230293838,3898,7230297736,6,0,1,4096,6,2531398055
688,7230306132,2470,7230308602,9,0,1,2560,9,9501927115
689,7230443267,40874,7230484141,0,0,1,66048,0,9742391615
690,7230476009,8478,7230484487,3,0,1,512,3,7062162702
691,7230479498,5860,7230485358,6,0,1,12288,6,9213579451
692,7230537263,78237,7230615500,0,0,0,1024,0,4379743190
693,7230549514,3422,7230552936,3,0,1,3584,3,3023851495
694,7230552445,837,7230553282,6,0,1,512,6,6170162436
695,7230560442,92840,7230653282,4,0,0,19968,4,10374024062
696,7230630939,97604,7230728543,6,0,0,20480,6,4351430843
697,7230635425,2870,7230638295,9,0,1,8704,9,2742302712
698,7230639424,1042,7230640466,7,0,1,1024,7,4532406061
699,7230669365,47288,7230716653,0,0,0,1536,0,1513697916
700,7230674265,193405,7230867670,4,0,0,25600,4,7401180667
701,7230715546,66979,7230782525,2,0,1,113664,2,651564725
702,7230736876,50155,7230787031,6,0,1,7168,6,4062164427
703,7230774735,170716,7230945451,7,0,0,1536,7,4799699324
704,7230783725,367481,7231151206,2,0,0,90112,2,10341694840
705,7230801681,194086,7230995767,2,0,0,20480,2,4586258751
706,7230819554,48131,7230867685,1,0,1,65536,1,136669444
707,7230853070,31524,7230884594,2,0,1,51200,2,7690117691
708,7230855195,30385,7230885580,8,0,1,1536,8,1935136615
709,7230938885,5326,7230944211,7,0,1,5632,7,4055936458
710,7231105883,102284,7231208167,2,0,0,35840,2,3877858321
711,7231129189,126829,7231256018,0,0,0,512,0,7656267761
712,7231133233,122614,7231255847,2,0,0,43520,2,9446374557
713,7231285408,13600,7231299008,1,0,1,23040,1,7162235464
714,7231295587,157418,7231453005,2,0,0,104960,2,4359556789
715,7231315961,59824,7231375785,0,0,0,2560,0,6301107610
716,7231345358,13770,7231359128,8,0,1,26624,8,3324320522
717,7231463062,23983,7231487045,0,0,1,39936,0,10349073333
718,7231492508,23378,7231515886,0,0,1,41984,0,3913526512
719,7231504623,11609,7231516232,6,0,1,512,6,7975961935
720,7231504973,205166,7231710139,9,0,0,512,9,9223745538
721,7231559699,4850,7231564549,0,0,1,5120,0,1450633253
722,7231738380,47288,7231785668,9,0,0,1536,9,7714152361
723,7231749379,3128,7231752507,4,0,1,9216,4,3225744385
724,7231834670,114762,7231949432,5,0,1,189952,5,2441172323
725,7231860217,89471,7231949688,7,0,1,9216,7,8946236002
726,7231880991,218027,7232099018,4,0,0,46592,4,4532566210
727,7231968128,1518,7231969646,9,0,1,1536,9,9483264744
728,7232004103,7706,7232011809,3,0,1,8192,3,4472399978
729,7232030325,31266,7232061591,1,0,1,50688,1,316757861
730,7232039462,79024,7232118486,8,0,0,9216,8,3201092639
731,7232185016,43904,7232228920,9,0,0,512,9,1491112099
732,7232259976,3645,7232263621,6,0,1,10240,6,5691551341
733,7232382433,4374,7232386807,5,0,1,4608,5,281687852
734,7232421016,182798,7232603814,3,0,0,39424,3,9376149253
735,7232446336,139622,7232585958,1,0,0,58880,1,6990643135
736,7232497953,1518,7232499471,0,0,1,1536,0,2191243435
737,7232508584,189652,7232698236,8,0,0,121344,8,9687175815
738,7232611428,128502,7232739930,8,0,0,30208,8,8526916124
739,7232628584,94600,7232723184,2,0,1,154112,2,159151840
740,7232789402,5802,7232795204,9,0,1,6144,9,5834704532
741,7232828336,184383,7233012719,4,0,0,47104,4,4567381616
742,7232881328,2946,7232884274,6,0,1,3072,6,2612615286
743,7232994813,17921,7233012734,4,0,1,6656,4,469471024
744,7233037125,101192,7233138317,2,0,0,32256,2,8201979567
745,7233063307,112736,7233176043,2,0,0,70144,2,10092523800
746,7233103281,109586,7233212867,3,0,0,21504,3,3750739436
747,7233164874,15535,7233180409,1,0,1,4608,1,8430704633
748,7233306703,5326,7233312029,9,0,1,5632,9,282086895
749,7233377319,83000,7233460319,3,0,0,17920,3,6539496198
750,7233415077,142964,7233558041,2,0,0,115712,2,8983315001
751,7233433609,153394,7233587003,8,0,0,28160,8,6306523540
752,7233495483,22174,7233517657,2,0,1,36352,2,2237515266
753,7233505274,14009,7233519283,9,0,1,2560,9,7275864421
754,7233558412,47288,7233605700,9,0,0,1536,9,2304848219
755,7233611955,103795,7233715750,6,0,0,14336,6,6589387830
756,7233622309,180687,7233802996,3,0,0,72704,3,6043805657
757,7233656729,1994,7233658723,4,0,1,2048,4,4482593782
758,7233727490,214850,7233942340,2,0,0,81920,2,8631402216
759,7233761394,110770,7233872164,2,0,0,35328,2,1466046339
760,7233826220,156228,7233982448,8,0,0,25088,8,6083512296
761,7233858090,114452,7233972542,9,0,0,1536,9,7651843902
762,7233917601,114011,7234031612,3,0,0,12800,3,6912112800
763,7234055551,6278,7234061829,6,0,1,6656,6,8454213792
764,7234093519,1994,7234095513,0,0,1,2048,0,4814147950
765,7234128139,52364,7234180503,7,0,0,3072,7,2607873721
766,7234152693,13770,7234166463,2,0,1,26624,2,8108473889
767,7234156809,49444,7234206253,7,0,0,512,7,5975886536
768,7234188674,161572,7234350246,7,0,0,2560,7,8947756613
769,7234233865,2470,7234236335,7,0,1,2560,7,10064541149
770,7234249822,81308,7234331130,8,0,0,17408,8,8408959408
771,7234321746,9399,7234331145,0,0,1,5120,0,3252212917
772,7234361775,2470,7234364245,6,0,1,2560,6,4935524843
773,7234427099,1994,7234429093,8,0,1,2048,8,8093406358
774,7234443573,566,7234444139,4,0,1,512,4,5516192530
775,7234503182,3898,7234507080,0,0,1,4096,0,5349054173
776,7234521626,7230,7234528856,9,0,1,7680,9,2439007801
777,7234532032,219799,7234751831,4,0,0,73216,4,791527636
778,7234671444,7230,7234678674,8,0,1,7680,8,2161775222
779,7234682979,140186,7234823165,3,0,0,79360,3,6668087308
780,7234875829,116792,7234992621,1,0,0,83456,1,7210983930
781,7234906375,111740,7235018115,2,0,0,9728,2,3231286029
782,7234959528,71780,7235031308,8,0,0,16384,8,1118250896
783,7234989863,79400,7235069263,9,0,0,1536,9,5222265538
784,7235001573,43904,7235045477,0,0,0,512,0,929798898
785,7235014360,50672,7235065032,7,0,0,2560,7,5675900266
786,7235024996,6327,7235031323,4,0,1,5120,4,3291231937
787,7235107542,36087,7235143629,1,0,1,63488,1,8798010652
788,7235178108,13253,7235191361,5,0,1,25600,5,4280545647
789,7235222503,99500,7235322003,0,0,0,1024,0,10134944307
790,7235288169,5326,7235293495,4,0,1,5632,4,6707472276
791,7235299600,22691,7235322291,1,0,1,37376,1,10493903520
792,7235339210,232797,7235572007,4,0,0,5632,4,2758817239
793,7235358113,566,7235358679,6,0,1,512,6,199880019
794,7235366898,22950,7235389848,5,0,1,37888,5,3441988153
795,7235410346,1518,7235411864,4,0,1,1536,4,3455921603
796,7235518439,47288,7235565727,9,0,0,1536,9,3092975498
797,7235635720,120848,7235756568,8,0,0,96768,8,6836585437
798,7235721807,3645,7235725452,3,0,1,10240,3,2928089242
799,7235787205,43904,7235831109,9,0,0,512,9,8778583338
800,7235788967,72448,7235861415,7,0,0,3072,7,7436110882
801,7235836427,100724,7235937151,3,0,0,30720,3,10374137395
802,7235999375,1518,7236000893,2,0,1,1536,2,4207053708
803,7236026938,93308,7236120246,2,0,0,21504,2,6592452624
804,7236027017,14804,7236041821,5,0,1,28672,5,1538251098
805,7236049670,13083,7236062753,5,0,1,22016,5,9944582163
806,7236066719,85389,7236152108,3,0,0,1536,3,5407102874
807,7236089352,1518,7236090870,8,0,1,1536,8,5515975582
808,7236210719,48980,7236259699,9,0,0,2048,9,10053378117
809,7236256109,4420,7236260529,7,0,1,11776,7,6405939831
810,7236286636,218320,7236504956,3,0,0,73728,3,9781427660
811,7236418121,113541,7236531662,1,0,0,29184,1,1510296996
812,7236514763,4374,7236519137,5,0,1,4608,5,8117432714
813,7236599303,69284,7236668587,4,0,0,8192,4,9423123745
814,7236661704,73604,7236735308,8,0,0,12288,8,9240809174
815,7236844767,6278,7236851045,8,0,1,6656,8,6839635570
816,7236875152,566,7236875718,4,0,1,512,4,9820339905
817,7236907219,83132,7236990351,4,0,0,13312,4,4257314844
818,7236951143,48980,7237000123,0,0,0,2048,0,4942980692
819,7237097251,43923,7237141174,0,0,0,512,0,3749570663
820,7237117290,87476,7237204766,8,0,0,22528,8,6889782788
821,7237192313,23120,7237215433,2,0,1,41472,2,8175450362
822,7237199496,21429,7237220925,6,0,1,17920,6,9636262584
823,7237224434,136688,7237361122,3,0,0,50176,3,4609555727
824,7237282732,45596,7237328328,0,0,0,1024,0,9922655357
825,7237491132,45596,7237536728,9,0,0,1024,9,7674996056
826,7237534607,50672,7237585279,3,0,0,2560,3,8875731405
827,7237583236,46803,7237630039,0,0,0,1024,0,5740600312
828,7237599837,3387,7237603224,4,0,1,9728,4,1055801963
829,7237686681,22691,7237709372,5,0,1,37376,5,7643587070
830,7237771676,257071,7238028747,0,0,0,4096,0,9489836133
831,7237823167,3645,7237826812,0,0,1,10240,0,10099468656
832,7237876722,102908,7237979630,1,0,0,37888,1,453355193
833,7237877919,54358,7237932277,1,0,1,89088,1,3552760383
834,7237940949,1994,7237942943,0,0,1,2048,0,2509535702
835,7237966398,194360,7238160758,1,0,0,13312,1,9327010260
836,7238023772,4990,7238028762,3,0,1,5120,3,9836110110
837,7238102117,43904,7238146021,7,0,0,512,7,9007763356
838,7238118137,13512,7238131649,6,0,1,26112,6,9628030355
839,7238222045,6754,7238228799,9,0,1,7168,9,9012146747
840,7238371505,1518,7238373023,6,0,1,1536,6,6006462820
841,7238436446,102596,7238539042,2,0,0,36864,2,6432806955
842,7238575156,3645,7238578801,3,0,1,10240,3,5935686992
843,7238609100,44662,7238653762,2,0,1,76800,2,9890858995
844,7238647790,81723,7238729513,8,0,0,12288,8,5253445785
845,7238660411,3645,7238664056,4,0,1,10240,4,8010400572
846,7238748478,5802,7238754280,9,0,1,6144,9,5131708814
847,7238761923,52824,7238814747,9,0,0,1024,9,3304362375
848,7238782847,1994,7238784841,4,0,1,2048,4,3368723748
849,7238832178,43904,7238876082,0,0,0,512,0,2351823385
850,7238841108,1518,7238842626,8,0,1,1536,8,9080218945
851,7238879233,43904,7238923137,7,0,0,512,7,3162830736
852,7238911805,132670,7239044475,8,0,0,15360,8,2033526252
853,7238971781,16613,7238988394,5,0,1,32256,5,7138410412
854,7238987929,46988,7239034917,2,0,1,81408,2,46425598
855,7239059497,5196,7239064693,0,0,1,13312,0,3909321466
856,7239066905,3422,7239070327,8,0,1,3584,8,2398292110
857,7239123515,1994,7239125509,8,0,1,2048,8,3337700578
858,7239252314,4420,7239256734,6,0,1,11776,6,10497635895
859,7239253413,157702,7239411115,1,0,0,107520,1,2927768533
860,7239257754,3422,7239261176,6,0,1,3584,6,2794173473
861,7239276964,135258,7239412222,1,0,0,3584,1,2983294826
862,7239280862,11533,7239292395,9,0,1,18944,9,5956748524
863,7239289999,6582,7239296581,6,0,1,6656,6,4947624729
864,7239371851,566,7239372417,9,0,1,512,9,6876358601
865,7239407253,8383,7239415636,5,0,1,3584,5,6053099710
866,7239440078,48980,7239489058,0,0,0,2048,0,3846864567
867,7239603473,101036,7239704509,3,0,0,31744,3,8371692190
868,7239651743,83870,7239735613,0,0,0,512,0,565518483
869,7239786548,2470,7239789018,4,0,1,2560,4,5983576185
870,7239922363,43904,7239966267,7,0,0,512,7,9020133596
871,7239941455,4937,7239946392,1,0,1,12800,1,2441816673
872,7240004746,136698,7240141444,1,0,0,44544,1,7878532103
873,7240131516,112672,7240244188,4,0,0,37376,4,242844412
874,7240161071,102191,7240263262,6,0,0,3072,6,1586655025
875,7240213318,102908,7240316226,3,0,0,37888,3,10305016362
876,7240323712,73760,7240397472,2,0,0,12800,2,10223181140
877,7240356199,110975,7240467174,8,0,0,64000,8,2514826646
878,7240372625,151501,7240524126,2,0,0,89600,2,380394932
879,7240406834,3904,7240410738,5,0,1,10752,5,9266109606
880,7240493290,54056,7240547346,3,0,0,3584,3,1196510570
881,7240515178,41498,7240556676,1,0,1,53248,1,71123567
882,7240609144,104849,7240713993,2,0,0,35840,2,8341268792
883,7240628504,3898,7240632402,4,0,1,4096,4,6496769981
884,7240658129,94594,7240752723,7,0,0,512,7,1554262366
885,7240666309,114338,7240780647,2,0,0,26624,2,8708326986
886,7240702935,11073,7240714008,6,0,1,4608,6,1001715646
887,7240746873,111290,7240858163,3,0,0,18432,3,2538654041
888,7240791526,12737,7240804263,2,0,1,24576,2,2664802858
889,7240838689,266910,7241105599,6,0,0,67584,6,2893269529
890,7240847284,99919,7240947203,8,0,0,26112,8,2731912424
891,7240858941,2946,7240861887,8,0,1,3072,8,9885614770
892,7240879967,86712,7240966679,1,0,1,145408,1,6186070627
893,7240909620,73022,7240982642,1,0,1,51712,1,1213833636
894,7240934445,51423,7240985868,7,0,1,5120,7,10240169383
895,7241013145,109317,7241122462,1,0,0,19968,1,8778550022
896,7241091508,206235,7241297743,3,0,0,169472,3,5833917682
897,7241164086,23120,7241187206,2,0,1,41472,2,6615943949
898,7241177169,14223,7241191392,5,0,1,6656,5,7331450687
899,7241363323,11016,7241374339,5,0,1,17920,5,9719833699
900,7241405062,112406,7241517468,3,0,0,38400,3,7575320271
901,7241414404,56066,7241470470,0,0,0,512,0,423609045
902,7241494271,3128,7241497399,8,0,1,9216,8,8616100364
903,7241538871,1042,7241539913,4,0,1,1024,4,7629616679
904,7241540803,6754,7241547557,9,0,1,7168,9,5797349638
905,7241555973,208123,7241764096,1,0,0,98816,1,5287321873
906,7241599033,4162,7241603195,8,0,1,11264,8,8010542846
907,7241732383,197527,7241929910,2,0,0,14848,2,10142069759
908,7241751801,15275,7241767076,2,0,1,3072,2,485353925
909,7241761724,74925,7241836649,3,0,0,13824,3,10144199978
910,7241763516,84378,7241847894,6,0,0,12288,6,8151302557
911,7241819090,1518,7241820608,1,0,1,1536,1,9688206933
912,7241876106,145654,7242021760,1,0,1,240128,1,6851184858
913,7241913571,109265,7242022836,0,0,1,13312,0,7883162084
914,7241930845,98404,7242029249,1,0,1,30720,1,2357432866
915,7241970677,74330,7242045007,2,0,1,50688,2,10466567181
916,7242045653,1994,7242047647,3,0,1,2048,3,2032108864
917,7242049687,2946,7242052633,0,0,1,3072,0,6905219614
918,7242147995,80076,7242228071,2,0,0,12288,2,2000095601
919,7242164592,1994,7242166586,4,0,1,2048,4,5209144051
920,7242224279,14767,7242239046,7,0,1,17920,7,1749270028
921,7242244449,3898,7242248347,9,0,1,4096,9,3463690713
922,7242248750,36604,7242285354,5,0,1,64512,5,8466603444
923,7242255391,228813,7242484204,8,0,0,20992,8,1445966610
924,7242280286,78691,7242358977,2,0,0,11776,2,426349406
925,7242334315,566,7242334881,6,0,1,512,6,4536572486
926,7242372181,5196,7242377377,9,0,1,13312,9,6156968355
927,7242585787,25962,7242611749,2,0,1,47104,2,9810558996
928,7242588827,300319,7242889146,6,0,0,100864,6,3701394653
929,7242589555,26380,7242615935,8,0,1,6656,8,4011760209
930,7242697588,114920,7242812508,2,0,0,77312,2,2938148304
931,7242776428,117368,7242893796,1,0,0,4096,1,9011581445
932,7242821076,7706,7242828782,0,0,1,8192,0,3231453115
933,7242866821,99641,7242966462,8,0,0,19456,8,362754253
934,7242968430,2470,7242970900,6,0,1,2560,6,10589534787
935,7243005743,86072,7243091815,4,0,0,17920,4,97534855
936,7243019731,72255,7243091986,9,0,0,512,9,2871261598
937,7243179889,43904,7243223793,9,0,0,512,9,9456493812
938,7243199915,4850,7243204765,9,0,1,5120,9,8188141683
939,7243220843,5802,7243226645,2,0,1,6144,2,9391425332
940,7243221576,6125,7243227701,6,0,1,12800,6,4936556149
941,7243370929,35054,7243405983,2,0,1,61440,2,3386822578
942,7243519284,75140,7243594424,6,0,0,12288,6,7731301962
943,7243558109,101192,7243659301,6,0,0,32256,6,5752173990
944,7243585247,210891,7243796138,1,0,0,44032,1,70604283
945,7243587605,1042,7243588647,7,0,1,1024,7,5922676782
946,7243604142,99632,7243703774,1,0,0,27136,1,1187635006
947,7243650886,180532,7243831418,4,0,0,33792,4,7299622388
948,7243695109,109312,7243804421,3,0,0,27136,3,7552188494
949,7243736414,1042,7243737456,6,0,1,1024,6,8533082874
950,7243779907,566,7243780473,0,0,1,512,0,9384886700
951,7243829663,5645,7243835308,0,0,1,4096,0,5297043161
952,7244199743,14029,7244213772,1,0,1,27136,1,8528267820
953,7244240545,566,7244241111,9,0,1,512,9,7332875982
954,7244301804,43904,7244345708,9,0,0,512,9,6021512992
955,7244342570,89588,7244432158,6,0,0,14336,6,5215626911
956,7244356191,99554,7244455745,6,0,0,22016,6,6121186139
957,7244363807,4162,7244367969,1,0,1,11264,1,3706389200
958,7244365429,6538,7244371967,2,0,1,12288,2,6186876157
959,7244380962,68060,7244449022,8,0,0,9216,8,7602645006
960,7244418979,566,7244419545,9,0,1,512,9,4980382511
961,7244420716,35044,7244455760,2,0,1,56320,2,9200523550
962,7244506110,56652,7244562762,9,0,0,512,9,3362022266
963,7244583269,198325,7244781594,7,0,0,512,7,2117300743
964,7244645379,3422,7244648801,4,0,1,3584,4,2277268093
965,7244699431,15321,7244714752,1,0,1,29696,1,1107197675
966,7244727239,43904,7244771143,0,0,0,512,0,5273136793
967,7244851924,6754,7244858678,0,0,1,7168,0,4836035573
968,7244880681,41649,7244922330,1,0,1,67584,1,3779719909
969,7244888046,137312,7245025358,1,0,0,20480,1,8827091275
970,7244894964,117605,7245012569,5,0,0,23040,5,1755897247
971,7244914185,45596,7244959781,6,0,0,1024,6,7894489618
972,7244952776,99726,7245052502,4,0,0,512,4,8074846971
973,7245047841,84224,7245132065,2,0,0,16896,2,150680983
974,7245090530,6754,7245097284,8,0,1,7168,8,9768298105
975,7245144295,43200,7245187495,2,0,1,70656,2,10057280321
976,7245220917,43904,7245264821,9,0,0,512,9,7523320321
977,7245506260,47288,7245553548,9,0,0,1536,9,7679093198
978,7245562639,105248,7245667887,1,0,0,45568,1,3578720810
979,7245694845,5971,7245700816,6,0,1,14848,6,2606865108
980,7245738036,5712,7245743748,5,0,1,14336,5,4780929967
981,7245768167,21658,7245789825,1,0,1,35328,1,5590262978
982,7245839351,6488,7245845839,9,0,1,15872,9,4572000468
983,7245943517,43904,7245987421,7,0,0,512,7,8888389040
984,7245986177,2870,7245989047,3,0,1,8704,3,10368084134
985,7245996060,107900,7246103960,3,0,0,54272,3,194556155
986,7246007834,23895,7246031729,5,0,1,43008,5,4960215506
987,7246008972,280555,7246289527,1,0,0,70656,1,102262010
988,7246025887,8108,7246033995,6,0,1,3584,6,8263258420
989,7246213514,77432,7246290946,8,0,0,4608,8,9321275312
990,7246239588,79354,7246318942,6,0,0,3584,6,5244042875
991,7246274556,70528,7246345084,9,0,0,2560,9,10126118518
992,7246296765,1518,7246298283,4,0,1,1536,4,6708639460
993,7246329428,110925,7246440353,6,0,0,45568,6,7038330026
994,7246335105,138583,7246473688,2,0,0,77824,2,7510818091
995,7246367585,106274,7246473859,9,0,0,512,9,10541792175
996,7246493458,47288,7246540746,7,0,0,1536,7,9411515447
997,7246518539,67460,7246585999,1,0,0,12288,1,9570851470
998,7246562404,5802,7246568206,9,0,1,6144,9,10565468512
999,7246599590,566,7246600156,8,0,1,512,8,9902878561
1000,7246739487,3422,7246742909,7,0,1,3584,7,2254681053
1001,7246756894,103220,7246860114,2,0,0,38912,2,4468026458
1002,7246773892,45596,7246819488,9,0,0,1024,9,5663342388
1003,7246894497,148303,7247042800,8,0,0,23552,8,6452866146
1004,7246915076,158307,7247073383,4,0,0,84480,4,2102853428
1005,7246968237,265858,7247234095,2,0,0,81920,2,10734768067
1006,7246969295,1994,7246971289,7,0,1,2048,7,5890326839
1007,7247003520,6278,7247009798,3,0,1,6656,3,2776558854
1008,7247008425,82447,7247090872,4,0,0,7680,4,7419448180
1009,7247057445,176977,7247234422,7,0,0,1024,7,5412834611
1010,7247080701,128419,7247209120,1,0,0,20480,1,5585681833
1011,7247183066,3645,7247186711,6,0,1,10240,6,5627433254
1012,7247236396,3898,7247240294,6,0,1,4096,6,6206298820
1013,7247259578,98641,7247358219,2,0,0,17920,2,9511570482
1014,7247346680,3422,7247350102,3,0,1,3584,3,880633789
1015,7247405075,4850,7247409925,3,0,1,5120,3,487469785
1016,7247428419,67238,7247495657,5,0,1,114176,5,9119701048
1017,7247441233,59813,7247501046,5,0,1,17408,5,995152664
1018,7247474701,26691,7247501392,0,0,1,512,0,5040284130
1019,7247484046,172586,7247656632,9,0,0,512,9,3665527258
1020,7247518785,217449,7247736234,4,0,0,33792,4,1548886108
1021,7247540729,1994,7247542723,2,0,1,2048,2,10564357002
1022,7247575398,23378,7247598776,1,0,1,41984,1,7291132896
1023,7247615386,88155,7247703541,9,0,0,2048,9,585314073
1024,7247635683,3422,7247639105,9,0,1,3584,9,5794516804
1025,7247653972,2470,7247656442,4,0,1,2560,4,2420803974
1026,7247721002,167818,7247888820,2,0,0,22528,2,5219389044
1027,7247765580,140070,7247905650,9,0,0,1024,9,4446350988
1028,7247785138,46988,7247832126,5,0,1,81408,5,2122405240
1029,7247859745,275950,7248135695,3,0,0,61440,3,2257649940
1030,7247910101,43904,7247954005,9,0,0,512,9,6886393689
1031,7247911317,64534,7247975851,9,0,0,512,9,4271118912
1032,7247985227,123624,7248108851,1,0,0,3584,1,9431756447
1033,7248000117,7706,7248007823,8,0,1,8192,8,1608687805
1034,7248052836,207504,7248260340,4,0,0,79360,4,5483738670
1035,7248063303,566,7248063869,9,0,1,512,9,1202613762
1036,7248063707,14029,7248077736,5,0,1,27136,5,8974247225
1037,7248112882,2946,7248115828,9,0,1,3072,9,9664478968
1038,7248242893,22289,7248265182,6,0,1,5120,6,8349195668
1039,7248347486,4850,7248352336,5,0,1,5120,5,6163266216
1040,7248421992,101192,7248523184,3,0,0,32256,3,6301918532
1041,7248440676,14029,7248454705,1,0,1,27136,1,1375289755
1042,7248487453,142932,7248630385,7,0,0,2048,7,8171919313
1043,7248780735,2946,7248783681,4,0,1,3072,4,8472048946
1044,7248807013,109460,7248916473,4,0,0,59392,4,5358345241
1045,7248826762,43904,7248870666,9,0,0,512,9,3351901905
1046,7248885192,50672,7248935864,7,0,0,2560,7,1338854937
1047,7248939395,566,7248939961,3,0,1,512,3,4329841836
1048,7248964974,50672,7249015646,9,0,0,2560,9,8994722500
1049,7249003377,3422,7249006799,2,0,1,3584,2,5825363471
1050,7249068543,7706,7249076249,4,0,1,8192,4,10202124618
1051,7249133372,13858,7249147230,5,0,1,23552,5,5555837957
1052,7249202905,5326,7249208231,9,0,1,5632,9,5217914701
1053,7249235909,1994,7249237903,2,0,1,2048,2,543947315
1054,7249414612,47288,7249461900,6,0,0,1536,6,5658634046
1055,7249500711,65768,7249566479,8,0,0,11776,8,5578002801
1056,7249560182,13512,7249573694,1,0,1,26112,1,7086187351
1057,7249633253,82149,7249715402,1,0,1,133120,1,1628281313
1058,7249697012,18736,7249715748,3,0,1,512,3,10250987427
1059,7249721728,126672,7249848400,2,0,0,38912,2,6597815941
1060,7249744167,43112,7249787279,5,0,1,73728,5,8365701018
1061,7249767709,160202,7249927911,2,0,0,22016,2,8982326994
1062,7250132319,59132,7250191451,8,0,0,5120,8,6577752829
1063,7250225813,62072,7250287885,2,0,0,9728,2,2161880343
1064,7250372407,3898,7250376305,5,0,1,4096,5,2630030428
1065,7250384768,4374,7250389142,3,0,1,4608,3,3559701527
1066,7250392663,3898,7250396561,4,0,1,4096,4,4273601914
1067,7250480298,70844,7250551142,4,0,0,13312,4,8100611122
1068,7250550133,5680,7250555813,4,0,1,12288,4,5641650914
1069,7250552329,3830,7250556159,9,0,1,512,9,9702291149
1070,7250578405,566,7250578971,0,0,1,512,0,7928995491
1071,7250579672,107865,7250687537,4,0,0,52736,4,10227810095
1072,7250590181,106674,7250696855,9,0,0,1536,9,4123248208
1073,7250664723,43887,7250708610,1,0,1,75264,1,1625868841
1074,7250807391,75608,7250882999,6,0,0,13824,6,4799735179
1075,7250822176,101102,7250923278,6,0,0,16896,6,661761548
1076,7250828661,566,7250829227,0,0,1,512,0,6315462000
1077,7250857419,65874,7250923293,1,0,1,104448,1,4818571527
1078,7250898561,120808,7251019369,4,0,0,17408,4,9108953361
1079,7250907583,19499,7250927082,5,0,1,18944,5,4803339308
1080,7251137369,5802,7251143171,2,0,1,6144,2,4129784515
1081,7251159284,5802,7251165086,4,0,1,6144,4,337684093
1082,7251233573,48980,7251282553,0,0,0,2048,0,5466550799
1083,7251273255,102908,7251376163,3,0,0,37888,3,2407697364
1084,7251326606,2470,7251329076,2,0,1,2560,2,4630432139
1085,7251332452,99320,7251431772,3,0,0,26112,3,2131076652
1086,7251407731,1518,7251409249,2,0,1,1536,2,940323774
1087,7251433885,1042,7251434927,0,0,1,1024,0,8517718512
1088,7251450737,48980,7251499717,2,0,0,2048,2,3001880832
1089,7251465040,67592,7251532632,1,0,0,7680,1,9686718050
1090,7251469448,128648,7251598096,3,0,0,36352,3,10401793609
1091,7251478481,12566,7251491047,5,0,1,20992,5,8023108733
1092,7251524966,7681,7251532647,6,0,1,6144,6,6500280043
1093,7251547702,161848,7251709550,2,0,0,47616,2,7297867565
1094,7251584558,1042,7251585600,0,0,1,1024,0,1065530924
1095,7251612639,114111,7251726750,8,0,0,13312,8,4505110338
1096,7251843704,43904,7251887608,0,0,0,512,0,9407704854
1097,7251909504,1518,7251911022,2,0,1,1536,2,4696214084
1098,7251934243,2470,7251936713,2,0,1,2560,2,9159439208
1099,7251948576,43904,7251992480,9,0,0,512,9,1869924181
1100,7252036015,3422,7252039437,3,0,1,3584,3,220501169
1101,7252077455,76544,7252153999,8,0,0,16896,8,1514827314
1102,7252277589,1042,7252278631,4,0,1,1024,4,4279908293
1103,7252386451,3898,7252390349,4,0,1,4096,4,10069446038
1104,7252437114,100880,7252537994,6,0,0,31232,6,4653672539
1105,7252536674,46908,7252583582,9,0,0,1024,9,3121168083
1106,7252622597,1518,7252624115,3,0,1,1536,3,6984775567
1107,7252648136,3422,7252651558,3,0,1,3584,3,8654731002
1108,7252670928,5802,7252676730,0,0,1,6144,0,3811165839
1109,7252719744,130697,7252850441,3,0,0,56320,3,6192358792
1110,7252753371,11016,7252764387,7,0,1,17920,7,34082645
1111,7252942911,1042,7252943953,6,0,1,1024,6,9895878877
1112,7252948827,97448,7253046275,4,0,0,19968,4,8250537335
1113,7252979248,1994,7252981242,0,0,1,2048,0,6286708337
1114,7253040763,9402,7253050165,0,0,1,4096,0,10001357928
1115,7253070484,45596,7253116080,7,0,0,1024,7,9181058634
1116,7253122928,3422,7253126350,4,0,1,3584,4,4343990550
1117,7253155895,1042,7253156937,8,0,1,1024,8,7204712276
1118,7253177107,75710,7253252817,0,0,0,512,0,8983862616
1119,7253178226,12049,7253190275,0,0,1,19968,0,10452132657
1120,7253308521,101036,7253409557,3,0,0,31744,3,5426066135
1121,7253356960,96404,7253453364,6,0,0,26624,6,4048560000
1122,7253540414,45596,7253586010,0,0,0,1024,0,4955375502
1123,7253559811,1518,7253561329,0,0,1,1536,0,3656625383
1124,7253617305,7230,7253624535,4,0,1,7680,4,1566515518
1125,7253664104,107588,7253771692,1,0,0,53248,1,9768344865
1126,7253744219,6278,7253750497,4,0,1,6656,4,6022415443
1127,7253787158,14029,7253801187,1,0,1,27136,1,9273598815
1128,7253862698,45596,7253908294,9,0,0,1024,9,6699505103
1129,7253902834,47288,7253950122,9,0,0,1536,9,6863896119
1130,7254022079,3422,7254025501,7,0,1,3584,7,53464674
1131,7254022938,47570,7254070508,7,0,0,1536,7,7678802263
1132,7254036029,111176,7254147205,8,0,0,65024,8,443775579
1133,7254191311,11791,7254203102,4,0,1,19456,4,9181423818
1134,7254245720,45596,7254291316,7,0,0,1024,7,8395785229
1135,7254259224,4162,7254263386,9,0,1,11264,9,4590672242
1136,7254289386,45596,7254334982,0,0,0,1024,0,3992755894
1137,7254297363,43904,7254341267,9,0,0,512,9,9035767762
1138,7254442376,2946,7254445322,2,0,1,3072,2,3266792234
1139,7254642404,1042,7254643446,8,0,1,1024,8,9949608529
1140,7254656712,43904,7254700616,7,0,0,512,7,3163916394
1141,7254693367,43904,7254737271,0,0,0,512,0,9332709724
1142,7254753001,4374,7254757375,8,0,1,4608,8,2181759793
1143,7254754854,95492,7254850346,1,0,0,28672,1,4180812385
1144,7254894974,1994,7254896968,7,0,1,2048,7,1855288887
1145,7254896922,6283,7254903205,0,0,1,6656,0,4320544467
1146,7254902311,81620,7254983931,4,0,0,18432,4,3131341961
1147,7254961498,1994,7254963492,9,0,1,2048,9,8754511057
1148,7254968402,109098,7255077500,2,0,0,37376,2,4613148400
1149,7255087162,43904,7255131066,2,0,0,512,2,9063012690
1150,7255148582,1518,7255150100,8,0,1,1536,8,5043789305
1151,7255182762,566,7255183328,3,0,1,512,3,2643819809
1152,7255183397,5802,7255189199,4,0,1,6144,4,4603032551
1153,7255412698,47288,7255459986,8,0,0,1536,8,2792785096
1154,7255469461,178100,7255647561,1,0,0,153600,1,2507556453
1155,7255475903,4850,7255480753,7,0,1,5120,7,7693496828
1156,7255500072,2946,7255503018,7,0,1,3072,7,2788297903
1157,7255614195,34400,7255648595,5,0,1,1024,5,6070000284
1158,7255662734,82976,7255745710,8,0,0,12800,8,547020872
1159,7255681127,64754,7255745881,9,0,0,512,9,9704697149
1160,7255724871,4420,7255729291,9,0,1,11776,9,5524942801
1161,7255735125,53761,7255788886,0,0,0,1024,0,4027528732
1162,7255842722,12049,7255854771,3,0,1,19968,3,4629937823
1163,7255859219,84860,7255944079,7,0,0,1536,7,6169934519
1164,7255913511,43904,7255957415,0,0,0,512,0,609016055
1165,7255934282,2946,7255937228,3,0,1,3072,3,5425354820
1166,7255987080,126269,7256113349,8,0,0,26112,8,1615192803
1167,7256026171,3898,7256030069,8,0,1,4096,8,9782052375
1168,7256084322,6754,7256091076,2,0,1,7168,2,190992123
1169,7256104732,72668,7256177400,3,0,0,9216,3,5157054759
1170,7256169412,11791,7256181203,6,0,1,19456,6,1733894543
1171,7256191212,183327,7256374539,9,0,0,512,9,8905018770
1172,7256231216,143144,7256374360,1,0,0,134656,1,6427752201
1173,7256336792,115304,7256452096,2,0,0,10752,2,10088800132
1174,7256399682,566,7256400248,7,0,1,512,7,8081596283
1175,7256447063,103517,7256550580,1,0,0,34304,1,8829892114
1176,7256562484,32041,7256594525,5,0,1,52224,5,2058552461
1177,7256589583,105716,7256695299,2,0,0,47104,2,3301099026
1178,7256644845,50766,7256695611,7,0,0,512,7,9387495782
1179,7256736755,14117,7256750872,5,0,1,24064,5,8335074462
1180,7256769158,43904,7256813062,9,0,0,512,9,4663070490
1181,7256841260,5802,7256847062,3,0,1,6144,3,2877305010
1182,7256944310,45596,7256989906,6,0,0,1024,6,423935636
1183,7257078534,3422,7257081956,0,0,1,3584,0,5863132662
1184,7257086319,1518,7257087837,8,0,1,1536,8,5583815463
1185,7257114515,45596,7257160111,9,0,0,1024,9,9095672176
1186,7257237852,4420,7257242272,9,0,1,11776,9,1513857532
1187,7257249554,46212,7257295766,1,0,1,79872,1,2577368939
1188,7257313395,101816,7257415211,8,0,0,34304,8,6420945478
1189,7257474538,14029,7257488567,1,0,1,27136,1,10450550388
1190,7257589188,99632,7257688820,2,0,0,27136,2,7417868599
1191,7257633209,1994,7257635203,0,0,1,2048,0,5995954490
1192,7257671274,2470,7257673744,6,0,1,2560,6,2592803682
1193,7257677957,22691,7257700648,1,0,1,37376,1,8262576012
1194,7257724270,45596,7257769866,7,0,0,1024,7,3499281697
1195,7257777570,1994,7257779564,4,0,1,2048,4,6578874501
1196,7257840187,110396,7257950583,1,0,0,62464,1,1264183424
1197,7257861934,1042,7257862976,3,0,1,1024,3,5938104037
1198,7257898416,52182,7257950598,1,0,1,68608,1,2102534672
1199,7257996334,157078,7258153412,1,0,0,18432,1,10459653750
1200,7258010347,3904,7258014251,4,0,1,10752,4,7435641518
1201,7258054538,1994,7258056532,7,0,1,2048,7,966516725
1202,7258110116,566,7258110682,4,0,1,512,4,9351251698
1203,7258255754,112268,7258368022,4,0,0,68608,4,5498995718
1204,7258266840,566,7258267406,7,0,1,512,7,4859724212
1205,7258286555,1518,7258288073,3,0,1,1536,3,5744656111
1206,7258302118,3422,7258305540,2,0,1,3584,2,5222392421
1207,7258354866,115234,7258470100,4,0,0,32256,4,8096249737
1208,7258491884,3422,7258495306,0,0,1,3584,0,3458525509
1209,7258636629,106496,7258743125,1,0,0,49664,1,7794221577
1210,7258719306,55562,7258774868,2,0,1,94720,2,5398510884
1211,7258781922,1518,7258783440,7,0,1,1536,7,6339920844
1212,7258784108,3422,7258787530,5,0,1,3584,5,1780642875
1213,7258819817,211181,7259030998,8,0,0,49664,8,4695000732
1214,7259043481,6754,7259050235,0,0,1,7168,0,6268746899
1215,7259053006,1042,7259054048,3,0,1,1024,3,10252635850
1216,7259131560,105248,7259236808,6,0,0,45568,6,355402375
1217,7259164996,3898,7259168894,4,0,1,4096,4,1717068041
1218,7259312564,47288,7259359852,7,0,0,1536,7,1172004152
1219,7259402901,32041,7259434942,5,0,1,52224,5,8268192895
1220,7259524404,86454,7259610858,2,0,1,144896,2,7629767728
1221,7259534020,152961,7259686981,7,0,0,1536,7,1785039043
1222,7259550146,118892,7259669038,8,0,0,29696,8,464326694
1223,7259599344,219558,7259818902,3,0,0,54272,3,4220073499
1224,7259610462,132073,7259742535,2,0,0,16384,2,1029364940
1225,7259672104,146969,7259819073,0,0,0,512,0,1739607409
1226,7259686902,2065,7259688967,9,0,1,2048,9,5171703172
1227,7259748093,45596,7259793689,9,0,0,1024,9,2968483568
1228,7259774665,71549,7259846214,7,0,0,512,7,924475091
1229,7259875114,102440,7259977554,1,0,0,36352,1,9296064867
1230,7260019360,6229,7260025589,2,0,1,15360,2,1913892923
1231,7260030072,566,7260030638,4,0,1,512,4,2743274730
1232,7260032765,96124,7260128889,1,0,0,12800,1,5862330418
1233,7260034072,7230,7260041302,3,0,1,7680,3,1664344667
1234,7260089365,66721,7260156086,1,0,1,113152,1,10299701598
1235,7260274363,23725,7260298088,1,0,1,39424,1,8613298451
1236,7260299248,99632,7260398880,4,0,0,27136,4,2399575180
1237,7260417222,4850,7260422072,6,0,1,5120,6,8913621411
1238,7260610560,15837,7260626397,5,0,1,30720,5,5510609069
1239,7260647163,45596,7260692759,0,0,0,1024,0,4020722297
1240,7260650720,2946,7260653666,7,0,1,3072,7,8707491754
1241,7260708628,120467,7260829095,4,0,0,10752,4,10551459638
1242,7260760859,155482,7260916341,1,0,0,69120,1,1129751067
1243,7260769797,7706,7260777503,8,0,1,8192,8,6739941573
1244,7260806023,122657,7260928680,4,0,0,40448,4,618515122
1245,7260836173,5802,7260841975,0,0,1,6144,0,3568408978
1246,7260863221,1042,7260864263,4,0,1,1024,4,3881035976
1247,7261088886,1994,7261090880,4,0,1,2048,4,9597250400
1248,7261118955,2946,7261121901,4,0,1,3072,4,4549511055
1249,7261129794,4937,7261134731,3,0,1,12800,3,3303265999
1250,7261148537,47288,7261195825,3,0,0,1536,3,224632973
1251,7261193909,45752,7261239661,0,0,0,1536,0,8587853370
1252,7261250999,3422,7261254421,3,0,1,3584,3,8123049231
1253,7261280216,73058,7261353274,5,0,1,118784,5,10519844910
1254,7261298681,114536,7261413217,9,0,0,1536,9,9929990721
1255,7261327258,89187,7261416445,7,0,0,2048,7,7782725119
1256,7261414319,43904,7261458223,9,0,0,512,9,3840941862
1257,7261600423,43904,7261644327,0,0,0,512,0,9229424425
1258,7261644581,43887,7261688468,5,0,1,75264,5,9697687179
1259,7261649403,65147,7261714550,5,0,1,81408,5,4883382774
1260,7261745570,187195,7261932765,0,0,0,2048,0,3686874364
1261,7261890190,43904,7261934094,0,0,0,512,0,4191874641
1262,7262007261,65900,7262073161,0,0,0,7168,0,3422784265
1263,7262127347,108212,7262235559,8,0,0,55296,8,9435295924
1264,7262212556,118820,7262331376,4,0,0,90112,4,1589732912
1265,7262307100,68172,7262375272,7,0,0,512,7,750212859
1266,7262357069,98228,7262455297,2,0,0,22528,2,5354374836
1267,7262359017,45596,7262404613,0,0,0,1024,0,727263385
1268,7262448769,10424,7262459193,4,0,1,10752,4,2512757822
1269,7262540249,3422,7262543671,6,0,1,3584,6,8331582144
1270,7262607297,99944,7262707241,6,0,0,28160,6,3273746044
1271,7262644389,63023,7262707412,7,0,0,512,7,734569633
1272,7262686750,110864,7262797614,8,0,0,64000,8,10465220950
1273,7262769612,1042,7262770654,0,0,1,1024,0,8122720323
1274,7262791174,264795,7263055969,3,0,0,152576,3,7904897657
1275,7262834898,170178,7263005076,3,0,0,22016,3,2067875461
1276,7262851985,31783,7262883768,1,0,1,51712,1,1610091018
1277,7262929596,3422,7262933018,7,0,1,3584,7,1852890285
1278,7262942210,47288,7262989498,7,0,0,1536,7,4283676190
1279,7262954522,156141,7263110663,9,0,0,512,9,1685116833
1280,7263127894,82666,7263210560,1,0,1,134144,1,2641977684
1281,7263129262,142506,7263271768,9,0,0,512,9,4774298688
1282,7263130231,81200,7263211431,4,0,1,12288,4,8397128727
1283,7263174828,191316,7263366144,3,0,0,1536,3,5633213776
1284,7263193284,172206,7263365490,1,0,0,75264,1,5057624350
1285,7263204982,160679,7263365661,7,0,0,512,7,5568299605
1286,7263238939,102519,7263341458,3,0,0,16384,3,617941502
1287,7263335431,6042,7263341473,3,0,1,2560,3,896785140
1288,7263397781,21916,7263419697,1,0,1,35840,1,501481232
1289,7263479705,111644,7263591349,1,0,0,66560,1,3923320347
1290,7263620774,68372,7263689146,8,0,0,10240,8,8101755181
1291,7263733644,3904,7263737548,6,0,1,10752,6,7543079254
1292,7263846931,6278,7263853209,4,0,1,6656,4,10500013667
1293,7263948553,54056,7264002609,9,0,0,3584,9,2556765155
1294,7263957004,48980,7264005984,0,0,0,2048,0,6169328519
1295,7264020469,2870,7264023339,4,0,1,8704,4,2433937762
1296,7264101408,78992,7264180400,4,0,0,14848,4,9369594823
1297,7264221144,88412,7264309556,6,0,0,25600,6,2864757734
1298,7264343034,90304,7264433338,6,0,0,14336,6,5936641312
1299,7264360415,3904,7264364319,2,0,1,10752,2,8273349099
1300,7264361553,3432,7264364985,6,0,1,1024,6,1620178391
1301,7264365141,45179,7264410320,5,0,1,77824,5,4216414658
1302,7264406345,56996,7264463341,1,0,0,8192,1,6125865077
1303,7264417537,79309,7264496846,0,0,0,1024,0,4041163609
1304,7264438470,59510,7264497980,7,0,0,512,7,9503222024
1305,7264481620,60083,7264541703,7,0,0,3072,7,8633426037
1306,7264507820,177253,7264685073,2,0,0,121856,2,5656104475
1307,7264679300,11091,7264690391,3,0,1,5632,3,1900777280
1308,7264690539,60824,7264751363,1,0,0,5632,1,1416222697
1309,7264894507,3422,7264897929,4,0,1,3584,4,1764056819
1310,7264989176,2470,7264991646,8,0,1,2560,8,647085795
1311,7264991020,72980,7265064000,2,0,0,10240,2,2282038397
1312,7264991915,1994,7264993909,9,0,1,2048,9,9337077541
1313,7264992043,89236,7265081279,2,0,0,15360,2,6817860835
1314,7265140117,101504,7265241621,6,0,0,33280,6,10247661194
1315,7265141623,192704,7265334327,4,0,0,109568,4,10279932565
1316,7265205708,566,7265206274,7,0,1,512,7,2501721247
1317,7265317759,21886,7265339645,0,0,1,5632,0,687060022
1318,7265351069,103718,7265454787,8,0,0,20480,8,32079177
1319,7265361248,4420,7265365668,8,0,1,11776,8,880825449
1320,7265370456,177820,7265548276,2,0,0,16896,2,4500448797
1321,7265435809,4374,7265440183,4,0,1,4608,4,5064943401
1322,7265453424,141935,7265595359,6,0,0,10240,6,839116622
1323,7265664523,3387,7265667910,2,0,1,9728,2,5853251138
1324,7265680468,2946,7265683414,9,0,1,3072,9,6244880866
1325,7265696098,566,7265696664,9,0,1,512,9,6013239018
1326,7265725250,153915,7265879165,8,0,0,21504,8,5158695356
1327,7265768654,6754,7265775408,2,0,1,7168,2,6797183971
1328,7265772474,5196,7265777670,0,0,1,13312,0,5820843530
1329,7265831587,150740,7265982327,0,0,0,512,0,7083235308
1330,7265842032,14029,7265856061,5,0,1,27136,5,9532570354
1331,7265843397,13010,7265856407,8,0,1,512,8,1128218373
1332,7265998966,43904,7266042870,7,0,0,512,7,1092954748
1333,7266017037,117915,7266134952,2,0,0,74752,2,3814471405
1334,7266080513,158851,7266239364,3,0,0,117760,3,5962192929
1335,7266124240,128162,7266252402,8,0,0,8192,8,7895468299
1336,7266132790,144884,7266277674,2,0,0,25600,2,5759036449
1337,7266275912,6604,7266282516,3,0,1,5120,3,6353036840
1338,7266301619,4679,7266306298,8,0,1,12288,8,2803422922
1339,7266304913,5349,7266310262,4,0,1,5120,4,8631635821
1340,7266332186,150672,7266482858,6,0,0,2560,6,5618547760
1341,7266365211,1994,7266367205,4,0,1,2048,4,3582417185
1342,7266415188,50672,7266465860,0,0,0,2560,0,10249944054
1343,7266481458,124436,7266605894,6,0,0,108544,6,6121306951
1344,7266508877,135819,7266644696,1,0,0,23040,1,9965007552
1345,7266615516,57572,7266673088,9,0,0,3072,9,7204667281
1346,7266778917,566,7266779483,2,0,1,512,2,1205033212
1347,7266794257,1518,7266795775,0,0,1,1536,0,9244797852
1348,7266823821,59132,7266882953,8,0,0,5120,8,8523442273
1349,7266965932,7230,7266973162,5,0,1,7680,5,10389592479
1350,7267095869,2946,7267098815,3,0,1,3072,3,4886313978
1351,7267102909,1042,7267103951,2,0,1,1024,2,6769596891
1352,7267177446,103466,7267280912,4,0,0,4096,4,4131678157
1353,7267325897,7230,7267333127,5,0,1,7680,5,9566400210
1354,7267328098,7935,7267336033,6,0,1,4608,6,7373032338
1355,7267353370,154925,7267508295,2,0,0,17408,2,7126762386
1356,7267408603,2470,7267411073,7,0,1,2560,7,6285886516
1357,7267554206,2946,7267557152,9,0,1,3072,9,8049592358
1358,7267686245,52692,7267738937,4,0,0,3072,4,5525309090
1359,7267771726,119083,7267890809,2,0,0,34816,2,4571993612
1360,7267784422,1994,7267786416,8,0,1,2048,8,232147464
1361,7267788474,5802,7267794276,2,0,1,6144,2,5107584816
1362,7267800213,2946,7267803159,0,0,1,3072,0,2535428178
1363,7267838282,2470,7267840752,3,0,1,2560,3,10473260196
1364,7267869807,43904,7267913711,7,0,0,512,7,6912540125
1365,7267888138,48259,7267936397,4,0,0,1024,4,3381847339
1366,7268033317,153283,7268186600,8,0,1,248320,8,8004920581
1367,7268062193,279773,7268341966,3,0,0,19456,3,8754798925
1368,7268087066,101800,7268188866,4,0,1,3584,4,2463305810
1369,7268123296,66338,7268189634,6,0,1,11776,6,2774216418
1370,7268185026,166889,7268351915,9,0,0,512,9,1419538131
1371,7268240390,253846,7268494236,2,0,0,25600,2,7613675585
1372,7268319928,24929,7268344857,1,0,1,45056,1,4492814870
1373,7268324676,52933,7268377609,9,0,0,512,9,1149246092
1374,7268330089,112937,7268443026,1,0,0,19968,1,26054402
1375,7268339256,8187,7268347443,0,0,1,4096,0,3877698873
1376,7268397183,566,7268397749,9,0,1,512,9,7778399976
1377,7268397904,163580,7268561484,6,0,0,84992,6,1208792782
1378,7268489706,72113,7268561819,9,0,0,1024,9,4598913018
1379,7268541507,21313,7268562820,3,0,1,1024,3,6915603560
1380,7268562451,100503,7268662954,2,0,0,26112,2,2983151253
1381,7268579137,2870,7268582007,7,0,1,8704,7,690450476
1382,7268587728,126520,7268714248,3,0,0,16896,3,9336412775
1383,7268610495,201145,7268811640,4,0,0,36864,4,6424217202
1384,7268667571,566,7268668137,3,0,1,512,3,6165123176
1385,7268743738,111996,7268855734,1,0,0,64512,1,8612009725
1386,7268879922,4850,7268884772,6,0,1,5120,6,63968490
1387,7268988816,52364,7269041180,9,0,0,3072,9,9426867453
1388,7269044899,7706,7269052605,4,0,1,8192,4,5670394801
1389,7269078012,2946,7269080958,6,0,1,3072,6,2201316789
1390,7269117157,103844,7269221001,6,0,0,40960,6,1324115752
1391,7269237883,1994,7269239877,0,0,1,2048,0,5750172969
1392,7269405439,43904,7269449343,0,0,0,512,0,4169491986
1393,7269572772,43887,7269616659,5,0,1,75264,5,9585432566
1394,7269578952,134705,7269713657,3,0,0,55808,3,8747919759
1395,7269624989,161562,7269786551,1,0,0,67072,1,6725072305
1396,7269800124,45596,7269845720,7,0,0,1024,7,7859360182
1397,7269869943,7230,7269877173,9,0,1,7680,9,6192324096
1398,7269960545,3422,7269963967,4,0,1,3584,4,10724229330
1399,7270009291,1518,7270010809,2,0,1,1536,2,5044539635
1400,7270014222,2946,7270017168,0,0,1,3072,0,6534580050
1401,7270024449,221780,7270246229,3,0,0,95232,3,4323464712
1402,7270058069,13341,7270071410,5,0,1,22528,5,2801743936
1403,7270197137,49115,7270246252,5,0,1,45056,5,85275717
1404,7270215279,94565,7270309844,0,0,0,1536,0,4846120341
1405,7270218239,51190,7270269429,1,0,1,38400,1,3929517711
1406,7270272946,6278,7270279224,3,0,1,6656,3,7916260227
1407,7270275941,83700,7270359641,1,0,1,136192,1,4486074685
1408,7270350382,162377,7270512759,9,0,0,512,9,10726593585
1409,7270364859,146003,7270510862,7,0,0,512,7,1905295418
1410,7270430479,1518,7270431997,0,0,1,1536,0,3365567676
1411,7270552856,99632,7270652488,4,0,0,27136,4,8372719114
1412,7270704588,45596,7270750184,7,0,0,1024,7,7253039280
1413,7270720210,3422,7270723632,0,0,1,3584,0,8149278661
1414,7270767450,11274,7270778724,4,0,1,18432,4,6978440480
1415,7270784794,114764,7270899558,8,0,0,76800,8,6399895901
1416,7270820991,3128,7270824119,2,0,1,9216,2,436324929
1417,7270859754,125340,7270985094,3,0,0,57856,3,5124483520
1418,7270892682,98478,7270991160,7,0,0,1024,7,5388749563
1419,7270925337,7230,7270932567,9,0,1,7680,9,6900614764
1420,7270985916,107652,7271093568,4,0,0,42496,4,1724961733
1421,7271009977,2946,7271012923,4,0,1,3072,4,3954062960
1422,7271157785,3898,7271161683,0,0,1,4096,0,7369177700
1423,7271189947,1994,7271191941,9,0,1,2048,9,9449543749
1424,7271250557,47288,7271297845,8,0,0,1536,8,8706074797
1425,7271383116,5196,7271388312,5,0,1,13312,5,6461771763
1426,7271419097,1994,7271421091,6,0,1,2048,6,504215024
1427,7271555084,6754,7271561838,5,0,1,7168,5,4995787749
1428,7271698079,47288,7271745367,9,0,0,1536,9,6330407313
1429,7271734421,24412,7271758833,8,0,1,44032,8,3994622329
1430,7271745092,35781,7271780873,1,0,1,57344,1,6986305243
1431,7271752330,29529,7271781859,7,0,1,1536,7,7281818874
1432,7271764416,23549,7271787965,6,0,1,20992,6,5386448828
1433,7271792769,3387,7271796156,6,0,1,9728,6,5555024112
1434,7271810099,127818,7271937917,2,0,0,32256,2,7222041622
1435,7271938135,4420,7271942555,3,0,1,11776,3,3527396660
1436,7271950307,3422,7271953729,0,0,1,3584,0,2148175814
1437,7272015970,142650,7272158620,8,0,0,27136,8,913579032
1438,7272044963,14545,7272059508,8,0,1,28160,8,3787330211
1439,7272082414,42424,7272124838,1,0,1,69120,1,8396000828
1440,7272141541,1042,7272142583,3,0,1,1024,3,5879332697
1441,7272252753,185780,7272438533,2,0,0,153600,2,10604919229
1442,7272289562,7230,7272296792,9,0,1,7680,9,6672933300
1443,7272393166,52113,7272445279,0,0,1,7168,0,646294704
1444,7272440244,6341,7272446585,0,0,1,2048,0,1144060469
1445,7272473046,5454,7272478500,7,0,1,13824,7,10426018794
1446,7272603875,43904,7272647779,7,0,0,512,7,2609869559
1447,7272612004,103064,7272715068,8,0,0,38400,8,6860618049
1448,7272613834,6278,7272620112,7,0,1,6656,7,3788394754
1449,7272740063,112112,7272852175,1,0,0,68096,1,4602765491
1450,7272787834,122103,7272909937,4,0,0,29696,4,456301296
1451,7272799609,5326,7272804935,2,0,1,5632,2,1482849523
1452,7272830903,46064,7272876967,4,0,0,1024,4,6440252275
1453,7272844881,51190,7272896071,7,0,0,512,7,2706152863
1454,7272856605,147292,7273003897,4,0,0,38400,4,9833124821
1455,7272880241,77771,7272958012,3,0,0,6656,3,394245314
1456,7273014051,45596,7273059647,0,0,0,1024,0,10727473752
1457,7273123841,49292,7273173133,2,0,0,3072,2,4562697978
1458,7273165945,4937,7273170882,6,0,1,12800,6,1430552218
1459,7273238149,4850,7273242999,5,0,1,5120,5,5045210726
1460,7273375467,1042,7273376509,3,0,1,1024,3,2093983753
1461,7273464476,2946,7273467422,0,0,1,3072,0,1063326369
1462,7273490570,104780,7273595350,8,0,0,44032,8,7530749079
1463,7273552820,12049,7273564869,8,0,1,19968,8,8405953572
1464,7273565921,65216,7273631137,7,0,0,1536,7,1326587288
1465,7273599636,3645,7273603281,0,0,1,10240,0,10431977979
1466,7273721608,103220,7273824828,8,0,0,38912,8,4687493040
1467,7273742043,47007,7273789050,0,0,0,1024,0,239120393
1468,7273820182,9964,7273830146,4,0,1,5632,4,9897317206
1469,7273963498,6754,7273970252,4,0,1,7168,4,2813888725
1470,7273984511,1994,7273986505,7,0,1,2048,7,9575770949
1471,7274243970,74852,7274318822,4,0,0,16384,4,2096161137
1472,7274376437,43904,7274420341,9,0,0,512,9,1676385481
1473,7274443272,99944,7274543216,2,0,0,28160,2,2248537137
1474,7274489192,3422,7274492614,2,0,1,3584,2,6130177196
1475,7274513860,45596,7274559456,0,0,0,1024,0,3378063465
1476,7274683196,5196,7274688392,9,0,1,13312,9,6931879139
1477,7274707373,127772,7274835145,2,0,0,53248,2,3208848807
1478,7274730282,3422,7274733704,6,0,1,3584,6,9358302574
1479,7274769541,101208,7274870749,1,0,0,12288,1,9858654453
1480,7274816723,1994,7274818717,9,0,1,2048,9,7071677392
1481,7274872344,2946,7274875290,9,0,1,3072,9,7433938580
1482,7275041106,100412,7275141518,1,0,0,29696,1,8656358989
1483,7275114213,106964,7275221177,6,0,0,51200,6,6820334135
1484,7275136983,15801,7275152784,8,0,1,18432,8,8770977940
1485,7275155730,135665,7275291395,3,0,0,48640,3,1181421284
1486,7275165360,153894,7275319254,3,0,0,41984,3,3925431889
1487,7275174367,145230,7275319597,8,0,0,1024,8,10269700990
1488,7275210189,18686,7275228875,6,0,1,8192,6,2604609138
1489,7275306666,18861,7275325527,6,0,1,14848,6,6532774155
1490,7275308337,22973,7275331310,6,0,1,7680,6,4546070696
1491,7275367555,101504,7275469059,3,0,0,33280,3,7385981514
1492,7275439752,1042,7275440794,6,0,1,1024,6,9091802580
1493,7275494061,566,7275494627,0,0,1,512,0,7515298292
1494,7275502719,110864,7275613583,8,0,0,64000,8,2894277087
1495,7275525807,62516,7275588323,6,0,0,6144,6,5899917676
1496,7275548049,566,7275548615,9,0,1,512,9,762112840
1497,7275563184,59669,7275622853,1,0,0,2560,1,4363732737
1498,7275672306,2946,7275675252,6,0,1,3072,6,4779847905
1499,7275690451,105560,7275796011,8,0,0,46592,8,4995355592
1500,7275907877,104783,7276012660,3,0,0,44032,3,3570919229
1501,7275946709,52520,7275999229,0,0,0,3584,0,5113156573
1502,7276051147,13770,7276064917,9,0,1,26624,9,5425348365
1503,7276054359,10904,7276065263,0,0,1,512,0,8592694594
1504,7276074623,79802,7276154425,0,0,0,512,0,1875968015
1505,7276135460,45596,7276181056,8,0,0,1024,8,7246890545
1506,7276208035,43904,7276251939,9,0,0,512,9,8998934026
1507,7276307508,3904,7276311412,5,0,1,10752,5,187410003
1508,7276326183,48842,7276375025,9,0,0,512,9,5198990912
1509,7276361890,124436,7276486326,3,0,0,108544,3,4532939906
1510,7276441585,44756,7276486341,8,0,1,71680,8,3893232006
1511,7276501357,206283,7276707640,4,0,0,14848,4,9090141008
1512,7276507464,2946,7276510410,9,0,1,3072,9,3524748603
1513,7276543240,1994,7276545234,4,0,1,2048,4,178423758
1514,7276682709,1042,7276683751,9,0,1,1024,9,5695817681
1515,7276811176,3422,7276814598,4,0,1,3584,4,6083367767
1516,7276813953,43887,7276857840,1,0,1,75264,1,4209286304
1517,7276814089,48577,7276862666,4,0,1,7680,4,7027503290
1518,7276827892,156478,7276984370,8,0,0,31744,8,321686
1519,7276868608,4374,7276872982,6,0,1,4608,6,9635695228
1520,7276871751,162197,7277033948,4,0,0,16896,4,8140141734
1521,7276964968,1518,7276966486,6,0,1,1536,6,10524913549
1522,7276988495,65535,7277054030,9,0,0,1024,9,9136032669
1523,7277021297,51351,7277072648,7,0,0,512,7,3793201699
1524,7277032602,45242,7277077844,7,0,0,512,7,242145966
1525,7277110395,5326,7277115721,5,0,1,5632,5,6361707114
1526,7277197804,43904,7277241708,7,0,0,512,7,10377338257
1527,7277299210,1518,7277300728,0,0,1,1536,0,2787690764
1528,7277321454,54212,7277375666,3,0,0,4096,3,1957898649
1529,7277389117,4374,7277393491,8,0,1,4608,8,5654363727
1530,7277398692,24929,7277423621,8,0,1,45056,8,5140112237
1531,7277405007,214946,7277619953,1,0,0,14848,1,1733214544
1532,7277459079,234689,7277693768,3,0,0,123904,3,10233113228
1533,7277466544,189457,7277656001,4,0,0,37376,4,6963399703
1534,7277615076,154229,7277769305,3,0,0,109568,3,9021642640
1535,7277718690,61079,7277779769,7,0,0,512,7,2622443320
1536,7277737780,43608,7277781388,2,0,1,19968,2,7655561146
1537,7277743598,39416,7277783014,0,0,1,2560,0,2955502874
1538,7277764257,169637,7277933894,2,0,0,61440,2,10447852080
1539,7277776280,7502,7277783782,1,0,1,11776,1,84570942
1540,7277965767,67592,7278033359,3,0,0,7680,3,6264391688
1541,7277990276,1042,7277991318,9,0,1,1024,9,9006057909
1542,7278022168,115765,7278137933,9,0,0,512,9,7818214569
1543,7278095084,121485,7278216569,2,0,0,97280,2,4926726808
1544,7278119467,20366,7278139833,8,0,1,32768,8,6725263002
1545,7278151289,66387,7278217676,2,0,0,3584,2,8657350216
1546,7278248259,2470,7278250729,2,0,1,2560,2,10235138528
1547,7278250035,7706,7278257741,2,0,1,8192,2,2033141404
1548,7278258000,116036,7278374036,4,0,0,27136,4,10490534634
1549,7278306619,1042,7278307661,7,0,1,1024,7,7945146552
1550,7278341811,7230,7278349041,2,0,1,7680,2,836697307
1551,7278382788,11274,7278394062,3,0,1,18432,3,6177465812
1552,7278618726,5326,7278624052,4,0,1,5632,4,6587148369
1553,7278668247,35054,7278703301,1,0,1,61440,1,160082519
1554,7278809182,1518,7278810700,5,0,1,1536,5,2194062959
1555,7278847385,3422,7278850807,8,0,1,3584,8,1404538731
1556,7278884120,6754,7278890874,9,0,1,7168,9,3001190898
1557,7278914660,55748,7278970408,6,0,0,4096,6,3075157904
1558,7278915423,56968,7278972391,7,0,0,512,7,6006096225
1559,7278941531,60824,7279002355,3,0,0,5632,3,1185300942
1560,7279019610,60068,7279079678,4,0,0,8192,4,1036523638
1561,7279120569,126152,7279246721,1,0,0,114176,1,2146945136
1562,7279225591,81946,7279307537,3,0,0,5632,3,1143948448
1563,7279358316,14804,7279373120,1,0,1,28672,1,5154990498
1564,7279418744,106340,7279525084,1,0,0,49152,1,560573063
1565,7279598387,5326,7279603713,9,0,1,5632,9,7049377799
1566,7279639637,6278,7279645915,9,0,1,6656,9,8514391670
1567,7279714651,43904,7279758555,7,0,0,512,7,7198080976
1568,7279728847,1518,7279730365,3,0,1,1536,3,8780835671
1569,7279832508,5326,7279837834,4,0,1,5632,4,892582296
1570,7279832541,5447,7279837988,5,0,1,8704,5,10302281635
1571,7279935384,4374,7279939758,9,0,1,4608,9,185554617
1572,7280159017,23895,7280182912,1,0,1,43008,1,3828399477
1573,7280178494,4777,7280183271,9,0,1,9728,9,2708991932
1574,7280255073,44492,7280299565,8,0,1,73216,8,3916458276
1575,7280284786,15125,7280299911,6,0,1,512,6,8908106910
1576,7280314597,4937,7280319534,0,0,1,12800,0,10658128708
1577,7280377135,129362,7280506497,9,0,0,1536,9,9087088720
1578,7280436042,5454,7280441496,3,0,1,13824,3,2552529723
1579,7280488962,7230,7280496192,0,0,1,7680,0,6668933220
1580,7280604590,148371,7280752961,8,0,0,43008,8,2016850748
1581,7280623917,104989,7280728906,2,0,0,17408,2,2721287247
1582,7280747952,10803,7280758755,3,0,1,6144,3,2456267397
1583,7280874983,43904,7280918887,9,0,0,512,9,7406205350
1584,7280993164,22174,7281015338,8,0,1,36352,8,4899434840
1585,7281079192,1518,7281080710,7,0,1,1536,7,97166484
1586,7281154260,6754,7281161014,2,0,1,7168,2,6046953672
1587,7281279082,5196,7281284278,1,0,1,13312,1,9470900100
1588,7281373176,100568,7281473744,2,0,0,30208,2,3747932026
1589,7281415737,566,7281416303,0,0,1,512,0,519227467
1590,7281416704,3422,7281420126,9,0,1,3584,9,6861409599
1591,7281427849,3645,7281431494,0,0,1,10240,0,3626228461
1592,7281473078,6112,7281479190,3,0,1,13824,3,4732322612
1593,7281582028,67592,7281649620,4,0,0,7680,4,2464455935
1594,7281643267,6368,7281649635,8,0,1,6656,8,6080054584
1595,7281690703,173589,7281864292,6,0,0,49152,6,8253014587
1596,7281729252,78045,7281807297,7,0,0,1024,7,6038355155
1597,7281815257,6754,7281822011,9,0,1,7168,9,5505191063
1598,7281815627,48992,7281864619,7,0,0,1024,7,7448407556
1599,7281865353,108368,7281973721,1,0,0,55808,1,1114842612
1600,7281902667,100100,7282002767,1,0,0,28672,1,2007404927
1601,7281951094,1518,7281952612,6,0,1,1536,6,3378047067
1602,7281999737,8348,7282008085,0,0,1,5632,0,4363184396
1603,7282036132,5802,7282041934,4,0,1,6144,4,2310653067
1604,7282279238,43904,7282323142,9,0,0,512,9,70566519
1605,7282322602,102440,7282425042,3,0,0,36352,3,4136501036
1606,7282411204,89324,7282500528,1,0,0,23552,1,5630873098
1607,7282468976,55748,7282524724,0,0,0,4096,0,8204341217
1608,7282471116,3387,7282474503,8,0,1,9728,8,10494707721
1609,7282548143,13253,7282561396,8,0,1,25600,8,6083728775
1610,7282626379,52364,7282678743,8,0,0,3072,8,2934971183
1611,7282693619,1042,7282694661,6,0,1,1024,6,3684270236
1612,7282739383,566,7282739949,6,0,1,512,6,3280567783
1613,7282870429,84824,7282955253,4,0,0,13824,4,3580750790
1614,7282896247,97916,7282994163,8,0,0,21504,8,8282051127
1615,7282955242,5805,7282961047,6,0,1,6144,6,9885477256
1616,7283119258,12049,7283131307,4,0,1,19968,4,567936209
1617,7283206309,2470,7283208779,2,0,1,2560,2,6732990656
1618,7283238099,86072,7283324171,1,0,0,17920,1,4051693652
1619,7283308868,97136,7283406004,1,0,0,18944,1,8895690392
1620,7283360326,4937,7283365263,0,0,1,12800,0,1579702130
1621,7283414529,89456,7283503985,1,0,0,18944,1,10229295025
1622,7283417822,3422,7283421244,4,0,1,3584,4,9776033682
1623,7283451163,3904,7283455067,2,0,1,10752,2,1676923512
1624,7283538891,14117,7283553008,1,0,1,24064,1,167615738
1625,7283542737,186543,7283729280,6,0,0,82432,6,2730970686
1626,7283550372,191879,7283742251,2,0,0,42496,2,8377804696
1627,7283555707,109616,7283665323,4,0,0,59904,4,8968144941
1628,7283706839,145309,7283852148,3,0,0,103424,3,3258854058
1629,7283741276,171286,7283912562,2,0,0,73728,2,4590326614
1630,7283834994,142506,7283977500,3,0,0,58880,3,8542455153
1631,7283836244,16487,7283852731,3,0,1,512,3,10433782702
1632,7283892878,133751,7284026629,8,0,1,185344,8,9944970752
1633,7284080289,107276,7284187565,3,0,0,52224,3,2656440674
1634,7284166779,4374,7284171153,3,0,1,4608,3,6728414997
1635,7284228989,53237,7284282226,1,0,1,90112,1,7331635834
1636,7284337747,77932,7284415679,9,0,0,2048,9,5604291902
1637,7284494508,98252,7284592760,4,0,0,27648,4,6200405502
1638,7284497980,5802,7284503782,1,0,1,6144,1,9956976809
1639,7284502641,92172,7284594813,0,0,0,512,0,5195672994
1640,7284506874,110084,7284616958,6,0,0,61440,6,10004046648
1641,7284540114,5802,7284545916,3,0,1,6144,3,6378548711
1642,7284547750,1994,7284549744,7,0,1,2048,7,10248662095
1643,7284555543,5802,7284561345,9,0,1,6144,9,506870066
1644,7284644535,78969,7284723504,7,0,0,1536,7,6312860728
1645,7284733840,134684,7284868524,4,0,0,132096,4,6219807557
1646,7284758326,148172,7284906498,4,0,0,33792,4,4782454685
1647,7284779942,4162,7284784104,2,0,1,11264,2,3247521810
1648,7284988932,2946,7284991878,5,0,1,3072,5,4451579154
1649,7284993561,5326,7284998887,2,0,1,5632,2,5753096484
1650,7285006192,3128,7285009320,2,0,1,9216,2,702881027
1651,7285026541,53841,7285080382,1,0,1,88064,1,2494593198
1652,7285185791,178709,7285364500,6,0,0,133632,6,8867290838
1653,7285315672,48843,7285364515,8,0,1,23552,8,6408143588
1654,7285452331,82428,7285534759,3,0,0,4608,3,8972259502
1655,7285536070,53300,7285589370,4,0,0,6144,4,98271802
1656,7285547244,3904,7285551148,0,0,1,10752,0,6708131938
1657,7285686623,56079,7285742702,1,0,1,95744,1,1271883781
1658,7285734901,80931,7285815832,6,0,0,2048,6,2525423671
1659,7285739094,8434,7285747528,4,0,1,7680,4,937586658
1660,7285774331,21916,7285796247,4,0,1,35840,4,1108563303
1661,7285819347,2946,7285822293,9,0,1,3072,9,4862918511
1662,7285819494,24733,7285844227,1,0,1,43008,1,4210237018
1663,7285970031,45596,7286015627,0,0,0,1024,0,7691515166
1664,7286071710,70976,7286142686,6,0,0,8704,6,2989171679
1665,7286200827,165140,7286365967,8,0,0,141312,8,4245037247
1666,7286291138,1042,7286292180,6,0,1,1024,6,10681072744
1667,7286298764,7230,7286305994,2,0,1,7680,2,6990947431
1668,7286351504,140295,7286491799,4,0,0,113152,4,2223286536
1669,7286404842,88064,7286492906,0,0,0,3584,0,8619822009
1670,7286572123,566,7286572689,9,0,1,512,9,7850197397
1671,7286620675,4374,7286625049,2,0,1,4608,2,1994154778
1672,7286648624,93020,7286741644,3,0,0,25600,3,354244266
1673,7286709010,55748,7286764758,8,0,0,4096,8,3343665960
1674,7286727991,53085,7286781076,9,0,0,1536,9,8027880823
1675,7286787089,72668,7286859757,3,0,0,9216,3,2497028512
1676,7286795280,11533,7286806813,9,0,1,18944,9,6641434608
1677,7286814766,1518,7286816284,3,0,1,1536,3,163720432
1678,7286954834,201108,7287155942,1,0,0,125440,1,4870809206
1679,7287068331,45596,7287113927,7,0,0,1024,7,3659511126
1680,7287079450,100256,7287179706,8,0,0,29184,8,2400394347
1681,7287188831,102128,7287290959,2,0,0,35328,2,1513660605
1682,7287192074,43904,7287235978,9,0,0,512,9,10047429777
1683,7287206272,127683,7287333955,2,0,0,65536,2,4734265684
1684,7287244571,4162,7287248733,7,0,1,11264,7,10563978551
1685,7287252631,55061,7287307692,0,0,0,512,0,7568150872
1686,7287328702,6763,7287335465,1,0,1,1536,1,6888389023
1687,7287339464,85004,7287424468,6,0,0,19456,6,5748589606
1688,7287353796,64208,7287418004,3,0,0,6656,3,1560275557
1689,7287460301,2870,7287463171,3,0,1,8704,3,1467309573
1690,7287460357,71953,7287532310,1,0,0,13312,1,7409206322
1691,7287646879,114140,7287761019,4,0,0,74752,4,1998924758
1692,7287653079,134328,7287787407,4,0,0,35328,4,3610560838
1693,7287694510,102809,7287797319,7,0,0,5120,7,5175104463
1694,7287728572,152849,7287881421,3,0,0,48128,3,10586584724
1695,7287749260,245245,7287994505,4,0,0,13312,4,4286503799
1696,7287756230,31192,7287787422,1,0,1,43008,1,4190992199
1697,7287761808,25629,7287787437,0,0,1,3072,0,4661654013
1698,7287794613,4850,7287799463,2,0,1,5120,2,7115534854
1699,7287802377,94261,7287896638,3,0,0,6144,3,4472657257
1700,7287802982,125960,7287928942,7,0,0,16384,7,3355665728
1701,7287811288,2946,7287814234,4,0,1,3072,4,1336561594
1702,7287898146,4937,7287903083,4,0,1,12800,4,10255503153
1703,7287973604,566,7287974170,1,0,1,512,1,8452684193
1704,7288075010,6754,7288081764,9,0,1,7168,9,3652770639
1705,7288077094,5336,7288082430,5,0,1,1024,5,5927829003
1706,7288164180,1042,7288165222,9,0,1,1024,9,3888454688
1707,7288169270,55630,7288224900,0,0,0,512,0,2100657438
1708,7288190978,133885,7288324863,9,0,0,1024,9,9534803766
1709,7288207573,116948,7288324521,3,0,0,83968,3,6359637640
1710,7288296585,27951,7288324536,8,0,1,15360,8,2164368895
1711,7288338496,1042,7288339538,6,0,1,1024,6,175963729
1712,7288376511,43904,7288420415,0,0,0,512,0,917733811
1713,7288599502,5326,7288604828,4,0,1,5632,4,9943775936
1714,7288666719,32299,7288699018,8,0,1,52736,8,2264078231
1715,7288691723,96333,7288788056,4,0,0,4096,4,10089025859
1716,7288718973,179085,7288898058,9,0,0,512,9,1574297678
1717,7288854888,119154,7288974042,6,0,0,88576,6,1000614363
1718,7288919863,129241,7289049104,4,0,0,37888,4,1800363591
1719,7289013946,2946,7289016892,6,0,1,3072,6,7406947941
1720,7289072024,2470,7289074494,7,0,1,2560,7,5479459409
1721,7289157700,97292,7289254992,2,0,0,19456,2,139600251
1722,7289206105,1994,7289208099,6,0,1,2048,6,2629338322
1723,7289363810,105560,7289469370,7,0,0,46592,7,4915449467
1724,7289486892,120848,7289607740,6,0,0,96768,6,8561061465
1725,7289612859,43887,7289656746,8,0,1,75264,8,8496396281
1726,7289684840,82820,7289767660,3,0,0,12288,3,5492195237
1727,7289731785,2946,7289734731,4,0,1,3072,4,677427888
1728,7289845042,43904,7289888946,0,0,0,512,0,3535630367
1729,7289896972,3422,7289900394,7,0,1,3584,7,10032980285
1730,7289902685,45596,7289948281,0,0,0,1024,0,8440896966
1731,7289915015,43904,7289958919,9,0,0,512,9,3241324182
1732,7290016753,113672,7290130425,7,0,0,73216,7,9414705530
1733,7290044114,113077,7290157191,4,0,0,8704,4,10413783261
1734,7290356229,47288,7290403517,8,0,0,1536,8,10114673002
1735,7290456982,55748,7290512730,0,0,0,4096,0,7569724996
1736,7290541917,45596,7290587513,9,0,0,1024,9,2231821905
1737,7290543122,92972,7290636094,7,0,0,15360,7,1442007585
1738,7290560407,10499,7290570906,4,0,1,16896,4,10100297504
1739,7290758447,3898,7290762345,0,0,1,4096,0,10211611118
1740,7290760458,76052,7290836510,8,0,0,10240,8,2028672386
1741,7290931393,2470,7290933863,4,0,1,2560,4,9212989826
1742,7290961907,1042,7290962949,3,0,1,1024,3,8005517226
1743,7291009997,5971,7291015968,5,0,1,14848,5,285918635
1744,7291031757,45596,7291077353,0,0,0,1024,0,3378198011
1745,7291068374,76520,7291144894,7,0,0,11776,7,9182015400
1746,7291095616,3645,7291099261,3,0,1,10240,3,3545359271
1747,7291171249,77744,7291248993,3,0,0,10752,3,1531565606
1748,7291173511,7706,7291181217,6,0,1,8192,6,7056413672
1749,7291213410,98540,7291311950,2,0,0,23552,2,10332227375
1750,7291267475,103688,7291371163,3,0,0,40448,3,4395656950
1751,7291404748,2946,7291407694,6,0,1,3072,6,2372988491
1752,7291424807,50019,7291474826,0,0,0,1536,0,2154869127
1753,7291541322,1994,7291543316,5,0,1,2048,5,9681349494
1754,7291646807,130924,7291777731,1,0,0,124416,1,6689854008
1755,7291794944,98072,7291893016,8,0,0,22016,8,5738209436
1756,7291862512,74412,7291936924,7,0,0,2560,7,6170654391
1757,7291883822,43904,7291927726,9,0,0,512,9,8777236869
1758,7291932136,45596,7291977732,9,0,0,1024,9,10124740444
1759,7291952124,7706,7291959830,5,0,1,8192,5,7402033293
1760,7291959910,10757,7291970667,2,0,1,17408,2,3790782745
1761,7291977730,89891,7292067621,7,0,0,8704,7,4126981118
1762,7291997652,3898,7292001550,5,0,1,4096,5,5022347869
1763,7292021800,5326,7292027126,3,0,1,5632,3,5539490089
1764,7292033173,3422,7292036595,4,0,1,3584,4,4480509604
1765,7292047726,105092,7292152818,6,0,0,45056,6,7094528298
1766,7292076534,136294,7292212828,4,0,0,1024,4,1625635407
1767,7292174453,97760,7292272213,3,0,0,20992,3,4126120504
1768,7292180241,45596,7292225837,2,0,0,1024,2,8511246216
1769,7292183142,150127,7292333269,2,0,0,70144,2,5625120576
1770,7292246954,93308,7292340262,1,0,1,151552,1,3049686844
1771,7292275433,169502,7292444935,1,0,0,35840,1,5215255922
1772,7292426642,117557,7292544199,1,0,0,61952,1,10226746937
1773,7292464206,84811,7292549017,0,0,0,1024,0,5729657482
1774,7292579346,566,7292579912,2,0,1,512,2,1557867003
1775,7292665433,566,7292665999,5,0,1,512,5,4115180792
1776,7292695641,95288,7292790929,1,0,0,17920,1,9938069949
1777,7292906864,566,7292907430,5,0,1,512,5,7028073354
1778,7292952691,6278,7292958969,2,0,1,6656,2,5796831454
1779,7293054633,43904,7293098537,9,0,0,512,9,3063915938
1780,7293192736,47600,7293240336,7,0,0,2560,7,409989981
1781,7293210371,2946,7293213317,2,0,1,3072,2,3341621019
1782,7293213163,23895,7293237058,8,0,1,43008,8,4126050923
1783,7293324906,102128,7293427034,2,0,0,35328,2,9314605029
1784,7293375835,566,7293376401,3,0,1,512,3,9932001464
1785,7293376298,5326,7293381624,4,0,1,5632,4,5140204561
1786,7293454246,43904,7293498150,9,0,0,512,9,5275083831
1787,7293502536,65900,7293568436,2,0,0,7168,2,5036048165
1788,7293520409,7706,7293528115,9,0,1,8192,9,8935703592
1789,7293734896,64208,7293799104,6,0,0,6656,6,6216951600
1790,7293750950,90368,7293841318,8,0,0,16896,8,3856859578
1791,7293796915,79436,7293876351,6,0,0,11264,6,1534762531
1792,7293823521,5802,7293829323,4,0,1,6144,4,7601706893
1793,7293890697,1518,7293892215,0,0,1,1536,0,1929027499
1794,7293894736,47288,7293942024,3,0,0,1536,3,3886941897
1795,7293904900,65429,7293970329,8,0,1,110592,8,2711117092
1796,7293999701,182290,7294181991,8,0,0,5120,8,2188365713
1797,7294027884,5326,7294033210,2,0,1,5632,2,2607001698
1798,7294043167,99476,7294142643,6,0,0,26624,6,2537288476
1799,7294084555,309688,7294394243,2,0,0,114688,2,2142280464
1800,7294090261,100793,7294191054,3,0,0,29696,3,4534838199
1801,7294145570,6278,7294151848,9,0,1,6656,9,3653741344
1802,7294309382,92871,7294402253,4,0,0,13824,4,1924984884
1803,7294472041,167948,7294639989,7,0,0,150528,7,10360912487
1804,7294494717,150138,7294644855,2,0,0,14848,2,712844596
1805,7294553218,87098,7294640316,9,0,0,1024,9,5645811706
1806,7294649266,99164,7294748430,2,0,0,25600,2,3504672379
1807,7294730103,30749,7294760852,1,0,1,49664,1,5596321971
1808,7294785302,1518,7294786820,4,0,1,1536,4,3301893520
1809,7294869675,1994,7294871669,0,0,1,2048,0,4408136103
1810,7294937764,45596,7294983360,9,0,0,1024,9,5069568917
1811,7294962292,46988,7295009280,8,0,1,81408,8,8537917531
1812,7294970250,39376,7295009626,9,0,1,512,9,951872412
1813,7295153509,3645,7295157154,2,0,1,10240,2,3590147720
1814,7295242844,43904,7295286748,0,0,0,512,0,9167091596
1815,7295318102,65900,7295384002,2,0,0,7168,2,9328222300
1816,7295382673,111205,7295493878,3,0,0,52736,3,9233869618
1817,7295402535,2470,7295405005,9,0,1,2560,9,2106479489
1818,7295500853,7706,7295508559,4,0,1,8192,4,4732520917
1819,7295537025,116012,7295653037,4,0,0,80896,4,1561301650
1820,7295615753,4374,7295620127,7,0,1,4608,7,2075364837
1821,7295646452,13082,7295659534,1,0,1,15872,1,3558174936
1822,7295652676,49118,7295701794,9,0,0,512,9,5308307320
1823,7295665001,97136,7295762137,1,0,0,18944,1,2596577402
1824,7295673477,566,7295674043,2,0,1,512,2,5011488215
1825,7295737219,3898,7295741117,1,0,1,4096,1,7857556795
1826,7295750478,2470,7295752948,4,0,1,2560,4,7972437569
1827,7295809561,566,7295810127,4,0,1,512,4,2705176466
1828,7295814578,4374,7295818952,2,0,1,4608,2,5098773751
1829,7295914066,312674,7296226740,2,0,0,156160,2,3227616892
1830,7295928937,107588,7296036525,1,0,0,53248,1,5193462835
1831,7295936766,111231,7296047997,6,0,0,10240,6,1479098253
1832,7296010893,25647,7296036540,1,0,1,19968,1,10216557931
1833,7296219133,116747,7296335880,6,0,0,58368,6,9604426774
1834,7296285207,76737,7296361944,0,0,0,512,0,5436214238
1835,7296343479,5802,7296349281,3,0,1,6144,3,8770945082
1836,7296399497,48980,7296448477,7,0,0,2048,7,3384650932
1837,7296449448,98072,7296547520,4,0,0,22016,4,7526179506
1838,7296522135,40874,7296563009,1,0,1,66048,1,8886450268
1839,7296539887,26668,7296566555,8,0,1,5632,8,4878617376
1840,7296610605,1042,7296611647,4,0,1,1024,4,1361446818
1841,7296688650,7230,7296695880,4,0,1,7680,4,8208732450
1842,7296733622,3904,7296737526,6,0,1,10752,6,1121379550
1843,7296776594,190731,7296967325,6,0,0,55296,6,7356947436
1844,7296794653,59535,7296854188,6,0,0,4096,6,7352774084
1845,7296813598,1994,7296815592,0,0,1,2048,0,4669501927
1846,7296816462,3898,7296820360,3,0,1,4096,3,4492354294
1847,7296825932,148272,7296974204,7,0,0,22528,7,8578395837
1848,7296857945,1518,7296859463,2,0,1,1536,2,4470149700
1849,7296892864,168235,7297061099,3,0,0,130048,3,9596141338
1850,7296901090,160180,7297061270,0,0,0,512,0,1504359654
1851,7296907573,159436,7297067009,6,0,0,7168,6,6785151901
1852,7296968029,93724,7297061753,9,0,0,1536,9,1627538165
1853,7297018093,43904,7297061997,0,0,0,512,0,10255374136
1854,7297122923,43904,7297166827,2,0,0,512,2,5136955839
1855,7297125866,2946,7297128812,7,0,1,3072,7,6169069998
1856,7297163531,11533,7297175064,5,0,1,18944,5,7297355341
1857,7297220302,7230,7297227532,7,0,1,7680,7,652035107
1858,7297286130,2946,7297289076,4,0,1,3072,4,9155449006
1859,7297455894,98384,7297554278,4,0,0,23040,4,6777471251
1860,7297528703,43904,7297572607,0,0,0,512,0,4266228644
1861,7297565869,104780,7297670649,2,0,0,44032,2,4384500434
1862,7297653221,47860,7297701081,9,0,0,512,9,2578019625
1863,7297697654,2946,7297700600,3,0,1,3072,3,10234572825
1864,7297702774,2470,7297705244,6,0,1,2560,6,10676345484
1865,7297727313,199839,7297927152,1,0,0,79360,1,4392167294
1866,7298132193,23637,7298155830,8,0,1,42496,8,4776878207
1867,7298383342,43904,7298427246,9,0,0,512,9,1608453100
1868,7298423939,2946,7298426885,2,0,1,3072,2,3682212177
1869,7298477170,43904,7298521074,9,0,0,512,9,2300631711
1870,7298493961,89168,7298583129,3,0,0,23040,3,353060013
1871,7298599882,114452,7298714334,6,0,0,75776,6,8763346158
1872,7298608667,119446,7298728113,2,0,0,37376,2,10171816123
1873,7298625361,109391,7298734752,0,0,0,512,0,5491555825
1874,7298685740,66562,7298752302,0,0,0,1536,0,1818278459
1875,7298742903,3422,7298746325,2,0,1,3584,2,6769608519
1876,7298753850,4850,7298758700,3,0,1,5120,3,6095951359
1877,7298787777,56372,7298844149,7,0,0,6144,7,4210009942
1878,7298791378,180062,7298971440,7,0,0,81920,7,10516147427
1879,7298910454,5712,7298916166,1,0,1,14336,1,646575634
1880,7298911348,6764,7298918112,4,0,1,3072,4,5633396851
1881,7298935543,35912,7298971455,1,0,1,32768,1,8350833105
1882,7299012586,45596,7299058182,9,0,0,1024,9,2651672655
1883,7299048034,13600,7299061634,1,0,1,23040,1,6274519744
1884,7299118619,43904,7299162523,9,0,0,512,9,8796252179
1885,7299187956,566,7299188522,9,0,1,512,9,4716896138
1886,7299191986,100100,7299292086,1,0,0,28672,1,10609375543
1887,7299200135,124171,7299324306,7,0,0,53760,7,4892907749
1888,7299216891,43904,7299260795,9,0,0,512,9,7839519381
1889,7299258848,78341,7299337189,1,0,0,7680,1,7143202603
1890,7299334808,47288,7299382096,9,0,0,1536,9,4103341543
1891,7299359003,105872,7299464875,7,0,0,47616,7,2182359307
1892,7299440937,2470,7299443407,5,0,1,2560,5,8525522881
1893,7299455193,10716,7299465909,4,0,1,1024,4,681552042
1894,7299473397,210312,7299683709,1,0,0,184320,1,6371018917
1895,7299740521,99632,7299840153,3,0,0,27136,3,5537057647
1896,7299749717,108680,7299858397,1,0,0,56832,1,6737416706
1897,7299812559,14545,7299827104,4,0,1,28160,4,9254072411
1898,7300016120,6754,7300022874,3,0,1,7168,3,8286004548
1899,7300030136,3898,7300034034,2,0,1,4096,2,9549746563
1900,7300034902,4850,7300039752,6,0,1,5120,6,10232075504
1901,7300044041,2870,7300046911,5,0,1,8704,5,2324539242
1902,7300156179,45908,7300202087,9,0,0,2048,9,4226725276
1903,7300163935,6754,7300170689,4,0,1,7168,4,4791211319
1904,7300302792,5326,7300308118,9,0,1,5632,9,7915566445
1905,7300304130,46023,7300350153,9,0,0,1024,9,8723939170
1906,7300316259,102596,7300418855,7,0,0,36864,7,2347371523
1907,7300354610,52364,7300406974,0,0,0,3072,0,3561595019
1908,7300395595,34108,7300429703,8,0,1,56320,8,7213475186
1909,7300476707,6754,7300483461,9,0,1,7168,9,4555305092
1910,7300510798,13512,7300524310,1,0,1,26112,1,8991664458
1911,7300651550,105560,7300757110,2,0,0,46592,2,8857396324
1912,7300657354,566,7300657920,6,0,1,512,6,2070199399
1913,7300662977,118703,7300781680,6,0,0,5120,6,5369468581
1914,7300671421,1518,7300672939,7,0,1,1536,7,4659775165
1915,7300696472,6754,7300703226,3,0,1,7168,3,1883048485
1916,7300702412,123129,7300825541,8,0,0,11776,8,8290847778
1917,7300800280,54056,7300854336,6,0,0,3584,6,816716439
1918,7300835418,115388,7300950806,7,0,0,78848,7,3298643549
1919,7300866232,139840,7301006072,3,0,0,32256,3,4834279854
1920,7300948444,2920,7300951364,7,0,1,512,7,9804874259
1921,7300984395,48980,7301033375,7,0,0,2048,7,8438673151
1922,7301005122,2936,7301008058,5,0,1,2048,5,8474190525
1923,7301181021,92240,7301273261,8,0,0,23040,8,8061993419
1924,7301229281,4420,7301233701,1,0,1,11776,1,748495690
1925,7301240510,105560,7301346070,8,0,0,46592,8,3585823091
1926,7301427929,101816,7301529745,1,0,0,34304,1,1630721507
1927,7301522129,11030,7301533159,3,0,1,3584,3,6771092799
1928,7301581528,1518,7301583046,9,0,1,1536,9,10569325062
1929,7301632156,2946,7301635102,7,0,1,3072,7,7598652193
1930,7301685216,5971,7301691187,7,0,1,14848,7,2786410441
1931,7301724602,65900,7301790502,8,0,0,7168,8,2007512448
1932,7301754097,188564,7301942661,6,0,0,157696,6,497575673
1933,7301904911,163894,7302068805,7,0,0,114176,7,7373113517
1934,7301970263,7706,7301977969,5,0,1,8192,5,1941679199
1935,7302037334,144979,7302182313,4,0,0,72704,4,9281927800
1936,7302159001,100100,7302259101,2,0,0,28672,2,3099989563
1937,7302251531,73462,7302324993,3,0,0,7168,3,5762623718
1938,7302291883,1042,7302292925,7,0,1,1024,7,4175693373
1939,7302319266,566,7302319832,9,0,1,512,9,4801797185
1940,7302402763,6754,7302409517,5,0,1,7168,5,6447284539
1941,7302435334,74984,7302510318,1,0,0,11776,1,8660075544
1942,7302469440,5326,7302474766,4,0,1,5632,4,8416255285
1943,7302499595,99788,7302599383,8,0,0,27648,8,5654040077
1944,7302584474,98696,7302683170,6,0,0,24064,6,5781497910
1945,7302787055,3898,7302790953,9,0,1,4096,9,1071465906
1946,7302817642,43904,7302861546,9,0,0,512,9,10086643451
1947,7302913048,45596,7302958644,2,0,0,1024,2,6074706029
1948,7302967865,4374,7302972239,2,0,1,4608,2,7629205944
1949,7303027188,62828,7303090016,4,0,0,7168,4,10323861071
1950,7303183393,85448,7303268841,8,0,0,15872,8,9270024899
1951,7303205993,204015,7303410008,6,0,0,15872,6,9317653070
1952,7303229711,1994,7303231705,2,0,1,2048,2,2657535857
1953,7303506276,1518,7303507794,5,0,1,1536,5,1702689692
1954,7303509756,4162,7303513918,9,0,1,11264,9,4519740048
1955,7303536563,566,7303537129,0,0,1,512,0,8423529665
1956,7303799963,2946,7303802909,0,0,1,3072,0,10014016081
1957,7303814804,93596,7303908400,7,0,0,17408,7,625518428
1958,7303865034,54270,7303919304,1,0,1,92160,1,1959030838
1959,7303944440,4850,7303949290,2,0,1,5120,2,6496979366
1960,7304079357,184781,7304264138,8,0,0,86528,8,3065560876
1961,7304091559,113350,7304204909,6,0,0,51712,6,3167010249
1962,7304109787,1518,7304111305,9,0,1,1536,9,939905271
1963,7304151957,124520,7304276477,6,0,0,40448,6,10263870536
1964,7304152101,5802,7304157903,6,0,1,6144,6,6684382555
1965,7304187007,17917,7304204924,3,0,1,9728,3,5490274387
1966,7304215120,2946,7304218066,7,0,1,3072,7,1556093539
1967,7304306110,4374,7304310484,7,0,1,4608,7,6655967592
1968,7304312625,10241,7304322866,5,0,1,16384,5,6237008271
1969,7304357217,1042,7304358259,0,0,1,1024,0,4950754004
1970,7304596861,23983,7304620844,1,0,1,39936,1,2170745229
1971,7304637669,10241,7304647910,5,0,1,16384,5,4321085955
1972,7304650879,181125,7304832004,4,0,0,5632,4,7711583316
1973,7304747505,52520,7304800025,1,0,0,3584,1,5482797405
1974,7304794247,52549,7304846796,8,0,1,85504,8,5415939808
1975,7304826388,24914,7304851302,1,0,1,7168,1,5343408758
1976,7304830142,21506,7304851648,0,0,1,512,0,5212460083
1977,7304843965,97764,7304941729,2,0,0,10752,2,7722251764
1978,7304864404,5196,7304869600,4,0,1,13312,4,6967574261
1979,7304941240,72484,7305013724,9,0,0,512,9,896305473
1980,7304979068,1994,7304981062,8,0,1,2048,8,874807318
1981,7305007126,3128,7305010254,4,0,1,9216,4,67990410
1982,7305015768,43904,7305059672,0,0,0,512,0,1113530702
1983,7305030858,52364,7305083222,4,0,0,3072,4,8931786689
1984,7305177871,1994,7305179865,6,0,1,2048,6,5821667322
1985,7305220870,116948,7305337818,4,0,0,83968,4,9769599938
1986,7305297798,121188,7305418986,6,0,0,50688,6,3363642315
1987,7305314618,305615,7305620233,3,0,0,50688,3,5933165930
1988,7305318633,71768,7305390401,1,0,1,85504,1,105179036
1989,7305331503,204742,7305536245,7,0,0,45056,7,543179188
1990,7305599897,566,7305600463,4,0,1,512,4,8878447589
1991,7305742702,113048,7305855750,3,0,0,71168,3,8092704364
1992,7305747392,156988,7305904380,4,0,0,17920,4,4638672033
1993,7305781499,74586,7305856085,9,0,0,1024,9,8444975469
1994,7305839875,172547,7306012422,2,0,0,138752,2,10616593762
1995,7305961711,105248,7306066959,2,0,0,45568,2,5990849858
1996,7305998133,18672,7306016805,5,0,1,4608,5,8454712155
1997,7306007398,63227,7306070625,0,0,0,1024,0,1213261908
1998,7306133679,12995,7306146674,4,0,1,25088,4,111781192
1999,7306168009,57679,7306225688,9,0,0,1024,9,4829557372
2000,7306249879,106184,7306356063,2,0,0,48640,2,9132914825
2001,7306298588,1994,7306300582,2,0,1,2048,2,5726352623
2002,7306318350,3422,7306321772,3,0,1,3584,3,5547661163
2003,7306384694,10757,7306395451,2,0,1,17408,2,4251280568
2004,7306396043,4850,7306400893,5,0,1,5120,5,439628543
2005,7306588723,566,7306589289,4,0,1,512,4,1927902200
2006,7306685755,43904,7306729659,1,0,0,512,1,6116458068
2007,7306702462,3128,7306705590,6,0,1,9216,6,1199376867
2008,7306780799,566,7306781365,5,0,1,512,5,7696272556
2009,7306816042,566,7306816608,0,0,1,512,0,4253392395
2010,7306866059,2870,7306868929,7,0,1,8704,7,5182281666
2011,7306941083,6278,7306947361,0,0,1,6656,0,8148786691
2012,7306976607,45596,7307022203,0,0,0,1024,0,10728597650
2013,7307086653,3387,7307090040,3,0,1,9728,3,400386240
2014,7307189283,1994,7307191277,9,0,1,2048,9,6295892010
2015,7307193852,153888,7307347740,4,0,0,9728,4,2155408955
2016,7307196691,82376,7307279067,3,0,0,15872,3,7893056902
2017,7307233430,3387,7307236817,9,0,1,9728,9,7624419760
2018,7307290139,85679,7307375818,1,0,1,143360,1,7298994423
2019,7307356161,139025,7307495186,6,0,0,14336,6,10052298845
2020,7307364537,225137,7307589674,6,0,0,4608,6,9485213496
2021,7307378842,185206,7307564048,3,0,0,17408,3,3724586592
2022,7307504821,7706,7307512527,4,0,1,8192,4,1856144445
2023,7307505532,13625,7307519157,8,0,1,19456,8,147146667
2024,7307674789,34537,7307709326,1,0,1,60416,1,659253865
2025,7307675411,136147,7307811558,6,0,0,11776,6,10125424780
2026,7307747134,4420,7307751554,8,0,1,11776,8,305680980
2027,7307798672,2946,7307801618,4,0,1,3072,4,8084118490
2028,7307888677,45596,7307934273,0,0,0,1024,0,9677209315
2029,7307916527,4850,7307921377,2,0,1,5120,2,9601946688
2030,7308024200,111020,7308135220,2,0,0,64512,2,10097558042
2031,7308076298,141182,7308217480,2,0,0,34816,2,5819577789
2032,7308205423,36346,7308241769,8,0,1,64000,8,799108503
2033,7308277008,5971,7308282979,1,0,1,14848,1,7167734052
2034,7308336098,4374,7308340472,6,0,1,4608,6,3366317959
2035,7308354910,100100,7308455010,3,0,0,28672,3,4425598121
2036,7308365428,3128,7308368556,2,0,1,9216,2,9412543233
2037,7308391322,54368,7308445690,2,0,0,4608,2,2966665272
2038,7308403621,103376,7308506997,1,0,0,39424,1,8555671835
2039,7308482492,124081,7308606573,2,0,0,66560,2,9436797891
2040,7308694868,111176,7308806044,1,0,0,65024,1,6598723051
2041,7308817521,22862,7308840383,1,0,1,40960,1,4563880033
2042,7308823839,129408,7308953247,6,0,0,73216,6,8164088986
2043,7309004180,4850,7309009030,5,0,1,5120,5,6709812859
2044,7309304723,213992,7309518715,2,0,0,241152,2,3763099115
2045,7309316541,1518,7309318059,5,0,1,1536,5,7680040015
2046,7309441590,77304,7309518894,9,0,0,512,9,5924107809
2047,7309452535,69238,7309521773,9,0,1,8704,9,7141489869
2048,7309495889,68593,7309564482,0,0,0,1024,0,7454663204
2049,7309508485,110141,7309618626,4,0,0,17408,4,8985164826
2050,7309518992,125076,7309644068,7,0,0,45568,7,2785876353
2051,7309587950,83051,7309671001,0,0,0,512,0,9963229829
2052,7309589953,4850,7309594803,5,0,1,5120,5,3806759208
2053,7309591708,222025,7309813733,6,0,0,39936,6,303162410
2054,7309677603,1518,7309679121,0,0,1,1536,0,4945678332
2055,7309694586,72799,7309767385,1,0,1,118272,1,6836117289
2056,7309722671,48260,7309770931,3,0,1,5632,3,2858471782
2057,7309780758,123803,7309904561,7,0,0,31744,7,3210280820
2058,7309799489,119135,7309918624,2,0,0,46080,2,10655640306
2059,7309863843,7706,7309871549,1,0,1,8192,1,4279902380
2060,7309887641,3904,7309891545,7,0,1,10752,7,253331954
2061,7309895877,34239,7309930116,8,0,1,18944,8,7938097906
2062,7309912315,121333,7310033648,3,0,0,32768,3,3453553139
2063,7309923673,8709,7309932382,9,0,1,3584,9,9837723663
2064,7310052397,137805,7310190202,2,0,0,65536,2,682370296
2065,7310052995,566,7310053561,1,0,1,512,1,3980063535
2066,7310079583,143168,7310222751,2,0,0,66560,2,924525666
2067,7310103011,43904,7310146915,9,0,0,512,9,232673245
2068,7310228591,566,7310229157,2,0,1,512,2,6641737193
2069,7310247626,86228,7310333854,7,0,0,18432,7,9680352561
2070,7310339197,3128,7310342325,3,0,1,9216,3,7628133458
2071,7310340341,132445,7310472786,6,0,0,72704,6,4816080107
2072,7310373925,1994,7310375919,2,0,1,2048,2,2898254602
2073,7310476373,5802,7310482175,3,0,1,6144,3,10040395519
2074,7310500312,144253,7310644565,4,0,0,51712,4,4726068330
2075,7310506725,154703,7310661428,8,0,0,55296,8,8692433736
2076,7310538388,4374,7310542762,0,0,1,4608,0,5916986201
2077,7310645936,115740,7310761676,2,0,0,29184,2,8670655540
2078,7310675702,150240,7310825942,4,0,0,67584,4,4498036041
2079,7310712531,113590,7310826121,9,0,0,512,9,2346724968
2080,7310776270,7706,7310783976,4,0,1,8192,4,7668480884
2081,7310820393,10537,7310830930,7,0,1,5120,7,2457518348
2082,7310859485,566,7310860051,9,0,1,512,9,6501803377
2083,7310936184,43904,7310980088,0,0,0,512,0,2596655235
2084,7311071570,6754,7311078324,3,0,1,7168,3,8264778644
2085,7311078595,3904,7311082499,0,0,1,10752,0,8842565444
2086,7311134292,113712,7311248004,3,0,0,71680,3,3702482369
2087,7311134307,1535,7311135842,0,0,1,1536,0,10440325061
2088,7311203277,82844,7311286121,8,0,0,17408,8,6497050790
2089,7311295242,61760,7311357002,6,0,0,8704,6,6923320567
2090,7311386188,22433,7311408621,1,0,1,36864,1,6386563084
2091,7311401121,50672,7311451793,3,0,0,2560,3,10362542256
2092,7311503864,55748,7311559612,8,0,0,4096,8,870480291
2093,7311596953,54056,7311651009,2,0,0,3584,2,5699662929
2094,7311620860,3898,7311624758,8,0,1,4096,8,3216382761
2095,7311680016,69776,7311749792,8,0,0,14848,8,5956982159
2096,7311908878,566,7311909444,3,0,1,512,3,4385833019
2097,7311919985,2470,7311922455,3,0,1,2560,3,547648792
2098,7311925489,4850,7311930339,5,0,1,5120,5,568254058
2099,7311967117,43904,7312011021,9,0,0,512,9,1351943254
2100,7311986284,5196,7311991480,9,0,1,13312,9,8921474084
2101,7312000996,11791,7312012787,0,0,1,19456,0,7058754454
2102,7312045575,93802,7312139377,0,0,0,1024,0,242287705
2103,7312062257,5971,7312068228,7,0,1,14848,7,6028781394
2104,7312104990,56252,7312161242,0,0,0,1024,0,3550493269
2105,7312119405,60455,7312179860,0,0,0,512,0,9659216174
2106,7312141494,136830,7312278324,2,0,0,512,2,5706037839
2107,7312282235,566,7312282801,0,0,1,512,0,4790524089
2108,7312336802,43904,7312380706,0,0,0,512,0,8327483788
2109,7312376470,6278,7312382748,3,0,1,6656,3,5958464815
2110,7312527507,3422,7312530929,2,0,1,3584,2,7730536647
2111,7312538271,72692,7312610963,6,0,0,14336,6,5002578835
2112,7312648058,5326,7312653384,3,0,1,5632,3,10123571367
2113,7312735891,2470,7312738361,0,0,1,2560,0,4010102153
2114,7312749039,1042,7312750081,2,0,1,1024,2,10485536735
2115,7312840025,6754,7312846779,4,0,1,7168,4,1244458048
2116,7312875696,90056,7312965752,4,0,0,15872,4,10337792927
2117,7312948953,3422,7312952375,7,0,1,3584,7,4830052657
2118,7312991338,50672,7313042010,9,0,0,2560,9,10186746253
2119,7313007033,106496,7313113529,8,0,0,49664,8,6048129011
2120,7313123755,4162,7313127917,6,0,1,11264,6,5185685351
2121,7313135486,566,7313136052,7,0,1,512,7,9799630253
2122,7313147628,92533,7313240161,1,0,1,150016,1,7721359852
2123,7313182060,58972,7313241032,1,0,1,12288,1,3292431161
2124,7313202698,95029,7313297727,1,0,1,158208,1,6650332027
2125,7313337396,72903,7313410299,2,0,0,1024,2,240889798
2126,7313400194,104113,7313504307,6,0,0,19968,6,232716375
2127,7313444124,5326,7313449450,0,0,1,5632,0,8084176623
2128,7313527861,106184,7313634045,3,0,0,48640,3,3128382674
2129,7313546370,13253,7313559623,5,0,1,25600,5,5874632903
2130,7313727443,566,7313728009,9,0,1,512,9,8055142867
2131,7313824277,1518,7313825795,6,0,1,1536,6,1733828869
2132,7313875167,1994,7313877161,7,0,1,2048,7,7535785819
2133,7313885189,43904,7313929093,2,0,0,512,2,1190573248
2134,7313913460,109772,7314023232,4,0,0,60416,4,6039100731
2135,7314062789,10499,7314073288,3,0,1,16896,3,7941218568
2136,7314093215,5196,7314098411,3,0,1,13312,3,9086510685
2137,7314095405,4312,7314099717,8,0,1,2048,8,3257653029
2138,7314273916,566,7314274482,3,0,1,512,3,6534504011
2139,7314451789,88856,7314540645,8,0,0,22016,8,10020026986
2140,7314484556,6754,7314491310,4,0,1,7168,4,324603007
2141,7314535331,8252,7314543583,2,0,1,3072,2,4596319903
2142,7314558658,1518,7314560176,5,0,1,1536,5,3508986358
2143,7314718595,198080,7314916675,3,0,0,188928,3,1912121472
2144,7314724514,192488,7314917002,2,0,0,1024,2,2955608553
2145,7314758922,74575,7314833497,9,0,0,512,9,7532615716
2146,7314794499,153946,7314948445,6,0,0,45056,6,5232198551
2147,7314806816,161003,7314967819,1,0,0,41984,1,5482330843
2148,7314854110,3898,7314858008,4,0,1,4096,4,10018700048
2149,7315144666,110396,7315255062,6,0,0,62464,6,6223673521
2150,7315175974,161966,7315337940,8,0,0,106496,8,9368745265
2151,7315228221,566,7315228787,0,0,1,512,0,8275493024
2152,7315234798,20279,7315255077,2,0,1,11776,2,5702448257
2153,7315267018,3898,7315270916,9,0,1,4096,9,8152851739
2154,7315356029,94184,7315450213,1,0,0,2048,1,6784792545
2155,7315453903,98156,7315552059,7,0,0,24576,7,1120048495
2156,7315456028,88520,7315544548,0,0,0,15872,0,7854470562
2157,7315531573,106808,7315638381,1,0,0,50688,1,9651676242
2158,7315537158,1042,7315538200,6,0,1,1024,6,5169836394
2159,7315540700,16168,7315556868,4,0,1,5120,4,7492956349
2160,7315577877,114534,7315692411,7,0,0,35328,7,4238637213
2161,7315633647,16000,7315649647,1,0,1,18432,1,1701426900
2162,7315675284,75452,7315750736,1,0,0,13312,1,9487699369
2163,7315796614,5196,7315801810,8,0,1,13312,8,4618289677
2164,7315861508,7706,7315869214,0,0,1,8192,0,96627357
2165,7315870189,43904,7315914093,9,0,0,512,9,3881550958
2166,7315886660,142847,7316029507,1,0,0,99840,1,5969643148
2167,7315895042,6229,7315901271,3,0,1,15360,3,8501218448
2168,7316035603,6278,7316041881,0,0,1,6656,0,318113107
2169,7316111831,6754,7316118585,8,0,1,7168,8,6329715859
2170,7316141622,109772,7316251394,7,0,0,60416,7,6685510157
2171,7316144256,70502,7316214758,3,0,0,10752,3,3812493203
2172,7316221334,104280,7316325614,8,0,0,19456,8,3831273942
2173,7316237825,24318,7316262143,9,0,1,17408,9,3225019134
2174,7316261899,81128,7316343027,7,0,0,11776,7,8848735232
2175,7316366328,3898,7316370226,2,0,1,4096,2,6932658014
2176,7316404677,566,7316405243,5,0,1,512,5,7520779528
2177,7316419616,4374,7316423990,9,0,1,4608,9,10734358373
2178,7316437488,5326,7316442814,9,0,1,5632,9,4506819252
2179,7316636911,45596,7316682507,2,0,0,1024,2,7406814280
2180,7316676254,12825,7316689079,4,0,1,21504,4,4746466627
2181,7316743124,52988,7316796112,1,0,0,5120,1,4061177656
2182,7316750022,115239,7316865261,8,0,0,35328,8,4485489093
2183,7316758525,72913,7316831438,6,0,0,7680,6,10377931256
2184,7316868860,5802,7316874662,9,0,1,6144,9,8180689835
2185,7316885925,111800,7316997725,0,0,0,67072,0,358110446
2186,7316894121,4374,7316898495,7,0,1,4608,7,7432475011
2187,7316927771,89588,7317017359,1,0,0,14336,1,2008601025
2188,7316941612,159717,7317101329,0,0,0,61952,0,9639183795
2189,7317018831,86996,7317105827,6,0,0,5120,6,8770506751
2190,7317088827,13060,7317101887,7,0,1,512,7,9619180227
2191,7317134459,117416,7317251875,6,0,0,85504,6,3590896888
2192,7317207949,3422,7317211371,6,0,1,3584,6,2870973395
2193,7317208197,15180,7317223377,1,0,1,27648,1,1408723331
2194,7317222733,353837,7317576570,7,0,0,126464,7,5572440820
2195,7317230335,29238,7317259573,5,0,1,8192,5,4177839308
2196,7317271617,150238,7317421855,0,0,0,44032,0,6321344976
2197,7317282744,139126,7317421870,1,0,1,212992,1,9981081381
2198,7317291618,347144,7317638762,8,0,0,20992,8,3963859185
2199,7317312155,109730,7317421885,8,0,1,2560,8,10387435608
2200,7317330438,91462,7317421900,4,0,1,6144,4,10723847744
2201,7317459151,162787,7317621938,8,0,0,36352,8,318106828
2202,7317564818,150270,7317715088,6,0,0,43520,6,3079036620
2203,7317769762,43904,7317813666,2,0,0,512,2,3990096206
2204,7317801943,106808,7317908751,6,0,0,50688,6,5664090224
2205,7317812858,2470,7317815328,0,0,1,2560,0,7998737862
2206,7317940417,43904,7317984321,6,0,0,512,6,6267345242
2207,7317969964,47288,7318017252,2,0,0,1536,2,3895243743
2208,7318009325,3645,7318012970,9,0,1,10240,9,5201010093
2209,7318014990,1518,7318016508,4,0,1,1536,4,4735160866
2210,7318028044,3387,7318031431,2,0,1,9728,2,3194641579
2211,7318053327,3422,7318056749,2,0,1,3584,2,3664050737
2212,7318100380,142618,7318242998,0,0,0,56832,0,635857827
2213,7318108861,135415,7318244276,9,0,0,1024,9,143048652
2214,7318122956,6278,7318129234,2,0,1,6656,2,5140505662
2215,7318124052,119897,7318243949,7,0,0,3072,7,7624118210
2216,7318153414,1518,7318154932,7,0,1,1536,7,6586747806
2217,7318277408,3387,7318280795,7,0,1,9728,7,1882120810
2218,7318313434,2946,7318316380,7,0,1,3072,7,710523053
2219,7318370979,59132,7318430111,7,0,0,5120,7,2192638927
2220,7318433591,48980,7318482571,8,0,0,2048,8,6087922570
2221,7318441499,56854,7318498353,1,0,1,97280,1,9339286143
2222,7318465108,44996,7318510104,1,0,1,48128,1,10240449743
2223,7318524067,3128,7318527195,4,0,1,9216,4,209739636
2224,7318598689,130382,7318729071,8,0,0,13312,8,9690758992
2225,7318738496,104468,7318842964,7,0,0,43008,7,951685288
2226,7318755070,104624,7318859694,0,0,0,43520,0,2887835141
2227,7318785425,76780,7318862205,1,0,0,8192,1,5943327412
2228,7318804820,140998,7318945818,8,0,0,51712,8,7462810067
2229,7318893973,100241,7318994214,1,0,0,6656,1,4023624902
2230,7318912425,4850,7318917275,6,0,1,5120,6,8160394279
2231,7318969869,108471,7319078340,1,0,0,54784,1,1226082479
2232,7319016336,3422,7319019758,2,0,1,3584,2,5243318625
2233,7319017429,4985,7319022414,9,0,1,12800,9,4710696494
2234,7319049823,86072,7319135895,0,0,0,17920,0,311770614
2235,7319074348,108389,7319182737,8,0,0,9216,8,4104955082
2236,7319235781,105092,7319340873,0,0,0,45056,0,3949369185
2237,7319353188,7230,7319360418,9,0,1,7680,9,5680440468
2238,7319368538,73604,7319442142,7,0,0,12288,7,8329859926
2239,7319378485,1042,7319379527,6,0,1,1024,6,9389499824
2240,7319428741,566,7319429307,8,0,1,512,8,7085367802
2241,7319477462,5196,7319482658,2,0,1,13312,2,4388017105
2242,7319561643,43904,7319605547,2,0,0,512,2,9695945373
2243,7319574015,57440,7319631455,6,0,0,4608,6,7274101799
2244,7319605459,158443,7319763902,1,0,1,261632,1,1816488588
2245,7319647964,286132,7319934096,8,0,0,26112,8,10548379727
2246,7319694517,280670,7319975187,9,0,0,2560,9,4034521445
2247,7319696069,246139,7319942208,4,0,0,5120,4,10684882199
2248,7319712414,203496,7319915910,0,0,0,5632,0,7842683388
2249,7319790606,113304,7319903910,6,0,0,1536,6,7712998541
2250,7319849484,117451,7319966935,9,0,0,512,9,746527567
2251,7319858552,10499,7319869051,4,0,1,16896,4,5943875670
2252,7319998448,4850,7320003298,2,0,1,5120,2,8146217682
2253,7320061080,6278,7320067358,2,0,1,6656,2,5407412705
2254,7320198223,57440,7320255663,7,0,0,4608,7,690297683
2255,7320305375,5196,7320310571,4,0,1,13312,4,9463702503
2256,7320331815,2946,7320334761,8,0,1,3072,8,479312805
2257,7320333149,52811,7320385960,2,0,0,512,2,8591588075
2258,7320403327,102284,7320505611,4,0,0,35840,4,7342360596
2259,7320476177,100568,7320576745,3,0,0,30208,3,10640607096
2260,7320478996,5326,7320484322,5,0,1,5632,5,7708832768
2261,7320578640,122876,7320701516,3,0,0,103424,3,390847139
2262,7320596119,3898,7320600017,6,0,1,4096,6,6453097059
2263,7320798936,53144,7320852080,4,0,0,5632,4,2790980186
2264,7320825123,13083,7320838206,4,0,1,22016,4,9185671344
2265,7320850710,2897,7320853607,9,0,1,1536,9,9009144044
2266,7320850783,5196,7320855979,6,0,1,3584,6,5788299537
2267,7320888734,109448,7320998182,6,0,0,1536,6,10674619816
2268,7321147056,2470,7321149526,8,0,1,2560,8,1533757456
2269,7321264854,4374,7321269228,5,0,1,4608,5,1207217755
2270,7321332725,103844,7321436569,8,0,0,40960,8,9929426199
2271,7321390979,45769,7321436748,9,0,0,512,9,6190497271
2272,7321424670,113863,7321538533,1,0,0,34816,1,5593400143
2273,7321465238,1518,7321466756,6,0,1,1536,6,5140553629
2274,7321485300,7706,7321493006,7,0,1,8192,7,10424651650
2275,7321575693,5802,7321581495,3,0,1,6144,3,6911100347
2276,7321591953,566,7321592519,8,0,1,512,8,7449698538
2277,7321623267,205749,7321829016,1,0,0,11776,1,7998509656
2278,7321631057,1042,7321632099,3,0,1,1024,3,7281424536
2279,7321645537,74608,7321720145,1,0,1,121856,1,5775522292
2280,7321730864,4850,7321735714,1,0,1,5120,1,2350233043
2281,7322004346,45596,7322049942,2,0,0,1024,2,1698649230
2282,7322031306,71756,7322103062,8,0,0,11264,8,8981039627
2283,7322122486,81128,7322203614,1,0,0,11776,1,5650859876
2284,7322147600,45596,7322193196,9,0,0,1024,9,1487563684
2285,7322164201,2946,7322167147,6,0,1,3072,6,9994300371
2286,7322164498,57512,7322222010,2,0,0,1536,2,9694125002
2287,7322240207,43904,7322284111,6,0,0,512,6,5843940652
2288,7322251943,7706,7322259649,9,0,1,8192,9,9851097052
2289,7322272539,114462,7322387001,0,0,0,63488,0,1407377437
2290,7322313202,4374,7322317576,8,0,1,4608,8,992617821
2291,7322396540,43904,7322440444,9,0,0,512,9,7892034958
2292,7322454155,43904,7322498059,0,0,0,512,0,3226986124
2293,7322481211,43904,7322525115,6,0,0,512,6,8363199043
2294,7322481797,43904,7322525701,9,0,0,512,9,457149160
2295,7322510239,6754,7322516993,2,0,1,7168,2,10493526357
2296,7322515936,79436,7322595372,7,0,0,11264,7,515785603
2297,7322550062,121472,7322671534,0,0,0,98816,0,3059508113
2298,7322712226,47288,7322759514,2,0,0,1536,2,9710386995
2299,7322755879,1042,7322756921,7,0,1,1024,7,9694515766
2300,7322824406,3898,7322828304,7,0,1,4096,7,618089860
2301,7322837585,4850,7322842435,4,0,1,5120,4,7135914690
2302,7322839067,58991,7322898058,4,0,0,7168,4,1285518426
2303,7322839914,5971,7322845885,4,0,1,14848,4,937584649
2304,7322877758,1518,7322879276,9,0,1,1536,9,3342050803
2305,7322889566,54056,7322943622,7,0,0,3584,7,2027882175
2306,7322927070,176571,7323103641,7,0,0,33792,7,1424026816
2307,7323071012,43904,7323114916,9,0,0,512,9,3890696358
2308,7323074385,6278,7323080663,4,0,1,6656,4,4261417737
2309,7323111136,43904,7323155040,6,0,0,512,6,923007564
2310,7323137495,12049,7323149544,2,0,1,19968,2,10034708899
2311,7323177798,50672,7323228470,7,0,0,2560,7,2049317753
2312,7323190328,3422,7323193750,5,0,1,3584,5,3828472910
2313,7323220166,4162,7323224328,8,0,1,11264,8,7818830633
2314,7323227547,1518,7323229065,6,0,1,1536,6,867340662
2315,7323282760,5326,7323288086,9,0,1,5632,9,4874425854
2316,7323321930,4679,7323326609,5,0,1,12288,5,3448928936
2317,7323414145,1994,7323416139,2,0,1,2048,2,1396440753
2318,7323421703,1518,7323423221,2,0,1,1536,2,8806949050
2319,7323485275,127675,7323612950,7,0,0,51200,7,1630149697
2320,7323503409,566,7323503975,0,0,1,512,0,10351067847
2321,7323526511,130294,7323656805,3,0,0,55296,3,9252279533
2322,7323548327,168182,7323716509,0,0,0,95744,0,9019133564
2323,7323572674,220559,7323793233,4,0,0,47104,4,10485300546
2324,7323592423,130973,7323723396,4,0,0,22528,4,10589206656
2325,7323600884,215221,7323816105,0,0,0,11264,0,3610729607
2326,7323694641,30257,7323724898,8,0,1,1536,8,4401026499
2327,7323714587,114013,7323828600,4,0,0,40960,4,8809542136
2328,7323770588,4374,7323774962,6,0,1,4608,6,2367237787
2329,7323790991,9940,7323800931,1,0,1,8192,1,9468751185
2330,7323880187,6229,7323886416,1,0,1,15360,1,2503787621
2331,7323888503,157712,7324046215,0,0,0,46592,0,6257377083
2332,7323893927,138077,7324032004,3,0,0,55808,3,1732827524
2333,7323902358,55123,7323957481,6,0,0,1024,6,896400430
2334,7323970552,122902,7324093454,3,0,0,27648,3,4811502792
2335,7323998700,3645,7324002345,1,0,1,10240,1,29124175
2336,7324003146,165188,7324168334,4,0,0,19456,4,1038442323
2337,7324005069,157322,7324162391,7,0,0,98304,7,5879594761
2338,7324140797,71433,7324212230,2,0,0,512,2,5997840251
2339,7324177806,57440,7324235246,9,0,0,4608,9,2778495923
2340,7324396937,566,7324397503,7,0,1,512,7,4445028353
2341,7324448976,145415,7324594391,6,0,0,512,6,10498589936
2342,7324488660,105560,7324594220,7,0,0,46592,7,7964991897
2343,7324605507,111800,7324717307,3,0,0,67072,3,432236595
2344,7324691228,33762,7324724990,1,0,1,58880,1,5813145972
2345,7324770765,5196,7324775961,2,0,1,13312,2,8682124807
2346,7324831328,203296,7325034624,1,0,0,98816,1,3588327020
2347,7324851079,1042,7324852121,3,0,1,1024,3,8518680768
2348,7325261018,1994,7325263012,0,0,1,2048,0,10678006534
2349,7325267430,43904,7325311334,9,0,0,512,9,787263864
2350,7325301559,3898,7325305457,2,0,1,4096,2,4168705995
2351,7325304356,107588,7325411944,3,0,0,53248,3,7427146320
2352,7325388541,56103,7325444644,2,0,0,2048,2,3515290368
2353,7325397587,18247,7325415834,4,0,1,4096,4,2335096466
2354,7325480880,4374,7325485254,7,0,1,4608,7,9271036949
2355,7325498165,134848,7325633013,2,0,0,1536,2,9451661354
2356,7325552799,76364,7325629163,7,0,0,11264,7,9039469480
2357,7325558691,47288,7325605979,9,0,0,1536,9,7439585601
2358,7325575680,62516,7325638196,1,0,0,6144,1,4335636324
2359,7325623091,6087,7325629178,9,0,1,3072,9,10320915088
2360,7325695619,111332,7325806951,7,0,0,65536,7,8245206606
2361,7325763381,43585,7325806966,1,0,1,70656,1,8849977235
2362,7325812215,1994,7325814209,2,0,1,2048,2,4423600966
2363,7325869440,132432,7326001872,6,0,0,1024,6,5044966111
2364,7325870273,74384,7325944657,3,0,0,14848,3,739785493
2365,7325885884,6278,7325892162,2,0,1,6656,2,7566204669
2366,7325898510,3387,7325901897,2,0,1,9728,2,2681183491
2367,7325914643,2870,7325917513,4,0,1,8704,4,4240119149
2368,7326132387,2470,7326134857,4,0,1,2560,4,10721682181
2369,7326254174,47288,7326301462,9,0,0,1536,9,9486465823
2370,7326307796,6754,7326314550,4,0,1,7168,4,7688975084
2371,7326379905,45752,7326425657,2,0,0,1536,2,1877645727
2372,7326459376,1994,7326461370,7,0,1,2048,7,2323778206
2373,7326460862,4374,7326465236,3,0,1,4608,3,7760908275
2374,7326582372,7706,7326590078,7,0,1,8192,7,4865454863
2375,7326589816,47444,7326637260,6,0,0,2048,6,8484547449
2376,7326611367,5971,7326617338,2,0,1,14848,2,6826130749
2377,7326632745,2470,7326635215,4,0,1,2560,4,1010122078
2378,7326699237,1518,7326700755,0,0,1,1536,0,10206481451
2379,7326705797,111332,7326817129,1,0,0,65536,1,10034471151
2380,7326765633,5326,7326770959,7,0,1,5632,7,10130697272
2381,7326833453,2946,7326836399,9,0,1,3072,9,9563099795
2382,7326933633,2470,7326936103,6,0,1,2560,6,639002911
2383,7326957564,67772,7327025336,0,0,0,13312,0,3032484145
2384,7326974856,82088,7327056944,3,0,0,19968,3,9110952395
2385,7326986619,566,7326987185,6,0,1,512,6,9616785055
2386,7327017477,80615,7327098092,9,0,0,1536,9,559404311
2387,7327020733,80746,7327101479,4,0,0,2048,4,1703407418
2388,7327027754,1994,7327029748,7,0,1,2048,7,8872925663
2389,7327048295,47288,7327095583,6,0,0,1536,6,623640488
2390,7327051608,49232,7327100840,9,0,0,512,9,7168382950
2391,7327071926,16613,7327088539,1,0,1,32256,1,6826927192
2392,7327143613,118242,7327261855,4,0,0,43008,4,10118103255
2393,7327151763,11274,7327163037,6,0,1,18432,6,8462650665
2394,7327216715,77576,7327294291,6,0,0,1024,6,4546946784
2395,7327269910,3898,7327273808,4,0,1,4096,4,1121547467
2396,7327289995,2470,7327292465,0,0,1,2560,0,2934986153
2397,7327338576,2946,7327341522,0,0,1,3072,0,3413511884
2398,7327369451,102596,7327472047,3,0,0,36864,3,9842232882
2399,7327388425,83949,7327472374,9,0,0,1024,9,7231020667
2400,7327395396,85885,7327481281,9,0,0,512,9,631973859
2401,7327417447,82322,7327499769,9,0,0,2560,9,1956184536
2402,7327480754,1042,7327481796,5,0,1,1024,5,354251807
2403,7327623864,42683,7327666547,1,0,1,69632,1,1379089980
2404,7327655172,184020,7327839192,1,0,0,96768,1,1623643501
2405,7327685295,6488,7327691783,9,0,1,15872,9,3510874164
2406,7327707179,87637,7327794816,2,0,0,1536,2,3851730215
2407,7327774757,64606,7327839363,2,0,0,512,2,13343266
2408,7327837997,2400,7327840397,5,0,1,1024,5,3805769105
2409,7327885301,72799,7327958100,1,0,1,118272,1,9389167182
2410,7327927069,31902,7327958971,7,0,1,12288,7,8904844770
2411,7327942882,22298,7327965180,7,0,1,29696,7,10550469124
2412,7327959826,6660,7327966486,8,0,1,2048,8,7822942367
2413,7327997990,86151,7328084141,8,0,0,4096,8,3821504780
2414,7328017146,2946,7328020092,8,0,1,3072,8,3368537495
2415,7328056635,1518,7328058153,5,0,1,1536,5,4119049350
2416,7328266965,1994,7328268959,0,0,1,2048,0,9462304975
2417,7328357684,68840,7328426524,7,0,0,11776,7,4106350774
2418,7328368725,1994,7328370719,4,0,1,2048,4,5182377573
2419,7328393344,4937,7328398281,4,0,1,12800,4,6398578795
2420,7328418856,3898,7328422754,7,0,1,4096,7,10232538949
2421,7328440631,43904,7328484535,2,0,0,512,2,3413775771
2422,7328471173,3128,7328474301,5,0,1,9216,5,4779457456
2423,7328550266,566,7328550832,5,0,1,512,5,10105944880
2424,7328553650,1042,7328554692,9,0,1,1024,9,2622727122
2425,7328556485,43904,7328600389,2,0,0,512,2,9122463378
2426,7328590524,52618,7328643142,2,0,0,1536,2,9336919459
2427,7328628744,106028,7328734772,0,0,0,48128,0,2123283508
2428,7328660399,46988,7328707387,1,0,1,81408,1,1882241570
2429,7328693842,247564,7328941406,4,0,0,49152,4,4285974482
2430,7328710071,238361,7328948432,6,0,0,512,6,874623544
2431,7328716082,65768,7328781850,7,0,0,11776,7,6235719411
2432,7328822984,566,7328823550,6,0,1,512,6,6397372063
2433,7328885791,566,7328886357,4,0,1,512,4,10186218350
2434,7328905257,566,7328905823,2,0,1,512,2,3798609519
2435,7328959288,3422,7328962710,3,0,1,3584,3,2043384810
2436,7328965286,99788,7329065074,8,0,0,27648,8,10611391387
2437,7329021210,1994,7329023204,8,0,1,2048,8,2705718723
2438,7329079743,7706,7329087449,5,0,1,8192,5,192145134
2439,7329122259,110240,7329232499,1,0,0,61952,1,6570869959
2440,7329195557,1042,7329196599,7,0,1,1024,7,4371645759
2441,7329246360,43904,7329290264,4,0,0,512,4,8359365961
2442,7329266721,48980,7329315701,9,0,0,2048,9,9507755720
2443,7329286526,117876,7329404402,7,0,0,45056,7,7471513145
2444,7329289134,1145,7329290279,2,0,1,1024,2,3380865506
2445,7329325305,99817,7329425122,4,0,0,1536,4,2753909349
2446,7329347766,64910,7329412676,4,0,0,512,4,7760877644
2447,7329446463,1994,7329448457,5,0,1,2048,5,7996994024
2448,7329459707,3422,7329463129,3,0,1,3584,3,3574602264
2449,7329517322,52364,7329569686,4,0,0,3072,4,659931440
2450,7329601129,45596,7329646725,4,0,0,1024,4,1508689669
2451,7329611346,5802,7329617148,7,0,1,6144,7,1677058007
2452,7329686121,4850,7329690971,2,0,1,5120,2,9057179729
2453,7329730448,56372,7329786820,8,0,0,6144,8,2846250459
2454,7329771258,107276,7329878534,3,0,0,52224,3,2910570218
2455,7329810191,84585,7329894776,4,0,0,3584,4,379057440
2456,7329857542,108992,7329966534,7,0,0,57856,7,2677356898
2457,7329866394,19838,7329886232,0,0,1,8192,0,9276033911
2458,7329897428,72256,7329969684,4,0,0,1536,4,2726560102
2459,7329903635,123937,7330027572,7,0,0,30208,7,2992754327
2460,7329939658,62312,7330001970,6,0,0,512,6,3998594250
2461,7329943404,43904,7329987308,4,0,0,512,4,7219438881
2462,7330017239,45596,7330062835,6,0,0,1024,6,915486695
2463,7330086627,47288,7330133915,4,0,0,1536,4,190524820
2464,7330090014,149399,7330239413,3,0,0,119808,3,378524928
2465,7330208781,74528,7330283309,6,0,0,512,6,9544722180
2466,7330303952,6754,7330310706,6,0,1,7168,6,4950122535
2467,7330318984,2470,7330321454,0,0,1,2560,0,7578182425
2468,7330340843,1518,7330342361,4,0,1,1536,4,3664679861
2469,7330349129,103624,7330452753,3,0,0,14336,3,9211541120
2470,7330374678,45596,7330420274,9,0,0,1024,9,3081846605
2471,7330382498,566,7330383064,7,0,1,512,7,4961518556
2472,7330452681,1106,7330453787,0,0,1,1024,0,4639878605
2473,7330572015,2470,7330574485,0,0,1,2560,0,2282114555
2474,7330605137,43904,7330649041,9,0,0,512,9,6703509279
2475,7330611665,1518,7330613183,4,0,1,1536,4,10440894444
2476,7330659269,67592,7330726861,7,0,0,7680,7,718112977
2477,7330688290,43904,7330732194,6,0,0,512,6,3635421508
2478,7330705566,1994,7330707560,0,0,1,2048,0,6452523022
2479,7330723383,3493,7330726876,1,0,1,3072,1,5019909007
2480,7330776415,10757,7330787172,0,0,1,17408,0,128118331
2481,7330789326,10499,7330799825,7,0,1,16896,7,9996359733
2482,7330983781,3904,7330987685,3,0,1,10752,3,4458406489
2483,7331013826,4420,7331018246,2,0,1,11776,2,8549730028
2484,7331239718,1994,7331241712,9,0,1,2048,9,2474228071
2485,7331356299,2470,7331358769,3,0,1,2560,3,8471575703
2486,7331415933,3898,7331419831,3,0,1,4096,3,6665964024
2487,7331487129,1518,7331488647,2,0,1,1536,2,10287617326
2488,7331512993,104936,7331617929,8,0,0,44544,8,1818714050
2489,7331571639,72582,7331644221,4,0,0,2560,4,7395578793
2490,7331587399,62810,7331650209,9,0,0,2048,9,1196297996
2491,7331598342,1994,7331600336,0,0,1,2048,0,441656383
2492,7331617700,6023,7331623723,2,0,1,6144,2,1242776525
2493,7331623140,1249,7331624389,3,0,1,1024,3,6740884850
2494,7331669209,4937,7331674146,2,0,1,12800,2,4268877209
2495,7331670156,136794,7331806950,8,0,0,37376,8,2537215611
2496,7331673646,56172,7331729818,9,0,0,2048,9,2325492185
2497,7331838213,16096,7331854309,0,0,1,31232,0,4492490567
2498,7331984480,47288,7332031768,9,0,0,1536,9,9248368529
2499,7332013328,98540,7332111868,3,0,0,23552,3,10282898778
2500,7332020157,4374,7332024531,9,0,1,4608,9,5107392085
2501,7332169442,123812,7332293254,8,0,0,106496,8,8304086066
2502,7332307053,49067,7332356120,9,0,0,2048,9,7581783876
2503,7332311577,43904,7332355481,2,0,0,512,2,577144574
2504,7332380797,3898,7332384695,5,0,1,4096,5,7294221258
2505,7332483493,121940,7332605433,3,0,0,100352,3,9711930120
2506,7332625308,5454,7332630762,5,0,1,13824,5,8521348490
2507,7332730875,57440,7332788315,7,0,0,4608,7,5780902933
2508,7332772866,3422,7332776288,2,0,1,3584,2,6709889647
2509,7332815860,1042,7332816902,6,0,1,1024,6,5432482647
2510,7332825539,2470,7332828009,0,0,1,2560,0,4498310610
2511,7332842705,11791,7332854496,6,0,1,19456,6,8327968371
2512,7332902257,101192,7333003449,7,0,0,32256,7,5616479988
2513,7332928288,109162,7333037450,2,0,0,512,2,8184968833
2514,7333046447,97916,7333144363,1,0,0,21504,1,9129652506
2515,7333084477,6488,7333090965,6,0,1,15872,6,2063693871
2516,7333264746,43904,7333308650,4,0,0,512,4,9915828878
2517,7333268854,85916,7333354770,3,0,0,17408,3,3281535510
2518,7333339171,52364,7333391535,7,0,0,3072,7,6540714217
2519,7333492821,115544,7333608365,0,0,0,79360,0,924944229
2520,7333542157,2870,7333545027,8,0,1,8704,8,4837884066
2521,7333574546,55959,7333630505,7,0,0,3584,7,5777660524
2522,7333624737,5783,7333630520,0,0,1,13824,0,3974150826
2523,7333764277,1994,7333766271,9,0,1,2048,9,5657370226
2524,7333843858,2870,7333846728,4,0,1,8704,4,10488758673
2525,7333848998,5802,7333854800,0,0,1,6144,0,2346175335
2526,7333918303,4850,7333923153,9,0,1,5120,9,9980687339
2527,7333954870,6278,7333961148,4,0,1,6656,4,2711156304
2528,7333984044,60633,7334044677,6,0,0,1024,6,8067477618
2529,7334027354,43904,7334071258,2,0,0,512,2,4498448555
2530,7334169782,50672,7334220454,9,0,0,2560,9,6487140396
2531,7334210316,79928,7334290244,7,0,0,17920,7,6199172616
2532,7334241488,1042,7334242530,3,0,1,1024,3,5448956668
2533,7334348948,4850,7334353798,7,0,1,5120,7,4606403299
2534,7334386471,55748,7334442219,8,0,0,4096,8,2110218285
2535,7334428646,3921,7334432567,7,0,1,10752,7,6230658115
2536,7334428654,4579,7334433233,6,0,1,1024,6,4351682253
2537,7334456676,2946,7334459622,9,0,1,3072,9,2199652262
2538,7334469786,47288,7334517074,9,0,0,1536,9,1348710819
2539,7334476110,66836,7334542946,8,0,0,10240,8,9129847406
2540,7334505030,2470,7334507500,1,0,1,2560,1,7320457116
2541,7334555682,136046,7334691728,8,0,0,88064,8,114605284
2542,7334650012,118508,7334768520,7,0,0,89088,7,2203293313
2543,7334767450,5436,7334772886,2,0,1,4608,2,4993836786
2544,7334839176,83288,7334922464,1,0,0,13824,1,8515881732
2545,7334848092,154843,7335002935,0,0,0,18432,0,7202045434
2546,7334848928,73707,7334922635,9,0,0,512,9,5469593095
2547,7334873282,2946,7334876228,1,0,1,3072,1,5359820762
2548,7335037190,1518,7335038708,0,0,1,1536,0,4337289021
2549,7335045558,45596,7335091154,6,0,0,1024,6,6808589474
2550,7335046787,101816,7335148603,3,0,0,34304,3,4047289352
2551,7335387303,1042,7335388345,2,0,1,1024,2,7005555731
2552,7335451820,2470,7335454290,5,0,1,2560,5,7008284189
2553,7335452336,3260,7335455596,2,0,1,2048,2,2441541474
2554,7335477848,43904,7335521752,6,0,0,512,6,1780521371
2555,7335492257,197743,7335690000,1,0,0,55808,1,8681974848
2556,7335609024,2946,7335611970,6,0,1,3072,6,8911226810
2557,7335632058,3422,7335635480,1,0,1,3584,1,10086198838
2558,7335661697,186494,7335848191,9,0,0,512,9,3867731041
2559,7335755135,199328,7335954463,0,0,0,193024,0,346445980
2560,7335846950,135809,7335982759,0,0,0,21504,0,8304680355
2561,7335849547,105578,7335955125,2,0,0,1024,2,5896392018
2562,7335852915,101875,7335954790,2,0,0,1024,2,8850598868
2563,7335928251,96283,7336024534,3,0,0,9728,3,9497155884
2564,7336004301,43904,7336048205,2,0,0,512,2,7317822527
2565,7336191687,71312,7336262999,3,0,0,14848,3,1098674384
2566,7336262070,105545,7336367615,7,0,0,43520,7,1159223680
2567,7336425836,5326,7336431162,9,0,1,5632,9,2773321918
2568,7336534206,2870,7336537076,1,0,1,8704,1,8264000491
2569,7336601618,109616,7336711234,3,0,0,59904,3,4999341828
2570,7336716876,4850,7336721726,9,0,1,5120,9,7271573218
2571,7336730377,50672,7336781049,4,0,0,2560,4,2209537752
2572,7336730652,3904,7336734556,9,0,1,10752,9,10110435870
2573,7336782306,1042,7336783348,5,0,1,1024,5,2509509373
2574,7336849418,45596,7336895014,6,0,0,1024,6,120330402
2575,7336886503,43904,7336930407,2,0,0,512,2,5290106472
2576,7336899081,4374,7336903455,3,0,1,4608,3,5762388161
2577,7336908304,10757,7336919061,5,0,1,17408,5,4578570662
2578,7337014148,3128,7337017276,0,0,1,9216,0,9443334657
2579,7337015787,8924,7337024711,2,0,1,8192,2,2865412211
2580,7337017202,8495,7337025697,9,0,1,1536,9,4217724018
2581,7337075056,43904,7337118960,9,0,0,512,9,7860648987
2582,7337105724,2946,7337108670,7,0,1,3072,7,9531587278
2583,7337152931,12737,7337165668,4,0,1,24576,4,8376306070
2584,7337153189,15705,7337168894,1,0,1,5120,1,7426154635
2585,7337223303,79148,7337302451,8,0,0,15360,8,1078194295
2586,7337367816,3898,7337371714,4,0,1,4096,4,1746026840
2587,7337430158,11274,7337441432,2,0,1,18432,2,8265698343
2588,7337468442,43904,7337512346,9,0,0,512,9,3466185636
2589,7337614567,74360,7337688927,1,0,0,9728,1,1089649734
2590,7337639759,43904,7337683663,4,0,0,512,4,9410482407
2591,7337706978,3898,7337710876,3,0,1,4096,3,630388425
2592,7337741502,108056,7337849558,1,0,0,54784,1,2249696309
2593,7337773757,4374,7337778131,0,0,1,4608,0,5339406756
2594,7337948679,127556,7338076235,3,0,0,118784,3,5791222530
2595,7337973230,2470,7337975700,8,0,1,2560,8,341906914
2596,7338077242,5326,7338082568,1,0,1,5632,1,7932492079
2597,7338095856,12995,7338108851,1,0,1,25088,1,7624657287
2598,7338180522,3387,7338183909,0,0,1,9728,0,1611871594
2599,7338281588,67592,7338349180,1,0,0,7680,1,8783642761
2600,7338295046,43904,7338338950,9,0,0,512,9,10537296761
2601,7338363791,2870,7338366661,4,0,1,8704,4,5557479773
2602,7338372320,3387,7338375707,3,0,1,9728,3,514110830
2603,7338382598,4420,7338387018,8,0,1,11776,8,4443622325
2604,7338493843,119666,7338613509,7,0,0,29184,7,4575909697
2605,7338499499,2946,7338502445,9,0,1,3072,9,3610982988
2606,7338542279,2946,7338545225,3,0,1,3072,3,7635593432
2607,7338586359,65490,7338651849,4,0,0,1536,4,3650458272
2608,7338635592,92684,7338728276,7,0,0,19456,7,319521911
2609,7338769893,73628,7338843521,7,0,0,17408,7,7573344172
2610,7338773307,4420,7338777727,6,0,1,11776,6,9327884507
2611,7338776094,46446,7338822540,0,0,0,1024,0,4457884934
2612,7338817294,566,7338817860,4,0,1,512,4,9762288243
2613,7338921693,3387,7338925080,3,0,1,9728,3,9121972345
2614,7338970073,103064,7339073137,7,0,0,38400,7,7978182591
2615,7339111922,4850,7339116772,2,0,1,5120,2,7117444767
2616,7339227986,102128,7339330114,0,0,0,35328,0,6007238027
2617,7339256606,3387,7339259993,2,0,1,9728,2,5069706422
2618,7339288565,61589,7339350154,6,0,0,3072,6,6319972650
2619,7339345612,6278,7339351890,8,0,1,6656,8,9756762786
2620,7339402911,13253,7339416164,7,0,1,25600,7,10296355134
2621,7339463961,5802,7339469763,2,0,1,6144,2,5907148129
2622,7339492906,4679,7339497585,9,0,1,12288,9,8833081123
2623,7339563395,64076,7339627471,1,0,0,11264,1,10505252465
2624,7339618136,566,7339618702,8,0,1,512,8,8793938753
2625,7339936361,566,7339936927,6,0,1,512,6,9815392511
2626,7340042574,72668,7340115242,0,0,0,9216,0,10702424158
2627,7340112876,47954,7340160830,1,0,0,1024,1,6212900748
2628,7340165346,2870,7340168216,6,0,1,8704,6,6458774985
2629,7340185739,566,7340186305,1,0,1,512,1,680322257
2630,7340212143,6278,7340218421,1,0,1,6656,1,2389980812
2631,7340218439,47288,7340265727,2,0,0,1536,2,4342953590
2632,7340291118,5326,7340296444,9,0,1,5632,9,1610748977
2633,7340455277,43904,7340499181,6,0,0,512,6,9109533347
2634,7340500444,3422,7340503866,2,0,1,3584,2,92906630
2635,7340610748,47288,7340658036,2,0,0,1536,2,987467864
2636,7340626815,43904,7340670719,4,0,0,512,4,2889344863
2637,7340727622,5802,7340733424,7,0,1,6144,7,9117064451
2638,7340780471,5326,7340785797,4,0,1,5632,4,1046755476
2639,7340802390,1518,7340803908,2,0,1,1536,2,898316143
2640,7340848759,96224,7340944983,3,0,0,20992,3,8328298770
2641,7340874978,4420,7340879398,4,0,1,11776,4,4046396751
2642,7340904588,68997,7340973585,9,0,0,512,9,2900736811
2643,7340932642,2470,7340935112,4,0,1,2560,4,9454738426
2644,7340954146,6754,7340960900,8,0,1,7168,8,404872589
2645,7340992540,2946,7340995486,4,0,1,3072,4,7644635666
2646,7341012043,271529,7341283572,3,0,0,7168,3,7372246264
2647,7341070889,45596,7341116485,1,0,0,1024,1,4788741126
2648,7341088299,3645,7341091944,2,0,1,10240,2,1191255562
2649,7341102594,112736,7341215330,0,0,0,70144,0,10251716413
2650,7341266206,54056,7341320262,2,0,0,3584,2,9812003746
2651,7341295894,43904,7341339798,9,0,0,512,9,4888906461
2652,7341444784,50672,7341495456,4,0,0,2560,4,5947464811
2653,7341591582,74852,7341666434,0,0,0,16384,0,4224838156
2654,7341617830,133510,7341751340,1,0,0,67072,1,550233840
2655,7341705104,47288,7341752392,7,0,0,1536,7,6319029583
2656,7341974893,45908,7342020801,2,0,0,2048,2,8787593370
2657,7342067247,4162,7342071409,1,0,1,11264,1,2959403497
2658,7342076852,2946,7342079798,3,0,1,3072,3,8442602354
2659,7342205249,1042,7342206291,6,0,1,1024,6,335310039
2660,7342208411,3904,7342212315,0,0,1,10752,0,562483744
2661,7342219333,6229,7342225562,9,0,1,15360,9,8650673175
2662,7342281278,2470,7342283748,7,0,1,2560,7,4194994188
2663,7342320770,22058,7342342828,2,0,0,512,2,1289945486
2664,7342343490,1042,7342344532,3,0,1,1024,3,3402436055
2665,7342639941,4679,7342644620,5,0,1,12288,5,5568498259
2666,7342797440,43904,7342841344,9,0,0,512,9,3354312954
2667,7342807966,2470,7342810436,8,0,1,2560,8,7904932734
2668,7342885366,1042,7342886408,1,0,1,1024,1,847908517
2669,7342997924,43904,7343041828,9,0,0,512,9,5043252958
2670,7343069829,45596,7343115425,4,0,0,1024,4,1685733035
2671,7343073972,43904,7343117876,0,0,0,512,0,3532539505
2672,7343078328,1518,7343079846,0,0,1,1536,0,4554246977
2673,7343117319,3898,7343121217,2,0,1,4096,2,4267543793
2674,7343173028,174783,7343347811,0,0,0,2560,0,3458311323
2675,7343174751,43904,7343218655,6,0,0,512,6,9673909488
2676,7343194420,47288,7343241708,7,0,0,1536,7,8041476264
2677,7343239896,107120,7343347016,1,0,0,51712,1,9514739849
2678,7343295194,66372,7343361566,4,0,0,2560,4,6962536368
2679,7343469437,43904,7343513341,2,0,0,512,2,706187325
2680,7343498644,7230,7343505874,9,0,1,7680,9,2520206368
2681,7343529177,1518,7343530695,3,0,1,1536,3,1971572983
2682,7343667694,1518,7343669212,1,0,1,1536,1,9965278187
2683,7343678060,101972,7343780032,0,0,0,34816,0,3303325688
2684,7343690431,90837,7343781268,2,0,0,3584,2,2014216453
2685,7343691026,3422,7343694448,0,0,1,3584,0,454735490
2686,7343764692,121612,7343886304,3,0,0,48640,3,5304026950
2687,7343988973,3128,7343992101,7,0,1,9216,7,9399774181
2688,7344031495,154053,7344185548,2,0,0,512,2,685740060
2689,7344033060,152659,7344185719,2,0,0,512,2,5816124911
2690,7344034778,2946,7344037724,8,0,1,3072,8,7899393759
2691,7344051951,43904,7344095855,6,0,0,512,6,5484409274
2692,7344069431,566,7344069997,9,0,1,512,9,4120438196
2693,7344146395,1994,7344148389,1,0,1,2048,1,5062904129
2694,7344233129,6278,7344239407,4,0,1,6656,4,1733972943
2695,7344282679,221552,7344504231,8,0,0,56320,8,4310856099
2696,7344312634,2470,7344315104,8,0,1,2560,8,8914746358
2697,7344535374,43904,7344579278,2,0,0,512,2,2395517090
2698,7344573416,149541,7344722957,8,0,0,19456,8,4506350153
2699,7344594945,95444,7344690389,3,0,0,18432,3,3746342970
2700,7344692161,1994,7344694155,1,0,1,2048,1,9543065047
2701,7344759721,43904,7344803625,7,0,0,512,7,1516530000
2702,7344830513,78524,7344909037,0,0,0,13312,0,932047419
2703,7344867775,111020,7344978795,0,0,0,64512,0,291311526
2704,7345008879,104000,7345112879,1,0,0,41472,1,2871024337
2705,7345092249,7230,7345099479,8,0,1,7680,8,3405459942
2706,7345115041,47288,7345162329,2,0,0,1536,2,10476667825
2707,7345227678,45596,7345273274,1,0,0,1024,1,1318156626
2708,7345400756,1042,7345401798,3,0,1,1024,3,4737005028
2709,7345472503,55748,7345528251,8,0,0,4096,8,4364479311
2710,7345480397,3422,7345483819,4,0,1,3584,4,6669856409
2711,7345497895,6278,7345504173,6,0,1,6656,6,3588341812
2712,7345532030,2470,7345534500,4,0,1,2560,4,923241295
2713,7345587356,68996,7345656352,1,0,0,12288,1,1518879057
2714,7345626530,566,7345627096,1,0,1,512,1,6690969865
2715,7345659661,144836,7345804497,6,0,0,512,6,9456302541
2716,7345836414,2946,7345839360,4,0,1,3072,4,7269540334
2717,7345839768,6754,7345846522,4,0,1,7168,4,9606895763
2718,7346031254,102128,7346133382,8,0,0,35328,8,4911903203
2719,7346060762,2946,7346063708,1,0,1,3072,1,8570472126
2720,7346095074,43904,7346138978,7,0,0,512,7,2550402192
2721,7346161970,1042,7346163012,8,0,1,1024,8,8420918207
2722,7346173294,1042,7346174336,0,0,1,1024,0,4690715057
2723,7346203421,45596,7346249017,7,0,0,1024,7,5580608671
2724,7346245114,47288,7346292402,9,0,0,1536,9,4850235417
2725,7346275905,3128,7346279033,2,0,1,9216,2,9028491290
2726,7346397981,566,7346398547,1,0,1,512,1,4011293565
2727,7346407945,91328,7346499273,1,0,0,25088,1,10234332288
2728,7346510418,43904,7346554322,4,0,0,512,4,9697683091
2729,7346526898,101660,7346628558,3,0,0,33792,3,2745256342
2730,7346527631,5802,7346533433,6,0,1,6144,6,6606156116
2731,7346658751,48980,7346707731,7,0,0,2048,7,6558511218
2732,7346765537,14804,7346780341,5,0,1,28672,5,10521556821
2733,7346782103,566,7346782669,8,0,1,512,8,10226285722
2734,7346879596,2870,7346882466,4,0,1,8704,4,3137190865
2735,7346888679,7230,7346895909,6,0,1,7680,6,216847660
2736,7346928890,82500,7347011390,9,0,0,512,9,5511868993
2737,7346986744,43904,7347030648,9,0,0,512,9,7706993983
2738,7347023057,100196,7347123253,9,0,0,4096,9,2085100492
2739,7347029981,43904,7347073885,4,0,0,512,4,8293300141
2740,7347045423,63633,7347109056,2,0,0,3584,2,6973721111
2741,7347053425,12825,7347066250,7,0,1,21504,7,4171207219
2742,7347056256,122023,7347178279,8,0,0,6656,8,5986065722
2743,7347060517,9599,7347070116,1,0,1,6144,1,1454994819
2744,7347100612,4850,7347105462,8,0,1,5120,8,2010111708
2745,7347103205,3883,7347107088,2,0,1,2560,2,5861320764
2746,7347112294,7706,7347120000,5,0,1,8192,5,6674064038
2747,7347144445,53237,7347197682,7,0,1,90112,7,2396657117
2748,7347153258,87064,7347240322,1,0,0,10240,1,4641327343
2749,7347261173,2470,7347263643,9,0,1,2560,9,3948627681
2750,7347407961,4679,7347412640,7,0,1,12288,7,10467363596
2751,7347459534,6229,7347465763,9,0,1,15360,9,5877642748
2752,7347506120,85528,7347591648,8,0,0,512,8,7328507225
2753,7347511389,4850,7347516239,4,0,1,5120,4,9689032534
2754,7347626364,4850,7347631214,4,0,1,5120,4,3737483386
2755,7347627127,4241,7347631368,4,0,1,8704,4,4224764961
2756,7347757151,97028,7347854179,8,0,0,28672,8,7222819427
2757,7347761491,1994,7347763485,4,0,1,2048,4,3176980101
2758,7347868468,1042,7347869510,2,0,1,1024,2,2399139884
2759,7347893376,5802,7347899178,5,0,1,6144,5,5505916137
2760,7347909166,2946,7347912112,3,0,1,3072,3,1754645234
2761,7347939057,2470,7347941527,2,0,1,2560,2,2767131352
2762,7347996081,1994,7347998075,2,0,1,2048,2,6893959008
2763,7348064672,2470,7348067142,9,0,1,2560,9,10508057252
2764,7348085145,50672,7348135817,6,0,0,2560,6,8755171074
2765,7348316802,101036,7348417838,1,0,0,31744,1,609875750
2766,7348365260,55692,7348420952,4,0,0,512,4,5316925732
2767,7348457658,20366,7348478024,7,0,1,32768,7,1035408481
2768,7348507196,3387,7348510583,2,0,1,9728,2,9085105386
2769,7348533424,57037,7348590461,4,0,0,5120,4,839618620
2770,7348587819,126530,7348714349,1,0,0,35840,1,9634458868
2771,7348642529,11791,7348654320,7,0,1,19456,7,7610874621
2772,7348715730,145674,7348861404,3,0,0,128000,3,803485377
2773,7348783599,123851,7348907450,8,0,0,29696,8,2297240538
2774,7348808594,1042,7348809636,2,0,1,1024,2,5240316352
2775,7348880778,124688,7349005466,1,0,0,51712,1,2531345216
2776,7349007150,48980,7349056130,4,0,0,2048,4,1827893990
2777,7349026022,109148,7349135170,0,0,0,58368,0,9979488499
2778,7349090550,2946,7349093496,0,0,1,3072,0,1963541960
2779,7349106734,3422,7349110156,1,0,1,3584,1,5006594590
2780,7349176965,43904,7349220869,2,0,0,512,2,3705726687
2781,7349235612,43904,7349279516,6,0,0,512,6,3243103445
2782,7349236359,45596,7349281955,9,0,0,1024,9,5946206271
2783,7349276306,82088,7349358394,8,0,0,19968,8,5874253869
2784,7349375653,2470,7349378123,1,0,1,2560,1,9684497518
2785,7349496156,77144,7349573300,3,0,0,13824,3,3755023672
2786,7349530138,62488,7349592626,2,0,0,512,2,6571536119
2787,7349563718,4850,7349568568,6,0,1,5120,6,1308953484
2788,7349566695,93644,7349660339,0,0,0,27648,0,9542370048
2789,7349629385,5454,7349634839,0,0,1,13824,0,3056054193
2790,7349647617,1518,7349649135,4,0,1,1536,4,1092430781
2791,7349794886,114805,7349909691,0,0,0,46592,0,7010523769
2792,7349796293,43904,7349840197,9,0,0,512,9,3082348319
2793,7349849658,93069,7349942727,7,0,0,1536,7,8072267075
2794,7349957034,97652,7350054686,1,0,0,30720,1,995928034
2795,7350103490,50672,7350154162,9,0,0,2560,9,8500870984
2796,7350157570,75296,7350232866,8,0,0,12800,8,1272764634
2797,7350214209,5802,7350220011,8,0,1,6144,8,5311274153
2798,7350269459,49070,7350318529,4,0,0,2048,4,1264935649
2799,7350406225,59132,7350465357,8,0,0,5120,8,6798457201
2800,7350477404,5454,7350482858,3,0,1,13824,3,8324950379
2801,7350519714,45752,7350565466,6,0,0,1536,6,6077475611
2802,7350668766,43904,7350712670,6,0,0,512,6,8134066184
2803,7350720496,3904,7350724400,8,0,1,10752,8,7875042772
2804,7350724297,62180,7350786477,9,0,0,512,9,9791866858
2805,7350751495,93128,7350844623,0,0,0,15872,0,1245998850
2806,7350782855,56236,7350839091,7,0,0,512,7,4755138555
2807,7350853153,107375,7350960528,8,0,0,19456,8,944698368
2808,7350863236,47288,7350910524,9,0,0,1536,9,3263868649
2809,7350881550,1042,7350882592,1,0,1,1024,1,4888325998
2810,7350916044,44655,7350960699,7,0,0,512,7,2884897704
2811,7351029423,53495,7351082918,7,0,1,90624,7,5866269995
2812,7351127306,123154,7351250460,4,0,0,512,4,8098769762
2813,7351181021,4850,7351185871,0,0,1,5120,0,8001525527
2814,7351252434,45596,7351298030,7,0,0,1024,7,3784716395
2815,7351254638,2946,7351257584,8,0,1,3072,8,6091931418
2816,7351263343,85765,7351349108,0,0,0,11264,0,6195683692
2817,7351284002,66750,7351350752,9,0,0,1536,9,10302081378
2818,7351290617,90056,7351380673,1,0,0,15872,1,8507135225
2819,7351396614,110396,7351507010,2,0,0,62464,2,613401573
2820,7351553552,11791,7351565343,3,0,1,19456,3,2132860938
2821,7351625485,47600,7351673085,7,0,0,2560,7,9576400857
2822,7351643139,5971,7351649110,2,0,1,14848,2,4518457129
2823,7351704854,1042,7351705896,5,0,1,1024,5,5169100770
2824,7351768582,119912,7351888494,2,0,0,93696,2,125958659
2825,7351814563,106736,7351921299,4,0,0,512,4,6562006219
2826,7351832986,13858,7351846844,7,0,1,23552,7,10482817028
2827,7351849034,45544,7351894578,6,0,0,512,6,7880851545
2828,7351849111,2470,7351851581,8,0,1,2560,8,6618572083
2829,7351883790,11450,7351895240,1,0,1,7168,1,4148545026
2830,7351905997,230253,7352136250,0,0,0,91648,0,10313604829
2831,7351995977,6754,7352002731,6,0,1,7168,6,10345973273
2832,7352131403,7785,7352139188,5,0,1,3072,5,10348504439
2833,7352142613,1042,7352143655,2,0,1,1024,2,2563348875
2834,7352209548,81908,7352291456,1,0,0,14336,1,10666409558
2835,7352250285,139363,7352389648,8,0,0,1024,8,5907849861
2836,7352270993,48980,7352319973,6,0,0,2048,6,5302889829
2837,7352306624,1518,7352308142,7,0,1,1536,7,5165475886
2838,7352319499,1032,7352320531,4,0,1,512,4,6429735742
2839,7352361002,71888,7352432890,8,0,0,10752,8,2808046994
2840,7352382776,1518,7352384294,4,0,1,1536,4,4732382486
2841,7352417735,4679,7352422414,7,0,1,12288,7,133348887
2842,7352425775,7130,7352432905,8,0,1,5632,8,7567328297
2843,7352608573,64137,7352672710,7,0,1,108032,7,2511312640
2844,7352637365,39211,7352676576,2,0,1,6144,2,6538664918
2845,7352651245,166361,7352817606,1,0,0,110592,1,9188664132
2846,7352678100,16613,7352694713,2,0,1,32256,2,3588413716
2847,7352694332,1994,7352696326,6,0,1,2048,6,4768891684
2848,7352721554,11533,7352733087,3,0,1,18944,3,5713407310
2849,7352851053,4679,7352855732,6,0,1,12288,6,3477711701
2850,7352876121,120224,7352996345,3,0,0,31744,3,1575320529
2851,7352890903,7230,7352898133,6,0,1,7680,6,7017015111
2852,7352898295,72106,7352970401,9,0,0,2048,9,79692177
2853,7352931726,133721,7353065447,0,0,0,86016,0,6724104224
2854,7352981596,84334,7353065930,4,0,0,1536,4,6353978096
2855,7353082365,3128,7353085493,1,0,1,9216,1,5464373990
2856,7353158144,113360,7353271504,6,0,0,72192,6,7933722357
2857,7353178777,1994,7353180771,8,0,1,2048,8,3324505001
2858,7353327764,124436,7353452200,3,0,0,108544,3,5020080247
2859,7353336110,2946,7353339056,5,0,1,3072,5,10517155231
2860,7353381144,81832,7353462976,7,0,0,512,7,9981509909
2861,7353417655,48980,7353466635,9,0,0,2048,9,7792061538
2862,7353459258,117416,7353576674,2,0,0,85504,2,7701473657
2863,7353500390,3128,7353503518,4,0,1,9216,4,7965858483
2864,7353511548,3898,7353515446,1,0,1,4096,1,3028456193
2865,7353583478,3898,7353587376,8,0,1,4096,8,1468109172
2866,7353605444,2470,7353607914,6,0,1,2560,6,7811516130
2867,7353693360,5802,7353699162,4,0,1,6144,4,8860705410
2868,7353881095,106652,7353987747,2,0,0,50176,2,3419834150
2869,7353987687,2522,7353990209,8,0,1,2560,8,2679141148
2870,7354012741,72380,7354085121,8,0,0,13312,8,3761666710
2871,7354036877,95266,7354132143,6,0,0,10240,6,4554071725
2872,7354279427,2470,7354281897,2,0,1,2560,2,5383551693
2873,7354283253,1994,7354285247,6,0,1,2048,6,10238889619
2874,7354338087,2946,7354341033,2,0,1,3072,2,258956339
2875,7354371877,47288,7354419165,4,0,0,1536,4,6963363937
2876,7354389225,48980,7354438205,4,0,0,2048,4,3123474193
2877,7354441427,5802,7354447229,5,0,1,6144,5,4894193973
2878,7354580067,2470,7354582537,0,0,1,2560,0,2309373791
2879,7354674245,43904,7354718149,7,0,0,512,7,2119076620
2880,7354709199,1994,7354711193,1,0,1,2048,1,462834247
2881,7354771237,2946,7354774183,4,0,1,3072,4,8347550153
2882,7354813881,3645,7354817526,3,0,1,10240,3,3150319438
2883,7354863964,61136,7354925100,6,0,0,6656,6,517594910
2884,7354932492,566,7354933058,4,0,1,512,4,4969251189
2885,7354981165,65900,7355047065,4,0,0,7168,4,3414055295
2886,7355004288,105404,7355109692,6,0,0,46080,6,598058417
2887,7355048839,4374,7355053213,8,0,1,4608,8,3137125496
2888,7355071464,1518,7355072982,5,0,1,1536,5,10223579495
2889,7355094212,88368,7355182580,1,0,0,15872,1,7215611619
2890,7355171154,105092,7355276246,2,0,0,45056,2,10618010342
2891,7355250749,59132,7355309881,8,0,0,5120,8,6497826474
2892,7355335715,3645,7355339360,2,0,1,10240,2,9855967374
2893,7355468809,5326,7355474135,6,0,1,5632,6,2397001221
2894,7355493179,2946,7355496125,5,0,1,3072,5,8198130579
2895,7355584421,43904,7355628325,6,0,0,512,6,8316231052
2896,7355692536,64208,7355756744,4,0,0,6656,4,10142243451
2897,7355718242,96480,7355814722,3,0,0,14336,3,8350714150
2898,7355721315,6754,7355728069,0,0,1,7168,0,1674888784
2899,7355873399,57752,7355931151,8,0,0,5632,8,7198137204
2900,7355964026,114296,7356078322,2,0,0,75264,2,6724979373
2901,7356041556,57682,7356099238,9,0,0,512,9,9949062989
2902,7356070362,51856,7356122218,9,0,0,512,9,9513037229
2903,7356093147,69308,7356162455,0,0,0,13312,0,6247900782
2904,7356154144,68528,7356222672,6,0,0,10752,6,9962776470
2905,7356165427,76544,7356241971,0,0,0,16896,0,7086985167
2906,7356240687,55488,7356296175,3,0,0,4096,3,4723635863
2907,7356509524,1518,7356511042,1,0,1,1536,1,6208106807
2908,7356536428,80528,7356616956,1,0,0,14848,1,3382330633
2909,7356572470,1042,7356573512,8,0,1,1024,8,6457721606
2910,7356574520,4850,7356579370,5,0,1,5120,5,1189823449
2911,7356588894,43904,7356632798,9,0,0,512,9,9342538891
2912,7356607148,2470,7356609618,5,0,1,2560,5,3778150981
2913,7356622324,138324,7356760648,2,0,0,64000,2,8247563451
2914,7356643640,234370,7356878010,3,0,0,150016,3,7738747322
2915,7356694442,4374,7356698816,4,0,1,4608,4,5531534977
2916,7356730335,63121,7356793456,9,0,0,3072,9,2997834071
2917,7356958926,2946,7356961872,5,0,1,3072,5,2599435153
2918,7356994742,43904,7357038646,9,0,0,512,9,7727328284
2919,7357059073,3898,7357062971,2,0,1,4096,2,5721071586
2920,7357067543,1042,7357068585,0,0,1,1024,0,9851333870
2921,7357094817,11791,7357106608,4,0,1,19456,4,9228843666
2922,7357151262,48074,7357199336,7,0,0,1024,7,9322412564
2923,7357151685,6278,7357157963,3,0,1,6656,3,9960181774
2924,7357174429,5802,7357180231,7,0,1,6144,7,10084735221
2925,7357335225,50672,7357385897,1,0,0,2560,1,1924830712
2926,7357371002,44060,7357415062,9,0,0,1024,9,1056380095
2927,7357396193,70976,7357467169,3,0,0,8704,3,2198129549
2928,7357409300,1518,7357410818,4,0,1,1536,4,6158616449
2929,7357423684,97604,7357521288,2,0,0,20480,2,474042267
2930,7357440651,566,7357441217,5,0,1,512,5,3194689946
2931,7357513305,100005,7357613310,2,0,0,17408,2,1286978432
2932,7357533280,3422,7357536702,8,0,1,3584,8,900443433
2933,7357585462,185403,7357770865,6,0,0,111616,6,10691378641
2934,7357588071,11016,7357599087,4,0,1,17920,4,1226868322
2935,7357634889,136147,7357771036,7,0,0,512,7,1258458939
2936,7357694922,89011,7357783933,9,0,0,1024,9,1686701288
2937,7357727506,2946,7357730452,4,0,1,3072,4,6361385379
2938,7357891697,100256,7357991953,2,0,0,29184,2,3033786738
2939,7357919076,1042,7357920118,6,0,1,1024,6,8982611275
2940,7357994892,43904,7358038796,8,0,0,512,8,3964300171
2941,7358017072,72692,7358089764,1,0,0,14336,1,590040591
2942,7358055552,85530,7358141082,1,0,0,10240,1,424182628
2943,7358095870,6754,7358102624,0,0,1,7168,0,7015659201
2944,7358130812,44492,7358175304,7,0,1,73216,7,2790558230
2945,7358149220,27070,7358176290,6,0,1,1536,6,4935398483
2946,7358191566,7706,7358199272,3,0,1,8192,3,7458259947
2947,7358199503,52364,7358251867,6,0,0,3072,6,4868290024
2948,7358247982,115855,7358363837,6,0,0,4608,6,2297938725
2949,7358403703,2946,7358406649,2,0,1,3072,2,9591160031
2950,7358487866,1518,7358489384,8,0,1,1536,8,9340482576
2951,7358490520,48387,7358538907,8,0,0,1024,8,74732032
2952,7358562202,3898,7358566100,1,0,1,4096,1,9821356032
2953,7358598987,54056,7358653043,6,0,0,3584,6,8422820063
2954,7358659469,1994,7358661463,3,0,1,2048,3,3467958208
2955,7358777003,4937,7358781940,1,0,1,12800,1,9731044040
2956,7358876849,68684,7358945533,1,0,0,11264,1,1694048633
2957,7358930167,107120,7359037287,6,0,0,51712,6,6703177837
2958,7358940457,80036,7359020493,7,0,0,512,7,7070596218
2959,7358972521,6278,7358978799,2,0,1,6656,2,9651898686
2960,7359011405,45596,7359057001,7,0,0,1024,7,1909340398
2961,7359046513,3904,7359050417,8,0,1,10752,8,5739765815
2962,7359184561,45596,7359230157,7,0,0,1024,7,1399336321
2963,7359279103,52364,7359331467,6,0,0,3072,6,10532486152
2964,7359287359,566,7359287925,1,0,1,512,1,7350971296
2965,7359311490,1042,7359312532,5,0,1,1024,5,8846713806
2966,7359325649,178466,7359504115,8,0,0,1536,8,6539983800
2967,7359370569,99188,7359469757,4,0,0,30720,4,1787059907
2968,7359388901,101972,7359490873,2,0,0,34816,2,3772068985
2969,7359461000,16455,7359477455,6,0,1,8192,6,9952936270
2970,7359525897,47600,7359573497,8,0,0,2560,8,7641545530
2971,7359542686,104120,7359646806,7,0,1,172544,7,5294520619
2972,7359662075,81197,7359743272,7,0,0,2048,7,6808884555
2973,7359679160,1042,7359680202,4,0,1,1024,4,10577047089
2974,7359709423,69152,7359778575,1,0,0,12800,1,7991595181
2975,7359727865,12049,7359739914,5,0,1,19968,5,3719926025
2976,7359738097,119612,7359857709,3,0,0,44544,3,2574158730
2977,7359743202,119716,7359862918,9,0,0,512,9,614668248
2978,7359759513,103218,7359862731,0,0,0,16384,0,819640112
2979,7359797716,2946,7359800662,7,0,1,3072,7,4801396946
2980,7359830853,104164,7359935017,3,0,0,33792,3,7801461667
2981,7359841690,16034,7359857724,4,0,1,5632,4,9210465610
2982,7359847602,16317,7359863919,8,0,1,1024,8,4967558812
2983,7359849468,102535,7359952003,2,0,0,12800,2,6849206242
2984,7359893759,3898,7359897657,8,0,1,4096,8,6975001250
2985,7359937660,4420,7359942080,1,0,1,11776,1,8453608080
2986,7360024884,2470,7360027354,2,0,1,2560,2,5390471591
2987,7360056704,44060,7360100764,7,0,0,1024,7,10660011290
2988,7360058449,43904,7360102353,7,0,0,512,7,9569554291
2989,7360169327,43904,7360213231,7,0,0,512,7,4259257248
2990,7360209812,110552,7360320364,3,0,0,62976,3,9298824131
2991,7360239789,7706,7360247495,2,0,1,8192,2,4954539821
2992,7360291660,1042,7360292702,4,0,1,1024,4,123974356
2993,7360429323,104936,7360534259,9,0,0,44544,9,5051930227
2994,7360484298,50132,7360534430,8,0,0,512,8,7172255859
2995,7360550952,101504,7360652456,9,0,0,33280,9,2703256837
2996,7360654734,3898,7360658632,1,0,1,4096,1,5870376499
2997,7360687222,99788,7360787010,1,0,0,27648,1,1735563578
2998,7360736582,4937,7360741519,2,0,1,12800,2,9204864660
2999,7360837964,2470,7360840434,4,0,1,2560,4,9699717213
3000,7360961846,54056,7361015902,3,0,0,3584,3,4153314966
3001,7360968697,74360,7361043057,1,0,0,9728,1,5897742179
3002,7361029370,1518,7361030888,6,0,1,1536,6,3462620124
3003,7361083751,62516,7361146267,3,0,0,6144,3,9387722686
3004,7361104712,122717,7361227429,9,0,0,44544,9,7604165309
3005,7361313294,107276,7361420570,3,0,0,52224,3,694901545
3006,7361382409,1994,7361384403,2,0,1,2048,2,2617429047
3007,7361398227,194851,7361593078,2,0,0,39936,2,10291401751
3008,7361439071,75750,7361514821,8,0,0,1024,8,98744946
3009,7361441311,1042,7361442353,3,0,1,1024,3,6964668640
3010,7361627254,566,7361627820,4,0,1,512,4,3009530948
3011,7361634114,6278,7361640392,6,0,1,6656,6,958055325
3012,7361634961,45134,7361680095,7,0,0,512,7,9649368596
3013,7361769112,2946,7361772058,2,0,1,3072,2,10132921455
3014,7361828903,120643,7361949546,2,0,0,77312,2,8626999435
3015,7361832746,5802,7361838548,2,0,1,6144,2,9834667127
3016,7361843122,106907,7361950029,8,0,0,1536,8,3290985426
3017,7361850935,159181,7362010116,0,0,0,48128,0,4467157983
3018,7361926463,150044,7362076507,9,0,0,56832,9,8508622104
3019,7362014495,62339,7362076834,2,0,0,1024,2,6326465749
3020,7362038865,64174,7362103039,3,0,0,512,3,4425354128
3021,7362093787,100568,7362194355,3,0,0,30208,3,761609336
3022,7362141741,106808,7362248549,9,0,0,50688,9,746589464
3023,7362376801,69284,7362446085,6,0,0,8192,6,5134547342
3024,7362434927,5454,7362440381,0,0,1,13824,0,6821059946
3025,7362442558,566,7362443124,5,0,1,512,5,1409641911
3026,7362498467,4374,7362502841,6,0,1,4608,6,8918857789
3027,7362533644,99476,7362633120,3,0,0,26624,3,4662866324
3028,7362619664,13471,7362633135,7,0,1,17408,7,7917956588
3029,7362665163,72980,7362738143,6,0,0,10240,6,2394828381
3030,7362671672,3422,7362675094,2,0,1,3584,2,2567838802
3031,7362714705,50672,7362765377,4,0,0,2560,4,8033228453
3032,7362755754,140711,7362896465,0,0,0,69632,0,5048392943
3033,7362764008,1994,7362766002,3,0,1,2048,3,9343262995
3034,7362836565,3645,7362840210,5,0,1,10240,5,210696641
3035,7362856698,125145,7362981843,7,0,1,206848,7,6996281105
3036,7362930319,56709,7362987028,0,0,1,16384,0,3994773474
3037,7363040410,127979,7363168389,4,0,0,14336,4,9224243944
3038,7363146786,59912,7363206698,9,0,0,7680,9,6771706579
3039,7363161514,76208,7363237722,4,0,0,10752,4,2888502187
3040,7363179729,4937,7363184666,7,0,1,12800,7,4376722990
3041,7363212741,43904,7363256645,7,0,0,512,7,3065872399
3042,7363257054,566,7363257620,1,0,1,512,1,3490764133
3043,7363270971,100100,7363371071,2,0,0,28672,2,4820929322
3044,7363441783,81128,7363522911,9,0,0,11776,9,5504564160
3045,7363608397,10499,7363618896,7,0,1,16896,7,8717586048
3046,7363642850,5802,7363648652,8,0,1,6144,8,6851446064
3047,7363680393,5326,7363685719,1,0,1,5632,1,485023393
3048,7363827844,566,7363828410,2,0,1,512,2,2233623463
3049,7363940766,103844,7364044610,0,0,0,40960,0,9771664650
3050,7364111763,4850,7364116613,4,0,1,5120,4,3995568260
3051,7364144537,106496,7364251033,3,0,0,49664,3,6241813768
3052,7364181798,6278,7364188076,0,0,1,6656,0,7769858773
3053,7364206882,4420,7364211302,3,0,1,11776,3,8520994387
3054,7364284341,3128,7364287469,3,0,1,9216,3,8098569167
3055,7364286811,47478,7364334289,8,0,0,1024,8,7818442147
3056,7364304194,112268,7364416462,2,0,0,68608,2,5240037623
3057,7364351041,1994,7364353035,1,0,1,2048,1,6471888789
3058,7364369192,1994,7364371186,4,0,1,2048,4,6292579194
3059,7364493374,100256,7364593630,2,0,0,29184,2,7812972749
3060,7364513474,60824,7364574298,6,0,0,5632,6,189249089
3061,7364728035,99164,7364827199,2,0,0,25600,2,8341494620
3062,7364736108,97970,7364834078,0,0,0,22528,0,6525017391
3063,7364759503,2470,7364761973,7,0,1,2560,7,6515273615
3064,7364781549,13600,7364795149,4,0,1,23040,4,8380874844
3065,7364854883,1518,7364856401,6,0,1,1536,6,1876181525
3066,7364942177,101816,7365043993,6,0,0,34304,6,807837752
3067,7365004931,80528,7365085459,2,0,0,14848,2,10614239252
3068,7365041664,9551,7365051215,4,0,1,7680,4,6769009974
3069,7365069182,4374,7365073556,0,0,1,4608,0,3791268186
3070,7365098583,3898,7365102481,4,0,1,4096,4,9009436365
3071,7365157120,4850,7365161970,2,0,1,5120,2,1407605370
3072,7365174535,101972,7365276507,0,0,0,34816,0,1380700540
3073,7365176898,61493,7365238391,1,0,0,7168,1,4874458682
3074,7365193449,57191,7365250640,6,0,0,1536,6,5130674737
3075,7365224645,52657,7365277302,3,0,0,2560,3,1315319628
3076,7365239562,4850,7365244412,7,0,1,5120,7,9220615082
3077,7365441688,2946,7365444634,1,0,1,3072,1,7617975746
3078,7365515986,11274,7365527260,3,0,1,18432,3,821322231
3079,7365533396,206867,7365740263,1,0,0,43008,1,9695045041
3080,7365548292,108368,7365656660,0,0,0,55808,0,1141169442
3081,7365816315,43904,7365860219,7,0,0,512,7,6248485273
3082,7365852699,45596,7365898295,7,0,0,1024,7,2864123587
3083,7365858771,99788,7365958559,0,0,0,27648,0,4397014668
3084,7365871234,43904,7365915138,8,0,0,512,8,1690054741
3085,7365915196,103220,7366018416,1,0,0,38912,1,1721213149
3086,7366007912,14394,7366022306,5,0,1,4096,5,7722085041
3087,7366037135,1518,7366038653,2,0,1,1536,2,9364545255
3088,7366076948,45596,7366122544,7,0,0,1024,7,3594968362
3089,7366138585,103064,7366241649,1,0,0,38400,1,4878045602
3090,7366177289,4850,7366182139,7,0,1,5120,7,3986128803
3091,7366185314,2870,7366188184,6,0,1,8704,6,7037300187
3092,7366197771,4374,7366202145,2,0,1,4608,2,991276664
3093,7366281143,182325,7366463468,9,0,0,40448,9,2265353019
3094,7366341191,4374,7366345565,4,0,1,4608,4,3451322293
3095,7366342060,12117,7366354177,4,0,1,18944,4,3010868544
3096,7366343357,169419,7366512776,6,0,0,40960,6,3733794909
3097,7366482969,14117,7366497086,4,0,1,24064,4,4832154920
3098,7366543489,83780,7366627269,6,0,0,20480,6,1899856617
3099,7366608387,50672,7366659059,6,0,0,2560,6,10473314573
3100,7366709381,4374,7366713755,0,0,1,4608,0,8460551285
3101,7366729995,4374,7366734369,6,0,1,4608,6,7757545103
3102,7366991034,2470,7366993504,5,0,1,2560,5,6241354105
3103,7366994273,3898,7366998171,3,0,1,4096,3,4630207422
3104,7367095740,52832,7367148572,4,0,0,4608,4,5469080795
3105,7367107835,74715,7367182550,0,0,0,4096,0,1355241794
3106,7367158415,1994,7367160409,0,0,1,2048,0,1182079953
3107,7367196771,2470,7367199241,3,0,1,2560,3,9293795063
3108,7367228443,103688,7367332131,9,0,0,40448,9,704319908
3109,7367246273,93049,7367339322,2,0,0,23552,2,4243991112
3110,7367315284,56831,7367372115,6,0,0,3072,6,17706436
3111,7367431454,5326,7367436780,6,0,1,5632,6,2844081909
3112,7367526225,5326,7367531551,1,0,1,5632,1,6337277682
3113,7367568462,1518,7367569980,6,0,1,1536,6,1918392270
3114,7367580776,47288,7367628064,4,0,0,1536,4,1517031501
3115,7367617653,69284,7367686937,0,0,0,8192,0,5086678093
3116,7367745528,97760,7367843288,1,0,0,20992,1,10102514937
3117,7367776508,2946,7367779454,4,0,1,3072,4,3878353769
3118,7367794854,2470,7367797324,2,0,1,2560,2,302258724
3119,7367798293,6278,7367804571,3,0,1,6656,3,7887260210
3120,7367929051,1518,7367930569,4,0,1,1536,4,9737451376
3121,7367936401,4850,7367941251,3,0,1,5120,3,2856316745
3122,7368004644,99632,7368104276,2,0,0,27136,2,7643072503
3123,7368008419,4850,7368013269,1,0,1,5120,1,4570681152
3124,7368034982,5712,7368040694,2,0,1,14336,2,3048859336
3125,7368071031,1994,7368073025,7,0,1,2048,7,3153620640
3126,7368197336,566,7368197902,6,0,1,512,6,5336789820
3127,7368288809,2470,7368291279,2,0,1,2560,2,54778139
3128,7368408972,89144,7368498116,1,0,0,17920,1,51264997
3129,7368489993,127088,7368617081,4,0,0,117248,4,7063905575
3130,7368568316,4850,7368573166,7,0,1,5120,7,9869175650
3131,7368638993,86828,7368725821,6,0,0,15360,6,5895644410
3132,7368689746,5326,7368695072,5,0,1,5632,5,297372196
3133,7368701682,64999,7368766681,8,0,0,1024,8,5354892562
3134,7368845696,108524,7368954220,0,0,0,56320,0,5390597400
3135,7369000130,54056,7369054186,4,0,0,3584,4,1530360970
3136,7369032332,102128,7369134460,6,0,0,35328,6,9718881311
3137,7369065863,48980,7369114843,8,0,0,2048,8,10407245010
3138,7369073331,103688,7369177019,6,0,0,40448,6,5308602459
3139,7369084687,2946,7369087633,2,0,1,3072,2,5069178300
3140,7369140491,138288,7369278779,0,0,0,74752,0,176888395
3141,7369143127,566,7369143693,1,0,1,512,1,10333523206
3142,7369214026,1042,7369215068,6,0,1,1024,6,4303341838
3143,7369410454,1994,7369412448,2,0,1,2048,2,2758063726
3144,7369421920,128960,7369550880,6,0,0,123392,6,10174862392
3145,7369484811,3422,7369488233,0,0,1,3584,0,1776536364
3146,7369554213,1518,7369555731,1,0,1,1536,1,8211329692
3147,7369567294,4850,7369572144,1,0,1,5120,1,4862142508
3148,7369569774,63764,7369633538,6,0,0,10240,6,3050195351
3149,7369684091,89300,7369773391,2,0,0,18432,2,9399661313
3150,7369980223,71156,7370051379,1,0,0,14336,1,4702286162
3151,7370063581,76052,7370139633,3,0,0,10240,3,2774924384
3152,7370229540,566,7370230106,7,0,1,512,7,9073321532
3153,7370236885,103220,7370340105,0,0,0,38912,0,1514841396
3154,7370314743,98228,7370412971,3,0,0,22528,3,7684169050
3155,7370341759,1042,7370342801,2,0,1,1024,2,1904930201
3156,7370437827,43904,7370481731,7,0,0,512,7,2780523482
3157,7370610822,110396,7370721218,9,0,0,62464,9,3216790295
3158,7370634007,5802,7370639809,2,0,1,6144,2,1435691120
3159,7370738894,47288,7370786182,7,0,0,1536,7,279312473
3160,7370865672,1042,7370866714,7,0,1,1024,7,9339181449
3161,7370918620,84536,7371003156,8,0,0,17920,8,10025190723
3162,7370946781,137069,7371083850,1,0,0,54784,1,10695794426
3163,7371017551,91757,7371109308,9,0,0,6144,9,3215761736
3164,7371021657,112680,7371134337,8,0,0,26112,8,2792065537
3165,7371056277,48980,7371105257,7,0,0,2048,7,3010858744
3166,7371079931,119248,7371199179,9,0,0,56320,9,4882352910
3167,7371086688,87138,7371173826,7,0,0,512,7,4985429625
3168,7371147124,65201,7371212325,2,0,0,2560,2,3752897059
3169,7371150138,2946,7371153084,1,0,1,3072,1,4190026544
3170,7371154969,141758,7371296727,3,0,0,76800,3,8416048536
3171,7371358351,3422,7371361773,6,0,1,3584,6,1012713218
3172,7371397899,1994,7371399893,0,0,1,2048,0,3614377752
3173,7371471219,3128,7371474347,7,0,1,9216,7,6365194342
3174,7371708470,1042,7371709512,4,0,1,1024,4,3157881967
3175,7371740920,157357,7371898277,6,0,0,6656,6,945535565
3176,7371840535,97760,7371938295,0,0,0,20992,0,3886278172
3177,7371872701,108080,7371980781,9,0,0,33280,9,9283904999
3178,7371902514,7230,7371909744,1,0,1,7680,1,10314838668
3179,7371946725,69648,7372016373,7,0,0,3072,7,7223059688
3180,7372068103,3898,7372072001,1,0,1,4096,1,5370400194
3181,7372152548,102752,7372255300,3,0,0,37376,3,1260847080
3182,7372156289,113963,7372270252,9,0,0,15872,9,2904856098
3183,7372248577,52311,7372300888,7,0,0,1024,7,10632454247
3184,7372353898,4374,7372358272,7,0,1,4608,7,3349578355
3185,7372430199,96736,7372526935,4,0,0,4608,4,1563034999
3186,7372461941,1994,7372463935,5,0,1,2048,5,1875481528
3187,7372527871,114920,7372642791,2,0,0,77312,2,4545097913
3188,7372611498,43904,7372655402,7,0,0,512,7,6700075449
3189,7372632069,58002,7372690071,0,0,0,1536,0,7986691493
3190,7372706627,566,7372707193,7,0,1,512,7,4209632131
3191,7372837344,1518,7372838862,5,0,1,1536,5,5708574425
3192,7372914819,45596,7372960415,0,0,0,1024,0,3966225850
3193,7373010462,10757,7373021219,4,0,1,17408,4,1673112925
3194,7373012164,11001,7373023165,7,0,1,3072,7,10057092989
3195,7373077360,1994,7373079354,8,0,1,2048,8,9789324597
3196,7373222432,4374,7373226806,4,0,1,4608,4,459922208
3197,7373313338,566,7373313904,1,0,1,512,1,3912153101
3198,7373347648,104468,7373452116,0,0,0,43008,0,5625819945
3199,7373509984,47288,7373557272,7,0,0,1536,7,3593864911
3200,7373579913,2470,7373582383,3,0,1,2560,3,991276580
3201,7373606921,2470,7373609391,8,0,1,2560,8,6568904817
3202,7373730532,4679,7373735211,7,0,1,12288,7,7996813423
3203,7373799663,110698,7373910361,8,0,0,4096,8,4868561515
3204,7373847699,1518,7373849217,0,0,1,1536,0,1748156409
3205,7373888607,4850,7373893457,3,0,1,5120,3,1478922590
3206,7373985417,100880,7374086297,9,0,0,31232,9,8295874221
3207,7374022558,3387,7374025945,7,0,1,9728,7,4960497298
3208,7374029854,120079,7374149933,3,0,0,26112,3,10148142609
3209,7374076459,9861,7374086320,3,0,1,2048,3,6495193589
3210,7374078163,13928,7374092091,0,0,1,6144,0,7164933112
3211,7374129887,3422,7374133309,7,0,1,3584,7,35505928
3212,7374181132,4850,7374185982,5,0,1,5120,5,4418517699
3213,7374205877,11016,7374216893,4,0,1,17920,4,9183351889
3214,7374252568,78704,7374331272,2,0,0,18944,2,7705735081
3215,7374325642,126771,7374452413,0,0,0,80384,0,10255702110
3216,7374358635,1518,7374360153,7,0,1,1536,7,2307524829
3217,7374390062,134471,7374524533,4,0,0,17408,4,7603533981
3218,7374446152,205556,7374651708,6,0,0,28672,6,4059314480
3219,7374478665,62566,7374541231,7,0,0,512,7,5445747109
3220,7374542543,566,7374543109,1,0,1,512,1,7971009511
3221,7374553914,117933,7374671847,2,0,0,66048,2,7615322467
3222,7374775140,566,7374775706,1,0,1,512,1,3266818670
3223,7374790844,1042,7374791886,8,0,1,1024,8,9040589296
3224,7374816807,138398,7374955205,2,0,0,25088,2,6052206771
3225,7374816866,6278,7374823144,3,0,1,6656,3,7978082644
3226,7375024148,82532,7375106680,2,0,0,16384,2,1913036361
3227,7375139002,191192,7375330194,4,0,0,161280,4,2010084662
3228,7375178956,5326,7375184282,1,0,1,5632,1,8554479967
3229,7375180034,158139,7375338173,8,0,0,26112,8,1581613690
3230,7375230932,10241,7375241173,4,0,1,16384,4,1335528242
3231,7375300450,40577,7375341027,1,0,1,8704,1,2363413626
3232,7375327085,15718,7375342803,1,0,1,2048,1,6691359734
3233,7375470986,5802,7375476788,6,0,1,6144,6,6832666391
3234,7375478202,117289,7375595491,1,0,0,71168,1,5534505696
3235,7375479197,131181,7375610378,8,0,0,23040,8,1369400906
3236,7375557263,4679,7375561942,2,0,1,12288,2,1724141596
3237,7375623204,120683,7375743887,3,0,0,65024,3,5989455710
3238,7375626178,1994,7375628172,5,0,1,2048,5,802438355
3239,7375642500,2946,7375645446,5,0,1,3072,5,8468447914
3240,7375692371,198372,7375890743,1,0,0,151552,1,8007702952
3241,7375727843,17078,7375744921,3,0,1,1024,3,7217681739
3242,7375745604,1994,7375747598,4,0,1,2048,4,7013637254
3243,7375763992,135838,7375899830,8,0,0,29696,8,8373037937
3244,7375782086,566,7375782652,0,0,1,512,0,5063938468
3245,7375782880,1518,7375784398,5,0,1,1536,5,8578675636
3246,7375850785,188837,7376039622,0,0,0,28160,0,9940229304
3247,7375867517,36646,7375904163,4,0,1,4608,4,3702950571
3248,7375869646,34863,7375904509,2,0,1,512,2,10568616303
3249,7375951847,165973,7376117820,0,0,0,56832,0,5335751292
3250,7376068690,566,7376069256,3,0,1,512,3,1690171965
3251,7376075733,3422,7376079155,8,0,1,3584,8,4417079350
3252,7376107991,121170,7376229161,4,0,0,25088,4,10044078447
3253,7376117517,886,7376118403,1,0,1,512,1,5156904471
3254,7376141905,147077,7376288982,2,0,0,31744,2,8156633605
3255,7376204893,2946,7376207839,6,0,1,3072,6,4292289734
3256,7376316554,102596,7376419150,1,0,0,36864,1,7597441646
3257,7376392950,5326,7376398276,0,0,1,5632,0,5622263302
3258,7376445747,7230,7376452977,6,0,1,7680,6,2024520803
3259,7376542507,119288,7376661795,6,0,0,91648,6,10340400583
3260,7376634196,33303,7376667499,7,0,1,14336,7,3009742991
3261,7376686560,2470,7376689030,0,0,1,2560,0,10548638594
3262,7376728460,1518,7376729978,7,0,1,1536,7,1568626630
3263,7376801559,47288,7376848847,8,0,0,1536,8,6367047949
3264,7376827975,4374,7376832349,8,0,1,4608,8,4653300155
3265,7376947166,4850,7376952016,6,0,1,5120,6,10434111448
3266,7376947707,8175,7376955882,8,0,1,6144,8,4091534511
3267,7376961896,4850,7376966746,4,0,1,5120,4,1825264935
3268,7376986184,103386,7377089570,4,0,0,32768,4,5571948801
3269,7377074887,70411,7377145298,7,0,0,11776,7,8786674450
3270,7377106013,99632,7377205645,1,0,0,27136,1,2380377020
3271,7377194956,10704,7377205660,0,0,1,8704,0,800709966
3272,7377300242,121628,7377421870,2,0,0,99328,2,10591708060
3273,7377360566,2946,7377363512,3,0,1,3072,3,9446342564
3274,7377361096,4362,7377365458,0,0,1,3072,0,3781644142
3275,7377472335,1042,7377473377,4,0,1,1024,4,5139942301
3276,7377521649,1994,7377523643,7,0,1,2048,7,804194418
3277,7377823589,84512,7377908101,8,0,0,12800,8,8081888643
3278,7377869095,1518,7377870613,1,0,1,1536,1,9494934280
3279,7377964149,65900,7378030049,9,0,0,7168,9,10387162155
3280,7377996204,126308,7378122512,2,0,0,114688,2,8451758915
3281,7378002927,566,7378003493,5,0,1,512,5,3303978985
3282,7378058460,134144,7378192604,2,0,0,45056,2,7586020134
3283,7378085709,66323,7378152032,7,0,0,7680,7,2087586749
3284,7378121113,158893,7378280006,7,0,0,103936,7,7344127039
3285,7378277916,73682,7378351598,4,0,0,10752,4,2623272430
3286,7378476359,1042,7378477401,6,0,1,1024,6,7253708319
3287,7378552806,3422,7378556228,5,0,1,3584,5,8737888301
3288,7378705620,50984,7378756604,0,0,0,3584,0,7118830744
3289,7378727023,53875,7378780898,3,0,0,1536,3,9327245446
3290,7378732412,71624,7378804036,0,0,0,15872,0,1875792145
3291,7378805202,112424,7378917626,1,0,0,69120,1,2747588619
3292,7378875781,54056,7378929837,9,0,0,3584,9,2735686854
3293,7378978104,105872,7379083976,7,0,0,47616,7,2162218983
3294,7379097677,4374,7379102051,1,0,1,4608,1,6510597696
3295,7379119270,1042,7379120312,5,0,1,1024,5,10144055347
3296,7379207856,4937,7379212793,6,0,1,12800,6,9396350590
3297,7379222794,74360,7379297154,9,0,0,9728,9,7473205418
3298,7379225977,3904,7379229881,8,0,1,10752,8,2201120351
3299,7379464649,3645,7379468294,4,0,1,10240,4,5718996015
3300,7379570082,566,7379570648,1,0,1,512,1,1979200215
3301,7379570301,56216,7379626517,8,0,0,5632,8,9361504761
3302,7379588638,76052,7379664690,3,0,0,10240,3,6302217065
3303,7379631498,2946,7379634444,7,0,1,3072,7,360454792
3304,7379689164,69908,7379759072,4,0,0,10240,4,7923028313
3305,7379757715,2884,7379760599,0,0,1,1536,0,10234020155
3306,7379758770,7057,7379765827,4,0,1,6656,4,10675231020
3307,7379782286,62768,7379845054,9,0,0,8192,9,4569550707
3308,7379861680,101816,7379963496,9,0,0,34304,9,1677299318
3309,7379955270,122358,7380077628,6,0,0,74752,6,194698083
3310,7380058417,20721,7380079138,1,0,1,1536,1,3919496918
3311,7380125375,2946,7380128321,6,0,1,3072,6,4998563481
3312,7380235313,119756,7380355069,3,0,0,93184,3,8399281696
3313,7380284614,2946,7380287560,7,0,1,3072,7,9560129005
3314,7380377867,106652,7380484519,4,0,0,50176,4,8782026041
3315,7380550674,3898,7380554572,1,0,1,4096,1,3532711123
3316,7380554111,5712,7380559823,4,0,1,14336,4,2787248116
3317,7380579504,1994,7380581498,5,0,1,2048,5,9707446195
3318,7380636156,114452,7380750608,1,0,0,75776,1,4263456774
3319,7380669660,82687,7380752347,6,0,0,5632,6,3801178844
3320,7380685803,1994,7380687797,0,0,1,2048,0,4316190543
3321,7380699530,131154,7380830684,2,0,0,38912,2,6131680892
3322,7380738753,19524,7380758277,0,0,1,14848,0,2294874003
3323,7380775318,82174,7380857492,1,0,0,8704,1,1219051471
3324,7380800025,566,7380800591,1,0,1,512,1,9195853581
3325,7380821566,237939,7381059505,8,0,0,100352,8,5954103295
3326,7380910255,107432,7381017687,3,0,0,52736,3,1105559026
3327,7380983011,6278,7380989289,8,0,1,6656,8,8138834277
3328,7381111628,7230,7381118858,6,0,1,7680,6,8242004983
3329,7381174734,100256,7381274990,6,0,0,29184,6,7071682982
3330,7381324166,566,7381324732,2,0,1,512,2,3737553105
3331,7381393871,5454,7381399325,6,0,1,13824,6,3809689232
3332,7381447024,177188,7381624212,0,0,0,155648,0,2568059718
3333,7381502452,278901,7381781353,0,0,0,81920,0,645621821
3334,7381531205,1042,7381532247,0,0,1,1024,0,982369764
3335,7381554508,2946,7381557454,4,0,1,3072,4,10351324498
3336,7381573704,50523,7381624227,4,0,1,5120,4,559787524
3337,7381790223,62384,7381852607,4,0,0,10752,4,4207070356
3338,7381908574,66056,7381974630,1,0,0,7680,1,5106035536
3339,7381924162,122084,7382046246,2,0,0,81408,2,6895471312
3340,7381964305,1518,7381965823,6,0,1,1536,6,7585861543
3341,7382148301,103532,7382251833,0,0,0,39936,0,8880036531
3342,7382235011,1518,7382236529,2,0,1,1536,2,3675425893
3343,7382261329,22174,7382283503,7,0,1,36352,7,7369716535
3344,7382511835,2946,7382514781,6,0,1,3072,6,2810434769
3345,7382555474,87764,7382643238,4,0,0,18432,4,663780150
3346,7382564887,137901,7382702788,1,0,0,66560,1,6125161917
3347,7382565355,147692,7382713047,7,0,0,25088,7,9845579988
3348,7382618393,131225,7382749618,8,0,0,22528,8,7845153827
3349,7382922299,3645,7382925944,3,0,1,10240,3,2078939029
3350,7383061291,2470,7383063761,1,0,1,2560,1,9463581348
3351,7383061506,4521,7383066027,1,0,1,3584,1,6018451406
3352,7383076823,97432,7383174255,8,0,0,4096,8,3111320888
3353,7383080107,123012,7383203119,0,0,0,79360,0,6847282630
3354,7383205909,1518,7383207427,6,0,1,1536,6,9020604466
3355,7383283599,4679,7383288278,1,0,1,12288,1,7940763695
3356,7383343304,4850,7383348154,8,0,1,5120,8,3738078229
3357,7383419162,2946,7383422108,0,0,1,3072,0,10434112561
3358,7383450327,1994,7383452321,3,0,1,2048,3,464551906
3359,7383522144,5326,7383527470,1,0,1,5632,1,463002735
3360,7383545839,2946,7383548785,2,0,1,3072,2,9417446101
3361,7383617798,4162,7383621960,5,0,1,11264,5,9246620996
3362,7383686657,6229,7383692886,5,0,1,15360,5,7612311223
3363,7383688292,124970,7383813262,6,0,0,18432,6,8194550212
3364,7383749616,102614,7383852230,6,0,0,29184,6,4412161878
3365,7383957193,5802,7383962995,2,0,1,6144,2,7879587820
3366,7383973222,103844,7384077066,7,0,0,40960,7,2765520898
3367,7384063696,13393,7384077089,3,0,1,5632,3,3807816612
3368,7384065335,123034,7384188369,3,0,0,41984,3,1095572792
3369,7384101280,117191,7384218471,3,0,0,33792,3,7612355586
3370,7384111007,1518,7384112525,4,0,1,1536,4,4156097803
3371,7384114833,10499,7384125332,4,0,1,16896,4,9560924598
3372,7384163785,145370,7384309155,8,0,0,31744,8,1647933387
3373,7384213360,8490,7384221850,0,0,1,9728,0,7128681045
3374,7384224744,115107,7384339851,4,0,0,26624,4,2304793322
3375,7384262505,177607,7384440112,0,0,0,48128,0,2609581075
3376,7384308815,1374,7384310189,7,0,1,1024,7,8658342465
3377,7384435921,5225,7384441146,5,0,1,1024,5,392078269
3378,7384468446,2946,7384471392,3,0,1,3072,3,2620256553
3379,7384578132,4679,7384582811,6,0,1,12288,6,8813746795
3380,7384630311,1518,7384631829,6,0,1,1536,6,4519067639
3381,7384669911,3898,7384673809,7,0,1,4096,7,3178255216
3382,7384694584,3904,7384698488,2,0,1,10752,2,2051619772
3383,7384821036,51247,7384872283,2,0,0,2560,2,7649620858
3384,7384923923,133505,7385057428,1,0,0,81408,1,1367100921
3385,7384935499,271706,7385207205,7,0,0,73728,7,8957641190
3386,7384941260,143303,7385084563,1,0,0,66048,1,6932271528
3387,7384960887,194850,7385155737,6,0,0,71168,6,6134550448
3388,7385074567,86408,7385160975,6,0,0,1536,6,6586589554
3389,7385191432,93689,7385285121,7,0,0,16384,7,4052098450
3390,7385210678,3904,7385214582,2,0,1,10752,2,837941156
3391,7385229058,101192,7385330250,4,0,0,32256,4,5571519045
3392,7385357751,7230,7385364981,5,0,1,7680,5,2523170413
3393,7385383453,111644,7385495097,7,0,0,66560,7,1290856877
3394,7385410555,1042,7385411597,7,0,1,1024,7,10522036436
3395,7385433228,566,7385433794,7,0,1,512,7,8481827574
3396,7385474575,20537,7385495112,8,0,1,4608,8,3830736744
3397,7385589661,5326,7385594987,8,0,1,5632,8,3861607622
3398,7385621244,47288,7385668532,3,0,0,1536,3,2615049943
3399,7385626219,192620,7385818839,4,0,0,171008,4,3496235304
3400,7385762549,76208,7385838757,2,0,0,10752,2,3370048926
3401,7385817955,14476,7385832431,7,0,1,23040,7,131751796
3402,7385876986,88079,7385965065,9,0,0,23040,9,6181865156
3403,7385886406,71624,7385958030,4,0,0,15872,4,309828945
3404,7385900745,138291,7386039036,6,0,0,53760,6,4427341374
3405,7385923645,1994,7385925639,0,0,1,2048,0,5204835074
3406,7385971959,4374,7385976333,5,0,1,4608,5,5828825985
3407,7386042243,186344,7386228587,7,0,0,78848,7,6168680557
3408,7386066999,5971,7386072970,5,0,1,14848,5,4954315839
3409,7386133484,2470,7386135954,5,0,1,2560,5,2041043484
3410,7386158095,72223,7386230318,2,0,0,5632,2,6144806648
3411,7386286270,2470,7386288740,1,0,1,2560,1,10196936911
3412,7386386036,83912,7386469948,3,0,0,15872,3,1230122201
3413,7386428838,2946,7386431784,5,0,1,3072,5,2556224888
3414,7386532643,3422,7386536065,6,0,1,3584,6,1084179374
3415,7386542406,3898,7386546304,4,0,1,4096,4,9822326417
3416,7386576338,14117,7386590455,3,0,1,24064,3,9707929137
3417,7386592846,7230,7386600076,4,0,1,7680,4,508757083
3418,7386605904,143793,7386749697,9,0,0,12800,9,1051355560
3419,7386607797,237560,7386845357,0,0,0,23040,0,3036749155
3420,7386608789,3128,7386611917,2,0,1,9216,2,10247049305
3421,7386616117,6754,7386622871,2,0,1,7168,2,6060047023
3422,7386703965,106340,7386810305,9,0,0,49152,9,9949369637
3423,7386748107,5480,7386753587,5,0,1,4096,5,107052924
3424,7386884829,5802,7386890631,8,0,1,6144,8,8098492918
3425,7387046083,5802,7387051885,1,0,1,6144,1,8987064434
3426,7387052163,127509,7387179672,4,0,0,75776,4,7840315796
3427,7387091407,118751,7387210158,3,0,0,18432,3,5805275660
3428,7387125989,4374,7387130363,5,0,1,4608,5,3742418992
3429,7387212415,111850,7387324265,1,0,0,27136,1,3956840509
3430,7387267192,1042,7387268234,4,0,1,1024,4,9088442543
3431,7387362954,6754,7387369708,6,0,1,7168,6,14670592
3432,7387400294,89636,7387489930,8,0,0,24576,8,6226633991
3433,7387488125,3791,7387491916,4,0,1,2048,4,10727157140
3434,7387571895,105092,7387676987,3,0,0,45056,3,7907039168
3435,7387756831,104312,7387861143,8,0,0,42496,8,83112776
3436,7387785045,101192,7387886237,3,0,0,32256,3,4372207266
3437,7387801631,113722,7387915353,1,0,0,32768,1,1608065324
3438,7387857880,70847,7387928727,2,0,0,7680,2,10121877766
3439,7387901907,100412,7388002319,4,0,0,29696,4,8868142704
3440,7387964618,50655,7388015273,2,0,0,512,2,10060174728
3441,7387995044,93471,7388088515,7,0,0,13312,7,5003895519
3442,7388092315,3422,7388095737,3,0,1,3584,3,8915811632
3443,7388110306,1042,7388111348,3,0,1,1024,3,2677827451
3444,7388127600,5326,7388132926,0,0,1,5632,0,3579005423
3445,7388232978,243045,7388476023,0,0,0,134656,0,10316528082
3446,7388333502,68840,7388402342,7,0,0,11776,7,9795917741
3447,7388484244,6754,7388490998,7,0,1,7168,7,1939049374
3448,7388566649,107120,7388673769,6,0,0,51712,6,3253800377
3449,7388607026,3128,7388610154,8,0,1,9216,8,10520287544
3450,7388752806,5802,7388758608,0,0,1,6144,0,2273319250
3451,7388814009,119718,7388933727,8,0,0,13824,8,2108910893
3452,7388830876,86852,7388917728,6,0,0,20480,6,143788721
3453,7388851542,6278,7388857820,6,0,1,6656,6,5579232570
3454,7388927531,62516,7388990047,0,0,0,6144,0,756482663
3455,7388964919,67148,7389032067,1,0,0,11264,1,8288354964
3456,7388990128,141821,7389131949,7,0,0,111104,7,6608334912
3457,7389072281,115444,7389187725,0,0,0,34816,0,2078586844
3458,7389154993,98144,7389253137,2,0,0,15360,2,10614472080
3459,7389159818,4374,7389164192,2,0,1,4608,2,4981997721
3460,7389167224,200059,7389367283,3,0,0,41984,3,10314882974
3461,7389208460,1042,7389209502,2,0,1,1024,2,4525926294
3462,7389283895,54524,7389338419,9,0,0,5120,9,6997650902
3463,7389378771,2470,7389381241,1,0,1,2560,1,3536309136
3464,7389379406,2181,7389381587,5,0,1,512,5,3144347189
3465,7389387475,84068,7389471543,3,0,0,16384,3,216219592
3466,7389426648,99135,7389525783,1,0,0,11776,1,2878154692
3467,7389522131,3667,7389525798,8,0,1,2560,8,2698142882
3468,7389535243,14117,7389549360,1,0,1,24064,1,4322456803
3469,7389583897,54056,7389637953,1,0,0,3584,1,9810367124
3470,7389608277,2470,7389610747,2,0,1,2560,2,7347375934
3471,7389628964,2870,7389631834,8,0,1,8704,8,7319887483
3472,7389697244,1994,7389699238,8,0,1,2048,8,7509299436
3473,7389845260,108524,7389953784,2,0,0,56320,2,6082664396
3474,7389859532,72668,7389932200,9,0,0,9216,9,9022040994
3475,7389872199,180591,7390052790,6,0,0,133120,6,2568251893
3476,7389890543,209509,7390100052,0,0,0,50176,0,7987321590
3477,7389927431,126778,7390054209,0,0,0,4608,0,3961809968
3478,7389950433,5813,7389956246,7,0,1,2560,7,4220652906
3479,7389956463,2470,7389958933,5,0,1,2560,5,2169662559
3480,7389990684,3904,7389994588,0,0,1,10752,0,7805949312
3481,7390006359,4374,7390010733,7,0,1,4608,7,487412120
3482,7390038316,19013,7390057329,5,0,1,9216,5,5301455383
3483,7390125454,14117,7390139571,2,0,1,24064,2,4108404498
3484,7390180150,2470,7390182620,7,0,1,2560,7,5731641326
3485,7390195662,201609,7390397271,3,0,0,8704,3,2805160626
3486,7390232771,1042,7390233813,3,0,1,1024,3,1880604425
3487,7390330960,5326,7390336286,5,0,1,5632,5,647739921
3488,7390363683,86384,7390450067,8,0,0,18944,8,4107291845
3489,7390392036,5250,7390397286,5,0,1,4608,5,7355962916
3490,7390409671,85390,7390495061,7,0,0,9216,7,4748590016
3491,7390714963,6278,7390721241,3,0,1,6656,3,6264572964
3492,7390758416,109594,7390868010,3,0,0,57344,3,5866652076
3493,7390845543,112268,7390957811,2,0,0,68608,2,8002572602
3494,7390936525,103390,7391039915,0,0,0,38400,0,958744152
3495,7391070809,4850,7391075659,0,0,1,5120,0,3741491588
3496,7391084740,48980,7391133720,9,0,0,2048,9,2913247594
3497,7391145095,4420,7391149515,2,0,1,11776,2,10274123204
3498,7391156049,1042,7391157091,0,0,1,1024,0,10266926392
3499,7391161196,3422,7391164618,5,0,1,3584,5,7627305547
3500,7391185126,1042,7391186168,5,0,1,1024,5,1773070697
3501,7391217375,191390,7391408765,9,0,0,144384,9,3588691955
3502,7391246926,5712,7391252638,0,0,1,14336,0,5516706450
3503,7391261015,2946,7391263961,0,0,1,3072,0,2914097961
3504,7391290180,131088,7391421268,6,0,0,40960,6,10140186084
3505,7391395419,32562,7391427981,7,0,1,7168,7,2401101144
3506,7391447489,64676,7391512165,4,0,0,8192,4,8656975311
3507,7391590468,3898,7391594366,2,0,1,4096,2,1585837113
3508,7391667794,1518,7391669312,2,0,1,1536,2,5571588530
3509,7391680640,2470,7391683110,3,0,1,2560,3,7144909285
3510,7391704246,5326,7391709572,8,0,1,5632,8,541834059
3511,7391706426,45752,7391752178,8,0,0,1536,8,5564698940
3512,7391719385,1994,7391721379,7,0,1,2048,7,7998953538
3513,7391722084,5326,7391727410,8,0,1,5632,8,10060667109
3514,7391851315,83624,7391934939,7,0,0,19968,7,3982622248
3515,7391875476,107379,7391982855,7,0,0,3584,7,7548173685
3516,7391890902,6754,7391897656,3,0,1,7168,3,8532217023
3517,7391953305,566,7391953871,5,0,1,512,5,7070141328
3518,7391993240,99320,7392092560,0,0,0,26112,0,2378321788
3519,7391995333,120798,7392116131,6,0,0,77312,6,5442145473
3520,7392013251,119604,7392132855,0,0,0,9216,0,10733429691
3521,7392144541,5326,7392149867,5,0,1,5632,5,6085722164
3522,7392147098,120160,7392267258,1,0,0,50688,1,907391479
3523,7392196808,127100,7392323908,6,0,0,3072,6,6143130561
3524,7392201699,102908,7392304607,7,0,0,37888,7,6399213943
3525,7392234176,125061,7392359237,6,0,0,19456,6,7326081252
3526,7392297274,7891,7392305165,4,0,1,512,4,6044811659
3527,7392352510,194036,7392546546,7,0,0,87552,7,9762066586
3528,7392471837,1994,7392473831,1,0,1,2048,1,9892213961
3529,7392608948,5326,7392614274,6,0,1,5632,6,5597396132
3530,7392614018,2946,7392616964,7,0,1,3072,7,4277907040
3531,7392650282,2470,7392652752,7,0,1,2560,7,1082359862
3532,7392696263,47288,7392743551,8,0,0,1536,8,9772345134
3533,7392707558,135693,7392843251,0,0,0,74240,0,9365088802
3534,7392720858,4162,7392725020,1,0,1,11264,1,4153355156
3535,7392933501,91616,7393025117,3,0,0,20992,3,1181268548
3536,7392949813,66056,7393015869,0,0,0,7680,0,6294372367
3537,7392971910,208511,7393180421,4,0,0,140288,4,2568765994
3538,7393166563,18717,7393185280,8,0,1,5120,8,10426136256
3539,7393174582,118748,7393293330,1,0,0,70656,1,9549612521
3540,7393182178,6648,7393188826,5,0,1,5632,5,7809176373
3541,7393209441,4374,7393213815,5,0,1,4608,5,5753395789
3542,7393277197,202091,7393479288,2,0,0,81408,2,8094117974
3543,7393367852,180742,7393548594,8,0,0,80896,8,253310013
3544,7393430159,1994,7393432153,4,0,1,2048,4,4683818271
3545,7393497165,51764,7393548929,9,0,0,1024,9,9754801318
3546,7393535681,116905,7393652586,1,0,0,41472,1,1277432709
3547,7393668355,64208,7393732563,4,0,0,6656,4,9699447370
3548,7393672612,48980,7393721592,7,0,0,2048,7,7688044993
3549,7393741038,5802,7393746840,0,0,1,6144,0,2592349921
3550,7393758767,3422,7393762189,2,0,1,3584,2,9379860293
3551,7393805591,566,7393806157,3,0,1,512,3,10692440717
3552,7393817674,3422,7393821096,1,0,1,3584,1,9938480241
3553,7393843459,111865,7393955324,3,0,0,42496,3,8410188617
3554,7393888032,69179,7393957211,9,0,0,6144,9,9689035695
3555,7393897295,5802,7393903097,8,0,1,6144,8,9332491448
3556,7393904616,5971,7393910587,5,0,1,14848,5,1385319323
3557,7393935698,194393,7394130091,8,0,0,113664,8,3773730251
3558,7394024224,224451,7394248675,1,0,0,180224,1,4217239702
3559,7394029140,2946,7394032086,5,0,1,3072,5,9925185797
3560,7394329116,5802,7394334918,5,0,1,6144,5,5849828860
3561,7394507353,126990,7394634343,9,0,0,56832,9,4423661693
3562,7394514212,4679,7394518891,3,0,1,12288,3,1291433102
3563,7394585667,160960,7394746627,6,0,0,36864,6,413939627
3564,7394616041,114140,7394730181,8,0,0,74752,8,125655022
3565,7394731242,15400,7394746642,7,0,1,6656,7,3639700293
3566,7394754283,5802,7394760085,0,0,1,6144,0,7807192074
3567,7394770575,109941,7394880516,0,0,0,46592,0,4945362133
3568,7394816462,45596,7394862058,4,0,0,1024,4,8496957280
3569,7394871814,10212,7394882026,2,0,1,1536,2,7246558147
3570,7394935658,99632,7395035290,1,0,0,27136,1,5851830513
3571,7394954288,1518,7394955806,6,0,1,1536,6,2905912669
3572,7394971406,192819,7395164225,8,0,0,48128,8,4498490911
3573,7395010806,134242,7395145048,8,0,0,47104,8,5253051109
3574,7395139987,108429,7395248416,6,0,0,39424,6,4122671180
3575,7395223116,131308,7395354424,6,0,0,78336,6,8710324765
3576,7395248206,107325,7395355531,8,0,0,3584,8,7511241599
3577,7395302491,2946,7395305437,7,0,1,3072,7,2024712541
3578,7395309563,53219,7395362782,6,0,0,3072,6,3342012050
3579,7395341973,210282,7395552255,9,0,0,26112,9,7988143807
3580,7395393042,23208,7395416250,1,0,1,38400,1,2179372971
3581,7395446429,210701,7395657130,6,0,0,28672,6,5190921455
3582,7395512132,123374,7395635506,3,0,0,3072,3,9133563010
3583,7395533990,180728,7395714718,1,0,0,157184,1,10119761472
3584,7395664613,566,7395665179,6,0,1,512,6,10132390370
3585,7395717201,167981,7395885182,6,0,0,89088,6,4127596253
3586,7395731361,1518,7395732879,0,0,1,1536,0,2670036427
3587,7395738664,165261,7395903925,3,0,0,61440,3,188419389
3588,7395775082,203895,7395978977,4,0,0,98304,4,8491589038
3589,7395802659,26738,7395829397,1,0,1,48640,1,2350031654
3590,7395878772,102248,7395981020,7,0,0,6656,7,1066977735
3591,7395916660,4374,7395921034,6,0,1,4608,6,2256150057
3592,7395926026,566,7395926592,7,0,1,512,7,10496067366
3593,7395997447,184883,7396182330,6,0,0,46080,6,3005618977
3594,7396091852,140944,7396232796,9,0,0,27648,9,5131701942
3595,7396113040,99788,7396212828,9,0,0,27648,9,247913879
3596,7396155900,130813,7396286713,8,0,0,3072,8,7047833770
3597,7396225032,10268,7396235300,0,0,1,2560,0,4651343147
3598,7396227713,137763,7396365476,9,0,0,52224,9,3952600241
3599,7396230383,197456,7396427839,6,0,0,73728,6,7327204911
3600,7396250907,2470,7396253377,4,0,1,2560,4,7849472985
3601,7396290440,3904,7396294344,8,0,1,10752,8,3217626233
3602,7396356794,10192,7396366986,2,0,1,1536,2,5523414805
3603,7396452229,110552,7396562781,1,0,0,62976,1,3930389770
3604,7396476576,179853,7396656429,1,0,0,50176,1,2761073092
3605,7396477303,162248,7396639551,1,0,0,81920,1,5585633075
3606,7396491457,149669,7396641126,0,0,0,5120,0,3221948130
3607,7396527699,42424,7396570123,1,0,1,69120,1,9852925306
3608,7396546495,207665,7396754160,1,0,0,71680,1,3889103304
3609,7396600054,199222,7396799276,9,0,0,17408,9,7207050495
3610,7396654602,5723,7396660325,2,0,1,10752,2,4428201683
3611,7396703102,126190,7396829292,7,0,0,28672,7,9617541150
3612,7396723397,249796,7396973193,6,0,0,70656,6,1248638935
3613,7396785498,166152,7396951650,1,0,0,40960,1,3540807690
3614,7396841930,1518,7396843448,2,0,1,1536,2,8966906916
3615,7396869629,185771,7397055400,4,0,0,107520,4,8745678465
3616,7396871195,151430,7397022625,9,0,0,40960,9,7515491182
3617,7396918394,140141,7397058535,0,0,0,10240,0,6286560708
3618,7396923588,7706,7396931294,0,0,1,8192,0,3705244909
3619,7397113001,115076,7397228077,2,0,0,77824,2,5239591529
3620,7397297780,566,7397298346,4,0,1,512,4,3206655398
3621,7397313951,1042,7397314993,6,0,1,1024,6,2134350880
3622,7397486468,3645,7397490113,6,0,1,10240,6,4187631018
3623,7397556956,132561,7397689517,1,0,0,11776,1,1032637336
3624,7397582876,98582,7397681458,8,0,0,16896,8,1775513147
3625,7397695067,1994,7397697061,7,0,1,2048,7,6077111243
3626,7397720502,2946,7397723448,4,0,1,3072,4,6162790834
3627,7397743685,118664,7397862349,2,0,0,89600,2,7492095098
3628,7397755694,187099,7397942793,6,0,0,22016,6,8883427338
3629,7397789209,115244,7397904453,2,0,0,2048,2,5205518507
3630,7397863794,119427,7397983221,8,0,0,28672,8,6938315752
3631,7397937495,9188,7397946683,4,0,1,4096,4,1540142039
3632,7397971806,109460,7398081266,3,0,0,59392,3,4885545620
3633,7398051947,58532,7398110479,6,0,0,8192,6,7793063156
3634,7398053182,154590,7398207772,0,0,0,79360,0,6307972179
3635,7398079991,103586,7398183577,6,0,0,30208,6,9126701292
3636,7398129523,103458,7398232981,2,0,0,3584,2,2090419924
3637,7398233405,101036,7398334441,3,0,0,31744,3,6397354060
3638,7398368091,102908,7398470999,0,0,0,37888,0,9990587395
3639,7398410496,114023,7398524519,3,0,0,4608,3,7244720732
3640,7398411131,126240,7398537371,0,0,0,26624,0,8240474216
3641,7398419098,143815,7398562913,2,0,0,28672,2,1727187722
3642,7398465658,8755,7398474413,4,0,1,3584,4,10051509947
3643,7398623086,108992,7398732078,9,0,0,57856,9,3985010204
3644,7398664123,71558,7398735681,7,0,0,11776,7,10597490059
3645,7398734089,4054,7398738143,8,0,1,2560,8,5083633847
3646,7398792361,6278,7398798639,4,0,1,6656,4,5395745097
3647,7398832732,2470,7398835202,1,0,1,2560,1,7904652812
3648,7398864994,185041,7399050035,9,0,0,49664,9,10624773099
3649,7398883350,5971,7398889321,6,0,1,14848,6,7946600030
3650,7398898641,1042,7398899683,2,0,1,1024,2,7421176753
3651,7398902363,115511,7399017874,1,0,0,14848,1,111881498
3652,7398966260,566,7398966826,7,0,1,512,7,10193442012
3653,7399064273,52364,7399116637,8,0,0,3072,8,9252673006
3654,7399082468,106652,7399189120,1,0,0,50176,1,10340535225
3655,7399157718,232107,7399389825,8,0,0,44544,8,5970240591
3656,7399163352,4374,7399167726,6,0,1,4608,6,5378322524
3657,7399181695,56397,7399238092,7,0,0,2048,7,7336466393
3658,7399279640,86384,7399366024,6,0,0,18944,6,1551612839
3659,7399301573,168370,7399469943,6,0,0,89600,6,5792507085
3660,7399303332,1042,7399304374,3,0,1,1024,3,3818658082
3661,7399421467,120848,7399542315,1,0,0,96768,1,7174686055
3662,7399442606,27862,7399470468,3,0,1,512,3,4731323725
3663,7399517573,26319,7399543892,7,0,1,1536,7,5053431743
3664,7399517933,229287,7399747220,2,0,0,135168,2,10317995996
3665,7399520710,172134,7399692844,1,0,0,68096,1,3966567078
3666,7399532467,18081,7399550548,7,0,1,8192,7,5562907879
3667,7399567718,266714,7399834432,6,0,0,46592,6,6135694321
3668,7399611766,171820,7399783586,3,0,0,21504,3,4497986598
3669,7399643567,132977,7399776544,2,0,0,17920,2,6155996935
3670,7399670707,90312,7399761019,0,0,0,22528,0,4723679944
3671,7399707761,44318,7399752079,3,0,1,5120,3,4205740377
3672,7399708184,44767,7399752951,1,0,1,11264,1,10038569744
3673,7399786443,220048,7400006491,2,0,0,98816,2,7984397863
3674,7399875002,133535,7400008537,0,0,0,3584,0,3243203951
3675,7399875550,3422,7399878972,2,0,1,3584,2,350655054
3676,7399914015,1518,7399915533,0,0,1,1536,0,4614331798
3677,7399961878,79592,7400041470,7,0,0,11776,7,6100099559
3678,7399979501,156865,7400136366,0,0,0,23552,0,229630872
3679,7400028181,97028,7400125209,9,0,0,28672,9,6624031167
3680,7400035753,139925,7400175678,8,0,0,61440,8,1079003665
3681,7400121083,107962,7400229045,2,0,0,40960,2,3617493932
3682,7400210008,3898,7400213906,7,0,1,4096,7,4495153157
3683,7400260738,5971,7400266709,2,0,1,14848,2,1804112469
3684,7400374862,4162,7400379024,0,0,1,11264,0,10116300818
3685,7400376703,5302,7400382005,0,0,1,10240,0,5897332151
3686,7400376831,11403,7400388234,7,0,1,7168,7,379009119
3687,7400384305,100866,7400485171,1,0,0,19456,1,5950030800
3688,7400386408,2492,7400388900,8,0,1,1024,8,6354156972
3689,7400503614,107276,7400610890,6,0,0,52224,6,3796858704
3690,7400514862,134890,7400649752,3,0,0,12288,3,9677054889
3691,7400519237,566,7400519803,0,0,1,512,0,5041480672
3692,7400522759,4850,7400527609,3,0,1,5120,3,466030025
3693,7400533043,59213,7400592256,3,0,0,2560,3,7738811112
3694,7400541370,1518,7400542888,4,0,1,1536,4,10461544395
3695,7400662051,94220,7400756271,0,0,0,19456,0,3967086881
3696,7400729255,20624,7400749879,3,0,1,33280,3,9790647595
3697,7400824503,98384,7400922887,7,0,0,23040,7,3292204479
3698,7400848410,115247,7400963657,6,0,0,29696,6,9150670990
3699,7400867580,154616,7401022196,8,0,0,77824,8,8834659357
3700,7400871243,79592,7400950835,0,0,0,6656,0,5090038750
3701,7400877922,4420,7400882342,7,0,1,11776,7,7071283787
3702,7400891460,192255,7401083715,7,0,0,89600,7,7109788421
3703,7401045189,38541,7401083730,8,0,1,22016,8,5186447677
3704,7401056333,110084,7401166417,0,0,0,61440,0,8161490277
3705,7401097430,3422,7401100852,6,0,1,3584,6,1807744474
3706,7401189137,2870,7401192007,7,0,1,8704,7,9258437328
3707,7401299122,1518,7401300640,3,0,1,1536,3,4220034901
3708,7401367040,5802,7401372842,3,0,1,6144,3,414560979
3709,7401385899,107350,7401493249,4,0,0,41472,4,8991998881
3710,7401398963,26479,7401425442,1,0,1,48128,1,9510984474
3711,7401514052,1042,7401515094,7,0,1,1024,7,5747010016
3712,7401531628,103064,7401634692,7,0,0,38400,7,5070988190
3713,7401652073,102128,7401754201,4,0,0,35328,4,1761970242
3714,7401711299,566,7401711865,6,0,1,512,6,942244369
3715,7401859503,2946,7401862449,0,0,1,3072,0,8708945868
3716,7401872094,212694,7402084788,9,0,0,76800,9,1322284898
3717,7401876562,2870,7401879432,7,0,1,8704,7,4851803462
3718,7401926254,1994,7401928248,0,0,1,2048,0,4947388642
3719,7401973155,4679,7401977834,0,0,1,12288,0,4380021332
3720,7402014644,216364,7402231008,0,0,0,134144,0,10563815753
3721,7402069043,22032,7402091075,6,0,1,6656,6,2407475400
3722,7402073437,175378,7402248815,1,0,0,58368,1,3466262488
3723,7402194265,144167,7402338432,7,0,0,52736,7,7040101831
3724,7402255553,101749,7402357302,6,0,0,7680,6,10716732403
3725,7402321971,110240,7402432211,6,0,0,61952,6,10687919729
3726,7402505921,48980,7402554901,6,0,0,2048,6,1402644964
3727,7402527846,3898,7402531744,7,0,1,4096,7,7012940145
3728,7402573478,3422,7402576900,4,0,1,3584,4,8357580892
3729,7402620840,3898,7402624738,7,0,1,4096,7,6724708901
3730,7402642138,108836,7402750974,2,0,0,57344,2,8994579366
3731,7402719989,7706,7402727695,2,0,1,8192,2,9523796462
3732,7402730438,55748,7402786186,3,0,0,4096,3,4085155006
3733,7402744334,123962,7402868296,4,0,0,80896,4,1954725942
3734,7402751341,147855,7402899196,4,0,0,20992,4,5812019321
3735,7402785886,25221,7402811107,1,0,1,45056,1,9619111650
3736,7402888965,10246,7402899211,8,0,1,15360,8,638865381
3737,7402927668,45596,7402973264,1,0,0,1024,1,4201177952
3738,7402992713,105092,7403097805,2,0,0,45056,2,7347355961
3739,7403039523,1518,7403041041,0,0,1,1536,0,7626164785
3740,7403090678,8637,7403099315,8,0,1,1536,8,4229416853
3741,7403221261,10499,7403231760,3,0,1,16896,3,6977688114
3742,7403344196,1518,7403345714,2,0,1,1536,2,3708731941
3743,7403368547,68372,7403436919,1,0,0,10240,1,5000225839
3744,7403434967,4414,7403439381,2,0,1,2560,2,950454358
3745,7403520411,144836,7403665247,7,0,0,135168,7,6304443654
3746,7403532016,198169,7403730185,9,0,0,120320,9,10664044205
3747,7403657222,152415,7403809637,8,0,0,81408,8,10168791839
3748,7403724998,151917,7403876915,9,0,0,74240,9,6828314831
3749,7403731222,4162,7403735384,7,0,1,11264,7,4215242437
3750,7403978160,45596,7404023756,3,0,0,1024,3,7593898158
3751,7404001268,7230,7404008498,2,0,1,7680,2,6479993166
3752,7404093406,74228,7404167634,2,0,0,14336,2,3748678229
3753,7404123921,68996,7404192917,4,0,0,12288,4,7249171924
3754,7404166067,95779,7404261846,1,0,0,19456,1,5571924598
3755,7404175197,5802,7404180999,7,0,1,6144,7,4824593977
3756,7404385815,132371,7404518186,8,0,0,83456,8,4484758405
3757,7404394263,7706,7404401969,2,0,1,8192,2,9282157512
3758,7404411526,1042,7404412568,6,0,1,1024,6,4698750070
3759,7404448264,189568,7404637832,4,0,0,56320,4,9366741948
3760,7404467865,2870,7404470735,7,0,1,8704,7,6728160925
3761,7404473017,82820,7404555837,7,0,0,12288,7,1904007267
3762,7404492102,109878,7404601980,7,0,0,23040,7,7709765019
3763,7404545116,11791,7404556907,0,0,1,19456,0,7711768432
3764,7404571965,94080,7404666045,6,0,0,15872,6,2387876492
3765,7404774140,3898,7404778038,3,0,1,4096,3,3230506663
3766,7404807132,98384,7404905516,6,0,0,23040,6,2627442685
3767,7404894027,13600,7404907627,2,0,1,23040,2,7177233231
3768,7404895848,12830,7404908678,4,0,1,9216,4,213917250
3769,7404898430,73003,7404971433,9,0,0,7168,9,9994101761
3770,7404900532,135965,7405036497,0,0,0,59392,0,2984571095
3771,7404930627,105893,7405036520,1,0,1,175616,1,8200137177
3772,7404965310,72293,7405037603,0,0,1,2048,0,6532793633
3773,7405034524,169958,7405204482,0,0,0,2048,0,4853054790
3774,7405153797,47288,7405201085,8,0,0,1536,8,3926257252
3775,7405214552,76052,7405290604,8,0,0,10240,8,2800680360
3776,7405230561,109616,7405340177,0,0,0,59904,0,1067472865
3777,7405233815,131034,7405364849,0,0,0,14848,0,10613335810
3778,7405359013,1042,7405360055,4,0,1,1024,4,5689510953
3779,7405418379,13770,7405432149,1,0,1,26624,1,6283068579
3780,7405463246,87156,7405550402,4,0,0,8704,4,3315619604
3781,7405598445,113204,7405711649,6,0,0,71680,6,475204737
3782,7405606058,134673,7405740731,3,0,0,9728,3,8109981866
3783,7405608295,142435,7405750730,1,0,0,32768,1,2249411282
3784,7405703056,135223,7405838279,7,0,0,30208,7,8885009377
3785,7405760566,3645,7405764211,1,0,1,10240,1,2952230161
3786,7405841289,128103,7405969392,9,0,0,89088,9,9124255903
3787,7405884555,41908,7405926463,1,0,1,68096,1,5690975303
3788,7405958760,255933,7406214693,3,0,0,75264,3,1232075324
3789,7405960948,9027,7405969975,8,0,1,512,8,1937979162
3790,7406104408,84359,7406188767,6,0,0,9216,6,3128326087
3791,7406413749,5802,7406419551,8,0,1,6144,8,1354612374
3792,7406429769,2946,7406432715,3,0,1,3072,3,9846637727
3793,7406430252,159786,7406590038,0,0,0,8704,0,7940820386
3794,7406507774,60224,7406567998,7,0,0,8704,7,3087887893
3795,7406554776,2470,7406557246,2,0,1,2560,2,10334609920
3796,7406605366,2946,7406608312,2,0,1,3072,2,3053761322
3797,7406696198,60824,7406757022,0,0,0,5632,0,10392003042
3798,7406798995,65900,7406864895,1,0,0,7168,1,186845888
3799,7406869292,4374,7406873666,2,0,1,4608,2,2219803247
3800,7406882520,2946,7406885466,4,0,1,3072,4,3279436050
3801,7406906175,52924,7406959099,9,0,0,3072,9,8420382815
3802,7406954720,1042,7406955762,3,0,1,1024,3,8657440620
3803,7406964123,142466,7407106589,0,0,0,14336,0,2772086852
3804,7406999878,6754,7407006632,7,0,1,7168,7,7657512410
3805,7407113398,113516,7407226914,1,0,0,72704,1,4748382691
3806,7407170089,3422,7407173511,8,0,1,3584,8,3281230559
3807,7407184896,189188,7407374084,8,0,0,159744,8,7600419217
3808,7407194988,566,7407195554,7,0,1,512,7,7330218384
3809,7407225017,4359,7407229376,6,0,1,2560,6,5173871442
3810,7407233333,2470,7407235803,4,0,1,2560,4,3833564634
3811,7407355399,202752,7407558151,1,0,0,37888,1,6350506748
3812,7407362508,103015,7407465523,0,0,0,18432,0,10654164851
3813,7407611023,52364,7407663387,1,0,0,3072,1,404108719
3814,7407621975,127156,7407749131,7,0,0,72192,7,5721862952
3815,7407654308,4374,7407658682,3,0,1,4608,3,7630826410
3816,7407669460,204182,7407873642,6,0,0,101376,6,2786529238
3817,7407686269,31524,7407717793,1,0,1,51200,1,7972702283
3818,7407753579,180973,7407934552,9,0,0,12288,9,7973953439
3819,7407792579,23466,7407816045,1,0,1,38912,1,10141759520
3820,7407854084,180314,7408034398,8,0,0,14848,8,5598561189
3821,7407867684,10137,7407877821,7,0,1,11264,7,6839638135
3822,7407915507,156876,7408072383,6,0,0,3072,6,4999707486
3823,7407923917,93404,7408017321,3,0,0,20480,3,1055123139
3824,7407941039,4420,7407945459,2,0,1,11776,2,9770079380
3825,7407957435,1042,7407958477,2,0,1,1024,2,4387885888
3826,7408021622,45596,7408067218,8,0,0,1024,8,2796324825
3827,7408056780,95132,7408151912,6,0,0,17408,6,658251969
3828,7408091676,70976,7408162652,2,0,0,8704,2,4391531620
3829,7408201796,48980,7408250776,7,0,0,2048,7,6043493044
3830,7408216355,56216,7408272571,7,0,0,5632,7,867169112
3831,7408218656,79616,7408298272,2,0,0,16896,2,219690027
3832,7408286050,99944,7408385994,6,0,0,28160,6,3583598968
3833,7408290269,96208,7408386477,7,0,0,1536,7,4316031367
3834,7408309891,154697,7408464588,6,0,0,43008,6,1360929646
3835,7408422606,43904,7408466510,4,0,0,512,4,3971211043
3836,7408452759,16500,7408469259,8,0,1,12288,8,3763553412
3837,7408523278,1042,7408524320,3,0,1,1024,3,5825531916
3838,7408528503,160404,7408688907,7,0,0,41472,7,9576553466
3839,7408535755,214464,7408750219,6,0,0,104448,6,478275030
3840,7408547719,143231,7408690950,3,0,0,6656,3,8367679798
3841,7408604268,236139,7408840407,1,0,0,102912,1,8152884774
3842,7408607316,174739,7408782055,2,0,0,47616,2,2286833915
3843,7408718829,63241,7408782070,0,0,1,37888,0,8530299831
3844,7408754074,206057,7408960131,6,0,0,29696,6,3807160721
3845,7408755295,217183,7408972478,4,0,0,40448,4,4622756654
3846,7408764443,186617,7408951060,9,0,0,137216,9,9766763826
3847,7408855353,7706,7408863059,2,0,1,8192,2,2919119860
3848,7408913952,220245,7409134197,7,0,0,53760,7,6456469678
3849,7408947079,29732,7408976811,3,0,1,4608,3,6806252374
3850,7409056298,5326,7409061624,0,0,1,5632,0,3886211757
3851,7409067042,1994,7409069036,0,0,1,2048,0,7006946586
3852,7409072765,104468,7409177233,2,0,0,43008,2,5308327763
3853,7409089122,48980,7409138102,7,0,0,2048,7,5093899353
3854,7409115958,61602,7409177560,2,0,0,1024,2,1130207499
3855,7409226639,36604,7409263243,1,0,1,64512,1,8834556229
3856,7409339858,99320,7409439178,1,0,0,26112,1,9563187689
3857,7409475002,87896,7409562898,4,0,0,13824,4,2889853700
3858,7409479888,4374,7409484262,0,0,1,4608,0,10151444906
3859,7409596498,4937,7409601435,1,0,1,12800,1,5987134098
3860,7409689405,3898,7409693303,8,0,1,4096,8,5717514699
3861,7409728507,3422,7409731929,7,0,1,3584,7,2085166665
3862,7409732375,207149,7409939524,3,0,0,90624,3,9015885759
3863,7409785192,117639,7409902831,0,0,0,15360,0,1011439595
3864,7409814989,125330,7409940319,8,0,0,2560,8,6386908910
3865,7409847703,4374,7409852077,2,0,1,4608,2,1594512005
3866,7410062243,95444,7410157687,6,0,0,18432,6,1791416059
3867,7410067985,244946,7410312931,3,0,0,205312,3,10695477455
3868,7410080755,4374,7410085129,8,0,1,4608,8,4745877364
3869,7410096666,10757,7410107423,7,0,1,17408,7,3333076678
3870,7410138363,179575,7410317938,6,0,0,16384,6,9434983488
3871,7410214484,172445,7410386929,9,0,0,76800,9,5451902706
3872,7410394469,11274,7410405743,1,0,1,18432,1,6233432241
3873,7410490261,4850,7410495111,8,0,1,5120,8,3745885068
3874,7410526314,48980,7410575294,2,0,0,2048,2,1048734804
3875,7410576399,94712,7410671111,4,0,0,26112,4,4209748321
3876,7410598643,55748,7410654391,3,0,0,4096,3,8266363076
3877,7410601577,6754,7410608331,0,0,1,7168,0,5161766414
3878,7410725027,14804,7410739831,7,0,1,28672,7,9421206368
3879,7410749175,71869,7410821044,8,0,0,512,8,9454526857
3880,7410762413,1518,7410763931,4,0,1,1536,4,4682313587
3881,7410899200,566,7410899766,2,0,1,512,2,10517381688
3882,7410912206,78236,7410990442,4,0,0,17408,4,9628422030
3883,7410980042,76052,7411056094,9,0,0,10240,9,4036947526
3884,7410984320,94034,7411078354,0,0,0,7680,0,8382296641
3885,7411092764,116168,7411208932,3,0,0,81408,3,7803280167
3886,7411156774,86580,7411243354,4,0,0,11776,4,7077698878
3887,7411300845,566,7411301411,0,0,1,512,0,4487143648
3888,7411346482,5326,7411351808,4,0,1,5632,4,5567002444
3889,7411373913,48980,7411422893,3,0,0,2048,3,7370601687
3890,7411427306,566,7411427872,7,0,1,512,7,9407043612
3891,7411461561,5196,7411466757,1,0,1,13312,1,7182470986
3892,7411490097,90212,7411580309,3,0,0,16384,3,8476679552
3893,7411519116,120371,7411639487,4,0,0,17920,4,2302571431
3894,7411558825,3422,7411562247,3,0,1,3584,3,3093840966
3895,7411566963,133125,7411700088,0,0,0,33280,0,816021102
3896,7411605314,1042,7411606356,6,0,1,1024,6,9041035105
3897,7411683623,116665,7411800288,4,0,0,62464,4,3299771250
3898,7411724268,99138,7411823406,0,0,0,6144,0,7920680940
3899,7411727574,174342,7411901916,3,0,0,35840,3,8844713165
3900,7411909528,106184,7412015712,1,0,0,48640,1,2097899934
3901,7412024123,77744,7412101867,0,0,0,10752,0,4235925860
3902,7412237796,6229,7412244025,6,0,1,15360,6,7957548186
3903,7412262929,100880,7412363809,9,0,0,31232,9,6884035122
3904,7412437342,1042,7412438384,7,0,1,1024,7,5853019470
3905,7412447202,113984,7412561186,3,0,0,74240,3,1073899977
3906,7412774428,112062,7412886490,6,0,0,61440,6,5214578069
3907,7412786615,4420,7412791035,7,0,1,11776,7,5393915913
3908,7412932284,56294,7412988578,8,0,0,512,8,5878621801
3909,7412993750,101348,7413095098,1,0,0,32768,1,4610873048
3910,7413047761,5802,7413053563,7,0,1,6144,7,10303923201
3911,7413091837,85661,7413177498,1,0,1,133632,1,857950349
3912,7413305178,74228,7413379406,6,0,0,14336,6,10671555153
3913,7413347547,117047,7413464594,1,0,0,19456,1,8532559025
3914,7413355599,10241,7413365840,6,0,1,16384,6,9889135112
3915,7413532717,2470,7413535187,6,0,1,2560,6,10395040048
3916,7413560148,45596,7413605744,8,0,0,1024,8,6977157885
3917,7413944027,4679,7413948706,3,0,1,12288,3,171604204
3918,7413987249,12049,7413999298,6,0,1,19968,6,4710548335
3919,7414024583,3422,7414028005,0,0,1,3584,0,2391184095
3920,7414057815,6278,7414064093,0,0,1,6656,0,3829807717
3921,7414075136,3898,7414079034,0,0,1,4096,0,5953384728
3922,7414083258,153296,7414236554,3,0,0,137728,3,5456436707
3923,7414083386,6754,7414090140,6,0,1,7168,6,3761334694
3924,7414241067,101660,7414342727,7,0,0,33792,7,8387172927
3925,7414307473,1042,7414308515,8,0,1,1024,8,1801624239
3926,7414337957,50358,7414388315,8,0,0,1024,8,9893486093
3927,7414339142,50890,7414390032,8,0,0,1536,8,969202761
3928,7414387191,110061,7414497252,9,0,0,53760,9,7945647580
3929,7414473232,51488,7414524720,8,0,0,512,8,3373003607
3930,7414509226,47288,7414556514,3,0,0,1536,3,8510960619
3931,7414554741,3422,7414558163,6,0,1,3584,6,8659965706
3932,7414576710,99632,7414676342,7,0,0,27136,7,10037552969
3933,7414611635,12737,7414624372,6,0,1,24576,6,1219244275
3934,7414675943,47679,7414723622,3,0,0,1536,3,635602549
3935,7414824797,43904,7414868701,8,0,0,512,8,4577092953
3936,7414886956,100568,7414987524,2,0,0,30208,2,4537611534
3937,7414902271,47177,7414949448,9,0,0,1024,9,8095499592
3938,7415007520,100880,7415108400,2,0,0,31232,2,1550327382
3939,7415046505,45596,7415092101,3,0,0,1024,3,9961567415
3940,7415056212,5971,7415062183,7,0,1,14848,7,8052903424
3941,7415068415,52471,7415120886,3,0,0,512,3,9953097324
3942,7415193951,47288,7415241239,8,0,0,1536,8,2904806983
3943,7415282519,45596,7415328115,3,0,0,1024,3,3314146007
3944,7415286316,6754,7415293070,0,0,1,7168,0,337432833
3945,7415317743,66840,7415384583,8,0,0,3072,8,10095922844
3946,7415386563,117572,7415504135,7,0,0,86016,7,4357915229
3947,7415472191,2946,7415475137,6,0,1,3072,6,5539403051
3948,7415534894,23637,7415558531,1,0,1,42496,1,2692571482
3949,7415641706,106496,7415748202,7,0,0,49664,7,5111634142
3950,7415770109,3898,7415774007,4,0,1,4096,4,241666834
3951,7415774187,6754,7415780941,0,0,1,7168,0,1992363117
3952,7415801686,1994,7415803680,3,0,1,2048,3,5673495140
3953,7415809433,1042,7415810475,8,0,1,1024,8,2161418816
3954,7415833305,6754,7415840059,1,0,1,7168,1,5566431694
3955,7415898782,45596,7415944378,0,0,0,1024,0,5061137755
3956,7415938758,2946,7415941704,3,0,1,3072,3,9202098884
3957,7415957047,1042,7415958089,7,0,1,1024,7,4669547374
3958,7416083964,2870,7416086834,3,0,1,8704,3,8618776821
3959,7416224503,43904,7416268407,0,0,0,512,0,7761028874
3960,7416310530,45596,7416356126,4,0,0,1024,4,6522808086
3961,7416474215,45596,7416519811,8,0,0,1024,8,7336384753
3962,7416533603,43975,7416577578,1,0,1,72192,1,1153032666
3963,7416593278,135348,7416728626,9,0,0,33792,9,7441287210
3964,7416663594,216518,7416880112,7,0,0,182784,7,5778808490
3965,7416706030,72622,7416778652,8,0,0,1024,8,6500714899
3966,7416838413,122819,7416961232,1,0,0,11776,1,5234569246
3967,7416898088,3422,7416901510,6,0,1,3584,6,8580047472
3968,7416927687,61604,7416989291,9,0,0,8192,9,10293706678
3969,7417094273,6278,7417100551,3,0,1,6656,3,9057282076
3970,7417095937,136869,7417232806,7,0,0,81408,7,9346212325
3971,7417134387,241664,7417376051,2,0,0,69120,2,5912355665
3972,7417160995,171760,7417332755,1,0,0,16896,1,6384282138
3973,7417180598,3422,7417184020,3,0,1,3584,3,4630074180
3974,7417195752,37093,7417232845,1,0,1,47104,1,7812650219
3975,7417208108,28638,7417236746,4,0,1,4096,4,2441413245
3976,7417216762,23530,7417240292,6,0,1,5632,6,8378253661
3977,7417220246,21672,7417241918,0,0,1,2560,0,3132729951
3978,7417288590,63647,7417352237,0,0,0,4096,0,5580185111
3979,7417346833,166598,7417513431,1,0,0,108032,1,9755218244
3980,7417425704,138382,7417564086,4,0,0,41472,4,1531177345
3981,7417460864,75280,7417536144,8,0,0,4096,8,4315170132
3982,7417540234,2946,7417543180,3,0,1,3072,3,1555910729
3983,7417549044,24670,7417573714,1,0,1,44544,1,4693651224
3984,7417558730,15240,7417573970,7,0,1,9216,7,8123792620
3985,7417597939,254583,7417852522,0,0,0,11264,0,5391628009
3986,7417617578,115959,7417733537,7,0,0,35840,7,9735538341
3987,7417682457,23983,7417706440,1,0,1,39936,1,281609966
3988,7417692064,48206,7417740270,2,0,0,1024,2,2017900303
3989,7417872164,45596,7417917760,3,0,0,1024,3,3106206664
3990,7418009841,114920,7418124761,7,0,0,77312,7,10688360149
3991,7418094256,30520,7418124776,1,0,1,41472,1,3198435804
3992,7418198814,102908,7418301722,1,0,0,37888,1,2011155847
3993,7418227698,4679,7418232377,0,0,1,12288,0,6809756052
3994,7418271375,115856,7418387231,1,0,0,80384,1,1140974780
3995,7418329024,4420,7418333444,6,0,1,11776,6,9063872725
3996,7418393466,6754,7418400220,7,0,1,7168,7,6073623559
3997,7418673102,3422,7418676524,6,0,1,3584,6,370297151
3998,7418741164,45596,7418786760,8,0,0,1024,8,9747821469
3999,7418770854,5802,7418776656,6,0,1,6144,6,6908937390
4000,7418842983,3422,7418846405,7,0,1,3584,7,7209441993
4001,7418865895,112112,7418978007,0,0,0,68096,0,9612816982
4002,7418942498,35532,7418978030,1,0,1,55296,1,8627400499
4003,7418968351,87648,7419055999,8,0,0,1024,8,8245822482
4004,7419027403,153982,7419181385,8,0,0,2560,8,5346725902
4005,7419140325,77924,7419218249,1,0,0,16384,1,9855829808
4006,7419324065,60824,7419384889,4,0,0,5632,4,1870733172
4007,7419479240,1994,7419481234,4,0,1,2048,4,8334445762
4008,7419606545,64988,7419671533,0,0,0,9216,0,7674645688
4009,7419700954,44492,7419745446,1,0,1,73216,1,3544612644
4010,7419767801,43904,7419811705,8,0,0,512,8,5247354408
4011,7419804708,54056,7419858764,3,0,0,3584,3,7625687261
4012,7419818109,126397,7419944506,1,0,0,93184,1,7990648612
4013,7419824750,43904,7419868654,3,0,0,512,3,5409564165
4014,7419845173,11016,7419856189,7,0,1,17920,7,5699324416
4015,7419903312,1042,7419904354,0,0,1,1024,0,7781478379
4016,7419938986,87444,7420026430,6,0,0,19456,6,9637216876
4017,7419946380,566,7419946946,0,0,1,512,0,1888126670
4018,7420079904,87296,7420167200,6,0,0,16896,6,5010198340
4019,7420224612,33591,7420258203,1,0,1,55296,1,10610710430
4020,7420301483,4850,7420306333,4,0,1,5120,4,5310556680
4021,7420397209,84980,7420482189,9,0,0,14336,9,5138219173
4022,7420450144,113516,7420563660,6,0,0,72704,6,5831921909
4023,7420623050,64988,7420688038,0,0,0,9216,0,3798093490
4024,7420796475,1518,7420797993,3,0,1,1536,3,8242555691
4025,7420829362,64364,7420893726,6,0,0,7168,6,6741997692
4026,7420898760,67928,7420966688,6,0,0,13824,6,8137794574
4027,7420913350,91304,7421004654,4,0,0,19968,4,3524865635
4028,7420927847,105303,7421033150,1,0,0,29184,1,5742538274
4029,7421028718,95440,7421124158,9,0,0,24064,9,951652364
4030,7421073791,5802,7421079593,8,0,1,6144,8,1372155100
4031,7421144516,5712,7421150228,3,0,1,14336,3,1898993028
4032,7421212898,102128,7421315026,2,0,0,35328,2,9051216716
4033,7421299460,111554,7421411014,9,0,0,50688,9,4378837831
4034,7421470133,73760,7421543893,9,0,0,12800,9,8706123061
4035,7421480901,67592,7421548493,0,0,0,7680,0,9315532810
4036,7421528592,1994,7421530586,7,0,1,2048,7,970071950
4037,7421545915,49162,7421595077,6,0,0,2048,6,2269304835
4038,7421621255,45596,7421666851,8,0,0,1024,8,7151344509
4039,7421710780,7230,7421718010,7,0,1,7680,7,5172180591
4040,7421767080,97160,7421864240,1,0,0,24064,1,1897756417
4041,7421852631,4162,7421856793,6,0,1,11264,6,5983151949
4042,7422100165,44060,7422144225,8,0,0,1024,8,4778065661
4043,7422176493,43904,7422220397,8,0,0,512,8,5509881235
4044,7422179656,90836,7422270492,9,0,0,18432,9,6270820385
4045,7422210972,3904,7422214876,6,0,1,10752,6,10396931496
4046,7422331171,59132,7422390303,0,0,0,5120,0,8315742086
4047,7422345393,115212,7422460605,9,0,0,53248,9,5581851846
4048,7422361247,3422,7422364669,1,0,1,3584,1,10716788904
4049,7422383218,3128,7422386346,8,0,1,9216,8,5186035056
4050,7422413425,4374,7422417799,0,0,1,4608,0,8801353085
4051,7422423339,66582,7422489921,8,0,0,1024,8,1001375953
4052,7422515625,45596,7422561221,6,0,0,1024,6,1599689454
4053,7422598013,566,7422598579,4,0,1,512,4,1968401122
4054,7422655448,79148,7422734596,7,0,0,15360,7,9701990643
4055,7422662326,6278,7422668604,3,0,1,6656,3,5808695319
4056,7422664670,75428,7422740098,9,0,0,2048,9,7323128751
4057,7422722205,47288,7422769493,8,0,0,1536,8,4947619610
4058,7422847303,106184,7422953487,2,0,0,48640,2,10365027491
4059,7422889967,65687,7422955654,1,0,1,111104,1,3814878325
4060,7422890941,66339,7422957280,0,0,1,2560,0,2282744321
4061,7423096705,1518,7423098223,7,0,1,1536,7,9329743011
4062,7423228438,2946,7423231384,4,0,1,3072,4,9625108200
4063,7423256091,93464,7423349555,7,0,0,22016,7,2982618754
4064,7423265893,13083,7423278976,0,0,1,22016,0,5590981863
4065,7423348986,62321,7423411307,9,0,0,8704,9,7739035831
4066,7423387843,54247,7423442090,3,0,0,1024,3,6470645088
4067,7423401883,43904,7423445787,3,0,0,512,3,7724389496
4068,7423491249,3898,7423495147,4,0,1,4096,4,8420847766
4069,7423592360,108056,7423700416,9,0,0,54784,9,672962964
4070,7423612045,11016,7423623061,3,0,1,17920,3,7959797819
4071,7423759728,45596,7423805324,8,0,0,1024,8,5140198547
4072,7423813144,107588,7423920732,9,0,0,53248,9,4930697875
4073,7423833398,5326,7423838724,6,0,1,5632,6,8899343365
4074,7423868495,81553,7423950048,3,0,0,1024,3,1787156295
4075,7424001902,101816,7424103718,9,0,0,34304,9,7267325247
4076,7424045180,43904,7424089084,6,0,0,512,6,7868989745
4077,7424061932,140270,7424202202,0,0,0,57856,0,2106451451
4078,7424139176,92630,7424231806,3,0,0,1536,3,9636592510
4079,7424422077,47288,7424469365,0,0,0,1536,0,4860003447
4080,7424447056,193688,7424640744,9,0,0,169472,9,424800444
4081,7424473813,230717,7424704530,2,0,0,39936,2,6024730035
4082,7424480476,189098,7424669574,1,0,0,86528,1,3693609260
4083,7424482312,187612,7424669924,6,0,0,1024,6,9516849848
4084,7424497982,1042,7424499024,7,0,1,1024,7,5912685487
4085,7424612991,159441,7424772432,2,0,0,34816,2,3525567
4086,7424613495,56094,7424669589,6,0,1,3584,6,10104886732
4087,7424652631,94250,7424746881,1,0,0,14336,1,3269224267
4088,7424741124,128676,7424869800,4,0,0,4608,4,2452240849
4089,7424763655,95597,7424859252,0,0,0,15360,0,1611656134
4090,7424788937,75166,7424864103,4,0,0,15872,4,8804537071
4091,7424946549,6754,7424953303,6,0,1,7168,6,730691007
4092,7424994453,97292,7425091745,7,0,0,19456,7,9414328314
4093,7425093873,48980,7425142853,2,0,0,2048,2,143344903
4094,7425095712,80708,7425176420,7,0,0,20480,7,4159981355
4095,7425536990,1994,7425538984,3,0,1,2048,3,2379081437
4096,7425601230,7706,7425608936,4,0,1,8192,4,10457257029
4097,7425602393,7529,7425609922,6,0,1,1536,6,2434777172
4098,7425725259,141452,7425866711,0,0,0,134144,0,5260078960
4099,7425811279,109756,7425921035,7,0,0,43008,7,7916949713
4100,7425880817,45596,7425926413,8,0,0,1024,8,904514639
4101,7425915744,5849,7425921593,4,0,1,512,4,3115052443
4102,7425923705,47288,7425970993,4,0,0,1536,4,8312554881
4103,7425930405,43904,7425974309,8,0,0,512,8,7518425455
4104,7425941883,2946,7425944829,3,0,1,3072,3,4744166036
4105,7425987250,52364,7426039614,1,0,0,3072,1,4234944818
4106,7426015691,106184,7426121875,7,0,0,48640,7,8302547853
4107,7426134729,45596,7426180325,8,0,0,1024,8,6592930389
4108,7426209049,1042,7426210091,4,0,1,1024,4,4637136294
4109,7426222882,1994,7426224876,0,0,1,2048,0,5625092027
4110,7426327875,43904,7426371779,3,0,0,512,3,8183037475
4111,7426345047,104208,7426449255,1,0,1,169472,1,10431532574
4112,7426409217,180891,7426590108,8,0,0,512,8,3254776546
4113,7426491987,2946,7426494933,3,0,1,3072,3,2931142134
4114,7426714692,1042,7426715734,8,0,1,1024,8,299756526
4115,7427012019,6754,7427018773,4,0,1,7168,4,5421516032
4116,7427056734,3898,7427060632,8,0,1,4096,8,5488655672
4117,7427200927,44404,7427245331,1,0,1,76288,1,2270316527
4118,7427252112,114402,7427366514,7,0,0,8704,7,537090249
4119,7427290498,566,7427291064,8,0,1,512,8,8725612831
4120,7427413079,105716,7427518795,0,0,0,47104,0,7357183976
4121,7427474156,129707,7427603863,1,0,0,26624,1,4231370683
4122,7427506612,123783,7427630395,7,0,0,17920,7,4362121646
4123,7427527826,2470,7427530296,3,0,1,2560,3,6015044828
4124,7427567414,6488,7427573902,6,0,1,15872,6,10189900009
4125,7427604644,91757,7427696401,1,0,1,148480,1,5603367889
4126,7427649459,47288,7427696747,8,0,1,512,8,5368708553
4127,7427687241,159657,7427846898,8,0,0,1024,8,10259052745
4128,7427721547,172240,7427893787,9,0,0,13824,9,7101938035
4129,7427783747,59288,7427843035,2,0,0,5632,2,6578506684
4130,7427785788,6278,7427792066,3,0,1,6656,3,1963666775
4131,7427866171,1518,7427867689,0,0,1,1536,0,5143888385
4132,7427883521,105872,7427989393,9,0,0,47616,9,9476790825
4133,7427935285,6754,7427942039,4,0,1,7168,4,7580029186
4134,7428056501,45596,7428102097,3,0,0,1024,3,3152776710
4135,7428069097,45752,7428114849,3,0,0,1536,3,8912933978
4136,7428120589,206660,7428327249,9,0,0,217088,9,9788738531
4137,7428205038,169995,7428375033,1,0,0,74240,1,9603594933
4138,7428290736,38975,7428329711,8,0,1,2560,8,9762060648
4139,7428426729,99164,7428525893,7,0,0,25600,7,11085660
4140,7428629890,99008,7428728898,7,0,0,25088,7,9543122416
4141,7428663599,4374,7428667973,7,0,1,4608,7,2694658200
4142,7428684080,81022,7428765102,8,0,0,512,8,10317675103
4143,7428756968,3422,7428760390,0,0,1,3584,0,2533406946
4144,7429213139,54056,7429267195,3,0,0,3584,3,9949630848
4145,7429224403,566,7429224969,6,0,1,512,6,900698404
4146,7429251127,1042,7429252169,0,0,1,1024,0,4821526116
4147,7429305460,86540,7429392000,7,0,0,19456,7,9113912931
4148,7429314960,2470,7429317430,6,0,1,2560,6,177383311
4149,7429341484,102752,7429444236,4,0,0,37376,4,4326150887
4150,7429442088,66348,7429508436,0,0,0,6656,0,10212859553
4151,7429486456,45596,7429532052,3,0,0,1024,3,4322799765
4152,7429498754,1042,7429499796,6,0,1,1024,6,6732817379
4153,7429500389,8062,7429508451,8,0,1,7168,8,5135681587
4154,7429728407,141457,7429869864,2,0,0,36864,2,10007586350
4155,7429747300,105716,7429853016,0,0,0,47104,0,8255623648
4156,7429757769,95730,7429853499,8,0,0,1536,8,9280252925
4157,7429764429,162528,7429926957,7,0,0,32256,7,6776545634
4158,7429765519,183324,7429948843,1,0,0,28160,1,8516377951
4159,7429860977,69703,7429930680,7,0,0,5632,7,5178500587
4160,7429899134,2946,7429902080,8,0,1,3072,8,8158154305
4161,7429914993,1518,7429916511,6,0,1,1536,6,6529821427
4162,7429924410,4057,7429928467,7,0,1,1536,7,8876068526
4163,7429975443,5326,7429980769,8,0,1,5632,8,4134496512
4164,7430005552,99055,7430104607,4,0,0,20480,4,7051800919
4165,7430026908,71444,7430098352,2,0,0,10240,2,9909196473
4166,7430170873,3645,7430174518,8,0,1,10240,8,5051133687
4167,7430324074,45596,7430369670,8,0,0,1024,8,2378745368
4168,7430353444,110396,7430463840,4,0,0,62464,4,1868833474
4169,7430531601,3422,7430535023,7,0,1,3584,7,9322011680
4170,7430614479,3898,7430618377,3,0,1,4096,3,8806549680
4171,7430627572,3128,7430630700,0,0,1,9216,0,2026651985
4172,7430710955,107048,7430818003,8,0,0,512,8,3299624191
4173,7430800572,566,7430801138,3,0,1,512,3,8597048396
4174,7430837111,132964,7430970075,8,0,0,1024,8,10285873038
4175,7430843142,69284,7430912426,2,0,0,8192,2,2581461611
4176,7430860577,101348,7430961925,4,0,0,32768,4,6629661670
4177,7431058787,45596,7431104383,3,0,0,1024,3,8986879365
4178,7431093946,62516,7431156462,7,0,0,6144,7,3518616051
4179,7431097171,5712,7431102883,4,0,1,14336,4,2728511408
4180,7431103670,6278,7431109948,6,0,1,6656,6,10500833615
4181,7431121447,6754,7431128201,6,0,1,7168,6,8367333682
4182,7431204972,70073,7431275045,8,0,0,1024,8,656662387
4183,7431227994,31007,7431259001,1,0,1,50176,1,5682039937
4184,7431244969,43200,7431288169,1,0,1,70656,1,6484463703
4185,7431248363,200656,7431449019,9,0,0,5632,9,10418286463
4186,7431296956,14029,7431310985,7,0,1,27136,7,10301883650
4187,7431325389,182677,7431508066,6,0,0,512,6,5771529322
4188,7431442757,1518,7431444275,7,0,1,1536,7,853555995
4189,7431525608,59771,7431585379,6,0,0,1536,6,9831482108
4190,7431536030,566,7431536596,7,0,1,512,7,1064856065
4191,7431654266,43904,7431698170,3,0,0,512,3,512640138
4192,7431996853,4850,7432001703,4,0,1,5120,4,2639137796
4193,7432021543,2870,7432024413,1,0,1,8704,1,5768075368
4194,7432228508,51322,7432279830,6,0,0,512,6,665984525
4195,7432239991,4420,7432244411,4,0,1,11776,4,2012352752
4196,7432454837,44060,7432498897,7,0,0,1024,7,2747633758
4197,7432471090,50672,7432521762,4,0,0,2560,4,7561519064
4198,7432567240,101660,7432668900,2,0,0,33792,2,1519842900
4199,7432667419,119760,7432787179,2,0,0,52736,2,9316966213
4200,7432679427,1042,7432680469,3,0,1,1024,3,7113215309
4201,7432767194,20000,7432787194,1,0,1,6656,1,8425989324
4202,7432773776,59687,7432833463,6,0,0,512,6,7476865233
4203,7432815053,47444,7432862497,6,0,0,2048,6,8125655963
4204,7432897059,99164,7432996223,0,0,0,25600,0,8209796598
4205,7432906471,566,7432907037,7,0,1,512,7,8333708318
4206,7432931019,130058,7433061077,0,0,0,25600,0,9053574631
4207,7432939215,58435,7432997650,7,0,0,4608,7,9052280260
4208,7432972962,106028,7433078990,7,0,0,48128,7,8633177656
4209,7432992286,17114,7433009400,7,0,1,19456,7,5508373819
4210,7433000191,92642,7433092833,6,0,0,512,6,3717596790
4211,7433019597,96314,7433115911,1,0,0,17920,1,2808875508
4212,7433106188,566,7433106754,7,0,1,512,7,4589449659
4213,7433195846,116021,7433311867,2,0,0,44544,2,2346312871
4214,7433196179,166859,7433363038,2,0,0,87552,2,4671757487
4215,7433238219,162316,7433400535,2,0,0,71168,2,7536676602
4216,7433300413,155364,7433455777,0,0,0,19456,0,8554507739
4217,7433305717,57336,7433363053,1,0,1,44544,1,8877188925
4218,7433339485,25095,7433364580,3,0,1,1536,3,9489347316
4219,7433354723,58730,7433413453,3,0,0,1536,3,1610978305
4220,7433380481,91829,7433472310,1,0,1,116224,1,6799017192
4221,7433388555,120516,7433509071,3,0,0,512,3,7829362189
4222,7433401610,162547,7433564157,0,0,0,13824,0,1848406938
4223,7433496330,93237,7433589567,7,0,0,20480,7,3679248653
4224,7433540135,139227,7433679362,1,0,0,67584,1,2495883636
4225,7433546691,2946,7433549637,4,0,1,3072,4,8572448469
4226,7433553234,1994,7433555228,6,0,1,2048,6,5597684582
4227,7433652067,27310,7433679377,1,0,1,25600,1,766223602
4228,7433721063,49786,7433770849,6,0,0,2048,6,7258874398
4229,7433744235,43904,7433788139,6,0,0,512,6,6911909722
4230,7433780656,6278,7433786934,4,0,1,6656,4,112179743
4231,7433826094,47288,7433873382,3,0,0,1536,3,8256531030
4232,7433877412,86696,7433964108,2,0,0,19968,2,5528531365
4233,7433961911,2755,7433964666,7,0,1,512,7,2293073302
4234,7434062034,4374,7434066408,0,0,1,4608,0,10655640140
4235,7434072793,6754,7434079547,3,0,1,7168,3,564181757
4236,7434083142,6278,7434089420,7,0,1,6656,7,10394209001
4237,7434140560,6229,7434146789,6,0,1,15360,6,1480707827
4238,7434294640,111176,7434405816,9,0,0,65024,9,7690155965
4239,7434321062,148732,7434469794,9,0,0,41984,9,881746976
4240,7434486848,5802,7434492650,0,0,1,6144,0,6452057316
4241,7434569936,43904,7434613840,8,0,0,512,8,893862776
4242,7434581903,1994,7434583897,3,0,1,2048,3,3684675556
4243,7434797545,130364,7434927909,7,0,0,128000,7,2827617938
4244,7434810036,119924,7434929960,1,0,0,6656,1,569028223
4245,7434816300,136821,7434953121,1,0,1,226304,1,1681150931
4246,7434841109,133824,7434974933,1,0,1,79872,1,4364910464
4247,7434906635,125786,7435032421,3,0,0,1024,3,7621076781
4248,7434918412,183832,7435102244,6,0,0,1024,6,109128202
4249,7434992885,170901,7435163786,2,0,0,15360,2,5230352741
4250,7435000139,221285,7435221424,3,0,0,512,3,8385260711
4251,7435011252,282673,7435293925,0,0,0,83968,0,2812330506
4252,7435041950,33245,7435075195,1,0,1,57856,1,763076519
4253,7435086323,52291,7435138614,1,0,1,84992,1,2820964007
4254,7435188199,123965,7435312164,9,0,0,6656,9,9702777188
4255,7435200291,93961,7435294252,8,0,0,1024,8,9796866294
4256,7435204169,15579,7435219748,1,0,1,30208,1,6915986855
4257,7435220180,179721,7435399901,3,0,0,512,3,4733466853
4258,7435359021,1994,7435361015,0,0,1,2048,0,3448988964
4259,7435631278,24670,7435655948,1,0,1,44544,1,2816625932
4260,7435765678,1518,7435767196,3,0,1,1536,3,10089321187
4261,7435781832,7230,7435789062,1,0,1,7680,1,7989021358
4262,7435795098,45055,7435840153,3,0,0,512,3,5357519991
4263,7435838654,1518,7435840172,4,0,1,1536,4,5504510339
4264,7435861561,227909,7436089470,2,0,0,174592,2,5669901694
4265,7435906342,192815,7436099157,0,0,0,31744,0,1365379342
4266,7435925939,6278,7435932217,6,0,1,6656,6,4246635454
4267,7436008851,90633,7436099484,3,0,0,1024,3,1046742032
4268,7436126338,48980,7436175318,8,0,0,2048,8,4701701544
4269,7436251818,45596,7436297414,6,0,0,1024,6,8107320470
4270,7436289038,47288,7436336326,3,0,0,1536,3,5405162765
4271,7436356991,43904,7436400895,3,0,0,512,3,7036457917
4272,7436527427,3387,7436530814,3,0,1,9728,3,8487725969
4273,7436581828,155446,7436737274,9,0,0,13312,9,8040868144
4274,7436662140,43904,7436706044,6,0,0,512,6,3335423438
4275,7436800854,111956,7436912810,9,0,0,67584,9,8536638002
4276,7436854641,58340,7436912981,3,0,0,512,3,7496678359
4277,7436928073,106964,7437035037,9,0,0,51200,9,252238251
4278,7436981125,67082,7437048207,6,0,0,2560,6,9314123197
4279,7437023390,17917,7437041307,3,0,1,6656,3,6601869253
4280,7437120116,1518,7437121634,4,0,1,1536,4,280223946
4281,7437141915,7706,7437149621,7,0,1,8192,7,3770747550
4282,7437211026,33850,7437244876,1,0,1,55808,1,3586688494
4283,7437272809,75568,7437348377,6,0,0,2048,6,8569132231
4284,7437395931,59132,7437455063,0,0,0,5120,0,19924832
4285,7437399777,89570,7437489347,1,0,0,11776,1,5887212649
4286,7437415993,2470,7437418463,3,0,1,2560,3,6935465603
4287,7437551322,106340,7437657662,4,0,0,49152,4,7211262083
4288,7437608769,113831,7437722600,9,0,0,34304,9,9842168709
4289,7437625125,102334,7437727459,1,0,0,15872,1,1227916544
4290,7437713774,24401,7437738175,4,0,1,17408,4,6352469405
4291,7437956511,3387,7437959898,0,0,1,9728,0,8374874578
4292,7437989622,77900,7438067522,1,0,0,11264,1,3014509054
4293,7438121537,107432,7438228969,4,0,0,52736,4,652762525
4294,7438344665,49604,7438394269,4,0,0,4096,4,7777785273
4295,7438460788,45596,7438506384,8,0,0,1024,8,193706235
4296,7438552400,111332,7438663732,1,0,0,65536,1,10572753106
4297,7438579504,1518,7438581022,7,0,1,1536,7,967898618
4298,7438601458,62757,7438664215,6,0,0,1536,6,8822029769
4299,7438603798,132774,7438736572,1,0,1,215040,1,7474232335
4300,7438664248,198960,7438863208,2,0,0,56832,2,556286082
4301,7438668697,69821,7438738518,0,0,1,3072,0,5879761438
4302,7438683526,185408,7438868934,2,0,0,4096,2,2915541374
4303,7438751846,5326,7438757172,7,0,1,5632,7,317793503
4304,7438762141,1994,7438764135,0,0,1,2048,0,9113959017
4305,7438821712,5802,7438827514,3,0,1,6144,3,5463786220
4306,7438848087,70215,7438918302,8,0,0,2560,8,901561241
4307,7438873981,98883,7438972864,0,0,0,14848,0,7389844194
4308,7438882495,1994,7438884489,3,0,1,2048,3,645010884
4309,7438886357,12737,7438899094,0,0,1,24576,0,1870182071
4310,7438928250,234230,7439162480,7,0,0,101888,7,2838604564
4311,7439259281,54992,7439314273,7,0,0,6656,7,6313389910
4312,7439298603,3898,7439302501,0,0,1,4096,0,5293098355
4313,7439354829,114920,7439469749,1,0,0,77312,1,3363211154
4314,7439385089,145518,7439530607,0,0,0,44032,0,4560474169
4315,7439395556,197151,7439592707,7,0,0,86528,7,7634518546
4316,7439468222,250437,7439718659,0,0,0,169984,0,9055633337
4317,7439545773,3128,7439548901,3,0,1,9216,3,9853995515
4318,7439600301,148028,7439748329,1,0,0,69632,1,4903650601
4319,7439682258,88703,7439770961,6,0,0,512,6,3199074763
4320,7439709518,121071,7439830589,4,0,0,39936,4,989633597
4321,7439782219,1518,7439783737,3,0,1,1536,3,8722578136
4322,7439785401,3128,7439788529,4,0,1,9216,4,9831247071
4323,7439806270,177230,7439983500,0,0,0,11264,0,3857858486
4324,7439844393,12737,7439857130,1,0,1,24576,1,7004431427
4325,7439846286,70020,7439916306,3,0,0,3584,3,5476857839
4326,7439866901,142579,7440009480,7,0,0,81408,7,4124203976
4327,7439959264,1518,7439960782,3,0,1,1536,3,8507565842
4328,7439999666,72946,7440072612,7,0,0,8192,7,9749916280
4329,7440083654,112580,7440196234,9,0,0,69632,9,2586455522
4330,7440092225,104795,7440197020,6,0,0,512,6,10237828605
4331,7440131956,109773,7440241729,4,0,0,12288,4,10585440326
4332,7440167714,28535,7440196249,7,0,1,16384,7,1908334937
4333,7440185887,79638,7440265525,1,0,0,8192,1,9223405547
4334,7440272098,68528,7440340626,0,0,0,10752,0,2445071632
4335,7440457191,45596,7440502787,8,0,0,1024,8,3164991951
4336,7440469694,107588,7440577282,7,0,0,53248,7,1789863322
4337,7440470037,128425,7440598462,2,0,0,16896,2,5725705618
4338,7440571002,10646,7440581648,0,0,1,4608,0,4405287236
4339,7440581938,1042,7440582980,3,0,1,1024,3,401599423
4340,7440586578,115573,7440702151,1,0,0,53760,1,4769348114
4341,7440799036,566,7440799602,7,0,1,512,7,1775016271
4342,7440838741,87008,7440925749,2,0,0,20992,2,4533017093
4343,7440916137,2470,7440918607,7,0,1,2560,7,1243406845
4344,7440936449,187417,7441123866,2,0,0,34816,2,2837884617
4345,7440956475,61684,7441018159,8,0,0,1024,8,3985727430
4346,7440976244,86540,7441062784,0,0,0,19456,0,7244274564
4347,7441041621,115905,7441157526,7,0,0,39424,7,135711656
4348,7441148961,94917,7441243878,0,0,0,13824,0,4419302948
4349,7441299652,111020,7441410672,1,0,0,64512,1,5888890538
4350,7441349890,125912,7441475802,9,0,0,90624,9,5778156325
4351,7441471609,65213,7441536822,4,0,0,5632,4,8612792560
4352,7441471799,7918,7441479717,4,0,1,4096,4,6039267040
4353,7441482727,52364,7441535091,9,0,0,3072,9,5908296919
4354,7441508376,25187,7441533563,1,0,1,45568,1,3526529608
4355,7441529150,7687,7441536837,1,0,1,14848,1,4452035933
4356,7441595597,75700,7441671297,2,0,0,1024,2,3545196202
4357,7441640319,120078,7441760397,1,0,0,36352,1,2019281432
4358,7441664312,2946,7441667258,4,0,1,3072,4,6514943166
4359,7441742306,4937,7441747243,3,0,1,12800,3,2343349607
4360,7441782832,14117,7441796949,1,0,1,24064,1,3941328167
4361,7441984075,47288,7442031363,0,0,0,1536,0,993912805
4362,7442003035,22950,7442025985,1,0,1,37888,1,1841913808
4363,7442044677,65487,7442110164,9,0,0,2560,9,10396052440
4364,7442129591,99476,7442229067,1,0,0,26624,1,2721881105
4365,7442131716,16613,7442148329,1,0,1,32256,1,6123394918
4366,7442194383,2470,7442196853,6,0,1,2560,6,6571875716
4367,7442284952,43904,7442328856,6,0,0,512,6,7159257649
4368,7442298300,101674,7442399974,1,0,0,26112,1,3892406307
4369,7442313582,1518,7442315100,0,0,1,1536,0,3483978108
4370,7442358332,1042,7442359374,1,0,1,1024,1,3634348107
4371,7442400710,96872,7442497582,4,0,0,28160,4,8613662718
4372,7442460301,11533,7442471834,3,0,1,18944,3,4111031958
4373,7442487216,10389,7442497605,1,0,1,16384,1,10482174006
4374,7442487992,17288,7442505280,6,0,1,8192,6,6245826288
4375,7442505048,7706,7442512754,8,0,1,8192,8,10193628481
4376,7442630089,102128,7442732217,4,0,0,35328,4,91566937
4377,7442709638,43904,7442753542,3,0,0,512,3,1326988298
4378,7442729517,48288,7442777805,8,0,0,1024,8,8275914931
4379,7442872953,77012,7442949965,4,0,0,18432,4,7360696588
4380,7442951739,2870,7442954609,6,0,1,8704,6,2647278691
4381,7442972899,105716,7443078615,7,0,0,47104,7,10159183245
4382,7443028107,3422,7443031529,4,0,1,3584,4,1279733510
4383,7443114764,98408,7443213172,2,0,0,28160,2,5042826015
4384,7443131989,101192,7443233181,1,0,0,32256,1,5669288426
4385,7443144595,119366,7443263961,1,0,0,12288,1,4987242242
4386,7443147827,184648,7443332475,7,0,0,39424,7,9929217538
4387,7443167303,2870,7443170173,7,0,1,8704,7,7754960531
4388,7443180648,2870,7443183518,3,0,1,8704,3,6333954634
4389,7443184203,51997,7443236200,6,0,0,2048,6,7284637918
4390,7443229217,325577,7443554794,2,0,0,108544,2,4967147907
4391,7443260179,15790,7443275969,6,0,1,19968,6,10656034106
4392,7443300779,64208,7443364987,1,0,0,6656,1,4274089441
4393,7443313707,76052,7443389759,1,0,0,10240,1,6508387683
4394,7443367451,153464,7443520915,7,0,0,62464,7,2265241746
4395,7443516868,90603,7443607471,9,0,0,24576,9,461061960
4396,7443557395,50247,7443607642,8,0,0,512,8,2816460679
4397,7443578307,1518,7443579825,6,0,1,1536,6,699782091
4398,7443657819,46212,7443704031,1,0,1,79872,1,2315019261
4399,7443691154,78438,7443769592,3,0,0,1024,3,2942204555
4400,7443719768,82734,7443802502,7,0,0,2048,7,1025735599
4401,7443851027,3645,7443854672,8,0,1,10240,8,3288621077
4402,7443917010,1042,7443918052,3,0,1,1024,3,799445902
4403,7443955596,45596,7444001192,1,0,0,1024,1,4513072648
4404,7444066801,101816,7444168617,0,0,0,34304,0,411058974
4405,7444219355,98096,7444317451,1,0,0,27136,1,2351215113
4406,7444265588,52190,7444317778,6,0,0,1024,6,880998011
4407,7444531996,4937,7444536933,7,0,1,12800,7,8805228305
4408,7444544381,5802,7444550183,4,0,1,6144,4,1817341121
4409,7444546646,8683,7444555329,8,0,1,8192,8,9154044501
4410,7444559344,65900,7444625244,1,0,0,7168,1,9557463654
4411,7444585872,60726,7444646598,3,0,0,512,3,9096695888
4412,7444659244,48980,7444708224,9,0,0,2048,9,7424688119
4413,7444674302,121293,7444795595,1,0,0,54272,1,1824426499
4414,7444710226,140010,7444850236,0,0,0,44544,0,5009410476
4415,7444756616,1518,7444758134,4,0,1,1536,4,7647592376
4416,7444923962,118508,7445042470,0,0,0,89088,0,5682030103
4417,7444927444,150138,7445077582,2,0,0,43008,2,3780359734
4418,7444983419,566,7444983985,6,0,1,512,6,9750296393
4419,7445149315,43904,7445193219,3,0,0,512,3,3364833993
4420,7445212783,115232,7445328015,4,0,0,78336,4,787821558
4421,7445217055,111131,7445328186,8,0,0,512,8,10156447866
4422,7445264962,2946,7445267908,3,0,1,3072,3,6270617935
4423,7445338581,122408,7445460989,2,0,0,101888,2,2298637226
4424,7445393949,117188,7445511137,7,0,0,37376,7,8071193356
4425,7445475280,59132,7445534412,1,0,0,5120,1,1692934113
4426,7445554002,76052,7445630054,9,0,0,10240,9,10223549692
4427,7445628142,74128,7445702270,7,0,0,12800,7,1917007887
4428,7445630016,2049,7445632065,0,0,1,2048,0,9200238503
4429,7445740062,106652,7445846714,2,0,0,50176,2,6731953853
4430,7445775134,97136,7445872270,2,0,0,18944,2,10473498715
4431,7445798458,135328,7445933786,9,0,0,31232,9,2726297247
4432,7445799113,138136,7445937249,4,0,0,11264,4,2063113843
4433,7445803341,12737,7445816078,3,0,1,24576,3,2393497982
4434,7445807987,160969,7445968956,0,0,0,31744,0,10374317441
4435,7445850420,566,7445850986,3,0,1,512,3,5618308019
4436,7445887542,183711,7446071253,9,0,0,76800,9,9654752533
4437,7445926505,12697,7445939202,8,0,1,2048,8,3044161062
4438,7445927499,104064,7446031563,2,0,0,20992,2,6698974941
4439,7446080416,144836,7446225252,2,0,0,135168,2,4302775435
4440,7446092756,136255,7446229011,7,0,0,12288,7,10434847256
4441,7446096186,135960,7446232146,2,0,0,10240,2,5297073401
4442,7446179879,72668,7446252547,4,0,0,9216,4,5962868675
4443,7446248920,99008,7446347928,0,0,0,25088,0,8823377719
4444,7446321677,105741,7446427418,4,0,0,47104,4,1145923521
4445,7446334407,3422,7446337829,4,0,1,3584,4,1822867714
4446,7446497538,106808,7446604346,0,0,0,50688,0,7076242851
4447,7446512688,100721,7446613409,4,0,0,29696,4,632960362
4448,7446644198,1042,7446645240,0,0,1,1024,0,9823315202
4449,7446663415,2470,7446665885,0,0,1,2560,0,7276120500
4450,7446697875,43904,7446741779,8,0,0,512,8,9875183765
4451,7446754895,566,7446755461,6,0,1,512,6,129071776
4452,7446771273,4850,7446776123,6,0,1,5120,6,3478578712
4453,7446804645,114296,7446918941,4,0,0,75264,4,7425667261
4454,7446808770,155393,7446964163,9,0,0,15872,9,7480637658
4455,7446827622,118691,7446946313,6,0,0,1536,6,5195203517
4456,7446866517,116348,7446982865,3,0,0,512,3,9216919011
4457,7446932730,133037,7447065767,2,0,0,49664,2,1014980360
4458,7447035972,1042,7447037014,3,0,1,1024,3,566702284
4459,7447122672,117416,7447240088,1,0,0,85504,1,6698019424
4460,7447173044,566,7447173610,7,0,1,512,7,10013732546
4461,7447173768,82892,7447256660,6,0,0,1536,6,6510743378
4462,7447425317,87920,7447513237,7,0,0,18944,7,9440165250
4463,7447521084,4374,7447525458,8,0,1,4608,8,2156102394
4464,7447540882,43904,7447584786,3,0,0,512,3,2153483253
4465,7447583005,105569,7447688574,9,0,0,41472,9,5656789826
4466,7447591467,119709,7447711176,1,0,0,38912,1,1532914067
4467,7447597187,2470,7447599657,7,0,1,2560,7,5731396125
4468,7447680088,114974,7447795062,4,0,0,49664,4,6653057041
4469,7447682422,11971,7447694393,1,0,1,6144,1,4642635972
4470,7447802843,3898,7447806741,4,0,1,4096,4,7781868148
4471,7447839535,104156,7447943691,1,0,0,41984,1,8498912348
4472,7448077346,6278,7448083624,6,0,1,6656,6,2684572396
4473,7448093648,1042,7448094690,8,0,1,1024,8,3014191126
4474,7448096739,2946,7448099685,8,0,1,3072,8,304065855
4475,7448129997,3904,7448133901,4,0,1,10752,4,7971035709
4476,7448175496,100568,7448276064,1,0,0,30208,1,2221588636
4477,7448313777,118123,7448431900,7,0,0,84480,7,4828775949
4478,7448333070,6278,7448339348,8,0,1,6656,8,1146162950
4479,7448378126,110458,7448488584,4,0,0,54784,4,9900105145
4480,7448502446,6278,7448508724,4,0,1,6656,4,4946017941
4481,7448510473,2470,7448512943,7,0,1,2560,7,6116902375
4482,7448553607,128823,7448682430,2,0,0,8192,2,8671370385
4483,7448571078,43887,7448614965,1,0,1,75264,1,4542416511
4484,7448588421,91498,7448679919,9,0,0,9728,9,5842160954
4485,7448588888,31466,7448620354,1,0,1,17408,1,3872479538
4486,7448749451,43904,7448793355,8,0,0,512,8,8710781008
4487,7448752576,45596,7448798172,8,0,0,1024,8,6952984978
4488,7448839878,3422,7448843300,0,0,1,3584,0,1858599347
4489,7448889266,98384,7448987650,1,0,0,23040,1,3577110422
4490,7448913338,12825,7448926163,3,0,1,21504,3,4127001847
4491,7448966671,48980,7449015651,3,0,0,2048,3,9877868875
4492,7449171288,45596,7449216884,6,0,0,1024,6,6471826628
4493,7449187283,111020,7449298303,7,0,0,64512,7,6602250539
4494,7449207404,25187,7449232591,1,0,1,45568,1,7600072058
4495,7449220793,79865,7449300658,2,0,0,7680,2,2598967313
4496,7449235873,65112,7449300985,6,0,0,1024,6,2587901181
4497,7449432965,43904,7449476869,8,0,0,512,8,3519265749
4498,7449557961,4850,7449562811,3,0,1,5120,3,453262642
4499,7449583011,5326,7449588337,3,0,1,5632,3,7540602788
4500,7449619710,43904,7449663614,3,0,0,512,3,9422784365
4501,7449717659,43904,7449761563,6,0,0,512,6,9729706095
4502,7449876670,79016,7449955686,7,0,0,19968,7,4004393259
4503,7449963578,566,7449964144,3,0,1,512,3,2684074153
4504,7449990422,43904,7450034326,8,0,0,512,8,8935440975
4505,7450001524,42941,7450044465,1,0,1,70144,1,9378757414
4506,7450005604,41447,7450047051,0,0,1,4096,0,4936829056
4507,7450011842,188599,7450200441,0,0,0,120320,0,1032268748
4508,7450041901,12737,7450054638,4,0,1,24576,4,1009673713
4509,7450126721,73743,7450200464,1,0,1,92160,1,10716855105
4510,7450177564,248062,7450425626,9,0,0,94208,9,5059363777
4511,7450221552,70532,7450292084,2,0,0,12288,2,3541271863
4512,7450228763,3422,7450232185,8,0,1,3584,8,3462373696
4513,7450256417,103877,7450360294,1,0,0,4096,1,7760304620
4514,7450299648,136269,7450435917,7,0,0,9728,7,9250672173
4515,7450490495,6278,7450496773,4,0,1,6656,4,5417199813
4516,7450575804,107276,7450683080,0,0,0,52224,0,10497905074
4517,7450638755,120027,7450758782,0,0,0,72704,0,8497468853
4518,7450665576,96284,7450761860,2,0,0,1024,2,3043062444
4519,7450692487,102769,7450795256,2,0,0,14848,2,6711707880
4520,7450772015,14804,7450786819,1,0,1,28672,1,5396105453
4521,7450832760,1994,7450834754,3,0,1,2048,3,10175987766
4522,7450848733,2870,7450851603,0,0,1,8704,0,6606646755
4523,7451041138,64832,7451105970,9,0,0,8704,9,7506822320
4524,7451141347,6278,7451147625,4,0,1,6656,4,7484144321
4525,7451154527,4162,7451158689,6,0,1,11264,6,4234274515
4526,7451252231,105716,7451357947,0,0,0,47104,0,793904145
4527,7451304842,103688,7451408530,4,0,0,40448,4,9788373610
4528,7451345263,151455,7451496718,1,0,0,30208,1,4008215955
4529,7451374414,50672,7451425086,3,0,0,2560,3,2282786547
4530,7451387140,64208,7451451348,4,0,0,6656,4,1547704422
4531,7451440768,103688,7451544456,2,0,0,40448,2,7604190747
4532,7451512195,132401,7451644596,9,0,0,130560,9,7320343200
4533,7451512508,2946,7451515454,4,0,1,3072,4,6568951914
4534,7451591547,115020,7451706567,4,0,0,38400,4,4043166114
4535,7451605032,198087,7451803119,0,0,0,75776,0,10348433153
4536,7451762274,3422,7451765696,8,0,1,3584,8,235342680
4537,7451783041,20636,7451803677,8,0,1,512,8,715033593
4538,7451803657,6766,7451810423,7,0,1,7168,7,8646041039
4539,7451824460,3422,7451827882,3,0,1,3584,3,734154839
4540,7451833968,6278,7451840246,3,0,1,6656,3,9574853551
4541,7451876267,97784,7451974051,0,0,0,26112,0,3736338443
4542,7451918928,149707,7452068635,7,0,0,36864,7,9232343891
4543,7451958973,52506,7452011479,6,0,0,512,6,5778585360
4544,7452039682,4850,7452044532,4,0,1,5120,4,9945768419
4545,7452065016,107767,7452172783,9,0,0,41984,9,635023231
4546,7452171772,101103,7452272875,7,0,0,28672,7,3923477109
4547,7452218964,96536,7452315500,0,0,0,22016,0,10568200764
4548,7452269087,83708,7452352795,4,0,0,17920,4,8998451342
4549,7452291979,64676,7452356655,2,0,0,8192,2,3201520988
4550,7452297271,75296,7452372567,1,0,0,12800,1,5304191051
4551,7452297658,566,7452298224,3,0,1,512,3,4736502238
4552,7452317927,147475,7452465402,8,0,0,1536,8,5444533744
4553,7452370768,2357,7452373125,6,0,1,512,6,1943843857
4554,7452451024,43904,7452494928,6,0,0,512,6,8786151023
4555,7452483444,1994,7452485438,4,0,1,2048,4,4174218883
4556,7452549265,103844,7452653109,2,0,0,40960,2,7207605562
4557,7452643661,13860,7452657521,6,0,1,11776,6,6336402402
4558,7452755056,48315,7452803371,6,0,0,1024,6,7687983155
4559,7452757611,566,7452758177,6,0,1,512,6,5207083613
4560,7452760125,274114,7453034239,9,0,0,69120,9,4329670134
4561,7452776645,97568,7452874213,3,0,0,512,3,867878178
4562,7452853532,5196,7452858728,7,0,1,13312,7,3289185346
4563,7453052331,1518,7453053849,7,0,1,1536,7,6798162570
4564,7453094763,82924,7453177687,1,0,1,134656,1,483447724
4565,7453101107,77860,7453178967,3,0,1,14336,3,1488446120
4566,7453148066,142782,7453290848,7,0,0,41472,7,7154765150
4567,7453154077,25876,7453179953,0,0,1,1536,0,4983603860
4568,7453273714,17149,7453290863,0,0,1,7168,0,2900448223
4569,7453315931,12825,7453328756,1,0,1,21504,1,6082591209
4570,7453370161,7230,7453377391,9,0,1,7680,9,6055641405
4571,7453493139,52364,7453545503,4,0,0,3072,4,9551593282
4572,7453503685,116168,7453619853,9,0,0,81408,9,3262478001
4573,7453522222,97802,7453620024,8,0,0,512,8,9632854992
4574,7453597051,150677,7453747728,2,0,0,119296,2,1669122936
4575,7453774660,3422,7453778082,6,0,1,3584,6,2234817116
4576,7453823943,4679,7453828622,7,0,1,12288,7,7418282565
4577,7453868691,3387,7453872078,4,0,1,9728,4,4715920582
4578,7453947045,1042,7453948087,6,0,1,1024,6,6604899309
4579,7454021653,1042,7454022695,8,0,1,1024,8,4098094732
4580,7454074742,1042,7454075784,8,0,1,1024,8,7470496266
4581,7454134938,44060,7454178998,8,0,0,1024,8,10026448346
4582,7454233568,45596,7454279164,9,0,0,1024,9,6156921289
4583,7454346444,66056,7454412500,2,0,0,7680,2,9652349659
4584,7454361983,4162,7454366145,9,0,1,11264,9,6564082082
4585,7454423716,117104,7454540820,1,0,0,84480,1,1080116029
4586,7454585096,3898,7454588994,9,0,1,4096,9,3742185297
4587,7454593402,2946,7454596348,4,0,1,3072,4,912993948
4588,7454598388,48980,7454647368,3,0,0,2048,3,5683534201
4589,7454630202,4850,7454635052,9,0,1,5120,9,10177159486
4590,7454640660,2946,7454643606,7,0,1,3072,7,580639014
4591,7454662709,13083,7454675792,6,0,1,22016,6,4144767801
4592,7454687596,54087,7454741683,8,0,0,512,8,4978318502
4593,7454758163,64208,7454822371,4,0,0,6656,4,9725282948
4594,7454887186,1518,7454888704,4,0,1,1536,4,167419060
4595,7455040428,104468,7455144896,9,0,0,43008,9,10012616574
4596,7455101333,6488,7455107821,9,0,1,15872,9,379230632
4597,7455213814,105404,7455319218,0,0,0,46080,0,6115086676
4598,7455277325,49448,7455326773,3,0,0,3584,3,6611136313
4599,7455349616,566,7455350182,0,0,1,512,0,7181038745
4600,7455375152,99944,7455475096,7,0,0,28160,7,7033433510
4601,7455568058,4420,7455572478,8,0,1,11776,8,2397781820
4602,7455570611,2213,7455572824,3,0,1,512,3,4899503268
4603,7455601635,1042,7455602677,9,0,1,1024,9,1414946882
4604,7455668085,2946,7455671031,0,0,1,3072,0,7763316175
4605,7455747441,100724,7455848165,4,0,0,30720,4,8289149192
4606,7455758090,3387,7455761477,4,0,1,9728,4,4984205682
4607,7455987796,31783,7456019579,1,0,1,51712,1,4282586902
4608,7455989306,33499,7456022805,1,0,1,5120,1,1487128622
4609,7456058625,3128,7456061753,7,0,1,9216,7,615502928
4610,7456142343,6278,7456148621,9,0,1,6656,9,886060170
4611,7456152338,5196,7456157534,9,0,1,13312,9,2500574858
4612,7456196163,2470,7456198633,4,0,1,2560,4,9647174010
4613,7456253069,47288,7456300357,6,0,0,1536,6,1442485450
4614,7456276849,4374,7456281223,7,0,1,4608,7,6724353224
4615,7456355543,117728,7456473271,4,0,0,86528,4,3073688415
4616,7456406179,2946,7456409125,9,0,1,3072,9,7021588020
4617,7456457959,122424,7456580383,0,0,0,51712,0,3371089416
4618,7456484346,3898,7456488244,9,0,1,4096,9,5353304996
4619,7456574266,10030,7456584296,0,0,1,10752,0,4824635329
4620,7456580049,126330,7456706379,0,0,0,62464,0,10223332273
4621,7456648369,61382,7456709751,1,0,1,99328,1,6231427698
4622,7456654442,244492,7456898934,0,0,0,71680,0,5351770893
4623,7456692485,28173,7456720658,6,0,1,27648,6,7816631817
4624,7456719406,5326,7456724732,0,0,1,5632,0,5101701750
4625,7456816158,136126,7456952284,7,0,0,35840,7,1925194212
4626,7456819738,3898,7456823636,3,0,1,4096,3,6049695937
4627,7456990065,48980,7457039045,9,0,0,2048,9,10010077356
4628,7457046469,3422,7457049891,7,0,1,3584,7,2087935119
4629,7457046599,71987,7457118586,4,0,0,8704,4,9031269916
4630,7457230265,83132,7457313397,2,0,0,13312,2,7725197851
4631,7457342146,5802,7457347948,8,0,1,6144,8,407897340
4632,7457366972,11274,7457378246,7,0,1,18432,7,806764022
4633,7457740107,115544,7457855651,0,0,0,79360,0,7377004316
4634,7457747885,107953,7457855838,6,0,0,512,6,7142601065
4635,7457831800,81283,7457913083,9,0,0,4608,9,4880360564
4636,7457832419,67153,7457899572,3,0,0,512,3,4780239411
4637,7457876521,77300,7457953821,9,0,0,14336,9,5441486838
4638,7458012900,106964,7458119864,2,0,0,51200,2,10666499297
4639,7458016370,43904,7458060274,8,0,0,512,8,4759519874
4640,7458113469,119356,7458232825,7,0,0,27648,7,1706369790
4641,7458130670,7230,7458137900,9,0,1,7680,9,6628892944
4642,7458190494,97604,7458288098,9,0,0,20480,9,4597442108
4643,7458221931,43904,7458265835,3,0,0,512,3,10696115171
4644,7458247782,60380,7458308162,9,0,0,9216,9,8359174420
4645,7458353367,4850,7458358217,9,0,1,5120,9,1701509998
4646,7458360123,107405,7458467528,4,0,0,28160,4,4301762721
4647,7458443779,43904,7458487683,3,0,0,512,3,323517270
4648,7458459971,32219,7458492190,4,0,1,44544,4,9067251571
4649,7458497429,187003,7458684432,6,0,0,1024,6,8398372737
4650,7458504036,51516,7458555552,1,0,1,83456,1,3640131070
4651,7458537423,20075,7458557498,4,0,1,3072,4,2961715837
4652,7458544643,126703,7458671346,9,0,0,34816,9,6080335237
4653,7458569547,4374,7458573921,6,0,1,4608,6,8567376722
4654,7458588052,2470,7458590522,9,0,1,2560,9,6127611111
4655,7458715335,3422,7458718757,8,0,1,3584,8,146080674
4656,7458778350,3422,7458781772,6,0,1,3584,6,10475901468
4657,7458834473,43904,7458878377,3,0,0,512,3,699896373
4658,7458978333,54992,7459033325,7,0,0,6656,7,9778066773
4659,7459012222,43904,7459056126,6,0,0,512,6,5041184952
4660,7459037748,5802,7459043550,4,0,1,6144,4,8050793809
4661,7459115166,1518,7459116684,4,0,1,1536,4,10032449852
4662,7459376553,2870,7459379423,3,0,1,8704,3,99882199
4663,7459414611,128180,7459542791,2,0,0,120832,2,6409386072
4664,7459514193,136022,7459650215,0,0,0,52736,0,3528948727
4665,7459586313,3422,7459589735,0,0,1,3584,0,9561219315
4666,7459642935,123541,7459766476,0,0,0,53760,0,2775940982
4667,7459656852,5802,7459662654,6,0,1,6144,6,4834510533
4668,7459748594,17897,7459766491,5,0,1,3072,5,9744389298
4669,7459767247,43904,7459811151,6,0,0,512,6,5318144182
4670,7459780988,132853,7459913841,0,0,0,109568,0,7748992316
4671,7459816251,138293,7459954544,6,0,0,1024,6,5988867765
4672,7459844754,95134,7459939888,4,0,0,7680,4,9639332131
4673,7459916630,43904,7459960534,8,0,0,512,8,1260678834
4674,7459941304,60824,7460002128,7,0,0,5632,7,3940600915
4675,7459941669,119283,7460060952,0,0,0,37376,0,1385947159
4676,7459964675,172363,7460137038,7,0,0,74240,7,8692730568
4677,7460004458,199947,7460204405,7,0,0,106496,7,3998236800
4678,7460093953,123415,7460217368,0,0,0,42496,0,9919970130
4679,7460291758,43904,7460335662,6,0,0,512,6,10464213794
4680,7460323605,97916,7460421521,9,0,0,21504,9,8400551322
4681,7460379859,101972,7460481831,1,0,0,34816,1,5398504213
4682,7460486742,45596,7460532338,6,0,0,1024,6,2920868521
4683,7460488582,85784,7460574366,2,0,0,22016,2,10412670307
4684,7460589738,97448,7460687186,2,0,0,19968,2,10518823128
4685,7460602963,32299,7460635262,1,0,1,52736,1,430082052
4686,7460634348,92628,7460726976,2,0,0,17920,2,5230314435
4687,7460638072,107450,7460745522,3,0,0,2048,3,6436061659
4688,7460668400,61450,7460729850,8,0,0,1024,8,9758120852
4689,7460740738,122876,7460863614,1,0,0,103424,1,934249139
4690,7460769253,110081,7460879334,6,0,0,1536,6,10289952753
4691,7460782141,82268,7460864409,8,0,0,2560,8,9006430587
4692,7460827999,97448,7460925447,2,0,0,19968,2,73647102
4693,7460901014,102284,7461003298,4,0,0,35840,4,2094456058
4694,7460953998,6278,7460960276,5,0,1,6656,5,6652314906
4695,7461002828,44366,7461047194,8,0,0,512,8,5828955115
4696,7461181973,79502,7461261475,2,0,0,32768,2,9351330399
4697,7461206718,88621,7461295339,3,0,0,512,3,5862108899
4698,7461330146,4374,7461334520,0,0,1,4608,0,4421325889
4699,7461392001,52364,7461444365,4,0,0,3072,4,5823875734
4700,7461566352,45596,7461611948,8,0,0,1024,8,7904376752
4701,7461615570,43904,7461659474,8,0,0,512,8,9660029915
4702,7461654874,1042,7461655916,3,0,1,1024,3,3819744538
4703,7461656586,43904,7461700490,3,0,0,512,3,9604504490
4704,7461682398,14029,7461696427,4,0,1,27136,4,7999677982
4705,7461684389,14944,7461699333,9,0,1,4608,9,7510770967
4706,7461738969,6754,7461745723,8,0,1,7168,8,3919944416
4707,7461741580,5129,7461746709,3,0,1,1536,3,3535463646
4708,7461753953,63129,7461817082,0,0,0,3584,0,21939181
4709,7461853561,50672,7461904233,6,0,0,2560,6,10508929896
4710,7461872383,45596,7461917979,8,0,0,1024,8,2100096689
4711,7461891366,43904,7461935270,8,0,0,512,8,7742883757
4712,7462008175,3387,7462011562,6,0,1,9728,6,4532524070
4713,7462116864,45596,7462162460,3,0,0,1024,3,402819466
4714,7462496983,2470,7462499453,5,0,1,2560,5,9992375285
4715,7462516674,1518,7462518192,0,0,1,1536,0,9115455802
4716,7462533201,6754,7462539955,9,0,1,7168,9,7954914519
4717,7462678473,1518,7462679991,8,0,1,1536,8,4548821645
4718,7462727579,10241,7462737820,5,0,1,16384,5,6708344550
4719,7462747493,13858,7462761351,1,0,1,23552,1,10052225190
4720,7462844634,1042,7462845676,9,0,1,1024,9,3018409644
4721,7462858789,5802,7462864591,0,0,1,6144,0,383323526
4722,7462929049,6229,7462935278,1,0,1,15360,1,7614802608
4723,7463040047,92681,7463132728,6,0,0,2560,6,1637758572
4724,7463127229,7230,7463134459,8,0,1,7680,8,9943368001
4725,7463211221,109928,7463321149,4,0,0,60928,4,3524896567
4726,7463383683,45596,7463429279,6,0,0,1024,6,7898317549
4727,7463401019,88256,7463489275,7,0,0,25088,7,4612230534
4728,7463419621,1994,7463421615,4,0,1,2048,4,8110806832
4729,7463508155,43904,7463552059,6,0,0,512,6,1208532762
4730,7463570811,3128,7463573939,6,0,1,9216,6,10686084004
4731,7463573271,6675,7463579946,6,0,1,6656,6,2645839996
4732,7463672266,1518,7463673784,8,0,1,1536,8,8391635407
4733,7463831924,47288,7463879212,8,0,0,1536,8,7221242662
4734,7463872578,1042,7463873620,3,0,1,1024,3,2081565602
4735,7463966920,69596,7464036516,0,0,0,9216,0,3834100765
4736,7464034638,2436,7464037074,0,0,1,512,0,2147100583
4737,7464041576,101972,7464143548,7,0,0,34816,7,5097958347
4738,7464132628,54270,7464186898,1,0,1,92160,1,2554031229
4739,7464137757,49487,7464187244,6,0,1,512,6,4756483709
4740,7464175725,14105,7464189830,8,0,1,4096,8,8773825107
4741,7464310524,4162,7464314686,5,0,1,11264,5,4767143222
4742,7464436915,66212,7464503127,9,0,0,8192,9,4704433404
4743,7464452789,22862,7464475651,1,0,1,40960,1,9869504451
4744,7464517688,202818,7464720506,7,0,0,38400,7,1096455164
4745,7464559267,64832,7464624099,2,0,0,8704,2,4130310778
4746,7464567349,76256,7464643605,6,0,0,1024,6,10557575546
4747,7464604921,2946,7464607867,3,0,1,3072,3,8471717175
4748,7464620715,88076,7464708791,4,0,0,19456,4,8658845872
4749,7464663868,35571,7464699439,1,0,1,62464,1,6266734338
4750,7464750532,2470,7464753002,3,0,1,2560,3,640321835
4751,7464886358,1518,7464887876,0,0,1,1536,0,4046174644
4752,7464900241,95267,7464995508,7,0,0,15360,7,9124763736
4753,7464903990,109785,7465013775,7,0,0,59904,7,5865209496
4754,7464969531,7230,7464976761,0,0,1,7680,0,10035406518
4755,7464983097,1518,7464984615,9,0,1,1536,9,1862469440
4756,7465016260,6278,7465022538,9,0,1,6656,9,2233182698
4757,7465039688,73141,7465112829,0,0,0,9216,0,3908652877
4758,7465071700,44662,7465116362,1,0,1,76800,1,10476498315
4759,7465079275,37753,7465117028,5,0,1,11264,5,10252598304
4760,7465095780,22234,7465118014,3,0,1,1536,3,3199564033
4761,7465311587,190592,7465502179,0,0,0,164352,0,3945771110
4762,7465399896,48595,7465448491,6,0,0,1024,6,2220955629
4763,7465431793,75089,7465506882,9,0,0,15360,9,866315376
4764,7465466655,79576,7465546231,6,0,0,1024,6,134778239
4765,7465541017,113360,7465654377,7,0,0,72192,7,7178979293
4766,7465746230,45752,7465791982,8,0,0,1536,8,7223566748
4767,7465768458,105622,7465874080,1,0,0,43008,1,5141716844
4768,7465822020,3904,7465825924,8,0,1,10752,8,10193069267
4769,7465979973,78860,7466058833,1,0,0,19456,1,3467531181
4770,7466083834,48980,7466132814,8,0,0,2048,8,4519885653
4771,7466106865,6278,7466113143,3,0,1,6656,3,8041759890
4772,7466126114,120719,7466246833,7,0,0,91648,7,1319175772
4773,7466213916,47288,7466261204,8,0,0,1536,8,260233318
4774,7466318775,43904,7466362679,6,0,0,512,6,7267712290
4775,7466335103,120348,7466455451,4,0,0,63488,4,5307700993
4776,7466344743,138592,7466483335,7,0,0,40448,7,6577244629
4777,7466381850,77795,7466459645,4,0,0,512,4,2116355893
4778,7466520781,114608,7466635389,0,0,0,76288,0,6354134377
4779,7466523212,1518,7466524730,4,0,1,1536,4,2411043110
4780,7466570144,112303,7466682447,3,0,0,512,3,1058411004
4781,7466603049,58020,7466661069,9,0,0,2048,9,2373480160
4782,7466694109,77768,7466771877,9,0,0,15872,9,8197867569
4783,7466756691,59132,7466815823,0,0,0,5120,0,6416996445
4784,7467039560,3422,7467042982,9,0,1,3584,9,485048772
4785,7467107530,50741,7467158271,1,0,1,81920,1,832264715
4786,7467329506,3422,7467332928,0,0,1,3584,0,6220347909
4787,7467379430,4374,7467383804,3,0,1,4608,3,8253690936
4788,7467421254,2470,7467423724,5,0,1,2560,5,5477677467
4789,7467436024,71445,7467507469,4,0,0,512,4,5684146021
4790,7467460529,1994,7467462523,3,0,1,2048,3,3143317410
4791,7467654423,48980,7467703403,7,0,0,2048,7,5498907312
4792,7467704196,100568,7467804764,2,0,0,30208,2,9187425240
4793,7467767445,1042,7467768487,3,0,1,1024,3,9313156616
4794,7467767677,1796,7467769473,6,0,1,1536,6,7374703692
4795,7467831745,1042,7467832787,0,0,1,1024,0,4339262257
4796,7467839510,45596,7467885106,4,0,0,1024,4,1227750124
4797,7467948510,108056,7468056566,9,0,0,54784,9,10232312265
4798,7468048006,63388,7468111394,9,0,0,6144,9,6117173560
4799,7468209448,5454,7468214902,5,0,1,13824,5,9127800247
4800,7468301185,43904,7468345089,3,0,0,512,3,1784767875
4801,7468455434,6754,7468462188,8,0,1,7168,8,6489261972
4802,7468517604,43904,7468561508,8,0,0,512,8,7175943516
4803,7468557831,2946,7468560777,0,0,1,3072,0,6718854724
4804,7468598892,45596,7468644488,8,0,0,1024,8,10663256265
4805,7468637240,566,7468637806,8,0,1,512,8,2585350248
4806,7468704018,54056,7468758074,0,0,0,3584,0,7431764944
4807,7468807856,5454,7468813310,0,0,1,13824,0,7073704978
4808,7468997448,47288,7469044736,8,0,0,1536,8,6390151766
4809,7469021889,6754,7469028643,9,0,1,7168,9,8984073499
4810,7469030754,1994,7469032748,1,0,1,2048,1,3910769310
4811,7469030783,46224,7469077007,4,0,0,1024,4,8482252274
4812,7469039459,124748,7469164207,9,0,0,109568,9,2149447500
4813,7469134259,127388,7469261647,7,0,0,19968,7,2214414617
4814,7469185967,147794,7469333761,7,0,0,28672,7,4882369290
4815,7469261342,44201,7469305543,6,0,0,512,6,219316549
4816,7469501791,45596,7469547387,3,0,0,1024,3,7755176428
4817,7469568584,3128,7469571712,8,0,1,9216,8,3097631197
4818,7469609295,47288,7469656583,8,0,0,1536,8,6959593591
4819,7469667835,43904,7469711739,7,0,0,512,7,7215794602
4820,7469670551,74516,7469745067,9,0,0,10240,9,832550399
4821,7469786972,99476,7469886448,0,0,0,26624,0,2730324882
4822,7469803640,2946,7469806586,3,0,1,3072,3,3269235154
4823,7469852201,13341,7469865542,4,0,1,22528,4,4821356365
4824,7469858132,8716,7469866848,7,0,1,2048,7,5867833960
4825,7469872983,13480,7469886463,6,0,1,7168,6,4662011877
4826,7469962703,10757,7469973460,7,0,1,17408,7,8674112016
4827,7470017802,3645,7470021447,3,0,1,10240,3,4231793520
4828,7470097574,79436,7470177010,7,0,0,11264,7,4330015904
4829,7470144687,45596,7470190283,4,0,0,1024,4,2843631243
4830,7470199322,3422,7470202744,6,0,1,3584,6,2651540043
4831,7470440222,3904,7470444126,4,0,1,10752,4,8973637918
4832,7470451897,70220,7470522117,9,0,0,11264,9,195043962
4833,7470529199,6754,7470535953,6,0,1,7168,6,1084057756
4834,7470615205,4850,7470620055,7,0,1,5120,7,3134082328
4835,7470615366,157496,7470772862,1,0,0,86528,1,9695208575
4836,7470653925,90727,7470744652,0,0,0,7680,0,2034827223
4837,7470684896,92798,7470777694,0,0,0,4096,0,5338512722
4838,7470780731,43904,7470824635,8,0,0,512,8,8907339367
4839,7470797957,84236,7470882193,9,0,0,16896,9,7066795368
4840,7470862668,1042,7470863710,4,0,1,1024,4,9792002741
4841,7470971048,48980,7471020028,6,0,0,2048,6,5383695969
4842,7471127055,7706,7471134761,0,0,1,8192,0,10014355731
4843,7471228472,43904,7471272376,6,0,0,512,6,122282675
4844,7471374729,4374,7471379103,7,0,1,4608,7,6663651089
4845,7471450204,45596,7471495800,4,0,0,1024,4,5074596470
4846,7471475256,3422,7471478678,5,0,1,3584,5,6031938137
4847,7471518768,116636,7471635404,7,0,0,82944,7,7866831532
4848,7471546499,141207,7471687706,7,0,0,26624,7,7317725967
4849,7471591129,109540,7471700669,7,0,0,42496,7,8182913194
4850,7471682887,18357,7471701244,4,0,1,512,4,2405144433
4851,7471692220,109502,7471801722,7,0,0,31744,7,5796631356
4852,7471738801,1042,7471739843,4,0,1,1024,4,3532229070
4853,7471743145,107129,7471850274,1,0,0,48640,1,7081363085
4854,7471854463,107120,7471961583,1,0,0,51712,1,7153540172
4855,7471898471,140530,7472039001,7,0,0,77824,7,8020597793
4856,7471928633,4850,7471933483,7,0,1,5120,7,1102994011
4857,7471967443,91694,7472059137,4,0,0,512,4,5955992278
4858,7471986511,1042,7471987553,6,0,1,1024,6,10596796452
4859,7472060385,2870,7472063255,3,0,1,8704,3,8754302903
4860,7472092034,56840,7472148874,0,0,0,7680,0,5334710007
4861,7472098428,65206,7472163634,0,0,0,10752,0,5736226003
4862,7472153283,3422,7472156705,3,0,1,3584,3,9826299442
4863,7472295719,43904,7472339623,3,0,0,512,3,7813834376
4864,7472316792,44677,7472361469,8,0,0,512,8,9176064291
4865,7472397503,4420,7472401923,7,0,1,11776,7,9220278075
4866,7472544592,45596,7472590188,8,0,0,1024,8,4347451706
4867,7472549616,43904,7472593520,3,0,0,512,3,8865969457
4868,7472575918,105716,7472681634,0,0,0,47104,0,9358918722
4869,7472611002,78282,7472689284,3,0,0,512,3,1445888364
4870,7472752447,3422,7472755869,4,0,1,3584,4,7147230199
4871,7472849435,2946,7472852381,3,0,1,3072,3,844966974
4872,7472865221,50672,7472915893,6,0,0,2560,6,8296330260
4873,7472905635,6754,7472912389,5,0,1,7168,5,10140580981
4874,7473090615,4374,7473094989,9,0,1,4608,9,8975412301
4875,7473210421,78368,7473288789,1,0,0,12800,1,746839868
4876,7473299791,43904,7473343695,3,0,0,512,3,3759906027
4877,7473376636,115076,7473491712,1,0,0,77824,1,4314885774
4878,7473475242,63750,7473538992,0,0,0,1536,0,7139680654
4879,7473480301,139667,7473619968,9,0,0,105984,9,4048483077
4880,7473504486,116121,7473620607,8,0,0,2048,8,9048828848
4881,7473530497,135762,7473666259,9,0,0,39936,9,4031636948
4882,7473536089,2946,7473539035,3,0,1,3072,3,1910868014
4883,7473573580,159957,7473733537,0,0,0,32768,0,1807987395
4884,7473590771,161189,7473751960,2,0,0,60416,2,9527493718
4885,7473647518,133623,7473781141,9,0,0,15360,9,1473662034
4886,7473720621,1518,7473722139,5,0,1,1536,5,8660975685
4887,7473757231,62516,7473819747,8,0,0,6144,8,10009186506
4888,7473762869,1994,7473764863,3,0,1,2048,3,417107510
4889,7473797437,3904,7473801341,4,0,1,10752,4,7977959882
4890,7473810375,3645,7473814020,1,0,1,10240,1,4973198323
4891,7473814157,304809,7474118966,9,0,0,110080,9,3349090851
4892,7473828215,95804,7473924019,1,0,1,159744,1,5946838569
4893,7473844409,81876,7473926285,8,0,1,3584,8,9772223926
4894,7473885986,131783,7474017769,2,0,0,10752,2,8691443661
4895,7473969585,186406,7474155991,9,0,0,15360,9,6812496657
4896,7474149426,6754,7474156180,6,0,1,7168,6,8665009042
4897,7474224082,566,7474224648,3,0,1,512,3,672249778
4898,7474238092,5326,7474243418,3,0,1,5632,3,8205254434
4899,7474292558,4374,7474296932,4,0,1,4608,4,3850114016
4900,7474349635,3422,7474353057,7,0,1,3584,7,1387072992
4901,7474449344,1042,7474450386,3,0,1,1024,3,2620223057
4902,7474510589,4420,7474515009,0,0,1,11776,0,1867779937
4903,7474615262,566,7474615828,6,0,1,512,6,2745938890
4904,7474615462,3427,7474618889,6,0,1,3584,6,10577422194
4905,7474649950,66836,7474716786,7,0,0,10240,7,1901993402
4906,7474872760,43904,7474916664,6,0,0,512,6,816144992
4907,7474914593,10241,7474924834,0,0,1,16384,0,6822161293
4908,7475001948,3422,7475005370,8,0,1,3584,8,9439926311
4909,7475021786,1518,7475023304,7,0,1,1536,7,4398466697
4910,7475038530,566,7475039096,0,0,1,512,0,8194444215
4911,7475183840,101796,7475285636,1,0,0,30720,1,4518713985
4912,7475186448,50672,7475237120,3,0,0,2560,3,6289623278
4913,7475251833,66368,7475318201,1,0,0,8704,1,365923037
4914,7475288012,6229,7475294241,6,0,1,15360,6,8162172525
4915,7475369112,97604,7475466716,2,0,0,20480,2,933829529
4916,7475407697,43904,7475451601,6,0,0,512,6,2165638538
4917,7475457263,53144,7475510407,1,0,0,5632,1,68728219
4918,7475558337,99164,7475657501,2,0,0,25600,2,3242801713
4919,7475576190,104624,7475680814,2,0,0,43520,2,946256551
4920,7475587854,2946,7475590800,6,0,1,3072,6,1513906799
4921,7475639370,2470,7475641840,6,0,1,2560,6,3526426462
4922,7475668351,90199,7475758550,9,0,0,10752,9,10481950918
4923,7475712262,13083,7475725345,7,0,1,22016,7,6427110634
4924,7475767028,2946,7475769974,8,0,1,3072,8,3543685569
4925,7475778063,104936,7475882999,9,0,0,44544,9,2362188838
4926,7475798186,44233,7475842419,1,0,1,72704,1,9448695181
4927,7475968795,3422,7475972217,4,0,1,3584,4,4084501736
4928,7476050949,69284,7476120233,2,0,0,8192,2,399212911
4929,7476077718,47288,7476125006,3,0,0,1536,3,1552693321
4930,7476095072,2946,7476098018,0,0,1,3072,0,9402886343
4931,7476109379,48980,7476158359,4,0,0,2048,4,2207578691
4932,7476121564,1518,7476123082,7,0,1,1536,7,9518927851
4933,7476272393,50672,7476323065,6,0,0,2560,6,7295130392
4934,7476318148,138068,7476456216,9,0,0,133120,9,8221810408
4935,7476385310,75886,7476461196,8,0,0,1024,8,5538848879
4936,7476434230,69266,7476503496,3,0,0,1536,3,9707089247
4937,7476485072,4374,7476489446,5,0,1,4608,5,4835488356
4938,7476505948,47288,7476553236,6,0,0,1536,6,2858160412
4939,7476532014,45596,7476577610,6,0,0,1024,6,3603299081
4940,7476693388,45596,7476738984,1,0,0,1024,1,146744146
4941,7476737223,4374,7476741597,9,0,1,4608,9,3704876264
4942,7476780533,77744,7476858277,1,0,0,10752,1,1616773826
4943,7476835259,3898,7476839157,0,0,1,4096,0,3518817293
4944,7476862751,5326,7476868077,9,0,1,5632,9,454015241
4945,7476868901,4850,7476873751,7,0,1,5120,7,2912134161
4946,7477293732,13858,7477307590,5,0,1,23552,5,10344970747
4947,7477299211,11925,7477311136,9,0,1,5632,9,7687610947
4948,7477328592,3422,7477332014,4,0,1,3584,4,423644712
4949,7477336774,1042,7477337816,4,0,1,1024,4,511801098
4950,7477364647,50672,7477415319,2,0,0,2560,2,1392910262
4951,7477397879,97916,7477495795,2,0,0,21504,2,10638671066
4952,7477414398,119555,7477533953,8,0,0,1024,8,2531981089
4953,7477428031,5802,7477433833,9,0,1,6144,9,1965449401
4954,7477433467,3422,7477436889,4,0,1,3584,4,389024331
4955,7477475979,80396,7477556375,9,0,0,19456,9,3777806958
4956,7477478571,83870,7477562441,1,0,1,139776,1,1954670694
4957,7477623827,3128,7477626955,0,0,1,9216,0,7809300256
4958,7477772722,3645,7477776367,0,0,1,10240,0,8815329976
4959,7477777384,102128,7477879512,7,0,0,35328,7,5957430516
4960,7477819265,566,7477819831,4,0,1,512,4,5536715286
4961,7477858425,48183,7477906608,2,0,0,1024,2,5737705481
4962,7477942937,5196,7477948133,3,0,1,13312,3,10378629548
4963,7477979932,43904,7478023836,3,0,0,512,3,838525935
4964,7478027765,115700,7478143465,2,0,0,79872,2,5539481504
4965,7478041362,160489,7478201851,7,0,0,43520,7,9046359220
4966,7478353770,65900,7478419670,2,0,0,7168,2,6448342915
4967,7478359739,42683,7478402422,1,0,1,69632,1,3055652642
4968,7478468278,48980,7478517258,6,0,0,2048,6,743199859
4969,7478484722,6278,7478491000,7,0,1,6656,7,295399557
4970,7478545883,101036,7478646919,7,0,0,31744,7,9966124567
4971,7478558105,44662,7478602767,1,0,1,76800,1,8459936150
4972,7479120216,6754,7479126970,4,0,1,7168,4,3426425035
4973,7479125470,1846,7479127316,5,0,1,512,5,2575203188
4974,7479189949,101504,7479291453,9,0,0,33280,9,4081305404
4975,7479190276,111176,7479301452,2,0,0,32768,2,77632699
4976,7479194868,172311,7479367179,2,0,0,58880,2,9571824185
4977,7479206118,122196,7479328314,0,0,0,20992,0,7285245675
4978,7479423269,4374,7479427643,5,0,1,4608,5,3048384534
4979,7479497832,5454,7479503286,8,0,1,13824,8,10521756186
4980,7479582347,1042,7479583389,1,0,1,1024,1,4254170828
4981,7479599540,112112,7479711652,0,0,0,68096,0,665484048
4982,7479607816,1994,7479609810,7,0,1,2048,7,9469421758
4983,7479642555,47288,7479689843,4,0,0,1536,4,5109310111
4984,7479720209,67460,7479787669,9,0,0,12288,9,5253238352
4985,7479723090,2470,7479725560,4,0,1,2560,4,9035060753
4986,7479819692,130735,7479950427,9,0,0,89088,9,2255353579
4987,7479854753,110213,7479964966,9,0,0,24576,9,2639270280
4988,7479944071,40627,7479984698,1,0,1,59904,1,5892248336
4989,7479957939,28065,7479986004,3,0,1,2048,3,4411867880
4990,7480082800,43904,7480126704,4,0,0,512,4,8190899812
4991,7480149391,2946,7480152337,0,0,1,3072,0,6914917758
4992,7480279657,100724,7480380381,7,0,0,30720,7,7398002665
4993,7480324314,103532,7480427846,7,0,0,39936,7,164839853
4994,7480339055,3645,7480342700,6,0,1,10240,6,1511875384
4995,7480425048,33797,7480458845,1,0,1,50176,1,4889857582
4996,7480608070,6488,7480614558,7,0,1,15872,7,7424751427
4997,7480612541,6216,7480618757,4,0,1,6144,4,4141041014
4998,7480680524,43904,7480724428,3,0,0,512,3,9333008851
4999,7480747007,118628,7480865635,7,0,0,69120,7,4951291383
5000,7480863230,75557,7480938787,9,0,0,15872,9,6159857196
5001,7481018944,99944,7481118888,0,0,0,28160,0,10138551962
5002,7481092363,2946,7481095309,3,0,1,3072,3,5389280641
5003,7481172651,104000,7481276651,0,0,0,41472,0,10258590274
5004,7481211999,67943,7481279942,1,0,0,10752,1,4407533843
5005,7481234874,10241,7481245115,9,0,1,16384,9,3288201569
5006,7481286271,6278,7481292549,7,0,1,6656,7,2223559258
5007,7481362949,2946,7481365895,9,0,1,3072,9,4120214149
5008,7481415094,2946,7481418040,5,0,1,3072,5,8851444615
5009,7481547339,5326,7481552665,7,0,1,5632,7,1022389506
5010,7481551785,5326,7481557111,7,0,1,5632,7,1534752376
5011,7481648018,1518,7481649536,0,0,1,1536,0,6823519399
5012,7481709823,107744,7481817567,1,0,0,53760,1,2882683320
5013,7481745925,1994,7481747919,7,0,1,2048,7,7428630852
5014,7481759251,86712,7481845963,1,0,1,145408,1,5940744085
5015,7481764998,159210,7481924208,1,0,0,9216,1,1391162128
5016,7481917266,43904,7481961170,4,0,0,512,4,1197391165
5017,7482065162,6488,7482071650,4,0,1,15872,4,503747707
5018,7482233774,47288,7482281062,4,0,0,1536,4,6700376373
5019,7482294754,118352,7482413106,0,0,0,88576,0,3254132427
5020,7482365461,7230,7482372691,6,0,1,7680,6,7459157493
5021,7482375133,103844,7482478977,7,0,0,40960,7,4781603011
5022,7482386976,31014,7482417990,8,0,1,5120,8,9078598536
5023,7482394550,25706,7482420256,6,0,1,3584,6,1811378556
5024,7482405307,119816,7482525123,9,0,0,14848,9,8607503317
5025,7482426836,144733,7482571569,2,0,0,19968,2,8638864324
5026,7482454108,98096,7482552204,0,0,0,27136,0,1520544865
5027,7482475665,3870,7482479535,7,0,1,512,7,4195885448
5028,7482550847,45253,7482596100,3,0,0,512,3,279061035
5029,7482553767,48980,7482602747,3,0,0,2048,3,10604125545
5030,7482589141,43904,7482633045,4,0,0,512,4,10318126911
5031,7482698113,47288,7482745401,4,0,0,1536,4,7013771946
5032,7482782256,3387,7482785643,8,0,1,9728,8,3512793614
5033,7482950317,43904,7482994221,8,0,0,512,8,823646616
5034,7482975270,4850,7482980120,4,0,1,5120,4,9458885949
5035,7482988833,121628,7483110461,7,0,0,99328,7,5351085132
5036,7483138427,12825,7483151252,1,0,1,21504,1,9116113035
5037,7483157124,143884,7483301008,7,0,0,84992,7,488582556
5038,7483176898,3128,7483180026,0,0,1,9216,0,8822691358
5039,7483200542,101261,7483301803,9,0,0,2560,9,6896869893
5040,7483223267,112324,7483335591,9,0,0,16384,9,9662817968
5041,7483250868,62516,7483313384,4,0,0,6144,4,6595606240
5042,7483415035,70688,7483485723,0,0,0,12800,0,5540243086
5043,7483417202,3898,7483421100,0,0,1,4096,0,4599933562
5044,7483422783,3645,7483426428,6,0,1,10240,6,4916211497
5045,7483473024,103064,7483576088,2,0,0,38400,2,4780435702
5046,7483498396,45596,7483543992,3,0,0,1024,3,726431616
5047,7483538236,1518,7483539754,3,0,1,1536,3,594757213
5048,7483545191,68393,7483613584,6,0,0,1024,6,3339357450
5049,7483553459,5802,7483559261,4,0,1,6144,4,5330352377
5050,7483680617,566,7483681183,9,0,1,512,9,6362534695
5051,7483717209,6488,7483723697,1,0,1,15872,1,8482236064
5052,7483799173,60824,7483859997,0,0,0,5632,0,2762187942
5053,7483878904,3898,7483882802,6,0,1,4096,6,4112303498
5054,7483899206,159395,7484058601,7,0,0,16896,7,7283588753
5055,7483925950,101816,7484027766,0,0,0,34304,0,1277697209
5056,7484006077,6754,7484012831,3,0,1,7168,3,2700897323
5057,7484064023,2946,7484066969,3,0,1,3072,3,5359331250
5058,7484068202,45596,7484113798,2,0,0,1024,2,7065813888
5059,7484112193,43904,7484156097,6,0,0,512,6,4310962368
5060,7484131058,2946,7484134004,6,0,1,3072,6,8108114950
5061,7484139883,136165,7484276048,9,0,0,33280,9,10729267834
5062,7484239104,43904,7484283008,8,0,0,512,8,6797524248
5063,7484274228,9518,7484283746,4,0,1,8192,4,2727005914
5064,7484289865,24929,7484314794,1,0,1,45056,1,3557826025
5065,7484303988,254374,7484558362,1,0,0,45568,1,5935228653
5066,7484394145,164388,7484558533,4,0,0,512,4,9744420384
5067,7484412665,3422,7484416087,9,0,1,3584,9,8808831928
5068,7484604644,43904,7484648548,6,0,0,512,6,7836429408
5069,7484666573,43904,7484710477,6,0,0,512,6,9739759477
5070,7484743826,99944,7484843770,1,0,0,28160,1,6489396312
5071,7484750230,2470,7484752700,4,0,1,2560,4,7191394489
5072,7484758401,341618,7485100019,7,0,0,67584,7,9271621957
5073,7484795994,47947,7484843941,6,0,0,512,6,9436101331
5074,7484813956,4374,7484818330,9,0,1,4608,9,3127934590
5075,7484826102,253294,7485079396,7,0,0,250880,7,5332256979
5076,7484858146,342001,7485200147,7,0,0,193536,7,3325105851
5077,7484963656,245726,7485209382,1,0,0,30208,1,5095661246
5078,7484974910,125124,7485100034,1,0,1,168448,1,680658482
5079,7484999261,101298,7485100559,5,0,1,512,5,5536109662
5080,7485024407,234322,7485258729,4,0,0,1024,4,2435598333
5081,7485144512,65420,7485209932,3,0,1,512,3,8963216645
5082,7485145679,65837,7485211516,0,0,1,2048,0,6691821061
5083,7485180131,168944,7485349075,0,0,0,124416,0,882630602
5084,7485205287,8495,7485213782,3,0,1,3584,3,7744424233
5085,7485222000,1994,7485223994,4,0,1,2048,4,1265630386
5086,7485231862,79290,7485311152,8,0,0,2048,8,6372950457
5087,7485248681,145302,7485393983,0,0,0,24576,0,3049763739
5088,7485264779,88330,7485353109,4,0,0,1024,4,7736808017
5089,7485264881,134436,7485399317,1,0,0,17408,1,2054337830
5090,7485306236,42854,7485349090,8,0,1,6656,8,8148323561
5091,7485317928,35196,7485353124,3,0,1,10752,3,9254195979
5092,7485377602,16396,7485393998,1,0,1,22528,1,3381709042
5093,7485429961,103844,7485533805,9,0,0,40960,9,5535961949
5094,7485445169,566,7485445735,6,0,1,512,6,4742438053
5095,7485445256,1160,7485446416,3,0,1,1024,3,8357980377
5096,7485484528,4679,7485489207,7,0,1,12288,7,10110828087
5097,7485530137,5178,7485535315,0,0,1,1536,0,7280990329
5098,7485583078,2470,7485585548,9,0,1,2560,9,5607263791
5099,7485594006,57752,7485651758,0,0,0,5632,0,8245312307
5100,7485669152,116195,7485785347,2,0,0,16896,2,9138145310
5101,7485693951,31524,7485725475,1,0,1,51200,1,10149380376
5102,7485697016,31365,7485728381,6,0,1,4608,6,3949526105
5103,7485728920,1042,7485729962,8,0,1,1024,8,6242062290
5104,7485729461,3422,7485732883,1,0,1,3584,1,5883593706
5105,7485730635,6754,7485737389,8,0,1,7168,8,5954471322
5106,7485752013,5326,7485757339,0,0,1,5632,0,5932118973
5107,7485787707,1042,7485788749,9,0,1,1024,9,2847926212
5108,7485837961,3422,7485841383,4,0,1,3584,4,1713697329
5109,7485900792,5326,7485906118,9,0,1,5632,9,4589352177
5110,7485917245,43904,7485961149,3,0,0,512,3,9110281390
5111,7485929506,2946,7485932452,7,0,1,3072,7,8376719494
5112,7485934127,43904,7485978031,4,0,0,512,4,5347171023
5113,7485947133,1518,7485948651,8,0,1,1536,8,10563851532
5114,7486000520,84512,7486085032,2,0,0,12800,2,1848287556
5115,7486039251,46108,7486085359,4,0,0,1024,4,10641029573
5116,7486130409,566,7486130975,6,0,1,512,6,3407733116
5117,7486159040,33075,7486192115,1,0,1,54272,1,4488264953
5118,7486177973,51092,7486229065,3,0,0,512,3,5574522780
5119,7486498835,2946,7486501781,6,0,1,3072,6,7763448952
5120,7486561593,3128,7486564721,3,0,1,9216,3,82486462
5121,7486564782,3904,7486568686,4,0,1,10752,4,495063135
5122,7486571052,3387,7486574439,8,0,1,9728,8,3585556688
5123,7486813602,5802,7486819404,6,0,1,6144,6,3315069987
5124,7486839032,1994,7486841026,6,0,1,2048,6,6857611371
5125,7486889428,45596,7486935024,8,0,0,1024,8,3831300549
5126,7486903500,4374,7486907874,4,0,1,4608,4,1059643133
5127,7487049032,43904,7487092936,9,0,0,512,9,10080452912
5128,7487067352,100100,7487167452,7,0,0,28672,7,9788840612
5129,7487131365,45596,7487176961,4,0,0,1024,4,503255091
5130,7487296882,100412,7487397294,9,0,0,29696,9,1108313974
5131,7487324807,48980,7487373787,6,0,0,2048,6,3412641479
5132,7487364314,48980,7487413294,9,0,0,2048,9,4889371060
5133,7487382538,116442,7487498980,0,0,0,55296,0,10228100225
5134,7487508347,3387,7487511734,4,0,1,9728,4,10483289729
5135,7487608675,43904,7487652579,8,0,0,512,8,5371218389
5136,7487638868,67460,7487706328,2,0,0,12288,2,9304762994
5137,7487712761,55748,7487768509,6,0,0,4096,6,6734388051
5138,7487725767,2470,7487728237,8,0,1,2560,8,10196564859
5139,7487766738,52988,7487819726,1,0,0,5120,1,4333757082
5140,7487797934,45596,7487843530,3,0,0,1024,3,7233873558
5141,7487815800,3941,7487819741,4,0,1,2560,4,7892435114
5142,7487997108,50672,7488047780,6,0,0,2560,6,10519094928
5143,7488129026,45596,7488174622,4,0,0,1024,4,2460156768
5144,7488421279,108792,7488530071,7,0,0,53760,7,10495435576
5145,7488422327,156940,7488579267,0,0,0,57344,0,10149626975
5146,7488437879,1518,7488439397,0,0,1,1536,0,6264040637
5147,7488459595,5802,7488465397,8,0,1,6144,8,8955601107
5148,7488474927,55315,7488530242,6,0,0,512,6,2269910314
5149,7488494875,114199,7488609074,4,0,0,512,4,5264077613
5150,7488923438,6278,7488929716,9,0,1,6656,9,5450966644
5151,7488968749,5802,7488974551,8,0,1,6144,8,3591045041
5152,7489052708,43904,7489096612,6,0,0,512,6,219975275
5153,7489102971,2946,7489105917,4,0,1,3072,4,6399550758
5154,7489121331,43904,7489165235,3,0,0,512,3,1053516991
5155,7489144668,10499,7489155167,9,0,1,16896,9,1827561098
5156,7489156636,5712,7489162348,6,0,1,14336,6,9468295373
5157,7489228036,7230,7489235266,4,0,1,7680,4,4994615630
5158,7489311171,100724,7489411895,0,0,0,30720,0,2341258872
5159,7489384363,3387,7489387750,6,0,1,9728,6,488920899
5160,7489501633,45596,7489547229,3,0,0,1024,3,4522403538
5161,7489532084,566,7489532650,9,0,1,512,9,1658729125
5162,7489557503,127868,7489685371,0,0,0,119808,0,1116030944
5163,7489562084,124238,7489686322,8,0,0,3072,8,10158278731
5164,7489643843,3422,7489647265,6,0,1,3584,6,5819657578
5165,7489694246,43904,7489738150,4,0,0,512,4,9682291606
5166,7489715987,6754,7489722741,9,0,1,7168,9,3648195633
5167,7489753591,139825,7489893416,2,0,0,21504,2,10339588084
5168,7489758210,209840,7489968050,9,0,0,43520,9,4978572575
5169,7489807814,239191,7490047005,2,0,0,43008,2,1263182452
5170,7489830324,3422,7489833746,5,0,1,3584,5,3247406002
5171,7489886237,7194,7489893431,3,0,1,2048,3,9074022076
5172,7490170920,54056,7490224976,8,0,0,3584,8,1432429815
5173,7490333112,86072,7490419184,7,0,0,17920,7,6049516612
5174,7490357891,101859,7490459750,2,0,0,13824,2,2471844658
5175,7490371535,1994,7490373529,0,0,1,2048,0,9611377400
5176,7490434139,10241,7490444380,7,0,1,16384,7,4232368601
5177,7490470699,50672,7490521371,9,0,0,2560,9,2775637768
5178,7490628377,102128,7490730505,2,0,0,35328,2,9376132621
5179,7490728592,8183,7490736775,9,0,1,6656,9,7523494780
5180,7490761647,1042,7490762689,3,0,1,1024,3,9676635555
5181,7490867662,45596,7490913258,6,0,0,1024,6,1515578942
5182,7490991034,566,7490991600,0,0,1,512,0,1447573141
5183,7491025168,4850,7491030018,6,0,1,5120,6,3851609584
5184,7491057387,81596,7491138983,9,0,0,13312,9,3259026120
5185,7491085964,84387,7491170351,1,0,1,140800,1,2683024877
5186,7491171585,72550,7491244135,6,0,0,512,6,3713931464
5187,7491237408,2470,7491239878,9,0,1,2560,9,10507774728
5188,7491292029,43904,7491335933,6,0,0,512,6,1938942802
5189,7491354570,57440,7491412010,3,0,0,4608,3,8679293734
5190,7491386730,114218,7491500948,7,0,0,63488,7,1527857068
5191,7491512478,566,7491513044,9,0,1,512,9,2966333161
5192,7491608087,89456,7491697543,0,0,0,18944,0,6292785602
5193,7491620972,2470,7491623442,5,0,1,2560,5,2518300849
5194,7491638351,75422,7491713773,8,0,0,512,8,9715445703
5195,7491799222,1518,7491800740,5,0,1,1536,5,7364046711
5196,7491840809,1518,7491842327,8,0,1,1536,8,9200379984
5197,7491866577,43904,7491910481,2,0,0,512,2,6198257304
5198,7491933765,1994,7491935759,7,0,1,2048,7,7837179726
5199,7491945560,4679,7491950239,4,0,1,12288,4,8627740260
5200,7491975674,54767,7492030441,3,0,0,512,3,7101914732
5201,7492035279,144568,7492179847,2,0,0,117248,2,3522707674
5202,7492145436,49724,7492195160,1,0,1,29696,1,9406927385
5203,7492256349,7706,7492264055,6,0,1,8192,6,9501223616
5204,7492365463,92864,7492458327,2,0,0,25088,2,9721763431
5205,7492371818,566,7492372384,5,0,1,512,5,7474442227
5206,7492405855,3422,7492409277,8,0,1,3584,8,9135012995
5207,7492448421,122564,7492570985,1,0,0,102400,1,4142864681
5208,7492484153,1994,7492486147,6,0,1,2048,6,10244877275
5209,7492631367,5326,7492636693,8,0,1,5632,8,7381935419
5210,7492658883,2946,7492661829,6,0,1,3072,6,8846812511
5211,7492800710,43904,7492844614,6,0,0,512,6,10664261611
5212,7492862296,2470,7492864766,6,0,1,2560,6,4081085214
5213,7492877898,1994,7492879892,8,0,1,2048,8,2167214639
5214,7492991301,3898,7492995199,7,0,1,4096,7,360032601
5215,7493006852,566,7493007418,4,0,1,512,4,7071666481
5216,7493044140,1994,7493046134,8,0,1,2048,8,907347438
5217,7493066233,566,7493066799,8,0,1,512,8,4660344114
5218,7493124577,6278,7493130855,4,0,1,6656,4,10017708944
5219,7493225473,3387,7493228860,7,0,1,9728,7,8102941554
5220,7493247480,30491,7493277971,1,0,1,49152,1,6164183490
5221,7493325937,49350,7493375287,8,0,0,1024,8,9530480991
5222,7493396001,6754,7493402755,4,0,1,7168,4,4636889507
5223,7493410838,43904,7493454742,4,0,0,512,4,1025793273
5224,7493431185,43904,7493475089,0,0,0,512,0,9934417218
5225,7493502318,58844,7493561162,0,0,0,9216,0,1725095511
5226,7493560034,4542,7493564576,0,0,1,3584,0,3386450507
5227,7493651226,105872,7493757098,9,0,0,47616,9,2019114444
5228,7493658036,3422,7493661458,8,0,1,3584,8,10407676067
5229,7493662836,48980,7493711816,4,0,0,2048,4,6525005204
5230,7493690168,107432,7493797600,9,0,0,52736,9,2983977568
5231,7493764108,61428,7493825536,3,0,0,1024,3,3301287924
5232,7493868298,70976,7493939274,2,0,0,8704,2,422114253
5233,7493909973,106496,7494016469,2,0,0,49664,2,10245868148
5234,7493931324,47288,7493978612,6,0,0,1536,6,8602798372
5235,7494053168,2470,7494055638,9,0,1,2560,9,5998657710
5236,7494109379,118196,7494227575,0,0,0,88064,0,4331606517
5237,7494172500,1994,7494174494,3,0,1,2048,3,6310531611
5238,7494254939,76052,7494330991,0,0,0,10240,0,9983003005
5239,7494283461,3645,7494287106,7,0,1,10240,7,1933063026
5240,7494369644,48980,7494418624,6,0,0,2048,6,5990887877
5241,7494386226,566,7494386792,9,0,1,512,9,4210072695
5242,7494389089,1518,7494390607,0,0,1,1536,0,6404837201
5243,7494436060,2470,7494438530,5,0,1,2560,5,620448355
5244,7494654538,55148,7494709686,0,0,0,7168,0,5493666199
5245,7494798085,102596,7494900681,2,0,0,36864,2,1416394554
5246,7494798288,4374,7494802662,3,0,1,4608,3,7009937125
5247,7494813714,47288,7494861002,8,0,0,1536,8,9065115351
5248,7494838284,44252,7494882536,8,0,0,512,8,5985682893
5249,7494868607,106808,7494975415,0,0,0,50688,0,8081177254
5250,7494918465,3422,7494921887,0,0,1,3584,0,4171162661
5251,7495102388,7706,7495110094,4,0,1,8192,4,6486402343
5252,7495139720,54368,7495194088,1,0,0,4608,1,2456626237
5253,7495141293,3898,7495145191,8,0,1,4096,8,7602640545
5254,7495231796,97760,7495329556,7,0,0,20992,7,1153685791
5255,7495335608,65924,7495401532,7,0,0,12288,7,3689969234
5256,7495389933,3387,7495393320,9,0,1,9728,9,8131790216
5257,7495407398,566,7495407964,8,0,1,512,8,10335422834
5258,7495532558,3422,7495535980,0,0,1,3584,0,3895981593
5259,7495537331,1518,7495538849,4,0,1,1536,4,8279228168
5260,7495578367,45596,7495623963,8,0,0,1024,8,6311165594
5261,7495668829,5326,7495674155,0,0,1,5632,0,9190963650
5262,7495701175,3387,7495704562,8,0,1,9728,8,9527933985
5263,7495718549,45596,7495764145,3,0,0,1024,3,101000181
5264,7495736604,139594,7495876198,0,0,0,20480,0,10228662957
5265,7495825378,4850,7495830228,3,0,1,5120,3,2988513104
5266,7495830688,4374,7495835062,4,0,1,4608,4,9151588964
5267,7495873335,6753,7495880088,7,0,1,4096,7,4855987264
5268,7495896694,197205,7496093899,1,0,0,47616,1,7142739245
5269,7495918565,103532,7496022097,2,0,0,39936,2,3760697401
5270,7495951812,213865,7496165677,0,0,0,50176,0,3439684802
5271,7496103404,2470,7496105874,8,0,1,2560,8,7063586143
5272,7496151927,129935,7496281862,1,0,0,81408,1,6860331988
5273,7496159469,156881,7496316350,1,0,0,33280,1,4000035785
5274,7496366149,149624,7496515773,7,0,0,140800,7,5550866965
5275,7496371181,7706,7496378887,4,0,1,8192,4,1593018211
5276,7496375031,4522,7496379553,5,0,1,1024,5,9867766271
5277,7496381672,566,7496382238,4,0,1,512,4,4002663602
5278,7496401782,181439,7496583221,7,0,0,61952,7,10606211899
5279,7496410603,105520,7496516123,4,0,0,512,4,8297302973
5280,7496455138,60814,7496515952,3,0,0,512,3,4406293282
5281,7496461480,54814,7496516294,8,0,0,512,8,1729529047
5282,7496484802,34838,7496519640,5,0,1,9728,5,261954626
5283,7496531971,4162,7496536133,9,0,1,11264,9,8586596918
5284,7496571504,96557,7496668061,1,0,0,18944,1,8630870959
5285,7496633717,47288,7496681005,1,0,0,1536,1,2296585599
5286,7496641082,47288,7496688370,8,0,0,1536,8,1953712986
5287,7496703534,75296,7496778830,7,0,0,12800,7,1990859002
5288,7496739556,4850,7496744406,5,0,1,5120,5,8145832041
5289,7496769534,1518,7496771052,3,0,1,1536,3,1788074384
5290,7496781108,2470,7496783578,8,0,1,2560,8,8355406590
5291,7496837488,6754,7496844242,6,0,1,7168,6,6146349851
5292,7496846995,76052,7496923047,2,0,0,10240,2,10034516738
5293,7496936256,5802,7496942058,8,0,1,6144,8,3451885171
5294,7497018253,3387,7497021640,4,0,1,9728,4,9465018581
5295,7497036558,4850,7497041408,8,0,1,5120,8,1841804933
5296,7497061890,45596,7497107486,4,0,0,1024,4,8279221187
5297,7497170792,4162,7497174954,7,0,1,11264,7,9872327096
5298,7497178928,20366,7497199294,1,0,1,32768,1,3808604111
5299,7497315832,101036,7497416868,9,0,0,31744,9,484818399
5300,7497355423,5454,7497360877,6,0,1,13824,6,2833962279
5301,7497389020,6278,7497395298,7,0,1,6656,7,7897483945
5302,7497389987,133042,7497523029,2,0,0,66560,2,4663917702
5303,7497560963,112580,7497673543,9,0,0,69632,9,10674179822
5304,7497637587,6278,7497643865,6,0,1,6656,6,1118641774
5305,7497736228,101348,7497837576,2,0,0,32768,2,9922205361
5306,7497844268,102596,7497946864,2,0,0,36864,2,2109663578
5307,7497905136,5326,7497910462,8,0,1,5632,8,6602724884
5308,7497941098,99386,7498040484,2,0,0,17408,2,9913070936
5309,7497984493,50672,7498035165,2,0,0,2560,2,7056956359
5310,7498060197,104000,7498164197,7,0,0,41472,7,6007660921
5311,7498077651,192465,7498270116,2,0,0,74240,2,5793265732
5312,7498078439,2946,7498081385,5,0,1,3072,5,9481495518
5313,7498113888,4162,7498118050,1,0,1,11264,1,7577421464
5314,7498167892,135476,7498303368,0,0,0,9728,0,9132930085
5315,7498257490,80234,7498337724,0,0,0,12800,0,5487554448
5316,7498401166,1994,7498403160,3,0,1,2048,3,6044017095
5317,7498417096,91304,7498508400,9,0,0,19968,9,8978921760
5318,7498474188,6754,7498480942,7,0,1,7168,7,5745490165
5319,7498481665,3387,7498485052,8,0,1,9728,8,4103953270
5320,7498508395,1994,7498510389,6,0,1,2048,6,9047680128
5321,7498527283,4850,7498532133,0,0,1,5120,0,6776238822
5322,7498597410,52520,7498649930,6,0,0,3584,6,1458560735
5323,7498597996,117884,7498715880,0,0,0,87040,0,4498889722
5324,7498636325,79882,7498716207,4,0,0,1024,4,2851277376
5325,7498743003,6278,7498749281,5,0,1,6656,5,4990825725
5326,7498885228,43904,7498929132,6,0,0,512,6,8836639062
5327,7498893270,108368,7499001638,9,0,0,55808,9,4377040078
5328,7498913439,34020,7498947459,1,0,1,59392,1,8869818994
5329,7498978885,5712,7498984597,4,0,1,14336,4,9938359075
5330,7499054651,47288,7499101939,6,0,0,1536,6,7900743474
5331,7499064278,2946,7499067224,6,0,1,3072,6,3079878701
5332,7499088024,181331,7499269355,9,0,0,25600,9,8723755807
5333,7499218981,134917,7499353898,9,0,0,64000,9,7772334375
5334,7499383333,47288,7499430621,4,0,0,1536,4,6259698923
5335,7499523993,4937,7499528930,9,0,1,12800,9,3473411090
5336,7499530921,6229,7499537150,7,0,1,15360,7,7136641131
5337,7499705997,1518,7499707515,4,0,1,1536,4,1647599938
5338,7499751618,1994,7499753612,4,0,1,2048,4,1631033498
5339,7499757961,4679,7499762640,0,0,1,12288,0,2336160301
5340,7499843856,4374,7499848230,0,0,1,4608,0,10642358409
5341,7500006589,1518,7500008107,9,0,1,1536,9,5052486045
5342,7500056470,43904,7500100374,4,0,0,512,4,8624478460
5343,7500116778,43904,7500160682,6,0,0,512,6,6219655463
5344,7500447095,6278,7500453373,3,0,1,6656,3,3503158580
5345,7500464338,1042,7500465380,6,0,1,1024,6,10152692710
5346,7500525148,72980,7500598128,0,0,0,10240,0,5757246924
5347,7500634932,13083,7500648015,1,0,1,22016,1,4179465903
5348,7500658542,210351,7500868893,7,0,0,40960,7,1105612917
5349,7500715386,3898,7500719284,0,0,1,4096,0,4732237316
5350,7500746751,1042,7500747793,8,0,1,1024,8,10457194133
5351,7500752808,198027,7500950835,0,0,0,81920,0,8128395351
5352,7500761434,118762,7500880196,1,0,0,17408,1,5349238864
5353,7500810257,1994,7500812251,9,0,1,2048,9,6982608983
5354,7500852043,1518,7500853561,7,0,1,1536,7,9505114429
5355,7500894679,56483,7500951162,4,0,0,1024,4,4434441680
5356,7500905598,1042,7500906640,4,0,1,1024,4,6529280900
5357,7500972889,566,7500973455,3,0,1,512,3,42145064
5358,7500981453,7230,7500988683,6,0,1,7680,6,3614079357
5359,7500986622,79772,7501066394,7,0,0,18432,7,5828463982
5360,7501009153,45596,7501054749,6,0,0,1024,6,5353163958
5361,7501040528,229877,7501270405,0,0,0,70144,0,7698249598
5362,7501174615,48980,7501223595,6,0,0,2048,6,7672000046
5363,7501226709,11016,7501237725,1,0,1,17920,1,9137033901
5364,7501234534,58347,7501292881,6,0,0,512,6,9353128859
5365,7501268737,4130,7501272867,4,0,1,2560,4,2689826642
5366,7501287958,36346,7501324304,1,0,1,64000,1,503076504
5367,7501311554,14056,7501325610,7,0,1,2048,7,4621076011
5368,7501386473,1518,7501387991,5,0,1,1536,5,1282933415
5369,7501430436,1994,7501432430,3,0,1,2048,3,8170996765
5370,7501594989,50672,7501645661,8,0,0,2560,8,1652432996
5371,7501597718,3387,7501601105,1,0,1,9728,1,3672839869
5372,7501692757,4162,7501696919,4,0,1,11264,4,10379510632
5373,7501748300,43904,7501792204,4,0,0,512,4,8526663247
5374,7501763966,2946,7501766912,8,0,1,3072,8,2584275397
5375,7501816880,566,7501817446,8,0,1,512,8,9836562373
5376,7501846195,3387,7501849582,9,0,1,9728,9,7187306986
5377,7501909948,1042,7501910990,3,0,1,1024,3,6564586254
5378,7502010314,123656,7502133970,0,0,0,105984,0,6042162416
5379,7502143546,133832,7502277378,9,0,0,71680,9,8043118454
5380,7502153479,5971,7502159450,1,0,1,14848,1,3049527694
5381,7502203476,74385,7502277861,0,0,0,1536,0,6710992359
5382,7502351409,88364,7502439773,7,0,0,15360,7,6894946178
5383,7502456000,6754,7502462754,3,0,1,7168,3,9938748020
5384,7502562088,1518,7502563606,7,0,1,1536,7,4732489185
5385,7502697221,94770,7502791991,1,0,1,157696,1,1696361187
5386,7502754015,101443,7502855458,2,0,0,5120,2,2392758669
5387,7502843327,47288,7502890615,9,0,0,1536,9,8720726498
5388,7502979663,43904,7503023567,3,0,0,512,3,6952478862
5389,7503097432,2470,7503099902,6,0,1,2560,6,9533179976
5390,7503118757,76052,7503194809,7,0,0,10240,7,10339615842
5391,7503179002,4420,7503183422,4,0,1,11776,4,5902186048
5392,7503220327,3898,7503224225,7,0,1,4096,7,345966937
5393,7503229486,2470,7503231956,3,0,1,2560,3,7309242876
5394,7503262726,54100,7503316826,1,0,1,88576,1,7021728660
5395,7503397602,566,7503398168,3,0,1,512,3,1857010526
5396,7503405723,1518,7503407241,4,0,1,1536,4,6706608527
5397,7503454281,45596,7503499877,4,0,0,1024,4,7268351294
5398,7503519278,3898,7503523176,4,0,1,4096,4,1062360741
5399,7503530288,178323,7503708611,2,0,0,73728,2,2774305558
5400,7503617455,60137,7503677592,8,0,0,512,8,2718287843
5401,7503705063,47444,7503752507,6,0,0,512,6,7232902253
5402,7503733846,3422,7503737268,7,0,1,3584,7,3281520375
5403,7503830455,86360,7503916815,1,0,0,13824,1,1374227167
5404,7503862142,3898,7503866040,3,0,1,4096,3,10352806654
5405,7503878160,1518,7503879678,7,0,1,1536,7,7319837037
5406,7503933574,1994,7503935568,5,0,1,2048,5,2036032618
5407,7503978763,5802,7503984565,3,0,1,6144,3,8135541534
5408,7504164142,93908,7504258050,0,0,0,18432,0,8106236758
5409,7504288694,566,7504289260,5,0,1,512,5,9528373470
5410,7504360137,75920,7504436057,9,0,0,14848,9,6232761706
5411,7504374675,4850,7504379525,8,0,1,5120,8,3749399572
5412,7504420452,50672,7504471124,3,0,0,2560,3,10629371582
5413,7504420539,54998,7504475537,4,0,0,1024,4,7599681628
5414,7504451781,25962,7504477743,1,0,1,47104,1,1086096604
5415,7504456376,61710,7504518086,8,0,0,512,8,7130158444
5416,7504487585,7230,7504494815,9,0,1,7680,9,2897482725
5417,7504535232,101972,7504637204,9,0,0,34816,9,5501732038
5418,7504657790,566,7504658356,5,0,1,512,5,4552001646
5419,7504704676,47288,7504751964,3,0,0,1536,3,7718784119
5420,7504960995,1042,7504962037,3,0,1,1024,3,6435228274
5421,7504985182,85004,7505070186,7,0,0,19456,7,1765237000
5422,7505037864,43904,7505081768,8,0,0,512,8,2948705251
5423,7505063091,45596,7505108687,8,0,0,1024,8,6111008206
5424,7505080365,44060,7505124425,4,0,0,1024,4,1748667679
5425,7505109256,110708,7505219964,1,0,0,63488,1,207947271
5426,7505134363,4850,7505139213,5,0,1,5120,5,8684898247
5427,7505189204,99320,7505288524,1,0,0,26112,1,2710036308
5428,7505310266,4374,7505314640,9,0,1,4608,9,3257598252
5429,7505387164,566,7505387730,1,0,1,512,1,1419263092
5430,7505480356,1518,7505481874,9,0,1,1536,9,957962853
5431,7505495022,3422,7505498444,8,0,1,3584,8,3120516992
5432,7505541620,566,7505542186,5,0,1,512,5,10125755325
5433,7505583493,1042,7505584535,4,0,1,1024,4,8968483942
5434,7505622671,72692,7505695363,8,0,0,14336,8,6499582642
5435,7505933202,1518,7505934720,8,0,1,1536,8,885893129
5436,7506120734,20882,7506141616,8,0,1,33792,8,1144930241
5437,7506185633,33850,7506219483,1,0,1,55808,1,8207085433
5438,7506218093,133673,7506351766,2,0,0,22016,2,10118791024
5439,7506277718,104624,7506382342,2,0,0,43520,2,5823616265
5440,7506309999,1994,7506311993,3,0,1,2048,3,4688690370
5441,7506314313,74593,7506388906,4,0,0,512,4,478953193
5442,7506329693,121421,7506451114,8,0,0,19968,8,10295743077
5443,7506369777,15027,7506384804,9,0,1,2560,9,4565448377
5444,7506404260,135012,7506539272,1,0,0,76288,1,4105711566
5445,7506555984,6754,7506562738,5,0,1,7168,5,3813012628
5446,7506559069,4015,7506563084,9,0,1,512,9,2435305352
5447,7506732159,2946,7506735105,4,0,1,3072,4,7855063756
5448,7506738020,95804,7506833824,1,0,1,159744,1,7415005129
5449,7506791109,43688,7506834797,5,0,1,12800,5,5268582380
5450,7506810468,100730,7506911198,6,0,0,512,6,3710707654
5451,7506827663,74300,7506901963,6,0,0,512,6,9044943449
5452,7506830391,5712,7506836103,9,0,1,2048,9,3278508684
5453,7506961646,123604,7507085250,1,0,0,36864,1,3484361397
5454,7506964230,2870,7506967100,9,0,1,8704,9,4127878293
5455,7507001824,3898,7507005722,9,0,1,4096,9,4948677973
5456,7507004160,57165,7507061325,6,0,0,1024,6,678633820
5457,7507038412,47165,7507085577,4,0,0,1024,4,10549110632
5458,7507141275,97604,7507238879,2,0,0,20480,2,4720048342
5459,7507178388,144929,7507323317,2,0,0,69632,2,3764283294
5460,7507229749,94051,7507323800,2,0,0,1536,2,7040220143
5461,7507291727,47600,7507339327,3,0,0,2560,3,8661533498
5462,7507308913,123091,7507432004,9,0,0,55296,9,8755870964
5463,7507367935,3422,7507371357,7,0,1,3584,7,9277203163
5464,7507490712,6754,7507497466,3,0,1,7168,3,8249869817
5465,7507495034,6938,7507501972,6,0,1,7168,6,5732106306
5466,7507553695,3898,7507557593,3,0,1,4096,3,10330585215
5467,7507554805,129010,7507683815,8,0,0,18432,8,3620390740
5468,7507646781,2470,7507649251,5,0,1,2560,5,3219354733
5469,7507664967,84224,7507749191,7,0,0,16896,7,8137837907
5470,7507696867,1518,7507698385,1,0,1,1536,1,6253983382
5471,7507734270,3128,7507737398,5,0,1,9216,5,8818684289
5472,7507858414,43904,7507902318,3,0,0,512,3,3160328938
5473,7507927586,103532,7508031118,2,0,0,39936,2,5294224076
5474,7508020896,13160,7508034056,9,0,1,3072,9,1212269093
5475,7508059402,196604,7508256006,4,0,0,1024,4,5599765882
5476,7508072269,106340,7508178609,2,0,0,49152,2,6416500043
5477,7508142802,35830,7508178632,1,0,1,52736,1,2294522115
5478,7508152162,103517,7508255679,6,0,0,1536,6,4496546643
5479,7508166472,93815,7508260287,6,0,0,1536,6,1961280081
5480,7508205462,7230,7508212692,6,0,1,7680,6,9714597739
5481,7508366965,1518,7508368483,3,0,1,1536,3,3079531325
5482,7508424081,22691,7508446772,1,0,1,37376,1,7417369095
5483,7508431016,48406,7508479422,6,0,0,512,6,8698189777
5484,7508516717,81128,7508597845,7,0,0,11776,7,8887350853
5485,7508590735,94049,7508684784,9,0,0,21504,9,3858915266
5486,7508610802,3422,7508614224,8,0,1,3584,8,3693585359
5487,7508620883,3904,7508624787,9,0,1,10752,9,10121415625
5488,7508657238,179489,7508836727,0,0,0,8192,0,10179492805
5489,7508778652,3128,7508781780,8,0,1,9216,8,6364746279
5490,7508850655,1518,7508852173,3,0,1,1536,3,3125168628
5491,7508916833,115975,7509032808,7,0,0,72192,7,9589997110
5492,7508919448,45596,7508965044,6,0,0,1024,6,5287452425
5493,7508987132,78005,7509065137,8,0,0,8192,8,8460859668
5494,7509097721,100100,7509197821,8,0,0,28672,8,6958218090
5495,7509275528,47288,7509322816,3,0,0,1536,3,6217109494
5496,7509283602,5802,7509289404,6,0,1,6144,6,10185925894
5497,7509297499,58809,7509356308,6,0,0,2048,6,2989995875
5498,7509410085,47288,7509457373,4,0,0,1536,4,7175494064
5499,7509446943,180080,7509627023,8,0,0,150016,8,5844243746
5500,7509543394,92281,7509635675,9,0,0,14848,9,4009657702
5501,7509550873,169084,7509719957,9,0,0,63488,9,6232732717
5502,7509577695,148049,7509725744,2,0,0,18944,2,5917697140
5503,7509729786,45596,7509775382,3,0,0,1024,3,7885408565
5504,7509741135,59444,7509800579,1,0,0,6144,1,6087180723
5505,7509835699,43904,7509879603,4,0,0,512,4,3926848891
5506,7509872661,45596,7509918257,3,0,0,1024,3,10146730503
5507,7509920166,5802,7509925968,6,0,1,6144,6,4180578892
5508,7509947855,4850,7509952705,8,0,1,5120,8,6766253762
5509,7509969300,59132,7510028432,1,0,0,5120,1,926571337
5510,7509972606,135740,7510108346,9,0,0,39424,9,3637837881
5511,7509992560,3422,7509995982,1,0,1,3584,1,8637499106
5512,7510043500,45596,7510089096,6,0,0,1024,6,4159031785
5513,7510113892,45596,7510159488,3,0,0,1024,3,8487987280
5514,7510158262,43904,7510202166,3,0,0,512,3,8541218242
5515,7510227461,5326,7510232787,9,0,1,5632,9,4038717272
5516,7510244035,43904,7510287939,3,0,0,512,3,9457535046
5517,7510402259,94532,7510496791,0,0,0,20480,0,7895185363
5518,7510421414,3898,7510425312,3,0,1,4096,3,1660477282
5519,7510451557,3422,7510454979,6,0,1,3584,6,10513122692
5520,7510484354,1042,7510485396,4,0,1,1024,4,5764190959
5521,7510496952,6754,7510503706,5,0,1,7168,5,7052456825
5522,7510550609,85004,7510635613,9,0,0,19456,9,10444414627
5523,7510598033,45596,7510643629,3,0,0,1024,3,2792059947
5524,7510619494,45596,7510665090,6,0,0,1024,6,2227256995
5525,7510637073,54056,7510691129,8,0,0,3584,8,3630977974
5526,7510646264,2470,7510648734,6,0,1,2560,6,2188950224
5527,7510817027,35312,7510852339,1,0,1,61952,1,1830142731
5528,7511007366,94220,7511101586,1,0,0,19456,1,8505181022
5529,7511012367,57440,7511069807,0,0,0,4608,0,7467842370
5530,7511113077,43904,7511156981,6,0,0,512,6,467437798
5531,7511150374,566,7511150940,9,0,1,512,9,8261070647
5532,7511154430,57440,7511211870,0,0,0,4608,0,10495324879
5533,7511187998,85472,7511273470,1,0,0,20992,1,2009412206
5534,7511387029,566,7511387595,9,0,1,512,9,2212031417
5535,7511402734,2870,7511405604,9,0,1,8704,9,4132856466
5536,7511408153,158705,7511566858,7,0,0,81408,7,4464074758
5537,7511424320,181019,7511605339,2,0,0,23552,2,3375855139
5538,7511439417,223950,7511663367,0,0,0,29184,0,4276014190
5539,7511447246,190457,7511637703,7,0,0,79360,7,7868560650
5540,7511649560,13822,7511663382,3,0,1,5632,3,9163000276
5541,7511663390,43904,7511707294,6,0,0,512,6,8631691290
5542,7511727209,3898,7511731107,4,0,1,4096,4,1610741618
5543,7511763158,3898,7511767056,7,0,1,4096,7,9745870949
5544,7511855743,6754,7511862497,3,0,1,7168,3,3820623173
5545,7511862049,4374,7511866423,9,0,1,4608,9,9510093137
5546,7511896956,68084,7511965040,1,0,0,14336,1,1387163218
5547,7511900525,4162,7511904687,6,0,1,11264,6,8043490949
5548,7512043392,3422,7512046814,6,0,1,3584,6,6165781712
5549,7512132246,114296,7512246542,2,0,0,75264,2,4934494249
5550,7512206811,43904,7512250715,3,0,0,512,3,646564477
5551,7512230929,20455,7512251384,3,0,1,5120,3,9619461761
5552,7512342858,216761,7512559619,0,0,0,114176,0,10339448239
5553,7512343020,6754,7512349774,4,0,1,7168,4,1004746206
5554,7512360868,112129,7512472997,2,0,0,57856,2,3410133181
5555,7512409200,195192,7512604392,9,0,0,38400,9,4099238740
5556,7512475599,95175,7512570774,3,0,0,2560,3,4204968637
5557,7512530407,131800,7512662207,2,0,0,36864,2,651803415
5558,7512587918,146559,7512734477,9,0,0,46080,9,2203080981
5559,7512616062,3422,7512619484,6,0,1,3584,6,5240349350
5560,7512664638,120046,7512784684,3,0,0,1536,3,933356947
5561,7512717581,34279,7512751860,1,0,1,59904,1,10685875476
5562,7512865509,52364,7512917873,8,0,0,3072,8,9873205441
5563,7512973932,102440,7513076372,2,0,0,36352,2,1305499340
5564,7513007640,6278,7513013918,8,0,1,6656,8,4283925566
5565,7513067870,165979,7513233849,9,0,0,40960,9,841093669
5566,7513158369,1994,7513160363,8,0,1,2048,8,8381767796
5567,7513181549,105560,7513287109,1,0,0,46592,1,10245864859
5568,7513220856,43904,7513264760,6,0,0,512,6,9823401834
5569,7513251003,2470,7513253473,3,0,1,2560,3,2030666329
5570,7513282444,113968,7513396412,9,0,0,32768,9,8781493791
5571,7513338418,566,7513338984,4,0,1,512,4,797796560
5572,7513431535,3904,7513435439,4,0,1,10752,4,1529078905
5573,7513473049,4162,7513477211,1,0,1,11264,1,7851218628
5574,7513504413,6278,7513510691,9,0,1,6656,9,3643398057
5575,7513517289,6229,7513523518,1,0,1,15360,1,1905847958
5576,7513522856,77732,7513600588,3,0,0,512,3,5567979137
5577,7513534622,52779,7513587401,9,0,0,1536,9,5210454518
5578,7513593632,12825,7513606457,1,0,1,21504,1,10127213047
5579,7513616736,48980,7513665716,3,0,0,2048,3,4931909728
5580,7513619554,43904,7513663458,6,0,0,512,6,2611938363
5581,7513654331,47432,7513701763,6,0,0,512,6,5685796784
5582,7513777902,196052,7513973954,0,0,0,182272,0,2339033255
5583,7513855936,124810,7513980746,2,0,0,10752,2,9995757777
5584,7513872225,128873,7514001098,2,0,0,27136,2,4992934497
5585,7514127214,60824,7514188038,2,0,0,5632,2,555841973
5586,7514168655,43904,7514212559,6,0,0,512,6,2003101564
5587,7514196424,43904,7514240328,4,0,0,512,4,3751517647
5588,7514270552,109148,7514379700,0,0,0,58368,0,5940381752
5589,7514376698,46898,7514423596,4,0,0,512,4,158332372
5590,7514390018,69284,7514459302,1,0,0,8192,1,2991892131
5591,7514432553,116647,7514549200,8,0,0,75264,8,9172108350
5592,7514476247,43904,7514520151,4,0,0,512,4,2057972715
5593,7514607077,566,7514607643,6,0,1,512,6,8632650772
5594,7514614135,4162,7514618297,5,0,1,11264,5,7505907576
5595,7514643890,322856,7514966746,9,0,0,82944,9,10078752099
5596,7514715115,53237,7514768352,1,0,1,90112,1,937717562
5597,7514743423,81128,7514824551,9,0,0,11776,9,6255080070
5598,7514806992,219202,7515026194,8,0,0,116736,8,10053932665
5599,7514870843,102941,7514973784,3,0,0,4096,3,9973081
5600,7514917848,49069,7514966917,3,0,0,512,3,6308189407
5601,7514986413,101348,7515087761,9,0,0,32768,9,728570965
5602,7514992386,41047,7515033433,5,0,1,7680,5,1501947884
5603,7515021959,18117,7515040076,1,0,1,18944,1,5730367702
5604,7515367477,6754,7515374231,9,0,1,7168,9,9840357749
5605,7515395834,2470,7515398304,6,0,1,2560,6,9609230004
5606,7515482610,55045,7515537655,1,0,1,93696,1,3663406750
5607,7515561502,23637,7515585139,1,0,1,42496,1,907339887
5608,7515579747,6698,7515586445,3,0,1,2048,3,7037959242
5609,7515609339,250189,7515859528,3,0,0,1024,3,5561166191
5610,7515622866,138712,7515761578,7,0,0,49152,7,3716336213
5611,7515703255,3422,7515706677,6,0,1,3584,6,9983495030
5612,7515712115,566,7515712681,8,0,1,512,8,1715138390
5613,7515767173,11016,7515778189,8,0,1,17920,8,848350964
5614,7515774345,4408,7515778753,3,0,1,10752,3,10542727931
5615,7515845167,102908,7515948075,1,0,0,37888,1,4615900061
5616,7515849953,6278,7515856231,9,0,1,6656,9,10458409012
5617,7515853254,3904,7515857158,9,0,1,10752,9,2053907249
5618,7515877543,50582,7515928125,3,0,0,1536,3,2198433667
5619,7515982888,4374,7515987262,9,0,1,4608,9,3057234990
5620,7516018502,566,7516019068,8,0,1,512,8,10489692196
5621,7516106945,102440,7516209385,9,0,0,36352,9,4254626850
5622,7516133960,194290,7516328250,1,0,0,119808,1,7192682892
5623,7516215021,5802,7516220823,8,0,1,6144,8,1917812581
5624,7516228055,157387,7516385442,7,0,0,17920,7,10239132957
5625,7516367048,5802,7516372850,3,0,1,6144,3,6609244191
5626,7516454897,4937,7516459834,1,0,1,12800,1,1213246975
5627,7516525060,184798,7516709858,2,0,0,73728,2,6926750931
5628,7516616882,20366,7516637248,6,0,1,32768,6,9567218965
5629,7516640195,110482,7516750677,0,0,0,13824,0,8391197751
5630,7516672809,157158,7516829967,1,0,0,46080,1,2145935134
5631,7516677452,163918,7516841370,9,0,0,37376,9,1056872291
5632,7516848226,105482,7516953708,9,0,0,12288,9,8561833603
5633,7516864744,48980,7516913724,3,0,0,2048,3,1045757824
5634,7516877388,112736,7516990124,0,0,0,70144,0,6504431602
5635,7516961681,43904,7517005585,4,0,0,512,4,992462905
5636,7517012177,47288,7517059465,8,0,0,1536,8,10717061557
5637,7517019567,47288,7517066855,3,0,0,1536,3,3400848767
5638,7517082334,4162,7517086496,8,0,1,11264,8,5437131518
5639,7517252119,3898,7517256017,7,0,1,4096,7,1457081904
5640,7517278159,7706,7517285865,3,0,1,8192,3,4330254478
5641,7517456084,3898,7517459982,6,0,1,4096,6,3158387439
5642,7517457974,3634,7517461608,7,0,1,2560,7,2570315424
5643,7517462954,1518,7517464472,4,0,1,1536,4,9523162659
5644,7517468683,205084,7517673767,8,0,0,51200,8,10529197677
5645,7517490622,79295,7517569917,4,0,0,1024,4,3706231321
5646,7517547309,63708,7517611017,1,0,1,103936,1,8632388893
5647,7517859841,73136,7517932977,9,0,0,10752,9,2882162652
5648,7518014323,13253,7518027576,6,0,1,25600,6,2224323169
5649,7518148586,75296,7518223882,0,0,0,12800,0,2698913132
5650,7518186105,5326,7518191431,5,0,1,5632,5,10669468745
5651,7518293686,22174,7518315860,1,0,1,36352,1,4524266171
5652,7518335060,171587,7518506647,7,0,0,3072,7,9455992043
5653,7518400616,4850,7518405466,7,0,1,5120,7,1545912788
5654,7518447212,47288,7518494500,4,0,0,1536,4,1129568624
5655,7518484777,6754,7518491531,6,0,1,7168,6,6661210992
5656,7518487248,5589,7518492837,5,0,1,2048,5,6656558282
5657,7518503339,46220,7518549559,4,0,0,512,4,10570356813
5658,7518690196,3898,7518694094,6,0,1,4096,6,2901023282
5659,7518736146,45596,7518781742,3,0,0,1024,3,5921791949
5660,7518828882,45596,7518874478,3,0,0,1024,3,2373809439
5661,7518839109,69440,7518908549,0,0,0,8704,0,8929661147
5662,7518856999,47288,7518904287,2,0,0,1536,2,5421622386
5663,7518883296,2470,7518885766,7,0,1,2560,7,9395533999
5664,7518890570,566,7518891136,7,0,1,512,7,5152763959
5665,7518911076,47288,7518958364,4,0,0,1536,4,9294112412
5666,7519001343,5802,7519007145,4,0,1,6144,4,603086219
5667,7519026815,1518,7519028333,8,0,1,1536,8,8756159167
5668,7519065651,43904,7519109555,6,0,0,512,6,9160755888
5669,7519239531,5802,7519245333,4,0,1,6144,4,4042726695
5670,7519338284,1994,7519340278,3,0,1,2048,3,7902646722
5671,7519350429,123812,7519474241,1,0,0,106496,1,4413947618
5672,7519364032,566,7519364598,7,0,1,512,7,2946461004
5673,7519370832,2470,7519373302,9,0,1,2560,9,5215847226
5674,7519411825,85657,7519497482,3,0,0,3072,3,9549244139
5675,7519415304,7230,7519422534,3,0,1,7680,3,712929681
5676,7519478371,70483,7519548854,4,0,0,3072,4,18330213
5677,7519662222,100412,7519762634,2,0,0,29696,2,55278200
5678,7519675952,48980,7519724932,3,0,0,2048,3,1228825467
5679,7519842115,103220,7519945335,1,0,0,38912,1,1992486251
5680,7520005851,47600,7520053451,4,0,0,2560,4,7888065371
5681,7520013203,3898,7520017101,3,0,1,4096,3,6468376037
5682,7520045824,48726,7520094550,4,0,0,1024,4,4754499390
5683,7520057046,101584,7520158630,8,0,0,33280,8,7443539106
5684,7520075578,4850,7520080428,6,0,1,5120,6,10542881861
5685,7520085958,5802,7520091760,4,0,1,6144,4,7370877158
5686,7520188313,1518,7520189831,4,0,1,1536,4,1338082454
5687,7520244578,4850,7520249428,6,0,1,5120,6,4542170196
5688,7520282629,55748,7520338377,8,0,0,4096,8,7849985513
5689,7520428554,55748,7520484302,7,0,0,4096,7,2853188769
5690,7520482184,88076,7520570260,1,0,0,19456,1,8444769730
5691,7520509491,85795,7520595286,2,0,0,9728,2,8741694689
5692,7520710479,99476,7520809955,0,0,0,26624,0,5603739572
5693,7520741115,104576,7520845691,8,0,0,512,8,2618843578
5694,7520967914,47288,7521015202,6,0,0,1536,6,8752589873
5695,7521011945,112817,7521124762,9,0,0,61440,9,7741155239
5696,7521064858,12737,7521077595,1,0,1,24576,1,8821438305
5697,7521118835,12407,7521131242,4,0,1,15872,4,1227567465
5698,7521199414,43904,7521243318,8,0,0,512,8,3303087994
5699,7521271918,6278,7521278196,7,0,1,6656,7,3043373656
5700,7521359700,1042,7521360742,9,0,1,1024,9,4784975
5701,7521404170,5326,7521409496,7,0,1,5632,7,1007801971
5702,7521452962,2946,7521455908,7,0,1,3072,7,650298737
5703,7521466052,2470,7521468522,5,0,1,2560,5,4379204772
5704,7521479359,3645,7521483004,9,0,1,10240,9,9336533225
5705,7521584224,47288,7521631512,4,0,0,1536,4,9522546774
5706,7521589926,5712,7521595638,4,0,1,14336,4,10633731689
5707,7521594633,4850,7521599483,7,0,1,5120,7,6938732720
5708,7521650141,3387,7521653528,8,0,1,9728,8,6009959108
5709,7521750795,3422,7521754217,7,0,1,3584,7,9559131005
5710,7521801462,2470,7521803932,4,0,1,2560,4,1913054283
5711,7521821328,7230,7521828558,3,0,1,7680,3,1441330394
5712,7521983734,4374,7521988108,1,0,1,4608,1,9555994788
5713,7522134712,1042,7522135754,6,0,1,1024,6,7851701466
5714,7522168552,4420,7522172972,7,0,1,11776,7,8215780544
5715,7522254606,45596,7522300202,4,0,0,1024,4,7153444767
5716,7522283813,110864,7522394677,0,0,0,64000,0,9869069524
5717,7522314717,114304,7522429021,8,0,0,3072,8,772345095
5718,7522371398,59471,7522430869,2,0,0,4096,2,3318479731
5719,7522451842,45596,7522497438,3,0,0,1024,3,7803875880
5720,7522471823,113516,7522585339,2,0,0,72704,2,4810684981
5721,7522649513,97916,7522747429,2,0,0,21504,2,8257492890
5722,7522780391,5802,7522786193,7,0,1,6144,7,8634672877
5723,7522935146,45596,7522980742,3,0,0,1024,3,2743896080
5724,7522978935,72668,7523051603,0,0,0,9216,0,2720855660
5725,7523051269,44230,7523095499,3,0,0,512,3,2617868821
5726,7523129768,1042,7523130810,9,0,1,1024,9,9200333423
5727,7523208118,85628,7523293746,9,0,0,21504,9,8132295370
5728,7523260664,173142,7523433806,4,0,0,512,4,6026571923
5729,7523281073,2470,7523283543,3,0,1,2560,3,9812342158
5730,7523339075,5326,7523344401,6,0,1,5632,6,2198277124
5731,7523344004,7706,7523351710,1,0,1,8192,1,9727363110
5732,7523367921,61744,7523429665,9,0,0,7168,9,3288598201
5733,7523418020,45596,7523463616,4,0,0,1024,4,10575614630
5734,7523425820,47288,7523473108,9,0,0,1536,9,3800538680
5735,7523455847,138318,7523594165,7,0,0,102912,7,4814178757
5736,7523479663,157290,7523636953,9,0,0,66560,9,1716905492
5737,7523570557,126900,7523697457,9,0,0,15872,9,98233783
5738,7523708310,2946,7523711256,7,0,1,3072,7,793328114
5739,7523844660,566,7523845226,3,0,1,512,3,1351741241
5740,7523853349,43904,7523897253,4,0,0,512,4,4481525292
5741,7523955731,52364,7524008095,1,0,0,3072,1,1401161262
5742,7524024597,12049,7524036646,9,0,1,19968,9,4872044387
5743,7524025741,53969,7524079710,3,0,0,2048,3,6008503365
5744,7524058051,246910,7524304961,9,0,0,62976,9,1749746125
5745,7524297924,11449,7524309373,4,0,1,11776,4,3400215114
5746,7524365528,4374,7524369902,5,0,1,4608,5,843465624
5747,7524422731,1042,7524423773,8,0,1,1024,8,1378404522
5748,7524454495,566,7524455061,6,0,1,512,6,9192290823
5749,7524492023,3645,7524495668,3,0,1,10240,3,6185477867
5750,7524568562,43904,7524612466,8,0,0,512,8,1454942016
5751,7524673341,101972,7524775313,2,0,0,34816,2,5722599445
5752,7524686393,138072,7524824465,1,0,0,34816,1,3352590335
5753,7524766202,12049,7524778251,4,0,1,3072,4,2817084459
5754,7524792021,97448,7524889469,9,0,0,19968,9,2662350911
5755,7524804273,226712,7525030985,0,0,0,161792,0,4090992190
5756,7524936391,4937,7524941328,4,0,1,12800,4,10223847795
5757,7524938868,93076,7525031944,6,0,0,3072,6,6001979688
5758,7524987453,114992,7525102445,2,0,0,15360,2,5680442094
5759,7525023639,10784,7525034423,6,0,1,2560,6,2898671266
5760,7525027207,52042,7525079249,8,0,0,1536,8,8152637090
5761,7525248153,47288,7525295441,4,0,0,1536,4,8712831435
5762,7525285406,92972,7525378378,8,0,0,15360,8,452430146
5763,7525329889,50828,7525380717,9,0,0,3072,9,8502644699
5764,7525337575,58064,7525395639,3,0,0,512,3,4573330482
5765,7525509841,1042,7525510883,7,0,1,1024,7,6625694875
5766,7525552453,102128,7525654581,0,0,0,35328,0,10315518100
5767,7525567223,43904,7525611127,4,0,0,512,4,6256691594
5768,7525662065,12308,7525674373,6,0,1,20480,6,5354433300
5769,7525666546,142320,7525808866,9,0,0,94720,9,1124522358
5770,7525687505,77289,7525764794,6,0,0,1536,6,4093411506
5771,7525700831,1518,7525702349,4,0,1,1536,4,7463340650
5772,7525754604,109838,7525864442,1,0,0,44032,1,10206922061
5773,7525844100,33850,7525877950,1,0,1,55808,1,3236884752
5774,7525848625,145051,7525993676,4,0,0,2048,4,4112668676
5775,7525863202,129835,7525993037,0,0,0,56320,0,5432720051
5776,7526066989,121616,7526188605,1,0,1,196608,1,9301759931
5777,7526161757,248238,7526409995,0,0,0,16384,0,6804319221
5778,7526263772,80084,7526343856,4,0,0,1024,4,6274682251
5779,7526338788,141702,7526480490,9,0,0,28672,9,4686579395
5780,7526349153,2870,7526352023,9,0,1,8704,9,7213464811
5781,7526510046,1042,7526511088,7,0,1,1024,7,4161064026
5782,7526516657,102752,7526619409,8,0,0,37376,8,10041732225
5783,7526595635,3422,7526599057,6,0,1,3584,6,4679864607
5784,7526650543,43904,7526694447,4,0,0,512,4,7579355459
5785,7526724094,1042,7526725136,3,0,1,1024,3,4556890366
5786,7526745880,566,7526746446,5,0,1,512,5,6926463556
5787,7526792885,5971,7526798856,1,0,1,14848,1,7801216163
5788,7526800753,1042,7526801795,4,0,1,1024,4,10603499834
5789,7526842189,64988,7526907177,0,0,0,9216,0,5735624025
5790,7526852207,566,7526852773,6,0,1,512,6,1164390544
5791,7526857493,153975,7527011468,7,0,0,18944,7,598679649
5792,7526892897,104628,7526997525,6,0,0,1024,6,571153199
5793,7527031613,45596,7527077209,3,0,0,1024,3,3599454694
5794,7527055391,124484,7527179875,9,0,0,104960,9,7747832947
5795,7527285225,47288,7527332513,6,0,0,1536,6,9757446018
5796,7527299147,48980,7527348127,3,0,0,2048,3,9736280448
5797,7527303273,110450,7527413723,8,0,0,50176,8,3017270660
5798,7527387050,47288,7527434338,4,0,0,1536,4,3566954516
5799,7527400857,60146,7527461003,6,0,0,1536,6,9156857605
5800,7527447937,12308,7527460245,3,0,1,20480,3,3308460129
5801,7527450573,13858,7527464431,7,0,1,6656,7,3336122399
5802,7527488615,263142,7527751757,0,0,0,77312,0,7500557727
5803,7527493734,3904,7527497638,3,0,1,10752,3,4678396435
5804,7527501290,200991,7527702281,1,0,0,40960,1,9498164758
5805,7527514052,123296,7527637348,4,0,0,1024,4,9550761791
5806,7527682621,127366,7527809987,0,0,0,40448,0,1359644661
5807,7527849701,43904,7527893605,4,0,0,512,4,3045550156
5808,7527857224,98228,7527955452,8,0,0,22528,8,9429785433
5809,7527880531,3645,7527884176,5,0,1,10240,5,568698952
5810,7527995008,48980,7528043988,9,0,0,2048,9,1274470633
5811,7528030608,115296,7528145904,7,0,0,36864,7,799494205
5812,7528145691,45801,7528191492,6,0,0,1024,6,3932746863
5813,7528176726,107900,7528284626,1,0,0,54272,1,6486435466
5814,7528205525,100412,7528305937,0,0,0,29696,0,8195869476
5815,7528257251,70976,7528328227,1,0,0,8704,1,6283207109
5816,7528363927,1994,7528365921,6,0,1,2048,6,9466156165
5817,7528421486,103220,7528524706,2,0,0,38912,2,6824725984
5818,7528437370,11533,7528448903,1,0,1,18944,1,4206851317
5819,7528438706,14703,7528453409,7,0,1,7168,7,560362838
5820,7528472745,566,7528473311,5,0,1,512,5,8928284259
5821,7528480901,113721,7528594622,2,0,0,37888,2,9578432346
5822,7528490614,3422,7528494036,7,0,1,3584,7,4096762319
5823,7528491307,177655,7528668962,2,0,0,22528,2,7451876517
5824,7528576442,5326,7528581768,3,0,1,5632,3,543739977
5825,7528706747,45596,7528752343,1,0,0,1024,1,528689787
5826,7528751093,1265,7528752358,4,0,1,1024,4,8369936642
5827,7528752286,107028,7528859314,2,0,0,51200,2,4216131865
5828,7528836043,2470,7528838513,6,0,1,2560,6,4408402501
5829,7528847735,213842,7529061577,0,0,0,142848,0,9480243716
5830,7528877537,99164,7528976701,2,0,0,25600,2,277525329
5831,7528932281,171926,7529104207,9,0,0,54784,9,9995119415
5832,7529140119,2470,7529142589,3,0,1,2560,3,8011477669
5833,7529266630,45596,7529312226,4,0,0,1024,4,6575210559
5834,7529303104,78212,7529381316,0,0,0,12288,0,6676615034
5835,7529353974,107276,7529461250,9,0,0,52224,9,9054461329
5836,7529416740,72446,7529489186,6,0,0,512,6,6534977872
5837,7529438074,3422,7529441496,9,0,1,3584,9,3645871489
5838,7529442549,45596,7529488145,0,0,0,1024,0,3040968589
5839,7529486624,43904,7529530528,4,0,0,512,4,7146452461
5840,7529513385,3898,7529517283,7,0,1,4096,7,4461297884
5841,7529515562,128402,7529643964,9,0,0,46080,9,5591363383
5842,7529531423,1994,7529533417,5,0,1,2048,5,6621311577
5843,7529821519,45596,7529867115,3,0,0,1024,3,10277015324
5844,7529866074,66080,7529932154,8,0,0,12800,8,3342328819
5845,7529965658,80528,7530046186,9,0,0,14848,9,9864835174
5846,7529986775,5196,7529991971,5,0,1,13312,5,2124662132
5847,7530078185,47288,7530125473,6,0,0,1536,6,7526146285
5848,7530126661,43904,7530170565,6,0,0,512,6,6810106548
5849,7530164754,106964,7530271718,7,0,0,51200,7,6698635286
5850,7530269441,104397,7530373838,0,0,0,35328,0,8936678597
5851,7530276981,106544,7530383525,0,0,0,31744,0,2310404730
5852,7530289878,12825,7530302703,6,0,1,21504,6,86939553
5853,7530292778,49297,7530342075,6,0,0,1024,6,7146601021
5854,7530350602,56320,7530406922,3,0,0,512,3,10036639427
5855,7530398801,102128,7530500929,7,0,0,35328,7,3933580850
5856,7530415250,58199,7530473449,9,0,0,5632,9,3708009243
5857,7530465732,71665,7530537397,4,0,0,1536,4,7267772753
5858,7530527116,2870,7530529986,1,0,1,8704,1,2801808312
5859,7530574950,177709,7530752659,0,0,0,20480,0,240531920
5860,7530594102,3387,7530597489,9,0,1,9728,9,8218608931
5861,7530691783,145782,7530837565,2,0,0,71168,2,7801857458
5862,7530742392,3422,7530745814,1,0,1,3584,1,3083614023
5863,7530807175,4850,7530812025,6,0,1,5120,6,5946337228
5864,7530870742,2946,7530873688,6,0,1,3072,6,225862280
5865,7531042528,59132,7531101660,1,0,0,5120,1,7296030816
5866,7531094933,2946,7531097879,7,0,1,3072,7,5755837615
5867,7531298824,120536,7531419360,0,0,0,95744,0,1103126834
5868,7531364515,5196,7531369711,9,0,1,13312,9,944163579
5869,7531404684,163661,7531568345,3,0,0,1024,3,10614118412
5870,7531725665,3128,7531728793,6,0,1,9216,6,2376846665
5871,7531748580,14804,7531763384,1,0,1,28672,1,7158757648
5872,7531763269,112720,7531875989,0,0,0,12800,0,8443811854
5873,7531840998,1518,7531842516,7,0,1,1536,7,3938640255
5874,7531845376,97760,7531943136,1,0,0,20992,1,3839949241
5875,7531876751,157063,7532033814,2,0,0,90624,2,6027690331
5876,7531910554,566,7531911120,3,0,1,512,3,5115950942
5877,7531984213,49772,7532033985,6,0,0,512,6,5878846144
5878,7532086536,43904,7532130440,6,0,0,512,6,4705728410
5879,7532119942,110240,7532230182,7,0,0,61952,7,4419999780
5880,7532180242,74912,7532255154,1,0,0,512,1,9695868305
5881,7532266586,1042,7532267628,3,0,1,1024,3,23007005
5882,7532306600,50828,7532357428,8,0,0,3072,8,1631470107
5883,7532374102,107276,7532481378,9,0,0,52224,9,1070310010
5884,7532452073,32558,7532484631,1,0,1,53248,1,3471748567
5885,7532537830,10241,7532548071,5,0,1,16384,5,258392064
5886,7532539754,8983,7532548737,4,0,1,1024,4,493982352
5887,7532681596,99032,7532780628,0,0,0,30208,0,3656883072
5888,7532922251,43904,7532966155,3,0,0,512,3,4443417032
5889,7532994761,158684,7533153445,8,0,0,140288,8,7238846317
5890,7533007918,166221,7533174139,7,0,0,25600,7,66585925
5891,7533054677,566,7533055243,4,0,1,512,4,7580528517
5892,7533122542,85115,7533207657,3,0,0,512,3,210236090
5893,7533162809,2946,7533165755,1,0,1,3072,1,764779539
5894,7533169457,5240,7533174697,6,0,1,512,6,8433378046
5895,7533392312,86204,7533478516,9,0,0,13312,9,7615109121
5896,7533430931,11791,7533442722,4,0,1,19456,4,1828518501
5897,7533479112,55748,7533534860,1,0,0,4096,1,9602418463
5898,7533500454,566,7533501020,8,0,1,512,8,4080869744
5899,7533510524,57876,7533568400,3,0,0,1024,3,4603076406
5900,7533585384,5326,7533590710,5,0,1,5632,5,7957456281
5901,7533614193,160080,7533774273,1,0,0,10240,1,5419889832
5902,7533670166,2470,7533672636,7,0,1,2560,7,3119536055
5903,7533670966,4966,7533675932,8,0,1,12800,8,9366406026
5904,7533692817,99320,7533792137,1,0,0,26112,1,7265133042
5905,7533704720,87900,7533792620,3,0,0,1536,3,8795593743
5906,7533727094,4850,7533731944,7,0,1,5120,7,6558504549
5907,7533753590,566,7533754156,3,0,1,512,3,10023136731
5908,7533809915,118845,7533928760,9,0,0,80896,9,8664288953
5909,7533816497,2470,7533818967,7,0,1,2560,7,10568016474
5910,7533877030,1518,7533878548,9,0,1,1536,9,3525083287
5911,7533916510,12808,7533929318,7,0,1,512,7,3897448059
5912,7533949265,103625,7534052890,8,0,0,35328,8,413454400
5913,7534010519,115265,7534125784,0,0,0,46592,0,3033173337
5914,7534090620,5802,7534096422,7,0,1,6144,7,7893283264
5915,7534137033,99320,7534236353,2,0,0,26112,2,9964137323
5916,7534144128,7706,7534151834,6,0,1,8192,6,9813337240
5917,7534155479,155542,7534311021,6,0,0,1024,6,7519064997
5918,7534185700,132941,7534318641,0,0,0,20992,0,5203318368
5919,7534355284,126464,7534481748,8,0,0,115200,8,4875562561
5920,7534381302,6278,7534387580,4,0,1,6656,4,10390350201
5921,7534381708,8778,7534390486,8,0,1,4608,8,8599622942
5922,7534393314,2470,7534395784,4,0,1,2560,4,8830120202
5923,7534455817,29362,7534485179,8,0,1,3584,8,6759814521
5924,7534458454,128715,7534587169,9,0,0,46080,9,3770570686
5925,7534522310,566,7534522876,9,0,1,512,9,7178037641
5926,7534580926,11085,7534592011,3,0,1,5120,3,1873208613
5927,7534612815,173336,7534786151,8,0,0,153088,8,9736960840
5928,7534678738,107896,7534786634,4,0,0,1536,4,3276837860
5929,7534686073,3422,7534689495,7,0,1,3584,7,6727642500
5930,7534729192,107054,7534836246,0,0,0,25600,0,3490125081
5931,7534821228,70976,7534892204,1,0,0,8704,1,683082821
5932,7534914151,1518,7534915669,3,0,1,1536,3,8309055567
5933,7534954697,2946,7534957643,8,0,1,3072,8,8068005200
5934,7535090211,5326,7535095537,7,0,1,5632,7,9548629342
5935,7535105188,48980,7535154168,0,0,0,2048,0,5737805535
5936,7535105701,1518,7535107219,8,0,1,1536,8,332408195
5937,7535131989,1042,7535133031,6,0,1,1024,6,4197328279
5938,7535274311,97136,7535371447,9,0,0,18944,9,7053479642
5939,7535297450,3898,7535301348,8,0,1,4096,8,7524514324
5940,7535308297,2946,7535311243,3,0,1,3072,3,8995916147
5941,7535315211,566,7535315777,6,0,1,512,6,8988384054
5942,7535354635,3904,7535358539,9,0,1,10752,9,10261845435
5943,7535560624,4162,7535564786,7,0,1,11264,7,4037769071
5944,7535694998,3898,7535698896,1,0,1,4096,1,7089316997
5945,7535713460,1042,7535714502,4,0,1,1024,4,8019325132
5946,7535792001,5326,7535797327,5,0,1,5632,5,2413779403
5947,7535834909,107120,7535942029,0,0,0,51712,0,9654560256
5948,7535888479,1994,7535890473,3,0,1,2048,3,9600367312
5949,7536070854,45596,7536116450,4,0,0,1024,4,2137165088
5950,7536121874,43904,7536165778,4,0,0,512,4,5025151613
5951,7536221531,114452,7536335983,8,0,0,75776,8,10144006605
5952,7536533850,48980,7536582830,3,0,0,2048,3,7195438781
5953,7536546733,6754,7536553487,6,0,1,7168,6,4531684522
5954,7536576947,1994,7536578941,6,0,1,2048,6,8827309237
5955,7536715417,103844,7536819261,9,0,0,40960,9,2050513142
5956,7536733155,50672,7536783827,6,0,0,2560,6,8915929000
5957,7536761334,95885,7536857219,2,0,0,14336,2,9429194218
5958,7536762546,1042,7536763588,8,0,1,1024,8,9254552090
5959,7536924540,43904,7536968444,6,0,0,512,6,867898909
5960,7537000851,3898,7537004749,4,0,1,4096,4,1248124133
5961,7537071143,1994,7537073137,4,0,1,2048,4,1645076215
5962,7537101502,43904,7537145406,6,0,0,512,6,893434131
5963,7537138206,3422,7537141628,6,0,1,3584,6,5488701002
5964,7537249251,59132,7537308383,8,0,0,5120,8,7832749552
5965,7537320807,43904,7537364711,3,0,0,512,3,9456159674
5966,7537325038,73316,7537398354,2,0,0,16384,2,3969166190
5967,7537380621,111897,7537492518,0,0,0,35840,0,6600479075
5968,7537415826,328998,7537744824,0,0,0,343552,0,3018528757
5969,7537451128,184252,7537635380,7,0,0,11264,7,6575933675
5970,7537576718,189025,7537765743,7,0,0,68608,7,7098235128
5971,7537727866,136745,7537864611,8,0,0,29696,8,5153794527
5972,7537757365,53991,7537811356,6,0,0,1024,6,9361033805
5973,7537769622,155625,7537925247,0,0,0,87552,0,2349180653
5974,7537778609,3898,7537782507,1,0,1,4096,1,4435004471
5975,7537836189,117654,7537953843,7,0,0,12800,7,8004340972
5976,7537897703,136210,7538033913,7,0,0,47616,7,3347371437
5977,7538018607,108524,7538127131,8,0,0,56320,8,9293172205
5978,7538263938,85472,7538349410,7,0,0,20992,7,9657212996
5979,7538269092,5802,7538274894,8,0,1,6144,8,2977458812
5980,7538354916,43904,7538398820,4,0,0,512,4,1735601766
5981,7538407876,3128,7538411004,9,0,1,9216,9,5534947510
5982,7538646021,1994,7538648015,5,0,1,2048,5,1514435186
5983,7538780073,97136,7538877209,1,0,0,18944,1,6820699740
5984,7538812198,45596,7538857794,6,0,0,1024,6,5667124911
5985,7538814459,126566,7538941025,9,0,0,84992,9,2430906817
5986,7539017304,12308,7539029612,1,0,1,20480,1,9095364835
5987,7539078935,5802,7539084737,7,0,1,6144,7,1244748273
5988,7539172585,5712,7539178297,1,0,1,14336,1,777363787
5989,7539216540,118104,7539334644,7,0,0,38912,7,3014423980
5990,7539302835,1042,7539303877,8,0,1,1024,8,7991090250
5991,7539305447,132145,7539437592,1,0,0,48640,1,2353053112
5992,7539320314,45596,7539365910,1,0,0,1024,1,4865677054
5993,7539350691,52083,7539402774,6,0,0,2048,6,1054488505
5994,7539382786,56069,7539438855,8,0,0,4096,8,3596399268
5995,7539419793,120224,7539540017,8,0,0,94720,8,1737700320
5996,7539558456,1518,7539559974,7,0,1,1536,7,9225408216
5997,7539581651,58064,7539639715,8,0,0,6656,8,10631967575
5998,7539596689,43904,7539640593,4,0,0,512,4,8945699853
5999,7539621029,1042,7539622071,8,0,1,1024,8,9576402013
6000,7539631088,1042,7539632130,9,0,1,1024,9,6137848592
6001,7539675943,1994,7539677937,8,0,1,2048,8,6273106641
6002,7539683035,47177,7539730212,4,0,0,1024,4,3180886620
6003,7539721678,3904,7539725582,4,0,1,10752,4,10030863396
6004,7539778655,71867,7539850522,3,0,0,1024,3,7897695723
6005,7539939715,30491,7539970206,1,0,1,49152,1,5208498341
6006,7540221582,108212,7540329794,8,0,0,55296,8,5827420623
6007,7540347022,3898,7540350920,6,0,1,4096,6,1256409400
6008,7540472603,105404,7540578007,1,0,0,46080,1,3287648428
6009,7540494351,60824,7540555175,0,0,0,5632,0,5694150790
6010,7540519355,566,7540519921,6,0,1,512,6,10445399340
6011,7540740167,4679,7540744846,7,0,1,12288,7,7283815037
6012,7540752231,47288,7540799519,4,0,0,1536,4,7220038330
6013,7540793955,109447,7540903402,8,0,0,29696,8,1491873759
6014,7540806353,171161,7540977514,8,0,0,111616,8,1028648612
6015,7540829794,242673,7541072467,0,0,0,179200,0,1963533438
6016,7540923265,149529,7541072794,4,0,0,1024,4,1478408728
6017,7541071020,5664,7541076684,6,0,1,4096,6,159343778
6018,7541075727,74516,7541150243,8,0,0,10240,8,5640095485
6019,7541111917,1042,7541112959,8,0,1,1024,8,6772248094
6020,7541117399,220523,7541337922,9,0,0,101376,9,7384212902
6021,7541118480,45596,7541164076,4,0,0,1024,4,8969713724
6022,7541160971,3387,7541164358,3,0,1,9728,3,2597503858
6023,7541231541,162895,7541394436,1,0,0,58880,1,7691365859
6024,7541393681,1313,7541394994,1,0,1,512,1,2193913827
6025,7541424972,45596,7541470568,3,0,0,1024,3,259586481
6026,7541439209,55748,7541494957,2,0,0,4096,2,9558713610
6027,7541539294,4162,7541543456,4,0,1,11264,4,109382575
6028,7541627320,47288,7541674608,6,0,0,1536,6,8460674258
6029,7541688754,47288,7541736042,4,0,0,1536,4,10269323083
6030,7541745124,107900,7541853024,9,0,0,54272,9,1382838647
6031,7541769555,1042,7541770597,8,0,1,1024,8,3514786359
6032,7541812585,138068,7541950653,2,0,0,133120,2,7207882871
6033,7541889059,69955,7541959014,3,0,0,512,3,3357904272
6034,7541892011,119131,7542011142,0,0,0,45568,0,5977490840
6035,7541989781,96092,7542085873,0,0,0,25600,0,7884895529
6036,7542042899,115226,7542158125,7,0,0,23552,7,8465849470
6037,7542138158,1042,7542139200,5,0,1,1024,5,6793683041
6038,7542197255,87632,7542284887,0,0,0,23040,0,4951136453
6039,7542221422,107432,7542328854,1,0,0,52736,1,690880052
6040,7542391982,1518,7542393500,6,0,1,1536,6,8722553114
6041,7542415131,34279,7542449410,8,0,1,59904,8,4946293499
6042,7542546908,74516,7542621424,1,0,0,10240,1,4439264701
6043,7542563835,108836,7542672671,8,0,0,57344,8,7259188441
6044,7542595335,566,7542595901,4,0,1,512,4,3283900297
6045,7542709421,1994,7542711415,4,0,1,2048,4,3864863654
6046,7542731325,46170,7542777495,6,0,0,1024,6,3268701384
6047,7542735151,3422,7542738573,6,0,1,3584,6,9308247159
6048,7542776983,94820,7542871803,2,0,0,16384,2,1788104961
6049,7542816521,43904,7542860425,6,0,0,512,6,778109687
6050,7543008132,103220,7543111352,7,0,0,38912,7,6681301063
6051,7543026740,5802,7543032542,7,0,1,6144,7,8866218476
6052,7543125295,87320,7543212615,2,0,0,22016,2,189841703
6053,7543133626,3898,7543137524,5,0,1,4096,5,4744552531
6054,7543184200,7230,7543191430,4,0,1,7680,4,8290713399
6055,7543195099,83468,7543278567,1,0,0,19456,1,7037316558
6056,7543203494,1518,7543205012,6,0,1,1536,6,7296845432
6057,7543224086,3898,7543227984,4,0,1,4096,4,4794070926
6058,7543299297,3898,7543303195,6,0,1,4096,6,4064473834
6059,7543304317,62785,7543367102,4,0,0,3072,4,8064248540
6060,7543314390,44252,7543358642,3,0,0,512,3,8216144125
6061,7543413287,3422,7543416709,4,0,1,3584,4,1200630847
6062,7543488346,71842,7543560188,3,0,0,512,3,1727188020
6063,7543542774,4850,7543547624,5,0,1,5120,5,2797876853
6064,7543559244,215583,7543774827,8,0,0,76800,8,4289116989
6065,7543642277,566,7543642843,3,0,1,512,3,5024810710
6066,7543714547,2870,7543717417,1,0,1,8704,1,3626907458
6067,7543749365,86672,7543836037,8,0,0,14848,8,10482604513
6068,7543782993,23637,7543806630,1,0,1,42496,1,10730868178
6069,7544000310,3128,7544003438,1,0,1,9216,1,3601498559
6070,7544038211,107900,7544146111,7,0,0,54272,7,4776001302
6071,7544088185,58253,7544146438,6,0,0,1024,6,10197520896
6072,7544122781,86174,7544208955,7,0,0,11264,7,5862614886
6073,7544140912,124335,7544265247,7,0,0,59904,7,1864750181
6074,7544234215,566,7544234781,7,0,1,512,7,5993701951
6075,7544235597,44222,7544279819,4,0,0,512,4,8505696430
6076,7544308957,56216,7544365173,2,0,0,5632,2,5582934427
6077,7544412754,4937,7544417691,4,0,1,12800,4,4536310723
6078,7544558275,111332,7544669607,0,0,0,65536,0,2990496689
6079,7544571982,3898,7544575880,5,0,1,4096,5,7647268648
6080,7544624439,170388,7544794827,1,0,0,25600,1,149884022
6081,7544630649,115182,7544745831,0,0,0,26112,0,4114944873
6082,7544799058,2946,7544802004,5,0,1,3072,5,4820328934
6083,7544827484,61136,7544888620,9,0,0,6656,9,7890548571
6084,7544835282,191455,7545026737,0,0,0,23040,0,1325392994
6085,7544864468,45596,7544910064,7,0,0,1024,7,2384577351
6086,7545061215,43904,7545105119,3,0,0,512,3,7418368580
6087,7545126180,566,7545126746,4,0,1,512,4,6651889942
6088,7545207671,72668,7545280339,8,0,0,9216,8,8838987748
6089,7545245390,94844,7545340234,2,0,0,21504,2,2732278209
6090,7545317611,43904,7545361515,0,0,0,512,0,10110541616
6091,7545353741,14287,7545368028,9,0,1,27648,9,5824956001
6092,7545401123,83288,7545484411,0,0,0,13824,0,8897372409
6093,7545409069,43904,7545452973,4,0,0,512,4,9759771699
6094,7545462093,1042,7545463135,4,0,1,1024,4,821679828
6095,7545470380,7706,7545478086,4,0,1,8192,4,8867155905
6096,7545500277,1518,7545501795,4,0,1,1536,4,7351666184
6097,7545512500,104000,7545616500,0,0,0,41472,0,10369052992
6098,7545519434,159358,7545678792,9,0,0,124928,9,4652571495
6099,7545575676,192164,7545767840,1,0,0,85504,1,1652187174
6100,7545620932,57883,7545678815,1,0,1,96768,1,9503157262
6101,7545643752,252275,7545896027,4,0,0,1024,4,28096546
6102,7545677765,4950,7545682715,5,0,1,4096,5,9604491016
6103,7545679687,6254,7545685941,5,0,1,5120,5,8048896234
6104,7545721004,196713,7545917717,6,0,0,512,6,2680514861
6105,7545737498,56837,7545794335,4,0,0,512,4,1740065337
6106,7545766285,7349,7545773634,1,0,1,6144,1,9332695830
6107,7545850052,115819,7545965871,2,0,0,78848,2,1328059762
6108,7545850483,178659,7546029142,0,0,0,29696,0,2131284568
6109,7545911304,82726,7545994030,9,0,0,10240,9,6070364810
6110,7545945753,23073,7545968826,7,0,1,3072,7,4613898210
6111,7545946948,23184,7545970132,9,0,1,2048,9,9235975552
6112,7546032627,97760,7546130387,0,0,0,20992,0,5202697781
6113,7546103836,65768,7546169604,9,0,0,11776,9,10735546353
6114,7546285698,108212,7546393910,1,0,0,55296,1,6223475452
6115,7546300824,6754,7546307578,6,0,1,7168,6,3045661301
6116,7546470473,1518,7546471991,6,0,1,1536,6,2354510045
6117,7546473007,55904,7546528911,0,0,0,4608,0,8767237652
6118,7546502138,107120,7546609258,0,0,0,51712,0,1172461165
6119,7546680843,54056,7546734899,8,0,0,3584,8,10081051690
6120,7546821239,6488,7546827727,3,0,1,15872,3,5215558325
6121,7546908094,45596,7546953690,3,0,0,1024,3,340308681
6122,7546950707,32299,7546983006,1,0,1,52736,1,4953221486
6123,7547071688,93737,7547165425,1,0,1,155648,1,2314654126
6124,7547385382,43904,7547429286,4,0,0,512,4,4233238871
6125,7547461998,99388,7547561386,7,0,0,19456,7,7616500858
6126,7547464094,70064,7547534158,8,0,0,10752,8,10521360587
6127,7547485445,45375,7547530820,3,0,0,512,3,10456131002
6128,7547498130,1042,7547499172,4,0,1,1024,4,2480586540
6129,7547532639,179328,7547711967,0,0,0,61440,0,6202477839
6130,7547613916,103025,7547716941,6,0,0,1024,6,4862763565
6131,7547641851,5712,7547647563,8,0,1,14336,8,7903313212
6132,7547686275,3422,7547689697,1,0,1,3584,1,8667478192
6133,7547699124,61815,7547760939,3,0,0,2048,3,4210939171
6134,7547780590,2946,7547783536,3,0,1,3072,3,8449201106
6135,7547798080,48980,7547847060,9,0,0,2048,9,132232513
6136,7547842961,6278,7547849239,4,0,1,6656,4,8762537398
6137,7547861814,208304,7548070118,9,0,0,79360,9,9454567718
6138,7547867261,155878,7548023139,8,0,0,49152,8,4342543706
6139,7547887957,262699,7548150656,7,0,0,115712,7,8585532764
6140,7547904862,131559,7548036421,6,0,0,1024,6,3412571704
6141,7547963961,194042,7548158003,0,0,0,24064,0,5319779416
6142,7548042344,47288,7548089632,6,0,0,1536,6,9889650769
6143,7548103726,54292,7548158018,8,0,1,90112,8,2345914621
6144,7548164229,45596,7548209825,3,0,0,1024,3,9570935006
6145,7548183113,143186,7548326299,6,0,0,1024,6,6213285777
6146,7548283067,43904,7548326971,6,0,0,512,6,4187183817
6147,7548455285,59912,7548515197,8,0,0,7680,8,7428016595
6148,7548486294,114296,7548600590,0,0,0,75264,0,1937494580
6149,7548579265,26643,7548605908,6,0,1,5632,6,4125171642
6150,7548625259,86096,7548711355,0,0,0,23040,0,5401140073
6151,7548662398,2870,7548665268,4,0,1,8704,4,3932104171
6152,7548757591,2946,7548760537,6,0,1,3072,6,4559442840
6153,7548882302,2946,7548885248,3,0,1,3072,3,3471185149
6154,7548976739,1042,7548977781,7,0,1,1024,7,6869415176
6155,7549074449,6278,7549080727,9,0,1,6656,9,7032740057
6156,7549078599,45596,7549124195,3,0,0,1024,3,5115992311
6157,7549162398,45596,7549207994,6,0,0,1024,6,6527395134
6158,7549172947,121513,7549294460,0,0,0,56832,0,5105064963
6159,7549292522,4400,7549296922,9,0,1,2560,9,3770647459
6160,7549327330,6278,7549333608,6,0,1,6656,6,9337141721
6161,7549332710,1244,7549333954,4,0,1,512,4,2483107633
6162,7549438023,1518,7549439541,5,0,1,1536,5,1590761546
6163,7549439535,1994,7549441529,5,0,1,2048,5,3332884941
6164,7549493929,43904,7549537833,3,0,0,512,3,1467434712
6165,7549586735,5802,7549592537,7,0,1,6144,7,2660481304
6166,7549670037,43904,7549713941,3,0,0,512,3,7633802400
6167,7549851876,57440,7549909316,8,0,0,4608,8,8782101989
6168,7549875223,1042,7549876265,4,0,1,1024,4,10483745507
6169,7549882623,116738,7549999361,9,0,0,34816,9,2333635534
6170,7549897888,4374,7549902262,3,0,1,4608,3,2200689824
6171,7549920520,194993,7550115513,6,0,0,1024,6,7861236384
6172,7550013058,102128,7550115186,7,0,0,35328,7,2728800914
6173,7550130128,48980,7550179108,6,0,0,2048,6,6041617618
6174,7550187765,98228,7550285993,0,0,0,22528,0,3976198773
6175,7550187906,7230,7550195136,4,0,1,7680,4,10091383403
6176,7550259816,48980,7550308796,4,0,0,2048,4,5674489526
6177,7550265070,4374,7550269444,6,0,1,4608,6,10261863247
6178,7550278417,175220,7550453637,0,0,0,42496,0,10093285948
6179,7550286518,3128,7550289646,1,0,1,9216,1,4497087050
6180,7550301264,77733,7550378997,7,0,0,4608,7,2936324318
6181,7550301657,45596,7550347253,4,0,0,1024,4,6145745529
6182,7550348882,5802,7550354684,6,0,1,6144,6,1805300137
6183,7550378761,3650,7550382411,5,0,1,3584,5,5170640471
6184,7550434186,76052,7550510238,2,0,0,10240,2,8523275878
6185,7550491707,1042,7550492749,5,0,1,1024,5,4666734797
6186,7550510758,120020,7550630778,7,0,0,62464,7,8191195098
6187,7550517963,193485,7550711448,7,0,0,94208,7,6709813985
6188,7550542353,566,7550542919,5,0,1,512,5,4016406950
6189,7550588937,122838,7550711775,4,0,0,1024,4,1133136660
6190,7550722028,7230,7550729258,7,0,1,7680,7,9519830461
6191,7550735781,1042,7550736823,9,0,1,1024,9,4171083804
6192,7550744891,50174,7550795065,6,0,0,1536,6,1085877446
6193,7550780805,108212,7550889017,7,0,0,55296,7,2824317169
6194,7550819336,7706,7550827042,3,0,1,8192,3,3920355110
6195,7550850113,5326,7550855439,4,0,1,5632,4,5284544474
6196,7550883487,113975,7550997462,8,0,0,29696,8,2117771281
6197,7550961871,2870,7550964741,3,0,1,8704,3,1624400265
6198,7551157920,62516,7551220436,7,0,0,6144,7,10242474590
6199,7551189789,13858,7551203647,8,0,1,23552,8,4635832758
6200,7551283196,6754,7551289950,7,0,1,7168,7,6294398091
6201,7551343116,12825,7551355941,8,0,1,21504,8,929825780
6202,7551424641,1042,7551425683,9,0,1,1024,9,5807127500
6203,7551441471,84475,7551525946,1,0,1,137728,1,3285916412
6204,7551460574,200357,7551660931,1,0,0,18944,1,3210403317
6205,7551509914,208657,7551718571,8,0,0,38912,8,6208495296
6206,7551608916,74608,7551683524,1,0,1,121856,1,2356598293
6207,7551615411,272046,7551887457,0,0,0,112640,0,960090216
6208,7551822253,65531,7551887784,4,0,0,1024,4,10555798635
6209,7551973728,6754,7551980482,7,0,1,7168,7,8551167850
6210,7551987691,5712,7551993403,9,0,1,14336,9,5316039260
6211,7552015647,566,7552016213,6,0,1,512,6,5169947254
6212,7552022733,54836,7552077569,7,0,0,6144,7,1920073659
6213,7552138576,21399,7552159975,1,0,1,34816,1,10583448716
6214,7552146594,15647,7552162241,5,0,1,3584,5,1250863613
6215,7552179368,6754,7552186122,4,0,1,7168,4,3580166339
6216,7552186111,127379,7552313490,8,0,0,61440,8,4063140626
6217,7552453783,4162,7552457945,3,0,1,11264,3,5443195836
6218,7552491001,221121,7552712122,1,0,0,34816,1,2717433943
6219,7552561510,43904,7552605414,1,0,0,512,1,2053376367
6220,7552565327,1518,7552566845,4,0,1,1536,4,6557009639
6221,7552623634,89127,7552712761,3,0,0,2048,3,9709740409
6222,7552780859,21916,7552802775,1,0,1,35840,1,766370804
6223,7552789997,45735,7552835732,4,0,0,512,4,585065358
6224,7552844495,34367,7552878862,1,0,1,56832,1,9754089606
6225,7552862015,94913,7552956928,7,0,0,1024,7,1502592961
6226,7553066298,43904,7553110202,9,0,0,512,9,124479655
6227,7553066595,2470,7553069065,3,0,1,2560,3,3710159887
6228,7553090949,99320,7553190269,1,0,0,26112,1,953475186
6229,7553095023,3128,7553098151,7,0,1,9216,7,6644486572
6230,7553127670,45596,7553173266,6,0,0,1024,6,9087110963
6231,7553247291,64208,7553311499,9,0,0,6656,9,6175030568
6232,7553275348,50672,7553326020,9,0,0,2560,9,6779808081
6233,7553317474,1042,7553318516,5,0,1,1024,5,4491941684
6234,7553347782,45596,7553393378,6,0,0,1024,6,8576066216
6235,7553373282,10241,7553383523,6,0,1,16384,6,6134011508
6236,7553392838,5326,7553398164,6,0,1,5632,6,2598138172
6237,7553449878,566,7553450444,7,0,1,512,7,5329865187
6238,7553477712,4374,7553482086,5,0,1,4608,5,8734802371
6239,7553561123,45596,7553606719,6,0,0,1024,6,8937158461
6240,7553638301,103376,7553741677,9,0,0,39424,9,7349686685
6241,7553688412,85101,7553773513,8,0,0,512,8,8314629777
6242,7553712328,144219,7553856547,2,0,0,45056,2,567196032
6243,7553777518,87303,7553864821,6,0,0,512,6,8451533974
6244,7553791202,5802,7553797004,9,0,1,6144,9,7380728833
6245,7553804128,72099,7553876227,6,0,0,1536,6,10409859513
6246,7553875992,23605,7553899597,1,0,1,41984,1,2971845306
6247,7553999785,5326,7554005111,7,0,1,5632,7,5231609674
6248,7554047965,102752,7554150717,8,0,0,37376,8,1643138115
6249,7554070167,36346,7554106513,8,0,1,64000,8,3005332874
6250,7554170880,43904,7554214784,4,0,0,512,4,2827604096
6251,7554183804,147246,7554331050,3,0,0,512,3,3421484955
6252,7554226618,566,7554227184,7,0,1,512,7,421550399
6253,7554241716,110790,7554352506,0,0,0,55808,0,778306436
6254,7554318448,43904,7554362352,6,0,0,512,6,4449951282
6255,7554460270,566,7554460836,6,0,1,512,6,6226601123
6256,7554492186,165973,7554658159,8,0,0,34816,8,4046443426
6257,7554545143,3904,7554549047,5,0,1,10752,5,215191265
6258,7554611392,68313,7554679705,1,0,0,3584,1,8619511984
6259,7554632049,106282,7554738331,8,0,0,18432,8,6462113166
6260,7554678213,102284,7554780497,9,0,0,35840,9,8130193227
6261,7554693351,6754,7554700105,7,0,1,7168,7,8076990476
6262,7554724317,98240,7554822557,8,0,0,15360,8,2789026860
6263,7554771785,12602,7554784387,9,0,1,4096,9,10370666201
6264,7554814140,74210,7554888350,4,0,0,3072,4,9491268108
6265,7554827978,120784,7554948762,0,0,0,4608,0,8910389733
6266,7554829979,45596,7554875575,4,0,0,1024,4,131879307
6267,7554924384,46471,7554970855,1,0,1,80384,1,1416485101
6268,7555006622,6278,7555012900,1,0,1,6656,1,8634906699
6269,7555077422,21399,7555098821,1,0,1,34816,1,1016313042
6270,7555084776,18871,7555103647,6,0,1,7680,6,6105033613
6271,7555121634,1042,7555122676,5,0,1,1024,5,4148432900
6272,7555211218,5326,7555216544,3,0,1,5632,3,8564355481
6273,7555219206,7706,7555226912,4,0,1,8192,4,4665257574
6274,7555420521,103376,7555523897,2,0,0,39424,2,3698357705
6275,7555501403,63140,7555564543,1,0,0,8192,1,6776390233
6276,7555506097,72724,7555578821,0,0,0,10752,0,2979662264
6277,7555565939,45179,7555611118,1,0,1,77824,1,5546616991
6278,7555796823,47288,7555844111,3,0,0,1536,3,9326640020
6279,7555838269,102284,7555940553,9,0,0,35840,9,6072105338
6280,7555929232,62516,7555991748,1,0,0,6144,1,4275229906
6281,7555950719,43904,7555994623,3,0,0,512,3,10516552471
6282,7555986905,43887,7556030792,8,0,1,75264,8,1386658564
6283,7556056936,1518,7556058454,4,0,1,1536,4,1825226205
6284,7556274107,91796,7556365903,7,0,0,26624,7,5811454563
6285,7556372562,70991,7556443553,8,0,1,114688,8,2463174900
6286,7556434842,9057,7556443899,3,0,1,512,3,10218706745
6287,7556460683,65478,7556526161,6,0,0,1536,6,3160283632
6288,7556498559,54100,7556552659,8,0,1,88576,8,1195383697
6289,7556538985,14980,7556553965,6,0,1,2048,6,8035154396
6290,7556596856,186822,7556783678,9,0,0,37888,9,6739999005
6291,7556675926,146345,7556822271,3,0,0,3584,3,513623577
6292,7556778504,10968,7556789472,7,0,1,6144,7,208460975
6293,7556784691,48188,7556832879,6,0,0,1536,6,7671005794
6294,7556787761,228382,7557016143,8,0,0,67072,8,6077982558
6295,7556854162,115835,7556969997,7,0,0,4096,7,7584515845
6296,7556856172,13600,7556869772,1,0,1,23040,1,674397018
6297,7556929415,43904,7556973319,4,0,0,512,4,8130354720
6298,7556934132,33591,7556967723,1,0,1,55296,1,5878339177
6299,7556936465,33547,7556970012,7,0,1,3072,7,1768488908
6300,7557101336,65900,7557167236,8,0,0,7168,8,5716058887
6301,7557121374,113672,7557235046,8,0,0,73216,8,3687358497
6302,7557179403,5802,7557185205,5,0,1,6144,5,9610985225
6303,7557192862,70492,7557263354,4,0,0,2560,4,8694436449
6304,7557241794,209372,7557451166,7,0,0,74752,7,7349677445
6305,7557280953,566,7557281519,9,0,1,512,9,5775645755
6306,7557321099,107276,7557428375,1,0,0,52224,1,4971699288
6307,7557384056,138591,7557522647,1,0,0,61952,1,10631055684
6308,7557438575,19813,7557458388,7,0,1,7680,7,5583867026
6309,7557468514,85766,7557554280,3,0,0,1024,3,8523764971
6310,7557510788,19081,7557529869,5,0,1,7680,5,4381314585
6311,7557610752,1518,7557612270,6,0,1,1536,6,1594249999
6312,7557654734,12737,7557667471,4,0,1,24576,4,6288073189
6313,7557784591,43904,7557828495,3,0,0,512,3,5457165225
6314,7557793887,205100,7557998987,9,0,0,211968,9,10657823869
6315,7557796067,203426,7557999493,0,0,0,1024,0,9233343639
6316,7557923416,75750,7557999166,3,0,0,512,3,6569727
6317,7557971181,32169,7558003350,4,0,1,4096,4,6974552335
6318,7558040848,3387,7558044235,5,0,1,9728,5,3628893952
6319,7558048941,3387,7558052328,6,0,1,9728,6,2769561739
6320,7558241098,12737,7558253835,1,0,1,24576,1,6794232087
6321,7558301181,59132,7558360313,0,0,0,5120,0,2510881316
6322,7558386548,151601,7558538149,0,0,0,88064,0,3877322041
6323,7558438009,47288,7558485297,4,0,0,1536,4,5624300323
6324,7558482438,185808,7558668246,7,0,0,27136,7,6364580859
6325,7558488047,1042,7558489089,3,0,1,1024,3,5057716960
6326,7558496820,89889,7558586709,4,0,0,1024,4,10472143163
6327,7558514008,27520,7558541528,4,0,1,9728,4,6482344060
6328,7558657861,126649,7558784510,8,0,0,78848,8,9387216212
6329,7558669125,130068,7558799193,1,0,0,43008,1,2816299975
6330,7558678466,48980,7558727446,3,0,0,2048,3,622901546
6331,7558690615,4162,7558694777,6,0,1,11264,6,5608656553
6332,7558735689,147231,7558882920,1,0,0,81920,1,9470884188
6333,7558741004,159723,7558900727,0,0,0,58368,0,1306659383
6334,7558859131,128249,7558987380,7,0,0,43008,7,1913883395
6335,7559006461,1518,7559007979,7,0,1,1536,7,3888520873
6336,7559070143,48980,7559119123,0,0,0,2048,0,8685941902
6337,7559226910,4374,7559231284,3,0,1,4608,3,2010324075
6338,7559304171,83932,7559388103,4,0,0,1024,4,10628379739
6339,7559393222,1042,7559394264,5,0,1,1024,5,7759143654
6340,7559452786,1994,7559454780,1,0,1,2048,1,1431774691
6341,7559454219,907,7559455126,3,0,1,512,3,7616237612
6342,7559484704,5196,7559489900,5,0,1,13312,5,1338117184
6343,7559625786,47288,7559673074,3,0,0,1536,3,10617574565
6344,7559639832,13858,7559653690,8,0,1,23552,8,4448753710
6345,7559650278,176039,7559826317,8,0,0,136192,8,1707014142
6346,7559744818,172919,7559917737,7,0,0,108032,7,4729819092
6347,7559761884,5802,7559767686,5,0,1,6144,5,5931681538
6348,7559778417,566,7559778983,7,0,1,512,7,6759834352
6349,7559780870,97330,7559878200,0,0,0,10752,0,5879128948
6350,7559872121,45795,7559917916,4,0,0,512,4,500298143
6351,7559881141,43904,7559925045,6,0,0,512,6,7579673463
6352,7559900741,22460,7559923201,6,0,1,5632,6,2899158133
6353,7559921406,4701,7559926107,5,0,1,4608,5,661420893
6354,7559964213,5326,7559969539,3,0,1,5632,3,2223064469
6355,7559991121,7706,7559998827,8,0,1,8192,8,9334867934
6356,7559992568,7565,7560000133,7,0,1,2048,7,8993356841
6357,7560036587,2470,7560039057,3,0,1,2560,3,2219440971
6358,7560042091,100568,7560142659,9,0,0,30208,9,6438319591
6359,7560060826,43904,7560104730,3,0,0,512,3,6667643026
6360,7560072415,5971,7560078386,6,0,1,14848,6,3197627698
6361,7560102064,4679,7560106743,6,0,1,12288,6,6267885766
6362,7560217283,49292,7560266575,1,0,0,3072,1,9411116728
6363,7560251738,43904,7560295642,4,0,0,512,4,1365119634
6364,7560361213,89636,7560450849,7,0,0,24576,7,346924422
6365,7560511091,45596,7560556687,4,0,0,1024,4,3516760452
6366,7560616290,2946,7560619236,7,0,1,3072,7,81011902
6367,7560622097,45596,7560667693,6,0,0,1024,6,9363952617
6368,7560667706,88052,7560755758,1,0,0,14336,1,9546612289
6369,7560694212,566,7560694778,6,0,1,512,6,339009041
6370,7560700176,566,7560700742,1,0,1,512,1,9222098372
6371,7560925429,115520,7561040949,8,0,0,74240,8,3433879850
6372,7560947217,132186,7561079403,7,0,0,12800,7,10513397887
6373,7561048399,116948,7561165347,0,0,0,15360,0,7099063771
6374,7561085188,6278,7561091466,5,0,1,6656,5,3416605542
6375,7561129761,109728,7561239489,9,0,0,30720,9,416964051
6376,7561229042,566,7561229608,9,0,1,512,9,7718478248
6377,7561240830,93128,7561333958,1,0,0,15872,1,4787695325
6378,7561316878,5196,7561322074,5,0,1,13312,5,3396050020
6379,7561335419,4850,7561340269,9,0,1,5120,9,6797211484
6380,7561342089,64746,7561406835,3,0,0,1024,3,543503485
6381,7561427180,3645,7561430825,5,0,1,10240,5,584848526
6382,7561472917,60824,7561533741,3,0,0,5632,3,4375483246
6383,7561594572,1518,7561596090,2,0,1,1536,2,6157890739
6384,7561599211,2870,7561602081,7,0,1,8704,7,5020096074
6385,7561638454,47288,7561685742,4,0,0,1536,4,5046939915
6386,7561778690,43904,7561822594,6,0,0,512,6,10687843369
6387,7561784688,102596,7561887284,7,0,0,36864,7,3112791448
6388,7561795213,3422,7561798635,7,0,1,3584,7,5568693328
6389,7561811492,142290,7561953782,9,0,0,27136,9,2887683988
6390,7561813400,86190,7561899590,6,0,0,512,6,2738899245
6391,7561833202,56602,7561889804,1,0,0,2560,1,9408725252
6392,7561878538,108058,7561986596,2,0,0,26112,2,9083600698
6393,7561879306,154492,7562033798,1,0,0,28672,1,5875300444
6394,7561887801,82532,7561970333,1,0,0,16384,1,93829865
6395,7561966651,103774,7562070425,7,0,0,28672,7,10447024772
6396,7562027651,86535,7562114186,9,0,0,19456,9,7601079816
6397,7562040107,103376,7562143483,7,0,0,39424,7,8416464819
6398,7562091439,65418,7562156857,6,0,0,1536,6,4381999081
6399,7562105541,37965,7562143506,1,0,1,61952,1,2023531139
6400,7562123265,150749,7562274014,3,0,0,23552,3,10432407603
6401,7562132807,11234,7562144041,3,0,1,512,3,2884385622
6402,7562251627,1042,7562252669,7,0,1,1024,7,6892323699
6403,7562259221,4374,7562263595,9,0,1,4608,9,4637187254
6404,7562284627,64208,7562348835,3,0,0,6656,3,2417235665
6405,7562323705,213380,7562537085,0,0,0,30208,0,9908940877
6406,7562345209,121784,7562466993,0,0,0,99840,0,2391955607
6407,7562353903,203633,7562557536,0,0,0,67072,0,1141720671
6408,7562416993,57284,7562474277,3,0,0,512,3,3557589277
6409,7562506558,3898,7562510456,9,0,1,4096,9,8175241296
6410,7562550432,117319,7562667751,4,0,0,1536,4,1206528088
6411,7562568632,50672,7562619304,4,0,0,2560,4,397091793
6412,7562606494,7706,7562614200,9,0,1,8192,9,1566385463
6413,7562715392,6754,7562722146,2,0,1,7168,2,598419657
6414,7562861284,1994,7562863278,3,0,1,2048,3,1886799350
6415,7562990986,69284,7563060270,0,0,0,8192,0,5898627457
6416,7563008815,13512,7563022327,8,0,1,26112,8,4537892139
6417,7563104275,34108,7563138383,8,0,1,56320,8,1857620202
6418,7563123368,16321,7563139689,5,0,1,2048,5,4054589658
6419,7563129404,13831,7563143235,6,0,1,5632,6,5439935732
6420,7563155218,211975,7563367193,7,0,0,109056,7,6844597515
6421,7563184372,184708,7563369080,3,0,0,6144,3,4612844823
6422,7563237467,47658,7563285125,6,0,0,1024,6,8385001347
6423,7563276426,3422,7563279848,8,0,1,3584,8,2400471338
6424,7563389077,12308,7563401385,8,0,1,20480,8,4609742069
6425,7563417991,1042,7563419033,6,0,1,1024,6,1082553909
6426,7563488314,85818,7563574132,8,0,0,8192,8,9938101815
6427,7563588531,4374,7563592905,5,0,1,4608,5,8844112145
6428,7563910257,48980,7563959237,2,0,0,2048,2,3156566243
6429,7563974878,107113,7564081991,3,0,0,5632,3,4591775808
6430,7563977136,26738,7564003874,1,0,1,48640,1,4080028961
6431,7564008686,4850,7564013536,1,0,1,5120,1,342713264
6432,7564068225,51409,7564119634,4,0,0,1024,4,7891517688
6433,7564069430,47288,7564116718,9,0,0,1536,9,7156407781
6434,7564089148,566,7564089714,3,0,1,512,3,5484227276
6435,7564112932,184305,7564297237,8,0,0,48128,8,10326490516
6436,7564218638,1518,7564220156,6,0,1,1536,6,7654250787
6437,7564235763,68812,7564304575,4,0,0,512,4,8429584087
6438,7564306617,2946,7564309563,3,0,1,3072,3,324403570
6439,7564307975,3534,7564311509,4,0,1,3072,4,5396157461
6440,7564366381,7230,7564373611,2,0,1,7680,2,3699330291
6441,7564383597,1518,7564385115,2,0,1,1536,2,8294750010
6442,7564423884,1042,7564424926,9,0,1,1024,9,3214612630
6443,7564511912,119756,7564631668,2,0,0,93184,2,2156401249
6444,7564592852,57656,7564650508,6,0,0,1536,6,9316995652
6445,7564609081,68175,7564677256,6,0,0,1024,6,9660159435
6446,7564684460,5326,7564689786,4,0,1,5632,4,7833442136
6447,7564906231,6754,7564912985,4,0,1,7168,4,3422835397
6448,7564924189,2946,7564927135,6,0,1,3072,6,5922138568
6449,7565001552,129797,7565131349,0,0,0,25600,0,3679384772
6450,7565027650,49292,7565076942,0,0,0,3072,0,5719510044
6451,7565044507,45596,7565090103,6,0,0,1024,6,8354169469
6452,7565097758,69284,7565167042,1,0,0,8192,1,9305307615
6453,7565109228,48980,7565158208,7,0,0,2048,7,293197135
6454,7565229015,7706,7565236721,5,0,1,8192,5,1517708166
6455,7565260753,54056,7565314809,1,0,0,3584,1,5833490498
6456,7565283834,4162,7565287996,5,0,1,11264,5,3511664724
6457,7565310415,5326,7565315741,3,0,1,5632,3,8591054232
6458,7565326385,4374,7565330759,6,0,1,4608,6,10023026001
6459,7565347448,192626,7565540074,1,0,0,16896,1,4821490687
6460,7565375386,74360,7565449746,3,0,0,9728,3,2466310412
6461,7565433721,125685,7565559406,1,0,0,45056,1,3651825688
6462,7565456960,106673,7565563633,2,0,0,13824,2,32791423
6463,7565490070,101052,7565591122,0,0,0,13312,0,1813907832
6464,7565637750,7706,7565645456,3,0,1,8192,3,542383440
6465,7565641060,116948,7565758008,0,0,0,83968,0,7355633513
6466,7565689309,105575,7565794884,8,0,0,6144,8,5256603820
6467,7565814835,111332,7565926167,3,0,0,65536,3,3221218611
6468,7565822290,142577,7565964867,0,0,0,31232,0,9750117161
6469,7565855101,4850,7565859951,1,0,1,5120,1,4413302067
6470,7565902890,1042,7565903932,2,0,1,1024,2,6834098730
6471,7565938923,97448,7566036371,1,0,0,19968,1,3636944089
6472,7565941421,283867,7566225288,3,0,0,27136,3,10251245928
6473,7565942815,7230,7565950045,6,0,1,7680,6,2426247583
6474,7565951061,90600,7566041661,7,0,0,7680,7,5685828380
6475,7565985289,52294,7566037583,4,0,0,1536,4,6626832591
6476,7566028908,101795,7566130703,9,0,0,27648,9,1649279622
6477,7566031526,15853,7566047379,5,0,1,17920,5,4938427547
6478,7566047386,105561,7566152947,7,0,0,46592,7,2729500380
6479,7566339754,566,7566340320,9,0,1,512,9,3335165287
6480,7566381966,566,7566382532,9,0,1,512,9,5666704901
6481,7566413157,3128,7566416285,3,0,1,9216,3,7899756170
6482,7566457303,98714,7566556017,4,0,0,512,4,7230955201
6483,7566488656,3645,7566492301,2,0,1,10240,2,2520689427
6484,7566668844,43904,7566712748,6,0,0,512,6,9555580540
6485,7566714710,101192,7566815902,0,0,0,32256,0,7465701383
6486,7566729386,43904,7566773290,4,0,0,512,4,4469322933
6487,7566759092,128768,7566887860,0,0,0,40448,0,7556999951
6488,7566805677,10240,7566815917,2,0,1,3072,2,9313026072
6489,7566818168,163802,7566981970,3,0,0,121344,3,8717100147
6490,7566835991,16096,7566852087,1,0,1,31232,1,6145484200
6491,7566954687,111679,7567066366,2,0,0,22528,2,9272519173
6492,7566973518,208336,7567181854,2,0,0,149504,2,741229706
6493,7566977986,112128,7567090114,1,0,0,9728,1,6668456459
6494,7566988395,1994,7566990389,6,0,1,2048,6,5190353230
6495,7567207343,97136,7567304479,1,0,0,18944,1,7002773592
6496,7567249266,566,7567249832,2,0,1,512,2,3430280402
6497,7567308444,43904,7567352348,6,0,0,512,6,3698491894
6498,7567329627,43904,7567373531,4,0,0,512,4,7380389212
6499,7567339079,59682,7567398761,6,0,0,1536,6,5454013515
6500,7567404542,50672,7567455214,6,0,0,2560,6,7138999372
6501,7567449659,50315,7567499974,6,0,0,1024,6,6115923064
6502,7567502822,33333,7567536155,1,0,1,54784,1,8910401836
6503,7567509327,27174,7567536501,4,0,1,512,4,3996475922
6504,7567510656,26191,7567536847,6,0,1,512,6,1101101940
6505,7567527002,87473,7567614475,4,0,0,512,4,7882808893
6506,7567551501,43904,7567595405,4,0,0,512,4,2561158666
6507,7567650323,1994,7567652317,3,0,1,2048,3,8747451306
6508,7567679358,110552,7567789910,1,0,0,62976,1,932745791
6509,7567718189,43904,7567762093,4,0,0,512,4,2176905721
6510,7567732812,5326,7567738138,4,0,1,5632,4,9959956043
6511,7567825435,6278,7567831713,2,0,1,6656,2,3877214965
6512,7567826240,5819,7567832059,6,0,1,512,6,7959369051
6513,7567837002,76122,7567913124,0,0,0,15360,0,7259748078
6514,7567889612,86732,7567976344,4,0,0,512,4,7945332998
6515,7567913518,43904,7567957422,4,0,0,512,4,9012759968
6516,7567949459,10757,7567960216,4,0,1,17408,4,792057785
6517,7568010395,86204,7568096599,1,0,0,13312,1,9043191233
6518,7568035082,81440,7568116522,3,0,0,12800,3,1371203945
6519,7568042121,4420,7568046541,2,0,1,11776,2,4597820922
6520,7568055945,146887,7568202832,3,0,0,68096,3,5410372155
6521,7568145006,4374,7568149380,4,0,1,4608,4,3856862792
6522,7568156418,118308,7568274726,2,0,0,56832,2,10223487233
6523,7568156980,4420,7568161400,5,0,1,11776,5,2668585080
6524,7568228794,46259,7568275053,4,0,0,1024,4,558128115
6525,7568236859,45596,7568282455,6,0,0,1024,6,1658306940
6526,7568331524,67592,7568399116,8,0,0,7680,8,9553886879
6527,7568388790,108654,7568497444,9,0,0,30720,9,8341875451
6528,7568409654,97760,7568507414,1,0,0,20992,1,5348339386
6529,7568449665,3422,7568453087,6,0,1,3584,6,8885179487
6530,7568515311,52964,7568568275,6,0,0,1536,6,3653643760
6531,7568524480,103376,7568627856,7,0,0,39424,7,4860288775
6532,7568552822,100924,7568653746,2,0,0,17408,2,1649545071
6533,7568635094,206848,7568841942,1,0,0,174080,1,1565311721
6534,7568698923,2946,7568701869,3,0,1,3072,3,1568821915
6535,7568971498,2946,7568974444,4,0,1,3072,4,6696014737
6536,7569092681,5712,7569098393,2,0,1,14336,2,2417591758
6537,7569380468,115076,7569495544,8,0,0,77824,8,2069937963
6538,7569393106,20882,7569413988,1,0,1,33792,1,9854456857
6539,7569417117,142882,7569559999,3,0,0,25088,3,5230585101
6540,7569511344,105343,7569616687,8,0,0,12288,8,667549524
6541,7569641581,2946,7569644527,3,0,1,3072,3,6566316388
6542,7569643687,89924,7569733611,2,0,0,20480,2,3097521284
6543,7569708151,7706,7569715857,4,0,1,8192,4,4696892260
6544,7569719294,82820,7569802114,7,0,0,12288,7,5815532357
6545,7569983767,43904,7570027671,6,0,0,512,6,5023522899
6546,7570123303,98072,7570221375,2,0,0,22016,2,5091239224
6547,7570229556,104936,7570334492,8,0,0,44544,8,1514876259
6548,7570235471,47288,7570282759,6,0,0,1536,6,5766694437
6549,7570283283,4374,7570287657,4,0,1,4608,4,6259146585
6550,7570307339,62984,7570370323,2,0,0,7680,2,2707160083
6551,7570467688,119288,7570586976,7,0,0,91648,7,7920552126
6552,7570488803,6754,7570495557,2,0,1,7168,2,7025227556
6553,7570515870,72864,7570588734,0,0,0,512,0,8126856497
6554,7570518370,131048,7570649418,9,0,0,68608,9,7460842296
6555,7570558441,112061,7570670502,9,0,0,5632,9,415571041
6556,7570591949,249486,7570841435,1,0,0,44544,1,1765461251
6557,7570592360,2946,7570595306,2,0,1,3072,2,7998111408
6558,7570609854,3898,7570613752,4,0,1,4096,4,1718747413
6559,7570611674,70840,7570682514,1,0,0,3584,1,6499149272
6560,7570626526,174998,7570801524,7,0,0,55296,7,6284171382
6561,7570694524,1042,7570695566,2,0,1,1024,2,5304335340
6562,7570731799,114487,7570846286,2,0,0,15872,2,6483510448
6563,7570809761,10241,7570820002,3,0,1,16384,3,2424957090
6564,7570923093,566,7570923659,9,0,1,512,9,696582880
6565,7570924350,48980,7570973330,8,0,0,2048,8,6898043308
6566,7570940188,6278,7570946466,4,0,1,6656,4,8849590546
6567,7570978767,101816,7571080583,9,0,0,34304,9,6972082475
6568,7571040659,25446,7571066105,1,0,1,46080,1,9230750628
6569,7571100898,341050,7571441948,7,0,0,300544,7,10356501416
6570,7571131807,5454,7571137261,9,0,1,13824,9,9025189007
6571,7571248534,195301,7571443835,7,0,0,6144,7,9532013468
6572,7571277507,2870,7571280377,2,0,1,8704,2,2091614623
6573,7571281165,172201,7571453366,0,0,0,31232,0,8988590870
6574,7571281360,1518,7571282878,9,0,1,1536,9,6444413900
6575,7571337500,116037,7571453537,4,0,0,512,4,7396741231
6576,7571457971,75140,7571533111,3,0,0,12288,3,941330075
6577,7571504077,2946,7571507023,4,0,1,3072,4,9716179253
6578,7571508781,103123,7571611904,4,0,0,1536,4,4759102203
6579,7571515464,153452,7571668916,3,0,0,138240,3,4209991869
6580,7571640051,33707,7571673758,3,0,1,5120,3,8218185218
6581,7571693343,93308,7571786651,2,0,0,21504,2,8007179999
6582,7571769513,47288,7571816801,4,0,0,1536,4,5412632300
6583,7572034664,3422,7572038086,3,0,1,3584,3,9504013577
6584,7572310288,2946,7572313234,5,0,1,3072,5,6939625206
6585,7572403405,82064,7572485469,3,0,0,14848,3,7228521495
6586,7572516691,3422,7572520113,1,0,1,3584,1,7640555057
6587,7572634294,7706,7572642000,3,0,1,8192,3,6504100560
6588,7572637065,6241,7572643306,1,0,1,2048,1,8411210161
6589,7572666113,45596,7572711709,6,0,0,1024,6,8479180978
6590,7572724822,4850,7572729672,4,0,1,5120,4,10947040
6591,7572741823,70976,7572812799,3,0,0,8704,3,3647426476
6592,7572853425,57596,7572911021,3,0,0,5120,3,9070748027
6593,7572880895,125528,7573006423,3,0,0,112128,3,2637674147
6594,7572919866,121933,7573041799,2,0,0,9216,2,5015247163
6595,7572932593,83514,7573016107,9,0,0,512,9,6458534571
6596,7572959892,86983,7573046875,0,0,0,10752,0,3351555836
6597,7572998672,109901,7573108573,7,0,0,25600,7,6654877507
6598,7573169789,11533,7573181322,3,0,1,18944,3,1898840281
6599,7573268089,2470,7573270559,9,0,1,2560,9,7396853323
6600,7573281120,105092,7573386212,0,0,0,45056,0,5452682782
6601,7573299938,108438,7573408376,9,0,0,22016,9,8433566284
6602,7573514422,3422,7573517844,6,0,1,3584,6,6295367614
6603,7573634416,101504,7573735920,8,0,0,33280,8,6451969977
6604,7573653903,1994,7573655897,3,0,1,2048,3,1331598689
6605,7573681610,3898,7573685508,6,0,1,4096,6,8979162359
6606,7573731895,108173,7573840068,7,0,0,41984,7,7095456164
6607,7573763845,3898,7573767743,6,0,1,4096,6,1994207093
6608,7573788463,54983,7573843446,6,0,0,1536,6,8364765613
6609,7573817859,54957,7573872816,6,0,0,1024,6,9976121323
6610,7573846216,64208,7573910424,7,0,0,6656,7,7692995942
6611,7573859588,45596,7573905184,6,0,0,1024,6,4508811051
6612,7573968210,45596,7574013806,6,0,0,1024,6,1753992643
6613,7573992367,93620,7574085987,1,0,0,22528,1,1426016753
6614,7574005507,3898,7574009405,3,0,1,4096,3,9583957604
6615,7574009014,184698,7574193712,7,0,0,29696,7,1931581041
6616,7574183454,1042,7574184496,4,0,1,1024,4,1540116025
6617,7574259374,110864,7574370238,8,0,0,64000,8,5624853700
6618,7574261009,83609,7574344618,6,0,0,5120,6,3974690230
6619,7574300081,111755,7574411836,2,0,0,17920,2,7785549447
6620,7574416185,11016,7574427201,5,0,1,17920,5,9012825626
6621,7574432360,197417,7574629777,3,0,0,3584,3,428617244
6622,7574519365,566,7574519931,9,0,1,512,9,4444007115
6623,7574525138,103532,7574628670,3,0,0,39936,3,181119648
6624,7574612602,128748,7574741350,9,0,0,110080,9,9535745698
6625,7574683421,71621,7574755042,4,0,0,1536,4,542220608
6626,7574751721,100256,7574851977,2,0,0,29184,2,8693378383
6627,7574761634,6278,7574767912,3,0,1,6656,3,2806767317
6628,7574818028,109807,7574927835,1,0,0,50176,1,4199053872
6629,7574826539,139805,7574966344,1,0,0,25600,1,7148235312
6630,7574872246,124474,7574996720,3,0,0,52736,3,8838027670
6631,7574938594,109794,7575048388,0,0,0,15360,0,6991452123
6632,7574999059,91757,7575090816,1,0,1,148480,1,10026256419
6633,7575102092,156308,7575258400,8,0,0,53248,8,188972102
6634,7575535255,112736,7575647991,9,0,0,70144,9,242348156
6635,7575624943,23063,7575648006,2,0,1,10240,2,4299438733
6636,7575771887,90080,7575861967,8,0,0,20992,8,2977906916
6637,7575842924,48980,7575891904,4,0,0,2048,4,3293813424
6638,7575937457,104780,7576042237,8,0,0,44032,8,6558400192
6639,7575963330,3904,7575967234,4,0,1,10752,4,6082236871
6640,7576027886,49136,7576077022,4,0,0,2560,4,2990763678
6641,7576034429,8366,7576042795,9,0,1,512,9,1965255787
6642,7576044318,85316,7576129634,0,0,0,20480,0,8188171780
6643,7576060462,97292,7576157754,3,0,0,19456,3,3258857949
6644,7576138066,115700,7576253766,1,0,0,79872,1,10532960964
6645,7576186533,5802,7576192335,5,0,1,6144,5,7235928334
6646,7576323713,4850,7576328563,9,0,1,5120,9,6191633909
6647,7576477690,89588,7576567278,2,0,0,14336,2,506093668
6648,7576591831,100256,7576692087,8,0,0,29184,8,802589192
6649,7576682984,43904,7576726888,4,0,0,512,4,5006723528
6650,7576703272,59132,7576762404,2,0,0,5120,2,3631128397
6651,7576724388,21141,7576745529,1,0,1,34304,1,2534042454
6652,7576782721,1042,7576783763,6,0,1,1024,6,10429634471
6653,7576794672,45596,7576840268,6,0,0,1024,6,5994617095
6654,7576871755,3128,7576874883,9,0,1,9216,9,3209084088
6655,7576888480,79592,7576968072,0,0,0,11776,0,727271082
6656,7576990585,59912,7577050497,8,0,0,7680,8,4265452436
6657,7577099027,82532,7577181559,2,0,0,16384,2,8486248485
6658,7577115061,566,7577115627,4,0,1,512,4,4818107201
6659,7577175977,5597,7577181574,5,0,1,5120,5,5982890450
6660,7577327872,48980,7577376852,4,0,0,2048,4,7827043468
6661,7577353047,2946,7577355993,3,0,1,3072,3,7975895948
6662,7577476688,102284,7577578972,3,0,0,35840,3,8469220608
6663,7577535726,126376,7577662102,0,0,0,100864,0,10359954279
6664,7577653866,52132,7577705998,4,0,0,512,4,846824114
6665,7577826534,45596,7577872130,4,0,0,1024,4,8804920170
6666,7577897572,107900,7578005472,9,0,0,54272,9,176345800
6667,7577899509,216201,7578115710,1,0,0,167936,1,9647525418
6668,7577940073,4850,7577944923,9,0,1,5120,9,8901377013
6669,7578037193,131678,7578168871,2,0,0,46592,2,5257871561
6670,7578060894,54831,7578115725,5,0,1,11776,5,4092856648
6671,7578142113,4937,7578147050,9,0,1,12800,9,863173668
6672,7578273268,99188,7578372456,2,0,0,30720,2,6715310334
6673,7578450483,84980,7578535463,2,0,0,14336,2,767479495
6674,7578696241,55904,7578752145,4,0,0,4608,4,789020959
6675,7578805506,104312,7578909818,8,0,0,42496,8,8142732610
6676,7578809755,104215,7578913970,8,0,0,10752,8,8987251536
6677,7579232874,1042,7579233916,9,0,1,1024,9,4093819652
6678,7579397184,2870,7579400054,2,0,1,8704,2,9073181672
6679,7579410322,2470,7579412792,1,0,1,2560,1,2629938674
6680,7579447944,102128,7579550072,8,0,0,35328,8,6027206189
6681,7579496759,566,7579497325,1,0,1,512,1,10585770527
6682,7579525903,166902,7579692805,8,0,0,15872,8,1573360957
6683,7579554714,72620,7579627334,8,0,0,13312,8,3719093426
6684,7579617000,107726,7579724726,2,0,0,33280,2,4940040060
6685,7579685249,107605,7579792854,7,0,0,10752,7,4626460889
6686,7579704409,2870,7579707279,1,0,1,8704,1,7594695382
6687,7579739552,35054,7579774606,1,0,1,61440,1,2980318229
6688,7579826600,116420,7579943020,0,0,0,23040,0,1342172412
6689,7579855631,1042,7579856673,2,0,1,1024,2,4974919490
6690,7579881518,1042,7579882560,5,0,1,1024,5,9871956037
6691,7579885122,59473,7579944595,1,0,0,5120,1,5291707852
6692,7579904725,6229,7579910954,4,0,1,15360,4,9518064978
6693,7580243300,5326,7580248626,3,0,1,5632,3,7319344906
6694,7580354622,43904,7580398526,4,0,0,512,4,538640302
6695,7580366807,45596,7580412403,4,0,0,1024,4,6338613275
6696,7580383224,43904,7580427128,6,0,0,512,6,9082165932
6697,7580454942,45596,7580500538,4,0,0,1024,4,6772253811
6698,7580537169,6754,7580543923,9,0,1,7168,9,6665813199
6699,7580580648,52549,7580633197,1,0,1,85504,1,7635445109
6700,7580595158,160695,7580755853,8,0,0,27136,8,3517400686
6701,7580665986,99089,7580765075,1,0,0,20992,1,10101557515
6702,7580688045,1042,7580689087,5,0,1,1024,5,9222047909
6703,7580729221,1042,7580730263,2,0,1,1024,2,4635800223
6704,7580768554,7706,7580776260,3,0,1,8192,3,4125546054
6705,7580778821,2470,7580781291,5,0,1,2560,5,867599102
6706,7580852535,5326,7580857861,3,0,1,5632,3,4564441341
6707,7580997304,50672,7581047976,3,0,0,2560,3,9745287927
6708,7581021209,2470,7581023679,6,0,1,2560,6,6059219201
6709,7581022141,3804,7581025945,3,0,1,3584,3,56378862
6710,7581049215,58376,7581107591,7,0,0,7680,7,9341639478
6711,7581070646,45596,7581116242,6,0,0,1024,6,973635431
6712,7581229236,2470,7581231706,3,0,1,2560,3,10181194084
6713,7581277742,1518,7581279260,2,0,1,1536,2,4029743813
6714,7581384147,566,7581384713,9,0,1,512,9,3285546429
6715,7581528475,2870,7581531345,4,0,1,8704,4,8767726187
6716,7581552946,184185,7581737131,0,0,0,40960,0,7709307245
6717,7581557056,99788,7581656844,7,0,0,27648,7,4602240567
6718,7581659533,114816,7581774349,1,0,0,76288,1,1384980092
6719,7581676250,100142,7581776392,3,0,0,6656,3,2524665528
6720,7581799219,50672,7581849891,4,0,0,2560,4,10075357726
6721,7581812810,77612,7581890422,3,0,0,15360,3,1603829644
6722,7581834173,3422,7581837595,5,0,1,3584,5,4010827356
6723,7581850577,82400,7581932977,9,0,0,20992,9,9985899496
6724,7581876822,5326,7581882148,4,0,1,5632,4,6932533791
6725,7581880202,10235,7581890437,6,0,1,7680,6,2784796863
6726,7581952280,4679,7581956959,4,0,1,12288,4,6751701701
6727,7582028569,221217,7582249786,8,0,0,73728,8,5816406486
6728,7582032693,5454,7582038147,9,0,1,13824,9,6956167756
6729,7582036436,149706,7582186142,7,0,0,12288,7,4364068940
6730,7582058450,3387,7582061837,1,0,1,9728,1,3885480073
6731,7582134018,89480,7582223498,0,0,0,24064,0,9433548487
6732,7582140402,566,7582140968,3,0,1,512,3,2344673949
6733,7582151909,47288,7582199197,7,0,0,1536,7,4019798889
6734,7582242281,121793,7582364074,3,0,0,75264,3,9302513124
6735,7582266070,43904,7582309974,6,0,0,512,6,10694769832
6736,7582572912,3128,7582576040,5,0,1,9216,5,7482433480
6737,7582687270,100583,7582787853,3,0,0,26624,3,2171315657
6738,7582835397,4420,7582839817,9,0,1,11776,9,1095847852
6739,7582842243,45596,7582887839,6,0,0,1024,6,8733061864
6740,7582938238,88832,7583027070,8,0,0,16896,8,3173899545
6741,7583005307,1042,7583006349,5,0,1,1024,5,4245296052
6742,7583118005,50672,7583168677,6,0,0,2560,6,10384325513
6743,7583141240,92972,7583234212,8,0,0,15360,8,8806719132
6744,7583262381,109928,7583372309,7,0,0,60928,7,1053226280
6745,7583394400,112424,7583506824,8,0,0,69120,8,9623577557
6746,7583498615,10671,7583509286,4,0,1,2560,4,4826561992
6747,7583523350,4850,7583528200,5,0,1,5120,5,7488361205
6748,7583542133,95444,7583637577,7,0,0,18432,7,10552238012
6749,7583559902,4850,7583564752,4,0,1,5120,4,397909318
6750,7583631973,49500,7583681473,6,0,0,512,6,2472140315
6751,7583655176,10757,7583665933,1,0,1,17408,1,10401164941
6752,7583702777,2946,7583705723,2,0,1,3072,2,45697203
6753,7583754268,119215,7583873483,0,0,0,8192,0,9344248870
6754,7583777180,69440,7583846620,7,0,0,8704,7,8277225452
6755,7583918556,6754,7583925310,5,0,1,7168,5,10011600532
6756,7583993266,120848,7584114114,8,0,0,96768,8,10092345056
6757,7584168541,104936,7584273477,1,0,0,44544,1,1771305600
6758,7584311906,6278,7584318184,6,0,1,6656,6,7177101106
6759,7584393369,1042,7584394411,6,0,1,1024,6,10662240499
6760,7584405523,50672,7584456195,1,0,0,2560,1,9204410303
6761,7584431558,53259,7584484817,0,0,0,1024,0,6446725759
6762,7584448737,82688,7584531425,2,0,0,16896,2,2020254792
6763,7584601926,566,7584602492,6,0,1,512,6,2585960566
6764,7584663668,4374,7584668042,6,0,1,4608,6,10022986208
6765,7584688494,2946,7584691440,5,0,1,3072,5,10588153830
6766,7584706683,64208,7584770891,3,0,0,6656,3,8237711176
6767,7584721027,99320,7584820347,3,0,0,26112,3,6746842570
6768,7584820881,13600,7584834481,1,0,1,23040,1,306074076
6769,7584917881,43904,7584961785,4,0,0,512,4,6839490604
6770,7584937325,95845,7585033170,6,0,0,4096,6,8670338535
6771,7584965701,4374,7584970075,9,0,1,4608,9,7755295979
6772,7584989806,1042,7584990848,6,0,1,1024,6,6058855861
6773,7585044301,3422,7585047723,3,0,1,3584,3,8882435370
6774,7585050300,136853,7585187153,2,0,0,32768,2,8530068981
6775,7585095531,566,7585096097,3,0,1,512,3,2775114019
6776,7585104992,2946,7585107938,5,0,1,3072,5,6398334814
6777,7585116459,33762,7585150221,1,0,1,58880,1,7136516897
6778,7585208789,2470,7585211259,3,0,1,2560,3,2863105220
6779,7585223336,258426,7585481762,6,0,0,512,6,1021570110
6780,7585235623,213973,7585449596,2,0,0,71680,2,4543348037
6781,7585259929,221662,7585481591,0,0,0,104960,0,8164713937
6782,7585365559,116218,7585481777,1,0,1,165888,1,5704055566
6783,7585404461,98699,7585503160,8,0,0,20992,8,8373839276
6784,7585479512,7194,7585486706,6,0,1,12800,6,5644560793
6785,7585508367,101504,7585609871,0,0,0,33280,0,1989914707
6786,7585563700,234966,7585798666,1,0,0,52736,1,6652958616
6787,7585571892,5326,7585577218,9,0,1,5632,9,3429875671
6788,7585583251,1518,7585584769,3,0,1,1536,3,249860308
6789,7585637534,103844,7585741378,1,0,0,40960,1,4428352022
6790,7585719952,125597,7585845549,0,0,0,73728,0,5258039260
6791,7585728649,45596,7585774245,4,0,0,1024,4,3274715411
6792,7586119973,1994,7586121967,9,0,1,2048,9,2605954738
6793,7586282565,4850,7586287415,1,0,1,5120,1,3876320727
6794,7586332767,13512,7586346279,6,0,1,26112,6,10648221842
6795,7586429359,195929,7586625288,3,0,0,143360,3,9558849202
6796,7586472110,2470,7586474580,2,0,1,2560,2,3080275808
6797,7586623318,45866,7586669184,6,0,0,512,6,8536621075
6798,7586625656,80776,7586706432,1,0,0,16896,1,8054826256
6799,7586666701,138527,7586805228,3,0,0,41472,3,6189204028
6800,7586721811,46859,7586768670,6,0,0,1024,6,98976298
6801,7586954611,76676,7587031287,0,0,0,12288,0,9873075368
6802,7586982181,3422,7586985603,5,0,1,3584,5,8929530090
6803,7587128012,103220,7587231232,3,0,0,38912,3,6698229605
6804,7587132215,7706,7587139921,5,0,1,8192,5,2198370989
6805,7587181299,566,7587181865,4,0,1,512,4,9408118945
6806,7587208775,1042,7587209817,6,0,1,1024,6,6203001191
6807,7587340261,104312,7587444573,7,0,0,42496,7,7065514465
6808,7587427373,1042,7587428415,9,0,1,1024,9,7709357958
6809,7587436961,71812,7587508773,8,0,0,6656,8,5968510859
6810,7587649021,97760,7587746781,0,0,0,20992,0,7523478971
6811,7587656745,6754,7587663499,4,0,1,7168,4,8200203783
6812,7587681645,91280,7587772925,3,0,0,14848,3,6614416125
6813,7587706447,43975,7587750422,1,0,1,72192,1,7802042652
6814,7587721881,124527,7587846408,3,0,0,25600,3,3600700558
6815,7587765291,43904,7587809195,4,0,0,512,4,8247073238
6816,7587775175,1042,7587776217,3,0,1,1024,3,2673808160
6817,7587848044,94284,7587942328,1,0,0,7168,1,2884044574
6818,7587862249,4162,7587866411,5,0,1,11264,5,279023688
6819,7587919280,64208,7587983488,1,0,0,6656,1,9209602428
6820,7587938188,4155,7587942343,9,0,1,2560,9,5599843026
6821,7587945778,235669,7588181447,8,0,0,76800,8,4356722636
6822,7587984099,267998,7588252097,2,0,0,100864,2,442932343
6823,7588017531,134740,7588152271,1,0,0,104960,1,9523496150
6824,7588064826,195094,7588259920,9,0,0,25600,9,1795914361
6825,7588236938,137715,7588374653,1,0,0,102400,1,4987116889
6826,7588330253,44571,7588374824,6,0,0,512,6,2653690337
6827,7588401625,10499,7588412124,2,0,1,16896,2,10343550255
6828,7588576164,2470,7588578634,3,0,1,2560,3,7659488438
6829,7588582990,43904,7588626894,4,0,0,512,4,5765633310
6830,7588625141,47288,7588672429,4,0,0,1536,4,5500236143
6831,7588819150,110396,7588929546,0,0,0,62464,0,8483151696
6832,7588924461,28285,7588952746,1,0,1,38400,1,7872701955
6833,7588986887,6754,7588993641,9,0,1,7168,9,8869154368
6834,7589054872,50672,7589105544,0,0,0,2560,0,248901262
6835,7589102759,106885,7589209644,2,0,0,44544,2,5339928228
6836,7589157838,144824,7589302662,8,0,0,121856,8,4451822685
6837,7589305959,4850,7589310809,9,0,1,5120,9,9405120463
6838,7589335223,6278,7589341501,5,0,1,6656,5,1053457821
6839,7589376058,5712,7589381770,5,0,1,14336,5,1399729681
6840,7589540303,97448,7589637751,4,0,0,19968,4,6332300374
6841,7589712316,1042,7589713358,4,0,1,1024,4,4914164183
6842,7589745196,65900,7589811096,8,0,0,7168,8,961761742
6843,7589854952,4374,7589859326,5,0,1,4608,5,2323252297
6844,7589974828,1518,7589976346,9,0,1,1536,9,4234667995
6845,7589998659,3904,7590002563,5,0,1,10752,5,6499720893
6846,7590029743,31007,7590060750,1,0,1,50176,1,6974818290
6847,7590140573,116792,7590257365,9,0,0,83456,9,3403132917
6848,7590241048,88377,7590329425,1,0,0,12288,1,369726767
6849,7590301378,7230,7590308608,4,0,1,7680,4,2223642550
6850,7590309809,1994,7590311803,4,0,1,2048,4,8556441725
6851,7590313407,106340,7590419747,0,0,0,49152,0,4369351630
6852,7590369213,97916,7590467129,1,0,0,21504,1,4587577431
6853,7590423635,3422,7590427057,6,0,1,3584,6,10204089218
6854,7590518320,93176,7590611496,9,0,0,26112,9,5398211234
6855,7590615950,120224,7590736174,4,0,0,94720,4,8248377298
6856,7590820801,4374,7590825175,3,0,1,4608,3,5736158944
6857,7590937928,6754,7590944682,6,0,1,7168,6,2683402839
6858,7591173504,105092,7591278596,9,0,0,45056,9,5605329083
6859,7591278061,4901,7591282962,6,0,1,4608,6,8161247701
6860,7591364740,119993,7591484733,1,0,0,22528,1,1913712049
6861,7591696314,120848,7591817162,1,0,0,96768,1,4514730551
6862,7591850238,81776,7591932014,2,0,0,18944,2,554618545
6863,7591857672,65900,7591923572,4,0,0,7168,4,10134645820
6864,7591952912,3898,7591956810,4,0,1,4096,4,4967203505
6865,7591979077,4162,7591983239,3,0,1,11264,3,4690156395
6866,7592006394,1042,7592007436,6,0,1,1024,6,1483249819
6867,7592007259,179408,7592186667,3,0,0,11776,3,83313789
6868,7592159215,72536,7592231751,9,0,0,13824,9,9495418002
6869,7592182215,128982,7592311197,8,0,0,46592,8,5622666857
6870,7592309242,108911,7592418153,4,0,0,51200,4,8064474536
6871,7592348806,11274,7592360080,1,0,1,18432,1,9377260268
6872,7592467942,10499,7592478441,6,0,1,16896,6,10234314146
6873,7592558432,156719,7592715151,9,0,0,54272,9,4828082849
6874,7592576718,1518,7592578236,6,0,1,1536,6,1856902917
6875,7592712137,15572,7592727709,1,0,1,20992,1,2069407940
6876,7592736603,45596,7592782199,2,0,0,1024,2,3207895483
6877,7592800041,172181,7592972222,0,0,0,51200,0,2221536375
6878,7593042260,43904,7593086164,6,0,0,512,6,10116753218
6879,7593077167,133689,7593210856,0,0,0,110080,0,1559413440
6880,7593343023,1518,7593344541,3,0,1,1536,3,1450599828
6881,7593345327,80840,7593426167,7,0,0,15872,7,8692868083
6882,7593402796,67592,7593470388,8,0,0,7680,8,4789843233
6883,7593448039,43904,7593491943,6,0,0,512,6,1061103662
6884,7593458044,100880,7593558924,4,0,0,31232,4,3847103545
6885,7593463208,122398,7593585606,0,0,0,47104,0,6133359068
6886,7593475124,1518,7593476642,9,0,1,1536,9,6816155627
6887,7593531122,133809,7593664931,3,0,0,6144,3,7663416553
6888,7593585950,2470,7593588420,2,0,1,2560,2,3729500694
6889,7593612106,566,7593612672,9,0,1,512,9,3393036722
6890,7593699634,1518,7593701152,4,0,1,1536,4,1827667119
6891,7593700787,80216,7593781003,7,0,0,13824,7,777421883
6892,7593757838,108680,7593866518,4,0,0,56832,4,2463133450
6893,7593841868,82820,7593924688,8,0,0,12288,8,2281635235
6894,7593850518,19379,7593869897,2,0,1,9728,2,10675057089
6895,7593960591,2870,7593963461,2,0,1,8704,2,6868022633
6896,7593988131,76988,7594065119,7,0,0,13312,7,5419915480
6897,7593999689,194437,7594194126,7,0,0,21504,7,7267014985
6898,7594023396,3387,7594026783,1,0,1,9728,1,543649494
6899,7594035413,3645,7594039058,2,0,1,10240,2,10152728276
6900,7594097431,1518,7594098949,9,0,1,1536,9,2537972454
6901,7594177452,5802,7594183254,4,0,1,6144,4,380832549
6902,7594217997,50672,7594268669,6,0,0,2560,6,5337546963
6903,7594241381,107202,7594348583,7,0,0,36864,7,8133694133
6904,7594307429,97292,7594404721,9,0,0,19456,9,4897515291
6905,7594333443,76492,7594409935,0,0,0,10240,0,2519016584
6906,7594342151,75708,7594417859,8,0,0,8192,8,5151073894
6907,7594432354,3422,7594435776,3,0,1,3584,3,8910415357
6908,7594432921,54630,7594487551,8,0,0,3584,8,5975933166
6909,7594457143,50672,7594507815,1,0,0,2560,1,9366218510
6910,7594480834,6732,7594487566,4,0,1,6656,4,5399705165
6911,7594496595,45596,7594542191,6,0,0,1024,6,4073582551
6912,7594515989,4374,7594520363,5,0,1,4608,5,6295735281
6913,7594550913,98852,7594649765,3,0,0,24576,3,1461709528
6914,7594584910,69577,7594654487,6,0,0,8704,6,4163020398
6915,7594734606,10757,7594745363,6,0,1,17408,6,9265940067
6916,7594986564,112268,7595098832,0,0,0,68608,0,8776623442
6917,7595016386,100412,7595116798,7,0,0,29696,7,3818554326
6918,7595109637,10099,7595119736,3,0,1,3072,3,5062591348
6919,7595412767,113672,7595526439,4,0,0,73216,4,8589722965
6920,7595593524,104770,7595698294,1,0,0,28160,1,6525477282
6921,7595605955,3645,7595609600,2,0,1,10240,2,4622559667
6922,7595641584,147738,7595789322,4,0,0,23552,4,9397326159
6923,7595650504,102284,7595752788,6,0,0,35840,6,10219898396
6924,7595877185,72224,7595949409,2,0,0,12800,2,1469891759
6925,7596045971,4374,7596050345,4,0,1,4608,4,1225250373
6926,7596071671,103220,7596174891,6,0,0,38912,6,10617370676
6927,7596310673,4374,7596315047,6,0,1,4608,6,6437321024
6928,7596312218,4775,7596316993,2,0,1,3072,2,10442481206
6929,7596399101,114915,7596514016,7,0,0,7168,7,1580393513
6930,7596522762,4374,7596527136,2,0,1,4608,2,2856128174
6931,7596668745,113135,7596781880,4,0,0,58880,4,838126182
6932,7596669485,94440,7596763925,3,0,0,27648,3,4091100418
6933,7596786254,114764,7596901018,6,0,0,76800,6,9526410558
6934,7596809820,4374,7596814194,6,0,1,4608,6,10199097068
6935,7596844254,4374,7596848628,4,0,1,4608,4,3804455213
6936,7597063434,104936,7597168370,8,0,0,44544,8,9316027050
6937,7597077771,67592,7597145363,9,0,0,7680,9,3898922
6938,7597153214,1042,7597154256,3,0,1,1024,3,10300505120
6939,7597203781,136376,7597340157,8,0,0,132608,8,8764484003
6940,7597245463,95333,7597340796,0,0,0,2048,0,1620583845
6941,7597255004,2946,7597257950,9,0,1,3072,9,5499907354
6942,7597270356,85557,7597355913,3,0,0,5632,3,10498699650
6943,7597358009,5802,7597363811,4,0,1,6144,4,8912981474
6944,7597372344,64137,7597436481,1,0,1,108032,1,1672051844
6945,7597506279,36346,7597542625,1,0,1,64000,1,6408655690
6946,7597515304,39072,7597554376,1,0,1,48128,1,3824081187
6947,7597580551,151401,7597731952,7,0,0,67584,7,1431567658
6948,7597706824,121409,7597828233,8,0,0,68096,8,6131066344
6949,7597709423,22544,7597731967,5,0,1,2048,5,2144422126
6950,7597716330,21907,7597738237,3,0,1,6656,3,316141426
6951,7597745415,2470,7597747885,2,0,1,2560,2,7690882280
6952,7597762128,2946,7597765074,9,0,1,3072,9,6103185368
6953,7597767473,1518,7597768991,2,0,1,1536,2,9106564723
6954,7597923433,101504,7598024937,4,0,0,33280,4,8858217133
6955,7597968328,135431,7598103759,4,0,0,64000,4,6087098259
6956,7598060003,72668,7598132671,9,0,0,9216,9,6078761506
6957,7598353970,81932,7598435902,4,0,0,19456,4,2806742185
6958,7598432443,100923,7598533366,2,0,0,25088,2,4538527743
6959,7598551764,3898,7598555662,9,0,1,4096,9,1906686054
6960,7598651168,6229,7598657397,1,0,1,15360,1,4651673730
6961,7598725977,10241,7598736218,3,0,1,16384,3,7926850570
6962,7598837422,3387,7598840809,5,0,1,9728,5,6305999023
6963,7598854779,43904,7598898683,9,0,0,512,9,8425065331
6964,7598880378,101816,7598982194,9,0,0,34304,9,1149925634
6965,7598973421,99133,7599072554,8,0,0,16896,8,157968388
6966,7599007384,40616,7599048000,1,0,1,65536,1,1315251915
6967,7599011107,311085,7599322192,8,0,0,27136,8,10265461779
6968,7599072725,252914,7599325639,4,0,0,11264,4,2294527642
6969,7599111802,5802,7599117604,6,0,1,6144,6,3734290204
6970,7599131252,299762,7599431014,1,0,0,231936,1,10233773098
6971,7599166413,4374,7599170787,9,0,1,4608,9,6499290842
6972,7599304226,4937,7599309163,2,0,1,12800,2,9949528545
6973,7599326237,4374,7599330611,3,0,1,4608,3,2326804555
6974,7599370219,66631,7599436850,2,0,1,6144,2,4767030439
6975,7599371658,125298,7599496956,3,0,0,7168,3,9427968999
6976,7599420614,110386,7599531000,4,0,0,28160,4,6773666894
6977,7599543703,5802,7599549505,4,0,1,6144,4,10316528923
6978,7599627578,115700,7599743278,7,0,0,79872,7,6950873059
6979,7599654495,566,7599655061,4,0,1,512,4,31429381
6980,7599686833,244028,7599930861,3,0,0,133120,3,6197102988
6981,7599779630,157330,7599936960,4,0,0,19968,4,7177028284
6982,7599822543,2470,7599825013,5,0,1,2560,5,9598064041
6983,7599829826,7230,7599837056,6,0,1,7680,6,7130764414
6984,7599932222,8375,7599940597,9,0,1,10240,9,8066552740
6985,7599938820,2443,7599941263,2,0,1,1024,2,5940049191
6986,7600042780,10499,7600053279,6,0,1,16896,6,7263900780
6987,7600070174,92761,7600162935,6,0,0,9728,6,10184194422
6988,7600117092,121581,7600238673,4,0,0,70656,4,4670899852
6989,7600168955,132316,7600301271,3,0,0,48128,3,640776314
6990,7600204681,169610,7600374291,8,0,0,126464,8,2331666463
6991,7600239983,272943,7600512926,0,0,0,77312,0,2279142744
6992,7600248686,2870,7600251556,9,0,1,8704,9,7350145608
6993,7600260399,566,7600260965,9,0,1,512,9,5843645032
6994,7600354760,102325,7600457085,4,0,0,6656,4,1263694792
6995,7600464348,104000,7600568348,6,0,0,41472,6,723311466
6996,7600625566,101529,7600727095,1,0,0,24064,1,5682173682
6997,7600640300,4162,7600644462,4,0,1,11264,4,8308953113
6998,7600677640,3128,7600680768,6,0,1,9216,6,4102171745
6999,7600697666,120723,7600818389,8,0,0,59904,8,2126810256
7000,7600716800,208901,7600925701,1,0,0,20480,1,3418682263
7001,7600721180,146048,7600867228,6,0,0,28672,6,2633126550
7002,7600781633,137813,7600919446,7,0,0,52736,7,3490228775
7003,7600838424,7230,7600845654,4,0,1,7680,4,3442674425
7004,7600851441,2870,7600854311,6,0,1,8704,6,10225667277
7005,7600946275,566,7600946841,6,0,1,512,6,2930001681
7006,7601054046,4850,7601058896,4,0,1,5120,4,6220858436
7007,7601140601,2470,7601143071,6,0,1,2560,6,757831077
7008,7601161851,64520,7601226371,1,0,0,7680,1,2615318226
7009,7601163246,99131,7601262377,2,0,0,13824,2,2140555990
7010,7601266829,110396,7601377225,9,0,0,62464,9,5318172461
7011,7601367474,13658,7601381132,2,0,1,4096,2,1933539226
7012,7601375014,49072,7601424086,7,0,0,1024,7,2034178791
7013,7601596227,13083,7601609310,9,0,1,22016,9,1009043812
7014,7601705241,36604,7601741845,1,0,1,64512,1,670751090
7015,7601791018,2470,7601793488,5,0,1,2560,5,2952737967
7016,7601823010,202958,7602025968,2,0,0,94720,2,3954530449
7017,7601946301,106006,7602052307,4,0,0,8704,4,5978820132
7018,7601990127,3422,7601993549,2,0,1,3584,2,7415992088
7019,7602007270,126199,7602133469,2,0,0,47104,2,701188587
7020,7602013583,131749,7602145332,6,0,0,11264,6,503156496
7021,7602055217,187657,7602242874,9,0,0,103424,9,6136837974
7022,7602084585,6278,7602090863,1,0,1,6656,1,5086010197
7023,7602156225,87296,7602243521,4,0,0,2048,4,793846043
7024,7602157996,3422,7602161418,2,0,1,3584,2,2613333460
7025,7602228158,121352,7602349510,8,0,0,36352,8,3062006309
7026,7602339786,14395,7602354181,9,0,1,12288,9,624192509
7027,7602390123,88232,7602478355,8,0,0,19968,8,7893231395
7028,7602402469,154054,7602556523,2,0,0,115200,2,1917793921
7029,7602465784,147721,7602613505,9,0,0,74240,9,7744942087
7030,7602572032,108056,7602680088,3,0,0,54784,3,7321463197
7031,7602585986,99889,7602685875,9,0,0,18944,9,116606260
7032,7602600790,14701,7602615491,5,0,1,2048,5,5159922174
7033,7602678517,124454,7602802971,1,0,0,84480,1,5784586529
7034,7602682271,127198,7602809469,0,0,0,17408,0,2924566768
7035,7602724546,1042,7602725588,6,0,1,1024,6,4876879321
7036,7602737251,566,7602737817,2,0,1,512,2,1543930416
7037,7602890435,4679,7602895114,2,0,1,12288,2,3237624966
7038,7603034806,1518,7603036324,2,0,1,1536,2,5482230618
7039,7603069292,2470,7603071762,3,0,1,2560,3,5028826710
7040,7603095459,78212,7603173671,6,0,0,12288,6,9915704249
7041,7603098935,100920,7603199855,9,0,0,27648,9,560390284
7042,7603153389,15579,7603168968,1,0,1,30208,1,9311060571
7043,7603194473,112338,7603306811,2,0,0,51200,2,4147231695
7044,7603316697,3422,7603320119,4,0,1,3584,4,3719317101
7045,7603429833,46212,7603476045,1,0,1,79872,1,5513227285
7046,7603436843,39356,7603476199,2,0,1,8704,2,10013359350
7047,7603454502,22043,7603476545,4,0,1,512,4,7675147454
7048,7603472536,6915,7603479451,9,0,1,4608,9,7573025392
7049,7603486236,149204,7603635440,9,0,0,55808,9,2277780770
7050,7603523211,3898,7603527109,6,0,1,4096,6,1455034152
7051,7603651058,1994,7603653052,5,0,1,2048,5,849144117
7052,7603690508,186975,7603877483,1,0,0,91648,1,1636332761
7053,7603875312,49451,7603924763,4,0,0,1536,4,6818719010
7054,7603885957,566,7603886523,2,0,1,512,2,1157958345
7055,7603911360,101504,7604012864,2,0,0,33280,2,10317137131
7056,7604079253,5712,7604084965,4,0,1,14336,4,2806235892
7057,7604112352,4374,7604116726,4,0,1,4608,4,1353069664
7058,7604282874,77744,7604360618,2,0,0,10752,2,8346248895
7059,7604283329,6754,7604290083,2,0,1,7168,2,3696707502
7060,7604312146,44233,7604356379,1,0,1,72704,1,3707351723
7061,7604329855,121556,7604451411,3,0,0,7680,3,8015973356
7062,7604345622,309309,7604654931,7,0,0,32256,7,6742113430
7063,7604349228,11405,7604360633,2,0,1,2048,2,4217298064
7064,7604392776,252312,7604645088,8,0,0,66048,8,8769754058
7065,7604482882,129573,7604612455,1,0,0,21504,1,6385174173
7066,7604534617,6278,7604540895,3,0,1,6656,3,1714714878
7067,7604612079,5218,7604617297,2,0,1,5120,2,9579622291
7068,7604638207,17758,7604655965,6,0,1,1024,6,4071797688
7069,7604741164,104000,7604845164,7,0,0,41472,7,5395365048
7070,7604954301,3904,7604958205,3,0,1,10752,3,546139890
7071,7605028357,566,7605028923,2,0,1,512,2,666841008
7072,7605113934,70976,7605184910,0,0,0,8704,0,5518734056
7073,7605127603,80240,7605207843,0,0,0,18944,0,7884833640
7074,7605333335,566,7605333901,9,0,1,512,9,9550001585
7075,7605364977,5802,7605370779,5,0,1,6144,5,8462573209
7076,7605378265,102752,7605481017,8,0,0,37376,8,2661056008
7077,7605391456,104164,7605495620,1,0,0,8704,1,6911759510
7078,7605461338,7706,7605469044,9,0,1,8192,9,8498198512
7079,7605606535,104312,7605710847,4,0,0,42496,4,8383057768
7080,7605618959,105951,7605724910,2,0,0,46080,2,8855129366
7081,7605700659,69312,7605769971,9,0,0,5120,9,9458734726
7082,7605771541,116012,7605887553,8,0,0,80896,8,22254015
7083,7605786425,102555,7605888980,3,0,0,4608,3,6884403911
7084,7605871049,69640,7605940689,7,0,0,5632,7,2570502970
7085,7605883341,10005,7605893346,6,0,1,4608,6,620495588
7086,7605896997,55748,7605952745,4,0,0,4096,4,1770350391
7087,7606081569,107588,7606189157,3,0,0,53248,3,10423605199
7088,7606108089,157253,7606265342,2,0,0,27136,2,7834734123
7089,7606130320,126739,7606257059,9,0,0,48128,9,3899694547
7090,7606145475,179486,7606324961,6,0,0,43008,6,136498349
7091,7606247962,18414,7606266376,6,0,1,1024,6,6833152978
7092,7606331199,67592,7606398791,3,0,0,7680,3,2725498848
7093,7606344442,102128,7606446570,3,0,0,35328,3,4262161260
7094,7606378110,104624,7606482734,0,0,0,43520,0,549573855
7095,7606489035,110396,7606599431,9,0,0,62464,9,1905120806
7096,7606622606,3422,7606626028,4,0,1,3584,4,10105786311
7097,7606628781,204110,7606832891,9,0,0,22016,9,10338802611
7098,7606831073,114702,7606945775,0,0,0,70656,0,10045276035
7099,7606840093,155680,7606995773,9,0,0,47104,9,10223042377
7100,7606891380,5802,7606897182,6,0,1,6144,6,8473064682
7101,7606909902,111737,7607021639,9,0,0,19968,9,338686145
7102,7606942159,84136,7607026295,3,0,0,14848,3,10346562085
7103,7607040288,78704,7607118992,4,0,0,18944,4,1888651055
7104,7607073268,107276,7607180544,6,0,0,52224,6,8386539956
7105,7607079849,1518,7607081367,4,0,1,1536,4,6688446896
7106,7607286871,79016,7607365887,3,0,0,19968,3,5046517387
7107,7607301478,566,7607302044,4,0,1,512,4,3739291302
7108,7607371925,95444,7607467369,6,0,0,18432,6,6376617784
7109,7607416983,52364,7607469347,0,0,0,3072,0,7057651953
7110,7607430625,4374,7607434999,2,0,1,4608,2,3775581557
7111,7607455557,129428,7607584985,0,0,0,124928,0,10388428416
7112,7607525473,142240,7607667713,6,0,0,96768,6,605918282
7113,7607572106,144945,7607717051,1,0,0,30720,1,10330950720
7114,7607604274,4937,7607609211,9,0,1,12800,9,7144472150
7115,7607633475,140327,7607773802,1,0,0,38400,1,418759206
7116,7607668753,93308,7607762061,6,0,0,21504,6,5078904545
7117,7607831459,107276,7607938735,6,0,0,52224,6,4025105592
7118,7608013386,1518,7608014904,4,0,1,1536,4,6640445088
7119,7608079138,3387,7608082525,6,0,1,9728,6,3170924724
7120,7608095631,102752,7608198383,6,0,0,37376,6,1294449155
7121,7608209562,99320,7608308882,4,0,0,26112,4,4144150892
7122,7608568864,7706,7608576570,5,0,1,8192,5,6654228534
7123,7608695107,4937,7608700044,6,0,1,12800,6,5603302571
7124,7608696301,4729,7608701030,5,0,1,1536,5,3303942876
7125,7608718743,43904,7608762647,4,0,0,512,4,2931049453
7126,7608789921,3422,7608793343,4,0,1,3584,4,3678499206
7127,7608913526,118508,7609032034,1,0,0,89088,1,1115041973
7128,7608952306,3898,7608956204,5,0,1,4096,5,29951486
7129,7608988840,61292,7609050132,4,0,0,7168,4,5518165211
7130,7608999057,63217,7609062274,6,0,0,4608,6,5699458480
7131,7609310617,1042,7609311659,3,0,1,1024,3,5672702
7132,7609410994,102908,7609513902,3,0,0,37888,3,2913479843
7133,7609519323,85604,7609604927,4,0,0,16384,4,4634451895
7134,7609625008,69440,7609694448,6,0,0,8704,6,3855948574
7135,7609867924,101660,7609969584,6,0,0,33792,6,9903407362
7136,7609868810,108433,7609977243,0,0,0,25088,0,2708413765
7137,7609877538,152382,7610029920,9,0,0,60416,9,6847637037
7138,7609897041,10757,7609907798,1,0,1,17408,1,9156096479
7139,7609920945,126675,7610047620,2,0,0,20480,2,10127367835
7140,7609923306,566,7609923872,1,0,1,512,1,6076662277
7141,7609928803,566,7609929369,4,0,1,512,4,8910432819
7142,7609957808,93592,7610051400,0,0,0,7680,0,3526624198
7143,7609965670,16891,7609982561,6,0,1,5632,6,8964318789
7144,7610062792,101660,7610164452,4,0,0,33792,4,10530349117
7145,7610069854,4374,7610074228,4,0,1,4608,4,10384108228
7146,7610169517,109148,7610278665,2,0,0,58368,2,5772468352
7147,7610338308,71000,7610409308,7,0,0,13824,7,6562046797
7148,7610339224,73843,7610413067,3,0,0,12288,3,2413551257
7149,7610451734,87896,7610539630,2,0,0,13824,2,3309171716
7150,7610483922,10499,7610494421,1,0,1,16896,1,4946747497
7151,7610740195,11016,7610751211,9,0,1,17920,9,7173016822
7152,7610915867,566,7610916433,4,0,1,512,4,3536671214
7153,7610941440,110084,7611051524,1,0,0,61440,1,2932741049
7154,7610998356,53183,7611051539,1,0,1,75776,1,1644171188
7155,7611196577,5802,7611202379,5,0,1,6144,5,9823330850
7156,7611201022,47288,7611248310,4,0,0,1536,4,5036909914
7157,7611204485,126593,7611331078,8,0,0,73728,8,741256142
7158,7611228222,45596,7611273818,3,0,0,1024,3,7645883805
7159,7611247295,1994,7611249289,3,0,1,2048,3,6195284973
7160,7611302749,79436,7611382185,1,0,0,11264,1,2327378657
7161,7611381084,78237,7611459321,7,0,0,13824,7,800546444
7162,7611391312,53753,7611445065,1,0,1,91136,1,8077547803
7163,7611507030,21916,7611528946,1,0,1,35840,1,6003028814
7164,7611547748,118887,7611666635,3,0,0,25600,3,5009865809
7165,7611631553,140584,7611772137,0,0,0,12288,0,10361399681
7166,7611733900,3645,7611737545,4,0,1,10240,4,2013479346
7167,7611791380,6278,7611797658,9,0,1,6656,9,2970272940
7168,7611804799,208332,7612013131,3,0,0,134656,3,8410608203
7169,7611807296,85292,7611892588,6,0,0,15360,6,1449010715
7170,7611891746,122336,7612014082,1,0,0,3072,1,270826639
7171,7611901043,4162,7611905205,6,0,1,11264,6,2451195983
7172,7611930430,214220,7612144650,0,0,0,24064,0,1120540515
7173,7611933891,128705,7612062596,0,0,0,11264,0,2487040437
7174,7612063331,73316,7612136647,7,0,0,16384,7,2879242670
7175,7612099242,45423,7612144665,1,0,1,71168,1,8548015454
7176,7612124600,246087,7612370687,4,0,0,190976,4,7807960508
7177,7612159445,566,7612160011,9,0,1,512,9,9198036868
7178,7612615288,4162,7612619450,2,0,1,11264,2,7670732992
7179,7612633550,1994,7612635544,9,0,1,2048,9,7597484069
7180,7612663962,4374,7612668336,5,0,1,4608,5,10223921902
7181,7612767806,111800,7612879606,6,0,0,67072,6,3985226997
7182,7612818588,99164,7612917752,9,0,0,25600,9,9053778063
7183,7612894086,70022,7612964108,0,0,0,4096,0,3364354302
7184,7612946018,1518,7612947536,6,0,1,1536,6,773631242
7185,7612961389,2734,7612964123,4,0,1,2048,4,10461804244
7186,7613019230,6278,7613025508,2,0,1,6656,2,8905015063
7187,7613046663,3898,7613050561,1,0,1,4096,1,3034323930
7188,7613095131,2470,7613097601,6,0,1,2560,6,8787467462
7189,7613155754,128794,7613284548,4,0,0,34816,4,5092674049
7190,7613172612,1042,7613173654,2,0,1,1024,2,9436437766
7191,7613343664,4162,7613347826,5,0,1,11264,5,2113101461
7192,7613405951,3422,7613409373,2,0,1,3584,2,6812940906
7193,7613485197,1518,7613486715,3,0,1,1536,3,9529649721
7194,7613581458,99944,7613681402,7,0,0,28160,7,528801738
7195,7613650871,97784,7613748655,1,0,0,26112,1,9668644413
7196,7613697647,214183,7613911830,7,0,0,143360,7,7228508590
7197,7613704594,97136,7613801730,6,0,0,18944,6,7234047897
7198,7613747187,3930,7613751117,2,0,1,2560,2,2238428372
7199,7613871655,44082,7613915737,3,0,1,4096,3,2389177303
7200,7613882032,158931,7614040963,6,0,0,119808,6,5091194348
7201,7613929198,149373,7614078571,3,0,0,86016,3,10455355887
7202,7613975684,566,7613976250,3,0,1,512,3,4745382026
7203,7614064279,95304,7614159583,4,0,0,21504,4,8346431751
7204,7614150730,112268,7614262998,3,0,0,68608,3,1490480301
7205,7614245009,96217,7614341226,3,0,0,17408,3,8365285198
7206,7614276821,126013,7614402834,7,0,0,53248,7,2568065630
7207,7614289343,4850,7614294193,3,0,1,5120,3,9795577667
7208,7614468437,63140,7614531577,3,0,0,8192,3,10439518255
7209,7614495247,113048,7614608295,0,0,0,71168,0,5291851108
7210,7614569261,137206,7614706467,1,0,0,93696,1,8803680767
7211,7614794623,1518,7614796141,5,0,1,1536,5,9519591979
7212,7614822952,104936,7614927888,3,0,0,44544,3,3399966254
7213,7614904365,89588,7614993953,0,0,0,14336,0,3866703169
7214,7614949272,6278,7614955550,6,0,1,6656,6,1960072296
7215,7614950700,5836,7614956536,3,0,1,1536,3,6798917625
7216,7614963189,3898,7614967087,4,0,1,4096,4,5121141416
7217,7614984862,159824,7615144686,7,0,0,7680,7,703767713
7218,7615120598,65900,7615186498,6,0,0,7168,6,2149870798
7219,7615137655,4420,7615142075,6,0,1,11776,6,4439561958
7220,7615178020,97448,7615275468,3,0,0,19968,3,7025757529
7221,7615443374,191372,7615634746,6,0,0,166912,6,2616862409
7222,7615724074,5802,7615729876,6,0,1,6144,6,10095162040
7223,7615774034,1518,7615775552,4,0,1,1536,4,7134541589
7224,7615791460,139627,7615931087,9,0,0,5632,9,10239397109
7225,7615860545,3898,7615864443,5,0,1,4096,5,2020773229
7226,7615938522,3422,7615941944,1,0,1,3584,1,429590820
7227,7616071492,69284,7616140776,2,0,0,8192,2,7227607208
7228,7616129275,11516,7616140791,3,0,1,16896,3,10250064172
7229,7616143688,141628,7616285316,0,0,0,103424,0,3363279401
7230,7616169343,157773,7616327116,2,0,0,8192,2,2607663392
7231,7616304873,6754,7616311627,5,0,1,7168,5,4537104826
7232,7616342209,1994,7616344203,2,0,1,2048,2,10170155669
7233,7616388005,1042,7616389047,9,0,1,1024,9,256963776
7234,7616388451,3898,7616392349,5,0,1,4096,5,3791548902
7235,7616398636,2946,7616401582,3,0,1,3072,3,5871688369
7236,7616704872,1994,7616706866,4,0,1,2048,4,4626017745
7237,7616790129,1042,7616791171,2,0,1,1024,2,10516206656
7238,7616901404,2946,7616904350,9,0,1,3072,9,9757564327
7239,7616926411,4850,7616931261,6,0,1,5120,6,9049701644
7240,7617003660,48980,7617052640,4,0,0,2048,4,7220073561
7241,7617164264,2470,7617166734,6,0,1,2560,6,4815311103
7242,7617248856,45596,7617294452,8,0,0,1024,8,10383905040
7243,7617259179,1042,7617260221,5,0,1,1024,5,8729469321
7244,7617387178,99788,7617486966,1,0,0,27648,1,5516556445
7245,7617428879,140653,7617569532,2,0,0,70656,2,2343196797
7246,7617683750,90056,7617773806,7,0,0,15872,7,1774900189
7247,7617811275,45596,7617856871,1,0,0,1024,1,9215850565
7248,7617955631,12825,7617968456,1,0,1,21504,1,2837411585
7249,7617964140,293849,7618257989,1,0,0,51712,1,5129417660
7250,7618054369,209095,7618263464,7,0,0,17920,7,2276555126
7251,7618076928,107744,7618184672,6,0,0,53760,6,5021015792
7252,7618101159,141059,7618242218,0,0,0,34816,0,10213573944
7253,7618152639,180731,7618333370,4,0,0,34304,4,5367100451
7254,7618157303,566,7618157869,9,0,1,512,9,1196559968
7255,7618355608,566,7618356174,3,0,1,512,3,9747758663
7256,7618356866,70867,7618427733,0,0,0,10752,0,2724464698
7257,7618449988,94556,7618544544,2,0,0,25600,2,7318599104
7258,7618525965,116948,7618642913,9,0,0,83968,9,9395461408
7259,7618528951,15608,7618544559,3,0,1,19456,3,5355777813
7260,7618614583,28345,7618642928,1,0,1,18432,1,3360129215
7261,7618657313,146009,7618803322,9,0,0,1536,9,9195110899
7262,7618697082,35571,7618732653,1,0,1,62464,1,2139975220
7263,7618963005,1518,7618964523,5,0,1,1536,5,119213250
7264,7619113473,3128,7619116601,2,0,1,9216,2,10492812594
7265,7619203108,3422,7619206530,2,0,1,3584,2,9010498660
7266,7619297959,100100,7619398059,6,0,0,28672,6,7564811355
7267,7619306131,201950,7619508081,9,0,0,161792,9,6791787549
7268,7619329882,2470,7619332352,1,0,1,2560,1,2540282225
7269,7619366369,1042,7619367411,2,0,1,1024,2,4159947833
7270,7619612033,1042,7619613075,9,0,1,1024,9,9504672593
7271,7619641413,99944,7619741357,8,0,0,28160,8,1301036629
7272,7619658390,87506,7619745896,0,0,0,14848,0,7774321352
7273,7619713018,103064,7619816082,0,0,0,38400,0,3724297425
7274,7619767610,139156,7619906766,1,0,0,36352,1,3226026915
7275,7619871855,11274,7619883129,5,0,1,18432,5,866535979
7276,7619890111,4850,7619894961,5,0,1,5120,5,9293770184
7277,7620097328,113984,7620211312,2,0,0,74240,2,9168055386
7278,7620112613,1994,7620114607,5,0,1,2048,5,8218063093
7279,7620159637,2946,7620162583,3,0,1,3072,3,10496407406
7280,7620167141,235534,7620402675,9,0,0,114688,9,1806307931
7281,7620276416,89300,7620365716,1,0,0,18432,1,9737943443
7282,7620296689,157053,7620453742,9,0,0,79360,9,768125303
7283,7620478245,1518,7620479763,9,0,1,1536,9,242573506
7284,7620555537,55748,7620611285,8,0,0,4096,8,2215805077
7285,7620619316,119132,7620738448,9,0,0,91136,9,8556964736
7286,7620745466,111488,7620856954,6,0,0,66048,6,426305997
7287,7620759800,148568,7620908368,1,0,0,16896,1,8664503807
7288,7620803426,146396,7620949822,7,0,0,71168,7,8789854797
7289,7620833673,62158,7620895831,1,0,1,100864,1,7847239072
7290,7621049262,121071,7621170333,3,0,0,71168,3,2754875227
7291,7621242225,124748,7621366973,3,0,0,109568,3,8147388667
7292,7621311897,4374,7621316271,2,0,1,4608,2,3082350124
7293,7621346298,26469,7621372767,9,0,1,6144,9,4947623077
7294,7621438705,112892,7621551597,8,0,0,70656,8,608629018
7295,7621440307,152174,7621592481,1,0,0,43520,1,6899575156
7296,7621440612,121061,7621561673,7,0,0,20992,7,1313930954
7297,7621552504,70565,7621623069,4,0,0,512,4,4922634072
7298,7621637797,4374,7621642171,2,0,1,4608,2,9073771223
7299,7621694110,2470,7621696580,5,0,1,2560,5,8274545046
7300,7621703517,1518,7621705035,5,0,1,1536,5,3904162601
7301,7621745898,164899,7621910797,8,0,0,37888,8,1020939817
7302,7621816806,80996,7621897802,1,0,0,16384,1,6220092583
7303,7621845671,5454,7621851125,2,0,1,13824,2,5903541955
7304,7621920571,110864,7622031435,9,0,0,64000,9,4562835002
7305,7621930985,4850,7621935835,3,0,1,5120,3,7382762552
7306,7622008318,85313,7622093631,1,0,0,13824,1,8360047653
7307,7622118619,79436,7622198055,8,0,0,11264,8,5030094558
7308,7622157256,118349,7622275605,7,0,0,32768,7,8529672061
7309,7622221549,67592,7622289141,1,0,0,7680,1,2681822689
7310,7622303184,91904,7622395088,2,0,0,16896,2,7941862361
7311,7622361443,78080,7622439523,6,0,0,16896,6,4762457777
7312,7622639239,52364,7622691603,9,0,0,3072,9,826436041
7313,7622683252,4850,7622688102,5,0,1,5120,5,7600200737
7314,7622702999,24929,7622727928,1,0,1,45056,1,1052822149
7315,7622893608,73472,7622967080,9,0,0,16896,9,2697249103
7316,7622959303,109772,7623069075,0,0,0,60416,0,320948095
7317,7623024857,81752,7623106609,7,0,0,13824,7,660679465
7318,7623068724,2337,7623071061,2,0,1,2048,2,2507286986
7319,7623081803,5196,7623086999,9,0,1,13312,9,3248469971
7320,7623198713,67460,7623266173,7,0,0,12288,7,7027387059
7321,7623212335,62228,7623274563,6,0,0,10240,6,5091925269
7322,7623240320,6278,7623246598,9,0,1,6656,9,9594569285
7323,7623254676,101348,7623356024,4,0,0,32768,4,5273862734
7324,7623404701,69464,7623474165,4,0,0,13824,4,373492977
7325,7623534735,3898,7623538633,5,0,1,4096,5,3483721611
7326,7623551108,112580,7623663688,4,0,0,69632,4,2864212910
7327,7623771499,566,7623772065,5,0,1,512,5,9333741342
7328,7623869690,3422,7623873112,6,0,1,3584,6,7171480882
7329,7623895432,4374,7623899806,5,0,1,4608,5,250903083
7330,7623961081,5802,7623966883,6,0,1,6144,6,10565342324
7331,7624095331,80511,7624175842,8,0,0,6144,8,8899975411
7332,7624183353,102596,7624285949,9,0,0,36864,9,4546668467
7333,7624240955,88542,7624329497,6,0,0,6144,6,435679390
7334,7624271545,1042,7624272587,6,0,1,1024,6,8996598738
7335,7624324743,2470,7624327213,6,0,1,2560,6,9478804511
7336,7624345135,118352,7624463487,3,0,0,88576,3,6696485272
7337,7624368672,566,7624369238,2,0,1,512,2,882847231
7338,7624370243,155219,7624525462,8,0,0,52736,8,10114783421
7339,7624538138,129428,7624667566,0,0,0,124928,0,2438539361
7340,7624552998,2470,7624555468,5,0,1,2560,5,10700384443
7341,7624572550,3422,7624575972,2,0,1,3584,2,4795753575
7342,7624595798,4850,7624600648,2,0,1,5120,2,10151858647
7343,7624626109,99476,7624725585,4,0,0,26624,4,7354792954
7344,7624639029,283458,7624922487,7,0,0,54784,7,9123651182
7345,7624651340,254440,7624905780,9,0,0,108032,9,9200671463
7346,7624667278,119021,7624786299,8,0,0,28160,8,517685987
7347,7624702820,228886,7624931706,4,0,0,30208,4,8779765227
7348,7624732348,99632,7624831980,8,0,0,27136,8,3506517558
7349,7624981386,15062,7624996448,1,0,1,29184,1,6738167898
7350,7624984617,133754,7625118371,1,0,0,23552,1,9807527785
7351,7624999376,2470,7625001846,3,0,1,2560,3,7065362104
7352,7625070641,118332,7625188973,4,0,0,37376,4,9200985719
7353,7625111238,135857,7625247095,8,0,0,75776,8,7828704760
7354,7625118294,176495,7625294789,0,0,0,51200,0,7408896190
7355,7625124221,186027,7625310248,2,0,0,50688,2,9042741331
7356,7625168389,190246,7625358635,0,0,0,32768,0,716784969
7357,7625271093,139058,7625410151,3,0,0,45568,3,1802921825
7358,7625348067,10583,7625358650,3,0,1,12800,3,7298040400
7359,7625387339,97392,7625484731,8,0,0,15872,8,2325045467
7360,7625409208,8641,7625417849,6,0,1,8192,6,9972775296
7361,7625496582,105560,7625602142,3,0,0,46592,3,2802600657
7362,7625531524,2470,7625533994,1,0,1,2560,1,9895352852
7363,7625538889,46639,7625585528,2,0,0,1024,2,3742657215
7364,7625584549,2470,7625587019,6,0,1,2560,6,4595091731
7365,7625611621,108596,7625720217,2,0,0,36352,2,1867044435
7366,7625685907,566,7625686473,5,0,1,512,5,10162143442
7367,7625718940,99809,7625818749,1,0,0,23552,1,345190614
7368,7625829111,90836,7625919947,0,0,0,18432,0,3451525815
7369,7625873058,1042,7625874100,9,0,1,1024,9,6153744132
7370,7625880248,71679,7625951927,2,0,0,10240,2,960869713
7371,7625884299,113864,7625998163,0,0,0,48640,0,1562617951
7372,7625994706,103237,7626097943,4,0,0,27648,4,5371468783
7373,7626068592,3422,7626072014,5,0,1,3584,5,648355002
7374,7626139070,105092,7626244162,2,0,0,45056,2,6841101718
7375,7626405602,6229,7626411831,6,0,1,15360,6,2265307406
7376,7626406625,100686,7626507311,9,0,0,18432,9,6293518426
7377,7626417905,63450,7626481355,1,0,1,103424,1,1872178204
7378,7626433252,51969,7626485221,3,0,1,6144,3,8305050671
7379,7626474156,223172,7626697328,7,0,0,16896,7,9224146670
7380,7626592841,152673,7626745514,0,0,0,32768,0,7889781169
7381,7626627903,182042,7626809945,1,0,0,64512,1,10451372560
7382,7626788711,148220,7626936931,3,0,0,136192,3,3471154566
7383,7626814536,151357,7626965893,6,0,0,48640,6,9607650718
7384,7626818227,294237,7627112464,3,0,0,60416,3,7848179551
7385,7626892884,44062,7626936946,5,0,1,10240,5,5546066633
7386,7626926288,167738,7627094026,6,0,0,72704,6,6342048068
7387,7626934929,182146,7627117075,7,0,0,2048,7,3484064176
7388,7627000162,132783,7627132945,7,0,0,37888,7,2317675784
7389,7627038437,109466,7627147903,8,0,0,10240,8,1905831927
7390,7627067928,26113,7627094041,5,0,1,6144,5,5288415685
7391,7627209537,54212,7627263749,1,0,0,4096,1,9043480763
7392,7627235556,26738,7627262294,2,0,1,48640,2,4334076857
7393,7627275456,1042,7627276498,9,0,1,1024,9,4837968844
7394,7627328527,125684,7627454211,9,0,0,112640,9,6050617999
7395,7627560455,100100,7627660555,6,0,0,28672,6,8257834217
7396,7627662112,2870,7627664982,6,0,1,8704,6,2881968211
7397,7627790026,2470,7627792496,9,0,1,2560,9,2320242766
7398,7627886087,4937,7627891024,6,0,1,12800,6,1569298812
7399,7627974032,128648,7628102680,3,0,0,122368,3,5631000973
7400,7627980581,141143,7628121724,6,0,0,23552,6,7129651443
7401,7627996505,199517,7628196022,9,0,0,39424,9,3864488414
7402,7628027991,5326,7628033317,9,0,1,5632,9,7460914812
7403,7628047274,55897,7628103171,3,0,0,1536,3,9130822482
7404,7628093511,126523,7628220034,7,0,0,17408,7,8536705517
7405,7628132914,127110,7628260024,3,0,0,21504,3,2348961824
7406,7628243293,3898,7628247191,9,0,1,4096,9,8407308732
7407,7628265900,74360,7628340260,9,0,0,9728,9,4943844094
7408,7628349028,2470,7628351498,5,0,1,2560,5,4357657779
7409,7628506473,61299,7628567772,0,0,0,512,0,9122685559
7410,7628523868,104000,7628627868,8,0,0,41472,8,5165807307
7411,7628602196,79928,7628682124,2,0,0,17920,2,4771592009
7412,7628610147,106573,7628716720,3,0,0,25600,3,950387235
7413,7628697942,5326,7628703268,2,0,1,5632,2,2888017905
7414,7628778193,50828,7628829021,6,0,0,3072,6,6622280216
7415,7628868516,34367,7628902883,1,0,1,56832,1,677853760
7416,7628924918,22174,7628947092,3,0,1,36352,3,376392525
7417,7628987462,6278,7628993740,2,0,1,6656,2,928064281
7418,7629024136,82088,7629106224,8,0,0,19968,8,4755698856
7419,7629063848,64052,7629127900,7,0,0,6144,7,5119433186
7420,7629084192,122218,7629206410,9,0,0,35840,9,3370208206
7421,7629173892,99310,7629273202,0,0,0,15872,0,6446502921
7422,7629184957,566,7629185523,5,0,1,512,5,6534377145
7423,7629221579,11533,7629233112,9,0,1,18944,9,2749539492
7424,7629363082,93596,7629456678,7,0,0,17408,7,8069850942
7425,7629500996,5971,7629506967,5,0,1,14848,5,10027012232
7426,7629508768,74360,7629583128,2,0,0,9728,2,657482341
7427,7629514148,148114,7629662262,4,0,0,41472,4,5135351880
7428,7629595705,1042,7629596747,9,0,1,1024,9,8154856122
7429,7629682026,134684,7629816710,0,0,0,132096,0,168948039
7430,7629769763,2470,7629772233,6,0,1,2560,6,5203712222
7431,7629788765,28503,7629817268,5,0,1,512,5,5385160955
7432,7630006667,75554,7630082221,1,0,1,126976,1,5649119163
7433,7630094703,130387,7630225090,8,0,0,55808,8,920411143
7434,7630206158,71444,7630277602,6,0,0,10240,6,6012963340
7435,7630215092,107086,7630322178,3,0,1,162304,3,3686839920
7436,7630243763,82601,7630326364,5,0,1,6656,5,10320710210
7437,7630249140,169579,7630418719,9,0,0,15872,9,6836854333
7438,7630489817,1042,7630490859,5,0,1,1024,5,4287435415
7439,7630544990,24670,7630569660,3,0,1,44544,3,7153373724
7440,7630736834,58844,7630795678,9,0,0,9216,9,5226466357
7441,7630877061,100412,7630977473,7,0,0,29696,7,8411010552
7442,7630900211,3898,7630904109,2,0,1,4096,2,8787197141
7443,7630928298,2470,7630930768,6,0,1,2560,6,2360404352
7444,7630970292,116789,7631087081,3,0,0,59904,3,5744499598
7445,7630977703,11533,7630989236,5,0,1,18944,5,4990929948
7446,7631011381,137317,7631148698,7,0,0,13824,7,4150995435
7447,7631015420,129051,7631144471,7,0,0,40448,7,10736058984
7448,7631054840,101039,7631155879,3,0,0,16384,3,3370740006
7449,7631061605,128592,7631190197,3,0,0,23040,3,9122906488
7450,7631090585,189573,7631280158,1,0,0,33792,1,10565785598
7451,7631183372,57489,7631240861,4,0,0,2560,4,591102316
7452,7631195859,12737,7631208596,3,0,1,24576,3,7221522681
7453,7631196963,12619,7631209582,5,0,1,1536,5,6111379374
7454,7631235958,178138,7631414096,3,0,0,5120,3,4280565540
7455,7631340816,566,7631341382,5,0,1,512,5,7977854433
7456,7631351151,98852,7631450003,9,0,0,24576,9,9220080531
7457,7631354800,566,7631355366,5,0,1,512,5,9094454686
7458,7631364919,1518,7631366437,5,0,1,1536,5,8779997842
7459,7631419989,55748,7631475737,4,0,0,4096,4,6748692560
7460,7631420320,1994,7631422314,5,0,1,2048,5,333797951
7461,7631421143,76884,7631498027,6,0,0,512,6,1717731589
7462,7631490157,102440,7631592597,7,0,0,36352,7,8732741557
7463,7631510270,10241,7631520511,2,0,1,16384,2,10112119842
7464,7631561158,1518,7631562676,9,0,1,1536,9,4211807424
7465,7631577516,91772,7631669288,7,0,0,21504,7,1162050404
7466,7631656489,41391,7631697880,1,0,1,67072,1,8994385690
7467,7631658326,321000,7631979326,9,0,0,54272,9,1534429005
7468,7631738093,26479,7631764572,1,0,1,48128,1,5620426195
7469,7631767895,129875,7631897770,2,0,0,28672,2,6135262402
7470,7631822274,99632,7631921906,0,0,0,27136,0,5565394034
7471,7631869358,140664,7632010022,2,0,0,1536,2,8107405189
7472,7631891846,8862,7631900708,2,0,1,3072,2,1708809431
7473,7631957320,43904,7632001224,6,0,0,512,6,2756227619
7474,7632008753,50672,7632059425,8,0,0,2560,8,5912568074
7475,7632080438,7230,7632087668,6,0,1,7680,6,6148586128
7476,7632149499,25446,7632174945,1,0,1,46080,1,7080730300
7477,7632154743,157181,7632311924,7,0,0,59904,7,1566634596
7478,7632221232,228011,7632449243,1,0,0,75264,1,7276715658
7479,7632293425,18514,7632311939,6,0,1,3584,6,8653822602
7480,7632300523,32549,7632333072,1,0,1,34304,1,5890817066
7481,7632388875,3898,7632392773,5,0,1,4096,5,9933767224
7482,7632411266,89349,7632500615,2,0,0,9728,2,10245138175
7483,7632467733,3422,7632471155,2,0,1,3584,2,1318048625
7484,7632538102,82666,7632620768,3,0,1,134144,3,3356829150
7485,7632634739,81370,7632716109,8,0,0,11776,8,2332530002
7486,7632728127,23208,7632751335,3,0,1,38400,3,8517798444
7487,7632750683,154263,7632904946,9,0,0,45056,9,4161012241
7488,7632754288,97760,7632852048,8,0,0,20992,8,1515028408
7489,7632768722,10241,7632778963,3,0,1,16384,3,8452873993
7490,7632841121,69678,7632910799,6,0,0,512,6,8024921030
7491,7632945236,119693,7633064929,4,0,0,43008,4,6059966933
7492,7633094669,7230,7633101899,9,0,1,7680,9,3310980355
7493,7633119699,12566,7633132265,9,0,1,20992,9,8573556502
7494,7633150052,152184,7633302236,4,0,0,115712,4,3342630312
7495,7633323005,108056,7633431061,3,0,0,54784,3,4755225551
7496,7633362006,74608,7633436614,3,0,1,121856,3,396997373
7497,7633429162,8758,7633437920,2,0,1,2048,2,604180889
7498,7633450065,143830,7633593895,8,0,0,19456,8,2803010805
7499,7633454694,7230,7633461924,2,0,1,7680,2,38919429
7500,7633578566,115055,7633693621,9,0,0,53248,9,3083630145
7501,7633582057,1994,7633584051,9,0,1,2048,9,8240404967
7502,7633662563,3904,7633666467,6,0,1,10752,6,5127524887
7503,7633866521,92864,7633959385,7,0,0,25088,7,9963140800
7504,7633885780,105549,7633991329,3,0,0,24064,3,426125478
7505,7634038198,106496,7634144694,4,0,0,49664,4,3935491406
7506,7634205787,99008,7634304795,1,0,0,25088,1,6212732506
7507,7634248589,142204,7634390793,7,0,0,79360,7,7747867164
7508,7634274536,122999,7634397535,7,0,0,21504,7,6458459596
7509,7634282085,6278,7634288363,9,0,1,6656,9,931744492
7510,7634321853,2470,7634324323,2,0,1,2560,2,7287954
7511,7634326147,4420,7634330567,9,0,1,11776,9,5269368196
7512,7634365805,215486,7634581291,8,0,0,77312,8,9515869031
7513,7634480888,176417,7634657305,4,0,0,98816,4,4237034742
7514,7634497321,88041,7634585362,3,0,0,13312,3,4577523761
7515,7634575616,115603,7634691219,7,0,0,43008,7,2143855916
7516,7634802806,101348,7634904154,2,0,0,32768,2,6838973336
7517,7634913623,102596,7635016219,2,0,0,36864,2,7769756387
7518,7634957790,96661,7635054451,1,0,0,18944,1,3790841388
7519,7635056013,47288,7635103301,6,0,0,1536,6,5392974336
7520,7635057245,51140,7635108385,2,0,0,4096,2,9211600185
7521,7635468829,47288,7635516117,1,0,0,1536,1,1276247151
7522,7635561052,103220,7635664272,1,0,0,38912,1,1321972571
7523,7635626692,83726,7635710418,3,0,0,12800,3,10399964805
7524,7635636265,98072,7635734337,2,0,0,22016,2,4480178712
7525,7635676466,1994,7635678460,2,0,1,2048,2,1342540413
7526,7635743489,169884,7635913373,4,0,0,59392,4,7949429024
7527,7635789515,1042,7635790557,5,0,1,1024,5,5147131671
7528,7635897652,19135,7635916787,2,0,1,3584,2,9204335580
7529,7636007146,81596,7636088742,7,0,0,13312,7,7113014022
7530,7636048534,83821,7636132355,8,0,0,4608,8,9742558312
7531,7636057164,4937,7636062101,1,0,1,12800,1,5167518811
7532,7636082794,140395,7636223189,2,0,0,74752,2,5456474608
7533,7636199182,115076,7636314258,9,0,0,77824,9,7181801743
7534,7636240444,10757,7636251201,5,0,1,17408,5,8494878940
7535,7636369745,82820,7636452565,8,0,0,12288,8,8992821217
7536,7636592245,118196,7636710441,4,0,0,88064,4,4730628609
7537,7636629616,148235,7636777851,8,0,0,76288,8,1655845030
7538,7636673358,120171,7636793529,2,0,0,5632,2,709824725
7539,7636790749,43904,7636834653,6,0,0,512,6,6610993695
7540,7636861513,3898,7636865411,2,0,1,4096,2,10412505552
7541,7636876977,62516,7636939493,9,0,0,6144,9,5358196017
7542,7637076078,45596,7637121674,6,0,0,1024,6,2119371779
7543,7637094605,43904,7637138509,6,0,0,512,6,10080150901
7544,7637193669,4679,7637198348,5,0,1,12288,5,7508777353
7545,7637343308,566,7637343874,5,0,1,512,5,6855643960
7546,7637426656,130676,7637557332,4,0,0,129024,4,165851661
7547,7637453963,104320,7637558283,6,0,0,3072,6,3567497158
7548,7637585946,104312,7637690258,0,0,0,42496,0,7667706589
7549,7637594698,62516,7637657214,4,0,0,6144,4,1356259940
7550,7637815328,5712,7637821040,6,0,1,14336,6,10724212529
7551,7637817860,4166,7637822026,5,0,1,1536,5,3351993332
7552,7637848691,32558,7637881249,3,0,1,53248,3,10339460506
7553,7637880155,101873,7637982028,1,0,0,7680,1,610567084
7554,7638076162,60824,7638136986,2,0,0,5632,2,6274978385
7555,7638111875,95492,7638207367,4,0,0,28672,4,3015418626
7556,7638175267,5326,7638180593,5,0,1,5632,5,358727802
7557,7638312804,96092,7638408896,4,0,0,25600,4,6622152575
7558,7638400749,8162,7638408911,6,0,1,512,6,2915072090
7559,7638426872,104936,7638531808,7,0,0,44544,7,809557632
7560,7638429327,179089,7638608416,7,0,0,134656,7,384976105
7561,7638475116,56707,7638531823,3,0,1,72192,3,9151653059
7562,7638495847,35991,7638531838,6,0,1,11776,6,3357754215
7563,7638577443,34093,7638611536,2,0,1,9216,2,10894740
7564,7638640431,123325,7638763756,0,0,0,52736,0,9717682762
7565,7638735699,105872,7638841571,7,0,0,47616,7,6850703166
7566,7638934850,102440,7639037290,7,0,0,36352,7,9855171803
7567,7638994810,80328,7639075138,4,0,0,2048,4,1863898627
7568,7639022073,50672,7639072745,6,0,0,2560,6,6511851471
7569,7639073486,47288,7639120774,6,0,0,1536,6,688505071
7570,7639142014,105092,7639247106,2,0,0,45056,2,221755675
7571,7639185994,147272,7639333266,3,0,0,28160,3,5367049562
7572,7639282552,115423,7639397975,7,0,0,56320,7,8466905703
7573,7639292472,4850,7639297322,5,0,1,5120,5,5720243617
7574,7639329250,17349,7639346599,9,0,1,22528,9,10335789351
7575,7639339789,11636,7639351425,6,0,1,7680,6,3880908934
7576,7639483869,146522,7639630391,0,0,0,64512,0,6960131306
7577,7639641165,2946,7639644111,9,0,1,3072,9,4522185527
7578,7639665819,1042,7639666861,2,0,1,1024,2,1457116379
7579,7639786490,103376,7639889866,9,0,0,39424,9,1858889514
7580,7639871475,110240,7639981715,8,0,0,61952,8,7565471390
7581,7639925991,230996,7640156987,9,0,0,181248,9,6286467495
7582,7640076699,84671,7640161370,0,0,0,14336,0,3230431020
7583,7640175503,99008,7640274511,2,0,0,25088,2,1051705374
7584,7640361136,97316,7640458452,0,0,0,24576,0,4439087615
7585,7640448673,114608,7640563281,1,0,0,76288,1,3007703259
7586,7640456799,158676,7640615475,8,0,0,29696,8,908552131
7587,7640501826,1042,7640502868,5,0,1,1024,5,1525305902
7588,7640503481,4937,7640508418,5,0,1,12800,5,6124605515
7589,7640676510,1518,7640678028,6,0,1,1536,6,2025914102
7590,7640783727,12825,7640796552,9,0,1,21504,9,8523638930
7591,7640799332,147906,7640947238,8,0,0,112128,8,13782714
7592,7640816169,145489,7640961658,3,0,0,25088,3,5916716322
7593,7640825152,2470,7640827622,9,0,1,2560,9,2425420356
7594,7640946446,3912,7640950358,5,0,1,9216,5,552468563
7595,7640953869,63638,7641017507,1,0,0,1024,1,7131460564
7596,7641026612,45696,7641072308,1,0,1,78848,1,6528246445
7597,7641059114,15460,7641074574,9,0,1,3584,9,5570139518
7598,7641225094,54056,7641279150,8,0,0,3584,8,9890063743
7599,7641287916,4679,7641292595,5,0,1,12288,5,1228499290
7600,7641380281,83288,7641463569,0,0,0,13824,0,9561317305
7601,7641413119,57260,7641470379,4,0,0,1536,4,3675565186
7602,7641414876,566,7641415442,1,0,1,512,1,9850061255
7603,7641493612,43904,7641537516,6,0,0,512,6,6808844585
7604,7641556638,192776,7641749414,2,0,0,171520,2,2993380
7605,7641599889,91961,7641691850,1,0,0,512,1,2931728074
7606,7641799831,86204,7641886035,7,0,0,13312,7,6243008322
7607,7641906014,34108,7641940122,3,0,1,56320,3,8515264768
7608,7642246690,102128,7642348818,9,0,0,35328,9,1276359678
7609,7642283044,72668,7642355712,8,0,0,9216,8,5266473375
7610,7642334204,87896,7642422100,2,0,0,13824,2,1588027044
7611,7642368306,23637,7642391943,1,0,1,42496,1,5986232265
7612,7642384936,71000,7642455936,0,0,0,13824,0,554613296
7613,7642406692,3128,7642409820,9,0,1,9216,9,8898915853
7614,7642593807,2470,7642596277,2,0,1,2560,2,5079744179
7615,7642672593,33245,7642705838,3,0,1,57856,3,4680879438
7616,7642711353,145883,7642857236,7,0,0,29184,7,7067639073
7617,7642775039,45596,7642820635,6,0,0,1024,6,1452167603
7618,7642826234,102582,7642928816,0,0,0,14848,0,2975586728
7619,7642868215,104468,7642972683,3,0,0,43008,3,4800955862
7620,7642885120,100880,7642986000,7,0,0,31232,7,670767209
7621,7642934043,12308,7642946351,2,0,1,20480,2,9594319386
7622,7642949624,129587,7643079211,9,0,0,72704,9,3225029183
7623,7643045595,55908,7643101503,7,0,0,2560,7,9330052113
7624,7643112821,2946,7643115767,6,0,1,3072,6,8437023694
7625,7643177487,43904,7643221391,6,0,0,512,6,10385723784
7626,7643205801,99632,7643305433,9,0,0,27136,9,9813578098
7627,7643219415,2870,7643222285,6,0,1,8704,6,1050681040
7628,7643225948,3898,7643229846,5,0,1,4096,5,8436965697
7629,7643281376,100100,7643381476,2,0,0,28672,2,9684896276
7630,7643338228,6488,7643344716,3,0,1,15872,3,5715338115
7631,7643473585,45596,7643519181,6,0,0,1024,6,220946052
7632,7643539674,108368,7643648042,9,0,0,55808,9,8848643066
7633,7643592105,6278,7643598383,9,0,1,6656,9,4650633225
7634,7643611050,45596,7643656646,8,0,0,1024,8,547131688
7635,7643619674,182051,7643801725,0,0,0,53248,0,8946876947
7636,7643778613,56060,7643834673,4,0,0,5120,4,8729763060
7637,7643816540,21658,7643838198,3,0,1,35328,3,2130833183
7638,7643867294,2470,7643869764,5,0,1,2560,5,395151517
7639,7644054629,45596,7644100225,1,0,0,1024,1,8252414295
7640,7644067925,52364,7644120289,6,0,0,3072,6,6871605615
7641,7644138554,135632,7644274186,2,0,0,104448,2,4861830861
7642,7644150998,123359,7644274357,9,0,0,512,9,3132179974
7643,7644172381,174237,7644346618,8,0,0,43008,8,3998787103
7644,7644208080,171838,7644379918,7,0,0,36352,7,3494596662
7645,7644328500,94664,7644423164,4,0,0,15872,4,7770787422
7646,7644436312,7230,7644443542,5,0,1,7680,5,2530021286
7647,7644502888,104312,7644607200,7,0,0,42496,7,2953612830
7648,7644510902,7230,7644518132,5,0,1,7680,5,2524409952
7649,7644679807,83780,7644763587,7,0,0,20480,7,10697823594
7650,7644758292,49191,7644807483,6,0,0,512,6,4505048356
7651,7644814901,45596,7644860497,6,0,0,1024,6,3140067031
7652,7645059741,4374,7645064115,0,0,1,4608,0,7783663988
7653,7645193111,2946,7645196057,9,0,1,3072,9,10570468609
7654,7645208152,43904,7645252056,6,0,0,512,6,8969139874
7655,7645219494,2470,7645221964,6,0,1,2560,6,4342046748
7656,7645250861,566,7645251427,1,0,1,512,1,10404782640
7657,7645333516,3387,7645336903,5,0,1,9728,5,645463146
7658,7645336188,1859,7645338047,6,0,1,1536,6,4394615831
7659,7645387161,102284,7645489445,3,0,0,35840,3,2340463547
7660,7645416401,47444,7645463845,6,0,0,2048,6,6964726108
7661,7645478064,106340,7645584404,8,0,0,49152,8,8548591388
7662,7645484888,123768,7645608656,3,0,0,12800,3,7991662181
7663,7645714218,91148,7645805366,2,0,0,19456,2,9741281554
7664,7645733490,43904,7645777394,6,0,0,512,6,9724391527
7665,7645762328,184716,7645947044,0,0,0,155648,0,504225068
7666,7645850423,139397,7645989820,3,0,0,26112,3,6859839169
7667,7646028819,113828,7646142647,7,0,0,73728,7,5839262568
7668,7646073363,84986,7646158349,3,0,0,8192,3,411084256
7669,7646164283,1042,7646165325,3,0,1,1024,3,3674037798
7670,7646356865,110552,7646467417,8,0,0,62976,8,8479962040
7671,7646571996,101348,7646673344,7,0,0,32768,7,3752586899
7672,7646627055,3898,7646630953,6,0,1,4096,6,8198519058
7673,7646664420,13290,7646677710,5,0,1,4608,5,7047191895
7674,7646678392,53221,7646731613,1,0,0,1536,1,10372160571
7675,7646699061,137270,7646836331,3,0,0,117248,3,2029590422
7676,7646834118,106985,7646941103,0,0,0,44032,0,4149607740
7677,7646874210,139607,7647013817,4,0,0,49664,4,8089987383
7678,7646919189,160034,7647079223,0,0,0,36352,0,2802228827
7679,7646942506,79717,7647022223,6,0,0,512,6,795013398
7680,7647099525,11016,7647110541,2,0,1,17920,2,1223766364
7681,7647121317,81620,7647202937,0,0,0,18432,0,6085194023
7682,7647228738,112424,7647341162,7,0,0,69120,7,6178269655
7683,7647264756,3904,7647268660,0,0,1,10752,0,1742614417
7684,7647332161,13367,7647345528,5,0,1,4608,5,5860997244
7685,7647352698,69284,7647421982,2,0,0,8192,2,227659723
7686,7647415160,3898,7647419058,6,0,1,4096,6,6820377449
7687,7647423052,4937,7647427989,6,0,1,12800,6,6821947749
7688,7647445579,5326,7647450905,9,0,1,5632,9,9251792677
7689,7647462087,77505,7647539592,1,0,0,4608,1,4025702892
7690,7647482152,101816,7647583968,2,0,0,34304,2,5380485903
7691,7647532905,4374,7647537279,0,0,1,4608,0,36816576
7692,7647599850,56929,7647656779,1,0,0,1536,1,7095499622
7693,7647619153,4850,7647624003,5,0,1,5120,5,3308652554
7694,7647810794,43904,7647854698,3,0,0,512,3,8028711620
7695,7647819334,103844,7647923178,2,0,0,40960,2,2849940783
7696,7648010434,43904,7648054338,6,0,0,512,6,5103981034
7697,7648038695,566,7648039261,2,0,1,512,2,257624296
7698,7648073441,566,7648074007,6,0,1,512,6,939435490
7699,7648100105,1042,7648101147,2,0,1,1024,2,9884722514
7700,7648149927,56968,7648206895,6,0,0,1024,6,7696166958
7701,7648161135,566,7648161701,9,0,1,512,9,8079418705
7702,7648164745,98852,7648263597,3,0,0,24576,3,4937290005
7703,7648193049,3645,7648196694,1,0,1,10240,1,2208124310
7704,7648215307,84387,7648299694,1,0,1,140800,1,9995177573
7705,7648287416,167600,7648455016,7,0,0,1536,7,7553334407
7706,7648306961,32816,7648339777,3,0,1,53760,3,2747416759
7707,7648312951,33547,7648346498,1,0,1,24064,1,5642951768
7708,7648368624,129721,7648498345,3,0,0,45056,3,1021071109
7709,7648517396,1518,7648518914,5,0,1,1536,5,2843604599
7710,7648566646,1042,7648567688,9,0,1,1024,9,4787698241
7711,7648621801,11274,7648633075,1,0,1,18432,1,6867815562
7712,7648671517,105404,7648776921,2,0,0,46080,2,2570119624
7713,7648693008,2946,7648695954,9,0,1,3072,9,4749294483
7714,7648705264,4420,7648709684,2,0,1,11776,2,8101527307
7715,7648741839,100182,7648842021,0,0,0,25600,0,4461861288
7716,7648840979,63550,7648904529,0,0,0,6144,0,6948088301
7717,7648851630,126766,7648978396,8,0,0,4096,8,3838784745
7718,7648887101,71444,7648958545,0,0,0,10240,0,9716251531
7719,7648893185,12566,7648905751,0,0,1,20992,0,302522579
7720,7648923883,4374,7648928257,0,0,1,4608,0,3622534750
7721,7648937435,4374,7648941809,3,0,1,4608,3,6733817428
7722,7648949395,161756,7649111151,2,0,0,140288,2,6133449859
7723,7648954421,566,7648954987,9,0,1,512,9,6497436565
7724,7649000843,121389,7649122232,6,0,0,512,6,335837898
7725,7649151444,45752,7649197196,6,0,0,1536,6,17684607
7726,7649183778,47288,7649231066,6,0,0,1536,6,1963085557
7727,7649266803,2470,7649269273,2,0,1,2560,2,449815790
7728,7649318140,2946,7649321086,6,0,1,3072,6,8895411170
7729,7649343006,99320,7649442326,9,0,0,26112,9,8712466262
7730,7649358822,121278,7649480100,4,0,0,43008,4,7564396472
7731,7649466310,64832,7649531142,4,0,0,8704,4,5217503514
7732,7649568814,2870,7649571684,6,0,1,8704,6,8885521481
7733,7649597316,61641,7649658957,1,0,1,99840,1,5733978008
7734,7649621454,58291,7649679745,3,0,1,74752,3,10722489007
7735,7649638042,192865,7649830907,3,0,0,41984,3,10170342497
7736,7649663819,179188,7649843007,4,0,0,512,4,4505010687
7737,7649698420,85375,7649783795,9,0,0,18432,9,7251264357
7738,7649771676,72867,7649844543,6,0,0,512,6,2717006622
7739,7649976982,566,7649977548,9,0,1,512,9,6530546134
7740,7650104530,72668,7650177198,3,0,0,9216,3,9049846658
7741,7650104962,154802,7650259764,4,0,0,52224,4,5214070088
7742,7650112048,3645,7650115693,0,0,1,10240,0,7698858843
7743,7650136410,6754,7650143164,9,0,1,7168,9,6421064064
7744,7650156694,132087,7650288781,1,0,0,1024,1,1132190820
7745,7650230671,5802,7650236473,2,0,1,6144,2,7459555842
7746,7650271890,139367,7650411257,6,0,0,1024,6,8268887380
7747,7650307908,2946,7650310854,3,0,1,3072,3,3405422443
7748,7650349157,43904,7650393061,6,0,0,512,6,5142380025
7749,7650471658,76208,7650547866,8,0,0,10752,8,7542219676
7750,7650503240,52364,7650555604,6,0,0,3072,6,4609805959
7751,7650631221,82820,7650714041,2,0,0,12288,2,5896432003
7752,7650667833,102182,7650770015,0,0,0,18432,0,4144556239
7753,7650756437,5712,7650762149,0,0,1,14336,0,7326549098
7754,7650771080,43904,7650814984,6,0,0,512,6,6588249361
7755,7650793855,47444,7650841299,3,0,0,2048,3,4273833373
7756,7650800353,21658,7650822011,3,0,1,35328,3,6178104907
7757,7650818516,239344,7651057860,2,0,0,90624,2,8685508817
7758,7650843496,167526,7651011022,7,0,0,73728,7,2561112455
7759,7650866974,237500,7651104474,7,0,0,39424,7,5518988370
7760,7650869175,161050,7651030225,9,0,0,62976,9,2341290770
7761,7650911214,2470,7650913684,0,0,1,2560,0,2733095924
7762,7650914769,3898,7650918667,0,0,1,4096,0,2034927770
7763,7650939812,215776,7651155588,8,0,0,24576,8,3314263878
7764,7650985069,102046,7651087115,7,0,0,27648,7,6827166746
7765,7651020565,154292,7651174857,6,0,0,512,6,4799639953
7766,7651073588,3898,7651077486,0,0,1,4096,0,8843228649
7767,7651182901,47288,7651230189,0,0,0,1536,0,7984355202
7768,7651232240,83132,7651315372,7,0,0,13312,7,5272113830
7769,7651273458,11533,7651284991,0,0,1,18944,0,256794337
7770,7651382882,102908,7651485790,4,0,0,37888,4,9773109304
7771,7651569034,7706,7651576740,0,0,1,8192,0,739250870
7772,7651638190,106496,7651744686,4,0,0,49664,4,8677769974
7773,7651739940,8636,7651748576,0,0,1,4096,0,9284951448
7774,7651760235,86204,7651846439,9,0,0,13312,9,3723018339
7775,7651799077,47533,7651846610,0,0,0,512,0,838600425
7776,7651888379,43904,7651932283,6,0,0,512,6,8709885534
7777,7651912378,79436,7651991814,9,0,0,11264,9,1626185731
7778,7651923828,105618,7652029446,7,0,0,44032,7,7697221643
7779,7652083937,10757,7652094694,3,0,1,17408,3,9425903349
7780,7652086402,9918,7652096320,0,0,1,2560,0,2165187921
7781,7652170299,566,7652170865,6,0,1,512,6,235527720
7782,7652173571,2470,7652176041,9,0,1,2560,9,2441546721
7783,7652335742,43904,7652379646,1,0,0,512,1,2277205101
7784,7652478658,1042,7652479700,6,0,1,1024,6,2237246639
7785,7652537450,82376,7652619826,3,0,0,15872,3,898620472
7786,7652564420,43904,7652608324,6,0,0,512,6,7933753240
7787,7652684205,4162,7652688367,9,0,1,11264,9,5621901520
7788,7652707082,43904,7652750986,1,0,0,512,1,9102089138
7789,7652831240,116792,7652948032,7,0,0,83456,7,3021506335
7790,7652983395,61292,7653044687,8,0,0,7168,8,8984406457
7791,7653004559,566,7653005125,0,0,1,512,0,5190436143
7792,7653027877,1042,7653028919,2,0,1,1024,2,4144950747
7793,7653029470,4850,7653034320,6,0,1,5120,6,9989662756
7794,7653078627,102284,7653180911,3,0,0,35840,3,9568660301
7795,7653111630,98819,7653210449,0,0,0,5632,0,10645558207
7796,7653140004,53525,7653193529,7,0,0,512,7,6141395040
7797,7653158459,76076,7653234535,7,0,0,15360,7,1764115989
7798,7653160835,106808,7653267643,8,0,0,50688,8,477118279
7799,7653173901,233995,7653407896,2,0,0,143872,2,1226388430
7800,7653241764,3904,7653245668,6,0,1,10752,6,6233104530
7801,7653292289,116714,7653409003,0,0,0,3584,0,5975407292
7802,7653306893,3898,7653310791,9,0,1,4096,9,5458012002
7803,7653338857,1042,7653339899,6,0,1,1024,6,9383451703
7804,7653357164,566,7653357730,9,0,1,512,9,6445497907
7805,7653435428,91406,7653526834,4,0,0,16896,4,2908897558
7806,7653538190,106340,7653644530,3,0,0,49152,3,2681861680
7807,7653549317,175439,7653724756,2,0,0,84480,2,10000964055
7808,7653628326,96445,7653724771,1,0,1,127488,1,4710502084
7809,7653784407,108524,7653892931,3,0,0,56320,3,3894211613
7810,7653832382,3898,7653836280,5,0,1,4096,5,8710560362
7811,7653888053,91570,7653979623,2,0,0,14336,2,7120468259
7812,7653903649,4679,7653908328,5,0,1,12288,5,9483160719
7813,7653913253,566,7653913819,5,0,1,512,5,2382579321
7814,7653950364,156652,7654107016,2,0,0,4608,2,6778192233
7815,7654149323,5196,7654154519,6,0,1,13312,6,8867088719
7816,7654163244,103862,7654267106,1,0,1,172032,1,3527219296
7817,7654237472,158206,7654395678,0,0,0,46592,0,10587460113
7818,7654382278,17554,7654399832,1,0,1,11264,1,1328622244
7819,7654508578,103220,7654611798,4,0,0,38912,4,4116133777
7820,7654533372,116340,7654649712,2,0,0,26112,2,3009303644
7821,7654551051,159825,7654710876,3,0,0,65536,3,6537751900
7822,7654603046,122512,7654725558,0,0,0,11776,0,3310127298
7823,7654619719,176678,7654796397,9,0,0,36352,9,4333771409
7824,7654624452,160854,7654785306,8,0,0,76800,8,7330884347
7825,7654633168,164960,7654798128,3,0,0,5632,3,1276476726
7826,7654797056,107560,7654904616,3,0,0,49664,3,9373583022
7827,7654823909,3904,7654827813,6,0,1,10752,6,7226399517
7828,7654842933,5802,7654848735,2,0,1,6144,2,5113603197
7829,7654890659,15985,7654906644,6,0,1,2048,6,9199115803
7830,7654898648,8662,7654907310,6,0,1,1024,6,7317781203
7831,7654903963,4013,7654907976,6,0,1,1024,6,1202859916
7832,7654946310,105248,7655051558,8,0,0,45568,8,7716029981
7833,7655014860,93308,7655108168,1,0,1,151552,1,9191836758
7834,7655051288,57866,7655109154,6,0,1,1536,6,3912380563
7835,7655132766,12737,7655145503,2,0,1,24576,2,10560216075
7836,7655253539,12308,7655265847,1,0,1,20480,1,2079792483
7837,7655272927,2470,7655275397,9,0,1,2560,9,5280885757
7838,7655290760,249512,7655540272,4,0,0,39936,4,7244261887
7839,7655308549,193491,7655502040,0,0,0,75776,0,7981184948
7840,7655311196,135864,7655447060,1,0,0,512,1,3238424956
7841,7655326396,112506,7655438902,7,0,0,23552,7,5757947716
7842,7655396338,48978,7655445316,6,0,0,512,6,5344316840
7843,7655454478,5326,7655459804,0,0,1,5632,0,4969903688
7844,7655574459,104936,7655679395,7,0,0,44544,7,8412620375
7845,7655594513,1042,7655595555,9,0,1,1024,9,7951246526
7846,7655653253,96762,7655750015,7,0,0,22016,7,8728135589
7847,7655782840,96224,7655879064,9,0,0,20992,9,5024470100
7848,7655817973,131309,7655949282,3,0,0,18432,3,324784380
7849,7655958099,70532,7656028631,7,0,0,12288,7,5756695158
7850,7655972027,566,7655972593,5,0,1,512,5,2048060198
7851,7656018261,16354,7656034615,6,0,1,31744,6,8612158542
7852,7656065031,114527,7656179558,0,0,0,30208,0,886958666
7853,7656078074,114282,7656192356,6,0,0,512,6,1921775978
7854,7656135376,106286,7656241662,0,0,0,6656,0,6841463656
7855,7656182460,97292,7656279752,0,0,0,19456,0,8124564664
7856,7656216603,1042,7656217645,9,0,1,1024,9,7834006336
7857,7656350105,50984,7656401089,0,0,0,3584,0,8011716599
7858,7656464218,43904,7656508122,6,0,0,512,6,3063935661
7859,7656473338,52832,7656526170,3,0,0,4608,3,812420221
7860,7656588504,101036,7656689540,0,0,0,31744,0,449039332
7861,7656662471,128336,7656790807,3,0,0,121344,3,8454572111
7862,7656687345,146848,7656834193,4,0,0,30720,4,2227300215
7863,7656726798,3128,7656729926,0,0,1,9216,0,193766617
7864,7656802228,48980,7656851208,8,0,0,2048,8,1394311283
7865,7656804688,102596,7656907284,8,0,0,36864,8,9296851354
7866,7656878767,6278,7656885045,5,0,1,6656,5,9179083999
7867,7656886074,6754,7656892828,5,0,1,7168,5,3593456180
7868,7657103035,79436,7657182471,3,0,0,11264,3,10686882180
7869,7657303243,2470,7657305713,9,0,1,2560,9,6304995936
7870,7657461916,71156,7657533072,8,0,0,14336,8,5952923982
7871,7657475372,43904,7657519276,0,0,0,512,0,7807665378
7872,7657476681,135012,7657611693,3,0,1,222720,3,6450008289
7873,7657544244,136643,7657680887,4,0,0,14336,4,6017947789
7874,7657619006,287182,7657906188,4,0,0,100864,4,5272870976
7875,7657637899,215987,7657853886,9,0,0,157184,9,1231761272
7876,7657838361,77056,7657915417,4,0,0,5120,4,6193899051
7877,7657860302,13083,7657873385,3,0,1,22016,3,5498511160
7878,7657863549,56747,7657920296,3,0,1,90112,3,6019843917
7879,7658136982,5802,7658142784,0,0,1,6144,0,3771432540
7880,7658212053,20366,7658232419,1,0,1,32768,1,2713097531
7881,7658341831,7706,7658349537,0,0,1,8192,0,10721458719
7882,7658369398,112088,7658481486,9,0,0,60928,9,7945902870
7883,7658423786,4374,7658428160,9,0,1,4608,9,2987405988
7884,7658481724,72668,7658554392,9,0,0,9216,9,9068458022
7885,7658538967,111569,7658650536,3,0,0,25088,3,6941598394
7886,7658747953,83000,7658830953,9,0,0,17920,9,3375445875
7887,7658752592,43904,7658796496,1,0,0,512,1,5661692116
7888,7658805497,63191,7658868688,3,0,1,102912,3,5198544911
7889,7658818880,190370,7659009250,7,0,0,103424,7,7527839609
7890,7659012752,5802,7659018554,9,0,1,6144,9,4388022370
7891,7659096766,100256,7659197022,8,0,0,29184,8,8229284358
7892,7659239166,10757,7659249923,3,0,1,17408,3,732800532
7893,7659397797,4374,7659402171,2,0,1,4608,2,9399635978
7894,7659436764,3387,7659440151,0,0,1,9728,0,2408793781
7895,7659441568,114589,7659556157,3,0,0,25600,3,2781840568
7896,7659456465,45596,7659502061,1,0,0,1024,1,8262642964
7897,7659555173,53340,7659608513,7,0,0,3072,7,9399889301
7898,7659572399,92552,7659664951,2,0,0,24064,2,8656781993
7899,7659627605,6278,7659633883,9,0,1,6656,9,3184371666
7900,7659688638,20882,7659709520,1,0,1,33792,1,2229830922
7901,7659723622,3422,7659727044,5,0,1,3584,5,3766310540
7902,7659742184,133150,7659875334,7,0,0,91648,7,7311777100
7903,7659824588,10241,7659834829,6,0,1,16384,6,2942584813
7904,7659855711,163184,7660018895,3,0,0,1024,3,7616300538
7905,7659867815,51440,7659919255,6,0,0,512,6,9120886672
7906,7659870047,9227,7659879274,0,0,1,4096,0,775153841
7907,7659878458,62745,7659941203,4,0,0,8704,4,4416846456
7908,7659929316,3898,7659933214,5,0,1,4096,5,5810486316
7909,7659944479,77744,7660022223,9,0,0,10752,9,6139662749
7910,7660003851,5326,7660009177,1,0,1,5632,1,608359233
7911,7660235277,100256,7660335533,4,0,0,29184,4,8530851536
7912,7660242987,100361,7660343348,3,0,0,25600,3,7685139484
7913,7660316913,91772,7660408685,3,0,0,21504,3,5842261872
7914,7660418739,110084,7660528823,4,0,0,61440,4,8092015981
7915,7660435550,2470,7660438020,5,0,1,2560,5,7422420177
7916,7660521390,198329,7660719719,7,0,0,165376,7,2455068504
7917,7660523920,97951,7660621871,1,0,0,512,1,1357697218
7918,7660604910,3422,7660608332,6,0,1,3584,6,6409398086
7919,7660704739,125212,7660829951,9,0,0,61952,9,10373038223
7920,7660773728,189500,7660963228,4,0,0,160768,4,3742163954
7921,7660820653,19531,7660840184,1,0,1,16384,1,134716338
7922,7660843776,119950,7660963726,1,0,0,1536,1,9690605163
7923,7660885167,7706,7660892873,6,0,1,8192,6,577262025
7924,7660913348,49895,7660963243,6,0,1,4096,6,45771309
7925,7660958469,192596,7661151065,0,0,0,106496,0,4507617248
7926,7661003000,154944,7661157944,2,0,0,22528,2,5904725726
7927,7661145424,135953,7661281377,3,0,1,200192,3,4660839208
7928,7661154855,114594,7661269449,4,0,0,66048,4,1437472370
7929,7661206477,215038,7661421515,2,0,0,39936,2,2823560472
7930,7661212306,293467,7661505773,4,0,0,83456,4,2868834504
7931,7661386270,2470,7661388740,9,0,1,2560,9,3809335964
7932,7661388147,162952,7661551099,9,0,0,19456,9,3384038944
7933,7661442404,63384,7661505788,3,0,1,67584,3,10223227117
7934,7661475136,150609,7661625745,9,0,0,76800,9,8427728708
7935,7661583178,45596,7661628774,9,0,0,1024,9,8495709906
7936,7661653552,43904,7661697456,6,0,0,512,6,9216083475
7937,7661684376,13253,7661697629,1,0,1,25600,1,8586689589
7938,7661689290,74067,7661763357,3,0,0,9216,3,1152820751
7939,7661691190,57547,7661748737,6,0,0,512,6,547106614
7940,7661741883,104624,7661846507,9,0,0,43520,9,2221499988
7941,7661815236,41132,7661856368,1,0,1,66560,1,2430795995
7942,7661882774,152249,7662035023,1,0,1,246272,1,2275975854
7943,7662237489,4937,7662242426,0,0,1,12800,0,5219018003
7944,7662282638,86204,7662368842,4,0,0,13312,4,2616900068
7945,7662316982,112030,7662429012,6,0,0,512,6,1429856418
7946,7662335035,1994,7662337029,2,0,1,2048,2,8843603266
7947,7662340907,48980,7662389887,1,0,0,2048,1,6293809066
7948,7662409771,4420,7662414191,0,0,1,11776,0,6152209971
7949,7662436186,43904,7662480090,6,0,0,512,6,4336694781
7950,7662457254,96270,7662553524,0,0,0,28672,0,4485606945
7951,7662497091,566,7662497657,9,0,1,512,9,1251611796
7952,7662664105,3645,7662667750,6,0,1,10240,6,1030214324
7953,7662729137,1518,7662730655,5,0,1,1536,5,8830198439
7954,7662846203,5802,7662852005,0,0,1,6144,0,5831492866
7955,7662942359,1518,7662943877,9,0,1,1536,9,349500439
7956,7663036143,91748,7663127891,0,0,0,16384,0,2292526850
7957,7663179101,4850,7663183951,0,0,1,5120,0,5219177354
7958,7663192709,43904,7663236613,1,0,0,512,1,7907049913
7959,7663280519,81596,7663362115,3,0,0,13312,3,10155798040
7960,7663336889,3422,7663340311,0,0,1,3584,0,4236538750
7961,7663403973,110681,7663514654,3,0,0,31232,3,7586779209
7962,7663532430,102284,7663634714,2,0,0,35840,2,6719731064
7963,7663543593,13512,7663557105,3,0,1,26112,3,408695827
7964,7663616721,50921,7663667642,6,0,0,512,6,1708395714
7965,7663676671,43904,7663720575,1,0,0,512,1,229903288
7966,7663717703,105092,7663822795,3,0,0,45056,3,3279065651
7967,7663805316,1042,7663806358,0,0,1,1024,0,7237333295
7968,7663955424,120068,7664075492,7,0,0,94208,7,5175667620
7969,7663983755,121690,7664105445,6,0,0,2560,6,1374142982
7970,7663986807,3422,7663990229,6,0,1,3584,6,363890942
7971,7664002422,176906,7664179328,2,0,0,14336,2,4663272135
7972,7664015818,155783,7664171601,7,0,0,58368,7,4849402028
7973,7664108378,43904,7664152282,9,0,0,512,9,5171026480
7974,7664295123,3128,7664298251,3,0,1,9216,3,615840848
7975,7664360964,101660,7664462624,8,0,0,33792,8,1210543945
7976,7664368031,43904,7664411935,6,0,0,512,6,6958530763
7977,7664381573,3422,7664384995,5,0,1,3584,5,9993926189
7978,7664403122,99164,7664502286,3,0,0,25600,3,3246429655
7979,7664415879,180673,7664596552,2,0,0,107008,2,10723139517
7980,7664429268,171979,7664601247,8,0,0,15360,8,10702525971
7981,7664454139,193435,7664647574,3,0,0,47616,3,2993721348
7982,7664673709,110708,7664784417,8,0,0,63488,8,2000422823
7983,7664698265,150622,7664848887,0,0,0,47104,0,5191533717
7984,7664702959,212438,7664915397,7,0,0,72704,7,6795697817
7985,7664740251,5802,7664746053,0,0,1,6144,0,5344749380
7986,7664766493,149387,7664915880,1,0,0,1536,1,5715076039
7987,7664816402,2946,7664819348,0,0,1,3072,0,9899997476
7988,7664953299,4162,7664957461,9,0,1,11264,9,6216039702
7989,7664957947,197204,7665155151,1,0,1,315392,1,4230327555
7990,7664998604,156532,7665155136,2,0,0,31744,2,10321358092
7991,7665001083,154648,7665155731,2,0,1,5120,2,7911914811
7992,7665009504,193090,7665202594,1,0,1,150528,1,7198351671
7993,7665095210,110290,7665205500,0,0,1,4608,0,2451346242
7994,7665138764,279223,7665417987,0,0,0,1024,0,1751240831
7995,7665243251,566,7665243817,5,0,1,512,5,7263997987
7996,7665356547,101586,7665458133,8,0,0,5632,8,8148734225
7997,7665374392,183448,7665557840,1,0,0,512,1,4687873332
7998,7665438424,45596,7665484020,6,0,0,1024,6,3281654958
7999,7665438929,118740,7665557669,2,0,0,89088,2,1887228898
8000,7665472981,99944,7665572925,4,0,0,28160,4,7226083991
8001,7665572172,44649,7665616821,1,0,0,512,1,5653242375
8002,7665584873,98787,7665683660,8,0,0,24064,8,7535172718
8003,7665630717,45596,7665676313,1,0,0,1024,1,7257590757
8004,7665728125,5196,7665733321,6,0,1,13312,6,6738878624
8005,7665822985,72668,7665895653,3,0,0,9216,3,7054948351
8006,7665869982,91641,7665961623,2,0,0,17920,2,790199289
8007,7665890300,5368,7665895668,6,0,1,3072,6,1886774179
8008,7665899453,3387,7665902840,6,0,1,9728,6,3622516886
8009,7666118496,5802,7666124298,5,0,1,6144,5,2075769626
8010,7666135718,72668,7666208386,4,0,0,9216,4,7257913864
8011,7666291257,47288,7666338545,1,0,0,1536,1,9011610591
8012,7666384022,50672,7666434694,4,0,0,2560,4,486140934
8013,7666480061,114920,7666594981,0,0,0,77312,0,9208410837
8014,7666503169,94791,7666597960,3,0,0,9728,3,10026055578
8015,7666560952,78195,7666639147,4,0,0,7168,4,9754264886
8016,7666765181,109304,7666874485,4,0,0,58880,4,7271357327
8017,7666867547,93134,7666960681,7,0,0,13312,7,5734707775
8018,7666881471,13341,7666894812,1,0,1,22528,1,6923929308
8019,7666955074,110487,7667065561,0,0,0,57856,0,1372246270
8020,7667021786,71687,7667093473,1,0,0,1024,1,8892098287
8021,7667035706,1042,7667036748,6,0,1,1024,6,8244636327
8022,7667046718,102171,7667148889,3,0,0,26624,3,4707440490
8023,7667051701,18789,7667070490,0,0,1,12800,0,5772976970
8024,7667176785,10499,7667187284,5,0,1,16896,5,2606616053
8025,7667176981,52289,7667229270,8,0,0,1536,8,7815458414
8026,7667414113,77768,7667491881,0,0,0,15872,0,1150986261
8027,7667422681,99944,7667522625,9,0,0,28160,9,9095370553
8028,7667469651,1994,7667471645,6,0,1,2048,6,4393892211
8029,7667479860,111681,7667591541,4,0,0,28160,4,1052897372
8030,7667678861,88208,7667767069,0,0,0,14848,0,1181369278
8031,7667681027,1042,7667682069,2,0,1,1024,2,7278499368
8032,7667731322,147959,7667879281,4,0,0,83456,4,9575017571
8033,7667877526,47343,7667924869,1,0,0,1024,1,4981062419
8034,7667965866,3422,7667969288,6,0,1,3584,6,2430534098
8035,7667988466,103220,7668091686,7,0,0,38912,7,2181664368
8036,7668266703,43904,7668310607,1,0,0,512,1,10163842713
8037,7668294672,50672,7668345344,9,0,0,2560,9,10669056659
8038,7668583838,43904,7668627742,1,0,0,512,1,6609359307
8039,7668623258,112268,7668735526,8,0,0,68608,8,9561974437
8040,7668729282,104464,7668833746,7,0,0,22528,7,6187238513
8041,7668747274,24929,7668772203,1,0,1,45056,1,4530698848
8042,7668757123,16066,7668773189,0,0,1,1536,0,9974914454
8043,7668884733,5802,7668890535,2,0,1,6144,2,5313795314
8044,7668902630,7230,7668909860,3,0,1,7680,3,6016119032
8045,7668964744,3128,7668967872,1,0,1,9216,1,8616896004
8046,7668982599,74324,7669056923,1,0,0,512,1,5108290556
8047,7669011509,1518,7669013027,2,0,1,1536,2,10314491969
8048,7669063046,10241,7669073287,5,0,1,16384,5,1397803335
8049,7669077321,43904,7669121225,1,0,0,512,1,2769848037
8050,7669112576,4162,7669116738,6,0,1,11264,6,6144997057
8051,7669362294,50672,7669412966,6,0,0,2560,6,8251518625
8052,7669366998,55748,7669422746,7,0,0,4096,7,3253324490
8053,7669376524,101640,7669478164,7,0,0,23552,7,2773476211
8054,7669381517,89456,7669470973,4,0,0,18944,4,1604824598
8055,7669598289,15321,7669613610,3,0,1,29696,3,1329825326
8056,7669611967,2949,7669614916,9,0,1,2048,9,2332897086
8057,7669658720,82400,7669741120,7,0,0,20992,7,10035585032
8058,7669675800,65803,7669741603,3,0,0,1536,3,4640511489
8059,7669815850,7706,7669823556,9,0,1,8192,9,9027220030
8060,7669830679,140920,7669971599,3,0,0,60416,3,6832007426
8061,7669892844,1042,7669893886,2,0,1,1024,2,9451924900
8062,7669894357,225584,7670119941,7,0,0,104960,7,10594086513
8063,7669903608,133865,7670037473,4,0,0,48640,4,9266597159
8064,7669981781,102068,7670083849,3,0,0,1536,3,10495344153
8065,7670031196,8263,7670039459,9,0,1,2048,9,3973257741
8066,7670084376,35580,7670119956,1,0,1,7680,1,1764283201
8067,7670114488,64592,7670179080,4,0,0,5120,4,3956606723
8068,7670115462,48415,7670163877,6,0,0,512,6,10317551961
8069,7670144923,3422,7670148345,1,0,1,3584,1,8623040187
8070,7670157314,45596,7670202910,1,0,0,1024,1,8577630302
8071,7670247960,93128,7670341088,0,0,0,15872,0,6636181852
8072,7670280735,2470,7670283205,0,0,1,2560,0,5786726956
8073,7670286080,43904,7670329984,1,0,0,512,1,8537888692
8074,7670317201,141247,7670458448,4,0,0,101376,4,5779220091
8075,7670359973,99585,7670459558,8,0,0,3072,8,1576580034
8076,7670376576,1994,7670378570,9,0,1,2048,9,3622532366
8077,7670392059,79349,7670471408,1,0,0,512,1,5357926261
8078,7670449006,14284,7670463290,9,0,1,5120,9,4027988514
8079,7670465297,60824,7670526121,8,0,0,5632,8,5989282916
8080,7670525311,83114,7670608425,7,0,0,2048,7,10694651323
8081,7670586384,566,7670586950,2,0,1,512,2,111876420
8082,7670803220,11791,7670815011,0,0,1,19456,0,3356245178
8083,7670822905,30491,7670853396,3,0,1,49152,3,2625054624
8084,7670826158,33242,7670859400,3,0,1,28672,3,2826565379
8085,7670905224,214888,7671120112,8,0,0,64000,8,10398383241
8086,7670914623,566,7670915189,9,0,1,512,9,8856450175
8087,7671036336,167914,7671204250,0,0,0,16384,0,95484616
8088,7671054712,127374,7671182086,2,0,0,39424,2,5123296908
8089,7671106293,120775,7671227068,0,0,0,51200,0,6542176767
8090,7671455683,1994,7671457677,9,0,1,2048,9,99832064
8091,7671456701,67592,7671524293,2,0,0,7680,2,5012829375
8092,7671524298,106187,7671630485,9,0,0,48640,9,7041792698
8093,7671581538,130991,7671712529,3,0,0,38400,3,6395756698
8094,7671711691,102646,7671814337,9,0,0,34304,9,7297605084
8095,7671767587,51516,7671819103,5,0,1,83456,5,2144138948
8096,7671778210,44759,7671822969,0,0,1,6144,0,7057610596
8097,7671824482,47288,7671871770,1,0,0,1536,1,8058108598
8098,7671930384,3898,7671934282,6,0,1,4096,6,8888437463
8099,7671999089,116636,7672115725,2,0,0,82944,2,4611458860
8100,7672058969,56927,7672115896,1,0,0,512,1,6692379021
8101,7672061351,107300,7672168651,0,0,0,28672,0,7608386182
8102,7672180983,102440,7672283423,4,0,0,36352,4,9134668658
8103,7672278445,48874,7672327319,6,0,0,512,6,444552642
8104,7672340096,2946,7672343042,0,0,1,3072,0,784878222
8105,7672348129,47928,7672396057,4,0,0,512,4,4989166199
8106,7672421749,1042,7672422791,0,0,1,1024,0,7997579735
8107,7672442707,54524,7672497231,2,0,0,5120,2,4125120535
8108,7672637941,69932,7672707873,3,0,0,15360,3,9165021293
8109,7672746858,22691,7672769549,3,0,1,37376,3,932984583
8110,7672858179,6229,7672864408,5,0,1,15360,5,294545488
8111,7672972688,47288,7673019976,1,0,0,1536,1,3455462871
8112,7673018602,80840,7673099442,0,0,0,15872,0,2612182089
8113,7673024516,100724,7673125240,2,0,0,30720,2,10269403282
8114,7673137982,3387,7673141369,0,0,1,9728,0,10472741870
8115,7673142072,1518,7673143590,1,0,1,1536,1,7161574476
8116,7673161154,1994,7673163148,9,0,1,2048,9,5990818676
8117,7673370743,12049,7673382792,0,0,1,19968,0,5460863349
8118,7673376078,154047,7673530125,0,0,0,50688,0,8684126290
8119,7673396860,184421,7673581281,9,0,0,52224,9,7806554179
8120,7673403559,16354,7673419913,9,0,1,31744,9,1958974299
8121,7673406677,15182,7673421859,2,0,1,3072,2,3692669696
8122,7673407306,15219,7673422525,1,0,1,1024,1,10706462944
8123,7673566993,68336,7673635329,9,0,0,3584,9,1497395873
8124,7673713893,43904,7673757797,6,0,0,512,6,4671975804
8125,7673741888,43904,7673785792,6,0,0,512,6,10123670615
8126,7673752666,1994,7673754660,2,0,1,2048,2,1066021642
8127,7673780862,97316,7673878178,0,0,0,24576,0,7993212893
8128,7673843163,3645,7673846808,9,0,1,10240,9,3363800413
8129,7673890769,566,7673891335,9,0,1,512,9,7340355616
8130,7673991728,2470,7673994198,4,0,1,2560,4,8090150636
8131,7674004687,4374,7674009061,1,0,1,4608,1,10159463929
8132,7674077462,55748,7674133210,8,0,0,4096,8,6044909799
8133,7674108176,1518,7674109694,0,0,1,1536,0,9497507141
8134,7674127444,128586,7674256030,2,0,0,107520,2,4260036538
8135,7674153554,2470,7674156024,6,0,1,2560,6,7507232248
8136,7674160362,137556,7674297918,3,0,0,26624,3,3647868844
8137,7674165420,137037,7674302457,4,0,0,14848,4,7610710247
8138,7674200141,110311,7674310452,8,0,0,6144,8,5553394861
8139,7674231772,25785,7674257557,1,0,1,1536,1,6808914541
8140,7674241476,61152,7674302628,6,0,0,512,6,6729761539
8141,7674302499,1639,7674304138,6,0,1,1536,6,3024455736
8142,7674327457,54056,7674381513,9,0,0,3584,9,8508673012
8143,7674334855,43904,7674378759,1,0,0,512,1,5618074327
8144,7674425893,74360,7674500253,9,0,0,9728,9,195028650
8145,7674484849,145652,7674630501,8,0,0,91648,8,10226543778
8146,7674518018,177265,7674695283,0,0,0,76288,0,8958111752
8147,7674542909,90167,7674633076,1,0,0,1024,1,5394174317
8148,7674555280,1994,7674557274,0,0,1,2048,0,8671084753
8149,7674592898,104584,7674697482,7,0,0,7168,7,8486576034
8150,7674624015,78696,7674702711,0,0,0,7680,0,7159888028
8151,7674703866,2946,7674706812,9,0,1,3072,9,8049870847
8152,7674751618,24412,7674776030,3,0,1,44032,3,2809947042
8153,7674764736,59282,7674824018,3,0,0,4608,3,2176132916
8154,7674778859,160648,7674939507,9,0,0,120320,9,8067285230
8155,7674807054,5326,7674812380,2,0,1,5632,2,3444609015
8156,7674958808,4374,7674963182,3,0,1,4608,3,7641798744
8157,7675122140,100412,7675222552,8,0,0,29696,8,9140985561
8158,7675146733,124449,7675271182,4,0,0,41984,4,10632385794
8159,7675178451,1042,7675179493,2,0,1,1024,2,199166052
8160,7675250992,65429,7675316421,3,0,1,110592,3,3541668309
8161,7675280165,164416,7675444581,3,0,0,57344,3,4077679067
8162,7675329683,119445,7675449128,8,0,0,14848,8,5044007254
8163,7675374131,1518,7675375649,2,0,1,1536,2,1292102208
8164,7675418030,43904,7675461934,1,0,0,512,1,10700764200
8165,7675429932,60237,7675490169,1,0,0,1024,1,2224770756
8166,7675450161,100724,7675550885,0,0,0,30720,0,8127185579
8167,7675496206,97231,7675593437,7,0,0,16896,7,7189291118
8168,7675643392,45596,7675688988,6,0,0,1024,6,5830761411
8169,7675677071,115856,7675792927,7,0,0,80384,7,1359241575
8170,7675744998,135649,7675880647,0,0,0,68608,0,9151955112
8171,7675754284,127002,7675881286,6,0,0,2048,6,2606375689
8172,7675845841,2470,7675848311,9,0,1,2560,9,6052433913
8173,7675901709,104000,7676005709,2,0,0,41472,2,7022712092
8174,7675965065,112368,7676077433,0,0,0,57856,0,7500082259
8175,7676246424,43904,7676290328,6,0,0,512,6,8198976073
8176,7676266387,81128,7676347515,8,0,0,11776,8,7851503106
8177,7676326959,43904,7676370863,1,0,0,512,1,5125505283
8178,7676509986,121004,7676630990,0,0,0,97280,0,1184989967
8179,7676533860,7706,7676541566,4,0,1,8192,4,6512322478
8180,7676541323,30749,7676572072,3,0,1,49664,3,6534841612
8181,7676604432,177657,7676782089,9,0,0,54272,9,9295287041
8182,7676732803,6488,7676739291,1,0,1,15872,1,3855317148
8183,7676735140,4497,7676739637,1,0,1,512,1,3754869755
8184,7676783163,22691,7676805854,5,0,1,37376,5,536126169
8185,7676790735,16745,7676807480,2,0,1,2560,2,8414979028
8186,7676794314,96772,7676891086,2,0,0,15360,2,7973955734
8187,7676897718,102284,7677000002,0,0,0,35840,0,3836096968
8188,7676912697,5802,7676918499,5,0,1,6144,5,956533462
8189,7676955975,3898,7676959873,2,0,1,4096,2,3066969732
8190,7677030844,141866,7677172710,3,0,1,229376,3,6385543514
8191,7677044675,314135,7677358810,9,0,0,38400,9,7011368277
8192,7677148500,292930,7677441430,8,0,0,36864,8,10465729534
8193,7677207495,222688,7677430183,3,0,0,77824,3,2803259599
8194,7677215444,6229,7677221673,3,0,1,15360,3,6513883417
8195,7677364071,169310,7677533381,8,0,0,135168,8,4504618449
8196,7677435417,28955,7677464372,3,0,1,37888,3,10042484074
8197,7677690923,12737,7677703660,1,0,1,24576,1,6568885118
8198,7677768508,100412,7677868920,4,0,0,29696,4,5058108632
8199,7677775954,3387,7677779341,6,0,1,9728,6,3686349626
8200,7677816982,306004,7678122986,3,0,0,284160,3,1011172799
8201,7677835825,4162,7677839987,3,0,1,11264,3,2203697876
8202,7677848388,111710,7677960098,7,0,0,6656,7,3035333968
8203,7677999515,128954,7678128469,2,0,0,17920,2,4737987615
8204,7678056234,76873,7678133107,2,0,1,12288,2,2307147815
8205,7678221095,13858,7678234953,3,0,1,23552,3,2352335936
8206,7678391379,1042,7678392421,2,0,1,1024,2,2340544892
8207,7678392215,43904,7678436119,6,0,0,512,6,3667890220
8208,7678496824,566,7678497390,0,0,1,512,0,7422181043
8209,7678540207,42166,7678582373,5,0,1,68608,5,7246553299
8210,7678604935,76673,7678681608,4,0,0,8704,4,7490265868
8211,7678662337,1994,7678664331,1,0,1,2048,1,1331377274
8212,7678669861,115757,7678785618,9,0,0,76288,9,1211363157
8213,7678761315,24318,7678785633,6,0,1,2048,6,2093594137
8214,7678839891,47288,7678887179,2,0,0,1536,2,5742150375
8215,7678925579,43904,7678969483,6,0,0,512,6,384130923
8216,7678937381,43904,7678981285,1,0,0,512,1,9117307050
8217,7678957561,4374,7678961935,1,0,1,4608,1,10352987286
8218,7678958453,4206,7678962659,6,0,1,10240,6,8464041877
8219,7679013151,45596,7679058747,6,0,0,1024,6,2865536428
8220,7679039577,69308,7679108885,4,0,0,13312,4,1802922225
8221,7679059165,52291,7679111456,3,0,1,84992,3,7970273163
8222,7679083523,33425,7679116948,5,0,1,26112,5,9637499011
8223,7679091208,29926,7679121134,4,0,1,6656,4,2908223547
8224,7679383163,1042,7679384205,9,0,1,1024,9,6320747642
8225,7679411124,105872,7679516996,4,0,0,47616,4,9265077257
8226,7679452329,152693,7679605022,9,0,0,108544,9,692878298
8227,7679514575,92193,7679606768,9,0,0,5120,9,136031162
8228,7679541171,64022,7679605193,1,0,0,512,1,4249493791
8229,7679542526,13341,7679555867,0,0,1,22528,0,7941525881
8230,7679736907,54056,7679790963,3,0,0,3584,3,4647232766
8231,7679940285,131938,7680072223,7,0,0,79360,7,9124298152
8232,7679956679,128039,7680084718,3,0,0,40960,3,3912993927
8233,7680003428,43716,7680047144,5,0,1,71680,5,2168114204
8234,7680100288,4850,7680105138,1,0,1,5120,1,9726653306
8235,7680181673,129498,7680311171,9,0,0,85504,9,1448199251
8236,7680197398,2470,7680199868,0,0,1,2560,0,8126483275
8237,7680299195,13962,7680313157,2,0,1,2048,2,5695754459
8238,7680312298,79904,7680392202,2,0,0,12800,2,1331390730
8239,7680334041,3422,7680337463,6,0,1,3584,6,6824011692
8240,7680356795,5712,7680362507,9,0,1,14336,9,6011499228
8241,7680389045,247131,7680636176,2,0,0,137216,2,5951963402
8242,7680509355,249335,7680758690,7,0,0,215552,7,5599756779
8243,7680749073,23467,7680772540,5,0,1,23552,5,10206042072
8244,7680794095,104000,7680898095,9,0,0,41472,9,2584988970
8245,7680819990,47288,7680867278,6,0,0,1536,6,5099574965
8246,7680934188,6754,7680940942,6,0,1,7168,6,3241169393
8247,7680942928,2946,7680945874,6,0,1,3072,6,4410787108
8248,7680964577,6278,7680970855,1,0,1,6656,1,1604931537
8249,7681000624,125063,7681125687,6,0,0,1024,6,8165310334
8250,7681044204,10241,7681054445,5,0,1,16384,5,237691057
8251,7681125966,130287,7681256253,4,0,0,25088,4,9149110401
8252,7681129076,54358,7681183434,3,0,1,89088,3,3470070772
8253,7681235736,2470,7681238206,0,0,1,2560,0,1508570906
8254,7681241611,2470,7681244081,0,0,1,2560,0,3547014544
8255,7681262989,5802,7681268791,2,0,1,6144,2,301753434
8256,7681305213,13512,7681318725,3,0,1,26112,3,303649961
8257,7681314832,4239,7681319071,6,0,1,512,6,4193735472
8258,7681340124,88267,7681428391,0,0,0,8192,0,2236320906
8259,7681533142,33333,7681566475,5,0,1,54784,5,8966812878
8260,7681562464,9157,7681571621,9,0,1,8192,9,8166987871
8261,7681599388,51257,7681650645,5,0,1,82944,5,8363431992
8262,7681650687,6278,7681656965,3,0,1,6656,3,5071324985
8263,7681899112,566,7681899678,1,0,1,512,1,4898895540
8264,7681913539,45596,7681959135,6,0,0,1024,6,2965936789
8265,7681964735,42941,7682007676,3,0,1,70144,3,8653080728
8266,7681966234,42748,7682008982,3,0,1,2048,3,6371902888
8267,7681985043,25565,7682010608,0,0,1,2560,0,1936202469
8268,7682098803,119325,7682218128,6,0,0,1024,6,5192141219
8269,7682110439,3422,7682113861,4,0,1,3584,4,8942732718
8270,7682135904,5326,7682141230,2,0,1,5632,2,1585334248
8271,7682159178,88676,7682247854,9,0,0,16384,9,87922277
8272,7682360563,102752,7682463315,9,0,0,37376,9,9252244547
8273,7682420917,62516,7682483433,0,0,0,6144,0,2597954215
8274,7682579800,4937,7682584737,9,0,1,12800,9,9013141464
8275,7682598104,5802,7682603906,1,0,1,6144,1,2449090739
8276,7682639292,4850,7682644142,5,0,1,5120,5,2022020502
8277,7682673193,117572,7682790765,0,0,0,86016,0,8364122853
8278,7682772808,18991,7682791799,9,0,1,1024,9,1147265587
8279,7682807986,101504,7682909490,2,0,0,33280,2,9013178370
8280,7682930109,43904,7682974013,6,0,0,512,6,8675679385
8281,7682940829,1518,7682942347,9,0,1,1536,9,698559255
8282,7683034339,3422,7683037761,1,0,1,3584,1,4528890260
8283,7683066032,47288,7683113320,0,0,0,1536,0,8119550743
8284,7683073768,153296,7683227064,9,0,0,137728,9,9195182190
8285,7683196158,131466,7683327624,7,0,0,30208,7,6486334224
8286,7683254494,3422,7683257916,1,0,1,3584,1,9219497934
8287,7683279362,3898,7683283260,6,0,1,4096,6,4189586877
8288,7683481651,6754,7683488405,0,0,1,7168,0,6456431546
8289,7683548922,59132,7683608054,9,0,0,5120,9,6401636866
8290,7683625261,1518,7683626779,1,0,1,1536,1,7639561523
8291,7683767260,1042,7683768302,9,0,1,1024,9,9592288093
8292,7683795682,65612,7683861294,2,0,0,11264,2,3681013334
8293,7683834426,1518,7683835944,6,0,1,1536,6,149172761
8294,7683843043,113672,7683956715,2,0,0,73216,2,1243096691
8295,7683874416,172575,7684046991,8,0,0,51712,8,2246416088
8296,7683989449,25187,7684014636,2,0,1,45568,2,3656778392
8297,7684043276,5701,7684048977,9,0,1,2048,9,2587471043
8298,7684067439,5712,7684073151,4,0,1,14336,4,5910256634
8299,7684134539,64654,7684199193,5,0,1,109056,5,10129621077
8300,7684135581,69001,7684204582,6,0,1,17408,6,3457910242
8301,7684176176,29712,7684205888,9,0,1,2048,9,8682652769
8302,7684183355,22879,7684206234,9,0,1,512,9,4706356990
8303,7684218379,3128,7684221507,1,0,1,9216,1,10134962507
8304,7684433053,104468,7684537521,9,0,0,43008,9,3807370101
8305,7684505198,3898,7684509096,4,0,1,4096,4,8146459012
8306,7684561994,47288,7684609282,0,0,0,1536,0,6180211104
8307,7684614393,14117,7684628510,6,0,1,24064,6,3547129092
8308,7684627314,92336,7684719650,7,0,0,10240,7,65645203
8309,7684740927,4937,7684745864,4,0,1,12800,4,7998548613
8310,7684745097,53638,7684798735,1,0,0,3072,1,4967378280
8311,7684899403,1518,7684900921,2,0,1,1536,2,366583216
8312,7685003092,566,7685003658,4,0,1,512,4,853253547
8313,7685051664,566,7685052230,0,0,1,512,0,5141602607
8314,7685054633,188716,7685243349,9,0,0,148480,9,4667095757
8315,7685114988,4374,7685119362,1,0,1,4608,1,3605234636
8316,7685203730,40670,7685244400,0,0,1,1024,0,9608673827
8317,7685220712,26380,7685247092,4,0,1,3584,4,10080160673
8318,7685248397,211918,7685460315,8,0,0,71680,8,10573358868
8319,7685260114,162601,7685422715,9,0,0,79872,9,7519471705
8320,7685421470,50685,7685472155,1,0,0,3584,1,8664755576
8321,7685496122,34108,7685530230,3,0,1,56320,3,9320941856
8322,7685508192,105283,7685613475,1,0,0,2560,1,1612183370
8323,7685515082,18054,7685533136,2,0,1,4608,2,5962196005
8324,7685527583,129392,7685656975,7,0,0,74752,7,1369189004
8325,7685743523,4850,7685748373,2,0,1,5120,2,3378084772
8326,7685764936,3128,7685768064,4,0,1,9216,4,414631670
8327,7685777824,1518,7685779342,6,0,1,1536,6,8897485828
8328,7685793598,50672,7685844270,8,0,0,2560,8,2601298220
8329,7685820276,160381,7685980657,3,0,0,29184,3,8194913004
8330,7685847906,43904,7685891810,1,0,0,512,1,9156601748
8331,7685914083,15837,7685929920,0,0,1,30720,0,5530463508
8332,7685942713,102128,7686044841,2,0,0,35328,2,3319865294
8333,7685955517,128983,7686084500,3,0,0,45056,3,8038699270
8334,7685974300,326297,7686300597,8,0,0,52224,8,3485704682
8335,7686080129,6833,7686086962,2,0,1,2560,2,4342910756
8336,7686385354,63140,7686448494,8,0,0,8192,8,3636914779
8337,7686403319,187316,7686590635,4,0,0,153600,4,2221001370
8338,7686520105,107432,7686627537,9,0,0,52736,9,8536700385
8339,7686521361,121791,7686643152,7,0,0,51200,7,8053784449
8340,7686524168,566,7686524734,3,0,1,512,3,3485411224
8341,7686525740,3898,7686529638,9,0,1,4096,9,2181664980
8342,7686572535,113404,7686685939,7,0,0,23040,7,603716145
8343,7686663740,23378,7686687118,3,0,1,41984,3,6922422220
8344,7686822715,111176,7686933891,4,0,0,65024,4,6911854027
8345,7686905224,46988,7686952212,5,0,1,81408,5,8080752478
8346,7686908378,218699,7687127077,2,0,0,52736,2,126927880
8347,7686946110,126076,7687072186,1,0,0,512,1,3750974765
8348,7686983209,11533,7686994742,5,0,1,18944,5,6164005384
8349,7687068706,4162,7687072868,2,0,1,11264,2,2647202320
8350,7687086252,43904,7687130156,6,0,0,512,6,1562744807
8351,7687090867,3387,7687094254,2,0,1,9728,2,4782616325
8352,7687173459,566,7687174025,9,0,1,512,9,7337576366
8353,7687295400,118352,7687413752,4,0,0,88576,4,1666098642
8354,7687373039,57573,7687430612,0,0,0,512,0,4875168022
8355,7687395289,93492,7687488781,3,0,1,125952,3,4013532992
8356,7687479584,15098,7687494682,4,0,1,19968,4,135325572
8357,7687501888,165125,7687667013,8,0,0,25600,8,305772826
8358,7687672465,7706,7687680171,1,0,1,8192,1,7059479626
8359,7687733119,97760,7687830879,3,0,0,20992,3,6774901492
8360,7687812565,109616,7687922181,2,0,0,59904,2,3726200669
8361,7687889334,120723,7688010057,4,0,0,48640,4,10575424711
8362,7687928556,90219,7688018775,0,0,0,512,0,8572068114
8363,7687931237,1042,7687932279,2,0,1,1024,2,10491772716
8364,7687936296,109479,7688045775,8,0,0,58880,8,6688037152
8365,7687959989,52291,7688012280,4,0,1,84992,4,9952885778
8366,7688069655,7230,7688076885,0,0,1,7680,0,4651122094
8367,7688125906,5454,7688131360,6,0,1,13824,6,8558281666
8368,7688224429,48980,7688273409,0,0,0,2048,0,3859706600
8369,7688244797,195190,7688439987,2,0,0,174592,2,10594296873
8370,7688268499,3645,7688272144,1,0,1,10240,1,4749469033
8371,7688298658,16613,7688315271,8,0,1,32256,8,4577405591
8372,7688527943,69776,7688597719,9,0,0,14848,9,2353676817
8373,7688632599,74608,7688707207,5,0,1,121856,5,8516756538
8374,7688651518,66109,7688717627,5,0,1,41472,5,4686804317
8375,7688696575,32598,7688729173,5,0,1,47104,5,456374036
8376,7688712516,203582,7688916098,0,0,0,512,0,3064783309
8377,7688795928,1042,7688796970,6,0,1,1024,6,4346217183
8378,7688818209,43904,7688862113,0,0,0,512,0,6878009509
8379,7688819959,54270,7688874229,5,0,1,92160,5,3224165692
8380,7688823493,68499,7688891992,6,0,0,512,6,3067194591
8381,7688910479,3898,7688914377,9,0,1,4096,9,5155643036
8382,7688940139,566,7688940705,0,0,1,512,0,1360298341
8383,7688959135,101348,7689060483,9,0,0,32768,9,6494242002
8384,7688973612,65429,7689039041,3,0,1,110592,3,5844105290
8385,7689031352,267520,7689298872,4,0,0,26112,4,1145842816
8386,7689099060,285006,7689384066,7,0,0,72704,7,5078018633
8387,7689102338,3422,7689105760,3,0,1,3584,3,1459576332
8388,7689118533,205158,7689323691,4,0,0,81408,4,5116538005
8389,7689132478,3422,7689135900,2,0,1,3584,2,705226979
8390,7689137788,4850,7689142638,9,0,1,5120,9,8003412152
8391,7689147677,2946,7689150623,6,0,1,3072,6,9351421928
8392,7689193500,11533,7689205033,3,0,1,18944,3,2750852094
8393,7689226512,108252,7689334764,0,0,0,512,0,1379745833
8394,7689345195,5326,7689350521,1,0,1,5632,1,5044296838
8395,7689372456,193171,7689565627,9,0,0,90112,9,1382582370
8396,7689385543,6278,7689391821,5,0,1,6656,5,305167451
8397,7689414521,1994,7689416515,2,0,1,2048,2,5816894863
8398,7689485348,139341,7689624689,9,0,0,38400,9,7085385495
8399,7689608088,16616,7689624704,8,0,1,23552,8,4385312642
8400,7689631326,32816,7689664142,8,0,1,53760,8,5311822425
8401,7689650915,19333,7689670248,3,0,1,29184,3,10056826344
8402,7689670203,2874,7689673077,9,0,1,8704,9,284947882
8403,7689675904,117968,7689793872,6,0,0,1024,6,1107026960
8404,7689684480,14029,7689698509,6,0,1,27136,6,7098928583
8405,7689720668,1994,7689722662,2,0,1,2048,2,2293630384
8406,7689773823,241103,7690014926,7,0,0,28672,7,2979184576
8407,7689790102,13770,7689803872,4,0,1,26624,4,9909110562
8408,7689879238,217450,7690096688,3,0,0,64000,3,1701158554
8409,7689954019,106321,7690060340,4,0,0,10240,4,4797994903
8410,7690120654,45596,7690166250,0,0,0,1024,0,8298871705
8411,7690142647,24929,7690167576,3,0,1,45056,3,10208618856
8412,7690190706,47600,7690238306,0,0,0,2560,0,7963960859
8413,7690194035,99049,7690293084,3,0,0,26624,3,485158244
8414,7690304054,5454,7690309508,8,0,1,13824,8,4888742209
8415,7690304177,106890,7690411067,3,0,0,37376,3,6064406425
8416,7690436553,70976,7690507529,9,0,0,8704,9,6024437258
8417,7690451558,45596,7690497154,1,0,0,1024,1,1688184796
8418,7690467568,16613,7690484181,4,0,1,32256,4,10287592975
8419,7690570847,72668,7690643515,7,0,0,9216,7,7445803773
8420,7690599197,1518,7690600715,1,0,1,1536,1,8960812657
8421,7690863345,35829,7690899174,4,0,1,62976,4,7731271933
8422,7690973673,125528,7691099201,2,0,0,112128,2,5053648465
8423,7691063093,53184,7691116277,4,0,0,4608,4,2614547995
8424,7691069647,73450,7691143097,4,0,0,512,4,1962467300
8425,7691102739,43904,7691146643,4,0,0,512,4,3989353004
8426,7691175674,4162,7691179836,0,0,1,11264,0,23232899
8427,7691287844,1042,7691288886,8,0,1,1024,8,675673352
8428,7691296618,4850,7691301468,5,0,1,5120,5,8519294674
8429,7691404333,3422,7691407755,1,0,1,3584,1,10625278161
8430,7691415409,55748,7691471157,1,0,0,4096,1,2123148012
8431,7691489297,102593,7691591890,2,0,0,23040,2,10466677919
8432,7691657835,566,7691658401,1,0,1,512,1,2659824880
8433,7691670296,45596,7691715892,1,0,0,1024,1,4013555154
8434,7691676236,24670,7691700906,5,0,1,44544,5,6317712030
8435,7691740558,45596,7691786154,1,0,0,1024,1,6752935056
8436,7692101396,45596,7692146992,1,0,0,1024,1,9763292764
8437,7692155193,124748,7692279941,2,0,0,109568,2,1625666502
8438,7692184844,96048,7692280892,6,0,0,3072,6,1993777345
8439,7692188882,4374,7692193256,2,0,1,4608,2,5308288534
8440,7692192242,35571,7692227813,3,0,1,62464,3,4385001829
8441,7692220303,128010,7692348313,8,0,0,17920,8,964902482
8442,7692463082,43904,7692506986,0,0,0,512,0,5277542758
8443,7692487366,1042,7692488408,1,0,1,1024,1,1023517140
8444,7692537838,3422,7692541260,2,0,1,3584,2,4640659385
8445,7692617121,25962,7692643083,5,0,1,47104,5,4807751501
8446,7692870990,110396,7692981386,9,0,0,62464,9,8318307440
8447,7692965310,90718,7693056028,4,0,1,121856,4,2896966831
8448,7692965683,91971,7693057654,0,0,1,2560,0,8352596832
8449,7692974463,52561,7693027024,4,0,0,1024,4,8110472528
8450,7693002642,56958,7693059600,1,0,1,3072,1,5902955562
8451,7693044165,16421,7693060586,5,0,1,1536,5,9876979843
8452,7693057895,64230,7693122125,1,0,0,3584,1,4275671744
8453,7693186254,13858,7693200112,4,0,1,23552,4,406962959
8454,7693189426,11352,7693200778,5,0,1,1024,5,10419374504
8455,7693223035,160904,7693383939,0,0,0,1024,0,5417953571
8456,7693223110,120169,7693343279,2,0,0,44544,2,1969143069
8457,7693325101,1042,7693326143,8,0,1,1024,8,5191187727
8458,7693335928,12280,7693348208,8,0,1,12800,8,9939459987
8459,7693355829,73058,7693428887,3,0,1,118784,3,112572289
8460,7693384520,46633,7693431153,2,0,1,3584,2,1931210037
8461,7693506507,161745,7693668252,1,0,0,512,1,4175770020
8462,7693517540,5326,7693522866,1,0,1,5632,1,5022640197
8463,7693518249,90976,7693609225,4,0,0,512,4,2166988486
8464,7693585291,5326,7693590617,8,0,1,5632,8,4636630314
8465,7693636273,5802,7693642075,6,0,1,6144,6,8052811156
8466,7693670167,54617,7693724784,3,0,1,89600,3,3360800333
8467,7693693573,56463,7693750036,3,0,0,3584,3,8337540123
8468,7693715894,34157,7693750051,4,0,1,54784,4,1684537790
8469,7693784792,4420,7693789212,3,0,1,11776,3,7762809618
8470,7693798924,4374,7693803298,9,0,1,4608,9,5314099048
8471,7693830467,3898,7693834365,2,0,1,4096,2,9923472368
8472,7694007548,4850,7694012398,8,0,1,5120,8,8109117976
8473,7694039501,11791,7694051292,3,0,1,19456,3,1571188691
8474,7694043564,45818,7694089382,0,0,0,512,0,10065629880
8475,7694144344,6754,7694151098,3,0,1,7168,3,344734093
8476,7694235983,4162,7694240145,3,0,1,11264,3,415188866
8477,7694238697,100711,7694339408,8,0,0,28160,8,774108639
8478,7694267159,30749,7694297908,3,0,1,49664,3,557631767
8479,7694340106,43904,7694384010,0,0,0,512,0,1010729726
8480,7694346236,43904,7694390140,4,0,0,512,4,255057846
8481,7694388121,5802,7694393923,1,0,1,6144,1,9278851258
8482,7694405281,103037,7694508318,9,0,0,36864,9,6215699094
8483,7694459206,81287,7694540493,4,0,0,512,4,5870608766
8484,7694462727,79302,7694542029,4,0,0,512,4,8447731500
8485,7694566864,113828,7694680692,7,0,0,73728,7,2132640963
8486,7694616607,88853,7694705460,1,0,0,1536,1,908016360
8487,7694690431,65900,7694756331,7,0,0,7168,7,2954036750
8488,7694774163,100724,7694874887,7,0,0,30720,7,9989759572
8489,7694803882,47288,7694851170,0,0,0,1536,0,6462262253
8490,7694817742,5802,7694823544,2,0,1,6144,2,10307238137
8491,7694889731,130364,7695020095,8,0,0,128000,8,3914880625
8492,7694971884,1042,7694972926,8,0,1,1024,8,2376698508
8493,7694986317,34336,7695020653,6,0,1,512,6,2973779818
8494,7695029754,45596,7695075350,1,0,0,1024,1,1546242017
8495,7695070074,47288,7695117362,6,0,0,1536,6,8697487297
8496,7695153490,43904,7695197394,0,0,0,512,0,1869324610
8497,7695168870,45596,7695214466,4,0,0,1024,4,10000421962
8498,7695293461,2946,7695296407,3,0,1,3072,3,9403321670
8499,7695427062,104624,7695531686,3,0,0,43520,3,9579413454
8500,7695440350,111800,7695552150,8,0,0,67072,8,6556185883
8501,7695501926,50403,7695552329,6,0,0,512,6,8386389664
8502,7695517751,66271,7695584022,6,0,0,3072,6,1748180992
8503,7695539422,56236,7695595658,5,0,1,74240,5,6037278974
8504,7695743015,50672,7695793687,6,0,0,2560,6,3366567906
8505,7695789843,4850,7695794693,8,0,1,5120,8,9755964977
8506,7695805886,43904,7695849790,8,0,0,512,8,9196997453
8507,7695811778,566,7695812344,2,0,1,512,2,2576175618
8508,7695815894,566,7695816460,0,0,1,512,0,5769813326
8509,7695816689,43904,7695860593,6,0,0,512,6,4396787997
8510,7695826549,51855,7695878404,1,0,0,2560,1,6051177208
8511,7695826758,66724,7695893482,1,0,0,512,1,491708291
8512,7695848236,566,7695848802,9,0,1,512,9,10702059720
8513,7695904880,98056,7696002936,1,0,0,2560,1,3216723460
8514,7695931591,1518,7695933109,8,0,1,1536,8,1706739232
8515,7695944932,101816,7696046748,9,0,0,34304,9,1551483969
8516,7695999295,69329,7696068624,2,0,0,9216,2,3649241211
8517,7696040020,91352,7696131372,8,0,0,11264,8,10045857938
8518,7696104970,81632,7696186602,4,0,1,132096,4,5250005802
8519,7696188257,209772,7696398029,8,0,0,27648,8,5191479187
8520,7696298322,3387,7696301709,5,0,1,9728,5,9690638001
8521,7696304809,152357,7696457166,1,0,0,1536,1,1104359585
8522,7696313906,55748,7696369654,2,0,0,4096,2,7655988298
8523,7696328800,12737,7696341537,8,0,1,24576,8,1411759997
8524,7696331422,12701,7696344123,1,0,1,4096,1,3137230574
8525,7696372405,72668,7696445073,3,0,0,9216,3,2354832647
8526,7696417086,69027,7696486113,6,0,0,512,6,9997899308
8527,7696548908,113984,7696662892,9,0,0,74240,9,3822052700
8528,7696570223,3387,7696573610,6,0,1,9728,6,6354464985
8529,7696616083,97575,7696713658,7,0,0,17920,7,4952328026
8530,7696702855,45596,7696748451,4,0,0,1024,4,5600904083
8531,7696733541,83468,7696817009,3,0,0,19456,3,2958005872
8532,7696746296,3422,7696749718,4,0,1,3584,4,2033184096
8533,7696780167,21141,7696801308,5,0,1,34304,5,4640155254
8534,7696818623,43904,7696862527,6,0,0,512,6,2395273426
8535,7696879118,43904,7696923022,0,0,0,512,0,1326070611
8536,7697123487,106496,7697229983,2,0,0,49664,2,10444221975
8537,7697195517,45752,7697241269,0,0,0,1536,0,6995848827
8538,7697278810,10757,7697289567,5,0,1,17408,5,4279765837
8539,7697333931,6754,7697340685,1,0,1,7168,1,9853892816
8540,7697348228,6754,7697354982,2,0,1,7168,2,5230768413
8541,7697440856,142977,7697583833,7,0,0,111616,7,7535862107
8542,7697565275,22454,7697587729,5,0,1,10752,5,1287310269
8543,7697603898,118448,7697722346,2,0,0,41984,2,3619724159
8544,7697615118,45596,7697660714,4,0,0,1024,4,4623228558
8545,7697693436,60980,7697754416,7,0,0,6144,7,621229215
8546,7697721072,72242,7697793314,3,0,0,8704,3,6266647422
8547,7697792816,116346,7697909162,3,0,0,80384,3,7075935190
8548,7697804394,43904,7697848298,0,0,0,512,0,6273633917
8549,7697831251,112645,7697943896,8,0,0,11776,8,7352220669
8550,7697963074,3422,7697966496,1,0,1,3584,1,7518761070
8551,7698066321,2946,7698069267,9,0,1,3072,9,16440126
8552,7698282851,3422,7698286273,8,0,1,3584,8,7521398902
8553,7698303173,75320,7698378493,8,0,0,17920,8,6313783660
8554,7698317366,76133,7698393499,1,0,0,512,1,1458632315
8555,7698375176,47213,7698422389,4,0,0,512,4,4973854750
8556,7698635983,48980,7698684963,6,0,0,2048,6,3768401978
8557,7698686634,5802,7698692436,1,0,1,6144,1,6568272415
8558,7698821024,45596,7698866620,6,0,0,1024,6,6874822219
8559,7698906213,57440,7698963653,9,0,0,4608,9,1856481393
8560,7698923421,23983,7698947404,5,0,1,39936,5,2498284702
8561,7698986488,98852,7699085340,8,0,0,24576,8,3341613785
8562,7699009957,104974,7699114931,7,0,0,24064,7,3893720345
8563,7699017504,90080,7699107584,9,0,0,20992,9,10110146925
8564,7699335206,4374,7699339580,1,0,1,4608,1,735202972
8565,7699441073,20624,7699461697,5,0,1,33280,5,1060961684
8566,7699449060,19050,7699468110,4,0,1,30720,4,8583549534
8567,7699576132,566,7699576698,1,0,1,512,1,2940826338
8568,7699604508,14287,7699618795,3,0,1,27648,3,6136022298
8569,7699633431,566,7699633997,2,0,1,512,2,999120780
8570,7699666440,64483,7699730923,5,0,1,105472,5,1944456799
8571,7699674473,56796,7699731269,1,0,1,512,1,6098717353
8572,7699704770,59583,7699764353,0,0,0,512,0,4206199600
8573,7699809146,43904,7699853050,6,0,0,512,6,9241637746
8574,7699885597,94664,7699980261,9,0,0,15872,9,8476336572
8575,7699945503,78056,7700023559,2,0,0,11776,2,10546130521
8576,7699972621,98072,7700070693,7,0,0,22016,7,3460635775
8577,7700022841,1752,7700024593,1,0,1,1024,1,10013542293
8578,7700042923,97004,7700139927,9,0,0,23552,9,2100874416
8579,7700056816,4374,7700061190,3,0,1,4608,3,6358595975
8580,7700158021,82052,7700240073,9,0,0,14336,9,4797310679
8581,7700159880,43904,7700203784,0,0,0,512,0,9554698152
8582,7700228632,4374,7700233006,8,0,1,4608,8,10355489502
8583,7700257702,2946,7700260648,0,0,1,3072,0,2027733147
8584,7700282536,7230,7700289766,8,0,1,7680,8,4252945620
8585,7700318411,4679,7700323090,9,0,1,12288,9,2999542771
8586,7700380209,62516,7700442725,3,0,0,6144,3,2354575050
8587,7700408562,137015,7700545577,7,0,0,44032,7,7865396412
8588,7700416322,70071,7700486393,0,0,0,1024,0,8021070701
8589,7700604413,50672,7700655085,1,0,0,2560,1,7457884871
8590,7700611309,66690,7700677999,0,0,0,1024,0,4913632717
8591,7700679952,45596,7700725548,1,0,0,1024,1,9356052311
8592,7700787385,14545,7700801930,4,0,1,28160,4,3283541525
8593,7700794985,104808,7700899793,8,0,0,35840,8,5850078661
8594,7700804635,1994,7700806629,8,0,1,2048,8,6588238527
8595,7700860448,52324,7700912772,4,0,0,512,4,5546322582
8596,7700906036,5802,7700911838,3,0,1,6144,3,6890777892
8597,7700948119,91772,7701039891,9,0,0,21504,9,415254308
8598,7701007931,43904,7701051835,6,0,0,512,6,1970517155
8599,7701012033,11016,7701023049,5,0,1,17920,5,2344325773
8600,7701096477,45596,7701142073,0,0,0,1024,0,230781468
8601,7701109810,1518,7701111328,9,0,1,1536,9,7381915380
8602,7701152000,128996,7701280996,2,0,0,34816,2,2073206012
8603,7701156225,114140,7701270365,8,0,0,74752,8,3760732002
8604,7701248495,146535,7701395030,4,0,1,185344,4,9832659302
8605,7701271844,233901,7701505745,8,0,0,8192,8,8199362438
8606,7701315386,79990,7701395376,2,0,1,512,2,8062635856
8607,7701507720,51951,7701559671,3,0,0,2048,3,7507200591
8608,7701518133,84078,7701602211,2,0,0,512,2,5090361955
8609,7701587446,3904,7701591350,1,0,1,10752,1,10488950773
8610,7701612778,159207,7701771985,6,0,0,1024,6,5201542416
8611,7701712484,3898,7701716382,1,0,1,4096,1,2176239362
8612,7701742524,47288,7701789812,2,0,0,1536,2,9310305156
8613,7701843832,43904,7701887736,0,0,0,512,0,3717749187
8614,7701954428,1994,7701956422,8,0,1,2048,8,9522998860
8615,7701963389,1518,7701964907,5,0,1,1536,5,9972158711
8616,7702010948,76846,7702087794,3,0,1,129536,3,9546054119
8617,7702256702,4420,7702261122,8,0,1,11776,8,2356779421
8618,7702284836,73829,7702358665,4,0,0,512,4,6233567329
8619,7702316190,5326,7702321516,0,0,1,5632,0,3469046704
8620,7702329104,43904,7702373008,2,0,0,512,2,7231001816
8621,7702366293,45596,7702411889,2,0,0,1024,2,4173458056
8622,7702367698,178711,7702546409,7,0,0,20480,7,9706580995
8623,7702374575,104656,7702479231,0,0,0,1024,0,7397339548
8624,7702403514,53841,7702457355,5,0,1,88064,5,9045337583
8625,7702472580,177062,7702649642,5,0,1,291328,5,9052437628
8626,7702514487,145358,7702659845,4,0,0,2048,4,9762835936
8627,7702619203,193634,7702812837,9,0,0,34816,9,994199817
8628,7702755537,62149,7702817686,9,0,0,9216,9,6808815731
8629,7703225971,110396,7703336367,7,0,0,62464,7,6903325757
8630,7703257993,566,7703258559,1,0,1,512,1,3423417410
8631,7703291339,76456,7703367795,2,0,0,2048,2,5886630356
8632,7703376261,566,7703376827,2,0,1,512,2,2720874801
8633,7703452934,97448,7703550382,7,0,0,19968,7,7804566682
8634,7703482966,67743,7703550709,1,0,0,1024,1,186736202
8635,7703574822,55748,7703630570,4,0,0,4096,4,8460378146
8636,7703590188,25446,7703615634,5,0,1,46080,5,112834693
8637,7703651171,2470,7703653641,9,0,1,2560,9,6824342898
8638,7703655875,68500,7703724375,6,0,0,1024,6,5493137403
8639,7703661590,41649,7703703239,5,0,1,67584,5,6931822803
8640,7703786689,55126,7703841815,6,0,0,512,6,8788336064
8641,7703873216,45696,7703918912,4,0,1,78848,4,1506384394
8642,7703885482,36976,7703922458,8,0,1,5632,8,2646298378
8643,7703908814,16870,7703925684,1,0,1,5120,1,10133424502
8644,7703918505,8485,7703926990,0,0,1,2048,0,9257939240
8645,7704018118,52676,7704070794,8,0,0,4096,8,6032170555
8646,7704028083,48980,7704077063,0,0,0,2048,0,10003005761
8647,7704063366,47288,7704110654,7,0,0,1536,7,1228826937
8648,7704066569,104936,7704171505,3,0,0,44544,3,10311710362
8649,7704107792,73679,7704181471,0,0,0,512,0,7297363823
8650,7704164771,50630,7704215401,0,0,0,512,0,9918307819
8651,7704328702,43904,7704372606,0,0,0,512,0,4503639105
8652,7704567323,77900,7704645223,3,0,0,11264,3,1390751103
8653,7704638094,10241,7704648335,1,0,1,16384,1,8448705709
8654,7704644561,44558,7704689119,4,0,0,512,4,8880233855
8655,7704684213,45596,7704729809,2,0,0,1024,2,7398987399
8656,7704746774,113048,7704859822,9,0,0,71168,9,8958848220
8657,7704785529,1042,7704786571,8,0,1,1024,8,3269894438
8658,7704796098,89272,7704885370,4,0,0,1536,4,1891201530
8659,7704839393,66017,7704905410,2,0,0,1024,2,7344172362
8660,7704870656,45596,7704916252,0,0,0,1024,0,6758701911
8661,7704892672,6278,7704898950,2,0,1,6656,2,10556597187
8662,7704990701,1042,7704991743,1,0,1,1024,1,8103096712
8663,7705073165,45596,7705118761,0,0,0,1024,0,1891614361
8664,7705090884,69284,7705160168,7,0,0,8192,7,6447636291
8665,7705176739,566,7705177305,1,0,1,512,1,7041017068
8666,7705185358,1518,7705186876,1,0,1,1536,1,8677678351
8667,7705244992,4850,7705249842,8,0,1,5120,8,5060250657
8668,7705408243,6488,7705414731,0,0,1,15872,0,1585186832
8669,7705531842,6754,7705538596,8,0,1,7168,8,9120973013
8670,7705651078,45596,7705696674,2,0,0,1024,2,1915241295
8671,7705834117,23466,7705857583,3,0,1,38912,3,3743094925
8672,7705907543,77389,7705984932,8,0,0,7680,8,10654123783
8673,7705994564,1042,7705995606,2,0,1,1024,2,3982113911
8674,7706041003,45596,7706086599,6,0,0,1024,6,8606390979
8675,7706056984,1042,7706058026,9,0,1,1024,9,5561233908
8676,7706124032,3422,7706127454,1,0,1,3584,1,391087106
8677,7706135946,52364,7706188310,9,0,0,3072,9,3961276853
8678,7706229908,3898,7706233806,8,0,1,4096,8,8363012146
8679,7706376406,21658,7706398064,3,0,1,35328,3,4455389032
8680,7706380929,23651,7706404580,0,0,1,23040,0,9587828123
8681,7706418975,50672,7706469647,2,0,0,2560,2,6298838487
8682,7706420379,5326,7706425705,3,0,1,5632,3,4028103203
8683,7706480250,198380,7706678630,3,0,0,88064,3,5777563087
8684,7706516131,77485,7706593616,4,0,0,512,4,10630573130
8685,7706518669,20366,7706539035,8,0,1,32768,8,4184318865
8686,7706526002,90996,7706616998,4,0,0,512,4,6832584607
8687,7706580029,98928,7706678957,2,0,0,1024,2,10442337335
8688,7706710402,45596,7706755998,0,0,0,1024,0,1386300790
8689,7706782823,6229,7706789052,2,0,1,15360,2,8370452540
8690,7706994051,3128,7706997179,0,0,1,9216,0,10630127660
8691,7707096093,50672,7707146765,3,0,0,2560,3,4887827316
8692,7707159003,52364,7707211367,3,0,0,3072,3,2455038265
8693,7707201762,45596,7707247358,2,0,0,1024,2,9133639521
8694,7707242382,43904,7707286286,9,0,0,512,9,5721918056
8695,7707291183,2946,7707294129,2,0,1,3072,2,8010202423
8696,7707305214,45596,7707350810,0,0,0,1024,0,6583100970
8697,7707344220,43904,7707388124,1,0,0,512,1,7211070636
8698,7707346559,23120,7707369679,4,0,1,41472,4,9238130154
8699,7707350110,53046,7707403156,2,0,0,512,2,4682634863
8700,7707352587,18078,7707370665,1,0,1,1536,1,4925492311
8701,7707366179,45596,7707411775,7,0,0,1024,7,9313136780
8702,7707371893,67527,7707439420,0,0,0,2560,0,8392248549
8703,7707402586,1994,7707404580,2,0,1,2048,2,7804986024
8704,7707416398,50672,7707467070,7,0,0,2560,7,9340474769
8705,7707417772,52364,7707470136,6,0,0,3072,6,8448820528
8706,7707480651,12049,7707492700,5,0,1,19968,5,4453146693
8707,7707580402,45596,7707625998,7,0,0,1024,7,10536734251
8708,7707675790,52364,7707728154,8,0,0,3072,8,2475128882
8709,7707750845,43904,7707794749,4,0,0,512,4,7127108124
8710,7707818040,119912,7707937952,8,0,0,93696,8,7267228599
8711,7707921346,118258,7708039604,8,0,0,33792,8,3890443722
8712,7707944371,14545,7707958916,4,0,1,28160,4,7239249022
8713,7707969374,70713,7708040087,2,0,0,1536,2,1130757215
8714,7708002962,43904,7708046866,6,0,0,512,6,5534730333
8715,7708014675,45596,7708060271,3,0,0,1024,3,8600051942
8716,7708051074,6754,7708057828,9,0,1,7168,9,585694983
8717,7708059329,49634,7708108963,2,0,0,512,2,8760867791
8718,7708070593,85341,7708155934,2,0,0,512,2,5767276434
8719,7708078232,1994,7708080226,8,0,1,2048,8,2855161281
8720,7708109975,47288,7708157263,7,0,0,1536,7,10674289960
8721,7708210535,1518,7708212053,9,0,1,1536,9,9519676021
8722,7708271233,48980,7708320213,2,0,0,2048,2,10241158238
8723,7708345272,5326,7708350598,2,0,1,5632,2,599071570
8724,7708400437,48980,7708449417,2,0,0,2048,2,4362910471
8725,7708447151,1518,7708448669,9,0,1,1536,9,966586766
8726,7708574661,4420,7708579081,2,0,1,11776,2,2600915495
8727,7708610378,47288,7708657666,1,0,0,1536,1,1723191161
8728,7708676989,50672,7708727661,1,0,0,2560,1,1317296463
8729,7708736687,1042,7708737729,2,0,1,1024,2,7034079714
8730,7708739791,11533,7708751324,4,0,1,18944,4,10173035832
8731,7708895901,3422,7708899323,8,0,1,3584,8,7639917438
8732,7708962929,45596,7709008525,7,0,0,1024,7,6492080675
8733,7709022448,104468,7709126916,8,0,0,43008,8,2828472942
8734,7709061481,74333,7709135814,7,0,0,512,7,4927777680
8735,7709182776,5454,7709188230,4,0,1,13824,4,3447673805
8736,7709226094,43904,7709269998,6,0,0,512,6,3485158825
8737,7709266256,4162,7709270418,9,0,1,11264,9,10431472896
8738,7709325624,16096,7709341720,5,0,1,31232,5,8185539025
8739,7709503007,48980,7709551987,7,0,0,2048,7,193385554
8740,7709525175,566,7709525741,0,0,1,512,0,3284200245
8741,7709684255,45596,7709729851,2,0,0,1024,2,8335713365
8742,7709823632,86672,7709910304,8,0,0,14848,8,1853198365
8743,7709877409,4850,7709882259,9,0,1,5120,9,908086075
8744,7709945894,34795,7709980689,5,0,1,60928,5,9241946145
8745,7710098638,47288,7710145926,2,0,0,1536,2,4656543589
8746,7710115283,52177,7710167460,0,0,0,512,0,2686394977
8747,7710149065,54056,7710203121,8,0,0,3584,8,7387926401
8748,7710180902,47288,7710228190,9,0,0,1536,9,6064708982
8749,7710268251,43904,7710312155,6,0,0,512,6,2785304311
8750,7710478131,48980,7710527111,7,0,0,2048,7,1968226260
8751,7710517367,166832,7710684199,3,0,0,141824,3,7825484130
8752,7710595364,89006,7710684370,4,0,0,512,4,726775456
8753,7710634668,566,7710635234,0,0,1,512,0,3086784871
8754,7710755466,2470,7710757936,3,0,1,2560,3,4093675795
8755,7710765284,45596,7710810880,4,0,0,1024,4,4037691951
8756,7710835953,43904,7710879857,9,0,0,512,9,6605169909
8757,7710836871,2946,7710839817,0,0,1,3072,0,69444625
8758,7710866476,73604,7710940080,3,0,0,12288,3,2187252889
8759,7710928437,43904,7710972341,1,0,0,512,1,6213123822
8760,7711137383,117884,7711255267,8,0,0,87040,8,3202483542
8761,7711140427,43904,7711184331,1,0,0,512,1,452020736
8762,7711217688,54907,7711272595,9,0,0,512,9,10498795947
8763,7711308194,43904,7711352098,9,0,0,512,9,3477785218
8764,7711387958,2946,7711390904,9,0,1,3072,9,494494778
8765,7711393363,43904,7711437267,8,0,0,512,8,6550078392
8766,7711423394,60824,7711484218,7,0,0,5632,7,10301130720
8767,7711641241,43904,7711685145,9,0,0,512,9,3982952388
8768,7711646553,72024,7711718577,5,0,1,116736,5,8194893635
8769,7711659728,60334,7711720062,4,0,1,15360,4,4777926412
8770,7711904821,45596,7711950417,1,0,0,1024,1,1857732264
8771,7712050495,13083,7712063578,3,0,1,22016,3,1583556105
8772,7712105703,1994,7712107697,5,0,1,2048,5,3000098060
8773,7712331749,45596,7712377345,0,0,0,1024,0,5679712267
8774,7712369109,566,7712369675,2,0,1,512,2,2170400736
8775,7712462686,48980,7712511666,0,0,0,2048,0,9295961420
8776,7712519550,6488,7712526038,1,0,1,15872,1,7754667677
8777,7712567004,43904,7712610908,0,0,0,512,0,5965960965
8778,7712637788,4850,7712642638,2,0,1,5120,2,6278993773
8779,7712639562,7262,7712646824,1,0,1,6656,1,8696770498
8780,7712648035,111666,7712759701,3,0,0,43520,3,7605883981
8781,7712697933,2470,7712700403,2,0,1,2560,2,3719093130
8782,7712763024,43904,7712806928,1,0,0,512,1,7777148503
8783,7712791825,108680,7712900505,3,0,0,56832,3,3333475278
8784,7712797416,2470,7712799886,8,0,1,2560,8,935933437
8785,7712823019,43904,7712866923,4,0,0,512,4,5062551174
8786,7712918886,5802,7712924688,9,0,1,6144,9,1592587407
8787,7712964468,43904,7713008372,4,0,0,512,4,9191051260
8788,7713044195,50672,7713094867,7,0,0,2560,7,6619513479
8789,7713073536,2470,7713076006,8,0,1,2560,8,6775152196
8790,7713422320,58532,7713480852,3,0,0,8192,3,9314199699
8791,7713472483,45596,7713518079,6,0,0,1024,6,2919456426
8792,7713562112,47288,7713609400,0,0,0,1536,0,5156040548
8793,7713601578,1518,7713603096,4,0,1,1536,4,5288242950
8794,7713646506,116673,7713763179,3,0,0,25600,3,5535003344
8795,7713738964,6278,7713745242,5,0,1,6656,5,2350342795
8796,7713799470,566,7713800036,1,0,1,512,1,5839308436
8797,7713811088,97760,7713908848,4,0,0,20992,4,1814780727
8798,7713950829,45596,7713996425,9,0,0,1024,9,5143167255
8799,7714143412,74696,7714218108,8,0,0,15872,8,4314908625
8800,7714146587,4850,7714151437,4,0,1,5120,4,3511776050
8801,7714255525,45596,7714301121,1,0,0,1024,1,1857735077
8802,7714291815,6278,7714298093,5,0,1,6656,5,2210946542
8803,7714342975,102752,7714445727,4,0,0,37376,4,1375908309
8804,7714453784,43904,7714497688,7,0,0,512,7,6561178405
8805,7714469907,91928,7714561835,3,0,0,22016,3,9535863392
8806,7714551122,3904,7714555026,1,0,1,10752,1,1575162680
8807,7714564152,6278,7714570430,0,0,1,6656,0,4850953531
8808,7714596050,43904,7714639954,9,0,0,512,9,601350754
8809,7714637386,101972,7714739358,4,0,0,34816,4,4697483803
8810,7714664821,160067,7714824888,3,0,0,87552,3,9988660989
8811,7714666736,3898,7714670634,9,0,1,4096,9,4707807075
8812,7714804619,32069,7714836688,5,0,1,19456,5,3044116881
8813,7714818367,52134,7714870501,1,0,0,1024,1,8056013248
8814,7714920420,97472,7715017892,8,0,0,25088,8,171578798
8815,7715142755,5454,7715148209,4,0,1,13824,4,5389898039
8816,7715175982,45596,7715221578,0,0,0,1024,0,493419686
8817,7715192831,48980,7715241811,1,0,0,2048,1,3978971121
8818,7715203932,121940,7715325872,8,0,0,100352,8,6111509254
8819,7715246830,5802,7715252632,8,0,1,6144,8,6577989637
8820,7715260524,102152,7715362676,8,0,0,7168,8,6005997757
8821,7715282865,101231,7715384096,3,0,0,22016,3,2821024526
8822,7715442038,24929,7715466967,3,0,1,45056,3,802548754
8823,7715579002,45596,7715624598,0,0,0,1024,0,2424903141
8824,7715623017,2470,7715625487,0,0,1,2560,0,3582874013
8825,7715754562,78704,7715833266,3,0,0,18944,3,8746504264
8826,7715843977,43904,7715887881,9,0,0,512,9,7798972513
8827,7715909384,5454,7715914838,5,0,1,13824,5,3714108276
8828,7715983609,3387,7715986996,1,0,1,9728,1,7752177984
8829,7715999221,109589,7716108810,8,0,0,19456,8,6360768353
8830,7716043829,15062,7716058891,1,0,1,29184,1,9230020694
8831,7716189378,59249,7716248627,2,0,0,512,2,7617046335
8832,7716294485,5326,7716299811,2,0,1,5632,2,560200898
8833,7716311555,6754,7716318309,0,0,1,7168,0,29935771
8834,7716315647,56189,7716371836,2,0,0,512,2,1569601199
8835,7716328884,150332,7716479216,6,0,0,512,6,9224260092
8836,7716421237,43904,7716465141,2,0,0,512,2,1991215163
8837,7716446783,7706,7716454489,1,0,1,8192,1,6828110367
8838,7716482081,137739,7716619820,1,0,0,1024,1,9891765042
8839,7716648165,1518,7716649683,2,0,1,1536,2,762718625
8840,7716741624,43904,7716785528,0,0,0,512,0,5397375100
8841,7716766550,10241,7716776791,2,0,1,16384,2,5252745830
8842,7716796508,43904,7716840412,6,0,0,512,6,2864352953
8843,7716813587,87452,7716901039,4,0,0,17408,4,2339071511
8844,7716836810,4850,7716841660,4,0,1,5120,4,2547153113
8845,7716880085,3422,7716883507,2,0,1,3584,2,8447752932
8846,7716886342,64742,7716951084,5,0,1,105984,5,2831872976
8847,7716893714,122041,7717015755,9,0,0,2560,9,3925948253
8848,7716935635,18035,7716953670,2,0,1,4096,2,761888056
8849,7716941139,177966,7717119105,3,0,0,20480,3,7409563356
8850,7717075174,97448,7717172622,8,0,0,19968,8,3761610488
8851,7717098401,3898,7717102299,4,0,1,4096,4,5644680276
8852,7717108625,53753,7717162378,5,0,1,91136,5,521956518
8853,7717119786,120093,7717239879,0,0,0,512,0,6121019583
8854,7717275427,5326,7717280753,4,0,1,5632,4,7069389745
8855,7717312501,45596,7717358097,0,0,0,1024,0,9010931442
8856,7717320343,2946,7717323289,2,0,1,3072,2,8870342403
8857,7717386531,51781,7717438312,0,0,0,512,0,6596030382
8858,7717419472,3645,7717423117,0,0,1,10240,0,9980902707
8859,7717461023,2946,7717463969,0,0,1,3072,0,6127946008
8860,7717481912,1994,7717483906,1,0,1,2048,1,1816476303
8861,7717485954,49804,7717535758,7,0,0,512,7,8197866859
8862,7717538117,1042,7717539159,1,0,1,1024,1,1752612843
8863,7717651259,45596,7717696855,9,0,0,1024,9,2866493928
8864,7717695067,55045,7717750112,5,0,1,93696,5,642728942
8865,7717725379,25706,7717751085,2,0,1,12800,2,3749283211
8866,7717794409,44477,7717838886,9,0,0,512,9,10551273111
8867,7717805676,6754,7717812430,8,0,1,7168,8,6321034615
8868,7717915431,50672,7717966103,0,0,0,2560,0,1742104282
8869,7717933219,156345,7718089564,3,0,0,8192,3,7061455769
8870,7717940187,47288,7717987475,7,0,0,1536,7,3441027687
8871,7718035831,54100,7718089931,5,0,1,88576,5,696242224
8872,7718049625,103703,7718153328,1,0,0,1024,1,790483674
8873,7718076218,231110,7718307328,4,0,0,52224,4,2400414148
8874,7718402233,47288,7718449521,7,0,0,1536,7,951912064
8875,7718477886,107120,7718585006,8,0,0,51712,8,5630163569
8876,7718480216,114264,7718594480,1,0,0,1024,1,7326149504
8877,7718504982,6488,7718511470,4,0,1,15872,4,7514837304
8878,7718521832,63345,7718585177,0,0,0,512,0,6198816096
8879,7718664981,1042,7718666023,1,0,1,1024,1,8847623251
8880,7718690205,44279,7718734484,6,0,0,512,6,1903861951
8881,7718692181,1042,7718693223,4,0,1,1024,4,7349681429
8882,7718765505,48980,7718814485,2,0,0,2048,2,1214890224
8883,7718826347,43904,7718870251,2,0,0,512,2,228687376
8884,7719069400,1042,7719070442,8,0,1,1024,8,10236905108
8885,7719118017,127828,7719245845,3,0,0,14336,3,10283995760
8886,7719149478,52877,7719202355,9,0,0,1024,9,404486887
8887,7719197748,48424,7719246172,1,0,0,1024,1,1214996387
8888,7719237931,43904,7719281835,9,0,0,512,9,4880480911
8889,7719306785,104000,7719410785,8,0,0,41472,8,7546852665
8890,7719429729,43975,7719473704,3,0,1,72192,3,4465821766
8891,7719601332,105248,7719706580,3,0,0,45568,3,6187075594
8892,7719645773,4679,7719650452,8,0,1,12288,8,2621578260
8893,7719705482,1656,7719707138,9,0,1,512,9,2394656695
8894,7719726264,104000,7719830264,8,0,0,41472,8,6115712927
8895,7719758880,79238,7719838118,8,0,0,5632,8,8806485230
8896,7719783806,46988,7719830794,3,0,1,81408,3,10725898294
8897,7719861531,104914,7719966445,7,0,0,512,7,3533629502
8898,7719888771,43904,7719932675,1,0,0,512,1,4901004837
8899,7720076328,52364,7720128692,0,0,0,3072,0,2081385131
8900,7720145874,45596,7720191470,0,0,0,1024,0,2445528771
8901,7720155802,127594,7720283396,3,0,0,74752,3,7553289327
8902,7720271984,14367,7720286351,4,0,1,3072,4,10141695656
8903,7720276254,11723,7720287977,4,0,1,2560,4,8019436039
8904,7720293455,24412,7720317867,3,0,1,44032,3,2034929338
8905,7720301201,51315,7720352516,0,0,0,1024,0,2595125917
8906,7720397216,6754,7720403970,9,0,1,7168,9,7199691040
8907,7720434648,118867,7720553515,3,0,0,62464,3,9217121132
8908,7720467564,51257,7720518821,3,0,1,82944,3,3017154365
8909,7720528127,25403,7720553530,1,0,1,7168,1,4587069048
8910,7720577615,108453,7720686068,3,0,0,35328,3,9529962295
8911,7720583319,43904,7720627223,2,0,0,512,2,257498849
8912,7720634487,56493,7720690980,9,0,0,512,9,148489361
8913,7720636755,167712,7720804467,5,0,1,276480,5,5516278993
8914,7720642502,233275,7720875777,3,0,0,4096,3,9457347847
8915,7720687756,255737,7720943493,3,0,0,65024,3,378359287
8916,7720691780,257656,7720949436,8,0,0,19456,8,10120336691
8917,7720794570,15286,7720809856,0,0,1,17408,0,4104317404
8918,7720856214,24154,7720880368,5,0,1,43520,5,4221184006
8919,7720864865,19689,7720884554,8,0,1,6656,8,2844460021
8920,7720889912,167316,7721057228,9,0,0,512,9,10632041520
8921,7720980276,20882,7721001158,8,0,1,33792,8,7401699191
8922,7721003413,3422,7721006835,3,0,1,3584,3,2458098467
8923,7721115479,65758,7721181237,9,0,0,1536,9,8227681458
8924,7721276569,566,7721277135,9,0,1,512,9,3390283606
8925,7721285053,43904,7721328957,0,0,0,512,0,10722208893
8926,7721350865,13512,7721364377,3,0,1,26112,3,8368990277
8927,7721354126,278280,7721632406,8,0,0,127488,8,2472245492
8928,7721644206,566,7721644772,8,0,1,512,8,10282457875
8929,7721705379,45596,7721750975,2,0,0,1024,2,7748725290
8930,7721861909,6229,7721868138,0,0,1,15360,0,7799522411
8931,7722012671,4374,7722017045,8,0,1,4608,8,4942758342
8932,7722018574,73916,7722092490,4,0,0,13312,4,9076107476
8933,7722033891,47288,7722081179,6,0,0,1536,6,1734563184
8934,7722043404,143820,7722187224,8,0,0,96256,8,7382451156
8935,7722070643,123195,7722193838,4,0,0,11264,4,1373698344
8936,7722183345,10508,7722193853,5,0,1,4096,5,3393182785
8937,7722248871,5712,7722254583,2,0,1,14336,2,528030792
8938,7722304944,154662,7722459606,7,0,0,1536,7,1916969024
8939,7722315666,47288,7722362954,2,0,0,1536,2,6615369903
8940,7722349411,4162,7722353573,4,0,1,11264,4,2554856865
8941,7722456459,43904,7722500363,9,0,0,512,9,7187844513
8942,7722522051,45596,7722567647,1,0,0,1024,1,3728482932
8943,7722703340,2470,7722705810,4,0,1,2560,4,8125269356
8944,7722738737,115076,7722853813,3,0,0,77824,3,1455504950
8945,7722747226,43904,7722791130,6,0,0,512,6,2564237557
8946,7722789732,1042,7722790774,2,0,1,1024,2,1255991778
8947,7722840405,16346,7722856751,8,0,1,3072,8,3741464935
8948,7722914526,48980,7722963506,0,0,0,2048,0,8199745771
8949,7722924922,43904,7722968826,9,0,0,512,9,6527920596
8950,7723104245,103844,7723208089,3,0,0,40960,3,4767695945
8951,7723128305,3387,7723131692,2,0,1,9728,2,478666195
8952,7723145207,43904,7723189111,9,0,0,512,9,10556786690
8953,7723168041,43904,7723211945,0,0,0,512,0,1349067151
8954,7723223484,117416,7723340900,8,0,0,85504,8,9423559761
8955,7723301445,566,7723302011,4,0,1,512,4,9017033152
8956,7723321956,62840,7723384796,7,0,0,512,7,5333152086
8957,7723382950,45596,7723428546,6,0,0,1024,6,9370437724
8958,7723420613,96692,7723517305,3,0,0,22528,3,6972210160
8959,7723558050,54056,7723612106,6,0,0,3584,6,1977842950
8960,7723617746,3422,7723621168,4,0,1,3584,4,10449807922
8961,7723703328,48980,7723752308,6,0,0,2048,6,4383826934
8962,7723850512,112580,7723963092,3,0,0,69632,3,4330873606
8963,7723877808,123902,7724001710,7,0,0,1536,7,357231076
8964,7723912549,4420,7723916969,9,0,1,11776,9,10234521919
8965,7723917419,14029,7723931448,8,0,1,27136,8,7619662580
8966,7723926380,59344,7723985724,1,0,0,512,1,1351773883
8967,7723939581,23526,7723963107,2,0,1,7168,2,7534844887
8968,7724060580,43904,7724104484,2,0,0,512,2,3920973590
8969,7724063335,178939,7724242274,8,0,0,105984,8,7722133086
8970,7724087463,12825,7724100288,4,0,1,21504,4,5192007937
8971,7724265803,1042,7724266845,4,0,1,1024,4,2972310560
8972,7724273255,5326,7724278581,4,0,1,5632,4,6751995390
8973,7724286282,4374,7724290656,0,0,1,4608,0,8494930594
8974,7724306186,566,7724306752,9,0,1,512,9,9430184730
8975,7724318618,5326,7724323944,0,0,1,5632,0,10144401549
8976,7724340605,1518,7724342123,9,0,1,1536,9,8858982383
8977,7724382864,25962,7724408826,3,0,1,47104,3,7072957374
8978,7724577678,43904,7724621582,6,0,0,512,6,744236307
8979,7724579612,43904,7724623516,7,0,0,512,7,1610790862
8980,7724608588,47288,7724655876,0,0,0,1536,0,8538589516
8981,7724804770,48980,7724853750,7,0,0,2048,7,5151000044
8982,7724806037,45596,7724851633,7,0,0,1024,7,365700441
8983,7724874674,3645,7724878319,9,0,1,10240,9,5647630853
8984,7724876007,176780,7725052787,2,0,0,512,2,5700767238
8985,7724879849,43904,7724923753,7,0,0,512,7,105902117
8986,7725160989,98072,7725259061,4,0,0,22016,4,3777114173
8987,7725261067,43904,7725304971,0,0,0,512,0,1675139836
8988,7725283419,43904,7725327323,1,0,0,512,1,10110815845
8989,7725291913,43904,7725335817,6,0,0,512,6,8016102937
8990,7725309408,106496,7725415904,4,0,0,49664,4,5110133845
8991,7725331290,93176,7725424466,9,0,0,1024,9,3720054881
8992,7725377253,1042,7725378295,9,0,1,1024,9,2687941096
8993,7725402103,89869,7725491972,3,0,0,15360,3,7062731378
8994,7725572855,1518,7725574373,2,0,1,1536,2,5081994143
8995,7725742532,47288,7725789820,2,0,0,1536,2,6353989464
8996,7725807823,93488,7725901311,4,0,0,27136,4,8537345379
8997,7725809456,96558,7725906014,8,0,0,15360,8,6331088639
8998,7725822415,3645,7725826060,9,0,1,10240,9,9546677634
8999,7725827231,4850,7725832081,4,0,1,5120,4,7151109338
9000,7725877274,103762,7725981036,3,0,0,13312,3,10115587157
9001,7725894716,50491,7725945207,7,0,0,512,7,3276344895
9002,7725955190,3904,7725959094,4,0,1,10752,4,9088593097
9003,7725976589,131321,7726107910,3,0,0,99840,3,3464809668
9004,7725993480,11016,7726004496,4,0,1,17920,4,3523410187
9005,7726157683,43904,7726201587,2,0,0,512,2,3466446407
9006,7726198875,47288,7726246163,1,0,0,1536,1,2707100476
9007,7726289471,62516,7726351987,4,0,0,6144,4,3139856934
9008,7726353833,47288,7726401121,9,0,0,1536,9,10588814246
9009,7726360946,1518,7726362464,2,0,1,1536,2,3773860713
9010,7726456715,63450,7726520165,5,0,1,103424,5,4022799612
9011,7726466170,55301,7726521471,4,0,1,2048,4,8400581320
9012,7726597362,77469,7726674831,6,0,0,1024,6,4465541096
9013,7726598635,5802,7726604437,1,0,1,6144,1,4143381930
9014,7726602302,43904,7726646206,1,0,0,512,1,6191055801
9015,7726661953,43904,7726705857,0,0,0,512,0,5887475894
9016,7726740245,13341,7726753586,3,0,1,22528,3,209759310
9017,7726765904,566,7726766470,9,0,1,512,9,5403436186
9018,7726790455,57189,7726847644,2,0,0,2560,2,4161699774
9019,7726849922,2946,7726852868,1,0,1,3072,1,1657981783
9020,7726947273,2870,7726950143,8,0,1,8704,8,3279430180
9021,7727014751,566,7727015317,0,0,1,512,0,701873293
9022,7727032783,12995,7727045778,3,0,1,25088,3,3620581131
9023,7727097206,2470,7727099676,9,0,1,2560,9,3163757083
9024,7727133209,132251,7727265460,8,0,0,58880,8,7810697376
9025,7727135233,165198,7727300431,3,0,0,20992,3,8945833429
9026,7727293619,104000,7727397619,3,0,0,41472,3,2477194515
9027,7727320057,77733,7727397790,6,0,0,512,6,8508972032
9028,7727381648,43458,7727425106,3,0,1,71168,3,1106809778
9029,7727599451,1042,7727600493,2,0,1,1024,2,10036225589
9030,7727642638,47288,7727689926,9,0,0,1536,9,8478454905
9031,7727764885,3422,7727768307,0,0,1,3584,0,10292203941
9032,7727784635,142698,7727927333,2,0,0,1536,2,4726479543
9033,7727787149,98622,7727885771,4,0,0,26624,4,1686991201
9034,7727892438,4374,7727896812,1,0,1,4608,1,4585952665
9035,7727982855,4850,7727987705,9,0,1,5120,9,2115993371
9036,7728044651,43904,7728088555,2,0,0,512,2,3995216732
9037,7728129701,21658,7728151359,3,0,1,35328,3,2391520741
9038,7728175346,3128,7728178474,0,0,1,9216,0,9419539815
9039,7728191077,50672,7728241749,1,0,0,2560,1,277961353
9040,7728203371,31524,7728234895,3,0,1,51200,3,10357844350
9041,7728215909,23172,7728239081,8,0,1,6656,8,7745003519
9042,7728236279,147721,7728384000,3,0,1,244224,3,7672175671
9043,7728251323,133663,7728384986,2,0,1,1536,2,2843040787
9044,7728259332,128240,7728387572,1,0,1,4096,1,10593352722
9045,7728391539,33245,7728424784,3,0,1,57856,3,7392405569
9046,7728443091,128525,7728571616,2,0,0,2048,2,9726359142
9047,7728448448,1042,7728449490,9,0,1,1024,9,6623988256
9048,7728450275,178900,7728629175,4,0,0,20480,4,8616402772
9049,7728453573,6278,7728459851,0,0,1,6656,0,6264297193
9050,7728458280,2877,7728461157,4,0,1,2048,4,4077320441
9051,7728575569,100423,7728675992,0,0,0,1024,0,9474996009
9052,7728722915,43904,7728766819,7,0,0,512,7,874075087
9053,7728749435,45015,7728794450,6,0,0,512,6,3587208817
9054,7728807347,43904,7728851251,6,0,0,512,6,4615650143
9055,7728814656,70976,7728885632,3,0,0,8704,3,2227066636
9056,7729038735,43904,7729082639,0,0,0,512,0,3052004422
9057,7729122136,3904,7729126040,5,0,1,10752,5,1417786875
9058,7729133636,2946,7729136582,8,0,1,3072,8,10318409427
9059,7729387119,112112,7729499231,8,0,0,68096,8,9753921401
9060,7729458365,3387,7729461752,1,0,1,9728,1,5805100650
9061,7729490442,15059,7729505501,1,0,1,6656,1,9756915405
9062,7729505849,11791,7729517640,1,0,1,19456,1,7363138894
9063,7729509171,18751,7729527922,3,0,1,31232,3,4134543991
9064,7729588073,77419,7729665492,2,0,0,512,2,10658485190
9065,7729670251,1518,7729671769,9,0,1,1536,9,9118338644
9066,7729682354,45596,7729727950,9,0,0,1024,9,305734608
9067,7729850425,43904,7729894329,6,0,0,512,6,7013746997
9068,7729872902,5326,7729878228,2,0,1,5632,2,771834034
9069,7730082048,4162,7730086210,1,0,1,11264,1,2800586597
9070,7730086934,4374,7730091308,1,0,1,4608,1,7890373105
9071,7730116977,22950,7730139927,3,0,1,37888,3,9799853377
9072,7730181253,4937,7730186190,8,0,1,12800,8,6196031013
9073,7730340196,566,7730340762,2,0,1,512,2,8919792918
9074,7730555802,48980,7730604782,0,0,0,2048,0,3349076583
9075,7730571299,97096,7730668395,5,0,1,162304,5,8372691049
9076,7730584719,349326,7730934045,8,0,0,157696,8,2111396073
9077,7730631759,39222,7730670981,4,0,1,4096,4,6512407669
9078,7730726604,293252,7731019856,4,0,0,36864,4,10483154278
9079,7730733107,62158,7730795265,5,0,1,100864,5,2038018037
9080,7730740640,345750,7731086390,2,0,0,2048,2,7380635290
9081,7730758584,186092,7730944676,3,0,0,34816,3,5218023758
9082,7730788233,277967,7731066200,8,0,0,27648,8,863631740
9083,7730874793,133290,7731008083,6,0,0,2560,6,7326636146
9084,7730888414,141946,7731030360,7,0,0,512,7,7457029910
9085,7730928116,241970,7731170086,4,0,0,61440,4,8314073407
9086,7730942108,5455,7730947563,0,0,1,8704,0,2679856697
9087,7730950246,13083,7730963329,5,0,1,22016,5,5500401006
9088,7730982420,53583,7731036003,3,0,1,87552,3,2306778665
9089,7730982826,132310,7731115136,3,0,0,17920,3,9578851485
9090,7731060299,202322,7731262621,1,0,0,1024,1,10467486840
9091,7731258364,106808,7731365172,8,0,0,50688,8,8108538410
9092,7731361318,49442,7731410760,6,0,0,1024,6,2361531677
9093,7731481566,2870,7731484436,2,0,1,8704,2,6717270235
9094,7731666390,115856,7731782246,4,0,0,80384,4,8840587838
9095,7731852377,5802,7731858179,9,0,1,6144,9,1343876967
9096,7732015627,47288,7732062915,8,0,0,1536,8,3893477032
9097,7732108331,43904,7732152235,9,0,0,512,9,9528773676
9098,7732181052,43904,7732224956,7,0,0,512,7,4692111205
9099,7732187134,4850,7732191984,9,0,1,5120,9,4026666556
9100,7732194834,99320,7732294154,3,0,0,26112,3,5165575504
9101,7732210666,45596,7732256262,2,0,0,1024,2,3559348678
9102,7732468456,566,7732469022,2,0,1,512,2,8406463649
9103,7732566924,45596,7732612520,1,0,0,1024,1,6200651981
9104,7732757613,43904,7732801517,0,0,0,512,0,7465153436
9105,7732796292,2470,7732798762,0,0,1,2560,0,3327998145
9106,7732949216,43904,7732993120,6,0,0,512,6,1900320437
9107,7733086185,1518,7733087703,1,0,1,1536,1,9494891238
9108,7733142621,7230,7733149851,9,0,1,7680,9,6285751120
9109,7733201552,566,7733202118,8,0,1,512,8,7803662012
9110,7733214590,47288,7733261878,0,0,0,1536,0,3632830132
9111,7733286469,5802,7733292271,9,0,1,6144,9,1264724895
9112,7733305195,45596,7733350791,6,0,0,1024,6,8049420
9113,7733309463,45596,7733355059,2,0,0,1024,2,1031871995
9114,7733427588,97760,7733525348,3,0,0,20992,3,1825514303
9115,7733437336,129772,7733567108,8,0,0,82432,8,9782960206
9116,7733466771,111003,7733577774,8,0,0,8704,8,3235170243
9117,7733487919,5326,7733493245,0,0,1,5632,0,10702977131
9118,7733498464,4374,7733502838,0,0,1,4608,0,10325405575
9119,7733601067,45596,7733646663,0,0,0,1024,0,9344673956
9120,7733668005,43904,7733711909,9,0,0,512,9,4370414408
9121,7733697549,48980,7733746529,7,0,0,2048,7,1477929544
9122,7733711761,6894,7733718655,2,0,1,7168,2,3075512833
9123,7733753462,1042,7733754504,1,0,1,1024,1,3398820355
9124,7733754072,86096,7733840168,1,0,0,23040,1,6958217480
9125,7733796024,79592,7733875616,1,0,0,11776,1,4245224157
9126,7733836773,9099,7733845872,8,0,1,14336,8,8167572109
9127,7733918967,6754,7733925721,4,0,1,7168,4,710857255
9128,7734031765,45596,7734077361,2,0,0,1024,2,3269433045
9129,7734115668,110708,7734226376,4,0,0,63488,4,3177888144
9130,7734256505,7706,7734264211,8,0,1,8192,8,3903567670
9131,7734320234,77744,7734397978,1,0,0,10752,1,705061606
9132,7734327233,109460,7734436693,4,0,0,59392,4,5956623694
9133,7734499123,3898,7734503021,4,0,1,4096,4,6260431228
9134,7734685024,69308,7734754332,3,0,0,13312,3,7646881422
9135,7734863906,1042,7734864948,4,0,1,1024,4,3066354327
9136,7734867733,45596,7734913329,2,0,0,1024,2,2456596791
9137,7734908252,2470,7734910722,9,0,1,2560,9,3159992389
9138,7734937197,5326,7734942523,8,0,1,5632,8,7287492090
9139,7734940508,43904,7734984412,6,0,0,512,6,6961955493
9140,7735061953,12995,7735074948,5,0,1,25088,5,8215134227
9141,7735110237,1042,7735111279,2,0,1,1024,2,1960294323
9142,7735154176,45596,7735199772,9,0,0,1024,9,4850365166
9143,7735333662,5802,7735339464,9,0,1,6144,9,8114915026
9144,7735378269,43904,7735422173,6,0,0,512,6,5400411785
9145,7735442473,5802,7735448275,1,0,1,6144,1,9465332397
9146,7735537037,43904,7735580941,7,0,0,512,7,8081089724
9147,7735539216,3128,7735542344,9,0,1,9216,9,463095410
9148,7735569118,74360,7735643478,8,0,0,9728,8,4463002021
9149,7735618953,5802,7735624755,2,0,1,6144,2,7688149590
9150,7735669043,43904,7735712947,0,0,0,512,0,9904883047
9151,7735691236,105080,7735796316,0,0,0,1024,0,6077173713
9152,7735819522,45596,7735865118,9,0,0,1024,9,10112087626
9153,7735838521,47288,7735885809,9,0,0,1536,9,109395875
9154,7735857413,48980,7735906393,1,0,0,2048,1,6367283064
9155,7736080177,4850,7736085027,2,0,1,5120,2,9405401267
9156,7736157344,64076,7736221420,8,0,0,11264,8,1136236790
9157,7736230533,43904,7736274437,2,0,0,512,2,3679785981
9158,7736293602,45596,7736339198,6,0,0,1024,6,10504639947
9159,7736356489,81128,7736437617,8,0,0,11776,8,9402471109
9160,7736401887,116580,7736518467,8,0,0,49152,8,9021559681
9161,7736420632,31007,7736451639,5,0,1,50176,5,529120028
9162,7736473355,326786,7736800141,3,0,0,115200,3,116562756
9163,7736477215,123489,7736600704,0,0,0,512,0,507673182
9164,7736487937,30545,7736518482,5,0,1,43520,5,1943316545
9165,7736500132,210423,7736710555,3,0,0,49152,3,7004725842
9166,7736543869,566,7736544435,2,0,1,512,2,6754515923
9167,7736677983,6278,7736684261,4,0,1,6656,4,8068415111
9168,7736728905,71259,7736800164,8,0,1,93696,8,1038971899
9169,7736758143,114581,7736872724,9,0,0,512,9,4809348430
9170,7736768626,245780,7737014406,3,0,0,52736,3,10689271073
9171,7737011943,46359,7737058302,0,0,0,512,0,2372802225
9172,7737066092,566,7737066658,1,0,1,512,1,291980527
9173,7737099515,5802,7737105317,1,0,1,6144,1,7547909727
9174,7737104720,123836,7737228556,8,0,0,55808,8,6687355184
9175,7737200996,113048,7737314044,3,0,0,71168,3,5821001243
9176,7737233268,239614,7737472882,4,0,0,198144,4,8075846523
9177,7737251925,566,7737252491,4,0,1,512,4,8823295814
9178,7737460744,16980,7737477724,4,0,1,5120,4,6706158425
9179,7737494407,72668,7737567075,3,0,0,9216,3,8896591580
9180,7737517263,1518,7737518781,5,0,1,1536,5,6841924506
9181,7737534992,100568,7737635560,1,0,0,30208,1,7162060875
9182,7737544149,2470,7737546619,2,0,1,2560,2,7610432733
9183,7737642461,7230,7737649691,4,0,1,7680,4,7219966075
9184,7737728357,1042,7737729399,4,0,1,1024,4,2935993508
9185,7737787897,105154,7737893051,5,0,1,174592,5,4255971623
9186,7737830891,103627,7737934518,9,0,0,512,9,9661195508
9187,7737922096,14545,7737936641,5,0,1,28160,5,9248855664
9188,7737991279,4679,7737995958,0,0,1,12288,0,2005419559
9189,7737992845,6601,7737999446,0,0,1,4608,0,2641486955
9190,7738067055,50072,7738117127,7,0,0,1024,7,8379866182
9191,7738134189,43904,7738178093,0,0,0,512,0,4044848765
9192,7738151440,3422,7738154862,0,0,1,3584,0,3014451523
9193,7738241362,11533,7738252895,0,0,1,18944,0,5539280032
9194,7738498395,53325,7738551720,8,0,1,87040,8,5898398610
9195,7738636465,81875,7738718340,0,0,0,512,0,377872813
9196,7738648460,2946,7738651406,1,0,1,3072,1,1119449092
9197,7738716842,5326,7738722168,4,0,1,5632,4,8482887
9198,7738750399,106496,7738856895,8,0,0,49664,8,2868341721
9199,7738781956,2946,7738784902,1,0,1,3072,1,8771825100
9200,7739039487,45596,7739085083,0,0,0,1024,0,6223175208
9201,7739104535,53237,7739157772,3,0,1,90112,3,2523023931
9202,7739138378,35561,7739173939,8,0,1,60928,8,1372196532
9203,7739184034,3898,7739187932,4,0,1,4096,4,9240523940
9204,7739198706,1994,7739200700,0,0,1,2048,0,5006041810
9205,7739221891,144164,7739366055,6,0,0,512,6,7275327651
9206,7739247002,7230,7739254232,9,0,1,7680,9,69977784
9207,7739315828,158687,7739474515,8,0,0,3072,8,4207342752
9208,7739386946,43904,7739430850,6,0,0,512,6,5972194891
9209,7739528876,73833,7739602709,3,0,1,120320,3,2225441071
9210,7739665834,47288,7739713122,8,0,0,1536,8,6263176921
9211,7739905995,43904,7739949899,6,0,0,512,6,3885691469
9212,7740001130,87757,7740088887,3,0,0,12800,3,8862666426
9213,7740002759,6229,7740008988,0,0,1,15360,0,3982526366
9214,7740075203,126676,7740201879,1,0,0,83968,1,15631399
9215,7740087988,121550,7740209538,1,0,0,25088,1,6460628184
9216,7740105079,65668,7740170747,8,0,0,1536,8,10077902643
9217,7740192811,139127,7740331938,4,0,0,101888,4,4057997173
9218,7740202556,14705,7740217261,9,0,1,8192,9,9524502845
9219,7740223166,3422,7740226588,4,0,1,3584,4,9235668309
9220,7740229291,102974,7740332265,9,0,0,1024,9,4384410821
9221,7740241300,142046,7740383346,3,0,0,11264,3,5329036542
9222,7740332084,739,7740332823,1,0,1,512,1,9156733961
9223,7740446895,48980,7740495875,0,0,0,2048,0,5747737552
9224,7740530748,5454,7740536202,2,0,1,13824,2,6954157733
9225,7740639699,98244,7740737943,9,0,0,512,9,1027449595
9226,7740655794,43904,7740699698,9,0,0,512,9,7326879081
9227,7740667335,43904,7740711239,0,0,0,512,0,5458087481
9228,7740673631,43904,7740717535,9,0,0,512,9,6503920689
9229,7740698453,1518,7740699971,9,0,1,1536,9,534174365
9230,7740801564,566,7740802130,1,0,1,512,1,3183112609
9231,7740881554,3422,7740884976,1,0,1,3584,1,3172127360
9232,7741106760,3898,7741110658,4,0,1,4096,4,8275190671
9233,7741125021,57440,7741182461,1,0,0,4608,1,3571130062
9234,7741146250,2470,7741148720,3,0,1,2560,3,4593268850
9235,7741212568,2470,7741215038,9,0,1,2560,9,4171258026
9236,7741356882,45596,7741402478,7,0,0,1024,7,10478369504
9237,7741359383,43904,7741403287,7,0,0,512,7,1868465012
9238,7741387833,34279,7741422112,5,0,1,59904,5,5823743612
9239,7741416676,8342,7741425018,9,0,1,4608,9,7921853977
9240,7741546283,109772,7741656055,4,0,0,60416,4,7949308231
9241,7741584096,77089,7741661185,9,0,0,512,9,581827790
9242,7741611830,62765,7741674595,8,0,0,3072,8,1247435125
9243,7741647543,52408,7741699951,8,0,0,512,8,6778425644
9244,7741738525,70532,7741809057,4,0,0,12288,4,10559691763
9245,7741795457,5971,7741801428,2,0,1,14848,2,6562153726
9246,7741817636,54056,7741871692,1,0,0,3584,1,5967416736
9247,7741830549,5326,7741835875,4,0,1,5632,4,6093563147
9248,7741913257,97387,7742010644,3,0,0,512,3,9629689910
9249,7741963442,52364,7742015806,3,0,0,3072,3,4332231064
9250,7741994084,43904,7742037988,7,0,0,512,7,3424500246
9251,7742004029,43904,7742047933,7,0,0,512,7,10682315785
9252,7742040457,88100,7742128557,4,0,0,24576,4,6010367270
9253,7742055649,22174,7742077823,5,0,1,36352,5,1248917093
9254,7742089031,2870,7742091901,1,0,1,8704,1,10062937108
9255,7742142842,11791,7742154633,5,0,1,19456,5,5507284644
9256,7742209116,176801,7742385917,4,0,0,22528,4,6665954034
9257,7742224596,24670,7742249266,5,0,1,44544,5,5491583965
9258,7742270969,68802,7742339771,7,0,0,1024,7,7108551472
9259,7742329464,67592,7742397056,1,0,0,7680,1,8194048802
9260,7742465458,7230,7742472688,3,0,1,7680,3,3459759368
9261,7742596986,2470,7742599456,0,0,1,2560,0,5992160751
9262,7742645002,49136,7742694138,0,0,0,2560,0,8721802875
9263,7742661881,43904,7742705785,9,0,0,512,9,5720398449
9264,7742817044,60824,7742877868,3,0,0,5632,3,6329510661
9265,7742929475,105092,7743034567,4,0,0,45056,4,1792231848
9266,7743122669,4162,7743126831,0,0,1,11264,0,10313501468
9267,7743263926,43370,7743307296,3,0,1,74240,3,1109689555
9268,7743356787,5802,7743362589,0,0,1,6144,0,6813996979
9269,7743377580,94712,7743472292,3,0,0,26112,3,4112749640
9270,7743423495,1518,7743425013,4,0,1,1536,4,5901961603
9271,7743444580,45141,7743489721,2,0,0,512,2,1595711277
9272,7743530279,126696,7743656975,8,0,1,209920,8,1209898860
9273,7743637357,72153,7743709510,0,0,0,512,0,4673627943
9274,7743705724,45596,7743751320,2,0,0,1024,2,6646883630
9275,7743709967,2470,7743712437,4,0,1,2560,4,1302524825
9276,7743713682,3128,7743716810,4,0,1,9216,4,1065731625
9277,7743796654,3422,7743800076,3,0,1,3584,3,8103368709
9278,7743870816,7230,7743878046,9,0,1,7680,9,10477536227
9279,7743955382,5802,7743961184,1,0,1,6144,1,4612739624
9280,7744023366,43904,7744067270,2,0,0,512,2,5934870117
9281,7744158299,45596,7744203895,2,0,0,1024,2,2134000791
9282,7744312745,1042,7744313787,0,0,1,1024,0,7547615969
9283,7744393912,3898,7744397810,2,0,1,4096,2,1735846144
9284,7744397244,6754,7744403998,1,0,1,7168,1,1412483517
9285,7744449075,45596,7744494671,6,0,0,1024,6,9055847144
9286,7744469804,6754,7744476558,2,0,1,7168,2,10248287702
9287,7744564651,100256,7744664907,1,0,0,29184,1,5766645002
9288,7744566159,98919,7744665078,0,0,0,512,0,2550290212
9289,7744653823,26738,7744680561,5,0,1,48640,5,7216368244
9290,7744669346,48129,7744717475,8,0,0,1536,8,7103658252
9291,7744717836,45924,7744763760,6,0,0,1024,6,3579018172
9292,7744737296,91136,7744828432,9,0,0,1024,9,6698396276
9293,7744742319,43904,7744786223,8,0,0,512,8,6899773328
9294,7744765834,82566,7744848400,8,0,0,1024,8,5341034969
9295,7744895286,47288,7744942574,6,0,0,1536,6,9227756370
9296,7744904535,3422,7744907957,4,0,1,3584,4,114807708
9297,7744972959,3128,7744976087,1,0,1,9216,1,6989677664
9298,7744981954,3387,7744985341,5,0,1,9728,5,8598096410
9299,7744995012,3387,7744998399,4,0,1,9728,4,1276751499
9300,7745085692,48980,7745134672,6,0,0,2048,6,2448403835
9301,7745094425,77164,7745171589,9,0,0,1024,9,86588063
9302,7745223236,25704,7745248940,3,0,1,46592,3,3840156144
9303,7745224088,25838,7745249926,9,0,1,1536,9,2005635819
9304,7745230338,100519,7745330857,6,0,0,512,6,8550957575
9305,7745274435,58114,7745332549,0,0,0,1024,0,380313407
9306,7745325254,75320,7745400574,3,0,0,17920,3,8602268202
9307,7745382537,55748,7745438285,3,0,0,4096,3,8917502563
9308,7745383751,104312,7745488063,3,0,0,42496,3,9693923189
9309,7745467049,48980,7745516029,6,0,0,2048,6,7572263601
9310,7745547733,33245,7745580978,3,0,1,57856,3,3235091242
9311,7745688180,6278,7745694458,9,0,1,6656,9,4179999886
9312,7745743491,14287,7745757778,8,0,1,27648,8,1258624008
9313,7745918894,44060,7745962954,2,0,0,1024,2,882788607
9314,7745944893,47288,7745992181,6,0,0,1536,6,2707246520
9315,7745964579,47288,7746011867,7,0,0,1536,7,1214239064
9316,7746030933,44060,7746074993,0,0,0,1024,0,6387369852
9317,7746110200,43904,7746154104,9,0,0,512,9,9299115721
9318,7746112205,1518,7746113723,4,0,1,1536,4,5763201589
9319,7746122906,126152,7746249058,3,0,0,114176,3,458762588
9320,7746172471,87339,7746259810,6,0,0,1024,6,195938026
9321,7746213380,62516,7746275896,1,0,0,6144,1,9905041543
9322,7746240777,56785,7746297562,6,0,0,512,6,5920320951
9323,7746362115,115076,7746477191,3,0,0,77824,3,7136723244
9324,7746422703,11533,7746434236,0,0,1,18944,0,6170226856
9325,7746470478,11555,7746482033,2,0,1,5120,2,3367762963
9326,7746545106,4374,7746549480,2,0,1,4608,2,9347873694
9327,7746560787,3422,7746564209,0,0,1,3584,0,1056024434
9328,7746565589,7230,7746572819,0,0,1,7680,0,6521547787
9329,7746575540,43904,7746619444,6,0,0,512,6,10273566007
9330,7746624574,124096,7746748670,4,0,0,89088,4,9909403860
9331,7746630162,43904,7746674066,0,0,0,512,0,6596040117
9332,7746672558,88920,7746761478,8,0,0,1024,8,1453837677
9333,7746745744,48514,7746794258,8,0,0,1024,8,9809980186
9334,7746749041,4374,7746753415,9,0,1,4608,9,3378069526
9335,7746782850,43904,7746826754,6,0,0,512,6,10252087872
9336,7746807782,64208,7746871990,3,0,0,6656,3,9499389568
9337,7746821546,13341,7746834887,8,0,1,22528,8,1521680990
9338,7746822642,13423,7746836065,2,0,1,13824,2,3698900451
9339,7746826782,12509,7746839291,4,0,1,5120,4,8983579648
9340,7746899551,24242,7746923793,8,0,1,40448,8,3360463729
9341,7747000257,24412,7747024669,5,0,1,44032,5,5209395713
9342,7747113926,43904,7747157830,0,0,0,512,0,2774737115
9343,7747236689,1518,7747238207,4,0,1,1536,4,8015582291
9344,7747335734,11016,7747346750,5,0,1,17920,5,9848140135
9345,7747420678,50672,7747471350,6,0,0,2560,6,1347387841
9346,7747530573,7706,7747538279,5,0,1,8192,5,1734131019
9347,7747619864,21141,7747641005,3,0,1,34304,3,8814190056
9348,7747645587,79690,7747725277,2,0,0,512,2,3112869511
9349,7747652828,45596,7747698424,8,0,0,1024,8,9165510503
9350,7747699593,105910,7747805503,4,0,0,35840,4,4762449748
9351,7747808018,113204,7747921222,1,0,0,71680,1,1224373212
9352,7747816470,47288,7747863758,9,0,0,1536,9,691186903
9353,7747979904,60824,7748040728,7,0,0,5632,7,245874400
9354,7747980033,43904,7748023937,9,0,0,512,9,1614364126
9355,7748071626,7230,7748078856,8,0,1,7680,8,6727004151
9356,7748148311,55748,7748204059,4,0,0,4096,4,4920392492
9357,7748152255,12049,7748164304,8,0,1,19968,8,8372500043
9358,7748195734,43904,7748239638,2,0,0,512,2,1377855669
9359,7748373000,43904,7748416904,2,0,0,512,2,3299732662
9360,7748375639,1042,7748376681,4,0,1,1024,4,6658570383
9361,7748401066,6278,7748407344,1,0,1,6656,1,6330723701
9362,7748407160,54056,7748461216,9,0,0,3584,9,9217681699
9363,7748435235,2870,7748438105,6,0,1,8704,6,9725510849
9364,7748577657,3422,7748581079,4,0,1,3584,4,6085264450
9365,7748615485,43904,7748659389,0,0,0,512,0,2098590078
9366,7748648904,118352,7748767256,3,0,0,88576,3,1158820403
9367,7748707756,83440,7748791196,1,0,0,3584,1,9550920474
9368,7748958236,80396,7749038632,1,0,0,19456,1,2542989902
9369,7749012582,43904,7749056486,0,0,0,512,0,7743769390
9370,7749189153,43904,7749233057,0,0,0,512,0,5058708655
9371,7749251654,51296,7749302950,3,0,0,4608,3,4218112473
9372,7749273818,4937,7749278755,9,0,1,12800,9,10656265843
9373,7749345729,104312,7749450041,7,0,0,42496,7,5344519815
9374,7749358087,45954,7749404041,8,0,1,79360,8,3286752823
9375,7749449562,62274,7749511836,9,0,0,1024,9,2494291019
9376,7749472964,48980,7749521944,6,0,0,2048,6,2851176843
9377,7749585059,46931,7749631990,9,0,0,512,9,124496365
9378,7749729759,1042,7749730801,5,0,1,1024,5,7221929724
9379,7749737289,43904,7749781193,8,0,0,512,8,3694118677
9380,7749747458,74524,7749821982,7,0,0,7168,7,6562160004
9381,7749747790,5326,7749753116,6,0,1,5632,6,4179252620
9382,7749784313,71023,7749855336,7,0,0,4608,7,354523266
9383,7749799026,56598,7749855624,2,0,0,512,2,8969784727
9384,7749865037,88676,7749953713,7,0,0,16384,7,10733292032
9385,7749996069,43904,7750039973,6,0,0,512,6,2020241722
9386,7750000651,2470,7750003121,9,0,1,2560,9,1622520837
9387,7750005581,60824,7750066405,3,0,0,5632,3,9788814558
9388,7750050266,48980,7750099246,2,0,0,2048,2,2570999206
9389,7750141870,123656,7750265526,3,0,0,105984,3,8089325141
9390,7750144309,164909,7750309218,7,0,0,88064,7,7161558917
9391,7750245742,80492,7750326234,6,0,0,512,6,3549110383
9392,7750273533,4374,7750277907,4,0,1,4608,4,7780426469
9393,7750291134,29609,7750320743,5,0,1,18944,5,9728273568
9394,7750325870,43904,7750369774,0,0,0,512,0,6840405820
9395,7750417767,67238,7750485005,3,0,1,114176,3,10031304775
9396,7750426196,62995,7750489191,5,0,1,6656,5,789297804
9397,7750524253,143573,7750667826,0,0,0,512,0,10732380670
9398,7750549101,43904,7750593005,9,0,0,512,9,319592690
9399,7750617275,4850,7750622125,2,0,1,5120,2,4057334638
9400,7750716813,47288,7750764101,2,0,0,1536,2,9716783616
9401,7750868969,5712,7750874681,9,0,1,14336,9,4848329151
9402,7750901784,4162,7750905946,2,0,1,11264,2,6049793795
9403,7751061706,3387,7751065093,9,0,1,9728,9,217799798
9404,7751133504,1994,7751135498,4,0,1,2048,4,9759463821
9405,7751246828,43904,7751290732,6,0,0,512,6,514987847
9406,7751282970,1042,7751284012,0,0,1,1024,0,10376408238
9407,7751311410,73760,7751385170,4,0,0,12800,4,7499130603
9408,7751315453,155217,7751470670,7,0,0,132096,7,10208190856
9409,7751405222,2470,7751407692,0,0,1,2560,0,1361238120
9410,7751429574,47288,7751476862,6,0,0,1536,6,9390937398
9411,7751779885,2946,7751782831,1,0,1,3072,1,8747240381
9412,7751835470,60824,7751896294,7,0,0,5632,7,5598161121
9413,7751883762,2946,7751886708,9,0,1,3072,9,7486176932
9414,7751900718,43904,7751944622,9,0,0,512,9,8284319061
9415,7751914373,43904,7751958277,9,0,0,512,9,2993701100
9416,7751997731,45596,7752043327,9,0,0,1024,9,7649708659
9417,7752013104,54056,7752067160,4,0,0,3584,4,4711467334
9418,7752058938,3904,7752062842,1,0,1,10752,1,9008513133
9419,7752078998,6488,7752085486,5,0,1,15872,5,3743227679
9420,7752131923,45596,7752177519,8,0,0,1024,8,3305696341
9421,7752138636,2946,7752141582,2,0,1,3072,2,7798613901
9422,7752157580,43904,7752201484,6,0,0,512,6,87185280
9423,7752182093,4420,7752186513,6,0,1,11776,6,6031618587
9424,7752265347,108609,7752373956,9,0,0,512,9,8970596149
9425,7752305738,124084,7752429822,1,0,0,16384,1,2463761427
9426,7752320432,45596,7752366028,2,0,0,1024,2,2432118900
9427,7752320788,48980,7752369768,1,0,0,2048,1,7665692797
9428,7752389478,21141,7752410619,2,0,1,34304,2,9481890215
9429,7752562747,6754,7752569501,2,0,1,7168,2,8918613520
9430,7752603074,45596,7752648670,2,0,0,1024,2,1122961789
9431,7752678963,1042,7752680005,6,0,1,1024,6,297088247
9432,7752785022,104468,7752889490,1,0,0,43008,1,3997359140
9433,7752858156,85448,7752943604,4,0,0,15872,4,3015272678
9434,7752927585,4374,7752931959,4,0,1,4608,4,91658433
9435,7753024243,99788,7753124031,1,0,0,27648,1,7145976211
9436,7753121617,5352,7753126969,4,0,1,3072,4,2486056650
9437,7753196527,43904,7753240431,2,0,0,512,2,2604470612
9438,7753201081,566,7753201647,1,0,1,512,1,8567527704
9439,7753250001,87476,7753337477,7,0,0,22528,7,4910623979
9440,7753339540,47288,7753386828,0,0,0,1536,0,10073937852
9441,7753350355,101192,7753451547,7,0,0,32256,7,819895554
9442,7753408142,113983,7753522125,7,0,0,40960,7,8074580203
9443,7753440720,55904,7753496624,3,0,0,4608,3,3867534999
9444,7753441355,10207,7753451562,4,0,1,2048,4,4560511083
9445,7753493479,12566,7753506045,3,0,1,20992,3,7884207155
9446,7753582983,48980,7753631963,8,0,0,2048,8,428155628
9447,7753654336,114452,7753768788,3,0,0,75776,3,8962739777
9448,7753659993,85107,7753745100,8,0,0,3072,8,7601742038
9449,7753679756,2470,7753682226,0,0,1,2560,0,9835155137
9450,7753853024,10241,7753863265,3,0,1,16384,3,3910169480
9451,7753943428,1518,7753944946,6,0,1,1536,6,10126757702
9452,7754051326,2946,7754054272,1,0,1,3072,1,1820557709
9453,7754106338,45596,7754151934,6,0,0,1024,6,421592025
9454,7754230305,2946,7754233251,4,0,1,3072,4,597082426
9455,7754435313,2946,7754438259,2,0,1,3072,2,3488858709
9456,7754475708,2870,7754478578,7,0,1,8704,7,549696242
9457,7754578514,55748,7754634262,1,0,0,4096,1,7422076895
9458,7754671873,45596,7754717469,0,0,0,1024,0,5720496918
9459,7754742120,43904,7754786024,8,0,0,512,8,7549228477
9460,7754808891,43904,7754852795,8,0,0,512,8,1062574207
9461,7754831162,4374,7754835536,6,0,1,4608,6,3063018172
9462,7754836221,43904,7754880125,6,0,0,512,6,8551494427
9463,7754890001,4162,7754894163,2,0,1,11264,2,1478919859
9464,7754899367,108534,7755007901,9,0,0,512,9,1116643325
9465,7754914023,20624,7754934647,4,0,1,33280,4,3242918516
9466,7754914744,83930,7754998674,8,0,0,1536,8,2188128672
9467,7755162170,4162,7755166332,4,0,1,11264,4,8174127116
9468,7755224028,47288,7755271316,2,0,0,1536,2,2504432962
9469,7755249146,1042,7755250188,7,0,1,1024,7,8689146019
9470,7755269160,47288,7755316448,8,0,0,1536,8,7376996438
9471,7755290737,43904,7755334641,9,0,0,512,9,5244771182
9472,7755346574,6754,7755353328,7,0,1,7168,7,1499515831
9473,7755351281,3673,7755354954,7,0,1,2560,7,7350015390
9474,7755392671,7230,7755399901,4,0,1,7680,4,7022256729
9475,7755481861,6754,7755488615,1,0,1,7168,1,10289094130
9476,7755559267,62516,7755621783,4,0,0,6144,4,5724047525
9477,7755623073,1042,7755624115,4,0,1,1024,4,3762418393
9478,7755665909,45596,7755711505,6,0,0,1024,6,5057300991
9479,7755780229,3898,7755784127,0,0,1,4096,0,9665199437
9480,7755816936,43904,7755860840,0,0,0,512,0,129913522
9481,7755945601,3422,7755949023,1,0,1,3584,1,3874081781
9482,7755994091,4850,7755998941,7,0,1,5120,7,9864881479
9483,7755996628,3299,7755999927,1,0,1,1536,1,1232325128
9484,7756016064,3898,7756019962,0,0,1,4096,0,938163590
9485,7756051354,102751,7756154105,1,0,0,21504,1,1603187160
9486,7756195336,124100,7756319436,3,0,0,102400,3,23862524
9487,7756202266,1042,7756203308,6,0,1,1024,6,3955091133
9488,7756216744,148934,7756365678,3,0,0,31232,3,3236373994
9489,7756237436,6754,7756244190,4,0,1,7168,4,9081525443
9490,7756275558,2946,7756278504,0,0,1,3072,0,1387507498
9491,7756320119,114085,7756434204,4,0,0,28160,4,4481832436
9492,7756341120,48980,7756390100,2,0,0,2048,2,8376004224
9493,7756350401,1042,7756351443,4,0,1,1024,4,5202065454
9494,7756432368,8106,7756440474,7,0,1,6656,7,2149407056
9495,7756492611,1994,7756494605,2,0,1,2048,2,1070784942
9496,7756501350,566,7756501916,6,0,1,512,6,7103212726
9497,7756524754,31524,7756556278,3,0,1,51200,3,9044848107
9498,7756542597,146619,7756689216,2,0,0,1024,2,9059080284
9499,7756546882,11662,7756558544,0,0,1,3584,0,1063302132
9500,7756580488,108401,7756688889,7,0,0,18944,7,7671371883
9501,7756610877,5196,7756616073,7,0,1,13312,7,9903064279
9502,7756685998,47114,7756733112,2,0,0,512,2,9041323387
9503,7756762731,6754,7756769485,0,0,1,7168,0,7710943783
9504,7756843421,3898,7756847319,6,0,1,4096,6,6607907680
9505,7756858236,83446,7756941682,3,0,0,12288,3,2516458495
9506,7756940296,50358,7756990654,2,0,0,2048,2,8047203044
9507,7756985126,136251,7757121377,7,0,0,93184,7,5800502004
9508,7756994031,127517,7757121548,2,0,0,512,2,10041331318
9509,7757001621,61537,7757063158,3,0,0,6656,3,9943952562
9510,7757087986,3387,7757091373,6,0,1,9728,6,1425816992
9511,7757146248,43904,7757190152,2,0,0,512,2,2594067825
9512,7757182850,43904,7757226754,2,0,0,512,2,2122819660
9513,7757197310,15321,7757212631,5,0,1,29696,5,2903295339
9514,7757311046,3645,7757314691,3,0,1,10240,3,4792074146
9515,7757469147,43904,7757513051,9,0,0,512,9,1360986960
9516,7757556200,49509,7757605709,2,0,0,512,2,8084810503
9517,7757556930,31524,7757588454,5,0,1,51200,5,2688004889
9518,7757618888,3387,7757622275,2,0,1,9728,2,2021306389
9519,7757644488,1042,7757645530,0,0,1,1024,0,6434941406
9520,7757737365,14804,7757752169,3,0,1,28672,3,7747999860
9521,7757790361,101972,7757892333,3,0,0,34816,3,3549133225
9522,7757843723,49249,7757892972,3,0,0,2048,3,2655334891
9523,7757866158,1042,7757867200,7,0,1,1024,7,7387835737
9524,7757923020,47288,7757970308,3,0,0,1536,3,10016600002
9525,7758079822,59444,7758139266,1,0,0,6144,1,8927576626
9526,7758085215,32041,7758117256,5,0,1,52224,5,5542551917
9527,7758133039,45596,7758178635,8,0,0,1024,8,5593390409
9528,7758133774,6278,7758140052,7,0,1,6656,7,10250938326
9529,7758141302,147217,7758288519,4,0,0,39424,4,10538733013
9530,7758213966,86079,7758300045,8,0,0,512,8,2332651268
9531,7758258329,65924,7758324253,4,0,0,12288,4,1156268307
9532,7758473193,3645,7758476838,4,0,1,10240,4,7983838366
9533,7758486196,70186,7758556382,8,0,0,2048,8,9167805097
9534,7758489568,47288,7758536856,0,0,0,1536,0,2406790794
9535,7758518168,84216,7758602384,3,0,1,137216,3,3965321512
9536,7758572621,34948,7758607569,7,0,1,16384,7,6099202806
9537,7758624934,1994,7758626928,2,0,1,2048,2,10611456141
9538,7758704365,100925,7758805290,6,0,0,1024,6,6358237042
9539,7758765163,71465,7758836628,7,0,0,9216,7,2194334002
9540,7758805300,119132,7758924432,4,0,0,91136,4,739798646
9541,7758846490,11791,7758858281,4,0,1,19456,4,4938744144
9542,7758955323,45596,7759000919,2,0,0,1024,2,4352864564
9543,7759051076,47288,7759098364,3,0,0,1536,3,931324348
9544,7759168955,47288,7759216243,9,0,0,1536,9,3966689170
9545,7759342624,1518,7759344142,5,0,1,1536,5,122301654
9546,7759461282,2946,7759464228,1,0,1,3072,1,10690204776
9547,7759461347,71911,7759533258,8,0,1,114688,8,9499510798
9548,7759538069,152909,7759690978,9,0,0,512,9,6369433182
9549,7759620179,43904,7759664083,3,0,0,512,3,9718609783
9550,7759787564,103532,7759891096,4,0,0,39936,4,4781775089
9551,7759807343,88604,7759895947,1,0,0,15872,1,5451978425
9552,7759910789,5326,7759916115,4,0,1,5632,4,2725086241
9553,7759915180,6229,7759921409,6,0,1,15360,6,2974834599
9554,7759917098,7686,7759924784,7,0,1,5120,7,1528235941
9555,7759918109,175965,7760094074,4,0,0,27136,4,2019557430
9556,7759981799,51509,7760033308,0,0,0,512,0,7516697159
9557,7760112860,48980,7760161840,7,0,0,2048,7,7032857063
9558,7760132440,3422,7760135862,0,0,1,3584,0,3144949459
9559,7760285367,2946,7760288313,4,0,1,3072,4,9510139056
9560,7760285438,24034,7760309472,3,0,1,41472,3,6142345365
9561,7760298068,12889,7760310957,5,0,1,15360,5,3996985575
9562,7760380677,43904,7760424581,8,0,0,512,8,1480448542
9563,7760438055,86971,7760525026,8,0,1,145920,8,23251219
9564,7760562691,257501,7760820192,1,0,0,21504,1,307287737
9565,7760593780,4374,7760598154,7,0,1,4608,7,1980413263
9566,7760651278,125996,7760777274,4,0,0,113664,4,7106779853
9567,7760674517,103864,7760778381,0,0,0,3584,0,525506104
9568,7760716439,5802,7760722241,0,0,1,6144,0,7757198196
9569,7760720347,14287,7760734634,5,0,1,27648,5,10556898957
9570,7760841742,3898,7760845640,0,0,1,4096,0,8083554876
9571,7760853210,3422,7760856632,7,0,1,3584,7,1287693378
9572,7760954789,43904,7760998693,2,0,0,512,2,9396608736
9573,7760959265,1042,7760960307,1,0,1,1024,1,2450642619
9574,7761044313,95648,7761139961,1,0,0,29184,1,3039169411
9575,7761052561,43904,7761096465,9,0,0,512,9,598655291
9576,7761065315,94680,7761159995,1,0,0,3072,1,3505777044
9577,7761109645,2946,7761112591,5,0,1,3072,5,7586550529
9578,7761173379,53237,7761226616,5,0,1,90112,5,608011225
9579,7761312730,11533,7761324263,6,0,1,18944,6,2409249226
9580,7761431854,1042,7761432896,4,0,1,1024,4,5428041811
9581,7761435451,43904,7761479355,1,0,0,512,1,4449191929
9582,7761451644,43904,7761495548,8,0,0,512,8,8280068414
9583,7761489349,43904,7761533253,3,0,0,512,3,3472011135
9584,7761565451,14804,7761580255,8,0,1,28672,8,4031124258
9585,7761631205,2946,7761634151,6,0,1,3072,6,680487896
9586,7761764978,91499,7761856477,8,0,1,147968,8,2834182672
9587,7761898735,106444,7762005179,9,0,0,1024,9,10218081947
9588,7762025547,43904,7762069451,3,0,0,512,3,10680912142
9589,7762081875,43904,7762125779,8,0,0,512,8,5433568420
9590,7762096726,45596,7762142322,9,0,0,1024,9,8939799706
9591,7762134394,3422,7762137816,4,0,1,3584,4,6373557440
9592,7762221697,48980,7762270677,3,0,0,2048,3,555691353
9593,7762383642,47288,7762430930,6,0,0,1536,6,288494617
9594,7762467860,4374,7762472234,1,0,1,4608,1,3774865894
9595,7762603372,43904,7762647276,2,0,0,512,2,7858283012
9596,7762608839,48980,7762657819,8,0,0,2048,8,7863651217
9597,7762659728,54992,7762714720,4,0,0,6656,4,8768440373
9598,7762661892,45596,7762707488,9,0,0,1024,9,4653184508
9599,7762689412,47288,7762736700,0,0,0,1536,0,5911485701
9600,7762775978,45596,7762821574,9,0,0,1024,9,8390909849
9601,7762837421,43904,7762881325,9,0,0,512,9,3779058466
9602,7762855320,99944,7762955264,7,0,0,28160,7,10577117390
9603,7762858254,97025,7762955279,3,0,1,151040,3,4733214861
9604,7762913647,41647,7762955294,3,0,1,15872,3,6989983278
9605,7762920673,177026,7763097699,9,0,0,512,9,10121175060
9606,7762955322,183256,7763138578,3,0,0,1536,3,2978247898
9607,7763048121,64208,7763112329,4,0,0,6656,4,6489792400
9608,7763048903,70642,7763119545,6,0,0,512,6,1883584343
9609,7763066137,67074,7763133211,8,0,0,3072,8,4069217237
9610,7763089098,6754,7763095852,0,0,1,7168,0,6247202775
9611,7763181533,54056,7763235589,8,0,0,3584,8,10581615172
9612,7763184764,43904,7763228668,2,0,0,512,2,6491977451
9613,7763192814,4850,7763197664,7,0,1,5120,7,1778968747
9614,7763195480,4130,7763199610,6,0,1,3072,6,2976938302
9615,7763216090,75812,7763291902,3,0,1,127488,3,4504320485
9616,7763322594,115702,7763438296,1,0,0,13824,1,1493839276
9617,7763460358,4850,7763465208,7,0,1,5120,7,6580766402
9618,7763487425,101972,7763589397,1,0,0,34816,1,6320309441
9619,7763495525,75170,7763570695,3,0,0,2560,3,5186679813
9620,7763658570,43904,7763702474,8,0,0,512,8,8128128835
9621,7763707521,48980,7763756501,8,0,0,2048,8,1967957667
9622,7763711016,47288,7763758304,9,0,0,1536,9,2899870104
9623,7763721856,45596,7763767452,2,0,0,1024,2,6487131987
9624,7763765012,55748,7763820760,1,0,0,4096,1,9030761244
9625,7763834230,1994,7763836224,1,0,1,2048,1,9563258530
9626,7763909082,99125,7764008207,9,0,0,4608,9,2101296046
9627,7763924655,112112,7764036767,1,0,0,68096,1,992497839
9628,7764012506,24276,7764036782,8,0,1,10752,8,4133960382
9629,7764061592,159579,7764221171,4,0,0,29696,4,6759704527
9630,7764121879,6754,7764128633,4,0,1,7168,4,6974713624
9631,7764260220,52364,7764312584,2,0,0,3072,2,5089161937
9632,7764397925,45596,7764443521,9,0,0,1024,9,1074794105
9633,7764579549,43904,7764623453,2,0,0,512,2,843590016
9634,7764587821,2470,7764590291,6,0,1,2560,6,7958855245
9635,7764594422,69284,7764663706,1,0,0,8192,1,8602746123
9636,7764647514,3904,7764651418,3,0,1,10752,3,3900657172
9637,7764706439,3904,7764710343,7,0,1,10752,7,1569462874
9638,7764749666,147349,7764897015,4,0,0,123392,4,8150876410
9639,7764953148,47288,7765000436,2,0,0,1536,2,3450195697
9640,7764960989,47288,7765008277,2,0,0,1536,2,2667012140
9641,7765039997,44060,7765084057,9,0,0,1024,9,125513535
9642,7765142970,3422,7765146392,1,0,1,3584,1,4898343348
9643,7765221064,56216,7765277280,1,0,0,5632,1,4258315574
9644,7765259790,121160,7765380950,1,0,0,97792,1,7110036743
9645,7765304261,11016,7765315277,6,0,1,17920,6,722074682
9646,7765331851,1518,7765333369,0,0,1,1536,0,3249674214
9647,7765361142,20366,7765381508,6,0,1,512,6,3867476133
9648,7765444612,3898,7765448510,7,0,1,4096,7,1410817546
9649,7765480817,76364,7765557181,4,0,0,11264,4,9501802970
9650,7765497665,118030,7765615695,6,0,0,512,6,581633537
9651,7765518744,88375,7765607119,4,0,0,17920,4,6662790260
9652,7765535034,43904,7765578938,6,0,0,512,6,4549705122
9653,7765579105,31783,7765610888,8,0,1,51712,8,8915425033
9654,7765773320,1518,7765774838,4,0,1,1536,4,8141704423
9655,7765778408,5326,7765783734,2,0,1,5632,2,10459558163
9656,7765860153,61124,7765921277,3,0,1,98816,3,10369671919
9657,7765906989,18474,7765925463,7,0,1,6656,7,10329259261
9658,7765985493,2946,7765988439,7,0,1,3072,7,7333815609
9659,7766065429,1518,7766066947,4,0,1,1536,4,6938058731
9660,7766112266,2946,7766115212,4,0,1,3072,4,1611008980
9661,7766137005,151532,7766288537,2,0,0,512,2,2101930287
9662,7766160334,33762,7766194096,8,0,1,58880,8,2219338316
9663,7766216314,63708,7766280022,8,0,1,103936,8,255275004
9664,7766295302,94744,7766390046,2,0,0,2560,2,5378962466
9665,7766299818,91102,7766390920,0,0,0,512,0,1032962750
9666,7766315277,1518,7766316795,5,0,1,1536,5,9940659837
9667,7766400343,22862,7766423205,3,0,1,40960,3,9095395468
9668,7766418310,94456,7766512766,2,0,0,512,2,7206572892
9669,7766740179,43904,7766784083,2,0,0,512,2,2138950281
9670,7766818563,47288,7766865851,0,0,0,1536,0,9516043767
9671,7766895379,12049,7766907428,7,0,1,19968,7,4277892577
9672,7766996538,111062,7767107600,2,0,0,512,2,9932862580
9673,7767005883,16613,7767022496,0,0,1,32256,0,5814860895
9674,7767032809,566,7767033375,7,0,1,512,7,7484488786
9675,7767059682,195756,7767255438,8,0,0,1536,8,4458491124
9676,7767085094,283259,7767368353,2,0,0,2560,2,7760675855
9677,7767096722,43200,7767139922,8,0,1,70656,8,5311024085
9678,7767104549,47124,7767151673,8,0,1,39936,8,7268898787
9679,7767105729,138930,7767244659,9,0,0,1536,9,10690938879
9680,7767110724,204417,7767315141,0,0,0,1536,0,4036298718
9681,7767168741,2470,7767171211,5,0,1,2560,5,3399126196
9682,7767292669,4162,7767296831,3,0,1,11264,3,5097833418
9683,7767436615,2470,7767439085,4,0,1,2560,4,2610949354
9684,7767442152,45596,7767487748,2,0,0,1024,2,7977018190
9685,7767460295,45908,7767506203,9,0,0,2048,9,10289622393
9686,7767462865,47288,7767510153,9,0,0,1536,9,1375082513
9687,7767548983,7706,7767556689,4,0,1,8192,4,792713386
9688,7767626233,7230,7767633463,8,0,1,7680,8,8532543542
9689,7767642477,64341,7767706818,4,0,0,6144,4,5033607946
9690,7767724030,45596,7767769626,2,0,0,1024,2,3784606293
9691,7767821247,3387,7767824634,0,0,1,9728,0,5937966394
9692,7768063750,15837,7768079587,2,0,1,30720,2,10724839413
9693,7768071560,159096,7768230656,4,0,0,104960,4,4152732181
9694,7768140166,23120,7768163286,3,0,1,41472,3,4499265161
9695,7768242701,80583,7768323284,4,0,0,4096,4,1527972816
9696,7768318803,101504,7768420307,7,0,0,33280,7,5058441126
9697,7768335506,3387,7768338893,3,0,1,9728,3,10003397994
9698,7768339802,1518,7768341320,4,0,1,1536,4,9718407630
9699,7768642738,2946,7768645684,4,0,1,3072,4,4847802828
9700,7768726991,7230,7768734221,4,0,1,7680,4,6361573568
9701,7768758913,7230,7768766143,4,0,1,7680,4,3471375633
9702,7768778618,101972,7768880590,7,0,0,34816,7,4112015947
9703,7768784319,5802,7768790121,2,0,1,6144,2,9149006497
9704,7768818467,78177,7768896644,2,0,0,512,2,1274886599
9705,7768825439,6229,7768831668,6,0,1,15360,6,3239312714
9706,7768885151,566,7768885717,1,0,1,512,1,5152673859
9707,7768914256,121455,7769035711,6,0,0,1536,6,1614958630
9708,7768976366,2946,7768979312,3,0,1,3072,3,6304240720
9709,7769003941,100724,7769104665,4,0,0,30720,4,8389011606
9710,7769049983,55321,7769105304,2,0,0,2048,2,653957424
9711,7769058576,101934,7769160510,9,0,0,1024,9,4612769245
9712,7769061560,13341,7769074901,6,0,1,22528,6,1706630625
9713,7769063670,48707,7769112377,6,0,0,512,6,5869172851
9714,7769128295,44072,7769172367,2,0,0,512,2,5755706161
9715,7769131901,12566,7769144467,5,0,1,20992,5,6979693138
9716,7769148483,104468,7769252951,1,0,0,43008,1,7270066637
9717,7769157317,16096,7769173413,3,0,1,31232,3,1613321966
9718,7769173234,118264,7769291498,9,0,0,1024,9,4506763293
9719,7769477480,106184,7769583664,1,0,0,48640,1,4114846888
9720,7769628587,54212,7769682799,8,0,0,4096,8,8818860155
9721,7769864586,87896,7769952482,4,0,0,13824,4,6050844670
9722,7769891901,7230,7769899131,8,0,1,7680,8,6487948024
9723,7769999571,1042,7770000613,2,0,1,1024,2,5584166521
9724,7770030029,3128,7770033157,2,0,1,9216,2,648625754
9725,7770078938,6488,7770085426,7,0,1,15872,7,3374595858
9726,7770088674,45596,7770134270,0,0,0,1024,0,1557930673
9727,7770152247,7706,7770159953,1,0,1,8192,1,1329153893
9728,7770221891,43904,7770265795,3,0,0,512,3,6481564486
9729,7770241909,43904,7770285813,9,0,0,512,9,90189212
9730,7770349149,61899,7770411048,3,0,1,100352,3,3235067655
9731,7770390678,112640,7770503318,1,0,0,13824,1,10048256209
9732,7770515495,43904,7770559399,6,0,0,512,6,1760426089
9733,7770715935,43904,7770759839,0,0,0,512,0,5043359474
9734,7770745499,52364,7770797863,2,0,0,3072,2,4404002270
9735,7770862691,23208,7770885899,8,0,1,38400,8,2728252241
9736,7770971443,48980,7771020423,9,0,0,2048,9,5072605225
9737,7770989486,126776,7771116262,7,0,0,116224,7,4446758564
9738,7770989706,4374,7770994080,1,0,1,4608,1,2071520460
9739,7771023344,143654,7771166998,4,0,0,13312,4,9176394211
9740,7771051552,4679,7771056231,3,0,1,12288,3,9462146620
9741,7771067385,566,7771067951,2,0,1,512,2,853585670
9742,7771147748,2470,7771150218,1,0,1,2560,1,10551548406
9743,7771163052,47842,7771210894,2,0,0,512,2,4079772835
9744,7771317096,4850,7771321946,2,0,1,5120,2,7365863143
9745,7771387578,43904,7771431482,8,0,0,512,8,1149664822
9746,7771401987,5802,7771407789,4,0,1,6144,4,6069357175
9747,7771456207,121985,7771578192,1,0,0,23552,1,4984581524
9748,7771561080,47288,7771608368,9,0,0,1536,9,8715946558
9749,7771579712,3422,7771583134,2,0,1,3584,2,4189173883
9750,7771690036,566,7771690602,0,0,1,512,0,9898373824
9751,7771695116,10499,7771705615,0,0,1,16896,0,9957943018
9752,7771704453,70960,7771775413,3,0,0,1024,3,2492082948
9753,7771762994,60824,7771823818,1,0,0,5632,1,5970669249
9754,7771763781,7706,7771771487,7,0,1,8192,7,2149577966
9755,7771773028,7230,7771780258,0,0,1,7680,0,8364348049
9756,7771801144,55748,7771856892,7,0,0,4096,7,4023302590
9757,7771802119,47204,7771849323,6,0,0,1024,6,6791363331
9758,7771852612,4295,7771856907,7,0,1,3584,7,9162068308
9759,7771930039,12308,7771942347,3,0,1,20480,3,5069590421
9760,7772005045,2946,7772007991,6,0,1,3072,6,3916465518
9761,7772064683,43904,7772108587,8,0,0,512,8,640685142
9762,7772099620,45596,7772145216,8,0,0,1024,8,8516693022
9763,7772143923,1308,7772145231,4,0,1,1024,4,5603527600
9764,7772172369,1042,7772173411,7,0,1,1024,7,8169257840
9765,7772288764,2946,7772291710,1,0,1,3072,1,3476430772
9766,7772388277,3128,7772391405,7,0,1,9216,7,5619930077
9767,7772456751,1518,7772458269,1,0,1,1536,1,9995682369
9768,7772602185,2470,7772604655,6,0,1,2560,6,5250101271
9769,7772659801,1518,7772661319,1,0,1,1536,1,3338956014
9770,7772682010,2946,7772684956,0,0,1,3072,0,7719265929
9771,7772796125,3387,7772799512,5,0,1,9728,5,1437826685
9772,7772841544,6229,7772847773,8,0,1,15360,8,6986228513
9773,7772895165,15837,7772911002,3,0,1,30720,3,2430661021
9774,7772920955,2470,7772923425,2,0,1,2560,2,7347853915
9775,7772972436,61124,7773033560,3,0,1,98816,3,5040273318
9776,7773026739,11007,7773037746,5,0,1,6656,5,2334116690
9777,7773033266,8346,7773041612,4,0,1,6144,4,7306242820
9778,7773158099,107120,7773265219,4,0,0,51712,4,10560524439
9779,7773378258,57113,7773435371,8,0,1,97792,8,7148848037
9780,7773382478,125769,7773508247,2,0,0,2560,2,3842608422
9781,7773449164,135761,7773584925,6,0,0,512,6,906708514
9782,7773570907,2946,7773573853,0,0,1,3072,0,10086385344
9783,7773586283,6278,7773592561,3,0,1,6656,3,2920440916
9784,7773587934,5293,7773593227,2,0,1,1024,2,10668992767
9785,7773602046,155456,7773757502,6,0,0,512,6,565032820
9786,7773685782,1994,7773687776,5,0,1,2048,5,6569986871
9787,7773801127,88110,7773889237,8,0,0,1536,8,7480579993
9788,7774012832,2470,7774015302,4,0,1,2560,4,9414471946
9789,7774051331,54012,7774105343,8,0,1,91648,8,8513732594
9790,7774126567,5196,7774131763,8,0,1,13312,8,8612235980
9791,7774127416,17043,7774144459,8,0,1,26624,8,1867953949
9792,7774128838,16389,7774145227,5,0,1,11776,5,572650103
9793,7774133416,69567,7774202983,8,0,0,2048,8,9167788475
9794,7774195031,146013,7774341044,1,0,0,68608,1,2134173027
9795,7774221148,6278,7774227426,5,0,1,6656,5,2870871201
9796,7774254383,3128,7774257511,2,0,1,9216,2,6975624925
9797,7774284735,5454,7774290189,5,0,1,13824,5,6585319456
9798,7774333774,271477,7774605251,4,0,0,10240,4,3560155085
9799,7774355864,1518,7774357382,7,0,1,1536,7,2402175089
9800,7774361222,43200,7774404422,8,0,1,70656,8,8086774398
9801,7774404548,163413,7774567961,4,0,0,50176,4,4033800510
9802,7774408716,63661,7774472377,6,0,0,2048,6,6510535541
9803,7774445548,4850,7774450398,6,0,1,5120,6,3046219251
9804,7774548898,48980,7774597878,2,0,0,2048,2,5165468774
9805,7774608067,43904,7774651971,9,0,0,512,9,7955941423
9806,7774721763,87959,7774809722,7,0,0,22528,7,9168815401
9807,7774736464,12049,7774748513,4,0,1,19968,4,4069429452
9808,7774835764,106028,7774941792,4,0,0,48128,4,4191372679
9809,7774838197,7706,7774845903,2,0,1,8192,2,6400447973
9810,7774885190,566,7774885756,1,0,1,512,1,781462269
9811,7774887618,5326,7774892944,4,0,1,5632,4,3592790501
9812,7774911011,74350,7774985361,3,0,1,121344,3,10009031904
9813,7774914939,76528,7774991467,3,0,1,29184,3,10292292595
9814,7774927804,65929,7774993733,5,0,1,3584,5,8381783556
9815,7774948559,143018,7775091577,4,0,0,3072,4,2224160846
9816,7774962169,36851,7774999020,7,0,1,16896,7,9437661097
9817,7774992892,93735,7775086627,7,0,0,5632,7,6718223645
9818,7775054106,12566,7775066672,2,0,1,20992,2,1912023640
9819,7775124467,263039,7775387506,1,0,0,74752,1,4629299199
9820,7775127659,2470,7775130129,0,0,1,2560,0,7294481645
9821,7775254007,3898,7775257905,4,0,1,4096,4,9662537666
9822,7775256629,7706,7775264335,4,0,1,8192,4,5259684861
9823,7775262560,148462,7775411022,8,0,0,1024,8,1962485221
9824,7775324881,62952,7775387833,2,0,0,1024,2,673023393
9825,7775334421,5971,7775340392,4,0,1,14848,4,9740637392
9826,7775461725,4162,7775465887,7,0,1,11264,7,8743930333
9827,7775464493,130365,7775594858,7,0,0,38912,7,4473704931
9828,7775512491,159675,7775672166,4,0,0,80384,4,8373377528
9829,7775592308,46446,7775638754,0,0,0,512,0,692947145
9830,7775678826,43904,7775722730,9,0,0,512,9,950452305
9831,7775702966,45596,7775748562,9,0,0,1024,9,8051146578
9832,7775769410,5802,7775775212,4,0,1,6144,4,3581509911
9833,7775792575,109460,7775902035,4,0,0,59392,4,2791599139
9834,7775830464,78705,7775909169,8,0,0,1024,8,3647777606
9835,7775914685,43904,7775958589,8,0,0,512,8,6197588486
9836,7775926437,43904,7775970341,6,0,0,512,6,9789421987
9837,7775965465,43904,7776009369,0,0,0,512,0,4367987740
9838,7775988718,45596,7776034314,2,0,0,1024,2,9223672170
9839,7776006076,85628,7776091704,1,0,0,21504,1,5686205638
9840,7776043569,65121,7776108690,9,0,0,512,9,5391424119
9841,7776130704,43904,7776174608,3,0,0,512,3,1469531624
9842,7776135949,107900,7776243849,1,0,0,54272,1,8510794690
9843,7776141029,153064,7776294093,4,0,0,57856,4,926026227
9844,7776201576,93468,7776295044,1,0,0,3072,1,4692334677
9845,7776219436,50672,7776270108,9,0,0,2560,9,8089019751
9846,7776221599,3422,7776225021,3,0,1,3584,3,6661722882
9847,7776336800,6278,7776343078,0,0,1,6656,0,2840192286
9848,7776369812,43904,7776413716,0,0,0,512,0,2164301232
9849,7776401496,23466,7776424962,8,0,1,38912,8,8370364947
9850,7776414848,43904,7776458752,9,0,0,512,9,362295771
9851,7776609299,45596,7776654895,3,0,0,1024,3,7320815482
9852,7776696309,43904,7776740213,9,0,0,512,9,7334280904
9853,7776703987,45596,7776749583,8,0,0,1024,8,5955134358
9854,7776810657,23378,7776834035,8,0,1,41984,8,1970654622
9855,7776812641,56256,7776868897,2,0,0,512,2,10261384489
9856,7776821530,100420,7776921950,1,0,0,2048,1,1179120589
9857,7776865802,1994,7776867796,8,0,1,2048,8,7217047664
9858,7776905324,3904,7776909228,7,0,1,10752,7,9571913413
9859,7776922687,103532,7777026219,4,0,0,39936,4,7279334226
9860,7776969413,56977,7777026390,0,0,0,512,0,256299243
9861,7776991565,566,7776992131,4,0,1,512,4,4141679551
9862,7777003660,24242,7777027902,8,0,1,40448,8,4962692790
9863,7777076674,43904,7777120578,2,0,0,512,2,5341754922
9864,7777105179,20366,7777125545,5,0,1,32768,5,5027692048
9865,7777136018,106422,7777242440,4,0,0,46080,4,4119936977
9866,7777156397,43904,7777200301,8,0,0,512,8,3686220699
9867,7777176464,566,7777177030,2,0,1,512,2,8708233573
9868,7777204986,142542,7777347528,7,0,0,17408,7,4074490407
9869,7777261722,45596,7777307318,0,0,0,1024,0,4111393110
9870,7777334762,43904,7777378666,9,0,0,512,9,5994291224
9871,7777379894,26221,7777406115,3,0,1,47616,3,3668191467
9872,7777398211,109026,7777507237,7,0,0,37888,7,9765289622
9873,7777403585,41649,7777445234,3,0,1,67584,3,8313139253
9874,7777433725,12815,7777446540,7,0,1,2048,7,5071417498
9875,7777577041,88943,7777665984,0,0,0,1536,0,7273100867
9876,7777579473,43904,7777623377,6,0,0,512,6,542873967
9877,7777634123,43904,7777678027,3,0,0,512,3,9596338731
9878,7777656265,43904,7777700169,2,0,0,512,2,9509277040
9879,7777800151,43904,7777844055,8,0,0,512,8,3931209646
9880,7777884949,108368,7777993317,7,0,0,55808,7,4799151827
9881,7777972196,43904,7778016100,3,0,0,512,3,7715718177
9882,7777996505,124592,7778121097,7,0,0,109056,7,6106987097
9883,7778030684,166559,7778197243,7,0,0,125952,7,10089322451
9884,7778108632,45549,7778154181,8,0,1,54272,8,3858937772
9885,7778112912,42255,7778155167,6,0,1,1536,6,704182057
9886,7778179846,64677,7778244523,0,0,0,1536,0,749994560
9887,7778263076,47288,7778310364,3,0,0,1536,3,3202074966
9888,7778441507,2470,7778443977,6,0,1,2560,6,3508191086
9889,7778559602,43904,7778603506,8,0,0,512,8,10580970193
9890,7778560685,4850,7778565535,2,0,1,5120,2,1593889159
9891,7778578233,3898,7778582131,2,0,1,4096,2,8626672966
9892,7778652009,10499,7778662508,5,0,1,16896,5,9614495462
9893,7778754838,97604,7778852442,7,0,0,20480,7,10436311065
9894,7778807577,78507,7778886084,4,0,0,13824,4,6879686156
9895,7778808816,43904,7778852720,8,0,0,512,8,7738788434
9896,7778835558,70718,7778906276,6,0,0,2048,6,7843281382
9897,7778847413,9412,7778856825,2,0,1,4608,2,4504704727
9898,7778851929,5242,7778857171,0,0,1,512,0,8482299077
9899,7778872181,6488,7778878669,5,0,1,15872,5,3029401335
9900,7779042158,45752,7779087910,9,0,0,1536,9,5453317405
9901,7779060557,43904,7779104461,9,0,0,512,9,5552661158
9902,7779148963,10241,7779159204,1,0,1,16384,1,2326521270
9903,7779155880,57708,7779213588,6,0,0,512,6,4152464451
9904,7779177017,2946,7779179963,2,0,1,3072,2,6450468872
9905,7779187179,5971,7779193150,1,0,1,14848,1,450076939
9906,7779204965,566,7779205531,1,0,1,512,1,4021414468
9907,7779250479,48980,7779299459,6,0,0,2048,6,4031110058
9908,7779283902,51346,7779335248,2,0,0,1024,2,5580466906
9909,7779291083,60261,7779351344,8,0,0,1024,8,2310310370
9910,7779324789,43904,7779368693,9,0,0,512,9,765739166
9911,7779365497,1994,7779367491,4,0,1,2048,4,2059068283
9912,7779376941,74360,7779451301,4,0,0,9728,4,7065870111
9913,7779557963,2470,7779560433,4,0,1,2560,4,2775195970
9914,7779571372,45596,7779616968,6,0,0,1024,6,3769826527
9915,7779572402,52364,7779624766,8,0,0,3072,8,7461332355
9916,7779623384,5326,7779628710,1,0,1,5632,1,8944792594
9917,7779666654,121463,7779788117,6,0,0,1536,6,2223443208
9918,7779708978,1518,7779710496,2,0,1,1536,2,4056420752
9919,7779781468,45596,7779827064,3,0,0,1024,3,9587597026
9920,7779905354,45596,7779950950,6,0,0,1024,6,3427917458
9921,7779929809,50672,7779980481,6,0,0,2560,6,4444925569
9922,7779932943,4374,7779937317,1,0,1,4608,1,10378378732
9923,7779945629,60418,7780006047,8,0,0,512,8,1415314353
9924,7779964516,4679,7779969195,2,0,1,12288,2,4362390159
9925,7779990001,1994,7779991995,6,0,1,2048,6,8560111438
9926,7780056390,43904,7780100294,6,0,0,512,6,3209246449
9927,7780496538,4374,7780500912,1,0,1,4608,1,9030032927
9928,7780503455,54056,7780557511,6,0,0,3584,6,9673363858
9929,7780601875,3898,7780605773,6,0,1,4096,6,8673283941
9930,7780863002,32041,7780895043,8,0,1,52224,8,760103090
9931,7780999188,86249,7781085437,2,0,0,2048,2,6883341850
9932,7781036440,43904,7781080344,9,0,0,512,9,6458784132
9933,7781037068,66814,7781103882,8,0,0,1024,8,3234210714
9934,7781156873,5326,7781162199,2,0,1,5632,2,2935619226
9935,7781274237,47288,7781321525,9,0,0,1536,9,1068933505
9936,7781324706,4850,7781329556,6,0,1,5120,6,4740708091
9937,7781356712,2946,7781359658,7,0,1,3072,7,3518743272
9938,7781395139,2470,7781397609,2,0,1,2560,2,7390216539
9939,7781416803,110868,7781527671,7,0,0,31744,7,1914085567
9940,7781474073,2946,7781477019,7,0,1,3072,7,6420958097
9941,7781722423,7706,7781730129,1,0,1,8192,1,2194009220
9942,7781795782,1994,7781797776,1,0,1,2048,1,984895220
9943,7781857404,2470,7781859874,4,0,1,2560,4,2305270009
9944,7781938233,13600,7781951833,5,0,1,23040,5,10125578175
9945,7781978277,1042,7781979319,6,0,1,1024,6,1337680591
9946,7782088231,1042,7782089273,2,0,1,1024,2,3107131685
9947,7782136577,4162,7782140739,8,0,1,11264,8,755823572
9948,7782186731,1042,7782187773,1,0,1,1024,1,4559958927
9949,7782209622,2946,7782212568,6,0,1,3072,6,8911812720
9950,7782230708,43904,7782274612,8,0,0,512,8,2561512428
9951,7782273234,43904,7782317138,3,0,0,512,3,1982200757
9952,7782290393,2470,7782292863,6,0,1,2560,6,3437443944
9953,7782295685,2470,7782298155,2,0,1,2560,2,5851609905
9954,7782427903,47288,7782475191,9,0,0,1536,9,4577332905
9955,7782500392,6488,7782506880,0,0,1,15872,0,4614666860
9956,7782671645,43904,7782715549,8,0,0,512,8,6588643714
9957,7782698900,3904,7782702804,1,0,1,10752,1,4620537118
9958,7782891357,101192,7782992549,1,0,0,32256,1,6748634275
9959,7782932808,7706,7782940514,2,0,1,8192,2,3964499429
9960,7782956831,43904,7783000735,2,0,0,512,2,8581647897
9961,7783064724,43904,7783108628,8,0,0,512,8,8782359573
9962,7783071569,83600,7783155169,4,0,0,14848,4,4315905318
9963,7783153522,45543,7783199065,9,0,0,512,9,8688858772
9964,7783168165,74852,7783243017,4,0,0,16384,4,8633758958
9965,7783328924,43904,7783372828,9,0,0,512,9,6273167099
9966,7783349199,15321,7783364520,0,0,1,29696,0,8500493939
9967,7783369447,2946,7783372393,1,0,1,3072,1,7418651707
9968,7783467994,108831,7783576825,2,0,0,512,2,703919166
9969,7783532133,2470,7783534603,0,0,1,2560,0,9173618171
9970,7783544043,566,7783544609,1,0,1,512,1,3499533603
9971,7783733674,5326,7783739000,5,0,1,5632,5,5546395159
9972,7783767786,11533,7783779319,8,0,1,18944,8,5405012231
9973,7783821044,2870,7783823914,7,0,1,8704,7,3770008024
9974,7783829844,2946,7783832790,2,0,1,3072,2,6527649978
9975,7783830567,44166,7783874733,9,0,0,512,9,7120187288
9976,7783889824,47288,7783937112,8,0,0,1536,8,7740416310
9977,7783909409,2946,7783912355,0,0,1,3072,0,5688278643
9978,7783987520,2470,7783989990,0,0,1,2560,0,1192507009
9979,7784001770,43904,7784045674,3,0,0,512,3,6704015056
9980,7784008074,11016,7784019090,5,0,1,17920,5,9098890833
9981,7784039980,47288,7784087268,8,0,0,1536,8,7796866839
9982,7784083139,6278,7784089417,7,0,1,6656,7,6435695447
9983,7784197248,2870,7784200118,2,0,1,8704,2,8285673018
9984,7784282762,45596,7784328358,3,0,0,1024,3,9157658109
9985,7784373081,566,7784373647,0,0,1,512,0,9109446635
9986,7784385620,14287,7784399907,0,0,1,27648,0,9402614208
9987,7784423928,2470,7784426398,4,0,1,2560,4,2956036548
9988,7784495035,165630,7784660665,1,0,0,26624,1,389923018
9989,7784547416,2870,7784550286,6,0,1,8704,6,7741125060
9990,7784553062,2470,7784555532,4,0,1,2560,4,9552213421
9991,7784586895,50672,7784637567,2,0,0,2560,2,3606311237
9992,7784644570,2946,7784647516,4,0,1,3072,4,1216062227
9993,7784661638,3422,7784665060,6,0,1,3584,6,8341957322
9994,7784736251,191216,7784927467,7,0,0,166400,7,9486821128
9995,7784772446,197651,7784970097,4,0,0,78336,4,10068097458
9996,7784790454,81009,7784871463,3,0,0,512,3,7681596312
9997,7784797050,1518,7784798568,6,0,1,1536,6,10407055047
9998,7784797986,75013,7784872999,0,0,0,512,0,8302562969
9999,7784808451,161973,7784970424,8,0,0,1024,8,1355832599
