RequestID,ArrivalTime,DelayTime,FinishTime,InitiatorID,TargetID,IOType,Size,VolumeID,Offset
0,3142051567,566,3142052133,13,0,1,512,13,8550204401
1,3142071879,2470,3142074349,3,0,1,2560,3,6740288805
2,3142087982,43904,3142131886,5,0,0,512,5,1358108639
3,3142090802,2470,3142093272,2,0,1,2560,2,4782985906
4,3142098946,5454,3142104400,15,0,1,13824,15,8618153691
5,3142113048,183170,3142296218,18,0,0,70144,18,10026139675
6,3142129950,86103,3142216053,15,0,0,17920,15,7119599686
7,3142132929,13858,3142146787,9,0,1,23552,9,8721637664
8,3142146383,205178,3142351561,4,0,0,1536,4,8910680356
9,3142175932,175138,3142351070,1,0,0,3072,1,2111760466
10,3142179512,170599,3142350111,13,0,0,68608,13,7726293779
11,3142234767,205575,3142440342,9,0,0,75264,9,2771481889
12,3142257325,213703,3142471028,3,0,0,32768,3,4680744172
13,3142263024,7706,3142270730,18,0,1,8192,18,3146221499
14,3142307769,196263,3142504032,16,0,0,56320,16,8756773407
15,3142309062,6754,3142315816,6,0,1,7168,6,3138835883
16,3142336290,18176,3142354466,0,0,1,3072,0,4826389081
17,3142347830,252174,3142600004,7,0,0,37888,7,7471351654
18,3142473460,5326,3142478786,14,0,1,5632,14,1329705195
19,3142512930,566,3142513496,1,0,1,512,1,5592747967
20,3142612334,4374,3142616708,14,0,1,4608,14,4914297981
21,3142701640,108921,3142810561,17,0,0,14848,17,765372016
22,3142702043,65900,3142767943,13,0,0,7168,13,572742033
23,3142789355,122408,3142911763,11,0,0,101888,11,9644476458
24,3142811696,1994,3142813690,1,0,1,2048,1,4190000384
25,3142832688,95107,3142927795,14,0,0,1024,14,4725534063
26,3142846202,2470,3142848672,5,0,1,2560,5,4755225280
27,3142859620,176067,3143035687,9,0,0,47616,9,338519019
28,3142869082,201826,3143070908,10,0,0,56320,10,5429593321
29,3142870845,1518,3142872363,1,0,1,1536,1,7007290106
30,3142901899,95358,3142997257,12,0,0,1024,12,5902657866
31,3142902638,20675,3142923313,13,0,1,18944,13,4498616249
32,3142933191,120542,3143053733,15,0,0,45056,15,6630898297
33,3142958740,112495,3143071235,3,0,0,1024,3,9812454446
34,3143009889,85903,3143095792,4,0,0,1024,4,10240469179
35,3143012275,3898,3143016173,7,0,1,4096,7,6216397019
36,3143017534,18168,3143035702,9,0,1,10240,9,5139409780
37,3143086382,3422,3143089804,3,0,1,3584,3,5048346965
38,3143131015,92552,3143223567,0,0,0,24064,0,7701535105
39,3143158811,48980,3143207791,8,0,0,2048,8,3911794737
40,3143201226,52364,3143253590,11,0,0,3072,11,1204529216
41,3143214740,8842,3143223582,6,0,1,1536,6,6621258350
42,3143400929,101660,3143502589,0,0,0,33792,0,4121242149
43,3143455734,82099,3143537833,8,0,0,1024,8,7947766560
44,3143485860,43904,3143529764,19,0,0,512,19,1290399939
45,3143491219,11393,3143502612,0,0,1,4096,0,3319312071
46,3143491496,56681,3143548177,8,0,0,1024,8,8368925338
47,3143521448,85628,3143607076,18,0,0,21504,18,184861166
48,3143555856,68362,3143624218,12,0,0,1024,12,8024056572
49,3143594602,12489,3143607091,1,0,1,8192,1,8370281634
50,3143630751,1518,3143632269,6,0,1,1536,6,5608038979
51,3143644411,2470,3143646881,1,0,1,2560,1,4437478691
52,3143652270,3898,3143656168,1,0,1,4096,1,9539736240
53,3143708353,7230,3143715583,15,0,1,7680,15,8351996918
54,3143724207,149558,3143873765,10,0,0,46592,10,2502719030
55,3143750916,4850,3143755766,14,0,1,5120,14,3512678497
56,3143800408,140479,3143940887,8,0,0,38912,8,3473447512
57,3143880346,43904,3143924250,5,0,0,512,5,7957399451
58,3143993509,1042,3143994551,15,0,1,1024,15,3234725125
59,3144030627,6278,3144036905,9,0,1,6656,9,5507705147
60,3144076075,45596,3144121671,14,0,0,1024,14,9621673290
61,3144110445,82820,3144193265,8,0,0,12288,8,5188664257
62,3144116073,45596,3144161669,19,0,0,1024,19,3956242602
63,3144165267,5196,3144170463,3,0,1,13312,3,10356267751
64,3144178348,43904,3144222252,1,0,0,512,1,9889331503
65,3144206516,193840,3144400356,8,0,0,28160,8,6862452942
66,3144216052,7230,3144223282,5,0,1,7680,5,10631654799
67,3144225727,2946,3144228673,11,0,1,3072,11,8220715012
68,3144234068,179434,3144413502,6,0,0,15360,6,2432516461
69,3144265301,48980,3144314281,1,0,0,2048,1,2699482096
70,3144301977,106815,3144408792,6,0,0,25600,6,273966771
71,3144322584,67139,3144389723,13,0,0,7168,13,6550172036
72,3144328596,5326,3144333922,13,0,1,5632,13,7042150303
73,3144349872,2470,3144352342,6,0,1,2560,6,7741527812
74,3144362106,1518,3144363624,11,0,1,1536,11,7220251515
75,3144391446,8925,3144400371,4,0,1,3072,4,10162818661
76,3144396121,12686,3144408807,7,0,1,1024,7,3546800338
77,3144407526,7010,3144414536,14,0,1,1024,14,8963053008
78,3144439438,86984,3144526422,17,0,0,15872,17,3713520485
79,3144453602,89878,3144543480,15,0,0,10240,15,837649290
80,3144472988,4850,3144477838,10,0,1,5120,10,9042272846
81,3144522995,108043,3144631038,0,0,0,43520,0,1455655373
82,3144591534,566,3144592100,18,0,1,512,18,5426162132
83,3144642577,4374,3144646951,18,0,1,4608,18,1498765755
84,3144644371,86204,3144730575,13,0,0,13312,13,5574141027
85,3144651662,45596,3144697258,5,0,0,1024,5,444860477
86,3144738495,77144,3144815639,15,0,0,13824,15,5148376522
87,3144803729,101036,3144904765,11,0,0,31744,11,2626036954
88,3144804197,47288,3144851485,17,0,0,1536,17,5846724229
89,3144828490,101438,3144929928,6,0,0,31232,6,2842695471
90,3144829048,105263,3144934311,7,0,0,14336,7,3773089896
91,3144891219,114399,3145005618,9,0,0,62464,9,841601238
92,3144904658,7805,3144912463,10,0,1,8192,10,981262595
93,3144919887,112239,3145032126,14,0,0,1024,14,4028418964
94,3144934529,1994,3144936523,11,0,1,2048,11,1369292670
95,3144945297,269453,3145214750,10,0,0,144896,10,7062184214
96,3144973501,154969,3145128470,1,0,0,23040,1,5746970267
97,3144980934,165990,3145146924,15,0,0,38912,15,7344909963
98,3145005343,2261,3145007604,7,0,1,2048,7,919834194
99,3145033505,221553,3145255058,17,0,0,12800,17,1842991507
100,3145042112,1042,3145043154,4,0,1,1024,4,2591115568
101,3145054808,1042,3145055850,0,0,1,1024,0,7554644984
102,3145100170,116631,3145216801,13,0,0,6656,13,178547622
103,3145147669,88441,3145236110,14,0,0,1024,14,9879028052
104,3145172603,50435,3145223038,11,0,1,6656,11,1884642834
105,3145279161,70532,3145349693,3,0,0,12288,3,10342293931
106,3145311141,71438,3145382579,11,0,0,8192,11,1605711736
107,3145340113,97316,3145437429,0,0,0,24576,0,1630854561
108,3145343147,178534,3145521681,7,0,0,139776,7,7746085499
109,3145353872,111993,3145465865,16,0,0,8192,16,9205419486
110,3145429393,8051,3145437444,3,0,1,10240,3,8963075082
111,3145458240,78365,3145536605,13,0,0,11264,13,3395428027
112,3145466240,2470,3145468710,2,0,1,2560,2,6739528661
113,3145485084,198380,3145683464,3,0,0,11264,3,2563815776
114,3145507202,107838,3145615040,6,0,0,10752,6,137699244
115,3145513054,12108,3145525162,11,0,1,3584,11,9217159153
116,3145515133,126778,3145641911,5,0,0,1024,5,5467564460
117,3145538832,102752,3145641584,3,0,0,37376,3,2982648784
118,3145680127,47233,3145727360,12,0,0,512,12,6066369170
119,3145718107,2470,3145720577,18,0,1,2560,18,3193149394
120,3145724367,54056,3145778423,17,0,0,3584,17,9803613406
121,3145730544,7706,3145738250,7,0,1,8192,7,5595905203
122,3145736057,4679,3145740736,5,0,1,12288,5,9956375324
123,3145756219,139943,3145896162,17,0,0,88064,17,9747944694
124,3145766265,4850,3145771115,5,0,1,5120,5,772468158
125,3145852404,45596,3145898000,5,0,0,1024,5,7424578982
126,3145867709,103844,3145971553,10,0,0,40960,10,6383685351
127,3145878858,19766,3145898624,11,0,1,2560,11,5579932045
128,3145928450,3387,3145931837,5,0,1,9728,5,6620619125
129,3145940249,128894,3146069143,8,0,0,8192,8,7117697787
130,3145953779,235159,3146188938,13,0,0,120320,13,3127353021
131,3146001782,108005,3146109787,18,0,0,13312,18,4201727663
132,3146012553,2470,3146015023,1,0,1,2560,1,9746469428
133,3146016320,566,3146016886,2,0,1,512,2,10719226780
134,3146030052,91711,3146121763,7,0,0,12288,7,1721160940
135,3146061644,147346,3146208990,9,0,0,39936,9,10301958717
136,3146076029,249922,3146325951,6,0,0,79360,6,6439236598
137,3146096270,13532,3146109802,4,0,1,17920,4,7774896992
138,3146196220,48980,3146245200,7,0,0,2048,7,9533559283
139,3146196694,105062,3146301756,10,0,0,41472,10,7698415517
140,3146294361,77392,3146371753,12,0,0,1024,12,1552901678
141,3146298377,134564,3146432941,1,0,0,50176,1,9890052307
142,3146309781,16778,3146326559,6,0,1,512,6,10161034161
143,3146337041,109061,3146446102,16,0,0,2560,16,5970467583
144,3146374304,96404,3146470708,12,0,0,1536,12,8039830803
145,3146387319,239623,3146626942,10,0,0,60928,10,783915393
146,3146389663,84791,3146474454,6,0,0,8704,6,2929132478
147,3146396079,3898,3146399977,15,0,1,4096,15,3100003849
148,3146413261,1042,3146414303,18,0,1,1024,18,4940979113
149,3146424443,136670,3146561113,0,0,0,50176,0,1485541086
150,3146429121,10066,3146439187,0,0,1,15360,0,4233757788
151,3146445742,3222,3146448964,5,0,1,8704,5,4950956657
152,3146489447,150302,3146639749,0,0,0,41984,0,561265379
153,3146520278,124010,3146644288,6,0,0,14848,6,3548126099
154,3146659723,102440,3146762163,15,0,0,36352,15,2715435838
155,3146679422,3904,3146683326,4,0,1,10752,4,7509969653
156,3146679985,159860,3146839845,1,0,0,53248,1,6859353405
157,3146820006,19854,3146839860,7,0,1,7168,7,1574647507
158,3146832242,8176,3146840418,15,0,1,512,15,2892510417
159,3146864573,203927,3147068500,0,0,0,204288,0,4273165729
160,3146876049,196389,3147072438,3,0,0,8192,3,9158982386
161,3146911459,4374,3146915833,11,0,1,4608,11,5314125551
162,3146922085,4850,3146926935,14,0,1,5120,14,9278673224
163,3146927023,146226,3147073249,5,0,0,2560,5,1128107321
164,3146975025,94902,3147069927,16,0,0,4608,16,9840600906
165,3146995205,78215,3147073420,19,0,0,512,19,4627604563
166,3147021836,93944,3147115780,12,0,0,1536,12,172773159
167,3147042041,36017,3147078058,9,0,1,12288,9,10548646525
168,3147045266,34098,3147079364,6,0,1,2048,6,6646971512
169,3147113738,82376,3147196114,9,0,0,15872,9,10407748772
170,3147123710,88520,3147212230,8,0,0,15872,8,7435898073
171,3147145886,77685,3147223571,6,0,0,6144,6,5470351151
172,3147161055,51970,3147213025,12,0,0,2560,12,5358112127
173,3147267408,50672,3147318080,12,0,0,2560,12,2905501781
174,3147325766,11533,3147337299,10,0,1,18944,10,8305422110
175,3147337407,43904,3147381311,4,0,0,512,4,2035694197
176,3147382578,1518,3147384096,4,0,1,1536,4,7195755622
177,3147385256,6229,3147391485,18,0,1,15360,18,9576997271
178,3147472305,100724,3147573029,9,0,0,30720,9,2622028178
179,3147501459,52314,3147553773,14,0,0,512,14,19621630
180,3147573416,99164,3147672580,6,0,0,25600,6,475465940
181,3147612345,95077,3147707422,9,0,0,12800,9,2712203730
182,3147679846,43904,3147723750,4,0,0,512,4,3740282692
183,3147764059,89324,3147853383,18,0,0,23552,18,8312538466
184,3147781158,3128,3147784286,7,0,1,9216,7,9240895197
185,3147797683,80372,3147878055,11,0,0,14336,11,2341728665
186,3147806996,3898,3147810894,1,0,1,4096,1,2311788098
187,3147830123,59932,3147890055,4,0,0,512,4,2035707662
188,3147885403,3898,3147889301,6,0,1,4096,6,8238944512
189,3147933749,1042,3147934791,1,0,1,1024,1,1594880598
190,3147951776,4850,3147956626,16,0,1,5120,16,7598965951
191,3147959317,3898,3147963215,11,0,1,4096,11,9730738281
192,3147963596,6278,3147969874,0,0,1,6656,0,9710297970
193,3147991053,3387,3147994440,11,0,1,9728,11,9276083524
194,3148026873,179376,3148206249,6,0,0,38912,6,8038571879
195,3148041837,60980,3148102817,0,0,0,6144,0,4309293885
196,3148077861,2946,3148080807,4,0,1,3072,4,2619040097
197,3148096522,566,3148097088,14,0,1,512,14,801795641
198,3148102616,91762,3148194378,8,0,0,15872,8,5068671530
199,3148115729,1518,3148117247,9,0,1,1536,9,3590488638
200,3148137344,6278,3148143622,0,0,1,6656,0,4525518719
201,3148214594,3904,3148218498,3,0,1,10752,3,10430058037
202,3148227724,566,3148228290,9,0,1,512,9,10073339841
203,3148289276,161519,3148450795,3,0,0,25600,3,9409865468
204,3148307167,1994,3148309161,3,0,1,2048,3,1872889892
205,3148321643,143207,3148464850,9,0,0,46080,9,10586110855
206,3148366521,101152,3148467673,10,0,0,9216,10,8401807263
207,3148396094,81274,3148477368,7,0,0,5632,7,4717628481
208,3148396576,159747,3148556323,7,0,0,84992,7,7905291856
209,3148424494,86984,3148511478,5,0,0,512,5,6921300341
210,3148465191,153142,3148618333,15,0,0,20992,15,10731198014
211,3148473298,4374,3148477672,11,0,1,4608,11,8459505318
212,3148495765,2470,3148498235,10,0,1,2560,10,429569583
213,3148505213,65924,3148571137,8,0,0,12288,8,726373429
214,3148552628,108461,3148661089,8,0,0,17920,8,8545014011
215,3148624359,3904,3148628263,13,0,1,10752,13,8696238700
216,3148658206,48471,3148706677,4,0,0,1024,4,6285431279
217,3148679027,92996,3148772023,7,0,0,20480,7,5400008321
218,3148684234,2946,3148687180,11,0,1,3072,11,944461014
219,3148710144,6754,3148716898,14,0,1,7168,14,9892241137
220,3148720552,58746,3148779298,5,0,0,512,5,2548655604
221,3148756435,43904,3148800339,5,0,0,512,5,5689570976
222,3148782704,108992,3148891696,1,0,0,57856,1,5989192009
223,3148795799,144971,3148940770,19,0,0,1024,19,75928246
224,3148799103,179386,3148978489,15,0,0,27648,15,3723480114
225,3148821294,121012,3148942306,4,0,0,1024,4,41591400
226,3148836670,133380,3148970050,17,0,0,87040,17,7512028265
227,3148879160,199102,3149078262,16,0,0,114176,16,5410680450
228,3148889718,4465,3148894183,1,0,1,2560,1,3975190483
229,3148912351,1994,3148914345,3,0,1,2048,3,1798773144
230,3148932142,64208,3148996350,6,0,0,6656,6,6401481474
231,3148961541,18458,3148979999,1,0,1,1536,1,7881242903
232,3148987113,126259,3149113372,13,0,0,34816,13,2026730625
233,3148993794,2571,3148996365,3,0,1,1024,3,5834199249
234,3149001727,2470,3149004197,16,0,1,2560,16,4181487803
235,3149019673,151917,3149171590,8,0,0,28160,8,3036935554
236,3149067911,76243,3149144154,13,0,0,7168,13,8458797372
237,3149071074,8723,3149079797,5,0,1,1536,5,7764918093
238,3149139897,102776,3149242673,17,0,0,11776,17,7508378038
239,3149255814,5196,3149261010,5,0,1,13312,5,10616531812
240,3149291891,63471,3149355362,18,0,0,3072,18,5921189574
241,3149311095,3422,3149314517,4,0,1,3584,4,10093908670
242,3149345737,103220,3149448957,0,0,0,38912,0,2112560320
243,3149368285,116451,3149484736,7,0,0,17920,7,5838372612
244,3149373166,3422,3149376588,18,0,1,3584,18,9592439830
245,3149378610,3422,3149382032,3,0,1,3584,3,8533697791
246,3149445629,53992,3149499621,8,0,0,2560,8,8870177247
247,3149466469,43904,3149510373,19,0,0,512,19,266648190
248,3149508600,108212,3149616812,16,0,0,55296,16,6055067047
249,3149535368,90966,3149626334,17,0,0,14848,17,4410301068
250,3149536307,7706,3149544013,9,0,1,8192,9,2684565338
251,3149557015,1994,3149559009,4,0,1,2048,4,8120078307
252,3149579791,96224,3149676015,6,0,0,20992,6,10129557713
253,3149597140,173193,3149770333,16,0,0,10752,16,8441656897
254,3149608001,98421,3149706422,0,0,0,13312,0,1309485374
255,3149611503,65627,3149677130,7,0,0,3584,7,7981157402
256,3149631601,4374,3149635975,16,0,1,4608,16,10446766875
257,3149665786,99221,3149765007,18,0,0,18432,18,415214971
258,3149670504,54483,3149724987,6,0,0,2048,6,9033362438
259,3149728450,1518,3149729968,2,0,1,1536,2,2810941003
260,3149733154,14287,3149747441,2,0,1,27648,2,5232667004
261,3149779677,3422,3149783099,1,0,1,3584,1,4110857610
262,3149783682,109906,3149893588,13,0,0,35328,13,10626599746
263,3149785203,4162,3149789365,6,0,1,11264,6,562813068
264,3149790173,329621,3150119794,13,0,0,21504,13,6204700593
265,3149791337,209265,3150000602,3,0,0,31744,3,323035697
266,3149797542,254494,3150052036,1,0,0,122880,1,2437244968
267,3149808529,3645,3149812174,16,0,1,10240,16,4214648861
268,3149810309,281582,3150091891,13,0,0,44544,13,414449571
269,3149847562,124812,3149972374,11,0,0,44032,11,5362292871
270,3149946926,147164,3150094090,7,0,0,7168,7,6602107613
271,3149977172,152162,3150129334,9,0,0,10240,9,9190260061
272,3149999435,78869,3150078304,17,0,0,10240,17,1640276340
273,3150050696,2850,3150053546,15,0,1,1536,15,1127269740
274,3150052906,6278,3150059184,13,0,1,6656,13,9876659918
275,3150124987,566,3150125553,4,0,1,512,4,4562799474
276,3150133241,104156,3150237397,17,0,0,41984,17,5619034152
277,3150188070,1042,3150189112,2,0,1,1024,2,3855802022
278,3150249478,100412,3150349890,6,0,0,29696,6,5189805534
279,3150275761,180722,3150456483,13,0,0,144384,13,1117534101
280,3150295283,3422,3150298705,13,0,1,3584,13,10151818965
281,3150296714,5454,3150302168,11,0,1,13824,11,111643403
282,3150332022,2870,3150334892,7,0,1,8704,7,10073088375
283,3150358673,120413,3150479086,6,0,0,36352,6,3572223827
284,3150370701,169029,3150539730,1,0,0,74240,1,5227766120
285,3150406592,204843,3150611435,6,0,0,27136,6,813003503
286,3150422353,118492,3150540845,13,0,0,3584,13,6718793503
287,3150454483,224267,3150678750,11,0,0,29184,11,2253198714
288,3150473893,8131,3150482024,18,0,1,3072,18,7372204345
289,3150487205,63595,3150550800,15,0,0,3584,15,10381308043
290,3150503353,133421,3150636774,17,0,0,52736,17,7664957494
291,3150516939,146864,3150663803,16,0,0,57856,16,4487415465
292,3150522345,19050,3150541395,11,0,1,512,11,6125350616
293,3150537877,218299,3150756176,17,0,0,33280,17,4210483264
294,3150566082,70863,3150636945,10,0,0,512,10,5054770846
295,3150596490,149531,3150746021,16,0,0,40448,16,4389767667
296,3150600826,160513,3150761339,16,0,0,16896,16,4288319906
297,3150640926,1994,3150642920,5,0,1,2048,5,2562055790
298,3150709162,3898,3150713060,13,0,1,4096,13,8150156824
299,3150871132,109928,3150981060,13,0,0,60928,13,8110386361
300,3150876010,177632,3151053642,1,0,0,71168,1,1132018783
301,3150894449,114246,3151008695,19,0,0,512,19,8479847003
302,3150907120,157610,3151064730,8,0,0,11776,8,7335471545
303,3150941320,5802,3150947122,14,0,1,6144,14,2896633119
304,3150957342,2946,3150960288,10,0,1,3072,10,10612997689
305,3150957776,61168,3151018944,5,0,0,1536,5,3969228977
306,3150960849,55293,3151016142,10,0,0,1536,10,4223126920
307,3150964876,60080,3151024956,15,0,0,512,15,560726140
308,3150967897,138533,3151106430,15,0,0,39936,15,9673770069
309,3151048225,11211,3151059436,13,0,1,6144,13,9057235840
310,3151056548,112233,3151168781,3,0,0,5632,3,4573220033
311,3151081538,71800,3151153338,11,0,0,5120,11,7480136581
312,3151094442,15402,3151109844,15,0,1,3584,15,5428917815
313,3151112958,45596,3151158554,4,0,0,1024,4,6057420313
314,3151131611,43904,3151175515,12,0,0,512,12,10083330475
315,3151187730,52676,3151240406,6,0,0,4096,6,9627743446
316,3151227337,6488,3151233825,3,0,1,15872,3,6171415971
317,3151232912,4850,3151237762,0,0,1,5120,0,9764829793
318,3151244852,5326,3151250178,13,0,1,5632,13,3699492932
319,3151252424,52364,3151304788,3,0,0,3072,3,3296368084
320,3151333163,3422,3151336585,10,0,1,3584,10,7131281974
321,3151339772,79304,3151419076,9,0,0,15872,9,10569196934
322,3151345670,3645,3151349315,4,0,1,10240,4,2627782282
323,3151376992,1042,3151378034,15,0,1,1024,15,3117489979
324,3151428556,2470,3151431026,2,0,1,2560,2,8218504264
325,3151433796,104000,3151537796,0,0,0,41472,0,9083407502
326,3151445708,133908,3151579616,17,0,0,17408,17,4602272668
327,3151476421,2946,3151479367,16,0,1,3072,16,6959724455
328,3151524701,140764,3151665465,0,0,0,89600,0,1525349634
329,3151586437,82190,3151668627,8,0,0,3072,8,493313412
330,3151586883,126262,3151713145,18,0,0,11776,18,7482086505
331,3151600955,80996,3151681951,15,0,0,16384,15,7948566599
332,3151617651,3422,3151621073,16,0,1,3584,16,5149200112
333,3151651583,149276,3151800859,10,0,0,71680,10,8994552627
334,3151687208,153427,3151840635,16,0,0,47104,16,7399729278
335,3151758070,1042,3151759112,2,0,1,1024,2,2063147021
336,3151830460,126647,3151957107,8,0,0,82432,8,3105950227
337,3151906363,5802,3151912165,10,0,1,6144,10,9066155527
338,3151911136,6754,3151917890,3,0,1,7168,3,7056356397
339,3151988107,1518,3151989625,11,0,1,1536,11,5831079585
340,3151996210,3422,3151999632,15,0,1,3584,15,6655133506
341,3152002604,6754,3152009358,1,0,1,7168,1,5554677656
342,3152026079,205666,3152231745,17,0,0,65536,17,9022915450
343,3152091689,52364,3152144053,9,0,0,3072,9,6065566974
344,3152098492,3645,3152102137,10,0,1,10240,10,2113623513
345,3152099092,3391,3152102483,3,0,1,512,3,4698260224
346,3152100317,3152,3152103469,9,0,1,1536,9,4112173092
347,3152141754,7706,3152149460,18,0,1,8192,18,8121443299
348,3152151020,80904,3152231924,14,0,0,512,14,9588161968
349,3152156776,566,3152157342,2,0,1,512,2,815173899
350,3152210883,85390,3152296273,11,0,0,11264,11,6292533359
351,3152224528,218782,3152443310,3,0,0,50176,3,3978073267
352,3152256426,81495,3152337921,4,0,0,1024,4,6633067578
353,3152267685,189220,3152456905,1,0,0,44544,1,8162653272
354,3152278894,69908,3152348802,18,0,0,10240,18,720328592
355,3152289112,7176,3152296288,11,0,1,5632,11,4878471732
356,3152370469,119725,3152490194,6,0,0,10240,6,7639836436
357,3152380700,566,3152381266,11,0,1,512,11,2190153141
358,3152392029,124703,3152516732,12,0,0,512,12,9211261314
359,3152412566,12566,3152425132,14,0,1,20992,14,2440066894
360,3152431802,129329,3152561131,16,0,0,44544,16,5589281581
361,3152488959,105938,3152594897,14,0,0,1536,14,2304281426
362,3152647960,7230,3152655190,5,0,1,7680,5,2956093794
363,3152665347,103688,3152769035,16,0,0,40448,16,8333172113
364,3152676421,112535,3152788956,9,0,0,27136,9,9752243713
365,3152690941,3387,3152694328,7,0,1,9728,7,4093446939
366,3152729281,197223,3152926504,13,0,0,27136,13,10652788260
367,3152745636,7706,3152753342,13,0,1,8192,13,7810246677
368,3152772487,168933,3152941420,7,0,0,30720,7,6552009401
369,3152778623,45913,3152824536,4,0,0,512,4,3766744462
370,3152836694,1518,3152838212,9,0,1,1536,9,1233638629
371,3152887560,54343,3152941903,5,0,0,1536,5,10244945049
372,3152908678,1042,3152909720,5,0,1,1024,5,3381652066
373,3152922644,9178,3152931822,9,0,1,5632,9,9552798515
374,3152974214,2470,3152976684,0,0,1,2560,0,3172940904
375,3152981739,6278,3152988017,0,0,1,6656,0,911100403
376,3152995257,64208,3153059465,19,0,0,6656,19,719325574
377,3153000760,45596,3153046356,3,0,0,1024,3,8919657530
378,3153006471,131012,3153137483,3,0,0,29696,3,5751758953
379,3153020446,3898,3153024344,13,0,1,4096,13,1076122853
380,3153035826,43904,3153079730,4,0,0,512,4,3441263408
381,3153037511,156031,3153193542,11,0,0,7680,11,2237252934
382,3153060578,1042,3153061620,3,0,1,1024,3,7960711757
383,3153067769,167173,3153234942,8,0,0,57856,8,5238815684
384,3153109139,566,3153109705,5,0,1,512,5,1875415092
385,3153147274,3645,3153150919,3,0,1,10240,3,4683028141
386,3153150573,178959,3153329532,9,0,0,57344,9,123360195
387,3153153597,2946,3153156543,15,0,1,3072,15,10124008143
388,3153178108,121382,3153299490,7,0,0,50688,7,8220000825
389,3153199136,1994,3153201130,0,0,1,2048,0,1129276547
390,3153234065,6195,3153240260,10,0,1,5632,10,2927690774
391,3153301025,3128,3153304153,7,0,1,9216,7,3268949148
392,3153406657,11533,3153418190,5,0,1,18944,5,1585965949
393,3153411993,9103,3153421096,15,0,1,4608,15,9021699785
394,3153428855,43904,3153472759,19,0,0,512,19,3478427093
395,3153469467,1042,3153470509,4,0,1,1024,4,2094179462
396,3153506974,98880,3153605854,14,0,0,512,14,5482407299
397,3153632164,102596,3153734760,11,0,0,36864,11,2100602508
398,3153640885,94210,3153735095,12,0,0,1024,12,9451839158
399,3153685232,128008,3153813240,1,0,0,19968,1,2013224625
400,3153724353,100455,3153824808,16,0,0,15872,16,6769713402
401,3153732396,5161,3153737557,4,0,1,2560,4,6859813834
402,3153760037,2470,3153762507,13,0,1,2560,13,6682662582
403,3153764579,5326,3153769905,14,0,1,5632,14,7515075871
404,3153772605,3898,3153776503,3,0,1,4096,3,6387007918
405,3153791571,125817,3153917388,7,0,0,25088,7,848864782
406,3153796349,231859,3154028208,0,0,0,58880,0,9284684408
407,3153849889,3387,3153853276,1,0,1,9728,1,5521113210
408,3153850803,177584,3154028387,4,0,0,512,4,3886795539
409,3153874298,131033,3154005331,18,0,0,24064,18,5199658259
410,3153875266,91466,3153966732,9,0,0,18432,9,8898267277
411,3153952546,105797,3154058343,17,0,0,24576,17,2479792342
412,3153953738,566,3153954304,4,0,1,512,4,3532934317
413,3153975629,132760,3154108389,18,0,0,11264,18,7596945380
414,3154005851,3645,3154009496,18,0,1,10240,18,7674367325
415,3154017704,131600,3154149304,3,0,0,37376,3,7740640070
416,3154023550,5395,3154028945,11,0,1,512,11,2601118232
417,3154056669,157325,3154213994,5,0,0,1024,5,1521700173
418,3154098990,2470,3154101460,2,0,1,2560,2,10225014579
419,3154198138,129896,3154328034,8,0,0,126464,8,3015655872
420,3154243643,151207,3154394850,1,0,0,46080,1,4861704458
421,3154273501,75701,3154349202,16,0,0,7168,16,9767968889
422,3154277705,3422,3154281127,18,0,1,3584,18,9025822978
423,3154283280,5802,3154289082,1,0,1,6144,1,8174333037
424,3154304737,223517,3154528254,3,0,0,48128,3,10396085024
425,3154332691,180227,3154512918,10,0,0,53248,10,7504817124
426,3154378167,97335,3154475502,12,0,0,1024,12,6804232948
427,3154380515,44143,3154424658,12,0,0,512,12,5391730365
428,3154445144,85941,3154531085,17,0,0,9216,17,7928884353
429,3154465123,72005,3154537128,12,0,0,512,12,3341022258
430,3154513763,113179,3154626942,13,0,0,24064,13,5377158233
431,3154527117,120900,3154648017,1,0,0,69120,1,3047993777
432,3154567315,4374,3154571689,1,0,1,4608,1,10148740639
433,3154582007,67980,3154649987,19,0,0,3584,19,9953946648
434,3154582564,1994,3154584558,14,0,1,2048,14,6041087295
435,3154607470,7706,3154615176,11,0,1,8192,11,9855499286
436,3154613147,103795,3154716942,9,0,0,14336,9,5313529268
437,3154631437,20946,3154652383,11,0,1,4608,11,876982787
438,3154674717,184753,3154859470,15,0,0,75264,15,4879692671
439,3154717178,96256,3154813434,16,0,0,6144,16,1705364712
440,3154754687,566,3154755253,10,0,1,512,10,420051496
441,3154824969,566,3154825535,18,0,1,512,18,2576457056
442,3154847053,14403,3154861456,4,0,1,2048,4,3818448946
443,3154883463,2470,3154885933,11,0,1,2560,11,8708216450
444,3154930513,79443,3155009956,17,0,0,7168,17,6361444988
445,3154938461,7706,3154946167,4,0,1,8192,4,10538535812
446,3154945810,12737,3154958547,18,0,1,24576,18,9089314432
447,3154969387,108699,3155078086,8,0,0,17920,8,9425773686
448,3154969583,10757,3154980340,4,0,1,17408,4,7573986506
449,3155021123,122146,3155143269,18,0,0,24576,18,661898374
450,3155023423,6278,3155029701,6,0,1,6656,6,3020421092
451,3155040755,141445,3155182200,16,0,0,6656,16,2641454593
452,3155068840,163038,3155231878,8,0,0,99840,8,7871091889
453,3155108488,92955,3155201443,15,0,0,22528,15,2878331527
454,3155127668,1518,3155129186,4,0,1,1536,4,9321412804
455,3155157492,125498,3155282990,15,0,0,78336,15,4910412482
456,3155204535,29329,3155233864,0,0,1,2048,0,1048037997
457,3155414085,107120,3155521205,6,0,0,51712,6,10001731739
458,3155477093,104312,3155581405,11,0,0,42496,11,7397694812
459,3155586354,48980,3155635334,12,0,0,2048,12,3036585378
460,3155611946,113683,3155725629,17,0,0,65536,17,5376757054
461,3155623296,157594,3155780890,1,0,0,20480,1,2681191465
462,3155642194,63452,3155705646,15,0,0,9216,15,7253988631
463,3155690791,566,3155691357,15,0,1,512,15,9268620477
464,3155699351,1518,3155700869,10,0,1,1536,10,7742270173
465,3155708211,18928,3155727139,4,0,1,1536,4,8688454846
466,3155733878,99788,3155833666,3,0,0,27648,3,2788787915
467,3155740583,43904,3155784487,19,0,0,512,19,6615587984
468,3155752211,1994,3155754205,16,0,1,2048,16,6047143281
469,3155753048,3898,3155756946,0,0,1,4096,0,3093987020
470,3155753082,6130,3155759212,14,0,1,3584,14,8237470481
471,3155766311,1518,3155767829,18,0,1,1536,18,1850851633
472,3155797335,566,3155797901,18,0,1,512,18,601432448
473,3155860453,12825,3155873278,1,0,1,21504,1,6342782228
474,3155877073,45596,3155922669,19,0,0,1024,19,107832441
475,3155883792,4420,3155888212,6,0,1,11776,6,4873829485
476,3155938687,4850,3155943537,13,0,1,5120,13,10272243655
477,3156018375,108368,3156126743,1,0,0,55808,1,8636953756
478,3156036058,2946,3156039004,5,0,1,3072,5,10615759250
479,3156101144,116810,3156217954,3,0,0,49664,3,6603132967
480,3156105848,20910,3156126758,10,0,1,19456,10,1275360698
481,3156126120,76687,3156202807,0,0,0,10240,0,16543211
482,3156142524,160277,3156302801,18,0,0,105984,18,418673846
483,3156149024,69101,3156218125,12,0,0,512,12,2944603282
484,3156199656,204192,3156403848,3,0,0,147968,3,6008553729
485,3156244209,159966,3156404175,14,0,0,1024,14,4278563061
486,3156248526,205312,3156453838,18,0,0,31744,18,3242401534
487,3156260182,5326,3156265508,7,0,1,5632,7,10602704490
488,3156320731,92657,3156413388,11,0,0,5632,11,1831236569
489,3156387319,19318,3156406637,15,0,1,2560,15,4956512520
490,3156415793,57440,3156473233,8,0,0,4608,8,1478745172
491,3156440332,43904,3156484236,19,0,0,512,19,4133003454
492,3156474609,5802,3156480411,3,0,1,6144,3,7927229298
493,3156484693,77168,3156561861,9,0,0,18944,9,4158040363
494,3156531325,94349,3156625674,5,0,0,1536,5,10295858567
495,3156565936,100880,3156666816,13,0,0,31232,13,2551428881
496,3156588432,176862,3156765294,0,0,0,126464,0,1599644667
497,3156590754,92864,3156683618,9,0,0,25088,9,2703686282
498,3156690495,4937,3156695432,3,0,1,12800,3,9247221517
499,3156707958,6754,3156714712,3,0,1,7168,3,5520716168
500,3156722628,1042,3156723670,10,0,1,1024,10,3832304128
501,3156727210,114128,3156841338,7,0,0,10240,7,2076543365
502,3156803526,1042,3156804568,4,0,1,1024,4,4446417277
503,3156815142,167848,3156982990,15,0,0,15360,15,10603937614
504,3156823464,114532,3156937996,7,0,0,25088,7,5818855425
505,3156842496,3422,3156845918,7,0,1,3584,7,3573191266
506,3156855821,3422,3156859243,16,0,1,3584,16,8071950625
507,3156875841,566,3156876407,18,0,1,512,18,4787155281
508,3156879667,1042,3156880709,0,0,1,1024,0,709632714
509,3156940864,2946,3156943810,7,0,1,3072,7,7120702328
510,3156953746,107744,3157061490,9,0,0,53760,9,9971460108
511,3156979248,4793,3156984041,16,0,1,1024,16,9667929161
512,3156982278,44945,3157027223,12,0,0,512,12,735365618
513,3157026807,566,3157027373,3,0,1,512,3,1672095063
514,3157036766,3128,3157039894,14,0,1,9216,14,9329932564
515,3157065580,146459,3157212039,1,0,0,27136,1,10671100258
516,3157075023,1518,3157076541,15,0,1,1536,15,10378702285
517,3157156752,87608,3157244360,3,0,0,17920,3,9233761602
518,3157207412,90582,3157297994,11,0,0,16384,11,8549741638
519,3157266522,5802,3157272324,16,0,1,6144,16,2804009378
520,3157306820,81128,3157387948,15,0,0,11776,15,292687912
521,3157322353,101660,3157424013,8,0,0,33792,8,510892949
522,3157384458,47386,3157431844,14,0,0,512,14,10596812843
523,3157422074,102655,3157524729,16,0,0,30720,16,6875047279
524,3157454945,2870,3157457815,14,0,1,8704,14,10472864943
525,3157485252,45596,3157530848,4,0,0,1024,4,5256291156
526,3157488558,103532,3157592090,11,0,0,39936,11,5443085636
527,3157493466,76497,3157569963,11,0,0,6656,11,5589330077
528,3157525064,132834,3157657898,10,0,0,40960,10,10526203654
529,3157526483,566,3157527049,1,0,1,512,1,9964550180
530,3157545250,2946,3157548196,18,0,1,3072,18,6196257723
531,3157547475,5326,3157552801,7,0,1,5632,7,2204601842
532,3157570438,4162,3157574600,4,0,1,11264,4,5163827218
533,3157580431,79362,3157659793,15,0,0,6144,15,10497753702
534,3157632931,147312,3157780243,11,0,0,72192,11,4479376772
535,3157647758,19700,3157667458,5,0,1,8192,5,7405166789
536,3157677466,264948,3157942414,18,0,0,2048,18,1530799489
537,3157723340,131057,3157854397,6,0,0,57344,6,5542520625
538,3157726734,215041,3157941775,3,0,0,111104,3,7048945471
539,3157804239,159935,3157964174,13,0,0,20992,13,5332885399
540,3157808146,4162,3157812308,9,0,1,11264,9,1383698584
541,3157810868,71597,3157882465,19,0,0,1024,19,5958568416
542,3157814880,566,3157815446,18,0,1,512,18,9161515855
543,3157894747,1994,3157896741,15,0,1,2048,15,7310647229
544,3157950922,1042,3157951964,2,0,1,1024,2,274972226
545,3157966721,6754,3157973475,10,0,1,7168,10,5750317176
546,3158064358,2870,3158067228,7,0,1,8704,7,2965174364
547,3158078647,47288,3158125935,5,0,0,1536,5,1120358631
548,3158091827,52155,3158143982,19,0,0,1024,19,6750082161
549,3158154630,43904,3158198534,4,0,0,512,4,9902333309
550,3158164974,108368,3158273342,11,0,0,55808,11,10675859641
551,3158251731,217115,3158468846,1,0,0,34304,1,1126089091
552,3158261498,385674,3158647172,10,0,0,386560,10,7915374261
553,3158296308,368241,3158664549,17,0,0,41984,17,7123174527
554,3158322726,324617,3158647343,19,0,0,512,19,8789186523
555,3158332292,3422,3158335714,16,0,1,3584,16,10580706547
556,3158349853,2946,3158352799,13,0,1,3072,13,920021059
557,3158372843,3904,3158376747,7,0,1,10752,7,3894662200
558,3158441142,210592,3158651734,8,0,0,14336,8,749028443
559,3158465958,249247,3158715205,15,0,0,61440,15,8893261539
560,3158479702,3898,3158483600,3,0,1,4096,3,8983377225
561,3158490587,175857,3158666444,7,0,0,6144,7,6930838514
562,3158495550,178699,3158674249,0,0,0,7680,0,5285835237
563,3158549348,166808,3158716156,16,0,0,3072,16,1439279614
564,3158573693,157262,3158730955,7,0,0,6144,7,4928514902
565,3158596753,70717,3158667470,5,0,1,1024,5,6178221777
566,3158654294,15392,3158669686,11,0,1,3072,11,1448395669
567,3158667898,54597,3158722495,7,0,0,3584,7,8769941473
568,3158681951,55748,3158737699,1,0,0,4096,1,10291834311
569,3158719433,107588,3158827021,13,0,0,53248,13,388033183
570,3158740134,4850,3158744984,6,0,1,5120,6,8436470917
571,3158752002,2946,3158754948,15,0,1,3072,15,8437267764
572,3158791167,1042,3158792209,14,0,1,1024,14,6938816239
573,3158794574,167142,3158961716,16,0,0,64512,16,1508867772
574,3158797690,103642,3158901332,15,0,0,27648,15,4151163902
575,3158827560,77929,3158905489,10,0,0,1024,10,5671348677
576,3158869356,566,3158869922,18,0,1,512,18,3084807634
577,3158921484,48980,3158970464,19,0,0,2048,19,3881675187
578,3158963060,125684,3159088744,16,0,0,112640,16,2745664141
579,3158972128,117255,3159089383,5,0,0,2048,5,6061937144
580,3158985037,105312,3159090349,5,0,0,1536,5,4126139185
581,3158994525,95341,3159089866,14,0,0,1536,14,5579334252
582,3159007844,3422,3159011266,5,0,1,3584,5,2162957456
583,3159042305,87959,3159130264,13,0,0,9728,13,9376125035
584,3159181445,5454,3159186899,9,0,1,13824,9,9509667676
585,3159197762,12825,3159210587,5,0,1,21504,5,5410554
586,3159203734,54110,3159257844,12,0,0,512,12,3155811046
587,3159304304,62516,3159366820,11,0,0,6144,11,533509379
588,3159318739,144876,3159463615,15,0,0,69632,15,1703668952
589,3159333309,2870,3159336179,15,0,1,8704,15,9910702603
590,3159366501,113821,3159480322,13,0,0,54784,13,4037662592
591,3159420930,1518,3159422448,10,0,1,1536,10,3861400213
592,3159484157,4679,3159488836,15,0,1,12288,15,182505060
593,3159542881,5971,3159548852,9,0,1,14848,9,2627665207
594,3159554749,74441,3159629190,17,0,0,7680,17,6993496845
595,3159576808,2946,3159579754,14,0,1,3072,14,8763352232
596,3159593041,75959,3159669000,3,0,0,6144,3,5515333383
597,3159615290,53881,3159669171,12,0,0,512,12,10625371392
598,3159630341,3128,3159633469,13,0,1,9216,13,4376705886
599,3159644909,43904,3159688813,3,0,0,512,3,1276526038
600,3159650355,93475,3159743830,16,0,0,11776,16,3800950791
601,3159680963,6488,3159687451,14,0,1,15872,14,8141241562
602,3159726613,4420,3159731033,3,0,1,11776,3,3132342835
603,3159748456,49448,3159797904,15,0,0,3584,15,4838845530
604,3159789228,1042,3159790270,6,0,1,1024,6,2080240698
605,3159811759,3387,3159815146,3,0,1,9728,3,363962002
606,3159817606,157163,3159974769,6,0,0,58880,6,6497316962
607,3159831903,89792,3159921695,15,0,0,25088,15,8687948837
608,3159855335,81030,3159936365,5,0,0,1536,5,241068094
609,3159919921,131144,3160051065,10,0,0,34816,10,5588368131
610,3159925497,4162,3159929659,11,0,1,11264,11,5597204099
611,3159992069,1518,3159993587,4,0,1,1536,4,7924156335
612,3160014903,4374,3160019277,13,0,1,4608,13,10364868023
613,3160019804,93180,3160112984,4,0,0,512,4,8902637723
614,3160022236,107744,3160129980,15,0,0,53760,15,9073240336
615,3160030895,3898,3160034793,16,0,1,4096,16,6859238903
616,3160058059,139175,3160197234,13,0,0,41472,13,4447376160
617,3160145776,4850,3160150626,7,0,1,5120,7,3379504715
618,3160147071,171187,3160318258,9,0,0,53248,9,2258451886
619,3160164939,63507,3160228446,14,0,0,512,14,6717789285
620,3160244079,118700,3160362779,11,0,0,6144,11,6655512646
621,3160282209,145220,3160427429,15,0,0,60928,15,1823881550
622,3160299293,18980,3160318273,7,0,1,3584,7,747171525
623,3160417168,11295,3160428463,18,0,1,1024,18,10281415483
624,3160488926,566,3160489492,1,0,1,512,1,7783680273
625,3160511491,4850,3160516341,10,0,1,5120,10,3491770543
626,3160548105,43904,3160592009,17,0,0,512,17,1497667691
627,3160583285,95288,3160678573,16,0,0,17920,16,7581153790
628,3160605608,193461,3160799069,6,0,0,87552,6,4515918574
629,3160635405,110164,3160745569,16,0,0,8704,16,2800900401
630,3160641343,85018,3160726361,1,0,0,10240,1,9538376185
631,3160677163,90102,3160767265,9,0,0,21504,9,2091518373
632,3160749296,1042,3160750338,11,0,1,1024,11,1970446803
633,3160779630,129747,3160909377,0,0,0,60928,0,4058665135
634,3160794730,10158,3160804888,2,0,1,6144,2,9738779656
635,3160830267,83852,3160914119,14,0,0,1024,14,5653443054
636,3160863088,1518,3160864606,14,0,1,1536,14,5400544567
637,3160875971,61374,3160937345,4,0,0,512,4,9640093825
638,3160895535,14876,3160910411,13,0,1,1024,13,2755641674
639,3160912411,3387,3160915798,18,0,1,9728,18,1531069997
640,3160913246,126790,3161040036,10,0,0,77824,10,2848272538
641,3160914408,3043,3160917451,14,0,1,2048,14,9947697642
642,3160924446,90842,3161015288,16,0,0,12288,16,5571174769
643,3160949838,90385,3161040223,4,0,0,512,4,10569756237
644,3160991849,48701,3161040550,12,0,0,1024,12,7736626161
645,3161018736,71964,3161090700,3,0,0,2560,3,6009897821
646,3161022169,153406,3161175575,1,0,0,80896,1,1164508688
647,3161056104,4162,3161060266,14,0,1,11264,14,1693826071
648,3161061021,1994,3161063015,15,0,1,2048,15,7126594247
649,3161064346,146493,3161210839,9,0,0,27648,9,1400680928
650,3161068287,157387,3161225674,4,0,0,512,4,2678345924
651,3161077381,68597,3161145978,9,0,0,6656,9,1576879564
652,3161101082,1994,3161103076,5,0,1,2048,5,7805006019
653,3161108743,88821,3161197564,11,0,0,9728,11,9869097885
654,3161141142,84811,3161225953,19,0,0,512,19,3051967982
655,3161145293,152066,3161297359,1,0,0,22016,1,33513028
656,3161215184,12308,3161227492,10,0,1,20480,10,5127193678
657,3161279662,305347,3161585009,17,0,0,512,17,1298896473
658,3161280290,5802,3161286092,14,0,1,6144,14,9228483641
659,3161297045,56403,3161353448,5,0,0,1024,5,47952382
660,3161297302,2544,3161299846,9,0,1,2560,9,6084891967
661,3161346396,1042,3161347438,18,0,1,1024,18,4944632180
662,3161371569,146483,3161518052,1,0,0,5632,1,9342487348
663,3161372969,1994,3161374963,2,0,1,2048,2,1089648964
664,3161390838,194000,3161584838,1,0,0,170496,1,8234905776
665,3161424042,83390,3161507432,16,0,0,1024,16,217523299
666,3161443117,4374,3161447491,7,0,1,4608,7,4918390640
667,3161448917,193401,3161642318,0,0,0,64512,0,6978626166
668,3161510246,1518,3161511764,10,0,1,1536,10,3507650939
669,3161554340,188181,3161742521,8,0,0,28672,8,8932544693
670,3161565774,21764,3161587538,13,0,1,2560,13,2352181592
671,3161575853,66651,3161642504,4,0,0,512,4,3260244021
672,3161577215,156555,3161733770,15,0,0,29696,15,2685456085
673,3161618174,24159,3161642333,15,0,1,6656,15,1184717857
674,3161708482,87476,3161795958,15,0,0,22528,15,1649563271
675,3161718003,83877,3161801880,14,0,0,512,14,7505671611
676,3161756815,125716,3161882531,15,0,0,52224,15,10445560063
677,3161775255,178298,3161953553,3,0,0,57344,3,8638930993
678,3161879990,91785,3161971775,1,0,0,5120,1,402262974
679,3161892090,43904,3161935994,17,0,0,512,17,8987902165
680,3161912508,111829,3162024337,11,0,0,40960,11,113295181
681,3161925101,116419,3162041520,9,0,0,56320,9,9368347822
682,3161952934,177094,3162130028,14,0,0,1024,14,2303460814
683,3161968171,161530,3162129701,18,0,0,134144,18,4842805356
684,3162016387,143730,3162160117,11,0,0,25600,11,8890210014
685,3162056307,229431,3162285738,4,0,0,26624,4,6455748056
686,3162102172,128260,3162230432,13,0,0,29696,13,3581858387
687,3162106741,147418,3162254159,9,0,0,77824,9,4246111644
688,3162160322,117289,3162277611,9,0,0,22016,9,8169609792
689,3162161521,1518,3162163039,7,0,1,1536,7,7461185264
690,3162189463,3898,3162193361,11,0,1,4096,11,10050278496
691,3162237018,20121,3162257139,7,0,1,3072,7,5497074191
692,3162239320,20405,3162259725,0,0,1,4096,0,1991959589
693,3162252617,70594,3162323211,9,0,0,3072,9,6160465560
694,3162262440,79982,3162342422,4,0,0,10752,4,10549121471
695,3162319042,103844,3162422886,9,0,0,40960,9,2875070355
696,3162359047,166383,3162525430,18,0,0,26112,18,5107530896
697,3162402227,115232,3162517459,0,0,0,78336,0,5294041292
698,3162406845,16056,3162422901,18,0,1,5120,18,14024420
699,3162423573,1042,3162424615,18,0,1,1024,18,4004723763
700,3162459293,3422,3162462715,18,0,1,3584,18,2109770692
701,3162535529,142860,3162678389,0,0,0,5120,0,7205080909
702,3162547506,1042,3162548548,15,0,1,1024,15,1110454455
703,3162551388,5802,3162557190,13,0,1,6144,13,7995827413
704,3162557595,62690,3162620285,6,0,0,4608,6,3916045407
705,3162577740,52364,3162630104,0,0,0,3072,0,5450426217
706,3162579798,164529,3162744327,15,0,0,33792,15,8143193358
707,3162606244,2470,3162608714,0,0,1,2560,0,3029045229
708,3162636523,48980,3162685503,4,0,0,2048,4,1676358432
709,3162679955,2946,3162682901,5,0,1,3072,5,10671345919
710,3162720641,48980,3162769621,4,0,0,2048,4,4030879797
711,3162727944,45596,3162773540,14,0,0,1024,14,3561360896
712,3162761759,81908,3162843667,13,0,0,14336,13,129734907
713,3162806881,47288,3162854169,5,0,0,1536,5,7293911677
714,3162814833,52364,3162867197,5,0,0,3072,5,7239098550
715,3162861356,74360,3162935716,1,0,0,9728,1,3737861223
716,3162874388,64208,3162938596,11,0,0,6656,11,6843824971
717,3162919088,4937,3162924025,9,0,1,12800,9,5747676197
718,3162947210,3422,3162950632,7,0,1,3584,7,4210875558
719,3162978717,60692,3163039409,15,0,0,10240,15,3966581109
720,3163010743,178670,3163189413,9,0,0,74752,9,6856853757
721,3163029999,1042,3163031041,7,0,1,1024,7,5278336561
722,3163075269,151806,3163227075,0,0,0,40960,0,9509058090
723,3163138858,101123,3163239981,12,0,0,1536,12,1873988643
724,3163185733,4238,3163189971,7,0,1,512,7,3523911517
725,3163205053,119756,3163324809,15,0,0,93184,15,6118301281
726,3163207526,5326,3163212852,6,0,1,5632,6,1540415484
727,3163217416,15639,3163233055,3,0,1,14848,3,4152960818
728,3163221616,135569,3163357185,7,0,0,5632,7,4245834917
729,3163320162,10458,3163330620,14,0,1,6144,14,8262310923
730,3163323957,8704,3163332661,2,0,1,14848,2,2919694314
731,3163376800,240243,3163617043,8,0,0,38400,8,3817814273
732,3163390914,110552,3163501466,9,0,0,62976,9,10194192221
733,3163391170,2870,3163394040,9,0,1,8704,9,3228674388
734,3163470711,215843,3163686554,8,0,0,37376,8,4004825578
735,3163488860,59886,3163548746,12,0,0,1536,12,4423981005
736,3163532210,68376,3163600586,19,0,0,3072,19,7143754175
737,3163548080,72209,3163620289,19,0,0,2560,19,7508738624
738,3163558315,3898,3163562213,1,0,1,4096,1,6540913171
739,3163561817,56645,3163618462,8,0,0,4608,8,10297000823
740,3163603062,133046,3163736108,0,0,0,17408,0,695664649
741,3163613211,207023,3163820234,15,0,0,65536,15,3157173480
742,3163729408,90997,3163820405,12,0,0,512,12,9872516006
743,3163737208,566,3163737774,5,0,1,512,5,1864873448
744,3163745190,3387,3163748577,0,0,1,9728,0,7479676837
745,3163772786,99788,3163872574,18,0,0,27648,18,8506748264
746,3163773668,189740,3163963408,6,0,0,97792,6,823489792
747,3163878404,3898,3163882302,0,0,1,4096,0,9845300879
748,3163902336,118558,3164020894,12,0,0,512,12,2520061498
749,3163907528,104468,3164011996,11,0,0,43008,11,1207496168
750,3163908317,7230,3163915547,13,0,1,7680,13,7516528093
751,3163909207,88617,3163997824,19,0,0,1536,19,6199704620
752,3163937709,38791,3163976500,15,0,1,22016,15,7367904864
753,3163944697,35669,3163980366,0,0,1,6144,0,6453672498
754,3163994473,566,3163995039,10,0,1,512,10,6536297569
755,3164024604,141653,3164166257,12,0,0,2048,12,943346841
756,3164031561,6229,3164037790,2,0,1,15360,2,2395061797
757,3164051553,2946,3164054499,10,0,1,3072,10,6887989166
758,3164115045,57440,3164172485,13,0,0,4608,13,2372779217
759,3164121396,1042,3164122438,13,0,1,1024,13,2830302854
760,3164144016,43904,3164187920,17,0,0,512,17,2860993403
761,3164150713,133307,3164284020,9,0,0,28672,9,9677237830
762,3164211783,146142,3164357925,3,0,0,42496,3,668417625
763,3164219800,144536,3164364336,10,0,0,20992,10,9543443847
764,3164243926,101036,3164344962,9,0,0,31744,9,4913456612
765,3164309260,55715,3164364975,19,0,0,2048,19,6627089709
766,3164363914,14565,3164378479,5,0,1,26112,5,7828913360
767,3164388672,149784,3164538456,7,0,0,80896,7,9784046440
768,3164410200,6278,3164416478,13,0,1,6656,13,6929685695
769,3164413251,5813,3164419064,4,0,1,4096,4,6362730931
770,3164493313,131303,3164624616,7,0,0,64000,7,9915863871
771,3164529212,10320,3164539532,5,0,1,1024,5,6883438376
772,3164530848,19487,3164550335,1,0,1,18944,1,1814290732
773,3164534239,16250,3164550489,5,0,1,8704,5,8805961801
774,3164593177,1518,3164594695,11,0,1,1536,11,2556406125
775,3164651429,79434,3164730863,14,0,0,1536,14,5944076858
776,3164702230,2946,3164705176,4,0,1,3072,4,3935062515
777,3164760703,1994,3164762697,3,0,1,2048,3,5685845883
778,3164768832,566,3164769398,13,0,1,512,13,10270190587
779,3164775671,3645,3164779316,14,0,1,10240,14,7432753134
780,3164782839,188906,3164971745,9,0,0,44544,9,7011357733
781,3164784542,2946,3164787488,9,0,1,3072,9,2315893962
782,3164844735,161813,3165006548,8,0,0,114176,8,8487356033
783,3164943375,4374,3164947749,6,0,1,4608,6,5090560165
784,3164974901,132831,3165107732,1,0,0,32256,1,1933138655
785,3165007307,11791,3165019098,15,0,1,19456,15,6641974807
786,3165063963,5326,3165069289,6,0,1,5632,6,1791056679
787,3165112633,47288,3165159921,14,0,0,1536,14,8250879996
788,3165123541,54842,3165178383,17,0,0,512,17,5128976051
789,3165174071,115544,3165289615,1,0,0,79360,1,9386433853
790,3165199456,248043,3165447499,8,0,0,126464,8,5821216295
791,3165201433,176268,3165377701,1,0,0,2048,1,8051919840
792,3165201755,1518,3165203273,3,0,1,1536,3,2380382661
793,3165202419,87367,3165289786,12,0,0,512,12,5077628011
794,3165207035,153398,3165360433,3,0,0,73728,3,5157763724
795,3165208290,4850,3165213140,16,0,1,5120,16,6704297924
796,3165245364,2470,3165247834,11,0,1,2560,11,10465992926
797,3165249869,6278,3165256147,0,0,1,6656,0,2667029611
798,3165261444,191538,3165452982,11,0,0,17920,11,8355067960
799,3165311930,154046,3165465976,14,0,0,1024,14,6071635783
800,3165318736,230842,3165549578,18,0,0,73728,18,9104182640
801,3165329709,135924,3165465633,16,0,0,41472,16,2912197611
802,3165334308,26140,3165360448,14,0,1,27648,14,5747490542
803,3165364240,149362,3165513602,14,0,0,1024,14,1815064078
804,3165369696,8020,3165377716,0,0,1,8192,0,1562032790
805,3165430863,39128,3165469991,16,0,1,4608,16,8370921536
806,3165442466,30111,3165472577,5,0,1,4096,5,885211439
807,3165497971,1042,3165499013,13,0,1,1024,13,1084214115
808,3165502079,76208,3165578287,8,0,0,10752,8,10307410010
809,3165527851,23730,3165551581,13,0,1,2048,13,4217377686
810,3165535558,16689,3165552247,4,0,1,1024,4,4580952699
811,3165553619,1518,3165555137,15,0,1,1536,15,9673884535
812,3165580652,566,3165581218,13,0,1,512,13,8834498966
813,3165632086,1518,3165633604,14,0,1,1536,14,2838191057
814,3165651023,5802,3165656825,1,0,1,6144,1,8546302986
815,3165669884,99008,3165768892,3,0,0,25088,3,1060721724
816,3165699735,182357,3165882092,7,0,0,62464,7,5148456424
817,3165773008,1994,3165775002,14,0,1,2048,14,9663523152
818,3165839652,66368,3165906020,3,0,0,8704,3,6528729210
819,3165926737,43904,3165970641,17,0,0,512,17,5628585034
820,3165951832,104780,3166056612,7,0,0,44032,7,2557679378
821,3165978863,112435,3166091298,18,0,0,30720,18,7499694048
822,3166036282,4374,3166040656,3,0,1,4608,3,3970572153
823,3166045980,11683,3166057663,3,0,1,1024,3,8857420328
824,3166052071,9712,3166061783,7,0,1,5120,7,9532153758
825,3166074562,16759,3166091321,16,0,1,17920,16,2418478151
826,3166083365,13251,3166096616,14,0,1,5632,14,10138920876
827,3166098099,220202,3166318301,9,0,0,24576,9,5088834972
828,3166123902,284267,3166408169,13,0,0,158208,13,3331559133
829,3166192520,215836,3166408356,5,0,0,512,5,6524823202
830,3166204942,75046,3166279988,18,0,0,4608,18,7239091455
831,3166283339,12825,3166296164,7,0,1,21504,7,9108132205
832,3166330493,6754,3166337247,11,0,1,7168,11,10642842778
833,3166338626,7706,3166346332,11,0,1,8192,11,10255175382
834,3166360160,53556,3166413716,3,0,1,5632,3,7071053750
835,3166368200,335493,3166703693,4,0,0,32768,4,7970986320
836,3166399908,257393,3166657301,1,0,0,130048,1,4819189572
837,3166403290,11753,3166415043,18,0,1,12800,18,7825616668
838,3166403494,20753,3166424247,10,0,1,16384,10,5356650290
839,3166423964,261120,3166685084,15,0,0,91136,15,2908370913
840,3166450610,241353,3166691963,9,0,0,22528,9,7714737145
841,3166459517,1518,3166461035,14,0,1,1536,14,3805108452
842,3166473241,7706,3166480947,18,0,1,8192,18,3577524764
843,3166478826,6754,3166485580,7,0,1,7168,7,9006359056
844,3166500719,270867,3166771586,4,0,0,35840,4,6743355740
845,3166535282,345394,3166880676,10,0,0,59392,10,6775067836
846,3166548303,145391,3166693694,11,0,0,5632,11,5865617123
847,3166555559,184957,3166740516,0,0,0,103424,0,6267674694
848,3166570975,134301,3166705276,0,0,0,5120,0,10559530121
849,3166608099,223450,3166831549,19,0,0,512,19,7781514471
850,3166666441,42439,3166708880,1,0,1,10240,1,8834176227
851,3166734690,7336,3166742026,7,0,1,1536,7,6782705630
852,3166798274,2470,3166800744,14,0,1,2560,14,5067210275
853,3166826800,112892,3166939692,18,0,0,70656,18,7850479999
854,3166880115,6007,3166886122,2,0,1,13824,2,900300494
855,3166910850,195666,3167106516,7,0,0,20480,7,10210650574
856,3166943060,145486,3167088546,7,0,0,111104,7,706909582
857,3166954910,4679,3166959589,15,0,1,12288,15,4671896982
858,3166957218,143043,3167100261,9,0,0,38400,9,9385683008
859,3167008073,107429,3167115502,8,0,0,6656,8,8702120352
860,3167097787,145887,3167243674,3,0,0,115712,3,8952447482
861,3167102815,6664,3167109479,2,0,1,3072,2,8237882465
862,3167112284,3898,3167116182,15,0,1,4096,15,7478096189
863,3167124011,75553,3167199564,5,0,0,512,5,4179480011
864,3167286531,106652,3167393183,18,0,0,50176,18,3884068179
865,3167288405,150810,3167439215,15,0,0,39936,15,7902401607
866,3167311070,146451,3167457521,15,0,0,38400,15,8726130190
867,3167325561,1042,3167326603,13,0,1,1024,13,9710408342
868,3167327824,1518,3167329342,3,0,1,1536,3,3186937878
869,3167332389,2870,3167335259,0,0,1,8704,0,10230085036
870,3167475402,1042,3167476444,2,0,1,1024,2,5202104691
871,3167500094,2470,3167502564,6,0,1,2560,6,8551781238
872,3167534288,47288,3167581576,17,0,0,1536,17,1932293235
873,3167552369,58421,3167610790,19,0,0,512,19,1010259057
874,3167564180,6754,3167570934,16,0,1,7168,16,1505257634
875,3167609667,4850,3167614517,10,0,1,5120,10,202676493
876,3167650334,109928,3167760262,3,0,0,60928,3,4878013335
877,3167679448,208398,3167887846,10,0,0,99328,10,1649284728
878,3167679853,126519,3167806372,18,0,0,59904,18,8879959083
879,3167697777,80527,3167778304,12,0,0,3072,12,2586586783
880,3167746222,88476,3167834698,19,0,0,512,19,10414082313
881,3167755633,251768,3168007401,9,0,0,25088,9,10030221498
882,3167776017,6278,3167782295,1,0,1,6656,1,2412801266
883,3167803588,3342,3167806930,9,0,1,512,9,1751502657
884,3167842106,11791,3167853897,2,0,1,19456,2,7262483409
885,3167843055,57392,3167900447,10,0,0,3072,10,8768925201
886,3167881083,282403,3168163486,12,0,0,1024,12,3245455824
887,3167886594,3263,3167889857,11,0,1,2048,11,10355515938
888,3167890749,5326,3167896075,6,0,1,5632,6,436504543
889,3167899731,84122,3167983853,12,0,0,1536,12,9029792847
890,3167915543,101950,3168017493,12,0,0,512,12,5738806116
891,3167916149,11274,3167927423,15,0,1,18432,15,10080702624
892,3167919260,12349,3167931609,16,0,1,6656,16,8603901834
893,3167964572,1042,3167965614,7,0,1,1024,7,3762998368
894,3167980467,182684,3168163151,0,0,0,148480,0,3271934369
895,3167996428,264299,3168260727,10,0,0,35328,10,6100012017
896,3167997479,203140,3168200619,17,0,0,512,17,2076596702
897,3168002317,166360,3168168677,9,0,0,9216,9,1595088812
898,3168063662,186286,3168249948,7,0,0,116224,7,7862604969
899,3168127989,132909,3168260898,19,0,0,512,19,8687010482
900,3168148349,20351,3168168700,5,0,1,4096,5,8212454364
901,3168166291,158429,3168324720,9,0,0,61952,9,2272521296
902,3168281643,68049,3168349692,19,0,0,512,19,9128267036
903,3168285495,566,3168286061,5,0,1,512,5,9494789613
904,3168312039,18644,3168330683,14,0,1,14848,14,6564698467
905,3168328357,4592,3168332949,9,0,1,3584,9,9207152695
906,3168333622,1518,3168335140,4,0,1,1536,4,10406773568
907,3168336642,1042,3168337684,18,0,1,1024,18,9837514297
908,3168338985,69284,3168408269,18,0,0,8192,18,2497162729
909,3168363978,48980,3168412958,9,0,0,2048,9,9074596822
910,3168376744,52567,3168429311,5,0,0,512,5,9451874319
911,3168389237,2946,3168392183,2,0,1,3072,2,6115399211
912,3168400788,1042,3168401830,3,0,1,1024,3,5351111563
913,3168466989,108836,3168575825,16,0,0,57344,16,414294110
914,3168469375,125956,3168595331,16,0,0,49664,16,9441028041
915,3168484916,110898,3168595814,5,0,0,1536,5,9964101844
916,3168506440,4850,3168511290,5,0,1,5120,5,5321949203
917,3168520184,566,3168520750,1,0,1,512,1,2917479216
918,3168557645,18195,3168575840,3,0,1,7168,3,1308062376
919,3168601039,43904,3168644943,14,0,0,512,14,2240093900
920,3168711984,1518,3168713502,14,0,1,1536,14,8882452997
921,3168714846,50828,3168765674,12,0,0,3072,12,1954190111
922,3168745330,3387,3168748717,0,0,1,9728,0,4223380180
923,3168756724,3422,3168760146,9,0,1,3584,9,9700712725
924,3168771947,156290,3168928237,17,0,0,512,17,5670438723
925,3168804259,106340,3168910599,7,0,0,49152,7,10020896016
926,3168823825,125802,3168949627,18,0,0,9216,18,1965555831
927,3168847690,136541,3168984231,15,0,0,46592,15,755741593
928,3168853108,154493,3169007601,15,0,0,11264,15,9128145371
929,3168859592,53411,3168913003,9,0,0,2048,9,5787434234
930,3168922646,3422,3168926068,4,0,1,3584,4,1724222632
931,3168934618,3128,3168937746,4,0,1,9216,4,7786841411
932,3168981107,7490,3168988597,2,0,1,4608,2,4802725872
933,3169000311,48980,3169049291,19,0,0,2048,19,7292983847
934,3169058794,67904,3169126698,9,0,0,8704,9,3592718653
935,3169076297,1994,3169078291,9,0,1,2048,9,7287269312
936,3169078269,7720,3169085989,5,0,1,8192,5,10230974277
937,3169150824,121784,3169272608,1,0,0,99840,1,9597862534
938,3169196122,105142,3169301264,6,0,0,5120,6,4961107776
939,3169236633,4679,3169241312,5,0,1,12288,5,9735824323
940,3169270292,46212,3169316504,19,0,0,512,19,3156626420
941,3169336366,3128,3169339494,1,0,1,9216,1,8682653991
942,3169363463,43904,3169407367,7,0,0,512,7,3898526075
943,3169384167,1518,3169385685,3,0,1,1536,3,1793238718
944,3169389703,43904,3169433607,12,0,0,512,12,4928806031
945,3169395476,47288,3169442764,13,0,0,1536,13,6346748611
946,3169397676,220204,3169617880,1,0,0,120320,1,5521383569
947,3169411596,43904,3169455500,19,0,0,512,19,9006786003
948,3169415769,134435,3169550204,9,0,0,39424,9,7925959348
949,3169433562,22728,3169456290,14,0,1,37376,14,7597995425
950,3169463113,105976,3169569089,11,0,0,29696,11,2664926529
951,3169501912,362349,3169864261,7,0,0,98304,7,10512127795
952,3169517047,226848,3169743895,11,0,0,52224,11,169023177
953,3169536673,13546,3169550219,13,0,1,3072,13,3036619594
954,3169542426,11430,3169553856,3,0,1,10240,3,1382530108
955,3169584193,308101,3169892294,0,0,0,30720,0,4149161121
956,3169645538,1518,3169647056,7,0,1,1536,7,721506959
957,3169650056,157685,3169807741,8,0,0,33792,8,6651987906
958,3169746910,3422,3169750332,14,0,1,3584,14,9979256420
959,3169759218,123701,3169882919,11,0,0,23040,11,564496654
960,3169763444,181575,3169945019,15,0,0,65536,15,7297287375
961,3169779534,3422,3169782956,2,0,1,3584,2,445002777
962,3169817431,1994,3169819425,1,0,1,2048,1,3506975737
963,3169912248,4374,3169916622,13,0,1,4608,13,5137203409
964,3169920243,74360,3169994603,0,0,0,9728,0,9214080801
965,3169923961,49292,3169973253,15,0,0,3072,15,9703448920
966,3169938425,7152,3169945577,8,0,1,512,8,327157431
967,3169970950,192704,3170163654,9,0,0,9216,9,1489645267
968,3169985830,99476,3170085306,3,0,0,26624,3,7326379572
969,3169995179,3904,3169999083,15,0,1,10752,15,6216300233
970,3170049514,258170,3170307684,1,0,0,253952,1,160440219
971,3170096929,211574,3170308503,19,0,0,2560,19,7909186323
972,3170132066,176623,3170308689,5,0,0,512,5,10556921815
973,3170193144,5454,3170198598,8,0,1,13824,8,4880464354
974,3170227670,80848,3170308518,3,0,1,22528,3,3837970609
975,3170229806,181402,3170411208,3,0,0,39936,3,8123005974
976,3170232411,219849,3170452260,10,0,0,48640,10,10630992853
977,3170237780,258898,3170496678,4,0,0,47104,4,5157118418
978,3170257133,127045,3170384178,5,0,0,512,5,346958969
979,3170259241,55284,3170314525,1,0,1,6144,1,8081858175
980,3170303740,116999,3170420739,4,0,0,31232,4,1576812684
981,3170317423,271542,3170588965,18,0,0,7680,18,5212218614
982,3170373846,566,3170374412,3,0,1,512,3,1554996731
983,3170377659,3904,3170381563,13,0,1,10752,13,788017158
984,3170377746,75309,3170453055,17,0,0,2560,17,7234243226
985,3170417347,64832,3170482179,15,0,0,7680,15,8559967409
986,3170430530,22540,3170453070,6,0,1,16384,6,10520108671
987,3170509104,50672,3170559776,14,0,0,2560,14,10677555154
988,3170515488,2470,3170517958,2,0,1,2560,2,7131130685
989,3170524154,1518,3170525672,10,0,1,1536,10,9303039149
990,3170528032,566,3170528598,5,0,1,512,5,2519740465
991,3170639045,3422,3170642467,13,0,1,3584,13,4331391604
992,3170641102,129132,3170770234,6,0,0,90624,6,9217984037
993,3170707161,74385,3170781546,6,0,0,2560,6,8356430715
994,3170725928,91018,3170816946,18,0,0,17920,18,10714389808
995,3170775318,115856,3170891174,18,0,0,80384,18,5430883198
996,3170780547,2470,3170783017,14,0,1,2560,14,685775555
997,3170790248,2470,3170792718,0,0,1,2560,0,1658457374
998,3170794369,135616,3170929985,0,0,0,35840,0,10312359301
999,3170794758,124292,3170919050,0,0,0,30720,0,1616433410
1000,3170829811,1042,3170830853,15,0,1,1024,15,3558373999
1001,3170843115,7230,3170850345,8,0,1,7680,8,8524777023
1002,3170880612,16050,3170896662,9,0,1,13824,9,2377404520
1003,3170882665,14343,3170897008,16,0,1,512,16,3692302121
1004,3170885851,72787,3170958638,18,0,0,7168,18,9126757828
1005,3170892534,151461,3171043995,17,0,0,2560,17,5741318953
1006,3170899320,183883,3171083203,11,0,0,26112,11,2002455142
1007,3170953764,4889,3170958653,2,0,1,8704,2,1147424482
1008,3170984650,1994,3170986644,9,0,1,2048,9,1076238389
1009,3170995600,118611,3171114211,7,0,0,22016,7,4947749481
1010,3171022940,238265,3171261205,13,0,0,97792,13,522666584
1011,3171033379,1994,3171035373,3,0,1,2048,3,6476114923
1012,3171034051,237621,3171271672,4,0,0,34304,4,1964502602
1013,3171060025,3898,3171063923,15,0,1,4096,15,6584870187
1014,3171082142,213083,3171295225,1,0,0,48128,1,9531076772
1015,3171117697,1994,3171119691,2,0,1,2048,2,8019821946
1016,3171150837,24670,3171175507,8,0,1,44544,8,3068309736
1017,3171156239,21534,3171177773,4,0,1,3584,4,2587628156
1018,3171219402,197510,3171416912,13,0,0,102400,13,4251371204
1019,3171260133,14418,3171274551,18,0,1,8704,18,5205813950
1020,3171270000,213474,3171483474,12,0,0,1536,12,1025025015
1021,3171287255,13674,3171300929,8,0,1,14336,8,10030559858
1022,3171309858,13512,3171323370,8,0,1,26112,8,9512962486
1023,3171315719,167272,3171482991,15,0,0,24576,15,7400098265
1024,3171357817,251061,3171608878,7,0,0,9728,7,6291783926
1025,3171369378,92533,3171461911,8,0,1,150016,8,795267249
1026,3171383686,82091,3171465777,14,0,1,6144,14,9222931112
1027,3171392532,186279,3171578811,17,0,0,512,17,871362411
1028,3171464443,19046,3171483489,8,0,1,31232,8,149903559
1029,3171468930,14574,3171483504,16,0,1,3584,16,2482225434
1030,3171473848,206339,3171680187,16,0,0,5120,16,3420854941
1031,3171500238,566,3171500804,15,0,1,512,15,1113543364
1032,3171516682,7706,3171524388,18,0,1,8192,18,6681701252
1033,3171536764,7706,3171544470,5,0,1,8192,5,1401099865
1034,3171540225,138387,3171678612,8,0,0,4608,8,1470785859
1035,3171604461,12566,3171617027,8,0,1,20992,8,2782432984
1036,3171648659,213512,3171862171,11,0,0,44544,11,6057645007
1037,3171677044,155377,3171832421,14,0,0,512,14,4573586746
1038,3171695503,2946,3171698449,7,0,1,3072,7,9595447397
1039,3171702209,6278,3171708487,13,0,1,6656,13,5745019674
1040,3171715871,3128,3171718999,7,0,1,9216,7,5096910416
1041,3171727749,3387,3171731136,6,0,1,9728,6,6218837590
1042,3171750120,11533,3171761653,3,0,1,18944,3,6396210445
1043,3171763158,4374,3171767532,6,0,1,4608,6,7308194227
1044,3171764099,247153,3172011252,4,0,0,68608,4,8295910551
1045,3171813939,105406,3171919345,15,0,0,44544,15,4824530591
1046,3171850750,217694,3172068444,8,0,0,43008,8,9259510941
1047,3171874541,5326,3171879867,3,0,1,5632,3,2925308037
1048,3171971922,3422,3171975344,5,0,1,3584,5,6317117976
1049,3172107886,6229,3172114115,9,0,1,15360,9,7959216092
1050,3172136225,5196,3172141421,1,0,1,13312,1,3378000511
1051,3172159456,3422,3172162878,14,0,1,3584,14,7315527890
1052,3172164805,43904,3172208709,14,0,0,512,14,1218598436
1053,3172195971,146320,3172342291,0,0,0,40960,0,571581910
1054,3172200704,1042,3172201746,13,0,1,1024,13,5255586059
1055,3172239726,5802,3172245528,7,0,1,6144,7,4770208407
1056,3172254968,74828,3172329796,8,0,0,11264,8,6128679722
1057,3172278727,133392,3172412119,4,0,0,44032,4,4795773833
1058,3172364481,2470,3172366951,16,0,1,2560,16,4671848386
1059,3172475183,7706,3172482889,16,0,1,8192,16,10105224678
1060,3172621763,108212,3172729975,8,0,0,55296,8,5963541395
1061,3172705840,43904,3172749744,17,0,0,512,17,2999243451
1062,3172755458,43904,3172799362,14,0,0,512,14,1059558190
1063,3172777297,107900,3172885197,9,0,0,54272,9,135634278
1064,3172794511,50672,3172845183,10,0,0,2560,10,1069464889
1065,3172854614,6754,3172861368,7,0,1,7168,7,8510256741
1066,3172898046,43904,3172941950,14,0,0,512,14,5934809842
1067,3172916188,55748,3172971936,3,0,0,4096,3,4491257332
1068,3172916968,85448,3173002416,11,0,0,18432,11,5247955659
1069,3172942063,122818,3173064881,18,0,0,7168,18,3168639442
1070,3172951210,58846,3173010056,15,0,0,1024,15,4193148506
1071,3172965009,7706,3172972715,15,0,1,8192,15,10068675126
1072,3173000590,7144,3173007734,10,0,1,5632,10,3252697662
1073,3173042509,45596,3173088105,19,0,0,1024,19,6332550742
1074,3173054787,115544,3173170331,8,0,0,79360,8,3271275130
1075,3173069576,7230,3173076806,1,0,1,7680,1,2545924854
1076,3173080275,5454,3173085729,6,0,1,13824,6,9201721805
1077,3173088839,2946,3173091785,15,0,1,3072,15,4296783959
1078,3173103979,2946,3173106925,4,0,1,3072,4,8890316994
1079,3173143687,242142,3173385829,13,0,0,31232,13,3107616802
1080,3173151993,24084,3173176077,1,0,1,14336,1,5902269053
1081,3173161668,214630,3173376298,13,0,0,74752,13,10457353978
1082,3173165582,160623,3173326205,14,0,0,1024,14,10624383977
1083,3173263243,2946,3173266189,15,0,1,3072,15,7839798190
1084,3173300409,177151,3173477560,11,0,0,25088,11,8269899554
1085,3173306015,142457,3173448472,12,0,0,45568,12,9396325955
1086,3173387130,191404,3173578534,3,0,0,128512,3,8969662980
1087,3173455917,2946,3173458863,15,0,1,3072,15,3091691548
1088,3173524900,1518,3173526418,15,0,1,1536,15,1238721942
1089,3173528858,6278,3173535136,15,0,1,6656,15,2285151203
1090,3173530548,66287,3173596835,11,0,0,7168,11,5330318974
1091,3173553500,137416,3173690916,0,0,0,18432,0,8191085227
1092,3173558717,23004,3173581721,6,0,1,9216,6,6195350110
1093,3173566349,142709,3173709058,10,0,0,32768,10,7080792228
1094,3173566567,17704,3173584271,14,0,1,8704,14,7304657929
1095,3173607575,1518,3173609093,11,0,1,1536,11,5535025888
1096,3173658215,97760,3173755975,16,0,0,20992,16,5958603644
1097,3173689531,176693,3173866224,13,0,0,107520,13,6906078476
1098,3173701546,11666,3173713212,15,0,1,11264,15,5699145601
1099,3173716956,149439,3173866395,19,0,0,512,19,6385078167
1100,3173763916,214040,3173977956,4,0,0,181248,4,5435704253
1101,3173776838,4374,3173781212,11,0,1,4608,11,10595568714
1102,3173825319,184659,3174009978,10,0,0,58368,10,4363116188
1103,3173940932,100342,3174041274,11,0,0,2560,11,2313241371
1104,3173968164,58789,3174026953,7,0,0,2048,7,6424637363
1105,3174007659,84555,3174092214,1,0,0,20480,1,1298795374
1106,3174031544,61933,3174093477,16,0,0,4096,16,4007051582
1107,3174069764,4374,3174074138,9,0,1,4608,9,743090204
1108,3174093900,206507,3174300407,9,0,0,31232,9,10296182239
1109,3174101201,210929,3174312130,16,0,0,38400,16,4868937600
1110,3174131591,2946,3174134537,16,0,1,3072,16,2625709391
1111,3174167153,6754,3174173907,7,0,1,7168,7,8179506353
1112,3174173668,62516,3174236184,7,0,0,6144,7,994918737
1113,3174215933,1994,3174217927,9,0,1,2048,9,5038243244
1114,3174219030,5454,3174224484,0,0,1,13824,0,3920385808
1115,3174225395,101034,3174326429,11,0,0,4608,11,7200650110
1116,3174228638,194825,3174423463,16,0,0,103936,16,142451496
1117,3174233379,5802,3174239181,10,0,1,6144,10,9900978613
1118,3174245404,208403,3174453807,18,0,0,59904,18,3237667052
1119,3174246459,245408,3174491867,12,0,0,32256,12,159925553
1120,3174248829,1042,3174249871,18,0,1,1024,18,8319242221
1121,3174278850,145408,3174424258,5,0,0,2560,5,8538715781
1122,3174291157,22926,3174314083,0,0,1,2048,0,772085922
1123,3174310280,147910,3174458190,8,0,0,14336,8,7836318458
1124,3174318581,1994,3174320575,11,0,1,2048,11,8437006777
1125,3174329568,2870,3174332438,5,0,1,8704,5,2667821072
1126,3174360246,248302,3174608548,10,0,0,58368,10,9988267210
1127,3174378737,1518,3174380255,9,0,1,1536,9,3675668806
1128,3174414472,96450,3174510922,15,0,0,14848,15,4138341339
1129,3174418966,9207,3174428173,2,0,1,4096,2,3261246460
1130,3174449984,117499,3174567483,8,0,0,7680,8,488541716
1131,3174461056,14804,3174475860,8,0,1,28672,8,4338166188
1132,3174470360,60447,3174530807,12,0,0,1536,12,3422332252
1133,3174628519,2470,3174630989,14,0,1,2560,14,8506543575
1134,3174643373,5326,3174648699,15,0,1,5632,15,10552959339
1135,3174650042,6754,3174656796,3,0,1,7168,3,872329499
1136,3174686267,4374,3174690641,4,0,1,4608,4,10605884044
1137,3174698117,274538,3174972655,0,0,0,107520,0,8314199340
1138,3174709607,146966,3174856573,10,0,0,58880,10,8606663244
1139,3174716391,1518,3174717909,15,0,1,1536,15,3721196902
1140,3174735520,2470,3174737990,3,0,1,2560,3,6428653842
1141,3174772571,256430,3175029001,0,0,0,119808,0,5094388679
1142,3174783255,209227,3174992482,15,0,0,65024,15,2315646960
1143,3174790488,3422,3174793910,14,0,1,3584,14,7627713633
1144,3174796512,3387,3174799899,18,0,1,9728,18,8107907444
1145,3174880297,3387,3174883684,6,0,1,9728,6,1655353459
1146,3174891368,5971,3174897339,9,0,1,14848,9,7887691508
1147,3174930157,98867,3175029024,8,0,1,141824,8,2777045832
1148,3175011013,92855,3175103868,8,0,0,5120,8,6937216015
1149,3175021612,8932,3175030544,5,0,1,1536,5,2286952699
1150,3175041577,1994,3175043571,15,0,1,2048,15,2920504766
1151,3175052568,2470,3175055038,5,0,1,2560,5,1246022413
1152,3175109541,306272,3175415813,6,0,0,93696,6,824148764
1153,3175113329,139651,3175252980,11,0,0,34304,11,7246523325
1154,3175138268,202706,3175340974,7,0,0,22016,7,5696662687
1155,3175141617,100880,3175242497,7,0,0,31232,7,9596855849
1156,3175177346,156897,3175334243,4,0,0,77824,4,8567130522
1157,3175231919,1042,3175232961,6,0,1,1024,6,5398123507
1158,3175238313,182819,3175421132,19,0,0,17408,19,977731794
1159,3175240110,283230,3175523340,9,0,0,159744,9,6864985322
1160,3175247924,115905,3175363829,0,0,0,13824,0,10501178680
1161,3175251505,4455,3175255960,16,0,1,3072,16,1000836777
1162,3175251987,339747,3175591734,10,0,0,30208,10,6863790267
1163,3175267562,2470,3175270032,1,0,1,2560,1,8886773485
1164,3175274876,354850,3175629726,11,0,0,100352,11,7744381838
1165,3175283808,566,3175284374,13,0,1,512,13,5185186439
1166,3175291698,2946,3175294644,3,0,1,3072,3,10651658078
1167,3175310691,240077,3175550768,12,0,0,14848,12,5027297082
1168,3175351992,194237,3175546229,4,0,0,15360,4,3895146271
1169,3175363114,3177,3175366291,6,0,1,2560,6,6055717411
1170,3175381391,2470,3175383861,7,0,1,2560,7,4614325891
1171,3175408024,15587,3175423611,6,0,1,2560,6,8582566856
1172,3175408791,259030,3175667821,10,0,0,23040,10,6125298271
1173,3175440925,156310,3175597235,7,0,0,10240,7,5179926561
1174,3175483213,147020,3175630233,5,0,0,1536,5,3705707454
1175,3175503903,183745,3175687648,19,0,0,65024,19,9428149247
1176,3175582195,125063,3175707258,8,0,0,45056,8,3140619143
1177,3175603776,117215,3175720991,19,0,0,3584,19,8506917895
1178,3175604897,232512,3175837409,6,0,0,26624,6,3539451002
1179,3175611677,131551,3175743228,16,0,0,10752,16,189738447
1180,3175656916,2470,3175659386,2,0,1,2560,2,3491353160
1181,3175686822,125370,3175812192,19,0,0,75776,19,2697348431
1182,3175719701,2870,3175722571,13,0,1,8704,13,8462987163
1183,3175848586,3128,3175851714,5,0,1,9216,5,716925573
1184,3175929737,4374,3175934111,14,0,1,4608,14,519992906
1185,3175981133,3645,3175984778,7,0,1,10240,7,869945605
1186,3175989319,5802,3175995121,15,0,1,6144,15,7642156578
1187,3175990796,105977,3176096773,7,0,0,11776,7,2315559579
1188,3175995836,11274,3176007110,16,0,1,18432,16,6975505489
1189,3176004660,140635,3176145295,9,0,0,33792,9,5805870562
1190,3176038049,5802,3176043851,6,0,1,6144,6,9007790222
1191,3176058220,49599,3176107819,5,0,0,1536,5,2806860149
1192,3176060628,140353,3176200981,0,0,0,44032,0,8268426035
1193,3176065344,43904,3176109248,17,0,0,512,17,1360481999
1194,3176068329,2470,3176070799,18,0,1,2560,18,8463006224
1195,3176071065,3422,3176074487,6,0,1,3584,6,4740235014
1196,3176085163,7706,3176092869,1,0,1,8192,1,9444412430
1197,3176095813,145590,3176241403,9,0,0,9216,9,6268308817
1198,3176139145,200195,3176339340,15,0,0,81920,15,2888411762
1199,3176190647,16604,3176207251,6,0,1,6656,6,9568871780
1200,3176206671,1994,3176208665,9,0,1,2048,9,7916874067
1201,3176221499,1518,3176223017,11,0,1,1536,11,3527958984
1202,3176234354,106717,3176341071,19,0,0,5632,19,5552425771
1203,3176257791,1994,3176259785,5,0,1,2048,5,9343846315
1204,3176297053,208553,3176505606,10,0,0,161792,10,4676113018
1205,3176354340,3422,3176357762,16,0,1,3584,16,1221937813
1206,3176418588,183490,3176602078,8,0,0,10752,8,6822720126
1207,3176420050,1994,3176422044,8,0,1,2048,8,6815198013
1208,3176427118,2946,3176430064,7,0,1,3072,7,362626214
1209,3176435990,257498,3176693488,11,0,0,72704,11,8539594500
1210,3176441591,64186,3176505777,17,0,0,512,17,10277414436
1211,3176450264,98252,3176548516,6,0,0,27648,6,3255921768
1212,3176498194,122316,3176620510,15,0,0,10752,15,4356325522
1213,3176507408,147254,3176654662,0,0,0,22016,0,10139368020
1214,3176559267,210541,3176769808,19,0,0,35840,19,7489349965
1215,3176568065,245610,3176813675,3,0,0,143872,3,7213953946
1216,3176584894,135250,3176720144,16,0,0,36352,16,178662894
1217,3176607537,101516,3176709053,18,0,0,4096,18,3718495808
1218,3176645159,1994,3176647153,16,0,1,2048,16,6704078904
1219,3176676701,178998,3176855699,7,0,0,23040,7,493843542
1220,3176723625,102979,3176826604,0,0,0,13312,0,8179247150
1221,3176737656,3898,3176741554,13,0,1,4096,13,5849805161
1222,3176763602,50276,3176813878,18,0,0,512,18,9771221122
1223,3176765393,49784,3176815177,2,0,1,1536,2,6360608024
1224,3176768702,132285,3176900987,13,0,0,20480,13,10466850540
1225,3176793058,22785,3176815843,16,0,1,1024,16,102227477
1226,3176799890,77281,3176877171,8,0,1,101888,8,5113874823
1227,3176834918,170475,3177005393,4,0,0,135168,4,1594119747
1228,3176843742,35695,3176879437,5,0,1,3584,5,235013824
1229,3176858928,26206,3176885134,1,0,1,27136,1,1343134214
1230,3176874175,282505,3177156680,0,0,0,12288,0,7498722297
1231,3176880940,228702,3177109642,18,0,0,38912,18,7721656314
1232,3176943204,3422,3176946626,16,0,1,3584,16,752382055
1233,3176960930,1994,3176962924,10,0,1,2048,10,9439616822
1234,3176978737,316432,3177295169,15,0,0,45568,15,7859076502
1235,3176995162,55844,3177051006,5,0,0,1024,5,4767102888
1236,3177015447,3422,3177018869,6,0,1,3584,6,6778043847
1237,3177039933,4374,3177044307,16,0,1,4608,16,6289340075
1238,3177043801,79975,3177123776,12,0,0,5120,12,286720789
1239,3177064981,254383,3177319364,6,0,0,79360,6,2522836192
1240,3177084494,1994,3177086488,5,0,1,2048,5,8594135559
1241,3177085439,82889,3177168328,5,0,0,512,5,3561941056
1242,3177197889,158912,3177356801,11,0,0,86528,11,8877988968
1243,3177216630,10499,3177227129,3,0,1,16896,3,4942308883
1244,3177274049,566,3177274615,1,0,1,512,1,3018468919
1245,3177278375,104370,3177382745,19,0,0,3072,19,9321815179
1246,3177307848,206556,3177514404,13,0,0,27648,13,3240252157
1247,3177334978,67411,3177402389,5,0,0,1024,5,1993063799
1248,3177345341,215563,3177560904,10,0,0,18944,10,5300733433
1249,3177375874,124748,3177500622,10,0,0,109568,10,7545143825
1250,3177432987,201123,3177634110,8,0,0,31232,8,4758582261
1251,3177494765,8319,3177503084,3,0,1,2560,3,5690541024
1252,3177524279,85160,3177609439,12,0,0,19968,12,329068200
1253,3177577247,57190,3177634437,1,0,0,1024,1,3454973786
1254,3177578136,6278,3177584414,4,0,1,6656,4,5780814661
1255,3177605866,109905,3177715771,9,0,0,49152,9,6827417971
1256,3177621121,1994,3177623115,10,0,1,2048,10,9958360141
1257,3177635958,124423,3177760381,13,0,0,23040,13,10715605692
1258,3177641024,566,3177641590,14,0,1,512,14,915515574
1259,3177668893,74208,3177743101,3,0,0,6656,3,3103999375
1260,3177696222,101816,3177798038,10,0,0,34304,10,9465269481
1261,3177703200,17000,3177720200,9,0,1,11776,9,409317090
1262,3177706353,168011,3177874364,10,0,0,56832,10,1047330509
1263,3177755986,139606,3177895592,11,0,0,30720,11,3450218959
1264,3177837731,73472,3177911203,3,0,0,16896,3,616893744
1265,3177859919,198860,3178058779,10,0,0,24064,10,10109874165
1266,3177894813,1813,3177896626,1,0,1,1024,1,8884438512
1267,3177977556,2870,3177980426,5,0,1,8704,5,6003654594
1268,3177994754,66848,3178061602,9,0,0,9216,9,1349101429
1269,3178044929,2470,3178047399,7,0,1,2560,7,326896161
1270,3178061734,1518,3178063252,5,0,1,1536,5,3478569205
1271,3178106756,4850,3178111606,11,0,1,5120,11,1235061938
1272,3178134581,146968,3178281549,19,0,0,41472,19,1301394706
1273,3178151828,45596,3178197424,17,0,0,1024,17,4998597581
1274,3178216865,127330,3178344195,6,0,0,29184,6,2206625825
1275,3178254825,162702,3178417527,18,0,0,108544,18,2695822801
1276,3178288893,80834,3178369727,5,0,0,512,5,7010936441
1277,3178437742,6278,3178444020,3,0,1,6656,3,2675504591
1278,3178471698,2946,3178474644,18,0,1,3072,18,6565012954
1279,3178532101,102128,3178634229,18,0,0,35328,18,7428845629
1280,3178558470,82376,3178640846,7,0,0,15872,7,8890394068
1281,3178570772,77168,3178647940,16,0,0,18944,16,2815152397
1282,3178609513,12566,3178622079,8,0,1,20992,8,9873018647
1283,3178634248,188700,3178822948,11,0,0,3072,11,1819401174
1284,3178648995,97760,3178746755,6,0,0,20992,6,9804139927
1285,3178650856,1042,3178651898,15,0,1,1024,15,3432193773
1286,3178687981,1042,3178689023,1,0,1,1024,1,8391195833
1287,3178707535,114454,3178821989,15,0,0,39936,15,7265146503
1288,3178733677,3128,3178736805,11,0,1,9216,11,7088841035
1289,3178756541,66734,3178823275,5,0,0,1024,5,5196975979
1290,3178756942,89057,3178845999,11,0,0,6144,11,5776647716
1291,3178811114,120370,3178931484,8,0,0,58880,8,7368129389
1292,3178907346,1994,3178909340,0,0,1,2048,0,5986154410
1293,3178940582,71156,3179011738,16,0,0,14336,16,4552034002
1294,3178988485,6229,3178994714,15,0,1,15360,15,5870372193
1295,3179013145,5802,3179018947,14,0,1,6144,14,3359554597
1296,3179150889,43904,3179194793,13,0,0,512,13,4201823886
1297,3179192164,2946,3179195110,6,0,1,3072,6,5586618501
1298,3179223498,566,3179224064,1,0,1,512,1,8868597109
1299,3179298105,2946,3179301051,10,0,1,3072,10,9222908958
1300,3179301617,3898,3179305515,6,0,1,4096,6,5239623561
1301,3179333315,2470,3179335785,16,0,1,2560,16,3355022928
1302,3179386055,76232,3179462287,15,0,0,15872,15,2310524755
1303,3179419617,66368,3179485985,13,0,0,8704,13,8325080313
1304,3179471298,70064,3179541362,0,0,0,10752,0,501190747
1305,3179485205,4194,3179489399,5,0,1,3584,5,8834214095
1306,3179564373,11274,3179575647,15,0,1,18432,15,7573681403
1307,3179612241,167541,3179779782,9,0,0,84480,9,1858612775
1308,3179612337,48980,3179661317,5,0,0,2048,5,3435587115
1309,3179666070,224582,3179890652,9,0,0,57344,9,3906888475
1310,3179684647,162601,3179847248,3,0,0,71168,3,7457693236
1311,3179724817,99320,3179824137,10,0,0,26112,10,6749502681
1312,3179785379,183642,3179969021,7,0,0,36352,7,8902247605
1313,3179812778,11374,3179824152,11,0,1,6656,11,5840416737
1314,3179815616,8551,3179824167,4,0,1,2560,4,686029803
1315,3179825265,132665,3179957930,1,0,0,50176,1,2995517965
1316,3179882801,126147,3180008948,12,0,0,32768,12,4976841828
1317,3179911737,1994,3179913731,4,0,1,2048,4,6781976441
1318,3180017942,112892,3180130834,6,0,0,70656,6,4796628388
1319,3180032636,74222,3180106858,7,0,0,2048,7,6175708089
1320,3180068422,5326,3180073748,13,0,1,5632,13,10143850886
1321,3180068686,123498,3180192184,18,0,0,44032,18,8655302631
1322,3180126112,10168,3180136280,11,0,1,13824,11,7632350924
1323,3180131270,10305,3180141575,10,0,1,15872,10,10019397362
1324,3180157881,51223,3180209104,17,0,0,1536,17,567749547
1325,3180159206,74867,3180234073,8,0,1,122368,8,6381360293
1326,3180186642,69029,3180255671,19,0,0,5120,19,7029923177
1327,3180198421,138376,3180336797,19,0,0,18944,19,59099436
1328,3180211452,264993,3180476445,9,0,0,88576,9,156046895
1329,3180251416,141165,3180392581,5,0,0,512,5,892793269
1330,3180284227,1518,3180285745,9,0,1,1536,9,8524584900
1331,3180304305,4374,3180308679,11,0,1,4608,11,9873173795
1332,3180357743,2946,3180360689,9,0,1,3072,9,206453908
1333,3180429794,4850,3180434644,2,0,1,5120,2,9529291823
1334,3180443077,143469,3180586546,10,0,0,72704,10,7775400244
1335,3180457135,21313,3180478448,6,0,1,2048,6,7547294458
1336,3180461799,17635,3180479434,11,0,1,1536,11,6453726459
1337,3180483626,213422,3180697048,9,0,0,81408,9,3243416304
1338,3180575479,14481,3180589960,15,0,1,3584,15,5565513513
1339,3180616110,82365,3180698475,15,0,0,4608,15,8464638675
1340,3180634060,3422,3180637482,9,0,1,3584,9,6865668834
1341,3180660632,1994,3180662626,14,0,1,2048,14,7308380972
1342,3180673235,27193,3180700428,15,0,1,2048,15,8711782135
1343,3180730779,78548,3180809327,4,0,0,18432,4,3440948555
1344,3180747636,107227,3180854863,11,0,0,41984,11,3971203481
1345,3180766640,2946,3180769586,15,0,1,3072,15,4011957658
1346,3180818101,1994,3180820095,14,0,1,2048,14,874442201
1347,3180849781,11828,3180861609,10,0,1,7168,10,2684287276
1348,3180881697,6754,3180888451,16,0,1,7168,16,8097819250
1349,3180933680,60824,3180994504,11,0,0,5632,11,5412684041
1350,3180959068,108994,3181068062,3,0,0,11776,3,10205084946
1351,3180972169,45596,3181017765,14,0,0,1024,14,5138797618
1352,3180992349,105560,3181097909,12,0,0,46592,12,9738457758
1353,3181006445,566,3181007011,2,0,1,512,2,8747428324
1354,3181036003,147904,3181183907,3,0,0,100864,3,4172716672
1355,3181038208,5971,3181044179,11,0,1,14848,11,6081751664
1356,3181085401,16421,3181101822,7,0,1,10752,7,4792648713
1357,3181089187,312177,3181401364,1,0,0,51200,1,2293209824
1358,3181116703,2470,3181119173,13,0,1,2560,13,6006988846
1359,3181117925,248272,3181366197,18,0,0,22528,18,5916796809
1360,3181118738,10499,3181129237,4,0,1,16896,4,4803590816
1361,3181140899,10241,3181151140,18,0,1,16384,18,10552670833
1362,3181173357,153241,3181326598,4,0,0,33792,4,3229839336
1363,3181193593,4374,3181197967,2,0,1,4608,2,2299019880
1364,3181209529,45596,3181255125,14,0,0,1024,14,7196214598
1365,3181232788,1994,3181234782,16,0,1,2048,16,10202821454
1366,3181232818,97539,3181330357,18,0,0,12288,18,9217746975
1367,3181279780,64824,3181344604,14,0,0,1024,14,6787192369
1368,3181327087,6649,3181333736,15,0,1,9728,15,663271823
1369,3181345732,64217,3181409949,7,0,0,2560,7,653019822
1370,3181350240,6754,3181356994,13,0,1,7168,13,3256471810
1371,3181380238,94976,3181475214,6,0,0,16896,6,3780340317
1372,3181397339,9819,3181407158,14,0,1,6144,14,7332166621
1373,3181431738,185472,3181617210,3,0,0,7680,3,5334867512
1374,3181434564,1042,3181435606,7,0,1,1024,7,4154737074
1375,3181441618,57440,3181499058,4,0,0,4608,4,9180233871
1376,3181474835,92479,3181567314,10,0,0,27648,10,8288916161
1377,3181571883,50672,3181622555,19,0,0,2560,19,4788912429
1378,3181591204,43904,3181635108,17,0,0,512,17,9239291590
1379,3181596355,76684,3181673039,7,0,0,9728,7,2892491280
1380,3181621704,99959,3181721663,0,0,0,28160,0,3230897307
1381,3181628124,1042,3181629166,5,0,1,1024,5,9111149734
1382,3181631002,3898,3181634900,16,0,1,4096,16,3417717134
1383,3181642216,105539,3181747755,19,0,0,13312,19,9989513758
1384,3181705959,3645,3181709604,16,0,1,10240,16,797800702
1385,3181706731,82508,3181789239,5,0,0,1024,5,5124812699
1386,3181765006,7706,3181772712,10,0,1,8192,10,1366889944
1387,3181776734,45908,3181822642,15,0,0,2048,15,4773429884
1388,3181798631,161192,3181959823,12,0,0,27136,12,9298848233
1389,3181829824,83709,3181913533,5,0,0,512,5,10418962191
1390,3181864803,1518,3181866321,0,0,1,1536,0,5008392819
1391,3181884236,1518,3181885754,0,0,1,1536,0,2238125114
1392,3181885721,2470,3181888191,0,0,1,2560,0,1601753514
1393,3181914923,166038,3182080961,15,0,0,14848,15,75824928
1394,3181935688,1994,3181937682,6,0,1,2048,6,2388382910
1395,3182008649,96396,3182105045,7,0,0,8192,7,5149168684
1396,3182016301,101686,3182117987,1,0,0,9216,1,5003639959
1397,3182084366,2946,3182087312,6,0,1,3072,6,3676226865
1398,3182094796,138625,3182233421,9,0,0,36864,9,8046612648
1399,3182104926,4009,3182108935,11,0,1,4096,11,4623058460
1400,3182107541,2380,3182109921,6,0,1,1536,6,8857890084
1401,3182198436,75085,3182273521,0,0,0,6144,0,2782025210
1402,3182216006,2870,3182218876,8,0,1,8704,8,1245686268
1403,3182234824,4374,3182239198,0,0,1,4608,0,7693529663
1404,3182244053,566,3182244619,7,0,1,512,7,2553092150
1405,3182312986,276805,3182589791,16,0,0,56320,16,5995232706
1406,3182312988,131903,3182444891,12,0,0,92160,12,1781709750
1407,3182322998,6488,3182329486,10,0,1,15872,10,8742784810
1408,3182346552,158261,3182504813,19,0,0,55808,19,10519725276
1409,3182368866,162383,3182531249,1,0,0,26624,1,4048512807
1410,3182396494,53421,3182449915,7,0,0,1024,7,3745038436
1411,3182419899,119237,3182539136,8,0,1,156672,8,3777174442
1412,3182468252,100433,3182568685,17,0,0,1536,17,8557793808
1413,3182501080,228073,3182729153,9,0,0,124416,9,10233690116
1414,3182542111,239260,3182781371,18,0,0,145920,18,2056592004
1415,3182550888,566,3182551454,14,0,1,512,14,1453563732
1416,3182645650,136524,3182782174,1,0,0,2560,1,10307350228
1417,3182694796,37337,3182732133,2,0,1,3072,2,2900092883
1418,3182705590,121496,3182827086,11,0,0,21504,11,6484386553
1419,3182706887,129574,3182836461,0,0,0,30720,0,7577305720
1420,3182735999,114475,3182850474,4,0,0,10240,4,6089461681
1421,3182737084,186856,3182923940,13,0,0,62464,13,10702986334
1422,3182788101,246701,3183034802,0,0,0,47104,0,5026399650
1423,3182798768,7230,3182805998,13,0,1,7680,13,5309435913
1424,3182815380,164186,3182979566,0,0,0,27136,0,8009839013
1425,3182862081,151395,3183013476,8,0,0,27648,8,10258403849
1426,3182869589,242687,3183112276,6,0,0,63488,6,776718155
1427,3182885282,129933,3183015215,13,0,0,5632,13,7873277345
1428,3182911413,16465,3182927878,18,0,1,10752,18,2118841559
1429,3182914279,24245,3182938524,18,0,1,18432,18,332313399
1430,3182920302,22088,3182942390,15,0,1,6144,15,4652007307
1431,3182932638,180433,3183113071,14,0,0,2560,14,5168136698
1432,3182952895,566,3182953461,0,0,1,512,0,2537132477
1433,3182972703,11792,3182984495,16,0,1,12800,16,927476397
1434,3182980384,6510,3182986894,6,0,1,9728,6,10544935902
1435,3183007012,140130,3183147142,14,0,0,1024,14,2817983025
1436,3183026338,179160,3183205498,11,0,0,20480,11,7927566483
1437,3183026635,9702,3183036337,11,0,1,1536,11,8493271451
1438,3183047186,78523,3183125709,11,0,0,8192,11,2327565023
1439,3183059853,167676,3183227529,6,0,0,14336,6,10599418017
1440,3183085808,202592,3183288400,11,0,0,69632,11,9728959133
1441,3183103709,102272,3183205981,13,0,0,1536,13,9898031108
1442,3183156543,5196,3183161739,11,0,1,13312,11,8031918824
1443,3183168234,4850,3183173084,7,0,1,5120,7,7406871858
1444,3183221091,76579,3183297670,11,0,0,8192,11,4642225338
1445,3183249164,1994,3183251158,10,0,1,2048,10,6973143303
1446,3183305703,11016,3183316719,1,0,1,17920,1,8035189780
1447,3183305968,12057,3183318025,0,0,1,2048,0,3131095021
1448,3183316039,5196,3183321235,8,0,1,13312,8,2240226784
1449,3183494838,3898,3183498736,6,0,1,4096,6,6768204313
1450,3183547140,143073,3183690213,19,0,0,11776,19,2174921653
1451,3183550720,67592,3183618312,7,0,0,7680,7,4099980522
1452,3183592867,2946,3183595813,5,0,1,3072,5,6965260619
1453,3183608557,56216,3183664773,7,0,0,5632,7,2252299735
1454,3183678882,7706,3183686588,11,0,1,8192,11,8717610653
1455,3183711885,106964,3183818849,6,0,0,51200,6,9055688890
1456,3183761965,2946,3183764911,10,0,1,3072,10,2300778424
1457,3183775068,102821,3183877889,15,0,0,15872,15,1239872014
1458,3183814315,7472,3183821787,7,0,1,3072,7,5395351119
1459,3183822014,5802,3183827816,18,0,1,6144,18,1690145131
1460,3183830873,5196,3183836069,14,0,1,13312,14,10066046267
1461,3183832808,61912,3183894720,18,0,0,2048,18,10465857756
1462,3183846812,121101,3183967913,18,0,0,36864,18,10716781312
1463,3183858619,57440,3183916059,17,0,0,4608,17,3167285253
1464,3183882979,163046,3184046025,7,0,0,67072,7,2828525515
1465,3183894868,197113,3184091981,9,0,0,13312,9,10657759261
1466,3183905045,92836,3183997881,17,0,0,512,17,2120890230
1467,3183953656,14272,3183967928,4,0,1,6656,4,4998427996
1468,3184001217,126912,3184128129,9,0,0,36864,9,6281992300
1469,3184091657,155772,3184247429,8,0,0,139776,8,7685344186
1470,3184121873,125727,3184247600,5,0,0,512,5,6467890695
1471,3184149047,99504,3184248551,11,0,0,3072,11,3492229180
1472,3184263969,215993,3184479962,7,0,0,203776,7,5314065576
1473,3184267692,308816,3184576508,1,0,0,181760,1,10622984197
1474,3184272481,2470,3184274951,2,0,1,2560,2,2426063471
1475,3184280379,4850,3184285229,18,0,1,5120,18,6859114495
1476,3184292742,198335,3184491077,16,0,0,36352,16,3862561636
1477,3184332610,2870,3184335480,11,0,1,8704,11,6333958053
1478,3184357908,259799,3184617707,3,0,0,26112,3,3735878610
1479,3184370164,1518,3184371682,18,0,1,1536,18,8332904636
1480,3184402671,5971,3184408642,16,0,1,14848,16,7633989001
1481,3184429752,62827,3184492579,1,0,1,1536,1,98057432
1482,3184437850,171878,3184609728,6,0,0,38912,6,4105743865
1483,3184457736,194933,3184652669,0,0,0,28672,0,9535741892
1484,3184479170,17209,3184496379,11,0,1,5120,11,9241340502
1485,3184515988,60535,3184576523,8,0,1,8192,8,3929629132
1486,3184530522,49397,3184579919,9,0,1,9728,9,8626696715
1487,3184554816,26198,3184581014,9,0,1,1536,9,10356695704
1488,3184600155,22386,3184622541,14,0,1,5120,14,5267291145
1489,3184608702,133896,3184742598,11,0,0,65536,11,7730019784
1490,3184616987,6540,3184623527,4,0,1,1536,4,8393908210
1491,3184651573,92303,3184743876,14,0,0,512,14,6403705291
1492,3184656859,113003,3184769862,14,0,0,1536,14,491319529
1493,3184672157,71548,3184743705,19,0,0,3584,19,6693278605
1494,3184683319,566,3184683885,10,0,1,512,10,10572837869
1495,3184688277,58532,3184746809,4,0,0,8192,4,9041667445
1496,3184712230,86413,3184798643,6,0,0,15872,6,8145746825
1497,3184720362,23529,3184743891,11,0,1,15872,11,10431724714
1498,3184750426,1042,3184751468,11,0,1,1024,11,4235537165
1499,3184793758,7972,3184801730,0,0,1,9216,0,7620597745
1500,3184910765,43904,3184954669,18,0,0,512,18,9899568194
1501,3184943008,43904,3184986912,14,0,0,512,14,7354932062
1502,3184948292,50069,3184998361,18,0,0,512,18,6239096371
1503,3184948572,45596,3184994168,5,0,0,1024,5,4379692080
1504,3184976480,1518,3184977998,7,0,1,1536,7,7697770436
1505,3184993489,1518,3184995007,9,0,1,1536,9,10273311880
1506,3184999043,54992,3185054035,0,0,0,6656,0,8372746710
1507,3185027393,7230,3185034623,0,0,1,7680,0,1817670819
1508,3185027966,160971,3185188937,0,0,0,61440,0,4367909476
1509,3185040055,227867,3185267922,7,0,0,9728,7,799715528
1510,3185050472,12995,3185063467,8,0,1,25088,8,1218236938
1511,3185059628,8345,3185067973,13,0,1,7168,13,9578243816
1512,3185084374,1518,3185085892,10,0,1,1536,10,9430215742
1513,3185088184,44662,3185132846,8,0,1,76800,8,8383078709
1514,3185090764,98188,3185188952,8,0,1,128512,8,3684683294
1515,3185151280,38167,3185189447,8,0,1,15360,8,1910949985
1516,3185163514,188378,3185351892,16,0,0,57344,16,2935056805
1517,3185197697,273950,3185471647,1,0,0,59904,1,7669997456
1518,3185313021,135218,3185448239,18,0,0,512,18,1190131292
1519,3185363994,1518,3185365512,4,0,1,1536,4,3417174175
1520,3185444989,1042,3185446031,15,0,1,1024,15,10088667264
1521,3185450596,164343,3185614939,3,0,0,139776,3,3580407246
1522,3185474278,172569,3185646847,13,0,0,50688,13,2841095992
1523,3185477247,1518,3185478765,9,0,1,1536,9,859242072
1524,3185485531,5454,3185490985,2,0,1,13824,2,3227454810
1525,3185486106,5225,3185491331,1,0,1,512,1,1173673807
1526,3185497700,2870,3185500570,11,0,1,8704,11,8252968098
1527,3185514461,566,3185515027,18,0,1,512,18,5267483425
1528,3185521833,12049,3185533882,0,0,1,19968,0,10065540810
1529,3185522776,92342,3185615118,18,0,0,512,18,6170101285
1530,3185554119,273041,3185827160,10,0,0,17408,10,7816600411
1531,3185565634,99219,3185664853,16,0,0,17920,16,8421781251
1532,3185608116,430514,3186038630,12,0,0,165888,12,3285938234
1533,3185615953,3422,3185619375,15,0,1,3584,15,1541782129
1534,3185681277,270113,3185951390,9,0,0,35840,9,6147251526
1535,3185682585,77265,3185759850,17,0,0,512,17,6595702038
1536,3185696823,566,3185697389,6,0,1,512,6,6644342385
1537,3185697927,363103,3186061030,15,0,0,65536,15,2480244954
1538,3185711864,2470,3185714334,4,0,1,2560,4,5433136595
1539,3185747831,173047,3185920878,1,0,0,62976,1,5063650069
1540,3185750535,5326,3185755861,4,0,1,5632,4,3944486918
1541,3185774411,264562,3186038973,18,0,0,1024,18,3130275847
1542,3185798377,5802,3185804179,5,0,1,6144,5,5971201379
1543,3185816847,224192,3186041039,10,0,0,6656,10,6661927270
1544,3185858871,566,3185859437,16,0,1,512,16,4623287457
1545,3185895432,206845,3186102277,4,0,0,96256,4,4805868938
1546,3185906934,27553,3185934487,2,0,1,23040,2,1877489114
1547,3185907354,233014,3186140368,10,0,0,61952,10,9841895625
1548,3185930035,7678,3185937713,11,0,1,5120,11,1809366941
1549,3185939267,12138,3185951405,1,0,1,6656,1,9744457431
1550,3185970354,68634,3186038988,8,0,1,60928,8,1095953914
1551,3185982502,215770,3186198272,13,0,0,10752,13,8874686803
1552,3185991365,69680,3186061045,14,0,1,1024,14,4610590964
1553,3186012984,230948,3186243932,9,0,0,68608,9,9442058191
1554,3186128458,118609,3186247067,6,0,0,10240,6,9662895555
1555,3186149444,48999,3186198443,18,0,0,512,18,8773382032
1556,3186156030,110846,3186266876,17,0,0,512,17,4265386075
1557,3186170723,2946,3186173669,16,0,1,3072,16,4480772334
1558,3186343870,114608,3186458478,14,0,0,76288,14,4188075043
1559,3186347442,129810,3186477252,10,0,0,10752,10,8004308633
1560,3186362487,2470,3186364957,7,0,1,2560,7,88777170
1561,3186366547,129449,3186495996,12,0,0,11776,12,9723243486
1562,3186477156,64951,3186542107,17,0,0,512,17,6502904862
1563,3186498203,49136,3186547339,7,0,0,2560,7,9086051771
1564,3186553460,154894,3186708354,12,0,0,138752,12,1947557139
1565,3186559279,3645,3186562924,1,0,1,10240,1,8098551828
1566,3186589249,5326,3186594575,15,0,1,5632,15,9139276387
1567,3186634667,141113,3186775780,13,0,0,30720,13,8861721580
1568,3186677320,146418,3186823738,16,0,0,30720,16,6783296879
1569,3186678859,31030,3186709889,11,0,1,1536,11,9790155604
1570,3186715623,7230,3186722853,1,0,1,7680,1,1239010227
1571,3186722083,91899,3186813982,8,0,0,13824,8,9294971661
1572,3186776387,114274,3186890661,17,0,0,512,17,513202126
1573,3186781534,328964,3187110498,19,0,0,70144,19,5388829030
1574,3186808219,103220,3186911439,9,0,0,38912,9,5071184470
1575,3186829449,187644,3187017093,9,0,0,102912,9,2029728797
1576,3186884256,2470,3186886726,16,0,1,2560,16,7345749121
1577,3186904981,184130,3187089111,9,0,0,80384,9,9902131184
1578,3186985526,31582,3187017108,6,0,1,5120,6,10718094400
1579,3187083647,75823,3187159470,18,0,0,2048,18,10017206167
1580,3187098493,19252,3187117745,18,0,1,7680,18,3312880906
1581,3187117852,566,3187118418,9,0,1,512,9,1700688085
1582,3187170226,169605,3187339831,14,0,0,22016,14,315010426
1583,3187179013,6488,3187185501,4,0,1,15872,4,1699827884
1584,3187325959,47444,3187373403,18,0,0,2048,18,1654720413
1585,3187330337,50672,3187381009,18,0,0,2560,18,3164409168
1586,3187349158,3645,3187352803,9,0,1,10240,9,10681824471
1587,3187353796,140829,3187494625,0,0,0,75776,0,2318174958
1588,3187444346,147023,3187591369,1,0,0,88576,1,6218211685
1589,3187458179,185648,3187643827,16,0,0,32768,16,1778089920
1590,3187468753,1042,3187469795,15,0,1,1024,15,2436603679
1591,3187476296,235943,3187712239,12,0,0,111104,12,5373841121
1592,3187488512,7172,3187495684,13,0,1,1024,13,3211487092
1593,3187552047,169114,3187721161,4,0,0,8192,4,8999395289
1594,3187588305,14589,3187602894,8,0,1,18944,8,10582111276
1595,3187626001,4374,3187630375,11,0,1,4608,11,3172369545
1596,3187644545,1994,3187646539,18,0,1,2048,18,5095419751
1597,3187661538,132517,3187794055,1,0,0,19456,1,6050115289
1598,3187668311,74092,3187742403,1,0,0,12800,1,2076011953
1599,3187711667,4938,3187716605,4,0,1,4608,4,3473089111
1600,3187763577,3898,3187767475,7,0,1,4096,7,6385765688
1601,3187802549,47288,3187849837,5,0,0,1536,5,10078389155
1602,3187816586,4937,3187821523,14,0,1,12800,14,6818505269
1603,3187917901,105875,3188023776,9,0,0,44544,9,5509748147
1604,3187941981,47288,3187989269,17,0,0,1536,17,3734860953
1605,3187968976,105929,3188074905,8,0,1,176128,8,7950650206
1606,3187992259,85872,3188078131,6,0,1,5120,6,6294904071
1607,3188007534,170967,3188178501,12,0,0,49152,12,9098657218
1608,3188012062,170855,3188182917,3,0,0,8192,3,5922989529
1609,3188025755,53042,3188078797,2,0,1,1024,2,6922333998
1610,3188030704,49169,3188079873,1,0,1,13312,1,7711882057
1611,3188056552,147563,3188204115,17,0,0,1024,17,7536140780
1612,3188124769,3128,3188127897,6,0,1,9216,6,1269730966
1613,3188198156,183810,3188381966,3,0,0,42496,3,8988176972
1614,3188198324,52364,3188250688,16,0,0,3072,16,5502704330
1615,3188212772,121574,3188334346,16,0,0,49664,16,2491003327
1616,3188247958,566,3188248524,9,0,1,512,9,4568716589
1617,3188323347,205943,3188529290,1,0,0,17408,1,7753915503
1618,3188331431,128883,3188460314,14,0,0,30208,14,4056162141
1619,3188366649,126032,3188492681,19,0,0,22016,19,6222366187
1620,3188443196,1518,3188444714,18,0,1,1536,18,6524835720
1621,3188450443,44515,3188494958,18,0,0,512,18,1112338096
1622,3188451622,11154,3188462776,5,0,1,2560,5,8712780206
1623,3188479567,63452,3188543019,8,0,0,9216,8,2560385043
1624,3188505692,4374,3188510066,16,0,1,4608,16,4657779530
1625,3188604984,58220,3188663204,13,0,0,7168,13,9630372435
1626,3188729871,106028,3188835899,15,0,0,48128,15,5389739233
1627,3188794607,70476,3188865083,5,0,0,512,5,5925372517
1628,3188877815,4850,3188882665,5,0,1,5120,5,2754240420
1629,3188879906,3745,3188883651,18,0,1,1536,18,3606982935
1630,3188880107,6545,3188886652,4,0,1,15360,4,3762692099
1631,3188908808,2870,3188911678,11,0,1,8704,11,10471891623
1632,3188931991,128180,3189060171,0,0,0,120832,0,1345767754
1633,3188950872,3898,3188954770,0,0,1,4096,0,5825405976
1634,3188954700,301436,3189256136,4,0,0,54272,4,7062626462
1635,3188966150,341148,3189307298,13,0,0,115200,13,658018744
1636,3188992992,91131,3189084123,0,0,0,5632,0,1663932527
1637,3189032447,30203,3189062650,13,0,1,2560,13,8569634879
1638,3189052312,174344,3189226656,0,0,0,45056,0,8349603613
1639,3189123492,4850,3189128342,7,0,1,5120,7,1943744134
1640,3189134626,54536,3189189162,5,0,0,1536,5,9906447028
1641,3189138400,2470,3189140870,13,0,1,2560,13,9144002493
1642,3189225507,2183,3189227690,10,0,1,1024,10,4612946852
1643,3189253352,7626,3189260978,10,0,1,5120,10,5987530987
1644,3189264994,48131,3189313125,5,0,0,512,5,7367133780
1645,3189269050,43904,3189312954,5,0,0,512,5,9916931624
1646,3189494330,43904,3189538234,5,0,0,512,5,3012189393
1647,3189522976,3422,3189526398,4,0,1,3584,4,9930755259
1648,3189597668,1518,3189599186,6,0,1,1536,6,7316077945
1649,3189633849,1042,3189634891,0,0,1,1024,0,10068524879
1650,3189696694,5326,3189702020,11,0,1,5632,11,939353054
1651,3189707589,7706,3189715295,10,0,1,8192,10,5667683716
1652,3189717819,52736,3189770555,18,0,0,1024,18,2317237242
1653,3189755719,108524,3189864243,16,0,0,56320,16,8307004581
1654,3189758431,6278,3189764709,5,0,1,6656,5,1652427130
1655,3189793448,2470,3189795918,7,0,1,2560,7,496982470
1656,3189796223,70726,3189866949,9,0,0,3584,9,2668259895
1657,3189820945,3422,3189824367,6,0,1,3584,6,9641886211
1658,3189829279,1042,3189830321,10,0,1,1024,10,5317667421
1659,3189858996,6757,3189865753,2,0,1,1536,2,2461094245
1660,3189875053,566,3189875619,13,0,1,512,13,1948699652
1661,3189904550,2946,3189907496,2,0,1,3072,2,5242975328
1662,3189915201,131473,3190046674,13,0,0,26624,13,2347865485
1663,3189921139,3422,3189924561,0,0,1,3584,0,7573096934
1664,3189922163,112325,3190034488,12,0,0,42496,12,6405069337
1665,3189923169,198648,3190121817,19,0,0,97792,19,2090315964
1666,3189932105,2870,3189934975,5,0,1,8704,5,3562835736
1667,3189941267,145535,3190086802,3,0,0,2048,3,4145766748
1668,3189963462,24670,3189988132,5,0,1,44544,5,8986258837
1669,3189974701,14417,3189989118,11,0,1,1536,11,6696149782
1670,3190129983,1518,3190131501,1,0,1,1536,1,8149973246
1671,3190133242,566,3190133808,1,0,1,512,1,6315095402
1672,3190136764,5196,3190141960,10,0,1,13312,10,6780310226
1673,3190146893,3645,3190150538,6,0,1,10240,6,6005324606
1674,3190156411,129296,3190285707,9,0,0,27136,9,7737356362
1675,3190181259,5326,3190186585,0,0,1,5632,0,7585607205
1676,3190213068,87164,3190300232,17,0,0,21504,17,1583723975
1677,3190276258,9464,3190285722,1,0,1,5120,1,4496851365
1678,3190286397,102596,3190388993,10,0,0,36864,10,560521278
1679,3190304453,4374,3190308827,15,0,1,4608,15,3171843995
1680,3190333054,59514,3190392568,0,0,0,2560,0,781293966
1681,3190340924,108603,3190449527,3,0,0,32768,3,8462132503
1682,3190414744,91436,3190506180,3,0,0,15360,3,8677480283
1683,3190452414,1042,3190453456,0,0,1,1024,0,1903999601
1684,3190453493,4679,3190458172,13,0,1,12288,13,8286467476
1685,3190483730,157797,3190641527,11,0,0,33280,11,4746122273
1686,3190488265,167005,3190655270,0,0,0,45056,0,314262277
1687,3190515793,212072,3190727865,16,0,0,100352,16,4278525830
1688,3190552461,3645,3190556106,0,0,1,10240,0,5249236347
1689,3190553835,198022,3190751857,15,0,0,7168,15,2318707800
1690,3190567821,241267,3190809088,6,0,0,89088,6,6369612011
1691,3190646739,12421,3190659160,14,0,1,4096,14,3510370284
1692,3190676006,99053,3190775059,5,0,0,1536,5,1911938920
1693,3190716007,60830,3190776837,18,0,0,2048,18,3055539226
1694,3190742389,9483,3190751872,13,0,1,8192,13,5834062794
1695,3190782914,29129,3190812043,8,0,1,3072,8,5096643021
1696,3190803603,74786,3190878389,12,0,0,8192,12,7454560069
1697,3190818189,2470,3190820659,9,0,1,2560,9,5012541428
1698,3190835279,1994,3190837273,18,0,1,2048,18,9561104776
1699,3190846722,279056,3191125778,16,0,0,293376,16,5637260045
1700,3190853975,387231,3191241206,14,0,0,82944,14,1411259992
1701,3190883987,4850,3190888837,18,0,1,5120,18,1880982012
1702,3190913546,220086,3191133632,4,0,0,23552,4,10496141026
1703,3190916949,209468,3191126417,5,0,0,2048,5,2202469399
1704,3190917584,1994,3190919578,7,0,1,2048,7,4396684508
1705,3190923250,4162,3190927412,7,0,1,11264,7,1560935728
1706,3190936562,258582,3191195144,14,0,0,68608,14,2015581778
1707,3190960191,173932,3191134123,1,0,0,1536,1,351276447
1708,3190963325,183927,3191147252,14,0,0,2560,14,6004954563
1709,3191046181,91571,3191137752,2,0,1,10240,2,2492600778
1710,3191076963,271763,3191348726,1,0,0,35328,1,1817671011
1711,3191086352,171832,3191258184,5,0,0,512,5,8674225241
1712,3191096652,54717,3191151369,9,0,1,24064,9,3910264884
1713,3191114104,189573,3191303677,19,0,0,100864,19,7825634406
1714,3191132425,25153,3191157578,1,0,1,21504,1,9900476773
1715,3191164911,278214,3191443125,7,0,0,49664,7,10208501806
1716,3191186236,24221,3191210457,8,0,1,29696,8,2333637768
1717,3191195338,232640,3191427978,13,0,0,14848,13,6845584737
1718,3191215680,148201,3191363881,13,0,0,49664,13,6161129453
1719,3191301716,12194,3191313910,14,0,1,16384,14,3489897978
1720,3191307570,9886,3191317456,18,0,1,5632,18,3219320222
1721,3191343288,146962,3191490250,7,0,0,9728,7,10667437978
1722,3191356212,191711,3191547923,13,0,0,2560,13,10135956737
1723,3191359505,6863,3191366368,1,0,1,2560,1,5355065976
1724,3191399449,1994,3191401443,4,0,1,2048,4,7838703996
1725,3191410782,3898,3191414680,18,0,1,4096,18,1857362240
1726,3191415501,101192,3191516693,8,0,0,32256,8,1216273387
1727,3191459208,81815,3191541023,17,0,0,5120,17,3146083837
1728,3191465719,6278,3191471997,0,0,1,6656,0,2425086845
1729,3191486843,121419,3191608262,9,0,0,18432,9,3295659843
1730,3191536087,88561,3191624648,13,0,0,512,13,5096977498
1731,3191550064,99814,3191649878,13,0,0,1536,13,3231077183
1732,3191612671,566,3191613237,14,0,1,512,14,753542085
1733,3191645411,5326,3191650737,13,0,1,5632,13,2799836290
1734,3191661160,13858,3191675018,8,0,1,23552,8,5091807004
1735,3191662527,269925,3191932452,11,0,0,26112,11,3915197974
1736,3191668794,7530,3191676324,9,0,1,2048,9,8887734689
1737,3191739849,70548,3191810397,1,0,0,6656,1,6905464203
1738,3191765303,4374,3191769677,18,0,1,4608,18,4834611416
1739,3191766287,74829,3191841116,16,0,0,9728,16,3275875327
1740,3191804513,1042,3191805555,15,0,1,1024,15,8663497292
1741,3191819397,125163,3191944560,4,0,0,20480,4,3012436022
1742,3191819436,2872,3191822308,14,0,1,8704,14,8797687836
1743,3191857325,52364,3191909689,18,0,0,3072,18,4792520679
1744,3191918837,70879,3191989716,14,0,0,5120,14,1719218043
1745,3191970605,150470,3192121075,14,0,0,91136,14,6778727493
1746,3191979938,6229,3191986167,6,0,1,15360,6,9903036614
1747,3191986717,1042,3191987759,10,0,1,1024,10,9292764666
1748,3191992883,1042,3191993925,0,0,1,1024,0,714960291
1749,3192000322,162063,3192162385,13,0,0,1536,13,5255021518
1750,3192055981,11533,3192067514,18,0,1,18944,18,1450736214
1751,3192058468,223325,3192281793,9,0,0,58880,9,8650177962
1752,3192060660,7110,3192067770,7,0,1,9216,7,3365495323
1753,3192066426,4374,3192070800,0,0,1,4608,0,3040387906
1754,3192067340,53750,3192121090,8,0,1,49664,8,5285681959
1755,3192111012,12557,3192123569,2,0,1,2560,2,6567349339
1756,3192111890,150989,3192262879,14,0,0,60416,14,3458717720
1757,3192170367,3422,3192173789,18,0,1,3584,18,1105120309
1758,3192190756,94040,3192284796,10,0,0,9728,10,3575350614
1759,3192195036,68794,3192263830,12,0,0,3072,12,2233108887
1760,3192201182,107466,3192308648,18,0,0,512,18,6198699368
1761,3192257840,26979,3192284819,18,0,1,3072,18,7594203819
1762,3192264790,21959,3192286749,15,0,1,2048,15,7850179991
1763,3192268848,99838,3192368686,10,0,0,22528,10,2421145611
1764,3192296964,121085,3192418049,15,0,0,11264,15,2939992127
1765,3192312719,3422,3192316141,2,0,1,3584,2,7812920087
1766,3192322745,180522,3192503267,7,0,0,62976,7,5062222635
1767,3192378226,165691,3192543917,11,0,0,44032,11,6340880376
1768,3192381812,122406,3192504218,19,0,0,3072,19,3816682193
1769,3192426975,6278,3192433253,7,0,1,6656,7,8069699927
1770,3192430321,7758,3192438079,13,0,1,7680,13,99694276
1771,3192433398,74706,3192508104,13,0,0,2048,13,5859973907
1772,3192442776,61613,3192504389,0,0,0,512,0,9236118111
1773,3192504928,11274,3192516202,13,0,1,18432,13,4131085433
1774,3192542381,57276,3192599657,19,0,0,4096,19,9216648617
1775,3192584543,54358,3192638901,8,0,1,89088,8,5449812632
1776,3192587239,52968,3192640207,18,0,1,2048,18,6060882492
1777,3192610982,140126,3192751108,16,0,0,15360,16,2885864099
1778,3192634830,7003,3192641833,9,0,1,2560,9,2744405090
1779,3192653529,566,3192654095,1,0,1,512,1,1019826085
1780,3192698168,566,3192698734,6,0,1,512,6,9729714223
1781,3192699517,121135,3192820652,7,0,0,6144,7,9091195122
1782,3192707176,4937,3192712113,6,0,1,12800,6,9948588275
1783,3192727392,81634,3192809026,11,0,0,7168,11,1184323414
1784,3192740661,1518,3192742179,0,0,1,1536,0,7542903109
1785,3192851417,43904,3192895321,13,0,0,512,13,3473965210
1786,3192858172,94221,3192952393,5,0,0,1024,5,5273387457
1787,3192872194,4850,3192877044,4,0,1,5120,4,5922729469
1788,3192891353,7230,3192898583,13,0,1,7680,13,2387022625
1789,3192938029,244202,3193182231,7,0,0,124416,7,10011942692
1790,3192947594,4162,3192951756,13,0,1,11264,13,2852078645
1791,3192966853,177455,3193144308,15,0,0,106496,15,2436306016
1792,3193071851,10499,3193082350,18,0,1,16896,18,4991738749
1793,3193077482,125198,3193202680,9,0,0,4608,9,1010555006
1794,3193101916,2946,3193104862,8,0,1,3072,8,6267604901
1795,3193137583,90239,3193227822,6,0,0,1024,6,7364160541
1796,3193137736,141804,3193279540,6,0,0,19456,6,1616954874
1797,3193146578,38641,3193185219,16,0,1,3072,16,1595809099
1798,3193219560,5971,3193225531,7,0,1,14848,7,10385391481
1799,3193271267,1994,3193273261,5,0,1,2048,5,6456740785
1800,3193278700,255052,3193533752,14,0,0,36352,14,6291495795
1801,3193283074,279367,3193562441,18,0,0,512,18,6694767541
1802,3193311673,259569,3193571242,8,0,0,512,8,4953054084
1803,3193331261,1518,3193332779,13,0,1,1536,13,2753169147
1804,3193333095,118129,3193451224,19,0,0,43520,19,615632967
1805,3193354673,2870,3193357543,0,0,1,8704,0,9617958290
1806,3193364255,198015,3193562270,16,0,0,17920,16,8915175819
1807,3193380976,12995,3193393971,8,0,1,25088,8,2164753629
1808,3193388115,7162,3193395277,0,0,1,2048,0,1910897238
1809,3193401419,121242,3193522661,17,0,0,52736,17,9308857394
1810,3193515821,149362,3193665183,9,0,0,39936,9,9249021772
1811,3193527489,9226,3193536715,14,0,1,3072,14,8843253831
1812,3193535776,48980,3193584756,18,0,0,2048,18,4306350733
1813,3193539863,6229,3193546092,4,0,1,15360,4,808423405
1814,3193589395,1042,3193590437,1,0,1,1024,1,6955222764
1815,3193624819,47288,3193672107,5,0,0,1536,5,7980665087
1816,3193631479,73844,3193705323,15,0,0,3072,15,1380168921
1817,3193639274,3422,3193642696,2,0,1,3584,2,8646871322
1818,3193643430,93908,3193737338,6,0,0,18432,6,443950434
1819,3193658470,7271,3193665741,14,0,1,512,14,9783448013
1820,3193665314,3453,3193668767,16,0,1,9728,16,3394677386
1821,3193679733,102877,3193782610,4,0,0,22528,4,2775329214
1822,3193699078,160062,3193859140,19,0,0,16896,19,5865966529
1823,3193705947,132491,3193838438,16,0,0,3584,16,9037821350
1824,3193747258,6278,3193753536,16,0,1,6656,16,4740936474
1825,3193779067,116850,3193895917,17,0,0,14848,17,7063845074
1826,3193791200,100178,3193891378,15,0,0,11776,15,7502820065
1827,3193791836,122903,3193914739,5,0,0,512,5,9645485313
1828,3193796539,7706,3193804245,14,0,1,8192,14,8133476168
1829,3193809616,104936,3193914552,14,0,0,44544,14,2017782801
1830,3193907026,51422,3193958448,18,0,0,512,18,682316753
1831,3193907670,138648,3194046318,19,0,0,60928,19,8179289003
1832,3193971827,43904,3194015731,13,0,0,512,13,7970748318
1833,3193987079,4679,3193991758,16,0,1,12288,16,3988520812
1834,3193988239,9121,3193997360,15,0,1,15872,15,6305272573
1835,3194005967,119813,3194125780,17,0,0,46080,17,7633139249
1836,3194024544,3128,3194027672,13,0,1,9216,13,6266573206
1837,3194025434,218503,3194243937,4,0,0,26112,4,6623841678
1838,3194052138,130411,3194182549,17,0,0,51712,17,6998433786
1839,3194110626,103573,3194214199,12,0,0,13312,12,5708903920
1840,3194163763,57554,3194221317,17,0,0,3072,17,821329026
1841,3194171560,12975,3194184535,9,0,1,2048,9,9012292135
1842,3194189527,6278,3194195805,4,0,1,6656,4,5834914586
1843,3194231112,175514,3194406626,1,0,0,83968,1,3137469095
1844,3194236211,222801,3194459012,11,0,0,78336,11,8704232857
1845,3194290970,4679,3194295649,14,0,1,12288,14,9168659535
1846,3194404495,116311,3194520806,11,0,0,48128,11,7027917830
1847,3194424926,77900,3194502826,9,0,0,11264,9,5092725117
1848,3194425477,181129,3194606606,16,0,0,56832,16,1555640885
1849,3194432935,1042,3194433977,11,0,1,1024,11,9356928140
1850,3194467161,566,3194467727,0,0,1,512,0,7987106073
1851,3194493143,566,3194493709,2,0,1,512,2,221230845
1852,3194532888,1994,3194534882,7,0,1,2048,7,3171532613
1853,3194533589,1959,3194535548,7,0,1,1024,7,9296085682
1854,3194623140,43904,3194667044,5,0,0,512,5,721787301
1855,3194663593,1042,3194664635,2,0,1,1024,2,10572094959
1856,3194670480,99788,3194770268,9,0,0,27648,9,9419708941
1857,3194671663,136801,3194808464,12,0,0,16896,12,1746180389
1858,3194676754,113653,3194790407,11,0,0,66048,11,8830004342
1859,3194677925,1042,3194678967,2,0,1,1024,2,7014599732
1860,3194692130,65604,3194757734,13,0,0,512,13,7947474192
1861,3194746607,1994,3194748601,1,0,1,2048,1,174199504
1862,3194748683,1042,3194749725,7,0,1,1024,7,8085529294
1863,3194759203,2470,3194761673,15,0,1,2560,15,4081089650
1864,3194862878,1518,3194864396,5,0,1,1536,5,9862214927
1865,3194893495,1518,3194895013,10,0,1,1536,10,3395008687
1866,3194942667,2946,3194945613,15,0,1,3072,15,3996348878
1867,3194948375,3422,3194951797,2,0,1,3584,2,8340424822
1868,3194972141,73776,3195045917,7,0,0,4096,7,3606252767
1869,3195002898,55748,3195058646,15,0,0,4096,15,1273340821
1870,3195021249,125891,3195147140,14,0,0,66560,14,6939853911
1871,3195049184,7706,3195056890,4,0,1,8192,4,10698949206
1872,3195103187,137369,3195240556,19,0,0,7680,19,252330104
1873,3195128767,23708,3195152475,6,0,1,5632,6,8878013419
1874,3195145763,178805,3195324568,16,0,0,24064,16,5691674503
1875,3195192084,105404,3195297488,4,0,0,46080,4,8203692495
1876,3195253396,1518,3195254914,15,0,1,1536,15,5972427350
1877,3195297826,123822,3195421648,15,0,0,43008,15,2424314082
1878,3195339957,2470,3195342427,16,0,1,2560,16,9524086571
1879,3195408716,65288,3195474004,14,0,0,3072,14,5791688654
1880,3195458063,105092,3195563155,16,0,0,45056,16,412933581
1881,3195465134,134837,3195599971,9,0,0,34816,9,702623925
1882,3195483856,2870,3195486726,14,0,1,8704,14,9764739084
1883,3195497972,196199,3195694171,16,0,0,15872,16,1312761269
1884,3195499365,1518,3195500883,13,0,1,1536,13,9701841317
1885,3195572051,2946,3195574997,2,0,1,3072,2,5966211570
1886,3195586758,1042,3195587800,1,0,1,1024,1,4940806378
1887,3195591094,16575,3195607669,15,0,1,8192,15,5090118973
1888,3195645247,3422,3195648669,4,0,1,3584,4,9418784607
1889,3195709372,118263,3195827635,12,0,0,28160,12,8153720899
1890,3195730599,566,3195731165,7,0,1,512,7,4162311777
1891,3195740079,3645,3195743724,1,0,1,10240,1,10631863923
1892,3195751694,2470,3195754164,7,0,1,2560,7,5317580763
1893,3195777017,130688,3195907705,12,0,0,62976,12,5071258387
1894,3195791847,2470,3195794317,11,0,1,2560,11,372045938
1895,3195796169,64946,3195861115,13,0,0,512,13,6705645441
1896,3195807075,159563,3195966638,14,0,0,26112,14,498770038
1897,3195863538,45596,3195909134,7,0,0,1024,7,9101535709
1898,3195867923,163857,3196031780,14,0,0,43008,14,7885989734
1899,3195890500,171346,3196061846,1,0,0,38912,1,6320441113
1900,3195890739,154004,3196044743,15,0,0,42496,15,4265363679
1901,3195903264,5066,3195908330,7,0,1,512,7,9258362254
1902,3195906523,4819,3195911342,16,0,1,3584,16,2847474324
1903,3195931241,256785,3196188026,9,0,0,47104,9,7980534019
1904,3195940729,1042,3195941771,9,0,1,1024,9,9852215605
1905,3195993676,139114,3196132790,14,0,0,27136,14,8595842843
1906,3196048207,67592,3196115799,8,0,0,7680,8,28640973
1907,3196148536,114999,3196263535,3,0,0,46592,3,1596194753
1908,3196170502,17547,3196188049,2,0,1,15872,2,10061435773
1909,3196172984,143020,3196316004,14,0,0,512,14,7260759312
1910,3196183939,170718,3196354657,3,0,0,112640,3,6598172730
1911,3196202816,566,3196203382,7,0,1,512,7,3162288949
1912,3196204417,313534,3196517951,1,0,0,70656,1,2462696098
1913,3196219294,3422,3196222716,4,0,1,3584,4,10395451121
1914,3196251750,14264,3196266014,18,0,1,2560,18,9875855810
1915,3196262496,5784,3196268280,4,0,1,3584,4,3379196684
1916,3196290983,166502,3196457485,1,0,0,14336,1,7683837987
1917,3196349787,132551,3196482338,14,0,0,29184,14,5549139154
1918,3196409814,111904,3196521718,14,0,0,12288,14,9668993233
1919,3196484702,123444,3196608146,12,0,0,81920,12,3919965065
1920,3196510338,14761,3196525099,8,0,1,3584,8,525717356
1921,3196519274,10331,3196529605,13,0,1,7168,13,4213096096
1922,3196537524,266860,3196804384,15,0,0,46592,15,3940171169
1923,3196543356,11274,3196554630,13,0,1,18432,13,8246834800
1924,3196565382,163876,3196729258,10,0,0,17920,10,6068246395
1925,3196598416,106188,3196704604,6,0,0,5120,6,10551569354
1926,3196656260,1994,3196658254,2,0,1,2048,2,10034685777
1927,3196679195,4937,3196684132,16,0,1,12800,16,10676923021
1928,3196701027,145627,3196846654,19,0,0,12800,19,5570803354
1929,3196715951,105716,3196821667,8,0,0,47104,8,10560359956
1930,3196755938,73379,3196829317,13,0,0,512,13,4242758481
1931,3196756927,64911,3196821838,18,0,0,512,18,3307038664
1932,3196760689,133266,3196893955,10,0,0,19968,10,8435948302
1933,3196775531,46634,3196822165,1,0,0,1024,1,4686290428
1934,3196778924,1042,3196779966,16,0,1,1024,16,1578641352
1935,3196825483,2946,3196828429,6,0,1,3072,6,9908086611
1936,3196844206,227439,3197071645,10,0,0,25088,10,559830019
1937,3196847003,118556,3196965559,15,0,0,10752,15,6546815782
1938,3196851488,12737,3196864225,8,0,1,24576,8,280828350
1939,3196902921,137804,3197040725,1,0,0,32768,1,8779444589
1940,3196915536,4374,3196919910,1,0,1,4608,1,3817839327
1941,3196918584,136196,3197054780,3,0,0,46080,3,2071900943
1942,3196935944,3422,3196939366,6,0,1,3584,6,4718382465
1943,3196942645,164646,3197107291,6,0,0,19968,6,2487465623
1944,3196967301,213790,3197181091,3,0,0,100864,3,9233875533
1945,3197045386,99376,3197144762,18,0,0,512,18,1308596072
1946,3197106701,8288,3197114989,18,0,1,8192,18,6425391810
1947,3197121039,102077,3197223116,12,0,0,29696,12,3152127260
1948,3197139703,4374,3197144077,15,0,1,4608,15,3564974780
1949,3197194313,48980,3197243293,11,0,0,2048,11,4560333300
1950,3197199617,207574,3197407191,10,0,0,115712,10,4106444925
1951,3197231077,74672,3197305749,3,0,0,10752,3,1388803373
1952,3197261231,220965,3197482196,15,0,0,6656,15,4766694381
1953,3197294275,157951,3197452226,8,0,0,10240,8,30329170
1954,3197298886,2470,3197301356,13,0,1,2560,13,5605449996
1955,3197310694,205681,3197516375,15,0,0,112128,15,10216252080
1956,3197334651,214457,3197549108,16,0,0,59904,16,1297234211
1957,3197437486,177672,3197615158,6,0,0,47616,6,8781475658
1958,3197469016,83703,3197552719,7,0,0,11776,7,3561390859
1959,3197479757,100043,3197579800,18,0,0,1024,18,8021390257
1960,3197510634,9155,3197519789,18,0,1,3584,18,6267251128
1961,3197520450,3904,3197524354,9,0,1,10752,9,4060224313
1962,3197538988,15684,3197554672,10,0,1,2048,10,4411354688
1963,3197575323,119681,3197695004,5,0,0,512,5,3769076304
1964,3197613599,6877,3197620476,10,0,1,5632,10,3604882505
1965,3197722404,1994,3197724398,9,0,1,2048,9,5184669768
1966,3197724158,65900,3197790058,16,0,0,7168,16,2054482178
1967,3197769262,91796,3197861058,16,0,0,26624,16,6353213124
1968,3197777826,4162,3197781988,6,0,1,11264,6,5462522016
1969,3197798010,4850,3197802860,2,0,1,5120,2,8943519570
1970,3197811058,136130,3197947188,7,0,0,76288,7,9812751793
1971,3197819744,566,3197820310,7,0,1,512,7,10579508230
1972,3197825068,45596,3197870664,5,0,0,1024,5,3957199738
1973,3197833402,4374,3197837776,6,0,1,4608,6,5699827642
1974,3197894838,6754,3197901592,13,0,1,7168,13,5021095336
1975,3197971810,131581,3198103391,15,0,0,21504,15,2558101183
1976,3197981868,211397,3198193265,0,0,0,83456,0,10443584073
1977,3198016408,346256,3198362664,6,0,0,27136,6,1230589368
1978,3198028471,200530,3198229001,8,0,0,39424,8,108966588
1979,3198082372,209197,3198291569,10,0,0,83456,10,10013250708
1980,3198091964,3645,3198095609,9,0,1,10240,9,8917525275
1981,3198097517,64374,3198161891,10,0,0,3072,10,9738462585
1982,3198147344,5802,3198153146,1,0,1,6144,1,8938407112
1983,3198176521,193103,3198369624,1,0,0,4608,1,7510005186
1984,3198197911,566,3198198477,15,0,1,512,15,2448207145
1985,3198223070,6489,3198229559,1,0,1,512,1,8205119242
1986,3198243538,210368,3198453906,14,0,0,53248,14,7861104788
1987,3198260317,1042,3198261359,10,0,1,1024,10,6752337815
1988,3198285202,254177,3198539379,5,0,0,18432,5,8523823834
1989,3198336178,5326,3198341504,7,0,1,5632,7,2171460042
1990,3198371007,162741,3198533748,11,0,0,72192,11,10652381357
1991,3198381818,127485,3198509303,0,0,0,17920,0,10619935775
1992,3198398730,153881,3198552611,17,0,0,1536,17,279017763
1993,3198488127,2870,3198490997,6,0,1,8704,6,7600653905
1994,3198490565,3209,3198493774,2,0,1,3072,2,177301445
1995,3198555748,94976,3198650724,7,0,0,16896,7,3978471136
1996,3198619037,2946,3198621983,13,0,1,3072,13,6485003892
1997,3198649815,152003,3198801818,11,0,0,53248,11,10394926076
1998,3198779308,108836,3198888144,17,0,0,57344,17,9852028808
1999,3198849701,3898,3198853599,15,0,1,4096,15,4510475718
2000,3198857570,55148,3198912718,12,0,0,7168,12,716925817
2001,3198858205,3898,3198862103,2,0,1,4096,2,5146897346
2002,3198926525,6754,3198933279,7,0,1,7168,7,1229707747
2003,3198992364,64364,3199056728,9,0,0,7168,9,584812735
2004,3199030142,110688,3199140830,14,0,0,50176,14,561870984
2005,3199032139,3422,3199035561,13,0,1,3584,13,9214831521
2006,3199073869,165286,3199239155,8,0,0,4608,8,5226420411
2007,3199086658,6278,3199092936,7,0,1,6656,7,10436173482
2008,3199092895,3645,3199096540,1,0,1,10240,1,4220105333
2009,3199116148,77324,3199193472,7,0,0,19456,7,6092081450
2010,3199129544,159286,3199288830,8,0,0,104448,8,7688276730
2011,3199182699,158788,3199341487,5,0,0,98816,5,10010428999
2012,3199187674,159444,3199347118,0,0,0,18432,0,2175272995
2013,3199200642,199104,3199399746,14,0,0,19968,14,8890536764
2014,3199207225,104139,3199311364,6,0,0,4608,6,364354581
2015,3199214455,179192,3199393647,7,0,0,30208,7,4559979734
2016,3199225438,122178,3199347616,18,0,0,512,18,2060578082
2017,3199244255,103532,3199347787,13,0,0,512,13,7569599521
2018,3199247363,50394,3199297757,13,0,0,1024,13,5813084361
2019,3199251725,95720,3199347445,18,0,0,1024,18,3706723211
2020,3199274329,25009,3199299338,9,0,1,16896,9,6866361533
2021,3199288442,14442,3199302884,2,0,1,5632,2,4140638993
2022,3199349641,5802,3199355443,11,0,1,6144,11,9027644905
2023,3199376724,196208,3199572932,5,0,0,182784,5,10604919887
2024,3199431840,3645,3199435485,18,0,1,10240,18,2087444895
2025,3199455498,176547,3199632045,0,0,0,31232,0,10661888658
2026,3199495495,175805,3199671300,19,0,0,12288,19,1152509386
2027,3199497175,75928,3199573103,18,0,0,512,18,1521517944
2028,3199544423,31635,3199576058,10,0,1,3072,10,1936672184
2029,3199546613,169558,3199716171,5,0,0,79360,5,218271923
2030,3199616157,118935,3199735092,12,0,0,7680,12,7940757256
2031,3199626140,6463,3199632603,7,0,1,512,7,2701591046
2032,3199769956,2870,3199772826,5,0,1,8704,5,8338346463
2033,3199874836,108212,3199983048,3,0,0,55296,3,6710317540
2034,3199880775,62984,3199943759,14,0,0,7680,14,9195104176
2035,3199884500,3422,3199887922,5,0,1,3584,5,9193503479
2036,3199886316,12308,3199898624,0,0,1,20480,0,7016899148
2037,3199906166,2470,3199908636,2,0,1,2560,2,10201523428
2038,3199941215,3422,3199944637,11,0,1,3584,11,9172045562
2039,3199970106,20181,3199990287,16,0,1,7680,16,9417896529
2040,3199972751,114782,3200087533,15,0,0,43008,15,8189540436
2041,3199990305,566,3199990871,16,0,1,512,16,7377146895
2042,3199998058,7706,3200005764,2,0,1,8192,2,2681353256
2043,3200047870,1518,3200049388,1,0,1,1536,1,8846803324
2044,3200056755,64949,3200121704,14,0,0,6656,14,4596836480
2045,3200063508,61244,3200124752,11,0,0,1536,11,7557678721
2046,3200097780,3645,3200101425,0,0,1,10240,0,4079725981
2047,3200146017,1518,3200147535,18,0,1,1536,18,5970101750
2048,3200209022,4374,3200213396,9,0,1,4608,9,226176156
2049,3200242185,6754,3200248939,14,0,1,7168,14,6256061337
2050,3200252959,1518,3200254477,0,0,1,1536,0,1995619402
2051,3200258115,71444,3200329559,7,0,0,10240,7,5699743949
2052,3200288315,1042,3200289357,15,0,1,1024,15,4292423960
2053,3200314166,43904,3200358070,13,0,0,512,13,4172227490
2054,3200331429,1042,3200332471,4,0,1,1024,4,9005397351
2055,3200352018,124592,3200476610,11,0,0,109056,11,3757711442
2056,3200383325,143067,3200526392,0,0,0,39424,0,2749336010
2057,3200395139,144783,3200539922,18,0,0,2048,18,1352343774
2058,3200448649,31392,3200480041,13,0,1,3584,13,7747803721
2059,3200476566,124166,3200600732,5,0,0,24064,5,3551717200
2060,3200486001,566,3200486567,13,0,1,512,13,6309502061
2061,3200499835,566,3200500401,4,0,1,512,4,1368694788
2062,3200506104,243314,3200749418,8,0,0,147968,8,7774473058
2063,3200533201,155108,3200688309,10,0,0,17920,10,3380833080
2064,3200571740,187076,3200758816,15,0,0,16896,15,8057630466
2065,3200580248,173397,3200753645,11,0,0,13824,11,3461981221
2066,3200593123,256345,3200849468,15,0,0,87040,15,6485226566
2067,3200598536,181051,3200779587,10,0,0,68096,10,8567038015
2068,3200729448,175442,3200904890,11,0,0,40960,11,1829804125
2069,3200741919,40573,3200782492,0,0,1,3072,0,2847950770
2070,3200808882,10241,3200819123,16,0,1,16384,16,4697209486
2071,3200809818,60184,3200870002,8,0,1,95744,8,3372288465
2072,3200842554,121818,3200964372,12,0,0,11264,12,9031720918
2073,3200844798,100026,3200944824,18,0,0,2560,18,5346962465
2074,3200888018,110176,3200998194,10,0,0,10240,10,4973884702
2075,3200890466,241717,3201132183,13,0,0,25088,13,4026292829
2076,3200898093,11163,3200909256,9,0,1,4608,9,8056956984
2077,3200918512,127199,3201045711,15,0,0,40960,15,9590047661
2078,3200938122,3422,3200941544,8,0,1,3584,8,6569138975
2079,3200985887,86954,3201072841,16,0,0,512,16,7124739870
2080,3201009028,146698,3201155726,7,0,0,74752,7,5773680576
2081,3201010087,177956,3201188043,15,0,0,47104,15,8763496760
2082,3201071058,236565,3201307623,5,0,0,49152,5,7925751666
2083,3201077740,1042,3201078782,1,0,1,1024,1,842772747
2084,3201099452,12825,3201112277,11,0,1,21504,11,5967567874
2085,3201103556,9067,3201112623,16,0,1,512,16,6300335227
2086,3201118042,206132,3201324174,16,0,0,54272,16,9237650991
2087,3201223325,120112,3201343437,19,0,0,14336,19,8037268337
2088,3201261150,2870,3201264020,11,0,1,8704,11,9041735692
2089,3201276822,236996,3201513818,10,0,0,60416,10,214466380
2090,3201286923,2946,3201289869,16,0,1,3072,16,2370480231
2091,3201316946,9690,3201326636,13,0,1,2560,13,5789666550
2092,3201333255,95813,3201429068,10,0,0,10240,10,8058545248
2093,3201336385,89431,3201425816,9,0,0,4608,9,6018613426
2094,3201349666,1042,3201350708,14,0,1,1024,14,1841455441
2095,3201367166,4420,3201371586,7,0,1,11776,7,10662637673
2096,3201383001,5326,3201388327,13,0,1,5632,13,7388172848
2097,3201424768,4462,3201429230,14,0,1,3584,14,6022624707
2098,3201429752,62672,3201492424,19,0,0,6656,19,1876619327
2099,3201431798,4850,3201436648,5,0,1,5120,5,5494337889
2100,3201485677,1994,3201487671,5,0,1,2048,5,3801563310
2101,3201514481,68638,3201583119,14,0,0,7168,14,5534347892
2102,3201517174,232391,3201749565,15,0,0,61440,15,3768719453
2103,3201528452,1518,3201529970,14,0,1,1536,14,5273416459
2104,3201546922,36604,3201583526,8,0,1,64512,8,6218038129
2105,3201588074,2946,3201591020,13,0,1,3072,13,2472953032
2106,3201598179,6754,3201604933,9,0,1,7168,9,8266324772
2107,3201658628,221718,3201880346,10,0,0,95744,10,10303592386
2108,3201809792,13770,3201823562,5,0,1,26624,5,6552313843
2109,3201809960,70869,3201880829,14,0,0,1536,14,1709406337
2110,3201835138,152511,3201987649,5,0,0,94720,5,2296489160
2111,3201847049,566,3201847615,16,0,1,512,16,9017781883
2112,3201866344,16471,3201882815,16,0,1,2048,16,8720825979
2113,3201896529,142150,3202038679,7,0,0,29184,7,10090175913
2114,3201966909,27027,3201993936,13,0,1,6656,13,1035142183
2115,3201983686,11712,3201995398,13,0,1,14336,13,2895221647
2116,3201989637,96428,3202086065,16,0,0,10752,16,5202346640
2117,3201990174,136843,3202127017,17,0,0,91136,17,6073568954
2118,3202020487,1518,3202022005,1,0,1,1536,1,8087912529
2119,3202046726,3128,3202049854,0,0,1,9216,0,7352280997
2120,3202073623,129701,3202203324,13,0,0,70656,13,5544059763
2121,3202087675,6754,3202094429,3,0,1,7168,3,2278987535
2122,3202095093,195386,3202290479,14,0,0,58880,14,2183079031
2123,3202142984,208533,3202351517,15,0,0,31232,15,9448325286
2124,3202157100,4374,3202161474,9,0,1,4608,9,9469434172
2125,3202208987,1518,3202210505,9,0,1,1536,9,5856609806
2126,3202213810,183667,3202397477,13,0,0,71168,13,2005244489
2127,3202228435,6278,3202234713,14,0,1,6656,14,3160448201
2128,3202289907,13559,3202303466,8,0,1,25088,8,9934766628
2129,3202392766,5745,3202398511,13,0,1,1024,13,9966449842
2130,3202401397,4374,3202405771,7,0,1,4608,7,3813795215
2131,3202411938,4850,3202416788,0,0,1,5120,0,7442838869
2132,3202449307,2870,3202452177,0,0,1,8704,0,9582128807
2133,3202452193,4679,3202456872,1,0,1,12288,1,2993245422
2134,3202459330,105764,3202565094,10,0,0,47104,10,7963047426
2135,3202476108,3645,3202479753,1,0,1,10240,1,3542075928
2136,3202581879,4850,3202586729,6,0,1,5120,6,7411409191
2137,3202581966,126863,3202708829,5,0,0,56320,5,5369929980
2138,3202589364,3898,3202593262,11,0,1,4096,11,1053547084
2139,3202599414,1042,3202600456,16,0,1,1024,16,8805250876
2140,3202689928,124205,3202814133,11,0,0,64000,11,10472160992
2141,3202694918,219211,3202914129,7,0,0,16896,7,8827111466
2142,3202739472,157062,3202896534,0,0,0,17408,0,3790999027
2143,3202740626,150589,3202891215,8,0,0,83968,8,3453894856
2144,3202851876,3128,3202855004,0,0,1,9216,0,3665141887
2145,3202885644,56478,3202942122,6,0,0,1024,6,5717904683
2146,3203002895,59132,3203062027,15,0,0,5120,15,4254049509
2147,3203037716,1994,3203039710,13,0,1,2048,13,3672229646
2148,3203040617,105092,3203145709,5,0,0,45056,5,1369009129
2149,3203058981,99940,3203158921,3,0,0,12800,3,9968812557
2150,3203061946,639,3203062585,5,0,1,512,5,514681969
2151,3203083097,11533,3203094630,18,0,1,18944,18,7730204749
2152,3203113509,5712,3203119221,8,0,1,14336,8,7041970535
2153,3203172025,209383,3203381408,3,0,0,25088,3,9795559220
2154,3203201871,100412,3203302283,8,0,0,29696,8,5966283468
2155,3203235457,138292,3203373749,4,0,0,31232,4,3379151271
2156,3203279258,3904,3203283162,0,0,1,10752,0,7908081963
2157,3203319679,11274,3203330953,13,0,1,18432,13,1407827210
2158,3203369155,149318,3203518473,13,0,0,13824,13,5826442299
2159,3203375863,177209,3203553072,19,0,0,8192,19,5859474225
2160,3203378761,115640,3203494401,3,0,0,55808,3,3798327293
2161,3203392419,157245,3203549664,18,0,0,2048,18,4829566912
2162,3203433296,2946,3203436242,6,0,1,3072,6,7944534771
2163,3203437362,127530,3203564892,13,0,0,6656,13,7333975045
2164,3203459282,165304,3203624586,6,0,0,26112,6,5208215629
2165,3203460010,3904,3203463914,7,0,1,10752,7,884763711
2166,3203554738,143030,3203697768,5,0,0,33280,5,9953876910
2167,3203556635,58957,3203615592,18,0,0,512,18,4728964180
2168,3203630422,79208,3203709630,18,0,0,512,18,6826484951
2169,3203699188,97760,3203796948,5,0,0,20992,5,8958630812
2170,3203700604,71312,3203771916,19,0,0,14848,19,8970070767
2171,3203713989,69284,3203783273,4,0,0,8192,4,701368612
2172,3203718795,132765,3203851560,8,0,0,38912,8,4455831163
2173,3203733546,196340,3203929886,5,0,0,57344,5,1904264067
2174,3203752578,159821,3203912399,7,0,0,5632,7,2015136893
2175,3203769394,10220,3203779614,7,0,1,8192,7,8316284386
2176,3203802947,6754,3203809701,18,0,1,7168,18,9386165100
2177,3203809655,162318,3203971973,9,0,0,2048,9,718632440
2178,3203822331,566,3203822897,13,0,1,512,13,3128478999
2179,3203962288,125060,3204087348,9,0,0,110592,9,6666594518
2180,3203967359,143557,3204110916,11,0,0,26624,11,8844358380
2181,3204019486,95657,3204115143,6,0,0,13824,6,6336906872
2182,3204044171,43192,3204087363,8,0,1,17920,8,10343711456
2183,3204073339,14582,3204087921,8,0,1,512,8,9060005602
2184,3204110991,5662,3204116653,1,0,1,1536,1,8870698401
2185,3204129030,7230,3204136260,7,0,1,7680,7,10412584815
2186,3204129431,6983,3204136414,3,0,1,8704,3,6204022434
2187,3204190192,109304,3204299496,10,0,0,58880,10,7640235836
2188,3204200197,106334,3204306531,15,0,0,23040,15,9369356543
2189,3204262249,151229,3204413478,1,0,0,6144,1,4254203201
2190,3204271371,122397,3204393768,9,0,0,68608,9,9040147207
2191,3204331919,1518,3204333437,0,0,1,1536,0,663865877
2192,3204356752,80864,3204437616,0,0,0,3584,0,4695363642
2193,3204370263,65900,3204436163,10,0,0,7168,10,3851994284
2194,3204386997,72740,3204459737,19,0,0,6144,19,1710466966
2195,3204397679,70063,3204467742,18,0,0,512,18,6593095499
2196,3204400422,22433,3204422855,8,0,1,36864,8,2014699311
2197,3204405245,61585,3204466830,14,0,0,2560,14,1170396741
2198,3204414857,77334,3204492191,12,0,0,3584,12,3702271984
2199,3204427367,173112,3204600479,0,0,0,26112,0,7506685689
2200,3204446379,3904,3204450283,13,0,1,10752,13,10527966201
2201,3204557351,96668,3204654019,17,0,0,17408,17,6425933915
2202,3204558534,3387,3204561921,0,0,1,9728,0,6668413898
2203,3204597211,5254,3204602465,0,0,1,2048,0,7117407461
2204,3204605585,246408,3204851993,14,0,0,115712,14,2575501195
2205,3204626785,107744,3204734529,0,0,0,53760,0,5144167785
2206,3204627266,79091,3204706357,9,0,0,1536,9,4489952119
2207,3204704856,5326,3204710182,0,0,1,5632,0,714533889
2208,3204877577,4850,3204882427,2,0,1,5120,2,7573588817
2209,3204933445,62228,3204995673,14,0,0,10240,14,1512091959
2210,3205032016,93284,3205125300,11,0,0,16384,11,1832045470
2211,3205034472,3898,3205038370,16,0,1,4096,16,3078028392
2212,3205036574,100011,3205136585,14,0,0,14848,14,7681933666
2213,3205092980,148201,3205241181,16,0,0,45056,16,3269031967
2214,3205099723,233516,3205333239,1,0,0,114176,1,5452587289
2215,3205106327,99788,3205206115,17,0,0,27648,17,4223028688
2216,3205148012,566,3205148578,11,0,1,512,11,3749050276
2217,3205205801,199567,3205405368,6,0,0,54272,6,3398280111
2218,3205234175,154642,3205388817,4,0,0,68608,4,5143047723
2219,3205303646,101893,3205405539,13,0,0,512,13,4750113870
2220,3205304413,143901,3205448314,12,0,0,53760,12,1323627429
2221,3205313550,23135,3205336685,4,0,1,9728,4,3362084019
2222,3205320029,18703,3205338732,15,0,1,2560,15,10663341371
2223,3205366217,191766,3205557983,1,0,0,70656,1,8680625185
2224,3205379328,33450,3205412778,2,0,1,7680,2,8545453335
2225,3205396921,17163,3205414084,6,0,1,2048,6,8331822304
2226,3205443397,10235,3205453632,15,0,1,5632,15,8989983816
2227,3205600960,566,3205601526,6,0,1,512,6,6094829877
2228,3205678856,108212,3205787068,19,0,0,55296,19,585596833
2229,3205706349,142849,3205849198,12,0,0,31232,12,5108124372
2230,3205749313,61448,3205810761,7,0,0,7680,7,7580867442
2231,3205779400,179467,3205958867,5,0,0,70144,5,7321541060
2232,3205798976,3128,3205802104,3,0,1,9216,3,5335337424
2233,3205841083,8673,3205849756,0,0,1,512,0,3515830661
2234,3205879481,133534,3206013015,16,0,0,20480,16,2119054535
2235,3205890111,5326,3205895437,2,0,1,5632,2,6925186073
2236,3205909128,3422,3205912550,10,0,1,3584,10,9599419829
2237,3205914559,566,3205915125,6,0,1,512,6,465036770
2238,3205927738,149717,3206077455,17,0,0,70656,17,4618004609
2239,3206032166,45460,3206077626,15,0,0,512,15,5597698993
2240,3206035423,107265,3206142688,8,0,0,34304,8,4434962375
2241,3206076624,132795,3206209419,1,0,0,16896,1,8912339708
2242,3206114799,47288,3206162087,18,0,0,1536,18,10446335043
2243,3206124801,5326,3206130127,5,0,1,5632,5,7070115609
2244,3206145941,13083,3206159024,16,0,1,22016,16,6039605689
2245,3206190671,142327,3206332998,8,0,0,33280,8,5450072610
2246,3206202592,6842,3206209434,1,0,1,2560,1,1495263581
2247,3206213953,3422,3206217375,18,0,1,3584,18,7559872365
2248,3206214753,3928,3206218681,18,0,1,2048,18,9593188762
2249,3206221799,167354,3206389153,1,0,0,35840,1,1807062231
2250,3206229353,59132,3206288485,5,0,0,5120,5,6290587562
2251,3206234415,10241,3206244656,4,0,1,16384,4,386561745
2252,3206247039,3898,3206250937,3,0,1,4096,3,2104247360
2253,3206273295,127293,3206400588,19,0,0,27136,19,4944729619
2254,3206387791,2872,3206390663,6,0,1,1536,6,7175865429
2255,3206398593,33770,3206432363,8,0,1,51712,8,6031964966
2256,3206402798,225947,3206628745,3,0,0,52736,3,10237376704
2257,3206430094,169410,3206599504,19,0,0,1536,19,9198602189
2258,3206441555,157466,3206599021,0,0,0,25088,0,4943002550
2259,3206477490,88251,3206565741,11,0,0,512,11,5716060129
2260,3206520908,60224,3206581132,1,0,0,8704,1,2094349208
2261,3206556323,4850,3206561173,5,0,1,5120,5,279802750
2262,3206586718,3422,3206590140,3,0,1,3584,3,3971829560
2263,3206643061,1518,3206644579,10,0,1,1536,10,10101240149
2264,3206666694,76052,3206742746,10,0,0,10240,10,10371179972
2265,3206668949,100568,3206769517,6,0,0,30208,6,4159451899
2266,3206696072,131951,3206828023,8,0,0,19456,8,9752354722
2267,3206700046,105012,3206805058,6,0,0,11776,6,4195546711
2268,3206700310,5802,3206706112,3,0,1,6144,3,8659302490
2269,3206763457,16551,3206780008,14,0,1,16896,14,9159767723
2270,3206798370,50984,3206849354,3,0,0,3584,3,9186602554
2271,3206875186,3898,3206879084,1,0,1,4096,1,2929179841
2272,3206888948,229752,3207118700,1,0,0,87040,1,9372148277
2273,3206893787,113204,3207006991,19,0,0,71680,19,5029730996
2274,3206915023,2946,3206917969,15,0,1,3072,15,1051995098
2275,3206922429,30491,3206952920,8,0,1,49152,8,3390568799
2276,3206977448,566,3206978014,5,0,1,512,5,5638860137
2277,3206981308,25698,3207007006,7,0,1,13312,7,2354623696
2278,3207013185,261915,3207275100,12,0,0,125952,12,1390160751
2279,3207176757,1042,3207177799,5,0,1,1024,5,1472381844
2280,3207226597,5712,3207232309,2,0,1,14336,2,3010247221
2281,3207285567,10241,3207295808,16,0,1,16384,16,9736084343
2282,3207288656,146964,3207435620,8,0,0,38912,8,6518004605
2283,3207290446,6028,3207296474,1,0,1,1024,1,238282964
2284,3207290681,85103,3207375784,4,0,0,13824,4,6042048282
2285,3207328678,4850,3207333528,3,0,1,5120,3,525911547
2286,3207373837,197272,3207571109,13,0,0,82432,13,7550106492
2287,3207636741,126776,3207763517,9,0,0,116224,9,5557608684
2288,3207644389,119299,3207763688,18,0,0,512,18,8388235367
2289,3207649253,166356,3207815609,11,0,0,120832,11,10369860344
2290,3207695697,3422,3207699119,5,0,1,3584,5,7916115560
2291,3207802524,56981,3207859505,6,0,0,512,6,10546283936
2292,3207911076,112580,3208023656,3,0,0,69632,3,8800268452
2293,3208068654,115232,3208183886,4,0,0,78336,4,907482469
2294,3208090867,162049,3208252916,12,0,0,51712,12,3642690292
2295,3208128164,66036,3208194200,0,0,0,10240,0,9746681684
2296,3208132846,94906,3208227752,16,0,0,24576,16,4654501321
2297,3208139100,4679,3208143779,11,0,1,12288,11,7769297151
2298,3208153627,305503,3208459130,13,0,0,69120,13,9124752486
2299,3208169517,27461,3208196978,11,0,1,22016,11,7409275347
2300,3208173245,175482,3208348727,0,0,0,101888,0,2549979560
2301,3208251636,177213,3208428849,7,0,0,23552,7,2457305511
2302,3208294899,236813,3208531712,12,0,0,79360,12,7649304490
2303,3208314337,329599,3208643936,14,0,0,52224,14,1387664335
2304,3208334577,28000,3208362577,16,0,1,23552,16,1145143274
2305,3208350161,16282,3208366443,10,0,1,6144,10,3286262437
2306,3208355930,14059,3208369989,18,0,1,5632,18,5350148800
2307,3208451379,255551,3208706930,14,0,0,15872,14,9081942004
2308,3208456418,142728,3208599146,19,0,0,72704,19,10541848241
2309,3208475376,1518,3208476894,0,0,1,1536,0,6013664700
2310,3208490412,157916,3208648328,8,0,0,6144,8,6815465484
2311,3208497306,7706,3208505012,13,0,1,8192,13,5930535259
2312,3208516820,19258,3208536078,14,0,1,4608,14,10102890318
2313,3208537063,7706,3208544769,3,0,1,8192,3,10509448762
2314,3208772259,72824,3208845083,11,0,0,9728,11,4425675229
2315,3208776406,45596,3208822002,6,0,0,1024,6,4091826883
2316,3208841765,12566,3208854331,13,0,1,20992,13,6401778505
2317,3208847683,7634,3208855317,0,0,1,1536,0,4724062120
2318,3208922571,3422,3208925993,0,0,1,3584,0,8010855811
2319,3208931292,93554,3209024846,18,0,0,1024,18,845972573
2320,3209110297,50828,3209161125,4,0,0,3072,4,8992998263
2321,3209137054,12737,3209149791,16,0,1,24576,16,8835713519
2322,3209139941,110146,3209250087,10,0,0,30208,10,134895802
2323,3209145577,4368,3209149945,1,0,1,8704,1,10561960689
2324,3209176998,101972,3209278970,11,0,0,34816,11,3901184096
2325,3209189053,206570,3209395623,10,0,0,9216,10,9306789104
2326,3209244479,106636,3209351115,11,0,0,31744,11,5036263914
2327,3209255507,107961,3209363468,3,0,0,22528,3,9539072946
2328,3209278533,7183,3209285716,4,0,1,7168,4,7727799718
2329,3209291795,4850,3209296645,4,0,1,5120,4,879619499
2330,3209331368,96223,3209427591,4,0,0,13312,4,7267116320
2331,3209375790,115388,3209491178,5,0,0,78848,5,10606863487
2332,3209376524,210918,3209587442,11,0,0,54784,11,10282384652
2333,3209414802,115592,3209530394,1,0,0,8704,1,2796223324
2334,3209441145,50048,3209491193,8,0,1,70656,8,3235442064
2335,3209450660,142086,3209592746,14,0,0,6656,14,8556868463
2336,3209458628,32580,3209491208,10,0,1,10240,10,8128389845
2337,3209520603,173670,3209694273,5,0,0,13312,5,10062019017
2338,3209527323,3102,3209530425,11,0,1,1536,11,1887191836
2339,3209527867,169898,3209697765,9,0,0,4608,9,3660553467
2340,3209528538,160664,3209689202,8,0,0,23552,8,2838994526
2341,3209571703,135823,3209707526,14,0,0,26624,14,6498414619
2342,3209571953,16072,3209588025,4,0,1,512,4,5547070185
2343,3209607759,101194,3209708953,12,0,0,4608,12,4948585681
2344,3209636717,173926,3209810643,10,0,0,50688,10,6613311598
2345,3209646139,248532,3209894671,4,0,0,66048,4,1706898531
2346,3209648549,2870,3209651419,2,0,1,8704,2,2990579907
2347,3209681943,142522,3209824465,18,0,0,1536,18,1630209962
2348,3209700005,9974,3209709979,11,0,1,1024,11,2407716984
2349,3209706756,144703,3209851459,5,0,0,18432,5,6992241340
2350,3209735877,86384,3209822261,8,0,0,18944,8,6109918244
2351,3209772053,296245,3210068298,12,0,0,24576,12,62756045
2352,3209807977,188643,3209996620,9,0,0,74752,9,1834527355
2353,3209808126,252661,3210060787,19,0,0,41472,19,8124302148
2354,3209838726,209410,3210048136,4,0,0,87552,4,7707797533
2355,3209869584,2946,3209872530,8,0,1,3072,8,827825754
2356,3209877010,20641,3209897651,18,0,1,3072,18,10724432932
2357,3209880527,18242,3209898769,5,0,1,9216,5,2259865272
2358,3209894183,208931,3210103114,5,0,0,45056,5,8061796282
2359,3209972636,140477,3210113113,19,0,0,32768,19,8349398336
2360,3210034384,185292,3210219676,14,0,0,33280,14,9644094790
2361,3210046140,29873,3210076013,7,0,1,8192,7,3605684225
2362,3210057209,175036,3210232245,7,0,0,31232,7,705175628
2363,3210075778,118330,3210194108,5,0,0,17920,5,5391572700
2364,3210081019,62516,3210143535,12,0,0,6144,12,2000645805
2365,3210081148,213918,3210295066,19,0,0,52736,19,9781889105
2366,3210102340,143567,3210245907,9,0,0,7168,9,4155156635
2367,3210113422,126357,3210239779,14,0,0,3072,14,7325931648
2368,3210128293,68014,3210196307,15,0,0,7168,15,407802690
2369,3210129282,1518,3210130800,0,0,1,1536,0,402845169
2370,3210129637,3109,3210132746,11,0,1,3072,11,4076006919
2371,3210163359,1042,3210164401,2,0,1,1024,2,1827998266
2372,3210185136,180873,3210366009,7,0,0,6656,7,2565770973
2373,3210223155,9648,3210232803,2,0,1,512,2,1143592819
2374,3210249235,83156,3210332391,14,0,0,18432,14,3007322344
2375,3210252207,3387,3210255594,5,0,1,9728,5,9317324098
2376,3210254636,12633,3210267269,4,0,1,19968,4,4180378584
2377,3210271576,136811,3210408387,10,0,0,28672,10,8355666594
2378,3210275993,186771,3210462764,12,0,0,21504,12,3644894757
2379,3210287675,106079,3210393754,9,0,0,24064,9,9618029654
2380,3210321693,156177,3210477870,13,0,0,32768,13,9495944425
2381,3210338217,269306,3210607523,10,0,0,78848,10,307725273
2382,3210353784,220028,3210573812,5,0,0,5632,5,6466989645
2383,3210355096,282706,3210637802,0,0,0,99328,0,3859898714
2384,3210384314,1518,3210385832,14,0,1,1536,14,4874617724
2385,3210406346,12274,3210418620,14,0,1,16384,14,10371840094
2386,3210410410,11116,3210421526,4,0,1,4608,4,475914726
2387,3210552511,5802,3210558313,18,0,1,6144,18,5525982047
2388,3210583326,106589,3210689915,10,0,0,44544,10,861106407
2389,3210627735,13498,3210641233,1,0,1,3584,1,7529471034
2390,3210635289,219913,3210855202,8,0,0,125440,8,10547999162
2391,3210670629,85088,3210755717,18,0,0,512,18,6561597767
2392,3210686470,128065,3210814535,8,0,1,205824,8,4022862956
2393,3210718997,96844,3210815841,1,0,1,2048,1,1350535142
2394,3210722248,132969,3210855217,2,0,1,5120,2,8959753946
2395,3210803999,271545,3211075544,19,0,0,41472,19,6052172364
2396,3210811922,357922,3211169844,9,0,0,153088,9,6882928852
2397,3210836524,339419,3211175943,16,0,0,19968,16,1077465396
2398,3210927318,6754,3210934072,5,0,1,7168,5,2930422373
2399,3210945432,256530,3211201962,7,0,0,50688,7,84031000
2400,3210966620,3422,3210970042,15,0,1,3584,15,7381063970
2401,3210981223,221237,3211202460,5,0,0,1536,5,5551140156
2402,3211080272,1518,3211081790,18,0,1,1536,18,6073403758
2403,3211116713,2870,3211119583,8,0,1,8704,8,8814734363
2404,3211141097,36373,3211177470,2,0,1,1536,2,3290947371
2405,3211142558,234235,3211376793,17,0,0,67072,17,6910797764
2406,3211184880,17097,3211201977,11,0,1,4096,11,2465949248
2407,3211191274,12220,3211203494,10,0,1,1024,10,4704071417
2408,3211270524,1518,3211272042,4,0,1,1536,4,986282567
2409,3211297368,175820,3211473188,0,0,0,4608,0,3404861730
2410,3211308941,81932,3211390873,7,0,0,19456,7,5097948334
2411,3211332263,7230,3211339493,14,0,1,7680,14,2387033130
2412,3211355757,116012,3211471769,19,0,0,80896,19,7122583592
2413,3211421144,124305,3211545449,3,0,0,23040,3,8495393871
2414,3211514355,3387,3211517742,0,0,1,9728,0,8101526391
2415,3211614885,99944,3211714829,17,0,0,28160,17,8589944116
2416,3211654834,69752,3211724586,7,0,0,9728,7,9719233740
2417,3211752032,125996,3211878028,1,0,0,113664,1,10568351633
2418,3211806328,7230,3211813558,10,0,1,7680,10,69303953
2419,3211829150,76706,3211905856,5,0,0,6144,5,1439709390
2420,3211838164,2946,3211841110,10,0,1,3072,10,6316311028
2421,3211855401,25565,3211880966,6,0,1,3072,6,5138371601
2422,3211893267,2470,3211895737,1,0,1,2560,1,202001092
2423,3211914587,77744,3211992331,7,0,0,10752,7,3486734495
2424,3211992235,86292,3212078527,10,0,0,13312,10,10000194145
2425,3212005875,1518,3212007393,0,0,1,1536,0,2803766134
2426,3212086294,86204,3212172498,3,0,0,13312,3,7772490367
2427,3212129167,44145,3212173312,8,0,1,75776,8,8484418305
2428,3212129411,115466,3212244877,1,0,0,1536,1,7278713162
2429,3212172835,165528,3212338363,12,0,0,80384,12,5338494723
2430,3212192845,1518,3212194363,13,0,1,1536,13,7937194720
2431,3212273461,273946,3212547407,0,0,0,39424,0,8277249158
2432,3212276265,194056,3212470321,3,0,0,174592,3,8540622967
2433,3212315300,209477,3212524777,11,0,0,13312,11,766282862
2434,3212338534,2946,3212341480,11,0,1,3072,11,4009735335
2435,3212354246,141981,3212496227,8,0,0,32768,8,908464800
2436,3212407067,3422,3212410489,14,0,1,3584,14,7562243519
2437,3212412161,63608,3212475769,5,0,0,9728,5,7320564534
2438,3212460081,193868,3212653949,11,0,0,19968,11,10004076703
2439,3212475354,44311,3212519665,18,0,0,512,18,7922540536
2440,3212481664,136645,3212618309,1,0,0,36864,1,9035943559
2441,3212489410,270769,3212760179,5,0,0,65024,5,10436980874
2442,3212538357,156914,3212695271,15,0,0,13312,15,1068083605
2443,3212548584,246593,3212795177,0,0,0,52736,0,6727874114
2444,3212575417,4420,3212579837,6,0,1,11776,6,10260809202
2445,3212663902,5196,3212669098,3,0,1,13312,3,3409864437
2446,3212668005,54074,3212722079,6,0,0,1024,6,8275879733
2447,3212672716,49534,3212722250,9,0,0,512,9,6193821327
2448,3212687947,1518,3212689465,2,0,1,1536,2,6539622425
2449,3212687971,87948,3212775919,17,0,0,10240,17,2052906635
2450,3212708901,6278,3212715179,4,0,1,6656,4,10506658927
2451,3212716661,198739,3212915400,7,0,0,32768,7,8135946701
2452,3212742767,19891,3212762658,11,0,1,2560,11,10416570939
2453,3212752982,107626,3212860608,16,0,0,29696,16,3223923101
2454,3212837803,45596,3212883399,6,0,0,1024,6,574785825
2455,3212844676,102859,3212947535,15,0,0,1536,15,8057402619
2456,3212930682,97604,3213028286,14,0,0,20480,14,4217351262
2457,3212947341,99818,3213047159,5,0,0,27136,5,440631549
2458,3212965935,43904,3213009839,18,0,0,512,18,4958908996
2459,3213006390,139756,3213146146,13,0,0,52224,13,9344044063
2460,3213013681,227981,3213241662,14,0,0,101376,14,889777778
2461,3213023318,8875,3213032193,4,0,1,4096,4,1759647689
2462,3213027961,32848,3213060809,16,0,1,50688,16,5827045348
2463,3213048929,16066,3213064995,3,0,1,6656,3,9313525332
2464,3213146042,2090,3213148132,15,0,1,2048,15,2558065482
2465,3213148893,4850,3213153743,14,0,1,5120,14,3695553937
2466,3213193912,231063,3213424975,15,0,0,131072,15,3575425274
2467,3213202459,4374,3213206833,0,0,1,4608,0,2900764464
2468,3213218180,27890,3213246070,2,0,1,4608,2,5889155505
2469,3213227523,21773,3213249296,14,0,1,5120,14,1053371666
2470,3213229231,20731,3213249962,5,0,1,1024,5,3001861959
2471,3213258805,3387,3213262192,11,0,1,9728,11,8230030639
2472,3213337687,87311,3213424998,16,0,1,106496,16,9884399405
2473,3213360245,64776,3213425021,14,0,1,6144,14,9281768380
2474,3213360533,136707,3213497240,17,0,0,22016,17,2473371569
2475,3213363688,310959,3213674647,15,0,0,67072,15,6526195354
2476,3213395529,36009,3213431538,15,0,1,15872,15,2586370503
2477,3213401323,122479,3213523802,15,0,0,12288,15,1977884978
2478,3213405315,213360,3213618675,14,0,0,7680,14,3661011929
2479,3213409685,24439,3213434124,5,0,1,4096,5,1041737493
2480,3213435230,6754,3213441984,11,0,1,7168,11,5351406746
2481,3213463834,3422,3213467256,0,0,1,3584,0,10362982318
2482,3213498689,184717,3213683406,7,0,0,28672,7,1793841150
2483,3213517941,21658,3213539599,8,0,1,35328,8,8183093534
2484,3213537068,166968,3213704036,5,0,0,27648,5,3056747148
2485,3213556016,158208,3213714224,1,0,0,5632,1,9982173852
2486,3213557118,366525,3213923643,8,0,0,27648,8,3719339920
2487,3213641237,42184,3213683421,16,0,1,57856,16,6061211273
2488,3213667478,198092,3213865570,16,0,0,21504,16,7620657828
2489,3213745167,113828,3213858995,4,0,0,73728,4,4630432776
2490,3213756825,55748,3213812573,12,0,0,4096,12,1386828001
2491,3213762936,258769,3214021705,15,0,0,103424,15,3175061536
2492,3213776417,2470,3213778887,18,0,1,2560,18,7223450074
2493,3213787728,7706,3213795434,0,0,1,8192,0,5117971402
2494,3213852558,14489,3213867047,7,0,1,1536,7,5581224739
2495,3213864483,101976,3213966459,3,0,0,4608,3,448131132
2496,3213883731,3898,3213887629,0,0,1,4096,0,7286485888
2497,3213883848,201812,3214085660,17,0,0,91136,17,1301411044
2498,3213926592,175931,3214102523,7,0,0,55296,7,6317031135
2499,3213929839,13858,3213943697,8,0,1,23552,8,8998414371
2500,3213972924,157260,3214130184,5,0,0,12800,5,3140243069
2501,3213991980,121178,3214113158,9,0,0,18944,9,2061406668
2502,3213999917,171566,3214171483,7,0,0,4096,7,7494078138
2503,3214032803,151799,3214184602,1,0,0,43008,1,8373918116
2504,3214048744,251636,3214300380,14,0,0,45568,14,3419844259
2505,3214069652,210698,3214280350,9,0,0,128512,9,7965581158
2506,3214122825,163640,3214286465,17,0,0,19968,17,625753983
2507,3214141184,4162,3214145346,2,0,1,11264,2,3399644710
2508,3214179933,7607,3214187540,6,0,1,3072,6,9046326909
2509,3214205721,111356,3214317077,5,0,0,14848,5,8384853553
2510,3214248421,51974,3214300395,3,0,1,4096,3,4996789387
2511,3214272479,27931,3214300410,14,0,1,2048,14,127236500
2512,3214292918,112888,3214405806,5,0,0,46080,5,2561993447
2513,3214316578,131048,3214447626,9,0,0,22016,9,1124291833
2514,3214397384,122473,3214519857,14,0,0,66048,14,8010912288
2515,3214463559,4374,3214467933,13,0,1,4608,13,2112951284
2516,3214471690,241180,3214712870,3,0,0,101888,3,7862205576
2517,3214471848,125792,3214597640,3,0,0,83968,3,2961679776
2518,3214477663,155605,3214633268,11,0,0,68608,11,3040457322
2519,3214590407,169881,3214760288,10,0,0,84992,10,2223511566
2520,3214600322,169980,3214770302,5,0,0,24576,5,10319911609
2521,3214618314,17909,3214636223,18,0,1,3072,18,4739233521
2522,3214630502,132297,3214762799,9,0,0,8192,9,799294484
2523,3214678111,34774,3214712885,6,0,1,5632,6,3400307692
2524,3214715328,79802,3214795130,13,0,0,6656,13,5938606028
2525,3214717720,1042,3214718762,0,0,1,1024,0,5899405102
2526,3214785630,95756,3214881386,11,0,0,19456,11,124015865
2527,3214796520,55748,3214852268,15,0,0,4096,15,9073592751
2528,3214813351,104391,3214917742,12,0,0,2560,12,4326110962
2529,3214818083,53237,3214871320,16,0,1,90112,16,10595451104
2530,3214828672,204512,3215033184,1,0,0,99840,1,4110767341
2531,3214889799,1994,3214891793,7,0,1,2048,7,1337282900
2532,3214891459,2470,3214893929,11,0,1,2560,11,7434665980
2533,3214903765,164843,3215068608,17,0,0,54784,17,9369045453
2534,3214985579,112027,3215097606,4,0,0,7680,4,4885746953
2535,3214993326,143910,3215137236,18,0,0,1024,18,1669341175
2536,3215003006,35989,3215038995,1,0,1,6144,1,10733260513
2537,3215018493,22768,3215041261,13,0,1,3584,13,5469257263
2538,3215042043,238807,3215280850,9,0,0,56832,9,8024570889
2539,3215064432,103176,3215167608,4,0,0,25088,4,4082735292
2540,3215082842,2946,3215085788,18,0,1,3072,18,8283918396
2541,3215116954,3387,3215120341,4,0,1,9728,4,742979795
2542,3215169507,6754,3215176261,7,0,1,7168,7,8548653256
2543,3215170340,220032,3215390372,16,0,0,72704,16,5395091127
2544,3215194542,86791,3215281333,6,0,0,1536,6,10579045712
2545,3215210799,33075,3215243874,8,0,1,54272,8,4250907011
2546,3215230909,15231,3215246140,14,0,1,3584,14,947096314
2547,3215252595,147932,3215400527,15,0,0,33280,15,2845846363
2548,3215277992,56934,3215334926,17,0,0,512,17,2377560389
2549,3215358162,69287,3215427449,9,0,0,4608,9,8832634078
2550,3215393065,114262,3215507327,8,0,0,50688,8,3198490915
2551,3215432894,130419,3215563313,13,0,0,26624,13,6412530204
2552,3215437765,4937,3215442702,16,0,1,12800,16,2374927854
2553,3215480146,4374,3215484520,7,0,1,4608,7,6504761944
2554,3215490013,154930,3215644943,3,0,0,66560,3,139077625
2555,3215553185,173871,3215727056,19,0,0,3584,19,6555142286
2556,3215579013,146936,3215725949,16,0,0,104448,16,1590422754
2557,3215580446,4420,3215584866,3,0,1,11776,3,4939228078
2558,3215644080,1897,3215645977,7,0,1,1024,7,333144917
2559,3215646897,3128,3215650025,7,0,1,9216,7,9496478129
2560,3215664687,152553,3215817240,10,0,0,129536,10,7041681797
2561,3215686085,177061,3215863146,7,0,0,52224,7,2954146683
2562,3215736529,3898,3215740427,10,0,1,4096,10,6131438497
2563,3215784579,136029,3215920608,13,0,0,39424,13,10333615932
2564,3215794264,114075,3215908339,7,0,0,512,7,10209521028
2565,3215806340,24195,3215830535,11,0,1,25600,11,4085498136
2566,3215878391,259481,3216137872,10,0,0,27648,10,3002453288
2567,3215907374,107974,3216015348,7,0,0,50688,7,394527785
2568,3215911615,145876,3216057491,6,0,0,512,6,26033839
2569,3215932890,218401,3216151291,7,0,0,27136,7,4817545034
2570,3215952094,177339,3216129433,7,0,0,122880,7,7998411098
2571,3215953548,1042,3215954590,15,0,1,1024,15,6654237620
2572,3215994148,21215,3216015363,7,0,1,19968,7,2877644477
2573,3216138640,79748,3216218388,16,0,0,12288,16,3387662685
2574,3216147035,10526,3216157561,6,0,1,6656,6,1834625819
2575,3216178133,4162,3216182295,13,0,1,11264,13,7362679715
2576,3216192831,3898,3216196729,0,0,1,4096,0,1725466355
2577,3216201576,108817,3216310393,5,0,0,18432,5,7087617813
2578,3216203450,5971,3216209421,7,0,1,14848,7,3791638663
2579,3216223078,60824,3216283902,11,0,0,5632,11,10094830403
2580,3216247609,264641,3216512250,19,0,0,30720,19,4350396787
2581,3216260730,116665,3216377395,19,0,0,50688,19,10129112528
2582,3216278466,139127,3216417593,13,0,0,15872,13,3257825701
2583,3216284944,6229,3216291173,14,0,1,15360,14,4977297133
2584,3216302453,132176,3216434629,10,0,0,30720,10,4848289019
2585,3216304497,93932,3216398429,3,0,0,23552,3,8183361195
2586,3216327099,75245,3216402344,9,0,0,12800,9,1279533688
2587,3216337624,278852,3216616476,10,0,0,139776,10,6193947078
2588,3216349866,27552,3216377418,8,0,1,38912,8,6663161631
2589,3216362193,161843,3216524036,7,0,0,14336,7,8419529234
2590,3216383458,3898,3216387356,18,0,1,4096,18,5298809087
2591,3216403775,6754,3216410529,18,0,1,7168,18,7681604514
2592,3216428572,190732,3216619304,14,0,0,7168,14,9954490170
2593,3216441828,11016,3216452844,18,0,1,17920,18,6375334562
2594,3216469280,160817,3216630097,5,0,0,17920,5,5158812394
2595,3216471216,61641,3216532857,16,0,1,99840,16,9186317646
2596,3216497322,58507,3216555829,7,0,0,1024,7,4417562734
2597,3216498327,36156,3216534483,1,0,1,2560,1,1547008100
2598,3216517441,137683,3216655124,14,0,0,13824,14,8100919334
2599,3216551851,255343,3216807194,8,0,0,25088,8,6968499368
2600,3216564193,101418,3216665611,15,0,0,17408,15,278466806
2601,3216626351,166998,3216793349,7,0,0,61952,7,1037427882
2602,3216634803,93638,3216728441,14,0,0,10240,14,7352778239
2603,3216665623,195652,3216861275,5,0,0,61952,5,4873795583
2604,3216688099,242359,3216930458,1,0,0,59392,1,8681383240
2605,3216713817,195917,3216909734,13,0,0,61952,13,2326909330
2606,3216718178,1518,3216719696,15,0,1,1536,15,2450556013
2607,3216749702,2946,3216752648,14,0,1,3072,14,3854682483
2608,3216767377,43200,3216810577,16,0,1,70656,16,1718294150
2609,3216771370,224194,3216995564,12,0,0,80384,12,5658716696
2610,3216800690,12793,3216813483,13,0,1,4608,13,3336868643
2611,3216846651,186821,3217033472,5,0,0,22528,5,3405739746
2612,3216860426,231517,3217091943,0,0,0,11264,0,6462126227
2613,3216884190,194469,3217078659,3,0,0,28160,3,7234000760
2614,3216919078,104380,3217023458,8,0,0,8704,8,8428913457
2615,3216967551,151527,3217119078,7,0,0,24576,7,9399838817
2616,3217039358,1994,3217041352,4,0,1,2048,4,5797488172
2617,3217069792,49457,3217119249,6,0,0,512,6,6213718075
2618,3217073342,82135,3217155477,0,0,0,9728,0,1130112343
2619,3217140627,53185,3217193812,6,0,0,1536,6,10397987637
2620,3217158005,2470,3217160475,2,0,1,2560,2,8939583534
2621,3217158284,7304,3217165588,4,0,1,7168,4,3338424079
2622,3217192856,107120,3217299976,17,0,0,51712,17,6692776592
2623,3217227753,80005,3217307758,6,0,0,512,6,1594787185
2624,3217290200,13155,3217303355,5,0,1,9728,5,3227898356
2625,3217300311,128945,3217429256,1,0,0,68096,1,265924915
2626,3217310087,4162,3217314249,18,0,1,11264,18,5808386217
2627,3217313154,155858,3217469012,9,0,0,62464,9,5802308927
2628,3217330635,160094,3217490729,13,0,0,1536,13,10665345884
2629,3217364912,3898,3217368810,11,0,1,4096,11,2904148262
2630,3217375718,136545,3217512263,6,0,0,512,6,682861153
2631,3217392168,95177,3217487345,19,0,0,512,19,5960179591
2632,3217462948,125503,3217588451,5,0,0,87552,5,7880541068
2633,3217490712,153314,3217644026,17,0,0,46592,17,8826857172
2634,3217516623,1042,3217517665,6,0,1,1024,6,6092078934
2635,3217547343,3422,3217550765,3,0,1,3584,3,4158153186
2636,3217564476,112152,3217676628,1,0,0,4608,1,1625733040
2637,3217568167,138997,3217707164,4,0,0,40960,4,9765663400
2638,3217606945,109438,3217716383,19,0,0,30208,19,5537913356
2639,3217654791,124403,3217779194,10,0,0,64512,10,1388625535
2640,3217707025,84514,3217791539,16,0,0,512,16,7717826359
2641,3217708092,108138,3217816230,3,0,0,10752,3,8446799662
2642,3217733771,71460,3217805231,19,0,0,5120,19,3968333932
2643,3217806031,566,3217806597,5,0,1,512,5,10410582741
2644,3217807557,1518,3217809075,14,0,1,1536,14,6012930899
2645,3217866924,4374,3217871298,11,0,1,4608,11,3848114574
2646,3217895373,1518,3217896891,1,0,1,1536,1,2175082638
2647,3217949214,83979,3218033193,15,0,0,2560,15,7172416391
2648,3217952809,3128,3217955937,13,0,1,9216,13,4608804202
2649,3217972244,54056,3218026300,1,0,0,3584,1,8602337762
2650,3217976289,98852,3218075141,13,0,0,24576,13,4224658832
2651,3217994650,6278,3218000928,7,0,1,6656,7,325032717
2652,3218032507,93016,3218125523,9,0,0,17408,9,9130279591
2653,3218054790,78860,3218133650,7,0,0,19456,7,5978899498
2654,3218069849,12514,3218082363,5,0,1,7680,5,9029787600
2655,3218087473,67643,3218155116,6,0,0,1536,6,4178740344
2656,3218115241,91438,3218206679,4,0,0,14336,4,1669175078
2657,3218115898,118957,3218234855,17,0,0,512,17,2519718112
2658,3218129181,180757,3218309938,0,0,0,2560,0,4084016273
2659,3218136887,4850,3218141737,1,0,1,5120,1,3404154767
2660,3218138650,136501,3218275151,14,0,0,72704,14,8697567239
2661,3218156876,68973,3218225849,6,0,0,512,6,8109342891
2662,3218210988,2946,3218213934,1,0,1,3072,1,9434129283
2663,3218253674,25648,3218279322,0,0,1,11264,0,6255335400
2664,3218254946,37504,3218292450,1,0,1,23552,1,1966405765
2665,3218318712,14117,3218332829,6,0,1,24064,6,4061079168
2666,3218436787,93176,3218529963,8,0,0,26112,8,895520996
2667,3218444717,90565,3218535282,9,0,0,17408,9,6725733042
2668,3218491571,79354,3218570925,1,0,0,8192,1,9342579937
2669,3218500954,125465,3218626419,0,0,0,43008,0,2696541467
2670,3218640150,2470,3218642620,1,0,1,2560,1,6268073773
2671,3218647699,566,3218648265,14,0,1,512,14,221207447
2672,3218686762,138198,3218824960,7,0,0,57856,7,7861768726
2673,3218731297,43904,3218775201,17,0,0,512,17,9491582471
2674,3218736908,69988,3218806896,18,0,0,2560,18,7149670775
2675,3218805428,69316,3218874744,7,0,0,11264,7,2294637488
2676,3218812200,15698,3218827898,3,0,1,3072,3,7687159032
2677,3218836472,100256,3218936728,4,0,0,29184,4,7431830857
2678,3218860459,192556,3219053015,15,0,0,39424,15,133228467
2679,3218933018,90086,3219023104,0,0,0,18944,0,4772343877
2680,3219029171,6754,3219035925,16,0,1,7168,16,7257807543
2681,3219064865,109829,3219174694,13,0,0,57344,13,9700853137
2682,3219122379,4679,3219127058,0,0,1,12288,0,1263618942
2683,3219122925,6686,3219129611,7,0,1,3584,7,8128224763
2684,3219123800,7126,3219130926,0,0,1,10240,0,1661711979
2685,3219182300,87164,3219269464,3,0,0,21504,3,6408823308
2686,3219187843,2470,3219190313,1,0,1,2560,1,7482600585
2687,3219275399,1042,3219276441,5,0,1,1024,5,1965847021
2688,3219281169,2946,3219284115,6,0,1,3072,6,8930223271
2689,3219282795,152799,3219435594,6,0,0,512,6,8975444141
2690,3219290805,61124,3219351929,6,0,0,1536,6,2126222123
2691,3219320887,2470,3219323357,15,0,1,2560,15,5726282370
2692,3219323385,57440,3219380825,13,0,0,4608,13,4917680127
2693,3219364685,74360,3219439045,19,0,0,9728,19,5682217443
2694,3219377921,88988,3219466909,17,0,0,17408,17,7466491682
2695,3219426787,52357,3219479144,16,0,0,1536,16,7432403337
2696,3219438253,100728,3219538981,4,0,0,28160,4,6397075369
2697,3219445473,5326,3219450799,0,0,1,5632,0,3410472092
2698,3219468070,158924,3219626994,9,0,0,11264,9,4987278768
2699,3219552544,45596,3219598140,18,0,0,1024,18,4221000055
2700,3219576791,104312,3219681103,8,0,0,42496,8,8864689087
2701,3219586403,99083,3219685486,8,0,0,14336,8,9418463909
2702,3219589467,110530,3219699997,17,0,0,2560,17,5508055240
2703,3219594017,63212,3219657229,18,0,0,2048,18,6991173154
2704,3219646758,1042,3219647800,4,0,1,1024,4,2306182711
2705,3219686445,69752,3219756197,5,0,0,9728,5,2989798479
2706,3219710113,97940,3219808053,5,0,0,26624,5,5358260617
2707,3219734309,102178,3219836487,5,0,0,23040,5,6016226144
2708,3219801095,81646,3219882741,17,0,0,15872,17,1807377011
2709,3219868554,47288,3219915842,18,0,0,1536,18,5312721331
2710,3219991438,103376,3220094814,7,0,0,39424,7,2765487848
2711,3220014183,87354,3220101537,8,0,0,22016,8,157992043
2712,3220030816,3898,3220034714,0,0,1,4096,0,7802757179
2713,3220033674,5326,3220039000,0,0,1,5632,0,7106699878
2714,3220038697,158830,3220197527,12,0,0,12288,12,9249246664
2715,3220040855,1518,3220042373,13,0,1,1536,13,7954258953
2716,3220046958,97535,3220144493,0,0,0,10752,0,2976383080
2717,3220181114,4850,3220185964,2,0,1,5120,2,9513915470
2718,3220245783,70376,3220316159,8,0,0,11776,8,5386834222
2719,3220250149,6754,3220256903,0,0,1,7168,0,10149711494
2720,3220308644,84512,3220393156,7,0,0,12800,7,6096303523
2721,3220322972,3387,3220326359,16,0,1,9728,16,4361755115
2722,3220327006,88370,3220415376,17,0,0,13824,17,6917788418
2723,3220351390,3898,3220355288,10,0,1,4096,10,1175795800
2724,3220417839,101192,3220519031,15,0,0,32256,15,7289001147
2725,3220417957,110449,3220528406,0,0,0,30720,0,1737967926
2726,3220429340,68497,3220497837,13,0,0,7680,13,6810621816
2727,3220503473,56854,3220560327,8,0,1,97280,8,6920079400
2728,3220537812,71830,3220609642,16,0,0,512,16,6329998644
2729,3220550488,10505,3220560993,4,0,1,1024,4,7095151149
2730,3220577375,71009,3220648384,16,0,0,512,16,8361207715
2731,3220581383,1042,3220582425,2,0,1,1024,2,6329207203
2732,3220607335,121043,3220728378,14,0,0,64000,14,5733208673
2733,3220619098,111782,3220730880,8,0,0,512,8,1026745715
2734,3220620586,52520,3220673106,18,0,0,3584,18,8366357334
2735,3220626539,14287,3220640826,8,0,1,27648,8,6937828292
2736,3220668500,4621,3220673121,10,0,1,11776,10,3109593511
2737,3220688632,566,3220689198,11,0,1,512,11,8905009495
2738,3220692649,95549,3220788198,18,0,0,1024,18,2038142169
2739,3220707104,63878,3220770982,8,0,1,107520,8,2703775733
2740,3220734412,51113,3220785525,17,0,0,1024,17,288193118
2741,3220739176,87918,3220827094,13,0,0,16384,13,5761385764
2742,3220749490,77931,3220827421,6,0,0,1024,6,6067078959
2743,3220779741,79816,3220859557,6,0,0,1024,6,7015441633
2744,3220819152,8284,3220827436,15,0,1,7168,15,4709868351
2745,3220870236,43904,3220914140,6,0,0,512,6,4931132058
2746,3220921871,67611,3220989482,18,0,0,1024,18,8336380999
2747,3220979606,94712,3221074318,9,0,0,26112,9,1806162602
2748,3221000608,1042,3221001650,4,0,1,1024,4,6290333361
2749,3221017104,90863,3221107967,15,0,0,2048,15,8700989260
2750,3221118486,64364,3221182850,9,0,0,7168,9,8023173339
2751,3221139657,43904,3221183561,18,0,0,512,18,9471998596
2752,3221146394,59658,3221206052,14,0,0,1536,14,10245947627
2753,3221151870,566,3221152436,0,0,1,512,0,1375415915
2754,3221163065,43904,3221206969,18,0,0,512,18,6800075559
2755,3221277708,2470,3221280178,0,0,1,2560,0,6029894791
2756,3221280066,149999,3221430065,0,0,0,85504,0,2846849257
2757,3221281936,101893,3221383829,19,0,0,19456,19,10247934073
2758,3221297484,1518,3221299002,10,0,1,1536,10,6255118039
2759,3221352297,77783,3221430080,16,0,1,87040,16,9823957094
2760,3221384254,45841,3221430095,11,0,1,2560,11,9377312346
2761,3221412815,226970,3221639785,15,0,0,5120,15,8102234298
2762,3221494152,148456,3221642608,8,0,0,9216,8,1990462008
2763,3221494672,143538,3221638210,11,0,0,28672,11,580901963
2764,3221504462,43904,3221548366,10,0,0,512,10,3865217007
2765,3221547032,52570,3221599602,19,0,0,3072,19,6622451787
2766,3221570922,3422,3221574344,14,0,1,3584,14,1294888120
2767,3221591675,133781,3221725456,15,0,0,87040,15,6141270529
2768,3221603522,50999,3221654521,16,0,1,82432,16,7192367437
2769,3221658987,3128,3221662115,5,0,1,9216,5,3298440184
2770,3221675003,4374,3221679377,0,0,1,4608,0,3173156842
2771,3221685599,193345,3221878944,15,0,0,18944,15,3702150130
2772,3221821750,1042,3221822792,13,0,1,1024,13,5179030143
2773,3221835866,566,3221836432,3,0,1,512,3,3705717235
2774,3221857976,1994,3221859970,10,0,1,2048,10,550924871
2775,3221906902,5326,3221912228,13,0,1,5632,13,660128742
2776,3221916228,161777,3222078005,7,0,0,70656,7,6764784897
2777,3221976331,3128,3221979459,7,0,1,9216,7,4378071644
2778,3222013257,249736,3222262993,4,0,0,5120,4,3576503573
2779,3222030160,47860,3222078020,16,0,1,79360,16,4880276957
2780,3222051185,50295,3222101480,16,0,0,1024,16,9978741669
2781,3222079854,257281,3222337135,0,0,0,20480,0,6450031355
2782,3222093780,109401,3222203181,0,0,0,26112,0,4868552471
2783,3222102009,1042,3222103051,18,0,1,1024,18,2359556647
2784,3222148351,1518,3222149869,13,0,1,1536,13,8388793197
2785,3222204661,2946,3222207607,7,0,1,3072,7,9658757236
2786,3222269107,106496,3222375603,17,0,0,49664,17,6659847821
2787,3222279031,7230,3222286261,14,0,1,7680,14,5034303725
2788,3222281967,8480,3222290447,7,0,1,6656,7,9430870108
2789,3222298351,3645,3222301996,7,0,1,10240,7,4204250760
2790,3222311843,566,3222312409,5,0,1,512,5,6303853596
2791,3222312617,196139,3222508756,1,0,0,101888,1,1825447660
2792,3222327366,212790,3222540156,5,0,0,49152,5,7544708736
2793,3222441691,100976,3222542667,4,0,0,8192,4,2740383582
2794,3222514974,7706,3222522680,18,0,1,8192,18,10698249633
2795,3222566251,106808,3222673059,5,0,0,50688,5,7111052047
2796,3222600774,177051,3222777825,5,0,0,45568,5,6251484725
2797,3222604646,114823,3222719469,8,0,0,15360,8,1744753992
2798,3222644112,6278,3222650390,0,0,1,6656,0,1794348524
2799,3222659702,118770,3222778472,6,0,0,2048,6,2181654962
2800,3222677973,191286,3222869259,15,0,0,112640,15,1524989479
2801,3222695195,95287,3222790482,16,0,1,158720,16,9524082214
2802,3222698312,96996,3222795308,15,0,1,7680,15,174990478
2803,3222717595,80299,3222797894,2,0,1,4096,2,520229404
2804,3222757575,55610,3222813185,18,0,0,512,18,5403932849
2805,3222765276,34244,3222799520,0,0,1,2560,0,3611794303
2806,3222787789,14317,3222802106,5,0,1,4096,5,9099656504
2807,3222871032,195798,3223066830,6,0,0,1024,6,1117315691
2808,3222908514,11016,3222919530,8,0,1,17920,8,10119739888
2809,3222945240,194236,3223139476,14,0,0,29184,14,4363724877
2810,3222957276,4850,3222962126,0,0,1,5120,0,10228154493
2811,3222978590,161369,3223139959,16,0,0,1536,16,4639097992
2812,3222988613,2470,3222991083,6,0,1,2560,6,10321245418
2813,3223004568,1518,3223006086,3,0,1,1536,3,2963052978
2814,3223064120,3128,3223067248,11,0,1,9216,11,4637561356
2815,3223078970,101972,3223180942,7,0,0,34816,7,1477558186
2816,3223095510,12049,3223107559,18,0,1,19968,18,2399503489
2817,3223158245,121355,3223279600,19,0,0,53760,19,8499541650
2818,3223164210,43904,3223208114,18,0,0,512,18,6023462753
2819,3223169623,227733,3223397356,9,0,0,59904,9,1098156826
2820,3223194266,2470,3223196736,6,0,1,2560,6,8507452198
2821,3223208959,127107,3223336066,18,0,0,1024,18,10123052692
2822,3223220132,4374,3223224506,13,0,1,4608,13,10662221470
2823,3223224983,143663,3223368646,7,0,0,37376,7,4019118691
2824,3223422211,126308,3223548519,10,0,0,114688,10,4001542511
2825,3223452740,96746,3223549486,5,0,0,3072,5,7619592966
2826,3223487434,124559,3223611993,9,0,0,2048,9,5587486481
2827,3223511687,75256,3223586943,7,0,0,6656,7,9727751427
2828,3223522333,133922,3223656255,8,0,0,53760,8,6165872245
2829,3223539506,178543,3223718049,9,0,0,23552,9,2923251826
2830,3223545442,8410,3223553852,3,0,1,4608,3,7465395021
2831,3223588308,67962,3223656270,16,0,1,114176,16,4704106911
2832,3223628965,146219,3223775184,9,0,0,47616,9,9088882909
2833,3223655779,1049,3223656828,1,0,1,512,1,8434096480
2834,3223690134,146868,3223837002,14,0,0,22528,14,1800333048
2835,3223699147,5326,3223704473,16,0,1,5632,16,376871148
2836,3223770761,199051,3223969812,9,0,0,69120,9,4477112215
2837,3223780558,1042,3223781600,18,0,1,1024,18,3731806996
2838,3223787055,232224,3224019279,14,0,0,162304,14,2493298715
2839,3223791941,56854,3223848795,8,0,1,97280,8,219763284
2840,3223818439,210115,3224028554,14,0,0,8192,14,5686545129
2841,3223856373,473223,3224329596,9,0,0,230400,9,5577192735
2842,3223859715,166328,3224026043,4,0,0,18944,4,4149952093
2843,3223873449,146625,3224020074,4,0,0,2560,4,9640819907
2844,3223898187,168147,3224066334,14,0,0,59904,14,4281353578
2845,3223944193,267545,3224211738,11,0,0,31232,11,6750628953
2846,3223997674,43058,3224040732,8,0,1,33280,8,6221295340
2847,3223998082,43636,3224041718,0,0,1,1536,0,4012415206
2848,3224019680,342490,3224362170,9,0,0,28672,9,1895526463
2849,3224031589,302086,3224333675,8,0,0,13312,8,3999467366
2850,3224090906,1518,3224092424,13,0,1,1536,13,6502801475
2851,3224091858,912,3224092770,5,0,1,512,5,8401990029
2852,3224119057,69839,3224188896,18,0,0,512,18,10415720388
2853,3224170905,2946,3224173851,0,0,1,3072,0,1217044768
2854,3224172234,246264,3224418498,11,0,0,52224,11,7331969101
2855,3224177078,566,3224177644,0,0,1,512,0,10636287568
2856,3224268567,66610,3224335177,19,0,1,1536,19,3583018031
2857,3224308921,27242,3224336163,18,0,1,1536,18,10370793529
2858,3224345446,2946,3224348392,1,0,1,3072,1,3569086340
2859,3224361138,57687,3224418825,6,0,0,1024,6,5502737457
2860,3224437024,5802,3224442826,14,0,1,6144,14,3751925778
2861,3224522464,62516,3224584980,19,0,0,6144,19,2104636575
2862,3224533964,221860,3224755824,13,0,0,244224,13,6014948373
2863,3224571845,216095,3224787940,8,0,0,72704,8,8210438710
2864,3224572271,3387,3224575658,3,0,1,9728,3,5142676943
2865,3224671154,1518,3224672672,3,0,1,1536,3,6000989221
2866,3224741826,16460,3224758286,16,0,1,2560,16,4522795800
2867,3224763889,566,3224764455,6,0,1,512,6,4168921522
2868,3224789951,89924,3224879875,12,0,0,20480,12,8905508367
2869,3224804454,4374,3224808828,4,0,1,4608,4,6834971104
2870,3224830885,21399,3224852284,16,0,1,34816,16,5510330386
2871,3224848760,75406,3224924166,18,0,0,512,18,6840493458
2872,3224854289,116091,3224970380,6,0,0,1536,6,1555824428
2873,3224879380,51783,3224931163,16,0,0,4608,16,2302745530
2874,3224879823,223083,3225102906,12,0,0,33792,12,7813752085
2875,3224898186,149386,3225047572,10,0,0,5632,10,9147906552
2876,3224930559,84844,3225015403,5,0,0,22016,5,8171510824
2877,3224939095,1042,3224940137,14,0,1,1024,14,6764260162
2878,3224961807,2470,3224964277,6,0,1,2560,6,1386019488
2879,3224972421,566,3224972987,5,0,1,512,5,664067250
2880,3224992559,1994,3224994553,17,0,1,2048,17,2497124041
2881,3224998995,1994,3225000989,0,0,1,2048,0,4415801159
2882,3225003613,2870,3225006483,11,0,1,8704,11,1824334365
2883,3225035366,22862,3225058228,16,0,1,40960,16,7717273069
2884,3225080291,2946,3225083237,5,0,1,3072,5,4363804957
2885,3225095403,129214,3225224617,1,0,0,46080,1,9608214582
2886,3225154527,1518,3225156045,6,0,1,1536,6,4750568135
2887,3225180054,93284,3225273338,1,0,0,16384,1,806306210
2888,3225254315,93351,3225347666,8,0,0,14336,8,233912840
2889,3225263606,566,3225264172,15,0,1,512,15,10009040253
2890,3225276271,129751,3225406022,19,0,0,44544,19,8378697937
2891,3225302542,73748,3225376290,18,0,0,512,18,2275123919
2892,3225323693,45596,3225369289,16,0,0,1024,16,7197729917
2893,3225343336,185735,3225529071,12,0,0,98816,12,6010619168
2894,3225396414,14467,3225410881,19,0,1,5120,19,1628642760
2895,3225401627,11160,3225412787,5,0,1,13312,5,10010180817
2896,3225414228,1518,3225415746,13,0,1,1536,13,6125895804
2897,3225446673,106507,3225553180,7,0,0,4608,7,4262310624
2898,3225480625,234989,3225715614,14,0,0,76288,14,2435945029
2899,3225491113,286485,3225777598,15,0,0,15872,15,2638873255
2900,3225524504,242779,3225767283,8,0,0,29696,8,5658124440
2901,3225531544,118943,3225650487,7,0,0,59904,7,5021135930
2902,3225548410,102100,3225650510,16,0,1,147968,16,7605165768
2903,3225593064,57461,3225650525,3,0,1,3072,3,4858937559
2904,3225639463,233904,3225873367,10,0,0,2048,10,7870011099
2905,3225650821,239200,3225890021,4,0,0,5632,4,4202492544
2906,3225655006,275968,3225930974,4,0,0,65024,4,9577273506
2907,3225661379,1994,3225663373,2,0,1,2048,2,882423456
2908,3225673939,2470,3225676409,19,0,1,2560,19,4568564246
2909,3225711969,116784,3225828753,10,0,0,28672,10,1014072963
2910,3225738489,253655,3225992144,12,0,0,32768,12,5793439423
2911,3225783817,254683,3226038500,14,0,0,11264,14,9356370133
2912,3225788778,145339,3225934117,19,0,0,10240,19,7821714762
2913,3225793148,74228,3225867376,12,0,0,14336,12,5170464812
2914,3225800586,93162,3225893748,10,0,0,2560,10,4367825458
2915,3225820170,72783,3225892953,10,0,0,6656,10,7401858571
2916,3225821193,12256,3225833449,15,0,1,12288,15,1249574210
2917,3225841127,156469,3225997596,14,0,0,14848,14,769678713
2918,3225856435,92850,3225949285,13,0,0,3072,13,818457566
2919,3225919762,135326,3226055088,7,0,0,9728,7,3817940372
2920,3225926900,8251,3225935151,2,0,1,1024,2,6092694094
2921,3225947007,68230,3226015237,0,0,0,512,0,10175019737
2922,3225983811,13800,3225997611,14,0,1,1024,14,6862079388
2923,3225985119,114318,3226099437,3,0,0,52224,3,10629953039
2924,3225999490,75629,3226075119,9,0,0,1536,9,8818863354
2925,3226023930,51732,3226075662,6,0,0,512,6,2124838059
2926,3226041335,122197,3226163532,3,0,0,60928,3,8394204534
2927,3226102509,91383,3226193892,18,0,0,2048,18,6531335354
2928,3226104766,99746,3226204512,14,0,0,6656,14,6520315354
2929,3226108071,58899,3226166970,1,0,0,512,1,7485850836
2930,3226132843,30704,3226163547,4,0,1,32256,4,6485130749
2931,3226178706,122347,3226301053,10,0,0,45056,10,10464297681
2932,3226197826,240641,3226438467,11,0,0,1024,11,7472081611
2933,3226207304,230836,3226438140,15,0,0,156160,15,6959118964
2934,3226213816,381583,3226595399,4,0,0,270848,4,5207699297
2935,3226240253,367345,3226607598,12,0,0,39936,12,99757463
2936,3226264215,12825,3226277040,1,0,1,21504,1,2381784186
2937,3226284634,340147,3226624781,10,0,0,56320,10,5622305024
2938,3226327500,3898,3226331398,4,0,1,4096,4,4854763370
2939,3226331605,15837,3226347442,16,0,1,30720,16,3064253150
2940,3226339691,8827,3226348518,8,0,1,13312,8,5560892033
2941,3226375581,270957,3226646538,13,0,0,21504,13,7863507860
2942,3226506432,120572,3226627004,12,0,0,7168,12,3910948531
2943,3226510009,129962,3226639971,4,0,0,13312,4,2520698864
2944,3226516241,115754,3226631995,15,0,1,7680,15,6557070432
2945,3226537872,119935,3226657807,19,0,0,6144,19,3625954871
2946,3226577039,112921,3226689960,3,0,0,7168,3,6207343961
2947,3226582285,64268,3226646553,15,0,1,28160,15,2890845727
2948,3226601944,44624,3226646568,11,0,1,7680,11,9509384626
2949,3226613948,34852,3226648800,19,0,1,3584,19,7007318265
2950,3226654566,131138,3226785704,17,0,0,23552,17,3617532784
2951,3226661673,195012,3226856685,0,0,0,21504,0,6778928717
2952,3226667141,110004,3226777145,19,0,0,28160,19,485759128
2953,3226857306,102752,3226960058,1,0,0,37376,1,9755065126
2954,3226861427,70376,3226931803,3,0,0,11776,3,5120318135
2955,3226895225,65784,3226961009,5,0,0,3072,5,5311555166
2956,3226905624,13858,3226919482,16,0,1,23552,16,2515581327
2957,3226928417,106087,3227034504,11,0,0,1024,11,3494111843
2958,3226936195,3422,3226939617,7,0,1,3584,7,5146727194
2959,3226939756,249920,3227189676,11,0,0,77824,11,10716354858
2960,3226944514,1518,3226946032,18,0,1,1536,18,4832198179
2961,3226961262,1994,3226963256,10,0,1,2048,10,2471343970
2962,3226968786,100422,3227069208,17,0,0,16896,17,3262195724
2963,3227043236,77900,3227121136,5,0,0,11264,5,1155511051
2964,3227044035,71912,3227115947,8,0,0,11776,8,5286055789
2965,3227045605,3422,3227049027,5,0,1,3584,5,5393313687
2966,3227096360,123766,3227220126,10,0,0,33792,10,7659183697
2967,3227135877,1994,3227137871,5,0,1,2048,5,10254207361
2968,3227165897,23794,3227189691,6,0,1,5120,6,4695454723
2969,3227224465,12737,3227237202,16,0,1,24576,16,3829454390
2970,3227256316,3422,3227259738,13,0,1,3584,13,4712085374
2971,3227265492,129787,3227395279,1,0,0,55808,1,4698458266
2972,3227279727,13858,3227293585,14,0,1,23552,14,10429779289
2973,3227308509,87268,3227395777,19,0,0,1536,19,7454323041
2974,3227336364,5454,3227341818,13,0,1,13824,13,6531110041
2975,3227376567,18727,3227395294,11,0,1,3072,11,6594302664
2976,3227591795,68281,3227660076,5,0,0,4096,5,9534587318
2977,3227606924,1518,3227608442,13,0,1,1536,13,8090204018
2978,3227641880,54056,3227695936,10,0,0,3584,10,7556707313
2979,3227642999,3645,3227646644,8,0,1,10240,8,7540850794
2980,3227709187,3422,3227712609,4,0,1,3584,4,1459413064
2981,3227736794,148494,3227885288,10,0,0,59904,10,6432901193
2982,3227804803,3422,3227808225,15,0,1,3584,15,2762406512
2983,3227814334,3898,3227818232,11,0,1,4096,11,7318093072
2984,3227827183,191996,3228019179,10,0,0,168960,10,262090443
2985,3227838546,5326,3227843872,10,0,1,5632,10,570023722
2986,3227848958,6278,3227855236,4,0,1,6656,4,9251534668
2987,3227892564,7230,3227899794,16,0,1,7680,16,3220213483
2988,3227903666,1042,3227904708,15,0,1,1024,15,9978022268
2989,3227926461,149508,3228075969,13,0,0,2048,13,4842370357
2990,3227943137,76057,3228019194,16,0,1,50176,16,4123449885
2991,3227989726,90284,3228080010,10,0,0,5632,10,8530062685
2992,3228026533,58529,3228085062,13,0,0,2048,13,8294511210
2993,3228060571,213257,3228273828,14,0,0,41984,14,8710952038
2994,3228081504,179517,3228261021,7,0,0,130048,7,1626440241
2995,3228170873,4374,3228175247,13,0,1,4608,13,3518380357
2996,3228311310,124904,3228436214,11,0,0,110080,11,9615229024
2997,3228355044,138434,3228493478,12,0,0,23552,12,8094173865
2998,3228389035,47194,3228436229,2,0,1,32768,2,9357182803
2999,3228396867,49655,3228446522,6,0,0,512,6,1706480422
3000,3228415628,21652,3228437280,11,0,1,1024,11,3941840926
3001,3228433464,78224,3228511688,18,0,0,1536,18,10631275454
3002,3228453759,66979,3228520738,8,0,1,113664,8,8651691954
3003,3228460404,190515,3228650919,17,0,0,62976,17,8817407470
3004,3228477771,314700,3228792471,6,0,0,1024,6,7303166706
3005,3228516201,216324,3228732525,15,0,0,97792,15,4595792955
3006,3228571900,2470,3228574370,11,0,1,2560,11,9285226572
3007,3228579032,1518,3228580550,19,0,1,1536,19,6878578120
3008,3228580970,4420,3228585390,13,0,1,11776,13,7708652317
3009,3228598375,1042,3228599417,10,0,1,1024,10,3727222661
3010,3228622671,139941,3228762612,4,0,0,53248,4,9860293866
3011,3228644317,232065,3228876382,4,0,0,57344,4,1580287459
3012,3228657160,155867,3228813027,16,0,1,253440,16,825386186
3013,3228681508,136025,3228817533,14,0,1,7168,14,3729567322
3014,3228688129,200691,3228888820,15,0,0,16384,15,4373213275
3015,3228692022,129057,3228821079,14,0,1,5632,14,7127664799
3016,3228704438,120827,3228825265,5,0,1,6656,5,8118456404
3017,3228759975,175058,3228935033,6,0,0,512,6,803044189
3018,3228789568,295473,3229085041,10,0,0,17920,10,10494984948
3019,3228853567,3422,3228856989,19,0,1,3584,19,4364286489
3020,3228900548,69270,3228969818,9,0,0,512,9,9967067465
3021,3228919185,11274,3228930459,6,0,1,18432,6,9366130149
3022,3228928377,6278,3228934655,10,0,1,6656,10,4114866157
3023,3228967895,142763,3229110658,1,0,0,28160,1,4853421532
3024,3228978524,1994,3228980518,10,0,1,2048,10,2060341952
3025,3228998980,199933,3229198913,10,0,0,10240,10,321569826
3026,3229035205,54617,3229089822,16,0,1,89600,16,10315565963
3027,3229084477,349222,3229433699,0,0,0,76800,0,443523368
3028,3229094291,74010,3229168301,16,0,0,512,16,4721183415
3029,3229110209,3828,3229114037,7,0,1,9728,7,544213167
3030,3229157784,3898,3229161682,6,0,1,4096,6,2645793880
3031,3229167202,205420,3229372622,1,0,0,28160,1,1233662730
3032,3229185643,72539,3229258182,16,0,0,1536,16,8621691730
3033,3229197344,4031,3229201375,15,0,1,2560,15,10425860757
3034,3229215215,5802,3229221017,5,0,1,6144,5,1707298961
3035,3229245184,3898,3229249082,4,0,1,4096,4,2781522546
3036,3229295636,44920,3229340556,16,0,1,77312,16,7145457750
3037,3229320034,128254,3229448288,3,0,0,8192,3,2298651703
3038,3229325113,185059,3229510172,0,0,0,53248,0,10470935063
3039,3229326618,14924,3229341542,10,0,1,1536,10,6002660509
3040,3229361188,103597,3229464785,12,0,0,16384,12,6715468400
3041,3229408813,24901,3229433714,0,0,1,3072,0,10264385838
3042,3229418115,178112,3229596227,13,0,0,20992,13,848302178
3043,3229447069,90541,3229537610,6,0,0,1024,6,10458635163
3044,3229462535,117865,3229580400,15,0,0,26112,15,6172878313
3045,3229495462,20997,3229516459,14,0,1,6656,14,5701863137
3046,3229503771,13994,3229517765,2,0,1,2048,2,3971754696
3047,3229525450,5802,3229531252,3,0,1,6144,3,8111660294
3048,3229573226,186323,3229759549,11,0,0,84480,11,2721602335
3049,3229615601,6754,3229622355,0,0,1,7168,0,9789650405
3050,3229657310,1518,3229658828,1,0,1,1536,1,3549265562
3051,3229674338,3645,3229677983,4,0,1,10240,4,5783686057
3052,3229678345,12049,3229690394,19,0,1,19968,19,10468094520
3053,3229752891,133722,3229886613,1,0,0,103936,1,2570035169
3054,3229765543,3645,3229769188,18,0,1,10240,18,2020248783
3055,3229803255,122316,3229925571,11,0,0,18944,11,8575927443
3056,3229837429,7230,3229844659,13,0,1,7680,13,3024569666
3057,3229854543,45596,3229900139,1,0,0,1024,1,1754181742
3058,3229916191,85472,3230001663,4,0,0,20992,4,2297727175
3059,3229951334,54056,3230005390,14,0,0,3584,14,9488324142
3060,3229953295,167625,3230120920,11,0,0,37376,11,6006941074
3061,3229957077,45696,3230002773,8,0,1,78848,8,5096162228
3062,3229999934,195770,3230195704,0,0,0,18432,0,2948670694
3063,3230004118,203334,3230207452,16,0,0,1536,16,4097195199
3064,3230026555,163288,3230189843,15,0,0,24064,15,3541562553
3065,3230033414,5196,3230038610,5,0,1,13312,5,3186077511
3066,3230074537,224349,3230298886,7,0,0,68608,7,868669018
3067,3230108136,74360,3230182496,8,0,0,9728,8,4719931998
3068,3230144891,1042,3230145933,10,0,1,1024,10,4392712504
3069,3230146338,1042,3230147380,11,0,1,1024,11,7536173711
3070,3230153247,3128,3230156375,17,0,1,9216,17,136938077
3071,3230166430,183948,3230350378,5,0,0,76288,5,1302074551
3072,3230219702,3645,3230223347,19,0,1,10240,19,2294608208
3073,3230254679,108641,3230363320,17,0,0,11776,17,8017262509
3074,3230292557,58148,3230350705,9,0,0,1024,9,9695713756
3075,3230306243,5971,3230312214,16,0,1,14848,16,9135806015
3076,3230310590,6028,3230316618,3,0,1,6144,3,4639574468
3077,3230312144,5140,3230317284,5,0,1,1024,5,5746995992
3078,3230319982,1994,3230321976,19,0,1,2048,19,828351499
3079,3230363179,699,3230363878,5,0,1,512,5,4283413948
3080,3230369282,2470,3230371752,2,0,1,2560,2,3846576217
3081,3230419087,566,3230419653,3,0,1,512,3,2047303321
3082,3230424837,3387,3230428224,18,0,1,9728,18,4746920722
3083,3230432725,3387,3230436112,17,0,1,9728,17,2792848148
3084,3230445614,49812,3230495426,12,0,0,1536,12,7423354997
3085,3230452835,124244,3230577079,13,0,0,27648,13,6833126188
3086,3230539336,1518,3230540854,13,0,1,1536,13,4874179261
3087,3230584663,100256,3230684919,10,0,0,29184,10,6729338549
3088,3230626548,2946,3230629494,1,0,1,3072,1,7643252888
3089,3230690249,1518,3230691767,16,0,1,1536,16,8982578160
3090,3230746862,4420,3230751282,5,0,1,11776,5,9830535759
3091,3230758411,4850,3230763261,5,0,1,5120,5,6015661501
3092,3230782969,47288,3230830257,6,0,0,1536,6,5311428778
3093,3230808495,6278,3230814773,14,0,1,6656,14,1974563025
3094,3230823782,1518,3230825300,5,0,1,1536,5,5461706825
3095,3230830229,47308,3230877537,6,0,0,1536,6,4608834036
3096,3230852175,235272,3231087447,16,0,0,1024,16,6537897426
3097,3230854064,233056,3231087120,14,0,0,212992,14,8310422637
3098,3230863613,1042,3230864655,2,0,1,1024,2,8347919768
3099,3230886951,231096,3231118047,1,0,0,61952,1,8831789656
3100,3230938805,5326,3230944131,0,0,1,5632,0,1552861468
3101,3230965312,184411,3231149723,7,0,0,512,7,6163795827
3102,3230975907,2870,3230978777,14,0,1,8704,14,1541224052
3103,3230976899,150211,3231127110,4,0,0,29696,4,9386546259
3104,3230982613,105161,3231087774,16,0,0,1024,16,487880522
3105,3231042922,50212,3231093134,14,0,1,5632,14,4790680059
3106,3231068730,136853,3231205583,15,0,0,22528,15,4624353111
3107,3231076538,116381,3231192919,1,0,0,19968,1,9460743035
3108,3231090752,55333,3231146085,6,0,0,512,6,5948148765
3109,3231119092,179705,3231298797,10,0,0,9216,10,6827426787
3110,3231123859,201902,3231325761,8,0,0,27136,8,5177393227
3111,3231132232,101746,3231233978,18,0,0,1024,18,3839271318
3112,3231220387,5971,3231226358,4,0,1,14848,4,851627541
3113,3231255487,6754,3231262241,1,0,1,7168,1,7565411963
3114,3231270476,73745,3231344221,8,0,1,123392,8,6035809278
3115,3231276451,191535,3231467986,11,0,0,60928,11,9124801699
3116,3231283411,64036,3231347447,19,0,1,5120,19,720150282
3117,3231294203,107294,3231401497,6,0,0,512,6,8786050677
3118,3231294345,54408,3231348753,18,0,1,2048,18,2402556018
3119,3231304902,44197,3231349099,4,0,1,512,4,2772227229
3120,3231309970,42035,3231352005,0,0,1,4608,0,6633725614
3121,3231362413,216733,3231579146,10,0,0,31232,10,1446643997
3122,3231373919,109559,3231483478,15,0,0,5120,15,2299155522
3123,3231417567,64208,3231481775,12,0,0,6656,12,8285599534
3124,3231420053,6754,3231426807,16,0,1,7168,16,1544682514
3125,3231518936,5802,3231524738,18,0,1,6144,18,4465205329
3126,3231519697,141511,3231661208,15,0,0,97792,15,9619445761
3127,3231532401,133510,3231665911,11,0,0,15360,11,3798514268
3128,3231578471,120471,3231698942,10,0,0,13824,10,3210400479
3129,3231585965,1994,3231587959,1,0,1,2048,1,8782559035
3130,3231648345,111395,3231759740,7,0,0,23552,7,9031847866
3131,3231710262,195118,3231905380,1,0,0,25600,1,10633720672
3132,3231725122,122332,3231847454,1,0,0,83456,1,656414080
3133,3231743262,104831,3231848093,9,0,0,2048,9,7424510950
3134,3231787747,3645,3231791392,18,0,1,10240,18,6646274740
3135,3231796477,2946,3231799423,10,0,1,3072,10,5587969028
3136,3231798194,50382,3231848576,9,0,0,1536,9,3804028830
3137,3231954149,2946,3231957095,4,0,1,3072,4,639784762
3138,3232011142,5802,3232016944,16,0,1,6144,16,5321529529
3139,3232038775,6754,3232045529,1,0,1,7168,1,7534033065
3140,3232090941,1994,3232092935,4,0,1,2048,4,3209647062
3141,3232091977,7230,3232099207,0,0,1,7680,0,6415613356
3142,3232095539,100412,3232195951,15,0,0,29696,15,4961939736
3143,3232142688,107492,3232250180,1,0,0,47104,1,9233808267
3144,3232193614,5275,3232198889,13,0,1,3072,13,9678177649
3145,3232204981,149633,3232354614,3,0,0,35328,3,6215267709
3146,3232337670,4850,3232342520,2,0,1,5120,2,7613475773
3147,3232380450,3898,3232384348,5,0,1,4096,5,4866162102
3148,3232419212,147111,3232566323,15,0,0,50688,15,5992603528
3149,3232436689,1994,3232438683,7,0,1,2048,7,731723054
3150,3232471158,5712,3232476870,2,0,1,14336,2,458303629
3151,3232490173,7230,3232497403,0,0,1,7680,0,3353677659
3152,3232495205,115429,3232610634,1,0,0,26112,1,2380665503
3153,3232518510,190749,3232709259,19,0,0,47104,19,8176799869
3154,3232540656,93152,3232633808,13,0,0,20992,13,6232326720
3155,3232543475,187908,3232731383,17,0,0,55808,17,4037079997
3156,3232612954,272119,3232885073,13,0,0,165888,13,7999561922
3157,3232628272,158249,3232786521,19,0,0,72704,19,5953794080
3158,3232661019,1042,3232662061,14,0,1,1024,14,7371138002
3159,3232733603,3645,3232737248,6,0,1,10240,6,7637857423
3160,3232734799,96885,3232831684,15,0,0,4096,15,3548691319
3161,3232756234,2470,3232758704,10,0,1,2560,10,1918223458
3162,3232853913,165173,3233019086,14,0,0,15360,14,8075791747
3163,3232883398,4162,3232887560,4,0,1,2560,4,2531149279
3164,3232939348,1518,3232940866,10,0,1,1536,10,6263872038
3165,3232943717,50672,3232994389,12,0,0,2560,12,1731700044
3166,3232974303,4937,3232979240,6,0,1,12800,6,573287983
3167,3233030629,1042,3233031671,11,0,1,1024,11,3789147751
3168,3233059672,4850,3233064522,2,0,1,5120,2,1457663258
3169,3233084441,101660,3233186101,3,0,0,33792,3,6960883038
3170,3233116778,103019,3233219797,4,0,0,2048,4,8470029591
3171,3233157071,1042,3233158113,0,0,1,1024,0,5558453935
3172,3233224071,101504,3233325575,3,0,0,33280,3,5341382784
3173,3233227850,153687,3233381537,14,0,0,4096,14,10108050293
3174,3233229809,134898,3233364707,11,0,0,25600,11,8633608551
3175,3233328606,90524,3233419130,11,0,0,17408,11,1595491642
3176,3233347768,123358,3233471126,0,0,0,67072,0,262720981
3177,3233387804,3422,3233391226,19,0,1,3584,19,10516501992
3178,3233422597,119706,3233542303,11,0,0,69120,11,5551331547
3179,3233434925,61282,3233496207,1,0,0,6144,1,454365054
3180,3233463733,163072,3233626805,19,0,0,58880,19,7333203976
3181,3233491201,5326,3233496527,10,0,1,5632,10,5991395619
3182,3233510302,98540,3233608842,14,0,0,23552,14,8421445084
3183,3233523387,103605,3233626992,9,0,0,512,9,2117021160
3184,3233562568,85169,3233647737,6,0,0,1024,6,8447626856
3185,3233589391,156218,3233745609,17,0,0,105472,17,3690710430
3186,3233600559,150845,3233751404,19,0,0,18944,19,483027430
3187,3233605754,160181,3233765935,8,0,0,47616,8,9329687162
3188,3233611518,199211,3233810729,3,0,0,21504,3,1717548002
3189,3233616876,85014,3233701890,18,0,0,512,18,10349469837
3190,3233676783,6278,3233683061,2,0,1,6656,2,10127387153
3191,3233734259,31707,3233765966,1,0,1,11264,1,5933616179
3192,3233748699,18771,3233767470,18,0,1,1536,18,9550397388
3193,3233755210,81185,3233836395,8,0,0,12800,8,9902066800
3194,3233778256,3898,3233782154,13,0,1,4096,13,9778277748
3195,3233782394,3898,3233786292,15,0,1,4096,15,5350306354
3196,3233786334,13253,3233799587,1,0,1,25600,1,5430756880
3197,3233805938,8681,3233814619,16,0,1,4096,16,7394014603
3198,3233831132,6488,3233837620,0,0,1,15872,0,4341156695
3199,3233876545,43904,3233920449,18,0,0,512,18,6140859292
3200,3233953524,4374,3233957898,1,0,1,4608,1,5214758451
3201,3233963894,1518,3233965412,2,0,1,1536,2,1794775210
3202,3233965991,4162,3233970153,14,0,1,11264,14,9363829112
3203,3234000167,114920,3234115087,13,0,0,77312,13,9016914401
3204,3234017121,5326,3234022447,6,0,1,5632,6,7868562566
3205,3234022598,36604,3234059202,8,0,1,64512,8,1154951427
3206,3234054546,320679,3234375225,12,0,0,77312,12,3013357182
3207,3234065978,113537,3234179515,13,0,0,44544,13,9235786851
3208,3234077193,2946,3234080139,0,0,1,3072,0,3312300300
3209,3234114257,2340,3234116597,1,0,1,1536,1,3794591519
3210,3234182847,167281,3234350128,16,0,0,1024,16,1131413362
3211,3234192290,7230,3234199520,5,0,1,7680,5,2448685655
3212,3234216748,133037,3234349785,0,0,0,89600,0,2199843017
3213,3234233408,70513,3234303921,14,0,0,4608,14,2431169415
3214,3234246024,140768,3234386792,1,0,0,37888,1,7491782059
3215,3234263591,123684,3234387275,16,0,0,1536,16,6951120765
3216,3234263605,134984,3234398589,9,0,0,512,9,8131283071
3217,3234282213,105249,3234387462,6,0,0,512,6,9579464039
3218,3234330332,132271,3234462603,0,0,0,17920,0,9722566748
3219,3234331241,184462,3234515703,11,0,0,18944,11,1634570577
3220,3234364928,285811,3234650739,19,0,0,207872,19,4286769544
3221,3234380866,166745,3234547611,19,0,0,30720,19,1566921572
3222,3234385322,152413,3234537735,16,0,0,512,16,418491605
3223,3234395825,106294,3234502119,8,0,0,4608,8,10190850844
3224,3234425163,134418,3234559581,18,0,0,512,18,7861949980
3225,3234520794,1518,3234522312,13,0,1,1536,13,1374090754
3226,3234524139,43904,3234568043,6,0,0,512,6,1539679656
3227,3234542589,10816,3234553405,3,0,1,6144,3,6494198985
3228,3234607208,48440,3234655648,17,0,1,5120,17,2321219456
3229,3234608842,51312,3234660154,14,0,1,7168,14,7512762130
3230,3234624821,37279,3234662100,6,0,1,3072,6,8496956836
3231,3234637904,126574,3234764478,11,0,0,73216,11,647210849
3232,3234664062,5712,3234669774,11,0,1,14336,11,9184719094
3233,3234664573,133997,3234798570,10,0,0,38912,10,1164297522
3234,3234685370,139187,3234824557,3,0,0,26112,3,5938999174
3235,3234686861,81459,3234768320,7,0,0,5632,7,4466829575
3236,3234721149,6754,3234727903,11,0,1,7168,11,9628997532
3237,3234736121,105866,3234841987,14,0,0,1536,14,8411938689
3238,3234804424,3128,3234807552,7,0,1,9216,7,8431317583
3239,3234809602,80084,3234889686,7,0,0,18432,7,381618891
3240,3234830222,100568,3234930790,14,0,0,30208,14,3073586263
3241,3234831977,172223,3235004200,3,0,0,5632,3,8322959711
3242,3234884902,27467,3234912369,8,0,1,37376,8,4838110074
3243,3234898804,90207,3234989011,0,0,0,13824,0,4873687779
3244,3234937673,51509,3234989182,5,0,0,512,5,10624081150
3245,3234948957,4374,3234953331,13,0,1,4608,13,9690436586
3246,3234950139,240459,3235190598,15,0,0,21504,15,10315872828
3247,3234957194,1994,3234959188,11,0,1,2048,11,506039618
3248,3234991109,2470,3234993579,5,0,1,2560,5,2358538561
3249,3235015050,7706,3235022756,19,0,1,8192,19,10118253407
3250,3235040656,43904,3235084560,6,0,0,512,6,5134182111
3251,3235054348,6754,3235061102,11,0,1,7168,11,8131988744
3252,3235065075,4420,3235069495,18,0,1,11776,18,7787863120
3253,3235127305,3422,3235130727,14,0,1,3584,14,8345546855
3254,3235139870,187689,3235327559,19,0,0,33280,19,2208108157
3255,3235159440,48980,3235208420,15,0,0,2048,15,1576466985
3256,3235219832,1994,3235221826,0,0,1,2048,0,6605983708
3257,3235243338,1518,3235244856,11,0,1,1536,11,1880492992
3258,3235266557,2470,3235269027,8,0,1,2560,8,795127100
3259,3235276688,51518,3235328206,6,0,0,2048,6,3218510179
3260,3235285455,272420,3235557875,19,0,0,286720,19,1793055117
3261,3235292797,265725,3235558522,18,0,0,2048,18,591513077
3262,3235299445,51516,3235350961,8,0,1,83456,8,3485100812
3263,3235306842,334032,3235640874,11,0,0,82944,11,4716657505
3264,3235348035,5196,3235353231,1,0,1,13312,1,5262050107
3265,3235354528,441027,3235795555,14,0,0,123392,14,7113299516
3266,3235372848,4374,3235377222,3,0,1,4608,3,7542791146
3267,3235398430,245609,3235644039,5,0,0,9728,5,3659721859
3268,3235398455,180943,3235579398,4,0,0,42496,4,10680991124
3269,3235417132,401861,3235818993,17,0,0,73216,17,6804993017
3270,3235452948,1042,3235453990,15,0,1,1024,15,5617299716
3271,3235467392,173653,3235641045,9,0,0,512,9,9109583390
3272,3235482958,81375,3235564333,0,0,1,6144,0,9919401054
3273,3235498564,80865,3235579429,14,0,1,17408,14,519482091
3274,3235543130,36314,3235579444,7,0,1,4608,7,6382863715
3275,3235564609,76451,3235641060,8,0,1,91648,8,7612598573
3276,3235566003,93267,3235659270,9,0,0,1536,9,7459142456
3277,3235582927,213735,3235796662,13,0,0,3584,13,4900713130
3278,3235655092,566,3235655658,11,0,1,512,11,1149679358
3279,3235658206,196253,3235854459,17,0,0,37376,17,7870440535
3280,3235769730,195780,3235965510,19,0,0,5632,19,1062521316
3281,3235785361,174993,3235960354,17,0,0,46592,17,2701491531
3282,3235790673,81012,3235871685,15,0,0,2048,15,6480734870
3283,3235803986,142149,3235946135,0,0,0,85504,0,2797750943
3284,3235825278,2470,3235827748,2,0,1,2560,2,8852055646
3285,3235835548,1518,3235837066,11,0,1,1536,11,7068878581
3286,3235909548,2470,3235912018,17,0,1,2560,17,3585660117
3287,3235910401,68554,3235978955,16,0,0,1024,16,1256933679
3288,3235914974,566,3235915540,11,0,1,512,11,6965083976
3289,3235924300,38959,3235963259,4,0,1,3072,4,7083552168
3290,3235953379,58575,3236011954,6,0,0,2560,6,1048223377
3291,3235961683,137862,3236099545,15,0,0,2048,15,7591056983
3292,3236011637,1827,3236013464,0,0,1,1536,0,1517401978
3293,3236098127,164917,3236263044,14,0,0,109568,14,2410195862
3294,3236143632,1518,3236145150,10,0,1,1536,10,7173908126
3295,3236184702,81017,3236265719,10,0,0,8704,10,7430433612
3296,3236224805,48980,3236273785,15,0,0,2048,15,674478968
3297,3236250357,126663,3236377020,5,0,0,74240,5,4441702286
3298,3236314584,114610,3236429194,8,0,0,59904,8,10716243211
3299,3236316762,3128,3236319890,4,0,1,9216,4,1008837495
3300,3236410753,18456,3236429209,6,0,1,11776,6,2914020167
3301,3236419465,10344,3236429809,7,0,1,512,7,6844149180
3302,3236423635,104911,3236528546,4,0,0,26112,4,2711238381
3303,3236424164,8181,3236432345,18,0,1,3072,18,9989842729
3304,3236455653,110477,3236566130,16,0,0,1024,16,720399141
3305,3236480884,2946,3236483830,15,0,1,3072,15,9043116660
3306,3236506242,107432,3236613674,10,0,0,52736,10,8519135044
3307,3236522116,14128,3236536244,3,0,1,8192,3,8843976926
3308,3236549768,1042,3236550810,4,0,1,1024,4,5323016716
3309,3236554353,7706,3236562059,14,0,1,8192,14,5031666115
3310,3236595523,327146,3236922669,13,0,0,223232,13,1602366125
3311,3236598574,225437,3236824011,12,0,0,122368,12,819296574
3312,3236605631,449473,3237055104,14,0,0,203264,14,3530084337
3313,3236617702,3898,3236621600,18,0,1,4096,18,6409294528
3314,3236707952,1518,3236709470,2,0,1,1536,2,1266497689
3315,3236746503,566,3236747069,15,0,1,512,15,6029842104
3316,3236754599,2470,3236757069,3,0,1,2560,3,1944713342
3317,3236762729,10499,3236773228,3,0,1,16896,3,2928570694
3318,3236779639,213518,3236993157,13,0,0,74240,13,6803969006
3319,3236813628,13321,3236826949,10,0,1,3072,10,3635816050
3320,3236880686,175369,3237056055,7,0,0,3072,7,4299892119
3321,3236939746,1994,3236941740,2,0,1,2048,2,5421862686
3322,3236960742,1518,3236962260,2,0,1,1536,2,897275051
3323,3237026276,93979,3237120255,4,0,0,6656,4,8444413389
3324,3237141013,45596,3237186609,18,0,0,1024,18,2293568272
3325,3237174782,4850,3237179632,7,0,1,5120,7,6205907888
3326,3237204358,3904,3237208262,6,0,1,10752,6,6891514928
3327,3237224371,1042,3237225413,19,0,1,1024,19,7443049401
3328,3237301572,85292,3237386864,17,0,0,15360,17,6027201720
3329,3237336523,43904,3237380427,16,0,0,512,16,10225694488
3330,3237345607,132543,3237478150,15,0,0,512,15,8969995548
3331,3237365501,190535,3237556036,12,0,0,28160,12,6584886290
3332,3237376765,157443,3237534208,0,0,0,57344,0,171399337
3333,3237455901,15062,3237470963,15,0,1,29184,15,3303060214
3334,3237459252,115774,3237575026,14,0,0,8704,14,6758281633
3335,3237467305,140055,3237607360,1,0,0,65536,1,6750283959
3336,3237503947,6754,3237510701,17,0,1,7168,17,3069421552
3337,3237544355,276142,3237820497,13,0,0,40960,13,4545225728
3338,3237605934,130227,3237736161,1,0,0,53760,1,3756336321
3339,3237685534,3128,3237688662,0,0,1,9216,0,9900205947
3340,3237697865,3422,3237701287,1,0,1,3584,1,6826971990
3341,3237718568,17608,3237736176,8,0,1,21504,8,1035837267
3342,3237740861,3422,3237744283,3,0,1,3584,3,2238664962
3343,3237755230,3898,3237759128,2,0,1,4096,2,3980261343
3344,3237762795,58029,3237820824,16,0,0,1024,16,2597652140
3345,3237848247,52364,3237900611,10,0,0,3072,10,2706445702
3346,3237868964,1994,3237870958,10,0,1,2048,10,6739572982
3347,3237884174,1518,3237885692,2,0,1,1536,2,8974341977
3348,3237885153,4850,3237890003,15,0,1,5120,15,9530837752
3349,3237893450,84536,3237977986,12,0,0,17920,12,3979157415
3350,3237955402,2946,3237958348,4,0,1,3072,4,8231568105
3351,3237994805,110644,3238105449,1,0,0,43520,1,147631744
3352,3238006918,4850,3238011768,4,0,1,5120,4,8126602132
3353,3238077107,2946,3238080053,0,0,1,3072,0,6017362220
3354,3238085663,159283,3238244946,4,0,0,24064,4,780494566
3355,3238095943,13872,3238109815,2,0,1,4608,2,3475334263
3356,3238118685,112847,3238231532,18,0,0,512,18,7852847390
3357,3238128182,43904,3238172086,6,0,0,512,6,5490422103
3358,3238169878,61124,3238231002,8,0,1,98816,8,8296250874
3359,3238176701,54647,3238231348,10,0,1,512,10,3770822504
3360,3238176816,106338,3238283154,6,0,0,1024,6,7439027169
3361,3238185463,49431,3238234894,19,0,1,5632,19,1829316517
3362,3238228658,86755,3238315413,10,0,0,1024,10,4155858269
3363,3238245103,1994,3238247097,7,0,1,2048,7,7613009847
3364,3238307309,150291,3238457600,1,0,0,18432,1,4850834839
3365,3238389283,85472,3238474755,12,0,0,20992,12,4424458566
3366,3238401683,14117,3238415800,8,0,1,24064,8,9637894832
3367,3238444400,43904,3238488304,9,0,0,512,9,1245510512
3368,3238466961,156481,3238623442,15,0,0,1536,15,150984372
3369,3238477238,2470,3238479708,3,0,1,2560,3,8676065438
3370,3238513657,2870,3238516527,16,0,1,8704,16,885611707
3371,3238565633,2946,3238568579,3,0,1,3072,3,7926785202
3372,3238570884,3422,3238574306,17,0,1,3584,17,7137981957
3373,3238573621,5802,3238579423,14,0,1,6144,14,2060153555
3374,3238598904,61604,3238660508,1,0,0,8192,1,6470167256
3375,3238622275,11274,3238633549,13,0,1,18432,13,3602951248
3376,3238713991,124026,3238838017,3,0,0,86016,3,5599310372
3377,3238720445,45596,3238766041,6,0,0,1024,6,6524516596
3378,3238765789,7950,3238773739,7,0,1,8192,7,5643242833
3379,3238802262,69284,3238871546,10,0,0,8192,10,7785001476
3380,3238826931,16880,3238843811,17,0,1,6144,17,2297862856
3381,3238867148,4413,3238871561,0,0,1,2560,0,1556586683
3382,3238882963,43904,3238926867,6,0,0,512,6,8902020595
3383,3238916471,122213,3239038684,15,0,0,1024,15,2554306977
3384,3238959082,26738,3238985820,8,0,1,48640,8,3449509387
3385,3238965958,23728,3238989686,3,0,1,6144,3,3958755229
3386,3239011097,70102,3239081199,17,0,0,10752,17,6261842704
3387,3239052948,158885,3239211833,16,0,0,1536,16,4016690755
3388,3239067740,143610,3239211350,8,0,0,61952,8,785672985
3389,3239081132,1101,3239082233,1,0,1,1024,1,1487943900
3390,3239131661,131797,3239263458,14,0,0,5632,14,9829641559
3391,3239145492,3128,3239148620,18,0,1,9216,18,6098576310
3392,3239203147,69781,3239272928,8,0,0,3584,8,7950367939
3393,3239208729,81021,3239289750,13,0,0,11264,13,6768117288
3394,3239212684,5326,3239218010,0,0,1,5632,0,4684386225
3395,3239254208,1518,3239255726,10,0,1,1536,10,7591927232
3396,3239294569,57440,3239352009,14,0,0,4608,14,2492367377
3397,3239309974,5326,3239315300,10,0,1,5632,10,6098791856
3398,3239330470,60676,3239391146,15,0,0,512,15,9457954729
3399,3239342624,63920,3239406544,12,0,0,10752,12,653179927
3400,3239373965,114452,3239488417,1,0,0,75776,1,5404423722
3401,3239375788,178950,3239554738,1,0,0,4096,1,4861815373
3402,3239398492,15837,3239414329,8,0,1,30720,8,8733764941
3403,3239404031,95774,3239499805,5,0,0,16896,5,10601743582
3404,3239427765,1518,3239429283,17,0,1,1536,17,5168879607
3405,3239447165,10241,3239457406,8,0,1,16384,8,4566035277
3406,3239472684,21479,3239494163,14,0,1,14336,14,10547356490
3407,3239479360,20460,3239499820,17,0,1,2048,17,6539522865
3408,3239485225,159411,3239644636,10,0,0,71168,10,8820875247
3409,3239516827,2470,3239519297,16,0,1,2560,16,6551244961
3410,3239547933,109842,3239657775,5,0,0,9728,5,4099208318
3411,3239548728,1518,3239550246,14,0,1,1536,14,5298219292
3412,3239554614,4966,3239559580,7,0,1,5120,7,7064781601
3413,3239596965,2470,3239599435,1,0,1,2560,1,6158810354
3414,3239639259,12599,3239651858,0,0,1,7680,0,1138857200
3415,3239652214,46445,3239698659,6,0,0,512,6,2049378446
3416,3239670760,118352,3239789112,19,0,0,88576,19,8615908437
3417,3239690285,157933,3239848218,5,0,0,74752,5,7771441895
3418,3239695421,566,3239695987,16,0,1,512,16,5015563654
3419,3239697928,154837,3239852765,4,0,0,14848,4,907576087
3420,3239706109,192509,3239898618,11,0,0,78848,11,8583050068
3421,3239739077,182108,3239921185,3,0,0,24576,3,4227596526
3422,3239781120,128664,3239909784,10,0,0,28672,10,5478207615
3423,3239790018,566,3239790584,16,0,1,512,16,312806123
3424,3239794260,1994,3239796254,18,0,1,2048,18,5267678823
3425,3239797924,3387,3239801311,15,0,1,9728,15,4905268940
3426,3239829408,30070,3239859478,6,0,1,7168,6,10655650168
3427,3239916633,7490,3239924123,19,0,1,3072,19,9519819974
3428,3239930786,566,3239931352,18,0,1,512,18,3634042051
3429,3239958046,57596,3240015642,10,0,0,5120,10,10538211994
3430,3239964482,1042,3239965524,1,0,1,1024,1,10166003718
3431,3239973767,125372,3240099139,10,0,0,111616,10,7734871255
3432,3239998458,3387,3240001845,6,0,1,9728,6,4677375377
3433,3240007403,163431,3240170834,14,0,0,52224,14,3102341708
3434,3240054756,124205,3240178961,17,0,0,26624,17,7810830281
3435,3240104101,4679,3240108780,3,0,1,12288,3,1990897447
3436,3240114342,120895,3240235237,5,0,0,25600,5,9467345403
3437,3240226252,9000,3240235252,17,0,1,1536,17,5475236254
3438,3240232056,250167,3240482223,19,0,0,93696,19,7352073231
3439,3240243697,186848,3240430545,10,0,0,152064,10,7915666261
3440,3240260221,287626,3240547847,9,0,0,1024,9,3179513453
3441,3240266512,3645,3240270157,1,0,1,10240,1,10380551505
3442,3240269029,161843,3240430872,6,0,0,1024,6,2920352088
3443,3240286416,252291,3240538707,0,0,0,117760,0,803481350
3444,3240311105,12825,3240323930,14,0,1,21504,14,7678417033
3445,3240324470,7230,3240331700,0,0,1,7680,0,3123646220
3446,3240343383,205844,3240549227,9,0,0,512,9,3109252215
3447,3240358472,5971,3240364443,2,0,1,14848,2,8631577605
3448,3240486453,117260,3240603713,11,0,0,84992,11,2277599151
3449,3240491736,3128,3240494864,1,0,1,9216,1,3434685284
3450,3240536017,272590,3240808607,10,0,0,224768,10,3226125779
3451,3240591123,282344,3240873467,12,0,0,87552,12,3168505296
3452,3240596770,212188,3240808958,16,0,0,1024,16,6782315530
3453,3240638732,288592,3240927324,11,0,0,40960,11,4265105335
3454,3240661910,67959,3240729869,15,0,0,512,15,1557938607
3455,3240682963,1518,3240684481,18,0,1,1536,18,2492654278
3456,3240718360,103069,3240821429,18,0,0,3584,18,5104223287
3457,3240747861,125964,3240873825,6,0,0,512,6,2998903552
3458,3240749880,61557,3240811437,0,0,1,2560,0,8535517139
3459,3240760154,52589,3240812743,15,0,1,2048,15,6664753200
3460,3240769275,126902,3240896177,17,0,0,9728,17,1089040292
3461,3240781869,91777,3240873646,18,0,0,512,18,8602800253
3462,3240851340,28722,3240880062,1,0,1,6656,1,3639038019
3463,3240858117,22099,3240880216,8,0,1,8704,8,5642140669
3464,3240905538,95600,3241001138,7,0,0,18944,7,7094856862
3465,3240905586,2470,3240908056,11,0,1,2560,11,3974205004
3466,3240924744,135056,3241059800,8,0,0,8704,8,3958114746
3467,3240936968,6278,3240943246,0,0,1,6656,0,1437906411
3468,3240939557,4675,3240944232,14,0,1,1536,14,2103130347
3469,3240943552,1994,3240945546,7,0,1,2048,7,2642342300
3470,3240968108,108762,3241076870,0,0,0,38400,0,3215086505
3471,3240985980,194430,3241180410,14,0,0,37376,14,4029471725
3472,3241021625,65652,3241087277,15,0,0,512,15,9576868181
3473,3241051693,1994,3241053687,19,0,1,2048,19,1127440716
3474,3241062095,1042,3241063137,2,0,1,1024,2,925752605
3475,3241130195,226068,3241356263,1,0,0,19968,1,9295705777
3476,3241166532,48030,3241214562,9,0,0,1024,9,5603853224
3477,3241200306,30749,3241231055,8,0,1,49664,8,7826682513
3478,3241238601,47288,3241285889,0,0,0,1536,0,6028280974
3479,3241254117,1042,3241255159,3,0,1,1024,3,7735206185
3480,3241320386,2946,3241323332,17,0,1,3072,17,5071683512
3481,3241336727,55748,3241392475,17,0,0,4096,17,829221201
3482,3241350004,6274,3241356278,7,0,1,2560,7,8999125527
3483,3241394352,3387,3241397739,7,0,1,9728,7,9721938372
3484,3241401920,6278,3241408198,7,0,1,6656,7,9574008477
3485,3241408510,43904,3241452414,16,0,0,512,16,10113162695
3486,3241408569,43860,3241452429,8,0,1,71680,8,4627678745
3487,3241431338,257740,3241689078,14,0,0,58368,14,588960780
3488,3241441918,123360,3241565278,7,0,0,8192,7,2422375763
3489,3241447422,98228,3241545650,1,0,0,22528,1,3706859225
3490,3241448036,143058,3241591094,12,0,0,3072,12,3194845937
3491,3241450009,359611,3241809620,3,0,0,19456,3,854824979
3492,3241481984,566,3241482550,5,0,1,512,5,9700962750
3493,3241504609,1994,3241506603,0,0,1,2048,0,9014934916
3494,3241553359,250310,3241803669,11,0,0,152576,11,7292013421
3495,3241657468,4850,3241662318,7,0,1,5120,7,9646225027
3496,3241658258,210952,3241869210,10,0,0,67584,10,5409392599
3497,3241678256,215157,3241893413,8,0,0,79360,8,4594383232
3498,3241694146,566,3241694712,7,0,1,512,7,419977026
3499,3241718525,5802,3241724327,18,0,1,6144,18,9193481895
3500,3241767186,196298,3241963484,14,0,0,36352,14,10324860952
3501,3241779293,156775,3241936068,19,0,0,21504,19,9667885776
3502,3241852475,151363,3242003838,7,0,0,20992,7,3541191648
3503,3241865317,35335,3241900652,17,0,1,7680,17,9131300310
3504,3241871442,31476,3241902918,6,0,1,3584,6,7395903751
3505,3241910405,179253,3242089658,4,0,0,76288,4,1834175250
3506,3241919581,136255,3242055836,11,0,0,29696,11,9628516927
3507,3241921999,175207,3242097206,12,0,0,15360,12,1539200307
3508,3241963342,1176,3241964518,2,0,1,1024,2,166789532
3509,3241984362,107339,3242091701,4,0,0,6656,4,4071156687
3510,3242005804,2946,3242008750,5,0,1,3072,5,10007829852
3511,3242024182,169597,3242193779,6,0,0,512,6,2575060002
3512,3242037628,155980,3242193608,10,0,0,93696,10,6607110589
3513,3242047250,92352,3242139602,18,0,0,1024,18,8169169581
3514,3242047485,18867,3242066352,13,0,1,16896,13,2875419004
3515,3242126053,165514,3242291567,11,0,0,82432,11,2864996492
3516,3242145611,76056,3242221667,10,0,0,14336,10,7888075210
3517,3242146069,102128,3242248197,4,0,0,35328,4,142114091
3518,3242257737,103844,3242361581,1,0,0,40960,1,3086221255
3519,3242290281,7556,3242297837,13,0,1,6656,13,7513002563
3520,3242310587,113436,3242424023,5,0,0,17920,5,5630761693
3521,3242322446,3128,3242325574,15,0,1,9216,15,9435940361
3522,3242374852,3904,3242378756,16,0,1,10752,16,35613492
3523,3242388763,7706,3242396469,18,0,1,8192,18,4232316239
3524,3242406200,139256,3242545456,1,0,0,56832,1,1465715487
3525,3242418043,5995,3242424038,3,0,1,9216,3,1317610957
3526,3242452828,11791,3242464619,17,0,1,19456,17,3875557753
3527,3242456153,203579,3242659732,4,0,0,64000,4,1875408253
3528,3242467130,5802,3242472932,4,0,1,6144,4,2965604320
3529,3242532804,201615,3242734419,17,0,0,44032,17,3402882084
3530,3242591453,566,3242592019,6,0,1,512,6,9464937132
3531,3242635721,107948,3242743669,1,0,0,29184,1,1380233665
3532,3242640332,94414,3242734746,16,0,0,1024,16,2172322107
3533,3242645964,16255,3242662219,5,0,1,2560,5,6485421824
3534,3242663871,3422,3242667293,19,0,1,3584,19,3173511899
3535,3242702723,239268,3242941991,14,0,0,117248,14,1160108659
3536,3242723946,179938,3242903884,18,0,0,2048,18,9412576928
3537,3242727083,39923,3242767006,8,0,1,41984,8,8847859104
3538,3242735390,206780,3242942170,18,0,0,512,18,9659456883
3539,3242762515,5477,3242767992,0,0,1,1536,0,6973686498
3540,3242765280,7218,3242772498,14,0,1,7168,14,7150796136
3541,3242784774,68110,3242852884,15,0,0,1024,15,7903591654
3542,3242796471,102908,3242899379,15,0,0,37888,15,3753708041
3543,3242834127,5326,3242839453,16,0,1,5632,16,663598051
3544,3242907346,231062,3243138408,8,0,0,37888,8,1809475056
3545,3242915054,29578,3242944632,3,0,1,2560,3,8585245917
3546,3242962890,163943,3243126833,8,0,0,78848,8,4414934734
3547,3242968485,1994,3242970479,19,0,1,2048,19,6175253404
3548,3243008766,157678,3243166444,9,0,0,512,9,7205673181
3549,3243018087,4374,3243022461,15,0,1,4608,15,4539236075
3550,3243027840,3898,3243031738,11,0,1,4096,11,583228506
3551,3243050528,194811,3243245339,10,0,0,29696,10,4268106918
3552,3243067685,83756,3243151441,13,0,0,15360,13,9233690198
3553,3243068200,4374,3243072574,19,0,1,4608,19,7070378810
3554,3243068559,143692,3243212251,5,0,0,37376,5,1732901421
3555,3243070609,165667,3243236276,19,0,0,34816,19,3568643503
3556,3243100263,1994,3243102257,1,0,1,2048,1,3385859096
3557,3243103613,197608,3243301221,11,0,0,36352,11,4904810640
3558,3243116816,22593,3243139409,7,0,1,1024,7,8434321799
3559,3243164443,5712,3243170155,1,0,1,14336,1,2588182509
3560,3243168862,2279,3243171141,11,0,1,1536,11,7765312355
3561,3243236105,65599,3243301704,6,0,0,1536,6,2175922981
3562,3243312198,1518,3243313716,5,0,1,1536,5,2390884332
3563,3243316462,1994,3243318456,18,0,1,2048,18,5672422066
3564,3243349432,192335,3243541767,19,0,0,18944,19,8267919168
3565,3243355265,566,3243355831,15,0,1,512,15,4204298371
3566,3243388651,64676,3243453327,14,0,0,8192,14,584677811
3567,3243397216,94400,3243491616,7,0,0,25088,7,2603489611
3568,3243397633,3898,3243401531,0,0,1,4096,0,6067355931
3569,3243426860,169579,3243596439,7,0,0,34816,7,5330562788
3570,3243451463,9086,3243460549,5,0,1,7680,5,7768966626
3571,3243462934,1518,3243464452,15,0,1,1536,15,2285061430
3572,3243473578,5326,3243478904,19,0,1,5632,19,5489371231
3573,3243493499,14029,3243507528,8,0,1,27136,8,5399751855
3574,3243534825,43904,3243578729,16,0,0,512,16,3561893500
3575,3243535876,77238,3243613114,16,0,0,1536,16,5133005788
3576,3243536928,144104,3243681032,13,0,0,13312,13,4398138858
3577,3243649560,3422,3243652982,11,0,1,3584,11,2120937261
3578,3243676289,4758,3243681047,6,0,1,1024,6,7821547563
3579,3243691255,256988,3243948243,19,0,0,64000,19,3560658590
3580,3243697313,106702,3243804015,1,0,0,46592,1,2048839839
3581,3243721394,160195,3243881589,19,0,0,73216,19,3166833785
3582,3243733312,2470,3243735782,16,0,1,2560,16,4287570
3583,3243807922,6754,3243814676,7,0,1,7168,7,8007231345
3584,3243810651,148091,3243958742,4,0,0,34304,4,1772574231
3585,3243837197,260056,3244097253,12,0,0,158720,12,1870021536
3586,3243887238,210194,3244097432,6,0,0,512,6,6963364301
3587,3243929237,34660,3243963897,17,0,1,13312,17,9642896716
3588,3243931170,39293,3243970463,2,0,1,8192,2,9474906361
3589,3243933168,38921,3243972089,6,0,1,2560,6,2236579878
3590,3243942678,214617,3244157295,14,0,0,34816,14,9531776682
3591,3244010794,2470,3244013264,6,0,1,2560,6,6638499346
3592,3244012664,103447,3244116111,10,0,0,30720,10,3864269123
3593,3244042520,3904,3244046424,2,0,1,10752,2,7008457365
3594,3244067072,32789,3244099861,6,0,1,2560,6,2067587709
3595,3244176095,566,3244176661,10,0,1,512,10,5425079019
3596,3244177256,79343,3244256599,18,0,0,512,18,2654724725
3597,3244253180,3434,3244256614,10,0,1,3584,10,4650017075
3598,3244268402,113724,3244382126,3,0,0,71680,3,10306969709
3599,3244289232,204497,3244493729,8,0,0,121344,8,4589228314
3600,3244303192,3645,3244306837,17,0,1,10240,17,7114247838
3601,3244354300,3904,3244358204,18,0,1,10752,18,5857160345
3602,3244359859,22282,3244382141,11,0,1,2048,11,10590606040
3603,3244383030,1518,3244384548,16,0,1,1536,16,3085455918
3604,3244414190,84546,3244498736,8,0,0,16384,8,4938562255
3605,3244445685,7230,3244452915,2,0,1,7680,2,5103373527
3606,3244489123,126603,3244615726,7,0,0,3584,7,8544977000
3607,3244495633,7799,3244503432,7,0,1,12288,7,9342937737
3608,3244567606,5454,3244573060,17,0,1,13824,17,5785227182
3609,3244584236,56431,3244640667,15,0,0,512,15,3387254188
3610,3244624008,1518,3244625526,10,0,1,1536,10,3758474053
3611,3244633049,148665,3244781714,16,0,0,1536,16,7607218399
3612,3244643895,566,3244644461,0,0,1,512,0,6344125323
3613,3244653870,104624,3244758494,5,0,0,43520,5,7859951300
3614,3244683195,2470,3244685665,0,0,1,2560,0,7694552871
3615,3244748285,15527,3244763812,15,0,1,5632,15,8343991741
3616,3244760165,60781,3244820946,1,0,0,5632,1,3194946585
3617,3244772402,7230,3244779632,3,0,1,7680,3,6726016120
3618,3244826823,43904,3244870727,8,0,0,512,8,10528410666
3619,3244850839,84824,3244935663,12,0,0,13824,12,10636940441
3620,3244884370,5326,3244889696,2,0,1,5632,2,8143828757
3621,3244929712,107276,3245036988,13,0,0,52224,13,6273488931
3622,3244965248,3422,3244968670,18,0,1,3584,18,5498788618
3623,3244971033,1518,3244972551,4,0,1,1536,4,5351367690
3624,3244984170,85292,3245069462,8,0,0,15360,8,7975335908
3625,3244986415,275851,3245262266,18,0,0,512,18,8699692280
3626,3244995038,77411,3245072449,10,0,0,9728,10,6594712614
3627,3245007325,254770,3245262095,13,0,0,213504,13,6791445398
3628,3245052823,5326,3245058149,1,0,1,5632,1,597463299
3629,3245066095,196506,3245262601,16,0,0,1024,16,3847830823
3630,3245112415,192528,3245304943,10,0,0,17920,10,6219944192
3631,3245165236,2946,3245168182,14,0,1,3072,14,9591792036
3632,3245187215,250752,3245437967,15,0,0,116224,15,7894691830
3633,3245216302,53989,3245270291,10,0,1,8192,10,104872933
3634,3245261868,19309,3245281177,8,0,1,31232,8,196654366
3635,3245265950,15573,3245281523,17,0,1,512,17,1896203219
3636,3245294436,3898,3245298334,0,0,1,4096,0,6997665722
3637,3245328924,1518,3245330442,11,0,1,1536,11,9628307960
3638,3245333280,148661,3245481941,11,0,0,52736,11,7738700721
3639,3245336234,4374,3245340608,5,0,1,4608,5,9654257905
3640,3245356902,1994,3245358896,0,0,1,2048,0,3232391128
3641,3245366995,79651,3245446646,18,0,0,512,18,9271879368
3642,3245371368,66614,3245437982,8,0,1,55808,8,4703069816
3643,3245384697,73474,3245458171,18,0,0,3072,18,1858971477
3644,3245523630,104014,3245627644,12,0,0,18944,12,2091663855
3645,3245528019,197131,3245725150,3,0,0,70656,3,1372134666
3646,3245551879,177662,3245729541,11,0,0,14336,11,5881946350
3647,3245561977,566,3245562543,18,0,1,512,18,1162140741
3648,3245562359,89969,3245652328,12,0,0,9216,12,2395437311
3649,3245575071,3128,3245578199,19,0,1,9216,19,530444246
3650,3245590067,156592,3245746659,16,0,0,1024,16,6314823781
3651,3245590488,249828,3245840316,16,0,0,57856,16,667229472
3652,3245631601,230214,3245861815,10,0,0,60928,10,2415937830
3653,3245635639,112400,3245748039,18,0,0,512,18,7719168887
3654,3245663381,159292,3245822673,12,0,0,22528,12,7525114873
3655,3245710244,26962,3245737206,11,0,1,8192,11,4849745400
3656,3245753938,119274,3245873212,19,0,0,13824,19,5822568391
3657,3245791677,3128,3245794805,7,0,1,9216,7,7469474303
3658,3245842791,19039,3245861830,11,0,1,2048,11,3845099435
3659,3245853975,123235,3245977210,12,0,0,78848,12,22242740
3660,3245881223,112445,3245993668,13,0,0,10752,13,2875424501
3661,3245941067,86291,3246027358,1,0,0,14336,1,3151105205
3662,3245961334,230046,3246191380,5,0,0,198656,5,2181009160
3663,3245975161,275859,3246251020,16,0,0,94720,16,3928491445
3664,3246007824,98920,3246106744,18,0,0,1536,18,4120278924
3665,3246021850,5523,3246027373,19,0,1,3584,19,5654782227
3666,3246033518,158673,3246192191,18,0,0,2560,18,5115139759
3667,3246049411,261753,3246311164,15,0,0,32768,15,6121090374
3668,3246051103,2870,3246053973,13,0,1,8704,13,6584942356
3669,3246055089,10757,3246065846,15,0,1,17408,15,8486961071
3670,3246091005,6754,3246097759,19,0,1,7168,19,8267108257
3671,3246100291,3422,3246103713,4,0,1,3584,4,2381658663
3672,3246133281,62792,3246196073,0,0,1,4096,0,386034510
3673,3246141599,55140,3246196739,14,0,1,1024,14,9234775343
3674,3246185246,15359,3246200605,3,0,1,6144,3,9363734785
3675,3246213192,566,3246213758,11,0,1,512,11,863242709
3676,3246221226,29809,3246251035,1,0,1,1536,1,2719770262
3677,3246268635,6278,3246274913,2,0,1,6656,2,5160238511
3678,3246294486,43904,3246338390,6,0,0,512,6,10085143872
3679,3246315351,46577,3246361928,6,0,0,1024,6,3260428025
3680,3246374990,1518,3246376508,0,0,1,1536,0,3441159252
3681,3246381765,109928,3246491693,11,0,0,60928,11,6698591502
3682,3246391192,146359,3246537551,17,0,0,38912,17,10405962278
3683,3246391599,566,3246392165,7,0,1,512,7,6171945401
3684,3246406768,322654,3246729422,13,0,0,20480,13,879890622
3685,3246433348,85472,3246518820,15,0,0,20992,15,1316891848
3686,3246457547,93348,3246550895,9,0,0,2048,9,9025202516
3687,3246468233,72805,3246541038,18,0,0,2048,18,2506161681
3688,3246475750,154600,3246630350,7,0,0,35328,7,9045311884
3689,3246483207,41595,3246524802,7,0,1,54272,7,5688901857
3690,3246488694,48872,3246537566,4,0,1,25088,4,1605344955
3691,3246508000,151024,3246659024,11,0,0,17408,11,2334338470
3692,3246557023,2946,3246559969,10,0,1,3072,10,6074934169
3693,3246607504,6754,3246614258,4,0,1,7168,4,3256140053
3694,3246608202,23968,3246632170,8,0,1,36864,8,815606265
3695,3246633856,566,3246634422,4,0,1,512,4,5485156739
3696,3246656151,6287,3246662438,14,0,1,3584,14,2755963548
3697,3246709328,7706,3246717034,11,0,1,8192,11,4591028690
3698,3246795019,67592,3246862611,7,0,0,7680,7,8300884967
3699,3246800778,84536,3246885314,12,0,0,17920,12,6195345445
3700,3246840621,5196,3246845817,0,0,1,13312,0,1579169519
3701,3246845730,3422,3246849152,16,0,1,3584,16,8655955775
3702,3246876798,268880,3247145678,3,0,0,159232,3,8078724958
3703,3246880190,126179,3247006369,19,0,0,97280,19,5553906197
3704,3246901922,1042,3246902964,16,0,1,1024,16,6758240675
3705,3246908063,4374,3246912437,15,0,1,4608,15,1844588885
3706,3247011149,2470,3247013619,6,0,1,2560,6,10645202035
3707,3247013763,10241,3247024004,6,0,1,16384,6,1462821126
3708,3247032639,11274,3247043913,16,0,1,18432,16,7038809797
3709,3247033387,324412,3247357799,7,0,0,145408,7,6059885479
3710,3247051876,3387,3247055263,19,0,1,9728,19,6245526236
3711,3247055198,141373,3247196571,14,0,0,45568,14,7929205962
3712,3247098336,49370,3247147706,2,0,1,2048,2,1598535340
3713,3247108251,382972,3247491223,16,0,0,72192,16,10105676636
3714,3247124816,261525,3247386341,19,0,0,1024,19,7594630353
3715,3247153951,12825,3247166776,16,0,1,21504,16,9023850863
3716,3247160905,255576,3247416481,15,0,0,59904,15,2856721260
3717,3247174400,5326,3247179726,11,0,1,5632,11,7339744122
3718,3247221555,3904,3247225459,5,0,1,10752,5,2736687949
3719,3247241522,6754,3247248276,11,0,1,7168,11,8443224606
3720,3247285522,5802,3247291324,4,0,1,6144,4,6572910412
3721,3247323835,177246,3247501081,1,0,0,30720,1,10153374200
3722,3247325619,112562,3247438181,4,0,0,2560,4,10655236882
3723,3247351177,140529,3247491706,18,0,0,1536,18,6643096262
3724,3247365001,2470,3247367471,17,0,1,2560,17,8930174049
3725,3247373357,182180,3247555537,0,0,0,55296,0,5703484369
3726,3247457604,5326,3247462930,3,0,1,5632,3,7143579443
3727,3247514812,104728,3247619540,7,0,0,26112,7,4848775963
3728,3247532843,185487,3247718330,14,0,0,122368,14,7957335959
3729,3247582771,141829,3247724600,3,0,0,9728,3,2882633739
3730,3247631355,90266,3247721621,11,0,0,10752,11,5420686674
3731,3247639315,1042,3247640357,16,0,1,1024,16,7951906165
3732,3247652662,72897,3247725559,15,0,0,3072,15,8116323700
3733,3247675548,127031,3247802579,7,0,0,48128,7,148630576
3734,3247713361,16531,3247729892,7,0,1,4608,7,6084402416
3735,3247731613,103534,3247835147,1,0,0,1536,1,503565144
3736,3247741793,566,3247742359,16,0,1,512,16,1552758680
3737,3247773725,6754,3247780479,3,0,1,7168,3,5800283401
3738,3247815221,82693,3247897914,4,0,0,3584,4,8697765960
3739,3247819323,122154,3247941477,14,0,0,29184,14,5396925585
3740,3247824960,6488,3247831448,14,0,1,15872,14,4932184395
3741,3247832005,52832,3247884837,19,0,0,4608,19,7811500215
3742,3247852216,10499,3247862715,14,0,1,16896,14,4318911933
3743,3247879369,101890,3247981259,12,0,0,12800,12,9637266691
3744,3247902717,566,3247903283,3,0,1,512,3,673905197
3745,3247974646,137995,3248112641,17,0,0,67584,17,233320669
3746,3247979136,195941,3248175077,5,0,0,116224,5,3862066712
3747,3248000859,236755,3248237614,12,0,0,29696,12,2659640888
3748,3248037491,6754,3248044245,11,0,1,7168,11,2807157994
3749,3248049050,2870,3248051920,14,0,1,8704,14,75498266
3750,3248106890,121653,3248228543,10,0,0,78848,10,3709256300
3751,3248114201,4162,3248118363,3,0,1,11264,3,8384989647
3752,3248152980,147790,3248300770,6,0,0,512,6,5778588465
3753,3248196882,566,3248197448,6,0,1,512,6,7060855692
3754,3248206590,136174,3248342764,7,0,0,6144,7,9938590596
3755,3248343147,5196,3248348343,11,0,1,13312,11,9755823080
3756,3248361058,1994,3248363052,4,0,1,2048,4,8877598174
3757,3248374114,3422,3248377536,17,0,1,3584,17,4928815057
3758,3248389443,89768,3248479211,17,0,0,19968,17,4918159186
3759,3248393202,2946,3248396148,19,0,1,3072,19,143394306
3760,3248431216,1042,3248432258,10,0,1,1024,10,8151268458
3761,3248433441,1518,3248434959,17,0,1,1536,17,1274792163
3762,3248496223,95780,3248592003,15,0,0,24576,15,7758463403
3763,3248531773,168669,3248700442,7,0,0,51712,7,9069103180
3764,3248559188,57440,3248616628,10,0,0,4608,10,3678052705
3765,3248589828,111573,3248701401,10,0,0,3072,10,5066853276
3766,3248593163,85888,3248679051,17,0,0,512,17,4593878012
3767,3248605474,113610,3248719084,12,0,0,9728,12,5034348969
3768,3248618301,3128,3248621429,15,0,1,9216,15,3780949929
3769,3248648672,7230,3248655902,1,0,1,7680,1,9092899130
3770,3248685229,101877,3248787106,8,0,0,14848,8,9790645378
3771,3248706600,98696,3248805296,13,0,0,24064,13,5372166353
3772,3248778359,8762,3248787121,0,0,1,4608,0,4017292003
3773,3248787104,83165,3248870269,9,0,0,18432,9,1989006515
3774,3248830902,1042,3248831944,7,0,1,1024,7,35096382
3775,3248836944,3387,3248840331,7,0,1,9728,7,3317669154
3776,3248861535,79904,3248941439,3,0,0,12800,3,355604829
3777,3248868345,50026,3248918371,18,0,0,1536,18,8275281494
3778,3248897541,98384,3248995925,10,0,0,23040,10,3116313202
3779,3248946870,88988,3249035858,19,0,0,17408,19,5911072471
3780,3248965321,2470,3248967791,13,0,1,2560,13,10077706576
3781,3248995528,112738,3249108266,1,0,0,15872,1,505413068
3782,3249044780,3898,3249048678,17,0,1,4096,17,7554176360
3783,3249076056,156965,3249233021,14,0,0,70144,14,4463765468
3784,3249112736,147785,3249260521,5,0,0,57856,5,9643591081
3785,3249162259,98449,3249260708,6,0,0,512,6,1463769866
3786,3249171514,3904,3249175418,13,0,1,10752,13,8555104444
3787,3249171906,6320,3249178226,19,0,1,9728,19,8882189079
3788,3249227589,91628,3249319217,17,0,0,13312,17,9749014241
3789,3249232424,105585,3249338009,9,0,0,32768,9,5228950121
3790,3249245511,217427,3249462938,0,0,0,53248,0,1548951260
3791,3249260081,1152,3249261233,15,0,1,512,15,4360552970
3792,3249260694,3032,3249263726,4,0,1,8704,4,5634342802
3793,3249261201,185498,3249446699,13,0,0,63488,13,3151618350
3794,3249268685,101802,3249370487,14,0,0,7168,14,4005890483
3795,3249271835,130924,3249402759,11,0,0,24064,11,5487318696
3796,3249283307,3898,3249287205,0,0,1,4096,0,10579490064
3797,3249330061,14169,3249344230,7,0,1,15360,7,3172785267
3798,3249340118,6698,3249346816,1,0,1,4096,1,8414241341
3799,3249351384,116249,3249467633,9,0,0,15360,9,6862176870
3800,3249383789,124201,3249507990,16,0,0,27648,16,5007956099
3801,3249405475,3898,3249409373,10,0,1,4096,10,6514440744
3802,3249521433,5971,3249527404,11,0,1,14848,11,5851471243
3803,3249535536,3128,3249538664,10,0,1,9216,10,908777310
3804,3249642434,11274,3249653708,4,0,1,18432,4,10042103950
3805,3249671832,101660,3249773492,9,0,0,33792,9,10315060339
3806,3249678686,45596,3249724282,16,0,0,1024,16,3124765490
3807,3249697145,127599,3249824744,1,0,0,8192,1,855468576
3808,3249725300,75912,3249801212,3,0,0,1536,3,8803729886
3809,3249756458,2946,3249759404,15,0,1,3072,15,9160364778
3810,3249760873,1994,3249762867,7,0,1,2048,7,7724811344
3811,3249783918,3128,3249787046,6,0,1,9216,6,519309180
3812,3249851694,1042,3249852736,16,0,1,1024,16,791543322
3813,3249946738,2946,3249949684,14,0,1,3072,14,2709184516
3814,3249963060,1042,3249964102,5,0,1,1024,5,7154435951
3815,3249987953,6229,3249994182,17,0,1,15360,17,7220151609
3816,3250011366,165626,3250176992,12,0,0,99840,12,3996133177
3817,3250023781,2946,3250026727,19,0,1,3072,19,333234001
3818,3250024104,222326,3250246430,3,0,0,94720,3,4699420409
3819,3250083249,126401,3250209650,16,0,0,14336,16,585261288
3820,3250113573,4850,3250118423,18,0,1,5120,18,8664493752
3821,3250132613,3422,3250136035,7,0,1,3584,7,2242265065
3822,3250199931,127584,3250327515,0,0,0,65024,0,3430022620
3823,3250225859,25413,3250251272,15,0,1,5120,15,7936401776
3824,3250296585,108836,3250405421,4,0,0,57344,4,4503609873
3825,3250305611,122946,3250428557,8,0,0,12288,8,10565239616
3826,3250311453,224884,3250536337,12,0,0,24064,12,4364200395
3827,3250328476,2870,3250331346,19,0,1,8704,19,7772869311
3828,3250345988,59768,3250405756,10,0,0,1024,10,1592034738
3829,3250347769,4420,3250352189,3,0,1,11776,3,2710399166
3830,3250363548,6754,3250370302,6,0,1,7168,6,620289996
3831,3250380334,1042,3250381376,13,0,1,1024,13,8222315627
3832,3250389325,131800,3250521125,9,0,0,51712,9,7115628008
3833,3250415676,3422,3250419098,1,0,1,3584,1,6130136150
3834,3250424756,183904,3250608660,14,0,0,92672,14,6870279311
3835,3250436607,3898,3250440505,17,0,1,4096,17,545306374
3836,3250521572,21399,3250542971,8,0,1,34816,8,10361680948
3837,3250532366,150992,3250683358,14,0,0,43008,14,1129680685
3838,3250564763,13512,3250578275,2,0,1,26112,2,6511214344
3839,3250568389,141236,3250709625,3,0,0,7168,3,5739919693
3840,3250576655,2926,3250579581,6,0,1,2048,6,10247066034
3841,3250587804,25052,3250612856,14,0,1,11264,14,282007734
3842,3250589666,245719,3250835385,16,0,0,97280,16,3300817703
3843,3250590755,265409,3250856164,16,0,0,68096,16,502456364
3844,3250654478,269526,3250924004,12,0,0,60416,12,9471545201
3845,3250708986,3577,3250712563,13,0,1,3072,13,8864805532
3846,3250753014,11016,3250764030,7,0,1,17920,7,596398099
3847,3250811877,75864,3250887741,5,0,0,3072,5,9232104782
3848,3250818502,41519,3250860021,17,0,1,4096,17,9370664219
3849,3250847663,116872,3250964535,12,0,0,27136,12,6800746795
3850,3250928760,1518,3250930278,3,0,1,1536,3,6261739777
3851,3250951143,1042,3250952185,7,0,1,1024,7,17507353
3852,3250953208,11342,3250964550,10,0,1,7680,10,8020848056
3853,3250964952,144837,3251109789,10,0,0,17408,10,885771030
3854,3250977578,6278,3250983856,5,0,1,6656,5,8180161499
3855,3250978220,5790,3250984010,0,0,1,8704,0,7883627533
3856,3250990881,1518,3250992399,6,0,1,1536,6,9571788946
3857,3250992892,3387,3250996279,8,0,1,9728,8,7277126944
3858,3251010010,32041,3251042051,8,0,1,52224,8,466378933
3859,3251016714,229831,3251246545,1,0,0,134144,1,4775185811
3860,3251036722,147113,3251183835,1,0,0,12288,1,6008964105
3861,3251050783,3422,3251054205,14,0,1,3584,14,5831344605
3862,3251091286,178310,3251269596,7,0,0,66048,7,5887191103
3863,3251190152,59132,3251249284,14,0,0,5120,14,2532029539
3864,3251223497,123764,3251347261,16,0,0,30720,16,6199215372
3865,3251226171,43440,3251269611,4,0,1,5120,4,1982163587
3866,3251258826,11861,3251270687,6,0,1,1024,6,8573796557
3867,3251259674,44820,3251304494,8,0,1,60416,8,8839345318
3868,3251262863,194755,3251457618,9,0,0,8704,9,9712932489
3869,3251271553,33607,3251305160,14,0,1,1024,14,8347947807
3870,3251315557,75608,3251391165,13,0,0,13824,13,6255027253
3871,3251317207,89012,3251406219,10,0,0,22528,10,10641936585
3872,3251324260,130691,3251454951,11,0,0,15360,11,8373552697
3873,3251349093,128191,3251477284,3,0,0,10752,3,4214716584
3874,3251354099,250851,3251604950,5,0,0,74752,5,924402611
3875,3251419589,6754,3251426343,16,0,1,7168,16,3036280860
3876,3251424722,4850,3251429572,2,0,1,5120,2,4348996200
3877,3251431475,175058,3251606533,9,0,0,5120,9,935653605
3878,3251461910,257828,3251719738,3,0,0,39936,3,9038147822
3879,3251466063,330589,3251796652,1,0,0,24064,1,643902681
3880,3251472764,4535,3251477299,7,0,1,3584,7,1727870905
3881,3251527177,54495,3251581672,6,0,0,1024,6,10596970699
3882,3251570655,2470,3251573125,15,0,1,2560,15,4514632969
3883,3251573956,3645,3251577601,7,0,1,10240,7,10486198018
3884,3251591707,290475,3251882182,13,0,0,76800,13,7268544735
3885,3251644095,205613,3251849708,11,0,0,98816,11,7673703028
3886,3251674928,1042,3251675970,6,0,1,1024,6,398388413
3887,3251696120,206528,3251902648,0,0,0,16384,0,9961330146
3888,3251697140,118701,3251815841,11,0,0,35840,11,1438856319
3889,3251728469,169172,3251897641,8,0,0,50688,8,3106391919
3890,3251776039,76336,3251852375,1,0,0,8704,1,2968815687
3891,3251852160,1725,3251853885,4,0,1,1536,4,608017594
3892,3251927060,45596,3251972656,18,0,0,1024,18,1360106749
3893,3251937058,101348,3252038406,3,0,0,32768,3,4720929870
3894,3251963623,124205,3252087828,19,0,0,17408,19,5129114825
3895,3251992653,10757,3252003410,8,0,1,17408,8,5343571580
3896,3252076972,10871,3252087843,3,0,1,7168,3,1832271845
3897,3252079044,8814,3252087858,3,0,1,512,3,983716700
3898,3252118556,101660,3252220216,19,0,0,33792,19,4346510737
3899,3252124642,4374,3252129016,3,0,1,4608,3,2880338466
3900,3252153416,566,3252153982,6,0,1,512,6,4862764323
3901,3252182116,1518,3252183634,13,0,1,1536,13,8070316357
3902,3252195972,45596,3252241568,0,0,0,1024,0,9235685081
3903,3252197899,3898,3252201797,11,0,1,4096,11,6122089157
3904,3252260597,566,3252261163,6,0,1,512,6,1114853236
3905,3252268368,178261,3252446629,8,0,0,68096,8,2149259798
3906,3252305333,79016,3252384349,12,0,0,19968,12,9223406344
3907,3252308880,1042,3252309922,10,0,1,1024,10,7134178240
3908,3252319425,566,3252319991,2,0,1,512,2,6349880801
3909,3252334318,7230,3252341548,15,0,1,7680,15,9489533156
3910,3252369934,80298,3252450232,9,0,0,11776,9,5860994670
3911,3252397155,5802,3252402957,16,0,1,6144,16,10415537239
3912,3252493495,124880,3252618375,3,0,0,53760,3,4979415303
3913,3252511284,90696,3252601980,18,0,0,1536,18,10427649352
3914,3252516438,125550,3252641988,13,0,0,16896,13,2968316488
3915,3252543818,2470,3252546288,18,0,1,2560,18,675285588
3916,3252547516,149678,3252697194,11,0,0,15360,11,776311132
3917,3252579215,165638,3252744853,10,0,0,13312,10,5226750775
3918,3252581907,110584,3252692491,5,0,0,24064,5,7014755867
3919,3252597904,70976,3252668880,19,0,0,8704,19,2740119240
3920,3252645155,119557,3252764712,14,0,0,23552,14,8690044657
3921,3252654958,4374,3252659332,15,0,1,4608,15,2151380874
3922,3252687864,14615,3252702479,16,0,1,5632,16,540145577
3923,3252702773,1042,3252703815,14,0,1,1024,14,2131799471
3924,3252733088,4850,3252737938,17,0,1,5120,17,5744029368
3925,3252762965,171961,3252934926,19,0,0,136704,19,10458403721
3926,3252783593,182822,3252966415,15,0,0,72192,15,7960145291
3927,3252817664,243868,3253061532,0,0,0,24576,0,1197080753
3928,3252877344,1042,3252878386,2,0,1,1024,2,1091751865
3929,3252884011,51110,3252935121,8,0,0,512,8,6952589624
3930,3252898042,142478,3253040520,15,0,0,31232,15,6998401151
3931,3252910665,107098,3253017763,0,0,0,12288,0,5832539232
3932,3252926277,11774,3252938051,10,0,1,3072,10,4773597407
3933,3252931399,8804,3252940203,16,0,1,11264,16,9200263566
3934,3252996286,70064,3253066350,0,0,0,10752,0,9277306636
3935,3253027326,3422,3253030748,7,0,1,3584,7,7812000486
3936,3253115410,3422,3253118832,14,0,1,3584,14,8076312919
3937,3253143429,1042,3253144471,7,0,1,1024,7,10291390048
3938,3253173422,47288,3253220710,6,0,0,1536,6,9502308546
3939,3253173636,11791,3253185427,14,0,1,19456,14,1187734281
3940,3253202142,101036,3253303178,10,0,0,31744,10,1248751058
3941,3253206397,171643,3253378040,7,0,0,4096,7,7675065589
3942,3253241839,2470,3253244309,3,0,1,2560,3,9783788777
3943,3253254874,164122,3253418996,16,0,0,57856,16,5204741245
3944,3253269688,303255,3253572943,10,0,0,70144,10,10621815972
3945,3253272363,208440,3253480803,12,0,0,117248,12,6254568328
3946,3253303580,214390,3253517970,10,0,0,121856,10,4229398938
3947,3253377853,2649,3253380502,4,0,1,2560,4,7771429477
3948,3253386352,2470,3253388822,5,0,1,2560,5,6286350684
3949,3253403102,23116,3253426218,14,0,1,7680,14,5240366068
3950,3253425159,3005,3253428164,19,0,1,3072,19,5715583407
3951,3253457305,125325,3253582630,10,0,0,31744,10,2644833567
3952,3253461141,57830,3253518971,5,0,1,1024,5,1500650493
3953,3253468446,61328,3253529774,14,0,1,18944,14,8539944199
3954,3253574140,108106,3253682246,14,0,0,15360,14,3419849825
3955,3253574378,64017,3253638395,14,0,0,4096,14,5432939782
3956,3253585311,92240,3253677551,7,0,0,23040,7,7160473356
3957,3253590859,107158,3253698017,16,0,0,51712,16,4949286008
3958,3253609466,109485,3253718951,7,0,0,4096,7,10298329743
3959,3253655223,3387,3253658610,0,0,1,9728,0,8114472056
3960,3253670384,105403,3253775787,3,0,0,22528,3,5193663425
3961,3253722230,6754,3253728984,13,0,1,7168,13,9917861228
3962,3253724083,23500,3253747583,8,0,1,41472,8,3187953411
3963,3253727478,23011,3253750489,1,0,1,4608,1,5950707709
3964,3253743811,7856,3253751667,16,0,1,13824,16,6969795959
3965,3253759470,130058,3253889528,9,0,0,37888,9,1101831432
3966,3253789759,142038,3253931797,13,0,0,34816,13,6656510401
3967,3253800564,5196,3253805760,16,0,1,13312,16,7676771915
3968,3253805936,115238,3253921174,9,0,0,34816,9,10502194550
3969,3253820784,187252,3254008036,0,0,0,72192,0,3817669625
3970,3253825556,80886,3253906442,18,0,0,1536,18,3282063660
3971,3253829190,2870,3253832060,2,0,1,8704,2,3737374907
3972,3253832618,264849,3254097467,3,0,0,1024,3,3055482948
3973,3253832880,4850,3253837730,18,0,1,5120,18,8003048902
3974,3253834449,4907,3253839356,11,0,1,2560,11,160035767
3975,3253864636,2470,3253867106,19,0,1,2560,19,5745661583
3976,3253869120,116897,3253986017,19,0,0,6144,19,6732561327
3977,3253885349,4737,3253890086,1,0,1,512,1,8464213887
3978,3253896562,2470,3253899032,5,0,1,2560,5,6788961958
3979,3253916536,138502,3254055038,15,0,0,33280,15,3993845262
3980,3253936973,3898,3253940871,5,0,1,4096,5,3807517097
3981,3253959361,173212,3254132573,17,0,0,13824,17,3175324785
3982,3253961128,4850,3253965978,10,0,1,5120,10,3595117386
3983,3253979580,1994,3253981574,19,0,1,2048,19,10348828780
3984,3253984579,24934,3254009513,5,0,1,1536,5,1312025570
3985,3253996541,90062,3254086603,16,0,0,4096,16,10379065652
3986,3254000275,13572,3254013847,15,0,1,5632,15,7600862382
3987,3254011402,4711,3254016113,13,0,1,3584,13,10568535767
3988,3254011848,80230,3254092078,10,0,0,17920,10,1622290799
3989,3254033933,160296,3254194229,13,0,0,90624,13,4268296371
3990,3254046070,11430,3254057500,4,0,1,2560,4,4244538060
3991,3254087896,4740,3254092636,3,0,1,512,3,1476515909
3992,3254119526,2470,3254121996,16,0,1,2560,16,5269627133
3993,3254131045,3990,3254135035,15,0,1,2560,15,3367353577
3994,3254172862,22877,3254195739,17,0,1,1536,17,1005508187
3995,3254244290,51302,3254295592,14,0,0,2048,14,524632152
3996,3254251798,221875,3254473673,15,0,0,17408,15,1212162638
3997,3254289306,110514,3254399820,14,0,0,53760,14,166211683
3998,3254310905,2470,3254313375,10,0,1,2560,10,3232367050
3999,3254329265,217995,3254547260,10,0,0,29184,10,1074937757
4000,3254339612,190062,3254529674,0,0,0,53248,0,7389147710
4001,3254340119,4850,3254344969,14,0,1,5120,14,9580172090
4002,3254350729,134659,3254485388,12,0,0,38400,12,1162630122
4003,3254355070,113284,3254468354,1,0,0,13312,1,5994175613
4004,3254362913,128151,3254491064,6,0,0,1024,6,803948363
4005,3254388255,15977,3254404232,18,0,1,11776,18,3786085045
4006,3254481344,6906,3254488250,2,0,1,8704,2,1434800024
4007,3254487209,138871,3254626080,19,0,0,20480,19,9449371883
4008,3254490520,66421,3254556941,18,0,0,512,18,3384540216
4009,3254505217,114608,3254619825,16,0,0,64512,16,2758922092
4010,3254505744,2470,3254508214,15,0,1,2560,15,8907390009
4011,3254508983,2470,3254511453,7,0,1,2560,7,1474765442
4012,3254510727,74905,3254585632,1,0,0,5120,1,5674324568
4013,3254548642,7706,3254556348,10,0,1,8192,10,7543337702
4014,3254559120,120667,3254679787,13,0,0,2560,13,8807924607
4015,3254586467,148852,3254735319,10,0,0,34816,10,9404302762
4016,3254653473,2946,3254656419,17,0,1,3072,17,34962978
4017,3254687946,2946,3254690892,0,0,1,3072,0,8151639072
4018,3254702405,3128,3254705533,3,0,1,9216,3,7146505128
4019,3254727506,19596,3254747102,5,0,1,19456,5,1410286465
4020,3254777074,113360,3254890434,15,0,0,72192,15,5147087070
4021,3254814438,197082,3255011520,1,0,0,27648,1,9614773077
4022,3254853174,130380,3254983554,8,0,0,32768,8,2690887266
4023,3254888593,5737,3254894330,6,0,1,10752,6,729725269
4024,3254894417,231961,3255126378,12,0,0,45568,12,8853487658
4025,3254945565,259929,3255205494,9,0,0,131584,9,600163575
4026,3254947628,4850,3254952478,12,0,1,5120,12,9689000273
4027,3255017430,566,3255017996,5,0,1,512,5,7002998728
4028,3255041072,166153,3255207225,15,0,0,5632,15,367940946
4029,3255045207,83682,3255128889,4,0,0,8192,4,8022795253
4030,3255084649,44411,3255129060,6,0,0,512,6,2038926824
4031,3255157681,2870,3255160551,11,0,1,8704,11,2217981217
4032,3255208699,119527,3255328226,9,0,0,5120,9,5952446904
4033,3255211252,115391,3255326643,15,0,0,67072,15,10333783411
4034,3255251496,173449,3255424945,19,0,0,19968,19,10164368896
4035,3255253601,1042,3255254643,16,0,1,1024,16,307107473
4036,3255261090,153847,3255414937,5,0,0,47616,5,8974367761
4037,3255265813,5333,3255271146,1,0,1,5632,1,655485565
4038,3255271115,3898,3255275013,19,0,1,4096,19,4044608822
4039,3255293592,1042,3255294634,5,0,1,1024,5,15598257
4040,3255306736,197601,3255504337,18,0,0,1024,18,9254881808
4041,3255350839,188464,3255539303,10,0,0,60928,10,6045461971
4042,3255360966,153423,3255514389,9,0,0,24064,9,6960275915
4043,3255410580,257842,3255668422,0,0,0,52224,0,4736350845
4044,3255423854,228625,3255652479,10,0,0,82944,10,4942636244
4045,3255427693,255728,3255683421,19,0,0,49152,19,4817821817
4046,3255438098,114967,3255553065,6,0,0,2560,6,4481696112
4047,3255441649,278696,3255720345,16,0,0,64000,16,2278202000
4048,3255459411,230250,3255689661,9,0,0,12288,9,3172037834
4049,3255474821,12308,3255487129,1,0,1,20480,1,6797069424
4050,3255487761,1518,3255489279,7,0,1,1536,7,3947672543
4051,3255537033,3780,3255540813,10,0,1,1536,10,10174908843
4052,3255565076,2870,3255567946,12,0,1,8704,12,9109393326
4053,3255610331,73261,3255683592,1,0,0,512,1,209722951
4054,3255612897,185356,3255798253,8,0,0,36864,8,5145706093
4055,3255629483,68444,3255697927,6,0,0,512,6,9501865808
4056,3255630223,53384,3255683607,15,0,1,12800,15,8399840620
4057,3255759156,154829,3255913985,13,0,0,17920,13,6239824025
4058,3255761744,5196,3255766940,7,0,1,13312,7,1285631296
4059,3255801250,50451,3255851701,6,0,0,1024,6,9463232329
4060,3255804784,3898,3255808682,5,0,1,4096,5,4434110188
4061,3255848332,68008,3255916340,15,0,0,7680,15,10431015867
4062,3255856738,45596,3255902334,18,0,0,1024,18,6854330632
4063,3255870631,170676,3256041307,17,0,0,64000,17,592939383
4064,3255875596,6229,3255881825,19,0,1,15360,19,4811334329
4065,3255915676,6458,3255922134,16,0,1,6144,16,9827167478
4066,3255932378,59132,3255991510,3,0,0,5120,3,1137422050
4067,3255995884,45602,3256041486,18,0,0,512,18,6357178850
4068,3256003533,3898,3256007431,0,0,1,4096,0,3443500036
4069,3256019257,46398,3256065655,18,0,0,512,18,1660348601
4070,3256027674,117770,3256145444,16,0,0,41472,16,6577741552
4071,3256055975,6488,3256062463,18,0,1,15872,18,10214935919
4072,3256061464,159352,3256220816,1,0,0,69120,1,9583239442
4073,3256066345,171553,3256237898,8,0,0,31232,8,884970545
4074,3256082855,103819,3256186674,0,0,0,4096,0,3488075887
4075,3256093932,262104,3256356036,3,0,0,78848,3,2785207525
4076,3256094008,129795,3256223803,3,0,0,9728,3,2315941028
4077,3256121049,1994,3256123043,1,0,1,2048,1,5871238656
4078,3256122750,131863,3256254613,5,0,0,8704,5,5759704492
4079,3256163256,6754,3256170010,15,0,1,7168,15,8025866956
4080,3256166966,231930,3256398896,16,0,0,27136,16,9925424830
4081,3256171874,128122,3256299996,19,0,0,22016,19,2633265012
4082,3256200878,114412,3256315290,18,0,0,512,18,1063766366
4083,3256253695,6712,3256260407,14,0,1,6144,14,9088106523
4084,3256294069,13149,3256307218,11,0,1,7680,11,9393607001
4085,3256307100,1518,3256308618,6,0,1,1536,6,4627785941
4086,3256322649,200296,3256522945,16,0,0,54272,16,3254704379
4087,3256364970,78368,3256443338,1,0,0,12800,1,10024925606
4088,3256366908,21141,3256388049,8,0,1,34304,8,8867743307
4089,3256407637,566,3256408203,2,0,1,512,2,2452376686
4090,3256419480,566,3256420046,5,0,1,512,5,7396984206
4091,3256425738,134920,3256560658,8,0,0,59392,8,9349241132
4092,3256446432,203380,3256649812,14,0,0,98816,14,7615785916
4093,3256462940,363489,3256826429,0,0,0,71680,0,6360460857
4094,3256500504,188912,3256689416,12,0,0,37888,12,1532625019
4095,3256557386,5258,3256562644,16,0,1,2048,16,9297672378
4096,3256572162,2946,3256575108,15,0,1,3072,15,8920061781
4097,3256579141,70850,3256649991,18,0,0,512,18,4992619829
4098,3256580134,224440,3256804574,14,0,0,87040,14,1636222068
4099,3256588977,3898,3256592875,1,0,1,4096,1,2811051227
4100,3256606703,130697,3256737400,5,0,0,26112,5,9672379740
4101,3256625982,30271,3256656253,0,0,1,6656,0,8493210638
4102,3256637916,196967,3256834883,9,0,0,12800,9,10630093995
4103,3256658477,172491,3256830968,1,0,0,14848,1,1963313413
4104,3256679752,11667,3256691419,7,0,1,2048,7,3578209004
4105,3256685925,9061,3256694986,10,0,1,12800,10,4376102183
4106,3256720159,151431,3256871590,12,0,0,72192,12,52573723
4107,3256728119,9296,3256737415,7,0,1,4608,7,6090475245
4108,3256757174,147781,3256904955,16,0,0,33792,16,10194275596
4109,3256834692,119732,3256954424,9,0,0,51200,9,659861876
4110,3256836622,49136,3256885758,13,0,0,2560,13,338124991
4111,3256849753,173041,3257022794,17,0,0,47616,17,7666046289
4112,3256860990,21116,3256882106,14,0,1,16896,14,187630051
4113,3256874152,9900,3256884052,18,0,1,3072,18,10303755293
4114,3256876627,9146,3256885773,11,0,1,2048,11,7379853612
4115,3256913400,4420,3256917820,3,0,1,11776,3,8230982128
4116,3257047997,6754,3257054751,19,0,1,7168,19,7756044048
4117,3257131327,66056,3257197383,17,0,0,7680,17,634269055
4118,3257143043,1994,3257145037,14,0,1,2048,14,9981810488
4119,3257146303,170605,3257316908,3,0,0,19968,3,10499250176
4120,3257152855,52832,3257205687,5,0,0,4608,5,2248995929
4121,3257165986,132251,3257298237,1,0,0,80384,1,8124713501
4122,3257181410,1042,3257182452,6,0,1,1024,6,3878746951
4123,3257206553,101800,3257308353,9,0,0,512,9,1274150826
4124,3257271913,26339,3257298252,10,0,1,5120,10,1216061135
4125,3257280007,25467,3257305474,17,0,1,7680,17,6065186685
4126,3257300442,67766,3257368208,18,0,0,4608,18,6633310502
4127,3257395543,43904,3257439447,18,0,0,512,18,7077898432
4128,3257401233,4937,3257406170,8,0,1,12800,8,5148186395
4129,3257409909,101504,3257511413,12,0,0,33280,12,4260113576
4130,3257424248,126066,3257550314,7,0,0,64512,7,5015292936
4131,3257470683,96303,3257566986,15,0,0,512,15,4844385313
4132,3257484372,6278,3257490650,10,0,1,6656,10,6460085578
4133,3257533772,139381,3257673153,12,0,0,8192,12,7878914823
4134,3257535469,135173,3257670642,9,0,0,46080,9,7569495266
4135,3257535615,15783,3257551398,16,0,1,1024,16,7564372993
4136,3257551996,197936,3257749932,19,0,0,12800,19,5950043154
4137,3257620877,166550,3257787427,0,0,0,96768,0,5583920872
4138,3257630152,7230,3257637382,4,0,1,7680,4,2980562644
4139,3257711487,44492,3257755979,8,0,1,73216,8,7352763593
4140,3257741122,46320,3257787442,1,0,1,5120,1,117022137
4141,3257748082,60974,3257809056,7,0,0,5120,7,8642826126
4142,3257751693,74908,3257826601,18,0,0,1024,18,8700923593
4143,3257783021,219981,3258003002,10,0,0,40960,10,9077320150
4144,3257787201,114593,3257901794,16,0,0,42496,16,547524701
4145,3257812053,566,3257812619,11,0,1,512,11,3658589859
4146,3257822016,90860,3257912876,19,0,0,23552,19,4674407971
4147,3257823239,147057,3257970296,13,0,0,50688,13,2990726142
4148,3257850739,4374,3257855113,5,0,1,4608,5,7910150748
4149,3257857886,3904,3257861790,16,0,1,10752,16,7864723522
4150,3257980537,4374,3257984911,17,0,1,4608,17,4708064855
4151,3257981098,4159,3257985257,16,0,1,512,16,10722383845
4152,3257986347,68372,3258054719,16,0,0,10240,16,7355452110
4153,3257991483,145287,3258136770,17,0,0,30208,17,5800122784
4154,3258022439,3422,3258025861,10,0,1,3584,10,8750976207
4155,3258053070,4153,3258057223,1,0,1,2560,1,4877609731
4156,3258053272,4937,3258058209,14,0,1,1536,14,4525282728
4157,3258054097,5738,3258059835,3,0,1,2560,3,2189742303
4158,3258100565,209258,3258309823,16,0,0,62976,16,2211734982
4159,3258183313,169645,3258352958,0,0,0,5632,0,10344285695
4160,3258243378,6754,3258250132,16,0,1,7168,16,2732587778
4161,3258266103,1042,3258267145,11,0,1,1024,11,8767682197
4162,3258268700,3422,3258272122,18,0,1,3584,18,4819126124
4163,3258278792,88364,3258367156,15,0,0,15360,15,9037931065
4164,3258307753,4056,3258311809,3,0,1,2048,3,9573589181
4165,3258329536,173167,3258502703,0,0,0,28160,0,7810457613
4166,3258334513,79189,3258413702,3,0,0,6144,3,1440256553
4167,3258409818,3899,3258413717,10,0,1,8704,10,9845493037
4168,3258423610,566,3258424176,18,0,1,512,18,9704291935
4169,3258462767,54056,3258516823,1,0,0,3584,1,7898222422
4170,3258575918,4374,3258580292,3,0,1,4608,3,1798400435
4171,3258576293,88463,3258664756,18,0,0,1536,18,1206497352
4172,3258600747,102284,3258703031,5,0,0,35840,5,4037832931
4173,3258667236,50672,3258717908,19,0,0,2560,19,7450473774
4174,3258691767,11279,3258703046,12,0,1,2048,12,8229302267
4175,3258720840,69908,3258790748,12,0,0,10240,12,118090352
4176,3258746606,167742,3258914348,10,0,0,2560,10,5716110347
4177,3258782139,131406,3258913545,5,0,0,87040,5,2070895040
4178,3258797033,566,3258797599,16,0,1,512,16,9907952209
4179,3258859546,67790,3258927336,13,0,0,3072,13,4712929763
4180,3258874972,101348,3258976320,5,0,0,32768,5,3559520381
4181,3258888141,32162,3258920303,11,0,1,14848,11,3745014629
4182,3258905447,16802,3258922249,8,0,1,3072,8,4909342878
4183,3258937077,103220,3259040297,13,0,0,38912,13,2098855649
4184,3258945967,1518,3258947485,18,0,1,1536,18,3249799756
4185,3258958381,566,3258958947,0,0,1,512,0,10572393139
4186,3258981717,2946,3258984663,3,0,1,3072,3,10199403941
4187,3258984774,205848,3259190622,11,0,0,23040,11,8027763865
4188,3259052962,130329,3259183291,9,0,0,35840,9,4700217620
4189,3259107545,146578,3259254123,4,0,0,28160,4,9810207702
4190,3259138753,106775,3259245528,10,0,0,30720,10,8066534005
4191,3259182611,73258,3259255869,19,0,0,5632,19,5951501123
4192,3259194355,91212,3259285567,17,0,0,16384,17,719427023
4193,3259218360,119749,3259338109,14,0,0,11264,14,1544794593
4194,3259229163,24975,3259254138,12,0,1,20992,12,6081733756
4195,3259280015,5567,3259285582,3,0,1,10240,3,1600232200
4196,3259297714,2870,3259300584,11,0,1,8704,11,4007694186
4197,3259300120,861,3259300981,6,0,1,512,6,307657800
4198,3259304180,54056,3259358236,11,0,0,3584,11,441619091
4199,3259322993,164474,3259487467,11,0,0,4608,11,1437541766
4200,3259347935,100256,3259448191,1,0,0,29184,1,10244703116
4201,3259372407,81862,3259454269,10,0,0,7680,10,9115981432
4202,3259373261,156161,3259529422,4,0,0,25600,4,7977670835
4203,3259378886,72604,3259451490,16,0,0,10752,16,9722968365
4204,3259415991,5326,3259421317,11,0,1,5632,11,5222865972
4205,3259419315,57919,3259477234,18,0,0,512,18,10148789083
4206,3259426847,1042,3259427889,5,0,1,1024,5,4743771321
4207,3259443782,94760,3259538542,3,0,0,5120,3,1388307651
4208,3259478297,165051,3259643348,8,0,0,39936,8,4321801063
4209,3259481504,48875,3259530379,1,0,0,2048,1,8701802617
4210,3259502374,3898,3259506272,6,0,1,4096,6,4782643308
4211,3259525496,9114,3259534610,16,0,1,13312,16,1810321275
4212,3259551108,79748,3259630856,9,0,0,12288,9,8713131174
4213,3259555933,190210,3259746143,19,0,0,43520,19,5191389502
4214,3259582544,133385,3259715929,3,0,0,12800,3,9395609243
4215,3259588442,1994,3259590436,7,0,1,2048,7,928115744
4216,3259593230,3904,3259597134,14,0,1,10752,14,1477720954
4217,3259639807,7431,3259647238,7,0,1,4096,7,7959237515
4218,3259645781,144414,3259790195,15,0,0,36864,15,10172038961
4219,3259723670,566,3259724236,4,0,1,512,4,9472590431
4220,3259724880,1518,3259726398,15,0,1,1536,15,4724383233
4221,3259748456,153208,3259901664,7,0,0,66560,7,7813802813
4222,3259831144,3898,3259835042,7,0,1,4096,7,3680769510
4223,3259851053,95492,3259946545,1,0,0,28672,1,2441398980
4224,3259871609,7706,3259879315,4,0,1,8192,4,8384067127
4225,3259873890,7051,3259880941,1,0,1,2560,1,4910097501
4226,3259965555,43904,3260009459,6,0,0,512,6,2374073599
4227,3259969499,6278,3259975777,3,0,1,6656,3,10342763430
4228,3259983593,7706,3259991299,1,0,1,8192,1,8172571554
4229,3259992273,5326,3259997599,16,0,1,5632,16,1909480990
4230,3260026320,100256,3260126576,8,0,0,29184,8,9852187706
4231,3260046296,154890,3260201186,5,0,0,46080,5,2018101548
4232,3260110143,566,3260110709,12,0,1,512,12,10393989717
4233,3260162418,95600,3260258018,1,0,0,18944,1,10401883477
4234,3260162633,149685,3260312318,5,0,0,24576,5,1412491571
4235,3260164901,14545,3260179446,11,0,1,28160,11,2918905998
4236,3260187623,113516,3260301139,1,0,0,22528,1,7230694681
4237,3260221869,4374,3260226243,16,0,1,4608,16,7461705234
4238,3260228835,152818,3260381653,9,0,0,53760,9,9654772180
4239,3260345371,4679,3260350050,2,0,1,12288,2,1824254492
4240,3260356089,44145,3260400234,8,0,1,75776,8,7635794769
4241,3260362152,38748,3260400900,1,0,1,1024,1,9179284533
4242,3260368486,160648,3260529134,16,0,0,34816,16,5988970840
4243,3260381755,20451,3260402206,19,0,1,2048,19,365919181
4244,3260388443,64137,3260452580,8,0,1,108032,8,4113260386
4245,3260391624,61302,3260452926,0,0,1,512,0,9632054955
4246,3260392255,65817,3260458072,1,0,1,8192,1,7417425043
4247,3260409849,52729,3260462578,19,0,1,7168,19,1350220355
4248,3260558994,186171,3260745165,9,0,0,124416,9,1409239483
4249,3260577170,3422,3260580592,14,0,1,3584,14,3459368637
4250,3260598727,1518,3260600245,3,0,1,1536,3,3998650712
4251,3260634582,398027,3261032609,16,0,0,167424,16,4782216258
4252,3260643847,333968,3260977815,1,0,0,123392,1,2292505389
4253,3260651571,3387,3260654958,12,0,1,9728,12,1174248454
4254,3260697549,230344,3260927893,12,0,0,86016,12,428974111
4255,3260713899,34271,3260748170,12,0,1,3072,12,1138379000
4256,3260735438,246136,3260981574,15,0,0,12288,15,10534536298
4257,3260738187,10649,3260748836,7,0,1,1024,7,2606478849
4258,3260738527,313177,3261051704,4,0,0,62464,4,4615478818
4259,3260780323,7230,3260787553,1,0,1,7680,1,7651937123
4260,3260952032,102347,3261054379,12,0,0,8704,12,4555651506
4261,3260963273,208929,3261172202,11,0,0,10752,11,10187846700
4262,3260991137,85393,3261076530,18,0,0,512,18,7818777558
4263,3260998146,103789,3261101935,17,0,0,8192,17,2761861899
4264,3260998259,240698,3261238957,1,0,0,68608,1,4685797321
4265,3260999639,74974,3261074613,11,0,1,37888,11,2332302460
4266,3261015428,243980,3261259408,10,0,0,67072,10,8743342825
4267,3261046744,28215,3261074959,5,0,1,512,5,5940915198
4268,3261093930,1994,3261095924,1,0,1,2048,1,9013767624
4269,3261120981,174046,3261295027,7,0,0,18944,7,1881863115
4270,3261167168,5049,3261172217,12,0,1,10240,12,1535782554
4271,3261183534,2946,3261186480,5,0,1,3072,5,9992147907
4272,3261322226,47756,3261369982,19,0,0,3072,19,2208982524
4273,3261330560,116840,3261447400,4,0,0,29184,4,5375752955
4274,3261332585,43904,3261376489,19,0,0,512,19,10177390926
4275,3261393507,566,3261394073,4,0,1,512,4,10218379299
4276,3261425154,2470,3261427624,14,0,1,2560,14,6965925252
4277,3261426067,67904,3261493971,14,0,0,8704,14,562680913
4278,3261427173,45596,3261472769,18,0,0,1024,18,2991089117
4279,3261453615,99294,3261552909,3,0,0,24576,3,1089174858
4280,3261495813,1518,3261497331,10,0,1,1536,10,4709749177
4281,3261549065,4402,3261553467,11,0,1,512,11,49332502
4282,3261609240,2946,3261612186,4,0,1,3072,4,1536431701
4283,3261659640,103688,3261763328,5,0,0,40448,5,5215846733
4284,3261670217,6278,3261676495,14,0,1,6656,14,9082928441
4285,3261702477,11274,3261713751,4,0,1,18432,4,9700368009
4286,3261731168,10499,3261741667,3,0,1,16896,3,9683733149
4287,3261749319,566,3261749885,3,0,1,512,3,5672509143
4288,3261765951,52808,3261818759,8,0,1,86016,8,625999446
4289,3261892886,3387,3261896273,5,0,1,9728,5,8553601924
4290,3261911119,183438,3262094557,13,0,0,29184,13,5336333484
4291,3261933694,130061,3262063755,5,0,0,52224,5,2065398105
4292,3261954086,3898,3261957984,4,0,1,4096,4,3326650022
4293,3262019254,110372,3262129626,10,0,0,43520,10,8628478181
4294,3262060565,107494,3262168059,7,0,0,42496,7,5916265564
4295,3262105380,161070,3262266450,16,0,0,51200,16,5071435015
4296,3262118495,14069,3262132564,19,0,1,3072,19,8074217461
4297,3262169563,6754,3262176317,3,0,1,7168,3,3968966149
4298,3262174854,4937,3262179791,0,0,1,12800,0,3631102702
4299,3262176763,3374,3262180137,1,0,1,512,1,3208977745
4300,3262183386,4420,3262187806,5,0,1,11776,5,5487765318
4301,3262282814,86696,3262369510,15,0,0,19968,15,2201890726
4302,3262292306,109383,3262401689,3,0,0,13312,3,4793708525
4303,3262326354,566,3262326920,17,0,1,512,17,6053627683
4304,3262365456,71350,3262436806,16,0,0,11776,16,3231574422
4305,3262382127,2870,3262384997,2,0,1,8704,2,7870079921
4306,3262396263,7230,3262403493,14,0,1,7680,14,9332306227
4307,3262442340,136674,3262579014,15,0,0,2048,15,8157124911
4308,3262553599,115625,3262669224,1,0,0,70144,1,8642585837
4309,3262591113,4374,3262595487,0,0,1,4608,0,1426062414
4310,3262592583,3570,3262596153,12,0,1,1024,12,9070694793
4311,3262600065,1042,3262601107,19,0,1,1024,19,7719625404
4312,3262726498,4374,3262730872,14,0,1,4608,14,4863734552
4313,3262761990,6229,3262768219,14,0,1,15360,14,7320332389
4314,3262768934,5196,3262774130,4,0,1,13312,4,9341094188
4315,3262769614,9396,3262779010,4,0,1,14848,4,7600264150
4316,3262821383,7706,3262829089,1,0,1,8192,1,5656800387
4317,3262887996,98852,3262986848,9,0,0,24576,9,2353083295
4318,3262912811,2946,3262915757,19,0,1,3072,19,4128534173
4319,3262958608,4162,3262962770,0,0,1,11264,0,9620496074
4320,3262961391,107989,3263069380,14,0,0,14336,14,7381485756
4321,3262964045,4162,3262968207,4,0,1,11264,4,2343593153
4322,3262994344,2870,3262997214,3,0,1,8704,3,6357135923
4323,3263131180,3898,3263135078,7,0,1,4096,7,10172042189
4324,3263195147,103844,3263298991,10,0,0,40960,10,6486102049
4325,3263210270,89048,3263299318,18,0,0,1024,18,9953115199
4326,3263245180,114608,3263359788,16,0,0,76288,16,1031719292
4327,3263320864,3422,3263324286,18,0,1,3584,18,2342236542
4328,3263339444,121216,3263460660,3,0,0,31232,3,518707600
4329,3263386544,1042,3263387586,7,0,1,1024,7,9484220881
4330,3263575872,72068,3263647940,10,0,0,12288,10,2973334862
4331,3263583043,7706,3263590749,14,0,1,8192,14,337110076
4332,3263620234,78916,3263699150,15,0,0,17920,15,2125082671
4333,3263625772,3645,3263629417,12,0,1,10240,12,2013784682
4334,3263637175,2946,3263640121,3,0,1,3072,3,5702200659
4335,3263663386,78154,3263741540,1,0,0,9728,1,5852906830
4336,3263673260,91482,3263764742,13,0,0,5632,13,6974905891
4337,3263681709,5802,3263687511,5,0,1,6144,5,6107273253
4338,3263685575,69015,3263754590,0,0,0,2560,0,10536891828
4339,3263686535,2282,3263688817,7,0,1,2048,7,3004267733
4340,3263705404,3128,3263708532,6,0,1,9216,6,1484073321
4341,3263716433,101036,3263817469,15,0,0,31744,15,1145333449
4342,3263725653,6278,3263731931,0,0,1,6656,0,1713905470
4343,3263727162,107064,3263834226,5,0,0,49664,5,9537345088
4344,3263727810,211261,3263939071,14,0,0,42496,14,7870828390
4345,3263754251,209030,3263963281,0,0,0,62464,0,10642444433
4346,3263759757,184477,3263944234,14,0,0,16896,14,1227316871
4347,3263771172,193060,3263964232,16,0,0,3072,16,316885106
4348,3263979346,566,3263979912,2,0,1,512,2,1860954595
4349,3264024562,3387,3264027949,19,0,1,9728,19,4302014181
4350,3264063769,3422,3264067191,7,0,1,3584,7,5957930024
4351,3264094607,2470,3264097077,11,0,1,2560,11,10145432512
4352,3264106812,100100,3264206912,1,0,0,28672,1,9293372473
4353,3264143773,138362,3264282135,3,0,0,512,3,3938772895
4354,3264177652,104312,3264281964,17,0,0,42496,17,3086937241
4355,3264195912,1518,3264197430,19,0,1,1536,19,3775286079
4356,3264198336,98233,3264296569,18,0,0,512,18,3624172703
4357,3264221702,74696,3264296398,14,0,0,15872,14,3260929810
4358,3264267288,170176,3264437464,9,0,0,109056,9,152622837
4359,3264272508,13534,3264286042,19,0,1,4096,19,3956111891
4360,3264272522,85682,3264358204,5,0,0,10240,5,1646173345
4361,3264283562,65456,3264349018,15,0,0,10752,15,995935219
4362,3264339466,4420,3264343886,5,0,1,11776,5,8122404421
4363,3264352855,5364,3264358219,11,0,1,4096,11,1284714706
4364,3264427064,109244,3264536308,9,0,0,24576,9,5077500541
4365,3264466756,139794,3264606550,3,0,0,27136,3,7850385662
4366,3264480333,74394,3264554727,6,0,0,512,6,6872371540
4367,3264617356,103532,3264720888,3,0,0,39936,3,8343686586
4368,3264622910,65144,3264688054,3,0,0,9728,3,10205970830
4369,3264666828,566,3264667394,17,0,1,512,17,729335625
4370,3264722645,76052,3264798697,13,0,0,10240,13,8226330268
4371,3264758061,67592,3264825653,3,0,0,7680,3,7500540741
4372,3264771645,175382,3264947027,3,0,0,137728,3,4603850838
4373,3264792900,7230,3264800130,2,0,1,7680,2,9839228924
4374,3264809381,261779,3265071160,1,0,0,50176,1,8554215403
4375,3264854120,152973,3265007093,16,0,0,52224,16,10676134861
4376,3264875789,3422,3264879211,5,0,1,3584,5,8209991502
4377,3264882090,5326,3264887416,14,0,1,5632,14,8962679984
4378,3264944859,4630,3264949489,11,0,1,2560,11,9646325794
4379,3264998091,15748,3265013839,12,0,1,7168,12,7779828323
4380,3265039824,1518,3265041342,11,0,1,1536,11,7909311540
4381,3265066953,49795,3265116748,6,0,0,1024,6,6830860691
4382,3265136286,566,3265136852,17,0,1,512,17,10356966896
4383,3265157313,105092,3265262405,10,0,0,45056,10,5802591631
4384,3265187820,129072,3265316892,6,0,0,2560,6,375896990
4385,3265195149,3898,3265199047,14,0,1,4096,14,224153696
4386,3265231009,123320,3265354329,5,0,0,34304,5,8759597236
4387,3265252458,11474,3265263932,7,0,1,1536,7,1240254604
4388,3265254435,11834,3265266269,12,0,1,9728,12,2425263979
4389,3265365581,6754,3265372335,2,0,1,7168,2,10662598211
4390,3265380497,56076,3265436573,18,0,0,512,18,10227252282
4391,3265427566,6754,3265434320,15,0,1,7168,15,5893821778
4392,3265463509,84716,3265548225,5,0,0,23552,5,2683663784
4393,3265467631,3422,3265471053,7,0,1,3584,7,4438966637
4394,3265481015,90836,3265571851,12,0,0,18432,12,3423210199
4395,3265481399,104290,3265585689,14,0,0,20480,14,6680724110
4396,3265529358,227498,3265756856,1,0,0,17408,1,190222192
4397,3265533960,199876,3265733836,16,0,0,512,16,6685056842
4398,3265535080,120535,3265655615,1,0,0,60416,1,7064384568
4399,3265540897,192760,3265733657,8,0,0,88576,8,9634262479
4400,3265564897,6969,3265571866,2,0,1,4096,2,9390736400
4401,3265569384,116547,3265685931,13,0,0,18432,13,3630443959
4402,3265601142,1518,3265602660,1,0,1,1536,1,2464917303
4403,3265607297,128754,3265736051,10,0,0,7168,10,9560297413
4404,3265648246,9355,3265657601,10,0,1,2048,10,4705434333
4405,3265659610,115480,3265775090,11,0,0,512,11,6700515526
4406,3265708043,29961,3265738004,5,0,1,2048,5,2841111377
4407,3265709821,96543,3265806364,1,0,0,13824,1,1207577167
4408,3265717339,23974,3265741313,17,0,1,12288,17,8227469472
4409,3265755633,152235,3265907868,17,0,0,96256,17,8035880440
4410,3265763204,2470,3265765674,12,0,1,2560,12,6427716666
4411,3265788915,1994,3265790909,0,0,1,2048,0,7710456666
4412,3265838087,3422,3265841509,10,0,1,3584,10,3259208498
4413,3265847423,3422,3265850845,4,0,1,3584,4,1275432259
4414,3265878509,31312,3265909821,3,0,1,2048,3,8594432329
4415,3265887864,64524,3265952388,18,0,0,512,18,6285388476
4416,3265888382,127103,3266015485,3,0,0,5632,3,8904881689
4417,3265930200,3422,3265933622,6,0,1,3584,6,7942686713
4418,3265946253,2946,3265949199,1,0,1,3072,1,9463719930
4419,3266030358,6754,3266037112,14,0,1,7168,14,2035930697
4420,3266031671,8987,3266040658,19,0,1,5632,19,5562685794
4421,3266131673,1042,3266132715,17,0,1,1024,17,7274569558
4422,3266137231,1994,3266139225,4,0,1,2048,4,3778441023
4423,3266142448,228033,3266370481,7,0,0,105472,7,2373429975
4424,3266274181,101159,3266375340,11,0,0,15872,11,3715620273
4425,3266275157,1518,3266276675,4,0,1,1536,4,8718540932
4426,3266300925,6278,3266307203,14,0,1,6656,14,524549546
4427,3266340657,39041,3266379698,3,0,1,4608,3,5273506830
4428,3266363474,23753,3266387227,5,0,1,16896,5,2257547417
4429,3266416374,70976,3266487350,15,0,0,8704,15,3279784578
4430,3266462758,89324,3266552082,8,0,0,23552,8,3271762411
4431,3266539862,4420,3266544282,3,0,1,11776,3,892223726
4432,3266560619,4374,3266564993,7,0,1,4608,7,10481988030
4433,3266583985,47600,3266631585,7,0,0,2560,7,1260609950
4434,3266620275,1994,3266622269,11,0,1,2048,11,379208090
4435,3266706320,54680,3266761000,5,0,0,5632,5,7607492022
4436,3266708213,156881,3266865094,1,0,0,119296,1,9761100418
4437,3266725645,3898,3266729543,2,0,1,4096,2,8750693737
4438,3266734098,282810,3267016908,3,0,0,140800,3,9794765019
4439,3266782941,82636,3266865577,18,0,0,1536,18,5132055150
4440,3266961508,6278,3266967786,4,0,1,6656,4,4009310102
4441,3266994099,30507,3267024606,3,0,1,8192,3,1289303140
4442,3267057913,1994,3267059907,2,0,1,2048,2,8094094187
4443,3267072367,1042,3267073409,0,0,1,1024,0,8947353534
4444,3267079169,130832,3267210001,1,0,0,129536,1,4658106309
4445,3267131995,4850,3267136845,3,0,1,5120,3,6425992836
4446,3267216973,60655,3267277628,6,0,0,1536,6,8440445517
4447,3267230340,54843,3267285183,1,0,0,1536,1,10230309175
4448,3267232378,2870,3267235248,5,0,1,8704,5,9959716541
4449,3267234297,3910,3267238207,5,0,1,9216,5,3639321560
4450,3267265804,106028,3267371832,15,0,0,48128,15,1727911337
4451,3267268718,1518,3267270236,18,0,1,1536,18,8307039032
4452,3267279145,566,3267279711,17,0,1,512,17,7115855955
4453,3267320543,7230,3267327773,0,0,1,7680,0,6260682081
4454,3267334621,148815,3267483436,14,0,0,49664,14,415269201
4455,3267345945,73920,3267419865,9,0,0,5120,9,8905884571
4456,3267354632,1042,3267355674,11,0,1,1024,11,1252707228
4457,3267405892,4679,3267410571,3,0,1,12288,3,1354502248
4458,3267411082,50268,3267461350,6,0,0,1024,6,10274335094
4459,3267488679,138354,3267627033,5,0,0,2560,5,4328689254
4460,3267491813,43904,3267535717,18,0,0,512,18,9319892298
4461,3267506600,5454,3267512054,14,0,1,13824,14,10444652579
4462,3267513026,1042,3267514068,9,0,1,1024,9,10559368490
4463,3267569292,103844,3267673136,13,0,0,40960,13,10343818175
4464,3267577279,2946,3267580225,10,0,1,3072,10,6373466734
4465,3267642434,566,3267643000,0,0,1,512,0,9397301529
4466,3267662265,73379,3267735644,8,0,0,6144,8,9348281349
4467,3267674920,2946,3267677866,6,0,1,3072,6,8500443853
4468,3267700053,98228,3267798281,4,0,0,22528,4,2748211991
4469,3267741370,114973,3267856343,0,0,0,15360,0,5176849690
4470,3267865635,67592,3267933227,3,0,0,7680,3,175866094
4471,3267917094,103376,3268020470,0,0,0,39424,0,1197084891
4472,3267943326,117110,3268060436,15,0,0,38400,15,3256677281
4473,3268004604,15897,3268020501,2,0,1,18944,2,4197997894
4474,3268006122,17787,3268023909,6,0,1,3584,6,510235623
4475,3268011266,126231,3268137497,12,0,0,45568,12,10284881517
4476,3268072056,3128,3268075184,3,0,1,9216,3,3169533503
4477,3268095042,3898,3268098940,19,0,1,4096,19,9554203820
4478,3268116303,51158,3268167461,6,0,0,512,6,10147558590
4479,3268173557,10757,3268184314,6,0,1,17408,6,9841637153
4480,3268249474,130209,3268379683,15,0,0,62464,15,2706139621
4481,3268253905,3645,3268257550,11,0,1,10240,11,4093234502
4482,3268254424,6072,3268260496,12,0,1,3584,12,1533593616
4483,3268272413,566,3268272979,17,0,1,512,17,230937356
4484,3268311476,81373,3268392849,14,0,0,9216,14,9258734427
4485,3268311555,133534,3268445089,1,0,0,49152,1,8543136963
4486,3268321085,1994,3268323079,17,0,1,2048,17,7700364275
4487,3268328463,210191,3268538654,19,0,0,25088,19,2330123786
4488,3268333366,6754,3268340120,2,0,1,7168,2,10038348768
4489,3268344873,146304,3268491177,10,0,0,32256,10,5497665615
4490,3268370755,126068,3268496823,17,0,0,1024,17,386862742
4491,3268402440,94056,3268496496,14,0,0,17408,14,5843277615
4492,3268440180,107042,3268547222,8,0,1,165376,8,5710060691
4493,3268445573,107346,3268552919,8,0,1,18944,8,10255306014
4494,3268450468,332238,3268782706,1,0,0,44544,1,760157892
4495,3268455852,341853,3268797705,0,0,0,49152,0,6271812172
4496,3268477620,75965,3268553585,11,0,1,11264,11,10055066533
4497,3268490747,417997,3268908744,15,0,0,197632,15,8383564225
4498,3268492047,99460,3268591507,17,0,0,512,17,701243375
4499,3268493580,168004,3268661584,17,0,0,1024,17,1949814397
4500,3268507930,315198,3268823128,11,0,0,9728,11,6887602797
4501,3268515300,39156,3268554456,7,0,1,12288,7,6176927192
4502,3268566085,485883,3269051968,9,0,0,47104,9,8129760968
4503,3268599554,248936,3268848490,5,0,0,78336,5,1046677476
4504,3268612401,2946,3268615347,19,0,1,3072,19,706080185
4505,3268620326,3422,3268623748,3,0,1,3584,3,2778409291
4506,3268641054,274740,3268915794,9,0,0,20992,9,9165096239
4507,3268669038,240345,3268909383,18,0,0,2048,18,3374067424
4508,3268732119,281779,3269013898,1,0,0,34816,1,7683833559
4509,3268773711,204271,3268977982,13,0,0,32256,13,8554156510
4510,3268786185,14934,3268801119,7,0,1,3584,7,7501199227
4511,3268819060,29445,3268848505,14,0,1,7168,14,8121215826
4512,3268829967,86170,3268916137,18,0,0,1024,18,697183523
4513,3268876883,203663,3269080546,0,0,0,8704,0,10649493302
4514,3268900937,16201,3268917138,15,0,1,1024,15,7500561644
4515,3268975123,186904,3269162027,11,0,0,78336,11,7827209358
4516,3269056431,232508,3269288939,13,0,0,38912,13,7694935471
4517,3269058443,60980,3269119423,19,0,0,6144,19,6957846044
4518,3269067422,308355,3269375777,14,0,0,75776,14,6842010940
4519,3269072047,192308,3269264355,14,0,0,169984,14,7070341779
4520,3269075290,1042,3269076332,5,0,1,1024,5,3806085573
4521,3269088546,1994,3269090540,7,0,1,2048,7,2545232959
4522,3269097093,198026,3269295119,0,0,0,13824,0,10375012851
4523,3269111598,4850,3269116448,2,0,1,5120,2,2436879208
4524,3269171939,311764,3269483703,3,0,0,43520,3,2311695994
4525,3269172582,6754,3269179336,4,0,1,7168,4,2883424756
4526,3269228010,368055,3269596065,1,0,0,184320,1,5696652186
4527,3269228835,192768,3269421603,18,0,0,1024,18,6176912804
4528,3269263956,132515,3269396471,9,0,0,26624,9,9554582264
4529,3269272785,3128,3269275913,2,0,1,9216,2,527273732
4530,3269281058,14076,3269295134,4,0,1,11776,4,10671110869
4531,3269330165,1042,3269331207,18,0,1,1024,18,9821608164
4532,3269364149,18867,3269383016,2,0,1,7680,2,1862522267
4533,3269365708,234821,3269600529,13,0,0,5632,13,894117633
4534,3269402550,12049,3269414599,4,0,1,19968,4,6066916403
4535,3269465300,143404,3269608704,4,0,0,5120,4,1745602813
4536,3269468277,199986,3269668263,15,0,0,30208,15,10008643546
4537,3269487546,5802,3269493348,2,0,1,6144,2,2019784627
4538,3269492568,105712,3269598280,7,0,0,7168,7,10206300996
4539,3269554529,207801,3269762330,13,0,0,40448,13,4018813738
4540,3269582795,17749,3269600544,15,0,1,1536,15,7633996692
4541,3269610991,1994,3269612985,9,0,1,2048,9,2949804324
4542,3269619319,4850,3269624169,17,0,1,5120,17,653414520
4543,3269639080,127485,3269766565,1,0,0,13824,1,10366284794
4544,3269685559,1042,3269686601,9,0,1,1024,9,1247764004
4545,3269698472,135262,3269833734,5,0,0,40960,5,339306173
4546,3269713591,6754,3269720345,15,0,1,7168,15,4280525803
4547,3269720051,151573,3269871624,10,0,0,13824,10,7343462107
4548,3269729890,50672,3269780562,6,0,0,2560,6,9047104286
4549,3269755810,57808,3269813618,10,0,0,4608,10,10386146390
4550,3269780335,1737,3269782072,18,0,1,1536,18,3008264603
4551,3269795246,48010,3269843256,9,0,0,512,9,2038622168
4552,3269830995,284275,3270115270,1,0,0,120832,1,768633902
4553,3269853512,44492,3269898004,10,0,1,73216,10,6193727571
4554,3269854116,342427,3270196543,10,0,0,94720,10,6421698538
4555,3269867089,136257,3270003346,14,0,0,512,14,10197496248
4556,3269904247,152930,3270057177,15,0,0,27136,15,9422931507
4557,3269924799,566,3269925365,5,0,1,512,5,7762864570
4558,3269933743,59132,3269992875,4,0,0,5120,4,9453536258
4559,3269968375,2870,3269971245,14,0,1,8704,14,7105190973
4560,3269987641,5249,3269992890,1,0,1,4608,1,2150851721
4561,3269994173,125028,3270119201,12,0,0,12800,12,85920775
4562,3270042191,85712,3270127903,18,0,0,512,18,738964411
4563,3270095340,104806,3270200146,1,0,0,11776,1,4781662897
4564,3270102794,104794,3270207588,1,0,0,12288,1,7816174590
4565,3270166739,57440,3270224179,9,0,0,4608,9,7375257474
4566,3270191916,120490,3270312406,9,0,0,68608,9,5366719359
4567,3270238050,6278,3270244328,15,0,1,6656,15,7745472637
4568,3270246416,21916,3270268332,8,0,1,35840,8,10655781793
4569,3270251023,222823,3270473846,1,0,0,52224,1,5435471268
4570,3270263233,101036,3270364269,9,0,0,31744,9,6084809743
4571,3270289526,168385,3270457911,5,0,0,111104,5,4857530853
4572,3270301363,22585,3270323948,17,0,1,18944,17,4417570368
4573,3270305597,77244,3270382841,8,0,1,109056,8,2353148064
4574,3270397239,174663,3270571902,3,0,0,37376,3,9255438517
4575,3270433512,170850,3270604362,18,0,0,512,18,7730160855
4576,3270472742,5946,3270478688,18,0,1,5120,18,1263436189
4577,3270476343,3971,3270480314,12,0,1,2560,12,10291023105
4578,3270515819,1042,3270516861,19,0,1,1024,19,9644437779
4579,3270544472,4374,3270548846,16,0,1,4608,16,2328562291
4580,3270553900,72024,3270625924,10,0,1,116736,10,6990936899
4581,3270562186,77193,3270639379,17,0,0,512,17,4953346145
4582,3270580242,46668,3270626910,9,0,1,1536,9,8289359689
4583,3270605552,25864,3270631416,9,0,1,7168,9,7308247160
4584,3270623880,234008,3270857888,7,0,0,19456,7,7136111474
4585,3270627441,8801,3270636242,16,0,1,7680,16,6852014804
4586,3270666451,214573,3270881024,6,0,0,2048,6,9018218612
4587,3270716047,164338,3270880385,11,0,0,512,11,9902507864
4588,3270766431,134438,3270900869,10,0,0,22528,10,275195610
4589,3270772159,47288,3270819447,18,0,0,1536,18,2440567538
4590,3270777306,102908,3270880214,19,0,0,37888,19,6793863455
4591,3270793425,162623,3270956048,4,0,0,53760,4,8743146484
4592,3270809251,154429,3270963680,4,0,0,14336,4,5088605821
4593,3270823996,288109,3271112105,8,0,0,58880,8,7590658854
4594,3270852856,166738,3271019594,12,0,0,69632,12,10560660333
4595,3270879495,279431,3271158926,7,0,0,25600,7,6834719035
4596,3270932951,4374,3270937325,5,0,1,4608,5,6047476722
4597,3270936713,157437,3271094150,3,0,0,53248,3,9340386841
4598,3270970007,329249,3271299256,1,0,0,73216,1,9651284844
4599,3270980954,45596,3271026550,16,0,0,1024,16,7002255596
4600,3271027099,2870,3271029969,9,0,1,8704,9,639685530
4601,3271051180,3898,3271055078,0,0,1,4096,0,4419697537
4602,3271082239,34604,3271116843,12,0,1,12288,12,4820016200
4603,3271086045,37093,3271123138,5,0,1,7680,5,9930271165
4604,3271103549,20255,3271123804,7,0,1,1024,7,2749358077
4605,3271111629,102359,3271213988,4,0,0,34304,4,1184463847
4606,3271118412,10218,3271128630,15,0,1,7680,15,3431363453
4607,3271159219,263985,3271423204,4,0,0,24064,4,10584746098
4608,3271199528,3904,3271203432,15,0,1,10752,15,10040829612
4609,3271216522,4374,3271220896,15,0,1,4608,15,9137540084
4610,3271227076,224691,3271451767,7,0,0,93696,7,10141090917
4611,3271232033,1042,3271233075,19,0,1,1024,19,2860908043
4612,3271293731,9438,3271303169,17,0,1,10752,17,4502168526
4613,3271293956,9879,3271303835,11,0,1,1024,11,10321753598
4614,3271410407,100676,3271511083,15,0,0,28160,15,131603505
4615,3271476301,1042,3271477343,1,0,1,1024,1,178231470
4616,3271508043,14823,3271522866,9,0,1,19456,9,2278493749
4617,3271546688,43904,3271590592,10,0,0,512,10,3465161158
4618,3271558100,1042,3271559142,10,0,1,1024,10,2353005872
4619,3271594048,45596,3271639644,9,0,0,1024,9,4261913633
4620,3271643040,104378,3271747418,14,0,0,19968,14,8770496849
4621,3271651768,84819,3271736587,13,0,0,17920,13,777058581
4622,3271667288,4162,3271671450,5,0,1,11264,5,8027080439
4623,3271668031,160941,3271828972,3,0,0,45568,3,2071039509
4624,3271693917,121156,3271815073,4,0,0,42496,4,4547044244
4625,3271755329,131949,3271887278,12,0,0,23040,12,7610178867
4626,3271787203,100246,3271887449,10,0,0,512,10,5253951827
4627,3271839591,2946,3271842537,18,0,1,3072,18,1725816686
4628,3271847115,1518,3271848633,15,0,1,1536,15,3958340434
4629,3271890206,112424,3272002630,13,0,0,69120,13,10349742004
4630,3271948656,2470,3271951126,3,0,1,2560,3,7023945252
4631,3271959518,104156,3272063674,13,0,0,41984,13,8439861070
4632,3271986441,102385,3272088826,9,0,0,13312,9,2589195555
4633,3271989085,16449,3272005534,11,0,1,8704,11,7180224124
4634,3271999076,8234,3272007310,11,0,1,2048,11,9200018550
4635,3272040080,5802,3272045882,11,0,1,6144,11,10513402245
4636,3272041426,133020,3272174446,8,0,0,13312,8,2409323029
4637,3272054787,168140,3272222927,1,0,0,132096,1,1682768211
4638,3272070372,23208,3272093580,10,0,1,38400,10,8706283364
4639,3272094961,566,3272095527,11,0,1,512,11,4015925081
4640,3272134773,144991,3272279764,14,0,0,26624,14,245445204
4641,3272189187,222293,3272411480,5,0,0,15872,5,6966448339
4642,3272228492,566,3272229058,5,0,1,512,5,1350335244
4643,3272231021,125216,3272356237,9,0,0,11776,9,5231907374
4644,3272233898,118736,3272352634,0,0,0,32768,0,8455370325
4645,3272237753,168876,3272406629,0,0,0,31232,0,3300362790
4646,3272238161,1042,3272239203,3,0,1,1024,3,5137161887
4647,3272262890,4420,3272267310,7,0,1,11776,7,8031364970
4648,3272267340,566,3272267906,12,0,1,512,12,2821916312
4649,3272407676,143365,3272551041,5,0,0,35840,5,4011427152
4650,3272465210,7706,3272472916,11,0,1,8192,11,992837604
4651,3272471516,141671,3272613187,11,0,0,95744,11,7537749407
4652,3272476921,10757,3272487678,12,0,1,17408,12,4379378912
4653,3272479567,8777,3272488344,4,0,1,1024,4,10530300478
4654,3272548863,125641,3272674504,8,0,0,21504,8,4884360893
4655,3272553987,1042,3272555029,6,0,1,1024,6,4519120386
4656,3272571439,2946,3272574385,15,0,1,3072,15,7673650637
4657,3272584231,106404,3272690635,1,0,0,14848,1,10651445383
4658,3272593726,81261,3272674987,17,0,0,1536,17,3813865907
4659,3272601370,12901,3272614271,3,0,1,1024,3,2097803473
4660,3272623839,121254,3272745093,11,0,0,37376,11,9149310462
4661,3272636198,2946,3272639144,8,0,1,3072,8,7953539839
4662,3272641629,5971,3272647600,14,0,1,14848,14,1803183255
4663,3272646324,76329,3272722653,10,0,1,128512,10,4243485467
4664,3272694178,62516,3272756694,15,0,0,6144,15,5879862706
4665,3272756720,1518,3272758238,19,0,1,1536,19,7723205932
4666,3272759792,24412,3272784204,8,0,1,44032,8,860620150
4667,3272784445,227371,3273011816,5,0,0,50688,5,2091252224
4668,3272788466,226650,3273015116,6,0,0,1024,6,7518834763
4669,3272815888,59912,3272875800,7,0,0,7680,7,7581189016
4670,3272867964,4850,3272872814,4,0,1,5120,4,9696652597
4671,3272871092,2068,3272873160,5,0,1,512,5,2492416573
4672,3272877694,4162,3272881856,15,0,1,11264,15,3445701058
4673,3272910536,271588,3273182124,5,0,0,72192,5,10604855042
4674,3272913702,99689,3273013391,13,0,0,5120,13,6741215549
4675,3272931107,3422,3272934529,9,0,1,3584,9,1288734425
4676,3272945531,1042,3272946573,11,0,1,1024,11,7404274771
4677,3272950665,3128,3272953793,18,0,1,9216,18,4689970165
4678,3272951180,6504,3272957684,5,0,1,11264,5,8544827481
4679,3272973302,4679,3272977981,1,0,1,12288,1,4963387208
4680,3272975461,45538,3273020999,17,0,0,512,17,7597646862
4681,3272987614,105883,3273093497,19,0,0,25600,19,8986660647
4682,3273044868,566,3273045434,9,0,1,512,9,1436820367
4683,3273045502,225587,3273271089,0,0,0,111616,0,6507856956
4684,3273045943,79506,3273125449,0,0,0,5120,0,4610878101
4685,3273049361,23895,3273073256,8,0,1,43008,8,3389297247
4686,3273049978,25224,3273075202,1,0,1,3072,1,1063189349
4687,3273067593,115022,3273182615,17,0,0,1536,17,3919812106
4688,3273117983,82924,3273200907,10,0,1,134656,10,3349366110
4689,3273176039,212718,3273388757,11,0,0,20480,11,10185924498
4690,3273187183,222406,3273409589,7,0,0,8192,7,545220003
4691,3273247730,30122,3273277852,12,0,1,7168,12,4941456408
4692,3273260060,66805,3273326865,10,0,1,87552,10,4339538706
4693,3273321162,162812,3273483974,6,0,0,2048,6,2150530487
4694,3273352157,85472,3273437629,0,0,0,20992,0,7294244364
4695,3273362582,3422,3273366004,6,0,1,3584,6,8534261543
4696,3273364964,1386,3273366350,2,0,1,512,2,3153225063
4697,3273391680,4374,3273396054,11,0,1,4608,11,6089198412
4698,3273401644,150306,3273551950,13,0,0,14848,13,9599361247
4699,3273422467,1042,3273423509,18,0,1,1024,18,5503248982
4700,3273468550,566,3273469116,1,0,1,512,1,8961376237
4701,3273478814,134376,3273613190,11,0,0,3584,11,8378720550
4702,3273494755,77325,3273572080,4,0,0,9216,4,2946667262
4703,3273516594,566,3273517160,2,0,1,512,2,2569467449
4704,3273518133,135033,3273653166,6,0,0,1024,6,9303811201
4705,3273522924,5802,3273528726,1,0,1,6144,1,3318183051
4706,3273538192,158189,3273696381,8,0,0,37376,8,5117998250
4707,3273558062,55555,3273613617,6,0,0,512,6,9298455049
4708,3273559626,54797,3273614423,12,0,0,2048,12,7374325712
4709,3273670018,56372,3273726390,9,0,0,6144,9,3218805207
4710,3273685046,144931,3273829977,5,0,0,7680,5,8666432820
4711,3273711121,116501,3273827622,11,0,0,58880,11,2173800294
4712,3273736863,119331,3273856194,7,0,0,26624,7,1014895441
4713,3273748591,3422,3273752013,3,0,1,3584,3,9882654990
4714,3273872895,120692,3273993587,19,0,0,96256,19,10487807302
4715,3273920648,215364,3274136012,7,0,0,69120,7,8609838238
4716,3273924341,10757,3273935098,8,0,1,17408,8,10188307785
4717,3273933513,4937,3273938450,18,0,1,12800,18,3741128705
4718,3273945762,104107,3274049869,15,0,0,34816,15,2326523413
4719,3273970477,23668,3273994145,6,0,1,512,6,8742017021
4720,3273994494,89687,3274084181,3,0,0,2048,3,4622896224
4721,3274003708,6278,3274009986,0,0,1,6656,0,71895498
4722,3274018281,5196,3274023477,9,0,1,13312,9,6054525271
4723,3274021084,118531,3274139615,8,0,0,11776,8,670401142
4724,3274035462,106196,3274141658,16,0,0,6656,16,8456918219
4725,3274056690,44261,3274100951,10,0,0,512,10,4635718396
4726,3274061955,188997,3274250952,4,0,0,69632,4,1329745197
4727,3274105695,1042,3274106737,15,0,1,1024,15,3201316239
4728,3274106370,75612,3274181982,11,0,0,10752,11,7168658475
4729,3274168770,289092,3274457862,14,0,0,115200,14,4269857627
4730,3274172019,566,3274172585,14,0,1,512,14,6156196130
4731,3274182151,71123,3274253274,10,0,0,512,10,10583091623
4732,3274196221,5196,3274201417,0,0,1,13312,0,5708827733
4733,3274199411,159505,3274358916,0,0,0,18432,0,6570605507
4734,3274200787,132857,3274333644,15,0,0,66560,15,1759727997
4735,3274202576,161554,3274364130,7,0,0,9216,7,1737702144
4736,3274228442,22525,3274250967,1,0,1,3584,1,3042837471
4737,3274241653,12728,3274254381,15,0,1,3584,15,10363994113
4738,3274270889,216004,3274486893,11,0,0,95232,11,5869121278
4739,3274279694,4937,3274284631,18,0,1,12800,18,9454868318
4740,3274338460,566,3274339026,14,0,1,512,14,1700628442
4741,3274342999,2470,3274345469,8,0,1,2560,8,4835577308
4742,3274362718,3874,3274366592,14,0,1,2560,14,204957036
4743,3274368721,186903,3274555624,19,0,0,103936,19,5019611600
4744,3274378102,6278,3274384380,18,0,1,6656,18,7762132338
4745,3274484556,6491,3274491047,17,0,1,11264,17,1989132689
4746,3274486981,9187,3274496168,19,0,1,6144,19,6069020627
4747,3274538437,234471,3274772908,15,0,0,110080,15,9702201166
4748,3274546757,10402,3274557159,12,0,1,1536,12,8475741098
4749,3274559215,6488,3274565703,18,0,1,15872,18,1201669820
4750,3274649388,5326,3274654714,16,0,1,5632,16,6577576322
4751,3274715876,6278,3274722154,18,0,1,6656,18,8992676227
4752,3274790036,5326,3274795362,2,0,1,5632,2,2839439478
4753,3274822559,566,3274823125,16,0,1,512,16,8809555537
4754,3274822662,6856,3274829518,17,0,1,7168,17,9031250704
4755,3274850948,98876,3274949824,7,0,0,29696,7,10304402364
4756,3274896038,123893,3275019931,19,0,0,49664,19,9896128779
4757,3274912803,1994,3274914797,7,0,1,2048,7,4045360176
4758,3274941224,126770,3275067994,11,0,0,40448,11,8826464114
4759,3274955123,72884,3275028007,6,0,0,512,6,8337772103
4760,3274956860,70976,3275027836,0,0,0,8704,0,2786169707
4761,3274994292,146104,3275140396,1,0,0,45056,1,4297717094
4762,3275007613,12876,3275020489,1,0,1,512,1,7497675944
4763,3275053105,45596,3275098701,9,0,0,1024,9,6858335057
4764,3275068551,73732,3275142283,13,0,0,6144,13,10235423519
4765,3275085815,127319,3275213134,5,0,0,55808,5,3669026658
4766,3275090834,566,3275091400,11,0,1,512,11,1489540927
4767,3275177238,112268,3275289506,13,0,0,68608,13,259666901
4768,3275254930,189534,3275444464,7,0,0,20992,7,7169641913
4769,3275255010,101531,3275356541,6,0,0,512,6,1783049271
4770,3275261949,176096,3275438045,13,0,0,152064,13,10495656423
4771,3275274204,218921,3275493125,9,0,0,58368,9,835060549
4772,3275282385,165214,3275447599,1,0,0,10240,1,6060259973
4773,3275292161,2946,3275295107,9,0,1,3072,9,4054442786
4774,3275316846,66721,3275383567,10,0,1,113152,10,2629743580
4775,3275325233,168234,3275493467,17,0,0,512,17,5357703952
4776,3275331954,54519,3275386473,3,0,1,4608,3,9885025425
4777,3275385199,108097,3275493296,6,0,0,512,6,6265669019
4778,3275393434,150644,3275544078,1,0,0,37888,1,4288976322
4779,3275413682,130419,3275544101,10,0,1,143360,10,6835839398
4780,3275419508,192137,3275611645,19,0,0,15360,19,10047564668
4781,3275515804,118239,3275634043,10,0,0,2048,10,2443813784
4782,3275531394,341154,3275872548,3,0,0,42496,3,10468737086
4783,3275533033,86536,3275619569,13,0,0,512,13,914427438
4784,3275546430,358645,3275905075,1,0,0,20480,1,3573722263
4785,3275592222,164958,3275757180,0,0,1,267776,0,8729916349
4786,3275597070,277061,3275874131,11,0,0,5120,11,7955168639
4787,3275599194,161532,3275760726,4,0,1,5632,4,1958185765
4788,3275684754,80158,3275764912,18,0,1,6656,18,8572427339
4789,3275692826,271919,3275964745,5,0,0,28672,5,4546818398
4790,3275704741,410288,3276115029,9,0,0,33792,9,391944522
4791,3275714472,478332,3276192804,15,0,0,37376,15,7286877821
4792,3275724962,43176,3275768138,14,0,1,5120,14,2836366803
4793,3275731319,85429,3275816748,18,0,0,512,18,879359468
4794,3275732923,183740,3275916663,4,0,0,26624,4,2814353635
4795,3275809561,246614,3276056175,4,0,0,68608,4,3376626183
4796,3275840057,452380,3276292437,11,0,0,84480,11,9473955058
4797,3275856982,17164,3275874146,8,0,1,25088,8,5404266397
4798,3275863226,314096,3276177322,4,0,0,43520,4,860778734
4799,3275884890,314529,3276199419,1,0,0,7168,1,4363067240
4800,3275915664,1557,3275917221,17,0,1,512,17,8330258944
4801,3275917607,209200,3276126807,6,0,0,1024,6,6717189396
4802,3275936465,244928,3276181393,8,0,0,13312,8,7299894545
4803,3275940312,71329,3276011641,6,0,0,1536,6,1690311585
4804,3275969897,3898,3275973795,7,0,1,4096,7,8396567486
4805,3276009964,1994,3276011958,17,0,1,2048,17,2051436858
4806,3276072907,189721,3276262628,16,0,0,56832,16,1425538907
4807,3276078176,566,3276078742,10,0,1,512,10,3579662835
4808,3276080867,2470,3276083337,19,0,1,2560,19,9822262026
4809,3276115095,2870,3276117965,17,0,1,8704,17,2442055597
4810,3276172302,139190,3276311492,14,0,0,13312,14,10720624814
4811,3276182101,147493,3276329594,10,0,0,1024,10,4978391229
4812,3276194927,566,3276195493,4,0,1,512,4,5733197985
4813,3276217060,96445,3276313505,17,0,0,1024,17,6707713170
4814,3276257692,5970,3276263662,6,0,1,1024,6,1336021013
4815,3276295422,133611,3276429033,15,0,0,93184,15,7402253088
4816,3276350122,11533,3276361655,10,0,1,18944,10,9982359179
4817,3276411449,18142,3276429591,14,0,1,512,14,7737114604
4818,3276471285,80216,3276551501,7,0,0,13824,7,7467311431
4819,3276491357,208667,3276700024,7,0,0,26624,7,2784954842
4820,3276494527,157563,3276652090,19,0,0,97280,19,3394229575
4821,3276600877,5802,3276606679,14,0,1,6144,14,888006933
4822,3276605269,47016,3276652285,17,0,0,512,17,6794316863
4823,3276607725,67056,3276674781,14,0,0,1024,14,170637854
4824,3276635038,18248,3276653286,3,0,1,1024,3,8262687647
4825,3276635982,24280,3276660262,0,0,1,8192,0,7125060799
4826,3276643450,111956,3276755406,11,0,0,15360,11,8699091704
4827,3276655787,5141,3276660928,17,0,1,1024,17,4714372144
4828,3276714783,88520,3276803303,11,0,0,15872,11,4994453690
4829,3276786833,116168,3276903001,1,0,0,81408,1,4682879250
4830,3276799492,114579,3276914071,13,0,0,10752,13,6512201377
4831,3276806353,50672,3276857025,18,0,0,2560,18,9036195004
4832,3276934876,2946,3276937822,19,0,1,3072,19,6216187312
4833,3276937609,3387,3276940996,8,0,1,9728,8,4872032866
4834,3276948933,104312,3277053245,19,0,0,42496,19,2880731399
4835,3276956987,3422,3276960409,19,0,1,3584,19,3546828775
4836,3276967259,107058,3277074317,7,0,0,15872,7,2387688504
4837,3276987160,196207,3277183367,13,0,0,39936,13,1492332298
4838,3276992452,134611,3277127063,7,0,0,21504,7,3022614297
4839,3277009718,128487,3277138205,15,0,0,31744,15,9137399766
4840,3277046025,95390,3277141415,16,0,0,3072,16,947705179
4841,3277056755,2470,3277059225,1,0,1,2560,1,10053541942
4842,3277064671,43904,3277108575,6,0,0,512,6,2638100873
4843,3277093117,163924,3277257041,16,0,0,53760,16,3659967202
4844,3277137233,46560,3277183793,10,0,0,1024,10,5430769221
4845,3277195948,125779,3277321727,15,0,0,35840,15,6976633070
4846,3277268435,2470,3277270905,19,0,1,2560,19,9416713289
4847,3277283282,4850,3277288132,16,0,1,5120,16,1300210466
4848,3277284202,69973,3277354175,11,0,0,8192,11,291798692
4849,3277284894,202452,3277487346,9,0,0,54784,9,1046242946
4850,3277300363,42941,3277343304,0,0,1,70144,0,1899083584
4851,3277322726,81116,3277403842,8,0,1,131072,8,2410487556
4852,3277386476,263320,3277649796,1,0,0,26624,1,964580838
4853,3277398405,278973,3277677378,5,0,0,5120,5,7981574420
4854,3277476355,11549,3277487904,14,0,1,512,14,10393271155
4855,3277490074,105092,3277595166,5,0,0,45056,5,3425503471
4856,3277514155,2470,3277516625,4,0,1,2560,4,7377987237
4857,3277516533,90135,3277606668,17,0,0,1024,17,8690763162
4858,3277524311,5326,3277529637,17,0,1,5632,17,8858188853
4859,3277531282,102483,3277633765,15,0,0,8704,15,9300581808
4860,3277553730,198248,3277751978,12,0,0,21504,12,2025072977
4861,3277571280,1042,3277572322,3,0,1,1024,3,5997241572
4862,3277579928,566,3277580494,7,0,1,512,7,543380651
4863,3277664931,2470,3277667401,11,0,1,2560,11,9650517027
4864,3277702020,50597,3277752617,17,0,0,2048,17,4949235400
4865,3277752791,61760,3277814551,14,0,0,8704,14,6460878322
4866,3277754807,566,3277755373,19,0,1,512,19,5073512335
4867,3277756319,44453,3277800772,18,0,0,512,18,5723252369
4868,3277780026,109304,3277889330,16,0,0,58880,16,3877864528
4869,3277790239,72024,3277862263,10,0,1,116736,10,7452980636
4870,3277818459,83393,3277901852,1,0,0,3072,1,3913062320
4871,3277863128,2946,3277866074,14,0,1,3072,14,1224210300
4872,3277873096,100115,3277973211,6,0,0,3072,6,6910785281
4873,3277874183,15772,3277889955,15,0,1,512,15,90020611
4874,3277877011,13290,3277890301,18,0,1,512,18,8687681036
4875,3277887289,151610,3278038899,11,0,0,57344,11,3130290543
4876,3277895392,3645,3277899037,0,0,1,10240,0,4057475368
4877,3277941387,4374,3277945761,17,0,1,4608,17,6196911599
4878,3277956973,111941,3278068914,1,0,0,1536,1,7478598317
4879,3277971632,6754,3277978386,17,0,1,7168,17,6034758094
4880,3277993464,166640,3278160104,19,0,0,80384,19,10683364718
4881,3278006487,1042,3278007529,7,0,1,1024,7,5639207953
4882,3278025403,17925,3278043328,7,0,1,11776,7,1383741196
4883,3278038786,44842,3278083628,0,0,1,66560,0,4742924324
4884,3278076200,160138,3278236338,16,0,0,16384,16,1528189040
4885,3278083973,120641,3278204614,12,0,0,4608,12,7907962061
4886,3278089405,70870,3278160275,3,0,0,512,3,6805749848
4887,3278089642,566,3278090208,9,0,1,512,9,1863442316
4888,3278092092,166585,3278258677,9,0,0,11776,9,1787882216
4889,3278183058,36604,3278219662,0,0,1,64512,0,7684279015
4890,3278206031,19430,3278225461,10,0,1,27648,10,10705934796
4891,3278234074,149491,3278383565,5,0,0,12800,5,10059994481
4892,3278254421,253607,3278508028,9,0,0,42496,9,725805303
4893,3278277693,1518,3278279211,14,0,1,1536,14,1781230039
4894,3278284524,357832,3278642356,16,0,0,116224,16,6463792002
4895,3278302304,34279,3278336583,8,0,1,59904,8,1443159981
4896,3278354423,2870,3278357293,15,0,1,8704,15,1067589776
4897,3278360158,3904,3278364062,18,0,1,10752,18,5301899387
4898,3278381994,224935,3278606929,19,0,0,9216,19,5047021163
4899,3278388357,124054,3278512411,3,0,0,14336,3,6639194057
4900,3278435126,260207,3278695333,17,0,0,1024,17,9278257427
4901,3278465909,14287,3278480196,0,0,1,27648,0,6229834720
4902,3278476513,82719,3278559232,11,0,0,6656,11,2547177484
4903,3278481019,1042,3278482061,16,0,1,1024,16,232562561
4904,3278509432,238863,3278748295,19,0,0,31232,19,1283343267
4905,3278519119,175887,3278695006,16,0,0,62976,16,3300174013
4906,3278581124,4374,3278585498,16,0,1,4608,16,10022447238
4907,3278611215,124432,3278735647,1,0,0,19968,1,4696960916
4908,3278614369,142053,3278756422,1,0,0,26624,1,4521870084
4909,3278651560,112326,3278763886,6,0,0,4608,6,9773183608
4910,3278664271,118167,3278782438,13,0,0,32768,13,1389885487
4911,3278702106,4937,3278707043,16,0,1,12800,16,4516724388
4912,3278718811,92972,3278811783,8,0,0,15360,8,6898453438
4913,3278732532,23905,3278756437,1,0,1,8192,1,8069770348
4914,3278762918,91417,3278854335,7,0,0,1536,7,6736939075
4915,3278767672,14789,3278782461,0,0,1,20480,0,7200233668
4916,3278769412,81584,3278850996,0,0,0,3584,0,2988778644
4917,3278784972,3898,3278788870,6,0,1,4096,6,395570843
4918,3278829791,137566,3278967357,4,0,0,39424,4,559627362
4919,3278929088,1518,3278930606,5,0,1,1536,5,4192869557
4920,3278949453,45596,3278995049,17,0,0,1024,17,1096556736
4921,3279047771,45596,3279093367,17,0,0,1024,17,5698036402
4922,3279060365,566,3279060931,2,0,1,512,2,1588424570
4923,3279063250,296528,3279359778,12,0,0,350720,12,8908511407
4924,3279114764,278920,3279393684,12,0,0,108544,12,474805252
4925,3279132840,268862,3279401702,5,0,0,25600,5,273513466
4926,3279135066,1042,3279136108,19,0,1,1024,19,2762561715
4927,3279142221,6754,3279148975,3,0,1,7168,3,10417805336
4928,3279150631,15321,3279165952,10,0,1,29696,10,8812507150
4929,3279156132,13366,3279169498,4,0,1,5632,4,5524796005
4930,3279161280,199317,3279360597,4,0,0,2560,4,4548780382
4931,3279209241,6488,3279215729,9,0,1,15872,9,3631247326
4932,3279218005,175882,3279393887,17,0,0,512,17,7805425208
4933,3279257962,312735,3279570697,5,0,0,143872,5,547039403
4934,3279280168,296472,3279576640,7,0,0,19456,7,5350865209
4935,3279292774,108983,3279401757,10,0,1,7680,10,2630697525
4936,3279356335,48713,3279405048,4,0,1,9728,4,1920470927
4937,3279362196,44423,3279406619,16,0,1,2048,16,8289727779
4938,3279362551,45374,3279407925,5,0,1,2048,5,6073301211
4939,3279393884,14387,3279408271,6,0,1,512,6,5293097095
4940,3279393910,122200,3279516110,6,0,0,1024,6,8397862645
4941,3279422890,82502,3279505392,18,0,0,512,18,4588426424
4942,3279468978,43904,3279512882,18,0,0,512,18,4182502140
4943,3279494700,4374,3279499074,1,0,1,4608,1,4995332597
4944,3279515668,199272,3279714940,3,0,0,13824,3,9732098533
4945,3279610673,5196,3279615869,8,0,1,13312,8,57442526
4946,3279618994,4374,3279623368,4,0,1,4608,4,4083477013
4947,3279631333,103220,3279734553,5,0,0,38912,5,8884233051
4948,3279636009,121410,3279757419,7,0,0,27136,7,1081547311
4949,3279663264,113568,3279776832,15,0,0,3072,15,2674337504
4950,3279732538,8761,3279741299,8,0,1,7168,8,8405034963
4951,3279742590,566,3279743156,16,0,1,512,16,11749060
4952,3279770384,118348,3279888732,7,0,0,70656,7,7884676395
4953,3279779556,136048,3279915604,18,0,0,2048,18,4799620953
4954,3279844811,139697,3279984508,9,0,0,87040,9,10047480983
4955,3279851079,209926,3280061005,12,0,0,33280,12,4846581082
4956,3279873733,177117,3280050850,16,0,0,76800,16,8424606338
4957,3279881923,179269,3280061192,13,0,0,512,13,769519510
4958,3279947943,2870,3279950813,3,0,1,8704,3,1048855224
4959,3279971529,14030,3279985559,6,0,1,1024,6,10614286012
4960,3279979585,9618,3279989203,18,0,1,4608,18,3178771130
4961,3279990820,1042,3279991862,4,0,1,1024,4,9978003366
4962,3279996114,101298,3280097412,19,0,0,12800,19,9504938864
4963,3280007535,3128,3280010663,9,0,1,9216,9,3265861171
4964,3280023069,566,3280023635,5,0,1,512,5,7303361876
4965,3280032217,35212,3280067429,17,0,1,6656,17,10458932445
4966,3280039641,79257,3280118898,18,0,0,1536,18,9782813312
4967,3280071403,113495,3280184898,19,0,0,56832,19,3370930232
4968,3280093615,5307,3280098922,11,0,1,1536,11,2720736918
4969,3280115562,5196,3280120758,12,0,1,13312,12,9218700537
4970,3280155500,107900,3280263400,7,0,0,54272,7,4318304815
4971,3280158925,69284,3280228209,8,0,0,8192,8,2171574478
4972,3280197663,14545,3280212208,10,0,1,28160,10,1103109290
4973,3280216029,92539,3280308568,5,0,0,8704,5,7582376599
4974,3280284848,4374,3280289222,7,0,1,4608,7,2212285236
4975,3280300115,8468,3280308583,19,0,1,6656,19,903733028
4976,3280304859,48980,3280353839,17,0,0,2048,17,9868461684
4977,3280328906,3898,3280332804,4,0,1,4096,4,3997198700
4978,3280363052,23378,3280386430,0,0,1,41984,0,10033858524
4979,3280409354,150362,3280559716,16,0,0,77824,16,8305512362
4980,3280417283,70661,3280487944,7,0,0,3584,7,9452568886
4981,3280427385,219014,3280646399,7,0,0,30720,7,4434181580
4982,3280476910,2946,3280479856,2,0,1,3072,2,1949281478
4983,3280542024,105014,3280647038,17,0,0,2048,17,3586579438
4984,3280668250,43904,3280712154,6,0,0,512,6,10651239098
4985,3280713236,73058,3280786294,8,0,1,118784,8,3083795266
4986,3280714433,304108,3281018541,13,0,0,8192,13,8503952967
4987,3280730662,61124,3280791786,19,0,1,17920,19,6144462304
4988,3280735340,336331,3281071671,5,0,0,95744,5,8629603717
4989,3280747098,252107,3280999205,1,0,0,29184,1,4608606462
4990,3280815507,1042,3280816549,19,0,1,1024,19,10075061138
4991,3280829115,6488,3280835603,0,0,1,15872,0,8105948058
4992,3280847836,113645,3280961481,1,0,0,39936,1,7717175328
4993,3280866011,316058,3281182069,11,0,0,40960,11,3715079129
4994,3280893597,2946,3280896543,18,0,1,3072,18,7727603057
4995,3280927968,336319,3281264287,8,0,0,42496,8,1268543125
4996,3280936983,142058,3281079041,11,0,0,24064,11,1307515236
4997,3280993913,7754,3281001667,1,0,1,2560,1,6033743791
4998,3281013371,129006,3281142377,12,0,0,17920,12,1793064419
4999,3281026893,210880,3281237773,0,0,0,62464,0,9239401906
5000,3281035979,124085,3281160064,13,0,0,53248,13,10446545148
5001,3281038127,33559,3281071686,14,0,1,5120,14,2314589978
5002,3281047035,43781,3281090816,9,0,1,19456,9,1909736535
5003,3281052307,267796,3281320103,3,0,0,15872,3,5249670344
5004,3281081785,10017,3281091802,2,0,1,1536,2,6297569184
5005,3281094025,4850,3281098875,2,0,1,5120,2,5629461594
5006,3281163068,2946,3281166014,1,0,1,3072,1,9272125568
5007,3281210079,215433,3281425512,11,0,0,135680,11,8265572772
5008,3281255891,14207,3281270098,7,0,1,6144,7,7784313214
5009,3281258559,13165,3281271724,1,0,1,2560,1,8824996215
5010,3281280519,182712,3281463231,3,0,0,75264,3,2389950760
5011,3281314352,5766,3281320118,15,0,1,12288,15,3348625732
5012,3281388763,156735,3281545498,15,0,0,19968,15,8616172879
5013,3281416439,109715,3281526154,12,0,0,12288,12,9694764841
5014,3281431649,82064,3281513713,5,0,0,14848,5,5604751879
5015,3281454985,142386,3281597371,19,0,0,61440,19,164063165
5016,3281534299,63711,3281598010,17,0,0,2048,17,3411955887
5017,3281538253,64106,3281602359,14,0,0,9216,14,7575658646
5018,3281562290,217206,3281779496,15,0,0,211968,15,5244417295
5019,3281657427,5802,3281663229,3,0,1,6144,3,6603017667
5020,3281665521,159239,3281824760,19,0,0,55808,19,10224978773
5021,3281679516,4374,3281683890,2,0,1,4608,2,4984918968
5022,3281680920,144323,3281825243,10,0,0,1536,10,2375991736
5023,3281699663,83600,3281783263,12,0,0,12288,12,4998692910
5024,3281720184,105238,3281825422,17,0,0,512,17,277405004
5025,3281783921,45596,3281829517,9,0,0,1024,9,858948808
5026,3281812776,74975,3281887751,7,0,0,6144,7,4782176226
5027,3281849851,79148,3281928999,3,0,0,15360,3,10029081350
5028,3281879201,109540,3281988741,7,0,0,38912,7,4573751653
5029,3281899951,4374,3281904325,12,0,1,4608,12,5218567164
5030,3281901825,4446,3281906271,15,0,1,3072,15,10302818020
5031,3281905749,1994,3281907743,7,0,1,2048,7,6330234215
5032,3281942492,97136,3282039628,5,0,0,18944,5,6265330109
5033,3281944472,1518,3281945990,1,0,1,1536,1,2014874676
5034,3281946093,126925,3282073018,3,0,0,56832,3,10184155384
5035,3282091545,141962,3282233507,15,0,0,86528,15,5788179422
5036,3282265463,566,3282266029,16,0,1,512,16,8855943500
5037,3282301263,43904,3282345167,17,0,0,512,17,79974087
5038,3282308759,117884,3282426643,14,0,0,87040,14,6711542651
5039,3282324184,3904,3282328088,1,0,1,10752,1,4434231941
5040,3282327329,69464,3282396793,3,0,0,8192,3,9457690442
5041,3282343779,4850,3282348629,6,0,1,5120,6,1235266346
5042,3282345540,135253,3282480793,11,0,0,31744,11,3522808110
5043,3282406514,22591,3282429105,5,0,1,2560,5,9608095537
5044,3282441083,99494,3282540577,5,0,0,24064,5,4622093238
5045,3282463616,1994,3282465610,7,0,1,2048,7,6628365559
5046,3282476309,80474,3282556783,10,0,0,512,10,8912483532
5047,3282495504,6278,3282501782,11,0,1,6656,11,5975502965
5048,3282527364,13228,3282540592,0,0,1,18944,0,4740959558
5049,3282528913,362128,3282891041,8,0,0,63488,8,1073292912
5050,3282551100,207717,3282758817,0,0,0,18944,0,9640116513
5051,3282564094,238790,3282802884,18,0,0,1024,18,6766700737
5052,3282576892,176138,3282753030,7,0,0,67072,7,5340521411
5053,3282588285,252327,3282840612,1,0,0,66048,1,2008313517
5054,3282628678,5326,3282634004,19,0,1,5632,19,3283008382
5055,3282634956,301176,3282936132,16,0,0,14336,16,9607132656
5056,3282644362,371385,3283015747,12,0,0,6144,12,5195014139
5057,3282659043,243737,3282902780,16,0,0,38400,16,10566240190
5058,3282674370,3898,3282678268,7,0,1,4096,7,6969980556
5059,3282784177,361654,3283145831,8,0,0,34304,8,7632441277
5060,3282844388,4420,3282848808,19,0,1,11776,19,6010462139
5061,3282846098,107955,3282954053,0,0,0,48128,0,9559965489
5062,3282852695,3422,3282856117,11,0,1,3584,11,2788265949
5063,3282879631,247108,3283126739,15,0,0,57344,15,10093424559
5064,3282881575,23158,3282904733,6,0,1,2048,6,7441017476
5065,3282886446,163379,3283049825,12,0,0,17408,12,9644553491
5066,3282969403,176607,3283146010,10,0,0,512,10,6878060929
5067,3282987099,101420,3283088519,8,0,0,7168,8,743139854
5068,3282993183,165890,3283159073,14,0,0,1024,14,4852687820
5069,3283048701,187112,3283235813,19,0,0,86528,19,10442083208
5070,3283054502,240045,3283294547,8,0,0,91648,8,10082692896
5071,3283121171,10514,3283131685,9,0,1,12800,9,4059711753
5072,3283122879,10112,3283132991,17,0,1,2048,17,7576429812
5073,3283142720,8099,3283150819,19,0,1,5120,19,10096563707
5074,3283194968,149229,3283344197,5,0,0,26624,5,9127568041
5075,3283213381,81509,3283294890,18,0,0,1024,18,10437998417
5076,3283267876,28491,3283296367,15,0,1,1536,15,6417031292
5077,3283277908,20405,3283298313,3,0,1,3072,3,9785544639
5078,3283353485,74228,3283427713,3,0,0,14336,3,8468839218
5079,3283376060,100902,3283476962,12,0,0,23552,12,5536774296
5080,3283383524,2470,3283385994,14,0,1,2560,14,9195654069
5081,3283393631,168861,3283562492,9,0,0,76288,9,5186271285
5082,3283401578,105335,3283506913,5,0,0,19968,5,4823362510
5083,3283416539,290578,3283707117,5,0,0,54272,5,4044507928
5084,3283450600,163101,3283613701,19,0,0,45568,19,8554224126
5085,3283454790,1042,3283455832,1,0,1,1024,1,9045335334
5086,3283491704,3904,3283495608,11,0,1,10752,11,8146514143
5087,3283559509,283321,3283842830,7,0,0,43008,7,1825303648
5088,3283564963,2470,3283567433,9,0,1,2560,9,4071804414
5089,3283585916,139780,3283725696,11,0,0,60928,11,6527638115
5090,3283615466,161269,3283776735,5,0,0,54784,5,8582966287
5091,3283674212,295977,3283970189,9,0,0,56832,9,9024398459
5092,3283695453,116251,3283811704,12,0,0,8192,12,3499709736
5093,3283746345,4850,3283751195,10,0,1,5120,10,5497125400
5094,3283752140,90861,3283843001,18,0,0,512,18,10092009900
5095,3283788979,163879,3283952858,3,0,0,104448,3,3553485330
5096,3283904033,566,3283904599,12,0,1,512,12,3838500870
5097,3283914630,86588,3284001218,4,0,0,18944,4,1221467825
5098,3283939809,35715,3283975524,11,0,1,5632,11,1434633756
5099,3283942816,39855,3283982671,1,0,1,17408,1,3353738224
5100,3284024647,11016,3284035663,10,0,1,17920,10,603323064
5101,3284038548,83783,3284122331,8,0,0,512,8,4936271879
5102,3284102032,57440,3284159472,15,0,0,4608,15,7458354028
5103,3284162696,3904,3284166600,5,0,1,10752,5,614869378
5104,3284165255,112033,3284277288,5,0,0,60416,5,2838021851
5105,3284206453,130289,3284336742,9,0,0,22528,9,518538934
5106,3284207449,6754,3284214203,17,0,1,7168,17,2901429
5107,3284210345,305092,3284515437,13,0,0,45056,13,1683548620
5108,3284222047,124382,3284346429,1,0,0,31744,1,4551782406
5109,3284226685,97517,3284324202,19,0,0,1536,19,3782777354
5110,3284228625,1518,3284230143,7,0,1,1536,7,5128966648
5111,3284251208,153630,3284404838,18,0,0,512,18,6133247261
5112,3284265324,139343,3284404667,16,0,0,16896,16,3591456374
5113,3284274176,10852,3284285028,6,0,1,8192,6,5273854766
5114,3284277218,189622,3284466840,7,0,0,80384,7,4874407598
5115,3284306033,2946,3284308979,0,0,1,3072,0,56590672
5116,3284332036,15444,3284347480,1,0,1,1024,1,10654602326
5117,3284340645,207567,3284548212,16,0,0,107520,16,5828715665
5118,3284387961,566,3284388527,19,0,1,512,19,4453292677
5119,3284392628,304451,3284697079,5,0,0,45056,5,128889535
5120,3284399293,221069,3284620362,8,0,0,12288,8,2665293758
5121,3284410439,255655,3284666094,15,0,0,131072,15,6340862562
5122,3284439866,176737,3284616603,11,0,0,24064,11,6871377997
5123,3284456082,13878,3284469960,2,0,1,9216,2,190671787
5124,3284521032,240432,3284761464,12,0,0,7168,12,1425992018
5125,3284539737,163918,3284703655,16,0,0,6144,16,10037726404
5126,3284546144,181961,3284728105,9,0,0,4608,9,2926324700
5127,3284612822,201407,3284814229,5,0,0,125952,5,1448569762
5128,3284669321,566,3284669887,9,0,1,512,9,8963874123
5129,3284729108,566,3284729674,11,0,1,512,11,6639813032
5130,3284738870,3898,3284742768,4,0,1,4096,4,9204606822
5131,3284748844,99195,3284848039,14,0,0,24064,14,8513568959
5132,3284761350,129319,3284890669,13,0,0,84992,13,6117534445
5133,3284764562,566,3284765128,15,0,1,512,15,7360184979
5134,3284782259,33497,3284815756,9,0,1,1536,9,3522110197
5135,3284798298,22896,3284821194,3,0,1,15872,3,6966925789
5136,3284819645,158436,3284978081,13,0,0,53760,13,2459107349
5137,3284830776,185099,3285015875,12,0,0,15360,12,310957141
5138,3284840017,8037,3284848054,11,0,1,1536,11,153201875
5139,3284853712,162334,3285016046,6,0,0,512,6,6228706909
5140,3284860478,274896,3285135374,15,0,0,36352,15,6128033242
5141,3284907208,3387,3284910595,14,0,1,9728,14,2285301319
5142,3284928655,159678,3285088333,13,0,0,83968,13,1232357279
5143,3284942691,1994,3284944685,3,0,1,2048,3,135632344
5144,3284952189,183386,3285135575,18,0,0,512,18,3493626906
5145,3284954970,1042,3284956012,2,0,1,1024,2,1892606054
5146,3284985239,191504,3285176743,13,0,0,30208,13,121977866
5147,3284988146,12049,3285000195,10,0,1,19968,10,6656663341
5148,3285015706,232780,3285248486,8,0,0,133120,8,8947867122
5149,3285021647,227634,3285249281,5,0,0,2560,5,2724186610
5150,3285040084,3128,3285043212,16,0,1,9216,16,1497881636
5151,3285065913,29642,3285095555,4,0,1,7680,4,4717973256
5152,3285090367,5854,3285096221,1,0,1,1024,1,8600471547
5153,3285096419,566,3285096985,14,0,1,512,14,1032285185
5154,3285122256,13133,3285135389,14,0,1,5120,14,6449399976
5155,3285122970,12434,3285135404,12,0,1,5120,12,428906936
5156,3285157974,3904,3285161878,10,0,1,10752,10,6454825493
5157,3285176604,3001,3285179605,3,0,1,8704,3,1172089873
5158,3285195971,165292,3285361263,13,0,0,4608,13,2118285229
5159,3285238238,75947,3285314185,10,0,1,109568,10,205808320
5160,3285281369,103030,3285384399,11,0,0,1536,11,5343340329
5161,3285320356,2470,3285322826,6,0,1,2560,6,6061372282
5162,3285327814,6754,3285334568,18,0,1,7168,18,9642631533
5163,3285381765,230117,3285611882,5,0,0,55808,5,10374557270
5164,3285396717,130953,3285527670,7,0,0,28672,7,4469459107
5165,3285415757,566,3285416323,5,0,1,512,5,1422448967
5166,3285432531,5326,3285437857,2,0,1,5632,2,6850845954
5167,3285466999,3898,3285470897,16,0,1,4096,16,1295640174
5168,3285535406,247693,3285783099,11,0,0,84992,11,833294985
5169,3285541138,13770,3285554908,0,0,1,26624,0,7157350242
5170,3285564626,104106,3285668732,7,0,0,19456,7,185154177
5171,3285583001,68060,3285651061,19,0,0,9216,19,5210164463
5172,3285583262,2870,3285586132,16,0,1,8704,16,2194133846
5173,3285623550,6278,3285629828,18,0,1,6656,18,6546757923
5174,3285627628,70787,3285698415,1,0,0,8704,1,1940574803
5175,3285686854,57939,3285744793,18,0,0,2048,18,6155677928
5176,3285689553,61872,3285751425,13,0,0,5120,13,5649159731
5177,3285798466,3387,3285801853,15,0,1,9728,15,3660005013
5178,3285799619,7186,3285806805,4,0,1,5632,4,5570775225
5179,3285817121,5326,3285822447,15,0,1,5632,15,7740904538
5180,3285820991,2762,3285823753,11,0,1,2048,11,10156749517
5181,3285828859,174233,3286003092,15,0,0,40960,15,2814832126
5182,3285830477,47288,3285877765,17,0,0,1536,17,10462347031
5183,3285855837,134760,3285990597,5,0,0,36352,5,4224076307
5184,3285880702,199342,3286080044,11,0,0,35328,11,4366243118
5185,3285945575,2946,3285948521,1,0,1,3072,1,3901530168
5186,3285967635,566,3285968201,19,0,1,512,19,2613189633
5187,3285968012,125307,3286093319,5,0,0,43520,5,3486162777
5188,3286019538,127028,3286146566,12,0,0,96256,12,4894544532
5189,3286081633,15117,3286096750,9,0,1,3584,9,1305970294
5190,3286086830,197010,3286283840,14,0,0,136704,14,8034332296
5191,3286152591,161022,3286313613,13,0,0,21504,13,1806314176
5192,3286156541,3387,3286159928,5,0,1,9728,5,2939491778
5193,3286198629,85866,3286284495,6,0,0,2048,6,6770243869
5194,3286198983,85691,3286284674,6,0,0,512,6,959332702
5195,3286209368,1518,3286210886,14,0,1,1536,14,8600707973
5196,3286223019,1518,3286224537,6,0,1,1536,6,5290732075
5197,3286249236,37867,3286287103,16,0,1,2560,16,5144640865
5198,3286262259,121698,3286383957,3,0,0,28672,3,10387613027
5199,3286275368,85693,3286361061,6,0,0,3584,6,10079001003
5200,3286335971,3387,3286339358,17,0,1,9728,17,9361495876
5201,3286344707,11533,3286356240,17,0,1,18944,17,4896105158
5202,3286407682,146812,3286554494,15,0,0,73728,15,1675693708
5203,3286417252,4850,3286422102,5,0,1,5120,5,5293887967
5204,3286428904,72668,3286501572,15,0,0,9216,15,8218067047
5205,3286430189,92551,3286522740,18,0,0,1024,18,10161250004
5206,3286439733,7230,3286446963,2,0,1,7680,2,8340499022
5207,3286446453,4162,3286450615,17,0,1,11264,17,630984151
5208,3286463676,148396,3286612072,3,0,0,13312,3,8969579132
5209,3286491194,95810,3286587004,1,0,0,6656,1,6355863026
5210,3286511549,57440,3286568989,19,0,0,4608,19,4882487822
5211,3286516125,13083,3286529208,0,0,1,22016,0,6851928997
5212,3286549567,118599,3286668166,9,0,0,45056,9,8259427262
5213,3286562270,63450,3286625720,10,0,1,103424,10,4368640321
5214,3286568168,68996,3286637164,10,0,1,46592,10,5807878344
5215,3286649012,19169,3286668181,14,0,1,8192,14,1230876628
5216,3286668786,2946,3286671732,4,0,1,3072,4,1326507306
5217,3286722354,135244,3286857598,1,0,0,38912,1,6841010070
5218,3286767108,194128,3286961236,14,0,0,46592,14,10090263263
5219,3286832418,4374,3286836792,1,0,1,4608,1,2721916741
5220,3286853319,108088,3286961407,18,0,0,512,18,506694925
5221,3286914972,5802,3286920774,1,0,1,6144,1,6908054666
5222,3286916339,7981,3286924320,14,0,1,5632,14,676228078
5223,3286944433,566,3286944999,2,0,1,512,2,85006789
5224,3286985297,2470,3286987767,6,0,1,2560,6,4020273207
5225,3286995826,13253,3287009079,0,0,1,25600,0,1977021684
5226,3286998019,19960,3287017979,0,0,1,27648,0,4766539462
5227,3287001613,19912,3287021525,9,0,1,5632,9,9154639096
5228,3287050640,182566,3287233206,0,0,0,4608,0,6956715375
5229,3287062073,6278,3287068351,4,0,1,6656,4,3418103372
5230,3287163553,3422,3287166975,17,0,1,3584,17,7054091362
5231,3287185408,82844,3287268252,4,0,0,17408,4,996421397
5232,3287199227,76423,3287275650,17,0,0,512,17,1263778909
5233,3287210927,1994,3287212921,19,0,1,2048,19,8644893530
5234,3287238729,7230,3287245959,15,0,1,7680,15,8245861096
5235,3287258769,9498,3287268267,6,0,1,12800,6,6300322001
5236,3287265491,5638,3287271129,12,0,1,8704,12,6823792253
5237,3287270531,4803,3287275334,15,0,1,4608,15,8953597305
5238,3287328819,5196,3287334015,6,0,1,13312,6,6039170444
5239,3287330478,183487,3287513965,5,0,0,27136,5,4104161929
5240,3287358139,254917,3287613056,1,0,0,10240,1,4509103372
5241,3287397216,5802,3287403018,18,0,1,6144,18,9656771268
5242,3287430443,3645,3287434088,3,0,1,10240,3,5223496986
5243,3287434637,126902,3287561539,8,0,0,10752,8,6755798692
5244,3287449528,20624,3287470152,8,0,1,33280,8,1466895929
5245,3287537264,51257,3287588521,8,0,1,82944,8,9696197427
5246,3287544652,45175,3287589827,16,0,1,2048,16,2389177301
5247,3287557052,250091,3287807143,12,0,0,19456,12,4509365573
5248,3287578735,77226,3287655961,17,0,0,512,17,8791726447
5249,3287582259,7824,3287590083,6,0,1,9216,6,7642399926
5250,3287594903,204900,3287799803,9,0,0,7168,9,5382342094
5251,3287596791,140591,3287737382,19,0,0,31232,19,8802835984
5252,3287601765,193823,3287795588,4,0,0,12800,4,7502399792
5253,3287603528,15579,3287619107,10,0,1,30208,10,6722352621
5254,3287625974,1518,3287627492,10,0,1,1536,10,7145075455
5255,3287662509,242701,3287905210,15,0,0,10240,15,4933635885
5256,3287665537,1042,3287666579,16,0,1,1024,16,9392788809
5257,3287668491,4374,3287672865,18,0,1,4608,18,2080293940
5258,3287692450,137245,3287829695,6,0,0,1024,6,3751973106
5259,3287720084,140439,3287860523,11,0,0,50176,11,6697031504
5260,3287797664,104411,3287902075,18,0,0,1536,18,3553942953
5261,3287818522,1042,3287819564,15,0,1,1024,15,7181661777
5262,3287824997,114387,3287939384,11,0,0,24064,11,4681159407
5263,3287885483,2870,3287888353,6,0,1,8704,6,2877858228
5264,3287898652,74360,3287973012,12,0,0,9728,12,893493479
5265,3287933098,134479,3288067577,3,0,0,61952,3,1508068003
5266,3287947349,1518,3287948867,17,0,1,1536,17,7109334568
5267,3287960418,12995,3287973413,2,0,1,25088,2,1513414581
5268,3287999856,95703,3288095559,14,0,0,13824,14,3510989206
5269,3288067432,2607,3288070039,19,0,1,2560,19,4293656650
5270,3288084245,57222,3288141467,16,0,0,1024,16,10636194250
5271,3288090124,1042,3288091166,15,0,1,1024,15,2796243728
5272,3288092118,4475,3288096593,12,0,1,1024,12,247864620
5273,3288130028,105872,3288235900,0,0,0,47616,0,8522704848
5274,3288161430,1994,3288163424,6,0,1,2048,6,6797199395
5275,3288181718,2470,3288184188,19,0,1,2560,19,160173457
5276,3288183376,4374,3288187750,18,0,1,4608,18,3136110652
5277,3288221073,201543,3288422616,10,0,0,1024,10,4250979782
5278,3288240557,4374,3288244931,16,0,1,4608,16,5965297458
5279,3288307558,100256,3288407814,8,0,0,29184,8,1207956406
5280,3288342593,162929,3288505522,0,0,0,31744,0,5447450151
5281,3288344240,103844,3288448084,12,0,0,40960,12,8634278466
5282,3288398827,9002,3288407829,15,0,1,2560,15,1826659647
5283,3288415077,99008,3288514085,16,0,0,25088,16,3963287709
5284,3288415841,3898,3288419739,18,0,1,4096,18,8174221806
5285,3288421645,3128,3288424773,3,0,1,9216,3,8746647244
5286,3288438761,189323,3288628084,13,0,0,7680,13,6923072981
5287,3288515573,3904,3288519477,3,0,1,10752,3,4872603638
5288,3288522667,1042,3288523709,3,0,1,1024,3,9917375279
5289,3288542413,1042,3288543455,16,0,1,1024,16,4689431311
5290,3288545026,101660,3288646686,11,0,0,33792,11,7060846641
5291,3288549282,3422,3288552704,12,0,1,3584,12,5857663974
5292,3288552429,1994,3288554423,4,0,1,2048,4,7608153737
5293,3288559396,1518,3288560914,14,0,1,1536,14,10030082371
5294,3288578226,1042,3288579268,7,0,1,1024,7,6831723921
5295,3288601433,13858,3288615291,0,0,1,23552,0,5820521192
5296,3288622264,7706,3288629970,16,0,1,8192,16,1891270228
5297,3288635689,100568,3288736257,1,0,0,30208,1,3046012144
5298,3288641166,51108,3288692274,17,0,0,1024,17,4793043296
5299,3288655517,62818,3288718335,18,0,0,512,18,5603726881
5300,3288696662,285530,3288982192,16,0,0,31744,16,7734228178
5301,3288747532,74608,3288822140,8,0,1,121856,8,9089690801
5302,3288786767,109118,3288895885,7,0,0,28672,7,8059289745
5303,3288794007,128122,3288922129,11,0,0,7168,11,3082421151
5304,3288804983,22342,3288827325,2,0,1,16384,2,7691798121
5305,3288809558,23873,3288833431,5,0,1,20992,5,2207140109
5306,3288820874,188876,3289009750,15,0,0,5120,15,3470616563
5307,3288848565,212054,3289060619,12,0,0,68608,12,7475534918
5308,3288849584,1042,3288850626,18,0,1,1024,18,2550585889
5309,3288902262,1518,3288903780,1,0,1,1536,1,2231357244
5310,3288925059,566,3288925625,17,0,1,512,17,7895381184
5311,3288931104,6754,3288937858,5,0,1,7168,5,4566539210
5312,3288934082,187793,3289121875,1,0,0,64512,1,9685878193
5313,3288967887,96179,3289064066,12,0,0,11264,12,3599273140
5314,3288978464,7365,3288985829,8,0,1,10240,8,1431247032
5315,3288994432,1042,3288995474,18,0,1,1024,18,7155279083
5316,3289001265,165969,3289167234,14,0,0,2048,14,5887937078
5317,3289058965,15867,3289074832,15,0,1,17408,15,8667820895
5318,3289060936,15202,3289076138,14,0,1,2048,14,1157390832
5319,3289066241,10243,3289076484,4,0,1,512,4,3485866716
5320,3289119456,5357,3289124813,7,0,1,3072,7,8098927487
5321,3289146679,6488,3289153167,6,0,1,15872,6,8739059224
5322,3289192849,3128,3289195977,5,0,1,9216,5,2396222430
5323,3289203989,41908,3289245897,10,0,1,68096,10,10453545238
5324,3289224773,86467,3289311240,10,0,1,144896,10,10074488045
5325,3289341933,4850,3289346783,6,0,1,5120,6,2567725757
5326,3289398350,5326,3289403676,14,0,1,5632,14,6267786504
5327,3289400778,278890,3289679668,5,0,0,151040,5,3824547804
5328,3289443980,181740,3289625720,4,0,0,36352,4,1962316236
5329,3289449917,11016,3289460933,0,0,1,17920,0,6586040776
5330,3289462252,4850,3289467102,6,0,1,5120,6,3512771470
5331,3289519199,11533,3289530732,14,0,1,18944,14,5095828677
5332,3289532275,157251,3289689526,8,0,0,32256,8,6156736843
5333,3289586491,2946,3289589437,1,0,1,3072,1,221108523
5334,3289591480,98537,3289690017,18,0,0,1536,18,5720721693
5335,3289628974,129451,3289758425,5,0,0,27648,5,10675029666
5336,3289630615,49068,3289679683,16,0,1,3584,16,6071801610
5337,3289654180,39218,3289693398,8,0,1,3584,8,8818658829
5338,3289697027,108528,3289805555,8,0,0,14848,8,5640998763
5339,3289719509,141151,3289860660,8,0,0,28160,8,2741091780
5340,3289738908,59516,3289798424,17,0,0,512,17,778245117
5341,3289768923,5326,3289774249,15,0,1,5632,15,6941252208
5342,3289777374,5326,3289782700,2,0,1,5632,2,7883972028
5343,3289798637,102596,3289901233,11,0,0,36864,11,10512883708
5344,3289838159,566,3289838725,4,0,1,512,4,7777457526
5345,3289865840,6229,3289872069,2,0,1,15360,2,5801874893
5346,3289887480,239746,3290127226,13,0,0,82944,13,793892771
5347,3289898866,59012,3289957878,8,0,0,1536,8,5523943367
5348,3289936346,5802,3289942148,7,0,1,6144,7,9763453226
5349,3290033429,129642,3290163071,8,0,0,37376,8,8837087962
5350,3290084302,83932,3290168234,1,0,0,16896,1,9376525734
5351,3290143229,2470,3290145699,19,0,1,2560,19,10126844089
5352,3290144381,1984,3290146365,12,0,1,1024,12,6618651780
5353,3290169349,3422,3290172771,9,0,1,3584,9,6973781003
5354,3290169384,14431,3290183815,0,0,1,22528,0,4190745597
5355,3290296806,2870,3290299676,4,0,1,8704,4,10429517715
5356,3290332457,118664,3290451121,8,0,0,89600,8,4946934673
5357,3290342368,131243,3290473611,7,0,0,17920,7,829656760
5358,3290342431,147122,3290489553,19,0,0,51200,19,8108066529
5359,3290396442,1518,3290397960,2,0,1,1536,2,7320809394
5360,3290405426,5326,3290410752,6,0,1,5632,6,924731252
5361,3290409177,85798,3290494975,18,0,0,512,18,5710622224
5362,3290422896,51042,3290473938,18,0,0,1024,18,10090300738
5363,3290442962,10145,3290453107,1,0,1,2048,1,1868836481
5364,3290460353,61899,3290522252,10,0,1,100352,10,9864362712
5365,3290473892,110462,3290584354,17,0,0,512,17,7303470831
5366,3290504728,110177,3290614905,12,0,0,15360,12,4748824584
5367,3290514304,9574,3290523878,7,0,1,2560,7,1319562383
5368,3290522071,162283,3290684354,18,0,0,512,18,9228722981
5369,3290582146,124054,3290706200,10,0,0,512,10,5963177550
5370,3290592012,1994,3290594006,15,0,1,2048,15,10365625954
5371,3290680121,6278,3290686399,16,0,1,6656,16,5884606637
5372,3290698737,100412,3290799149,13,0,0,29696,13,6790923260
5373,3290746655,125232,3290871887,7,0,0,40448,7,2758889950
5374,3290754072,566,3290754638,11,0,1,512,11,766464712
5375,3290762702,53753,3290816455,8,0,1,91136,8,3272914326
5376,3290839105,3128,3290842233,10,0,1,9216,10,6031566496
5377,3290865903,112970,3290978873,12,0,0,3072,12,6128469344
5378,3290870270,183170,3291053440,8,0,0,12288,8,8962363844
5379,3290882651,5971,3290888622,6,0,1,14848,6,681808821
5380,3290887927,12566,3290900493,17,0,1,20992,17,1033464857
5381,3290893854,7625,3290901479,5,0,1,1536,5,5835687810
5382,3290903528,566,3290904094,7,0,1,512,7,5908415059
5383,3290959665,43904,3291003569,10,0,0,512,10,7886431121
5384,3291005684,1518,3291007202,1,0,1,1536,1,10438147132
5385,3291006903,4850,3291011753,3,0,1,5120,3,6310784505
5386,3291032372,5196,3291037568,12,0,1,13312,12,6152669317
5387,3291045525,3422,3291048947,19,0,1,3584,19,609968553
5388,3291080436,161264,3291241700,3,0,0,12288,3,10375354603
5389,3291088715,116012,3291204727,3,0,0,80896,3,2609963372
5390,3291108467,10757,3291119224,3,0,1,17408,3,1137886986
5391,3291135205,70446,3291205651,13,0,0,1024,13,9101923965
5392,3291157270,134554,3291291824,4,0,0,55808,4,5704553548
5393,3291235296,78290,3291313586,14,0,0,5120,14,8996492924
5394,3291240187,4927,3291245114,4,0,1,3584,4,8053951968
5395,3291254371,37468,3291291839,10,0,1,52736,10,5608432584
5396,3291300787,2470,3291303257,10,0,1,2560,10,10102319955
5397,3291302029,140939,3291442968,5,0,0,98816,5,434792635
5398,3291311180,224536,3291535716,5,0,0,12800,5,9089664488
5399,3291369841,126389,3291496230,0,0,0,50688,0,4709675706
5400,3291429824,109369,3291539193,18,0,0,2048,18,568632030
5401,3291453287,208549,3291661836,15,0,0,1024,15,9341283048
5402,3291473299,65255,3291538554,7,0,0,9216,7,2370065267
5403,3291487730,10486,3291498216,19,0,1,2048,19,3625326897
5404,3291503544,3422,3291506966,5,0,1,3584,5,2659275825
5405,3291503886,113700,3291617586,13,0,0,38400,13,6862857161
5406,3291531183,4548,3291535731,4,0,1,2048,4,1192360250
5407,3291584995,105715,3291690710,7,0,0,32768,7,9891102696
5408,3291615192,5808,3291621000,18,0,1,3584,18,509975506
5409,3291647952,119261,3291767213,7,0,0,59904,7,8720252342
5410,3291671518,77428,3291748946,5,0,0,15360,5,1620950385
5411,3291837834,566,3291838400,14,0,1,512,14,4920342908
5412,3291846726,146810,3291993536,4,0,0,123904,4,5104026710
5413,3291859812,139223,3291999035,4,0,0,17920,4,3928011228
5414,3291892934,201192,3292094126,13,0,0,111616,13,4597847475
5415,3291933226,107248,3292040474,13,0,0,36352,13,163613069
5416,3291974966,49732,3292024698,8,0,1,46592,8,260918195
5417,3291976705,49299,3292026004,6,0,1,2048,6,5781952233
5418,3291986349,152093,3292138442,8,0,1,205824,8,4673897859
5419,3292026882,111906,3292138788,7,0,1,512,7,6233254040
5420,3292035484,105890,3292141374,15,0,1,4096,15,3132408910
5421,3292068701,252262,3292320963,3,0,0,36864,3,8215517024
5422,3292086966,58274,3292145240,14,0,1,6144,14,7552239773
5423,3292105260,46086,3292151346,6,0,1,29184,6,9518597056
5424,3292133747,17753,3292151500,4,0,1,8704,4,3865561101
5425,3292180618,158338,3292338956,8,0,0,37888,8,2178792421
5426,3292267917,220510,3292488427,11,0,0,21504,11,5468998925
5427,3292324547,51516,3292376063,8,0,1,83456,8,9065788312
5428,3292348458,28271,3292376729,3,0,1,1024,3,8210360815
5429,3292488796,131866,3292620662,19,0,0,26112,19,10526240
5430,3292543031,4937,3292547968,10,0,1,12800,10,4942629413
5431,3292660332,43904,3292704236,6,0,0,512,6,9592052232
5432,3292683312,4679,3292687991,5,0,1,12288,5,5604251871
5433,3292693480,4374,3292697854,5,0,1,4608,5,1384982985
5434,3292722043,1042,3292723085,18,0,1,1024,18,6732785632
5435,3292726197,5802,3292731999,18,0,1,6144,18,1617102434
5436,3292748205,566,3292748771,3,0,1,512,3,2535161070
5437,3292767353,5454,3292772807,4,0,1,13824,4,3080949774
5438,3292807307,125862,3292933169,15,0,0,59904,15,3014423832
5439,3292820572,160727,3292981299,15,0,0,49152,15,2814124975
5440,3292823553,142755,3292966308,13,0,0,32256,13,2613809309
5441,3292831973,173269,3293005242,8,0,0,7680,8,2654899903
5442,3292871337,71182,3292942519,17,0,0,512,17,10528051860
5443,3292890711,95751,3292986462,7,0,0,16896,7,2180143667
5444,3292932857,1822,3292934679,12,0,1,1536,12,7146911313
5445,3292935874,1994,3292937868,3,0,1,2048,3,9455752129
5446,3292947931,7706,3292955637,12,0,1,8192,12,2752540122
5447,3293022651,43904,3293066555,17,0,0,512,17,2996661360
5448,3293024170,52364,3293076534,14,0,0,3072,14,4672312307
5449,3293047205,139084,3293186289,1,0,0,18944,1,5882267540
5450,3293093236,566,3293093802,4,0,1,512,4,7195964127
5451,3293112627,10241,3293122868,5,0,1,16384,5,1609227081
5452,3293195010,105560,3293300570,5,0,0,46592,5,6411903108
5453,3293209129,107376,3293316505,1,0,0,52224,1,4232780305
5454,3293211698,1518,3293213216,18,0,1,1536,18,264917147
5455,3293244230,3898,3293248128,5,0,1,4096,5,6141072962
5456,3293269343,2470,3293271813,5,0,1,2560,5,7578115161
5457,3293287404,33222,3293320626,0,0,1,11264,0,4008447568
5458,3293304132,18743,3293322875,7,0,1,3072,7,129461286
5459,3293339347,5326,3293344673,18,0,1,5632,18,10427418229
5460,3293341494,11533,3293353027,3,0,1,18944,3,10712855330
5461,3293355331,60824,3293416155,0,0,0,5632,0,6405953477
5462,3293369612,139208,3293508820,16,0,0,18432,16,2793729409
5463,3293380759,224979,3293605738,1,0,0,108544,1,10581480308
5464,3293401282,52364,3293453646,10,0,0,3072,10,10410718769
5465,3293403983,4850,3293408833,1,0,1,5120,1,1767960066
5466,3293413475,7706,3293421181,18,0,1,8192,18,7215742906
5467,3293425060,3904,3293428964,16,0,1,10752,16,5983478364
5468,3293497845,108088,3293605933,10,0,0,512,10,1097436265
5469,3293523375,189807,3293713182,8,0,0,30720,8,7724057854
5470,3293539377,72584,3293611961,15,0,0,1536,15,3631756162
5471,3293546277,110401,3293656678,14,0,0,16384,14,1909253240
5472,3293556041,4850,3293560891,5,0,1,5120,5,9534615578
5473,3293557998,137032,3293695030,19,0,0,71680,19,374771347
5474,3293561888,44060,3293605948,0,0,1,60416,0,7166090720
5475,3293570439,36986,3293607425,14,0,1,1536,14,10488639137
5476,3293586010,264726,3293850736,12,0,0,72192,12,773521103
5477,3293586927,20844,3293607771,1,0,1,512,1,4722860068
5478,3293606098,89259,3293695357,6,0,0,1024,6,5668593642
5479,3293611208,209666,3293820874,8,0,0,18432,8,7000083272
5480,3293634157,7706,3293641863,5,0,1,8192,5,7522871981
5481,3293656813,5802,3293662615,18,0,1,6144,18,6140047361
5482,3293803869,102752,3293906621,13,0,0,37376,13,7055964767
5483,3293840347,259331,3294099678,19,0,0,72704,19,1984147118
5484,3293870443,5971,3293876414,18,0,1,14848,18,5801791491
5485,3293881737,43904,3293925641,6,0,0,512,6,7003847661
5486,3293899339,176665,3294076004,17,0,0,1536,17,8882299566
5487,3293912094,163427,3294075521,1,0,0,140800,1,6321686353
5488,3293933170,143332,3294076502,10,0,0,1024,10,1782648521
5489,3293937809,3898,3293941707,11,0,1,4096,11,6794295570
5490,3293950439,13512,3293963951,8,0,1,26112,8,8744474841
5491,3293964471,111704,3294076175,18,0,0,512,18,7727935138
5492,3294060710,225242,3294285952,8,0,0,39936,8,8448426736
5493,3294072300,27393,3294099693,4,0,1,2560,4,7678506802
5494,3294147788,87632,3294235420,15,0,0,23040,15,2137128811
5495,3294162212,1042,3294163254,17,0,1,1024,17,5416681080
5496,3294168204,54056,3294222260,11,0,0,3584,11,7795471517
5497,3294171065,123950,3294295015,8,0,0,29696,8,6189760831
5498,3294210578,3128,3294213706,7,0,1,9216,7,9660131623
5499,3294211653,8060,3294219713,3,0,1,6656,3,8364448348
5500,3294378608,57908,3294436516,8,0,0,6144,8,10339691576
5501,3294446252,6278,3294452530,5,0,1,6656,5,642481686
5502,3294449997,7359,3294457356,18,0,1,7680,18,1495622246
5503,3294483094,7706,3294490800,16,0,1,8192,16,8602682124
5504,3294483546,110050,3294593596,3,0,0,54272,3,9332212065
5505,3294504806,101816,3294606622,12,0,0,34304,12,8152437697
5506,3294506006,173009,3294679015,5,0,0,55296,5,3379464249
5507,3294547469,3387,3294550856,14,0,1,9728,14,929265474
5508,3294562402,5802,3294568204,7,0,1,6144,7,4197469138
5509,3294590198,3956,3294594154,6,0,1,512,6,7171381932
5510,3294619025,1042,3294620067,4,0,1,1024,4,6206294538
5511,3294621147,121894,3294743041,14,0,0,42496,14,454931499
5512,3294630356,3387,3294633743,18,0,1,9728,18,2902528336
5513,3294634114,146635,3294780749,17,0,0,1024,17,583517249
5514,3294639326,2470,3294641796,3,0,1,2560,3,5129189357
5515,3294647224,199983,3294847207,7,0,0,16896,7,10649262749
5516,3294684305,195848,3294880153,0,0,0,108032,0,1095816515
5517,3294698371,78990,3294777361,17,0,0,512,17,2892105093
5518,3294712027,566,3294712593,2,0,1,512,2,9051821124
5519,3294727924,15132,3294743056,1,0,1,5120,1,8764824281
5520,3294753033,66056,3294819089,9,0,0,7680,9,1261561618
5521,3294809726,566,3294810292,11,0,1,512,11,6658827446
5522,3294815655,101606,3294917261,1,0,0,30208,1,9522758523
5523,3294817622,4405,3294822027,5,0,1,3072,5,8911352030
5524,3294841211,6011,3294847222,4,0,1,1024,4,2771996708
5525,3294894504,5454,3294899958,0,0,1,13824,0,4449935009
5526,3294901435,2470,3294903905,18,0,1,2560,18,10326104182
5527,3294911075,51774,3294962849,10,0,0,1024,10,5080911182
5528,3294942598,61386,3295003984,1,0,0,5120,1,4522261701
5529,3294944852,104954,3295049806,9,0,0,8192,9,8808035018
5530,3294947903,2946,3294950849,15,0,1,3072,15,9646569635
5531,3294974084,86712,3295060796,10,0,1,145408,10,3467895668
5532,3295088979,65321,3295154300,10,0,0,1536,10,5926556749
5533,3295139450,101036,3295240486,15,0,0,31744,15,3341684173
5534,3295175692,1042,3295176734,5,0,1,1024,5,2114803926
5535,3295246254,3645,3295249899,18,0,1,10240,18,8397614198
5536,3295256556,73058,3295329614,10,0,1,118784,10,7729944524
5537,3295266278,65282,3295331560,14,0,1,3072,14,5059828935
5538,3295294818,267326,3295562144,8,0,0,28160,8,4791510742
5539,3295308651,23895,3295332546,15,0,1,1536,15,6891926022
5540,3295334380,73397,3295407777,18,0,0,512,18,1769264646
5541,3295337957,1518,3295339475,16,0,1,1536,16,9731270595
5542,3295365767,229659,3295595426,15,0,0,10240,15,7898623026
5543,3295372062,1518,3295373580,2,0,1,1536,2,5799545513
5544,3295377192,4867,3295382059,18,0,1,5120,18,5532478174
5545,3295377198,6807,3295384005,12,0,1,3072,12,5408524125
5546,3295451215,101623,3295552838,17,0,0,1536,17,3196231281
5547,3295451920,136750,3295588670,11,0,0,43520,11,4630442519
5548,3295452621,70976,3295523597,19,0,0,8704,19,7460837800
5549,3295480142,13600,3295493742,0,0,1,23040,0,10408488387
5550,3295481435,159393,3295640828,9,0,0,22016,9,4124251982
5551,3295534888,183052,3295717940,9,0,0,40960,9,10494438443
5552,3295577753,17688,3295595441,9,0,1,4608,9,8049130632
5553,3295593489,2986,3295596475,9,0,1,1024,9,8538493329
5554,3295642605,1042,3295643647,19,0,1,1024,19,7384670171
5555,3295782876,1042,3295783918,18,0,1,1024,18,5094101072
5556,3295787321,1518,3295788839,19,0,1,1536,19,3372176397
5557,3295812573,107755,3295920328,9,0,0,47104,9,10636475069
5558,3295841434,85008,3295926442,10,0,0,512,10,811154895
5559,3295859126,1518,3295860644,3,0,1,1536,3,5860344460
5560,3295861802,129254,3295991056,13,0,0,14848,13,7161047355
5561,3295937496,125650,3296063146,12,0,0,83968,12,7611811501
5562,3295984851,1518,3295986369,12,0,1,1536,12,8131557407
5563,3296088769,2470,3296091239,14,0,1,2560,14,8277430463
5564,3296092440,1042,3296093482,16,0,1,1024,16,5179154018
5565,3296139820,4850,3296144670,4,0,1,5120,4,10365646821
5566,3296142378,45596,3296187974,18,0,0,1024,18,9558470039
5567,3296151618,3898,3296155516,3,0,1,4096,3,9851533884
5568,3296198781,158744,3296357525,6,0,0,1024,6,9907967245
5569,3296202272,6229,3296208501,8,0,1,15360,8,5429293851
5570,3296220007,72690,3296292697,17,0,0,512,17,801822260
5571,3296220023,1535,3296221558,14,0,1,1536,14,7920681235
5572,3296248589,4850,3296253439,11,0,1,5120,11,6272552510
5573,3296267196,191447,3296458643,12,0,0,11776,12,1640624459
5574,3296278592,136495,3296415087,15,0,0,65024,15,2194986101
5575,3296303911,45596,3296349507,13,0,0,1024,13,6815416632
5576,3296334564,80694,3296415258,6,0,0,512,6,4304710844
5577,3296349484,42956,3296392440,10,0,1,70144,10,1885165137
5578,3296372182,110149,3296482331,0,0,0,11264,0,6357499198
5579,3296379608,152109,3296531717,1,0,0,28672,1,3491690141
5580,3296428592,103296,3296531888,17,0,0,512,17,4078577474
5581,3296436789,45557,3296482346,8,0,1,75776,8,2937404125
5582,3296476428,5933,3296482361,19,0,1,2048,19,8151626438
5583,3296565150,141506,3296706656,7,0,0,4608,7,1553085131
5584,3296579018,127926,3296706944,18,0,0,512,18,384892378
5585,3296590676,126359,3296717035,7,0,0,9216,7,1859246970
5586,3296663999,3422,3296667421,5,0,1,3584,5,6626034995
5587,3296692398,2946,3296695344,1,0,1,3072,1,4033190951
5588,3296724818,3128,3296727946,1,0,1,9216,1,9367794923
5589,3296764640,566,3296765206,18,0,1,512,18,2167913527
5590,3296783141,3898,3296787039,4,0,1,4096,4,4752860
5591,3296834796,108212,3296943008,15,0,0,55296,15,10483717198
5592,3296840151,114572,3296954723,0,0,0,38400,0,10607650010
5593,3296880356,133380,3297013736,5,0,0,23040,5,7675728260
5594,3296888447,7230,3296895677,12,0,1,7680,12,3950678890
5595,3296896962,1042,3296898004,14,0,1,1024,14,7628850321
5596,3296964741,6488,3296971229,19,0,1,15872,19,9679149102
5597,3296976716,55386,3297032102,17,0,0,1536,17,2071274623
5598,3297037111,45596,3297082707,10,0,0,1024,10,7649749737
5599,3297065161,4162,3297069323,4,0,1,11264,4,3980379642
5600,3297097572,566,3297098138,18,0,1,512,18,4763649222
5601,3297127429,63140,3297190569,15,0,0,8192,15,3801952603
5602,3297142287,115595,3297257882,14,0,0,33280,14,3175431600
5603,3297171864,139319,3297311183,0,0,0,46080,0,7734369484
5604,3297177882,91287,3297269169,4,0,0,16896,4,7196763944
5605,3297180228,177731,3297357959,10,0,0,27648,10,10714515112
5606,3297222544,10241,3297232785,3,0,1,16384,3,9706822691
5607,3297241463,2946,3297244409,7,0,1,3072,7,1650801681
5608,3297241802,55326,3297297128,9,0,0,5632,9,7310855030
5609,3297251979,223099,3297475078,7,0,0,56320,7,4077929977
5610,3297268437,3194,3297271631,9,0,1,2560,9,6284840056
5611,3297355430,50461,3297405891,6,0,0,1024,6,1223309648
5612,3297420112,141680,3297561792,4,0,0,32256,4,3931588858
5613,3297438775,36334,3297475109,8,0,1,55296,8,7606589492
5614,3297453591,212183,3297665774,5,0,0,13824,5,2491274853
5615,3297460144,36375,3297496519,0,0,1,34816,0,2013845727
5616,3297468638,31747,3297500385,18,0,1,6144,18,4755937453
5617,3297474903,174289,3297649192,13,0,0,31232,13,5842116339
5618,3297495459,166080,3297661539,8,0,0,40448,8,7711107788
5619,3297586751,3422,3297590173,14,0,1,3584,14,10398789342
5620,3297597256,106876,3297704132,10,0,0,8704,10,426192520
5621,3297607017,65569,3297672586,8,0,0,1024,8,3042513544
5622,3297629052,99350,3297728402,13,0,0,1536,13,2931544963
5623,3297640031,73985,3297714016,9,0,0,8704,9,7060724400
5624,3297647969,75513,3297723482,18,0,0,512,18,10358806673
5625,3297650275,20817,3297671092,4,0,1,5632,4,6119526013
5626,3297669795,3563,3297673358,8,0,1,3584,8,1702526296
5627,3297699545,16613,3297716158,0,0,1,32256,0,2527299075
5628,3297742768,114607,3297857375,8,0,0,32256,8,8168324137
5629,3297745320,43904,3297789224,18,0,0,512,18,2499583403
5630,3297751627,5326,3297756953,16,0,1,5632,16,9708536625
5631,3297783424,1994,3297785418,3,0,1,2048,3,9980327598
5632,3297790255,1994,3297792249,18,0,1,2048,18,5891460446
5633,3297798442,104000,3297902442,10,0,0,41472,10,7188295069
5634,3297801465,2470,3297803935,17,0,1,2560,17,1249779790
5635,3297864111,80708,3297944819,3,0,0,20480,3,10688415494
5636,3298011379,99788,3298111167,7,0,0,27648,7,7856033145
5637,3298057366,7230,3298064596,15,0,1,7680,15,6416028125
5638,3298069612,118415,3298188027,5,0,0,39424,5,7962784326
5639,3298092531,125496,3298218027,7,0,0,82432,7,971893683
5640,3298120832,163263,3298284095,8,0,0,29184,8,3783913238
5641,3298130802,87396,3298218198,14,0,0,512,14,8505338552
5642,3298234424,49842,3298284266,6,0,0,512,6,7160867235
5643,3298251816,6278,3298258094,17,0,1,6656,17,28098795
5644,3298272567,566,3298273133,12,0,1,512,12,9300995962
5645,3298273264,23895,3298297159,17,0,1,43008,17,1305198725
5646,3298291488,8577,3298300065,19,0,1,4608,19,1213543534
5647,3298295710,102440,3298398150,3,0,0,36352,3,2142499825
5648,3298313734,4374,3298318108,1,0,1,4608,1,8529607105
5649,3298323980,4850,3298328830,19,0,1,5120,19,8643293588
5650,3298366366,5454,3298371820,2,0,1,13824,2,9386239592
5651,3298375756,4374,3298380130,11,0,1,4608,11,4228808769
5652,3298385960,12205,3298398165,7,0,1,2048,7,7105076794
5653,3298399009,7230,3298406239,19,0,1,7680,19,6712503231
5654,3298404775,122791,3298527566,7,0,0,3072,7,3182478734
5655,3298410348,101972,3298512320,3,0,0,34816,3,6303236801
5656,3298434717,4937,3298439654,11,0,1,12800,11,5034725895
5657,3298480689,566,3298481255,2,0,1,512,2,6722162196
5658,3298497849,2946,3298500795,11,0,1,3072,11,10065726016
5659,3298502966,58326,3298561292,7,0,0,2048,7,6503928505
5660,3298513090,7230,3298520320,10,0,1,7680,10,2642156231
5661,3298516934,3745,3298520679,18,0,1,9728,18,2739069819
5662,3298517822,6975,3298524797,18,0,1,5120,18,950378619
5663,3298521359,6344,3298527703,1,0,1,4608,1,8802648677
5664,3298539212,1994,3298541206,16,0,1,2048,16,4145815755
5665,3298548700,566,3298549266,18,0,1,512,18,3484362265
5666,3298570371,3422,3298573793,1,0,1,3584,1,233670680
5667,3298581551,281431,3298862982,0,0,0,43520,0,10339589626
5668,3298614348,566,3298614914,1,0,1,512,1,3012537216
5669,3298637595,52364,3298689959,17,0,0,3072,17,3125765561
5670,3298692808,97604,3298790412,0,0,0,20480,0,6237045624
5671,3298695753,3898,3298699651,11,0,1,4096,11,5404237740
5672,3298751800,566,3298752366,3,0,1,512,3,7846159400
5673,3298812436,5326,3298817762,1,0,1,5632,1,3276476685
5674,3298840829,103327,3298944156,10,0,0,27648,10,1278903181
5675,3298849675,86042,3298935717,0,0,0,15360,0,3238472746
5676,3298853695,13177,3298866872,10,0,1,4096,10,4827638836
5677,3298924563,1518,3298926081,5,0,1,1536,5,1719815209
5678,3298965902,3422,3298969324,17,0,1,3584,17,6950539222
5679,3299045910,3898,3299049808,2,0,1,4096,2,3175789849
5680,3299053316,214603,3299267919,0,0,0,65024,0,8972627881
5681,3299070381,124940,3299195321,19,0,0,103424,19,972120585
5682,3299201933,122170,3299324103,16,0,0,10240,16,8410724422
5683,3299208949,3128,3299212077,14,0,1,9216,14,414485436
5684,3299254243,47259,3299301502,8,0,1,55296,8,7044873686
5685,3299282792,114205,3299396997,11,0,0,21504,11,6459191357
5686,3299306781,135129,3299441910,5,0,0,22016,5,568814989
5687,3299314691,4850,3299319541,17,0,1,5120,17,843676110
5688,3299352206,3645,3299355851,15,0,1,10240,15,659791090
5689,3299417002,4420,3299421422,5,0,1,11776,5,6598447654
5690,3299424241,62516,3299486757,7,0,0,6144,7,7254561547
5691,3299510101,75452,3299585553,0,0,0,13312,0,321316077
5692,3299568959,73604,3299642563,12,0,0,12288,12,10648697013
5693,3299586121,43904,3299630025,14,0,0,512,14,6122956541
5694,3299601683,16354,3299618037,10,0,1,31744,10,707502131
5695,3299627868,7230,3299635098,16,0,1,7680,16,9574499592
5696,3299628166,132152,3299760318,9,0,0,30208,9,4273428284
5697,3299644547,155507,3299800054,11,0,0,34816,11,10657994322
5698,3299649165,3387,3299652552,14,0,1,9728,14,9641169818
5699,3299666031,218462,3299884493,15,0,0,32768,15,3703769251
5700,3299692962,1042,3299694004,11,0,1,1024,11,934500703
5701,3299744301,56865,3299801166,6,0,0,1024,6,2384383120
5702,3299748438,75704,3299824142,18,0,0,1536,18,7137464737
5703,3299761036,113458,3299874494,4,0,0,60928,4,7365167301
5704,3299763344,121967,3299885311,14,0,0,2048,14,9522937350
5705,3299764277,120395,3299884672,14,0,0,512,14,8129722488
5706,3299849590,4850,3299854440,12,0,1,5120,12,7154252372
5707,3299872098,18022,3299890120,12,0,1,5120,12,1079652884
5708,3299897220,100412,3299997632,1,0,0,29696,1,837073142
5709,3299930168,103532,3300033700,9,0,0,39936,9,7439376801
5710,3299934321,1518,3299935839,4,0,1,1536,4,5931885974
5711,3299940028,1518,3299941546,3,0,1,1536,3,5194270620
5712,3299965132,7230,3299972362,15,0,1,7680,15,570737346
5713,3300010967,102596,3300113563,7,0,0,36864,7,3957507897
5714,3300053348,150383,3300203731,3,0,0,23040,3,9741360448
5715,3300060290,289290,3300349580,12,0,0,79872,12,3604280788
5716,3300061877,111488,3300173365,12,0,0,66048,12,2154339524
5717,3300075567,180683,3300256250,0,0,0,1536,0,3818895959
5718,3300101915,168219,3300270134,1,0,0,7168,1,8760441066
5719,3300123824,6754,3300130578,11,0,1,7168,11,1654150143
5720,3300144946,28434,3300173380,8,0,1,48640,8,42838090
5721,3300206936,5326,3300212262,5,0,1,5632,5,1555401572
5722,3300215112,214694,3300429806,11,0,0,115200,11,2407087576
5723,3300221789,7230,3300229019,9,0,1,7680,9,3840128164
5724,3300326832,103613,3300430445,6,0,0,2048,6,2397008386
5725,3300355049,5326,3300360375,16,0,1,5632,16,3842490251
5726,3300440905,1518,3300442423,3,0,1,1536,3,4736075960
5727,3300472520,161831,3300634351,0,0,0,2560,0,9805163179
5728,3300473485,45596,3300519081,6,0,0,1024,6,269525467
5729,3300501804,2946,3300504750,6,0,1,3072,6,7523489512
5730,3300502169,6074,3300508243,7,0,1,13824,7,1265631071
5731,3300518715,3453,3300522168,3,0,1,9216,3,7602435838
5732,3300521218,161765,3300682983,4,0,0,61440,4,5563461185
5733,3300531783,1994,3300533777,1,0,1,2048,1,9784844772
5734,3300536216,12825,3300549041,10,0,1,21504,10,4540553061
5735,3300546875,154243,3300701118,5,0,0,59392,5,6350164438
5736,3300569132,5326,3300574458,19,0,1,5632,19,3483546571
5737,3300589675,231056,3300820731,16,0,0,6144,16,6791259693
5738,3300622716,2946,3300625662,9,0,1,3072,9,9718983324
5739,3300634847,183997,3300818844,3,0,0,92160,3,5898762122
5740,3300670700,33323,3300704023,19,0,1,3072,19,10558392128
5741,3300675500,29383,3300704883,3,0,1,8704,3,5564384191
5742,3300677466,30621,3300708087,6,0,1,3584,6,3919265887
5743,3300703349,158632,3300861981,12,0,0,50688,12,9111370776
5744,3300829115,43904,3300873019,18,0,0,512,18,10214149730
5745,3300882579,55562,3300938141,8,0,1,94720,8,3704843254
5746,3300940702,566,3300941268,7,0,1,512,7,6547316223
5747,3300942840,246462,3301189302,10,0,0,49664,10,6079752675
5748,3300970378,142502,3301112880,8,0,0,72192,8,2102044513
5749,3300982120,6278,3300988398,7,0,1,6656,7,3413609540
5750,3300996385,62516,3301058901,3,0,0,6144,3,5582253842
5751,3301008945,119699,3301128644,9,0,0,46592,9,9039280656
5752,3301014105,5802,3301019907,12,0,1,6144,12,3156406896
5753,3301108820,156340,3301265160,0,0,0,70656,0,10500309443
5754,3301129072,2870,3301131942,6,0,1,8704,6,8680887131
5755,3301135751,165180,3301300931,3,0,0,14848,3,4756771608
5756,3301165133,24192,3301189325,10,0,1,32768,10,8190959054
5757,3301166449,127013,3301293462,16,0,0,8192,16,9008338399
5758,3301193897,226078,3301419975,9,0,0,95744,9,2178664532
5759,3301221985,43904,3301265889,18,0,0,512,18,10599045483
5760,3301270279,154250,3301424529,8,0,0,3584,8,4702177255
5761,3301285840,137582,3301423422,9,0,0,11264,9,2724049623
5762,3301367435,3128,3301370563,6,0,1,9216,6,5289210091
5763,3301414063,12928,3301426991,16,0,1,2560,16,2707373708
5764,3301426134,236723,3301662857,3,0,0,101376,3,10684719766
5765,3301498995,1042,3301500037,6,0,1,1024,6,2166137804
5766,3301550520,158681,3301709201,11,0,0,92160,11,7782228955
5767,3301554053,3898,3301557951,14,0,1,4096,14,4075226726
5768,3301557329,161262,3301718591,10,0,0,25600,10,2599015011
5769,3301579213,131563,3301710776,5,0,0,5120,5,7668336019
5770,3301602837,2470,3301605307,1,0,1,2560,1,2932945362
5771,3301645988,17427,3301663415,12,0,1,512,12,6563605725
5772,3301706620,16354,3301722974,3,0,1,4608,3,995083764
5773,3301716686,51214,3301767900,12,0,0,3072,12,9378776122
5774,3301757331,120235,3301877566,15,0,0,63488,15,9561995597
5775,3301766694,1221,3301767915,6,0,1,512,6,3893798717
5776,3301822719,137435,3301960154,4,0,0,104448,4,7348824497
5777,3301823131,4162,3301827293,15,0,1,11264,15,9232519179
5778,3301839987,4850,3301844837,14,0,1,5120,14,1621795787
5779,3301869504,124049,3301993553,13,0,0,13312,13,4112545526
5780,3301871919,10990,3301882909,3,0,1,5632,3,2584793033
5781,3301888896,248169,3302137065,12,0,0,44032,12,550177046
5782,3301902371,1994,3301904365,3,0,1,2048,3,5246534471
5783,3301937919,79667,3302017586,16,0,0,4608,16,6663807816
5784,3301950270,92877,3302043147,16,0,0,12800,16,3421439399
5785,3301961286,66227,3302027513,17,0,0,1536,17,828842607
5786,3301977067,2946,3301980013,11,0,1,3072,11,7958456100
5787,3301978917,43904,3302022821,17,0,0,512,17,490517909
5788,3301994868,128766,3302123634,1,0,0,39424,1,6785095893
5789,3302034077,152494,3302186571,13,0,0,22528,13,1103112405
5790,3302092468,139322,3302231790,9,0,0,94720,9,1640556052
5791,3302097450,3422,3302100872,18,0,1,3584,18,8420303631
5792,3302162076,3898,3302165974,12,0,1,4096,12,8507516870
5793,3302215803,31041,3302246844,6,0,1,29184,6,4970585094
5794,3302294636,6278,3302300914,11,0,1,6656,11,572214184
5795,3302337703,67044,3302404747,8,0,0,7168,8,9895856557
5796,3302357593,1518,3302359111,3,0,1,1536,3,3089125823
5797,3302363157,1518,3302364675,3,0,1,1536,3,1615695818
5798,3302397034,11016,3302408050,6,0,1,17920,6,1797515434
5799,3302400694,24669,3302425363,1,0,1,33280,1,6544395390
5800,3302467719,20882,3302488601,10,0,1,33792,10,6865210988
5801,3302506048,21399,3302527447,10,0,1,34816,10,8949445829
5802,3302517639,11114,3302528753,18,0,1,2048,18,7089977397
5803,3302540916,5326,3302546242,17,0,1,5632,17,1599204923
5804,3302594618,154868,3302749486,6,0,0,512,6,1312420076
5805,3302594699,2870,3302597569,1,0,1,8704,1,3596506822
5806,3302648126,72443,3302720569,18,0,0,1024,18,9048853243
5807,3302665060,2870,3302667930,2,0,1,8704,2,2203897548
5808,3302714540,46988,3302761528,10,0,1,81408,10,5529007750
5809,3302765876,5802,3302771678,11,0,1,6144,11,1974671498
5810,3302774325,156557,3302930882,1,0,0,79360,1,10452173940
5811,3302795212,4420,3302799632,17,0,1,11776,17,1884998983
5812,3302873159,2470,3302875629,1,0,1,2560,1,5582423105
5813,3302919895,13449,3302933344,19,0,1,2560,19,8206371693
5814,3302958129,43904,3303002033,6,0,0,512,6,7889572138
5815,3302961002,107276,3303068278,10,0,0,52224,10,4437238481
5816,3303028179,5971,3303034150,12,0,1,14848,12,9824122286
5817,3303065382,6310,3303071692,2,0,1,3584,2,8455667714
5818,3303075677,43904,3303119581,14,0,0,512,14,4551196206
5819,3303118050,183413,3303301463,7,0,0,109568,7,5379670963
5820,3303122224,7230,3303129454,7,0,1,7680,7,5407967638
5821,3303148697,5326,3303154023,15,0,1,5632,15,8676956848
5822,3303169424,98640,3303268064,11,0,0,19968,11,6363059784
5823,3303185966,4374,3303190340,9,0,1,4608,9,3138234945
5824,3303198563,103703,3303302266,4,0,0,2560,4,130389709
5825,3303260145,109686,3303369831,13,0,0,17408,13,7375996794
5826,3303283906,19837,3303303743,1,0,1,1536,1,4969954350
5827,3303337761,2470,3303340231,14,0,1,2560,14,9297660160
5828,3303349007,88364,3303437371,3,0,0,15360,3,7985557722
5829,3303372050,127775,3303499825,4,0,0,27648,4,5106600368
5830,3303378740,107655,3303486395,0,0,0,11264,0,3747864538
5831,3303403012,79928,3303482940,3,0,0,17920,3,960189771
5832,3303443901,57117,3303501018,6,0,0,512,6,5382249623
5833,3303458333,55070,3303513403,18,0,0,512,18,4259208928
5834,3303478024,21824,3303499848,5,0,1,8192,5,5138839465
5835,3303492817,11937,3303504754,12,0,1,12800,12,2730837125
5836,3303532541,12049,3303544590,10,0,1,19968,10,892068126
5837,3303552030,245888,3303797918,1,0,0,60416,1,8496514296
5838,3303552164,2946,3303555110,12,0,1,3072,12,4066693900
5839,3303563606,24412,3303588018,10,0,1,44032,10,5068837932
5840,3303582718,6926,3303589644,19,0,1,2560,19,7763619176
5841,3303635476,110801,3303746277,13,0,0,25600,13,1001088875
5842,3303641829,1994,3303643823,1,0,1,2048,1,6797046745
5843,3303709606,96590,3303806196,14,0,0,1536,14,5539756916
5844,3303711654,111384,3303823038,0,0,0,13824,0,3407514038
5845,3303745830,59883,3303805713,19,0,0,6144,19,10499002129
5846,3303766100,566,3303766666,11,0,1,512,11,3770715310
5847,3303779253,259935,3304039188,8,0,0,56320,8,7137071389
5848,3303811622,102752,3303914374,15,0,0,37376,15,87645150
5849,3303881512,110708,3303992220,19,0,0,63488,19,6221487881
5850,3303883364,2470,3303885834,2,0,1,2560,2,4751738487
5851,3303926931,238937,3304165868,17,0,0,1536,17,419092599
5852,3303948747,3898,3303952645,7,0,1,4096,7,6069152463
5853,3303952630,1525,3303954155,12,0,1,1536,12,1961245106
5854,3303992015,763,3303992778,8,0,1,512,8,3865584592
5855,3304011294,6278,3304017572,14,0,1,6656,14,10381355698
5856,3304017922,117637,3304135559,14,0,0,512,14,8309129245
5857,3304027162,138223,3304165385,3,0,0,13824,3,4558880780
5858,3304042161,288005,3304330166,9,0,0,111616,9,6646871629
5859,3304045336,11533,3304056869,6,0,1,18944,6,3760671856
5860,3304054817,43904,3304098721,6,0,0,512,6,6275754967
5861,3304089334,43200,3304132534,8,0,1,70656,8,5420954432
5862,3304092918,203225,3304296143,0,0,0,66560,0,1579817646
5863,3304124438,8557,3304132995,12,0,1,10240,12,8124481962
5864,3304134195,4162,3304138357,9,0,1,11264,9,6959114608
5865,3304136757,199196,3304335953,11,0,0,18944,11,10239995694
5866,3304146080,566,3304146646,7,0,1,512,7,3674412848
5867,3304163705,61284,3304224989,14,0,0,512,14,8190725868
5868,3304166968,4850,3304171818,9,0,1,5120,9,7566727766
5869,3304169234,170166,3304339400,7,0,0,11264,7,7777287724
5870,3304264964,74451,3304339415,0,0,1,64000,0,3148341561
5871,3304305385,294838,3304600223,13,0,0,73216,13,6187548536
5872,3304337880,32559,3304370439,10,0,1,50176,10,9172986985
5873,3304380878,6754,3304387632,18,0,1,7168,18,2654250060
5874,3304385999,246165,3304632164,19,0,0,71168,19,6346173065
5875,3304386361,75921,3304462282,11,0,0,3584,11,4001819470
5876,3304388323,1994,3304390317,14,0,1,2048,14,6789661463
5877,3304421045,62147,3304483192,6,0,0,512,6,1913437272
5878,3304429573,246713,3304676286,11,0,0,28160,11,3856952122
5879,3304435647,43904,3304479551,17,0,0,512,17,8351263523
5880,3304448106,156812,3304604918,8,0,1,258560,8,4790092136
5881,3304472464,136960,3304609424,3,0,1,7168,3,5353553249
5882,3304530317,101862,3304632179,0,0,1,31232,0,8076501926
5883,3304543734,88460,3304632194,12,0,1,4608,12,7114188585
5884,3304571128,61081,3304632209,7,0,1,11264,7,5741426686
5885,3304658670,17631,3304676301,8,0,1,20992,8,2744765586
5886,3304716678,4850,3304721528,17,0,1,5120,17,2884633292
5887,3304744896,2470,3304747366,3,0,1,2560,3,6651264710
5888,3304784565,280597,3305065162,1,0,0,150528,1,1924091810
5889,3304834788,1994,3304836782,15,0,1,2048,15,398089059
5890,3304871375,43904,3304915279,4,0,0,512,4,1971820432
5891,3304888527,2946,3304891473,2,0,1,3072,2,7197501992
5892,3304915319,47288,3304962607,6,0,0,1536,6,1629128015
5893,3304923719,185208,3305108927,5,0,0,35840,5,10407148316
5894,3304944861,137063,3305081924,0,0,0,47616,0,3860672734
5895,3305029842,171791,3305201633,12,0,0,112128,12,8871158781
5896,3305173763,103914,3305277677,4,0,0,10240,4,2953466185
5897,3305178134,70804,3305248938,14,0,0,1536,14,4113709097
5898,3305190461,23005,3305213466,17,0,1,19456,17,8389778783
5899,3305205246,91486,3305296732,18,0,0,1536,18,4065046653
5900,3305216485,106064,3305322549,3,0,0,26112,3,3313394118
5901,3305233661,1042,3305234703,3,0,1,1024,3,3213929932
5902,3305256650,57440,3305314090,3,0,0,4608,3,7506749038
5903,3305283817,20366,3305304183,8,0,1,32768,8,4458496015
5904,3305284771,276123,3305560894,0,0,0,86016,0,3064991406
5905,3305322416,22041,3305344457,10,0,1,35840,10,8429228551
5906,3305348123,4850,3305352973,15,0,1,5120,15,9110641894
5907,3305421020,182444,3305603464,16,0,0,83456,16,296903052
5908,3305427298,5712,3305433010,2,0,1,14336,2,4906100751
5909,3305460696,60664,3305521360,11,0,0,512,11,4214412109
5910,3305464816,2470,3305467286,16,0,1,2560,16,8045054055
5911,3305506126,97665,3305603791,14,0,0,1024,14,10484331920
5912,3305515295,114075,3305629370,8,0,1,185344,8,5521046550
5913,3305531474,187626,3305719100,11,0,0,26112,11,3524544947
5914,3305568199,65997,3305634196,5,0,1,7680,5,9249470852
5915,3305609590,25912,3305635502,16,0,1,2048,16,8483055728
5916,3305620520,26221,3305646741,8,0,1,45568,8,9962659656
5917,3305626700,116598,3305743298,4,0,0,3584,4,10267712977
5918,3305629367,18552,3305647919,18,0,1,13824,18,9562679455
5919,3305642871,251212,3305894083,15,0,0,30720,15,9146024737
5920,3305682845,3898,3305686743,6,0,1,4096,6,2560419278
5921,3305689147,3898,3305693045,18,0,1,4096,18,716537332
5922,3305703546,1518,3305705064,17,0,1,1536,17,8236359605
5923,3305710995,14117,3305725112,10,0,1,24064,10,3208999621
5924,3305727746,81478,3305809224,18,0,0,1536,18,4045949156
5925,3305766596,252532,3306019128,1,0,0,35328,1,4481868429
5926,3305773633,110490,3305884123,0,0,0,3072,0,2040890206
5927,3305801224,207125,3306008349,16,0,0,23040,16,1037746013
5928,3305810495,187497,3305997992,0,0,0,68096,0,4257442916
5929,3305873400,566,3305873966,1,0,1,512,1,586175731
5930,3305878016,150395,3306028411,17,0,0,512,17,274521262
5931,3306094538,100568,3306195106,19,0,0,30208,19,10248905285
5932,3306114681,53583,3306168264,0,0,1,87552,0,639049069
5933,3306123495,242271,3306365766,19,0,0,56832,19,9142980887
5934,3306167646,64742,3306232388,8,0,1,105984,8,1299155338
5935,3306176584,142202,3306318786,15,0,0,17920,15,2089564309
5936,3306182025,269050,3306451075,12,0,0,58368,12,3982154852
5937,3306197948,279833,3306477781,10,0,0,13824,10,764436155
5938,3306232453,7706,3306240159,12,0,1,8192,12,3984569789
5939,3306237175,59879,3306297054,17,0,0,2048,17,7362469270
5940,3306254379,204823,3306459202,11,0,0,26624,11,6658512136
5941,3306271114,308012,3306579126,6,0,0,1024,6,7120811225
5942,3306312792,100470,3306413262,17,0,0,1536,17,6592376386
5943,3306330672,211353,3306542025,0,0,0,51200,0,404018249
5944,3306338178,213854,3306552032,10,0,0,32768,10,4122526951
5945,3306367576,211223,3306578799,3,0,0,42496,3,9150724269
5946,3306406521,177234,3306583755,6,0,0,512,6,8742521142
5947,3306406746,4937,3306411683,12,0,1,12800,12,7584777651
5948,3306528680,50461,3306579141,8,0,1,46080,8,4971035917
5949,3306647264,43904,3306691168,14,0,0,512,14,5631346595
5950,3306665144,62416,3306727560,7,0,1,101376,7,307632115
5951,3306666080,179885,3306845965,8,0,0,29696,8,5194220918
5952,3306728151,213336,3306941487,4,0,0,28672,4,3205084230
5953,3306730858,122745,3306853603,16,0,0,13312,16,10701544129
5954,3306772237,91758,3306863995,0,0,0,2048,0,4693768585
5955,3306813058,119678,3306932736,19,0,0,20480,19,3688842654
5956,3306837357,11987,3306849344,7,0,1,9728,7,1549839549
5957,3306882403,193844,3307076247,4,0,0,169984,4,1279777504
5958,3306904370,105921,3307010291,17,0,0,512,17,2138195521
5959,3306917127,6229,3306923356,18,0,1,15360,18,3547288445
5960,3306930070,16259,3306946329,11,0,1,5120,11,5368861967
5961,3306945143,4162,3306949305,11,0,1,11264,11,10509778015
5962,3306972541,3898,3306976439,17,0,1,4096,17,3472458558
5963,3306977306,99112,3307076418,10,0,0,512,10,10071439818
5964,3307012884,115624,3307128508,3,0,0,20480,3,10466610401
5965,3307055132,128710,3307183842,9,0,0,52736,9,7796010626
5966,3307126958,4964,3307131922,19,0,1,3584,19,2774090213
5967,3307137666,117854,3307255520,4,0,0,15360,4,9688990433
5968,3307152579,10241,3307162820,8,0,1,16384,8,7981161467
5969,3307190112,171686,3307361798,16,0,0,136192,16,1804401204
5970,3307237242,7230,3307244472,5,0,1,7680,5,663942175
5971,3307241397,4061,3307245458,9,0,1,1536,9,5380975315
5972,3307241836,206411,3307448247,9,0,0,23552,9,5910338548
5973,3307267722,95667,3307363389,4,0,0,5120,4,6834170160
5974,3307305230,215690,3307520920,7,0,0,55296,7,764529919
5975,3307324283,79964,3307404247,8,0,1,66048,8,3859364858
5976,3307337167,131300,3307468467,5,0,0,50176,5,7364732758
5977,3307355546,165701,3307521247,14,0,0,1024,14,2139316602
5978,3307379602,30137,3307409739,10,0,1,26112,10,9419919566
5979,3307425133,4850,3307429983,15,0,1,5120,15,2428557288
5980,3307438902,141256,3307580158,11,0,0,36352,11,8616358207
5981,3307477431,24154,3307501585,0,0,1,43520,0,7493480358
5982,3307538869,304424,3307843293,9,0,0,47616,9,6076890638
5983,3307539090,566,3307539656,15,0,1,512,15,3766808614
5984,3307591126,1518,3307592644,6,0,1,1536,6,3474116849
5985,3307595132,3422,3307598554,8,0,1,3584,8,6355016340
5986,3307635164,1518,3307636682,17,0,1,1536,17,9610404325
5987,3307641612,4850,3307646462,9,0,1,5120,9,144819771
5988,3307659378,12308,3307671686,17,0,1,20480,17,3786787956
5989,3307667959,109440,3307777399,7,0,0,44544,7,1570030836
5990,3307698294,182309,3307880603,19,0,0,512,19,5217612765
5991,3307726785,6278,3307733063,16,0,1,6656,16,7577153008
5992,3307735037,82924,3307817961,7,0,1,134656,7,9537729491
5993,3307744151,209742,3307953893,8,0,0,63488,8,1729168730
5994,3307797423,167515,3307964938,13,0,0,19968,13,1437242922
5995,3307798972,236548,3308035520,13,0,0,10240,13,8765908008
5996,3307808701,10886,3307819587,9,0,1,2560,9,3088314559
5997,3307822395,191756,3308014151,11,0,0,33280,11,10620659875
5998,3307824650,172376,3307997026,7,0,0,28672,7,5457654616
5999,3307847315,4679,3307851994,12,0,1,12288,12,7847594812
6000,3307853127,6754,3307859881,1,0,1,7168,1,9625217244
6001,3307880348,1042,3307881390,9,0,1,1024,9,3690732375
6002,3307955772,9181,3307964953,16,0,1,11264,16,7422167394
6003,3308064319,45596,3308109915,18,0,0,1024,18,4817518932
6004,3308123980,43904,3308167884,6,0,0,512,6,7909979383
6005,3308193670,100724,3308294394,1,0,0,30720,1,2024736262
6006,3308277669,3422,3308281091,1,0,1,3584,1,1278727087
6007,3308355546,45596,3308401142,18,0,0,1024,18,7601448558
6008,3308363564,4420,3308367984,1,0,1,11776,1,3645266903
6009,3308364410,50079,3308414489,19,0,0,1536,19,3741270950
6010,3308457282,45596,3308502878,14,0,0,1024,14,3725060373
6011,3308466887,139530,3308606417,0,0,0,80384,0,8624293489
6012,3308479420,98228,3308577648,19,0,0,22528,19,8098826768
6013,3308563045,6278,3308569323,5,0,1,6656,5,933381813
6014,3308579906,193712,3308773618,8,0,0,14848,8,7845954975
6015,3308586950,24785,3308611735,19,0,1,5632,19,5886445955
6016,3308652446,1042,3308653488,12,0,1,1024,12,8493016670
6017,3308658309,115636,3308773945,17,0,0,1024,17,5903765910
6018,3308667765,14029,3308681794,10,0,1,27136,10,9362195646
6019,3308686955,48980,3308735935,18,0,0,2048,18,2538571342
6020,3308698615,104845,3308803460,12,0,0,5120,12,9640600581
6021,3308725288,566,3308725854,18,0,1,512,18,8378223943
6022,3308738006,122349,3308860355,16,0,0,41984,16,3831755580
6023,3308746206,1994,3308748200,4,0,1,2048,4,5977800878
6024,3308762229,566,3308762795,12,0,1,512,12,45493799
6025,3308773937,1518,3308775455,18,0,1,1536,18,3570572556
6026,3308779248,566,3308779814,17,0,1,512,17,523812029
6027,3308824775,181802,3309006577,13,0,0,22528,13,3477453173
6028,3308834208,5326,3308839534,19,0,1,5632,19,7237434286
6029,3308839815,144316,3308984131,1,0,0,25600,1,9241858186
6030,3308866876,2946,3308869822,4,0,1,3072,4,9395575460
6031,3308926930,201187,3309128117,1,0,0,48128,1,7851423066
6032,3308927322,134009,3309061331,8,0,0,61952,8,6198966553
6033,3308940575,70404,3309010979,18,0,0,2560,18,2580786578
6034,3308947461,2946,3308950407,11,0,1,3072,11,1631654173
6035,3308990314,193142,3309183456,4,0,0,20480,4,9718541474
6036,3309016458,2870,3309019328,19,0,1,8704,19,4251037874
6037,3309043053,38894,3309081947,0,0,1,33280,0,494921479
6038,3309093490,180522,3309274012,17,0,0,1024,17,1593461287
6039,3309095462,183455,3309278917,13,0,0,15872,13,2765529799
6040,3309113286,160391,3309273677,8,0,0,67584,8,6752457004
6041,3309113354,139716,3309253070,4,0,0,61952,4,1060939191
6042,3309185407,88628,3309274035,10,0,1,122880,10,7173183880
6043,3309202722,71328,3309274050,2,0,1,1536,2,832502302
6044,3309219636,167436,3309387072,13,0,0,29184,13,7112675541
6045,3309253153,172176,3309425329,17,0,0,1024,17,2694606399
6046,3309258416,21502,3309279918,1,0,1,1024,1,2971054583
6047,3309260197,24317,3309284514,19,0,1,5632,19,8529357928
6048,3309261288,163698,3309424986,15,0,0,81920,15,2262057476
6049,3309283865,1635,3309285500,2,0,1,1536,2,10195456202
6050,3309312493,4374,3309316867,4,0,1,4608,4,6471224111
6051,3309360052,4374,3309364426,3,0,1,4608,3,9113340441
6052,3309374254,176293,3309550547,16,0,0,80384,16,4876243070
6053,3309400266,29872,3309430138,9,0,1,5120,9,2905251351
6054,3309408510,142208,3309550718,6,0,0,512,6,2252067497
6055,3309434215,1518,3309435733,19,0,1,1536,19,5249749868
6056,3309462480,48980,3309511460,3,0,0,2048,3,3151864954
6057,3309470732,13341,3309484073,2,0,1,22528,2,194135128
6058,3309513636,2946,3309516582,9,0,1,3072,9,967514497
6059,3309558742,142848,3309701590,0,0,0,42496,0,4773885261
6060,3309574946,3422,3309578368,9,0,1,3584,9,2163320206
6061,3309576975,7230,3309584205,9,0,1,7680,9,3387253578
6062,3309603453,5196,3309608649,9,0,1,13312,9,6130524782
6063,3309626173,45596,3309671769,17,0,0,1024,17,1496391900
6064,3309630468,1518,3309631986,14,0,1,1536,14,4359465789
6065,3309713330,2946,3309716276,1,0,1,3072,1,789597667
6066,3309722442,3128,3309725570,0,0,1,9216,0,3222814544
6067,3309743068,90525,3309833593,14,0,0,1024,14,469517341
6068,3309863290,3422,3309866712,18,0,1,3584,18,677074464
6069,3309896950,54529,3309951479,0,0,1,92672,0,7400120771
6070,3309941861,12844,3309954705,9,0,1,5120,9,2593476060
6071,3309945878,208782,3310154660,19,0,0,11776,19,8253611199
6072,3309957940,359824,3310317764,5,0,0,97280,5,10169844264
6073,3310001600,117887,3310119487,5,0,0,23552,5,2608698260
6074,3310028645,566,3310029211,12,0,1,512,12,7811511475
6075,3310044800,86204,3310131004,1,0,0,13312,1,482395520
6076,3310063242,224852,3310288094,4,0,0,60416,4,1516785796
6077,3310086503,63983,3310150486,18,0,0,512,18,7694122565
6078,3310090383,155135,3310245518,8,0,0,21504,8,4092520424
6079,3310098882,4374,3310103256,4,0,1,4608,4,8576614395
6080,3310108471,346436,3310454907,0,0,0,110080,0,10399643269
6081,3310190594,132340,3310322934,3,0,0,512,3,8326232890
6082,3310210081,149599,3310359680,16,0,0,22016,16,10123124633
6083,3310233439,32816,3310266255,8,0,1,53760,8,4975414747
6084,3310241866,46243,3310288109,15,0,1,18432,15,435366793
6085,3310261489,204057,3310465546,7,0,0,34816,7,3443348333
6086,3310317619,182829,3310500448,18,0,0,1024,18,2479253756
6087,3310343227,16468,3310359695,0,0,1,27136,0,2796911486
6088,3310376157,6754,3310382911,12,0,1,7168,12,8780075560
6089,3310382489,129895,3310512384,11,0,0,3072,11,1372449546
6090,3310395579,184027,3310579606,5,0,0,37888,5,945574983
6091,3310431597,131881,3310563478,15,0,0,5120,15,2252860031
6092,3310434017,288056,3310722073,11,0,0,44544,11,2217141122
6093,3310477760,3645,3310481405,17,0,1,10240,17,7504225024
6094,3310505767,130461,3310636228,4,0,0,10752,4,9214249630
6095,3310608325,11791,3310620116,7,0,1,19456,7,9713493935
6096,3310622524,6754,3310629278,5,0,1,7168,5,6697643772
6097,3310625666,82820,3310708486,11,0,0,12288,11,7563972994
6098,3310639202,2470,3310641672,5,0,1,2560,5,7786680091
6099,3310652824,43904,3310696728,3,0,0,512,3,2283056880
6100,3310667149,197067,3310864216,1,0,0,28672,1,5420555679
6101,3310674718,566,3310675284,17,0,1,512,17,3016280413
6102,3310718640,6553,3310725193,14,0,1,9216,14,2220034030
6103,3310731215,43904,3310775119,14,0,0,512,14,7223960124
6104,3310741244,2946,3310744190,4,0,1,3072,4,5108863571
6105,3310745568,228268,3310973836,8,0,0,99328,8,6147484382
6106,3310760808,5326,3310766134,2,0,1,5632,2,4762721642
6107,3310765889,1994,3310767883,1,0,1,2048,1,4492350927
6108,3310774693,168381,3310943074,1,0,0,29696,1,4018398326
6109,3310858483,11527,3310870010,16,0,1,6144,16,7086548071
6110,3310866384,111078,3310977462,0,0,0,11264,0,2894270310
6111,3310891114,52443,3310943557,14,0,0,1536,14,5819382982
6112,3310908776,65239,3310974015,14,0,0,512,14,4704564289
6113,3310960377,17610,3310977987,19,0,1,512,19,6031210106
6114,3311099279,45596,3311144875,3,0,0,1024,3,182833369
6115,3311112508,47288,3311159796,12,0,0,1536,12,9628598183
6116,3311136062,45596,3311181658,17,0,0,1024,17,6224905062
6117,3311177176,13253,3311190429,8,0,1,25600,8,8739208834
6118,3311269457,45596,3311315053,3,0,0,1024,3,3085179423
6119,3311296095,50672,3311346767,14,0,0,2560,14,3650678616
6120,3311394286,47288,3311441574,6,0,0,1536,6,8726131146
6121,3311402442,77744,3311480186,4,0,0,10752,4,6648374982
6122,3311405702,147654,3311553356,4,0,0,48128,4,2599078012
6123,3311461540,5196,3311466736,1,0,1,13312,1,9887620503
6124,3311489676,156549,3311646225,0,0,0,48128,0,8604850466
6125,3311537867,15504,3311553371,10,0,1,15360,10,1293499847
6126,3311569394,3898,3311573292,19,0,1,4096,19,8606603828
6127,3311615587,55821,3311671408,0,0,1,95232,0,9140071780
6128,3311689315,13770,3311703085,10,0,1,26624,10,5465043480
6129,3311710697,5454,3311716151,14,0,1,13824,14,3531307301
6130,3311714836,5059,3311719895,18,0,1,12800,18,155776655
6131,3311720973,229458,3311950431,11,0,0,45056,11,10708325187
6132,3311722717,252717,3311975434,1,0,0,77312,1,9843398626
6133,3311730166,134784,3311864950,3,0,0,2048,3,1616527788
6134,3311743554,2470,3311746024,15,0,1,2560,15,3071359650
6135,3311745229,2470,3311747699,19,0,1,2560,19,8487763590
6136,3311785260,69146,3311854406,18,0,0,2560,18,3734052299
6137,3311786746,2946,3311789692,15,0,1,3072,15,6144837056
6138,3311830170,147969,3311978139,3,0,0,512,3,6888578921
6139,3311859313,118655,3311977968,16,0,0,8192,16,10730168834
6140,3311863826,140959,3312004785,8,0,0,28160,8,4378972428
6141,3311885736,566,3311886302,17,0,1,512,17,4486241538
6142,3311906275,83907,3311990182,14,0,0,512,14,8978498488
6143,3311931943,1042,3311932985,17,0,1,1024,17,5811865505
6144,3311942600,53419,3311996019,18,0,0,1024,18,4202428352
6145,3311946597,28852,3311975449,5,0,1,1536,5,9144489076
6146,3311947096,31058,3311978154,0,0,1,43008,0,2063214056
6147,3311948096,48094,3311996190,14,0,0,512,14,6038613069
6148,3311966020,17419,3311983439,18,0,1,5632,18,8465726074
6149,3311997519,99227,3312096746,17,0,0,2048,17,7159587471
6150,3312013033,83074,3312096107,11,0,0,9216,11,8075014909
6151,3312032899,14804,3312047703,10,0,1,28672,10,3686500013
6152,3312076334,2870,3312079204,19,0,1,8704,19,10377396116
6153,3312078904,168041,3312246945,9,0,0,33792,9,9450910736
6154,3312201831,3898,3312205729,1,0,1,4096,1,82775330
6155,3312208400,84248,3312292648,0,0,0,22016,0,3619511656
6156,3312225921,566,3312226487,17,0,1,512,17,1549596793
6157,3312230159,3898,3312234057,14,0,1,4096,14,2104823969
6158,3312275475,43904,3312319379,17,0,0,512,17,6820751516
6159,3312326565,4850,3312331415,3,0,1,5120,3,2445941874
6160,3312338909,110396,3312449305,11,0,0,62464,11,10328522352
6161,3312350270,566,3312350836,5,0,1,512,5,8147902548
6162,3312383960,71699,3312455659,14,0,0,1536,14,3601513911
6163,3312391388,278529,3312669917,11,0,0,181248,11,2859250286
6164,3312391637,58064,3312449701,6,0,0,1024,6,9668438263
6165,3312439818,91231,3312531049,5,0,0,13824,5,3302378523
6166,3312457721,6754,3312464475,16,0,1,7168,16,7590633178
6167,3312465381,44568,3312509949,1,0,0,512,1,996486678
6168,3312480620,88305,3312568925,10,0,0,1024,10,1980035145
6169,3312486355,195589,3312681944,16,0,0,39424,16,8806530918
6170,3312511900,192676,3312704576,13,0,0,46592,13,4709923253
6171,3312536156,2946,3312539102,15,0,1,3072,15,4910575604
6172,3312541485,1042,3312542527,10,0,1,1024,10,1770621873
6173,3312574337,4679,3312579016,9,0,1,12288,9,6163410573
6174,3312733998,50984,3312784982,8,0,0,3584,8,4142689913
6175,3312754112,62516,3312816628,5,0,0,6144,5,10306742795
6176,3312835690,1042,3312836732,17,0,1,1024,17,9296629831
6177,3312860835,69284,3312930119,15,0,0,8192,15,3690006791
6178,3312902238,81116,3312983354,7,0,1,131072,7,2787940454
6179,3312906615,217961,3313124576,16,0,0,135168,16,8905742688
6180,3312952622,34918,3312987540,3,0,1,6656,3,1168478927
6181,3312971862,153197,3313125059,14,0,0,1536,14,6575884352
6182,3312974372,217455,3313191827,8,0,0,22016,8,9747481444
6183,3312976497,163392,3313139889,10,0,0,512,10,8975580590
6184,3313006884,178220,3313185104,13,0,0,24064,13,6020499952
6185,3313010156,208043,3313218199,12,0,0,1024,12,4090274405
6186,3313021191,291227,3313312418,0,0,0,65024,0,6438894342
6187,3313120396,6173,3313126569,16,0,1,1536,16,2613848695
6188,3313145796,139916,3313285712,7,0,0,9216,7,6815162846
6189,3313159210,153379,3313312589,18,0,0,512,18,2862884366
6190,3313169968,122623,3313292591,9,0,0,22528,9,1902075381
6191,3313173065,43628,3313216693,0,0,1,74752,0,7745282128
6192,3313200207,18007,3313218214,5,0,1,2048,5,3816678301
6193,3313244285,191249,3313435534,5,0,0,3584,5,7654947573
6194,3313265637,168611,3313434248,0,0,0,91648,0,268496873
6195,3313348591,85828,3313434419,17,0,0,512,17,2638852092
6196,3313406943,29116,3313436059,6,0,1,512,6,4758986242
6197,3313464636,12995,3313477631,0,0,1,25088,0,10017102908
6198,3313468717,129104,3313597821,7,0,1,204288,7,7713320754
6199,3313495928,108511,3313604439,16,0,1,31744,16,838366302
6200,3313528529,76576,3313605105,10,0,1,1024,10,9865305477
6201,3313538523,138988,3313677511,3,0,0,512,3,7408135496
6202,3313551425,169994,3313721419,11,0,0,28672,11,5230528678
6203,3313565670,44261,3313609931,14,0,1,7680,14,2315871414
6204,3313617036,43904,3313660940,14,0,0,512,14,211850773
6205,3313617817,5802,3313623619,18,0,1,6144,18,6821571850
6206,3313635387,5454,3313640841,11,0,1,13824,11,2796689242
6207,3313652687,16096,3313668783,7,0,1,31232,7,7676765855
6208,3313699775,3904,3313703679,3,0,1,10752,3,8756248876
6209,3313768092,4374,3313772466,5,0,1,4608,5,5103987299
6210,3313769265,124554,3313893819,8,0,0,20992,8,7472980472
6211,3313827302,97604,3313924906,19,0,0,20480,19,7594038459
6212,3313838099,169901,3314008000,11,0,0,44032,11,946309549
6213,3313880513,114048,3313994561,19,0,0,44544,19,2103790689
6214,3313896523,6229,3313902752,19,0,1,15360,19,7086135662
6215,3313961816,64888,3314026704,6,0,0,1536,6,2820812926
6216,3313982378,39698,3314022076,8,0,1,24064,8,71518067
6217,3313998206,25816,3314024022,19,0,1,3072,19,6331370210
6218,3314001113,25606,3314026719,11,0,1,3584,11,3298982097
6219,3314011849,128482,3314140331,13,0,0,67072,13,8195125418
6220,3314014419,176299,3314190718,12,0,0,69120,12,128003141
6221,3314019245,24670,3314043915,7,0,1,44544,7,6497874839
6222,3314043257,108031,3314151288,3,0,0,1024,3,5242350837
6223,3314047473,566,3314048039,11,0,1,512,11,7372977562
6224,3314051955,6754,3314058709,8,0,1,7168,8,10217511057
6225,3314059676,321056,3314380732,3,0,0,1536,3,2137433472
6226,3314069327,196533,3314265860,15,0,0,16896,15,9869483286
6227,3314108325,195779,3314304104,19,0,0,16384,19,6313721380
6228,3314108811,60824,3314169635,9,0,0,5632,9,9427975965
6229,3314168321,34664,3314202985,10,0,1,20480,10,5886764324
6230,3314176045,204025,3314380070,15,0,0,84992,15,8384976348
6231,3314202047,4679,3314206726,5,0,1,12288,5,6538700529
6232,3314202405,151754,3314354159,19,0,0,37376,19,8570566749
6233,3314211673,10241,3314221914,14,0,1,16384,14,9447343321
6234,3314237095,1042,3314238137,11,0,1,1024,11,10349076655
6235,3314262251,4167,3314266418,9,0,1,512,9,747576156
6236,3314269847,1042,3314270889,17,0,1,1024,17,3918756083
6237,3314282756,97485,3314380241,18,0,0,512,18,6095303787
6238,3314325688,55215,3314380903,14,0,0,512,14,3519860132
6239,3314334333,2946,3314337279,12,0,1,3072,12,10670999946
6240,3314337493,566,3314338059,10,0,1,512,10,4941916205
6241,3314358816,94085,3314452901,16,0,0,9216,16,7986121953
6242,3314391565,4850,3314396415,2,0,1,5120,2,6330775220
6243,3314418813,65687,3314484500,8,0,1,111104,8,4710275802
6244,3314485889,292982,3314778871,0,0,0,54784,0,3416127577
6245,3314495323,566,3314495889,11,0,1,512,11,3552044004
6246,3314497168,88337,3314585505,3,0,0,1536,3,6432195491
6247,3314517679,7706,3314525385,18,0,1,8192,18,3656523432
6248,3314569870,156758,3314726628,12,0,0,36864,12,79669464
6249,3314627644,1994,3314629638,3,0,1,2048,3,7784378317
6250,3314642076,230133,3314872209,8,0,0,127488,8,6345340213
6251,3314742001,130535,3314872536,3,0,0,1024,3,10400387237
6252,3314828628,43923,3314872551,1,0,1,7168,1,7086880788
6253,3314849163,140277,3314989440,19,0,0,43008,19,10050676606
6254,3314855762,23052,3314878814,17,0,1,15360,17,1117315220
6255,3314857689,32571,3314890260,7,0,1,25088,7,4248217716
6256,3314876907,131736,3315008643,4,0,0,62976,4,8176549830
6257,3314877064,136496,3315013560,4,0,0,5120,4,3930627624
6258,3314903922,1042,3314904964,15,0,1,1024,15,7414268437
6259,3314932759,157547,3315090306,5,0,0,18944,5,5198039803
6260,3314951391,149694,3315101085,14,0,0,35328,14,8415118498
6261,3314959137,566,3314959703,6,0,1,512,6,10535248428
6262,3315092682,67527,3315160209,7,0,0,5120,7,7976148907
6263,3315093430,128536,3315221966,12,0,0,32256,12,3010097954
6264,3315095712,19532,3315115244,8,0,1,24064,8,1758792779
6265,3315136431,107721,3315244152,3,0,0,1536,3,440959774
6266,3315143156,141636,3315284792,1,0,0,25600,1,2491687722
6267,3315152147,93229,3315245376,10,0,0,512,10,9173203000
6268,3315167411,3128,3315170539,17,0,1,9216,17,9572735463
6269,3315331345,108524,3315439869,11,0,0,56320,11,9570911897
6270,3315333077,112891,3315445968,8,0,0,19968,8,4867986807
6271,3315357998,125521,3315483519,12,0,0,22016,12,4930330825
6272,3315418180,4374,3315422554,1,0,1,4608,1,3613543358
6273,3315455563,6754,3315462317,1,0,1,7168,1,205215926
6274,3315485136,2470,3315487606,5,0,1,2560,5,9444123432
6275,3315552172,566,3315552738,14,0,1,512,14,3946521617
6276,3315572008,112580,3315684588,0,0,0,69632,0,8491748716
6277,3315578291,566,3315578857,14,0,1,512,14,2778879031
6278,3315660187,105404,3315765591,12,0,0,46080,12,9096120806
6279,3315679352,86262,3315765614,0,0,1,130560,0,3882440074
6280,3315716134,478194,3316194328,4,0,0,326144,4,7730479665
6281,3315725560,40069,3315765629,17,0,1,15872,17,9044711367
6282,3315739455,122658,3315862113,19,0,0,10240,19,7818850731
6283,3315757281,11256,3315768537,19,0,1,3072,19,9082196695
6284,3315776390,1042,3315777432,11,0,1,1024,11,7091255309
6285,3315805690,1042,3315806732,10,0,1,1024,10,2922304130
6286,3315819799,204315,3316024114,13,0,0,512,13,9195417
6287,3315821514,11791,3315833305,8,0,1,19456,8,1531729873
6288,3315828522,371920,3316200442,8,0,0,18944,8,3874852292
6289,3315832856,399211,3316232067,15,0,0,53248,15,631529943
6290,3315838301,197459,3316035760,0,0,0,34816,0,9085449086
6291,3315842790,3422,3315846212,18,0,1,3584,18,8571209968
6292,3315897023,2946,3315899969,19,0,1,3072,19,3792667173
6293,3315897379,3896,3315901275,5,0,1,2048,5,9279385097
6294,3315897701,7760,3315905461,11,0,1,6656,11,3179800629
6295,3315905546,3904,3315909450,7,0,1,10752,7,3140767278
6296,3315912730,107970,3316020700,6,0,0,512,6,964293756
6297,3315915479,285134,3316200613,18,0,0,512,18,3106841781
6298,3315921644,4679,3315926323,7,0,1,12288,7,9586841056
6299,3315930946,272490,3316203436,0,0,0,9216,0,6643231724
6300,3315934048,260607,3316194655,3,0,0,1024,3,2599575332
6301,3316007193,2946,3316010139,15,0,1,3072,15,924359376
6302,3316038880,166911,3316205791,11,0,0,7680,11,8885956471
6303,3316055796,159237,3316215033,8,0,0,1024,8,9083107421
6304,3316063929,150777,3316214706,12,0,0,29184,12,2243421498
6305,3316064316,151512,3316215828,7,0,0,2560,7,7167806736
6306,3316159092,160363,3316319455,5,0,0,73216,5,10170578496
6307,3316221646,140163,3316361809,5,0,0,24576,5,6779673129
6308,3316290870,4162,3316295032,6,0,1,11264,6,4080562678
6309,3316334165,47288,3316381453,6,0,0,1536,6,1655516719
6310,3316345431,130059,3316475490,6,0,0,512,6,4260618880
6311,3316345523,16301,3316361824,11,0,1,19456,11,7186171964
6312,3316354005,64896,3316418901,10,0,0,1024,10,7838360194
6313,3316416553,3128,3316419681,6,0,1,9216,6,39495478
6314,3316480969,46152,3316527121,10,0,0,1024,10,6277503392
6315,3316481525,106220,3316587745,4,0,0,15360,4,5301176577
6316,3316483703,2470,3316486173,9,0,1,2560,9,7075391759
6317,3316500178,82864,3316583042,0,0,0,8704,0,5844712660
6318,3316558291,96824,3316655115,8,0,0,17920,8,6930233722
6319,3316580589,14345,3316594934,16,0,1,7680,16,9404310705
6320,3316604308,104624,3316708932,14,0,0,43520,14,3410806821
6321,3316662236,132040,3316794276,15,0,0,49152,15,6852040953
6322,3316701454,65047,3316766501,6,0,0,512,6,8881969560
6323,3316720824,4374,3316725198,10,0,1,4608,10,5706836929
6324,3316722224,3640,3316725864,19,0,1,1024,19,5022733877
6325,3316757809,1994,3316759803,14,0,1,2048,14,8089446126
6326,3316774442,19849,3316794291,3,0,1,14336,3,52497658
6327,3316816484,7706,3316824190,8,0,1,8192,8,5824229524
6328,3316835383,116012,3316951395,5,0,0,80896,5,6729595511
6329,3316913658,3128,3316916786,5,0,1,9216,5,489716597
6330,3316938024,78195,3317016219,5,0,0,8704,5,4257689329
6331,3316964893,57758,3317022651,0,0,0,4608,0,10365426391
6332,3317010946,43904,3317054850,6,0,0,512,6,3102188734
6333,3317022078,42989,3317065067,7,0,1,69120,7,9939889924
6334,3317057447,7966,3317065413,3,0,1,512,3,7453490688
6335,3317092973,1518,3317094491,14,0,1,1536,14,3918552302
6336,3317112380,24929,3317137309,7,0,1,45056,7,4072246530
6337,3317122063,20635,3317142698,19,0,1,17408,19,3879951804
6338,3317143546,3128,3317146674,15,0,1,9216,15,3275021216
6339,3317154604,13600,3317168204,0,0,1,23040,0,9052687118
6340,3317208290,94341,3317302631,7,0,1,153600,7,5376990473
6341,3317251950,51142,3317303092,19,0,1,10240,19,7576388499
6342,3317318836,167778,3317486614,15,0,0,2560,15,9971702751
6343,3317403469,12737,3317416206,8,0,1,24576,8,3226671491
6344,3317411378,93410,3317504788,15,0,0,5632,15,29425903
6345,3317495047,92312,3317587359,1,0,0,1024,1,9021399345
6346,3317550428,43904,3317594332,14,0,0,512,14,9184844778
6347,3317558912,43904,3317602816,10,0,0,512,10,629811938
6348,3317644318,103808,3317748126,17,0,0,1024,17,467198629
6349,3317735004,51257,3317786261,0,0,1,82944,0,369335868
6350,3317795557,2470,3317798027,14,0,1,2560,14,600380487
6351,3317800520,190405,3317990925,1,0,0,11776,1,4296163458
6352,3317816954,104860,3317921814,8,0,0,36352,8,10038694912
6353,3317818316,1518,3317819834,12,0,1,1536,12,6558608183
6354,3317818545,3235,3317821780,10,0,1,3072,10,2165286342
6355,3317851209,5454,3317856663,12,0,1,13824,12,3605230480
6356,3317902494,45596,3317948090,3,0,0,1024,3,250495116
6357,3317987418,7661,3317995079,19,0,1,11264,19,6370280595
6358,3318052370,7706,3318060076,17,0,1,8192,17,9414177865
6359,3318073399,13341,3318086740,7,0,1,22528,7,7786250364
6360,3318085409,104636,3318190045,1,0,0,20480,1,1527389478
6361,3318118827,47756,3318166583,16,0,0,3072,16,9226822329
6362,3318141232,106957,3318248189,5,0,0,37888,5,2198360909
6363,3318158478,130475,3318288953,1,0,0,3072,1,1389097507
6364,3318160407,3898,3318164305,5,0,1,4096,5,8028706874
6365,3318186103,47838,3318233941,10,0,0,512,10,8383917865
6366,3318187317,4739,3318192056,19,0,1,2048,19,3229054454
6367,3318274844,566,3318275410,6,0,1,512,6,2485947932
6368,3318327519,5326,3318332845,10,0,1,5632,10,293759515
6369,3318352565,94858,3318447423,7,0,1,154624,7,7101541953
6370,3318356730,328260,3318684990,19,0,0,100864,19,7068511955
6371,3318370029,366406,3318736435,16,0,0,24576,16,1481401168
6372,3318385904,158042,3318543946,10,0,0,1024,10,1088417121
6373,3318420739,29910,3318450649,12,0,1,5120,12,926224368
6374,3318447915,175834,3318623749,16,0,0,44032,16,7318446436
6375,3318456945,330502,3318787447,0,0,0,13312,0,787662925
6376,3318525688,171485,3318697173,11,0,0,39936,11,4194683955
6377,3318597357,5971,3318603328,3,0,1,14848,3,7057049786
6378,3318627642,94176,3318721818,1,0,0,12800,1,3619401908
6379,3318639965,59677,3318699642,6,0,0,512,6,7037530621
6380,3318644459,2946,3318647405,19,0,1,3072,19,2289987081
6381,3318679998,94333,3318774331,17,0,0,512,17,6899239573
6382,3318720867,2461,3318723328,3,0,1,1536,3,2206436949
6383,3318776337,1518,3318777855,19,0,1,1536,19,6892562764
6384,3318817725,45596,3318863321,18,0,0,1024,18,10298595882
6385,3318842947,5326,3318848273,18,0,1,5632,18,10171982163
6386,3318849794,43887,3318893681,8,0,1,75264,8,7102956919
6387,3318881876,12573,3318894449,11,0,1,11776,11,6591224996
6388,3318930015,98440,3319028455,8,0,0,6144,8,3630807779
6389,3318982078,52364,3319034442,12,0,0,3072,12,5551091139
6390,3319024398,122603,3319147001,1,0,0,37888,1,2908640079
6391,3319067787,48980,3319116767,17,0,0,2048,17,7785501239
6392,3319083119,69181,3319152300,3,0,0,2560,3,4636908101
6393,3319119085,95468,3319214553,1,0,0,23552,1,10677804829
6394,3319198377,30749,3319229126,16,0,1,49664,16,9365336259
6395,3319204294,25818,3319230112,11,0,1,1536,11,7546520766
6396,3319242535,197465,3319440000,1,0,0,2048,1,10017652762
6397,3319256938,227382,3319484320,0,0,0,26624,0,2668793984
6398,3319313534,73456,3319386990,7,0,0,5632,7,8885298462
6399,3319356632,82348,3319438980,5,0,0,13824,5,907137559
6400,3319383985,157348,3319541333,8,0,0,20992,8,10579259324
6401,3319390192,10241,3319400433,15,0,1,16384,15,3396282374
6402,3319404244,114001,3319518245,13,0,0,10752,13,9818818043
6403,3319412069,3422,3319415491,11,0,1,3584,11,10662865391
6404,3319413186,169337,3319582523,1,0,0,18944,1,4565015555
6405,3319413695,16096,3319429791,19,0,1,31232,19,6523665307
6406,3319466726,1994,3319468720,9,0,1,2048,9,8500117541
6407,3319512098,566,3319512664,0,0,1,512,0,4447462024
6408,3319524640,251682,3319776322,14,0,0,97280,14,9105435610
6409,3319596024,1042,3319597066,15,0,1,1024,15,9610381311
6410,3319630566,198682,3319829248,19,0,0,43008,19,7678477137
6411,3319680350,55748,3319736098,7,0,0,4096,7,13578976
6412,3319709758,162427,3319872185,7,0,0,68096,7,9976465606
6413,3319732083,215155,3319947238,15,0,0,40960,15,9077467249
6414,3319735671,151592,3319887263,8,0,0,48128,8,5604351082
6415,3319767333,10499,3319777832,10,0,1,1536,10,258146735
6416,3319788966,142559,3319931525,5,0,0,37376,5,8722579919
6417,3319824631,127146,3319951777,19,0,0,14848,19,5023022179
6418,3319836400,12737,3319849137,7,0,1,24576,7,6558955763
6419,3319851067,120406,3319971473,0,0,0,33792,0,4189402277
6420,3319923411,78554,3320001965,5,0,0,9216,5,3085764591
6421,3319948067,9504,3319957571,17,0,1,6144,17,5272351294
6422,3319956670,2527,3319959197,5,0,1,2560,5,4174971978
6423,3319968541,134203,3320102744,16,0,0,2560,16,8439301601
6424,3320000142,43981,3320044123,8,0,1,68608,8,3991244958
6425,3320002491,43898,3320046389,3,0,1,3584,3,544651487
6426,3320071141,2470,3320073611,14,0,1,2560,14,10371363600
6427,3320114906,47288,3320162194,3,0,0,1536,3,5811930022
6428,3320194846,105404,3320300250,14,0,0,46080,14,3667298389
6429,3320196494,207052,3320403546,9,0,0,80384,9,8903003892
6430,3320212002,1042,3320213044,18,0,1,1024,18,6750556785
6431,3320223925,248243,3320472168,4,0,0,32256,4,8510526263
6432,3320229620,3387,3320233007,19,0,1,9728,19,3550139892
6433,3320259443,161925,3320421368,8,0,0,22528,8,6211758958
6434,3320265272,149209,3320414481,5,0,0,35840,5,7792832536
6435,3320302326,176781,3320479107,1,0,0,8704,1,4522804994
6436,3320306708,3898,3320310606,14,0,1,4096,14,3506173431
6437,3320397520,76223,3320473743,1,0,0,5120,1,9832649706
6438,3320447559,1042,3320448601,1,0,1,1024,1,9160185804
6439,3320450038,140764,3320590802,4,0,0,41984,4,8791025827
6440,3320450152,5802,3320455954,14,0,1,6144,14,8332916001
6441,3320495911,148259,3320644170,15,0,0,69120,15,10238356321
6442,3320542556,129472,3320672028,14,0,0,8192,14,4792252357
6443,3320549267,146497,3320695764,12,0,0,25600,12,6056891111
6444,3320568725,3898,3320572623,9,0,1,4096,9,2557099422
6445,3320607380,131920,3320739300,8,0,0,72704,8,6947262986
6446,3320640375,180040,3320820415,5,0,0,64000,5,2807627048
6447,3320641286,25763,3320667049,0,0,1,40960,0,9485025196
6448,3320649610,22585,3320672195,14,0,1,8192,14,9544266254
6449,3320660330,80545,3320740875,7,0,0,5120,7,4875021462
6450,3320700335,165499,3320865834,16,0,0,76288,16,5833993074
6451,3320777839,142150,3320919989,14,0,0,4608,14,10368367394
6452,3320781512,89657,3320871169,7,0,0,17408,7,436469038
6453,3320804531,100783,3320905314,3,0,0,2048,3,10074587911
6454,3320807277,16283,3320823560,7,0,1,9216,7,1276448812
6455,3320850065,218653,3321068718,1,0,0,47104,1,6521992879
6456,3320851432,24116,3320875548,9,0,1,11776,9,8689850227
6457,3320875140,2870,3320878010,2,0,1,8704,2,1819275218
6458,3320876282,61607,3320937889,3,0,0,2048,3,8577021536
6459,3320896784,4850,3320901634,15,0,1,5120,15,5342190840
6460,3320897121,5176,3320902297,14,0,1,10752,14,7151035659
6461,3320903722,25446,3320929168,0,0,1,46080,0,10729496824
6462,3320909081,24593,3320933674,1,0,1,7168,1,6062746771
6463,3320944370,4162,3320948532,9,0,1,11264,9,9407347201
6464,3320968354,75284,3321043638,17,0,0,5120,17,9323285824
6465,3320983091,3422,3320986513,3,0,1,3584,3,2993029018
6466,3321059414,32416,3321091830,0,0,1,41472,0,3874203738
6467,3321082177,12879,3321095056,12,0,1,5120,12,9534880898
6468,3321127581,67592,3321195173,7,0,0,7680,7,9733088829
6469,3321192085,47980,3321240065,3,0,0,1536,3,1493828545
6470,3321195166,196944,3321392110,18,0,0,2560,18,7868174800
6471,3321196065,6754,3321202819,9,0,1,7168,9,7081963440
6472,3321213806,135688,3321349494,19,0,0,54784,19,671550626
6473,3321219842,141020,3321360862,6,0,0,4096,6,221818862
6474,3321237563,566,3321238129,3,0,1,512,3,445005507
6475,3321313434,207887,3321521321,11,0,0,56320,11,4445415100
6476,3321317011,3128,3321320139,1,0,1,9216,1,862618973
6477,3321323727,7706,3321331433,11,0,1,8192,11,875158244
6478,3321341392,104415,3321445807,0,0,1,160768,0,1674867733
6479,3321395933,130551,3321526484,7,0,0,16896,7,2549745168
6480,3321402018,65601,3321467619,7,0,1,71680,7,7356837454
6481,3321445666,37711,3321483377,8,0,1,50688,8,449512915
6482,3321476901,13512,3321490413,16,0,1,26112,16,5691494916
6483,3321492972,190683,3321683655,7,0,0,24576,7,5413123351
6484,3321502228,215645,3321717873,6,0,0,1024,6,8758893829
6485,3321526726,1518,3321528244,4,0,1,1536,4,9423142877
6486,3321582866,43904,3321626770,18,0,0,512,18,3651022075
6487,3321592616,35571,3321628187,16,0,1,62464,16,2972192634
6488,3321618652,13401,3321632053,10,0,1,6144,10,466531510
6489,3321629904,5695,3321635599,17,0,1,5632,17,3177965888
6490,3321633097,3488,3321636585,6,0,1,1536,6,10656374094
6491,3321658412,135852,3321794264,6,0,0,512,6,8284008830
6492,3321701533,244972,3321946505,7,0,0,13312,7,2631944956
6493,3321718560,2470,3321721030,3,0,1,2560,3,7703371806
6494,3321723226,273451,3321996677,9,0,0,132608,9,10397579136
6495,3321732803,6229,3321739032,14,0,1,15360,14,420737090
6496,3321814640,117909,3321932549,1,0,0,83456,1,4733695406
6497,3321859158,7230,3321866388,14,0,1,7680,14,9661021379
6498,3321876472,64795,3321941267,3,0,0,512,3,5657739686
6499,3321939795,83727,3322023522,10,0,0,512,10,65003969
6500,3321940209,100880,3322041089,4,0,0,31232,4,1133273206
6501,3322004183,15321,3322019504,16,0,1,29696,16,4271724162
6502,3322010700,118468,3322129168,0,0,0,18944,0,2790420585
6503,3322020127,146804,3322166931,12,0,0,10752,12,7064996703
6504,3322042026,72380,3322114406,4,0,0,13312,4,6359492340
6505,3322120054,566,3322120620,3,0,1,512,3,9786678897
6506,3322133864,205754,3322339618,0,0,0,73728,0,7333921311
6507,3322135972,81116,3322217088,7,0,1,131072,7,190201979
6508,3322137075,80167,3322217242,3,0,1,8704,3,4898814316
6509,3322142263,170437,3322312700,8,0,1,217600,8,2303177706
6510,3322265863,48143,3322314006,10,0,1,2048,10,2289731902
6511,3322282185,57448,3322339633,16,0,1,18944,16,2926334575
6512,3322306301,33347,3322339648,8,0,1,3072,8,2090797560
6513,3322332680,8954,3322341634,10,0,1,2048,10,3089465214
6514,3322344593,204455,3322549048,10,0,0,1536,10,5392729601
6515,3322349632,87763,3322437395,17,0,0,512,17,261130890
6516,3322382313,1518,3322383831,6,0,1,1536,6,8167759090
6517,3322388437,295067,3322683504,7,0,0,54784,7,8081049565
6518,3322415193,99164,3322514357,15,0,0,25600,15,3840953047
6519,3322424276,165691,3322589967,19,0,0,41984,19,6139843654
6520,3322456315,4374,3322460689,4,0,1,4608,4,5775025525
6521,3322470948,10241,3322481189,9,0,1,16384,9,6791545882
6522,3322491964,4420,3322496384,7,0,1,11776,7,8443388476
6523,3322526942,244345,3322771287,7,0,0,108032,7,8147718724
6524,3322541357,74003,3322615360,8,0,1,123904,8,5857398093
6525,3322556622,62604,3322619226,2,0,1,6144,2,6570844864
6526,3322583590,38862,3322622452,5,0,1,5120,5,4497163683
6527,3322590223,222919,3322813142,1,0,0,12800,1,9456693116
6528,3322626515,161643,3322788158,7,0,0,40448,7,5752284851
6529,3322668222,103251,3322771473,17,0,0,512,17,4512585842
6530,3322738176,33126,3322771302,19,0,1,4096,19,10002296087
6531,3323081012,31783,3323112795,7,0,1,51712,7,1403914497
6532,3323088972,24899,3323113871,6,0,1,13312,6,6536627896
6533,3323184219,45596,3323229815,17,0,0,1024,17,8432206284
6534,3323237597,1994,3323239591,17,0,1,2048,17,7588869274
6535,3323238614,113279,3323351893,9,0,0,11776,9,8054055251
6536,3323242730,105560,3323348290,5,0,0,46592,5,8703623947
6537,3323245010,2470,3323247480,9,0,1,2560,9,689704122
6538,3323285563,7706,3323293269,3,0,1,8192,3,3606695975
6539,3323302375,94779,3323397154,19,0,0,3072,19,8754766456
6540,3323323242,145646,3323468888,9,0,0,40960,9,8532602946
6541,3323370472,4850,3323375322,18,0,1,5120,18,1400604934
6542,3323414313,566,3323414879,2,0,1,512,2,8566921180
6543,3323436275,104073,3323540348,8,0,0,35328,8,1376769925
6544,3323438889,53843,3323492732,11,0,0,1024,11,3412367226
6545,3323440652,100335,3323540987,17,0,0,2048,17,6290210214
6546,3323447210,111060,3323558270,15,0,0,17408,15,1570412744
6547,3323449301,2470,3323451771,15,0,1,2560,15,1660173148
6548,3323452001,16902,3323468903,4,0,1,5632,4,848148964
6549,3323459768,14581,3323474349,19,0,1,13824,19,4424606189
6550,3323491189,83935,3323575124,1,0,0,1024,1,10672878010
6551,3323561419,7706,3323569125,3,0,1,8192,3,2574759578
6552,3323703271,7230,3323710501,4,0,1,7680,4,7758747466
6553,3323722089,3898,3323725987,4,0,1,4096,4,755007288
6554,3323745487,2470,3323747957,18,0,1,2560,18,3975611977
6555,3323771286,3387,3323774673,18,0,1,9728,18,10634673207
6556,3323779699,84716,3323864415,11,0,0,23552,11,3354457960
6557,3323816320,1518,3323817838,15,0,1,1536,15,4688952659
6558,3323835726,4374,3323840100,2,0,1,4608,2,9660331699
6559,3323841697,107589,3323949286,1,0,0,22528,1,6394761364
6560,3323871179,4850,3323876029,0,0,1,5120,0,9818263875
6561,3323883361,242188,3324125549,16,0,0,7680,16,8985664597
6562,3323891444,1042,3323892486,12,0,1,1024,12,94989203
6563,3323941112,8189,3323949301,17,0,1,8704,17,6463819590
6564,3323946359,280845,3324227204,4,0,0,105984,4,3560230667
6565,3323968644,6754,3323975398,17,0,1,7168,17,9140042256
6566,3323989439,6278,3323995717,6,0,1,6656,6,4745963357
6567,3323994855,13253,3324008108,16,0,1,25600,16,6067457847
6568,3323996642,13092,3324009734,3,0,1,2560,3,8798076391
6569,3324033540,212726,3324246266,15,0,0,53760,15,5000528655
6570,3324048339,181532,3324229871,14,0,0,8704,14,8873294608
6571,3324052149,4420,3324056569,2,0,1,11776,2,7829378831
6572,3324088801,44492,3324133293,7,0,1,73216,7,9757936445
6573,3324096713,250650,3324347363,11,0,0,3584,11,8886349161
6574,3324159597,7706,3324167303,4,0,1,8192,4,3956565191
6575,3324165948,325913,3324491861,11,0,0,249856,11,4360630771
6576,3324188613,156381,3324344994,9,0,0,512,9,5315625495
6577,3324255536,265869,3324521405,13,0,0,68608,13,5605896408
6578,3324273886,11533,3324285419,12,0,1,18944,12,7845284400
6579,3324280345,220111,3324500456,11,0,0,28160,11,209672575
6580,3324349679,337395,3324687074,1,0,0,56832,1,7635743307
6581,3324360517,193304,3324553821,5,0,0,61440,5,4179390360
6582,3324364665,135806,3324500471,0,0,1,124928,0,9176757834
6583,3324370445,130041,3324500486,19,0,1,512,19,3684300525
6584,3324397400,226975,3324624375,15,0,0,65024,15,1378346918
6585,3324470294,184953,3324655247,0,0,1,217088,0,10396962481
6586,3324486621,267659,3324754280,15,0,0,34304,15,3169241810
6587,3324519945,174320,3324694265,5,0,0,23552,5,3182428405
6588,3324548110,263993,3324812103,0,0,0,30208,0,1289996321
6589,3324601274,186180,3324787454,12,0,0,26112,12,183896392
6590,3324721673,133036,3324854709,3,0,0,2560,3,3862845010
6591,3324764226,566,3324764792,4,0,1,512,4,917491843
6592,3324780523,9410,3324789933,5,0,1,2560,5,4856877430
6593,3324784607,63676,3324848283,18,0,0,512,18,4727352811
6594,3324799085,250176,3325049261,3,0,0,1024,3,1118766829
6595,3324806434,113561,3324919995,11,0,0,54272,11,5542517426
6596,3324830569,43904,3324874473,18,0,0,512,18,1675390253
6597,3324869131,7230,3324876361,5,0,1,7680,5,2812875963
6598,3324894836,2470,3324897306,6,0,1,2560,6,9458019040
6599,3324939113,1994,3324941107,2,0,1,2048,2,8785284310
6600,3324941178,1518,3324942696,14,0,1,1536,14,620943661
6601,3324977685,156311,3325133996,1,0,0,7168,1,1722169481
6602,3324994964,1518,3324996482,19,0,1,1536,19,1519384618
6603,3325026227,157881,3325184108,0,0,0,80896,0,4482292383
6604,3325072266,5454,3325077720,19,0,1,13824,19,7315908375
6605,3325178462,119472,3325297934,1,0,0,23040,1,5855739360
6606,3325181160,48561,3325229721,19,0,0,1024,19,6502422339
6607,3325274954,14804,3325289758,8,0,1,28672,8,3869923854
6608,3325277422,63503,3325340925,17,0,0,512,17,4049743877
6609,3325300925,43904,3325344829,17,0,0,512,17,1473979050
6610,3325306522,5326,3325311848,12,0,1,5632,12,7860703880
6611,3325327458,257969,3325585427,11,0,0,90624,11,2464098759
6612,3325400729,10499,3325411228,8,0,1,16896,8,5546229967
6613,3325429908,14117,3325444025,7,0,1,24064,7,9130234610
6614,3325468877,288101,3325756978,10,0,0,512,10,4701190440
6615,3325483930,102612,3325586542,0,0,0,3584,0,4685081383
6616,3325500011,243654,3325743665,8,0,0,173056,8,5456318202
6617,3325530825,152014,3325682839,18,0,0,512,18,5487041453
6618,3325549314,201550,3325750864,5,0,0,23552,5,3388797058
6619,3325561491,195316,3325756807,8,0,0,19456,8,772876608
6620,3325570993,16107,3325587100,15,0,1,512,15,7953036011
6621,3325590081,2470,3325592551,12,0,1,2560,12,1007619956
6622,3325591506,5196,3325596702,4,0,1,13312,4,2680188899
6623,3325605691,185903,3325791594,15,0,0,29184,15,3653568463
6624,3325605959,2946,3325608905,2,0,1,3072,2,6901033969
6625,3325617013,236582,3325853595,17,0,0,2560,17,3379919328
6626,3325630270,13341,3325643611,0,0,1,22528,0,3260939245
6627,3325685960,241135,3325927095,18,0,0,2048,18,4145803857
6628,3325695815,66022,3325761837,4,0,1,5120,4,9081124948
6629,3325716476,45707,3325762183,5,0,1,512,5,3682598819
6630,3325743600,22129,3325765729,5,0,1,5632,5,1027881552
6631,3325784177,154956,3325939133,3,0,0,2560,3,2589682508
6632,3325825391,1042,3325826433,5,0,1,1024,5,8158012964
6633,3325827683,98773,3325926456,14,0,0,24064,14,5162167147
6634,3325847408,1042,3325848450,2,0,1,1024,2,5240783152
6635,3325877680,566,3325878246,9,0,1,512,9,10519846619
6636,3325891211,125637,3326016848,16,0,0,36352,16,2557398259
6637,3325898696,77924,3325976620,1,0,0,16384,1,10119394415
6638,3325923183,54576,3325977759,14,0,0,2560,14,5624203710
6639,3325951619,137655,3326089274,1,0,0,46080,1,8771396549
6640,3325964041,125560,3326089601,3,0,0,1024,3,6334743035
6641,3325988905,5326,3325994231,4,0,1,5632,4,3032202120
6642,3326114249,74360,3326188609,15,0,0,9728,15,4217382050
6643,3326142152,6754,3326148906,1,0,1,7168,1,3480581443
6644,3326159808,115544,3326275352,0,0,0,79360,0,3799643811
6645,3326174175,137044,3326311219,4,0,0,43008,4,4918686341
6646,3326210001,148391,3326358392,7,0,0,52224,7,2980697598
6647,3326252708,113310,3326366018,10,0,0,512,10,10221794372
6648,3326253414,22997,3326276411,17,0,1,1024,17,7725227279
6649,3326315247,174618,3326489865,15,0,0,40448,15,6677416040
6650,3326337025,112892,3326449917,11,0,0,70656,11,5339600244
6651,3326378434,167722,3326546156,17,0,0,512,17,7408974214
6652,3326380625,154779,3326535404,10,0,0,512,10,6762471710
6653,3326440047,10428,3326450475,10,0,1,512,10,1565880852
6654,3326454871,70375,3326525246,19,0,0,3584,19,2697243775
6655,3326455676,241096,3326696772,16,0,0,50688,16,1846359139
6656,3326457447,3387,3326460834,0,0,1,9728,0,8033926276
6657,3326515004,69703,3326584707,10,0,0,512,10,4445897648
6658,3326517177,2470,3326519647,3,0,1,2560,3,10351407537
6659,3326540740,1994,3326542734,10,0,1,2048,10,4777273341
6660,3326556495,22862,3326579357,8,0,1,40960,8,3356456621
6661,3326575082,9101,3326584183,5,0,1,7680,5,2511848981
6662,3326592911,14117,3326607028,9,0,1,24064,9,6225892651
6663,3326593656,103755,3326697411,15,0,0,2048,15,8182995593
6664,3326608205,1518,3326609723,18,0,1,1536,18,9434037512
6665,3326616854,4850,3326621704,1,0,1,5120,1,2375127854
6666,3326727569,4162,3326731731,12,0,1,11264,12,2486535701
6667,3326735037,176800,3326911837,9,0,0,50176,9,4078466781
6668,3326778477,1042,3326779519,19,0,1,1024,19,4067320462
6669,3326803097,119316,3326922413,15,0,0,20480,15,7917164500
6670,3326806002,106922,3326912924,3,0,0,1024,3,9365492524
6671,3326820838,91014,3326911852,7,0,1,139264,7,722546425
6672,3326843106,300625,3327143731,12,0,0,34816,12,3999518142
6673,3326889486,45596,3326935082,18,0,0,1024,18,960944008
6674,3326893275,187458,3327080733,12,0,0,88576,12,9261569318
6675,3326920384,9251,3326929635,14,0,1,7680,14,68279791
6676,3326922492,10689,3326933181,5,0,1,5632,5,8344197049
6677,3326925244,242205,3327167449,13,0,0,40960,13,8365241083
6678,3326934930,6898,3326941828,10,0,1,7168,10,10707407789
6679,3326937316,5690,3326943006,2,0,1,13824,2,1544749550
6680,3326966294,3898,3326970192,16,0,1,4096,16,2459733995
6681,3326974666,3898,3326978564,6,0,1,4096,6,7318784025
6682,3327012182,190943,3327203125,4,0,0,16896,4,4084035098
6683,3327032747,1518,3327034265,18,0,1,1536,18,7651479659
6684,3327098897,84387,3327183284,16,0,1,140800,16,8680024860
6685,3327103825,81725,3327185550,18,0,1,3584,18,5732325413
6686,3327122384,189533,3327311917,8,0,0,74752,8,2661116729
6687,3327136802,288378,3327425180,19,0,0,14848,19,153690168
6688,3327194264,79315,3327273579,10,0,0,1536,10,8857911828
6689,3327233372,176868,3327410240,19,0,0,6144,19,1622792492
6690,3327265357,3387,3327268744,17,0,1,9728,17,6352042162
6691,3327266912,172948,3327439860,8,0,0,5632,8,8019947069
6692,3327277458,139829,3327417287,18,0,0,512,18,7122312919
6693,3327359184,156519,3327515703,5,0,0,7168,5,9661409747
6694,3327361202,63993,3327425195,8,0,1,106496,8,8043289073
6695,3327397525,227582,3327625107,14,0,0,114176,14,3274914451
6696,3327419700,6349,3327426049,7,0,1,15360,7,9586586117
6697,3327429739,210671,3327640410,7,0,0,50176,7,8892830991
6698,3327458374,3387,3327461761,12,0,1,9728,12,2896998115
6699,3327463590,309581,3327773171,4,0,0,96256,4,184744125
6700,3327479899,566,3327480465,3,0,1,512,3,428319748
6701,3327493268,250010,3327743278,17,0,0,3072,17,6777192422
6702,3327541013,240528,3327781541,5,0,0,20480,5,6804107161
6703,3327588690,103209,3327691899,8,0,0,38400,8,9052333414
6704,3327628987,234010,3327862997,8,0,0,76800,8,8335538503
6705,3327635266,6679,3327641945,7,0,1,1536,7,4736148875
6706,3327644652,3422,3327648074,6,0,1,3584,6,185440682
6707,3327683921,11098,3327695019,5,0,1,9216,5,2376681893
6708,3327709527,117341,3327826868,9,0,0,4608,9,5942545757
6709,3327763986,102778,3327866764,9,0,0,12288,9,9270676789
6710,3327771670,9886,3327781556,9,0,1,2560,9,8988580099
6711,3327840362,97143,3327937505,7,0,0,10240,7,9612797019
6712,3327907970,2470,3327910440,5,0,1,2560,5,334866020
6713,3327989400,145966,3328135366,9,0,0,20480,9,9854275935
6714,3328014506,4850,3328019356,1,0,1,5120,1,1183842810
6715,3328048030,113448,3328161478,14,0,0,20480,14,4281300333
6716,3328079348,112053,3328191401,3,0,0,512,3,4553180320
6717,3328125616,9765,3328135381,16,0,1,15360,16,9297591098
6718,3328132918,46359,3328179277,17,0,0,512,17,6253504724
6719,3328154371,7130,3328161501,6,0,1,14336,6,3213189074
6720,3328158770,91462,3328250232,14,0,0,14336,14,136656820
6721,3328173648,3898,3328177546,18,0,1,4096,18,5812831054
6722,3328207326,45596,3328252922,6,0,0,1024,6,3677243013
6723,3328339134,566,3328339700,18,0,1,512,18,9834497858
6724,3328339443,10499,3328349942,16,0,1,16896,16,8721751380
6725,3328347592,4936,3328352528,6,0,1,4096,6,2050639585
6726,3328347773,5741,3328353514,12,0,1,1536,12,1091167566
6727,3328348975,11964,3328360939,19,0,1,18944,19,5540670209
6728,3328359366,108857,3328468223,19,0,0,24576,19,9707899923
6729,3328395134,5326,3328400460,15,0,1,5632,15,1399876010
6730,3328396889,6797,3328403686,19,0,1,5120,19,9948052039
6731,3328479067,43904,3328522971,17,0,0,512,17,9326769356
6732,3328557194,93752,3328650946,19,0,0,17920,19,67543803
6733,3328580211,57440,3328637651,16,0,0,4608,16,9417544521
6734,3328586988,7230,3328594218,14,0,1,7680,14,7383390976
6735,3328633988,102908,3328736896,4,0,0,37888,4,1404513397
6736,3328669504,160410,3328829914,5,0,0,115200,5,734096725
6737,3328684550,11016,3328695566,4,0,1,17920,4,9771545729
6738,3328711946,1994,3328713940,1,0,1,2048,1,1332396469
6739,3328798056,33861,3328831917,17,0,1,2048,17,1467099542
6740,3328805658,95249,3328900907,0,0,0,8704,0,5820953962
6741,3328857604,87590,3328945194,6,0,0,512,6,7561837175
6742,3328869142,7706,3328876848,14,0,1,8192,14,5048949609
6743,3328902905,87479,3328990384,4,0,0,11264,4,8544261527
6744,3328923268,85686,3329008954,3,0,0,512,3,6764234886
6745,3328923497,239282,3329162779,5,0,0,91136,5,9615261916
6746,3328926260,4420,3328930680,10,0,1,11776,10,219827452
6747,3328953286,170032,3329123318,0,0,0,9728,0,3197392875
6748,3328956393,259755,3329216148,12,0,0,93184,12,1029296621
6749,3328957966,1042,3328959008,5,0,1,1024,5,7156885821
6750,3328969732,93585,3329063317,10,0,0,512,10,6859369127
6751,3328998969,3128,3329002097,19,0,1,9216,19,4344033034
6752,3329043493,1518,3329045011,2,0,1,1536,2,2717068687
6753,3329053323,3645,3329056968,7,0,1,10240,7,8566839565
6754,3329077150,4374,3329081524,1,0,1,4608,1,1618618018
6755,3329103518,1042,3329104560,6,0,1,1024,6,8996992347
6756,3329135166,81013,3329216179,0,0,1,80896,0,3298559251
6757,3329137900,78294,3329216194,14,0,1,1536,14,1455653563
6758,3329196499,21668,3329218167,18,0,1,2048,18,6752681591
6759,3329200993,18800,3329219793,5,0,1,2560,5,5615126461
6760,3329219803,98696,3329318499,15,0,0,24064,15,1017942770
6761,3329229084,15321,3329244405,0,0,1,29696,0,7876663270
6762,3329238149,371073,3329609222,8,0,0,45568,8,8089410763
6763,3329264531,139868,3329404399,18,0,0,1024,18,10466211190
6764,3329266899,273257,3329540156,12,0,0,97280,12,2496680355
6765,3329324443,138613,3329463056,6,0,0,512,6,1827139030
6766,3329376845,22433,3329399278,7,0,1,36864,7,7249396017
6767,3329446542,103028,3329549570,6,0,0,1024,6,858308051
6768,3329471796,3898,3329475694,17,0,1,4096,17,9583608165
6769,3329472488,4832,3329477320,3,0,1,2560,3,10486179613
6770,3329500249,43904,3329544153,3,0,0,512,3,4115575822
6771,3329523438,86126,3329609564,18,0,0,1024,18,10469612497
6772,3329547633,45596,3329593229,10,0,0,1024,10,6939035736
6773,3329548865,234398,3329783263,11,0,0,87040,11,1335242211
6774,3329573624,5802,3329579426,3,0,1,6144,3,8644787683
6775,3329592434,16803,3329609237,6,0,1,3584,6,591224700
6776,3329593372,93520,3329686892,18,0,0,3072,18,7571295309
6777,3329622860,192384,3329815244,10,0,0,2048,10,5411085691
6778,3329625539,52528,3329678067,10,0,0,2048,10,2538498431
6779,3329635690,43904,3329679594,10,0,0,512,10,3243831348
6780,3329636943,153355,3329790298,0,0,0,23040,0,9576200809
6781,3329662011,3387,3329665398,15,0,1,9728,15,3509440685
6782,3329663649,45279,3329708928,3,0,0,512,3,9127507350
6783,3329686129,2273,3329688402,12,0,1,1536,12,4109886489
6784,3329708967,7230,3329716197,7,0,1,7680,7,1247498165
6785,3329728920,72917,3329801837,10,0,0,512,10,10734796458
6786,3329745162,566,3329745728,2,0,1,512,2,928910694
6787,3329813136,315244,3330128380,0,0,0,272896,0,45476796
6788,3329845193,304114,3330149307,14,0,0,68608,14,3991464711
6789,3329869352,173294,3330042646,9,0,0,12800,9,8597280487
6790,3329895876,5326,3329901202,2,0,1,5632,2,7302160153
6791,3329899253,61112,3329960365,10,0,0,512,10,1070320240
6792,3329941025,217969,3330158994,5,0,0,31744,5,4304573843
6793,3329943792,566,3329944358,17,0,1,512,17,2538065229
6794,3329979401,1518,3329980919,3,0,1,1536,3,7551235399
6795,3329996835,2470,3329999305,10,0,1,2560,10,10350856116
6796,3330057068,115208,3330172276,6,0,0,512,6,3409297989
6797,3330108808,63498,3330172306,0,0,1,25600,0,9994665196
6798,3330124935,51237,3330176172,6,0,1,6144,6,7408358636
6799,3330140917,35511,3330176428,17,0,1,9216,17,10326070302
6800,3330144126,33928,3330178054,5,0,1,2560,5,8341652827
6801,3330160056,58066,3330218122,6,0,0,512,6,533310284
6802,3330178910,67880,3330246790,7,0,0,6656,7,10062341237
6803,3330252640,5802,3330258442,2,0,1,6144,2,9152100360
6804,3330262153,64076,3330326229,9,0,0,11264,9,3929966997
6805,3330302588,73358,3330375946,0,0,0,4608,0,4568049213
6806,3330320042,67304,3330387346,14,0,0,11776,14,2936829814
6807,3330374699,70835,3330445534,12,0,0,4608,12,4818006150
6808,3330387542,566,3330388108,18,0,1,512,18,10319755009
6809,3330406171,566,3330406737,17,0,1,512,17,2034062739
6810,3330478986,43904,3330522890,18,0,0,512,18,3535831656
6811,3330490507,7230,3330497737,2,0,1,7680,2,6684016638
6812,3330496326,165526,3330661852,18,0,0,1024,18,4682410758
6813,3330501370,57235,3330558605,5,0,0,512,5,2754693369
6814,3330517994,4374,3330522368,19,0,1,4608,19,6246971784
6815,3330538172,1994,3330540166,0,0,1,2048,0,8404803609
6816,3330548141,5326,3330553467,15,0,1,5632,15,3067209204
6817,3330558865,53853,3330612718,18,0,0,1024,18,6365165796
6818,3330622914,7230,3330630144,17,0,1,7680,17,4996387227
6819,3330633197,4374,3330637571,6,0,1,4608,6,9184926301
6820,3330678552,25187,3330703739,7,0,1,45568,7,3487699135
6821,3330682933,24672,3330707605,1,0,1,6144,1,7763974523
6822,3330730554,80537,3330811091,3,0,0,1536,3,8182597684
6823,3330814887,87140,3330902027,7,0,0,16384,7,5460679652
6824,3330846050,4850,3330850900,3,0,1,5120,3,3115845277
6825,3330854381,1994,3330856375,4,0,1,2048,4,5274164551
6826,3330885290,100100,3330985390,14,0,0,28672,14,5545333847
6827,3330889481,137472,3331026953,3,0,0,3584,3,1137474848
6828,3330902588,6488,3330909076,0,0,1,15872,0,7884611901
6829,3330941450,56012,3330997462,3,0,0,512,3,2483485412
6830,3330965416,2946,3330968362,10,0,1,3072,10,670462883
6831,3330977800,109543,3331087343,9,0,0,34304,9,7887839214
6832,3330994812,116362,3331111174,0,0,0,37376,0,4097310648
6833,3330997312,2612,3330999924,6,0,1,2560,6,396694754
6834,3331038973,82815,3331121788,10,0,0,512,10,5979526391
6835,3331059907,209128,3331269035,9,0,0,12288,9,9291927776
6836,3331088197,6278,3331094475,5,0,1,6656,5,2467740624
6837,3331144011,5802,3331149813,12,0,1,6144,12,6043735417
6838,3331254846,14204,3331269050,8,0,1,16896,8,546764117
6839,3331256411,12654,3331269065,2,0,1,4096,2,4689519176
6840,3331279474,106340,3331385814,11,0,0,49152,11,4013087652
6841,3331283739,106458,3331390197,11,0,0,14336,11,10269060220
6842,3331303145,139459,3331442604,14,0,0,32768,14,4360629398
6843,3331330785,5802,3331336587,5,0,1,6144,5,9801052003
6844,3331367877,107479,3331475356,8,0,1,179200,8,8351170262
6845,3331406314,107540,3331513854,5,0,0,19968,5,3165018115
6846,3331406755,75219,3331481974,19,0,1,23552,19,5932300893
6847,3331411381,60479,3331471860,3,0,0,512,3,3091232684
6848,3331425355,58245,3331483600,3,0,1,2560,3,6899135746
6849,3331461902,25884,3331487786,4,0,1,6656,4,1230714859
6850,3331520434,4937,3331525371,19,0,1,12800,19,4586754906
6851,3331544949,300770,3331845719,5,0,0,46080,5,3092704225
6852,3331546054,2946,3331549000,5,0,1,3072,5,1428836671
6853,3331567821,1518,3331569339,10,0,1,1536,10,7278196851
6854,3331570283,1994,3331572277,12,0,1,2048,12,779717858
6855,3331579409,270381,3331849790,12,0,0,13312,12,3214793947
6856,3331585687,141548,3331727235,11,0,0,46080,11,4236116927
6857,3331622413,5196,3331627609,12,0,1,13312,12,3949302052
6858,3331632573,1042,3331633615,4,0,1,1024,4,2378226810
6859,3331673674,1042,3331674716,19,0,1,1024,19,6901472971
6860,3331684208,4850,3331689058,9,0,1,5120,9,9882039696
6861,3331752801,2946,3331755747,2,0,1,3072,2,7356486146
6862,3331756501,166839,3331923340,4,0,0,11776,4,7258925059
6863,3331758582,116919,3331875501,6,0,0,1024,6,4901815669
6864,3331847850,208084,3332055934,7,0,0,143360,7,3217991926
6865,3331858247,3898,3331862145,14,0,1,4096,14,3066411525
6866,3331897415,4162,3331901577,11,0,1,11264,11,9245118818
6867,3331907156,1994,3331909150,10,0,1,2048,10,8655646110
6868,3331955581,119762,3332075343,14,0,0,28672,14,3146737756
6869,3331961558,12308,3331973866,5,0,1,20480,5,491631896
6870,3331973436,87742,3332061178,18,0,0,2048,18,5125231847
6871,3332021774,121201,3332142975,3,0,0,512,3,6868287459
6872,3332048961,50894,3332099855,10,0,0,512,10,4212801726
6873,3332053501,27662,3332081163,0,0,1,45568,0,167401149
6874,3332098642,4850,3332103492,3,0,1,5120,3,10611225106
6875,3332127075,222208,3332349283,1,0,0,54784,1,5707128079
6876,3332163808,105716,3332269524,1,0,0,47104,1,877848934
6877,3332189876,79819,3332269695,17,0,0,512,17,3950642556
6878,3332195946,4850,3332200796,19,0,1,5120,19,2527920561
6879,3332201488,152646,3332354134,12,0,0,15872,12,4322024943
6880,3332283514,2946,3332286460,6,0,1,3072,6,4372169903
6881,3332304920,132731,3332437651,12,0,0,50176,12,6517809786
6882,3332306199,80386,3332386585,8,0,0,9728,8,410447433
6883,3332310995,247131,3332558126,9,0,0,81408,9,1381712913
6884,3332320088,293586,3332613674,13,0,0,36864,13,6421564048
6885,3332353150,5350,3332358500,1,0,1,4608,1,6306477116
6886,3332364436,147844,3332512280,5,0,0,7680,5,7714045319
6887,3332383706,279034,3332662740,19,0,0,104960,19,8778076258
6888,3332396447,2870,3332399317,17,0,1,8704,17,9213009190
6889,3332421082,16584,3332437666,6,0,1,3072,6,3166876096
6890,3332428305,33807,3332462112,7,0,1,44032,7,2728868106
6891,3332429036,260994,3332690030,12,0,0,58368,12,762485366
6892,3332435788,28590,3332464378,10,0,1,3584,10,237509364
6893,3332438222,27782,3332466004,9,0,1,2560,9,1277062789
6894,3332442235,26035,3332468270,8,0,1,3584,8,3511251322
6895,3332472705,5712,3332478417,3,0,1,14336,3,819526438
6896,3332475938,273418,3332749356,5,0,0,1024,5,6984790795
6897,3332488013,103691,3332591704,16,0,1,168448,16,3421145370
6898,3332516702,259004,3332775706,10,0,0,512,10,2039039979
6899,3332532217,60153,3332592370,17,0,1,1024,17,869784160
6900,3332545848,50388,3332596236,16,0,1,6144,16,8435888092
6901,3332589868,72887,3332662755,0,0,1,93184,0,238978836
6902,3332594009,254219,3332848228,4,0,0,66048,4,7023928595
6903,3332613062,76983,3332690045,8,0,1,97280,8,8581571669
6904,3332619531,70529,3332690060,12,0,1,7168,12,4820931665
6905,3332640619,58141,3332698760,7,0,1,58880,7,10700022109
6906,3332646927,270056,3332916983,16,0,0,3584,16,8189379360
6907,3332657675,46231,3332703906,18,0,1,8192,18,6484456584
6908,3332676198,31574,3332707772,9,0,1,6144,9,10269728929
6909,3332698293,339724,3333038017,17,0,0,512,17,7386936419
6910,3332698714,10364,3332709078,17,0,1,2048,17,1938627011
6911,3332720782,10757,3332731539,8,0,1,17408,8,444449868
6912,3332723708,300349,3333024057,1,0,0,29184,1,1348877715
6913,3332766642,12566,3332779208,5,0,1,20992,5,8804516171
6914,3332777420,91915,3332869335,6,0,0,512,6,668509797
6915,3332782658,127267,3332909925,18,0,0,1536,18,4851120188
6916,3332786340,238200,3333024540,17,0,0,1536,17,2650586299
6917,3332818532,132352,3332950884,9,0,0,512,9,7316411423
6918,3332838232,227442,3333065674,11,0,0,48640,11,10607996192
6919,3332867209,7706,3332874915,5,0,1,8192,5,7246249916
6920,3332963520,108901,3333072421,3,0,0,512,3,5112517948
6921,3333019663,54729,3333074392,10,0,0,512,10,5899383141
6922,3333020082,7421,3333027503,17,0,1,3072,17,5807369209
6923,3333067305,358500,3333425805,7,0,0,32768,7,5859071568
6924,3333079172,237837,3333317009,12,0,0,24064,12,1901023816
6925,3333081678,195962,3333277640,8,0,0,101376,8,1005001169
6926,3333095693,3904,3333099597,19,0,1,10752,19,2073304166
6927,3333098058,180704,3333278762,6,0,0,512,6,4042886968
6928,3333100225,178366,3333278591,1,0,0,3072,1,7465150819
6929,3333109100,92761,3333201861,14,0,0,1536,14,4543347868
6930,3333126244,566,3333126810,1,0,1,512,1,9801960011
6931,3333140288,4850,3333145138,10,0,1,5120,10,2935713828
6932,3333144788,4850,3333149638,2,0,1,5120,2,1910278027
6933,3333153681,1042,3333154723,15,0,1,1024,15,4383085479
6934,3333266303,56355,3333322658,6,0,0,512,6,738167470
6935,3333273425,8776,3333282201,18,0,1,3584,18,369297458
6936,3333306887,1994,3333308881,18,0,1,2048,18,9800085695
6937,3333359786,4850,3333364636,15,0,1,5120,15,6411655650
6938,3333398312,6229,3333404541,2,0,1,15360,2,3350263007
6939,3333410463,97183,3333507646,10,0,0,512,10,9425971823
6940,3333433929,122951,3333556880,8,0,0,25600,8,6658951086
6941,3333437367,74405,3333511772,7,0,0,3584,7,5773143360
6942,3333443135,202239,3333645374,14,0,0,88064,14,5981799055
6943,3333477524,108032,3333585556,14,0,0,33280,14,1152276030
6944,3333503400,2470,3333505870,6,0,1,2560,6,6484529168
6945,3333527992,4420,3333532412,6,0,1,11776,6,6968452597
6946,3333537941,3898,3333541839,4,0,1,4096,4,8978528079
6947,3333541709,145644,3333687353,11,0,0,47616,11,2808917306
6948,3333615481,1042,3333616523,11,0,1,1024,11,1762107925
6949,3333619153,133900,3333753053,9,0,0,24064,9,9132385193
6950,3333646246,75728,3333721974,19,0,0,512,19,5446325131
6951,3333669456,17912,3333687368,9,0,1,10240,9,10531555142
6952,3333672166,15217,3333687383,10,0,1,1536,10,10448543108
6953,3333688632,110548,3333799180,9,0,0,12288,9,5674672334
6954,3333703808,10241,3333714049,6,0,1,16384,6,2965018179
6955,3333714500,4850,3333719350,15,0,1,5120,15,7114988654
6956,3333732405,88124,3333820529,10,0,0,512,10,1199978746
6957,3333745282,175530,3333920812,5,0,0,41472,5,2049718034
6958,3333752372,5352,3333757724,1,0,1,12288,1,4393112541
6959,3333767802,355235,3334123037,11,0,0,132096,11,5759162789
6960,3333774161,113519,3333887680,11,0,0,18432,11,681859926
6961,3333779510,12737,3333792247,16,0,1,24576,16,8660273575
6962,3333781364,12163,3333793527,19,0,1,14336,19,2676346442
6963,3333799628,94463,3333894091,13,0,0,20992,13,4690488450
6964,3333819985,2946,3333822931,2,0,1,3072,2,2930130303
6965,3333820254,185053,3334005307,14,0,0,40960,14,8369691299
6966,3333828451,220630,3334049081,9,0,0,50688,9,3779903241
6967,3333897467,168103,3334065570,0,0,0,15872,0,8201067288
6968,3333899598,239530,3334139128,14,0,0,52736,14,8530717532
6969,3333903950,145302,3334049252,18,0,0,512,18,7245718188
6970,3333922831,108742,3334031573,7,0,0,14336,7,185730782
6971,3333975462,5326,3333980788,12,0,1,5632,12,3081224014
6972,3334085863,87786,3334173649,16,0,1,60416,16,9990942391
6973,3334110829,63486,3334174315,3,0,1,1024,3,4048518831
6974,3334130773,161836,3334292609,9,0,0,41472,9,10512719742
6975,3334132387,44194,3334176581,18,0,1,3584,18,240195115
6976,3334152576,34835,3334187411,0,0,1,35328,0,8759686883
6977,3334171345,18652,3334189997,11,0,1,4096,11,9213558677
6978,3334178707,12916,3334191623,1,0,1,2560,1,4515274537
6979,3334187235,7934,3334195169,1,0,1,5632,1,10036116220
6980,3334196896,272805,3334469701,5,0,0,15360,5,7936031743
6981,3334208545,181355,3334389900,9,0,0,101376,9,10411733212
6982,3334227510,211348,3334438858,3,0,0,512,3,5108926950
6983,3334228011,365618,3334593629,5,0,0,55808,5,6684839350
6984,3334236744,566,3334237310,2,0,1,512,2,8643690804
6985,3334238629,6229,3334244858,16,0,1,15360,16,8817565740
6986,3334287332,5835,3334293167,2,0,1,512,2,7189783244
6987,3334308691,115487,3334424178,6,0,0,1024,6,4998929609
6988,3334308731,233297,3334542028,7,0,0,172032,7,6094502980
6989,3334311747,30491,3334342238,16,0,1,49152,16,10143866366
6990,3334338026,226645,3334564671,8,0,0,74240,8,7666439228
6991,3334386032,179278,3334565310,18,0,0,2048,18,7806415683
6992,3334403291,5454,3334408745,19,0,1,13824,19,6059069775
6993,3334435095,5196,3334440291,6,0,1,13312,6,9868079842
6994,3334459547,4850,3334464397,11,0,1,5120,11,5053152032
6995,3334470288,6754,3334477042,2,0,1,7168,2,7411172925
6996,3334480760,566,3334481326,14,0,1,512,14,5074080085
6997,3334481656,1994,3334483650,14,0,1,2048,14,1061019463
6998,3334527190,241700,3334768890,1,0,0,13312,1,929665763
6999,3334544384,105363,3334649747,17,0,0,512,17,9510502469
7000,3334597417,566,3334597983,1,0,1,512,1,2282433464
7001,3334646196,2470,3334648666,2,0,1,2560,2,8474696593
7002,3334651857,82472,3334734329,1,0,0,15872,1,4644735827
7003,3334660337,6488,3334666825,7,0,1,15872,7,1148779697
7004,3334679098,106964,3334786062,12,0,0,39424,12,4458883836
7005,3334704866,184800,3334889666,16,0,0,40448,16,84483278
7006,3334774709,17316,3334792025,8,0,1,14848,8,3237122453
7007,3334841662,1994,3334843656,2,0,1,2048,2,2191169375
7008,3334855732,61382,3334917114,8,0,1,99328,8,7225621506
7009,3334891693,193602,3335085295,5,0,0,33280,5,807530067
7010,3334969147,95312,3335064459,19,0,0,23040,19,9946828941
7011,3334983066,3387,3334986453,4,0,1,9728,4,7687293505
7012,3334998764,1042,3334999806,15,0,1,1024,15,2812410857
7013,3335006284,174135,3335180419,11,0,0,60928,11,195606531
7014,3335016599,80558,3335097157,3,0,0,512,3,9091230830
7015,3335034714,189605,3335224319,12,0,0,63488,12,126331517
7016,3335067885,3422,3335071307,19,0,1,3584,19,8333978244
7017,3335093610,2470,3335096080,1,0,1,2560,1,291591857
7018,3335098362,566,3335098928,14,0,1,512,14,3204606921
7019,3335106159,2470,3335108629,1,0,1,2560,1,10039745221
7020,3335139241,7706,3335146947,15,0,1,8192,15,10709996672
7021,3335141538,5755,3335147293,18,0,1,512,18,9604439274
7022,3335203664,102759,3335306423,16,0,0,33280,16,1866408708
7023,3335218917,9309,3335228226,12,0,1,4096,12,10471549904
7024,3335224229,129258,3335353487,8,0,0,46592,8,2429988131
7025,3335255160,99442,3335354602,4,0,0,3584,4,3629480959
7026,3335292168,14270,3335306438,3,0,1,5632,3,1999444765
7027,3335340472,63679,3335404151,10,0,0,2560,10,2563402289
7028,3335378774,5802,3335384576,2,0,1,6144,2,9512799237
7029,3335380149,105944,3335486093,13,0,0,43520,13,568289056
7030,3335381751,175028,3335556779,14,0,0,42496,14,8842548994
7031,3335412728,13770,3335426498,7,0,1,26624,7,2333772306
7032,3335439161,103556,3335542717,9,0,0,23040,9,458551016
7033,3335454624,1518,3335456142,5,0,1,1536,5,6560976896
7034,3335478636,9936,3335488572,5,0,1,2560,5,5602348943
7035,3335483925,75310,3335559235,17,0,0,512,17,591960992
7036,3335501650,281981,3335783631,4,0,0,63488,4,2397856245
7037,3335522894,33908,3335556802,0,0,1,57856,0,6668697658
7038,3335552442,18616,3335571058,16,0,1,27648,16,2905998798
7039,3335607785,4937,3335612722,17,0,1,12800,17,649097175
7040,3335623820,114815,3335738635,18,0,0,512,18,5283455378
7041,3335630119,134153,3335764272,13,0,0,23552,13,10573248447
7042,3335676202,107615,3335783817,17,0,0,512,17,7837930458
7043,3335713908,1518,3335715426,10,0,1,1536,10,9256417628
7044,3335717462,7230,3335724692,17,0,1,7680,17,2943921120
7045,3335750589,33057,3335783646,3,0,1,33280,3,9342321238
7046,3335779205,7567,3335786772,6,0,1,3072,6,837253669
7047,3335782212,8828,3335791040,16,0,1,6656,16,10602796586
7048,3335794613,84902,3335879515,10,0,0,1536,10,1296587238
7049,3335797963,1042,3335799005,9,0,1,1024,9,6180746915
7050,3335799464,163917,3335963381,12,0,0,37888,12,7390544293
7051,3335874672,4937,3335879609,5,0,1,12800,5,10712235700
7052,3335944003,1518,3335945521,17,0,1,1536,17,3174805039
7053,3336066042,125641,3336191683,14,0,0,100864,14,9319143850
7054,3336084452,1518,3336085970,5,0,1,1536,5,2353186326
7055,3336119217,116346,3336235563,18,0,0,1024,18,9748153928
7056,3336119430,4850,3336124280,7,0,1,5120,7,10360233743
7057,3336153839,6229,3336160068,11,0,1,15360,11,1878076214
7058,3336160913,224102,3336385015,16,0,0,49152,16,4300125147
7059,3336171705,194250,3336365955,5,0,0,48640,5,1431246108
7060,3336258918,48980,3336307898,3,0,0,2048,3,1282213590
7061,3336303621,566,3336304187,19,0,1,512,19,7042583405
7062,3336307869,6775,3336314644,17,0,1,7168,17,1821798459
7063,3336330207,189225,3336519432,9,0,0,39936,9,7095335758
7064,3336346360,42941,3336389301,0,0,1,70144,0,1637794838
7065,3336385490,5971,3336391461,5,0,1,14848,5,5193883549
7066,3336386914,5853,3336392767,2,0,1,2048,2,1927615760
7067,3336457447,1994,3336459441,18,0,1,2048,18,5907332273
7068,3336480155,113224,3336593379,16,0,0,13312,16,1047490395
7069,3336525281,50672,3336575953,15,0,0,2560,15,7350471597
7070,3336550211,121876,3336672087,8,0,0,12288,8,5114930688
7071,3336586183,43904,3336630087,6,0,0,512,6,6145151512
7072,3336598253,4374,3336602627,11,0,1,4608,11,9752159812
7073,3336600763,24929,3336625692,16,0,1,45056,16,10573267901
7074,3336601993,92779,3336694772,5,0,0,13824,5,5990905224
7075,3336611222,159646,3336770868,5,0,0,60928,5,2313773703
7076,3336612870,45640,3336658510,10,0,0,512,10,10220355366
7077,3336633640,273232,3336906872,12,0,0,61952,12,5687932359
7078,3336642479,228843,3336871322,5,0,0,63488,5,2784664368
7079,3336672575,6754,3336679329,14,0,1,7168,14,10057819437
7080,3336675235,5720,3336680955,5,0,1,2560,5,8067473647
7081,3336763726,263305,3337027031,5,0,0,78848,5,565211369
7082,3336799694,72587,3336872281,16,0,0,3072,16,4809917199
7083,3336800711,48980,3336849691,17,0,0,2048,17,1234820983
7084,3336809743,193249,3337002992,11,0,0,54784,11,7606179299
7085,3336854576,219822,3337074398,5,0,0,35328,5,5702355646
7086,3336880793,156651,3337037444,12,0,0,25600,12,1470777702
7087,3336943683,4850,3336948533,17,0,1,5120,17,6277510613
7088,3336960116,152610,3337112726,15,0,0,54784,15,2400425583
7089,3336994078,121783,3337115861,14,0,0,10240,14,9418073091
7090,3337002505,34962,3337037467,10,0,1,4096,10,4906046452
7091,3337030571,8859,3337039430,19,0,1,2048,19,9561769325
7092,3337042875,2870,3337045745,7,0,1,8704,7,3021281161
7093,3337087265,2870,3337090135,12,0,1,8704,12,6309041731
7094,3337187522,102440,3337289962,13,0,0,36352,13,5187880760
7095,3337192675,109470,3337302145,11,0,0,39936,11,4016947354
7096,3337228174,3898,3337232072,10,0,1,4096,10,7922871022
7097,3337244336,97448,3337341784,8,0,0,19968,8,1276746361
7098,3337270868,79538,3337350406,4,0,0,5632,4,2302000240
7099,3337306141,7706,3337313847,1,0,1,8192,1,6048152759
7100,3337345969,96536,3337442505,15,0,0,22016,15,3362057715
7101,3337351334,2946,3337354280,19,0,1,3072,19,3056991426
7102,3337356523,1518,3337358041,19,0,1,1536,19,10664491589
7103,3337409841,1518,3337411359,3,0,1,1536,3,3211309389
7104,3337415336,100724,3337516060,4,0,0,30720,4,421865240
7105,3337426750,2470,3337429220,17,0,1,2560,17,4919733678
7106,3337435352,7176,3337442528,10,0,1,5632,10,9832273520
7107,3337440117,76114,3337516231,3,0,0,512,3,8351989617
7108,3337488622,71132,3337559754,5,0,0,9216,5,4993598477
7109,3337515513,3180,3337518693,4,0,1,2560,4,3098059690
7110,3337522860,82924,3337605784,7,0,1,134656,7,8351143766
7111,3337545779,61951,3337607730,18,0,1,3072,18,1555659932
7112,3337571710,36686,3337608396,3,0,1,1024,3,1039526592
7113,3337585082,23660,3337608742,15,0,1,512,15,10306370341
7114,3337606637,2451,3337609088,19,0,1,512,19,2412736280
7115,3337608028,92977,3337701005,18,0,0,512,18,7898139644
7116,3337611454,173689,3337785143,3,0,0,1536,3,6397734497
7117,3337651442,5326,3337656768,0,0,1,5632,0,3400388456
7118,3337664552,5326,3337669878,6,0,1,5632,6,5986841434
7119,3337764206,3898,3337768104,12,0,1,4096,12,9920069899
7120,3337774290,108524,3337882814,5,0,0,56320,5,1693047569
7121,3337788270,26479,3337814749,8,0,1,48128,8,2314853165
7122,3337788784,206335,3337995119,19,0,0,78848,19,5482568551
7123,3337788866,28789,3337817655,14,0,1,4608,14,3450599346
7124,3337803275,155683,3337958958,11,0,0,13312,11,4486515328
7125,3337808513,12048,3337820561,11,0,1,4608,11,853463649
7126,3337809892,11015,3337820907,6,0,1,512,6,8145515858
7127,3337810296,15117,3337825413,19,0,1,7168,19,10532949815
7128,3337817326,10033,3337827359,16,0,1,3072,16,5531061896
7129,3337819565,10060,3337829625,18,0,1,3584,18,8157189297
7130,3337847144,154401,3338001545,11,0,0,19968,11,6205388447
7131,3337849983,1994,3337851977,15,0,1,2048,15,8915104580
7132,3337911938,7706,3337919644,11,0,1,8192,11,5997056898
7133,3337918233,312961,3338231194,15,0,0,79872,15,954456522
7134,3337945964,201458,3338147422,16,0,0,114688,16,8555894214
7135,3337946167,49279,3337995446,18,0,0,1024,18,1002970404
7136,3337951652,222149,3338173801,15,0,0,86528,15,2991247271
7137,3337964010,2946,3337966956,6,0,1,3072,6,8289537218
7138,3338024695,7230,3338031925,17,0,1,7680,17,1382224793
7139,3338040729,5196,3338045925,14,0,1,13312,14,395384172
7140,3338042333,63625,3338105958,7,0,1,98816,7,1749153639
7141,3338056873,224704,3338281577,15,0,0,5632,15,5131097551
7142,3338057232,381618,3338438850,7,0,0,140288,7,6952662691
7143,3338078952,27160,3338106112,17,0,1,8704,17,10002866615
7144,3338089257,115367,3338204624,7,0,1,187904,7,5789818525
7145,3338134241,169991,3338304232,5,0,0,512,5,701647963
7146,3338142001,245038,3338387039,1,0,0,17920,1,9890605889
7147,3338151128,304296,3338455424,19,0,0,51200,19,4604609023
7148,3338175495,30000,3338205495,6,0,1,12288,6,10210053939
7149,3338183646,22195,3338205841,15,0,1,512,15,6655264925
7150,3338252563,242027,3338494590,7,0,0,7680,7,9487986196
7151,3338276456,317990,3338594446,7,0,0,78336,7,8202605923
7152,3338282617,335465,3338618082,9,0,0,73728,9,2270813065
7153,3338292858,146943,3338439801,3,0,0,3072,3,704553874
7154,3338337057,460729,3338797786,13,0,0,123392,13,2584817757
7155,3338362213,1518,3338363731,9,0,1,1536,9,3062099853
7156,3338364596,2470,3338367066,8,0,1,2560,8,6104175653
7157,3338367610,470766,3338838376,19,0,0,119808,19,8468824462
7158,3338378275,8787,3338387062,17,0,1,11776,17,8026559384
7159,3338378437,423420,3338801857,1,0,0,13312,1,4167702014
7160,3338413991,44338,3338458329,18,0,1,3072,18,4521433996
7161,3338510341,1518,3338511859,15,0,1,1536,15,3721462
7162,3338515643,196142,3338711785,3,0,0,512,3,1045525458
7163,3338523618,566,3338524184,11,0,1,512,11,1899199065
7164,3338533965,177649,3338711614,12,0,0,67072,12,9438823058
7165,3338567586,566,3338568152,19,0,1,512,19,4009558710
7166,3338574267,43830,3338618097,12,0,1,7168,12,240897745
7167,3338576934,175253,3338752187,16,0,0,22016,16,10697409556
7168,3338624625,1994,3338626619,5,0,1,2048,5,10018755079
7169,3338624906,2379,3338627285,18,0,1,1024,18,7411768945
7170,3338655818,566,3338656384,3,0,1,512,3,9028956403
7171,3338683002,155545,3338838547,18,0,0,512,18,7351898833
7172,3338712007,1994,3338714001,19,0,1,2048,19,9632910829
7173,3338829843,9262,3338839105,1,0,1,512,1,7075030594
7174,3338874956,50672,3338925628,0,0,0,2560,0,1431341377
7175,3338882498,186380,3339068878,19,0,0,150528,19,2824279481
7176,3338937058,7706,3338944764,9,0,1,8192,9,7846159268
7177,3338937760,9590,3338947350,8,0,1,4096,8,1187434548
7178,3338943972,6284,3338950256,10,0,1,4608,10,8535147423
7179,3338954058,4162,3338958220,10,0,1,11264,10,3058187465
7180,3338974513,96923,3339071436,8,0,0,8192,8,8067086305
7181,3338985913,184372,3339170285,13,0,0,138240,13,2938096262
7182,3339022814,46079,3339068893,2,0,1,512,2,1173615426
7183,3339024418,191845,3339216263,4,0,0,28672,4,1052515848
7184,3339035869,36092,3339071961,5,0,1,512,5,10367787699
7185,3339058821,13486,3339072307,2,0,1,512,2,6461277308
7186,3339060677,16832,3339077509,3,0,1,6144,3,7750679904
7187,3339073216,4959,3339078175,5,0,1,11264,5,8918939680
7188,3339087602,83478,3339171080,16,0,0,2560,16,1068561587
7189,3339166618,9321,3339175939,11,0,1,5120,11,5404702665
7190,3339166990,12495,3339179485,2,0,1,5632,2,4444980723
7191,3339177520,120259,3339297779,19,0,0,36864,19,6573953251
7192,3339177685,160084,3339337769,17,0,0,1024,17,668909288
7193,3339180927,566,3339181493,8,0,1,512,8,1238848339
7194,3339180979,13923,3339194902,2,0,1,26624,2,4703748027
7195,3339204912,144402,3339349314,14,0,0,2048,14,1711880440
7196,3339214340,3450,3339217790,19,0,1,1536,19,5459356724
7197,3339214975,42897,3339257872,7,0,1,66560,7,7498148979
7198,3339223276,113858,3339337134,9,0,0,23552,9,8044621618
7199,3339224428,148321,3339372749,4,0,0,30208,4,8551904370
7200,3339247488,74597,3339322085,7,0,0,4608,7,256079376
7201,3339259539,102310,3339361849,10,0,0,1536,10,9018140241
7202,3339271076,1994,3339273070,15,0,1,2048,15,1238697266
7203,3339287824,17177,3339305001,1,0,1,7680,1,2619410740
7204,3339312299,68640,3339380939,3,0,0,512,3,2845384235
7205,3339341301,152546,3339493847,8,0,0,4608,8,3073162178
7206,3339341356,1518,3339342874,11,0,1,1536,11,4470463959
7207,3339435584,48980,3339484564,17,0,0,2048,17,619482487
7208,3339443076,3898,3339446974,2,0,1,4096,2,7489702359
7209,3339449871,52364,3339502235,8,0,0,3072,8,8506536689
7210,3339471260,100412,3339571672,8,0,0,29696,8,5950216773
7211,3339480484,2870,3339483354,19,0,1,8704,19,7690912576
7212,3339481310,4821,3339486131,5,0,1,3072,5,4256300078
7213,3339494625,5712,3339500337,3,0,1,14336,3,4043977860
7214,3339505478,263969,3339769447,9,0,0,39936,9,1250531836
7215,3339511573,144337,3339655910,4,0,0,77824,4,5560187673
7216,3339519491,175085,3339694576,5,0,0,67584,5,10063698350
7217,3339520541,197649,3339718190,16,0,0,12800,16,10423155532
7218,3339530210,136921,3339667131,6,0,0,1024,6,725553474
7219,3339568384,128095,3339696479,16,0,0,6144,16,2517718100
7220,3339602652,145966,3339748618,16,0,0,22016,16,4277856511
7221,3339640178,16766,3339656944,10,0,1,1024,10,8842635687
7222,3339674133,133618,3339807751,14,0,0,37376,14,1619246160
7223,3339685252,14056,3339699308,17,0,1,8704,17,10451646972
7224,3339701381,1042,3339702423,5,0,1,1024,5,5991653346
7225,3339715281,4419,3339719700,9,0,1,1536,9,9681867896
7226,3339751323,213143,3339964466,14,0,0,191488,14,2132535295
7227,3339756529,12933,3339769462,4,0,1,8704,4,2577377873
7228,3339781214,183579,3339964793,13,0,0,1024,13,933468418
7229,3339795832,11934,3339807766,5,0,1,1024,5,7509721658
7230,3339818633,5971,3339824604,16,0,1,14848,16,6248537590
7231,3339891255,74021,3339965276,18,0,0,1536,18,7406687043
7232,3339968792,104000,3340072792,5,0,0,41472,5,5689550136
7233,3339990053,3128,3339993181,1,0,1,9216,1,10701167122
7234,3340014275,3422,3340017697,10,0,1,3584,10,559625376
7235,3340073059,98230,3340171289,9,0,0,23552,9,7103753982
7236,3340081887,1994,3340083881,11,0,1,2048,11,416913928
7237,3340142040,45596,3340187636,17,0,0,1024,17,3277952747
7238,3340149280,22032,3340171312,16,0,1,33792,16,6585654933
7239,3340156981,14346,3340171327,3,0,1,11264,3,7854548574
7240,3340169216,27519,3340196735,0,0,1,46080,0,2450911757
7241,3340219119,127784,3340346903,15,0,0,54272,15,7985375084
7242,3340254485,1518,3340256003,15,0,1,1536,15,5733612579
7243,3340286434,23725,3340310159,16,0,1,39424,16,309369539
7244,3340305002,74289,3340379291,6,0,0,2048,6,5466266019
7245,3340317166,47288,3340364454,6,0,0,1536,6,5215976590
7246,3340339629,7849,3340347478,12,0,1,512,12,1253734777
7247,3340345845,173276,3340519121,8,0,0,71680,8,6050987653
7248,3340353826,269108,3340622934,9,0,0,122368,9,9024812670
7249,3340379018,115060,3340494078,6,0,0,512,6,5130687375
7250,3340395304,147243,3340542547,13,0,0,30720,13,4554865614
7251,3340415248,207865,3340623113,17,0,0,512,17,8204650220
7252,3340583097,77300,3340660397,9,0,0,14336,9,236881336
7253,3340587608,46763,3340634371,1,0,1,18432,1,7037851843
7254,3340611178,125606,3340736784,8,0,0,71168,8,8449514222
7255,3340624171,10866,3340635037,19,0,1,1024,19,4726495065
7256,3340637752,150361,3340788113,9,0,0,80384,9,6829790997
7257,3340653229,2470,3340655699,11,0,1,2560,11,8435322500
7258,3340672300,208009,3340880309,0,0,0,7680,0,6037515312
7259,3340673485,4850,3340678335,2,0,1,5120,2,3749405201
7260,3340701438,566,3340702004,3,0,1,512,3,4447917705
7261,3340739670,236680,3340976350,16,0,0,69120,16,7784119061
7262,3340754131,179638,3340933769,1,0,0,41984,1,7320256801
7263,3340785702,219546,3341005248,13,0,0,76800,13,3495995960
7264,3340814940,2946,3340817886,14,0,1,3072,14,8728684745
7265,3340830983,1042,3340832025,5,0,1,1024,5,4324029051
7266,3340848350,133475,3340981825,9,0,0,17920,9,3005833713
7267,3340855688,1042,3340856730,8,0,1,1024,8,1192761913
7268,3340891127,6754,3340897881,14,0,1,7168,14,6726754107
7269,3340927756,150610,3341078366,18,0,0,512,18,3742396827
7270,3340936283,109928,3341046211,19,0,0,60928,19,277297768
7271,3340939437,150976,3341090413,13,0,0,13312,13,7335183781
7272,3340962543,46051,3341008594,4,0,1,9728,4,5734816400
7273,3340990637,23296,3341013933,2,0,1,14336,2,7321720207
7274,3340994865,82894,3341077759,16,0,1,110080,16,3801574106
7275,3341037625,42720,3341080345,0,0,1,4096,0,4052140653
7276,3341043756,161623,3341205379,9,0,0,56320,9,2300657148
7277,3341051447,172154,3341223601,14,0,0,4096,14,1094401356
7278,3341052515,28176,3341080691,0,0,1,512,0,9992233796
7279,3341065323,17634,3341082957,3,0,1,3584,3,3761044319
7280,3341088956,3443,3341092399,6,0,1,2048,6,5122139983
7281,3341122667,6229,3341128896,19,0,1,15360,19,1705158959
7282,3341128841,6292,3341135133,8,0,1,6656,8,8881404269
7283,3341155123,4679,3341159802,3,0,1,12288,3,7533530656
7284,3341228621,6278,3341234899,6,0,1,6656,6,9383505419
7285,3341248637,13770,3341262407,7,0,1,26624,7,7190592663
7286,3341272947,101234,3341374181,4,0,0,27648,4,9804740279
7287,3341309879,85761,3341395640,15,0,0,512,15,9818570013
7288,3341392491,105248,3341497739,0,0,0,45568,0,5387940101
7289,3341402102,43904,3341446006,6,0,0,512,6,4791524476
7290,3341408455,178877,3341587332,1,0,0,16896,1,2806625978
7291,3341408740,4420,3341413160,5,0,1,11776,5,2473032766
7292,3341419842,50672,3341470514,0,0,0,2560,0,6272945875
7293,3341420393,3387,3341423780,0,0,1,9728,0,5513368299
7294,3341421929,155135,3341577064,18,0,0,1536,18,5540848377
7295,3341424720,370915,3341795635,8,0,0,151552,8,8624934269
7296,3341480624,189370,3341669994,1,0,0,80384,1,6631918767
7297,3341524074,154825,3341678899,6,0,0,2560,6,3610864665
7298,3341571246,110257,3341681503,6,0,0,1024,6,3853650713
7299,3341575100,12247,3341587347,3,0,1,7680,3,4692576771
7300,3341577138,10224,3341587362,17,0,1,5632,17,4039331543
7301,3341614812,123874,3341738686,4,0,0,19456,4,3884139549
7302,3341619302,14545,3341633847,0,0,1,28160,0,1546789948
7303,3341664294,11035,3341675329,6,0,1,5632,6,4399677123
7304,3341667089,315202,3341982291,0,0,0,23552,0,4648748053
7305,3341673794,65946,3341739740,16,0,1,111616,16,9662710249
7306,3341753911,42800,3341796711,3,0,1,1024,3,2498672307
7307,3341784685,58099,3341842784,6,0,0,1024,6,1091318658
7308,3341788507,65234,3341853741,8,0,0,6656,8,262349116
7309,3341800771,63703,3341864474,6,0,0,512,6,4505627023
7310,3341831196,220221,3342051417,19,0,0,17408,19,5209692188
7311,3341839421,1518,3341840939,8,0,1,1536,8,3043994942
7312,3341930188,66929,3341997117,17,0,0,512,17,1085814817
7313,3341977250,9883,3341987133,4,0,1,5120,4,9539079404
7314,3342071721,87896,3342159617,14,0,0,13824,14,5511690273
7315,3342113664,1042,3342114706,8,0,1,1024,8,972959844
7316,3342150313,3128,3342153441,1,0,1,9216,1,5965259156
7317,3342152502,224920,3342377422,0,0,0,66560,0,8706675600
7318,3342167857,61185,3342229042,19,0,0,4608,19,2827731587
7319,3342168092,54056,3342222148,10,0,0,3584,10,408995370
7320,3342170418,145264,3342315682,5,0,0,72192,5,2302490276
7321,3342190753,131340,3342322093,12,0,0,20992,12,4184899629
7322,3342229351,1518,3342230869,4,0,1,1536,4,7433986717
7323,3342248963,134246,3342383209,4,0,0,18944,4,6264289215
7324,3342325511,58337,3342383848,17,0,0,2048,17,8055974959
7325,3342419605,201512,3342621117,14,0,0,200192,14,2551728409
7326,3342440226,101961,3342542187,15,0,0,512,15,3164120081
7327,3342546953,74359,3342621312,7,0,0,512,7,5527095580
7328,3342560434,61403,3342621837,10,0,1,512,10,1823081710
7329,3342568077,153469,3342721546,14,0,0,29696,14,4744679514
7330,3342603025,21530,3342624555,18,0,1,9216,18,514049566
7331,3342629301,92416,3342721717,6,0,0,512,6,9250366581
7332,3342640770,50672,3342691442,5,0,0,2560,5,1906641571
7333,3342645845,84353,3342730198,16,0,0,11264,16,7178565415
7334,3342661218,47288,3342708506,15,0,0,1536,15,3139051072
7335,3342691703,566,3342692269,17,0,1,512,17,7853300660
7336,3342732884,2946,3342735830,9,0,1,3072,9,10036319922
7337,3342752624,4374,3342756998,14,0,1,4608,14,3665289957
7338,3342783444,150593,3342934037,16,0,0,22016,16,4099977203
7339,3342808900,102284,3342911184,8,0,0,35840,8,7869876765
7340,3342812708,50672,3342863380,13,0,0,2560,13,4675354807
7341,3342814135,151053,3342965188,16,0,0,34304,16,10648541068
7342,3342827234,7706,3342834940,18,0,1,8192,18,704571629
7343,3342862683,208910,3343071593,5,0,0,18944,5,3774872034
7344,3342889734,97648,3342987382,7,0,0,10240,7,6701281975
7345,3342897188,124245,3343021433,15,0,0,512,15,8268043754
7346,3342981440,90636,3343072076,18,0,0,1536,18,8002311898
7347,3343034241,4850,3343039091,3,0,1,5120,3,9666922677
7348,3343039911,62516,3343102427,15,0,0,6144,15,2385870691
7349,3343082194,45596,3343127790,10,0,0,1024,10,2058493907
7350,3343102969,45596,3343148565,18,0,0,1024,18,4451794969
7351,3343193262,43904,3343237166,17,0,0,512,17,10159519364
7352,3343219985,96848,3343316833,19,0,0,23040,19,3485587392
7353,3343235942,47288,3343283230,10,0,0,1536,10,8138972045
7354,3343241944,4850,3343246794,3,0,1,5120,3,1899323067
7355,3343245001,93566,3343338567,0,0,1,152064,0,543523557
7356,3343247499,163588,3343411087,3,0,0,1024,3,5323985157
7357,3343247973,162787,3343410760,11,0,0,19968,11,10039808762
7358,3343250812,252164,3343502976,8,0,0,1536,8,369057804
7359,3343272120,214330,3343486450,18,0,0,1024,18,5555043708
7360,3343276004,63843,3343339847,0,0,1,14336,0,120182162
7361,3343320105,21368,3343341473,3,0,1,2560,3,2349091164
7362,3343336884,227022,3343563906,11,0,0,4608,11,379657150
7363,3343348439,6278,3343354717,14,0,1,6656,14,423883020
7364,3343354827,2946,3343357773,6,0,1,3072,6,557964297
7365,3343388033,3128,3343391161,2,0,1,9216,2,3117489894
7366,3343402029,1042,3343403071,1,0,1,1024,1,8180766040
7367,3343418230,103844,3343522074,12,0,0,40960,12,7510498705
7368,3343420999,137207,3343558206,17,0,0,1024,17,1046396605
7369,3343453189,111265,3343564454,6,0,0,1024,6,6759286000
7370,3343460736,113610,3343574346,14,0,0,3584,14,3936360396
7371,3343493232,4850,3343498082,2,0,1,5120,2,10010418406
7372,3343506909,1518,3343508427,12,0,1,1536,12,1726711417
7373,3343539412,2946,3343542358,12,0,1,3072,12,10663035040
7374,3343561205,2716,3343563921,10,0,1,2560,10,9253104857
7375,3343612640,45596,3343658236,3,0,0,1024,3,8165102291
7376,3343625002,43904,3343668906,3,0,0,512,3,2530894034
7377,3343640885,47288,3343688173,17,0,0,1536,17,6485284463
7378,3343683579,23466,3343707045,7,0,1,38912,7,10286969611
7379,3343697715,210377,3343908092,0,0,0,74240,0,3282829522
7380,3343720258,43904,3343764162,10,0,0,512,10,7473898602
7381,3343721232,1042,3343722274,4,0,1,1024,4,3299136180
7382,3343722022,124054,3343846076,12,0,0,16896,12,3142780960
7383,3343851986,3422,3343855408,4,0,1,3584,4,9993162878
7384,3343861927,3128,3343865055,2,0,1,9216,2,5110362456
7385,3343863337,44770,3343908107,7,0,1,62464,7,2466280351
7386,3343878517,29613,3343908130,5,0,1,1024,5,8084888583
7387,3343900521,118576,3344019097,16,0,0,16896,16,4054392805
7388,3343949968,53883,3344003851,10,0,0,1024,10,1702903990
7389,3344049653,566,3344050219,2,0,1,512,2,1910174762
7390,3344050768,5326,3344056094,3,0,1,5632,3,9324821308
7391,3344121095,2470,3344123565,6,0,1,2560,6,8594108826
7392,3344144355,43904,3344188259,18,0,0,512,18,3535102462
7393,3344144602,48156,3344192758,6,0,0,1024,6,7641205082
7394,3344178137,112929,3344291066,17,0,0,512,17,6483024064
7395,3344184327,152273,3344336600,8,0,0,7680,8,2304176640
7396,3344190227,1994,3344192221,18,0,1,2048,18,3723527841
7397,3344237087,43904,3344280991,3,0,0,512,3,6657969558
7398,3344313906,50672,3344364578,12,0,0,2560,12,8903245694
7399,3344315181,59132,3344374313,12,0,0,5120,12,7758466887
7400,3344330963,23466,3344354429,7,0,1,38912,7,3264523752
7401,3344348354,134878,3344483232,8,0,0,22528,8,1298794012
7402,3344390317,26221,3344416538,0,0,1,47616,0,6406550430
7403,3344441494,3387,3344444881,3,0,1,9728,3,3340142842
7404,3344445854,7230,3344453084,12,0,1,7680,12,7257505639
7405,3344496311,204942,3344701253,5,0,0,33792,5,10134743377
7406,3344593403,74348,3344667751,6,0,0,512,6,5284753991
7407,3344610631,256288,3344866919,7,0,0,30720,7,4948843923
7408,3344624107,2470,3344626577,10,0,1,2560,10,6471791852
7409,3344631014,4937,3344635951,10,0,1,12800,10,8023889686
7410,3344655674,2946,3344658620,3,0,1,3072,3,3072968866
7411,3344698007,6366,3344704373,12,0,1,9216,12,8090228255
7412,3344742092,3422,3344745514,10,0,1,3584,10,921622916
7413,3344757262,62516,3344819778,8,0,0,6144,8,4429853825
7414,3344770907,151872,3344922779,16,0,0,52736,16,6018784650
7415,3344772105,2946,3344775051,9,0,1,3072,9,3250978756
7416,3344781385,3387,3344784772,17,0,1,9728,17,1165415142
7417,3344866175,4381,3344870556,2,0,1,10240,2,711648325
7418,3344880703,6754,3344887457,6,0,1,7168,6,7606356279
7419,3344881399,6417,3344887816,15,0,1,9728,15,6887821817
7420,3344901814,94688,3344996502,12,0,0,20992,12,7885682527
7421,3344920218,9783,3344930001,4,0,1,7680,4,4454471365
7422,3344930921,205787,3345136708,14,0,0,50176,14,8938759869
7423,3344982528,89574,3345072102,15,0,0,2560,15,8840261243
7424,3344984317,1042,3344985359,19,0,1,1024,19,6903970984
7425,3345032781,180067,3345212848,9,0,0,138752,9,9069304635
7426,3345091944,7706,3345099650,16,0,1,8192,16,9925719520
7427,3345099312,114955,3345214267,4,0,0,4608,4,4681907543
7428,3345116542,51451,3345167993,15,0,0,512,15,4267167276
7429,3345154793,165653,3345320446,5,0,0,70656,5,599578971
7430,3345213390,118381,3345331771,13,0,0,30208,13,6268488183
7431,3345228501,65057,3345293558,15,0,0,512,15,9796998452
7432,3345230571,1994,3345232565,6,0,1,2048,6,7825982756
7433,3345267182,141983,3345409165,7,0,0,47104,7,5590264256
7434,3345271592,137759,3345409351,6,0,0,512,6,10450855865
7435,3345294875,99923,3345394798,19,0,0,25088,19,8071459710
7436,3345303011,28775,3345331786,7,0,1,5120,7,8819908530
7437,3345312952,146988,3345459940,5,0,0,20992,5,5551561345
7438,3345385776,23404,3345409180,15,0,1,17920,15,98765163
7439,3345420426,204837,3345625263,19,0,0,2048,19,6898332783
7440,3345464584,1042,3345465626,14,0,1,1024,14,4413397826
7441,3345488752,566,3345489318,19,0,1,512,19,2495195278
7442,3345497848,126776,3345624624,14,0,0,116224,14,9250485138
7443,3345503761,4374,3345508135,6,0,1,4608,6,5209044375
7444,3345503826,5615,3345509441,1,0,1,2048,1,3935795272
7445,3345504530,5897,3345510427,3,0,1,1536,3,3073456324
7446,3345509027,121087,3345630114,12,0,0,15872,12,7060804046
7447,3345516933,7706,3345524639,11,0,1,8192,11,2348702906
7448,3345535464,111282,3345646746,16,0,0,11264,16,7397796380
7449,3345631841,1518,3345633359,11,0,1,1536,11,5490178777
7450,3345636397,113357,3345749754,13,0,0,49664,13,1774319795
7451,3345672511,127421,3345799932,12,0,0,31744,12,265310697
7452,3345691527,1994,3345693521,3,0,1,2048,3,4215436802
7453,3345696209,13341,3345709550,9,0,1,22528,9,5498706721
7454,3345714300,4937,3345719237,1,0,1,12800,1,8218835299
7455,3345734647,19039,3345753686,1,0,1,4096,1,2126779732
7456,3345736203,139315,3345875518,15,0,0,512,15,8363879204
7457,3345748840,6875,3345755715,15,0,1,12288,15,6200450024
7458,3345778768,78648,3345857416,12,0,0,12800,12,6312082729
7459,3345797483,352553,3346150036,16,0,0,51200,16,3606187789
7460,3345804635,165593,3345970228,4,0,0,78336,4,3449525941
7461,3345808121,10757,3345818878,2,0,1,17408,2,592701593
7462,3345837313,566,3345837879,5,0,1,512,5,4453449039
7463,3345840585,2946,3345843531,11,0,1,3072,11,5166262151
7464,3345852104,1042,3345853146,12,0,1,1024,12,5906529255
7465,3345856104,8058,3345864162,18,0,1,7168,18,4296478408
7466,3345892034,135020,3346027054,5,0,0,36864,5,8239409667
7467,3345919082,175154,3346094236,14,0,0,74752,14,5240565897
7468,3345923152,265295,3346188447,5,0,0,15360,5,10386884795
7469,3345931141,319210,3346250351,0,0,0,100864,0,9441775747
7470,3345955396,19240,3345974636,12,0,1,4608,12,3969813617
7471,3345957644,46063,3346003707,16,0,1,52224,16,5263895997
7472,3345963266,41427,3346004693,8,0,1,1536,8,10125180629
7473,3346084989,179012,3346264001,4,0,0,23552,4,8446465298
7474,3346142756,139455,3346282211,10,0,0,1536,10,7732816645
7475,3346147568,102954,3346250522,15,0,0,512,15,7637663733
7476,3346170957,81732,3346252689,6,0,0,1024,6,7044167349
7477,3346178295,2946,3346181241,2,0,1,3072,2,8137940555
7478,3346202684,566,3346203250,11,0,1,512,11,177755326
7479,3346207072,65687,3346272759,16,0,1,111104,16,4290991224
7480,3346251249,21766,3346273015,10,0,1,9216,10,2431859093
7481,3346266074,141525,3346407599,4,0,0,28160,4,9872031610
7482,3346275127,112463,3346387590,18,0,0,512,18,1704098854
7483,3346305530,6278,3346311808,1,0,1,6656,1,6233224832
7484,3346321955,129994,3346451949,19,0,0,10752,19,5494193237
7485,3346325228,4374,3346329602,4,0,1,4608,4,3907679023
7486,3346422670,2870,3346425540,17,0,1,8704,17,1714026966
7487,3346513186,3645,3346516831,8,0,1,10240,8,1092507184
7488,3346553130,32299,3346585429,0,0,1,52736,0,8762157169
7489,3346628749,6488,3346635237,18,0,1,15872,18,7136571524
7490,3346673989,52364,3346726353,11,0,0,3072,11,9314501925
7491,3346722560,114452,3346837012,19,0,0,75776,19,10125665129
7492,3346783878,53617,3346837495,3,0,0,1536,3,5839432779
7493,3346794551,66605,3346861156,3,0,0,1536,3,4231132594
7494,3346889069,133824,3347022893,13,0,0,81408,13,4454856815
7495,3346906725,45596,3346952321,17,0,0,1024,17,3867051309
7496,3346935317,88839,3347024156,14,0,0,4096,14,3657615051
7497,3346940071,142276,3347082347,11,0,0,43520,11,2358153709
7498,3346981207,171820,3347153027,5,0,0,114176,5,3603729282
7499,3347029164,53198,3347082362,7,0,1,79872,7,4552717673
7500,3347081743,73967,3347155710,9,0,0,8704,9,8233935730
7501,3347120483,79668,3347200151,15,0,0,1024,15,10012199757
7502,3347135717,135199,3347270916,0,0,0,38912,0,3525596047
7503,3347141073,141066,3347282139,7,0,1,209408,7,5514112360
7504,3347161754,125570,3347287324,1,0,1,24576,1,9454770899
7505,3347197480,109092,3347306572,13,0,0,15872,13,10166797846
7506,3347220626,85961,3347306587,7,0,1,53248,7,7351103119
7507,3347243846,237685,3347481531,11,0,0,38400,11,2054307751
7508,3347259746,46856,3347306602,4,0,1,1536,4,4634407655
7509,3347285645,20972,3347306617,12,0,1,10752,12,6458320009
7510,3347293298,168207,3347461505,16,0,0,5120,16,3567075583
7511,3347324468,3898,3347328366,18,0,1,4096,18,7637196188
7512,3347359362,206976,3347566338,7,0,0,75776,7,7683200613
7513,3347367447,4374,3347371821,12,0,1,4608,12,10215531813
7514,3347381857,566,3347382423,12,0,1,512,12,4493065498
7515,3347392128,5802,3347397930,8,0,1,6144,8,5239255511
7516,3347426673,1042,3347427715,3,0,1,1024,3,5872411139
7517,3347447484,5326,3347452810,17,0,1,5632,17,5256781042
7518,3347448557,8759,3347457316,4,0,1,7168,4,9640732477
7519,3347468795,254843,3347723638,12,0,0,69120,12,10424340075
7520,3347475155,6976,3347482131,18,0,1,512,18,5760497493
7521,3347477156,5321,3347482477,6,0,1,512,6,2906110651
7522,3347477530,6341,3347483871,3,0,1,2048,3,2779455256
7523,3347489583,181961,3347671544,7,0,0,3072,7,2799662594
7524,3347502021,3645,3347505666,5,0,1,10240,5,6860091895
7525,3347550986,26635,3347577621,16,0,1,18432,16,6847048602
7526,3347551801,211953,3347763754,15,0,0,512,15,1973442531
7527,3347585999,116564,3347702563,4,0,0,45568,4,9157628447
7528,3347592686,93077,3347685763,17,0,0,512,17,1231355168
7529,3347636822,3898,3347640720,1,0,1,4096,1,9467176385
7530,3347652959,134252,3347787211,5,0,0,33792,5,5596144642
7531,3347700807,25811,3347726618,17,0,1,3072,17,10037273505
7532,3347714320,14884,3347729204,18,0,1,4096,18,8866546927
7533,3347714447,138422,3347852869,16,0,0,41472,16,2050250019
7534,3347743716,3387,3347747103,6,0,1,9728,6,1042114222
7535,3347777377,10868,3347788245,4,0,1,1024,4,6119995559
7536,3347806617,6488,3347813105,3,0,1,15872,3,7321359631
7537,3347831457,90646,3347922103,17,0,0,512,17,2748124069
7538,3347849761,7474,3347857235,15,0,1,4608,15,2230011402
7539,3347868364,64076,3347932440,0,0,0,11264,0,4834369076
7540,3347892496,2946,3347895442,10,0,1,3072,10,10634944465
7541,3347896301,188790,3348085091,15,0,0,1024,15,842086749
7542,3347922963,566,3347923529,18,0,1,512,18,8122782999
7543,3347928885,200901,3348129786,13,0,0,146432,13,9101875880
7544,3347933758,150998,3348084756,8,0,0,50176,8,1860803911
7545,3347955625,3898,3347959523,11,0,1,4096,11,5217005056
7546,3348000744,4420,3348005164,16,0,1,11776,16,5268131
7547,3348079620,80268,3348159888,19,0,0,12288,19,2417599546
7548,3348090054,61399,3348151453,0,0,1,35328,0,6817820750
7549,3348099482,62801,3348162283,7,0,1,35328,7,10695519035
7550,3348218877,2870,3348221747,10,0,1,8704,10,1161198061
7551,3348245213,103532,3348348745,5,0,0,39936,5,10667383856
7552,3348269667,5326,3348274993,11,0,1,5632,11,8471272948
7553,3348291336,150739,3348442075,12,0,0,118272,12,1249898301
7554,3348355126,87120,3348442246,6,0,0,512,6,456398714
7555,3348388068,2946,3348391014,18,0,1,3072,18,6897403632
7556,3348391337,131090,3348522427,18,0,0,2048,18,2684990188
7557,3348444530,5712,3348450242,18,0,1,14336,18,6347789497
7558,3348467760,67686,3348535446,9,0,0,4608,9,1466511249
7559,3348484411,3898,3348488309,4,0,1,4096,4,3454750615
7560,3348522111,173965,3348696076,4,0,0,20992,4,9084979828
7561,3348625980,43904,3348669884,6,0,0,512,6,9901055244
7562,3348642561,5326,3348647887,1,0,1,5632,1,5457019605
7563,3348684488,11603,3348696091,8,0,1,6656,8,77783181
7564,3348699693,2470,3348702163,18,0,1,2560,18,227053491
7565,3348706328,47638,3348753966,10,0,0,1024,10,5162594674
7566,3348728518,44085,3348772603,10,0,0,512,10,5516115978
7567,3348756470,12049,3348768519,2,0,1,19968,2,3784904081
7568,3348807474,131730,3348939204,1,0,0,57344,1,2615664699
7569,3348826295,6278,3348832573,5,0,1,6656,5,8918161676
7570,3348850532,121010,3348971542,1,0,0,31744,1,5522126789
7571,3348892952,110968,3349003920,14,0,0,20480,14,1143646222
7572,3348933946,314389,3349248335,11,0,0,188416,11,9704504456
7573,3348946533,3422,3348949955,14,0,1,3584,14,5749517212
7574,3348956802,47445,3349004247,6,0,0,1024,6,9308529780
7575,3348970429,119183,3349089612,15,0,0,2048,15,1279263571
7576,3348976981,566,3348977547,3,0,1,512,3,8733223023
7577,3348977525,5340,3348982865,5,0,1,5632,5,3126571630
7578,3349011368,137271,3349148639,4,0,0,22528,4,4472330357
7579,3349059209,51781,3349110990,17,0,0,512,17,84133211
7580,3349084026,6754,3349090780,4,0,1,7168,4,4166939945
7581,3349090435,6278,3349096713,4,0,1,6656,4,1998741714
7582,3349120825,47288,3349168113,7,0,0,1536,7,6171861620
7583,3349156663,1042,3349157705,2,0,1,1024,2,5362399890
7584,3349163655,143390,3349307045,11,0,0,26112,11,3220567756
7585,3349207427,86546,3349293973,10,0,0,1024,10,4899261515
7586,3349217615,79717,3349297332,17,0,0,2048,17,5230788664
7587,3349231126,159199,3349390325,8,0,0,50176,8,9630875024
7588,3349244272,157843,3349402115,0,0,0,2048,0,2426390252
7589,3349245710,177968,3349423678,10,0,0,1024,10,1301217499
7590,3349273837,7230,3349281067,8,0,1,7680,8,2202162609
7591,3349313180,103821,3349417001,14,0,0,19456,14,6117086873
7592,3349475748,45596,3349521344,9,0,0,1024,9,6726291629
7593,3349481900,5326,3349487226,3,0,1,5632,3,6108153861
7594,3349497344,14117,3349511461,5,0,1,24064,5,1956634059
7595,3349522772,4374,3349527146,1,0,1,4608,1,4888163041
7596,3349588477,4162,3349592639,6,0,1,11264,6,7604192827
7597,3349589781,8931,3349598712,1,0,1,7168,1,2692161302
7598,3349611958,1994,3349613952,10,0,1,2048,10,5010714164
7599,3349629060,91172,3349720232,1,0,0,24576,1,8055484705
7600,3349629750,202696,3349832446,8,0,0,24064,8,4897473567
7601,3349655468,94638,3349750106,18,0,0,512,18,7435351878
7602,3349669173,120241,3349789414,9,0,0,18944,9,540773159
7603,3349736670,1518,3349738188,12,0,1,1536,12,1319747661
7604,3349768302,2470,3349770772,2,0,1,2560,2,1878545089
7605,3349793945,43904,3349837849,10,0,0,512,10,9224587467
7606,3349913624,2946,3349916570,11,0,1,3072,11,2888195000
7607,3349967249,1994,3349969243,12,0,1,2048,12,4800536245
7608,3350037830,101036,3350138866,19,0,0,31744,19,8552901162
7609,3350095999,55197,3350151196,17,0,0,512,17,7543240773
7610,3350106231,43904,3350150135,15,0,0,512,15,9013636450
7611,3350131420,8480,3350139900,12,0,1,1024,12,5955331401
7612,3350145625,190510,3350336135,9,0,0,67584,9,5836939594
7613,3350177194,36604,3350213798,0,0,1,64512,0,5329341371
7614,3350196480,18624,3350215104,17,0,1,2048,17,396429520
7615,3350204293,11797,3350216090,10,0,1,1536,10,8544199808
7616,3350250183,4850,3350255033,15,0,1,5120,15,2936744606
7617,3350264489,230048,3350494537,18,0,0,512,18,4818779033
7618,3350304193,4679,3350308872,8,0,1,12288,8,1909147505
7619,3350310283,566,3350310849,2,0,1,512,2,5276842686
7620,3350324423,12312,3350336735,4,0,1,512,4,2378618127
7621,3350327494,9587,3350337081,19,0,1,512,19,82995634
7622,3350328296,269277,3350597573,4,0,0,36352,4,2445989502
7623,3350342193,1994,3350344187,1,0,1,2048,1,4537619157
7624,3350347441,146925,3350494366,19,0,0,48128,19,6031287811
7625,3350352074,566,3350352640,17,0,1,512,17,390484098
7626,3350399139,98845,3350497984,16,0,0,11264,16,655578189
7627,3350430777,155705,3350586482,5,0,0,110592,5,5522065791
7628,3350472302,3898,3350476200,9,0,1,4096,9,2305435678
7629,3350523596,117604,3350641200,0,0,1,195584,0,142853152
7630,3350576086,66394,3350642480,18,0,1,14336,18,731348328
7631,3350625758,17708,3350643466,17,0,1,1536,17,5945135787
7632,3350653839,134053,3350787892,8,0,0,40960,8,10077263026
7633,3350674320,165532,3350839852,13,0,0,50176,13,8187622063
7634,3350756348,1518,3350757866,18,0,1,1536,18,10497081091
7635,3350809045,75843,3350884888,14,0,0,9216,14,6779932275
7636,3350870092,54456,3350924548,9,0,0,1024,9,10072102945
7637,3350908262,43904,3350952166,17,0,0,512,17,5714819843
7638,3350936124,3422,3350939546,2,0,1,3584,2,9260759138
7639,3350941199,3422,3350944621,2,0,1,3584,2,6947270976
7640,3350955831,57440,3351013271,13,0,0,4608,13,10462888108
7641,3351043054,6488,3351049542,12,0,1,15872,12,3051896237
7642,3351045721,7544,3351053265,14,0,1,5632,14,9144670638
7643,3351048985,7186,3351056171,12,0,1,4608,12,5559210659
7644,3351055819,62978,3351118797,6,0,0,1536,6,4491808527
7645,3351138706,99887,3351238593,11,0,0,11264,11,9031187662
7646,3351139723,6754,3351146477,9,0,1,7168,9,7217804605
7647,3351157742,138654,3351296396,9,0,0,74240,9,1833880872
7648,3351229831,140339,3351370170,18,0,0,1536,18,10160394066
7649,3351237456,2647,3351240103,18,0,1,1536,18,1427343648
7650,3351242905,3128,3351246033,12,0,1,9216,12,6425062977
7651,3351263780,91016,3351354796,9,0,0,24064,9,8412686209
7652,3351265019,216660,3351481679,11,0,0,105472,11,3895181760
7653,3351292731,196927,3351489658,13,0,0,26112,13,10222556132
7654,3351305782,5326,3351311108,6,0,1,5632,6,387234619
7655,3351385963,105929,3351491892,0,0,1,176128,0,9403804401
7656,3351456200,175934,3351632134,8,0,0,36864,8,10520059278
7657,3351513148,7706,3351520854,15,0,1,8192,15,5091704492
7658,3351520415,76565,3351596980,12,0,0,1024,12,8111531363
7659,3351533178,566,3351533744,15,0,1,512,15,670286585
7660,3351547579,107221,3351654800,16,0,1,178688,16,5863189506
7661,3351582439,162881,3351745320,9,0,0,23040,9,1026505027
7662,3351589467,65679,3351655146,9,0,1,512,9,9096561544
7663,3351651936,200740,3351852676,12,0,0,52224,12,4075752387
7664,3351669038,5196,3351674234,14,0,1,13312,14,10602396286
7665,3351835531,17160,3351852691,5,0,1,9216,5,3600807639
7666,3351926581,2946,3351929527,14,0,1,3072,14,864398867
7667,3352020123,98852,3352118975,16,0,0,24576,16,8715945072
7668,3352051162,4850,3352056012,17,0,1,5120,17,4340194664
7669,3352079093,43904,3352122997,10,0,0,512,10,7923574577
7670,3352108786,1042,3352109828,11,0,1,1024,11,8432110387
7671,3352147478,121316,3352268794,5,0,0,98304,5,3375664427
7672,3352165673,1042,3352166715,10,0,1,1024,10,6186031912
7673,3352191473,90080,3352281553,0,0,0,20992,0,564190194
7674,3352251650,120356,3352372006,7,0,0,38912,7,4403596185
7675,3352261013,8364,3352269377,18,0,1,512,18,3650776280
7676,3352280806,34242,3352315048,0,0,1,58368,0,3921294822
7677,3352282572,60710,3352343282,18,0,0,512,18,932731653
7678,3352308067,99315,3352407382,5,0,0,1536,5,4815228258
7679,3352358885,61382,3352420267,16,0,1,99328,16,921616184
7680,3352365018,55595,3352420613,9,0,1,512,9,2152599352
7681,3352408971,15508,3352424479,4,0,1,6144,4,3943623443
7682,3352447595,198262,3352645857,1,0,0,25088,1,1260341768
7683,3352460849,145107,3352605956,6,0,0,512,6,473818561
7684,3352481021,5971,3352486992,5,0,1,14848,5,3859646757
7685,3352493149,7230,3352500379,0,0,1,7680,0,3807125604
7686,3352505630,98790,3352604420,18,0,0,512,18,727348417
7687,3352513081,86624,3352599705,6,0,0,512,6,2415131629
7688,3352555801,67442,3352623243,18,0,0,1024,18,6049658361
7689,3352564626,1518,3352566144,11,0,1,1536,11,6525450179
7690,3352574791,102571,3352677362,4,0,0,22016,4,6701750208
7691,3352581105,115304,3352696409,1,0,0,62464,1,1122456894
7692,3352658276,61425,3352719701,3,0,0,1536,3,6317291691
7693,3352686771,10672,3352697443,6,0,1,1024,6,6419520570
7694,3352698082,4374,3352702456,2,0,1,4608,2,9829628821
7695,3352713314,2946,3352716260,14,0,1,3072,14,2608135906
7696,3352719317,123445,3352842762,16,0,0,67584,16,3323756795
7697,3352724445,2946,3352727391,14,0,1,3072,14,5735441363
7698,3352730330,1518,3352731848,15,0,1,1536,15,377512754
7699,3352776103,190660,3352966763,7,0,0,130048,7,5409282256
7700,3352781639,3645,3352785284,17,0,1,10240,17,9863239460
7701,3352785506,1994,3352787500,17,0,1,2048,17,5014573467
7702,3352788636,185474,3352974110,5,0,0,24064,5,7289676503
7703,3352802365,6754,3352809119,18,0,1,7168,18,10630305157
7704,3352813862,91887,3352905749,3,0,0,1024,3,4005868876
7705,3352874722,125224,3352999946,8,0,0,25088,8,722180101
7706,3352882560,4937,3352887497,3,0,1,12800,3,558843234
7707,3352946476,31048,3352977524,16,0,1,3584,16,5581894460
7708,3353001113,5802,3353006915,4,0,1,6144,4,120820016
7709,3353022050,162810,3353184860,6,0,0,2048,6,290034311
7710,3353041149,215510,3353256659,14,0,0,162304,14,8974082189
7711,3353126716,139423,3353266139,6,0,0,22016,6,7821721909
7712,3353132166,125912,3353258078,0,0,0,4608,0,2381444212
7713,3353208833,94833,3353303666,3,0,0,1024,3,9060318717
7714,3353223476,92059,3353315535,12,0,0,4608,12,8275521582
7715,3353229831,29331,3353259162,7,0,1,1024,7,1044006675
7716,3353259484,11021,3353270505,7,0,1,4608,7,2074385625
7717,3353297435,197300,3353494735,9,0,0,186368,9,7659044965
7718,3353330921,1994,3353332915,10,0,1,2048,10,3376143946
7719,3353353330,187311,3353540641,13,0,0,109056,13,10075991060
7720,3353360459,180368,3353540827,3,0,0,512,3,7214863304
7721,3353388497,1042,3353389539,3,0,1,1024,3,2255405999
7722,3353427389,1994,3353429383,14,0,1,2048,14,2912267320
7723,3353435606,105548,3353541154,10,0,0,1024,10,3661330256
7724,3353451260,92004,3353543264,17,0,0,512,17,4542904778
7725,3353491816,50224,3353542040,10,0,0,1536,10,2531333823
7726,3353506063,34593,3353540656,15,0,1,1536,15,2709425594
7727,3353609065,1042,3353610107,6,0,1,1024,6,3342534799
7728,3353612704,52364,3353665068,10,0,0,3072,10,2501151168
7729,3353675366,1994,3353677360,12,0,1,2048,12,6833497717
7730,3353682416,566,3353682982,1,0,1,512,1,336714798
7731,3353710452,90212,3353800664,5,0,0,16384,5,5799595930
7732,3353713491,48980,3353762471,9,0,0,2048,9,1628801386
7733,3353715421,566,3353715987,2,0,1,512,2,3401572721
7734,3353776032,3898,3353779930,10,0,1,4096,10,271936934
7735,3353791035,1994,3353793029,3,0,1,2048,3,2525925339
7736,3353832728,3898,3353836626,10,0,1,4096,10,5623195350
7737,3353840545,1994,3353842539,11,0,1,2048,11,8572654711
7738,3353904543,91748,3353996291,16,0,0,16384,16,685774109
7739,3353951449,104936,3354056385,12,0,0,44544,12,1300178869
7740,3353973045,4420,3353977465,2,0,1,11776,2,105384915
7741,3354037464,3898,3354041362,6,0,1,4096,6,6280789672
7742,3354037905,18503,3354056408,14,0,1,16896,14,5557233801
7743,3354041306,137260,3354178566,9,0,0,15360,9,5272515145
7744,3354053627,253583,3354307210,12,0,0,129024,12,9367105096
7745,3354074199,47931,3354122130,3,0,0,1024,3,3561091205
7746,3354120874,70748,3354191622,3,0,0,512,3,3228797291
7747,3354151216,3128,3354154344,12,0,1,9216,12,3705271094
7748,3354164542,189978,3354354520,7,0,0,56320,7,9624765051
7749,3354247111,1518,3354248629,14,0,1,1536,14,6631275481
7750,3354248229,2946,3354251175,7,0,1,3072,7,9332462207
7751,3354258893,6754,3354265647,3,0,1,7168,3,7557493125
7752,3354288426,19359,3354307785,7,0,1,512,7,2133501443
7753,3354300272,80936,3354381208,1,0,0,512,1,7407900144
7754,3354345197,12261,3354357458,5,0,1,3072,5,5625267569
7755,3354356710,1414,3354358124,14,0,1,1024,14,1159781306
7756,3354368326,7706,3354376032,4,0,1,8192,4,289461942
7757,3354391327,566,3354391893,6,0,1,512,6,8416208429
7758,3354428548,43904,3354472452,17,0,0,512,17,6450213082
7759,3354482990,51059,3354534049,3,0,0,1024,3,2584762316
7760,3354501180,83444,3354584624,6,0,0,14336,6,4726248518
7761,3354554053,566,3354554619,4,0,1,512,4,6449568710
7762,3354636731,566,3354637297,1,0,1,512,1,9926107070
7763,3354647855,1518,3354649373,7,0,1,1536,7,8409420398
7764,3354670005,2946,3354672951,2,0,1,3072,2,6806704193
7765,3354682174,7230,3354689404,6,0,1,7680,6,3483209937
7766,3354700025,3387,3354703412,7,0,1,9728,7,5323847488
7767,3354701847,13499,3354715346,9,0,1,20480,9,235110940
7768,3354704529,12443,3354716972,11,0,1,2560,11,2744413948
7769,3354711785,321529,3355033314,8,0,0,56320,8,7053906542
7770,3354762589,1042,3354763631,8,0,1,1024,8,3012809396
7771,3354788062,150797,3354938859,9,0,0,13312,9,10179026711
7772,3354820767,2470,3354823237,6,0,1,2560,6,8422064882
7773,3354853351,295117,3355148468,12,0,0,113664,12,9871185691
7774,3354866788,1518,3354868306,6,0,1,1536,6,1986730522
7775,3354870885,12308,3354883193,17,0,1,20480,17,2230406366
7776,3354877081,112083,3354989164,6,0,0,45056,6,3235957131
7777,3354907532,137392,3355044924,13,0,0,2560,13,3493816770
7778,3354934417,124471,3355058888,14,0,0,10752,14,1348189063
7779,3354979958,109855,3355089813,13,0,0,16384,13,8434876693
7780,3354995425,3422,3354998847,19,0,1,3584,19,3245322755
7781,3355025272,58979,3355084251,1,0,0,2048,1,4523712261
7782,3355043709,205959,3355249668,8,0,0,52224,8,577631909
7783,3355076173,72513,3355148686,10,0,0,512,10,5758670664
7784,3355076193,154805,3355230998,8,0,0,50688,8,9781099662
7785,3355113069,35414,3355148483,10,0,1,8192,10,9314439425
7786,3355122529,52078,3355174607,16,0,1,47104,16,10243972951
7787,3355124689,50904,3355175593,3,0,1,1536,3,5067320316
7788,3355125744,51155,3355176899,1,0,1,2048,1,1695767500
7789,3355128199,137145,3355265344,16,0,0,9216,16,10055596424
7790,3355230913,185772,3355416685,16,0,0,92672,16,8954786212
7791,3355247575,138997,3355386572,3,0,0,2560,3,6989070147
7792,3355265208,91682,3355356890,18,0,0,512,18,5265882263
7793,3355271846,3898,3355275744,11,0,1,4096,11,9014107779
7794,3355291347,4850,3355296197,7,0,1,5120,7,544565054
7795,3355308223,201239,3355509462,4,0,0,57344,4,9201975563
7796,3355308818,7230,3355316048,3,0,1,7680,3,2751748183
7797,3355309332,8982,3355318314,7,0,1,3584,7,1696872879
7798,3355351474,226371,3355577845,6,0,0,128000,6,9154226758
7799,3355364974,148286,3355513260,0,0,0,8192,0,5861306620
7800,3355422171,1042,3355423213,1,0,1,1024,1,6768574985
7801,3355514069,1994,3355516063,10,0,1,2048,10,5246366777
7802,3355562486,95099,3355657585,5,0,0,12288,5,378745898
7803,3355583399,102128,3355685527,11,0,0,35328,11,6458120915
7804,3355622459,187704,3355810163,16,0,1,308736,16,9024108519
7805,3355634349,176787,3355811136,17,0,1,12800,17,1607704898
7806,3355657480,214924,3355872404,13,0,0,512,13,4108913999
7807,3355687393,173764,3355861157,18,0,0,1024,18,3356706778
7808,3355698051,115991,3355814042,18,0,1,4608,18,998394997
7809,3355710722,175377,3355886099,8,0,0,6144,8,6491179443
7810,3355769463,162335,3355931798,15,0,0,512,15,7183173944
7811,3355776802,38226,3355815028,10,0,1,1536,10,8718093181
7812,3355800794,15220,3355816014,1,0,1,1536,1,2197744335
7813,3355810471,316662,3356127133,12,0,0,79360,12,7568263115
7814,3355890855,7230,3355898085,4,0,1,7680,4,4178815747
7815,3355932642,5802,3355938444,1,0,1,6144,1,6841177512
7816,3355962437,104624,3356067061,13,0,0,43520,13,7391938035
7817,3355988178,45596,3356033774,7,0,0,1024,7,1395343988
7818,3356018985,139747,3356158732,9,0,0,29696,9,3030748372
7819,3356045833,101917,3356147750,10,0,0,512,10,7531924359
7820,3356052036,95543,3356147579,0,0,0,5120,0,8083910378
7821,3356109177,23291,3356132468,12,0,1,5632,12,3649215379
7822,3356122466,10988,3356133454,12,0,1,1536,12,5531727369
7823,3356132491,207216,3356339707,11,0,0,46080,11,10016389341
7824,3356175897,566,3356176463,5,0,1,512,5,9877564796
7825,3356188589,5712,3356194301,1,0,1,14336,1,5813553696
7826,3356192697,3437,3356196134,3,0,1,9216,3,6940785475
7827,3356199171,1042,3356200213,15,0,1,1024,15,8470933772
7828,3356206989,10241,3356217230,19,0,1,16384,19,8131971815
7829,3356217741,3422,3356221163,7,0,1,3584,7,6267118890
7830,3356219952,87721,3356307673,1,0,0,16896,1,9017673909
7831,3356284028,84733,3356368761,0,0,1,138240,0,5332185274
7832,3356285179,87448,3356372627,5,0,1,6144,5,4035805413
7833,3356301817,326191,3356628008,7,0,0,23552,7,6431955950
7834,3356310995,61888,3356372883,18,0,1,9216,18,8579125514
7835,3356390540,1042,3356391582,2,0,1,1024,2,5872351011
7836,3356405556,4374,3356409930,3,0,1,4608,3,746887825
7837,3356446308,1042,3356447350,6,0,1,1024,6,5118456423
7838,3356455773,566,3356456339,2,0,1,512,2,7153877730
7839,3356527731,4937,3356532668,14,0,1,12800,14,6894340053
7840,3356537589,227030,3356764619,5,0,0,140288,5,5908058514
7841,3356547561,1042,3356548603,16,0,1,1024,16,2606283795
7842,3356587959,4374,3356592333,8,0,1,4608,8,8995819333
7843,3356614136,48980,3356663116,15,0,0,2048,15,9625449203
7844,3356622024,11319,3356633343,6,0,1,5632,6,9678548580
7845,3356623716,30946,3356654662,16,0,1,45056,16,6228054711
7846,3356628512,28416,3356656928,15,0,1,3584,15,1840367214
7847,3356640548,135474,3356776022,8,0,0,37376,8,6004827375
7848,3356656610,167474,3356824084,7,0,0,28160,7,5776734179
7849,3356661038,188556,3356849594,8,0,0,36864,8,1475062356
7850,3356675479,101042,3356776521,15,0,0,1536,15,8280461290
7851,3356693680,4850,3356698530,14,0,1,5120,14,106320883
7852,3356710267,4850,3356715117,18,0,1,5120,18,5763334280
7853,3356713806,202750,3356916556,4,0,0,17408,4,8601048963
7854,3356717375,1042,3356718417,8,0,1,1024,8,2930218461
7855,3356752715,216875,3356969590,6,0,0,18944,6,648256396
7856,3356764852,171176,3356936028,14,0,0,20480,14,1698532671
7857,3356782682,73753,3356856435,8,0,0,9216,8,10634455178
7858,3356790808,95444,3356886252,5,0,0,18432,5,5119203903
7859,3356829594,45596,3356875190,8,0,0,1024,8,10600796412
7860,3356831266,5326,3356836592,12,0,1,5632,12,6687927346
7861,3356831395,177539,3357008934,6,0,0,67072,6,5207018452
7862,3356832455,17154,3356849609,5,0,1,3584,5,736412721
7863,3356854897,5428,3356860325,7,0,1,4096,7,9912376367
7864,3356879402,169198,3357048600,14,0,0,34816,14,10370942281
7865,3356891499,206286,3357097785,14,0,0,3072,14,638904283
7866,3356918535,1042,3356919577,14,0,1,1024,14,6862951538
7867,3356937852,86710,3357024562,18,0,0,512,18,6570670180
7868,3357051138,119055,3357170193,1,0,0,16896,1,10395558469
7869,3357057684,102254,3357159938,6,0,0,16896,6,7131770443
7870,3357075935,6229,3357082164,12,0,1,15360,12,4330492033
7871,3357105978,95756,3357201734,8,0,0,19456,8,2892197376
7872,3357171276,68378,3357239654,3,0,0,512,3,2094176100
7873,3357180911,14804,3357195715,16,0,1,28672,16,7832019927
7874,3357263607,3898,3357267505,14,0,1,4096,14,4455615831
7875,3357273173,111176,3357384349,8,0,0,65024,8,24128851
7876,3357340820,5196,3357346016,6,0,1,13312,6,9541694973
7877,3357362428,21936,3357384364,17,0,1,5632,17,5393892106
7878,3357425502,5326,3357430828,5,0,1,5632,5,8657934192
7879,3357435367,566,3357435933,7,0,1,512,7,5046241383
7880,3357464012,106808,3357570820,19,0,0,50688,19,2273792221
7881,3357489450,50672,3357540122,15,0,0,2560,15,5901055925
7882,3357491312,566,3357491878,2,0,1,512,2,4883750349
7883,3357534767,107427,3357642194,16,0,0,37888,16,4458128120
7884,3357582137,1994,3357584131,2,0,1,2048,2,4176376289
7885,3357593941,48432,3357642373,17,0,0,512,17,2365023847
7886,3357600396,1518,3357601914,15,0,1,1536,15,9841734393
7887,3357629011,136430,3357765441,4,0,0,6656,4,4616731892
7888,3357633343,11459,3357644802,6,0,1,2560,6,8973323842
7889,3357643835,203224,3357847059,11,0,0,76800,11,1028564966
7890,3357671891,3387,3357675278,1,0,1,9728,1,4836865305
7891,3357693802,213671,3357907473,1,0,0,47104,1,9239777187
7892,3357734727,43904,3357778631,11,0,0,512,11,7208068113
7893,3357797985,139580,3357937565,6,0,0,42496,6,10579623191
7894,3357808197,43904,3357852101,17,0,0,512,17,898872889
7895,3357841853,192786,3358034639,7,0,0,133120,7,1128980222
7896,3357894577,87686,3357982263,12,0,0,512,12,10652052667
7897,3357908030,129276,3358037306,5,0,0,8704,5,3050317498
7898,3357974111,3898,3357978009,11,0,1,4096,11,9343225931
7899,3358013324,71262,3358084586,10,0,0,1536,10,3637024482
7900,3358042268,2470,3358044738,11,0,1,2560,11,10712521867
7901,3358080717,74321,3358155038,11,0,0,8704,11,9073333890
7902,3358098834,3904,3358102738,3,0,1,10752,3,3011963519
7903,3358117837,47288,3358165125,15,0,0,1536,15,4305437425
7904,3358145168,165899,3358311067,18,0,0,10752,18,7998914542
7905,3358174613,112268,3358286881,5,0,0,68608,5,4894235823
7906,3358246656,232988,3358479644,13,0,0,87040,13,9259753722
7907,3358277494,175575,3358453069,4,0,0,117760,4,5695976904
7908,3358289639,89157,3358378796,10,0,0,512,10,3568386756
7909,3358290939,230344,3358521283,18,0,0,113664,18,9211011993
7910,3358310618,170453,3358481071,19,0,0,4608,19,8178999757
7911,3358375291,566,3358375857,3,0,1,512,3,3046872234
7912,3358417379,68502,3358485881,3,0,1,6656,3,9266265022
7913,3358421648,262548,3358684196,18,0,0,45568,18,7183207028
7914,3358432916,193650,3358626566,19,0,0,79360,19,1180373420
7915,3358433968,310018,3358743986,13,0,0,79360,13,2817275395
7916,3358436673,232601,3358669274,4,0,0,113664,4,2807164260
7917,3358473570,12977,3358486547,14,0,1,1024,14,5114764323
7918,3358559950,1518,3358561468,11,0,1,1536,11,3227726243
7919,3358609193,18900,3358628093,11,0,1,1536,11,5978938473
7920,3358616821,88741,3358705562,9,0,0,8704,9,3564297382
7921,3358660511,162313,3358822824,16,0,1,248832,16,4368248240
7922,3358664462,158721,3358823183,5,0,1,9728,5,5850237265
7923,3358744247,82802,3358827049,7,0,1,6144,7,6820477644
7924,3358744680,87554,3358832234,19,0,1,16384,19,1954719257
7925,3358755872,77668,3358833540,8,0,1,2048,8,10094506607
7926,3358765949,71137,3358837086,9,0,1,5632,9,1686505246
7927,3358776076,364769,3359140845,6,0,0,46080,6,6092456744
7928,3358786768,50664,3358837432,12,0,1,512,12,3401866597
7929,3358808067,31311,3358839378,4,0,1,3072,4,7567317861
7930,3358858646,6278,3358864924,3,0,1,6656,3,2150564672
7931,3358879915,346460,3359226375,11,0,0,98816,11,9775841329
7932,3358951309,158089,3359109398,4,0,0,58880,4,6248115269
7933,3358959319,194465,3359153784,4,0,0,31232,4,1257872381
7934,3358982751,1042,3358983793,1,0,1,1024,1,3283840205
7935,3358998760,232622,3359231382,14,0,0,16384,14,5193747517
7936,3359039242,105011,3359144253,8,0,0,4608,8,142218465
7937,3359041167,281832,3359322999,18,0,0,86016,18,1631876375
7938,3359051929,4850,3359056779,3,0,1,5120,3,2016655075
7939,3359101742,12991,3359114733,2,0,1,5632,2,4341741760
7940,3359104585,290840,3359395425,11,0,0,95744,11,694555940
7941,3359160821,2946,3359163767,4,0,1,3072,4,3731707552
7942,3359183065,1042,3359184107,6,0,1,1024,6,9966933275
7943,3359210104,115102,3359325206,9,0,0,7168,9,2379276721
7944,3359213409,247389,3359460798,8,0,0,76288,8,3777558071
7945,3359232634,14117,3359246751,0,0,1,24064,0,2442746473
7946,3359262398,2470,3359264868,11,0,1,2560,11,8455706065
7947,3359275513,3128,3359278641,4,0,1,9216,4,519316689
7948,3359288911,3422,3359292333,17,0,1,3584,17,5529680975
7949,3359302895,297057,3359599952,13,0,0,46080,13,2363432630
7950,3359330974,136580,3359467554,13,0,0,1536,13,4181559904
7951,3359337001,100538,3359437539,11,0,0,13824,11,8181518025
7952,3359337676,4679,3359342355,4,0,1,12288,4,4780129243
7953,3359340795,80400,3359421195,10,0,0,512,10,2822453136
7954,3359347285,6278,3359353563,11,0,1,6656,11,8755632535
7955,3359374312,27901,3359402213,6,0,1,7168,6,293561402
7956,3359378966,24118,3359403084,4,0,1,12288,4,4941449185
7957,3359385719,18031,3359403750,15,0,1,1024,15,3418419244
7958,3359396180,209723,3359605903,12,0,0,19456,12,8755203402
7959,3359431980,59175,3359491155,3,0,0,1024,3,1800936555
7960,3359444076,23961,3359468037,4,0,1,7680,4,2576443894
7961,3359453936,17647,3359471583,6,0,1,5632,6,10335843945
7962,3359480524,238826,3359719350,14,0,0,48128,14,10396383839
7963,3359487444,68770,3359556214,3,0,0,512,3,7863585222
7964,3359504933,3387,3359508320,19,0,1,9728,19,6103488851
7965,3359534646,139100,3359673746,6,0,0,37888,6,3945824986
7966,3359557245,1518,3359558763,18,0,1,1536,18,7042418577
7967,3359557742,177933,3359735675,0,0,0,25600,0,4154029892
7968,3359574910,100910,3359675820,17,0,0,512,17,10730325556
7969,3359587938,89654,3359677592,3,0,0,512,3,7490429336
7970,3359602253,73396,3359675649,9,0,0,6144,9,3682318113
7971,3359642770,195519,3359838289,16,0,0,7680,16,8762204650
7972,3359664136,217755,3359881891,8,0,0,28672,8,4162974641
7973,3359665267,12030,3359677297,4,0,1,1536,4,4137552798
7974,3359709539,14653,3359724192,17,0,1,5120,17,3103474729
7975,3359724055,128126,3359852181,13,0,0,19456,13,9230452414
7976,3359736763,109475,3359846238,5,0,0,23040,5,4285532204
7977,3359750052,59132,3359809184,3,0,0,5120,3,3161660434
7978,3359774893,84404,3359859297,14,0,0,22528,14,19544937
7979,3359899464,58688,3359958152,1,0,0,8704,1,3428569943
7980,3359922476,79592,3360002068,6,0,0,11776,6,5201618600
7981,3359928017,58101,3359986118,9,0,0,3584,9,6541358920
7982,3360013524,45596,3360059120,10,0,0,1024,10,2924496021
7983,3360040851,212744,3360253595,11,0,0,237056,11,7137364184
7984,3360089071,1042,3360090113,12,0,1,1024,12,9964419397
7985,3360092818,274202,3360367020,9,0,0,126976,9,2562574146
7986,3360093761,26221,3360119982,16,0,1,47616,16,710557927
7987,3360115297,140661,3360255958,9,0,0,7680,9,10735335120
7988,3360126622,141176,3360267798,9,0,0,4096,9,2777999655
7989,3360140705,374931,3360515636,6,0,0,108544,6,10363575432
7990,3360147060,1518,3360148578,14,0,1,1536,14,1652193441
7991,3360156400,221415,3360377815,11,0,0,35328,11,5872010167
7992,3360161924,4374,3360166298,15,0,1,4608,15,1218219136
7993,3360204878,323868,3360528746,9,0,0,14336,9,4286888399
7994,3360223743,221835,3360445578,14,0,0,35840,14,10678547919
7995,3360225701,160407,3360386108,17,0,0,1024,17,10686239610
7996,3360254625,387944,3360642569,14,0,0,3072,14,6673773249
7997,3360288187,230272,3360518459,18,0,0,9216,18,597985537
7998,3360347861,208431,3360556292,4,0,0,17920,4,7642917822
7999,3360357604,98462,3360456066,18,0,0,7168,18,2532275585
8000,3360384266,279707,3360663973,6,0,0,6656,6,6029114146
8001,3360409690,6278,3360415968,1,0,1,6656,1,1079757260
8002,3360435658,16207,3360451865,7,0,1,6656,7,7606808347
8003,3360437178,204440,3360641618,4,0,0,59904,4,4698848446
8004,3360445905,10176,3360456081,12,0,1,5632,12,6229390288
8005,3360510661,63709,3360574370,9,0,0,512,9,6798339324
8006,3360575773,43904,3360619677,17,0,0,512,17,488989099
8007,3360577329,3422,3360580751,11,0,1,3584,11,10443485484
8008,3360579068,2870,3360581938,2,0,1,8704,2,3167948042
8009,3360579312,3975,3360583287,18,0,1,1536,18,9006713225
8010,3360603187,566,3360603753,6,0,1,512,6,6720127197
8011,3360613978,6754,3360620732,5,0,1,7168,5,3896190539
8012,3360640058,6877,3360646935,15,0,1,4608,15,1418533694
8013,3360660252,6754,3360667006,17,0,1,7168,17,4350025491
8014,3360667328,201742,3360869070,6,0,0,74240,6,6323910182
8015,3360690230,1994,3360692224,11,0,1,2048,11,1004047575
8016,3360706837,169143,3360875980,10,0,0,2048,10,6558531230
8017,3360718037,169042,3360887079,13,0,0,36352,13,10054695254
8018,3360745940,129393,3360875333,18,0,0,20480,18,8095811989
8019,3360750232,79696,3360829928,7,0,0,5120,7,7894499565
8020,3360786969,1518,3360788487,10,0,1,1536,10,7796539305
8021,3360788286,177701,3360965987,9,0,0,76800,9,9228408630
8022,3360862305,24797,3360887102,5,0,1,11776,5,9488406260
8023,3360870534,19926,3360890460,11,0,1,3584,11,8768176493
8024,3360899641,92800,3360992441,7,0,0,11264,7,7951355052
8025,3360911941,5326,3360917267,11,0,1,5632,11,1589030163
8026,3360982151,43904,3361026055,10,0,0,512,10,7902251647
8027,3360986290,160587,3361146877,16,0,0,58368,16,3704202128
8028,3360995505,124568,3361120073,10,0,0,512,10,3072524390
8029,3360997553,49136,3361046689,12,0,0,2560,12,3118762334
8030,3361015703,7230,3361022933,1,0,1,7680,1,2721017469
8031,3361028368,1994,3361030362,7,0,1,2048,7,6245056829
8032,3361038968,7736,3361046704,14,0,1,7680,14,9806521904
8033,3361088881,140880,3361229761,8,0,0,30720,8,9190293082
8034,3361119350,2870,3361122220,19,0,1,8704,19,585419079
8035,3361148625,3898,3361152523,17,0,1,4096,17,6432245693
8036,3361159475,2946,3361162421,19,0,1,3072,19,6693343078
8037,3361211866,3645,3361215511,19,0,1,10240,19,10220874958
8038,3361218966,135389,3361354355,14,0,0,47616,14,4182754104
8039,3361223650,6669,3361230319,12,0,1,512,12,1233356111
8040,3361309935,566,3361310501,2,0,1,512,2,688815027
8041,3361335865,18505,3361354370,2,0,1,4608,2,7934885401
8042,3361388028,3422,3361391450,9,0,1,3584,9,6468114525
8043,3361390715,7230,3361397945,18,0,1,7680,18,4020261952
8044,3361391098,10713,3361401811,11,0,1,6144,11,672255553
8045,3361400367,7230,3361407597,4,0,1,7680,4,922031215
8046,3361426678,4850,3361431528,14,0,1,5120,14,8464956572
8047,3361467193,43904,3361511097,17,0,0,512,17,6508174280
8048,3361506969,79436,3361586405,14,0,0,11264,14,7775353537
8049,3361510651,105404,3361616055,12,0,0,46080,12,4159238362
8050,3361521480,182133,3361703613,16,0,0,105472,16,7106233722
8051,3361528747,88883,3361617630,8,0,0,5120,8,3845783105
8052,3361554504,150060,3361704564,19,0,0,3072,19,481636241
8053,3361581934,4486,3361586420,15,0,1,2560,15,9127665276
8054,3361596150,177711,3361773861,8,0,0,36352,8,7961568507
8055,3361626274,175656,3361801930,9,0,0,13824,9,6724480365
8056,3361646627,3387,3361650014,19,0,1,9728,19,775772637
8057,3361651437,61278,3361712715,7,0,0,5632,7,3627451013
8058,3361652026,52553,3361704579,0,0,1,73728,0,5268890477
8059,3361762613,11263,3361773876,12,0,1,2560,12,1142552396
8060,3361766693,190143,3361956836,17,0,0,1024,17,4352844572
8061,3361790471,13770,3361804241,0,0,1,26624,0,228661528
8062,3361798980,227515,3362026495,5,0,0,30208,5,10498427795
8063,3361856264,1042,3361857306,17,0,1,1024,17,9915752066
8064,3361867443,566,3361868009,3,0,1,512,3,3690718259
8065,3361908723,5971,3361914694,3,0,1,14848,3,10174368376
8066,3361912967,71305,3361984272,6,0,0,8704,6,6897484769
8067,3361931809,99141,3362030950,13,0,0,4096,13,1973219132
8068,3361963794,3422,3361967216,9,0,1,3584,9,1006480501
8069,3361965391,135978,3362101369,13,0,0,37888,13,9539330251
8070,3361969133,3422,3361972555,8,0,1,3584,8,8825420073
8071,3362088437,12947,3362101384,10,0,1,7680,10,2408327775
8072,3362106789,43904,3362150693,17,0,0,512,17,6292498333
8073,3362139977,2470,3362142447,18,0,1,2560,18,5719442359
8074,3362151644,4850,3362156494,8,0,1,5120,8,3320228351
8075,3362175163,3898,3362179061,12,0,1,4096,12,6940111263
8076,3362243041,65900,3362308941,18,0,0,7168,18,6953445282
8077,3362268268,104000,3362372268,1,0,0,41472,1,2549342022
8078,3362385308,1994,3362387302,9,0,1,2048,9,3057068247
8079,3362411659,2946,3362414605,10,0,1,3072,10,805904041
8080,3362420154,111176,3362531330,12,0,0,65024,12,9484733677
8081,3362425526,46653,3362472179,10,0,0,512,10,553040322
8082,3362436372,3422,3362439794,1,0,1,3584,1,883062981
8083,3362461273,1994,3362463267,4,0,1,2048,4,2349131960
8084,3362473785,79904,3362553689,4,0,0,12800,4,3856133212
8085,3362538896,101348,3362640244,18,0,0,32768,18,7338832591
8086,3362546912,566,3362547478,12,0,1,512,12,4430917951
8087,3362558955,52156,3362611111,8,0,0,2560,8,2166820303
8088,3362559331,80928,3362640259,16,0,1,128512,16,3817749480
8089,3362611182,29092,3362640274,14,0,1,1536,14,9916494200
8090,3362657757,6754,3362664511,7,0,1,7168,7,4562823732
8091,3362699794,10757,3362710551,19,0,1,17408,19,10248344050
8092,3362740395,34795,3362775190,16,0,1,60928,16,2358548597
8093,3362815856,132383,3362948239,1,0,0,23040,1,4208393980
8094,3362817453,123743,3362941196,16,0,0,62976,16,7419952437
8095,3362842125,2470,3362844595,9,0,1,2560,9,2220335714
8096,3362842523,204751,3363047274,7,0,0,83968,7,6073191983
8097,3362883872,3422,3362887294,3,0,1,3584,3,156788359
8098,3362891194,181292,3363072486,4,0,0,55808,4,6337561018
8099,3362926585,27350,3362953935,8,0,1,14336,8,6043956284
8100,3362937895,16386,3362954281,18,0,1,512,18,6058345535
8101,3362960116,566,3362960682,5,0,1,512,5,9928820825
8102,3362975655,41391,3363017046,16,0,1,67072,16,2957526991
8103,3363020821,26468,3363047289,14,0,1,8192,14,6579299042
8104,3363045759,65730,3363111489,11,0,0,6656,11,2749330609
8105,3363085743,84946,3363170689,10,0,0,512,10,8087224828
8106,3363109199,3128,3363112327,5,0,1,9216,5,626425405
8107,3363142273,215254,3363357527,5,0,0,37376,5,6444091176
8108,3363151244,95613,3363246857,13,0,0,28160,13,7936573154
8109,3363176256,227052,3363403308,19,0,0,60416,19,7519689281
8110,3363180248,7706,3363187954,9,0,1,8192,9,8578595325
8111,3363214936,1518,3363216454,7,0,1,1536,7,8703418395
8112,3363230689,98228,3363328917,4,0,0,22528,4,3975069908
8113,3363232782,4679,3363237461,14,0,1,12288,14,6223314422
8114,3363278943,566,3363279509,3,0,1,512,3,1619055980
8115,3363367362,103220,3363470582,4,0,0,38912,4,5632108314
8116,3363375606,143660,3363519266,15,0,0,37376,15,3821989181
8117,3363377706,25617,3363403323,17,0,1,8192,17,9527206327
8118,3363448478,1518,3363449996,9,0,1,1536,9,5209141069
8119,3363455121,15476,3363470597,8,0,1,20480,8,9146403798
8120,3363487210,6229,3363493439,3,0,1,15360,3,9013308013
8121,3363503543,157238,3363660781,4,0,0,60416,4,3450457695
8122,3363561511,115178,3363676689,14,0,0,22016,14,8883238016
8123,3363563811,4374,3363568185,4,0,1,4608,4,6071134518
8124,3363568378,566,3363568944,14,0,1,512,14,9366135740
8125,3363609129,3422,3363612551,7,0,1,3584,7,7190125579
8126,3363638430,22366,3363660796,18,0,1,8192,18,9037459338
8127,3363638466,172192,3363810658,3,0,0,1024,3,5794263801
8128,3363642024,46760,3363688784,3,0,0,1024,3,9503874223
8129,3363654323,64289,3363718612,17,0,0,1024,17,1166426507
8130,3363682697,1518,3363684215,6,0,1,1536,6,7116817948
8131,3363690563,96869,3363787432,10,0,0,1536,10,6072489700
8132,3363690992,109180,3363800172,11,0,0,38400,11,1955942583
8133,3363711539,150611,3363862150,11,0,0,74240,11,8599812163
8134,3363760099,1042,3363761141,6,0,1,1024,6,5989994212
8135,3363792332,21949,3363814281,18,0,1,24064,18,7845659811
8136,3363815960,2470,3363818430,14,0,1,2560,14,160355821
8137,3363844777,91968,3363936745,10,0,0,1024,10,7771784004
8138,3363848766,17792,3363866558,11,0,1,4608,11,10690862975
8139,3363855460,29010,3363884470,16,0,1,33792,16,5513742675
8140,3363908987,137176,3364046163,18,0,0,13824,18,6051401885
8141,3363950740,161144,3364111884,5,0,0,9216,5,6418936563
8142,3363962715,43904,3364006619,3,0,0,512,3,5303047176
8143,3363972361,132041,3364104402,15,0,0,91648,15,9032881087
8144,3363974101,93080,3364067181,3,0,0,1024,3,8660077992
8145,3363988267,3387,3363991654,12,0,1,9728,12,3821205459
8146,3363993188,111401,3364104589,4,0,0,512,4,3698227203
8147,3364001718,1518,3364003236,6,0,1,1536,6,2145351483
8148,3364022925,1518,3364024443,6,0,1,1536,6,4282069798
8149,3364062848,74360,3364137208,14,0,0,9728,14,2537469131
8150,3364080996,34076,3364115072,14,0,1,16896,14,6480299641
8151,3364082935,32803,3364115738,5,0,1,1024,5,5370420337
8152,3364088184,32060,3364120244,19,0,1,7168,19,106749944
8153,3364160378,223799,3364384177,6,0,0,104448,6,6453676684
8154,3364217981,90524,3364308505,4,0,0,17408,4,10387369439
8155,3364299502,566,3364300068,18,0,1,512,18,9351412047
8156,3364347511,4420,3364351931,14,0,1,11776,14,8707173127
8157,3364423537,11791,3364435328,6,0,1,19456,6,10732323174
8158,3364547595,3904,3364551499,0,0,1,10752,0,7000866947
8159,3364551493,1994,3364553487,14,0,1,2048,14,8849376381
8160,3364553341,156870,3364710211,5,0,0,41984,5,1843707297
8161,3364598918,1994,3364600912,14,0,1,2048,14,1220199373
8162,3364646182,566,3364646748,9,0,1,512,9,4376712775
8163,3364672125,128974,3364801099,1,0,0,74240,1,4310011818
8164,3364687115,137595,3364824710,0,0,0,29696,0,5547245446
8165,3364724235,4937,3364729172,2,0,1,12800,2,1153222953
8166,3364874406,47288,3364921694,10,0,0,1536,10,10121339213
8167,3364899555,6754,3364906309,12,0,1,7168,12,8369126457
8168,3364957091,1994,3364959085,8,0,1,2048,8,1755746208
8169,3364964419,92369,3365056788,19,0,0,5632,19,3527983384
8170,3364987383,566,3364987949,10,0,1,512,10,3406421723
8171,3365001423,1994,3365003417,5,0,1,2048,5,1886798277
8172,3365041810,566,3365042376,14,0,1,512,14,9849781206
8173,3365049241,61502,3365110743,9,0,0,4608,9,5136289432
8174,3365057051,11016,3365068067,10,0,1,17920,10,6654542675
8175,3365068252,3422,3365071674,8,0,1,3584,8,10471545892
8176,3365083861,4374,3365088235,14,0,1,4608,14,8015188351
8177,3365125143,57440,3365182583,6,0,0,4608,6,8371849575
8178,3365129504,94567,3365224071,17,0,0,1024,17,978436888
8179,3365140216,15321,3365155537,0,0,1,29696,0,7929726949
8180,3365177455,159512,3365336967,6,0,0,32256,6,8835491773
8181,3365221398,155145,3365376543,6,0,0,20992,6,8578915519
8182,3365231676,1518,3365233194,11,0,1,1536,11,6739910687
8183,3365240382,2470,3365242852,19,0,1,2560,19,8480702777
8184,3365242480,232298,3365474778,16,0,0,84480,16,5721639687
8185,3365271128,105898,3365377026,10,0,0,1536,10,5300656620
8186,3365276676,3422,3365280098,12,0,1,3584,12,9512306286
8187,3365279472,1612,3365281084,11,0,1,1536,11,10182173491
8188,3365314517,2470,3365316987,19,0,1,2560,19,5584220957
8189,3365328816,10613,3365339429,5,0,1,2560,5,10149830126
8190,3365350292,146653,3365496945,15,0,0,72704,15,9205361782
8191,3365398820,257690,3365656510,7,0,0,62464,7,5782297278
8192,3365416788,4162,3365420950,11,0,1,11264,11,9009238861
8193,3365428295,111904,3365540199,18,0,0,37376,18,7047007080
8194,3365432881,1994,3365434875,8,0,1,2048,8,3911038669
8195,3365465784,31811,3365497595,10,0,1,512,10,2478575884
8196,3365478636,115930,3365594566,11,0,0,20480,11,2142936314
8197,3365480933,117236,3365598169,8,0,0,11776,8,10240871020
8198,3365491108,217956,3365709064,12,0,0,27136,12,9476124131
8199,3365495515,106291,3365601806,5,0,0,4096,5,5009903562
8200,3365508589,5326,3365513915,3,0,1,5632,3,10363015770
8201,3365553610,212406,3365766016,12,0,0,52736,12,8548380891
8202,3365604949,3645,3365608594,9,0,1,10240,9,5816305511
8203,3365619418,6754,3365626172,2,0,1,7168,2,2596826882
8204,3365634474,2946,3365637420,15,0,1,3072,15,7337981242
8205,3365638027,199124,3365837151,12,0,0,50688,12,5764265121
8206,3365656612,4374,3365660986,11,0,1,4608,11,7189648060
8207,3365717181,23637,3365740818,0,0,1,42496,0,10002267414
8208,3365747755,47288,3365795043,1,0,0,1536,1,669879953
8209,3365749967,206908,3365956875,6,0,0,51200,6,8669813212
8210,3365795642,110503,3365906145,6,0,0,49152,6,10295416204
8211,3365880726,141219,3366021945,12,0,0,31744,12,10134221274
8212,3365956802,2059,3365958861,3,0,1,2048,3,6013892723
8213,3366074811,50672,3366125483,19,0,0,2560,19,3386274990
8214,3366080522,566,3366081088,5,0,1,512,5,3183404471
8215,3366082848,172376,3366255224,6,0,0,144896,6,8963270053
8216,3366109545,3128,3366112673,19,0,1,9216,19,4629560772
8217,3366109955,156236,3366266191,13,0,0,35840,13,7311325541
8218,3366113315,1042,3366114357,10,0,1,1024,10,10194140058
8219,3366118952,155390,3366274342,6,0,0,26624,6,7516197
8220,3366219634,54723,3366274357,10,0,1,9728,10,10467897919
8221,3366231742,147897,3366379639,9,0,0,26112,9,4109726119
8222,3366237703,36677,3366274380,18,0,1,2048,18,2840821371
8223,3366244006,30389,3366274395,6,0,1,1536,6,8929192686
8224,3366268047,147683,3366415730,15,0,0,4608,15,7110638630
8225,3366288828,217031,3366505859,6,0,0,129024,6,7869129060
8226,3366303019,203635,3366506654,1,0,0,2560,1,8571784640
8227,3366313391,2946,3366316337,14,0,1,3072,14,6144737849
8228,3366353733,165884,3366519617,18,0,0,42496,18,6063667279
8229,3366382181,10499,3366392680,10,0,1,16896,10,2382990222
8230,3366400947,129170,3366530117,6,0,0,22528,6,5877826633
8231,3366419139,4850,3366423989,10,0,1,5120,10,7668047818
8232,3366518839,3640,3366522479,7,0,1,8704,7,1295680772
8233,3366527643,268321,3366795964,11,0,0,126464,11,2669640039
8234,3366539776,280446,3366820222,17,0,0,1536,17,10247242242
8235,3366547454,100256,3366647710,16,0,0,29184,16,3465945713
8236,3366558188,261527,3366819715,14,0,0,77824,14,3607525130
8237,3366573353,113429,3366686782,1,0,0,5120,1,7495354953
8238,3366628805,4850,3366633655,6,0,1,5120,6,4831468344
8239,3366655462,179751,3366835213,18,0,0,49152,18,3230319429
8240,3366657990,283541,3366941531,14,0,0,32256,14,4717171588
8241,3366666907,20882,3366687789,0,0,1,33792,0,6063570452
8242,3366705802,4374,3366710176,17,0,1,4608,17,7199898238
8243,3366716163,133916,3366850079,1,0,0,19456,1,1856516318
8244,3366730259,267000,3366997259,11,0,0,11776,11,10579629060
8245,3366753823,167632,3366921455,11,0,0,5632,11,5573192520
8246,3366757519,77709,3366835228,17,0,1,2048,17,2759637441
8247,3366761277,311912,3367073189,6,0,0,226304,6,9075173354
8248,3366773045,62198,3366835243,17,0,1,1536,17,5996764483
8249,3366782139,299349,3367081488,9,0,0,27136,9,7274393428
8250,3366828963,375920,3367204883,0,0,0,86016,0,8514659415
8251,3366839634,10460,3366850094,8,0,1,5632,8,9417074758
8252,3366887795,237293,3367125088,12,0,0,75776,12,2062041722
8253,3366890049,315161,3367205210,11,0,0,1024,11,10185517457
8254,3366905884,176087,3367081971,16,0,0,1536,16,107375929
8255,3366914597,174097,3367088694,0,0,0,22016,0,3809268202
8256,3366916570,185415,3367101985,9,0,0,43520,9,5891479328
8257,3366931335,10211,3366941546,15,0,1,7168,15,8893638326
8258,3366944235,3387,3366947622,6,0,1,9728,6,2964166635
8259,3366982611,176271,3367158882,8,0,0,29184,8,692506432
8260,3367031415,212883,3367244298,5,0,0,21504,5,3668557825
8261,3367040127,84976,3367125103,6,0,1,4608,6,3501626563
8262,3367079174,280971,3367360145,0,0,0,51712,0,7548033798
8263,3367174955,216093,3367391048,13,0,0,101376,13,942807858
8264,3367201984,252162,3367454146,7,0,0,124416,7,1001459465
8265,3367220707,1994,3367222701,10,0,1,2048,10,8870403693
8266,3367227573,90610,3367318183,11,0,0,6656,11,7989137890
8267,3367267488,20882,3367288370,16,0,1,33792,16,2732714463
8268,3367282498,7498,3367289996,15,0,1,2560,15,10601045420
8269,3367331772,59307,3367391079,8,0,1,68608,8,2011922609
8270,3367350937,136326,3367487263,4,0,0,6656,4,2768413479
8271,3367371070,22465,3367393535,18,0,1,2560,18,8648660625
8272,3367449644,82886,3367532530,1,0,0,17920,1,8272833992
8273,3367453681,195357,3367649038,6,0,0,32768,6,10025255783
8274,3367518150,110708,3367628858,15,0,0,63488,15,10223429306
8275,3367553168,145484,3367698652,1,0,0,58368,1,6371572249
8276,3367562926,3422,3367566348,11,0,1,3584,11,4130916822
8277,3367631803,92972,3367724775,16,0,0,15360,16,4888044479
8278,3367671262,146687,3367817949,11,0,0,93184,11,9286566577
8279,3367689963,146497,3367836460,1,0,0,49664,1,818275634
8280,3367696269,3459,3367699728,2,0,1,1024,2,2785468336
8281,3367698438,6362,3367704800,10,0,1,6144,10,7326475763
8282,3367711704,566,3367712270,9,0,1,512,9,6587926217
8283,3367768868,215201,3367984069,5,0,0,72704,5,890664813
8284,3367796942,103370,3367900312,13,0,0,1024,13,9222791612
8285,3367806974,191930,3367998904,6,0,0,48640,6,4179825469
8286,3367815081,24826,3367839907,16,0,1,35840,16,1139469348
8287,3367825344,136558,3367961902,16,0,0,25600,16,10688586475
8288,3367833937,7596,3367841533,2,0,1,2560,2,4991814476
8289,3367855285,1518,3367856803,3,0,1,1536,3,2982400915
8290,3367911945,6754,3367918699,19,0,1,7168,19,6154328884
8291,3367913750,120284,3368034034,8,0,0,45568,8,5321627002
8292,3367935762,126776,3368062538,8,0,0,45056,8,623944393
8293,3367973095,28288,3368001383,18,0,1,2560,18,9750001747
8294,3367995637,154185,3368149822,1,0,0,43008,1,9092221128
8295,3368032048,9208,3368041256,14,0,1,7680,14,10714774633
8296,3368068188,81649,3368149837,16,0,1,122880,16,7910772412
8297,3368144414,144651,3368289065,9,0,0,26624,9,10541140435
8298,3368241121,6278,3368247399,3,0,1,6656,3,5986176724
8299,3368338151,43904,3368382055,3,0,0,512,3,58319502
8300,3368376512,6754,3368383266,18,0,1,7168,18,6605763403
8301,3368452004,178623,3368630627,1,0,0,55296,1,6903899814
8302,3368583041,61074,3368644115,3,0,0,1536,3,389574986
8303,3368612896,17746,3368630642,15,0,1,10240,15,7196838285
8304,3368651144,62933,3368714077,8,0,1,102400,8,8326303131
8305,3368652868,64115,3368716983,11,0,1,4608,11,10180435701
8306,3368722281,87178,3368809459,11,0,0,4096,11,5613890719
8307,3368727500,204524,3368932024,9,0,0,9728,9,462228837
8308,3368781911,6278,3368788189,6,0,1,6656,6,6095895005
8309,3368789142,10499,3368799641,10,0,1,16896,10,5150637316
8310,3368798954,101348,3368900302,9,0,0,32768,9,1929639225
8311,3368874912,2470,3368877382,18,0,1,2560,18,8486850712
8312,3368905247,101657,3369006904,11,0,0,11264,11,3279826186
8313,3368938455,4850,3368943305,6,0,1,5120,6,8536240562
8314,3368976128,5326,3368981454,19,0,1,5632,19,2397021673
8315,3368987127,1042,3368988169,14,0,1,1024,14,5722564709
8316,3369009432,210787,3369220219,15,0,0,32256,15,7204523391
8317,3369041423,104156,3369145579,13,0,0,41984,13,6845636185
8318,3369077367,566,3369077933,18,0,1,512,18,4181047803
8319,3369096993,113368,3369210361,0,0,0,26624,0,3387102802
8320,3369105462,141295,3369246757,18,0,0,25088,18,10095365954
8321,3369182448,2870,3369185318,7,0,1,8704,7,7779359066
8322,3369201119,9257,3369210376,11,0,1,1536,11,1427301852
8323,3369219440,66671,3369286111,15,0,0,7168,15,3393210880
8324,3369222750,83179,3369305929,3,0,0,512,3,5767155740
8325,3369322247,117728,3369439975,15,0,0,86528,15,8236302134
8326,3369334064,128267,3369462331,18,0,0,38912,18,4810525638
8327,3369371339,140996,3369512335,11,0,0,9216,11,7499211862
8328,3369456363,17751,3369474114,19,0,1,19456,19,2515116578
8329,3369521814,86200,3369608014,1,0,0,15360,1,6446115343
8330,3369529419,1518,3369530937,2,0,1,1536,2,7631520926
8331,3369564547,566,3369565113,2,0,1,512,2,2878491423
8332,3369632846,4162,3369637008,5,0,1,11264,5,221149575
8333,3369649676,12049,3369661725,12,0,1,19968,12,7905302424
8334,3369672715,66680,3369739395,19,0,0,9728,19,10033619446
8335,3369715035,118544,3369833579,4,0,0,8192,4,6643105937
8336,3369784948,1042,3369785990,11,0,1,1024,11,9885754302
8337,3369786032,5712,3369791744,8,0,1,14336,8,7744242896
8338,3369802223,85857,3369888080,4,0,0,1024,4,9786711176
8339,3369836596,3128,3369839724,14,0,1,9216,14,4605954307
8340,3369839952,44900,3369884852,10,0,0,512,10,9842319025
8341,3369841507,566,3369842073,7,0,1,512,7,9565981201
8342,3369852043,100880,3369952923,14,0,0,31232,14,3262439014
8343,3369871868,84814,3369956682,18,0,0,12288,18,1387521025
8344,3369915770,60717,3369976487,1,0,0,512,1,1609450141
8345,3369927671,53325,3369980996,8,0,1,87040,8,9490837670
8346,3370057258,76690,3370133948,11,0,0,1024,11,9209087148
8347,3370062260,142332,3370204592,1,0,0,31232,1,6195140564
8348,3370178560,93800,3370272360,1,0,0,28160,1,8771545696
8349,3370230975,103376,3370334351,6,0,0,39424,6,1742161416
8350,3370243935,132662,3370376597,10,0,0,512,10,2129981271
8351,3370273328,137505,3370410833,11,0,0,62464,11,8827258614
8352,3370306256,170376,3370476632,16,0,0,27136,16,1726501230
8353,3370333882,24356,3370358238,0,0,1,43008,0,1763023669
8354,3370403605,10642,3370414247,5,0,1,3584,5,3662554774
8355,3370415913,171729,3370587642,1,0,0,41984,1,7977237489
8356,3370459526,3422,3370462948,10,0,1,3584,10,8231521158
8357,3370487081,112106,3370599187,16,0,0,20992,16,4095162200
8358,3370530235,3645,3370533880,10,0,1,10240,10,5986728722
8359,3370554733,83132,3370637865,18,0,0,13312,18,5021729542
8360,3370631474,1518,3370632992,18,0,1,1536,18,4584952047
8361,3370633280,96692,3370729972,0,0,0,22528,0,5225040287
8362,3370634152,74335,3370708487,13,0,0,6144,13,10473029762
8363,3370647340,140052,3370787392,6,0,0,49664,6,5009698460
8364,3370701991,1042,3370703033,11,0,1,1024,11,1783921363
8365,3370721885,131707,3370853592,12,0,0,82432,12,2958648589
8366,3370748593,170405,3370918998,6,0,0,69120,6,8948576446
8367,3370813448,113512,3370926960,11,0,0,23552,11,5238662992
8368,3370823196,151872,3370975068,7,0,0,30208,7,4671442690
8369,3370825227,118887,3370944114,16,0,0,7680,16,8633048297
8370,3370848013,8517,3370856530,6,0,1,3072,6,3078689715
8371,3370874696,52747,3370927443,3,0,0,1536,3,7020091662
8372,3370949072,157949,3371107021,5,0,0,137216,5,1031738344
8373,3370962034,2470,3370964504,10,0,1,2560,10,5955263276
8374,3371022766,245358,3371268124,9,0,0,225792,9,580355979
8375,3371046576,146008,3371192584,6,0,0,3072,6,8682390163
8376,3371065308,46622,3371111930,12,0,1,5120,12,1016420107
8377,3371069726,44150,3371113876,3,0,1,3072,3,7788862745
8378,3371080701,37361,3371118062,9,0,1,6656,9,204907116
8379,3371086482,220342,3371306824,6,0,0,12800,6,3196265196
8380,3371168521,131763,3371300284,5,0,0,26624,5,1857656830
8381,3371175093,1518,3371176611,17,0,1,1536,17,262632703
8382,3371184925,5802,3371190727,19,0,1,6144,19,4438422695
8383,3371192565,2481,3371195046,6,0,1,2560,6,602978349
8384,3371239956,29269,3371269225,19,0,1,1024,19,107675890
8385,3371241429,30964,3371272393,19,0,1,4096,19,10411145389
8386,3371243315,29424,3371272739,7,0,1,512,7,7070808814
8387,3371263194,112375,3371375569,16,0,1,175616,16,3014059962
8388,3371279163,97712,3371376875,18,0,1,2048,18,6352105771
8389,3371320996,56865,3371377861,6,0,1,1536,6,6676897950
8390,3371342115,40572,3371382687,11,0,1,7680,11,5870196811
8391,3371349691,33150,3371382841,1,0,1,8704,1,7318652874
8392,3371364609,21138,3371385747,5,0,1,4608,5,6430875805
8393,3371385628,5326,3371390954,18,0,1,5632,18,7798037046
8394,3371401974,5196,3371407170,9,0,1,13312,9,2543650340
8395,3371421931,2946,3371424877,14,0,1,3072,14,3822835193
8396,3371434620,87764,3371522384,0,0,0,18432,0,1561026630
8397,3371452638,152086,3371604724,7,0,0,23040,7,166786555
8398,3371509698,49670,3371559368,17,0,0,512,17,8276399841
8399,3371531478,246533,3371778011,10,0,0,1536,10,5233324200
8400,3371551170,1518,3371552688,17,0,1,1536,17,9935737527
8401,3371564900,12995,3371577895,5,0,1,25088,5,7075257226
8402,3371592305,1518,3371593823,2,0,1,1536,2,1571799297
8403,3371592615,44111,3371636726,10,0,0,512,10,6604797845
8404,3371613616,163904,3371777520,7,0,0,105984,7,6997538903
8405,3371668925,3422,3371672347,7,0,1,3584,7,202488349
8406,3371742940,52291,3371795231,8,0,1,84992,8,4973168876
8407,3371768123,27774,3371795897,1,0,1,1024,1,3515484689
8408,3371793327,248754,3372042081,14,0,0,26624,14,10117587258
8409,3371820811,64988,3371885799,10,0,0,1024,10,5068593246
8410,3371827754,566,3371828320,18,0,1,512,18,882874891
8411,3371838821,43716,3371882537,0,0,1,71680,0,10708792710
8412,3371850402,98343,3371948745,12,0,0,19968,12,8793973059
8413,3371864301,105070,3371969371,17,0,0,2560,17,3277933996
8414,3371865733,90182,3371955915,3,0,0,2048,3,3907878261
8415,3371868839,120683,3371989522,3,0,0,1024,3,6052551704
8416,3371909133,48980,3371958113,5,0,0,2048,5,10072217725
8417,3371967062,150853,3372117915,11,0,0,42496,11,4354143459
8418,3371980871,92800,3372073671,1,0,0,8192,1,4244606804
8419,3372036673,9298,3372045971,14,0,1,4096,14,8987595902
8420,3372042208,100091,3372142299,7,0,0,19456,7,4473210781
8421,3372107191,74180,3372181371,4,0,0,6656,4,5641167222
8422,3372136577,387380,3372523957,9,0,0,255488,9,1996806169
8423,3372157664,13512,3372171176,0,0,1,26112,0,3131846268
8424,3372162346,100083,3372262429,17,0,0,1536,17,995192460
8425,3372184921,3898,3372188819,11,0,1,4096,11,7164565202
8426,3372190391,216818,3372407209,6,0,0,5632,6,2096623637
8427,3372208466,566,3372209032,12,0,1,512,12,9826638122
8428,3372212761,6754,3372219515,7,0,1,7168,7,1661155290
8429,3372224514,406459,3372630973,16,0,0,34816,16,4430418559
8430,3372250865,83786,3372334651,8,0,0,512,8,8219725703
8431,3372268954,6754,3372275708,7,0,1,7168,7,6311383523
8432,3372300100,289718,3372589818,1,0,0,53760,1,4113526998
8433,3372397803,141505,3372539308,4,0,0,50176,4,3606092646
8434,3372423293,5802,3372429095,11,0,1,6144,11,4214999573
8435,3372435588,4679,3372440267,9,0,1,12288,9,2404360830
8436,3372437034,3899,3372440933,7,0,1,1024,7,9952068923
8437,3372441797,200355,3372642152,17,0,0,512,17,6706128587
8438,3372441922,157271,3372599193,9,0,0,30720,9,4856933800
8439,3372443487,210983,3372654470,18,0,0,35840,18,4555316444
8440,3372458393,293631,3372752024,0,0,0,51712,0,9780496141
8441,3372480809,61880,3372542689,12,0,1,3584,12,9484752895
8442,3372489661,56152,3372545813,9,0,1,13824,9,3665565261
8443,3372492374,55065,3372547439,9,0,1,2560,9,660677689
8444,3372507463,373171,3372880634,15,0,0,64000,15,939570766
8445,3372510225,212429,3372722654,4,0,0,98304,4,5988316358
8446,3372538680,386396,3372925076,0,0,0,57856,0,1001175986
8447,3372558434,296556,3372854990,19,0,0,55808,19,6487695880
8448,3372595024,6631,3372601655,5,0,1,2560,5,6823303626
8449,3372615616,171040,3372786656,8,0,0,80384,8,4161840764
8450,3372624629,13566,3372638195,18,0,1,7680,18,423402891
8451,3372637318,265327,3372902645,13,0,0,72192,13,6169654246
8452,3372648278,138557,3372786835,3,0,0,512,3,9386913452
8453,3372650785,6172,3372656957,12,0,1,2560,12,884187260
8454,3372667554,6229,3372673783,19,0,1,15360,19,10239641678
8455,3372675044,12737,3372687781,12,0,1,24576,12,1450046204
8456,3372697624,205200,3372902824,17,0,0,512,17,1527959609
8457,3372767587,194874,3372962461,3,0,0,1024,3,8711066639
8458,3372798443,233918,3373032361,15,0,0,69120,15,5031904218
8459,3372809269,4420,3372813689,6,0,1,11776,6,2413838573
8460,3372844792,13612,3372858404,1,0,1,3584,1,5242067430
8461,3372868897,98687,3372967584,12,0,0,7168,12,4018756498
8462,3372915556,13932,3372929488,0,0,1,11776,0,9415379869
8463,3372927766,105898,3373033664,17,0,0,512,17,6227878533
8464,3372971726,1042,3372972768,9,0,1,1024,9,5257888554
8465,3372982419,130223,3373112642,4,0,0,31744,4,9091214538
8466,3372986620,150814,3373137434,6,0,0,12288,6,2229344475
8467,3372991538,93088,3373084626,3,0,0,512,3,9424495312
8468,3373026826,7045,3373033871,11,0,1,1536,11,3916344958
8469,3373163273,1518,3373164791,1,0,1,1536,1,8459189206
8470,3373165882,5712,3373171594,15,0,1,14336,15,10728808333
8471,3373167695,6502,3373174197,2,0,1,4096,2,3737230388
8472,3373214216,3904,3373218120,17,0,1,10752,17,4942817238
8473,3373220776,70953,3373291729,12,0,0,3072,12,8950679660
8474,3373251126,54056,3373305182,15,0,0,3584,15,1386026408
8475,3373263792,116882,3373380674,11,0,0,67584,11,8186225524
8476,3373323003,142271,3373465274,7,0,0,45568,7,8032078733
8477,3373395533,132183,3373527716,5,0,0,22528,5,1715109817
8478,3373530421,43904,3373574325,17,0,0,512,17,6787247427
8479,3373545370,49234,3373594604,17,0,0,1536,17,7015136973
8480,3373546372,2946,3373549318,6,0,1,3072,6,2626205798
8481,3373557182,4850,3373562032,3,0,1,5120,3,1180055505
8482,3373563504,43904,3373607408,10,0,0,512,10,2250379636
8483,3373622745,123925,3373746670,9,0,0,43008,9,305106707
8484,3373636763,7230,3373643993,10,0,1,7680,10,6831571232
8485,3373645340,63279,3373708619,3,0,0,1024,3,7388141849
8486,3373654566,14117,3373668683,17,0,1,24064,17,667273369
8487,3373670857,174506,3373845363,19,0,0,38400,19,7006197714
8488,3373713465,5196,3373718661,16,0,1,13312,16,5797453648
8489,3373874818,47288,3373922106,1,0,0,1536,1,9632192113
8490,3373890269,113360,3374003629,16,0,0,72192,16,1675722681
8491,3373954688,77561,3374032249,19,0,0,2560,19,6985448131
8492,3373963144,13858,3373977002,16,0,1,23552,16,7380975602
8493,3373974657,153552,3374128209,14,0,0,55808,14,703801838
8494,3373980555,23089,3374003644,2,0,1,2048,2,9507775263
8495,3374000398,16321,3374016719,16,0,1,22016,16,7583957660
8496,3374041832,566,3374042398,12,0,1,512,12,10026658165
8497,3374066516,1042,3374067558,3,0,1,1024,3,310336292
8498,3374076669,122234,3374198903,0,0,0,3584,0,8806455354
8499,3374084871,96831,3374181702,4,0,0,25600,4,3272180963
8500,3374104500,23740,3374128240,16,0,1,19456,16,1787095427
8501,3374114240,67477,3374181717,0,0,1,82432,0,7104174166
8502,3374115721,108836,3374224557,6,0,0,16896,6,5427607560
8503,3374156975,24757,3374181732,9,0,1,13312,9,2598224515
8504,3374187134,3898,3374191032,3,0,1,4096,3,3019898836
8505,3374275070,7706,3374282776,15,0,1,8192,15,10622738774
8506,3374302850,133518,3374436368,1,0,0,22528,1,6718727596
8507,3374319764,109725,3374429489,4,0,0,44032,4,9298197970
8508,3374330818,67695,3374398513,0,0,0,6656,0,3671417702
8509,3374365992,1042,3374367034,3,0,1,1024,3,5324549494
8510,3374384551,62896,3374447447,17,0,0,1024,17,9072181948
8511,3374429108,83035,3374512143,4,0,0,10752,4,10582297972
8512,3374457900,80708,3374538608,1,0,0,20480,1,3223440620
8513,3374502332,111488,3374613820,9,0,0,66048,9,4293520412
8514,3374607808,12282,3374620090,9,0,1,6656,9,6468164102
8515,3374614212,8784,3374622996,16,0,1,4608,16,9490258584
8516,3374661521,66680,3374728201,1,0,0,9728,1,2686916241
8517,3374665464,6754,3374672218,15,0,1,7168,15,3240301630
8518,3374690284,22691,3374712975,8,0,1,37376,8,1886628297
8519,3374800153,126384,3374926537,16,0,0,23040,16,10495229692
8520,3374825137,6278,3374831415,14,0,1,6656,14,3216229583
8521,3374951322,566,3374951888,14,0,1,512,14,8282471793
8522,3374965809,4420,3374970229,2,0,1,11776,2,3721394795
8523,3375002032,99476,3375101508,0,0,0,26624,0,10240651788
8524,3375015549,3898,3375019447,18,0,1,4096,18,9484272094
8525,3375035454,69501,3375104955,19,0,0,11264,19,1364210
8526,3375040592,1042,3375041634,11,0,1,1024,11,808036993
8527,3375043797,6278,3375050075,6,0,1,6656,6,7589099671
8528,3375048994,2067,3375051061,7,0,1,1536,7,6387863371
8529,3375128647,107120,3375235767,18,0,0,51712,18,5695822853
8530,3375145931,98072,3375244003,4,0,0,22016,4,7321570163
8531,3375161173,74773,3375235946,10,0,0,512,10,1327275782
8532,3375181759,137816,3375319575,0,0,0,57344,0,8780360131
8533,3375182072,68292,3375250364,15,0,0,7168,15,1077351780
8534,3375225853,135320,3375361173,0,0,0,11264,0,2261914752
8535,3375246805,287738,3375534543,16,0,0,190976,16,9104910163
8536,3375253844,3898,3375257742,3,0,1,4096,3,1983567948
8537,3375257055,294062,3375551117,7,0,0,6656,7,5239510411
8538,3375262574,2870,3375265444,2,0,1,8704,2,7626093092
8539,3375323659,566,3375324225,15,0,1,512,15,6937101822
8540,3375324390,224676,3375549066,8,0,0,47616,8,8924841912
8541,3375348303,4374,3375352677,3,0,1,4608,3,5972555535
8542,3375390058,1994,3375392052,19,0,1,2048,19,6622236184
8543,3375442327,141104,3375583431,14,0,0,21504,14,135294930
8544,3375465933,91476,3375557409,10,0,0,512,10,8302080533
8545,3375515352,39697,3375555049,10,0,1,4096,10,6897313362
8546,3375538129,363720,3375901849,16,0,0,48640,16,7398156123
8547,3375541447,176040,3375717487,6,0,0,1024,6,4587779800
8548,3375545213,114388,3375659601,1,0,0,43520,1,3359392195
8549,3375555975,158050,3375714025,18,0,0,41984,18,1128429822
8550,3375596437,1994,3375598431,2,0,1,2048,2,2284878836
8551,3375610145,4937,3375615082,8,0,1,12800,8,1340274919
8552,3375624672,94858,3375719530,9,0,0,6656,9,436358312
8553,3375632170,84990,3375717160,11,0,0,10240,11,6384426432
8554,3375677051,140625,3375817676,0,0,0,30720,0,2654171507
8555,3375678342,566,3375678908,15,0,1,512,15,321100156
8556,3375690807,136556,3375827363,8,0,0,31744,8,4988013438
8557,3375720761,2946,3375723707,2,0,1,3072,2,5939930317
8558,3375787011,1994,3375789005,9,0,1,2048,9,10557759338
8559,3375885996,15868,3375901864,11,0,1,9728,11,2602013787
8560,3375980309,106964,3376087273,0,0,0,51200,0,7313180688
8561,3376079448,60337,3376139785,7,0,0,3584,7,9666049622
8562,3376091205,111332,3376202537,14,0,0,65536,14,3074359480
8563,3376162212,110240,3376272452,13,0,0,61952,13,876467973
8564,3376199031,75776,3376274807,14,0,0,7680,14,10137603736
8565,3376225299,5326,3376230625,7,0,1,5632,7,148038408
8566,3376250705,1042,3376251747,6,0,1,1024,6,8040867683
8567,3376310144,114608,3376424752,11,0,0,76288,11,5196590747
8568,3376375877,69479,3376445356,17,0,0,512,17,5526267222
8569,3376517006,4937,3376521943,12,0,1,12800,12,5395171549
8570,3376527420,236747,3376764167,0,0,0,48128,0,6011189699
8571,3376530406,52138,3376582544,19,0,0,2048,19,10727470885
8572,3376539271,95804,3376635075,19,0,0,29696,19,1809886531
8573,3376561296,4850,3376566146,10,0,1,5120,10,10688925943
8574,3376585664,254961,3376840625,12,0,0,66048,12,7026323840
8575,3376703866,101816,3376805682,4,0,0,34304,4,8592989758
8576,3376705768,3387,3376709155,7,0,1,9728,7,3817671634
8577,3376710263,13858,3376724121,8,0,1,23552,8,9257409670
8578,3376716690,7995,3376724685,9,0,1,10752,9,9464253092
8579,3376722488,4463,3376726951,8,0,1,3584,8,10086603696
8580,3376723473,127562,3376851035,11,0,0,18432,11,1670729663
8581,3376788672,52140,3376840812,17,0,0,512,17,2861722659
8582,3376810622,198512,3377009134,4,0,0,40448,4,2966310297
8583,3376812095,6754,3376818849,15,0,1,7168,15,2438720847
8584,3376821466,122683,3376944149,1,0,0,39936,1,410268966
8585,3376829027,22023,3376851050,14,0,1,7680,14,7517855945
8586,3376837173,13892,3376851065,14,0,1,9216,14,8265462091
8587,3376852040,1518,3376853558,18,0,1,1536,18,8239900969
8588,3376869050,75894,3376944944,8,0,0,2560,8,5642890227
8589,3376902275,221147,3377123422,6,0,0,25088,6,5035425804
8590,3376958645,33503,3376992148,0,0,1,58368,0,7449078275
8591,3376984785,82933,3377067718,16,0,0,3584,16,6173569376
8592,3377002477,160131,3377162608,12,0,0,21504,12,9010460207
8593,3377009379,6278,3377015657,5,0,1,6656,5,2875156501
8594,3377014057,50672,3377064729,15,0,0,2560,15,8407317404
8595,3377022811,3387,3377026198,5,0,1,9728,5,2040768792
8596,3377085299,189131,3377274430,13,0,0,12800,13,3234115340
8597,3377107760,4374,3377112134,12,0,1,4608,12,8233002013
8598,3377125457,254335,3377379792,16,0,0,2560,16,8808139809
8599,3377127149,99035,3377226184,15,0,0,16896,15,10164184065
8600,3377146961,3446,3377150407,0,0,1,3584,0,2463050239
8601,3377146976,5057,3377152033,9,0,1,2560,9,4275677795
8602,3377164416,122074,3377286490,16,0,0,16384,16,1703855899
8603,3377172928,247084,3377420012,11,0,0,12288,11,8116763645
8604,3377192685,45596,3377238281,17,0,0,1024,17,8312561046
8605,3377193665,4850,3377198515,6,0,1,5120,6,9157030146
8606,3377211437,167560,3377378997,8,0,0,59392,8,1397648870
8607,3377233300,7706,3377241006,5,0,1,8192,5,7580800774
8608,3377296678,64208,3377360886,0,0,0,6656,0,10591853544
8609,3377315681,1994,3377317675,14,0,1,2048,14,9088085645
8610,3377337459,103844,3377441303,13,0,0,40960,13,8273129787
8611,3377344799,113635,3377458434,13,0,0,27136,13,2393474743
8612,3377412872,86836,3377499708,15,0,0,10240,15,7077670604
8613,3377434590,115591,3377550181,4,0,0,52736,4,9906791761
8614,3377436304,8455,3377444759,10,0,1,3584,10,2548023261
8615,3377439983,5442,3377445425,15,0,1,1024,15,10720044793
8616,3377450213,179257,3377629470,12,0,0,80384,12,5538316534
8617,3377487329,142624,3377629953,10,0,0,1536,10,7293444827
8618,3377498089,6031,3377504120,18,0,1,11776,18,5691098467
8619,3377607679,131414,3377739093,19,0,0,58368,19,6111302696
8620,3377643753,1518,3377645271,6,0,1,1536,6,641950445
8621,3377652649,263264,3377915913,8,0,0,212992,8,6569089990
8622,3377654544,137523,3377792067,9,0,0,14336,9,6102519400
8623,3377663811,566,3377664377,6,0,1,512,6,3892572080
8624,3377666419,5326,3377671745,6,0,1,5632,6,6970399534
8625,3377692398,236643,3377929041,3,0,0,5120,3,6492304890
8626,3377695741,2946,3377698687,2,0,1,3072,2,4644997764
8627,3377704352,268849,3377973201,19,0,0,48128,19,2744896779
8628,3377745856,3422,3377749278,2,0,1,3584,2,3603072199
8629,3377756402,239598,3377996000,7,0,0,74752,7,10375934669
8630,3377766392,243991,3378010383,15,0,0,43008,15,1048283358
8631,3377842903,200354,3378043257,6,0,0,21504,6,4356037330
8632,3377892727,230590,3378123317,19,0,0,4608,19,4603071762
8633,3377944150,133667,3378077817,19,0,0,36352,19,5328579068
8634,3377961920,116224,3378078144,14,0,0,1024,14,3524046626
8635,3377989434,53838,3378043272,8,0,1,71680,8,436203431
8636,3377992525,50762,3378043287,15,0,1,5120,15,8538339047
8637,3378015582,30915,3378046497,7,0,1,5632,7,1783920047
8638,3378058606,1042,3378059648,1,0,1,1024,1,4818544198
8639,3378076740,6722,3378083462,7,0,1,5632,7,1128670705
8640,3378080261,6107,3378086368,5,0,1,4608,5,5531888034
8641,3378091310,107073,3378198383,7,0,0,12800,7,5951991694
8642,3378193671,4727,3378198398,5,0,1,1536,5,5414340151
8643,3378205887,1518,3378207405,6,0,1,1536,6,8980823515
8644,3378209722,92313,3378302035,0,0,0,3584,0,9744014202
8645,3378214187,121343,3378335530,11,0,0,61952,11,2576768648
8646,3378215094,92149,3378307243,3,0,0,512,3,5313710527
8647,3378303104,216376,3378519480,7,0,0,38912,7,7736343752
8648,3378327066,9515,3378336581,7,0,1,1024,7,2426298068
8649,3378333423,13702,3378347125,16,0,1,18432,16,6152457368
8650,3378346798,138655,3378485453,5,0,0,65536,5,811212969
8651,3378355618,169961,3378525579,19,0,0,19968,19,2570745349
8652,3378370833,5326,3378376159,7,0,1,5632,7,6888581818
8653,3378386561,257680,3378644241,1,0,0,74752,1,8326687112
8654,3378393839,3387,3378397226,17,0,1,9728,17,8759874079
8655,3378406686,119688,3378526374,17,0,0,2560,17,7218162577
8656,3378479618,173218,3378652836,13,0,0,28160,13,3855708671
8657,3378527446,2946,3378530392,17,0,1,3072,17,4651586335
8658,3378553788,1042,3378554830,14,0,1,1024,14,1501595827
8659,3378585025,89768,3378674793,16,0,0,19968,16,8496657985
8660,3378589581,94543,3378684124,12,0,0,11776,12,7364799653
8661,3378659115,84512,3378743627,15,0,0,12800,15,1056940902
8662,3378700552,92060,3378792612,15,0,0,17408,15,7015156992
8663,3378720764,3128,3378723892,8,0,1,9216,8,1904188184
8664,3378765865,156094,3378921959,10,0,0,512,10,7710875149
8665,3378774390,45596,3378819986,17,0,0,1024,17,3642819767
8666,3378798863,3387,3378802250,6,0,1,9728,6,10654262332
8667,3378803527,4679,3378808206,0,0,1,12288,0,3035505249
8668,3378812571,101660,3378914231,12,0,0,33792,12,5776698508
8669,3378821238,235290,3379056528,16,0,0,47616,16,5274395418
8670,3378928340,1518,3378929858,1,0,1,1536,1,2327367831
8671,3378938368,190729,3379129097,6,0,0,23040,6,7066277486
8672,3378962896,32299,3378995195,0,0,1,52736,0,2567521465
8673,3378967063,188285,3379155348,3,0,0,1024,3,8093346713
8674,3378999321,110208,3379109529,9,0,0,26624,9,5369366430
8675,3379002931,3422,3379006353,17,0,1,3584,17,64647211
8676,3379015477,2946,3379018423,17,0,1,3072,17,9785284988
8677,3379117184,11928,3379129112,3,0,1,13312,3,6195671833
8678,3379166238,14117,3379180355,11,0,1,24064,11,9391047770
8679,3379277351,91280,3379368631,9,0,0,14848,9,848365217
8680,3379302484,148945,3379451429,11,0,0,9728,11,9855480373
8681,3379319138,49820,3379368958,0,0,0,1024,0,1120681103
8682,3379326039,109772,3379435811,12,0,0,60416,12,7994602965
8683,3379336598,64208,3379400806,16,0,0,6656,16,628567144
8684,3379427339,14759,3379442098,2,0,1,6656,2,3260309728
8685,3379432905,12419,3379445324,7,0,1,5120,7,5833980442
8686,3379484729,139226,3379623955,10,0,0,512,10,8055708346
8687,3379488743,122564,3379611307,1,0,0,102400,1,53999314
8688,3379511632,6278,3379517910,11,0,1,6656,11,8140957763
8689,3379549697,120122,3379669819,15,0,0,19968,15,7533732443
8690,3379595925,18838,3379614763,5,0,1,3584,5,5146817682
8691,3379605659,10090,3379615749,18,0,1,1536,18,712737823
8692,3379608764,8611,3379617375,7,0,1,2560,7,2405089769
8693,3379642807,30749,3379673556,0,0,1,49664,0,503917654
8694,3379684763,147739,3379832502,12,0,0,33792,12,4402990185
8695,3379689445,3422,3379692867,3,0,1,3584,3,4776098725
8696,3379694400,6754,3379701154,10,0,1,7168,10,4602277658
8697,3379725620,203630,3379929250,8,0,0,28160,8,9442181081
8698,3379733297,121451,3379854748,9,0,0,1536,9,6432604030
8699,3379753736,21658,3379775394,16,0,1,35328,16,8787220658
8700,3379851892,188649,3380040541,13,0,0,23040,13,762696663
8701,3379871083,1042,3379872125,7,0,1,1024,7,3454042528
8702,3379886944,45596,3379932540,14,0,0,1024,14,2389164619
8703,3379907644,125862,3380033506,0,0,0,70656,0,3706302480
8704,3379943075,105071,3380048146,3,0,0,512,3,5701937814
8705,3379979546,7230,3379986776,12,0,1,7680,12,2496578022
8706,3380017477,66960,3380084437,17,0,0,512,17,7023188116
8707,3380061703,71507,3380133210,8,0,1,115712,8,10308985447
8708,3380079160,55996,3380135156,15,0,1,3072,15,6565188840
8709,3380145264,100880,3380246144,14,0,0,31232,14,2606029095
8710,3380240683,49357,3380290040,12,0,0,512,12,395692923
8711,3380295661,1518,3380297179,2,0,1,1536,2,10706939693
8712,3380303695,99164,3380402859,7,0,0,25600,7,2903052600
8713,3380308324,5196,3380313520,11,0,1,13312,11,1860644523
8714,3380319014,2470,3380321484,13,0,1,2560,13,525294899
8715,3380320550,3128,3380323678,15,0,1,9216,15,1397310091
8716,3380348050,111155,3380459205,8,0,0,12800,8,233100864
8717,3380381867,124624,3380506491,14,0,0,66048,14,4042165079
8718,3380395532,11217,3380406749,19,0,1,4096,19,6834378809
8719,3380440484,4937,3380445421,1,0,1,12800,1,830155103
8720,3380444439,144300,3380588739,11,0,0,66560,11,9861860263
8721,3380458199,3468,3380461667,17,0,1,2560,17,5380433350
8722,3380482946,195199,3380678145,7,0,0,126976,7,403676607
8723,3380492204,19171,3380511375,19,0,1,5120,19,6180922554
8724,3380493058,291450,3380784508,15,0,0,90624,15,3182462769
8725,3380498778,13263,3380512041,9,0,1,1024,9,6664757429
8726,3380507969,120834,3380628803,17,0,0,512,17,10421302547
8727,3380551336,144505,3380695841,8,0,0,7680,8,752349996
8728,3380565775,1042,3380566817,13,0,1,1024,13,6841589940
8729,3380566158,222429,3380788587,11,0,0,13312,11,5539472263
8730,3380596333,303075,3380899408,15,0,0,142848,15,6577875319
8731,3380600311,226611,3380826922,6,0,0,22016,6,3264298851
8732,3380602719,12825,3380615544,2,0,1,21504,2,9564730915
8733,3380628167,180281,3380808448,13,0,0,5632,13,5085866926
8734,3380639064,268969,3380908033,18,0,0,27648,18,693496986
8735,3380649487,30210,3380679697,6,0,1,1536,6,4439274298
8736,3380662502,249461,3380911963,14,0,0,12288,14,4330068080
8737,3380675489,6803,3380682292,14,0,1,10240,14,6800847220
8738,3380686605,3422,3380690027,9,0,1,3584,9,8245475534
8739,3380731203,177001,3380908204,12,0,0,512,12,8716669605
8740,3380757979,33770,3380791749,5,0,1,9216,5,7376549177
8741,3380774325,22041,3380796366,10,0,1,12800,10,7810104044
8742,3380777551,134739,3380912290,17,0,0,1024,17,10015111738
8743,3380777841,21133,3380798974,6,0,1,10240,6,9178937120
8744,3380804227,95367,3380899594,12,0,0,512,12,4921762888
8745,3380827358,3898,3380831256,5,0,1,4096,5,7493566895
8746,3380843860,282235,3381126095,11,0,0,35840,11,8220451160
8747,3380854338,45085,3380899423,17,0,1,4096,17,6253263767
8748,3380945892,7706,3380953598,15,0,1,8192,15,1290755410
8749,3380950842,103532,3381054374,15,0,0,39936,15,2191029727
8750,3380987130,111881,3381099011,18,0,0,22528,18,1149435502
8751,3381028574,86556,3381115130,15,0,0,10240,15,4293698988
8752,3381041402,44652,3381086054,0,0,0,512,0,3967403275
8753,3381047926,10380,3381058306,12,0,1,4096,12,4366128667
8754,3381048157,66988,3381115145,8,0,1,97792,8,5926574190
8755,3381052059,63101,3381115160,19,0,1,2048,19,4930366235
8756,3381067027,79120,3381146147,8,0,0,3584,8,6963802130
8757,3381127067,109040,3381236107,19,0,0,19968,19,3515663463
8758,3381139252,76817,3381216069,14,0,0,3072,14,3166470451
8759,3381186223,3898,3381190121,15,0,1,4096,15,2418099431
8760,3381214172,47288,3381261460,12,0,0,1536,12,5674047263
8761,3381252568,76417,3381328985,9,0,0,512,9,2297427923
8762,3381272924,2946,3381275870,12,0,1,3072,12,9335394123
8763,3381299587,118421,3381418008,11,0,0,33280,11,2130513852
8764,3381361027,90625,3381451652,17,0,0,512,17,8079843765
8765,3381366910,131299,3381498209,0,0,0,18432,0,8615297055
8766,3381374209,6488,3381380697,3,0,1,15872,3,7134411327
8767,3381388699,52364,3381441063,18,0,0,3072,18,10396606634
8768,3381399857,78498,3381478355,10,0,0,2560,10,4065280984
8769,3381407748,45596,3381453344,11,0,0,1024,11,1972210547
8770,3381412801,54179,3381466980,12,0,0,2048,12,3718424216
8771,3381419995,45596,3381465591,3,0,0,1024,3,9159554365
8772,3381441638,81340,3381522978,16,0,0,13312,16,6423729528
8773,3381458908,2870,3381461778,0,0,1,8704,0,7376767925
8774,3381482298,3422,3381485720,9,0,1,3584,9,1208776583
8775,3381485875,71082,3381556957,9,0,0,1536,9,6752222105
8776,3381497266,8182,3381505448,18,0,1,7680,18,5411093034
8777,3381497892,107034,3381604926,1,0,0,17408,1,7797009403
8778,3381516561,53066,3381569627,16,0,1,86528,16,8224595214
8779,3381520571,51642,3381572213,6,0,1,4096,6,10087142715
8780,3381551192,47890,3381599082,10,0,0,1024,10,8055222920
8781,3381567931,4628,3381572559,17,0,1,512,17,6672888927
8782,3381576067,4374,3381580441,5,0,1,4608,5,1159949895
8783,3381584158,271900,3381856058,8,0,0,34304,8,6986599485
8784,3381655938,281603,3381937541,5,0,0,183296,5,7101313303
8785,3381669095,303078,3381972173,0,0,0,90624,0,9663066947
8786,3381713603,101235,3381814838,14,0,0,7680,14,7859142310
8787,3381767595,293630,3382061225,11,0,0,68096,11,1905582919
8788,3381768509,5802,3381774311,13,0,1,6144,13,8647562635
8789,3381788914,3645,3381792559,17,0,1,10240,17,599803689
8790,3381795009,566,3381795575,9,0,1,512,9,7984478394
8791,3381824870,202626,3382027496,16,0,0,1536,16,2878583719
8792,3381849153,10795,3381859948,3,0,1,4096,3,991275383
8793,3381861278,4374,3381865652,7,0,1,4608,7,6171535970
8794,3381869990,209781,3382079771,0,0,0,52224,0,4373293948
8795,3381870801,102487,3381973288,6,0,0,3584,6,232208476
8796,3381895560,45395,3381940955,7,0,1,3584,7,9072091827
8797,3381967280,7485,3381974765,19,0,1,1536,19,10651436244
8798,3382069897,16112,3382086009,7,0,1,15360,7,7921276002
8799,3382073712,184336,3382258048,0,0,0,13312,0,2322961532
8800,3382080216,54965,3382135181,11,0,0,2560,11,4802957249
8801,3382173019,43904,3382216923,10,0,0,512,10,7564847366
8802,3382226779,137694,3382364473,16,0,0,92160,16,5195520562
8803,3382227899,61216,3382289115,17,0,0,512,17,3947742012
8804,3382261977,47288,3382309265,9,0,0,1536,9,5726243307
8805,3382305385,169415,3382474800,5,0,0,57344,5,341201944
8806,3382316812,116948,3382433760,4,0,0,83968,4,3861520351
8807,3382346160,30096,3382376256,0,0,1,19456,0,4888380335
8808,3382377961,3128,3382381089,10,0,1,9216,10,735170965
8809,3382391277,62439,3382453716,9,0,0,1024,9,2193192937
8810,3382394932,1042,3382395974,19,0,1,1024,19,7359507729
8811,3382397082,566,3382397648,9,0,1,512,9,3982679578
8812,3382432986,4664,3382437650,18,0,1,4096,18,7380883129
8813,3382445207,3422,3382448629,19,0,1,3584,19,8261888572
8814,3382450743,43904,3382494647,12,0,0,512,12,6507683573
8815,3382454718,125245,3382579963,7,0,0,92672,7,3543621387
8816,3382493690,2470,3382496160,19,0,1,2560,19,3134095518
8817,3382498622,83803,3382582425,12,0,0,1024,12,9186232659
8818,3382541781,2470,3382544251,12,0,1,2560,12,10721211863
8819,3382555666,216957,3382772623,7,0,0,99328,7,10695728012
8820,3382561457,25028,3382586485,0,0,1,15872,0,4726369895
8821,3382568854,94775,3382663629,11,0,0,19968,11,7538412045
8822,3382609872,566,3382610438,2,0,1,512,2,5331100502
8823,3382622084,7706,3382629790,2,0,1,8192,2,1592045000
8824,3382651550,42166,3382693716,16,0,1,68608,16,1193978196
8825,3382656851,38171,3382695022,19,0,1,2048,19,30182722
8826,3382713735,75856,3382789591,17,0,0,1536,17,3525575192
8827,3382725065,1042,3382726107,14,0,1,1024,14,6934858270
8828,3382733378,5326,3382738704,2,0,1,5632,2,6114014691
8829,3382737898,3898,3382741796,7,0,1,4096,7,4272810188
8830,3382881273,85580,3382966853,5,0,0,9728,5,4737059090
8831,3382884270,4420,3382888690,6,0,1,11776,6,10442680574
8832,3382894817,156630,3383051447,0,0,0,59392,0,2114728679
8833,3382939475,4162,3382943637,15,0,1,11264,15,9795657795
8834,3382943417,113669,3383057086,4,0,0,18432,4,9743771995
8835,3383004610,52647,3383057257,10,0,0,512,10,5221540812
8836,3383023589,107622,3383131211,4,0,0,21504,4,7681289469
8837,3383034063,48857,3383082920,8,0,1,46592,8,9710188379
8838,3383098954,184270,3383283224,11,0,0,104448,11,9632147705
8839,3383107074,1042,3383108116,11,0,1,1024,11,9193455073
8840,3383107878,2870,3383110748,1,0,1,8704,1,3895514532
8841,3383127791,155995,3383283786,17,0,0,1024,17,1930405048
8842,3383132773,43370,3383176143,0,0,1,74240,0,328938208
8843,3383203560,25187,3383228747,8,0,1,45568,8,4194977252
8844,3383296865,5196,3383302061,9,0,1,13312,9,3845810023
8845,3383319067,69536,3383388603,14,0,0,7168,14,3909934016
8846,3383355001,159083,3383514084,18,0,0,30720,18,2463404111
8847,3383373153,131548,3383504701,15,0,0,40960,15,3220429790
8848,3383447836,21399,3383469235,0,0,1,34816,0,822649305
8849,3383452862,111503,3383564365,1,0,0,47616,1,6042136436
8850,3383466170,5331,3383471501,12,0,1,3584,12,1757979883
8851,3383484419,255559,3383739978,14,0,0,37888,14,1921358333
8852,3383499248,15837,3383515085,9,0,1,1024,9,4707377876
8853,3383546434,224137,3383770571,8,0,0,26112,8,4617737871
8854,3383551416,18412,3383569828,14,0,1,13824,14,6231128363
8855,3383552168,71658,3383623826,0,0,0,6144,0,4660439444
8856,3383590772,60824,3383651596,18,0,0,5632,18,2506790922
8857,3383604627,157973,3383762600,1,0,0,58880,1,3120546667
8858,3383632128,190262,3383822390,5,0,0,27136,5,6015024022
8859,3383724107,1042,3383725149,7,0,1,1024,7,2822505827
8860,3383735515,48359,3383783874,12,0,0,512,12,7803135857
8861,3383772815,2470,3383775285,6,0,1,2560,6,476868149
8862,3383788449,3387,3383791836,10,0,1,9728,10,2933561289
8863,3383827338,43904,3383871242,9,0,0,512,9,8468651332
8864,3383866123,21658,3383887781,16,0,1,35328,16,6405434262
8865,3383868310,23977,3383892287,11,0,1,7168,11,170404704
8866,3383868538,113930,3383982468,11,0,0,5120,11,295908301
8867,3383877741,43102,3383920843,0,0,1,67584,0,9910008659
8868,3383905248,97662,3384002910,9,0,0,512,9,219167682
8869,3383936844,15321,3383952165,17,0,1,29696,17,2351106147
8870,3383939013,280728,3384219741,1,0,0,118272,1,4678736154
8871,3383956818,114902,3384071720,17,0,0,512,17,5197736259
8872,3383963675,72570,3384036245,5,0,0,512,5,2768046467
8873,3383992725,51720,3384044445,17,0,0,1024,17,9350225259
8874,3383997240,80052,3384077292,17,0,0,1536,17,1309354441
8875,3383997330,5802,3384003132,1,0,1,6144,1,2714996443
8876,3384013217,5196,3384018413,0,0,1,13312,0,7067455569
8877,3384068312,80362,3384148674,15,0,0,6656,15,5682661665
8878,3384069702,566,3384070268,12,0,1,512,12,6782932123
8879,3384073910,207248,3384281158,16,0,0,22528,16,4296506684
8880,3384138987,185677,3384324664,1,0,0,23040,1,5507684128
8881,3384139927,197488,3384337415,4,0,0,2560,4,9637841107
8882,3384163610,12049,3384175659,16,0,1,19968,16,5911855548
8883,3384214004,216138,3384430142,13,0,0,31744,13,1289961324
8884,3384280222,140233,3384420455,6,0,0,23040,6,8678720863
8885,3384284816,63921,3384348737,17,0,0,512,17,10072216938
8886,3384330136,4937,3384335073,7,0,1,12800,7,8660076770
8887,3384333262,265383,3384598645,14,0,0,113152,14,9047700570
8888,3384339985,114219,3384454204,3,0,0,1024,3,1151020985
8889,3384364292,3422,3384367714,14,0,1,3584,14,7865900218
8890,3384403562,120215,3384523777,18,0,0,23040,18,8439026359
8891,3384432630,226784,3384659414,4,0,0,123392,4,4062323706
8892,3384479927,5454,3384485381,19,0,1,13824,19,3571781168
8893,3384526677,147239,3384673916,16,0,0,8704,16,7683773487
8894,3384542362,1042,3384543404,7,0,1,1024,7,7443058634
8895,3384631289,98961,3384730250,18,0,0,13312,18,4947713358
8896,3384670147,1042,3384671189,4,0,1,1024,4,6784034763
8897,3384776110,24154,3384800264,8,0,1,43520,8,4025131836
8898,3384801738,144741,3384946479,14,0,0,53248,14,6011477538
8899,3384807269,199064,3385006333,17,0,0,1024,17,7929557105
8900,3384863231,5712,3384868943,3,0,1,14336,3,1857900352
8901,3384879989,190184,3385070173,19,0,0,6656,19,2533448287
8902,3384913719,132490,3385046209,6,0,0,20992,6,4043288973
8903,3384961814,6278,3384968092,18,0,1,6656,18,8760841944
8904,3385000737,57592,3385058329,4,0,0,3072,4,9241411621
8905,3385058119,113406,3385171525,16,0,0,71680,16,5552624308
8906,3385106131,11533,3385117664,3,0,1,18944,3,3531243015
8907,3385110742,95610,3385206352,19,0,0,25088,19,1517602627
8908,3385149842,187714,3385337556,6,0,0,1536,6,5902696252
8909,3385168842,5646,3385174488,7,0,1,3072,7,204043849
8910,3385247541,45596,3385293137,3,0,0,1024,3,7242236880
8911,3385321885,125092,3385446977,3,0,0,1024,3,6338628935
8912,3385329999,3898,3385333897,15,0,1,4096,15,2053239413
8913,3385354712,233814,3385588526,15,0,0,46592,15,9373523551
8914,3385366828,4374,3385371202,15,0,1,4608,15,1532712973
8915,3385377567,566,3385378133,10,0,1,512,10,5395003649
8916,3385394247,3904,3385398151,17,0,1,10752,17,1031269227
8917,3385474806,4162,3385478968,6,0,1,11264,6,6442096452
8918,3385482286,4679,3385486965,1,0,1,12288,1,2537509397
8919,3385570840,87140,3385657980,1,0,0,16384,1,2273027781
8920,3385600607,1518,3385602125,10,0,1,1536,10,1464323319
8921,3385620957,48387,3385669344,12,0,0,1024,12,7408576525
8922,3385626268,47288,3385673556,17,0,0,1536,17,4682934645
8923,3385647128,1994,3385649122,7,0,1,2048,7,4122148222
8924,3385654539,147346,3385801885,7,0,0,61440,7,3559875049
8925,3385678033,7706,3385685739,4,0,1,8192,4,6841973850
8926,3385693964,160498,3385854462,14,0,0,14848,14,492939447
8927,3385707544,183593,3385891137,0,0,0,120320,0,6410130243
8928,3385756036,3422,3385759458,6,0,1,3584,6,9771267536
8929,3385783288,23005,3385806293,6,0,1,4608,6,2355625780
8930,3385783638,23641,3385807279,6,0,1,1536,6,1970699411
8931,3385786631,21314,3385807945,7,0,1,1024,7,5390646002
8932,3385813694,77630,3385891324,9,0,0,512,9,7090715118
8933,3385854897,39564,3385894461,18,0,1,9216,18,4786927239
8934,3385876004,22557,3385898561,10,0,1,11776,10,1944107404
8935,3385887037,17180,3385904217,16,0,1,15872,16,7094146768
8936,3385887951,16612,3385904563,12,0,1,512,12,477914452
8937,3385934794,132512,3386067306,14,0,0,38912,14,8271543867
8938,3385945576,3422,3385948998,11,0,1,3584,11,1494431163
8939,3385950802,227574,3386178376,4,0,0,119296,4,7162574966
8940,3385955872,117006,3386072878,3,0,0,1024,3,9988462202
8941,3385994192,7706,3386001898,2,0,1,8192,2,7509084288
8942,3386063440,17716,3386081156,5,0,1,23552,5,7176360966
8943,3386084173,101694,3386185867,16,0,0,5632,16,180431749
8944,3386115753,243852,3386359605,0,0,0,54784,0,3126436286
8945,3386144411,54598,3386199009,2,0,1,33280,2,8728431704
8946,3386166128,322140,3386488268,11,0,0,98304,11,10665869679
8947,3386190113,146317,3386336430,13,0,0,23040,13,8651833172
8948,3386195593,111393,3386306986,18,0,0,34304,18,3673079451
8949,3386203538,198732,3386402270,8,0,0,44032,8,941967516
8950,3386226186,1042,3386227228,2,0,1,1024,2,7027020779
8951,3386278796,7230,3386286026,4,0,1,7680,4,6051027317
8952,3386286045,1042,3386287087,13,0,1,1024,13,3038641588
8953,3386301392,79331,3386380723,16,0,1,123392,16,8262841879
8954,3386362752,24282,3386387034,13,0,1,22016,13,7317797060
8955,3386365379,129282,3386494661,9,0,0,512,9,1174965988
8956,3386424329,103728,3386528057,13,0,0,6656,13,9883660330
8957,3386492515,60854,3386553369,10,0,0,1024,10,7505366586
8958,3386497806,14117,3386511923,4,0,1,24064,4,3712394888
8959,3386549218,1042,3386550260,15,0,1,1024,15,673304785
8960,3386587191,3898,3386591089,18,0,1,4096,18,8545970849
8961,3386590656,275573,3386866229,1,0,0,81920,1,3231152986
8962,3386595621,4850,3386600471,18,0,1,5120,18,5529269313
8963,3386660945,32816,3386693761,8,0,1,53760,8,1403721686
8964,3386666138,44052,3386710190,16,0,1,53760,16,154701269
8965,3386696094,15402,3386711496,6,0,1,2048,6,4634135745
8966,3386728234,147682,3386875916,13,0,0,31744,13,9915610525
8967,3386786195,89892,3386876087,12,0,0,512,12,1900579893
8968,3386888914,48980,3386937894,17,0,0,2048,17,7312954998
8969,3386925995,7706,3386933701,7,0,1,8192,7,7149409324
8970,3386926871,55939,3386982810,0,0,0,1024,0,796640881
8971,3386936878,68166,3387005044,8,0,0,5632,8,6305396247
8972,3386964311,160504,3387124815,11,0,0,112128,11,1376061473
8973,3386968462,176219,3387144681,1,0,0,37376,1,5663160921
8974,3386970103,163159,3387133262,16,0,0,27648,16,6400938174
8975,3386992648,201273,3387193921,4,0,0,59392,4,9638851937
8976,3387051579,5326,3387056905,8,0,1,5632,8,6899049791
8977,3387053758,3813,3387057571,12,0,1,1024,12,2384211760
8978,3387095641,102342,3387197983,17,0,0,1024,17,4911658397
8979,3387121308,73096,3387194404,15,0,0,1536,15,4906717438
8980,3387125424,22603,3387148027,11,0,1,9728,11,3105971204
8981,3387147591,3960,3387151551,3,0,1,4096,3,10532444214
8982,3387158271,121254,3387279525,11,0,0,61952,11,5622383257
8983,3387196336,10757,3387207093,9,0,1,17408,9,6249570988
8984,3387205633,4046,3387209679,10,0,1,4096,10,10008117288
8985,3387299709,66976,3387366685,18,0,0,4608,18,2467748720
8986,3387300955,253897,3387554852,19,0,0,19968,19,547407646
8987,3387303153,12049,3387315202,8,0,1,19968,8,7649525516
8988,3387317471,134031,3387451502,19,0,0,65024,19,3232775613
8989,3387322074,168479,3387490553,3,0,0,2560,3,7115470967
8990,3387322654,167104,3387489758,16,0,0,34304,16,1850750491
8991,3387324162,1042,3387325204,10,0,1,1024,10,9519530495
8992,3387334978,3128,3387338106,4,0,1,9216,4,6281726792
8993,3387345062,448770,3387793832,7,0,0,74240,7,2848935421
8994,3387353442,6278,3387359720,11,0,1,6656,11,1034908021
8995,3387356947,219505,3387576452,13,0,0,40448,13,4382052824
8996,3387390434,380763,3387771197,0,0,0,225792,0,1672023805
8997,3387449955,7341,3387457296,9,0,1,6144,9,9016826888
8998,3387486607,312076,3387798683,1,0,0,15872,1,6448492593
8999,3387523149,2470,3387525619,10,0,1,2560,10,8457176871
9000,3387531247,393947,3387925194,1,0,0,79360,1,9119548398
9001,3387532708,4162,3387536870,4,0,1,11264,4,2080670407
9002,3387562701,1042,3387563743,13,0,1,1024,13,5283379367
9003,3387598539,53237,3387651776,8,0,1,90112,8,4178950862
9004,3387647913,5489,3387653402,11,0,1,2560,11,4136229447
9005,3387679888,12308,3387692196,16,0,1,20480,16,6736055901
9006,3387826648,127374,3387954022,13,0,0,57856,13,7478211747
9007,3387839819,201043,3388040862,15,0,0,36864,15,9943688414
9008,3387840768,144940,3387985708,14,0,0,4096,14,4559060522
9009,3387844421,3422,3387847843,7,0,1,3584,7,3314638257
9010,3387895855,3904,3387899759,17,0,1,10752,17,9759659528
9011,3387924037,6475,3387930512,7,0,1,5632,7,8943504854
9012,3387934291,21399,3387955690,0,0,1,34816,0,2950654032
9013,3387951420,8396,3387959816,2,0,1,6144,2,682191719
9014,3387972988,1042,3387974030,14,0,1,1024,14,10735127955
9015,3388022294,18583,3388040877,18,0,1,8192,18,3960733215
9016,3388030374,14393,3388044767,14,0,1,4096,14,1706504545
9017,3388043591,194303,3388237894,11,0,0,43520,11,6111114347
9018,3388048172,1042,3388049214,5,0,1,1024,5,8150238608
9019,3388054791,14545,3388069336,2,0,1,28160,2,1686818882
9020,3388085905,72453,3388158358,17,0,0,512,17,4963130811
9021,3388088668,4374,3388093042,13,0,1,4608,13,4921645349
9022,3388088803,155166,3388243969,4,0,0,8192,4,6330974433
9023,3388120016,10499,3388130515,8,0,1,16896,8,168920031
9024,3388133790,10757,3388144547,8,0,1,17408,8,6168078476
9025,3388135138,10280,3388145418,0,0,1,12288,0,5891853734
9026,3388170350,99586,3388269936,12,0,0,1024,12,309698443
9027,3388179756,1042,3388180798,2,0,1,1024,2,8825801461
9028,3388205763,183630,3388389393,1,0,0,34816,1,10424988432
9029,3388219830,69908,3388289738,11,0,0,10240,11,2821795259
9030,3388254561,52364,3388306925,17,0,0,3072,17,8592282917
9031,3388307188,43904,3388351092,12,0,0,512,12,8776863402
9032,3388314898,3904,3388318802,5,0,1,10752,5,661355223
9033,3388320350,72541,3388392891,16,0,1,117760,16,999536702
9034,3388333854,59703,3388393557,17,0,1,11264,17,5066025054
9035,3388340144,79846,3388419990,8,0,1,85504,8,2029639231
9036,3388342559,108788,3388451347,12,0,0,1024,12,1590562238
9037,3388347418,75158,3388422576,7,0,1,4096,7,5037120557
9038,3388371571,106542,3388478113,12,0,0,2048,12,7924968612
9039,3388373886,55206,3388429092,13,0,1,23040,13,8197775278
9040,3388432943,387515,3388820458,12,0,0,1536,12,4421223266
9041,3388433135,12049,3388445184,16,0,1,19968,16,3332899393
9042,3388440741,8309,3388449050,18,0,1,6144,18,7342771149
9043,3388454540,173016,3388627556,0,0,1,280064,0,5457884173
9044,3388485323,143539,3388628862,13,0,1,2048,13,8774810708
9045,3388497183,135225,3388632408,13,0,1,5632,13,2368898015
9046,3388517488,234490,3388751978,11,0,0,116224,11,6320209569
9047,3388575300,60014,3388635314,19,0,1,4608,19,7362682779
9048,3388588778,47842,3388636620,18,0,1,2048,18,882522706
9049,3388608025,269110,3388877135,15,0,0,58880,15,6143483662
9050,3388617348,199438,3388816786,13,0,0,4608,13,4596347501
9051,3388672994,379672,3389052666,8,0,0,40448,8,6478765781
9052,3388674535,2470,3388677005,12,0,1,2560,12,2137697033
9053,3388678337,180843,3388859180,8,0,0,25600,8,8251350193
9054,3388680119,158828,3388838947,15,0,0,5120,15,1454961303
9055,3388684518,307094,3388991612,8,0,0,24064,8,4833892507
9056,3388694136,346191,3389040327,16,0,0,148992,16,3058894255
9057,3388712654,39339,3388751993,16,0,1,48128,16,3159927412
9058,3388817196,120008,3388937204,17,0,0,1536,17,703669911
9059,3388835503,116899,3388952402,10,0,0,512,10,7140911702
9060,3388870562,190975,3389061537,1,0,0,11264,1,1388558381
9061,3388900426,81943,3388982369,8,0,0,2560,8,10558261000
9062,3388967310,85559,3389052869,10,0,0,512,10,9372133818
9063,3388999496,218869,3389218365,8,0,0,82432,8,8739484026
9064,3389007063,54489,3389061552,14,0,1,6656,14,423258542
9065,3389011325,153520,3389164845,11,0,0,68096,11,4509666396
9066,3389014728,153579,3389168307,14,0,0,11264,14,70604792
9067,3389128462,93038,3389221500,5,0,0,10240,5,614016272
9068,3389227758,566,3389228324,6,0,1,512,6,8491186680
9069,3389238862,76388,3389315250,0,0,0,16384,0,5963903723
9070,3389251870,173237,3389425107,18,0,0,17920,18,545577436
9071,3389298282,5802,3389304084,17,0,1,6144,17,7099881882
9072,3389348137,52033,3389400170,16,0,1,84480,16,3189254142
9073,3389406464,566,3389407030,14,0,1,512,14,4631978439
9074,3389466030,74040,3389540070,6,0,0,10240,6,6401582987
9075,3389472883,99632,3389572515,6,0,0,27136,6,6946638921
9076,3389483607,79436,3389563043,1,0,0,11264,1,4621410821
9077,3389495331,3422,3389498753,4,0,1,3584,4,7129573801
9078,3389498105,994,3389499099,2,0,1,512,2,2076703167
9079,3389509268,95749,3389605017,0,0,0,6656,0,10600110654
9080,3389513608,3904,3389517512,14,0,1,10752,14,9544710535
9081,3389514601,3257,3389517858,9,0,1,512,9,794864524
9082,3389518875,66018,3389584893,1,0,0,6144,1,2450564158
9083,3389521862,2946,3389524808,13,0,1,3072,13,3594092956
9084,3389590574,5454,3389596028,10,0,1,13824,10,7794630947
9085,3389594486,2208,3389596694,17,0,1,1024,17,2920066190
9086,3389631983,123206,3389755189,15,0,0,27648,15,4887779719
9087,3389641293,566,3389641859,3,0,1,512,3,8547072642
9088,3389677714,6488,3389684202,12,0,1,15872,12,5040827262
9089,3389694717,77278,3389771995,9,0,0,1024,9,8642276709
9090,3389714296,3898,3389718194,3,0,1,4096,3,3864327163
9091,3389717407,254624,3389972031,14,0,0,51200,14,2743333503
9092,3389759938,50672,3389810610,17,0,0,2560,17,2762340666
9093,3389792148,208191,3390000339,1,0,0,28160,1,560678793
9094,3389818510,3422,3389821932,4,0,1,3584,4,1655192416
9095,3389854729,88208,3389942937,15,0,0,14848,15,2695113725
9096,3389861883,49036,3389910919,15,0,0,1024,15,5312573855
9097,3389863803,296836,3390160639,14,0,0,150016,14,9175317180
9098,3389894060,6754,3389900814,7,0,1,7168,7,3156961375
9099,3389921738,2470,3389924208,14,0,1,2560,14,10345201282
9100,3389936600,120593,3390057193,6,0,0,43520,6,4967217458
9101,3389978240,566,3389978806,9,0,1,512,9,8113662442
9102,3389984873,188908,3390173781,1,0,0,43008,1,8330479744
9103,3390001272,1518,3390002790,9,0,1,1536,9,2093007908
9104,3390005332,1042,3390006374,2,0,1,1024,2,8738988052
9105,3390066242,4374,3390070616,18,0,1,4608,18,8362192960
9106,3390083083,3645,3390086728,12,0,1,10240,12,9443421138
9107,3390096557,151371,3390247928,14,0,0,34816,14,5378156749
9108,3390113978,46676,3390160654,18,0,1,1536,18,8650378093
9109,3390131205,50241,3390181446,17,0,1,8192,17,268115090
9110,3390169431,14921,3390184352,7,0,1,4608,7,6149699503
9111,3390337741,1994,3390339735,14,0,1,2048,14,3506694190
9112,3390341450,2946,3390344396,1,0,1,3072,1,5258038810
9113,3390372602,75291,3390447893,17,0,0,1024,17,2207148798
9114,3390446569,1994,3390448563,4,0,1,2048,4,5837810420
9115,3390449987,57440,3390507427,17,0,0,4608,17,8399975823
9116,3390508012,48980,3390556992,16,0,0,2048,16,7484250850
9117,3390552832,1518,3390554350,5,0,1,1536,5,7697266347
9118,3390597343,66900,3390664243,12,0,0,1024,12,1200164227
9119,3390608230,2946,3390611176,18,0,1,3072,18,10555163505
9120,3390618647,97604,3390716251,1,0,0,20480,1,8987711768
9121,3390621081,171472,3390792553,14,0,0,37888,14,8334703898
9122,3390631698,2946,3390634644,14,0,1,3072,14,6139659412
9123,3390660049,193841,3390853890,6,0,0,35840,6,2517768825
9124,3390682426,3904,3390686330,15,0,1,10752,15,10531474635
9125,3390682993,4752,3390687745,1,0,1,2048,1,2579981647
9126,3390690220,566,3390690786,2,0,1,512,2,3385064611
9127,3390692488,4679,3390697167,3,0,1,12288,3,10078362480
9128,3390762415,30153,3390792568,0,0,1,36864,0,9297365188
9129,3390796288,566,3390796854,10,0,1,512,10,9751968961
9130,3390853468,2408,3390855876,6,0,1,2048,6,3718783508
9131,3390877651,47288,3390924939,3,0,0,1536,3,10095637707
9132,3390967958,3387,3390971345,12,0,1,9728,12,9529898849
9133,3390996961,186184,3391183145,1,0,0,5632,1,2600849097
9134,3391004492,45596,3391050088,17,0,0,1024,17,2956421526
9135,3391007537,1518,3391009055,6,0,1,1536,6,5496521275
9136,3391011399,5454,3391016853,8,0,1,13824,8,10271836553
9137,3391052507,3128,3391055635,11,0,1,9216,11,7329485672
9138,3391054071,1910,3391055981,1,0,1,512,1,7282645645
9139,3391068644,169834,3391238478,0,0,0,15360,0,921367718
9140,3391092831,118800,3391211631,4,0,0,4096,4,6792984450
9141,3391120414,131180,3391251594,5,0,0,28160,5,994378526
9142,3391134253,1042,3391135295,10,0,1,1024,10,8499439733
9143,3391174043,5802,3391179845,17,0,1,6144,17,6034509738
9144,3391202725,1042,3391203767,6,0,1,1024,6,1989584432
9145,3391208300,63140,3391271440,6,0,0,8192,6,4303524058
9146,3391211336,66536,3391277872,1,0,0,4096,1,2217529820
9147,3391222710,4937,3391227647,5,0,1,12800,5,8933065557
9148,3391239409,12200,3391251609,18,0,1,15872,18,3459219858
9149,3391254273,45596,3391299869,17,0,0,1024,17,9030481812
9150,3391262437,105248,3391367685,7,0,0,45568,7,308580338
9151,3391308055,135674,3391443729,10,0,0,512,10,364907131
9152,3391322802,261135,3391583937,11,0,0,158208,11,9296595941
9153,3391353860,161076,3391514936,15,0,0,27136,15,9761101028
9154,3391456853,75045,3391531898,9,0,0,1024,9,8642719982
9155,3391474263,5802,3391480065,2,0,1,6144,2,3463982900
9156,3391503592,11359,3391514951,15,0,1,4608,15,8556385069
9157,3391527686,3422,3391531108,2,0,1,3584,2,9186169190
9158,3391540755,154539,3391695294,18,0,0,58368,18,2647731898
9159,3391565166,25542,3391590708,19,0,1,7168,19,10033037993
9160,3391589504,123307,3391712811,12,0,0,1024,12,6200452296
9161,3391609302,2946,3391612248,3,0,1,3072,3,2467584089
9162,3391610240,3314,3391613554,15,0,1,2048,15,10350460934
9163,3391613077,127515,3391740592,7,0,0,50688,7,9215573857
9164,3391625344,44920,3391670264,0,0,1,77312,0,6047068305
9165,3391630598,187880,3391818478,18,0,0,78336,18,3979440975
9166,3391634230,36905,3391671135,13,0,1,12288,13,3808460292
9167,3391635458,158648,3391794106,6,0,0,23552,6,10169238279
9168,3391638256,110841,3391749097,0,0,1,160768,0,10174956140
9169,3391656676,93804,3391750480,3,0,1,14848,3,6055564735
9170,3391698795,55551,3391754346,3,0,1,6144,3,2803422085
9171,3391714720,282544,3391997264,18,0,0,68608,18,9657832695
9172,3391728530,268905,3391997435,12,0,0,512,12,2553912068
9173,3391729277,177591,3391906868,12,0,0,1024,12,3812659308
9174,3391747511,308919,3392056430,5,0,0,34816,5,8022725948
9175,3391755340,208754,3391964094,12,0,0,1024,12,1966563846
9176,3391792260,26233,3391818493,15,0,1,4096,15,2984106510
9177,3391841033,7706,3391848739,14,0,1,8192,14,9571276906
9178,3391870182,175606,3392045788,18,0,0,2560,18,1855264547
9179,3391873565,1994,3391875559,18,0,1,2048,18,418267272
9180,3391887613,2946,3391890559,7,0,1,3072,7,1233597316
9181,3391904510,13858,3391918368,15,0,1,23552,15,6064141115
9182,3391953928,155779,3392109707,6,0,1,256512,6,1202771441
9183,3391956006,281651,3392237657,1,0,0,13312,1,3372994236
9184,3391973880,109990,3392083870,3,0,0,512,3,1971224159
9185,3392004955,105738,3392110693,4,0,1,1536,4,6991484892
9186,3392024278,205682,3392229960,16,0,0,146432,16,3918056443
9187,3392086828,225890,3392312718,11,0,0,99328,11,8754381397
9188,3392116843,198854,3392315697,14,0,0,9728,14,8179908154
9189,3392117504,283716,3392401220,3,0,0,2048,3,1995589839
9190,3392124559,109027,3392233586,18,0,0,11776,18,4908061519
9191,3392130430,114164,3392244594,18,0,0,16896,18,3650688521
9192,3392184486,45497,3392229983,18,0,1,12288,18,137203036
9193,3392185019,53639,3392238658,1,0,1,1024,1,7117289565
9194,3392344756,1994,3392346750,13,0,1,2048,13,8285995979
9195,3392398675,45596,3392444271,9,0,0,1024,9,4955307748
9196,3392414320,74516,3392488836,0,0,0,10240,0,1405212543
9197,3392443505,192941,3392636446,11,0,0,27648,11,8914244784
9198,3392469938,3898,3392473836,7,0,1,4096,7,1382562273
9199,3392474513,56899,3392531412,17,0,0,1536,17,4485325405
9200,3392516245,226060,3392742305,18,0,0,42496,18,6893124538
9201,3392516603,201234,3392717837,10,0,0,1024,10,5594334987
9202,3392525906,286329,3392812235,16,0,0,44032,16,4083706275
9203,3392559525,95936,3392655461,9,0,0,2048,9,6518625458
9204,3392602919,6754,3392609673,5,0,1,7168,5,4743524541
9205,3392619359,72380,3392691739,6,0,0,13312,6,2487051886
9206,3392633935,86974,3392720909,9,0,0,1024,9,8468249108
9207,3392655630,3422,3392659052,4,0,1,3584,4,3202005610
9208,3392671161,3387,3392674548,5,0,1,9728,5,2566720192
9209,3392676235,149506,3392825741,15,0,0,1536,15,8287401772
9210,3392699006,56366,3392755372,18,0,0,12288,18,2706588316
9211,3392748101,14029,3392762130,15,0,1,27136,15,8961725344
9212,3392755126,8950,3392764076,17,0,1,3072,17,5670110119
9213,3392815697,43904,3392859601,4,0,0,512,4,3461221794
9214,3392848390,2470,3392850860,5,0,1,2560,5,9160128072
9215,3392851758,237229,3393088987,18,0,0,132608,18,1550136688
9216,3392861604,92533,3392954137,3,0,0,1024,3,6048387597
9217,3392862650,12566,3392875216,6,0,1,20992,6,7287012758
9218,3392872431,90691,3392963122,15,0,0,2048,15,4160643548
9219,3392886599,262934,3393149533,11,0,0,98304,11,3477080780
9220,3392912791,6488,3392919279,9,0,1,15872,9,4946652833
9221,3392949451,140331,3393089782,12,0,0,2560,12,7255492464
9222,3392951136,4374,3392955510,7,0,1,4608,7,6035238424
9223,3393010829,248894,3393259723,19,0,0,70656,19,7343160595
9224,3393025863,289611,3393315474,16,0,0,135680,16,293864610
9225,3393031233,199451,3393230684,18,0,0,65024,18,7290323612
9226,3393113212,4937,3393118149,2,0,1,12800,2,6788788178
9227,3393141968,119954,3393261922,11,0,0,7168,11,1595681724
9228,3393151948,4850,3393156798,10,0,1,5120,10,7906423353
9229,3393158248,206876,3393365124,5,0,0,70656,5,6818199860
9230,3393159707,156296,3393316003,17,0,0,512,17,6048109263
9231,3393173644,5326,3393178970,14,0,1,5632,14,5408267186
9232,3393208600,1518,3393210118,3,0,1,1536,3,1281262731
9233,3393213309,102336,3393315645,9,0,0,512,9,266986475
9234,3393214690,213959,3393428649,0,0,0,11264,0,10629204399
9235,3393223452,92364,3393315816,12,0,0,512,12,6460780782
9236,3393235146,190056,3393425202,11,0,0,34816,11,7189285646
9237,3393246435,135135,3393381570,15,0,0,32768,15,9900609976
9238,3393282078,37782,3393319860,16,0,1,4096,16,4005293040
9239,3393284694,36420,3393321114,7,0,1,10752,7,4496983480
9240,3393377832,50832,3393428664,16,0,1,65536,16,2075980631
9241,3393389993,38686,3393428679,8,0,1,20480,8,8807549716
9242,3393409931,22437,3393432368,15,0,1,6656,15,6474588751
9243,3393465155,47288,3393512443,4,0,0,1536,4,490148302
9244,3393507848,566,3393508414,1,0,1,512,1,7271606174
9245,3393529947,3645,3393533592,10,0,1,10240,10,6649817948
9246,3393564008,1994,3393566002,2,0,1,2048,2,2193472128
9247,3393597288,131424,3393728712,14,0,0,48128,14,1326316538
9248,3393639683,34537,3393674220,6,0,1,60416,6,6146341932
9249,3393652376,24750,3393677126,14,0,1,4608,14,137394842
9250,3393706089,379079,3394085168,7,0,0,34816,7,2018735704
9251,3393762873,12308,3393775181,0,0,1,20480,0,6303284067
9252,3393781730,138756,3393920486,8,0,0,15360,8,7568808275
9253,3393785323,203970,3393989293,7,0,0,80384,7,136515863
9254,3393793565,122218,3393915783,16,0,0,82944,16,3508381669
9255,3393806390,196178,3394002568,6,0,0,43520,6,5213604525
9256,3393813207,334499,3394147706,5,0,0,32256,5,7509630049
9257,3393825116,44492,3393869608,0,0,1,73216,0,6692251688
9258,3393841559,376677,3394218236,19,0,0,30720,19,2230089297
9259,3393899833,402997,3394302830,15,0,0,80384,15,3487082978
9260,3393935644,566,3393936210,15,0,1,512,15,4297509366
9261,3393990937,25152,3394016089,15,0,1,26112,15,1217667817
9262,3394000530,124798,3394125328,17,0,0,512,17,4777726799
9263,3394040666,3898,3394044564,14,0,1,4096,14,844570555
9264,3394075714,153587,3394229301,17,0,0,512,17,8351273700
9265,3394127406,5802,3394133208,1,0,1,6144,1,3929913553
9266,3394129417,67270,3394196687,17,0,0,512,17,8828525379
9267,3394184794,186521,3394371315,6,0,0,11776,6,839658983
9268,3394237493,352402,3394589895,0,0,0,275456,0,8143526621
9269,3394355005,23120,3394378125,8,0,1,41472,8,3615859388
9270,3394372134,133746,3394505880,6,0,0,4096,6,9596007571
9271,3394400379,566,3394400945,5,0,1,512,5,2193070990
9272,3394411134,10241,3394421375,2,0,1,16384,2,8583297740
9273,3394506903,194661,3394701564,0,0,0,66048,0,5687568678
9274,3394549623,40855,3394590478,7,0,1,512,7,6684308535
9275,3394604692,226109,3394830801,0,0,0,64000,0,586284733
9276,3394619278,113831,3394733109,0,0,0,12800,0,7735639838
9277,3394657729,3422,3394661151,4,0,1,3584,4,6248999600
9278,3394664365,3898,3394668263,19,0,1,4096,19,8985839614
9279,3394673563,1994,3394675557,14,0,1,2048,14,5624681897
9280,3394715588,5712,3394721300,19,0,1,14336,19,3874168715
9281,3394726396,1518,3394727914,3,0,1,1536,3,8648718020
9282,3394726948,6176,3394733124,1,0,1,2048,1,10050387798
9283,3394729376,119789,3394849165,4,0,0,17920,4,2653084412
9284,3394753948,76876,3394830824,6,0,1,121344,6,6095170766
9285,3394759896,89284,3394849180,0,0,1,73728,0,10212062650
9286,3394763842,89546,3394853388,10,0,1,7168,10,3722808881
9287,3394765329,92245,3394857574,17,0,1,6656,17,3139143700
9288,3394826953,30877,3394857830,1,0,1,9216,1,92315866
9289,3394854519,3977,3394858496,9,0,1,1024,9,8910532054
9290,3394863944,5454,3394869398,6,0,1,13824,6,4900347496
9291,3394898750,122972,3395021722,1,0,0,19456,1,7702631203
9292,3394903053,43904,3394946957,10,0,0,512,10,8855626525
9293,3394910261,3387,3394913648,0,0,1,9728,0,2738140565
9294,3394912292,2500,3394914792,17,0,1,1536,17,3918874588
9295,3394946729,13858,3394960587,14,0,1,23552,14,6379133109
9296,3394972367,82584,3395054951,14,0,0,4608,14,2753995414
9297,3394976241,4374,3394980615,0,0,1,4608,0,5057372767
9298,3395052624,48980,3395101604,3,0,0,2048,3,10226645877
9299,3395057716,308124,3395365840,0,0,0,83456,0,10040743626
9300,3395159020,13858,3395172878,2,0,1,23552,2,8423812118
9301,3395188406,151991,3395340397,11,0,0,119296,11,3965219861
9302,3395207582,65903,3395273485,17,0,0,512,17,8717264915
9303,3395218317,148638,3395366955,1,0,0,3584,1,10362083253
9304,3395315470,99342,3395414812,12,0,0,2048,12,5188933583
9305,3395337835,73016,3395410851,17,0,0,512,17,1864065321
9306,3395354779,249808,3395604587,16,0,0,144384,16,8972464256
9307,3395356618,10962,3395367580,5,0,1,512,5,5664137471
9308,3395358287,9639,3395367926,3,0,1,512,3,6068577358
9309,3395387849,147232,3395535081,13,0,0,18944,13,9428028057
9310,3395430302,3422,3395433724,5,0,1,3584,5,5661455223
9311,3395433098,15062,3395448160,15,0,1,29184,15,9915801803
9312,3395434190,120140,3395554330,16,0,1,181760,16,6760931445
9313,3395441125,113551,3395554676,4,0,1,512,4,3047289698
9314,3395448894,294821,3395743715,18,0,0,89088,18,8061048638
9315,3395483955,215122,3395699077,12,0,0,512,12,7364127677
9316,3395496458,59844,3395556302,2,0,1,2560,2,3086087180
9317,3395505652,99270,3395604922,17,0,0,1024,17,1396251223
9318,3395524850,120608,3395645458,3,0,0,1536,3,4456861931
9319,3395571974,191280,3395763254,18,0,0,10752,18,2548503132
9320,3395588536,20276,3395608812,10,0,1,4096,10,2622807390
9321,3395606597,316295,3395922892,6,0,0,43008,6,8740889270
9322,3395677103,74956,3395752059,10,0,0,512,10,9107097932
9323,3395680240,2946,3395683186,9,0,1,3072,9,3885054840
9324,3395702540,103220,3395805760,8,0,0,38912,8,2402513369
9325,3395722711,129333,3395852044,13,0,0,2048,13,2735920339
9326,3395723439,67581,3395791020,17,0,0,1536,17,3582677906
9327,3395753806,94664,3395848470,11,0,0,15872,11,4883297823
9328,3395789906,78958,3395868864,17,0,0,1024,17,7835495328
9329,3395790569,144982,3395935551,15,0,0,41472,15,6248937716
9330,3395833438,134570,3395968008,7,0,0,19968,7,9127971933
9331,3395843645,163567,3396007212,4,0,0,5120,4,6054381807
9332,3395858272,147186,3396005458,16,0,0,86016,16,2496503416
9333,3395910476,95153,3396005629,9,0,0,512,9,2634502252
9334,3395955022,65170,3396020192,16,0,1,110080,16,9913390417
9335,3395995149,245530,3396240679,18,0,0,36864,18,1265575393
9336,3396013319,7859,3396021178,9,0,1,1536,9,4795116869
9337,3396017929,296034,3396313963,18,0,0,58368,18,4958343182
9338,3396039431,43904,3396083335,19,0,0,512,19,2713967758
9339,3396087744,81046,3396168790,12,0,0,512,12,4492900138
9340,3396107609,177560,3396285169,0,0,0,50688,0,1099578408
9341,3396186822,3898,3396190720,13,0,1,4096,13,2461723686
9342,3396252132,147049,3396399181,18,0,0,110080,18,5641329312
9343,3396275864,184067,3396459931,0,0,0,86528,0,1671288182
9344,3396297426,21446,3396318872,19,0,1,5120,19,5112442867
9345,3396298223,190653,3396488876,15,0,0,1024,15,7983201501
9346,3396311390,114832,3396426222,17,0,0,512,17,5268936814
9347,3396313322,8136,3396321458,17,0,1,4096,17,3024929414
9348,3396321740,229824,3396551564,1,0,0,70656,1,9455960952
9349,3396322348,233451,3396555799,8,0,0,13824,8,7093092746
9350,3396333635,130063,3396463698,0,0,0,12288,0,6417466023
9351,3396334949,13770,3396348719,17,0,1,26624,17,7494593789
9352,3396346165,2900,3396349065,3,0,1,512,3,4139631801
9353,3396351150,59762,3396410912,19,0,0,5120,19,4592133191
9354,3396373588,31880,3396405468,1,0,1,6656,1,1085926870
9355,3396385000,125566,3396510566,10,0,0,512,10,7133675242
9356,3396411159,3898,3396415057,9,0,1,4096,9,10015469127
9357,3396446039,20771,3396466810,13,0,1,9216,13,5117705850
9358,3396450122,105692,3396555814,5,0,1,114176,5,8510946529
9359,3396467108,248213,3396715321,7,0,0,14336,7,6827955447
9360,3396489961,205998,3396695959,11,0,0,52736,11,9654515232
9361,3396501336,54501,3396555837,9,0,1,6144,9,872207486
9362,3396505100,50752,3396555852,13,0,1,6656,13,2396028104
9363,3396533131,24702,3396557833,6,0,1,2048,6,204077148
9364,3396534596,191196,3396725792,3,0,0,1024,3,3945877443
9365,3396546434,270634,3396817068,8,0,0,55296,8,1538149706
9366,3396562744,3387,3396566131,1,0,1,9728,1,1093700797
9367,3396565420,282687,3396848107,4,0,0,55808,4,2071029948
9368,3396593357,5326,3396598683,6,0,1,5632,6,8541179625
9369,3396598784,100622,3396699406,0,0,0,11264,0,1823903858
9370,3396632830,4374,3396637204,10,0,1,4608,10,4495276672
9371,3396636830,2470,3396639300,18,0,1,2560,18,5193349406
9372,3396637070,246054,3396883124,13,0,0,61440,13,8713389224
9373,3396652596,117740,3396770336,3,0,0,1024,3,9474460063
9374,3396712286,306937,3397019223,14,0,0,132096,14,5056591129
9375,3396766781,297256,3397064037,13,0,0,11776,13,2026036625
9376,3396795031,183914,3396978945,4,0,0,38400,4,2642387725
9377,3396800310,142016,3396942326,3,0,0,2560,3,2468244163
9378,3396853434,166116,3397019550,3,0,0,1024,3,9430834579
9379,3396879229,7274,3396886503,19,0,1,9728,19,892913252
9380,3396884700,2149,3396886849,18,0,1,512,18,2479353238
9381,3396905034,153357,3397058391,4,0,0,71168,4,8389759170
9382,3396921940,32558,3396954498,0,0,1,53248,0,10597997365
9383,3396961170,144055,3397105225,13,0,0,16896,13,6629598705
9384,3396961244,99190,3397060434,6,0,0,6656,6,5559737756
9385,3396964637,14323,3396978960,3,0,1,10752,3,3625136239
9386,3397059376,50249,3397109625,3,0,0,1024,3,6931711430
9387,3397084384,169330,3397253714,14,0,0,112640,14,3963912633
9388,3397084528,21141,3397105669,5,0,1,34304,5,7893839223
9389,3397100267,162845,3397263112,19,0,0,30720,19,7361298918
9390,3397115894,83347,3397199241,10,0,0,512,10,6894029135
9391,3397131045,132238,3397263283,9,0,0,512,9,6366808366
9392,3397148831,3387,3397152218,16,0,1,9728,16,2534884708
9393,3397167761,95693,3397263454,10,0,0,512,10,1493975052
9394,3397203392,2470,3397205862,12,0,1,2560,12,10575411442
9395,3397217832,35897,3397253729,7,0,1,7168,7,4579611793
9396,3397225928,98925,3397324853,14,0,0,9216,14,6087508956
9397,3397293458,566,3397294024,13,0,1,512,13,1050263084
9398,3397329298,43904,3397373202,9,0,0,512,9,3001288170
9399,3397362787,3422,3397366209,4,0,1,3584,4,6892136122
9400,3397422513,1042,3397423555,19,0,1,1024,19,7624629692
9401,3397462687,3645,3397466332,10,0,1,10240,10,6566595837
9402,3397494413,241115,3397735528,7,0,0,155136,7,5444117268
9403,3397494817,3904,3397498721,3,0,1,10752,3,4992986751
9404,3397542923,1042,3397543965,15,0,1,1024,15,5391733680
9405,3397583698,15579,3397599277,0,0,1,30208,0,6794656099
9406,3397584366,62685,3397647051,6,0,1,88576,6,5610858950
9407,3397609247,38790,3397648037,3,0,1,1536,3,1898022598
9408,3397625540,26683,3397652223,9,0,1,6656,9,5545486257
9409,3397682803,341000,3398023803,18,0,0,17408,18,9270081951
9410,3397716703,21329,3397738032,9,0,1,2560,9,10399600058
9411,3397725420,205073,3397930493,8,0,0,17920,8,60735124
9412,3397734147,82050,3397816197,1,0,0,3584,1,3910216656
9413,3397738361,5326,3397743687,7,0,1,5632,7,5302567990
9414,3397739219,185799,3397925018,16,0,0,88576,16,9759493834
9415,3397741790,213054,3397954844,7,0,0,79872,7,3545438364
9416,3397745631,5326,3397750957,10,0,1,5632,10,5051022806
9417,3397839912,1042,3397840954,7,0,1,1024,7,4904043878
9418,3397881702,220143,3398101845,1,0,0,45568,1,6651536540
9419,3397933105,26218,3397959323,16,0,1,11776,16,1217891133
9420,3397942176,114189,3398056365,13,0,0,33280,13,3596364270
9421,3397942672,22097,3397964769,17,0,1,6656,17,5191982024
9422,3397950878,15837,3397966715,15,0,1,3072,15,10297864339
9423,3397956878,11463,3397968341,11,0,1,2560,11,8681544172
9424,3397966631,6278,3397972909,8,0,1,6656,8,4755369442
9425,3397969084,64433,3398033517,17,0,0,1536,17,5733654465
9426,3398003947,566,3398004513,7,0,1,512,7,9789747407
9427,3398025783,246081,3398271864,14,0,0,68096,14,10113656477
9428,3398029559,100568,3398130127,0,0,0,30208,0,2446546455
9429,3398038628,3422,3398042050,8,0,1,3584,8,2663824551
9430,3398048561,53299,3398101860,5,0,1,68096,5,5018825804
9431,3398062721,138118,3398200839,7,0,0,21504,7,5744818853
9432,3398072781,47768,3398120549,16,0,1,74240,16,9146098231
9433,3398111350,18792,3398130142,13,0,1,3584,13,7505902323
9434,3398120467,9698,3398130165,7,0,1,11776,7,317433032
9435,3398122027,371093,3398493120,8,0,0,166912,8,6578703524
9436,3398148152,280064,3398428216,19,0,0,38400,19,5376738977
9437,3398231535,1994,3398233529,9,0,1,2048,9,385976374
9438,3398239587,133137,3398372724,0,0,0,8704,0,9526819645
9439,3398301405,228421,3398529826,10,0,0,512,10,100069946
9440,3398325504,3422,3398328926,8,0,1,3584,8,1083352312
9441,3398377889,232884,3398610773,19,0,0,112640,19,3115830643
9442,3398415801,97842,3398513643,13,0,0,5632,13,9452519320
9443,3398430397,91971,3398522368,8,0,0,22528,8,8313655113
9444,3398473297,310420,3398783717,1,0,0,234496,1,4255912745
9445,3398482267,388526,3398870793,8,0,0,97792,8,8750716450
9446,3398536741,20624,3398557365,0,0,1,33280,0,10419969387
9447,3398575538,566,3398576104,7,0,1,512,7,2177734817
9448,3398581523,61800,3398643323,6,0,1,53248,6,3422739971
9449,3398617794,223188,3398840982,7,0,0,52224,7,1222055822
9450,3398664994,211430,3398876424,14,0,0,18432,14,4525488232
9451,3398689292,7230,3398696522,10,0,1,7680,10,1755487805
9452,3398708681,75051,3398783732,19,0,1,7168,19,2495534659
9453,3398716865,268747,3398985612,6,0,0,13824,6,3807539042
9454,3398743008,41324,3398784332,2,0,1,512,2,7361221392
9455,3398747851,169256,3398917107,3,0,0,1536,3,8704316384
9456,3398788995,2470,3398791465,1,0,1,2560,1,16322668
9457,3398791492,189893,3398981385,14,0,0,32768,14,908399464
9458,3398820667,150719,3398971386,16,0,0,80384,16,3789760145
9459,3398823691,224489,3399048180,1,0,0,38912,1,4477541688
9460,3398904202,4850,3398909052,8,0,1,5120,8,9236915968
9461,3398909975,1994,3398911969,4,0,1,2048,4,4797832880
9462,3398940862,44921,3398985783,9,0,0,512,9,8283916610
9463,3398997488,71146,3399068634,10,0,0,4096,10,1670867039
9464,3399047474,100642,3399148116,5,0,0,28160,5,4832381333
9465,3399047869,73776,3399121645,15,0,0,11776,15,6446648088
9466,3399081362,80176,3399161538,9,0,0,512,9,1196587964
9467,3399112571,1518,3399114089,8,0,1,1536,8,5893441583
9468,3399133144,5326,3399138470,7,0,1,5632,7,6123485991
9469,3399139160,35312,3399174472,6,0,1,61952,6,2890321716
9470,3399148988,76566,3399225554,17,0,0,1024,17,4305071781
9471,3399170948,6229,3399177177,7,0,1,15360,7,8855516724
9472,3399240384,104000,3399344384,6,0,0,41472,6,4875171376
9473,3399257918,1518,3399259436,12,0,1,1536,12,4813814365
9474,3399280190,1042,3399281232,2,0,1,1024,2,7823797802
9475,3399288349,86142,3399374491,6,0,0,19968,6,8230414248
9476,3399389074,48980,3399438054,12,0,0,2048,12,10718610687
9477,3399392100,1518,3399393618,7,0,1,1536,7,9382103792
9478,3399396373,105473,3399501846,15,0,0,36864,15,3745807405
9479,3399403030,1042,3399404072,10,0,1,1024,10,4467861215
9480,3399428232,3422,3399431654,13,0,1,3584,13,5328798259
9481,3399435822,566,3399436388,9,0,1,512,9,3230847766
9482,3399468186,3422,3399471608,15,0,1,3584,15,3894300293
9483,3399568412,2470,3399570882,17,0,1,2560,17,5256432116
9484,3399588511,105248,3399693759,1,0,0,45568,1,9572725903
9485,3399601710,98517,3399700227,13,0,0,16384,13,696084194
9486,3399627813,4162,3399631975,18,0,1,11264,18,8237669153
9487,3399643634,103087,3399746721,5,0,0,31744,5,9419010286
9488,3399668620,141559,3399810179,15,0,0,52224,15,10220582928
9489,3399673434,5971,3399679405,1,0,1,14848,1,7954598989
9490,3399751957,3387,3399755344,15,0,1,9728,15,10172756612
9491,3399755100,204918,3399960018,1,0,0,3072,1,1772383644
9492,3399770286,4374,3399774660,7,0,1,4608,7,6317371128
9493,3399782409,32041,3399814450,16,0,1,52224,16,5226950102
9494,3399829229,4162,3399833391,13,0,1,11264,13,680649826
9495,3399839728,111956,3399951684,1,0,0,67584,1,5234263631
9496,3399852457,7706,3399860163,16,0,1,8192,16,2145447440
9497,3399864924,1994,3399866918,14,0,1,2048,14,6867871343
9498,3399876309,1042,3399877351,19,0,1,1024,19,5564766605
9499,3399932300,147105,3400079405,0,0,1,211968,0,4120002059
9500,3399982415,97451,3400079866,13,0,1,10240,13,8906965639
9501,3399993052,97336,3400090388,16,0,1,33792,16,8081384130
9502,3400014992,104325,3400119317,3,0,0,512,3,8065762068
9503,3400075126,17528,3400092654,1,0,1,3584,1,4771625186
9504,3400081748,12212,3400093960,15,0,1,2048,15,3205481997
9505,3400126218,63130,3400189348,8,0,0,2560,8,1679018633
9506,3400136950,2470,3400139420,17,0,1,2560,17,7110158956
9507,3400151937,4937,3400156874,2,0,1,12800,2,4910910600
9508,3400160047,2946,3400162993,19,0,1,3072,19,1766678324
9509,3400199023,7230,3400206253,17,0,1,7680,17,3945211819
9510,3400204772,2147,3400206919,13,0,1,1024,13,9226001939
9511,3400209870,5326,3400215196,17,0,1,5632,17,7598800998
9512,3400260246,4679,3400264925,19,0,1,12288,19,470541664
9513,3400262637,94086,3400356723,4,0,0,19456,4,1245686819
9514,3400297817,4162,3400301979,9,0,1,11264,9,5895892412
9515,3400300935,5559,3400306494,14,0,1,13312,14,6004897056
9516,3400313950,10241,3400324191,0,0,1,16384,0,9437189023
9517,3400326727,5326,3400332053,9,0,1,5632,9,10522070076
9518,3400333726,146183,3400479909,15,0,0,7680,15,7059674613
9519,3400336931,109187,3400446118,6,0,0,18432,6,7679961237
9520,3400346707,74314,3400421021,12,0,0,1536,12,253707052
9521,3400356931,4850,3400361781,10,0,1,5120,10,10388418286
9522,3400361162,5326,3400366488,3,0,1,5632,3,8175394043
9523,3400384779,268700,3400653479,4,0,0,90624,4,1593365802
9524,3400394160,1518,3400395678,17,0,1,1536,17,7766303465
9525,3400409699,3387,3400413086,19,0,1,9728,19,8557856615
9526,3400412082,153059,3400565141,15,0,0,28672,15,175939216
9527,3400488904,1994,3400490898,13,0,1,2048,13,10455548986
9528,3400500410,153396,3400653806,8,0,0,1024,8,1575455710
9529,3400510902,5326,3400516228,1,0,1,5632,1,5175620823
9530,3400532641,6754,3400539395,1,0,1,7168,1,3239135605
9531,3400560100,6117,3400566217,2,0,1,1024,2,3301501655
9532,3400563241,4716,3400567957,1,0,1,2560,1,10274978814
9533,3400564369,59679,3400624048,0,0,0,2560,0,1583255754
9534,3400600133,1994,3400602127,14,0,1,2048,14,7609938409
9535,3400608877,45100,3400653977,3,0,0,512,3,2775292558
9536,3400659218,43904,3400703122,1,0,0,512,1,9976446618
9537,3400659671,47288,3400706959,9,0,0,1536,9,1567721252
9538,3400695926,2470,3400698396,8,0,1,2560,8,7221047053
9539,3400722181,4374,3400726555,13,0,1,4608,13,3921348440
9540,3400725553,115544,3400841097,14,0,0,79360,14,8909048068
9541,3400736942,205240,3400942182,4,0,0,43008,4,2919633693
9542,3400754178,3898,3400758076,1,0,1,4096,1,601482273
9543,3400844830,160769,3401005599,12,0,0,1024,12,9616053819
9544,3400854926,2946,3400857872,9,0,1,3072,9,2903770251
9545,3400855331,122815,3400978146,1,0,0,14848,1,8984563775
9546,3400863736,141536,3401005272,11,0,0,27136,11,7765180507
9547,3400888707,59983,3400948690,9,0,0,1024,9,4471722221
9548,3400889270,100880,3400990150,1,0,0,31232,1,6292882345
9549,3400946447,82555,3401029002,9,0,0,3072,9,10725545537
9550,3400965955,6754,3400972709,14,0,1,7168,14,6353846708
9551,3401046851,4162,3401051013,2,0,1,11264,2,624804777
9552,3401062528,192159,3401254687,3,0,0,2048,3,1580578347
9553,3401063361,66212,3401129573,11,0,0,8192,11,1813481022
9554,3401083017,160712,3401243729,13,0,0,146944,13,601969681
9555,3401090300,163748,3401254048,11,0,0,33792,11,2713351887
9556,3401114909,3422,3401118331,11,0,1,3584,11,6982189895
9557,3401166808,3898,3401170706,9,0,1,4096,9,4957701340
9558,3401224455,32711,3401257166,18,0,1,2560,18,9256138714
9559,3401234162,31813,3401265975,12,0,1,16896,12,10434180364
9560,3401240989,25652,3401266641,14,0,1,1024,14,3851526299
9561,3401256642,27980,3401284622,6,0,1,42496,6,7646639239
9562,3401285110,110418,3401395528,1,0,0,37376,1,5438190826
9563,3401331717,194327,3401526044,13,0,0,54784,13,6682881074
9564,3401361202,10241,3401371443,4,0,1,16384,4,9854248430
9565,3401403943,301851,3401705794,13,0,0,38400,13,3055226546
9566,3401492981,33086,3401526067,16,0,1,36352,16,8845159067
9567,3401513226,138892,3401652118,19,0,0,23552,19,3939911860
9568,3401568191,3387,3401571578,10,0,1,9728,10,8237721396
9569,3401588822,3128,3401591950,11,0,1,9216,11,3728561764
9570,3401600421,200701,3401801122,7,0,0,11264,7,10284014509
9571,3401639776,3422,3401643198,7,0,1,3584,7,216813574
9572,3401651487,141344,3401792831,4,0,0,86528,4,1183313277
9573,3401710717,138105,3401848822,14,0,0,46080,14,5823582935
9574,3401716513,3898,3401720411,15,0,1,4096,15,1989038434
9575,3401719095,1662,3401720757,8,0,1,512,8,6484016570
9576,3401730918,4937,3401735855,4,0,1,12800,4,6913466897
9577,3401745326,257219,3402002545,1,0,0,82432,1,4840642592
9578,3401773608,240199,3402013807,8,0,0,35840,8,5330652411
9579,3401782910,13108,3401796018,7,0,1,9216,7,1523982707
9580,3401783578,144462,3401928040,15,0,0,62976,15,9151107219
9581,3401792085,148792,3401940877,15,0,0,1024,15,1373186549
9582,3401794150,135177,3401929327,3,0,0,4096,3,7435765532
9583,3401861776,141096,3402002872,1,0,0,1024,1,6937479704
9584,3401911952,25065,3401937017,5,0,1,8192,5,6334589084
9585,3401914066,29532,3401943598,19,0,1,19456,19,4894192929
9586,3401914822,29762,3401944584,11,0,1,1536,11,4133793272
9587,3401922247,23963,3401946210,9,0,1,2560,9,6296060714
9588,3401947199,102839,3402050038,16,0,0,8192,16,4944175724
9589,3402002773,14413,3402017186,19,0,1,9728,19,10247692570
9590,3402085212,73316,3402158528,18,0,0,16384,18,8751725419
9591,3402208542,104895,3402313437,5,0,1,174080,5,7139340681
9592,3402214744,202699,3402417443,13,0,0,49152,13,5984726475
9593,3402248300,70731,3402319031,14,0,1,18432,14,4099606687
9594,3402278036,190111,3402468147,17,0,0,512,17,3751315734
9595,3402292864,36689,3402329553,5,0,1,33792,5,7991010163
9596,3402293479,56965,3402350444,0,0,1,67072,0,9264637121
9597,3402312666,202684,3402515350,5,0,0,9728,5,10397891692
9598,3402319280,35350,3402354630,7,0,1,6656,7,9812804313
9599,3402331871,289610,3402621481,16,0,0,23552,16,7142581518
9600,3402334016,21792,3402355808,5,0,1,13824,5,5535145187
9601,3402334185,22494,3402356679,12,0,1,12288,12,299051143
9602,3402342384,19684,3402362068,10,0,1,17408,10,9392162853
9603,3402342484,125492,3402467976,14,0,0,37376,14,5294749745
9604,3402428485,161400,3402589885,0,0,0,66048,0,7040471218
9605,3402440741,14804,3402455545,9,0,1,28672,9,892043384
9606,3402512459,281680,3402794139,15,0,0,22528,15,1123826073
9607,3402535071,67913,3402602984,12,0,0,512,12,892289701
9608,3402589237,206789,3402796026,8,0,0,6144,8,5474365501
9609,3402608902,167237,3402776139,18,0,0,75264,18,4587824491
9610,3402622474,7230,3402629704,14,0,1,7680,14,7280756390
9611,3402628147,3904,3402632051,9,0,1,10752,9,5189230698
9612,3402733698,63376,3402797074,10,0,0,512,10,402070266
9613,3402820151,45596,3402865747,10,0,0,1024,10,4232825240
9614,3402822562,43904,3402866466,9,0,0,512,9,97191793
9615,3402846134,3422,3402849556,3,0,1,3584,3,10702499198
9616,3402889329,3898,3402893227,11,0,1,4096,11,2738109832
9617,3402912460,146534,3403058994,15,0,0,129536,15,2800231557
9618,3402917512,151964,3403069476,4,0,0,33792,4,4939542259
9619,3402942412,2470,3402944882,8,0,1,2560,8,8722431550
9620,3402944062,115103,3403059165,1,0,0,512,1,5469506002
9621,3402996435,5326,3403001761,3,0,1,5632,3,543299406
9622,3403001844,2946,3403004790,12,0,1,3072,12,2122220371
9623,3403063460,54988,3403118448,13,0,0,2048,13,2825314757
9624,3403122685,3898,3403126583,1,0,1,4096,1,2977123804
9625,3403127807,2470,3403130277,15,0,1,2560,15,5118830695
9626,3403129490,151496,3403280986,15,0,0,6656,15,4598473805
9627,3403131230,3128,3403134358,18,0,1,9216,18,9395112230
9628,3403152687,6754,3403159441,18,0,1,7168,18,8452282151
9629,3403159495,45596,3403205091,12,0,0,1024,12,9433283211
9630,3403189571,151782,3403341353,11,0,0,21504,11,4201665262
9631,3403195301,2870,3403198171,2,0,1,8704,2,9446479993
9632,3403200663,2946,3403203609,14,0,1,3072,14,10023409164
9633,3403222900,146473,3403369373,4,0,0,20992,4,3459499918
9634,3403228196,4374,3403232570,1,0,1,4608,1,9480196832
9635,3403249979,6488,3403256467,12,0,1,15872,12,7192011612
9636,3403269523,127270,3403396793,10,0,0,1024,10,6652334431
9637,3403319162,5326,3403324488,17,0,1,5632,17,9477112862
9638,3403328557,79960,3403408517,17,0,0,1024,17,10086280625
9639,3403358093,46456,3403404549,10,0,0,1024,10,6814019417
9640,3403367609,99048,3403466657,16,0,0,19456,16,4182958300
9641,3403401102,5802,3403406904,4,0,1,6144,4,2003900496
9642,3403476731,82557,3403559288,4,0,0,21504,4,8056391942
9643,3403487808,84631,3403572439,11,0,0,9216,11,4181823479
9644,3403494399,50672,3403545071,0,0,0,2560,0,263932374
9645,3403552705,9964,3403562669,3,0,1,3584,3,207197236
9646,3403556763,8812,3403565575,15,0,1,4608,15,3377151534
9647,3403600046,43904,3403643950,11,0,0,512,11,10235271670
9648,3403629591,3898,3403633489,8,0,1,4096,8,5476633011
9649,3403629627,104309,3403733936,5,0,0,32256,5,4870908581
9650,3403653389,4162,3403657551,17,0,1,11264,17,6631096558
9651,3403659974,42941,3403702915,6,0,1,70144,6,7939428651
9652,3403668104,35157,3403703261,4,0,1,512,4,1640769520
9653,3403760280,72668,3403832948,16,0,0,9216,16,7307957789
9654,3403847972,103950,3403951922,5,0,1,168960,5,660361837
9655,3403909928,42340,3403952268,14,0,1,512,14,3805703703
9656,3403928903,24991,3403953894,13,0,1,2560,13,619035614
9657,3403950817,3743,3403954560,11,0,1,1024,11,9783690070
9658,3404021638,112052,3404133690,5,0,0,13824,5,5211760953
9659,3404028081,70989,3404099070,1,0,0,1024,1,2706926082
9660,3404039650,87608,3404127258,19,0,0,17920,19,4330668053
9661,3404061176,1994,3404063170,3,0,1,2048,3,5943678204
9662,3404080260,144852,3404225112,16,0,0,44032,16,5479359809
9663,3404094107,3128,3404097235,10,0,1,9216,10,10163407693
9664,3404137481,566,3404138047,14,0,1,512,14,4068960813
9665,3404147098,196357,3404343455,19,0,0,6144,19,3336680539
9666,3404210447,101192,3404311639,16,0,0,32256,16,8718531707
9667,3404220885,178803,3404399688,11,0,0,54272,11,7502368638
9668,3404257204,3422,3404260626,19,0,1,3584,19,2076243621
9669,3404279605,103532,3404383137,14,0,0,39936,14,7729021909
9670,3404280092,566,3404280658,1,0,1,512,1,8202300905
9671,3404286094,178173,3404464267,15,0,0,54272,15,8134678394
9672,3404314690,4850,3404319540,5,0,1,5120,5,10199501516
9673,3404370061,228818,3404598879,4,0,0,85504,4,2590757544
9674,3404387419,114961,3404502380,16,0,1,166400,16,3987976862
9675,3404390640,122262,3404512902,16,0,1,33792,16,3665708663
9676,3404393445,245361,3404638806,4,0,0,128000,4,3290665971
9677,3404401147,257195,3404658342,13,0,0,16384,13,2768981971
9678,3404408286,107202,3404515488,17,0,1,4096,17,6620760253
9679,3404419531,96303,3404515834,3,0,1,512,3,5607879449
9680,3404422312,94828,3404517140,7,0,1,2048,7,2161670908
9681,3404457713,60195,3404517908,11,0,1,11776,11,9135644479
9682,3404521229,428447,3404949676,15,0,0,82944,15,4467916917
9683,3404552030,566,3404552596,15,0,1,512,15,1364638840
9684,3404572555,26339,3404598894,17,0,1,512,17,2155919982
9685,3404598016,284252,3404882268,7,0,0,200704,7,4797734288
9686,3404614342,534886,3405149228,0,0,0,111104,0,309367026
9687,3404620550,24568,3404645118,2,0,1,6656,2,5265523928
9688,3404629330,396836,3405026166,16,0,0,122368,16,9735738463
9689,3404659964,566,3404660530,1,0,1,512,1,8017243717
9690,3404691378,273460,3404964838,12,0,0,512,12,6590338506
9691,3404697497,341944,3405039441,19,0,0,43520,19,9911377726
9692,3404741002,446351,3405187353,16,0,0,29696,16,9365248499
9693,3404753349,11533,3404764882,12,0,1,18944,12,3473301003
9694,3404770435,329444,3405099879,16,0,0,74240,16,3584385723
9695,3404772644,6278,3404778922,3,0,1,6656,3,7759627290
9696,3404776454,338728,3405115182,0,0,0,50176,0,7381284275
9697,3404800769,314592,3405115361,17,0,0,512,17,8524486316
9698,3404862006,35075,3404897081,16,0,1,28672,16,6071662788
9699,3404881214,26412,3404907626,5,0,1,32256,5,2293333363
9700,3404915490,262792,3405178282,15,0,0,44032,15,3464784499
9701,3404916289,124103,3405040392,19,0,0,3072,19,8088827939
9702,3404922146,27545,3404949691,3,0,1,2560,3,1571171994
9703,3404945344,372909,3405318253,15,0,0,62464,15,2021642033
9704,3404966332,286965,3405253297,19,0,0,48128,19,10116875142
9705,3404978508,186335,3405164843,8,0,0,51200,8,5889275453
9706,3405023198,327640,3405350838,7,0,0,6144,7,7738271121
9707,3405038983,151372,3405190355,8,0,0,9728,8,5583369293
9708,3405065271,257365,3405322636,19,0,0,14336,19,5417024897
9709,3405088074,99302,3405187376,12,0,1,1024,12,3606764662
9710,3405123664,76891,3405200555,6,0,1,16384,6,9206215439
9711,3405161097,40124,3405201221,14,0,1,1024,14,7924380050
9712,3405208756,218072,3405426828,8,0,0,22528,8,2410081918
9713,3405328916,5196,3405334112,17,0,1,13312,17,9980301266
9714,3405384367,95136,3405479503,3,0,0,1536,3,1702923935
9715,3405385607,12825,3405398432,16,0,1,21504,16,1851510893
9716,3405388564,19481,3405408045,5,0,1,30720,5,5627395519
9717,3405401789,6602,3405408391,7,0,1,512,7,7604077264
9718,3405414801,221688,3405636489,19,0,0,106496,19,9944027914
9719,3405421136,10638,3405431774,9,0,1,12800,9,513890830
9720,3405422101,109836,3405531937,18,0,0,45056,18,2873933586
9721,3405444580,32816,3405477396,5,0,1,53760,5,1947171160
9722,3405454360,27862,3405482222,19,0,1,7680,19,316109103
9723,3405497729,157654,3405655383,7,0,0,1024,7,1155880900
9724,3405502748,304488,3405807236,4,0,0,96768,4,6361438149
9725,3405517590,256660,3405774250,5,0,0,10752,5,10021489904
9726,3405553822,1518,3405555340,17,0,1,1536,17,7965395373
9727,3405570792,260015,3405830807,19,0,0,77312,19,6381001931
9728,3405628477,363130,3405991607,19,0,0,103424,19,2296645699
9729,3405636024,226351,3405862375,13,0,0,14336,13,1723848545
9730,3405667953,6278,3405674231,5,0,1,6656,5,905060664
9731,3405688235,56596,3405744831,16,0,1,96768,16,5844172435
9732,3405693781,248817,3405942598,15,0,0,61952,15,9036892564
9733,3405752880,104500,3405857380,6,0,0,10240,6,7730875346
9734,3405756367,4162,3405760529,14,0,1,11264,14,9660605197
9735,3405810189,23623,3405833812,2,0,1,3072,2,5514656757
9736,3405811930,22868,3405834798,17,0,1,1536,17,6838061719
9737,3405814581,27930,3405842511,12,0,1,16384,12,8950930133
9738,3405815246,29211,3405844457,12,0,1,3072,12,3036969999
9739,3405838258,110694,3405948952,12,0,0,1024,12,526888500
9740,3405838531,233633,3406072164,15,0,0,26624,15,27681942
9741,3405863506,6278,3405869784,8,0,1,6656,8,7016870027
9742,3405878895,113039,3405991934,10,0,0,1024,10,3905054021
9743,3405909117,2470,3405911587,15,0,1,2560,15,2385046223
9744,3406003187,68992,3406072179,16,0,1,112128,16,3213047824
9745,3406053323,18974,3406072297,2,0,1,4608,2,3895567568
9746,3406054917,129490,3406184407,19,0,0,14848,19,1026394232
9747,3406086453,100540,3406186993,19,0,0,2048,19,4196115307
9748,3406088622,3645,3406092267,15,0,1,10240,15,10253569145
9749,3406151690,4850,3406156540,18,0,1,5120,18,5241491687
9750,3406179485,5802,3406185287,8,0,1,6144,8,10102286570
9751,3406210692,158217,3406368909,6,0,0,134656,6,3403967767
9752,3406213233,1042,3406214275,17,0,1,1024,17,3831153709
9753,3406240918,5326,3406246244,13,0,1,5632,13,3146408765
9754,3406256959,172286,3406429245,10,0,0,512,10,1218414311
9755,3406262990,165072,3406428062,19,0,0,64512,19,9701171894
9756,3406315088,93303,3406408391,16,0,0,6144,16,3571405337
9757,3406317276,1518,3406318794,3,0,1,1536,3,8211359139
9758,3406357992,15088,3406373080,8,0,1,11264,8,6972956785
9759,3406359656,14090,3406373746,19,0,1,1024,19,9197704898
9760,3406437270,6278,3406443548,15,0,1,6656,15,9174147150
9761,3406440491,6603,3406447094,14,0,1,5632,14,426736868
9762,3406451737,240983,3406692720,16,0,0,18432,16,9230783708
9763,3406457780,113967,3406571747,13,0,0,68096,13,8427000578
9764,3406474816,11791,3406486607,3,0,1,19456,3,8414823607
9765,3406491634,3898,3406495532,12,0,1,4096,12,10732826532
9766,3406492833,4325,3406497158,14,0,1,2560,14,9478588509
9767,3406522001,566,3406522567,4,0,1,512,4,3754807367
9768,3406543376,269179,3406812555,16,0,0,140288,16,3704383133
9769,3406551363,23339,3406574702,12,0,1,3072,12,10337018241
9770,3406571450,136075,3406707525,18,0,0,23552,18,2101493952
9771,3406574306,95912,3406670218,4,0,0,19968,4,10736855548
9772,3406588044,299271,3406887315,19,0,0,16384,19,8629179600
9773,3406645796,236512,3406882308,15,0,0,78848,15,5424611735
9774,3406651082,1042,3406652124,16,0,1,1024,16,3668581624
9775,3406662580,92529,3406755109,3,0,0,512,3,1212532366
9776,3406678503,566,3406679069,15,0,1,512,15,10207873674
9777,3406712968,174518,3406887486,9,0,0,512,9,8362865192
9778,3406744296,1994,3406746290,14,0,1,2048,14,1931655533
9779,3406780514,109483,3406889997,16,0,0,8192,16,3676784540
9780,3406815917,566,3406816483,3,0,1,512,3,10122839458
9781,3406823857,145506,3406969363,13,0,0,29184,13,2570941897
9782,3406845863,221354,3407067217,4,0,0,122368,4,672980138
9783,3406846829,69898,3406916727,3,0,0,1024,3,3168462025
9784,3406886440,4115,3406890555,10,0,1,512,10,7392335596
9785,3406914008,10499,3406924507,16,0,1,16896,16,10623517490
9786,3406917576,12653,3406930229,14,0,1,17920,14,930744672
9787,3406937113,7230,3406944343,2,0,1,7680,2,7714213635
9788,3406968796,217828,3407186624,0,0,0,54272,0,2774041381
9789,3406974444,5802,3406980246,1,0,1,6144,1,1715852405
9790,3406978214,151577,3407129791,4,0,0,94720,4,3171393431
9791,3406999135,23725,3407022860,16,0,1,39424,16,6784247020
9792,3407092161,4162,3407096323,12,0,1,11264,12,2702755421
9793,3407110394,192952,3407303346,19,0,0,42496,19,5453449006
9794,3407144193,53841,3407198034,16,0,1,88064,16,1801357951
9795,3407163974,98210,3407262184,17,0,0,512,17,7322826090
9796,3407185087,90698,3407275785,17,0,0,512,17,2336726529
9797,3407215661,5802,3407221463,14,0,1,6144,14,10031989046
9798,3407219435,189047,3407408482,13,0,0,6144,13,1211887393
9799,3407244218,3387,3407247605,3,0,1,9728,3,7146170241
9800,3407283638,234404,3407518042,11,0,0,66048,11,9463006206
9801,3407306030,89792,3407395822,5,0,0,25088,5,3417275144
9802,3407412536,1042,3407413578,8,0,1,1024,8,3406841251
9803,3407490694,566,3407491260,2,0,1,512,2,1384821589
9804,3407495717,50672,3407546389,12,0,0,2560,12,6769260309
9805,3407496282,21775,3407518057,4,0,1,21504,4,6023476076
9806,3407510524,10395,3407520919,15,0,1,8704,15,4129860448
9807,3407524010,178170,3407702180,15,0,0,78848,15,5945458085
9808,3407537640,121590,3407659230,14,0,0,60928,14,5993762066
9809,3407559605,1042,3407560647,3,0,1,1024,3,891681065
9810,3407575751,187471,3407763222,18,0,0,41472,18,1577307098
9811,3407648232,102270,3407750502,8,0,0,14848,8,4535444288
9812,3407673548,130387,3407803935,18,0,0,18944,18,5318857679
9813,3407676834,170541,3407847375,15,0,0,45568,15,5813599719
9814,3407696593,108761,3407805354,0,0,0,4608,0,4221324481
9815,3407719062,566,3407719628,7,0,1,512,7,2219155300
9816,3407724939,165858,3407890797,8,0,0,36864,8,9513359235
9817,3407793128,142777,3407935905,16,0,0,58880,16,3172170543
9818,3407812235,6278,3407818513,12,0,1,6656,12,8765665081
9819,3407859069,140564,3407999633,6,0,0,26624,6,5378576394
9820,3407866258,95347,3407961605,15,0,0,7680,15,412632124
9821,3407885529,145713,3408031242,7,0,0,13824,7,8418328038
9822,3407904262,71000,3407975262,8,0,0,13824,8,1907391413
9823,3407960202,5769,3407965971,12,0,1,4608,12,1944017305
9824,3407963549,5328,3407968877,11,0,1,4608,11,3457858480
9825,3407978628,44145,3408022773,16,0,1,75776,16,195757147
9826,3408007268,74520,3408081788,6,0,1,124928,6,1371085106
9827,3408007573,197862,3408205435,17,0,0,512,17,3519398806
9828,3408034307,51667,3408085974,0,0,1,6656,0,1493841809
9829,3408040154,182230,3408222384,19,0,0,27648,19,5050291539
9830,3408073302,23706,3408097008,16,0,1,36352,16,2933646091
9831,3408090148,228638,3408318786,18,0,0,28160,18,6405301193
9832,3408157280,4374,3408161654,18,0,1,4608,18,5217248652
9833,3408158904,6616,3408165520,2,0,1,6144,2,10218733479
9834,3408180971,119888,3408300859,11,0,0,3584,11,2615323316
9835,3408182041,94680,3408276721,1,0,0,2560,1,8543581200
9836,3408226557,60866,3408287423,5,0,1,98304,5,5760216815
9837,3408240776,124320,3408365096,12,0,0,1024,12,2083089524
9838,3408256088,32961,3408289049,4,0,1,2560,4,809404514
9839,3408356370,50999,3408407369,16,0,1,82432,16,1528243195
9840,3408363771,138859,3408502630,1,0,0,1024,1,6951170144
9841,3408390594,206934,3408597528,16,0,1,300032,16,3234623432
9842,3408436489,161054,3408597543,15,0,1,1536,15,4481581505
9843,3408441253,156260,3408597513,16,0,0,73728,16,5659290828
9844,3408463756,133802,3408597558,3,0,1,3584,3,7698000980
9845,3408535235,62338,3408597573,13,0,1,4096,13,9069404383
9846,3408563270,269724,3408832994,16,0,0,14848,16,9667939274
9847,3408617762,302543,3408920305,6,0,0,58368,6,3271353432
9848,3408619466,4850,3408624316,7,0,1,5120,7,4693466364
9849,3408649940,1518,3408651458,19,0,1,1536,19,1066130400
9850,3408658730,310795,3408969525,7,0,0,122880,7,3754288538
9851,3408722294,268409,3408990703,6,0,0,61440,6,7954929509
9852,3408792180,5326,3408797506,11,0,1,5632,11,6431259004
9853,3408836993,41132,3408878125,0,0,1,66560,0,8858874483
9854,3408959176,148730,3409107906,18,0,0,47616,18,8282245042
9855,3408995094,4374,3408999468,17,0,1,4608,17,6671233006
9856,3409007984,43904,3409051888,10,0,0,512,10,7024424833
9857,3409012879,566,3409013445,19,0,1,512,19,3533397561
9858,3409020991,224296,3409245287,3,0,0,512,3,8759426378
9859,3409028079,99788,3409127867,18,0,0,27648,18,9972226831
9860,3409032677,2015,3409034692,9,0,1,2048,9,203848005
9861,3409032689,15437,3409048126,16,0,1,28672,16,10565853286
9862,3409043649,5143,3409048792,7,0,1,11264,7,8770139853
9863,3409064307,140618,3409204925,14,0,0,42496,14,8272108026
9864,3409070339,161013,3409231352,13,0,0,26624,13,767104391
9865,3409118286,228006,3409346292,13,0,0,8192,13,6946350465
9866,3409128944,4374,3409133318,13,0,1,4608,13,5373866895
9867,3409162160,181605,3409343765,14,0,0,95744,14,3244960213
9868,3409242810,146127,3409388937,18,0,0,31232,18,8278356082
9869,3409256219,7230,3409263449,15,0,1,7680,15,9259096489
9870,3409265902,126794,3409392696,4,0,0,12288,4,10080302131
9871,3409314529,118527,3409433056,8,0,0,14848,8,3945118398
9872,3409315189,35436,3409350625,3,0,1,4608,3,4702448518
9873,3409315433,36901,3409352334,18,0,1,12288,18,9042099607
9874,3409407533,3645,3409411178,13,0,1,10240,13,6838854661
9875,3409437618,22691,3409460309,16,0,1,37376,16,2054946268
9876,3409497687,3128,3409500815,11,0,1,9216,11,6535998551
9877,3409509795,133583,3409643378,4,0,0,33792,4,3757054335
9878,3409520820,242771,3409763591,1,0,0,6656,1,8144668868
9879,3409521519,84904,3409606423,0,0,1,141824,0,5165707458
9880,3409522958,390903,3409913861,19,0,0,271872,19,368216657
9881,3409526164,80925,3409607089,3,0,1,11264,3,761093497
9882,3409564294,150850,3409715144,17,0,0,1024,17,3482106489
9883,3409583483,355845,3409939328,7,0,0,83456,7,1833717771
9884,3409625342,316044,3409941386,18,0,0,6656,18,2527925297
9885,3409644483,5802,3409650285,2,0,1,6144,2,10497605707
9886,3409674610,275433,3409950043,5,0,0,14336,5,1363828653
9887,3409697682,1518,3409699200,4,0,1,1536,4,1462582584
9888,3409738453,207207,3409945660,7,0,0,13312,7,7156435448
9889,3409768959,172598,3409941557,3,0,0,512,3,3619557718
9890,3409776402,162941,3409939343,5,0,1,193024,5,6047183568
9891,3409818949,188108,3410007057,10,0,0,1024,10,2236509725
9892,3409827572,122494,3409950066,11,0,1,1024,11,10190808899
9893,3409862586,87495,3409950081,11,0,1,512,11,1242352515
9894,3409918447,191806,3410110253,10,0,0,512,10,3230686661
9895,3409921506,32870,3409954376,3,0,1,4608,3,10219920768
9896,3409987336,192481,3410179817,18,0,0,24576,18,3527643242
9897,3410111771,2470,3410114241,8,0,1,2560,8,8038562321
9898,3410141153,2470,3410143623,4,0,1,2560,4,9652651827
9899,3410147692,7230,3410154922,1,0,1,7680,1,3029849389
9900,3410156950,187962,3410344912,6,0,1,309248,6,10210056339
9901,3410194854,162705,3410357559,5,0,0,12800,5,1285047054
9902,3410247538,97720,3410345258,19,0,1,512,19,5467065168
9903,3410284984,60940,3410345924,16,0,1,11264,16,8977973412
9904,3410300505,96991,3410397496,12,0,0,1536,12,5701532047
9905,3410324672,241579,3410566251,3,0,0,3072,3,5608010173
9906,3410377561,35571,3410413132,5,0,1,62464,5,8168882622
9907,3410417311,2470,3410419781,10,0,1,2560,10,5550456391
9908,3410480816,159084,3410639900,9,0,0,1024,9,3763353370
9909,3410492337,3645,3410495982,15,0,1,10240,15,352496146
9910,3410498745,43904,3410542649,9,0,0,512,9,559219975
9911,3410515149,5326,3410520475,10,0,1,5632,10,4591817722
9912,3410540123,270328,3410810451,5,0,0,64512,5,10494423769
9913,3410555169,84404,3410639573,19,0,0,22528,19,7560447558
9914,3410568022,1042,3410569064,17,0,1,1024,17,7339227166
9915,3410594753,123762,3410718515,18,0,0,13312,18,8234360656
9916,3410647566,3128,3410650694,19,0,1,9216,19,1009239464
9917,3410660453,6754,3410667207,12,0,1,7168,12,104153153
9918,3410799629,114502,3410914131,13,0,0,40448,13,6795280205
9919,3410817368,4850,3410822218,19,0,1,5120,19,851336524
9920,3410847944,2470,3410850414,19,0,1,2560,19,1477374395
9921,3410859013,55445,3410914458,12,0,0,1024,12,5351582912
9922,3410912218,36786,3410949004,16,0,1,60416,16,8685927551
9923,3410913213,35945,3410949158,19,0,1,8704,19,3100163143
9924,3410920634,109362,3411029996,17,0,0,2560,17,4486400863
9925,3410933142,165099,3411098241,14,0,0,33792,14,7202462022
9926,3410964252,1042,3410965294,7,0,1,1024,7,4502514099
9927,3410994769,43628,3411038397,0,0,1,74752,0,1834057174
9928,3411037755,6488,3411044243,11,0,1,15872,11,897896254
9929,3411070923,566,3411071489,12,0,1,512,12,558381241
9930,3411122027,33591,3411155618,0,0,1,55296,0,6617880712
9931,3411133298,54231,3411187529,10,0,0,1024,10,7808508511
9932,3411140521,18003,3411158524,1,0,1,4608,1,1195109014
9933,3411152889,8221,3411161110,7,0,1,4096,7,4076177966
9934,3411184035,238194,3411422229,4,0,0,40448,4,10254891626
9935,3411208316,4850,3411213166,19,0,1,5120,19,216517775
9936,3411249129,566,3411249695,14,0,1,512,14,6493904871
9937,3411273898,46729,3411320627,5,0,1,80896,5,4689597602
9938,3411278772,158883,3411437655,11,0,0,14336,11,2658488513
9939,3411298466,247457,3411545923,18,0,0,41472,18,6603326834
9940,3411362601,2946,3411365547,1,0,1,3072,1,6220090575
9941,3411400212,91616,3411491828,6,0,0,20992,6,9469965344
9942,3411433319,49924,3411483243,3,0,0,1024,3,10097290978
9943,3411451069,1994,3411453063,18,0,1,2048,18,7106718593
9944,3411487960,8710,3411496670,10,0,1,5120,10,9482805109
9945,3411496683,229462,3411726145,15,0,0,140800,15,4204844623
9946,3411540014,204554,3411744568,0,0,0,60416,0,9076889336
9947,3411550938,4679,3411555617,11,0,1,12288,11,7791690255
9948,3411638957,2470,3411641427,2,0,1,2560,2,3052227626
9949,3411651931,92824,3411744755,3,0,0,512,3,228650449
9950,3411686141,61493,3411747634,19,0,1,8704,19,8744343089
9951,3411692008,55974,3411747982,17,0,1,512,17,3781444639
9952,3411725801,62850,3411788651,3,0,0,512,3,7439832501
9953,3411736758,12332,3411749090,7,0,1,1536,7,6382571487
9954,3411826082,4374,3411830456,12,0,1,4608,12,9483724792
9955,3411826933,81652,3411908585,10,0,0,512,10,9396130348
9956,3411839265,45596,3411884861,10,0,0,1024,10,9637355795
9957,3411875014,70347,3411945361,6,0,0,15360,6,2920290960
9958,3411895263,1518,3411896781,4,0,1,1536,4,165445443
9959,3411901392,50672,3411952064,6,0,0,2560,6,5563958086
9960,3411908919,101505,3412010424,15,0,0,17408,15,286598340
9961,3411909298,183680,3412092978,10,0,0,25088,10,3742825410
9962,3411915173,1042,3411916215,12,0,1,1024,12,727115096
9963,3411924793,109409,3412034202,11,0,0,3584,11,9314074612
9964,3411934664,87376,3412022040,10,0,0,5120,10,1857155008
9965,3411979825,171353,3412151178,14,0,0,54784,14,2822402171
9966,3411995529,80736,3412076265,3,0,0,1536,3,607494800
9967,3412010089,187514,3412197603,6,0,1,307712,6,3105648952
9968,3412041481,243871,3412285352,19,0,0,1536,19,5387235299
9969,3412042490,263547,3412306037,0,0,0,1024,0,10320246297
9970,3412050563,153146,3412203709,16,0,1,29184,16,6465042802
9971,3412054350,251360,3412305710,8,0,0,11776,8,6050007260
9972,3412065601,141014,3412206615,3,0,1,4608,3,460603113
9973,3412074227,330256,3412404483,19,0,0,19968,19,1356600582
9974,3412090248,119273,3412209521,4,0,1,4608,4,2126054119
9975,3412127418,249597,3412377015,7,0,0,7680,7,7224245703
9976,3412130665,84757,3412215422,9,0,1,19968,9,9512657027
9977,3412137915,108766,3412246681,5,0,1,108544,5,4056116561
9978,3412238439,15579,3412254018,5,0,1,30208,5,7504768785
9979,3412245042,214056,3412459098,0,0,0,30720,0,3886106838
9980,3412270883,1518,3412272401,14,0,1,1536,14,1435205486
9981,3412279354,3898,3412283252,11,0,1,4096,11,1416106515
9982,3412313116,2470,3412315586,19,0,1,2560,19,2109793461
9983,3412342812,83958,3412426770,5,0,1,136704,5,2873276957
9984,3412343386,104889,3412448275,5,0,1,78336,5,4206070485
9985,3412348442,101139,3412449581,18,0,1,2048,18,7872107097
9986,3412372310,86803,3412459113,19,0,1,512,19,10027484106
9987,3412389648,69480,3412459128,14,0,1,6144,14,1833318026
9988,3412413930,66501,3412480431,0,0,1,86528,0,7318862365
9989,3412505626,566,3412506192,9,0,1,512,9,2624159267
9990,3412535384,177532,3412712916,15,0,0,6656,15,10124120282
9991,3412536146,1994,3412538140,14,0,1,2048,14,3539679211
9992,3412540418,217506,3412757924,4,0,0,57344,4,3933382485
9993,3412545311,3128,3412548439,5,0,1,9216,5,7935978899
9994,3412562239,5712,3412567951,1,0,1,14336,1,8548446036
9995,3412568525,108013,3412676538,13,0,0,19456,13,3926624953
9996,3412604413,1042,3412605455,11,0,1,1024,11,6215432046
9997,3412630508,147450,3412777958,6,0,0,1536,6,2552092643
9998,3412643119,80187,3412723306,16,0,0,1536,16,6047920816
9999,3412659464,53467,3412712931,6,0,1,84992,6,4326318303
