RequestID,ArrivalTime,DelayTime,FinishTime,InitiatorID,TargetID,IOType,Size,VolumeID,Offset
0,0,22691,22691,0,0,1,37376,29,8926903649
1,1,101660,101661,0,3,0,33792,37,4226030008
2,2,114296,114298,0,4,0,75264,12,7253549806
3,3,43904,43907,0,5,0,512,20,5723713301
4,4,12825,12829,0,1,1,21504,18,3571373116
5,5,6754,6759,0,6,1,7168,14,9963649312
6,6,3645,3651,0,7,1,10240,40,7592118696
7,7,36604,36611,0,8,1,64512,21,2038464417
8,8,43904,43912,0,9,0,512,45,1531733535
9,9,16354,16363,0,2,1,31744,14,8971653500
10,31999,5598,37597,0,8,1,1536,21,5732155928
11,41473,3898,45371,0,5,1,4096,20,1658185780
12,62418,2946,65364,0,1,1,3072,18,2709104046
13,130332,4937,135269,0,1,1,12800,18,6633542285
14,145202,102596,247798,0,6,0,36864,14,7939147015
15,204208,138636,342844,0,6,0,120832,14,4663728149
16,279815,20624,300439,0,2,1,33280,14,2416112980
17,349781,15062,364843,0,0,1,29184,29,2946860161
18,359099,117104,476203,0,6,0,84480,14,339840184
19,531485,1994,533479,0,7,1,2048,40,10470127207
20,543537,115700,659237,0,3,0,79872,37,4899490834
21,572922,5196,578118,0,5,1,13312,20,8813085644
22,599035,4679,603714,0,7,1,12288,40,5881379160
23,608447,13858,622305,0,0,1,23552,29,2645908540
24,627908,3387,631295,0,5,1,9728,20,1347092301
25,629100,195272,824372,0,4,0,179712,12,9129399941
26,671660,3898,675558,0,7,1,4096,40,7530660369
27,710081,1518,711599,0,7,1,1536,40,7674472916
28,715738,4420,720158,0,6,1,11776,14,3122993838
29,756706,6488,763194,0,7,1,15872,40,7275892413
30,764452,5802,770254,0,6,1,6144,14,473991714
31,817668,121628,939296,0,6,0,99328,14,1846965327
32,819053,197612,1016665,0,3,0,187392,37,6593427671
33,844911,90892,935803,0,3,0,1536,37,8825818001
34,852973,5712,858685,0,1,1,14336,18,4205732026
35,866224,3898,870122,0,7,1,4096,40,4073161222
36,868455,2870,871325,0,1,1,8704,18,2092601894
37,868947,5712,874659,0,0,1,14336,29,9931917748
38,973149,3898,977047,0,2,1,4096,14,9039424874
39,1021407,48980,1070387,0,5,0,2048,20,3773414775
40,1050625,106964,1157589,0,9,0,51200,45,5425970203
41,1118413,13083,1131496,0,7,1,22016,40,2318867134
42,1153990,43904,1197894,0,5,0,512,20,3548054077
43,1159325,101816,1261141,0,3,0,34304,37,2463724540
44,1160181,74672,1234853,0,4,0,10752,12,933555646
45,1161462,4937,1166399,0,5,1,12800,20,737531831
46,1173882,5326,1179208,0,6,1,5632,14,5328680267
47,1200401,3422,1203823,0,3,1,3584,37,7880628686
48,1210935,11274,1222209,0,0,1,18432,29,7350051413
49,1266625,286388,1553013,0,9,0,317440,45,3394612682
50,1274379,239363,1513742,0,8,1,392704,21,3480136635
51,1298920,52364,1351284,0,6,0,3072,14,7742394376
52,1434826,202604,1637430,0,9,0,203776,45,3444057260
53,1518836,113048,1631884,0,2,0,71168,14,7186615699
54,1524030,5196,1529226,0,8,1,13312,21,8916634826
55,1638238,193145,1831383,0,2,0,111104,14,8596881513
56,1644322,24242,1668564,0,2,1,40448,14,3142808858
57,1671789,1042,1672831,0,1,1,1024,18,2407175772
58,1706079,4420,1710499,0,1,1,11776,18,2268286282
59,1714547,293096,2007643,0,9,0,339456,45,6619517965
60,1721289,363059,2084348,0,2,0,52736,14,5751810836
61,1760037,308220,2068257,0,2,0,337920,14,4848631473
62,1805808,80396,1886204,0,3,0,19456,37,490710795
63,1949744,375944,2325688,0,4,0,450048,12,2833538437
64,2041417,21141,2062558,0,3,1,34304,37,9608438995
65,2043369,154464,2197833,0,2,0,125440,14,301621220
66,2092217,246590,2338807,0,4,0,43008,12,3944636362
67,2100366,12737,2113103,0,3,1,24576,37,6236566737
68,2128091,124280,2252371,0,6,0,108032,14,10665658934
69,2144374,212963,2357337,0,3,0,57344,37,2063118330
70,2274490,23120,2297610,0,3,1,41472,37,2296358796
71,2292372,188720,2481092,0,2,0,158208,14,1269093579
72,2318411,57440,2375851,0,5,0,4608,20,6280048173
73,2336414,5196,2341610,0,5,1,13312,20,8654888943
74,2345673,12698,2358371,0,3,1,1024,37,348042008
75,2353501,52676,2406177,0,5,0,4096,20,8494713530
76,2358565,173336,2531901,0,9,0,153088,45,8659199624
77,2359428,188096,2547524,0,6,0,156160,14,7297886707
78,2396880,13083,2409963,0,0,1,22016,29,1092001441
79,2409332,321050,2730382,0,3,0,364544,37,1518073110
80,2421005,5196,2426201,0,0,1,13312,29,6996511697
81,2481029,82666,2563695,0,8,1,134144,21,5438901408
82,2562497,196052,2758549,0,2,0,182272,14,8420549667
83,2565797,14029,2579826,0,5,1,27136,20,9235874381
84,2677571,13512,2691083,0,8,1,26112,21,923229366
85,2687934,81632,2769566,0,8,1,132096,21,1262166828
86,2731587,4420,2736007,0,5,1,11776,20,9383465071
87,2757664,566,2758230,0,7,1,512,40,3724187112
88,2775330,10499,2785829,0,7,1,16896,40,8567922312
89,2802447,1518,2803965,0,5,1,1536,20,2930561518
90,2804013,14545,2818558,0,5,1,28160,20,4350418052
91,2858131,2470,2860601,0,7,1,2560,40,5896830910
92,2877855,53495,2931350,0,8,1,90624,21,8433846974
93,2907163,118976,3026139,0,9,0,90624,45,7117177901
94,2954561,83958,3038519,0,8,1,136704,21,6005627180
95,3052446,1518,3053964,0,2,1,1536,14,3631889864
96,3056614,2870,3059484,0,5,1,8704,20,7860494175
97,3179202,566,3179768,0,5,1,512,20,4597757834
98,3200007,112424,3312431,0,3,0,69120,37,4600316283
99,3212206,1994,3214200,0,0,1,2048,29,7511792506
100,3239671,3898,3243569,0,2,1,4096,14,7316834992
101,3270096,135222,3405318,0,2,0,126464,14,2810172153
102,3275457,51257,3326714,0,8,1,82944,21,2607887625
103,3378960,5454,3384414,0,0,1,13824,29,9836861887
104,3399475,45596,3445071,0,5,0,1024,20,3611427478
105,3434226,199640,3633866,0,3,0,194048,37,3616364516
106,3449312,48980,3498292,0,5,0,2048,20,1383870819
107,3513040,12825,3525865,0,5,1,21504,20,2541477805
108,3645566,132992,3778558,0,3,0,131584,37,2886627186
109,3732122,55748,3787870,0,2,0,4096,14,7057758484
110,3738861,210092,3948953,0,6,0,228352,14,7825163384
111,3763908,2870,3766778,0,5,1,8704,20,603291863
112,3787134,2470,3789604,0,5,1,2560,20,787802826
113,3790860,4374,3795234,0,5,1,4608,20,8561173455
114,3801342,127212,3928554,0,8,1,210944,21,2386155402
115,3815637,47288,3862925,0,2,0,1536,14,896092305
116,3857853,92411,3950264,0,8,1,71168,21,3963587226
117,3909885,4162,3914047,0,5,1,11264,20,7648759333
118,3967934,3645,3971579,0,2,1,10240,14,1585628389
119,3976663,20366,3997029,0,2,1,32768,14,1687257446
120,3981978,304899,4286877,0,8,1,493568,21,4824742495
121,3998158,543157,4541315,0,8,1,666112,21,5650398990
122,4011124,4850,4015974,0,5,1,5120,20,5854184703
123,4014333,74360,4088693,0,2,0,9728,14,60908746
124,4096864,115544,4212408,0,3,0,79360,37,733745121
125,4098623,7230,4105853,0,2,1,7680,14,1147509001
126,4118508,214772,4333280,0,6,0,243712,14,5623689147
127,4195992,231180,4427172,0,3,0,243712,37,8580211193
128,4203300,207314,4410614,0,2,0,152576,14,9352409339
129,4262391,84092,4346483,0,4,0,21504,12,6679428682
130,4457981,14117,4472098,0,2,1,24064,14,3327266202
131,4533319,12566,4545885,0,2,1,20992,14,9003239980
132,4749049,213257,4962306,0,8,1,345088,21,7140181508
133,5036600,14117,5050717,0,0,1,24064,29,5511674844
134,5061393,112892,5174285,0,6,0,70656,14,7107368257
135,5068318,4162,5072480,0,1,1,11264,18,1768778208
136,5081907,161936,5243843,0,6,0,91136,14,7647120576
137,5084397,102752,5187149,0,9,0,37376,45,7008237588
138,5133612,473954,5607566,0,3,0,543744,37,4430182170
139,5247922,217556,5465478,0,6,0,247808,14,8770358404
140,5278752,272076,5550828,0,6,0,163840,14,433941115
141,5340454,211637,5552091,0,6,0,4096,14,4450137480
142,5388611,25187,5413798,0,2,1,45568,14,3428100119
143,5466101,10241,5476342,0,2,1,16384,14,10253281129
144,5480990,14804,5495794,0,8,1,28672,21,839064393
145,5508565,11016,5519581,0,2,1,17920,14,825861333
146,5513348,499341,6012689,0,8,1,808960,21,8258829225
147,5541207,51140,5592347,0,5,0,4096,20,9617551063
148,5572422,50672,5623094,0,9,0,2560,45,896179149
149,5629505,282800,5912305,0,2,0,305664,14,2706282191
150,5689826,12995,5702821,0,2,1,25088,14,5716068299
151,5773949,376568,6150517,0,9,0,452096,45,7057694639
152,5781199,566,5781765,0,2,1,512,14,9365585483
153,5912078,50672,5962750,0,5,0,2560,20,9770880611
154,5985781,10757,5996538,0,2,1,17408,14,5606170705
155,5998602,5971,6004573,0,2,1,14848,14,6685452048
156,6156347,125216,6281563,0,4,0,111104,12,696772306
157,6168987,163448,6332435,0,6,0,140800,14,5824657768
158,6172215,293780,6465995,0,6,0,256512,14,8193701061
159,6185108,13341,6198449,0,1,1,22528,18,5854380795
160,6220504,115251,6335755,0,4,0,24576,12,9796633891
161,6300057,45596,6345653,0,5,0,1024,20,483556886
162,6413394,65159,6478553,0,6,1,20992,14,3878638311
163,6423334,283112,6706446,0,4,0,306688,12,9014814653
164,6425762,113204,6538966,0,3,0,71680,37,6803296445
165,6628314,107900,6736214,0,3,0,54272,37,6014415373
166,6774927,99476,6874403,0,4,0,26624,12,10549634798
167,6787074,49136,6836210,0,5,0,2560,20,6463894873
168,6846856,13512,6860368,0,2,1,26112,14,8550755409
169,6874860,14117,6888977,0,2,1,24064,14,6542194776
170,6910600,102596,7013196,0,6,0,36864,14,3262819122
171,6920684,110552,7031236,0,9,0,62976,45,3442275224
172,6948846,3422,6952268,0,1,1,3584,18,9707434053
173,6982072,6754,6988826,0,2,1,7168,14,10300720031
174,6997503,213056,7210559,0,3,0,238080,37,10432273251
175,7063290,158372,7221662,0,2,0,139264,14,6603782954
176,7105186,4162,7109348,0,2,1,11264,14,6544034680
177,7309087,3645,7312732,0,1,1,10240,18,4133828020
178,7362201,129584,7491785,0,6,0,125440,14,7810697862
179,7490148,21658,7511806,0,1,1,35328,18,8336945602
180,7511293,121004,7632297,0,4,0,97280,12,3106306496
181,7532446,4420,7536866,0,1,1,11776,18,4686082525
182,7683107,16613,7699720,0,1,1,32256,18,6923976157
183,7721092,112736,7833828,0,2,0,70144,14,588927664
184,7723479,86096,7809575,0,4,0,23040,12,9768963044
185,7740995,47288,7788283,0,5,0,1536,20,5292036376
186,7918344,26221,7944565,0,1,1,47616,18,10458814091
187,7956905,105092,8061997,0,4,0,45056,12,2079340582
188,7976102,2870,7978972,0,2,1,8704,14,5508962772
189,8029928,114140,8144068,0,9,0,74752,45,3707200811
190,8133096,74260,8207356,0,9,0,8704,45,3270856314
191,8137481,82088,8219569,0,2,0,19968,14,5324679757
192,8200725,3904,8204629,0,1,1,10752,18,3510851842
193,8409052,54056,8463108,0,5,0,3584,20,9689999140
194,8438080,204320,8642400,0,2,0,209408,14,3662226919
195,8455071,376167,8831238,0,2,0,313856,14,2389115494
196,8480515,108992,8589507,0,6,0,57856,14,1811985331
197,8506605,286700,8793305,0,4,0,318464,12,6201013791
198,8545394,302863,8848257,0,2,0,55808,14,2739109896
199,8668549,43458,8712007,0,2,1,71168,14,4611883493
200,8726690,112112,8838802,0,6,0,68096,14,2928616953
201,8770743,30491,8801234,0,1,1,49152,18,1175151219
202,8804131,103532,8907663,0,3,0,39936,37,4764004203
203,8928541,13253,8941794,0,1,1,25600,18,9631753330
204,8967483,20624,8988107,0,1,1,33280,18,8731858182
205,9006048,176876,9182924,0,9,0,154624,45,3588809830
206,9010739,1518,9012257,0,2,1,1536,14,5448864980
207,9034549,118196,9152745,0,4,0,88064,12,6311954031
208,9060857,104468,9165325,0,6,0,43008,14,9795268066
209,9078403,1518,9079921,0,1,1,1536,18,2195656266
210,9101532,47288,9148820,0,5,0,1536,20,9603122462
211,9170704,7230,9177934,0,1,1,7680,18,2104501139
212,9201774,13253,9215027,0,2,1,25600,14,4229558359
213,9207955,21916,9229871,0,1,1,35840,18,9577400934
214,9249040,111332,9360372,0,6,0,65536,14,3861826625
215,9277161,3898,9281059,0,2,1,4096,14,3617516245
216,9297237,13600,9310837,0,1,1,23040,18,7483297949
217,9343186,12737,9355923,0,1,1,24576,18,4595954813
218,9539875,199172,9739047,0,4,0,192512,12,7003271715
219,9540514,23725,9564239,0,1,1,39424,18,3585595188
220,9545446,200732,9746178,0,9,0,197632,45,4134081545
221,9567377,91172,9658549,0,3,0,24576,37,742125381
222,9623666,123689,9747355,0,3,0,88064,37,6029539114
223,9642542,33503,9676045,0,1,1,58368,18,6653846809
224,9696603,322428,10019031,0,4,0,296448,12,8679242941
225,9772576,4162,9776738,0,1,1,11264,18,10341921432
226,9847687,5454,9853141,0,1,1,13824,18,6068390885
227,10019802,62516,10082318,0,5,0,6144,20,3257961968
228,10147042,119756,10266798,0,9,0,93184,45,5590234458
229,10186065,3904,10189969,0,1,1,10752,18,1964158171
230,10192425,3898,10196323,0,1,1,4096,18,8051002965
231,10249133,282644,10531777,0,6,0,305152,14,287512491
232,10291419,55748,10347167,0,5,0,4096,20,1927157326
233,10333774,47288,10381062,0,5,0,1536,20,5968363286
234,10422155,191216,10613371,0,2,0,166400,14,3303777716
235,10445521,13770,10459291,0,1,1,26624,18,9008095484
236,10452612,113360,10565972,0,4,0,72192,12,7400371705
237,10471270,324681,10795951,0,2,0,304640,14,5563084280
238,10571591,124124,10695715,0,6,0,107520,14,7097703128
239,10693548,1518,10695066,0,4,1,1536,12,5488378811
240,10849844,55748,10905592,0,5,0,4096,20,10727580963
241,10861302,81440,10942742,0,3,0,12800,37,1098169385
242,10889566,62672,10952238,0,5,0,6656,20,5785794557
243,10963385,48980,11012365,0,8,0,2048,21,3048143016
244,10969887,97472,11067359,0,9,0,25088,45,1657429934
245,11087530,201824,11289354,0,2,0,201216,14,8471517031
246,11094391,175784,11270175,0,9,0,151040,45,1174455314
247,11117545,67460,11185005,0,3,0,12288,37,7375510479
248,11153753,118621,11272374,0,9,0,7168,45,10081721725
249,11263950,207596,11471546,0,6,0,220160,14,6921270795
250,11341817,50672,11392489,0,5,0,2560,20,2131694571
251,11513749,124904,11638653,0,9,0,110080,45,3821067086
252,11521917,138282,11660199,0,9,0,13312,45,266158714
253,11529640,200888,11730528,0,3,0,198144,37,8001988818
254,11698219,73136,11771355,0,9,0,10752,45,4497084044
255,11752477,110084,11862561,0,9,0,61440,45,3457749209
256,11936775,74672,12011447,0,2,0,10752,14,5266302524
257,12063229,167012,12230241,0,3,0,147456,37,6037618801
258,12120808,97760,12218568,0,6,0,20992,14,2189855420
259,12185867,95000,12280867,0,9,0,22016,45,4051649824
260,12359583,213524,12573107,0,3,0,239616,37,5474767015
261,12675686,11274,12686960,0,7,1,18432,40,390942465
262,12823486,119912,12943398,0,4,0,93696,12,1469138139
263,12828955,297270,13126225,0,8,1,485376,21,8024279777
264,12829408,14287,12843695,0,7,1,27648,40,4983346072
265,12884710,208844,13093554,0,2,0,224256,14,8599511462
266,12897077,89149,12986226,0,2,0,3072,14,6453545064
267,12958299,367052,13325351,0,4,0,420864,12,6273161673
268,12975833,162246,13138079,0,8,1,40448,21,8049747608
269,13004236,191996,13196232,0,3,0,168960,37,485233089
270,13102597,116168,13218765,0,9,0,81408,45,761493192
271,13129214,227383,13356597,0,9,0,143360,45,5849928312
272,13154921,181209,13336130,0,4,0,35328,12,10267481721
273,13157081,5971,13163052,0,7,1,14848,40,7932784184
274,13165469,4679,13170148,0,8,1,12288,21,9369096698
275,13210937,98696,13309633,0,6,0,24064,14,6243916207
276,13328661,31007,13359668,0,8,1,50176,21,9937425192
277,13442941,65144,13508085,0,9,0,9728,45,4081319281
278,13589731,106808,13696539,0,4,0,50688,12,8114927394
279,13675568,32299,13707867,0,7,1,52736,40,7743251974
280,13682665,26188,13708853,0,7,1,1536,40,8932109164
281,13759535,43904,13803439,0,5,0,512,20,5719888366
282,13797693,12737,13810430,0,7,1,24576,40,7427583306
283,13830575,104000,13934575,0,9,0,41472,45,2106160935
284,13873102,3898,13877000,0,6,1,4096,14,9723088692
285,13950887,4850,13955737,0,6,1,5120,14,7080692257
286,13969396,97472,14066868,0,4,0,25088,12,5051473932
287,13989031,74262,14063293,0,8,1,124416,21,4757206786
288,14065069,3387,14068456,0,6,1,9728,14,9087660882
289,14093824,101660,14195484,0,3,0,33792,37,3350925659
290,14095459,52549,14148008,0,8,1,85504,21,6931557909
291,14105411,59132,14164543,0,2,0,5120,14,5487258955
292,14134871,107221,14242092,0,8,1,178688,21,236590550
293,14141260,153990,14295250,0,6,0,66048,14,10243752984
294,14144527,16613,14161140,0,6,1,32256,14,4843904879
295,14312250,73760,14386010,0,3,0,12800,37,4923788364
296,14340090,282956,14623046,0,9,0,306176,45,3336021079
297,14369236,5326,14374562,0,7,1,5632,40,2070470000
298,14390817,108680,14499497,0,6,0,56832,14,1097750926
299,14429007,54056,14483063,0,5,0,3584,20,3362276820
300,14458442,106496,14564938,0,4,0,49664,12,9176041766
301,14513303,63296,14576599,0,0,0,8704,29,1175126900
302,14534530,6278,14540808,0,1,1,6656,18,4507661165
303,14585551,97760,14683311,0,4,0,20992,12,2088474454
304,14600586,192620,14793206,0,3,0,171008,37,6465557347
305,14664126,99788,14763914,0,6,0,27648,14,1868019626
306,14678231,2470,14680701,0,6,1,2560,14,7047808268
307,14687307,123188,14810495,0,4,0,104448,12,9596117089
308,14687337,168836,14856173,0,9,0,143360,45,3391358
309,14732636,189114,14921750,0,9,0,43008,45,6195125218
310,14741341,180736,14922077,0,9,0,1024,45,10711187095
311,14756276,11052,14767328,0,6,1,3584,14,8634701331
312,14765731,47288,14813019,0,5,0,1536,20,5061790216
313,14776614,132017,14908631,0,9,0,87552,45,1146769469
314,14796396,178433,14974829,0,9,0,64512,45,4909373156
315,14834837,11533,14846370,0,6,1,18944,14,4917862051
316,14850571,120648,14971219,0,4,0,92672,12,4829888910
317,14871904,177513,15049417,0,4,0,121344,12,3318129796
318,14871912,186456,15058368,0,4,0,22528,12,9814314852
319,14887644,566,14888210,0,7,1,512,40,3314271426
320,14963014,47288,15010302,0,2,0,1536,14,5080655859
321,15047396,173000,15220396,0,3,0,146944,37,1732553704
322,15060231,23466,15083697,0,6,1,38912,14,4719334770
323,15074980,9703,15084683,0,6,1,1536,14,9586822821
324,15252724,7230,15259954,0,7,1,7680,40,6053448047
325,15299894,48980,15348874,0,5,0,2048,20,1263996054
326,15318769,5454,15324223,0,7,1,13824,40,3012758033
327,15416403,52364,15468767,0,2,0,3072,14,9638975744
328,15465453,4420,15469873,0,6,1,11776,14,4287661089
329,15503814,22433,15526247,0,6,1,36864,14,10680875802
330,15526366,13512,15539878,0,3,1,26112,37,10104697173
331,15562952,101036,15663988,0,4,0,31744,12,10559201845
332,15688434,55748,15744182,0,5,0,4096,20,6055118735
333,15705549,13512,15719061,0,7,1,26112,40,8421790199
334,15705863,20516,15726379,0,7,1,21504,40,2312259726
335,15930354,105872,16036226,0,3,0,47616,37,4434583753
336,16023420,13600,16037020,0,8,1,23040,21,8207098334
337,16026057,3898,16029955,0,9,1,4096,45,6516461292
338,16088403,6754,16095157,0,7,1,7168,40,9255431385
339,16123696,3128,16126824,0,7,1,9216,40,4908076097
340,16140944,206036,16346980,0,9,0,215040,45,4046394645
341,16256067,236365,16492432,0,9,0,231424,45,10331470442
342,16384061,4374,16388435,0,7,1,4608,40,8454533382
343,16468049,69284,16537333,0,6,0,8192,14,481607531
344,16469972,185912,16655884,0,6,0,148992,14,1128015680
345,16621603,85448,16707051,0,3,0,15872,37,7927139031
346,16688067,4937,16693004,0,7,1,12800,40,336983284
347,16703872,59288,16763160,0,2,0,5632,14,930054294
348,16704497,6937,16711434,0,3,1,4608,37,3066248976
349,16705146,10474,16715620,0,3,1,6656,37,8373436992
350,16720424,162068,16882492,0,3,0,141312,37,119213150
351,16794096,7706,16801802,0,1,1,8192,18,9577160473
352,16948285,47600,16995885,0,2,0,2560,14,949125085
353,16978911,2470,16981381,0,3,1,2560,37,2931082782
354,17043667,197144,17240811,0,9,0,185856,45,9256799945
355,17052536,1994,17054530,0,3,1,2048,37,1597890736
356,17250864,112736,17363600,0,9,0,70144,45,9450122896
357,17277315,67460,17344775,0,4,0,12288,12,9518170382
358,17392411,1518,17393929,0,7,1,1536,40,6775122025
359,17424349,13770,17438119,0,7,1,26624,40,3643937103
360,17573048,98852,17671900,0,4,0,24576,12,2854228022
361,17613583,118196,17731779,0,6,0,88064,14,9706783552
362,17758976,12049,17771025,0,7,1,19968,40,10183245133
363,17798769,15837,17814606,0,3,1,30720,37,5295095096
364,17924602,2870,17927472,0,7,1,8704,40,1779475701
365,18056699,45596,18102295,0,5,0,1024,20,2816346431
366,18078899,1518,18080417,0,7,1,1536,40,626776111
367,18097295,59132,18156427,0,9,0,5120,45,8256055853
368,18192112,67592,18259704,0,5,0,7680,20,6160823757
369,18209899,47288,18257187,0,9,0,1536,45,8058977192
370,18327355,3422,18330777,0,7,1,3584,40,3108242336
371,18344768,15062,18359830,0,7,1,29184,40,2046550843
372,18359730,105716,18465446,0,4,0,47104,12,7881727012
373,18429839,149067,18578906,0,4,0,119808,12,3290235015
374,18600730,3898,18604628,0,3,1,4096,37,7764497509
375,18614253,12308,18626561,0,1,1,20480,18,3265991810
376,18752813,1994,18754807,0,6,1,2048,14,1623236922
377,18790040,12049,18802089,0,3,1,19968,37,6715745486
378,18817175,22691,18839866,0,3,1,37376,37,9527144664
379,18833718,3422,18837140,0,7,1,3584,40,3641232803
380,18842237,4679,18846916,0,3,1,12288,37,4270210826
381,18977665,49136,19026801,0,5,0,2560,20,2282266587
382,19012849,3128,19015977,0,6,1,9216,14,5730652855
383,19231596,566,19232162,0,3,1,512,37,8207526937
384,19234676,50672,19285348,0,2,0,2560,14,5098888853
385,19272548,2470,19275018,0,6,1,2560,14,5778800828
386,19330867,45596,19376463,0,5,0,1024,20,9604558413
387,19366033,126620,19492653,0,9,0,115712,45,5882888588
388,19454692,4162,19458854,0,3,1,11264,37,861575453
389,19486365,15062,19501427,0,1,1,29184,18,7864479980
390,19524696,47288,19571984,0,2,0,1536,14,7602195042
391,19526590,6229,19532819,0,7,1,15360,40,3987454
392,19587392,64208,19651600,0,5,0,6656,20,10015813482
393,19666177,45596,19711773,0,5,0,1024,20,10587021884
394,19691775,54368,19746143,0,2,0,4608,14,10148187001
395,19742913,11274,19754187,0,3,1,18432,37,10551535823
396,19744027,12825,19756852,0,1,1,21504,18,5570033769
397,19868053,7230,19875283,0,3,1,7680,37,5110412060
398,19879637,7230,19886867,0,0,1,7680,29,6631033777
399,19918579,108680,20027259,0,9,0,56832,45,2105042598
400,20000603,45596,20046199,0,2,0,1024,14,8642943135
401,20055643,5326,20060969,0,3,1,5632,37,7063387701
402,20099424,201824,20301248,0,6,0,201216,14,5489346812
403,20133452,124748,20258200,0,9,0,109568,45,2547818933
404,20168390,267540,20435930,0,6,0,253952,14,6664929808
405,20175985,151527,20327512,0,9,0,37376,45,2853477748
406,20229988,14117,20244105,0,0,1,24064,29,8429860356
407,20255293,47096,20302389,0,5,0,512,20,5101936969
408,20258485,50672,20309157,0,5,0,2560,20,7821946718
409,20300787,190748,20491535,0,4,0,164864,12,1885232373
410,20304740,225164,20529904,0,9,0,240640,45,3085904525
411,20356990,2470,20359460,0,0,1,2560,29,3966129168
412,20403583,2470,20406053,0,1,1,2560,18,2009809445
413,20412509,45596,20458105,0,2,0,1024,14,9334922726
414,20432229,15484,20447713,0,6,1,19456,14,1761592943
415,20522967,124657,20647624,0,9,0,86528,45,9957266149
416,20686389,13341,20699730,0,0,1,22528,29,6806013981
417,20687239,92240,20779479,0,4,0,23040,12,5157100674
418,20697668,3368,20701036,0,0,1,2048,29,2241957807
419,20746820,48980,20795800,0,5,0,2048,20,10457623731
420,20752690,13341,20766031,0,0,1,22528,29,2972662702
421,20784980,110552,20895532,0,4,0,62976,12,7690836269
422,20808629,47288,20855917,0,8,0,1536,21,7568172596
423,20920374,20882,20941256,0,0,1,33792,29,1652545690
424,20928947,7706,20936653,0,6,1,8192,14,6828718634
425,20946792,5326,20952118,0,1,1,5632,18,301891723
426,21034229,1518,21035747,0,1,1,1536,18,10718274346
427,21043854,76052,21119906,0,4,0,10240,12,1192271171
428,21062307,111800,21174107,0,9,0,67072,45,1074263390
429,21147618,47288,21194906,0,5,0,1536,20,4147361361
430,21150673,1042,21151715,0,0,1,1024,29,2514723849
431,21159971,45596,21205567,0,2,0,1024,14,9623595572
432,21209762,45596,21255358,0,5,0,1024,20,10311382807
433,21379576,45596,21425172,0,2,0,1024,14,8468252211
434,21524622,71132,21595754,0,2,0,9216,14,7627429548
435,21563226,4937,21568163,0,1,1,12800,18,4911099559
436,21564041,16217,21580258,0,1,1,22016,18,7224334163
437,21718936,116168,21835104,0,4,0,81408,12,3288382349
438,21796666,101348,21898014,0,9,0,32768,45,10349833229
439,21861771,101972,21963743,0,4,0,34816,12,3839142096
440,21899417,54836,21954253,0,5,0,6144,20,4041427511
441,21908280,127400,22035680,0,9,0,118272,45,10715255834
442,21925241,4374,21929615,0,0,1,4608,29,2331211321
443,21978868,15837,21994705,0,6,1,30720,14,8996526197
444,21992726,7230,21999956,0,1,1,7680,18,10016293041
445,22034147,2946,22037093,0,1,1,3072,18,4098855853
446,22099413,2870,22102283,0,6,1,8704,14,178431001
447,22151703,50672,22202375,0,5,0,2560,20,5241776980
448,22244260,24154,22268414,0,1,1,43520,18,6926001166
449,22278821,216012,22494833,0,0,1,353792,29,1177243970
450,22333753,76232,22409985,0,4,0,15872,12,8447218697
451,22344162,83600,22427762,0,6,0,14848,14,4962774521
452,22368022,111176,22479198,0,9,0,65024,45,6961788434
453,22423189,72208,22495397,0,0,1,10752,29,7322304989
454,22508397,286112,22794509,0,0,1,466944,29,8336676537
455,22509297,54056,22563353,0,2,0,3584,14,2455448518
456,22552850,5196,22558046,0,6,1,13312,14,8507312106
457,22593135,192308,22785443,0,9,0,169984,45,5821646652
458,22615357,123656,22739013,0,4,0,105984,12,2743449904
459,22619866,43904,22663770,0,2,0,512,14,9847779539
460,22660605,11274,22671879,0,1,1,18432,18,6395290255
461,22685452,5712,22691164,0,6,1,14336,14,3053110775
462,22695197,54056,22749253,0,2,0,3584,14,10714683054
463,22728409,76418,22804827,0,0,1,40960,29,7121622593
464,22788485,10499,22798984,0,1,1,16896,18,6221058216
465,22789833,118976,22908809,0,4,0,90624,12,4002507086
466,22806698,10241,22816939,0,1,1,16384,18,8731329675
467,22819595,216270,23035865,0,0,1,354304,29,1845290299
468,22854060,3904,22857964,0,6,1,10752,14,7693668477
469,22860591,222342,23082933,0,0,1,151552,29,9151141805
470,22904832,105716,23010548,0,9,0,47104,45,1489287968
471,22927906,47288,22975194,0,2,0,1536,14,5122520370
472,22958368,3387,22961755,0,6,1,9728,14,2264154637
473,23063390,48980,23112370,0,2,0,2048,14,692931876
474,23090226,113360,23203586,0,9,0,72192,45,9131434893
475,23149052,45596,23194648,0,5,0,1024,20,3192890472
476,23183175,237037,23420212,0,0,1,388096,29,1915746516
477,23354880,30749,23385629,0,1,1,49664,18,5583134090
478,23532525,10757,23543282,0,6,1,17408,14,7659471892
479,23538236,104312,23642548,0,9,0,42496,45,3482828423
480,23553198,50672,23603870,0,5,0,2560,20,7022407078
481,23598436,7706,23606142,0,6,1,8192,14,5433220915
482,23603426,47288,23650714,0,2,0,1536,14,5610432325
483,23687652,2946,23690598,0,6,1,3072,14,9510291614
484,23848621,6229,23854850,0,1,1,15360,18,2627691075
485,23959054,4679,23963733,0,5,1,12288,20,2919025955
486,23967063,2946,23970009,0,6,1,3072,14,5280734068
487,23970353,62516,24032869,0,9,0,6144,45,7345886575
488,24165356,2870,24168226,0,6,1,8704,14,9867196989
489,24200369,60824,24261193,0,2,0,5632,14,2256727526
490,24226431,62674,24289105,0,0,1,101888,29,2987916919
491,24266656,4162,24270818,0,5,1,11264,20,5821409073
492,24342519,43904,24386423,0,5,0,512,20,2889314252
493,24470108,52364,24522472,0,5,0,3072,20,10450289895
494,24480421,388395,24868816,0,1,1,632832,18,9423670464
495,24497229,5454,24502683,0,5,1,13824,20,8485321139
496,24517489,10499,24527988,0,5,1,16896,20,6265363688
497,24630211,43904,24674115,0,2,0,512,14,2812324992
498,24759269,115244,24874513,0,1,1,18944,18,8251124758
499,24787536,16354,24803890,0,0,1,31744,29,6465332577
500,24862175,73487,24935662,0,0,1,122880,29,5935440630
501,25012514,45596,25058110,0,2,0,1024,14,2847347736
502,25068548,14545,25083093,0,5,1,28160,20,8181085042
503,25126319,129428,25255747,0,9,0,124928,45,10373366460
504,25149852,4937,25154789,0,5,1,12800,20,9553178234
505,25168846,21141,25189987,0,8,1,34304,21,1266766154
506,25231978,48980,25280958,0,5,0,2048,20,9543419392
507,25239190,47288,25286478,0,5,0,1536,20,4032596497
508,25252618,64520,25317138,0,4,0,7680,12,6487356496
509,25274297,6278,25280575,0,4,1,6656,12,8006648320
510,25401977,208688,25610665,0,4,0,223744,12,8778382893
511,25488901,22174,25511075,0,4,1,36352,12,6304299049
512,25528128,318236,25846364,0,4,0,385024,12,4619309893
513,25593140,566,25593706,0,6,1,512,14,6234830917
514,25625416,15062,25640478,0,5,1,29184,20,447598819
515,25625750,111491,25737241,0,1,1,180224,18,4020789927
516,25676833,49136,25725969,0,2,0,2560,14,8452217272
517,25693827,75185,25769012,0,1,1,102912,18,117969862
518,25718737,127642,25846379,0,4,1,20992,12,10054848450
519,25759105,2946,25762051,0,5,1,3072,20,1575875711
520,25776690,47288,25823978,0,2,0,1536,14,1280272040
521,25783705,5802,25789507,0,5,1,6144,20,752986261
522,26178013,130676,26308689,0,9,0,129024,45,1880555476
523,26233642,21141,26254783,0,0,1,34304,29,7546825050
524,26237102,89659,26326761,0,9,0,4608,45,1445111085
525,26267924,47288,26315212,0,2,0,1536,14,6892377636
526,26271922,4679,26276601,0,5,1,12288,20,709749452
527,26277798,52364,26330162,0,5,0,3072,20,9328776589
528,26289020,50672,26339692,0,2,0,2560,14,5010366476
529,26322146,21658,26343804,0,4,1,35328,12,750503599
530,26439742,125492,26565234,0,0,1,204288,29,8750461379
531,26526336,1518,26527854,0,4,1,1536,12,2894069031
532,26606196,566,26606762,0,6,1,512,14,6940998758
533,26795305,7230,26802535,0,6,1,7680,14,5936957938
534,26808768,45596,26854364,0,5,0,1024,20,2695011732
535,26840379,52364,26892743,0,5,0,3072,20,7622715200
536,26882220,5454,26887674,0,6,1,13824,14,9631506174
537,26882780,24412,26907192,0,4,1,44032,12,9960779735
538,27051809,82974,27134783,0,5,0,8704,20,8565605011
539,27065280,66836,27132116,0,5,0,10240,20,5595792280
540,27073272,2470,27075742,0,6,1,2560,14,3027382336
541,27076650,114764,27191414,0,4,0,76800,12,2321283219
542,27194060,111020,27305080,0,9,0,64512,45,474546042
543,27198447,104120,27302567,0,0,1,172544,29,8413466100
544,27233704,54212,27287916,0,5,0,4096,20,6253579580
545,27237977,160812,27398789,0,0,1,244224,29,8438658430
546,27278499,44920,27323419,0,4,1,77312,12,7488031181
547,27370258,39873,27410131,0,0,1,37888,29,6992585293
548,27379148,10241,27389389,0,6,1,16384,14,7097291403
549,27395214,3645,27398859,0,4,1,10240,12,2922792633
550,27397960,6911,27404871,0,4,1,15872,12,4153501002
551,27430816,296216,27727032,0,9,0,349696,45,3415308074
552,27465531,57440,27522971,0,2,0,4608,14,2202206186
553,27473629,340096,27813725,0,0,1,555520,29,2136964003
554,27500321,24242,27524563,0,5,1,40448,20,9906651265
555,27500524,386343,27886867,0,0,1,235520,29,3710506947
556,27501840,256875,27758715,0,9,0,103936,45,7531483482
557,27554670,3128,27557798,0,5,1,9216,20,7122785608
558,27575241,241893,27817134,0,9,0,117760,45,7212721960
559,27618224,54056,27672280,0,2,0,3584,14,9383976335
560,27630375,3128,27633503,0,5,1,9216,20,1178365291
561,27719229,3904,27723133,0,6,1,10752,14,4233006335
562,27768806,159381,27928187,0,0,1,140288,29,9265412684
563,27775025,199640,27974665,0,9,0,194048,45,2343839862
564,27832453,189684,28022137,0,9,0,50176,45,6592581155
565,27835050,104581,27939631,0,0,1,46592,29,6747566336
566,27880554,7230,27887784,0,4,1,7680,12,8272195457
567,27959746,336049,28295795,0,0,1,544256,29,1699840629
568,28220102,3645,28223747,0,4,1,10240,12,8565873169
569,28222666,1518,28224184,0,5,1,1536,20,2470232710
570,28275904,3645,28279549,0,4,1,10240,12,5211267351
571,28303466,2470,28305936,0,4,1,2560,12,5867424722
572,28361442,5454,28366896,0,5,1,13824,20,4243638817
573,28369804,93283,28463087,0,5,0,3584,20,9936498532
574,28391238,13600,28404838,0,0,1,23040,29,5789727151
575,28436694,113204,28549898,0,4,0,71680,12,5345815486
576,28476689,55562,28532251,0,0,1,94720,29,6069498014
577,28535906,83736,28619642,0,4,0,9728,12,6933222925
578,28543213,141493,28684706,0,4,0,61952,12,3353151972
579,28566510,198860,28765370,0,9,0,191488,45,2808579975
580,28615297,20366,28635663,0,6,1,32768,14,1715341019
581,28639935,4420,28644355,0,4,1,11776,12,8997953625
582,28648858,111488,28760346,0,4,0,66048,12,957998220
583,28713229,330253,29043482,0,9,0,290304,45,8857960891
584,28770794,3898,28774692,0,9,1,4096,45,3583448379
585,28796767,566,28797333,0,6,1,512,14,4614499618
586,28829196,11533,28840729,0,5,1,18944,20,8640500600
587,28829920,223249,29053169,0,9,0,31744,45,8693825923
588,28850134,43904,28894038,0,2,0,512,14,4116813241
589,28897024,33850,28930874,0,6,1,55808,14,5935944441
590,28942133,1518,28943651,0,0,1,1536,29,7695380113
591,29069915,57440,29127355,0,5,0,4608,20,9863799597
592,29083452,2470,29085922,0,5,1,2560,20,4462797731
593,29204523,45596,29250119,0,5,0,1024,20,5089464134
594,29275987,50672,29326659,0,5,0,2560,20,3770092006
595,29327251,1042,29328293,0,9,1,1024,45,10191858335
596,29356446,43904,29400350,0,0,0,512,29,9125128611
597,29378803,4679,29383482,0,5,1,12288,20,8443956451
598,29401001,89588,29490589,0,0,0,14336,29,10182618844
599,29405619,309008,29714627,0,4,0,391680,12,5775018644
600,29450922,45596,29496518,0,5,0,1024,20,10503035623
601,29451674,76071,29527745,0,0,1,128000,29,4042601886
602,29469860,43904,29513764,0,2,0,512,14,2209612639
603,29658653,54056,29712709,0,0,0,3584,29,5876091562
604,29667105,12566,29679671,0,9,1,20992,45,5336876973
605,29712703,3645,29716348,0,9,1,10240,45,5665240775
606,29756406,16613,29773019,0,0,1,32256,29,5183780345
607,29760771,43904,29804675,0,5,0,512,20,7310860171
608,29821954,10499,29832453,0,9,1,16896,45,10721838620
609,29831634,115795,29947429,0,0,1,192000,29,6345606054
610,29915693,65900,29981593,0,2,0,7168,14,4188439472
611,29926829,216956,30143785,0,4,0,250880,12,5611781509
612,29927033,134653,30061686,0,0,0,2560,29,5963485458
613,29969057,5712,29974769,0,5,1,14336,20,3530025133
614,30066678,3904,30070582,0,5,1,10752,20,3853053162
615,30158997,36346,30195343,0,0,1,64000,29,5512843078
616,30169543,283527,30453070,0,0,1,444416,29,2426757696
617,30273735,212650,30486385,0,0,0,512,29,10221610405
618,30334989,10499,30345488,0,9,1,16896,45,2016787359
619,30368056,106929,30474985,0,0,1,80384,29,933695048
620,30499789,70064,30569853,0,2,0,10752,14,246651216
621,30575083,43904,30618987,0,5,0,512,20,4407100160
622,30688953,45596,30734549,0,0,0,1024,29,1562220944
623,30738255,49136,30787391,0,0,0,2560,29,5647424093
624,30755495,114296,30869791,0,9,0,75264,45,4887211927
625,30788461,7706,30796167,0,9,1,8192,45,929977673
626,30813996,43904,30857900,0,2,0,512,14,2567102652
627,30873153,134684,31007837,0,4,0,132096,12,26713752
628,30884868,4937,30889805,0,5,1,12800,20,5869130963
629,30966157,134495,31100652,0,0,1,221696,29,6864734844
630,31113880,48980,31162860,0,2,0,2048,14,565456171
631,31212950,193556,31406506,0,9,0,174080,45,4529760465
632,31216859,136523,31353382,0,9,0,14848,45,9335532700
633,31356980,86196,31443176,0,1,1,144384,18,2731575203
634,31366271,7230,31373501,0,5,1,7680,20,954541032
635,31393481,17954,31411435,0,9,1,12800,45,2991132427
636,31476828,48980,31525808,0,5,0,2048,20,9587240047
637,31500968,83958,31584926,0,1,1,136704,18,2458258147
638,31543012,43904,31586916,0,2,0,512,14,1181409461
639,31546134,53753,31599887,0,0,1,91136,29,5735312078
640,31579637,197998,31777635,0,0,0,4096,29,10099937876
641,31619744,149929,31769673,0,0,0,2048,29,709291143
642,31742401,43458,31785859,0,1,1,71168,18,6130794851
643,31755988,60824,31816812,0,0,0,5632,29,4479615106
644,31773179,102908,31876087,0,9,0,37888,45,2734123102
645,31797850,74516,31872366,0,0,0,10240,29,3304597708
646,31869855,11437,31881292,0,9,1,13312,45,1861978526
647,31872347,130756,32003103,0,9,0,48128,45,847198068
648,31889478,10241,31899719,0,1,1,16384,18,3111229311
649,31979911,50672,32030583,0,5,0,2560,20,9818295937
650,31985077,130832,32115909,0,0,0,129536,29,6896883883
651,32088426,694729,32783155,0,1,1,1129472,18,4692340806
652,32162605,192620,32355225,0,4,0,171008,12,9672112337
653,32174842,629204,32804046,0,1,1,67072,18,4826391494
654,32224433,74350,32298783,0,0,1,121344,29,2852823583
655,32284959,163408,32448367,0,8,1,264704,21,5116753525
656,32352661,96837,32449498,0,0,1,161792,29,3791180257
657,32374177,47288,32421465,0,5,0,1536,20,1643026180
658,32399322,146429,32545751,0,8,1,241664,21,2898122769
659,32430199,4162,32434361,0,9,1,11264,45,95112600
660,32500234,83612,32583846,0,0,1,139264,29,3958366050
661,32504721,48980,32553701,0,5,0,2048,20,10303479905
662,32549042,94858,32643900,0,8,1,154624,21,1537643158
663,32571340,48980,32620320,0,5,0,2048,20,10249021215
664,32619382,201343,32820725,0,1,1,55296,18,8085716874
665,32631187,2946,32634133,0,5,1,3072,20,3115938773
666,32751943,108056,32859999,0,9,0,54784,45,160340708
667,32829808,6488,32836296,0,1,1,15872,18,408850641
668,32834693,48980,32883673,0,2,0,2048,14,4748131373
669,32903302,1518,32904820,0,5,1,1536,20,9542872656
670,32909216,3898,32913114,0,5,1,4096,20,5022554593
671,32920900,246475,33167375,0,1,1,399872,18,3000484091
672,32932574,23378,32955952,0,5,1,41984,20,6188897692
673,32980811,77744,33058555,0,5,0,10752,20,7894190211
674,32993688,115076,33108764,0,0,0,77824,29,906741793
675,33018144,143414,33161558,0,0,0,28160,29,7823698186
676,33076242,195333,33271575,0,1,1,316928,18,6649495383
677,33100041,202896,33302937,0,1,1,109056,18,5028281103
678,33137317,48980,33186297,0,2,0,2048,14,10052134251
679,33151487,45596,33197083,0,5,0,1024,20,608647890
680,33206564,44060,33250624,0,2,0,1024,14,7944332604
681,33216370,109616,33325986,0,9,0,59904,45,2123689325
682,33229438,151004,33380442,0,9,0,77312,45,391171631
683,33261142,11016,33272158,0,5,1,17920,20,5774270783
684,33338592,4850,33343442,0,5,1,5120,20,5288268519
685,33460691,2870,33463561,0,5,1,8704,20,9769865507
686,33462181,118820,33581001,0,4,0,90112,12,7470146630
687,33517474,34020,33551494,0,0,1,59392,29,9539362831
688,33615402,74360,33689762,0,9,0,9728,45,1992131047
689,33675396,286112,33961508,0,1,1,466944,18,1864763418
690,33751398,123500,33874898,0,4,0,105472,12,4617627996
691,33927591,193783,34121374,0,0,1,313856,29,2910317757
692,34126911,102284,34229195,0,4,0,35840,12,10617071203
693,34145660,43904,34189564,0,2,0,512,14,46009354
694,34289329,65429,34354758,0,0,1,110592,29,2902241473
695,34340229,48980,34389209,0,2,0,2048,14,1153821721
696,34456836,1518,34458354,0,0,1,1536,29,7414409738
697,34546993,10499,34557492,0,6,1,16896,14,9304573574
698,34785939,106496,34892435,0,9,0,49664,45,3195665027
699,34828313,294500,35122813,0,4,0,344064,12,2316251711
700,34830584,1518,34832102,0,0,1,1536,29,2237059752
701,34891473,43904,34935377,0,5,0,512,20,10128159410
702,34899333,47288,34946621,0,2,0,1536,14,5953814514
703,34924576,50672,34975248,0,5,0,2560,20,398151538
704,35151104,144836,35295940,0,0,0,135168,29,1220564100
705,35241823,112545,35354368,0,0,0,67584,29,5229018540
706,35274444,492488,35766932,0,8,1,802304,21,6964497487
707,35442087,45696,35487783,0,0,1,78848,29,2868903376
708,35463759,27250,35491009,0,0,1,5120,29,8935358094
709,35499178,23466,35522644,0,1,1,38912,18,2218827624
710,35513597,112268,35625865,0,9,0,68608,45,4225568221
711,35617456,242638,35860094,0,8,1,298496,21,2289427850
712,35703237,43904,35747141,0,5,0,512,20,8836906797
713,35739406,64208,35803614,0,5,0,6656,20,7031162576
714,35768619,43904,35812523,0,2,0,512,14,1520029151
715,35849273,77744,35927017,0,0,0,10752,29,4116626401
716,35883328,115076,35998404,0,4,0,77824,12,4703408210
717,35889607,106446,35996053,0,1,1,177152,18,7288140638
718,35904065,16613,35920678,0,0,1,32256,29,8068821314
719,35942575,114873,36057448,0,1,1,184832,18,7025429947
720,35968376,53144,36021520,0,5,0,5632,20,7611007799
721,36341962,2870,36344832,0,0,1,8704,29,7387044241
722,36428456,43904,36472360,0,5,0,512,20,9374754872
723,36451680,121874,36573554,0,8,1,197120,21,10113913524
724,36555126,50672,36605798,0,5,0,2560,20,3815514836
725,36584851,370484,36955335,0,4,0,432128,12,7000492974
726,36600438,36346,36636784,0,8,1,64000,21,7955974424
727,36650697,15062,36665759,0,1,1,29184,18,10015464638
728,36716286,15062,36731348,0,1,1,29184,18,7109850553
729,36758906,90368,36849274,0,0,0,16896,29,5255196121
730,36818637,45752,36864389,0,5,0,1536,20,9574268826
731,36868552,64912,36933464,0,1,1,109568,18,1496553130
732,36943145,120068,37063213,0,0,0,94208,29,635226980
733,36949541,196676,37146217,0,9,0,184320,45,2754935745
734,37026039,115020,37141059,0,0,1,190464,29,1178143828
735,37053880,227294,37281174,0,0,1,323584,29,8773138942
736,37130434,45596,37176030,0,2,0,1024,14,6182813712
737,37187063,54056,37241119,0,2,0,3584,14,1810727192
738,37228066,59132,37287198,0,2,0,5120,14,10311205083
739,37251216,195075,37446291,0,8,1,316416,21,5957472667
740,37296479,122564,37419043,0,9,0,102400,45,7986096942
741,37324776,204941,37529717,0,0,1,332288,29,2077034927
742,37392794,64941,37457735,0,8,1,38400,21,7677702022
743,37403079,174013,37577092,0,0,1,161280,29,8151154983
744,37489452,189656,37679108,0,4,0,161280,12,10479463587
745,37661191,4162,37665353,0,1,1,11264,18,1271562087
746,37704999,186457,37891456,0,0,0,63488,29,2598839163
747,37772687,286076,38058763,0,9,0,316416,45,1702484747
748,37807253,186670,37993923,0,8,1,306688,21,2458419787
749,37854977,21399,37876376,0,1,1,34816,18,10658146789
750,37916938,320001,38236939,0,9,0,334336,45,8095089143
751,37931071,10241,37941312,0,0,1,16384,29,4090168747
752,37957515,23120,37980635,0,0,1,41472,29,38980792
753,37993719,31783,38025502,0,1,1,51712,18,1312675182
754,37995772,59132,38054904,0,5,0,5120,20,3374909072
755,38044001,45596,38089597,0,2,0,1024,14,1285494993
756,38062128,54056,38116184,0,2,0,3584,14,1618350990
757,38157959,24242,38182201,0,0,1,40448,29,7510688512
758,38176588,1042,38177630,0,1,1,1024,18,8746062697
759,38213448,4679,38218127,0,1,1,12288,18,405099909
760,38296947,124280,38421227,0,0,0,108032,29,5281640070
761,38302245,2470,38304715,0,1,1,2560,18,9862078424
762,38346322,61124,38407446,0,8,1,98816,21,2311341698
763,38379589,48980,38428569,0,2,0,2048,14,5897282478
764,38383641,37601,38421242,0,0,1,33792,29,7854024279
765,38526940,34537,38561477,0,1,1,60416,18,1251384933
766,38540660,52364,38593024,0,5,0,3072,20,9892889105
767,38554808,123344,38678152,0,4,0,104960,12,1264954098
768,38640367,75037,38715404,0,0,1,125952,29,7385453781
769,38827947,368145,39196092,0,8,1,600064,21,3288321752
770,38869031,7706,38876737,0,0,1,8192,29,10568208409
771,38898984,50672,38949656,0,5,0,2560,20,7942275138
772,38941576,5971,38947547,0,1,1,14848,18,8806233697
773,38950315,45954,38996269,0,0,1,79360,29,8998525526
774,38976455,2946,38979401,0,1,1,3072,18,7636195471
775,38988279,212998,39201277,0,8,1,24576,21,1282462715
776,39045423,12308,39057731,0,1,1,20480,18,1006664346
777,39076626,4374,39081000,0,1,1,4608,18,2216339324
778,39083914,101816,39185730,0,9,0,34304,45,9792753994
779,39222547,64208,39286755,0,5,0,6656,20,8675478319
780,39225958,10241,39236199,0,1,1,16384,18,1998098326
781,39254132,43904,39298036,0,2,0,512,14,8748015571
782,39257814,67144,39324958,0,2,0,2048,14,8635842511
783,39271445,307483,39578928,0,8,1,498688,21,4175418597
784,39360411,52364,39412775,0,4,0,3072,12,6343542582
785,39479002,118664,39597666,0,4,0,89600,12,2424173389
786,39548963,113828,39662791,0,0,0,73728,29,2703167752
787,39742389,116636,39859025,0,0,0,82944,29,5022855659
788,39801070,100724,39901794,0,4,0,30720,12,10664500257
789,39822912,72024,39894936,0,8,1,116736,21,8453703679
790,39843564,111644,39955208,0,9,0,66560,45,2713671853
791,39855525,45596,39901121,0,2,0,1024,14,3674020002
792,39874011,93995,39968006,0,8,1,156160,21,7474205162
793,40025175,43904,40069079,0,2,0,512,14,5664609908
794,40039356,65900,40105256,0,9,0,7168,45,4784758438
795,40233793,43904,40277697,0,5,0,512,20,4559926459
796,40238591,120068,40358659,0,9,0,94208,45,6790742935
797,40307234,47288,40354522,0,4,0,1536,12,9779685127
798,40322137,12566,40334703,0,1,1,20992,18,1569639187
799,40375593,5196,40380789,0,5,1,13312,20,1578059415
800,40392912,43904,40436816,0,2,0,512,14,3644626184
801,40475804,12825,40488629,0,5,1,21504,20,668587690
802,40527791,198236,40726027,0,9,0,189440,45,653793612
803,40527813,127712,40655525,0,0,0,119296,29,5396422914
804,40568534,24412,40592946,0,7,1,44032,40,7110070967
805,40593239,10241,40603480,0,5,1,16384,20,3220697011
806,40805258,131300,40936558,0,4,0,131072,12,4745794350
807,40824088,65900,40889988,0,5,0,7168,20,3193016483
808,40892870,45596,40938466,0,2,0,1024,14,9836153207
809,40923395,4937,40928332,0,7,1,12800,40,38655948
810,40953289,7230,40960519,0,5,1,7680,20,1462967280
811,40983911,4374,40988285,0,7,1,4608,40,9442712458
812,40987863,6754,40994617,0,5,1,7168,20,2594581431
813,41038600,43904,41082504,0,2,0,512,14,10544318909
814,41073064,115856,41188920,0,9,0,80384,45,9684571240
815,41094284,74482,41168766,0,5,0,1536,20,7712606631
816,41094692,183970,41278662,0,9,0,146944,45,6873983293
817,41193211,413753,41606964,0,9,0,512512,45,8666098761
818,41204676,54524,41259200,0,2,0,5120,14,1943417757
819,41221501,43904,41265405,0,2,0,512,14,3296382561
820,41299807,101192,41400999,0,0,0,32256,29,245729825
821,41353777,12308,41366085,0,4,1,20480,12,6825863252
822,41398591,116480,41515071,0,4,0,82432,12,10633987249
823,41441478,3422,41444900,0,3,1,3584,37,9728241958
824,41557505,99632,41657137,0,4,0,27136,12,10500126387
825,41577845,52364,41630209,0,5,0,3072,20,5949712126
826,41579100,1518,41580618,0,6,1,1536,14,6507331453
827,41692981,57440,41750421,0,5,0,4608,20,6694186671
828,41845942,3128,41849070,0,7,1,9216,40,2019071914
829,41856024,112736,41968760,0,0,0,70144,29,4244125558
830,42000916,112892,42113808,0,4,0,70656,12,3594093581
831,42001983,2470,42004453,0,1,1,2560,18,7245542334
832,42052462,566,42053028,0,1,1,512,18,8062558901
833,42195075,2470,42197545,0,1,1,2560,18,7031069946
834,42224824,6229,42231053,0,9,1,15360,45,9017476080
835,42276050,1518,42277568,0,7,1,1536,40,2533870958
836,42297525,54056,42351581,0,2,0,3584,14,8894973536
837,42300296,3422,42303718,0,7,1,3584,40,10096498546
838,42329180,52364,42381544,0,5,0,3072,20,5505826623
839,42354644,24929,42379573,0,1,1,45056,18,4036532408
840,42357709,103844,42461553,0,9,0,40960,45,3650035039
841,42577506,52364,42629870,0,2,0,3072,14,10486474477
842,42600127,6229,42606356,0,1,1,15360,18,5275470149
843,42733204,3422,42736626,0,1,1,3584,18,6122091836
844,42734562,14117,42748679,0,1,1,24064,18,4822401129
845,42765348,25446,42790794,0,0,1,46080,29,1232805495
846,42776633,3128,42779761,0,1,1,9216,18,10290710315
847,42805091,23378,42828469,0,1,1,41984,18,1772183427
848,42850772,55748,42906520,0,5,0,4096,20,10437616588
849,42860340,31266,42891606,0,8,1,50688,21,1045880917
850,42878111,297932,43176043,0,4,0,355328,12,4128471831
851,42939284,62516,43001800,0,2,0,6144,14,1834015266
852,42948794,266888,43215682,0,4,0,130048,12,3837648311
853,43011852,5326,43017178,0,1,1,5632,18,1427064383
854,43051204,120536,43171740,0,0,0,95744,29,3077208612
855,43156256,13512,43169768,0,1,1,26112,18,5417485050
856,43158389,118123,43276512,0,0,0,44032,29,9690128495
857,43194901,20882,43215783,0,7,1,33792,40,2895127503
858,43235661,50672,43286333,0,2,0,2560,14,456876817
859,43259070,4162,43263232,0,7,1,11264,40,7068515295
860,43435954,125372,43561326,0,4,0,111616,12,7340311282
861,43460222,288260,43748482,0,9,0,323584,45,5314255507
862,43542870,11791,43554661,0,1,1,19456,18,5764305008
863,43667428,429929,44097357,0,0,1,700416,29,4497150648
864,43784395,45596,43829991,0,5,0,1024,20,3306975977
865,43787619,4374,43791993,0,1,1,4608,18,9495765037
866,43953636,45752,43999388,0,5,0,1536,20,6223465499
867,44145659,192620,44338279,0,9,0,171008,45,6065212470
868,44269736,4679,44274415,0,1,1,12288,18,10392357200
869,44518108,102596,44620704,0,0,0,36864,29,718882447
870,44527530,55748,44583278,0,2,0,4096,14,1208791649
871,44566505,108524,44675029,0,9,0,56320,45,5415804474
872,44749537,137854,44887391,0,0,1,228352,29,6412660576
873,44765439,3422,44768861,0,1,1,3584,18,1764395847
874,44849848,44161,44894009,0,0,1,31744,29,2902428051
875,44938519,73136,45011655,0,9,0,10752,45,1197316381
876,45051269,33245,45084514,0,0,1,57856,29,2683012745
877,45077684,3645,45081329,0,1,1,10240,18,9955590746
878,45210664,87229,45297893,0,0,1,146432,29,810595667
879,45303357,25962,45329319,0,1,1,47104,18,7995378972
880,45355940,185630,45541570,0,0,0,146944,29,5738928082
881,45403893,48980,45452873,0,5,0,2048,20,1422831885
882,45418626,4162,45422788,0,9,1,11264,45,676434574
883,45423974,186154,45610128,0,0,1,305664,29,3782259276
884,45519038,237849,45756887,0,0,1,349184,29,10133044377
885,45537649,125684,45663333,0,9,0,112640,45,4276089734
886,45623705,2946,45626651,0,9,1,3072,45,7329501909
887,45657035,113254,45770289,0,9,0,51200,45,3642241678
888,45670543,109433,45779976,0,9,0,31744,45,6184283207
889,45671262,50672,45721934,0,5,0,2560,20,9164066212
890,45936953,194336,46131289,0,0,0,176640,29,9436676742
891,45947347,6229,45953576,0,1,1,15360,18,9115875742
892,45947518,10499,45958017,0,9,1,16896,45,4231193531
893,45960395,305108,46265503,0,4,0,378880,12,9745842788
894,45969698,10499,45980197,0,1,1,16896,18,8499084059
895,46017701,5326,46023027,0,1,1,5632,18,703482168
896,46034092,43904,46077996,0,9,0,512,45,7552223854
897,46036792,183908,46220700,0,9,0,147456,45,7257692478
898,46111678,27309,46138987,0,0,1,8192,29,9501388625
899,46147414,566,46147980,0,9,1,512,45,4988487148
900,46217843,3415,46221258,0,9,1,512,45,4342795340
901,46259349,203540,46462889,0,9,0,206848,45,8594377624
902,46375105,3422,46378527,0,0,1,3584,29,9622900543
903,46430895,44035,46474930,0,9,1,19968,45,6093522961
904,46464176,194960,46659136,0,5,0,178688,20,1749108604
905,46492604,6754,46499358,0,9,1,7168,45,8776824065
906,46533296,59132,46592428,0,0,0,5120,29,7447146833
907,46552151,185600,46737751,0,9,0,147968,45,9140453308
908,46584070,5454,46589524,0,1,1,13824,18,3841500226
909,46676260,48980,46725240,0,2,0,2048,14,69814620
910,46697894,184112,46882006,0,4,0,158208,12,8633890143
911,46739272,3422,46742694,0,0,1,3584,29,7880622635
912,46767867,20624,46788491,0,9,1,33280,45,4289456219
913,46798908,13858,46812766,0,0,1,23552,29,1209493617
914,46810627,566,46811193,0,9,1,512,45,904483856
915,46847533,12995,46860528,0,0,1,25088,29,1298949498
916,46875096,107314,46982410,0,4,0,29696,12,541486039
917,46885603,13253,46898856,0,0,1,25600,29,448332142
918,46999313,88676,47087989,0,9,0,16384,45,8958386391
919,47013015,12049,47025064,0,1,1,19968,18,3520571341
920,47159699,3898,47163597,0,1,1,4096,18,7877237216
921,47247340,110084,47357424,0,5,0,61440,20,4494899124
922,47294380,112112,47406492,0,0,0,68096,29,5697829567
923,47311175,1042,47312217,0,9,1,1024,45,7066604436
924,47320128,4374,47324502,0,9,1,4608,45,2595199351
925,47387934,49292,47437226,0,2,0,3072,14,781437918
926,47424973,277964,47702937,0,5,0,289792,20,2019832030
927,47425756,98852,47524608,0,9,0,24576,45,3338623677
928,47512520,1518,47514038,0,9,1,1536,45,6055811520
929,47573296,128492,47701788,0,4,0,121856,12,3244513361
930,47584327,150638,47734965,0,5,0,95232,20,1866402072
931,47611992,106028,47718020,0,9,0,48128,45,4900666625
932,47751597,100724,47852321,0,4,0,30720,12,4957177214
933,47790078,566,47790644,0,1,1,512,18,10002805568
934,48102841,103532,48206373,0,0,0,39936,29,423168957
935,48113446,113828,48227274,0,9,0,73728,45,778990120
936,48138859,109928,48248787,0,5,0,60928,20,3536749311
937,48148261,182936,48331197,0,5,0,103424,20,6395730227
938,48175265,294967,48470232,0,9,0,320512,45,1317065564
939,48183219,176068,48359287,0,9,0,512,45,7019970238
940,48212823,52520,48265343,0,2,0,3584,14,3447524158
941,48308200,47288,48355488,0,2,0,1536,14,9852517894
942,48409251,76052,48485303,0,2,0,10240,14,2027774340
943,48733624,119600,48853224,0,9,0,92672,45,8296738971
944,48734011,50672,48784683,0,2,0,2560,14,9118224864
945,48823811,113984,48937795,0,5,0,74240,20,9563111609
946,48892846,2870,48895716,0,9,1,8704,45,5413923961
947,48913521,45596,48959117,0,2,0,1024,14,7687817253
948,48938558,34537,48973095,0,9,1,60416,45,8128444133
949,48970903,118976,49089879,0,5,0,90624,20,7197780336
950,48981260,270255,49251515,0,9,0,176128,45,8303061534
951,49017038,113828,49130866,0,0,0,73728,29,10624587338
952,49062076,21658,49083734,0,9,1,35328,45,1862204021
953,49067224,34795,49102019,0,3,1,60928,37,7908938533
954,49117852,566,49118418,0,1,1,512,18,5440942316
955,49130243,63131,49193374,0,0,0,6144,29,9194173060
956,49201781,295436,49497217,0,0,0,347136,29,3655187977
957,49219376,111488,49330864,0,5,0,66048,20,4358548994
958,49295059,14287,49309346,0,3,1,27648,37,1660609514
959,49349240,5326,49354566,0,9,1,5632,45,3170209941
960,49543074,13512,49556586,0,9,1,26112,45,6178260433
961,49543773,201338,49745111,0,9,0,174592,45,2061194780
962,49635834,10241,49646075,0,1,1,16384,18,1937400300
963,49644930,2451,49647381,0,1,1,2048,18,463459756
964,49666250,3898,49670148,0,9,1,4096,45,1545500626
965,49800777,3128,49803905,0,9,1,9216,45,10683204398
966,49809237,196364,50005601,0,5,0,183296,20,8289160702
967,49919421,7706,49927127,0,1,1,8192,18,8473948673
968,49939248,10241,49949489,0,3,1,16384,37,3527467900
969,49947298,58318,50005616,0,5,1,22528,20,9259943477
970,49953092,4420,49957512,0,3,1,11776,37,2921006395
971,49990131,17947,50008078,0,5,1,2560,20,7220511224
972,50056015,229778,50285793,0,5,0,226304,20,7203339281
973,50138845,10757,50149602,0,9,1,17408,45,6237964354
974,50204558,3904,50208462,0,5,1,10752,20,5246898893
975,50227648,119912,50347560,0,9,0,93696,45,3108582580
976,50302135,214589,50516724,0,9,0,187904,45,10726604832
977,50327889,200108,50527997,0,5,0,195584,20,4822812937
978,50403118,2946,50406064,0,1,1,3072,18,5831542057
979,50442648,104312,50546960,0,9,0,42496,45,6928645788
980,50455728,43904,50499632,0,2,0,512,14,2422791894
981,50471760,43904,50515664,0,2,0,512,14,4863360476
982,50479723,7230,50486953,0,2,1,7680,14,7011122082
983,50509846,7706,50517552,0,1,1,8192,18,7491824762
984,50549208,101816,50651024,0,9,0,34304,45,7675172802
985,50601668,12308,50613976,0,9,1,20480,45,3408734058
986,50631653,5712,50637365,0,3,1,14336,37,307476535
987,50771596,4850,50776446,0,5,1,5120,20,7113308341
988,50781410,11016,50792426,0,9,1,17920,45,10205070535
989,50860429,202292,51062721,0,9,0,202752,45,5851365232
990,50974045,6488,50980533,0,1,1,15872,18,2607092090
991,50975615,9117,50984732,0,1,1,6144,18,9597517710
992,50996026,3387,50999413,0,9,1,9728,45,6833217766
993,51012882,1994,51014876,0,1,1,2048,18,6084117915
994,51126852,12049,51138901,0,1,1,19968,18,2124018414
995,51189757,5454,51195211,0,9,1,13824,45,9745650769
996,51228955,201980,51430935,0,9,0,201728,45,6007087480
997,51269827,116792,51386619,0,0,0,83456,29,4452586029
998,51303971,3422,51307393,0,5,1,3584,20,2507348609
999,51318729,201834,51520563,0,9,0,171008,45,8663943970
1000,51319674,47288,51366962,0,2,0,1536,14,8539985303
1001,51477327,5802,51483129,0,1,1,6144,18,5990157173
1002,51533771,10757,51544528,0,5,1,17408,20,3246578310
1003,51591576,24670,51616246,0,5,1,44544,20,539197965
1004,51638494,172643,51811137,0,5,0,26624,20,689898078
1005,51777400,4937,51782337,0,1,1,12800,18,9085204489
1006,51813552,1994,51815546,0,9,1,2048,45,5748274919
1007,51859613,12995,51872608,0,9,1,25088,45,9676676070
1008,51959977,11274,51971251,0,9,1,18432,45,5440017049
1009,52031210,2946,52034156,0,5,1,3072,20,464470779
1010,52086584,4162,52090746,0,5,1,11264,20,8745269482
1011,52110130,21399,52131529,0,9,1,34816,45,5942794220
1012,52113067,271275,52384342,0,9,0,150528,45,4637247534
1013,52193725,82376,52276101,0,5,0,15872,20,8930136517
1014,52220124,118339,52338463,0,9,0,4096,45,4196802691
1015,52236062,2870,52238932,0,3,1,8704,37,7445733299
1016,52254036,6754,52260790,0,5,1,7168,20,6366276442
1017,52272108,11533,52283641,0,7,1,18944,40,7206601828
1018,52278806,1518,52280324,0,9,1,1536,45,10175912058
1019,52344654,6278,52350932,0,7,1,6656,40,10021837662
1020,52367606,207128,52574734,0,0,0,218624,29,2526222225
1021,52413541,11016,52424557,0,9,1,17920,45,7410782604
1022,52450848,112424,52563272,0,5,0,69120,20,9420693482
1023,52537678,101192,52638870,0,5,0,32256,20,5130972194
1024,52551626,3422,52555048,0,9,1,3584,45,10076846201
1025,52581873,10757,52592630,0,7,1,17408,40,6193280499
1026,52651610,1994,52653604,0,0,1,2048,29,7200796688
1027,52655056,3904,52658960,0,5,1,10752,20,10077869932
1028,52707452,276404,52983856,0,5,0,284672,20,548283612
1029,52707749,52033,52759782,0,5,1,84480,20,6008163555
1030,52731173,220232,52951405,0,9,0,261632,45,2106890009
1031,52741875,4937,52746812,0,3,1,12800,37,4510209448
1032,52777091,3387,52780478,0,3,1,9728,37,6671606996
1033,52939540,56099,52995639,0,5,1,19456,20,4011389638
1034,53056463,2946,53059409,0,9,1,3072,45,2050938150
1035,53109005,57440,53166445,0,2,0,4608,14,10386256510
1036,53121184,2870,53124054,0,0,1,8704,29,47924870
1037,53127195,99944,53227139,0,5,0,28160,20,1575927024
1038,53127792,7706,53135498,0,7,1,8192,40,7410917650
1039,53138199,57908,53196107,0,2,0,6144,14,7591685018
1040,53144229,63878,53208107,0,5,1,107520,20,10105089918
1041,53162985,55748,53218733,0,2,0,4096,14,10253893102
1042,53268604,5712,53274316,0,7,1,14336,40,4693065669
1043,53342217,200903,53543120,0,5,0,166400,20,8534046398
1044,53353867,138538,53492405,0,5,0,31744,20,10374322701
1045,53387963,3422,53391385,0,5,1,3584,20,10005142671
1046,53523455,114296,53637751,0,9,0,75264,45,3982514776
1047,53598422,22691,53621113,0,0,1,37376,29,6313904535
1048,53628160,6229,53634389,0,0,1,15360,29,5854342117
1049,53657282,566,53657848,0,0,1,512,29,3210123717
1050,53705596,16354,53721950,0,3,1,31744,37,6270162647
1051,53738980,11016,53749996,0,3,1,17920,37,5082191427
1052,53750515,21399,53771914,0,3,1,34816,37,8206601007
1053,53780464,4374,53784838,0,9,1,4608,45,3159427937
1054,53867257,26738,53893995,0,9,1,48640,45,4758301284
1055,53987626,7230,53994856,0,0,1,7680,29,2679565223
1056,54022934,4679,54027613,0,9,1,12288,45,2558698899
1057,54100063,109928,54209991,0,0,0,60928,29,6624476991
1058,54106156,12825,54118981,0,3,1,21504,37,10640711987
1059,54138367,5971,54144338,0,9,1,14848,45,1571349743
1060,54139116,152784,54291900,0,9,0,127488,45,5652065579
1061,54192098,129116,54321214,0,5,0,123904,20,4863954089
1062,54357245,212120,54569365,0,5,0,235008,20,4290807389
1063,54398867,115700,54514567,0,0,0,79872,29,6199933494
1064,54547236,15837,54563073,0,9,1,30720,45,6020977057
1065,54558751,47288,54606039,0,2,0,1536,14,4816138590
1066,54592036,106964,54699000,0,5,0,51200,20,777788907
1067,54611708,97292,54709000,0,0,0,19456,29,3842103161
1068,54613901,50672,54664573,0,2,0,2560,14,5002663764
1069,54686513,2946,54689459,0,0,1,3072,29,3178964141
1070,54692924,370640,55063564,0,9,0,432640,45,2471412185
1071,54717329,5326,54722655,0,9,1,5632,45,1110849218
1072,54720902,5196,54726098,0,0,1,13312,29,5497455141
1073,54739818,385148,55124966,0,5,0,480256,20,6358815940
1074,54867055,566,54867621,0,0,1,512,29,6808593744
1075,54876190,3128,54879318,0,3,1,9216,37,4316242635
1076,54930044,566,54930610,0,3,1,512,37,5747968409
1077,55116339,96668,55213007,0,0,0,17408,29,4521332701
1078,55151057,20882,55171939,0,9,1,33792,45,8128717488
1079,55239199,1042,55240241,0,9,1,1024,45,6238760751
1080,55251076,10499,55261575,0,9,1,16896,45,8958025417
1081,55433087,24929,55458016,0,3,1,45056,37,7734488059
1082,55471249,4850,55476099,0,7,1,5120,40,9261846476
1083,55472306,3422,55475728,0,3,1,3584,37,4379831546
1084,55655194,1518,55656712,0,3,1,1536,37,9726775408
1085,55661686,5454,55667140,0,0,1,13824,29,5585474784
1086,55673011,91304,55764315,0,9,0,19968,45,5311950914
1087,55726115,14545,55740660,0,1,1,28160,18,7457845013
1088,55750973,287948,56038921,0,9,0,322560,45,7253883811
1089,55753861,1042,55754903,0,9,1,1024,45,6001238574
1090,55779037,1518,55780555,0,9,1,1536,45,4008538220
1091,55782331,11274,55793605,0,0,1,18432,29,5935653323
1092,55863619,2870,55866489,0,0,1,8704,29,2202692840
1093,55944956,45596,55990552,0,2,0,1024,14,6485688470
1094,56085234,22950,56108184,0,3,1,37888,37,9532466891
1095,56099019,65170,56164189,0,8,1,110080,21,219597051
1096,56112213,1042,56113255,0,5,1,1024,20,6115500046
1097,56151572,5454,56157026,0,1,1,13824,18,5730384042
1098,56206395,47288,56253683,0,2,0,1536,14,3620810247
1099,56239807,10499,56250306,0,3,1,16896,37,7192681246
1100,56254566,5712,56260278,0,9,1,14336,45,6415970463
1101,56255320,12308,56267628,0,1,1,20480,18,9580131738
1102,56258001,163910,56421911,0,9,0,92672,45,371156867
1103,56268178,102128,56370306,0,0,0,35328,29,8604627770
1104,56301731,22174,56323905,0,9,1,36352,45,1138133032
1105,56359834,5802,56365636,0,5,1,6144,20,5693411585
1106,56368264,6278,56374542,0,9,1,6656,45,9035722471
1107,56369239,10241,56379480,0,3,1,16384,37,5468176924
1108,56379744,3898,56383642,0,9,1,4096,45,8719322934
1109,56418107,97354,56515461,0,8,1,162816,21,8708650645
1110,56422403,7230,56429633,0,1,1,7680,18,223630300
1111,56437040,107432,56544472,0,5,0,52736,20,8948854612
1112,56548628,5326,56553954,0,3,1,5632,37,9549165171
1113,56618089,35312,56653401,0,8,1,61952,21,5037172144
1114,56658541,196537,56855078,0,8,1,322560,21,1270175735
1115,56691136,23208,56714344,0,9,1,38400,45,9067534654
1116,56691518,5971,56697489,0,1,1,14848,18,4485412420
1117,56710590,45596,56756186,0,2,0,1024,14,9273320864
1118,56754544,32987,56787531,0,0,1,57344,29,6446589938
1119,56907688,5454,56913142,0,1,1,13824,18,4328965591
1120,57027654,6754,57034408,0,0,1,7168,29,8411174543
1121,57075904,11274,57087178,0,0,1,18432,29,6842930971
1122,57148030,3898,57151928,0,0,1,4096,29,2158397584
1123,57155048,184049,57339097,0,0,0,54784,29,10374089981
1124,57162436,59132,57221568,0,9,0,5120,45,10293456683
1125,57175938,47288,57223226,0,2,0,1536,14,451843452
1126,57196357,60593,57256950,0,9,0,9216,45,4121541429
1127,57200645,110708,57311353,0,0,0,63488,29,5817268841
1128,57200889,11016,57211905,0,5,1,17920,20,3934715979
1129,57317520,133549,57451069,0,8,1,216576,21,7158257577
1130,57356023,109460,57465483,0,0,0,59392,29,7522910899
1131,57366443,119860,57486303,0,0,0,11776,29,8498576069
1132,57444585,43200,57487785,0,0,1,70656,29,3295802946
1133,57478397,35829,57514226,0,5,1,62976,20,4187854708
1134,57482408,424530,57906938,0,0,0,402432,29,9781085437
1135,57482608,3645,57486253,0,9,1,10240,45,5138261749
1136,57506223,11229,57517452,0,5,1,5120,20,9244009811
1137,57526729,387868,57914597,0,0,0,25088,29,10208982146
1138,57629287,102284,57731571,0,5,0,35840,20,8148217414
1139,57677480,226002,57903482,0,5,0,72192,20,225673338
1140,57697365,6488,57703853,0,5,1,15872,20,9579827939
1141,57698299,154003,57852302,0,5,0,65536,20,1727198084
1142,57727571,11698,57739269,0,5,1,8192,20,6700570762
1143,57733466,295748,58029214,0,0,0,348160,29,8582543809
1144,57869814,212120,58081934,0,5,0,235008,20,5405558950
1145,57873084,33591,57906675,0,8,1,55296,21,4978323516
1146,57906929,13770,57920699,0,8,1,26624,21,10180709216
1147,57941519,51774,57993293,0,8,1,83968,21,1828174042
1148,58001340,81389,58082729,0,5,0,2560,20,5761366819
1149,58029026,72668,58101694,0,9,0,9216,45,7126913033
1150,58030284,2946,58033230,0,9,1,3072,45,2711693608
1151,58059166,3645,58062811,0,9,1,10240,45,2790824161
1152,58064488,47288,58111776,0,2,0,1536,14,4136662838
1153,58154476,11791,58166267,0,5,1,19456,20,3976653636
1154,58171993,1042,58173035,0,0,1,1024,29,9040215759
1155,58210004,5712,58215716,0,9,1,14336,45,8745468039
1156,58259618,47288,58306906,0,2,0,1536,14,9470293004
1157,58311167,5196,58316363,0,9,1,13312,45,1610015132
1158,58376229,126776,58503005,0,5,0,116224,20,4081559182
1159,58465624,44233,58509857,0,8,1,72704,21,7719818785
1160,58512172,43904,58556076,0,2,0,512,14,6450039906
1161,58622202,13253,58635455,0,8,1,25600,21,3354092179
1162,58639589,20624,58660213,0,5,1,33280,20,5514495095
1163,58642908,266120,58909028,0,8,1,434688,21,288097567
1164,58672133,6754,58678887,0,5,1,7168,20,2687211068
1165,58782906,34020,58816926,0,9,1,59392,45,3479463633
1166,58793437,187505,58980942,0,8,1,229376,21,3095246598
1167,58911945,12566,58924511,0,0,1,20992,29,8501946363
1168,58965974,10757,58976731,0,4,1,17408,12,4483519840
1169,59017313,108836,59126149,0,9,0,57344,45,7600483762
1170,59023859,4420,59028279,0,9,1,11776,45,10672768020
1171,59026246,120848,59147094,0,1,0,96768,18,6546245468
1172,59048982,341006,59389988,0,6,0,263680,14,10639889367
1173,59059807,434872,59494679,0,6,0,343552,14,1570539136
1174,59098550,27614,59126164,0,9,1,44032,45,4672123354
1175,59173632,5971,59179603,0,9,1,14848,45,4316857298
1176,59243458,1994,59245452,0,9,1,2048,45,527922668
1177,59253989,4850,59258839,0,9,1,5120,45,2837671644
1178,59283268,255262,59538530,0,6,0,143872,14,137231848
1179,59284311,47288,59331599,0,2,0,1536,14,8099683241
1180,59347519,3422,59350941,0,9,1,3584,45,143306977
1181,59347723,23466,59371189,0,5,1,38912,20,226721950
1182,59504009,102128,59606137,0,9,0,35328,45,7549194505
1183,59568718,566,59569284,0,5,1,512,20,4353921692
1184,59598052,105681,59703733,0,9,0,20480,45,202786041
1185,59610344,23208,59633552,0,9,1,38400,45,6312359306
1186,59759197,95545,59854742,0,8,1,159232,21,1364515917
1187,59766718,206816,59973534,0,6,0,217600,14,9241669943
1188,59793766,375788,60169554,0,0,0,449536,29,2335666613
1189,59843002,23466,59866468,0,4,1,38912,12,1083378871
1190,59845280,129049,59974329,0,6,0,2560,14,5265386963
1191,59878622,12995,59891617,0,4,1,25088,12,3003529199
1192,59894339,14117,59908456,0,4,1,24064,12,4256367030
1193,59960872,4679,59965551,0,9,1,12288,45,2914770792
1194,59971924,236021,60207945,0,0,0,125952,29,7149049523
1195,60048728,278588,60327316,0,2,0,291840,14,1196780565
1196,60274579,81128,60355707,0,5,0,11776,20,7912023999
1197,60298599,2470,60301069,0,5,1,2560,20,8222768747
1198,60322444,43904,60366348,0,6,0,512,14,6851733675
1199,60359559,120224,60479783,0,5,0,94720,20,3597825601
1200,60504484,1042,60505526,0,1,1,1024,18,9907435233
1201,60547387,14804,60562191,0,8,1,28672,21,3402486459
1202,60612494,111176,60723670,0,2,0,65024,14,10699771381
1203,60649043,211496,60860539,0,5,0,232960,20,10586681383
1204,60693639,97096,60790735,0,8,1,162304,21,4934690895
1205,60727425,122871,60850296,0,2,0,86528,14,10555963806
1206,60732568,131315,60863883,0,2,0,44544,14,5425157431
1207,60743683,43904,60787587,0,6,0,512,14,6640777166
1208,60752386,69284,60821670,0,0,0,8192,29,9802139036
1209,60773304,87250,60860554,0,5,1,34816,20,7297281841
1210,60801956,66296,60868252,0,5,1,8192,20,8984835103
1211,60802759,2946,60805705,0,1,1,3072,18,3061487208
1212,60815058,20366,60835424,0,4,1,32768,12,5075161106
1213,60851685,6488,60858173,0,0,1,15872,29,7621747361
1214,60861578,72283,60933861,0,8,1,117248,21,7857121860
1215,60898221,271041,61169262,0,0,0,256000,29,7571177894
1216,60906401,84565,60990966,0,5,0,5632,20,2290860203
1217,60928399,34367,60962766,0,5,1,56832,20,8926153775
1218,60928490,48980,60977470,0,9,0,2048,45,4489089058
1219,60954215,3422,60957637,0,1,1,3584,18,8339196214
1220,60987753,225944,61213697,0,5,0,184320,20,6514253262
1221,61008132,55304,61063436,0,8,1,94208,21,5888892443
1222,61113097,173573,61286670,0,0,0,85504,29,7239213892
1223,61194841,174995,61369836,0,8,1,287232,21,3124532288
1224,61197092,48980,61246072,0,6,0,2048,14,462295797
1225,61240589,2946,61243535,0,5,1,3072,20,8922266596
1226,61256139,5802,61261941,0,1,1,6144,18,2797310586
1227,61282312,126758,61409070,0,0,0,101888,29,5110990727
1228,61303420,1994,61305414,0,4,1,2048,12,4386357430
1229,61307160,68680,61375840,0,8,1,28672,21,3077474280
1230,61462987,130676,61593663,0,0,0,129024,29,6881230419
1231,61498686,136203,61634889,0,0,0,36352,29,3927779968
1232,61674840,13253,61688093,0,0,1,25600,29,1259142653
1233,61714652,23120,61737772,0,4,1,41472,12,3222575790
1234,61770108,32041,61802149,0,4,1,52224,12,6228766246
1235,61774886,127400,61902286,0,0,0,118272,29,1966934245
1236,61785834,150380,61936214,0,2,0,138240,14,2079592724
1237,61786122,47288,61833410,0,6,0,1536,14,6616444160
1238,61815897,25187,61841084,0,3,1,45568,37,6671323611
1239,61831006,4679,61835685,0,5,1,12288,20,28615649
1240,61843885,255498,62099383,0,5,0,118272,20,5675244981
1241,61989290,239000,62228290,0,2,0,267776,14,6651384110
1242,62033436,5196,62038632,0,0,1,13312,29,1784972558
1243,62074543,43904,62118447,0,6,0,512,14,1175909550
1244,62150870,218048,62368918,0,0,0,254464,29,9571247526
1245,62174166,566,62174732,0,1,1,512,18,3641592164
1246,62212492,60824,62273316,0,5,0,5632,20,5467575144
1247,62236554,1994,62238548,0,1,1,2048,18,6167786182
1248,62254984,5802,62260786,0,8,1,6144,21,1559380604
1249,62264181,566,62264747,0,8,1,512,21,9782252292
1250,62415058,10241,62425299,0,4,1,16384,12,8643921579
1251,62476875,4850,62481725,0,1,1,5120,18,4211389925
1252,62498374,2946,62501320,0,4,1,3072,12,10586502705
1253,62539476,2946,62542422,0,0,1,3072,29,9326068086
1254,62546294,4850,62551144,0,1,1,5120,18,5328797239
1255,62570058,81152,62651210,0,2,0,16896,14,7781758279
1256,62573303,5454,62578757,0,0,1,13824,29,5175010007
1257,62591627,4850,62596477,0,8,1,5120,21,5394774625
1258,62663869,1994,62665863,0,1,1,2048,18,7847128502
1259,62693440,112268,62805708,0,2,0,68608,14,9235655987
1260,62755230,279680,63034910,0,0,0,295424,29,9160115567
1261,62793357,2470,62795827,0,1,1,2560,18,4098620626
1262,62822075,33503,62855578,0,1,1,58368,18,463843849
1263,62830977,4420,62835397,0,8,1,11776,21,458034064
1264,62877008,3898,62880906,0,0,1,4096,29,4804661138
1265,62997147,120224,63117371,0,5,0,94720,20,8176608983
1266,63136233,5326,63141559,0,1,1,5632,18,1644058929
1267,63295591,6754,63302345,0,4,1,7168,12,5842010897
1268,63318720,26221,63344941,0,2,1,47616,14,10592894565
1269,63344439,14117,63358556,0,8,1,24064,21,10017193955
1270,63434199,6754,63440953,0,4,1,7168,12,4436906776
1271,63545350,14029,63559379,0,4,1,27136,12,2460661754
1272,63546341,190904,63737245,0,5,0,165376,20,1052490330
1273,63553019,98852,63651871,0,0,0,24576,29,142184601
1274,63645296,55547,63700843,0,0,0,2048,29,8327261579
1275,63674263,5454,63679717,0,8,1,13824,21,9914668928
1276,63714131,121958,63836089,0,5,0,24576,20,1277999216
1277,63792223,198548,63990771,0,0,0,190464,29,2208475747
1278,63926918,108212,64035130,0,0,0,55296,29,858852557
1279,63985509,6278,63991787,0,1,1,6656,18,8789291612
1280,64005355,209859,64215214,0,0,0,185344,29,5363234050
1281,64405658,218204,64623862,0,5,0,254976,20,7650609023
1282,64447468,248664,64696132,0,5,0,19968,20,3117503949
1283,64453216,211410,64664626,0,5,0,89088,20,5126604417
1284,64461967,5326,64467293,0,8,1,5632,21,7832924697
1285,64499439,3898,64503337,0,1,1,4096,18,3509679617
1286,64531156,5454,64536610,0,8,1,13824,21,9066570691
1287,64564254,11274,64575528,0,8,1,18432,21,8571554241
1288,64839346,2870,64842216,0,0,1,8704,29,10477048318
1289,64888126,10499,64898625,0,0,1,16896,29,8446206294
1290,64950305,10241,64960546,0,1,1,16384,18,6149880303
1291,65017893,2470,65020363,0,0,1,2560,29,9218613805
1292,65038969,6278,65045247,0,1,1,6656,18,3419895006
1293,65106869,6229,65113098,0,1,1,15360,18,2097724939
1294,65114120,5196,65119316,0,0,1,13312,29,5891951996
1295,65164422,3898,65168320,0,1,1,4096,18,5761604180
1296,65265662,6754,65272416,0,8,1,7168,21,8674557600
1297,65389737,3898,65393635,0,8,1,4096,21,1454608042
1298,65404547,12308,65416855,0,4,1,20480,12,5586034142
1299,65520191,3904,65524095,0,0,1,10752,29,989858395
1300,65595625,2470,65598095,0,1,1,2560,18,4636105813
1301,65703753,127868,65831621,0,5,0,119808,20,7538615873
1302,65758581,224576,65983157,0,5,0,156160,20,8747322293
1303,65778608,4937,65783545,0,0,1,12800,29,3076986664
1304,65859118,243103,66102221,0,5,0,211968,20,8637552619
1305,66206676,566,66207242,0,0,1,512,29,6870123546
1306,66418510,10499,66429009,0,1,1,16896,18,5280486683
1307,66473885,115232,66589117,0,5,0,78336,20,5715302310
1308,66491514,114523,66606037,0,5,0,17920,20,5374632602
1309,66523380,6754,66530134,0,5,1,7168,20,2926259971
1310,66639202,106028,66745230,0,0,0,48128,29,1497781911
1311,66671707,4420,66676127,0,0,1,11776,29,331810111
1312,66718117,6229,66724346,0,1,1,15360,18,3945798232
1313,66770553,5326,66775879,0,0,1,5632,29,1203648961
1314,66777635,57752,66835387,0,2,0,5632,14,9826406010
1315,66865216,1042,66866258,0,1,1,1024,18,5846689012
1316,66890977,10241,66901218,0,3,1,16384,37,10028585333
1317,66943667,14287,66957954,0,3,1,27648,37,5176413956
1318,66992444,4937,66997381,0,3,1,12800,37,10016499916
1319,67077800,48980,67126780,0,0,0,2048,29,9114583955
1320,67094060,211004,67305064,0,0,0,226304,29,10616255783
1321,67121822,22433,67144255,0,0,1,36864,29,8501823639
1322,67160634,5326,67165960,0,1,1,5632,18,132862838
1323,67316442,257792,67574234,0,5,0,279040,20,3282039562
1324,67367448,117104,67484552,0,0,0,84480,29,192095579
1325,67387513,43904,67431417,0,6,0,512,14,10556609027
1326,67394185,1518,67395703,0,0,1,1536,29,2819587987
1327,67394771,7706,67402477,0,0,1,8192,29,4892490172
1328,67426301,10499,67436800,0,0,1,16896,29,7688104973
1329,67477828,52364,67530192,0,6,0,3072,14,9837166985
1330,67489095,196930,67686025,0,0,0,46080,29,1711165833
1331,67611414,4850,67616264,0,0,1,5120,29,5073886965
1332,67640128,6278,67646406,0,4,1,6656,12,7725306988
1333,67701589,12566,67714155,0,0,1,20992,29,4981152205
1334,67708208,48980,67757188,0,6,0,2048,14,8095478526
1335,67776351,149912,67926263,0,0,0,136704,29,6745643428
1336,67903580,86751,67990331,0,0,0,11264,29,8903753552
1337,67977191,1042,67978233,0,0,1,1024,29,3941231688
1338,68040378,43904,68084282,0,6,0,512,14,1369548198
1339,68183934,64076,68248010,0,2,0,11264,14,652691574
1340,68282378,49448,68331826,0,6,0,3584,14,10245397944
1341,68319392,79436,68398828,0,0,0,11264,29,5726405924
1342,68391415,13600,68405015,0,3,1,23040,37,9797496888
1343,68455401,1994,68457395,0,0,1,2048,29,4946101630
1344,68458236,43904,68502140,0,6,0,512,14,9966830507
1345,68614630,479570,69094200,0,5,0,562176,20,2541152964
1346,68644028,480763,69124791,0,5,0,100352,20,4096637129
1347,68724878,1994,68726872,0,7,1,2048,40,8808154377
1348,68730143,11791,68741934,0,7,1,19456,40,3661391812
1349,68765297,12049,68777346,0,7,1,19968,40,2034621964
1350,68765573,396049,69161622,0,5,0,120832,20,7451978557
1351,68800612,5196,68805808,0,3,1,13312,37,7820851505
1352,68821651,126308,68947959,0,0,0,114688,29,7107928799
1353,68869705,7230,68876935,0,3,1,7680,37,5093696179
1354,68885917,402581,69288498,0,5,0,243712,20,923376666
1355,68892855,296862,69189717,0,5,0,92160,20,5058680395
1356,69053129,6754,69059883,0,3,1,7168,37,9369933740
1357,69061080,48980,69110060,0,6,0,2048,14,4521625480
1358,69136609,5326,69141935,0,7,1,5632,40,10095605475
1359,69190500,190904,69381404,0,0,0,165376,29,5525346234
1360,69240299,42166,69282465,0,0,1,68608,29,3524323901
1361,69249983,1518,69251501,0,7,1,1536,40,3492774915
1362,69271708,2470,69274178,0,3,1,2560,37,3176991685
1363,69346660,55748,69402408,0,6,0,4096,14,9764738900
1364,69377320,6070,69383390,0,0,1,2048,29,356027643
1365,69404744,24154,69428898,0,7,1,43520,40,1642964073
1366,69715535,43904,69759439,0,6,0,512,14,9316473933
1367,69803673,126464,69930137,0,0,0,115200,29,8355980857
1368,69962523,105248,70067771,0,0,0,45568,29,4984807100
1369,70167108,167144,70334252,0,0,0,142848,29,8269792743
1370,70382004,6488,70388492,0,0,1,15872,29,541742933
1371,70405112,122109,70527221,0,0,0,89088,29,2456342885
1372,70700821,58064,70758885,0,6,0,6656,14,7817599321
1373,70742282,52364,70794646,0,6,0,3072,14,874828086
1374,70772912,6278,70779190,0,0,1,6656,29,4320332335
1375,70810992,7706,70818698,0,9,1,8192,45,1334947994
1376,70853583,97604,70951187,0,0,0,20480,29,6665957013
1377,70940897,10305,70951202,0,0,1,13824,29,754713593
1378,70983370,52364,71035734,0,6,0,3072,14,4811469889
1379,71175612,4162,71179774,0,6,1,11264,14,5627644922
1380,71189037,3422,71192459,0,6,1,3584,14,953093071
1381,71208438,3645,71212083,0,0,1,10240,29,3521107160
1382,71247604,228227,71475831,0,0,0,172544,29,4442391790
1383,71345466,50672,71396138,0,6,0,2560,14,7415159596
1384,71360554,206816,71567370,0,5,0,217600,20,1668326375
1385,71632880,7706,71640586,0,0,1,8192,29,5564703247
1386,71899636,246080,72145716,0,0,0,270848,29,1201410065
1387,72189839,1518,72191357,0,2,1,1536,14,4799247352
1388,72240167,1518,72241685,0,4,1,1536,12,4381271272
1389,72265404,5454,72270858,0,2,1,13824,14,2968363707
1390,72302299,2946,72305245,0,2,1,3072,14,1806964979
1391,72321861,4937,72326798,0,2,1,12800,14,2982266869
1392,72360395,3128,72363523,0,2,1,9216,14,10254294008
1393,72407064,12308,72419372,0,6,1,20480,14,3726110171
1394,72480669,6754,72487423,0,2,1,7168,14,7283091763
1395,72544942,52364,72597306,0,6,0,3072,14,3949985646
1396,72755194,4850,72760044,0,2,1,5120,14,5283054209
1397,72787831,7706,72795537,0,7,1,8192,40,7251761832
1398,72805337,2870,72808207,0,6,1,8704,14,6441612862
1399,72865788,116480,72982268,0,0,0,82432,29,4751898786
1400,72951172,43904,72995076,0,6,0,512,14,1075858143
1401,72970946,3904,72974850,0,4,1,10752,12,5461049000
1402,73044713,3898,73048611,0,6,1,4096,14,8788073276
1403,73202287,10241,73212528,0,4,1,16384,12,8922775778
1404,73285550,5971,73291521,0,7,1,14848,40,2066211356
1405,73333682,62516,73396198,0,6,0,6144,14,5222067106
1406,73376614,4162,73380776,0,6,1,11264,14,5306778594
1407,73500219,123500,73623719,0,5,0,105472,20,8552143565
1408,73507261,20366,73527627,0,6,1,32768,14,8393531741
1409,73524616,3357,73527973,0,6,1,512,14,28933987
1410,73593674,4937,73598611,0,2,1,12800,14,7591237533
1411,73652944,13341,73666285,0,4,1,22528,12,1011717375
1412,73706645,23208,73729853,0,6,1,38400,14,8277827514
1413,73732608,2470,73735078,0,7,1,2560,40,8151301681
1414,73769355,13341,73782696,0,6,1,22528,14,6943732363
1415,73946968,2470,73949438,0,7,1,2560,40,8785429801
1416,74103599,15579,74119178,0,2,1,30208,14,2908912701
1417,74182435,52364,74234799,0,6,0,3072,14,5304506872
1418,74209861,6229,74216090,0,6,1,15360,14,7209965206
1419,74235867,3645,74239512,0,2,1,10240,14,5944327304
1420,74273039,2946,74275985,0,7,1,3072,40,6968418608
1421,74303707,5326,74309033,0,5,1,5632,20,10720685592
1422,74328628,2470,74331098,0,6,1,2560,14,252616567
1423,74509340,3422,74512762,0,3,1,3584,37,341139258
1424,74643200,206348,74849548,0,0,0,216064,29,8921197480
1425,74653086,42683,74695769,0,4,1,69632,12,5274603
1426,74750842,54056,74804898,0,6,0,3584,14,4727387789
1427,74784233,4850,74789083,0,7,1,5120,40,1865387362
1428,74788287,1994,74790281,0,4,1,2048,12,2003720629
1429,75116980,12825,75129805,0,4,1,21504,12,2843472666
1430,75363578,43904,75407482,0,6,0,512,14,2395291687
1431,75515520,146528,75662048,0,5,0,135680,20,1664154832
1432,75645993,102899,75748892,0,5,0,20480,20,7116568462
1433,75706702,5712,75712414,0,2,1,14336,14,5817993363
1434,75763467,194180,75957647,0,5,0,176128,20,6083649126
1435,75978748,56372,76035120,0,6,0,6144,14,1727155000
1436,76036869,120536,76157405,0,0,0,95744,29,1038599407
1437,76127706,25446,76153152,0,4,1,46080,12,126966924
1438,76169071,3128,76172199,0,4,1,9216,12,8309389810
1439,76442221,45596,76487817,0,6,0,1024,14,891734019
1440,76479450,2470,76481920,0,2,1,2560,14,2375980917
1441,76690093,673658,77363751,0,0,0,876544,29,7981664198
1442,76690197,3128,76693325,0,2,1,9216,14,9900222605
1443,76824376,5802,76830178,0,2,1,6144,14,4344450946
1444,76850331,482222,77332553,0,5,0,570880,20,1155949658
1445,77267660,181365,77449025,0,5,0,82432,20,3918628777
1446,77345414,6278,77351692,0,4,1,6656,12,203098906
1447,77357766,347165,77704931,0,5,0,371712,20,7202387518
1448,77380028,151004,77531032,0,0,0,140288,29,4560107091
1449,77615930,93413,77709343,0,5,1,11776,20,6344464934
1450,77636272,121472,77757744,0,0,0,98816,29,7487969439
1451,77706420,8894,77715314,0,5,1,7168,20,7744998068
1452,77756380,12995,77769375,0,4,1,25088,12,2151816266
1453,77788119,6488,77794607,0,4,1,15872,12,5255668040
1454,77858552,4679,77863231,0,6,1,12288,14,3991100908
1455,77859055,3904,77862959,0,4,1,10752,12,3654210151
1456,77925119,2470,77927589,0,4,1,2560,12,648907251
1457,77945079,5454,77950533,0,5,1,13824,20,6713669428
1458,77962226,1518,77963744,0,4,1,1536,12,10102342440
1459,78031821,293096,78324917,0,5,0,339456,20,10368097154
1460,78050741,5326,78056067,0,5,1,5632,20,1936761269
1461,78091728,65900,78157628,0,0,0,7168,29,9108656099
1462,78323385,7706,78331091,0,6,1,8192,14,476139647
1463,78346476,50239,78396715,0,6,0,2048,14,8622068501
1464,78348945,5196,78354141,0,4,1,13312,12,2584352234
1465,78389642,86852,78476494,0,0,0,20480,29,8096333059
1466,78423873,3422,78427295,0,5,1,3584,20,2317948377
1467,78441156,123110,78564266,0,6,0,44032,14,5872443853
1468,78442239,22174,78464413,0,6,1,36352,14,8330491288
1469,78453450,6278,78459728,0,4,1,6656,12,10368519438
1470,78611967,5712,78617679,0,4,1,14336,12,4279647146
1471,78614448,3387,78617835,0,6,1,9728,14,4154155791
1472,78660555,199640,78860195,0,6,0,194048,14,7470678190
1473,78706227,203312,78909539,0,6,0,56320,14,4233867143
1474,78801204,83912,78885116,0,6,1,45056,14,10028031970
1475,78904493,4937,78909430,0,4,1,12800,12,9477014304
1476,78910285,23895,78934180,0,6,1,43008,14,2482173308
1477,78933931,150846,79084777,0,6,0,47104,14,4090950009
1478,79032117,79148,79111265,0,5,0,15360,20,1620620183
1479,79090677,3128,79093805,0,6,1,9216,14,3483395650
1480,79213785,107588,79321373,0,0,0,53248,29,6701501951
1481,79220121,4937,79225058,0,4,1,12800,12,9979905909
1482,79240210,207908,79448118,0,5,0,221184,20,9916875906
1483,79307250,3128,79310378,0,6,1,9216,14,4699294140
1484,79382639,71273,79453912,0,5,1,6144,20,2232548369
1485,79438149,2470,79440619,0,6,1,2560,14,8082711822
1486,79620383,33591,79653974,0,6,1,55296,14,328021791
1487,79674644,6278,79680922,0,5,1,6656,20,6435203574
1488,79708833,107432,79816265,0,0,0,52736,29,2381258632
1489,79711914,7706,79719620,0,5,1,8192,20,10319018186
1490,79876505,21916,79898421,0,4,1,35840,12,4701083753
1491,79916209,3904,79920113,0,4,1,10752,12,5362219371
1492,80048422,218672,80267094,0,6,0,256512,14,7999232670
1493,80136282,4679,80140961,0,5,1,12288,20,8102221446
1494,80208386,3387,80211773,0,4,1,9728,12,7757065339
1495,80346982,128024,80475006,0,0,0,120320,29,9958015123
1496,80423571,2946,80426517,0,4,1,3072,12,3624600036
1497,80514574,86852,80601426,0,0,0,20480,29,8075220227
1498,80585267,24929,80610196,0,4,1,45056,12,4857815940
1499,80636665,86696,80723361,0,6,0,19968,14,10055429133
1500,80743728,45437,80789165,0,5,1,78336,20,9897599099
1501,80845858,6754,80852612,0,4,1,7168,12,3409197404
1502,81058471,566,81059037,0,5,1,512,20,4959167174
1503,81058599,10576,81069175,0,5,1,16896,20,6471630927
1504,81230467,3422,81233889,0,9,1,3584,45,98601470
1505,81292046,6278,81298324,0,5,1,6656,20,5882987328
1506,81292800,13341,81306141,0,4,1,22528,12,8647685660
1507,81313876,5196,81319072,0,9,1,13312,45,8033804442
1508,81329212,62984,81392196,0,5,0,7680,20,1656690717
1509,81356232,23466,81379698,0,4,1,38912,12,980204789
1510,81367107,279524,81646631,0,6,0,294912,14,9761155531
1511,81471456,101192,81572648,0,0,0,32256,29,322326651
1512,81508967,6754,81515721,0,5,1,7168,20,4000135900
1513,81526994,5802,81532796,0,5,1,6144,20,8243627575
1514,81528857,11332,81540189,0,5,1,18432,20,3954964620
1515,81578734,354248,81932982,0,0,0,409088,29,197256742
1516,81613933,10757,81624690,0,3,1,17408,37,6059071522
1517,81673396,4850,81678246,0,1,1,5120,18,1226201538
1518,81711956,6754,81718710,0,9,1,7168,45,7463544821
1519,81728273,5326,81733599,0,4,1,5632,12,1941087335
1520,81737562,6278,81743840,0,5,1,6656,20,4588894987
1521,81768684,3387,81772071,0,9,1,9728,45,4584305198
1522,81876227,61426,81937653,0,0,1,12288,29,5989428688
1523,81941375,48980,81990355,0,6,0,2048,14,4194190320
1524,81953640,105716,82059356,0,4,0,47104,12,1027530585
1525,82065492,3904,82069396,0,4,1,10752,12,4386912642
1526,82099518,6229,82105747,0,3,1,15360,37,1278594235
1527,82144087,5196,82149283,0,4,1,13312,12,4761084684
1528,82172029,100568,82272597,0,0,0,30208,29,1780383536
1529,82234205,223780,82457985,0,0,0,177664,29,2052909056
1530,82338142,170141,82508283,0,0,0,119808,29,10717444662
1531,82385704,7706,82393410,0,4,1,8192,12,9257052944
1532,82396028,129715,82525743,0,0,0,28672,29,9686760539
1533,82535996,121784,82657780,0,0,0,99840,29,1428240567
1534,82561447,4374,82565821,0,4,1,4608,12,5633693089
1535,82619560,1994,82621554,0,9,1,2048,45,3513546011
1536,82748785,12825,82761610,0,0,1,21504,29,6131207728
1537,82852104,6229,82858333,0,9,1,15360,45,6379008798
1538,82916268,185756,83102024,0,5,0,148480,20,1230961216
1539,83144270,12308,83156578,0,9,1,20480,45,5391697793
1540,83370547,377504,83748051,0,5,0,455168,20,5345945399
1541,83460862,305620,83766482,0,5,0,60416,20,753672372
1542,83471286,4937,83476223,0,5,1,12800,20,10324169904
1543,83483342,6229,83489571,0,0,1,15360,29,1482836088
1544,83501139,7706,83508845,0,5,1,8192,20,401363340
1545,83503250,16530,83519780,0,5,1,31232,20,5975230468
1546,83620465,113360,83733825,0,0,0,72192,29,6644210663
1547,83673848,5971,83679819,0,9,1,14848,45,9824215905
1548,83700144,158607,83858751,0,5,0,63488,20,4611348742
1549,83760658,5802,83766460,0,0,1,6144,29,3985763391
1550,84036751,3387,84040138,0,9,1,9728,45,1321618353
1551,84084253,125060,84209313,0,0,0,110592,29,5547330372
1552,84188360,107588,84295948,0,5,0,53248,20,2370218678
1553,84307846,111332,84419178,0,5,0,65536,20,8525594848
1554,84375155,99320,84474475,0,5,0,26112,20,8821470868
1555,84434421,31524,84465945,0,3,1,51200,37,7891071792
1556,84461427,5798,84467225,0,3,1,14336,37,265509060
1557,84469658,3645,84473303,0,0,1,10240,29,1615314074
1558,84514785,2946,84517731,0,3,1,3072,37,3620519175
1559,84555617,6229,84561846,0,3,1,15360,37,3058449800
1560,84587949,203696,84791645,0,4,0,207360,12,2777377263
1561,84695029,1042,84696071,0,0,1,1024,29,9209572827
1562,84803420,281396,85084816,0,5,0,301056,20,4872895909
1563,84806349,1042,84807391,0,0,1,1024,29,2776500581
1564,84847664,10757,84858421,0,0,1,17408,29,3100974224
1565,84931636,2870,84934506,0,0,1,8704,29,4516036599
1566,84938850,20882,84959732,0,3,1,33792,37,2222838930
1567,84980891,13341,84994232,0,4,1,22528,12,2073458059
1568,85165847,4374,85170221,0,0,1,4608,29,9296382913
1569,85212949,5326,85218275,0,0,1,5632,29,6837079137
1570,85249380,169016,85418396,0,9,0,148992,45,9863337550
1571,85264512,47600,85312112,0,1,0,2560,18,5657782780
1572,85271449,3422,85274871,0,3,1,3584,37,9724820296
1573,85355354,45908,85401262,0,0,0,2048,29,9100443034
1574,85365198,4162,85369360,0,4,1,11264,12,1101487022
1575,85446831,4850,85451681,0,9,1,5120,45,7117165204
1576,85513903,16096,85529999,0,4,1,31232,12,718500877
1577,85540599,13512,85554111,0,3,1,26112,37,6359183143
1578,85762711,98072,85860783,0,0,0,22016,29,5788933310
1579,85785874,95156,85881030,0,9,0,22528,45,8035668078
1580,85851280,25446,85876726,0,0,1,46080,29,7804329590
1581,85996341,3422,85999763,0,5,1,3584,20,7742808313
1582,86013552,4937,86018489,0,3,1,12800,37,2819542676
1583,86085493,1042,86086535,0,3,1,1024,37,8144736728
1584,86139658,6229,86145887,0,4,1,15360,12,2467528639
1585,86160615,6488,86167103,0,3,1,15872,37,3672486199
1586,86348408,188720,86537128,0,5,0,158208,20,9705014779
1587,86454509,14804,86469313,0,9,1,28672,45,6363512835
1588,86470588,3904,86474492,0,5,1,10752,20,243421777
1589,86583782,10241,86594023,0,0,1,16384,29,2289673475
1590,86615395,2470,86617865,0,4,1,2560,12,7110000949
1591,86662021,118976,86780997,0,0,0,90624,29,10186551907
1592,86671483,3904,86675387,0,5,1,10752,20,5368430364
1593,86677301,180416,86857717,0,9,0,156160,45,4303732200
1594,86694169,5454,86699623,0,4,1,13824,12,7821516738
1595,86741261,153626,86894887,0,9,0,50176,45,4247750857
1596,86796319,200888,86997207,0,5,0,198144,20,8222351502
1597,86812843,205724,87018567,0,0,0,214016,29,9688337252
1598,87026371,7706,87034077,0,9,1,8192,45,5115655198
1599,87062483,1994,87064477,0,1,1,2048,18,5719031270
1600,87095922,6278,87102200,0,3,1,6656,37,3700691466
1601,87097435,10805,87108240,0,3,1,16384,37,2805044252
1602,87130708,7706,87138414,0,4,1,8192,12,6635046653
1603,87144584,12566,87157150,0,1,1,20992,18,7890341788
1604,87231898,52364,87284262,0,0,0,3072,29,9637074897
1605,87277118,4850,87281968,0,2,1,5120,14,9429350919
1606,87308944,4850,87313794,0,3,1,5120,37,4216900176
1607,87311119,101816,87412935,0,0,0,34304,29,7477235724
1608,87328647,5802,87334449,0,1,1,6144,18,4445541126
1609,87359719,277118,87636837,0,0,0,178688,29,6268363325
1610,87372415,139154,87511569,0,0,0,130048,29,3027761285
1611,87445310,114140,87559450,0,5,0,74752,20,5567582218
1612,87533138,1518,87534656,0,9,1,1536,45,9509555901
1613,87543618,227632,87771250,0,5,0,233984,20,3110181160
1614,87589041,150540,87739581,0,0,0,37376,29,4890070225
1615,87604433,1518,87605951,0,4,1,1536,12,33577028
1616,87734375,406883,88141258,0,5,0,430592,20,10727018648
1617,87767225,12308,87779533,0,9,1,20480,45,4820210351
1618,87799187,215739,88014926,0,9,0,57344,45,2955131243
1619,87817785,5712,87823497,0,9,1,14336,45,588894099
1620,87822268,1518,87823786,0,5,1,1536,20,6743637310
1621,87915611,4420,87920031,0,5,1,11776,20,4036928670
1622,87937234,43628,87980862,0,4,1,74752,12,1976640772
1623,87982510,118664,88101174,0,0,0,89600,29,1253918773
1624,88056516,92482,88148998,0,5,1,8192,20,9871149321
1625,88063992,1994,88065986,0,4,1,2048,12,4813127957
1626,88103505,45749,88149254,0,5,1,9216,20,5179864370
1627,88126280,30815,88157095,0,5,1,16896,20,8328315181
1628,88209115,6278,88215393,0,5,1,6656,20,10084452777
1629,88357788,5196,88362984,0,6,1,13312,14,5423034280
1630,88403945,1042,88404987,0,9,1,1024,45,6845033189
1631,88493715,1042,88494757,0,5,1,1024,20,9816246778
1632,88494211,236429,88730640,0,5,0,137216,20,5060522957
1633,88536348,15062,88551410,0,4,1,29184,12,4185916421
1634,88766651,99788,88866439,0,5,0,27648,20,1744417258
1635,88775179,2870,88778049,0,9,1,8704,45,8327138690
1636,88839028,4374,88843402,0,1,1,4608,18,10521837716
1637,88872584,48980,88921564,0,9,0,2048,45,7334028893
1638,88991272,481754,89473026,0,5,0,569344,20,5074874727
1639,89057742,32987,89090729,0,9,1,57344,45,2630436502
1640,89132077,4937,89137014,0,9,1,12800,45,925850005
1641,89263781,566,89264347,0,6,1,512,14,4917839069
1642,89285022,1042,89286064,0,9,1,1024,45,6199325043
1643,89464351,3645,89467996,0,1,1,10240,18,1261775627
1644,89518341,366740,89885081,0,5,0,419840,20,7397440779
1645,89596445,119756,89716201,0,0,0,93184,29,3010176742
1646,89623046,271878,89894924,0,5,0,32256,20,99899335
1647,89663352,128725,89792077,0,0,0,77824,29,1775211151
1648,89694539,264674,89959213,0,0,0,165376,29,3443672904
1649,89696080,5196,89701276,0,6,1,13312,14,4748417519
1650,89728344,244187,89972531,0,5,0,179200,20,5605500092
1651,89781240,3422,89784662,0,9,1,3584,45,110738035
1652,89797120,1994,89799114,0,9,1,2048,45,8436851910
1653,90011887,1518,90013405,0,9,1,1536,45,753463239
1654,90050488,97160,90147648,0,5,0,24064,20,10316364444
1655,90081228,11274,90092502,0,6,1,18432,14,4144860749
1656,90290643,112892,90403535,0,5,0,70656,20,3337320126
1657,90520916,103376,90624292,0,5,0,39424,20,8888980374
1658,90579046,3645,90582691,0,9,1,10240,45,10488599862
1659,90610921,5802,90616723,0,9,1,6144,45,7593330640
1660,90618870,12825,90631695,0,9,1,21504,45,1263223890
1661,90649572,121316,90770888,0,5,0,98304,20,7481902874
1662,90920694,79436,91000130,0,5,0,11264,20,7147170400
1663,90922001,114452,91036453,0,0,0,75776,29,2260919791
1664,90940623,5196,90945819,0,6,1,13312,14,10695994865
1665,91003852,95024,91098876,0,9,0,27136,45,3376976898
1666,91089988,101036,91191024,0,9,0,31744,45,7181212994
1667,91134348,3387,91137735,0,9,1,9728,45,5151138905
1668,91163300,125996,91289296,0,0,0,113664,29,5540510575
1669,91206185,1518,91207703,0,2,1,1536,14,3877695651
1670,91224609,110396,91335005,0,5,0,62464,20,3040315032
1671,91233629,34795,91268424,0,9,1,60928,45,5577156258
1672,91250186,18597,91268783,0,9,1,9728,45,2192639683
1673,91333755,4937,91338692,0,2,1,12800,14,5732668672
1674,91366663,5971,91372634,0,4,1,14848,12,10424146652
1675,91379453,2946,91382399,0,9,1,3072,45,2689465521
1676,91408411,4374,91412785,0,4,1,4608,12,3733610660
1677,91447237,5196,91452433,0,4,1,13312,12,450751595
1678,91511434,302924,91814358,0,0,0,371712,29,6564782586
1679,91529759,5802,91535561,0,2,1,6144,14,7051448345
1680,91777129,25446,91802575,0,4,1,46080,12,2761620399
1681,91786896,85292,91872188,0,5,0,15360,20,5486136057
1682,91817179,13512,91830691,0,9,1,26112,45,826353638
1683,91937604,4374,91941978,0,9,1,4608,45,1799746349
1684,92081742,3645,92085387,0,4,1,10240,12,8940422889
1685,92164410,103532,92267942,0,9,0,39936,45,9703995470
1686,92176470,21916,92198386,0,4,1,35840,12,10171320768
1687,92230628,112424,92343052,0,5,0,69120,20,9045776650
1688,92504358,125840,92630198,0,5,0,113152,20,6082060462
1689,92525390,11533,92536923,0,2,1,18944,14,6653030860
1690,92706616,2470,92709086,0,1,1,2560,18,7032151055
1691,92748187,99164,92847351,0,9,0,25600,45,7408382224
1692,92886269,74672,92960941,0,5,0,10752,20,10567442920
1693,92982138,14287,92996425,0,2,1,27648,14,3885826806
1694,93132584,4420,93137004,0,2,1,11776,14,10225897508
1695,93182694,6229,93188923,0,2,1,15360,14,1901247571
1696,93245513,190124,93435637,0,5,0,162816,20,10055371261
1697,93317355,7706,93325061,0,3,1,8192,37,210341246
1698,93356926,6488,93363414,0,2,1,15872,14,1034885511
1699,93432873,3387,93436260,0,3,1,9728,37,8689793163
1700,93436843,16613,93453456,0,4,1,32256,12,9546373897
1701,93497403,116168,93613571,0,9,0,81408,45,8786131304
1702,93672222,3422,93675644,0,2,1,3584,14,1177292481
1703,93738519,16354,93754873,0,2,1,31744,14,6820366907
1704,93774829,106652,93881481,0,5,0,50176,20,1610067605
1705,93801905,1994,93803899,0,3,1,2048,37,9136307486
1706,93903543,1042,93904585,0,3,1,1024,37,2102106929
1707,94016332,566,94016898,0,3,1,512,37,7424326903
1708,94159375,110708,94270083,0,9,0,63488,45,4886568304
1709,94395627,3898,94399525,0,2,1,4096,14,5934080463
1710,94396730,97940,94494670,0,5,0,26624,20,10491102236
1711,94406040,21399,94427439,0,2,1,34816,14,6896416117
1712,94553884,43904,94597788,0,5,0,512,20,3749447912
1713,94639253,377036,95016289,0,9,0,453632,45,3961968236
1714,94921153,393060,95314213,0,9,0,355328,45,4738613777
1715,95203521,5802,95209323,0,2,1,6144,14,3722866090
1716,95499504,1042,95500546,0,2,1,1024,14,7898363482
1717,95558064,142232,95700296,0,4,0,136704,12,8308946423
1718,95842768,4162,95846930,0,2,1,11264,14,10193897350
1719,96217461,100256,96317717,0,4,0,29184,12,7181779004
1720,96458916,99788,96558704,0,9,0,27648,45,834692255
1721,96581651,200108,96781759,0,5,0,195584,20,7705166035
1722,96651840,11791,96663631,0,2,1,19456,14,4268637888
1723,96807397,502190,97309587,0,5,0,636416,20,1927242645
1724,96930165,198548,97128713,0,4,0,190464,12,2702865182
1725,97007392,6278,97013670,0,4,1,6656,12,6685953675
1726,97032230,111644,97143874,0,9,0,66560,45,9622570872
1727,97136710,206016,97342726,0,9,0,191488,45,9712662581
1728,97188869,244810,97433679,0,5,0,102400,20,2120133239
1729,97293272,195049,97488321,0,5,0,53760,20,7605028930
1730,97294135,107744,97401879,0,4,0,53760,12,9421403926
1731,97355438,115357,97470795,0,5,0,10240,20,5123082458
1732,97368761,211174,97579935,0,4,0,177152,12,8747986918
1733,97433508,566,97434074,0,8,1,512,21,2623445700
1734,97495242,1518,97496760,0,5,1,1536,20,9594466826
1735,97506798,6754,97513552,0,2,1,7168,14,10243351128
1736,97548567,31266,97579833,0,5,1,50688,20,7721677364
1737,97646847,148485,97795332,0,5,0,89600,20,6379607695
1738,97914183,112736,98026919,0,9,0,70144,45,278820337
1739,97952617,195740,98148357,0,5,0,181248,20,5085866890
1740,97961799,5454,97967253,0,4,1,13824,12,3848867509
1741,97978236,4420,97982656,0,4,1,11776,12,1588085911
1742,97995261,15579,98010840,0,2,1,30208,14,5213719050
1743,97997455,15331,98012786,0,2,1,3072,14,1183258048
1744,98162198,12049,98174247,0,8,1,19968,21,5551801212
1745,98207323,22433,98229756,0,5,1,36864,20,3975261326
1746,98258928,5196,98264124,0,2,1,13312,14,7655541374
1747,98347387,107432,98454819,0,5,0,52736,20,1292819960
1748,98372203,12737,98384940,0,7,1,24576,40,8216192595
1749,98428542,15837,98444379,0,7,1,30720,40,3760277657
1750,98468764,10757,98479521,0,5,1,17408,20,3827930393
1751,98620904,3904,98624808,0,2,1,10752,14,2675392805
1752,98622540,4817,98627357,0,2,1,9216,14,5393395928
1753,98650947,3422,98654369,0,2,1,3584,14,10149869207
1754,98658547,13341,98671888,0,7,1,22528,40,2787293350
1755,98711162,6754,98717916,0,5,1,7168,20,9475965514
1756,98777453,4679,98782132,0,7,1,12288,40,2060789746
1757,98787730,151628,98939358,0,4,0,142336,12,6003129810
1758,98799862,115700,98915562,0,9,0,79872,45,2947698510
1759,98805940,21916,98827856,0,2,1,35840,14,2362640657
1760,98946322,3645,98949967,0,9,1,10240,45,2671863689
1761,98955756,3387,98959143,0,9,1,9728,45,9831084218
1762,99014641,214184,99228825,0,9,0,171520,45,4750868893
1763,99027226,6278,99033504,0,2,1,6656,14,9740477795
1764,99275715,13600,99289315,0,9,1,23040,45,7219450781
1765,99295332,4850,99300182,0,7,1,5120,40,5998507553
1766,99315011,3898,99318909,0,4,1,4096,12,6114791888
1767,99317163,4679,99321842,0,5,1,12288,20,9407026525
1768,99346108,1042,99347150,0,1,1,1024,18,6018723280
1769,99362329,189968,99552297,0,9,0,162304,45,911481040
1770,99363121,2946,99366067,0,5,1,3072,20,10700714896
1771,99419615,215084,99634699,0,5,0,244736,20,5704190178
1772,99470695,14545,99485240,0,4,1,28160,12,5235627527
1773,99506365,98852,99605217,0,4,0,24576,12,2927450170
1774,99711926,3128,99715054,0,5,1,9216,20,3112259018
1775,99777914,3898,99781812,0,5,1,4096,20,6412334082
1776,99808440,62828,99871268,0,5,0,7168,20,6701325169
1777,99842667,4374,99847041,0,2,1,4608,14,1245385266
1778,99957458,13600,99971058,0,9,1,23040,45,3385561112
1779,100029618,222446,100252064,0,9,0,202240,45,6907772458
1780,100032537,172244,100204781,0,5,0,149504,20,9832986213
1781,100251254,566,100251820,0,5,1,512,20,6789014939
1782,100258927,3904,100262831,0,0,1,10752,29,7425300832
1783,100281203,10757,100291960,0,4,1,17408,12,7098318917
1784,100302625,7706,100310331,0,6,1,8192,14,2189416967
1785,100354783,16096,100370879,0,7,1,31232,40,2061323517
1786,100442557,12308,100454865,0,5,1,20480,20,1667553377
1787,100469483,98096,100567579,0,4,0,27136,12,5612766408
1788,100480848,14029,100494877,0,9,1,27136,45,3043179661
1789,100541225,25962,100567187,0,2,1,47104,14,9857719528
1790,100554433,104936,100659369,0,4,0,44544,12,9058604891
1791,100623412,14545,100637957,0,7,1,28160,40,7991958745
1792,100646555,133342,100779897,0,4,0,95744,12,603978609
1793,100677687,25446,100703133,0,5,1,46080,20,8093577928
1794,100693145,5971,100699116,0,9,1,14848,45,463477543
1795,100736979,170519,100907498,0,9,0,124928,45,8002184013
1796,100800506,23983,100824489,0,2,1,39936,14,10110517725
1797,100871276,37774,100909050,0,9,1,1536,45,4934088747
1798,100878472,34378,100912850,0,9,1,5120,45,5580471787
1799,100886315,26689,100913004,0,9,1,8704,45,6733354357
1800,100934261,6278,100940539,0,9,1,6656,45,4743415212
1801,101095060,6278,101101338,0,0,1,6656,29,3870084651
1802,101097958,5971,101103929,0,9,1,14848,45,4161927887
1803,101168906,7706,101176612,0,7,1,8192,40,3199526843
1804,101197478,14804,101212282,0,0,1,28672,29,6951373237
1805,101217385,196520,101413905,0,4,0,183808,12,1332299982
1806,101288741,3422,101292163,0,0,1,3584,29,4853655349
1807,101291866,5196,101297062,0,5,1,13312,20,9072660151
1808,101313354,102602,101415956,0,4,0,6656,12,246346501
1809,101318246,3422,101321668,0,5,1,3584,20,9825022486
1810,101352112,102440,101454552,0,4,0,36352,12,5672382739
1811,101397518,135309,101532827,0,5,0,86528,20,2537002605
1812,101398093,19816,101417909,0,4,1,2048,12,3608234408
1813,101448461,89707,101538168,0,4,0,19968,12,5467656967
1814,101463649,79233,101542882,0,5,0,3584,20,5137544834
1815,101539747,3387,101543134,0,9,1,9728,45,1855709586
1816,101622538,566,101623104,0,2,1,512,14,6844017641
1817,101627432,30491,101657923,0,5,1,49152,20,3769183234
1818,101645033,2946,101647979,0,7,1,3072,40,8888415845
1819,101680241,141936,101822177,0,5,0,101888,20,5381044605
1820,101697738,104780,101802518,0,9,0,44032,45,3454118370
1821,101828054,3422,101831476,0,7,1,3584,40,6633125648
1822,101861265,2946,101864211,0,7,1,3072,40,7496170270
1823,101933755,177452,102111207,0,9,0,146432,45,9133028641
1824,101998299,3898,102002197,0,5,1,4096,20,3712793606
1825,102018665,6278,102024943,0,7,1,6656,40,36682357
1826,102056612,5802,102062414,0,0,1,6144,29,1109014538
1827,102095430,47600,102143030,0,5,0,2560,20,9339800794
1828,102095525,4374,102099899,0,5,1,4608,20,10193763553
1829,102160495,2946,102163441,0,7,1,3072,40,4384287012
1830,102271563,6278,102277841,0,7,1,6656,40,8470701360
1831,102293326,3128,102296454,0,2,1,9216,14,8703821245
1832,102312430,3898,102316328,0,7,1,4096,40,8264857055
1833,102348767,3422,102352189,0,9,1,3584,45,8833713232
1834,102467091,11016,102478107,0,9,1,17920,45,347124993
1835,102501309,3904,102505213,0,7,1,10752,40,2748978193
1836,102508285,6754,102515039,0,5,1,7168,20,9996137989
1837,102617807,99476,102717283,0,9,0,26624,45,9073793140
1838,102814182,3898,102818080,0,5,1,4096,20,8137267309
1839,102930166,5196,102935362,0,4,1,13312,12,5777450344
1840,103098247,3422,103101669,0,4,1,3584,12,9617550882
1841,103133562,106652,103240214,0,9,0,50176,45,3108900423
1842,103201364,102284,103303648,0,5,0,35840,20,3316179562
1843,103244537,4850,103249387,0,9,1,5120,45,4194306860
1844,103286828,103688,103390516,0,9,0,40448,45,7212904265
1845,103335249,2946,103338195,0,7,1,3072,40,2141906546
1846,103402518,64232,103466750,0,9,0,11776,45,6159557458
1847,103426019,7706,103433725,0,7,1,8192,40,7666396788
1848,103454995,11533,103466528,0,5,1,18944,20,9813202605
1849,103532610,20882,103553492,0,5,1,33792,20,7770607726
1850,103542264,14454,103556718,0,5,1,5120,20,9108849245
1851,103558110,21141,103579251,0,9,1,34304,45,7456827006
1852,103661077,171014,103832091,0,9,0,79360,45,10557549593
1853,103668664,11791,103680455,0,7,1,19456,40,3780927431
1854,103775962,3422,103779384,0,7,1,3584,40,3648830843
1855,103833184,12049,103845233,0,5,1,19968,20,4569799296
1856,103872230,98096,103970326,0,5,0,27136,20,1879766058
1857,103891173,1518,103892691,0,0,1,1536,29,10127249448
1858,103931335,104000,104035335,0,9,0,41472,45,7661519746
1859,103953353,4679,103958032,0,0,1,12288,29,1835908930
1860,104099373,11533,104110906,0,7,1,18944,40,5432099076
1861,104180501,1042,104181543,0,0,1,1024,29,5600329429
1862,104270328,7230,104277558,0,7,1,7680,40,5117570985
1863,104333304,207923,104541227,0,5,0,97280,20,6913386917
1864,104345807,165765,104511572,0,5,0,123904,20,4144696194
1865,104415167,5196,104420363,0,7,1,13312,40,4831543901
1866,104674218,2470,104676688,0,3,1,2560,37,10482916207
1867,104692871,6278,104699149,0,7,1,6656,40,9102686596
1868,104770540,2946,104773486,0,0,1,3072,29,7842359412
1869,104829226,1518,104830744,0,0,1,1536,29,8208724345
1870,104871495,101036,104972531,0,5,0,31744,20,3224670541
1871,104921816,1042,104922858,0,7,1,1024,40,2731996049
1872,104933534,6229,104939763,0,7,1,15360,40,1422068520
1873,104943592,1042,104944634,0,0,1,1024,29,6710440124
1874,105129046,2470,105131516,0,7,1,2560,40,2001869447
1875,105178583,146528,105325111,0,9,0,135680,45,2240336170
1876,105355401,4162,105359563,0,7,1,11264,40,1852893786
1877,105362446,3128,105365574,0,0,1,9216,29,5455746069
1878,105402800,210560,105613360,0,5,0,229888,20,3183276737
1879,105540020,6229,105546249,0,6,1,15360,14,6369049598
1880,105576517,87507,105664024,0,5,0,2560,20,10458971263
1881,105677538,103532,105781070,0,9,0,39936,45,1212217870
1882,105680324,78836,105759160,0,5,0,14336,20,73277707
1883,105952311,5326,105957637,0,5,1,5632,20,2624598918
1884,106139552,193556,106333108,0,5,0,174080,20,8651113506
1885,106329739,120380,106450119,0,9,0,95232,45,809120496
1886,106399436,4850,106404286,0,5,1,5120,20,1714586215
1887,106402728,3128,106405856,0,5,1,9216,20,8871930038
1888,106557470,191684,106749154,0,9,0,167936,45,1978009889
1889,106835471,195584,107031055,0,9,0,180736,45,10402750325
1890,106846709,189500,107036209,0,5,0,160768,20,4035666619
1891,107111371,151316,107262687,0,9,0,141312,45,6082970354
1892,107534268,121004,107655272,0,9,0,97280,45,8431291137
1893,107703588,286388,107989976,0,9,0,317440,45,5977977397
1894,107737605,284834,108022439,0,9,0,106496,45,10198807440
1895,108020568,14287,108034855,0,5,1,27648,20,100816231
1896,108096583,157850,108254433,0,5,0,14848,20,7205575779
1897,108191865,95118,108286983,0,5,0,4608,20,6918123563
1898,108219591,4850,108224441,0,0,1,5120,29,9998819451
1899,108246325,210248,108456573,0,5,0,228864,20,350587837
1900,108380940,1518,108382458,0,4,1,1536,12,7878252519
1901,108400155,12737,108412892,0,3,1,24576,37,9018317550
1902,108529627,2946,108532573,0,5,1,3072,20,421697745
1903,108586040,115232,108701272,0,9,0,78336,45,8165003971
1904,108638142,63145,108701287,0,9,1,95232,45,9871287633
1905,108933944,202760,109136704,0,5,0,204288,20,6808493621
1906,108937246,1518,108938764,0,6,1,1536,14,2670055235
1907,109204447,3898,109208345,0,6,1,4096,14,3275711053
1908,109209860,1994,109211854,0,5,1,2048,20,1646795543
1909,109211959,263170,109475129,0,5,0,219136,20,8091605535
1910,109232667,125684,109358351,0,9,0,112640,45,5001175608
1911,109315304,175596,109490900,0,5,0,51712,20,10580790669
1912,109420883,21399,109442282,0,6,1,34816,14,1817393653
1913,109477138,107276,109584414,0,9,0,52224,45,6490896017
1914,109521144,16354,109537498,0,3,1,31744,37,529413368
1915,109643633,114140,109757773,0,9,0,74752,45,10199310160
1916,109899746,112580,110012326,0,9,0,69632,45,6723490060
1917,109910240,15579,109925819,0,6,1,30208,14,2583154859
1918,109920801,10757,109931558,0,3,1,17408,37,10646010849
1919,109959595,3898,109963493,0,6,1,4096,14,9256229455
1920,110035847,23466,110059313,0,6,1,38912,14,238982496
1921,110055773,22950,110078723,0,5,1,37888,20,9146541334
1922,110080616,153482,110234098,0,5,0,84992,20,7505465058
1923,110092209,4937,110097146,0,3,1,12800,37,893630631
1924,110114219,186560,110300779,0,9,0,156160,45,453780769
1925,110163638,132060,110295698,0,5,0,19456,20,921108812
1926,110198180,3128,110201308,0,6,1,9216,14,7963710099
1927,110219279,463956,110683235,0,5,1,731136,20,2689163970
1928,110262272,158255,110420527,0,9,0,93184,45,4422959093
1929,110310555,4420,110314975,0,3,1,11776,37,9758600028
1930,110408789,4850,110413639,0,3,1,5120,37,8606331053
1931,110421885,205880,110627765,0,9,0,214528,45,4082066006
1932,110433562,383285,110816847,0,5,1,426496,20,9323734058
1933,110449769,34279,110484048,0,9,1,59904,45,7610360278
1934,110564530,2470,110567000,0,3,1,2560,37,9320118770
1935,110569412,13770,110583182,0,6,1,26624,14,10686477758
1936,110647396,5326,110652722,0,3,1,5632,37,4861084103
1937,110668761,7706,110676467,0,4,1,8192,12,6684870888
1938,110707453,11533,110718986,0,3,1,18944,37,5256524821
1939,110756813,11274,110768087,0,3,1,18432,37,7361171147
1940,110810037,162632,110972669,0,5,1,263168,20,3318673000
1941,110813220,7706,110820926,0,6,1,8192,14,2817396465
1942,110831198,245339,111076537,0,5,1,302592,20,8598658746
1943,110863422,275172,111138594,0,5,1,198656,20,117213392
1944,111040828,6278,111047106,0,6,1,6656,14,9791410429
1945,111121961,120224,111242185,0,9,0,94720,45,4810592234
1946,111202899,5971,111208870,0,4,1,14848,12,3960559077
1947,111277684,6278,111283962,0,4,1,6656,12,2667799334
1948,111371790,193051,111564841,0,5,0,172032,20,6286705159
1949,111378918,109928,111488846,0,9,0,60928,45,9040799898
1950,111391929,205999,111597928,0,5,0,108544,20,6847770929
1951,111447988,7706,111455694,0,3,1,8192,37,256985205
1952,111489508,13600,111503108,0,4,1,23040,12,1920192619
1953,111601757,246392,111848149,0,5,0,271872,20,7665558030
1954,111761787,3387,111765174,0,4,1,9728,12,6342107777
1955,111890019,4937,111894956,0,2,1,12800,14,10000931284
1956,111931610,1042,111932652,0,3,1,1024,37,7636652943
1957,112037611,33333,112070944,0,4,1,54784,12,9875697570
1958,112146655,6754,112153409,0,7,1,7168,40,9965957045
1959,112147040,72380,112219420,0,5,0,13312,20,4168620877
1960,112199014,566,112199580,0,6,1,512,14,8881044876
1961,112372461,143144,112515605,0,5,0,134656,20,1582146982
1962,112434032,3128,112437160,0,3,1,9216,37,2948801775
1963,112439823,6229,112446052,0,7,1,15360,40,4305727512
1964,112540642,5802,112546444,0,7,1,6144,40,764571024
1965,112577146,115020,112692166,0,5,1,190464,20,7802374243
1966,112726816,266152,112992968,0,5,0,221184,20,9167181284
1967,112846606,2946,112849552,0,3,1,3072,37,5580306748
1968,112895648,6488,112902136,0,6,1,15872,14,7477677144
1969,112914570,1042,112915612,0,6,1,1024,14,9395744384
1970,113010015,46471,113056486,0,7,1,80384,40,10288361591
1971,113034730,22862,113057592,0,5,1,40960,20,6405963529
1972,113134898,6488,113141386,0,4,1,15872,12,4869572224
1973,113213981,22691,113236672,0,4,1,37376,12,7546604998
1974,113253962,114591,113368553,0,5,1,186368,20,5756033276
1975,113288520,4374,113292894,0,9,1,4608,45,3854355459
1976,113397740,2470,113400210,0,4,1,2560,12,215743381
1977,113400693,157472,113558165,0,5,0,10240,20,4880891594
1978,113405491,22862,113428353,0,4,1,40960,12,7207292790
1979,113525160,14545,113539705,0,7,1,28160,40,9209774292
1980,113534548,120068,113654616,0,9,0,94208,45,2891410438
1981,113566855,106028,113672883,0,5,0,48128,20,9124725375
1982,113567193,10241,113577434,0,4,1,16384,12,7715593373
1983,113582266,23378,113605644,0,4,1,41984,12,4043236042
1984,113622668,2470,113625138,0,3,1,2560,37,6564811803
1985,113623046,5454,113628500,0,7,1,13824,40,9384556927
1986,113797706,11533,113809239,0,3,1,18944,37,2726088214
1987,113876055,12308,113888363,0,5,1,20480,20,8533622689
1988,113891065,3898,113894963,0,7,1,4096,40,5512412888
1989,113936717,4162,113940879,0,3,1,11264,37,9780103648
1990,113951487,1518,113953005,0,4,1,1536,12,9948916647
1991,113963994,60824,114024818,0,9,0,5632,45,9131804516
1992,114107684,121316,114229000,0,5,0,98304,20,7570976876
1993,114124970,566,114125536,0,9,1,512,45,8394273070
1994,114335650,74350,114410000,0,5,1,121344,20,274411262
1995,114402505,189500,114592005,0,9,0,160768,45,7350050378
1996,114475885,13858,114489743,0,3,1,23552,37,2192274583
1997,114539055,52965,114592020,0,9,1,40448,45,1648854998
1998,114644590,31524,114676114,0,5,1,51200,20,2514808830
1999,114714444,10241,114724685,0,9,1,16384,45,10220109575
2000,114719315,3645,114722960,0,3,1,10240,37,5279592277
2001,114742460,16096,114758556,0,0,1,31232,29,6279144321
2002,114744420,4850,114749270,0,9,1,5120,45,1467438506
2003,114807871,126932,114934803,0,5,0,116736,20,3569933391
2004,114860593,159902,115020495,0,5,0,98304,20,5930988337
2005,114897799,61448,114959247,0,9,0,7680,45,2556760443
2006,114944654,97354,115042008,0,5,1,162816,20,7683761154
2007,115049723,40616,115090339,0,4,1,65536,12,8558260904
2008,115066728,23637,115090365,0,0,1,42496,29,6176407843
2009,115072860,323310,115396170,0,5,0,32256,20,3201812376
2010,115094499,167712,115262211,0,5,1,276480,20,9709790278
2011,115153930,11533,115165463,0,4,1,18944,12,5420425908
2012,115167614,152545,115320159,0,5,1,187392,20,2885269548
2013,115201404,412262,115613666,0,5,0,150528,20,8925553454
2014,115235725,24929,115260654,0,3,1,45056,37,4988552596
2015,115237900,6754,115244654,0,0,1,7168,29,8347851641
2016,115269026,204944,115473970,0,9,0,211456,45,578263337
2017,115273396,47224,115320620,0,5,1,10240,20,9275277974
2018,115292130,14804,115306934,0,3,1,28672,37,837518291
2019,115452446,10499,115462945,0,7,1,16896,40,7010093592
2020,115499318,2946,115502264,0,0,1,3072,29,2961170439
2021,115506590,1518,115508108,0,0,1,1536,29,401844917
2022,115531968,11274,115543242,0,2,1,18432,14,5126787056
2023,115565581,1994,115567575,0,4,1,2048,12,7960362222
2024,115579582,123812,115703394,0,9,0,106496,45,9570605487
2025,115580137,30749,115610886,0,7,1,49664,40,6870834914
2026,115645753,3898,115649651,0,0,1,4096,29,629154056
2027,115647348,182528,115829876,0,5,0,147968,20,10700826904
2028,115680447,87229,115767676,0,1,1,146432,18,7678125984
2029,115708145,204296,115912441,0,9,0,204288,45,8491868334
2030,115741641,1042,115742683,0,9,1,1024,45,8438947748
2031,115827363,4850,115832213,0,9,1,5120,45,7609608862
2032,115840772,1518,115842290,0,4,1,1536,12,393034295
2033,115891328,25284,115916612,0,9,1,11264,45,1478781283
2034,115893674,23604,115917278,0,9,1,1024,45,1227400617
2035,115894223,5802,115900025,0,5,1,6144,20,732231139
2036,116080878,566,116081444,0,4,1,512,12,4778955864
2037,116086914,2946,116089860,0,7,1,3072,40,5768328677
2038,116089551,21658,116111209,0,3,1,35328,37,7679188016
2039,116116685,1994,116118679,0,9,1,2048,45,8779618767
2040,116136572,12049,116148621,0,0,1,19968,29,10391260017
2041,116184603,4850,116189453,0,5,1,5120,20,5891998236
2042,116202338,2870,116205208,0,9,1,8704,45,9191389342
2043,116282944,5712,116288656,0,9,1,14336,45,4898921563
2044,116314582,4162,116318744,0,5,1,11264,20,2246221941
2045,116440457,2870,116443327,0,0,1,8704,29,8830594011
2046,116518468,3422,116521890,0,9,1,3584,45,7199159324
2047,116641670,6229,116647899,0,7,1,15360,40,4015555018
2048,116671674,10757,116682431,0,4,1,17408,12,7412424928
2049,116690740,13083,116703823,0,9,1,22016,45,576906113
2050,116706011,4850,116710861,0,4,1,5120,12,4325556337
2051,116721934,4850,116726784,0,3,1,5120,37,8845498126
2052,116731498,7230,116738728,0,5,1,7680,20,3802252481
2053,116974798,4679,116979477,0,0,1,12288,29,5313611717
2054,117047226,1518,117048744,0,7,1,1536,40,1417985836
2055,117055433,14029,117069462,0,0,1,27136,29,351671374
2056,117066485,107900,117174385,0,9,0,54272,45,3075975368
2057,117082200,21916,117104116,0,3,1,35840,37,5643323790
2058,117113950,4679,117118629,0,5,1,12288,20,115715085
2059,117142414,2870,117145284,0,5,1,8704,20,669759155
2060,117224221,22862,117247083,0,5,1,40960,20,5489434001
2061,117392381,14117,117406498,0,3,1,24064,37,10154562104
2062,117576892,4162,117581054,0,9,1,11264,45,7824016245
2063,117688909,55748,117744657,0,9,0,4096,45,6954051502
2064,117710487,99944,117810431,0,9,0,28160,45,895372845
2065,117745367,22433,117767800,0,9,1,36864,45,10013328506
2066,117757526,104156,117861682,0,5,0,41984,20,4534658704
2067,117827491,4937,117832428,0,3,1,12800,37,6738613737
2068,117923345,14545,117937890,0,9,1,28160,45,1862692817
2069,118151094,4374,118155468,0,5,1,4608,20,7651997193
2070,118232971,2946,118235917,0,3,1,3072,37,7655055247
2071,118394322,10241,118404563,0,9,1,16384,45,1048279184
2072,118465078,3904,118468982,0,3,1,10752,37,6139325476
2073,118491133,23637,118514770,0,9,1,42496,45,4783579609
2074,118586009,14117,118600126,0,5,1,24064,20,318863180
2075,118592199,33762,118625961,0,9,1,58880,45,10725286100
2076,118617381,13406,118630787,0,9,1,7680,45,2114160053
2077,118640643,1042,118641685,0,0,1,1024,29,4275492103
2078,118654076,13341,118667417,0,5,1,22528,20,6269100541
2079,118725408,71132,118796540,0,9,0,9216,45,10660359546
2080,118817114,11533,118828647,0,3,1,18944,37,3719102530
2081,118848837,1042,118849879,0,3,1,1024,37,5126126000
2082,118851385,14117,118865502,0,3,1,24064,37,9024567230
2083,118923021,54836,118977857,0,5,0,6144,20,6276310904
2084,118954271,7706,118961977,0,9,1,8192,45,485723664
2085,119036045,211838,119247883,0,9,0,167424,45,5994013668
2086,119042561,6229,119048790,0,5,1,15360,20,4923258792
2087,119111675,104468,119216143,0,5,0,43008,20,336725258
2088,119201460,161803,119363263,0,9,0,78848,45,610579180
2089,119216898,2870,119219768,0,0,1,8704,29,2979950511
2090,119237924,5196,119243120,0,5,1,13312,20,9765298041
2091,119321819,120536,119442355,0,5,0,95744,20,7466084280
2092,119333718,46729,119380447,0,0,1,80896,29,1160014756
2093,119360818,6278,119367096,0,5,1,6656,20,762704617
2094,119426984,39000,119465984,0,5,1,42496,20,3027608424
2095,119520648,21399,119542047,0,6,1,34816,14,9998964217
2096,119654678,36346,119691024,0,9,1,64000,45,5340033093
2097,119754661,1042,119755703,0,5,1,1024,20,6534415333
2098,119785084,24929,119810013,0,6,1,45056,14,1712223170
2099,119899237,103220,120002457,0,5,0,38912,20,8748105640
2100,119993947,6488,120000435,0,6,1,15872,14,7760376258
2101,119999450,1518,120000968,0,3,1,1536,37,2566050784
2102,120066623,11791,120078414,0,3,1,19456,37,5312222552
2103,120163150,4937,120168087,0,6,1,12800,14,7121594227
2104,120221991,92996,120314987,0,9,0,20480,45,8995034161
2105,120322964,1994,120324958,0,6,1,2048,14,5222813231
2106,120330570,4420,120334990,0,6,1,11776,14,7472810334
2107,120331202,16605,120347807,0,6,1,23040,14,2258630753
2108,120344961,4937,120349898,0,6,1,12800,14,10636403011
2109,120382913,6278,120389191,0,1,1,6656,18,2577695805
2110,120404908,107900,120512808,0,9,0,54272,45,4219728975
2111,120467720,97604,120565324,0,5,0,20480,20,1053026525
2112,120504877,106964,120611841,0,5,0,51200,20,8293017333
2113,120518695,112580,120631275,0,9,0,69632,45,7117227380
2114,120555124,317465,120872589,0,5,0,284672,20,7132870803
2115,120587210,294130,120881340,0,5,0,28672,20,1781064032
2116,120593090,105092,120698182,0,5,0,45056,20,195543023
2117,120639331,4420,120643751,0,1,1,11776,18,9094244022
2118,120682696,2470,120685166,0,3,1,2560,37,7945565625
2119,120885664,102908,120988572,0,5,0,37888,20,5095673844
2120,120943948,5802,120949750,0,3,1,6144,37,5902824103
2121,120962432,21141,120983573,0,1,1,34304,18,5084069899
2122,121112169,4937,121117106,0,1,1,12800,18,6739307225
2123,121688156,101816,121789972,0,5,0,34304,20,2220921876
2124,121695443,6754,121702197,0,0,1,7168,29,9756971276
2125,121775910,126152,121902062,0,5,0,114176,20,4270064529
2126,121892683,24154,121916837,0,3,1,43520,37,737321579
2127,121895868,27485,121923353,0,3,1,23040,37,6084609024
2128,121922777,285608,122208385,0,9,0,314880,45,7447509642
2129,122011674,3645,122015319,0,0,1,10240,29,875039765
2130,122044234,1994,122046228,0,1,1,2048,18,225719019
2131,122363470,5196,122368666,0,4,1,13312,12,430753700
2132,122417360,5802,122423162,0,0,1,6144,29,9935937766
2133,122474307,190904,122665211,0,9,0,165376,45,9399719694
2134,122519599,1042,122520641,0,0,1,1024,29,966884171
2135,122548248,5196,122553444,0,3,1,13312,37,1802953055
2136,122625540,3422,122628962,0,6,1,3584,14,7664100044
2137,122803600,6278,122809878,0,0,1,6656,29,8230242470
2138,122868360,7230,122875590,0,3,1,7680,37,9698344830
2139,122939636,309008,123248644,0,5,0,391680,20,9868855700
2140,123007825,190748,123198573,0,9,0,164864,45,8552618438
2141,123042694,263993,123306687,0,9,0,185856,45,6617655665
2142,123351348,2870,123354218,0,3,1,8704,37,168233392
2143,123353312,3387,123356699,0,1,1,9728,18,10673111678
2144,123360231,13512,123373743,0,0,1,26112,29,6456537568
2145,123400304,7706,123408010,0,1,1,8192,18,1782426489
2146,123443185,3645,123446830,0,0,1,10240,29,7500742423
2147,123536319,102596,123638915,0,9,0,36864,45,3399218275
2148,123689694,16354,123706048,0,0,1,31744,29,7312166774
2149,123757314,114140,123871454,0,5,0,74752,20,9353072357
2150,123783457,6278,123789735,0,0,1,6656,29,9592320838
2151,124181371,120380,124301751,0,5,0,95232,20,5821132050
2152,124473739,109772,124583511,0,9,0,60416,45,6347468042
2153,124529187,45596,124574783,0,5,0,1024,20,249534685
2154,124791932,12566,124804498,0,0,1,20992,29,9034555403
2155,125168124,106652,125274776,0,5,0,50176,20,9859215137
2156,125188338,118196,125306534,0,9,0,88064,45,2010664338
2157,125405353,23120,125428473,0,4,1,41472,12,5072549499
2158,125452445,2870,125455315,0,2,1,8704,14,8992060505
2159,125455769,1994,125457763,0,4,1,2048,12,375951275
2160,125500396,12737,125513133,0,0,1,24576,29,5679308464
2161,125518699,10757,125529456,0,4,1,17408,12,7503378122
2162,125573461,13512,125586973,0,4,1,26112,12,8218651884
2163,125637791,31524,125669315,0,4,1,51200,12,7582714462
2164,125680515,5712,125686227,0,8,1,14336,21,3427135060
2165,125789297,12049,125801346,0,4,1,19968,12,5492667735
2166,125897550,3128,125900678,0,4,1,9216,12,3108549074
2167,125930549,11016,125941565,0,4,1,17920,12,9037516846
2168,125979163,5802,125984965,0,0,1,6144,29,4776192442
2169,125987501,13512,126001013,0,8,1,26112,21,4612728026
2170,126048735,12308,126061043,0,4,1,20480,12,2249234736
2171,126066168,291380,126357548,0,9,0,333824,45,7735561078
2172,126230146,3645,126233791,0,4,1,10240,12,7981484117
2173,126303668,1042,126304710,0,4,1,1024,12,1508469314
2174,126311198,247386,126558584,0,9,0,198656,45,5198148461
2175,126329821,14545,126344366,0,0,1,28160,29,1389000509
2176,126495900,5971,126501871,0,4,1,14848,12,689044934
2177,126515970,54368,126570338,0,5,0,4608,20,9928392661
2178,126869712,11533,126881245,0,0,1,18944,29,8705638356
2179,126879737,3904,126883641,0,4,1,10752,12,5203068243
2180,126894415,14117,126908532,0,4,1,24064,12,9381689401
2181,126943339,4420,126947759,0,5,1,11776,20,8270432229
2182,126994481,6229,127000710,0,4,1,15360,12,3921127245
2183,127115250,22433,127137683,0,4,1,36864,12,529280409
2184,127152662,2870,127155532,0,4,1,8704,12,4444264736
2185,127175859,16096,127191955,0,0,1,31232,29,6759654933
2186,127233525,13083,127246608,0,8,1,22016,21,648433921
2187,127284490,208844,127493334,0,9,0,224256,45,1664812250
2188,127341018,3422,127344440,0,0,1,3584,29,5169722450
2189,127440769,5971,127446740,0,0,1,14848,29,3869235425
2190,127481352,13341,127494693,0,8,1,22528,21,3267249253
2191,127481877,11274,127493151,0,5,1,18432,20,4172182997
2192,127545128,4162,127549290,0,0,1,11264,29,6672011383
2193,127693216,5454,127698670,0,0,1,13824,29,9245877972
2194,127706257,1042,127707299,0,0,1,1024,29,9907886849
2195,127710525,10499,127721024,0,0,1,16896,29,2458565152
2196,127837954,1994,127839948,0,6,1,2048,14,949672171
2197,127984536,117416,128101952,0,5,0,85504,20,7663515507
2198,127996379,154827,128151206,0,5,0,34304,20,4583246580
2199,128049673,4374,128054047,0,4,1,4608,12,8634902511
2200,128092711,103220,128195931,0,9,0,38912,45,5943294404
2201,128101975,5454,128107429,0,0,1,13824,29,2923967743
2202,128286739,3387,128290126,0,0,1,9728,29,131163630
2203,128398234,11533,128409767,0,1,1,18944,18,10674900887
2204,128445679,65300,128510979,0,5,0,10240,20,8748814773
2205,128589474,4420,128593894,0,0,1,11776,29,2263490585
2206,128848421,4937,128853358,0,0,1,12800,29,3907438538
2207,128941430,15837,128957267,0,5,1,30720,20,760794425
2208,128967370,2870,128970240,0,4,1,8704,12,9440293041
2209,129034056,566,129034622,0,0,1,512,29,1067895560
2210,129124002,4850,129128852,0,4,1,5120,12,9744383867
2211,129139023,163448,129302471,0,5,0,140800,20,9388286559
2212,129168154,5326,129173480,0,4,1,5632,12,1368778960
2213,129220326,3128,129223454,0,0,1,9216,29,2971990259
2214,129302255,202344,129504599,0,5,0,202240,20,8867441385
2215,129312719,6488,129319207,0,0,1,15872,29,10032861794
2216,129315787,3898,129319685,0,4,1,4096,12,6792875459
2217,129533157,4374,129537531,0,0,1,4608,29,6909705315
2218,129640381,2870,129643251,0,4,1,8704,12,3924174499
2219,129723863,23895,129747758,0,4,1,43008,12,1296726765
2220,129832374,21399,129853773,0,5,1,34816,20,8725900770
2221,129843712,23120,129866832,0,0,1,41472,29,4632062574
2222,129850065,2870,129852935,0,4,1,8704,12,9573331992
2223,129851000,14849,129865849,0,4,1,22016,12,4825035692
2224,129864080,31783,129895863,0,4,1,51712,12,2616636700
2225,129894113,40616,129934729,0,0,1,65536,29,10133640041
2226,129949582,2946,129952528,0,0,1,3072,29,4301047187
2227,130171573,12825,130184398,0,0,1,21504,29,10273924402
2228,130267512,7706,130275218,0,4,1,8192,12,6576907495
2229,130283152,1042,130284194,0,5,1,1024,20,1979106826
2230,130287227,22862,130310089,0,5,1,40960,20,3289478554
2231,130303459,23637,130327096,0,7,1,42496,40,6093297580
2232,130377481,108368,130485849,0,9,0,55808,45,6689837616
2233,130457833,5326,130463159,0,4,1,5632,12,5361398118
2234,130525557,110084,130635641,0,9,0,61440,45,1393076790
2235,130683863,4679,130688542,0,5,1,12288,20,1288418054
2236,130817535,3904,130821439,0,5,1,10752,20,646110407
2237,130995734,1994,130997728,0,5,1,2048,20,2798941573
2238,131119883,159932,131279815,0,5,0,144384,20,9015681580
2239,131121553,2470,131124023,0,7,1,2560,40,737832299
2240,131316782,1994,131318776,0,6,1,2048,14,3286293453
2241,131379749,3422,131383171,0,2,1,3584,14,2102697545
2242,131402270,107120,131509390,0,9,0,51712,45,9699355231
2243,131868383,112580,131980963,0,9,0,69632,45,2530950202
2244,131891510,14804,131906314,0,5,1,28672,20,1370257586
2245,132304012,97292,132401304,0,5,0,19456,20,6351131674
2246,132364193,378128,132742321,0,9,0,457216,45,7883350387
2247,132391112,10207,132401319,0,5,1,5120,20,7634982403
2248,132487068,10499,132497567,0,5,1,16896,20,1898390202
2249,132590465,14287,132604752,0,5,1,27648,20,3909427251
2250,132980536,190904,133171440,0,5,0,165376,20,3303936973
2251,133103000,127612,133230612,0,5,0,59904,20,204448646
2252,133231546,101972,133333518,0,5,0,34816,20,877242320
2253,133323573,4679,133328252,0,9,1,12288,45,2549466704
2254,133483687,57440,133541127,0,9,0,4608,45,5674321803
2255,133686747,13341,133700088,0,5,1,22528,20,6991794781
2256,133845417,10241,133855658,0,5,1,16384,20,7955795071
2257,133904841,102440,134007281,0,5,0,36352,20,1987275333
2258,134077545,109616,134187161,0,5,0,59904,20,8426840916
2259,134089830,16096,134105926,0,3,1,31232,37,1222445963
2260,134250662,4937,134255599,0,5,1,12800,20,10579029995
2261,134346669,83156,134429825,0,9,0,18432,45,1995985523
2262,134434720,5971,134440691,0,3,1,14848,37,2381190593
2263,134505626,22174,134527800,0,5,1,36352,20,6520744199
2264,134679195,5196,134684391,0,3,1,13312,37,176098417
2265,134915030,7230,134922260,0,3,1,7680,37,9397181276
2266,135171856,3904,135175760,0,5,1,10752,20,6839521621
2267,135432000,10241,135442241,0,5,1,16384,20,8997133627
2268,135513655,53753,135567408,0,2,1,91136,14,6194933361
2269,135588597,190280,135778877,0,9,0,163328,45,7222512415
2270,135591047,134684,135725731,0,5,0,132096,20,678495868
2271,135594029,5802,135599831,0,0,1,6144,29,10238074637
2272,135696932,12995,135709927,0,0,1,25088,29,7422591929
2273,135702001,1518,135703519,0,3,1,1536,37,1553334690
2274,135957507,4679,135962186,0,5,1,12288,20,450733382
2275,135982237,45596,136027833,0,9,0,1024,45,5203634625
2276,135996530,2946,135999476,0,0,1,3072,29,2126561517
2277,136017728,2946,136020674,0,4,1,3072,12,7723726933
2278,136023018,1042,136024060,0,4,1,1024,12,3462006338
2279,136024617,4162,136028779,0,5,1,11264,20,1987798791
2280,136048929,4374,136053303,0,5,1,4608,20,9240588852
2281,136112238,5454,136117692,0,5,1,13824,20,1004588559
2282,136119636,13858,136133494,0,2,1,23552,14,8657401978
2283,136133251,135767,136269018,0,5,0,50688,20,3164618744
2284,136197863,102752,136300615,0,9,0,37376,45,2163005389
2285,136207131,222682,136429813,0,9,0,67072,45,5983142095
2286,136234114,162051,136396165,0,9,0,32256,45,10476521943
2287,136289358,7706,136297064,0,5,1,8192,20,8071141774
2288,136316841,26221,136343062,0,3,1,47616,37,5411445539
2289,136358699,1042,136359741,0,5,1,1024,20,599148313
2290,136425819,301450,136727269,0,9,0,353792,45,4773000527
2291,136476599,24929,136501528,0,4,1,45056,12,4612275521
2292,136489186,10241,136499427,0,2,1,16384,14,6605054353
2293,136546046,5712,136551758,0,0,1,14336,29,2395165016
2294,136596627,3898,136600525,0,3,1,4096,37,5861198197
2295,136615733,15579,136631312,0,3,1,30208,37,1187888666
2296,136768881,22433,136791314,0,4,1,36864,12,9150191348
2297,136859501,5454,136864955,0,5,1,13824,20,9199253653
2298,136865171,4679,136869850,0,5,1,12288,20,5297864873
2299,136967054,166549,137133603,0,5,0,48640,20,7934363021
2300,137012143,11791,137023934,0,0,1,19456,29,3434600480
2301,137109476,6278,137115754,0,3,1,6656,37,7115086870
2302,137161434,7230,137168664,0,9,1,7680,45,9547360996
2303,137166293,12737,137179030,0,2,1,24576,14,5954388782
2304,137211119,12825,137223944,0,5,1,21504,20,3576932609
2305,137351176,184688,137535864,0,9,0,150016,45,9665883286
2306,137359494,32299,137391793,0,0,1,52736,29,8734862908
2307,137431244,3645,137434889,0,4,1,10240,12,668958301
2308,137433021,182151,137615172,0,9,0,145920,45,6768384261
2309,137437489,5802,137443291,0,4,1,6144,12,6759944059
2310,137474436,48980,137523416,0,8,0,2048,21,10229914932
2311,137482641,3898,137486539,0,0,1,4096,29,3083820197
2312,137503627,69308,137572935,0,5,0,13312,20,530815889
2313,137630187,14804,137644991,0,0,1,28672,29,3458254253
2314,137651494,33850,137685344,0,4,1,55808,12,281706523
2315,137678423,136376,137814799,0,9,0,132608,45,3693619640
2316,137687995,2870,137690865,0,5,1,8704,20,3533613398
2317,137690916,22862,137713778,0,4,1,40960,12,10112928552
2318,137778090,22950,137801040,0,0,1,37888,29,10396347509
2319,137791851,204788,137996639,0,5,0,210944,20,8918052870
2320,137874218,14545,137888763,0,2,1,28160,14,3425850846
2321,137938790,16096,137954886,0,3,1,31232,37,1316174359
2322,137950418,8654,137959072,0,3,1,6656,37,293353556
2323,137954160,3422,137957582,0,0,1,3584,29,6864464544
2324,138084095,26738,138110833,0,3,1,48640,37,2909897747
2325,138233388,14117,138247505,0,5,1,24064,20,9312356659
2326,138243810,2946,138246756,0,4,1,3072,12,6720044604
2327,138253099,1042,138254141,0,0,1,1024,29,9589220021
2328,138338380,5454,138343834,0,4,1,13824,12,6430432576
2329,138402770,1042,138403812,0,4,1,1024,12,9917193603
2330,138510251,106496,138616747,0,5,0,49664,20,6073373736
2331,138663408,109928,138773336,0,5,0,60928,20,9414556305
2332,138705804,11533,138717337,0,0,1,18944,29,2300755846
2333,138803662,101972,138905634,0,9,0,34816,45,6487701609
2334,138939272,1518,138940790,0,4,1,1536,12,6992972294
2335,138953402,5802,138959204,0,4,1,6144,12,599261277
2336,139028473,13253,139041726,0,0,1,25600,29,296672439
2337,139201291,13083,139214374,0,3,1,22016,37,689147182
2338,139360069,5802,139365871,0,0,1,6144,29,4008955980
2339,139364341,32987,139397328,0,0,1,57344,29,3749185272
2340,139402200,566,139402766,0,4,1,512,12,2912617624
2341,139408830,1994,139410824,0,4,1,2048,12,8043333508
2342,139507406,11533,139518939,0,0,1,18944,29,1088177946
2343,139555515,21658,139577173,0,0,1,35328,29,4739850083
2344,139575985,264380,139840365,0,9,0,275456,45,3728434563
2345,139624282,3422,139627704,0,3,1,3584,37,4853572206
2346,139789161,123656,139912817,0,5,0,105984,20,17024783
2347,139809026,1042,139810068,0,7,1,1024,40,2499792551
2348,139914992,6754,139921746,0,4,1,7168,12,2813383850
2349,140035516,4420,140039936,0,0,1,11776,29,2274084125
2350,140045950,6754,140052704,0,3,1,7168,37,10491613117
2351,140076349,5971,140082320,0,0,1,14848,29,412286142
2352,140204625,45596,140250221,0,5,0,1024,20,3072536977
2353,140256391,122720,140379111,0,9,0,102912,45,8532537449
2354,140290096,5196,140295292,0,3,1,13312,37,4918665754
2355,140344139,123656,140467795,0,5,0,105984,20,1589436150
2356,140405676,257792,140663468,0,9,0,279040,45,596241771
2357,140414499,3387,140417886,0,3,1,9728,37,6345998863
2358,140525074,3387,140528461,0,9,1,9728,45,5906710944
2359,140538061,13858,140551919,0,4,1,23552,12,1766423064
2360,140542365,321161,140863526,0,9,0,385024,45,5020380577
2361,140680007,3898,140683905,0,5,1,4096,20,2391206542
2362,140695017,3128,140698145,0,0,1,9216,29,7704364963
2363,140803190,62322,140865512,0,9,1,2048,45,4724430857
2364,140812488,12825,140825313,0,3,1,21504,37,12838019
2365,140859370,1994,140861364,0,4,1,2048,12,4684578617
2366,140882031,30749,140912780,0,3,1,49664,37,7515909811
2367,141046754,24670,141071424,0,3,1,44544,37,9085191608
2368,141090688,12049,141102737,0,9,1,19968,45,7647017081
2369,141194869,6278,141201147,0,4,1,6656,12,1441561992
2370,141217011,225464,141442475,0,5,0,263680,20,407035289
2371,141237633,110864,141348497,0,9,0,64000,45,4968341971
2372,141336929,149034,141485963,0,5,0,121856,20,4465160050
2373,141455167,1042,141456209,0,4,1,1024,12,5596696742
2374,141492696,11791,141504487,0,4,1,19456,12,4338906729
2375,141576519,1518,141578037,0,3,1,1536,37,5977520491
2376,141590630,13512,141604142,0,3,1,26112,37,1222088736
2377,141915540,23895,141939435,0,8,1,43008,21,3272154086
2378,141993015,21916,142014931,0,4,1,35840,12,8236468742
2379,142157556,126932,142284488,0,5,0,116736,20,6908355488
2380,142312175,2946,142315121,0,8,1,3072,21,6526474699
2381,142367841,1518,142369359,0,2,1,1536,14,7404552679
2382,142432228,4850,142437078,0,8,1,5120,21,2917727107
2383,142544720,4420,142549140,0,4,1,11776,12,10246637021
2384,142668130,30749,142698879,0,9,1,49664,45,7404527781
2385,142713735,566,142714301,0,8,1,512,21,1687829280
2386,142771364,74091,142845455,0,4,1,120832,12,1239654847
2387,142788229,2870,142791099,0,8,1,8704,21,83636368
2388,142800287,121940,142922227,0,5,0,100352,20,4200892148
2389,142881773,5196,142886969,0,0,1,13312,29,750215858
2390,142951884,120848,143072732,0,9,0,96768,45,10276831785
2391,143027073,4374,143031447,0,3,1,4608,37,7687108908
2392,143028117,566,143028683,0,8,1,512,21,4733219588
2393,143086635,1994,143088629,0,9,1,2048,45,1097921780
2394,143110160,12737,143122897,0,3,1,24576,37,4010621585
2395,143128043,2470,143130513,0,3,1,2560,37,3273596779
2396,143131328,4850,143136178,0,8,1,5120,21,10563121288
2397,143305288,12825,143318113,0,9,1,21504,45,9058852464
2398,143306107,123188,143429295,0,5,0,104448,20,993168518
2399,143310866,6278,143317144,0,3,1,6656,37,6730725665
2400,143335920,5326,143341246,0,8,1,5632,21,2198139655
2401,143364283,5802,143370085,0,3,1,6144,37,2466398293
2402,143735976,566,143736542,0,9,1,512,45,8495127304
2403,143845701,1994,143847695,0,8,1,2048,21,2738594571
2404,144194861,566,144195427,0,7,1,512,40,5579045828
2405,144260195,3898,144264093,0,9,1,4096,45,9146547169
2406,144658757,1994,144660751,0,9,1,2048,45,1339075810
2407,144671438,1518,144672956,0,9,1,1536,45,5385566543
2408,144753119,4420,144757539,0,8,1,11776,21,7407650973
2409,144824406,36604,144861010,0,8,1,64512,21,2939260285
2410,144892953,4162,144897115,0,9,1,11264,45,3080232081
2411,145005618,7706,145013324,0,9,1,8192,45,8602816689
2412,145439961,3422,145443383,0,8,1,3584,21,1836381165
2413,145520318,5326,145525644,0,9,1,5632,45,1667420122
2414,145533939,3904,145537843,0,8,1,10752,21,4121192269
2415,145547258,119444,145666702,0,9,0,92160,45,1754589216
2416,145586545,280772,145867317,0,3,0,299008,37,8358408127
2417,145629631,4420,145634051,0,8,1,11776,21,5620020798
2418,145755312,97160,145852472,0,9,0,24064,45,4741696255
2419,145886644,10241,145896885,0,8,1,16384,21,7693420042
2420,146172250,2870,146175120,0,7,1,8704,40,10549881430
2421,146288682,122408,146411090,0,9,0,101888,45,8328898982
2422,146319593,34795,146354388,0,9,1,60928,45,8504012474
2423,146368782,179339,146548121,0,9,0,83456,45,6622192529
2424,146551892,94664,146646556,0,9,0,15872,45,7701023102
2425,146661016,4850,146665866,0,9,1,5120,45,1730011573
2426,146808757,5196,146813953,0,8,1,13312,21,8986385375
2427,146866028,118040,146984068,0,9,0,87552,45,9098100021
2428,146906604,1518,146908122,0,7,1,1536,40,7370894933
2429,146980398,4850,146985248,0,8,1,5120,21,4440073804
2430,147044097,1042,147045139,0,9,1,1024,45,3252631904
2431,147046796,7230,147054026,0,8,1,7680,21,1644975147
2432,147139732,4374,147144106,0,7,1,4608,40,5925855874
2433,147176892,4162,147181054,0,8,1,11264,21,8025808266
2434,147227703,12995,147240698,0,7,1,25088,40,4127181963
2435,147389392,2946,147392338,0,8,1,3072,21,6710614805
2436,147407312,2470,147409782,0,7,1,2560,40,6182339298
2437,147455486,5802,147461288,0,9,1,6144,45,4313826943
2438,147477566,4420,147481986,0,8,1,11776,21,2759278544
2439,147819940,43628,147863568,0,9,1,74752,45,7977897674
2440,147879598,103220,147982818,0,3,0,38912,37,1447924193
2441,147967062,69308,148036370,0,9,0,13312,45,2747254480
2442,147986705,276716,148263421,0,1,0,285696,18,7464446749
2443,148057551,109772,148167323,0,3,0,60416,37,8553894982
2444,148199153,94088,148293241,0,9,0,24064,45,3322172269
2445,148418459,36346,148454805,0,7,1,64000,40,6309923431
2446,148621635,97028,148718663,0,9,0,28672,45,274674946
2447,148710320,107432,148817752,0,3,0,52736,37,3290506871
2448,148839669,119132,148958801,0,9,0,91136,45,4463790005
2449,148889291,3898,148893189,0,7,1,4096,40,1798751634
2450,148944399,73526,149017925,0,9,0,5120,45,5821623813
2451,148992381,1042,148993423,0,7,1,1024,40,1682841584
2452,149081812,5326,149087138,0,7,1,5632,40,8225026136
2453,149136007,191372,149327379,0,3,0,166912,37,4506838956
2454,149182192,3904,149186096,0,7,1,10752,40,4214626940
2455,149200478,21141,149221619,0,7,1,34304,40,2359990568
2456,149274685,1042,149275727,0,9,1,1024,45,212344418
2457,149292275,10241,149302516,0,7,1,16384,40,9646278518
2458,149507925,13600,149521525,0,9,1,23040,45,7256175816
2459,149645485,11274,149656759,0,4,1,18432,12,681565200
2460,149690816,14117,149704933,0,9,1,24064,45,6898632912
2461,149720764,128648,149849412,0,3,0,122368,37,4946204803
2462,149778930,5802,149784732,0,7,1,6144,40,8396249805
2463,150078988,108368,150187356,0,3,0,55808,37,5116276855
2464,150329538,2946,150332484,0,7,1,3072,40,2817809904
2465,150369808,4679,150374487,0,7,1,12288,40,98445820
2466,150612229,7230,150619459,0,7,1,7680,40,1821637791
2467,150743594,6278,150749872,0,9,1,6656,45,9317296850
2468,150784221,23120,150807341,0,7,1,41472,40,567878472
2469,150793540,16354,150809894,0,9,1,31744,45,8911955024
2470,150818962,30749,150849711,0,9,1,49664,45,8426402240
2471,150861560,2470,150864030,0,7,1,2560,40,439985014
2472,150906688,6754,150913442,0,7,1,7168,40,9317018411
2473,151048757,23725,151072482,0,7,1,39424,40,8403977622
2474,151142982,109616,151252598,0,3,0,59904,37,4505472665
2475,151267369,225464,151492833,0,9,0,263680,45,2545917555
2476,151607782,14545,151622327,0,3,1,28160,37,1449252495
2477,151735995,159790,151895785,0,3,0,54784,37,5312709349
2478,151929846,1518,151931364,0,0,1,1536,29,8630042818
2479,152117057,122252,152239309,0,9,0,101376,45,4229297920
2480,152169836,191165,152361001,0,9,0,160768,45,2893582534
2481,152230534,3422,152233956,0,3,1,3584,37,7166324182
2482,152361167,124280,152485447,0,3,0,108032,37,7948463629
2483,152472018,15415,152487433,0,3,1,2048,37,7027157375
2484,153248911,5454,153254365,0,4,1,13824,12,7373446086
2485,153260538,4850,153265388,0,6,1,5120,14,557613334
2486,153392421,14029,153406450,0,9,1,27136,45,8223748787
2487,153397385,11791,153409176,0,3,1,19456,37,1505397567
2488,153453230,12566,153465796,0,6,1,20992,14,5359088749
2489,153542298,24242,153566540,0,3,1,40448,37,245198705
2490,153647383,66056,153713439,0,9,0,7680,45,8839325723
2491,153678807,13083,153691890,0,9,1,22016,45,2425968406
2492,153950628,197768,154148396,0,9,0,187904,45,8490170145
2493,153998071,3422,154001493,0,3,1,3584,37,9937353589
2494,154021146,1042,154022188,0,6,1,1024,14,8263270398
2495,154060087,6278,154066365,0,3,1,6656,37,8128818413
2496,154070190,3422,154073612,0,3,1,3584,37,4084179714
2497,154075190,1518,154076708,0,6,1,1536,14,2565655898
2498,154152099,33591,154185690,0,6,1,55296,14,7700485257
2499,154169886,12049,154181935,0,3,1,19968,37,852733189
2500,154241503,12995,154254498,0,3,1,25088,37,889890728
2501,154487870,215084,154702954,0,9,0,244736,45,1222689718
2502,154923557,101972,155025529,0,9,0,34816,45,1136444944
2503,154925118,11791,154936909,0,8,1,19456,21,7905803927
2504,155036631,1518,155038149,0,3,1,1536,37,1080135440
2505,155104848,2470,155107318,0,8,1,2560,21,6751906548
2506,155242612,55748,155298360,0,9,0,4096,45,7486207026
2507,155247235,1042,155248277,0,3,1,1024,37,581062491
2508,155302542,6754,155309296,0,8,1,7168,21,6454186887
2509,155314570,20882,155335452,0,3,1,33792,37,4922048407
2510,155364773,5326,155370099,0,8,1,5632,21,681859682
2511,155522951,1994,155524945,0,9,1,2048,45,4071919445
2512,155613592,104000,155717592,0,9,0,41472,45,7022008127
2513,155746077,3898,155749975,0,3,1,4096,37,10198298523
2514,155892593,118508,156011101,0,9,0,89088,45,3204740748
2515,155970854,40262,156011116,0,9,1,36864,45,4798953515
2516,156223749,566,156224315,0,6,1,512,14,4036520850
2517,156272302,1042,156273344,0,3,1,1024,37,8766587938
2518,156272611,240404,156513015,0,9,0,272384,45,7677239092
2519,156282641,4374,156287015,0,3,1,4608,37,9277205260
2520,156371907,174852,156546759,0,9,0,83456,45,5103350271
2521,156518839,304916,156823755,0,9,0,375296,45,5459750510
2522,156629585,4679,156634264,0,9,1,12288,45,4520262264
2523,156965839,111800,157077639,0,9,0,67072,45,7055846639
2524,157031411,1518,157032929,0,3,1,1536,37,4084895900
2525,157091312,122876,157214188,0,9,0,103424,45,4411616757
2526,157259406,10241,157269647,0,3,1,16384,37,1473048523
2527,157271493,184064,157455557,0,9,0,147968,45,6358393662
2528,157424255,1994,157426249,0,1,1,2048,18,8458287662
2529,157618313,4374,157622687,0,1,1,4608,18,6042465641
2530,157673744,2870,157676614,0,3,1,8704,37,5293935208
2531,157893231,105872,157999103,0,9,0,47616,45,9600333405
2532,158169716,22691,158192407,0,1,1,37376,18,1317548056
2533,158216711,10757,158227468,0,3,1,17408,37,7962572081
2534,158261430,10241,158271671,0,9,1,16384,45,965869188
2535,158356865,6278,158363143,0,1,1,6656,18,6551663397
2536,158424493,109148,158533641,0,9,0,58368,45,5665177504
2537,158492772,4850,158497622,0,3,1,5120,37,7369696257
2538,158511383,13253,158524636,0,3,1,25600,37,4776605006
2539,158535691,24154,158559845,0,1,1,43520,18,339068399
2540,158660104,32816,158692920,0,1,1,53760,18,10574082868
2541,159022916,566,159023482,0,1,1,512,18,5069520410
2542,159107789,2946,159110735,0,3,1,3072,37,5699187569
2543,159307525,3128,159310653,0,1,1,9216,18,2959542356
2544,159344509,63140,159407649,0,9,0,8192,45,10432518287
2545,159374590,104981,159479571,0,9,0,41472,45,4894345091
2546,159387167,35312,159422479,0,3,1,61952,37,8859645973
2547,159573122,566,159573688,0,1,1,512,18,75264486
2548,159605326,15579,159620905,0,1,1,30208,18,1809635043
2549,159652708,13512,159666220,0,1,1,26112,18,9889733666
2550,159691322,86516,159777838,0,9,0,14336,45,2853516965
2551,159985356,2470,159987826,0,1,1,2560,18,10556446143
2552,160052534,5196,160057730,0,1,1,13312,18,6127237893
2553,160222972,2946,160225918,0,1,1,3072,18,2386561223
2554,160367810,54056,160421866,0,9,0,3584,45,3577932928
2555,160386684,4850,160391534,0,1,1,5120,18,2249137020
2556,160453690,14117,160467807,0,1,1,24064,18,1157268053
2557,160532051,93020,160625071,0,9,0,25600,45,3499094185
2558,160555352,5454,160560806,0,1,1,13824,18,6623654668
2559,160572426,236623,160809049,0,9,0,240128,45,9586985326
2560,160682483,3128,160685611,0,8,1,9216,21,8088179551
2561,160750153,158052,160908205,0,9,0,25600,45,5093582285
2562,160937312,108056,161045368,0,9,0,54784,45,3571238517
2563,161280589,5196,161285785,0,1,1,13312,18,7496125894
2564,161395570,203540,161599110,0,9,0,206848,45,9854864625
2565,161447825,4850,161452675,0,1,1,5120,18,3732573456
2566,161566483,20882,161587365,0,1,1,33792,18,8429284747
2567,161806528,2470,161808998,0,4,1,2560,12,6185417966
2568,162049658,148220,162197878,0,9,0,136192,45,2228253685
2569,162059851,1518,162061369,0,4,1,1536,12,7008231848
2570,162224812,7706,162232518,0,1,1,8192,18,4794212812
2571,162387944,13770,162401714,0,1,1,26624,18,9557644886
2572,162465575,21141,162486716,0,5,1,34304,20,6321977812
2573,162531909,10757,162542666,0,5,1,17408,20,8589728870
2574,162551330,16354,162567684,0,4,1,31744,12,1067502777
2575,162569314,10499,162579813,0,1,1,16896,18,2628943032
2576,162690503,2870,162693373,0,5,1,8704,20,3721341954
2577,162807104,3898,162811002,0,8,1,4096,21,9519061759
2578,162864171,49292,162913463,0,9,0,3072,45,8996603864
2579,162918241,10499,162928740,0,1,1,16896,18,5118555675
2580,163029682,6488,163036170,0,5,1,15872,20,5852931123
2581,163066974,3904,163070878,0,1,1,10752,18,7679426224
2582,163068199,3422,163071621,0,8,1,3584,21,4544371804
2583,163248134,3898,163252032,0,8,1,4096,21,787268734
2584,163281072,5326,163286398,0,1,1,5632,18,260242489
2585,163286091,16354,163302445,0,8,1,31744,21,9637581242
2586,163402579,2946,163405525,0,1,1,3072,18,4786242884
2587,163590158,2946,163593104,0,8,1,3072,21,2991731521
2588,163627203,15579,163642782,0,4,1,30208,12,4556645378
2589,163632118,38875,163670993,0,4,1,60416,12,1057499014
2590,163686579,5196,163691775,0,5,1,13312,20,2877811061
2591,163755004,3387,163758391,0,1,1,9728,18,7926011919
2592,163772534,108836,163881370,0,9,0,57344,45,570343928
2593,163775636,5971,163781607,0,8,1,14848,21,2061645649
2594,163803427,97701,163901128,0,9,0,5120,45,2727220238
2595,163847378,5326,163852704,0,8,1,5632,21,9695034600
2596,163897826,7230,163905056,0,8,1,7680,21,6086074612
2597,163990277,195428,164185705,0,3,0,180224,37,7701075379
2598,164039422,5196,164044618,0,1,1,13312,18,7796618144
2599,164040706,116792,164157498,0,9,0,83456,45,4825443348
2600,164073734,100846,164174580,0,9,0,17408,45,4716269021
2601,164094149,10241,164104390,0,4,1,16384,12,5081537204
2602,164230546,566,164231112,0,4,1,512,12,5036637062
2603,164328588,2946,164331534,0,4,1,3072,12,8845989839
2604,164409581,6229,164415810,0,1,1,15360,18,7958299303
2605,164417503,287168,164704671,0,9,0,320000,45,6734142927
2606,164453921,13770,164467691,0,6,1,26624,14,6528280022
2607,164591491,2946,164594437,0,7,1,3072,40,4901542254
2608,164669701,20882,164690583,0,7,1,33792,40,3705045407
2609,164731621,4420,164736041,0,6,1,11776,14,4108279856
2610,164777067,209468,164986535,0,3,0,226304,37,3149645083
2611,164797420,4374,164801794,0,5,1,4608,20,661291247
2612,164830591,7230,164837821,0,6,1,7680,14,4747925350
2613,164895662,10241,164905903,0,1,1,16384,18,1789399413
2614,165015269,13253,165028522,0,6,1,25600,14,8565731922
2615,165037621,200732,165238353,0,3,0,197632,37,418899426
2616,165076545,204912,165281457,0,3,0,39424,37,3332681300
2617,165109543,4374,165113917,0,6,1,4608,14,5953629758
2618,165152866,108212,165261078,0,9,0,55296,45,2246442309
2619,165285178,1518,165286696,0,7,1,1536,40,7554282241
2620,165338955,195896,165534851,0,9,0,181760,45,2114049029
2621,165388212,1518,165389730,0,4,1,1536,12,8378657742
2622,165403767,15837,165419604,0,9,1,30720,45,938672397
2623,165509179,14804,165523983,0,6,1,28672,14,3698649658
2624,165529071,566,165529637,0,7,1,512,40,10479306670
2625,165567603,52364,165619967,0,9,0,3072,45,4881523433
2626,165610226,5712,165615938,0,4,1,14336,12,2446393058
2627,165620323,5454,165625777,0,4,1,13824,12,4695317308
2628,165719376,1042,165720418,0,4,1,1024,12,10672563489
2629,165724029,16354,165740383,0,6,1,31744,14,8729507195
2630,165744192,3898,165748090,0,7,1,4096,40,9507418962
2631,165820923,1994,165822917,0,9,1,2048,45,7976112446
2632,165885263,15837,165901100,0,1,1,30720,18,9586680519
2633,165935284,3422,165938706,0,7,1,3584,40,6149258833
2634,165971456,2470,165973926,0,6,1,2560,14,10164853645
2635,166037662,11533,166049195,0,9,1,18944,45,4280966617
2636,166067689,6754,166074443,0,4,1,7168,12,1290554933
2637,166080105,21399,166101504,0,9,1,34816,45,2570303745
2638,166110775,197768,166308543,0,3,0,187904,37,6666757188
2639,166121510,2870,166124380,0,6,1,8704,14,8246181842
2640,166147010,6754,166153764,0,1,1,7168,18,5436183380
2641,166160849,4937,166165786,0,4,1,12800,12,4777441091
2642,166380157,4679,166384836,0,9,1,12288,45,2023481312
2643,166481729,5196,166486925,0,4,1,13312,12,4735853027
2644,166491650,45596,166537246,0,9,0,1024,45,4777049976
2645,166705503,283424,166988927,0,3,0,307712,37,5857529360
2646,166707940,10499,166718439,0,9,1,16896,45,9418960697
2647,166947021,4374,166951395,0,7,1,4608,40,9978631012
2648,167154231,63878,167218109,0,7,1,107520,40,3032674572
2649,167165610,24412,167190022,0,9,1,44032,45,1168370746
2650,167190532,14287,167204819,0,4,1,27648,12,1245319225
2651,167216788,13770,167230558,0,6,1,26624,14,3401206008
2652,167239500,5971,167245471,0,1,1,14848,18,4080540198
2653,167254196,5196,167259392,0,1,1,13312,18,2232817536
2654,167306068,3422,167309490,0,4,1,3584,12,4135202770
2655,167467914,12737,167480651,0,9,1,24576,45,4358749271
2656,167475658,5196,167480854,0,6,1,13312,14,6145523875
2657,167568479,3387,167571866,0,9,1,9728,45,5359556547
2658,167573428,1994,167575422,0,6,1,2048,14,972882108
2659,167577262,101192,167678454,0,3,0,32256,37,7678947109
2660,167578852,5326,167584178,0,4,1,5632,12,1126997388
2661,167602998,63748,167666746,0,9,0,512,45,10021895788
2662,167636591,3422,167640013,0,4,1,3584,12,3485666978
2663,167764641,210404,167975045,0,3,0,229376,37,2923391577
2664,167790477,4420,167794897,0,4,1,11776,12,830750854
2665,167809661,12737,167822398,0,4,1,24576,12,6595997974
2666,167815295,15932,167831227,0,4,1,27136,12,2608784362
2667,167833576,16354,167849930,0,6,1,31744,14,7432971418
2668,167861883,13253,167875136,0,6,1,25600,14,10672614347
2669,167888117,23120,167911237,0,9,1,41472,45,2599570076
2670,167888664,1994,167890658,0,4,1,2048,12,9243220777
2671,167905589,13858,167919447,0,9,1,23552,45,8515514700
2672,167972801,123069,168095870,0,9,0,1024,45,8295889343
2673,168008612,179192,168187804,0,3,0,157184,37,2063919077
2674,168016324,189903,168206227,0,3,0,60416,37,1604816164
2675,168020526,6488,168027014,0,9,1,15872,45,6378716243
2676,168029058,11533,168040591,0,6,1,18944,14,1778611786
2677,168035431,13512,168048943,0,7,1,26112,40,5505367502
2678,168087013,5971,168092984,0,9,1,14848,45,9899961765
2679,168167150,6488,168173638,0,1,1,15872,18,2239365835
2680,168185300,4374,168189674,0,1,1,4608,18,2746884344
2681,168218901,10757,168229658,0,9,1,17408,45,8148243604
2682,168421835,96716,168518551,0,3,0,27648,37,6469930885
2683,168435073,52364,168487437,0,9,0,3072,45,3953718479
2684,168578159,70220,168648379,0,3,0,11264,37,6739425453
2685,168686011,43887,168729898,0,7,1,75264,40,9910221177
2686,168686959,3387,168690346,0,4,1,9728,12,6877699588
2687,168759799,3898,168763697,0,6,1,4096,14,3727363675
2688,168789642,50672,168840314,0,9,0,2560,45,10458087325
2689,168816896,10757,168827653,0,9,1,17408,45,10127445181
2690,168898590,35829,168934419,0,7,1,62976,40,8740325513
2691,168997678,12995,169010673,0,4,1,25088,12,9854522823
2692,169060657,227687,169288344,0,7,1,373248,40,4057716931
2693,169216214,3128,169219342,0,4,1,9216,12,10672073678
2694,169244053,50090,169294143,0,7,1,19456,40,2836802659
2695,169286339,45596,169331935,0,9,0,1024,45,8080760170
2696,169302954,11533,169314487,0,9,1,18944,45,5424240517
2697,169399293,7230,169406523,0,6,1,7680,14,6865926407
2698,169614556,284649,169899205,0,7,1,460800,40,10722231241
2699,169645182,14117,169659299,0,6,1,24064,14,3183791871
2700,169645719,47444,169693163,0,9,0,2048,45,3264538462
2701,169824082,449954,170274036,0,3,0,535552,37,4125425978
2702,170275939,7230,170283169,0,6,1,7680,14,7530796591
2703,170427036,293876,170720912,0,3,0,342016,37,2553712907
2704,170730115,54212,170784327,0,9,0,4096,45,6076376022
2705,170939540,12737,170952277,0,6,1,24576,14,8134019491
2706,170954386,297308,171251694,0,3,0,353280,37,2576423900
2707,171069902,5326,171075228,0,6,1,5632,14,6143638593
2708,171102971,7706,171110677,0,0,1,8192,29,10294369607
2709,171186001,21916,171207917,0,6,1,35840,14,5679280797
2710,171196473,12315,171208788,0,6,1,12288,14,2894267161
2711,171353609,43904,171397513,0,9,0,512,45,680494268
2712,171444201,21399,171465600,0,6,1,34816,14,1365300641
2713,171481313,2470,171483783,0,3,1,2560,37,6455881673
2714,171494467,245227,171739694,0,3,0,190976,37,9792879497
2715,171518370,47444,171565814,0,9,0,2048,45,344232509
2716,171562477,45752,171608229,0,9,0,1536,45,3086321598
2717,171566061,180824,171746885,0,3,0,23552,37,5712803320
2718,171571035,25446,171596481,0,6,1,46080,14,5450717553
2719,171780233,107900,171888133,0,3,0,54272,37,1533590438
2720,171817918,4937,171822855,0,6,1,12800,14,8075200934
2721,171920702,113828,172034530,0,3,0,73728,37,7792248930
2722,171970623,4420,171975043,0,6,1,11776,14,947046686
2723,172011585,301477,172313062,0,3,0,365568,37,7370715172
2724,172065756,22950,172088706,0,6,1,37888,14,10109135565
2725,172378951,2946,172381897,0,6,1,3072,14,4466158203
2726,172527783,48980,172576763,0,9,0,2048,45,7998085614
2727,172573175,1994,172575169,0,6,1,2048,14,2549027770
2728,172659516,47288,172706804,0,9,0,1536,45,5278837644
2729,172825967,3904,172829871,0,6,1,10752,14,3706658823
2730,173497074,112268,173609342,0,3,0,68608,37,8363266654
2731,173589958,3898,173593856,0,2,1,4096,14,4047889480
2732,173775490,43904,173819394,0,9,0,512,45,3915573049
2733,174007716,15321,174023037,0,2,1,29696,14,7134341051
2734,174032901,14117,174047018,0,2,1,24064,14,3355862811
2735,174059699,6754,174066453,0,2,1,7168,14,1139640124
2736,174346762,49136,174395898,0,9,0,2560,45,5317604378
2737,174901179,120536,175021715,0,3,0,95744,37,8455628494
2738,175156343,5802,175162145,0,9,1,6144,45,7514124267
2739,175422276,3645,175425921,0,9,1,10240,45,2853481621
2740,175496884,47288,175544172,0,9,0,1536,45,1759772499
2741,175499028,5326,175504354,0,9,1,5632,45,2006744782
2742,175551983,2946,175554929,0,9,1,3072,45,4450531091
2743,175628555,2870,175631425,0,9,1,8704,45,7171316206
2744,175753975,52364,175806339,0,9,0,3072,45,6029313853
2745,175765803,202292,175968095,0,3,0,202752,37,3317344731
2746,175834014,1042,175835056,0,2,1,1024,14,923517050
2747,175903156,6278,175909434,0,9,1,6656,45,902217741
2748,176026647,48980,176075627,0,9,0,2048,45,4763313310
2749,176081056,2946,176084002,0,1,1,3072,18,5898162055
2750,176203265,5802,176209067,0,2,1,6144,14,5138886424
2751,176404893,2470,176407363,0,9,1,2560,45,871703962
2752,176456966,104468,176561434,0,3,0,43008,37,6281683218
2753,176469929,221543,176691472,0,3,0,186368,37,9800532406
2754,176531123,5454,176536577,0,9,1,13824,45,9075673904
2755,176581205,3898,176585103,0,2,1,4096,14,5095763613
2756,176744533,106652,176851185,0,3,0,50176,37,5389139446
2757,176854314,48980,176903294,0,9,0,2048,45,453026359
2758,176938714,161756,177100470,0,3,0,140288,37,7196210211
2759,176977669,55748,177033417,0,9,0,4096,45,6301607493
2760,177059355,47288,177106643,0,9,0,1536,45,2057000775
2761,177112490,1994,177114484,0,6,1,2048,14,4847566199
2762,177190308,67592,177257900,0,9,0,7680,45,3239035081
2763,177318335,11791,177330126,0,9,1,19456,45,676059858
2764,177326173,3128,177329301,0,1,1,9216,18,500335924
2765,177445113,3904,177449017,0,2,1,10752,14,5273283296
2766,177507008,84248,177591256,0,3,0,22016,37,9877268453
2767,177604742,161756,177766498,0,3,0,140288,37,8024175902
2768,177708085,6488,177714573,0,2,1,15872,14,10191338729
2769,177717886,43904,177761790,0,9,0,512,45,10400766742
2770,177849045,6488,177855533,0,3,1,15872,37,4703734123
2771,177861221,5712,177866933,0,1,1,14336,18,2665808159
2772,177894323,7230,177901553,0,2,1,7680,14,9406624711
2773,177914394,43904,177958298,0,9,0,512,45,3226221635
2774,177922157,11791,177933948,0,1,1,19456,18,6236853472
2775,177981829,15837,177997666,0,0,1,30720,29,2530643991
2776,178116749,3645,178120394,0,2,1,10240,14,5139320075
2777,178144952,21399,178166351,0,9,1,34816,45,10362203059
2778,178163722,7230,178170952,0,2,1,7680,14,10378579933
2779,178169500,15321,178184821,0,2,1,29696,14,9483080823
2780,178318958,6488,178325446,0,1,1,15872,18,2630802664
2781,178339535,52364,178391899,0,9,0,3072,45,8020497566
2782,178407932,5712,178413644,0,0,1,14336,29,4389460381
2783,178411689,6278,178417967,0,5,1,6656,20,211455574
2784,178529768,4374,178534142,0,2,1,4608,14,3799983298
2785,178568764,3387,178572151,0,1,1,9728,18,4632454193
2786,178728211,60824,178789035,0,9,0,5632,45,3665260007
2787,178775818,92972,178868790,0,3,0,15360,37,6834016541
2788,178930536,4679,178935215,0,1,1,12288,18,657552751
2789,178951942,14117,178966059,0,1,1,24064,18,4843054045
2790,178970348,3128,178973476,0,1,1,9216,18,7288789667
2791,178982798,57440,179040238,0,3,0,4608,37,5702320037
2792,178984623,13770,178998393,0,2,1,26624,14,1190832908
2793,179033342,1042,179034384,0,6,1,1024,14,2843350008
2794,179429493,4850,179434343,0,3,1,5120,37,5061345176
2795,179574917,102908,179677825,0,3,0,37888,37,2163413835
2796,179686956,5802,179692758,0,0,1,6144,29,9546764699
2797,179748853,5326,179754179,0,2,1,5632,14,5087363309
2798,179900816,47288,179948104,0,9,0,1536,45,6091755961
2799,179917069,7706,179924775,0,2,1,8192,14,10375041335
2800,179933518,21141,179954659,0,1,1,34304,18,9038577629
2801,179959464,43904,180003368,0,9,0,512,45,9206298245
2802,179969728,5971,179975699,0,0,1,14848,29,1995618527
2803,179989572,20366,180009938,0,2,1,32768,14,7399082400
2804,180005711,4162,180009873,0,6,1,11264,14,4198770587
2805,180069220,7230,180076450,0,0,1,7680,29,9938174779
2806,180089741,4420,180094161,0,2,1,11776,14,9281187460
2807,180151703,15062,180166765,0,6,1,29184,14,10341185577
2808,180309677,11533,180321210,0,0,1,18944,29,8881888454
2809,180402437,14287,180416724,0,6,1,27648,14,5458494578
2810,180475861,4850,180480711,0,2,1,5120,14,7799599855
2811,180586736,42683,180629419,0,2,1,69632,14,3209118723
2812,180702191,5196,180707387,0,5,1,13312,20,2170232325
2813,180731657,3387,180735044,0,2,1,9728,14,5402383848
2814,180788448,67592,180856040,0,9,0,7680,45,7435686190
2815,180979952,23725,181003677,0,2,1,39424,14,2495939721
2816,181012523,15321,181027844,0,0,1,29696,29,3239994447
2817,181114284,15321,181129605,0,0,1,29696,29,8035982173
2818,181502823,54056,181556879,0,9,0,3584,45,3982998858
2819,181570169,11274,181581443,0,2,1,18432,14,1682250073
2820,181731887,13341,181745228,0,2,1,22528,14,932056701
2821,181812927,6278,181819205,0,0,1,6656,29,1581509487
2822,181829753,47288,181877041,0,9,0,1536,45,8058837590
2823,181832216,2470,181834686,0,5,1,2560,20,1497569539
2824,181969886,22433,181992319,0,5,1,36864,20,3946171265
2825,182006889,4162,182011051,0,2,1,11264,14,6409952274
2826,182224235,12825,182237060,0,2,1,21504,14,4237543858
2827,182225060,102128,182327188,0,4,0,35328,12,8436724656
2828,182491819,504530,182996349,0,4,0,644096,12,10508967816
2829,182533910,2470,182536380,0,8,1,2560,21,1090894279
2830,182551494,1518,182553012,0,8,1,1536,21,4196613267
2831,182612766,4374,182617140,0,2,1,4608,14,8199224486
2832,182680961,7706,182688667,0,8,1,8192,21,1396104705
2833,182773639,4937,182778576,0,5,1,12800,20,8324235288
2834,182834595,5326,182839921,0,5,1,5632,20,8727949253
2835,182836274,3422,182839696,0,2,1,3584,14,7535720883
2836,182888007,12566,182900573,0,5,1,20992,20,3308416425
2837,182889320,16950,182906270,0,5,1,18944,20,8425690673
2838,182955390,3387,182958777,0,5,1,9728,20,3274652206
2839,182966492,125216,183091708,0,3,0,111104,37,2132429129
2840,183076052,2946,183078998,0,0,1,3072,29,3739878621
2841,183099613,103376,183202989,0,4,0,39424,12,683163632
2842,183155676,1518,183157194,0,2,1,1536,14,4672251393
2843,183295676,3422,183299098,0,0,1,3584,29,7102072709
2844,183319253,60824,183380077,0,9,0,5632,45,5721576752
2845,183406947,48980,183455927,0,9,0,2048,45,8287425896
2846,183433334,5802,183439136,0,8,1,6144,21,2407088666
2847,183515016,104312,183619328,0,3,0,42496,37,1395574453
2848,183574136,14117,183588253,0,5,1,24064,20,8556581903
2849,183652346,45596,183697942,0,9,0,1024,45,1460879932
2850,183694459,4374,183698833,0,0,1,4608,29,10175391976
2851,183876814,6488,183883302,0,2,1,15872,14,10236857009
2852,183949060,12308,183961368,0,5,1,20480,20,1873398428
2853,183989878,52364,184042242,0,3,0,3072,37,5264607178
2854,183996741,101504,184098245,0,4,0,33280,12,6622701276
2855,184011262,171109,184182371,0,4,0,81408,12,3125729458
2856,184028386,21399,184049785,0,7,1,34816,40,5864851307
2857,184120423,13770,184134193,0,2,1,26624,14,6624897719
2858,184174605,2470,184177075,0,1,1,2560,18,5149717542
2859,184245041,48980,184294021,0,9,0,2048,45,8628850037
2860,184269584,54056,184323640,0,3,0,3584,37,5224934292
2861,184333407,43975,184377382,0,2,1,72192,14,4445133222
2862,184362454,121940,184484394,0,9,0,100352,45,9122430797
2863,184549640,1042,184550682,0,5,1,1024,20,228048634
2864,184576875,22174,184599049,0,3,1,36352,37,7876291722
2865,184696309,125996,184822305,0,9,0,113664,45,693385149
2866,184910159,107432,185017591,0,9,0,52736,45,2268123883
2867,184925693,140114,185065807,0,9,0,49664,45,3780296210
2868,185001498,209624,185211122,0,4,0,226816,12,5082582862
2869,185020894,84475,185105369,0,2,1,137728,14,6276558747
2870,185098394,13341,185111735,0,3,1,22528,37,5461126040
2871,185285709,7706,185293415,0,5,1,8192,20,9334000671
2872,185380163,15837,185396000,0,5,1,30720,20,6937459911
2873,185386391,126620,185513011,0,3,0,115712,37,945058900
2874,185398522,5802,185404324,0,5,1,6144,20,10445246752
2875,185486440,142263,185628703,0,3,0,79872,37,2409361560
2876,185636718,14804,185651522,0,2,1,28672,14,378244101
2877,185677796,32299,185710095,0,2,1,52736,14,10659439707
2878,185685298,282020,185967318,0,4,0,303104,12,1181156479
2879,185841167,200173,186041340,0,4,0,161792,12,3444073888
2880,185851245,4420,185855665,0,5,1,11776,20,7664734315
2881,185966484,5712,185972196,0,5,1,14336,20,7542217505
2882,185974374,104637,186079011,0,2,1,173568,14,2282444922
2883,186029496,3422,186032918,0,5,1,3584,20,7655808808
2884,186082019,116571,186198590,0,2,1,193536,14,3241923363
2885,186146036,3645,186149681,0,5,1,10240,20,8127292847
2886,186179860,113672,186293532,0,3,0,73216,37,4341363820
2887,186191877,6867,186198744,0,2,1,8704,14,2605559978
2888,186248389,7230,186255619,0,2,1,7680,14,4555767609
2889,186268533,210560,186479093,0,3,0,229888,37,8419251152
2890,186328889,184728,186513617,0,3,0,43520,37,8557633563
2891,186368796,43458,186412254,0,5,1,71168,20,10214582215
2892,186470327,165140,186635467,0,4,0,141312,12,10367279006
2893,186474640,1518,186476158,0,5,1,1536,20,178711766
2894,186510091,43112,186553203,0,2,1,73728,14,4266412910
2895,186525198,112268,186637466,0,3,0,68608,37,8757256214
2896,186575044,3645,186578689,0,0,1,10240,29,4099514128
2897,186666737,57440,186724177,0,4,0,4608,12,5978949727
2898,186670022,104624,186774646,0,3,0,43520,37,375409573
2899,187061728,198548,187260276,0,4,0,190464,12,9860143777
2900,187145013,129584,187274597,0,9,0,125440,45,3479776222
2901,187280475,103844,187384319,0,4,0,40960,12,281203394
2902,187449178,74262,187523440,0,2,1,124416,14,937180780
2903,187455828,98769,187554597,0,2,1,99840,14,3328454602
2904,187552360,184244,187736604,0,3,0,153600,37,4231052608
2905,187622932,73760,187696692,0,4,0,12800,12,7341856822
2906,187927464,5971,187933435,0,1,1,14848,18,6381316653
2907,187971277,566,187971843,0,1,1,512,18,3434352858
2908,188004535,33245,188037780,0,2,1,57856,14,1644836090
2909,188150616,21399,188172015,0,1,1,34816,18,1280703028
2910,188155147,74540,188229687,0,9,0,15360,45,4893392140
2911,188294162,268724,188562886,0,9,0,284672,45,6058035852
2912,188502088,14545,188516633,0,1,1,28160,18,4096875553
2913,188552082,98540,188650622,0,4,0,23552,12,8220492018
2914,188571102,235616,188806718,0,3,0,266752,37,1872788494
2915,188636528,13083,188649611,0,9,1,22016,45,7388687751
2916,188750789,113672,188864461,0,9,0,73216,45,5608519031
2917,188901493,76052,188977545,0,4,0,10240,12,5558704226
2918,188952421,7230,188959651,0,1,1,7680,18,10087161881
2919,188962241,69284,189031525,0,9,0,8192,45,460547396
2920,189008743,207128,189215871,0,4,0,218624,12,5554581288
2921,189140757,65687,189206444,0,2,1,111104,14,6381181234
2922,189178795,88388,189267183,0,9,0,20480,45,1563548742
2923,189222157,5326,189227483,0,3,1,5632,37,911123388
2924,189295345,2870,189298215,0,1,1,8704,18,2799547531
2925,189355706,120380,189476086,0,9,0,95232,45,9276799006
2926,189411201,149173,189560374,0,9,0,72192,45,391419649
2927,189439059,4937,189443996,0,6,1,12800,14,2714271863
2928,189453444,14029,189467473,0,1,1,27136,18,913241080
2929,189525296,108368,189633664,0,4,0,55808,12,7641007422
2930,189662004,201668,189863672,0,3,0,200704,37,4934727171
2931,189710573,193233,189903806,0,3,0,104448,37,7301592954
2932,189850823,14117,189864940,0,2,1,24064,14,3147730151
2933,190026710,82064,190108774,0,3,0,14848,37,6757885126
2934,190117119,215864,190332983,0,4,0,247296,12,8838751715
2935,190168302,116792,190285094,0,3,0,83456,37,10262214997
2936,190212502,140665,190353167,0,4,0,49152,12,8878310859
2937,190415509,6278,190421787,0,1,1,6656,18,7488578091
2938,190464975,115108,190580083,0,2,1,187392,14,374659562
2939,190680709,12737,190693446,0,2,1,24576,14,8176612678
2940,190707166,193088,190900254,0,4,0,172544,12,1712754027
2941,191169693,133549,191303242,0,2,1,216576,14,3575711821
2942,191280231,115388,191395619,0,3,0,78848,37,10545203498
2943,191889026,36863,191925889,0,7,1,65024,40,6432696244
2944,192134218,4162,192138380,0,1,1,11264,18,8066563145
2945,192334102,4679,192338781,0,1,1,12288,18,3949079384
2946,192390693,3128,192393821,0,1,1,9216,18,151258236
2947,192632914,21916,192654830,0,1,1,35840,18,1082513982
2948,192725942,13770,192739712,0,1,1,26624,18,6122664986
2949,192807229,84216,192891445,0,2,1,137216,14,8708197908
2950,192843647,175292,193018939,0,4,0,144384,12,10145086305
2951,193067225,125920,193193145,0,2,1,208384,14,1633035146
2952,193103156,111488,193214644,0,4,0,66048,12,1542295852
2953,193697294,77744,193775038,0,4,0,10752,12,4466926656
2954,193772160,32816,193804976,0,2,1,53760,14,6849328230
2955,193832388,131300,193963688,0,4,0,131072,12,4077507977
2956,193902622,36604,193939226,0,8,1,64512,21,3839219806
2957,193977974,11274,193989248,0,0,1,18432,29,6392136566
2958,194161094,5454,194166548,0,8,1,13824,21,7726159353
2959,194367747,11016,194378763,0,8,1,17920,21,7606320824
2960,194382088,104895,194486983,0,2,1,174080,14,2734026106
2961,194411339,81750,194493089,0,2,1,20992,14,4271741085
2962,194497694,234860,194732554,0,4,0,269312,12,5635743894
2963,194651525,102399,194753924,0,7,1,165888,40,8270472849
2964,194691295,2470,194693765,0,2,1,2560,14,4553201258
2965,194808108,13770,194821878,0,8,1,26624,21,5470282031
2966,194858707,42166,194900873,0,5,1,68608,20,5429638930
2967,194873964,36863,194910827,0,0,1,65024,29,2788946315
2968,195003393,63708,195067101,0,7,1,103936,40,1673312424
2969,195094212,3898,195098110,0,6,1,4096,14,5933821966
2970,195139654,14287,195153941,0,2,1,27648,14,1556041
2971,195167707,5454,195173161,0,5,1,13824,20,9552290189
2972,195183955,3422,195187377,0,5,1,3584,20,8307107044
2973,195184880,4937,195189817,0,9,1,12800,45,8455468194
2974,195289217,10499,195299716,0,0,1,16896,29,488508025
2975,195330611,13341,195343952,0,8,1,22528,21,436469599
2976,195343851,66721,195410572,0,7,1,113152,40,6235510349
2977,195356659,5454,195362113,0,3,1,13824,37,10183368488
2978,195513726,2870,195516596,0,0,1,8704,29,6273324141
2979,195561163,3422,195564585,0,8,1,3584,21,841996400
2980,195610278,83700,195693978,0,7,1,136192,40,5026374205
2981,195639034,104895,195743929,0,2,1,174080,14,4446401153
2982,195679391,5196,195684587,0,5,1,13312,20,9989658195
2983,195717730,1042,195718772,0,5,1,1024,20,517585770
2984,195737530,4937,195742467,0,5,1,12800,20,5301883800
2985,195743407,193266,195936673,0,2,1,312832,14,6864446897
2986,195751246,6754,195758000,0,5,1,7168,20,3429338634
2987,195834420,2946,195837366,0,8,1,3072,21,6592098707
2988,195937456,4850,195942306,0,5,1,5120,20,8381297114
2989,195957044,3904,195960948,0,7,1,10752,40,9274467572
2990,196003495,14545,196018040,0,5,1,28160,20,6940072765
2991,196027986,5326,196033312,0,5,1,5632,20,4963425767
2992,196079953,10499,196090452,0,0,1,16896,29,7189303777
2993,196117699,5196,196122895,0,0,1,13312,29,8926970292
2994,196125733,23120,196148853,0,8,1,41472,21,7499891502
2995,196155353,2470,196157823,0,8,1,2560,21,1240870782
2996,196164187,5971,196170158,0,0,1,14848,29,4985334612
2997,196209245,206233,196415478,0,7,1,334848,40,5288840510
2998,196221467,20882,196242349,0,5,1,33792,20,3046791320
2999,196248108,34795,196282903,0,4,1,60928,12,1663820958
3000,196286587,1994,196288581,0,5,1,2048,20,6129936728
3001,196423091,5712,196428803,0,5,1,14336,20,3418327042
3002,196475131,3128,196478259,0,8,1,9216,21,5150979385
3003,196640347,56337,196696684,0,2,1,96256,14,8696627451
3004,196757520,81374,196838894,0,2,1,131584,14,4366105062
3005,196813481,115795,196929276,0,2,1,192000,14,2936700259
3006,196871732,226137,197097869,0,7,1,370176,40,3640636434
3007,196912670,59132,196971802,0,4,0,5120,12,6468976531
3008,196913403,216100,197129503,0,2,1,350720,14,7427609378
3009,196923651,10499,196934150,0,5,1,16896,20,7002372463
3010,196994880,20882,197015762,0,8,1,33792,21,10679618911
3011,197006990,237488,197244478,0,2,1,363008,14,10096192890
3012,197016842,86621,197103463,0,7,1,18432,40,5741485267
3013,197021725,234402,197256127,0,2,1,39424,14,4125015719
3014,197065058,566,197065624,0,3,1,512,37,10040560222
3015,197097791,3645,197101436,0,5,1,10240,20,5932891932
3016,197181498,15837,197197335,0,8,1,30720,21,9106067113
3017,197338443,3898,197342341,0,6,1,4096,14,7518374396
3018,197370166,105154,197475320,0,2,1,174592,14,8742392623
3019,197382712,23208,197405920,0,7,1,38400,40,168554155
3020,197391789,13253,197405042,0,5,1,25600,20,8405337060
3021,197397244,32987,197430231,0,6,1,57344,14,9861534155
3022,197443169,113816,197556985,0,7,1,184832,40,2784889181
3023,197525780,1042,197526822,0,8,1,1024,21,4828650100
3024,197626482,6278,197632760,0,5,1,6656,20,10685365041
3025,197641890,326700,197968590,0,7,1,529408,40,2251681517
3026,197648718,3645,197652363,0,8,1,10240,21,4682065840
3027,197670254,4374,197674628,0,5,1,4608,20,9183908415
3028,197673129,11274,197684403,0,5,1,18432,20,6369184952
3029,197776388,91499,197867887,0,2,1,147968,14,896050110
3030,197828791,100256,197929047,0,4,0,29184,12,10640443439
3031,197977522,12995,197990517,0,6,1,25088,14,8979562481
3032,197996611,7230,198003841,0,4,1,7680,12,7858942938
3033,198063799,2946,198066745,0,6,1,3072,14,8064594807
3034,198116037,207954,198323991,0,7,1,341504,40,846623883
3035,198134177,210705,198344882,0,7,1,67072,40,9656112979
3036,198164982,13770,198178752,0,4,1,26624,12,8386586265
3037,198187577,5712,198193289,0,4,1,14336,12,6490696828
3038,198241002,181439,198422441,0,7,1,256512,40,9015152843
3039,198333820,276245,198610065,0,7,1,451072,40,9002865866
3040,198376387,7230,198383617,0,6,1,7680,14,2574288061
3041,198580964,4374,198585338,0,4,1,4608,12,1501578398
3042,198657335,329712,198987047,0,2,1,538624,14,573864207
3043,198862817,141012,199003829,0,2,1,55808,14,3231760899
3044,198908421,23725,198932146,0,7,1,39424,40,284967881
3045,199002508,13770,199016278,0,7,1,26624,40,539088373
3046,199248471,753412,200001883,0,7,1,1223680,40,6099108643
3047,199274033,41132,199315165,0,2,1,66560,14,3062951758
3048,199495801,46212,199542013,0,2,1,79872,14,9946895223
3049,199575304,14117,199589421,0,1,1,24064,18,4724716876
3050,199665805,45179,199710984,0,2,1,77824,14,7220347950
3051,200296981,154833,200451814,0,2,1,251392,14,6651199402
3052,200407787,20882,200428669,0,3,1,33792,37,8839919260
3053,200465192,10499,200475691,0,3,1,16896,37,1728467359
3054,200475632,5454,200481086,0,4,1,13824,12,7818060774
3055,200599276,5712,200604988,0,2,1,14336,14,8734288247
3056,200757540,2946,200760486,0,4,1,3072,12,8783427859
3057,200863270,2870,200866140,0,4,1,8704,12,7767272901
3058,200912005,12049,200924054,0,4,1,19968,12,7134060793
3059,201033857,137079,201170936,0,2,1,226816,14,5021236126
3060,201136796,5196,201141992,0,4,1,13312,12,3345070973
3061,201147316,28126,201175442,0,2,1,7168,14,9724290129
3062,201314449,74779,201389228,0,2,1,125440,14,1879961146
3063,201333402,163936,201497338,0,2,1,238080,14,6621470024
3064,201434490,74360,201508850,0,4,0,9728,12,3838371561
3065,201691410,1518,201692928,0,3,1,1536,37,10087234582
3066,201769271,1518,201770789,0,3,1,1536,37,7306443057
3067,201812822,7706,201820528,0,0,1,8192,29,976433662
3068,201879707,7230,201886937,0,3,1,7680,37,5988415758
3069,201908492,4420,201912912,0,0,1,11776,29,7743129667
3070,201967608,1518,201969126,0,3,1,1536,37,1848830678
3071,201969806,42683,202012489,0,2,1,69632,14,4508553517
3072,201972902,35829,202008731,0,0,1,62976,29,8571467459
3073,202075640,23466,202099106,0,3,1,38912,37,9761175089
3074,202075840,6754,202082594,0,0,1,7168,29,4869506882
3075,202118927,30749,202149676,0,3,1,49664,37,8206945267
3076,202183873,4374,202188247,0,4,1,4608,12,9681258940
3077,202221703,94770,202316473,0,2,1,157696,14,9880395173
3078,202310061,16096,202326157,0,0,1,31232,29,1117374707
3079,202355091,3898,202358989,0,4,1,4096,12,6501148931
3080,202368672,6278,202374950,0,6,1,6656,14,2661793139
3081,202391210,6488,202397698,0,6,1,15872,14,3345336113
3082,202535679,5971,202541650,0,3,1,14848,37,327098287
3083,202687129,24929,202712058,0,6,1,45056,14,7599338659
3084,202730387,566,202730953,0,4,1,512,12,8066193350
3085,202783471,280148,203063619,0,4,0,296960,12,3021132348
3086,202808454,11533,202819987,0,4,1,18944,12,5298719339
3087,202854521,6488,202861009,0,1,1,15872,18,2598580223
3088,202967215,11016,202978231,0,0,1,17920,29,9410062263
3089,203075253,71156,203146409,0,4,0,14336,12,163181972
3090,203185463,1042,203186505,0,1,1,1024,18,7833725242
3091,203186015,14545,203200560,0,1,1,28160,18,802530067
3092,203237469,13770,203251239,0,6,1,26624,14,8793749775
3093,203344413,10241,203354654,0,4,1,16384,12,4189157456
3094,203642019,347725,203989744,0,2,1,563712,14,368475022
3095,203730394,4374,203734768,0,1,1,4608,18,9279864895
3096,203744368,7230,203751598,0,0,1,7680,29,676192648
3097,203854023,4937,203858960,0,1,1,12800,18,6059554428
3098,203856279,116792,203973071,0,4,0,83456,12,2254792569
3099,203871780,7230,203879010,0,1,1,7680,18,5428692616
3100,203890343,2946,203893289,0,4,1,3072,12,3709465033
3101,203953144,127507,204080651,0,4,0,53248,12,7015668771
3102,203993879,13341,204007220,0,1,1,22528,18,6466274607
3103,204016572,10757,204027329,0,1,1,17408,18,6774032218
3104,204068327,16354,204084681,0,6,1,31744,14,378230871
3105,204143760,1994,204145754,0,6,1,2048,14,5040335946
3106,204228094,12566,204240660,0,6,1,20992,14,7945007405
3107,204229467,13512,204242979,0,4,1,26112,12,1909658698
3108,204230273,17891,204248164,0,4,1,16384,12,889407854
3109,204233992,11016,204245008,0,0,1,17920,29,1756618594
3110,204342292,3128,204345420,0,1,1,9216,18,2420917286
3111,204366961,13253,204380214,0,4,1,25600,12,4176334833
3112,204386361,3645,204390006,0,4,1,10240,12,3194025799
3113,204401022,250510,204651532,0,4,0,46080,12,2113609146
3114,204616214,6754,204622968,0,6,1,7168,14,7412630264
3115,204669412,13083,204682495,0,6,1,22016,14,9492056724
3116,204716243,195428,204911671,0,4,0,180224,12,1152562706
3117,204756151,566,204756717,0,1,1,512,18,7130413684
3118,204788004,4374,204792378,0,1,1,4608,18,2568675270
3119,204811776,5326,204817102,0,0,1,5632,29,2952627814
3120,204832849,10757,204843606,0,0,1,17408,29,4602800680
3121,204866575,12308,204878883,0,6,1,20480,14,4658693917
3122,204953485,177062,205130547,0,2,1,291328,14,9181641888
3123,205094194,2946,205097140,0,0,1,3072,29,7687145529
3124,205127369,22950,205150319,0,0,1,37888,29,4569324817
3125,205269972,84992,205354964,0,7,1,138752,40,4998611547
3126,205312842,2870,205315712,0,0,1,8704,29,8544315135
3127,205313008,125920,205438928,0,7,1,208384,40,5484030061
3128,205409264,14029,205423293,0,6,1,27136,14,4254213177
3129,205482731,358537,205841268,0,7,1,584704,40,6778644359
3130,205642409,4679,205647088,0,4,1,12288,12,8902534467
3131,205684892,114920,205799812,0,4,0,77312,12,5883090438
3132,205693985,3128,205697113,0,4,1,9216,12,7656517391
3133,205718907,20366,205739273,0,0,1,32768,29,1366808032
3134,205820583,2870,205823453,0,4,1,8704,12,4683496627
3135,205842842,2470,205845312,0,0,1,2560,29,6065431988
3136,205975895,24670,206000565,0,7,1,44544,40,157433671
3137,206029410,121316,206150726,0,4,0,98304,12,6125766768
3138,206030363,7706,206038069,0,4,1,8192,12,7719015027
3139,206089807,13341,206103148,0,7,1,22528,40,6656629164
3140,206112947,5196,206118143,0,0,1,13312,29,1153886817
3141,206184427,11533,206195960,0,1,1,18944,18,6235554813
3142,206300667,12825,206313492,0,4,1,21504,12,3416828503
3143,206302753,32299,206335052,0,7,1,52736,40,9735652660
3144,206403075,13341,206416416,0,6,1,22528,14,3697024214
3145,206483820,42424,206526244,0,2,1,69120,14,6784548957
3146,206514993,16538,206531531,0,2,1,25088,14,8569463787
3147,206604080,446391,207050471,0,2,1,722432,14,6419379403
3148,206721389,3645,206725034,0,8,1,10240,21,2050483314
3149,206796068,13600,206809668,0,6,1,23040,14,10572845411
3150,206858586,10499,206869085,0,0,1,16896,29,414744572
3151,206874192,2946,206877138,0,4,1,3072,12,3492226650
3152,206880460,11533,206891993,0,8,1,18944,21,3882543290
3153,206968878,4374,206973252,0,0,1,4608,29,4994366904
3154,207058876,3904,207062780,0,4,1,10752,12,5349557721
3155,207118698,3387,207122085,0,6,1,9728,14,7566362799
3156,207168933,96321,207265254,0,2,1,160768,14,5564341673
3157,207322415,13600,207336015,0,6,1,23040,14,3770563211
3158,207490181,5802,207495983,0,1,1,6144,18,8116834265
3159,207550077,43370,207593447,0,7,1,74240,40,5560790612
3160,207575430,10241,207585671,0,4,1,16384,12,7916343643
3161,207606732,3645,207610377,0,0,1,10240,29,6446587783
3162,207670410,5971,207676381,0,0,1,14848,29,4219831279
3163,207729982,195850,207925832,0,7,1,317952,40,4373708108
3164,207765272,2946,207768218,0,4,1,3072,12,3945564810
3165,207776107,24412,207800519,0,0,1,44032,29,232216775
3166,207958609,72799,208031408,0,7,1,118272,40,3523182888
3167,208020756,11016,208031772,0,6,1,17920,14,10222138710
3168,208042981,4374,208047355,0,4,1,4608,12,2555885203
3169,208069611,4850,208074461,0,0,1,5120,29,9419564750
3170,208123968,12049,208136017,0,2,1,19968,14,7678564469
3171,208211317,36863,208248180,0,7,1,65024,40,5155288765
3172,208217426,279056,208496482,0,4,0,293376,12,6385823232
3173,208247638,351624,208599262,0,4,0,184832,12,5248417198
3174,208279175,4679,208283854,0,1,1,12288,18,8426280214
3175,208501589,13512,208515101,0,0,1,26112,29,2519293281
3176,208525709,145654,208671363,0,7,1,240128,40,4365490034
3177,208529034,213496,208742530,0,4,0,194048,12,9718685557
3178,208539454,20366,208559820,0,1,1,32768,18,10721000031
3179,208574341,6754,208581095,0,0,1,7168,29,5148617241
3180,208583262,89689,208672951,0,7,1,15872,40,6136086247
3181,208586549,306362,208892911,0,2,1,499712,14,3598477256
3182,208651120,10241,208661361,0,4,1,16384,12,461429564
3183,208704770,45475,208750245,0,4,1,8192,12,6298232506
3184,208716769,224950,208941719,0,4,0,192512,12,10132950331
3185,208771468,7230,208778698,0,0,1,7680,29,2889170416
3186,208786623,5971,208792594,0,6,1,14848,14,6229454007
3187,208984529,23725,209008254,0,7,1,39424,40,1787450847
3188,209042066,7230,209049296,0,4,1,7680,12,8904922201
3189,209122859,3898,209126757,0,4,1,4096,12,6003186431
3190,209191164,4679,209195843,0,1,1,12288,18,592584839
3191,209197680,73487,209271167,0,2,1,122880,14,6356061812
3192,209258806,81632,209340438,0,6,1,132096,14,4158156442
3193,209360905,12737,209373642,0,0,1,24576,29,5807591468
3194,209428989,22433,209451422,0,7,1,36864,40,210662457
3195,209430354,196208,209626562,0,4,0,182784,12,2152628167
3196,209442832,6278,209449110,0,4,1,6656,12,5291863924
3197,209461585,6488,209468073,0,1,1,15872,18,355174406
3198,209637224,14117,209651341,0,7,1,24064,40,2798326301
3199,209729793,94858,209824651,0,2,1,154624,14,7659102371
3200,209735136,32041,209767177,0,6,1,52224,14,1878758863
3201,209751508,100293,209851801,0,2,1,89088,14,7292673371
3202,209774803,4850,209779653,0,4,1,5120,12,2203385338
3203,209868229,566,209868795,0,6,1,512,14,8457318514
3204,209885752,108368,209994120,0,4,0,55808,12,3260997589
3205,209992520,186124,210178644,0,4,0,149504,12,3462603616
3206,210065272,11016,210076288,0,0,1,17920,29,10695752508
3207,210144638,175600,210320238,0,6,1,285184,14,1725037737
3208,210238444,93136,210331580,0,6,1,46080,14,5257104052
3209,210270722,13770,210284492,0,0,1,26624,29,3761288605
3210,210336145,3645,210339790,0,0,1,10240,29,4186751771
3211,210425193,101504,210526697,0,3,0,33280,37,1773864463
3212,210441900,59912,210501812,0,4,0,7680,12,573211446
3213,210565512,23120,210588632,0,2,1,41472,14,5765774610
3214,210600511,5802,210606313,0,2,1,6144,14,8991018442
3215,210647431,50999,210698430,0,7,1,82432,40,4118680009
3216,210731710,50741,210782451,0,6,1,81920,14,6961689793
3217,210741720,566,210742286,0,4,1,512,12,8229606682
3218,210834343,87476,210921819,0,3,0,22528,37,8505854179
3219,210841879,64483,210906362,0,2,1,105472,14,8410516893
3220,211023121,20882,211044003,0,6,1,33792,14,10371760498
3221,211036552,22433,211058985,0,6,1,36864,14,10121652352
3222,211048465,3387,211051852,0,8,1,9728,21,9941204388
3223,211141973,3898,211145871,0,0,1,4096,29,4432026438
3224,211158438,10241,211168679,0,8,1,16384,21,2283426060
3225,211201740,13083,211214823,0,0,1,22016,29,7450278628
3226,211221983,94253,211316236,0,2,1,156672,14,10731416122
3227,211245033,247937,211492970,0,7,1,406016,40,2026938848
3228,211357594,141482,211499076,0,7,1,20992,40,7063781208
3229,211385520,63140,211448660,0,4,0,8192,12,2341147387
3230,211414496,7230,211421726,0,8,1,7680,21,3820256806
3231,211507327,1042,211508369,0,8,1,1024,21,7442358881
3232,211563810,3898,211567708,0,0,1,4096,29,8434488932
3233,211569175,4937,211574112,0,2,1,12800,14,10594655615
3234,211643475,3898,211647373,0,8,1,4096,21,2005907470
3235,211662479,34367,211696846,0,2,1,56832,14,5620773741
3236,211731411,1042,211732453,0,7,1,1024,40,923022407
3237,211758023,32558,211790581,0,7,1,53248,40,2154825424
3238,211789064,244149,212033213,0,7,1,395264,40,3061322343
3239,211792660,46729,211839389,0,6,1,80896,14,6232061243
3240,211815130,311450,212126580,0,7,1,299520,40,2023390582
3241,211844205,61760,211905965,0,3,0,8704,37,5198654104
3242,211845122,4850,211849972,0,0,1,5120,29,9249924650
3243,211863264,108836,211972100,0,4,0,57344,12,1673322801
3244,211918704,11791,211930495,0,8,1,19456,21,7107995670
3245,212092020,55451,212147471,0,7,1,75264,40,6779602184
3246,212158057,118820,212276877,0,3,0,90112,37,8995650946
3247,212282389,103691,212386080,0,6,1,168448,14,6811441374
3248,212371000,104725,212475725,0,6,1,170496,14,7457922610
3249,212395919,132498,212528417,0,6,1,175104,14,7583205130
3250,212640534,53583,212694117,0,7,1,87552,40,115117082
3251,212767892,63362,212831254,0,6,1,106496,14,2436400515
3252,212856806,14804,212871610,0,8,1,28672,21,5917819504
3253,212941464,12737,212954201,0,8,1,24576,21,1118048809
3254,212957076,157329,213114405,0,6,1,259584,14,8123336940
3255,212958362,79436,213037798,0,3,0,11264,37,9678658915
3256,213067392,205716,213273108,0,7,1,333824,40,8173300430
3257,213124414,124748,213249162,0,4,0,109568,12,5361205952
3258,213160468,136604,213297072,0,4,0,33792,12,8940701591
3259,213181602,71507,213253109,0,6,1,115712,14,7102651135
3260,213197892,126494,213324386,0,6,1,179200,14,7136684064
3261,213203290,1994,213205284,0,8,1,2048,21,9890998899
3262,213279481,12995,213292476,0,8,1,25088,21,6490867298
3263,213294932,7706,213302638,0,8,1,8192,21,5786987995
3264,213343390,1042,213344432,0,1,1,1024,18,2021867219
3265,213345460,2946,213348406,0,0,1,3072,29,2535377228
3266,213449199,1994,213451193,0,8,1,2048,21,4420697719
3267,213472096,101036,213573132,0,3,0,31744,37,1102828429
3268,213597079,5326,213602405,0,0,1,5632,29,1583250476
3269,213658159,86196,213744355,0,6,1,144384,14,472692793
3270,213810846,1518,213812364,0,8,1,1536,21,5824012862
3271,213812289,111800,213924089,0,6,0,67072,14,6328487086
3272,213931561,346950,214278511,0,7,1,562176,40,6503949473
3273,213964588,127556,214092144,0,4,0,118784,12,9149363389
3274,213973630,54787,214028417,0,6,1,93184,14,5242510435
3275,213982956,56700,214039656,0,6,1,37376,14,76663714
3276,213986731,102128,214088859,0,3,0,35328,37,5059006655
3277,213993974,342280,214336254,0,7,1,194560,40,9157347708
3278,214087619,192925,214280544,0,4,0,157184,12,10320423728
3279,214228284,87320,214315604,0,4,0,22016,12,5200045676
3280,214302449,50999,214353448,0,6,1,82432,14,1328424550
3281,214308867,142124,214450991,0,7,1,229888,40,4734269794
3282,214512792,23208,214536000,0,7,1,38400,40,1252788147
3283,214603410,101816,214705226,0,3,0,34304,37,9743412242
3284,214667520,116012,214783532,0,4,0,80896,12,10477973914
3285,214726059,210560,214936619,0,9,0,229888,45,6749632208
3286,214761489,131999,214893488,0,7,1,213504,40,2579576151
3287,214868249,122925,214991174,0,4,0,103424,12,3990312197
3288,214888318,138124,215026442,0,4,0,57856,12,1868493054
3289,214950705,62158,215012863,0,1,1,100864,18,6722301094
3290,215061087,5802,215066889,0,8,1,6144,21,836113479
3291,215098964,6488,215105452,0,8,1,15872,21,3392909656
3292,215103785,387488,215491273,0,4,0,487936,12,3626854820
3293,215260111,96579,215356690,0,7,1,161280,40,2160095343
3294,215358750,107744,215466494,0,3,0,53760,37,4096211351
3295,215384762,74520,215459282,0,7,1,124928,40,9462057842
3296,215432136,125920,215558056,0,7,1,208384,40,3926431745
3297,215457172,138118,215595290,0,3,0,122880,37,2493658913
3298,215473815,14029,215487844,0,1,1,27136,18,1263822349
3299,215490342,24670,215515012,0,8,1,44544,21,7621722106
3300,215513505,12737,215526242,0,3,1,24576,37,3133532438
3301,215522046,219296,215741342,0,4,0,258560,12,6830572383
3302,215542412,123166,215665578,0,6,1,199680,14,4357066400
3303,215584260,22691,215606951,0,8,1,37376,21,10525306374
3304,215595506,1994,215597500,0,1,1,2048,18,1092986631
3305,215604877,176545,215781422,0,6,1,290304,14,2895311837
3306,215659276,179377,215838653,0,6,1,192000,14,1665455596
3307,215718182,21399,215739581,0,7,1,34816,40,5087713544
3308,215763595,10499,215774094,0,8,1,16896,21,4546689069
3309,215873286,3645,215876931,0,8,1,10240,21,520227577
3310,215912219,124904,216037123,0,4,0,110080,12,3096705847
3311,215933218,144450,216077668,0,7,1,234496,40,8277673826
3312,215950037,5196,215955233,0,9,1,13312,45,9549631512
3313,215957581,22950,215980531,0,8,1,37888,21,9784890619
3314,215964961,84128,216049089,0,6,1,140288,14,7469895060
3315,215992122,1994,215994116,0,9,1,2048,45,8802066249
3316,215993122,3387,215996509,0,9,1,9728,45,3843453280
3317,216010286,2470,216012756,0,8,1,2560,21,6953298984
3318,216017407,1518,216018925,0,8,1,1536,21,1714648712
3319,216185726,199328,216385054,0,3,0,193024,37,2515630686
3320,216242645,52549,216295194,0,6,1,85504,14,3321027031
3321,216558615,1518,216560133,0,9,1,1536,45,9407620759
3322,216676695,14029,216690724,0,7,1,27136,40,6335533548
3323,216676986,198392,216875378,0,4,0,189952,12,2905848653
3324,216692484,4162,216696646,0,9,1,11264,45,2815629816
3325,216704691,1994,216706685,0,9,1,2048,45,9507355696
3326,216729031,6754,216735785,0,1,1,7168,18,6028494153
3327,216747735,7230,216754965,0,9,1,7680,45,1248850038
3328,216786719,6754,216793473,0,8,1,7168,21,4385497660
3329,216844086,158216,217002302,0,4,0,116736,12,6976476990
3330,216969331,15837,216985168,0,8,1,30720,21,355871693
3331,216973045,4374,216977419,0,9,1,4608,45,7460828351
3332,216995891,4937,217000828,0,8,1,12800,21,7720942224
3333,217045818,100256,217146074,0,3,0,29184,37,322687826
3334,217155148,331472,217486620,0,3,0,399872,37,10602231580
3335,217180403,7230,217187633,0,7,1,7680,40,4529457007
3336,217380642,5712,217386354,0,8,1,14336,21,197569941
3337,217404304,3898,217408202,0,9,1,4096,45,4889385098
3338,217452030,6488,217458518,0,9,1,15872,45,6881267311
3339,217583017,291224,217874241,0,3,0,333312,37,5092690426
3340,217588885,96824,217685709,0,4,0,17920,12,3083526878
3341,217597242,2946,217600188,0,8,1,3072,21,8371473178
3342,217743447,125662,217869109,0,7,1,207872,40,348105680
3343,217785132,5326,217790458,0,8,1,5632,21,432736902
3344,217798967,107120,217906087,0,4,0,51712,12,9403337288
3345,217801685,1042,217802727,0,9,1,1024,45,9598107144
3346,217882241,7230,217889471,0,9,1,7680,45,5715901662
3347,217900770,44920,217945690,0,7,1,77312,40,2485242037
3348,217901446,8020,217909466,0,4,1,9728,12,8098241006
3349,217974943,101624,218076567,0,7,1,164352,40,7248548153
3350,218159338,14287,218173625,0,9,1,27648,45,4409814155
3351,218611931,43628,218655559,0,8,1,74752,21,6231069094
3352,218800028,162374,218962402,0,7,1,262656,40,2986537414
3353,219055541,82666,219138207,0,7,1,134144,40,1773992954
3354,219145656,86712,219232368,0,7,1,145408,40,3325140992
3355,219180150,116948,219297098,0,4,0,83968,12,3304571504
3356,219194222,566,219194788,0,9,1,512,45,1978873442
3357,219265829,10757,219276586,0,8,1,17408,21,9266470266
3358,219308942,2870,219311812,0,8,1,8704,21,5831052463
3359,219439555,124904,219564459,0,3,0,110080,37,843598782
3360,219490856,6278,219497134,0,9,1,6656,45,9543306193
3361,219513681,81632,219595313,0,7,1,132096,40,3037777679
3362,219635437,2870,219638307,0,8,1,8704,21,8262136484
3363,219638994,244666,219883660,0,7,1,396288,40,5744174858
3364,219662575,237252,219899827,0,7,1,60928,40,7825109723
3365,219722447,198885,219921332,0,7,1,78336,40,3830154372
3366,219770937,3387,219774324,0,9,1,9728,45,4390777678
3367,219988526,118352,220106878,0,3,0,88576,37,8682269718
3368,220011349,242223,220253572,0,3,0,180736,37,2701740582
3369,220090331,11791,220102122,0,9,1,19456,45,4362488942
3370,220176567,190280,220366847,0,4,0,163328,12,10369822378
3371,220280987,4850,220285837,0,8,1,5120,21,643418688
3372,220283118,5712,220288830,0,9,1,14336,45,7369388920
3373,220343076,150383,220493459,0,4,0,115712,12,9794254644
3374,220501635,127088,220628723,0,4,0,117248,12,5831705809
3375,220506467,1994,220508461,0,3,1,2048,37,8522548173
3376,220545286,150913,220696199,0,4,0,79360,12,5433301383
3377,220616579,125840,220742419,0,3,0,113152,37,5807961983
3378,220637368,266725,220904093,0,7,1,432640,40,359867566
3379,220702534,6278,220708812,0,9,1,6656,45,4680030816
3380,220727716,100899,220828615,0,3,0,13312,37,4657864994
3381,220791997,49136,220841133,0,3,0,2560,37,10172390103
3382,220813754,102908,220916662,0,3,0,37888,37,8739711843
3383,220879949,116627,220996576,0,3,0,72192,37,8988799098
3384,220929908,4374,220934282,0,9,1,4608,45,7850161010
3385,221109893,121004,221230897,0,4,0,97280,12,96966069
3386,221121503,186536,221308039,0,3,0,151040,37,335602809
3387,221233189,5802,221238991,0,9,1,6144,45,9685897852
3388,221449873,10499,221460372,0,9,1,16896,45,1171547511
3389,221622613,121784,221744397,0,0,0,99840,29,4265386429
3390,221681900,107744,221789644,0,4,0,53760,12,3737328988
3391,222154188,3904,222158092,0,5,1,10752,20,7964290885
3392,222203998,5196,222209194,0,9,1,13312,45,7497685178
3393,222301110,23983,222325093,0,0,1,39936,29,7575432153
3394,222305954,104156,222410110,0,4,0,41984,12,7849255790
3395,222336235,144741,222480976,0,4,0,46592,12,4294472835
3396,222426134,104780,222530914,0,4,0,44032,12,1566639668
3397,222528962,48980,222577942,0,3,0,2048,37,5716540422
3398,222541325,71468,222612793,0,4,0,15360,12,4763944878
3399,222765327,117728,222883055,0,3,0,86528,37,6906227447
3400,222800285,26738,222827023,0,9,1,48640,45,5390384609
3401,222944779,44233,222989012,0,3,1,72704,37,4683093551
3402,223149438,52676,223202114,0,4,0,4096,12,9535659450
3403,223186819,43904,223230723,0,4,0,512,12,7872752336
3404,223227847,10241,223238088,0,5,1,16384,20,7462697872
3405,223288228,14029,223302257,0,2,1,27136,14,3124198859
3406,223345987,10757,223356744,0,9,1,17408,45,6957898225
3407,223414898,66212,223481110,0,3,0,8192,37,7649033019
3408,223535354,2470,223537824,0,9,1,2560,45,4216821429
3409,223596514,49136,223645650,0,4,0,2560,12,1105217567
3410,223630429,52291,223682720,0,2,1,84992,14,9742170481
3411,223758000,1518,223759518,0,5,1,1536,20,3096516908
3412,223810178,2946,223813124,0,5,1,3072,20,668649920
3413,223863570,3128,223866698,0,5,1,9216,20,1093662453
3414,224058039,21658,224079697,0,5,1,35328,20,6377990721
3415,224120440,55748,224176188,0,4,0,4096,12,9072844395
3416,224142387,50672,224193059,0,4,0,2560,12,7145497586
3417,224147955,6754,224154709,0,1,1,7168,18,10683760006
3418,224197073,262688,224459761,0,3,0,274944,37,5263353761
3419,224227240,5326,224232566,0,9,1,5632,45,3399593833
3420,224239342,25446,224264788,0,9,1,46080,45,1773567947
3421,224270148,52988,224323136,0,4,0,5120,12,1469128506
3422,224476553,5712,224482265,0,5,1,14336,20,481799632
3423,224494657,119912,224614569,0,3,0,93696,37,3076061562
3424,224833997,36604,224870601,0,9,1,64512,45,5116421178
3425,225100636,43904,225144540,0,4,0,512,12,1527233943
3426,225328574,1518,225330092,0,9,1,1536,45,2745072172
3427,225644385,116012,225760397,0,3,0,80896,37,6725535583
3428,225659374,566,225659940,0,9,1,512,45,10114613576
3429,225728870,204279,225933149,0,3,0,186880,37,4793080619
3430,225800978,23725,225824703,0,9,1,39424,45,1017743835
3431,225893682,4850,225898532,0,9,1,5120,45,8465799278
3432,226165599,566,226166165,0,8,1,512,21,2906571003
3433,226437213,12737,226449950,0,8,1,24576,21,9119005696
3434,226556313,566,226556879,0,9,1,512,45,6088357816
3435,226581722,566,226582288,0,9,1,512,45,6189736388
3436,226601776,43370,226645146,0,5,1,74240,20,2699581985
3437,226742576,10241,226752817,0,0,1,16384,29,6104861584
3438,226772275,4374,226776649,0,9,1,4608,45,9507022881
3439,226787749,2946,226790695,0,9,1,3072,45,10183758414
3440,226795662,5196,226800858,0,8,1,13312,21,4379290298
3441,226926148,393260,227319408,0,3,0,506880,37,4786440053
3442,227030286,11274,227041560,0,3,1,18432,37,65369739
3443,227084479,21399,227105878,0,8,1,34816,21,5712152596
3444,227291862,6754,227298616,0,9,1,7168,45,9156250399
3445,227333454,3898,227337352,0,3,1,4096,37,10183805125
3446,227464096,13341,227477437,0,9,1,22528,45,8133320511
3447,227774165,2870,227777035,0,9,1,8704,45,4362753928
3448,227779061,21658,227800719,0,8,1,35328,21,5117649240
3449,227894744,23466,227918210,0,9,1,38912,45,7509911609
3450,228026082,12825,228038907,0,9,1,21504,45,4461916084
3451,228033396,1042,228034438,0,3,1,1024,37,1688938874
3452,228197001,259304,228456305,0,3,0,273920,37,8703370205
3453,228309685,7706,228317391,0,8,1,8192,21,8240466495
3454,228466532,98696,228565228,0,3,0,24064,37,5222294032
3455,228547673,2946,228550619,0,3,1,3072,37,1453716449
3456,228903242,12737,228915979,0,8,1,24576,21,5089620070
3457,229061237,300428,229361665,0,3,0,363520,37,8809774203
3458,229090184,6278,229096462,0,8,1,6656,21,5492464160
3459,229098564,4850,229103414,0,8,1,5120,21,7497814003
3460,229115892,264196,229380088,0,3,0,60416,37,3553771392
3461,229318081,11016,229329097,0,4,1,17920,12,7432615837
3462,229365183,128569,229493752,0,3,0,73216,37,6542834417
3463,229479556,3645,229483201,0,8,1,10240,21,9323927572
3464,229620644,31007,229651651,0,8,1,50176,21,8725524244
3465,229740156,130832,229870988,0,3,0,129536,37,4954553869
3466,230054865,1518,230056383,0,4,1,1536,12,3856392228
3467,230193444,50672,230244116,0,4,0,2560,12,2420663283
3468,230450624,123188,230573812,0,3,0,104448,37,1545415360
3469,230605315,54056,230659371,0,4,0,3584,12,1238213449
3470,230771074,50672,230821746,0,8,0,2560,21,8872603150
3471,230795136,48980,230844116,0,4,0,2048,12,7340789944
3472,230865977,5712,230871689,0,8,1,14336,21,8706453417
3473,230911523,45596,230957119,0,8,0,1024,21,2505331366
3474,230981985,14117,230996102,0,4,1,24064,12,6704364512
3475,231005692,72442,231078134,0,4,0,512,12,1832766193
3476,231048439,4374,231052813,0,0,1,4608,29,6232505907
3477,231065616,1518,231067134,0,8,1,1536,21,1849577425
3478,231181633,1994,231183627,0,8,1,2048,21,6710420971
3479,231278136,102752,231380888,0,3,0,37376,37,2651753767
3480,231322308,566,231322874,0,8,1,512,21,2889331973
3481,231338346,43904,231382250,0,4,0,512,12,8064851788
3482,231401602,209312,231610914,0,3,0,225792,37,8388573759
3483,231450486,14545,231465031,0,4,1,28160,12,9411828315
3484,231696230,47288,231743518,0,8,0,1536,21,627152704
3485,231705381,3422,231708803,0,4,1,3584,12,9368914826
3486,231767956,11274,231779230,0,8,1,18432,21,7875031528
3487,231772478,10499,231782977,0,4,1,16896,12,10582684125
3488,231893634,102959,231996593,0,4,0,2560,12,7109774479
3489,231958459,5326,231963785,0,4,1,5632,12,8858435743
3490,232024354,43904,232068258,0,4,0,512,12,9634281551
3491,232267326,48980,232316306,0,4,0,2048,12,10338270381
3492,232393827,47288,232441115,0,8,0,1536,21,8511961951
3493,232435172,16613,232451785,0,4,1,32256,12,5316628595
3494,232559079,4850,232563929,0,4,1,5120,12,189315943
3495,232568263,45752,232614015,0,4,0,1536,12,3159824093
3496,232597009,3387,232600396,0,5,1,9728,20,5339365015
3497,232699370,13600,232712970,0,8,1,23040,21,9631684241
3498,232704342,69985,232774327,0,8,0,2560,21,6850070141
3499,232744488,48980,232793468,0,4,0,2048,12,5009712973
3500,232780609,62516,232843125,0,8,0,6144,21,1698790769
3501,232835072,47288,232882360,0,4,0,1536,12,2229876991
3502,232874940,5454,232880394,0,4,1,13824,12,9010540027
3503,233054896,47600,233102496,0,8,0,2560,21,1720269053
3504,233108290,3387,233111677,0,8,1,9728,21,4892122816
3505,233117296,12566,233129862,0,0,1,20992,29,1735470684
3506,233207532,87296,233294828,0,3,0,16896,37,7759989667
3507,233217971,48980,233266951,0,4,0,2048,12,5412936362
3508,233288438,45596,233334034,0,8,0,1024,21,1202963785
3509,233321180,5712,233326892,0,1,1,14336,18,3379024563
3510,233372436,2470,233374906,0,8,1,2560,21,2472940551
3511,233380911,6488,233387399,0,1,1,15872,18,8258714048
3512,233424243,4374,233428617,0,1,1,4608,18,4794896304
3513,233464769,22862,233487631,0,3,1,40960,37,7301492419
3514,233471814,45954,233517768,0,8,1,79360,21,10014492618
3515,233480167,110944,233591111,0,8,0,1024,21,704335122
3516,233584332,257618,233841950,0,3,0,267264,37,6477422049
3517,233695790,81128,233776918,0,8,0,11776,21,2968397028
3518,233796398,4850,233801248,0,1,1,5120,18,10357091250
3519,233952927,3898,233956825,0,4,1,4096,12,3613540888
3520,234019429,5326,234024755,0,8,1,5632,21,5079599937
3521,234202680,4374,234207054,0,8,1,4608,21,8513684653
3522,234233262,7230,234240492,0,0,1,7680,29,7913053121
3523,234248692,54056,234302748,0,4,0,3584,12,2503355856
3524,234401610,126696,234528306,0,6,1,209920,14,5060412776
3525,234441630,102331,234543961,0,6,1,50176,14,6493059997
3526,234458738,178481,234637219,0,6,1,257536,14,1787861443
3527,234494691,13083,234507774,0,4,1,22016,12,2614701075
3528,234578192,15062,234593254,0,8,1,29184,21,5693806554
3529,234617356,31266,234648622,0,0,1,50688,29,6942075915
3530,234632521,207284,234839805,0,3,0,219136,37,6418939257
3531,234649532,236003,234885535,0,2,1,386048,14,2225712556
3532,234683483,3904,234687387,0,8,1,10752,21,3506237447
3533,234745369,52988,234798357,0,8,0,5120,21,7151676697
3534,234772262,1994,234774256,0,8,1,2048,21,10407583648
3535,234819917,12308,234832225,0,5,1,20480,20,5966657005
3536,235044153,1518,235045671,0,0,1,1536,29,2334178393
3537,235092696,35312,235128008,0,6,1,61952,14,7531511974
3538,235191434,31266,235222700,0,6,1,50688,14,5681752854
3539,235256080,3904,235259984,0,0,1,10752,29,4369508424
3540,235382306,45596,235427902,0,4,0,1024,12,3700708598
3541,235475743,566,235476309,0,9,1,512,45,1586581377
3542,235485280,123683,235608963,0,6,1,200704,14,8953658024
3543,235537849,52364,235590213,0,4,0,3072,12,8165250343
3544,235555559,23725,235579284,0,0,1,39424,29,546687809
3545,235626686,111488,235738174,0,3,0,66048,37,2496640147
3546,235631012,186412,235817424,0,6,1,306176,14,8767106470
3547,235675191,48980,235724171,0,8,0,2048,21,4048417393
3548,235692333,84068,235776401,0,3,0,16384,37,6121279061
3549,235844440,4679,235849119,0,9,1,12288,45,6666850927
3550,235865092,50672,235915764,0,8,0,2560,21,10692138599
3551,235890508,15579,235906087,0,6,1,30208,14,7379140172
3552,235953996,100724,236054720,0,3,0,30720,37,9175272793
3553,235982090,4850,235986940,0,9,1,5120,45,8813575240
3554,235994249,5326,235999575,0,4,1,5632,12,9813560432
3555,236000223,15579,236015802,0,5,1,30208,20,9513797087
3556,236021633,5712,236027345,0,0,1,14336,29,785729746
3557,236023805,126954,236150759,0,6,1,210432,14,198311923
3558,236031806,20624,236052430,0,2,1,33280,14,4842275299
3559,236067282,54056,236121338,0,8,0,3584,21,531265313
3560,236079875,12566,236092441,0,4,1,20992,12,9910428911
3561,236098939,21658,236120597,0,4,1,35328,12,6938994609
3562,236185450,13083,236198533,0,5,1,22016,20,10176671711
3563,236314474,53144,236367618,0,8,0,5632,21,473936027
3564,236651784,3904,236655688,0,0,1,10752,29,2941428701
3565,236738048,4937,236742985,0,0,1,12800,29,714218757
3566,236755062,4162,236759224,0,4,1,11264,12,4671716715
3567,236763478,12825,236776303,0,0,1,21504,29,5454935575
3568,236921324,3387,236924711,0,0,1,9728,29,403992393
3569,236930115,3128,236933243,0,5,1,9216,20,9914610575
3570,236936927,45752,236982679,0,8,0,1536,21,8481254811
3571,236976549,7706,236984255,0,5,1,8192,20,1035419801
3572,236993471,13341,237006812,0,7,1,22528,40,2664719657
3573,237082269,24242,237106511,0,5,1,40448,20,2299869396
3574,237101617,283892,237385509,0,3,0,309248,37,10021396929
3575,237153964,43975,237197939,0,7,1,72192,40,8861717600
3576,237324944,6278,237331222,0,7,1,6656,40,3646112064
3577,237409956,3422,237413378,0,9,1,3584,45,8769202163
3578,237411946,59132,237471078,0,3,0,5120,37,10201983210
3579,237425477,54358,237479835,0,6,1,89088,14,4695870231
3580,237469886,47288,237517174,0,4,0,1536,12,7865954936
3581,237576442,6754,237583196,0,7,1,7168,40,5491395038
3582,237613857,57440,237671297,0,4,0,4608,12,8250288898
3583,237660602,6754,237667356,0,2,1,7168,14,9809718922
3584,237807005,3898,237810903,0,7,1,4096,40,9479608277
3585,237818091,34367,237852458,0,6,1,56832,14,5100292577
3586,237941305,10499,237951804,0,7,1,16896,40,4968203294
3587,237947289,47288,237994577,0,8,0,1536,21,7555771537
3588,237958911,4162,237963073,0,7,1,11264,40,7774247105
3589,238178562,5196,238183758,0,9,1,13312,45,7133177698
3590,238217353,60824,238278177,0,8,0,5632,21,5130864553
3591,238271202,1042,238272244,0,3,1,1024,37,2939371258
3592,238411509,297152,238708661,0,3,0,352768,37,9738971022
3593,238432478,4850,238437328,0,8,1,5120,21,9495465331
3594,238438646,5196,238443842,0,3,1,13312,37,4059862077
3595,238459978,13341,238473319,0,3,1,22528,37,29417894
3596,238525653,88328,238613981,0,8,0,512,21,1087067138
3597,238528194,47288,238575482,0,8,0,1536,21,9785317265
3598,238687240,34408,238721648,0,3,1,25088,37,10168790310
3599,238699096,50672,238749768,0,8,0,2560,21,3419364224
3600,238752175,3128,238755303,0,6,1,9216,14,5499524327
3601,238780458,61641,238842099,0,2,1,99840,14,8690816762
3602,238785228,7706,238792934,0,3,1,8192,37,1889829197
3603,238832579,318037,239150616,0,6,1,519168,14,5650443045
3604,238983284,57596,239040880,0,4,0,5120,12,934637367
3605,238997907,5971,239003878,0,8,1,14848,21,3507534043
3606,239112461,52364,239164825,0,4,0,3072,12,4792840680
3607,239130206,24670,239154876,0,2,1,44544,14,3806436199
3608,239165393,89744,239255137,0,8,0,14848,21,1450376868
3609,239238452,304899,239543351,0,6,1,493568,14,1678423480
3610,239308459,277339,239585798,0,6,1,137728,14,9384685050
3611,239322501,321143,239643644,0,6,1,195072,14,4341333684
3612,239469690,2470,239472160,0,9,1,2560,45,6288354907
3613,239571462,14029,239585491,0,3,1,27136,37,7651833344
3614,239586937,43904,239630841,0,8,0,512,21,4603927699
3615,239621783,120334,239742117,0,8,0,66048,21,5146985375
3616,239767949,14287,239782236,0,3,1,27648,37,5122274268
3617,239844005,14029,239858034,0,2,1,27136,14,731202540
3618,239882562,10499,239893061,0,2,1,16896,14,1466044681
3619,239932156,43904,239976060,0,4,0,512,12,9864406660
3620,239965986,1042,239967028,0,3,1,1024,37,6976845435
3621,240019805,2946,240022751,0,3,1,3072,37,6755977861
3622,240043566,173274,240216840,0,2,1,280576,14,6380788776
3623,240083360,189032,240272392,0,3,0,159232,37,27873024
3624,240134336,109347,240243683,0,2,1,87552,14,6037922988
3625,240150843,4850,240155693,0,3,1,5120,37,3719366778
3626,240161866,55748,240217614,0,4,0,4096,12,3246765923
3627,240246199,111956,240358155,0,8,0,67584,21,6645099020
3628,240250907,5971,240256878,0,9,1,14848,45,8992484569
3629,240308995,1042,240310037,0,3,1,1024,37,7244261083
3630,240384569,1994,240386563,0,6,1,2048,14,7037108489
3631,240395227,4937,240400164,0,7,1,12800,40,6975654491
3632,240396188,10241,240406429,0,8,1,16384,21,2910309183
3633,240398030,65427,240463457,0,8,0,10240,21,6387417010
3634,240436674,57113,240493787,0,2,1,97792,14,4639060294
3635,240452979,114296,240567275,0,3,0,75264,37,6207413520
3636,240493577,22950,240516527,0,1,1,37888,18,4585530850
3637,240494442,2870,240497312,0,7,1,8704,40,1513535136
3638,240500122,143456,240643578,0,8,0,135680,21,2873192504
3639,240522558,77363,240599921,0,2,1,130560,14,1769256448
3640,240536213,70224,240606437,0,2,1,23040,14,4729622398
3641,240599253,56216,240655469,0,4,0,5632,12,3829976124
3642,240624717,54890,240679607,0,4,0,3072,12,9217001785
3643,240652660,215396,240868056,0,3,0,245760,37,8245897150
3644,240716974,3898,240720872,0,6,1,4096,14,4879462611
3645,240746313,72668,240818981,0,4,0,9216,12,9689158597
3646,240793413,11274,240804687,0,5,1,18432,20,5810877552
3647,240803584,64225,240867809,0,6,1,104960,14,5498626403
3648,240845263,28550,240873813,0,6,1,28672,14,768321565
3649,240854198,2870,240857068,0,7,1,8704,40,3494024865
3650,240914343,6754,240921097,0,3,1,7168,37,539392423
3651,241080563,3128,241083691,0,3,1,9216,37,2510338980
3652,241227184,2470,241229654,0,7,1,2560,40,9844742656
3653,241258390,4850,241263240,0,7,1,5120,40,8782213696
3654,241393658,14545,241408203,0,6,1,28160,14,7449549190
3655,241563454,120536,241683990,0,3,0,95744,37,3601983124
3656,241588821,48980,241637801,0,4,0,2048,12,5493134882
3657,241634109,54012,241688121,0,6,1,91648,14,7463803118
3658,241797174,3904,241801078,0,7,1,10752,40,3997880581
3659,241798252,189656,241987908,0,8,0,161280,21,3641739783
3660,241808599,246128,242054727,0,6,1,402432,14,6156365898
3661,241830699,47288,241877987,0,4,0,1536,12,5171859667
3662,241932818,235296,242168114,0,6,1,370688,14,9149979061
3663,242050195,43904,242094099,0,4,0,512,12,1983775416
3664,242146977,204320,242351297,0,3,0,209408,37,5872356081
3665,242169477,246386,242415863,0,3,0,147968,37,1944420315
3666,242249143,5802,242254945,0,5,1,6144,20,9980637888
3667,242273234,102128,242375362,0,8,0,35328,21,1580218019
3668,242335943,116226,242452169,0,3,0,31232,37,125176153
3669,242356907,14029,242370936,0,5,1,27136,20,9650519956
3670,242392743,2470,242395213,0,5,1,2560,20,1866448272
3671,242413637,6278,242419915,0,7,1,6656,40,3879668297
3672,242439185,4850,242444035,0,7,1,5120,40,6224419476
3673,242542776,3422,242546198,0,5,1,3584,20,10241957380
3674,242560203,7706,242567909,0,5,1,8192,20,7409203859
3675,242671300,124592,242795892,0,3,0,109056,37,2163153864
3676,242854245,190748,243044993,0,3,0,164864,37,10679510370
3677,243013642,52364,243066006,0,4,0,3072,12,9732244045
3678,243057552,10757,243068309,0,0,1,17408,29,2427014367
3679,243092758,54056,243146814,0,4,0,3584,12,939875651
3680,243092956,2946,243095902,0,5,1,3072,20,7967867461
3681,243143085,566,243143651,0,8,1,512,21,3186297408
3682,243179798,566,243180364,0,5,1,512,20,8747923737
3683,243254762,351176,243605938,0,8,0,409088,21,5814298071
3684,243309591,566,243310157,0,0,1,512,29,9211111152
3685,243355904,1518,243357422,0,8,1,1536,21,7212725056
3686,243362047,6278,243368325,0,2,1,6656,14,1968767561
3687,243371631,13341,243384972,0,8,1,22528,21,10180999746
3688,243408803,224926,243633729,0,8,0,91136,21,7515889480
3689,243452744,2470,243455214,0,7,1,2560,40,5263638391
3690,243501032,134199,243635231,0,8,1,1536,21,8259093538
3691,243595156,46255,243641411,0,8,1,7680,21,4277404954
3692,244043537,13858,244057395,0,8,1,23552,21,402942006
3693,244135777,11016,244146793,0,7,1,17920,40,1691338987
3694,244329617,6754,244336371,0,8,1,7168,21,3716501108
3695,244390037,6754,244396791,0,5,1,7168,20,1436519925
3696,244479134,6488,244485622,0,7,1,15872,40,10682801374
3697,244867014,4937,244871951,0,2,1,12800,14,5779148665
3698,244875662,179036,245054698,0,3,0,156672,37,1351669382
3699,244887345,3898,244891243,0,7,1,4096,40,59513258
3700,245028771,108992,245137763,0,8,0,57856,21,8166589938
3701,245040441,13600,245054041,0,9,1,23040,45,289575
3702,245050029,2870,245052899,0,5,1,8704,20,7855771016
3703,245060001,16354,245076355,0,3,1,31744,37,1423190855
3704,245089580,2870,245092450,0,5,1,8704,20,7611052974
3705,245098839,12995,245111834,0,3,1,25088,37,9033579537
3706,245137250,1042,245138292,0,5,1,1024,20,10131063427
3707,245263453,6754,245270207,0,5,1,7168,20,822282529
3708,245292942,4850,245297792,0,5,1,5120,20,6570889338
3709,245370828,7230,245378058,0,3,1,7680,37,6044994161
3710,245373762,99944,245473706,0,3,0,28160,37,2731423405
3711,245430310,4850,245435160,0,7,1,5120,40,8749155201
3712,245528702,11274,245539976,0,5,1,18432,20,6073354269
3713,245632550,144836,245777386,0,3,0,135168,37,7733756387
3714,245633101,69284,245702385,0,8,0,8192,21,3139766319
3715,245671987,1518,245673505,0,7,1,1536,40,4432841415
3716,245736872,12049,245748921,0,5,1,19968,20,3321214167
3717,245850589,1994,245852583,0,1,1,2048,18,10625103575
3718,245992369,45596,246037965,0,4,0,1024,12,2593655059
3719,246036382,4679,246041061,0,7,1,12288,40,8488142074
3720,246092535,6278,246098813,0,7,1,6656,40,6810510293
3721,246317767,10241,246328008,0,5,1,16384,20,5055430478
3722,246441655,6229,246447884,0,5,1,15360,20,10228203972
3723,246451643,47288,246498931,0,4,0,1536,12,5996528810
3724,246570887,6278,246577165,0,7,1,6656,40,2640515734
3725,246646112,265862,246911974,0,6,1,434176,14,6928705198
3726,246792022,20366,246812388,0,5,1,32768,20,8369268560
3727,246835030,43904,246878934,0,4,0,512,12,4886852006
3728,246848983,34020,246883003,0,5,1,59392,20,6465975557
3729,246851863,103688,246955551,0,8,0,40448,21,3862730904
3730,246938190,4937,246943127,0,7,1,12800,40,10465230148
3731,246985504,45596,247031100,0,4,0,1024,12,7105948409
3732,247085088,5454,247090542,0,9,1,13824,45,5657560661
3733,247088223,48980,247137203,0,4,0,2048,12,7153441721
3734,247104828,1994,247106822,0,9,1,2048,45,10276395061
3735,247109905,13512,247123417,0,5,1,26112,20,3381909054
3736,247205717,3904,247209621,0,1,1,10752,18,6062310900
3737,247250056,13083,247263139,0,1,1,22016,18,2025229771
3738,247283059,6278,247289337,0,4,1,6656,12,8437540283
3739,247304574,14117,247318691,0,1,1,24064,18,1813370554
3740,247308366,206816,247515182,0,8,0,217600,21,7811281543
3741,247334419,6488,247340907,0,9,1,15872,45,7581658033
3742,247412434,128804,247541238,0,3,0,122880,37,7785326080
3743,247503482,21658,247525140,0,7,1,35328,40,943554093
3744,247570412,566,247570978,0,7,1,512,40,5391462494
3745,247619572,276092,247895664,0,3,0,283648,37,6564345466
3746,247754884,99164,247854048,0,8,0,25600,21,6729676268
3747,247783888,119747,247903635,0,3,0,26112,37,10700126163
3748,247785781,167795,247953576,0,3,0,95744,37,9033076130
3749,247799005,4162,247803167,0,9,1,11264,45,2167462024
3750,247842749,219113,248061862,0,2,1,359936,14,6184483822
3751,247855596,237218,248092814,0,2,1,98816,14,4024168099
3752,247896081,132606,248028687,0,3,0,110592,37,10291166587
3753,247980873,7230,247988103,0,1,1,7680,18,234932516
3754,248049808,201044,248250852,0,8,0,198656,21,2667800973
3755,248101744,566,248102310,0,1,1,512,18,1882290292
3756,248106744,266496,248373240,0,8,0,209920,21,1791267497
3757,248133424,4162,248137586,0,9,1,11264,45,3272817000
3758,248200044,13600,248213644,0,7,1,23040,40,5926298084
3759,248262619,23378,248285997,0,2,1,41984,14,8613824093
3760,248263855,1518,248265373,0,8,1,1536,21,6494785812
3761,248355171,35829,248391000,0,7,1,62976,40,1718453259
3762,248377163,15015,248392178,0,7,1,13824,40,5774660596
3763,248405064,2870,248407934,0,8,1,8704,21,4137162410
3764,248452844,12049,248464893,0,7,1,19968,40,9820001554
3765,248474359,45596,248519955,0,4,0,1024,12,2900604124
3766,248511556,104468,248616024,0,8,0,43008,21,9844551720
3767,248518426,287168,248805594,0,3,0,320000,37,3081390318
3768,248747773,13083,248760856,0,2,1,22016,14,8850376913
3769,248757042,11016,248768058,0,9,1,17920,45,6305776851
3770,248888384,57440,248945824,0,4,0,4608,12,3966967949
3771,248938036,287404,249225440,0,2,1,469504,14,5812650160
3772,248939734,12308,248952042,0,8,1,20480,21,7332796073
3773,249173196,10241,249183437,0,8,1,16384,21,7925482963
3774,249404215,10499,249414714,0,2,1,16896,14,10182454013
3775,249413946,279212,249693158,0,3,0,293888,37,3286849289
3776,249443950,122408,249566358,0,8,0,101888,21,10661233944
3777,249487508,3898,249491406,0,8,1,4096,21,7511477138
3778,249555433,57440,249612873,0,4,0,4608,12,6501526788
3779,249652954,127212,249780166,0,2,1,210944,14,9367335216
3780,249730303,73745,249804048,0,7,1,123392,40,4237122116
3781,249799310,107432,249906742,0,3,0,52736,37,9722650844
3782,249817482,32816,249850298,0,8,1,53760,21,485238413
3783,249820118,30334,249850452,0,8,1,8704,21,7783687174
3784,249865070,12566,249877636,0,7,1,20992,40,1688871654
3785,249889872,22174,249912046,0,8,1,36352,21,9307892029
3786,249917360,45596,249962956,0,4,0,1024,12,9903004343
3787,249933975,276957,250210932,0,8,0,146944,21,157343883
3788,249971236,41649,250012885,0,8,1,67584,21,9637120000
3789,250030786,48980,250079766,0,4,0,2048,12,4427731690
3790,250041839,174737,250216576,0,2,1,286720,14,5615905456
3791,250074354,12308,250086662,0,7,1,20480,40,7033669799
3792,250183929,116312,250300241,0,6,1,193024,14,2420420702
3793,250327099,193712,250520811,0,8,0,174592,21,8112363199
3794,250389107,176128,250565235,0,8,0,35840,21,3533231705
3795,250404864,35054,250439918,0,6,1,61440,14,6374497153
3796,250446639,109772,250556411,0,3,0,60416,37,9241102583
3797,250510515,13675,250524190,0,8,1,9728,21,5853837117
3798,250657943,118040,250775983,0,3,0,87552,37,6187963581
3799,250828353,22433,250850786,0,8,1,36864,21,9732807930
3800,250955697,132774,251088471,0,2,1,215040,14,869262121
3801,250987690,100880,251088570,0,3,0,31232,37,2325032975
3802,251261321,10499,251271820,0,8,1,16896,21,9319159186
3803,251351224,491894,251843118,0,3,0,602624,37,4269315623
3804,251549234,317299,251866533,0,3,0,76800,37,3809630770
3805,251624354,316804,251941158,0,3,0,236544,37,490270617
3806,251657337,211239,251868576,0,3,0,6656,37,3440186437
3807,251673967,3904,251677871,0,8,1,10752,21,392336849
3808,251821267,47288,251868555,0,4,0,1536,12,9840821592
3809,252078455,2946,252081401,0,0,1,3072,29,9327697941
3810,252310585,3904,252314489,0,6,1,10752,14,7339024654
3811,252329235,192308,252521543,0,8,0,169984,21,5752405285
3812,252332756,11274,252344030,0,6,1,18432,14,6132651207
3813,252334059,99008,252433067,0,3,0,25088,37,8995834556
3814,252417440,7230,252424670,0,8,1,7680,21,374369552
3815,252503505,122096,252625601,0,3,0,100864,37,7304962896
3816,252568849,5196,252574045,0,4,1,13312,12,8315787047
3817,252585316,11016,252596332,0,6,1,17920,14,9490271492
3818,252644738,143144,252787882,0,3,0,134656,37,5718196055
3819,252816985,566,252817551,0,6,1,512,14,5473406129
3820,252840351,1518,252841869,0,8,1,1536,21,21198954
3821,252879444,49136,252928580,0,3,0,2560,37,1568735356
3822,252970759,45596,253016355,0,4,0,1024,12,5736931245
3823,253069851,32041,253101892,0,8,1,52224,21,1024542532
3824,253077122,25538,253102660,0,8,1,11776,21,5064375044
3825,253085024,11274,253096298,0,6,1,18432,14,1008264927
3826,253124198,5196,253129394,0,8,1,13312,21,662782238
3827,253139979,215084,253355063,0,3,0,244736,37,42142066
3828,253149897,208457,253358354,0,3,0,10752,37,8553262989
3829,253205417,12566,253217983,0,6,1,20992,14,4377031480
3830,253205746,21195,253226941,0,6,1,29184,14,1877559990
3831,253207768,24562,253232330,0,6,1,17408,14,4817350579
3832,253271646,129584,253401230,0,8,0,125440,21,9680144792
3833,253427247,3898,253431145,0,6,1,4096,14,9200349102
3834,253481745,70220,253551965,0,4,0,11264,12,516809456
3835,253626815,119132,253745947,0,3,0,91136,37,3949827828
3836,253768695,202448,253971143,0,8,0,203264,21,410555399
3837,253784418,218580,254002998,0,8,0,104448,21,5178896263
3838,253833710,3898,253837608,0,6,1,4096,14,1552070098
3839,253876295,26221,253902516,0,6,1,47616,14,1417981027
3840,253915981,107674,254023655,0,8,0,3584,21,3051515673
3841,253932385,208235,254140620,0,8,0,145408,21,3906384313
3842,253933030,118508,254051538,0,3,0,89088,37,7408146445
3843,253940239,48980,253989219,0,4,0,2048,12,4079184181
3844,254095544,3128,254098672,0,6,1,9216,14,1526959693
3845,254158429,5454,254163883,0,6,1,13824,14,8743464202
3846,254174683,178096,254352779,0,2,1,293376,14,1202678257
3847,254382510,3422,254385932,0,6,1,3584,14,8901574119
3848,254419735,5712,254425447,0,2,1,14336,14,1121498859
3849,254456395,81632,254538027,0,2,1,132096,14,4181087277
3850,254541159,92016,254633175,0,2,1,148992,14,6048008814
3851,254663083,54680,254717763,0,4,0,5632,12,5549235735
3852,254678533,111020,254789553,0,8,0,64512,21,8388773625
3853,254753322,1994,254755316,0,6,1,2048,14,6389192479
3854,254787715,43904,254831619,0,4,0,512,12,3060787308
3855,254865224,52364,254917588,0,4,0,3072,12,8312943176
3856,255101015,2470,255103485,0,6,1,2560,14,3884159920
3857,255115333,22174,255137507,0,2,1,36352,14,5067968447
3858,255424029,125011,255549040,0,8,0,108544,21,3663818108
3859,255429047,53583,255482630,0,2,1,87552,14,7754401614
3860,255444914,177488,255622402,0,8,0,121344,21,4996540703
3861,255530731,21399,255552130,0,6,1,34816,14,3354699571
3862,255854686,92084,255946770,0,3,0,22528,37,1112261156
3863,255882180,12566,255894746,0,6,1,20992,14,1636080826
3864,255892389,64208,255956597,0,4,0,6656,12,3561799569
3865,255983443,52832,256036275,0,4,0,4608,12,7802561271
3866,256054571,13858,256068429,0,2,1,23552,14,9264209913
3867,256099548,197612,256297160,0,3,0,187392,37,2309782721
3868,256196113,4374,256200487,0,6,1,4608,14,7789762585
3869,256287163,2470,256289633,0,6,1,2560,14,9943520159
3870,256346228,123812,256470040,0,3,0,106496,37,5933003453
3871,256577643,1518,256579161,0,6,1,1536,14,1437313773
3872,256605889,67148,256673037,0,8,0,11264,21,1934472114
3873,256724521,52364,256776885,0,4,0,3072,12,5013780695
3874,256728005,245700,256973705,0,2,1,398336,14,6990969690
3875,256759457,1042,256760499,0,6,1,1024,14,5009491067
3876,256862931,126429,256989360,0,2,1,50176,14,8216929736
3877,256978494,11225,256989719,0,2,1,9728,14,1783445700
3878,257149141,124887,257274028,0,2,1,206336,14,860399310
3879,257202206,13083,257215289,0,6,1,22016,14,6206102559
3880,257260951,13253,257274204,0,6,1,25600,14,588153082
3881,257572006,244388,257816394,0,3,0,270336,37,723400094
3882,257605754,3904,257609658,0,6,1,10752,14,5470166156
3883,257631407,23466,257654873,0,6,1,38912,14,7576693718
3884,257696379,502346,258198725,0,8,0,636928,21,864959829
3885,257783668,447832,258231500,0,8,0,107520,21,6797976853
3886,258093325,23120,258116445,0,6,1,41472,14,10327468898
3887,258117843,104624,258222467,0,3,0,43520,37,6592651729
3888,258134180,64654,258198834,0,2,1,109056,14,7503078085
3889,258240045,33762,258273807,0,6,1,58880,14,9589174274
3890,258258829,11274,258270103,0,7,1,18432,40,7108805633
3891,258295666,15321,258310987,0,7,1,29696,40,6980568628
3892,258358464,11791,258370255,0,6,1,19456,14,10280597900
3893,258383866,97916,258481782,0,3,0,21504,37,6747222557
3894,258455986,1518,258457504,0,2,1,1536,14,4611732477
3895,258470768,22174,258492942,0,2,1,36352,14,4764593644
3896,258541726,43904,258585630,0,4,0,512,12,5230934826
3897,258619513,6754,258626267,0,2,1,7168,14,5797574742
3898,258679157,15062,258694219,0,5,1,29184,20,7128964687
3899,258977491,45596,259023087,0,4,0,1024,12,9846149202
3900,258981398,15062,258996460,0,2,1,29184,14,3774942825
3901,258999311,117572,259116883,0,8,0,86016,21,2483385768
3902,259024571,97292,259121863,0,3,0,19456,37,10291340183
3903,259031086,10241,259041327,0,4,1,16384,12,8660260679
3904,259099225,21916,259121141,0,5,1,35840,20,6625155205
3905,259153080,4420,259157500,0,6,1,11776,14,5797909243
3906,259195539,33333,259228872,0,6,1,54784,14,9863512627
3907,259227498,365804,259593302,0,3,0,416768,37,4269422746
3908,259253291,15837,259269128,0,2,1,30720,14,472649303
3909,259440865,43904,259484769,0,4,0,512,12,8191097501
3910,259497598,211396,259708994,0,3,0,79872,37,2726925076
3911,259577214,45596,259622810,0,4,0,1024,12,3418533874
3912,259583260,11274,259594534,0,6,1,18432,14,2966218425
3913,259591845,1042,259592887,0,2,1,1024,14,5056958007
3914,259673103,3422,259676525,0,6,1,3584,14,9610616277
3915,259767448,95132,259862580,0,3,0,17408,37,3720942364
3916,259786151,44060,259830211,0,4,0,1024,12,9276848315
3917,259930818,10241,259941059,0,6,1,16384,14,5340959860
3918,260104501,6229,260110730,0,6,1,15360,14,8540155141
3919,260271587,6278,260277865,0,6,1,6656,14,7681495670
3920,260420713,285920,260706633,0,8,0,315904,21,9678929914
3921,260890164,6229,260896393,0,6,1,15360,14,6597535478
3922,260897104,6278,260903382,0,6,1,6656,14,7821070871
3923,260928455,373195,261301650,0,6,0,194048,14,9452455555
3924,260933118,126308,261059426,0,3,0,114688,37,6114825265
3925,260967291,275220,261242511,0,6,0,162816,14,1989571394
3926,261003750,138092,261141842,0,3,0,85504,37,9217829511
3927,261024732,99944,261124676,0,8,0,28160,21,2405427321
3928,261373721,10757,261384478,0,8,1,17408,21,10535836105
3929,261504756,129116,261633872,0,6,0,123904,14,6118191589
3930,261600659,108212,261708871,0,3,0,55296,37,7877354242
3931,261684849,11274,261696123,0,7,1,18432,40,5680397106
3932,261721029,4679,261725708,0,7,1,12288,40,9093124299
3933,261748496,4937,261753433,0,7,1,12800,40,1880339657
3934,261763948,50672,261814620,0,4,0,2560,12,2940587720
3935,261878939,210092,262089031,0,8,0,228352,21,8894921439
3936,261926101,10757,261936858,0,7,1,17408,40,4059517746
3937,261999426,70220,262069646,0,3,0,11264,37,6805225293
3938,262063493,10241,262073734,0,7,1,16384,40,3327794073
3939,262326731,11274,262338005,0,7,1,18432,40,1426436007
3940,262332421,4374,262336795,0,6,1,4608,14,2203512070
3941,262357493,25187,262382680,0,7,1,45568,40,6000695658
3942,262480330,11274,262491604,0,6,1,18432,14,7876930283
3943,262492570,13083,262505653,0,6,1,22016,14,4234075896
3944,262506741,1518,262508259,0,6,1,1536,14,10354303835
3945,262558616,54056,262612672,0,4,0,3584,12,8584686989
3946,262618925,11274,262630199,0,7,1,18432,40,3223063180
3947,262717206,194960,262912166,0,3,0,178688,37,3554613417
3948,262790700,15062,262805762,0,6,1,29184,14,4839819735
3949,262827291,161142,262988433,0,6,0,5632,14,4003546633
3950,262866824,10499,262877323,0,6,1,16896,14,5576227032
3951,262893967,21658,262915625,0,6,1,35328,14,7013655582
3952,262912576,175925,263088501,0,6,0,512,14,5407238097
3953,262992064,12049,263004113,0,6,1,19968,14,9833345203
3954,263045343,5454,263050797,0,6,1,13824,14,2979089143
3955,263123560,54680,263178240,0,3,0,5632,37,10719834807
3956,263253676,62516,263316192,0,6,0,6144,14,2940150865
3957,263476523,10241,263486764,0,7,1,16384,40,8022918711
3958,263804322,52364,263856686,0,6,0,3072,14,3895855144
3959,263806093,115700,263921793,0,3,0,79872,37,6826509546
3960,263806325,12308,263818633,0,6,1,20480,14,3819767866
3961,263838914,292004,264130918,0,8,0,335872,21,3497702129
3962,263871438,286171,264157609,0,8,0,87552,21,999798829
3963,263895762,43904,263939666,0,6,0,512,14,4494039263
3964,263917604,293221,264210825,0,3,0,326144,37,6857354809
3965,264004535,215977,264220512,0,3,0,31744,37,8972113322
3966,264140769,2470,264143239,0,5,1,2560,20,7896302480
3967,264185395,5971,264191366,0,5,1,14848,20,522841726
3968,264191723,3387,264195110,0,5,1,9728,20,9804673166
3969,264204170,10241,264214411,0,6,1,16384,14,2336048390
3970,264254467,162224,264416691,0,8,0,141824,21,7227543979
3971,264421113,57440,264478553,0,6,0,4608,14,8868354950
3972,264573454,43904,264617358,0,6,0,512,14,2989619620
3973,264717961,102440,264820401,0,8,0,36352,21,4176363317
3974,264780946,47288,264828234,0,6,0,1536,14,10589890768
3975,264823893,50672,264874565,0,4,0,2560,12,8867230601
3976,264861323,23895,264885218,0,5,1,43008,20,1078263513
3977,264877769,12737,264890506,0,5,1,24576,20,8223556373
3978,264984775,2470,264987245,0,5,1,2560,20,10052335437
3979,265154399,122408,265276807,0,3,0,101888,37,3827217330
3980,265266163,35829,265301992,0,6,1,62976,14,10516346761
3981,265301567,47288,265348855,0,4,0,1536,12,8662116237
3982,265354681,10757,265365438,0,6,1,17408,14,8165147058
3983,265369693,179889,265549582,0,6,0,3072,14,753993152
3984,265513025,43904,265556929,0,4,0,512,12,8766458834
3985,265518465,5454,265523919,0,6,1,13824,14,3907901396
3986,265525401,375944,265901345,0,8,0,450048,21,10443694401
3987,265666723,100100,265766823,0,3,0,28672,37,4746295336
3988,265692118,250894,265943012,0,8,0,136704,21,2839910797
3989,265909775,5802,265915577,0,6,1,6144,14,2226551554
3990,265996366,1042,265997408,0,6,1,1024,14,23856215
3991,266093719,52364,266146083,0,4,0,3072,12,10568159210
3992,266239265,14545,266253810,0,5,1,28160,20,5198904573
3993,266537846,1518,266539364,0,5,1,1536,20,10689172620
3994,266581802,43904,266625706,0,6,0,512,14,6244367699
3995,266655827,43904,266699731,0,6,0,512,14,9341257524
3996,266699204,121004,266820208,0,8,0,97280,21,4647561999
3997,266783961,7230,266791191,0,5,1,7680,20,10490638621
3998,266843901,12049,266855950,0,6,1,19968,14,2923442910
3999,267039537,90704,267130241,0,3,0,23040,37,9189898913
4000,267058443,47288,267105731,0,6,0,1536,14,8645541720
4001,267078537,13083,267091620,0,6,1,22016,14,3726756034
4002,267081800,10486,267092286,0,6,1,1024,14,9585551331
4003,267133472,59132,267192604,0,6,0,5120,14,9245700540
4004,267135400,1518,267136918,0,5,1,1536,20,10405412411
4005,267175901,21399,267197300,0,5,1,34816,20,4758848902
4006,267181787,48980,267230767,0,6,0,2048,14,4535619082
4007,267393157,4162,267397319,0,5,1,11264,20,4460670004
4008,267408139,93332,267501471,0,3,0,26624,37,5060791110
4009,267446889,13341,267460230,0,6,1,22528,14,8250271689
4010,267478466,486902,267965368,0,8,0,586240,21,7978660059
4011,267566221,12995,267579216,0,7,1,25088,40,4578310174
4012,267672432,52364,267724796,0,4,0,3072,12,2106044495
4013,267672496,50672,267723168,0,4,0,2560,12,1908346008
4014,267682340,22862,267705202,0,7,1,40960,40,2161395986
4015,267733317,12825,267746142,0,7,1,21504,40,5302126892
4016,267767917,6754,267774671,0,6,1,7168,14,9098190883
4017,267769521,566,267770087,0,8,1,512,21,6831748996
4018,267801959,6278,267808237,0,6,1,6656,14,7874538222
4019,267848036,121160,267969196,0,3,0,97792,37,912519232
4020,267927785,11533,267939318,0,5,1,18944,20,4048685327
4021,268051068,5802,268056870,0,5,1,6144,20,8160237762
4022,268133696,94220,268227916,0,3,0,19456,37,5932086272
4023,268198247,11016,268209263,0,8,1,17920,21,2249323057
4024,268265840,54056,268319896,0,4,0,3584,12,4652225931
4025,268353221,47288,268400509,0,6,0,1536,14,599298582
4026,268360394,51296,268411690,0,6,0,4608,14,7937640984
4027,268399152,84668,268483820,0,8,0,13312,21,6624155972
4028,268410124,175916,268586040,0,8,0,146432,21,4228230660
4029,268438857,212277,268651134,0,8,0,132096,21,9760423656
4030,268468465,5196,268473661,0,7,1,13312,40,1052051989
4031,268626087,35538,268661625,0,8,1,16896,21,1997819567
4032,268660659,40616,268701275,0,7,1,65536,40,5588508667
4033,268716843,62516,268779359,0,6,0,6144,14,1627761056
4034,268720041,45596,268765637,0,4,0,1024,12,7162530752
4035,268720699,131300,268851999,0,8,0,131072,21,2103424189
4036,268753236,348128,269101364,0,3,0,414208,37,383000844
4037,268819906,49292,268869198,0,4,0,3072,12,6836669945
4038,268900136,52364,268952500,0,6,0,3072,14,3298565869
4039,268929087,209888,269138975,0,3,0,123392,37,3702975529
4040,268938574,45596,268984170,0,4,0,1024,12,7201271258
4041,268939761,11016,268950777,0,7,1,17920,40,3172673681
4042,269083113,122378,269205491,0,3,0,9216,37,6094216015
4043,269106284,10499,269116783,0,8,1,16896,21,1493712934
4044,269144987,7706,269152693,0,6,1,8192,14,6617484448
4045,269279455,5971,269285426,0,6,1,14848,14,5610620642
4046,269473715,12566,269486281,0,8,1,20992,21,5873819079
4047,269498428,6754,269505182,0,5,1,7168,20,5974398518
4048,269507833,3128,269510961,0,5,1,9216,20,3001294568
4049,269626520,14287,269640807,0,5,1,27648,20,8566604792
4050,269826386,4850,269831236,0,6,1,5120,14,7746616292
4051,269835803,110240,269946043,0,8,0,61952,21,6575676885
4052,269931115,5326,269936441,0,7,1,5632,40,3790039512
4053,270056465,1042,270057507,0,7,1,1024,40,782583316
4054,270393700,4420,270398120,0,8,1,11776,21,1133237074
4055,270463873,208844,270672717,0,8,0,224256,21,10032004668
4056,270475534,5712,270481246,0,6,1,14336,14,9306165899
4057,270481895,15579,270497474,0,5,1,30208,20,584316107
4058,270503762,25704,270529466,0,5,1,46592,20,10239557963
4059,270593222,45596,270638818,0,4,0,1024,12,3175454845
4060,270629293,566,270629859,0,6,1,512,14,2517921827
4061,270651222,3387,270654609,0,7,1,9728,40,6256004257
4062,270684117,6278,270690395,0,6,1,6656,14,1132275530
4063,270687324,187316,270874640,0,3,0,153600,37,1017850457
4064,270697718,5802,270703520,0,5,1,6144,20,2306262596
4065,270708426,5196,270713622,0,6,1,13312,14,9789238735
4066,270713931,14117,270728048,0,8,1,24064,21,1486444549
4067,270714679,175888,270890567,0,3,0,52224,37,9935412403
4068,270714710,4374,270719084,0,7,1,4608,40,5596420782
4069,270790141,47288,270837429,0,4,0,1536,12,6723091902
4070,270850035,4420,270854455,0,5,1,11776,20,6206356533
4071,271091754,13770,271105524,0,7,1,26624,40,9424349314
4072,271118141,4162,271122303,0,6,1,11264,14,9760187279
4073,271148415,6229,271154644,0,1,1,15360,18,4062750507
4074,271253536,198236,271451772,0,3,0,189440,37,1300330662
4075,271286730,6278,271293008,0,5,1,6656,20,1361692977
4076,271303352,566,271303918,0,7,1,512,40,490121443
4077,271310140,7230,271317370,0,1,1,7680,18,7693398981
4078,271381500,11533,271393033,0,1,1,18944,18,7432796504
4079,271404099,53144,271457243,0,6,0,5632,14,8238205431
4080,271490323,60824,271551147,0,8,0,5632,21,1390107489
4081,271572891,3898,271576789,0,8,1,4096,21,4182098028
4082,271773231,566,271773797,0,5,1,512,20,3156739399
4083,271803416,2946,271806362,0,6,1,3072,14,10366939590
4084,271819529,566,271820095,0,1,1,512,18,2625268665
4085,271860294,5802,271866096,0,6,1,6144,14,7641303789
4086,271868412,13253,271881665,0,6,1,25600,14,7963200491
4087,271885986,101972,271987958,0,8,0,34816,21,2033873370
4088,271943454,5454,271948908,0,8,1,13824,21,6342043247
4089,271958584,110767,272069351,0,8,0,32768,21,7510998138
4090,272023562,59756,272083318,0,6,0,7168,14,8746961394
4091,272076394,43904,272120298,0,6,0,512,14,10050287956
4092,272082784,120380,272203164,0,8,0,95232,21,6192623316
4093,272163284,47288,272210572,0,4,0,1536,12,1373180131
4094,272168219,5454,272173673,0,7,1,13824,40,5869611039
4095,272207939,65900,272273839,0,6,0,7168,14,5821638366
4096,272208925,99008,272307933,0,3,0,25088,37,4119846673
4097,272215500,3898,272219398,0,7,1,4096,40,7788588133
4098,272252297,4937,272257234,0,5,1,12800,20,322255041
4099,272259576,6754,272266330,0,3,1,7168,37,4755375233
4100,272375787,7230,272383017,0,7,1,7680,40,4620540301
4101,272397762,126225,272523987,0,3,0,89088,37,2998862794
4102,272585737,2470,272588207,0,7,1,2560,40,2548973146
4103,272626146,1518,272627664,0,6,1,1536,14,3903170402
4104,272633708,6488,272640196,0,1,1,15872,18,3966966131
4105,272647140,4937,272652077,0,5,1,12800,20,6570897545
4106,272684633,5196,272689829,0,1,1,13312,18,7582349895
4107,272752697,2470,272755167,0,1,1,2560,18,2284226588
4108,272754375,83468,272837843,0,8,0,19456,21,6854949742
4109,272859200,26221,272885421,0,1,1,47616,18,2165293033
4110,272890719,7706,272898425,0,6,1,8192,14,2840697792
4111,272950605,111176,273061781,0,8,0,65024,21,8143671006
4112,272977922,4850,272982772,0,1,1,5120,18,6749290460
4113,273012871,45596,273058467,0,6,0,1024,14,6212005822
4114,273146094,4162,273150256,0,6,1,11264,14,6945000849
4115,273181379,51702,273233081,0,4,0,2560,12,624749324
4116,273182409,56684,273239093,0,4,0,7168,12,2522015351
4117,273201470,285920,273487390,0,8,0,315904,21,4077420589
4118,273219639,45596,273265235,0,4,0,1024,12,500616541
4119,273248700,124124,273372824,0,3,0,107520,37,9092029862
4120,273264700,14545,273279245,0,1,1,28160,18,9627952108
4121,273294243,47288,273341531,0,4,0,1536,12,8008738624
4122,273324928,5326,273330254,0,3,1,5632,37,6400563325
4123,273412801,3422,273416223,0,7,1,3584,40,206658986
4124,273470597,47288,273517885,0,4,0,1536,12,2021267917
4125,273484779,115232,273600011,0,3,0,78336,37,9152953088
4126,273553527,48980,273602507,0,6,0,2048,14,10047657737
4127,273567976,50672,273618648,0,6,0,2560,14,9347382084
4128,273605833,1042,273606875,0,1,1,1024,18,4428234176
4129,273649126,112112,273761238,0,3,0,68096,37,2733930277
4130,273668422,268106,273936528,0,3,0,264192,37,6243110693
4131,273677433,3645,273681078,0,6,1,10240,14,7364185234
4132,273682702,12308,273695010,0,6,1,20480,14,4367195872
4133,273686721,372200,274058921,0,8,0,437760,21,2185053507
4134,273802518,59132,273861650,0,4,0,5120,12,493354944
4135,273826125,6754,273832879,0,5,1,7168,20,5684697761
4136,273931233,5326,273936559,0,1,1,5632,18,5612683120
4137,273942959,123968,274066927,0,3,0,107008,37,4926999340
4138,273971293,6278,273977571,0,6,1,6656,14,3124144848
4139,273994421,15579,274010000,0,6,1,30208,14,4388010879
4140,274019345,7230,274026575,0,7,1,7680,40,586023650
4141,274036097,3128,274039225,0,1,1,9216,18,3289149694
4142,274036848,7230,274044078,0,6,1,7680,14,5053889360
4143,274050471,45596,274096067,0,4,0,1024,12,10628856324
4144,274122749,62516,274185265,0,6,0,6144,14,4023947948
4145,274155206,13600,274168806,0,7,1,23040,40,8246726133
4146,274200519,20366,274220885,0,7,1,32768,40,927153826
4147,274230134,15837,274245971,0,6,1,30720,14,511216547
4148,274247238,4679,274251917,0,6,1,12288,14,1118987731
4149,274344920,3422,274348342,0,6,1,3584,14,3957849196
4150,274386566,107432,274493998,0,8,0,52736,21,990258963
4151,274391629,1042,274392671,0,1,1,1024,18,10164959667
4152,274394178,65300,274459478,0,4,0,10240,12,159577369
4153,274612797,24412,274637209,0,7,1,44032,40,466887351
4154,274616532,15579,274632111,0,1,1,30208,18,10678257412
4155,274623314,480194,275103508,0,3,0,564224,37,9111253830
4156,274745974,7230,274753204,0,1,1,7680,18,6779345151
4157,274818667,47288,274865955,0,6,0,1536,14,1764370627
4158,274835887,55748,274891635,0,6,0,4096,14,6134706951
4159,274843403,10241,274853644,0,6,1,16384,14,429363040
4160,274914781,3387,274918168,0,1,1,9728,18,9655319732
4161,274936414,25446,274961860,0,1,1,46080,18,7325901188
4162,274939273,6488,274945761,0,5,1,15872,20,7953496872
4163,274941020,6367,274947387,0,5,1,2560,20,8103991180
4164,275037064,4850,275041914,0,1,1,5120,18,6278772532
4165,275046501,216488,275262989,0,8,0,249344,21,10206197414
4166,275246329,45596,275291925,0,4,0,1024,12,7358780274
4167,275404893,13858,275418751,0,3,1,23552,37,5038708314
4168,275565428,14117,275579545,0,8,1,24064,21,5810600809
4169,275710635,6278,275716913,0,5,1,6656,20,1737904710
4170,275711954,14029,275725983,0,6,1,27136,14,2341722750
4171,275717288,84695,275801983,0,6,0,2560,14,6741992104
4172,275802352,1994,275804346,0,3,1,2048,37,8449242182
4173,275864187,2470,275866657,0,3,1,2560,37,6027150332
4174,275937820,11274,275949094,0,5,1,18432,20,6430202316
4175,275980479,45596,276026075,0,6,0,1024,14,3225181062
4176,275992995,25187,276018182,0,3,1,45568,37,5034165582
4177,276056114,4850,276060964,0,6,1,5120,14,8274750173
4178,276065036,4679,276069715,0,3,1,12288,37,6204156175
4179,276072974,5712,276078686,0,6,1,14336,14,9592519036
4180,276097879,22691,276120570,0,6,1,37376,14,6913810444
4181,276107738,346418,276454156,0,3,0,402432,37,3551446806
4182,276149573,5326,276154899,0,9,1,5632,45,7949779320
4183,276210780,4850,276215630,0,3,1,5120,37,1399054639
4184,276225553,5802,276231355,0,5,1,6144,20,5731805649
4185,276295822,48980,276344802,0,6,0,2048,14,6062197763
4186,276407593,566,276408159,0,5,1,512,20,264753936
4187,276423731,102752,276526483,0,8,0,37376,21,7054285903
4188,276424457,21141,276445598,0,6,1,34304,14,2880366210
4189,276428572,50672,276479244,0,4,0,2560,12,9031702525
4190,276440313,6488,276446801,0,5,1,15872,20,1505730412
4191,276448861,2870,276451731,0,5,1,8704,20,64060023
4192,276575403,5802,276581205,0,3,1,6144,37,3146256528
4193,276596292,7706,276603998,0,6,1,8192,14,6203517513
4194,276636934,1994,276638928,0,3,1,2048,37,893637305
4195,276734291,2946,276737237,0,5,1,3072,20,2098382201
4196,276816910,109928,276926838,0,3,0,60928,37,3647572130
4197,276842829,2470,276845299,0,2,1,2560,14,1199868450
4198,276927620,13512,276941132,0,5,1,26112,20,7087534884
4199,276943396,1518,276944914,0,8,1,1536,21,8748226239
4200,277152986,1518,277154504,0,8,1,1536,21,8228116662
4201,277206935,1518,277208453,0,5,1,1536,20,7530824034
4202,277290216,43904,277334120,0,3,0,512,37,5314699223
4203,277304065,67592,277371657,0,6,0,7680,14,9918393419
4204,277363710,5196,277368906,0,5,1,13312,20,8238586507
4205,277442592,10757,277453349,0,8,1,17408,21,3381688108
4206,277484923,127400,277612323,0,1,0,118272,18,3979048403
4207,277487958,3128,277491086,0,8,1,9216,21,782871579
4208,277512522,16354,277528876,0,5,1,31744,20,10186225486
4209,277519438,24721,277544159,0,5,1,35840,20,8185620456
4210,277666060,22433,277688493,0,2,1,36864,14,8615475420
4211,277692204,3422,277695626,0,5,1,3584,20,8693553403
4212,277785018,119444,277904462,0,8,0,92160,21,9025948768
4213,277873035,43904,277916939,0,3,0,512,37,3545496995
4214,277908435,3898,277912333,0,8,1,4096,21,4445644404
4215,277909971,13253,277923224,0,2,1,25600,14,3307728258
4216,277942387,107588,278049975,0,8,0,53248,21,2877097016
4217,278020680,566,278021246,0,5,1,512,20,8525139076
4218,278072164,2870,278075034,0,7,1,8704,40,4808250508
4219,278112362,21399,278133761,0,5,1,34816,20,9830203828
4220,278115487,5971,278121458,0,8,1,14848,21,4121466369
4221,278123433,164055,278287488,0,8,0,102400,21,2140270445
4222,278274226,26854,278301080,0,8,1,23040,21,7855853341
4223,278296382,6004,278302386,0,8,1,2048,21,9482684318
4224,278359716,3422,278363138,0,2,1,3584,14,1136689184
4225,278364157,30749,278394906,0,2,1,49664,14,5254357953
4226,278428741,3422,278432163,0,5,1,3584,20,7079223531
4227,278450256,36604,278486860,0,5,1,64512,20,417590494
4228,278482561,1042,278483603,0,8,1,1024,21,5492942538
4229,278487271,43904,278531175,0,3,0,512,37,3844359624
4230,278599367,43904,278643271,0,6,0,512,14,558337606
4231,278626416,2870,278629286,0,5,1,8704,20,10520035615
4232,278654228,115232,278769460,0,8,0,78336,21,4380304171
4233,278744446,566,278745012,0,2,1,512,14,4125719953
4234,278780453,186116,278966569,0,8,0,159744,21,2259117829
4235,278829616,43904,278873520,0,6,0,512,14,5358673942
4236,278843877,4937,278848814,0,5,1,12800,20,93341799
4237,278860571,111473,278972044,0,8,0,17920,21,10133803382
4238,279046823,4420,279051243,0,7,1,11776,40,8725322606
4239,279079409,1994,279081403,0,5,1,2048,20,5585018225
4240,279340725,43904,279384629,0,3,0,512,37,3614349749
4241,279361627,44848,279406475,0,3,0,512,37,755163057
4242,279380472,3898,279384370,0,7,1,4096,40,5241860198
4243,279384135,45596,279429731,0,8,0,1024,21,8808618790
4244,279484474,1518,279485992,0,0,1,1536,29,5232057723
4245,279561805,12995,279574800,0,6,1,25088,14,3539509981
4246,279590861,12308,279603169,0,7,1,20480,40,2729560905
4247,279623738,50672,279674410,0,3,0,2560,37,8170846159
4248,279656421,3387,279659808,0,0,1,9728,29,2510812447
4249,279720585,20366,279740951,0,7,1,32768,40,306851698
4250,279755598,10499,279766097,0,0,1,16896,29,5998600374
4251,279828052,49292,279877344,0,6,0,3072,14,10489889785
4252,279880779,52364,279933143,0,3,0,3072,37,5889051712
4253,280004405,1994,280006399,0,0,1,2048,29,6579620771
4254,280131037,4937,280135974,0,9,1,12800,45,2320200697
4255,280145026,7706,280152732,0,6,1,8192,14,7759730704
4256,280165148,10241,280175389,0,0,1,16384,29,6571560292
4257,280192218,5454,280197672,0,5,1,13824,20,5467268265
4258,280211236,117728,280328964,0,8,0,86528,21,3460604201
4259,280273256,36604,280309860,0,0,1,64512,29,3310537071
4260,280340990,100880,280441870,0,8,0,31232,21,794360973
4261,280397190,110396,280507586,0,8,0,62464,21,1065444352
4262,280423763,102128,280525891,0,7,0,35328,40,3410591912
4263,280425238,3422,280428660,0,0,1,3584,29,2052182013
4264,280443846,52364,280496210,0,3,0,3072,37,2579678244
4265,280514445,23895,280538340,0,0,1,43008,29,9729088589
4266,280556323,43904,280600227,0,3,0,512,37,7527074709
4267,280726906,7706,280734612,0,6,1,8192,14,7072119703
4268,280743548,203228,280946776,0,7,0,205824,40,9515325120
4269,280792932,6278,280799210,0,5,1,6656,20,759602794
4270,280799202,7230,280806432,0,0,1,7680,29,4054074730
4271,280842967,3128,280846095,0,6,1,9216,14,7266196571
4272,280862742,11274,280874016,0,6,1,18432,14,6966551379
4273,281033767,566,281034333,0,4,1,512,12,10047832980
4274,281056105,117416,281173521,0,7,0,85504,40,2694221372
4275,281111124,6754,281117878,0,6,1,7168,14,9507776901
4276,281207458,67904,281275362,0,7,0,8704,40,5538059791
4277,281215960,3422,281219382,0,0,1,3584,29,3627107935
4278,281295294,48980,281344274,0,7,0,2048,40,3187361812
4279,281299238,2946,281302184,0,0,1,3072,29,4133327943
4280,281301675,43904,281345579,0,3,0,512,37,7210577088
4281,281356122,374540,281730662,0,7,0,445440,40,5830243638
4282,281433166,199952,281633118,0,8,0,195072,21,4753562208
4283,281454261,6488,281460749,0,0,1,15872,29,5359954059
4284,281524845,7230,281532075,0,4,1,7680,12,7813202180
4285,281526186,7835,281534021,0,4,1,3072,12,10286889751
4286,281579368,13600,281592968,0,0,1,23040,29,9739038456
4287,281629499,47288,281676787,0,6,0,1536,14,1067479684
4288,281720799,4374,281725173,0,4,1,4608,12,8217864980
4289,281882101,12049,281894150,0,6,1,19968,14,8535631264
4290,281955275,130988,282086263,0,7,0,130048,40,3694441709
4291,281981862,13858,281995720,0,5,1,23552,20,8040557307
4292,281994210,7706,282001916,0,4,1,8192,12,6862315648
4293,282152058,55748,282207806,0,3,0,4096,37,5021191605
4294,282169886,52998,282222884,0,3,0,2048,37,617886097
4295,282192809,15579,282208388,0,4,1,30208,12,7839294553
4296,282392885,212588,282605473,0,8,0,236544,21,6202395470
4297,282398435,6229,282404664,0,6,1,15360,14,3027572960
4298,282561923,2946,282564869,0,0,1,3072,29,8737233302
4299,282575888,24242,282600130,0,5,1,40448,20,1520433961
4300,282602037,6754,282608791,0,5,1,7168,20,4698312198
4301,282763765,5326,282769091,0,4,1,5632,12,1904719786
4302,282795824,148220,282944044,0,8,0,136192,21,5603272465
4303,282858768,3904,282862672,0,8,1,10752,21,973311775
4304,282858873,2470,282861343,0,0,1,2560,29,8609904720
4305,283043847,3422,283047269,0,0,1,3584,29,9393227759
4306,283057079,111488,283168567,0,7,0,66048,40,2064998044
4307,283070019,3645,283073664,0,8,1,10240,21,10215869314
4308,283100739,47288,283148027,0,3,0,1536,37,10702198821
4309,283122252,2870,283125122,0,6,1,8704,14,4298639481
4310,283219009,12049,283231058,0,0,1,19968,29,2727025839
4311,283268445,23378,283291823,0,6,1,41984,14,2769800057
4312,283322122,3645,283325767,0,0,1,10240,29,466893140
4313,283329212,117260,283446472,0,7,0,84992,40,944201854
4314,283368949,55748,283424697,0,6,0,4096,14,3536527606
4315,283428649,76052,283504701,0,6,0,10240,14,8632380741
4316,283561309,6754,283568063,0,1,1,7168,18,5550194843
4317,283616745,3422,283620167,0,8,1,3584,21,2246973456
4318,283619093,76052,283695145,0,8,0,10240,21,2933625025
4319,283621273,44060,283665333,0,6,0,1024,14,9316102619
4320,283626274,49136,283675410,0,6,0,2560,14,1392136799
4321,283726304,6278,283732582,0,0,1,6656,29,8139566450
4322,283727151,16354,283743505,0,6,1,31744,14,4645874316
4323,283738217,3387,283741604,0,8,1,9728,21,8626470279
4324,283762320,5712,283768032,0,8,1,14336,21,7192858071
4325,283891286,3904,283895190,0,9,1,10752,45,4493617807
4326,283892928,1518,283894446,0,0,1,1536,29,8058080169
4327,283916420,14029,283930449,0,4,1,27136,12,8950111056
4328,283930491,65900,283996391,0,6,0,7168,14,5260537354
4329,284003221,196364,284199585,0,8,0,183296,21,4196676638
4330,284036051,2946,284038997,0,0,1,3072,29,4439515491
4331,284102587,6278,284108865,0,9,1,6656,45,4247236936
4332,284227719,6278,284233997,0,6,1,6656,14,797697849
4333,284279591,50672,284330263,0,3,0,2560,37,6028332375
4334,284307377,3904,284311281,0,4,1,10752,12,7612236977
4335,284322149,3387,284325536,0,8,1,9728,21,9055110286
4336,284326876,3645,284330521,0,8,1,10240,21,6732452581
4337,284357607,289196,284646803,0,7,0,326656,40,6923599991
4338,284378078,47288,284425366,0,3,0,1536,37,2090600709
4339,284541586,1518,284543104,0,9,1,1536,45,1876818867
4340,284567719,4937,284572656,0,8,1,12800,21,925641354
4341,284573400,52549,284625949,0,6,1,85504,14,2243670461
4342,284588387,11016,284599403,0,4,1,17920,12,9070438070
4343,284590451,27599,284618050,0,4,1,43520,12,4554913368
4344,284602349,28785,284631134,0,6,1,16384,14,3628428911
4345,284627862,3422,284631284,0,0,1,3584,29,6455967199
4346,284645703,121628,284767331,0,8,0,99328,21,6994201032
4347,284647309,23208,284670517,0,0,1,38400,29,1792970467
4348,284724245,2946,284727191,0,8,1,3072,21,5120470249
4349,284770450,45596,284816046,0,3,0,1024,37,9968347862
4350,284807675,5802,284813477,0,8,1,6144,21,976967658
4351,284881351,11016,284892367,0,8,1,17920,21,10315366904
4352,284923295,4162,284927457,0,0,1,11264,29,1463434303
4353,284924353,2946,284927299,0,6,1,3072,14,5565615124
4354,284927360,4374,284931734,0,6,1,4608,14,9736292200
4355,284975845,2870,284978715,0,6,1,8704,14,6564385394
4356,284988626,101348,285089974,0,7,0,32768,40,4268679565
4357,285033197,7230,285040427,0,0,1,7680,29,216245492
4358,285063466,12308,285075774,0,3,1,20480,37,1099338622
4359,285066564,310054,285376618,0,7,0,351232,40,4776385613
4360,285249856,50672,285300528,0,6,0,2560,14,10274992564
4361,285393928,119600,285513528,0,6,0,92672,14,6412214602
4362,285470436,47288,285517724,0,3,0,1536,37,1600210658
4363,285542791,1518,285544309,0,6,1,1536,14,3819252196
4364,285572748,45596,285618344,0,3,0,1024,37,1563854700
4365,285574615,197612,285772227,0,8,0,187392,21,6945751544
4366,285620132,43904,285664036,0,3,0,512,37,2165921866
4367,285690101,4850,285694951,0,9,1,5120,45,1769044481
4368,285699354,30491,285729845,0,9,1,49152,45,9853925494
4369,285704943,12049,285716992,0,0,1,19968,29,4978131
4370,285737404,20882,285758286,0,6,1,33792,14,6077138877
4371,285791900,4679,285796579,0,3,1,12288,37,7878113180
4372,285840880,106340,285947220,0,7,0,49152,40,8919130804
4373,285921912,36863,285958775,0,0,1,65024,29,1528119050
4374,285979717,47288,286027005,0,3,0,1536,37,2162769609
4375,286028914,6754,286035668,0,6,1,7168,14,592593689
4376,286051578,566,286052144,0,6,1,512,14,1117858753
4377,286100203,221666,286321869,0,6,0,199680,14,4238470043
4378,286108259,72483,286180742,0,3,0,512,37,4511046437
4379,286119999,5971,286125970,0,3,1,14848,37,1209236523
4380,286148050,121472,286269522,0,8,0,98816,21,9141253498
4381,286155262,109616,286264878,0,7,0,59904,40,1802404896
4382,286220464,119102,286339566,0,7,0,20480,40,10224448112
4383,286237846,13600,286251446,0,6,1,23040,14,925771946
4384,286254524,37423,286291947,0,8,1,36864,21,185795270
4385,286267329,88123,286355452,0,6,1,55296,14,1945593627
4386,286358792,12995,286371787,0,9,1,25088,45,8492458564
4387,286372944,21658,286394602,0,0,1,35328,29,438964650
4388,286453924,49448,286503372,0,3,0,3584,37,1270119645
4389,286503786,102862,286606648,0,6,0,34304,14,3251465981
4390,286504745,91436,286596181,0,6,0,15360,14,7031985248
4391,286507563,94400,286601963,0,7,0,25088,40,4098642570
4392,286513091,1518,286514609,0,0,1,1536,29,1500502764
4393,286514527,114296,286628823,0,7,0,75264,40,5602985422
4394,286556437,22433,286578870,0,0,1,36864,29,6914266620
4395,286620902,1994,286622896,0,9,1,2048,45,10444448976
4396,286644912,187784,286832696,0,7,0,155136,40,2244589655
4397,286648583,3645,286652228,0,6,1,10240,14,7789322345
4398,286658668,1042,286659710,0,9,1,1024,45,6237274062
4399,286672859,168432,286841291,0,7,0,28160,40,9238978571
4400,286792702,1518,286794220,0,6,1,1536,14,5032651375
4401,286857858,24242,286882100,0,3,1,40448,37,1194387302
4402,286860460,13083,286873543,0,6,1,22016,14,3740183026
4403,286924445,213212,287137657,0,7,0,238592,40,670028647
4404,287037439,12308,287049747,0,8,1,20480,21,1740261233
4405,287138953,31266,287170219,0,9,1,50688,45,5046648076
4406,287277502,10757,287288259,0,6,1,17408,14,10634238092
4407,287367745,117728,287485473,0,6,0,86528,14,4718156397
4408,287405895,118040,287523935,0,8,0,87552,21,157520023
4409,287441844,2946,287444790,0,9,1,3072,45,9327855632
4410,287506225,123188,287629413,0,6,0,104448,14,6615701805
4411,287610921,4374,287615295,0,8,1,4608,21,9184949009
4412,287757414,16096,287773510,0,8,1,31232,21,4003519331
4413,287770490,45596,287816086,0,3,0,1024,37,6817953523
4414,287817095,3645,287820740,0,9,1,10240,45,463079055
4415,287849156,12566,287861722,0,9,1,20992,45,3838985938
4416,287889029,20366,287909395,0,6,1,32768,14,7655523963
4417,287903468,281240,288184708,0,7,0,300544,40,2693177058
4418,287927012,12049,287939061,0,3,1,19968,37,7747425864
4419,287992767,22950,288015717,0,3,1,37888,37,355507756
4420,288019308,2470,288021778,0,8,1,2560,21,1569577327
4421,288180824,3422,288184246,0,6,1,3584,14,5281504272
4422,288281563,189188,288470751,0,7,0,159744,40,187949950
4423,288328911,25704,288354615,0,6,1,46592,14,2081546828
4424,288415069,125774,288540843,0,7,0,90112,40,5356171019
4425,288486780,21399,288508179,0,1,1,34816,18,5576511922
4426,288493487,14545,288508032,0,8,1,28160,21,4301449390
4427,288544460,16096,288560556,0,8,1,31232,21,3357571067
4428,288661482,7706,288669188,0,8,1,8192,21,1467545227
4429,288689986,101660,288791646,0,6,0,33792,14,9204381912
4430,288737575,13253,288750828,0,8,1,25600,21,3987217714
4431,288789257,4850,288794107,0,3,1,5120,37,590317655
4432,288851627,3645,288855272,0,8,1,10240,21,711346537
4433,288868514,1994,288870508,0,1,1,2048,18,8608876315
4434,288933813,24929,288958742,0,3,1,45056,37,8191733304
4435,288980737,3128,288983865,0,1,1,9216,18,1270194247
4436,288992732,5802,288998534,0,8,1,6144,21,6025996686
4437,289049464,3898,289053362,0,3,1,4096,37,2443653949
4438,289305213,11533,289316746,0,6,1,18944,14,611739195
4439,289351982,6754,289358736,0,1,1,7168,18,3189781496
4440,289356285,11016,289367301,0,6,1,17920,14,833553233
4441,289361309,1042,289362351,0,8,1,1024,21,5046008342
4442,289393003,7706,289400709,0,6,1,8192,14,5580480829
4443,289398829,23983,289422812,0,1,1,39936,18,8818108100
4444,289422076,1994,289424070,0,6,1,2048,14,4709334118
4445,289484120,5712,289489832,0,3,1,14336,37,3232788397
4446,289556421,6754,289563175,0,3,1,7168,37,7445107947
4447,289586845,479258,290066103,0,7,0,561152,40,6454482582
4448,289588345,5454,289593799,0,1,1,13824,18,8543875149
4449,289686111,1994,289688105,0,8,1,2048,21,9580472793
4450,289722819,5454,289728273,0,1,1,13824,18,7591418660
4451,289863181,12995,289876176,0,1,1,25088,18,2904859606
4452,289907113,1042,289908155,0,1,1,1024,18,9698858456
4453,289921999,1994,289923993,0,6,1,2048,14,3864668872
4454,289980198,4850,289985048,0,8,1,5120,21,6214098518
4455,289990653,10499,290001152,0,1,1,16896,18,7765505826
4456,290011336,14117,290025453,0,1,1,24064,18,7826801711
4457,290022453,256698,290279151,0,7,0,238080,40,7859730528
4458,290046765,4162,290050927,0,1,1,11264,18,930992379
4459,290086907,2946,290089853,0,1,1,3072,18,6493869149
4460,290135001,5326,290140327,0,2,1,5632,14,1695998609
4461,290142364,110084,290252448,0,8,0,61440,21,2305316755
4462,290181308,4420,290185728,0,3,1,11776,37,5562232197
4463,290245498,234689,290480187,0,7,0,198656,40,10146475392
4464,290261554,5326,290266880,0,1,1,5632,18,3127997060
4465,290288724,2470,290291194,0,1,1,2560,18,5083284195
4466,290313876,292851,290606727,0,7,0,178176,40,3333858765
4467,290320523,35829,290356352,0,3,1,62976,37,634198013
4468,290327292,330957,290658249,0,7,0,119296,40,1075120635
4469,290553736,15321,290569057,0,8,1,29696,21,639717048
4470,290714723,69596,290784319,0,7,0,9216,40,2826135567
4471,290850072,10241,290860313,0,3,1,16384,37,4386089284
4472,291005421,16354,291021775,0,8,1,31744,21,3726771427
4473,291062040,133196,291195236,0,8,0,77312,21,9731893513
4474,291133702,25962,291159664,0,8,1,47104,21,4026306570
4475,291414074,4374,291418448,0,1,1,4608,18,6870643818
4476,291420890,11791,291432681,0,3,1,19456,37,3083797291
4477,291424659,111800,291536459,0,8,0,67072,21,6055943064
4478,291425145,118352,291543497,0,6,0,88576,14,7463906308
4479,291450158,425541,291875699,0,6,0,466944,14,8046835977
4480,291522488,382874,291905362,0,6,0,97280,14,7497599994
4481,291535603,86672,291622275,0,7,0,14848,40,4808106820
4482,291612412,12825,291625237,0,8,1,21504,21,4514518942
4483,291682041,1994,291684035,0,3,1,2048,37,608064879
4484,291753462,12049,291765511,0,3,1,19968,37,9738289553
4485,291788214,280721,292068935,0,6,0,173056,14,1739248487
4486,291810064,11274,291821338,0,3,1,18432,37,5862355916
4487,291810777,13787,291824564,0,3,1,5120,37,6371904985
4488,291942143,4162,291946305,0,3,1,11264,37,4922528189
4489,292052164,2470,292054634,0,8,1,2560,21,10349942908
4490,292104358,240393,292344751,0,8,0,140800,21,6901417884
4491,292124466,92684,292217150,0,7,0,19456,40,7295291604
4492,292139513,5971,292145484,0,3,1,14848,37,6484650134
4493,292242467,110708,292353175,0,6,0,63488,14,549888615
4494,292262276,234947,292497223,0,8,0,180224,21,9606429704
4495,292351583,381428,292733011,0,6,0,462848,14,7618333862
4496,292361432,397186,292758618,0,6,0,83968,14,8294706091
4497,292395207,127868,292523075,0,7,0,119808,40,476613992
4498,292416157,6754,292422911,0,8,1,7168,21,5872799694
4499,292416723,3387,292420110,0,6,1,9728,14,5489963501
4500,292493571,6488,292500059,0,3,1,15872,37,10125420252
4501,292574692,4374,292579066,0,3,1,4608,37,5786355788
4502,292636530,129753,292766283,0,6,1,8192,14,7408124486
4503,292663830,6278,292670108,0,3,1,6656,37,6903911804
4504,292789742,101816,292891558,0,6,0,34304,14,7183308824
4505,292830655,6229,292836884,0,1,1,15360,18,8894972341
4506,292853990,1042,292855032,0,8,1,1024,21,4645542073
4507,292857411,116500,292973911,0,8,0,81408,21,7806841389
4508,292961915,4850,292966765,0,6,1,5120,14,7620352063
4509,293021228,12308,293033536,0,3,1,20480,37,682298594
4510,293034496,6229,293040725,0,1,1,15360,18,10167610686
4511,293039488,4679,293044167,0,8,1,12288,21,6439377877
4512,293145280,3422,293148702,0,6,1,3584,14,2545262255
4513,293308726,4850,293313576,0,6,1,5120,14,6593275705
4514,293311255,25446,293336701,0,6,1,46080,14,8983637023
4515,293334082,12049,293346131,0,6,1,19968,14,4722289339
4516,293460475,7706,293468181,0,4,1,8192,12,9136753677
4517,293481488,4420,293485908,0,4,1,11776,12,7736192627
4518,293490353,4937,293495290,0,4,1,12800,12,761610033
4519,293532696,113360,293646056,0,0,0,72192,29,6414309380
4520,293552722,2870,293555592,0,3,1,8704,37,2008938620
4521,293559953,14029,293573982,0,1,1,27136,18,90032965
4522,293572987,5971,293578958,0,6,1,14848,14,102986152
4523,293620280,127556,293747836,0,6,0,118784,14,6966638110
4524,293662089,3904,293665993,0,8,1,10752,21,5122039888
4525,293689059,2946,293692005,0,4,1,3072,12,1783617736
4526,293733219,106808,293840027,0,7,0,50688,40,2989334206
4527,293743230,10241,293753471,0,3,1,16384,37,4877700070
4528,293832129,13341,293845470,0,3,1,22528,37,8067974791
4529,293878252,4679,293882931,0,3,1,12288,37,5261284681
4530,293936084,4420,293940504,0,4,1,11776,12,9170109646
4531,293999027,2470,294001497,0,8,1,2560,21,7891413858
4532,294000790,11791,294012581,0,1,1,19456,18,3535331936
4533,294017562,1994,294019556,0,3,1,2048,37,4704354670
4534,294053014,566,294053580,0,4,1,512,12,4585890004
4535,294074582,143150,294217732,0,8,0,128512,21,10618169713
4536,294093270,6229,294099499,0,3,1,15360,37,1678044959
4537,294162071,55676,294217747,0,8,1,45568,21,8915355699
4538,294195508,2946,294198454,0,3,1,3072,37,4401810477
4539,294334868,2946,294337814,0,4,1,3072,12,7773763820
4540,294391667,21916,294413583,0,6,1,35840,14,5452296537
4541,294409305,191528,294600833,0,7,0,167424,40,7775466966
4542,294416737,130988,294547725,0,8,0,130048,21,5033831051
4543,294434214,307292,294741506,0,0,0,386048,29,10313937922
4544,294451911,112268,294564179,0,6,0,68608,14,10452889061
4545,294571722,2470,294574192,0,6,1,2560,14,2058826371
4546,294716302,1518,294717820,0,1,1,1536,18,2536570232
4547,294789313,5196,294794509,0,6,1,13312,14,6636295992
4548,294876033,91148,294967181,0,8,0,19456,21,6030465523
4549,294957939,7230,294965169,0,1,1,7680,18,7415966119
4550,295013082,32816,295045898,0,6,1,53760,14,6574335977
4551,295085156,66836,295151992,0,8,0,10240,21,1022530330
4552,295110821,5712,295116533,0,6,1,14336,14,8932607816
4553,295149825,11791,295161616,0,6,1,19456,14,9961561061
4554,295180670,115076,295295746,0,8,0,77824,21,4422280734
4555,295191544,85472,295277016,0,0,0,20992,29,5616300269
4556,295215975,2946,295218921,0,4,1,3072,12,6491360821
4557,295302474,109304,295411778,0,0,0,58880,29,203307218
4558,295400686,116636,295517322,0,8,0,82944,21,2798275931
4559,295443406,104000,295547406,0,0,0,41472,29,3821202827
4560,295443791,4937,295448728,0,6,1,12800,14,8608943675
4561,295483817,3898,295487715,0,1,1,4096,18,8218930659
4562,295521228,45596,295566824,0,6,0,1024,14,8667291671
4563,295720805,4420,295725225,0,6,1,11776,14,1574993937
4564,295732246,43904,295776150,0,6,0,512,14,696163835
4565,295866985,118352,295985337,0,8,0,88576,21,3411516281
4566,295867478,49136,295916614,0,6,0,2560,14,2070724638
4567,296029786,43904,296073690,0,6,0,512,14,3025661490
4568,296105772,3128,296108900,0,6,1,9216,14,817728523
4569,296185537,60980,296246517,0,6,0,6144,14,3570416126
4570,296195130,1994,296197124,0,6,1,2048,14,7828829353
4571,296389013,195896,296584909,0,0,0,181760,29,6368320454
4572,296401160,197144,296598304,0,8,0,185856,21,1357156520
4573,296460992,5196,296466188,0,1,1,13312,18,9777042071
4574,296538850,293720,296832570,0,7,0,341504,40,8630757176
4575,296559488,2470,296561958,0,1,1,2560,18,5960728879
4576,296581941,252360,296834301,0,7,0,5632,40,8174430899
4577,296907959,1518,296909477,0,1,1,1536,18,6586525072
4578,296945979,1042,296947021,0,3,1,1024,37,3013757832
4579,296997754,2870,297000624,0,1,1,8704,18,10434629185
4580,297000444,4861,297005305,0,1,1,5120,18,1912359244
4581,297030093,10241,297040334,0,6,1,16384,14,8069856148
4582,297051139,125996,297177135,0,0,0,113664,29,6643517550
4583,297135230,3422,297138652,0,4,1,3584,12,3354052806
4584,297169526,2946,297172472,0,1,1,3072,18,8141527530
4585,297207571,54056,297261627,0,6,0,3584,14,8318377763
4586,297235711,11016,297246727,0,6,1,17920,14,3240285952
4587,297449663,3422,297453085,0,1,1,3584,18,9227489807
4588,297518267,566,297518833,0,1,1,512,18,4859182778
4589,297623823,194024,297817847,0,0,0,175616,29,7892850267
4590,297626167,6278,297632445,0,4,1,6656,12,8762275298
4591,297692436,119288,297811724,0,8,0,91648,21,4365220913
4592,297709707,218828,297928535,0,7,0,257024,40,8948209232
4593,297728986,132370,297861356,0,8,0,15360,21,387251468
4594,297774831,566,297775397,0,1,1,512,18,7680803876
4595,297775806,162884,297938690,0,7,0,33280,40,1308277486
4596,297805821,566,297806387,0,4,1,512,12,5781076727
4597,297947582,59132,298006714,0,6,0,5120,14,10090932619
4598,298030728,5196,298035924,0,1,1,13312,18,6313675334
4599,298162175,1042,298163217,0,1,1,1024,18,3914238884
4600,298231367,208844,298440211,0,0,0,224256,29,7628582762
4601,298425806,4162,298429968,0,4,1,11264,12,4881774281
4602,298428315,20366,298448681,0,1,1,32768,18,6367158676
4603,298545492,45596,298591088,0,6,0,1024,14,2014527768
4604,298619923,7706,298627629,0,4,1,8192,12,1090918235
4605,298635978,60824,298696802,0,6,0,5632,14,3214035437
4606,298661535,215396,298876931,0,0,0,245760,29,5155274733
4607,298663960,169328,298833288,0,7,0,150016,40,6184320680
4608,298769277,48980,298818257,0,6,0,2048,14,2745870003
4609,298942410,6278,298948688,0,1,1,6656,18,10228758835
4610,298951044,189656,299140700,0,7,0,161280,40,177203821
4611,298967771,14287,298982058,0,6,1,27648,14,3243611462
4612,298970899,119600,299090499,0,8,0,92672,21,5174640507
4613,299063948,95484,299159432,0,7,0,13824,40,7885938047
4614,299209463,99788,299309251,0,0,0,27648,29,6277220953
4615,299221553,55748,299277301,0,6,0,4096,14,2513423185
4616,299228994,103220,299332214,0,8,0,38912,21,582275114
4617,299344425,12995,299357420,0,1,1,25088,18,8368922810
4618,299391291,106028,299497319,0,0,0,48128,29,9903051867
4619,299400654,165608,299566262,0,7,0,142848,40,10275462951
4620,299553976,202916,299756892,0,0,0,204800,29,3520715666
4621,299571049,202862,299773911,0,0,0,55808,29,2839619621
4622,299667697,107165,299774862,0,0,0,3072,29,3035544431
4623,299763289,3904,299767193,0,8,1,10752,21,9293206886
4624,299895284,10241,299905525,0,1,1,16384,18,1379996483
4625,299927495,3645,299931140,0,6,1,10240,14,7922410425
4626,299966993,208064,300175057,0,0,0,221696,29,3281720209
4627,300103255,114608,300217863,0,8,0,76288,21,10144762327
4628,300180686,130676,300311362,0,7,0,129024,40,516747380
4629,300261425,118625,300380050,0,7,0,54784,40,4414307760
4630,300265043,11533,300276576,0,8,1,18944,21,3718739772
4631,300268627,313302,300581929,0,7,0,184320,40,9980076945
4632,300300343,341367,300641710,0,7,0,155136,40,451327818
4633,300337120,188634,300525754,0,7,0,92160,40,6946981086
4634,300342344,116324,300458668,0,0,0,81920,29,3863891329
4635,300492526,1994,300494520,0,1,1,2048,18,2056802464
4636,300700748,22862,300723610,0,0,1,40960,29,6314566397
4637,300772192,133021,300905213,0,0,0,20992,29,1680518228
4638,300834343,47444,300881787,0,6,0,2048,14,2527632990
4639,300842244,2946,300845190,0,8,1,3072,21,2709543256
4640,300905391,121940,301027331,0,7,0,100352,40,1906592271
4641,300946820,24412,300971232,0,2,1,44032,14,10127274702
4642,301180456,4420,301184876,0,0,1,11776,29,1160383609
4643,301210854,6278,301217132,0,8,1,6656,21,1883054508
4644,301211184,98852,301310036,0,7,0,24576,40,4787243126
4645,301278114,6229,301284343,0,8,1,15360,21,8095475401
4646,301287328,36087,301323415,0,0,1,63488,29,7858161642
4647,301327040,5454,301332494,0,2,1,13824,14,4151908911
4648,301426528,5712,301432240,0,0,1,14336,29,1140859748
4649,301512954,103220,301616174,0,0,0,38912,29,4080135811
4650,301529589,15321,301544910,0,8,1,29696,21,1953190349
4651,301576163,4420,301580583,0,0,1,11776,29,865419658
4652,301662048,5326,301667374,0,0,1,5632,29,9933049364
4653,301694603,1994,301696597,0,1,1,2048,18,10403098202
4654,301723740,3422,301727162,0,0,1,3584,29,2609981022
4655,301729637,5971,301735608,0,1,1,14848,18,8371803999
4656,301803219,106964,301910183,0,7,0,51200,40,5244440259
4657,301860460,47288,301907748,0,6,0,1536,14,1237598947
4658,301867694,7706,301875400,0,1,1,8192,18,9455862078
4659,301871952,45596,301917548,0,6,0,1024,14,3424557529
4660,301911937,3898,301915835,0,0,1,4096,29,2749342965
4661,301929862,47288,301977150,0,6,0,1536,14,3303226522
4662,301992463,117884,302110347,0,8,0,87040,21,3151798257
4663,301993931,256534,302250465,0,8,0,152576,21,1639067066
4664,302000696,60824,302061520,0,6,0,5632,14,10011645447
4665,302171576,119288,302290864,0,7,0,91648,40,9731414513
4666,302202589,45596,302248185,0,6,0,1024,14,577849484
4667,302213083,11016,302224099,0,4,1,17920,12,3177517783
4668,302257346,32558,302289904,0,4,1,53248,12,8116103626
4669,302259469,35581,302295050,0,4,1,8192,12,3878344891
4670,302266181,566,302266747,0,0,1,512,29,9026103214
4671,302312580,54056,302366636,0,0,0,3584,29,10638207099
4672,302346899,47288,302394187,0,6,0,1536,14,1080181442
4673,302369555,34279,302403834,0,8,1,59904,21,3104211103
4674,302464701,4850,302469551,0,0,1,5120,29,6617759592
4675,302595098,172244,302767342,0,7,0,149504,40,4345416657
4676,302611322,3422,302614744,0,1,1,3584,18,7967713054
4677,302631051,6229,302637280,0,0,1,15360,29,6924332749
4678,302655200,108836,302764036,0,8,0,57344,21,10505683935
4679,302705679,132325,302838004,0,8,0,60928,21,6049860396
4680,302773589,1518,302775107,0,4,1,1536,12,5006542623
4681,302870367,2946,302873313,0,2,1,3072,14,4504936845
4682,302970983,3904,302974887,0,0,1,10752,29,1636148212
4683,302977128,4374,302981502,0,4,1,4608,12,7802042390
4684,303001960,3645,303005605,0,8,1,10240,21,3715031934
4685,303030117,13341,303043458,0,0,1,22528,29,7861849517
4686,303050234,566,303050800,0,8,1,512,21,2052317887
4687,303060115,5712,303065827,0,3,1,14336,37,7255298631
4688,303064907,106184,303171091,0,0,0,48640,29,2271533625
4689,303142105,6754,303148859,0,8,1,7168,21,2419566409
4690,303189855,76832,303266687,0,0,0,12800,29,10352391094
4691,303204053,1994,303206047,0,8,1,2048,21,3924973566
4692,303247865,14287,303262152,0,4,1,27648,12,10097619437
4693,303286442,120848,303407290,0,7,0,96768,40,3234375602
4694,303301746,6229,303307975,0,3,1,15360,37,3513292721
4695,303418999,141452,303560451,0,0,0,134144,29,2801771210
4696,303433663,3422,303437085,0,8,1,3584,21,5556468997
4697,303484656,3645,303488301,0,3,1,10240,37,6937239952
4698,303494807,5454,303500261,0,8,1,13824,21,1217794546
4699,303545462,19355,303564817,0,0,1,4608,29,2503373924
4700,303631416,214928,303846344,0,8,0,244224,21,924837402
4701,303648208,12737,303660945,0,0,1,24576,29,6431875568
4702,303693333,55748,303749081,0,6,0,4096,14,9915421854
4703,303706932,115232,303822164,0,7,0,78336,40,765186296
4704,303743839,25187,303769026,0,3,1,45568,37,3526236034
4705,303796324,22862,303819186,0,0,1,40960,29,932846230
4706,303831568,195292,304026860,0,8,0,146432,21,9166339295
4707,303869609,10241,303879850,0,3,1,16384,37,3764167114
4708,303906762,1042,303907804,0,8,1,1024,21,5166851708
4709,303935603,45596,303981199,0,6,0,1024,14,805146650
4710,303947851,6229,303954080,0,4,1,15360,12,9590562234
4711,303992899,37851,304030750,0,8,1,4096,21,9142097569
4712,304017156,100568,304117724,0,0,0,30208,29,536476972
4713,304170540,2470,304173010,0,8,1,2560,21,619236163
4714,304192733,4679,304197412,0,0,1,12288,29,9598533552
4715,304201170,4162,304205332,0,4,1,11264,12,7609194686
4716,304360539,118976,304479515,0,0,0,90624,29,6587878729
4717,304398461,1518,304399979,0,0,1,1536,29,7686796363
4718,304404456,6488,304410944,0,3,1,15872,37,5489964063
4719,304410462,4850,304415312,0,8,1,5120,21,2027593957
4720,304418504,52364,304470868,0,6,0,3072,14,8359158851
4721,304438193,290132,304728325,0,8,0,329728,21,5170192949
4722,304450608,1994,304452602,0,4,1,2048,12,1243389074
4723,304471682,67592,304539274,0,6,0,7680,14,5595605068
4724,304509856,12049,304521905,0,4,1,19968,12,534186388
4725,304535692,566,304536258,0,0,1,512,29,6818805287
4726,304574491,10499,304584990,0,4,1,16896,12,5878981719
4727,304618202,1518,304619720,0,3,1,1536,37,5344585005
4728,304648333,1518,304649851,0,4,1,1536,12,7837668356
4729,304648895,1042,304649937,0,3,1,1024,37,149386612
4730,304672702,6278,304678980,0,3,1,6656,37,354940867
4731,304699078,6754,304705832,0,3,1,7168,37,7282378464
4732,304710763,15321,304726084,0,3,1,29696,37,1649213150
4733,304761686,64208,304825894,0,0,0,6656,29,9309815454
4734,304795742,566,304796308,0,8,1,512,21,5384580704
4735,304837075,11533,304848608,0,0,1,18944,29,4393710416
4736,304881679,566,304882245,0,0,1,512,29,1914345020
4737,304928650,7230,304935880,0,0,1,7680,29,3573181592
4738,304953334,23208,304976542,0,8,1,38400,21,5950453246
4739,305095826,4374,305100200,0,3,1,4608,37,2338479591
4740,305170864,213680,305384544,0,7,0,240128,40,2226175689
4741,305239894,192458,305432352,0,7,0,102400,40,8358006291
4742,305368596,103844,305472440,0,8,0,40960,21,2602552557
4743,305373064,6488,305379552,0,3,1,15872,37,6346026007
4744,305385604,35571,305421175,0,0,1,62464,29,7182329797
4745,305835082,11016,305846098,0,9,1,17920,45,3998383443
4746,305921862,14029,305935891,0,0,1,27136,29,287803259
4747,305941936,117416,306059352,0,8,0,85504,21,6662398584
4748,305998051,20624,306018675,0,0,1,33280,29,9364449721
4749,306002962,107874,306110836,0,0,0,36864,29,7332361280
4750,306448590,129428,306578018,0,7,0,124928,40,7547657969
4751,306479779,195560,306675339,0,0,0,175616,29,4042764730
4752,306503894,6278,306510172,0,0,1,6656,29,8098649087
4753,306509666,13341,306523007,0,0,1,22528,29,7400352366
4754,306631185,108212,306739397,0,7,0,55296,40,10457258203
4755,307011707,14804,307026511,0,0,1,28672,29,4621801782
4756,307069222,55748,307124970,0,6,0,4096,14,3638786198
4757,307192275,100724,307292999,0,0,0,30720,29,10568388639
4758,307363210,5971,307369181,0,3,1,14848,37,9870421610
4759,307501827,7706,307509533,0,4,1,8192,12,113150028
4760,307574304,201907,307776211,0,0,0,187904,29,8163752242
4761,307593308,1518,307594826,0,0,1,1536,29,3002310722
4762,307703954,3645,307707599,0,4,1,10240,12,7977744214
4763,307725987,121940,307847927,0,7,0,100352,40,5289022904
4764,307793750,2946,307796696,0,4,1,3072,12,9286876648
4765,307814940,2946,307817886,0,0,1,3072,29,2036756493
4766,307847877,3422,307851299,0,0,1,3584,29,6935500382
4767,307854933,12825,307867758,0,4,1,21504,12,1564432910
4768,308121740,123968,308245708,0,8,0,107008,21,5195691708
4769,308211456,104312,308315768,0,0,0,42496,29,535773564
4770,308230676,1518,308232194,0,4,1,1536,12,5568503581
4771,308239697,566,308240263,0,4,1,512,12,462556606
4772,308264372,12049,308276421,0,0,1,19968,29,3736374898
4773,308284767,72668,308357435,0,7,0,9216,40,10101683366
4774,308429817,5326,308435143,0,1,1,5632,18,9552554606
4775,308450735,3422,308454157,0,0,1,3584,29,8851329176
4776,308470359,1518,308471877,0,4,1,1536,12,6910176857
4777,308484081,13341,308497422,0,0,1,22528,29,10569967009
4778,308688225,278744,308966969,0,7,0,292352,40,9829891194
4779,308810476,2870,308813346,0,4,1,8704,12,6436570863
4780,308831737,79436,308911173,0,6,0,11264,14,4903661919
4781,308960219,203852,309164071,0,8,0,207872,21,4557340550
4782,309063508,10757,309074265,0,0,1,17408,29,2307229323
4783,309227893,78056,309305949,0,6,0,11776,14,2462554634
4784,309240109,3422,309243531,0,0,1,3584,29,8701580120
4785,309273509,50672,309324181,0,0,0,2560,29,98481217
4786,309338136,4937,309343073,0,4,1,12800,12,1952497518
4787,309365283,128492,309493775,0,7,0,121856,40,5031488324
4788,309369234,45596,309414830,0,6,0,1024,14,4439724916
4789,309386336,214460,309600796,0,0,0,242688,29,6739426716
4790,309570841,1042,309571883,0,4,1,1024,12,1749482752
4791,309620189,13770,309633959,0,3,1,26624,37,7703990096
4792,309901284,3387,309904671,0,3,1,9728,37,112816757
4793,310052589,2470,310055059,0,3,1,2560,37,4280040134
4794,310168218,43904,310212122,0,6,0,512,14,10313263908
4795,310195303,4850,310200153,0,3,1,5120,37,10305267907
4796,310251003,25187,310276190,0,3,1,45568,37,9073449151
4797,310424545,212900,310637445,0,7,0,237568,40,2696485872
4798,310642198,2946,310645144,0,6,1,3072,14,4783625156
4799,310689006,45596,310734602,0,6,0,1024,14,3058011163
4800,310829682,6754,310836436,0,0,1,7168,29,2662840220
4801,310944544,7706,310952250,0,0,1,8192,29,9617943335
4802,311011683,5196,311016879,0,4,1,13312,12,4961431710
4803,311030964,59132,311090096,0,6,0,5120,14,7201476622
4804,311061587,157167,311218754,0,0,0,26112,29,10352353205
4805,311076717,13600,311090317,0,0,1,23040,29,975332650
4806,311181254,194804,311376058,0,8,0,178176,21,2215999011
4807,311194467,54056,311248523,0,6,0,3584,14,1569400439
4808,311244223,4937,311249160,0,0,1,12800,29,8898667694
4809,311429856,93752,311523608,0,0,0,17920,29,3638602554
4810,311452102,101192,311553294,0,7,0,32256,40,3480660671
4811,311493758,122564,311616322,0,8,0,102400,21,10020506128
4812,311513843,9780,311523623,0,0,1,4608,29,4274087503
4813,311598351,3128,311601479,0,5,1,9216,20,737152400
4814,311674236,1042,311675278,0,0,1,1024,29,1005991556
4815,311752496,66368,311818864,0,7,0,8704,40,7327001583
4816,311764417,2946,311767363,0,3,1,3072,37,7819230202
4817,311773602,14029,311787631,0,0,1,27136,29,2695907598
4818,311877861,79436,311957297,0,0,0,11264,29,1458133346
4819,311905356,49292,311954648,0,6,0,3072,14,7489122171
4820,311952013,95936,312047949,0,8,0,25088,21,7724038623
4821,311985230,4420,311989650,0,0,1,11776,29,3133199898
4822,312023726,121160,312144886,0,5,0,97792,20,10254386311
4823,312079104,5454,312084558,0,0,1,13824,29,5067846596
4824,312141422,290132,312431554,0,0,0,329728,29,1134042878
4825,312187954,32299,312220253,0,5,1,52736,20,7843389566
4826,312226076,109304,312335380,0,7,0,58880,40,1148997495
4827,312274367,5802,312280169,0,3,1,6144,37,3427260059
4828,312312981,6754,312319735,0,3,1,7168,37,7062064207
4829,312328942,1994,312330936,0,0,1,2048,29,3474092858
4830,312333392,7706,312341098,0,3,1,8192,37,5830629217
4831,312434633,4937,312439570,0,3,1,12800,37,8458400107
4832,312456750,191060,312647810,0,8,0,165888,21,5927238292
4833,312607633,23725,312631358,0,3,1,39424,37,5318754934
4834,312713616,13600,312727216,0,3,1,23040,37,9903033002
4835,312719099,111644,312830743,0,0,0,66560,29,7956823414
4836,312790730,43716,312834446,0,5,1,71680,20,6040458405
4837,312814354,226742,313041096,0,5,1,368128,20,2894282025
4838,312954240,302144,313256384,0,8,0,369152,21,2059868284
4839,313001940,3898,313005838,0,7,1,4096,40,5888263553
4840,313019955,15062,313035017,0,6,1,29184,14,4290132256
4841,313052335,1042,313053377,0,0,1,1024,29,9917335161
4842,313055591,3645,313059236,0,7,1,10240,40,281081996
4843,313101693,4162,313105855,0,3,1,11264,37,8964107039
4844,313167683,2470,313170153,0,3,1,2560,37,2903297585
4845,313203690,101036,313304726,0,0,0,31744,29,846925725
4846,313271178,5971,313277149,0,2,1,14848,14,1262999876
4847,313318587,47288,313365875,0,6,0,1536,14,4661420530
4848,313323953,194336,313518289,0,7,0,176640,40,1510124423
4849,313390401,158704,313549105,0,7,0,83968,40,7785301739
4850,313443166,7706,313450872,0,7,1,8192,40,6568522413
4851,313492817,89672,313582489,0,7,0,6656,40,2436606155
4852,313520800,3898,313524698,0,0,1,4096,29,9359942033
4853,313606387,72692,313679079,0,8,0,14336,21,2383269140
4854,313620777,22433,313643210,0,4,1,36864,12,946870728
4855,313631714,1042,313632756,0,0,1,1024,29,7351801215
4856,313842651,201200,314043851,0,0,0,199168,29,10448855477
4857,313844739,5326,313850065,0,7,1,5632,40,4224227586
4858,313907642,3898,313911540,0,0,1,4096,29,3357242361
4859,314171691,105248,314276939,0,7,0,45568,40,7266018177
4860,314288128,87296,314375424,0,0,0,16896,29,3827000920
4861,314307546,196208,314503754,0,7,0,182784,40,275630272
4862,314322499,5454,314327953,0,3,1,13824,37,7402498201
4863,314379755,47288,314427043,0,6,0,1536,14,2187839662
4864,314381057,52364,314433421,0,6,0,3072,14,8991100476
4865,314390831,45596,314436427,0,6,0,1024,14,8924348371
4866,314430193,50672,314480865,0,6,0,2560,14,5689420830
4867,314474680,322318,314796998,0,7,0,339968,40,7455990455
4868,314520774,11016,314531790,0,7,1,17920,40,691902846
4869,314529848,1518,314531366,0,3,1,1536,37,7560041919
4870,314779356,20762,314800118,0,7,1,9216,40,5481683176
4871,314794044,6278,314800322,0,1,1,6656,18,220405169
4872,314805780,280304,315086084,0,8,0,297472,21,5848699417
4873,314944218,6278,314950496,0,1,1,6656,18,6178417485
4874,315035991,1042,315037033,0,0,1,1024,29,6735811991
4875,315055178,125060,315180238,0,0,0,110592,29,6219137504
4876,315079564,11791,315091355,0,1,1,19456,18,9202374251
4877,315087321,14117,315101438,0,1,1,24064,18,7168295504
4878,315190319,94253,315284572,0,5,1,156672,20,247881259
4879,315218277,566,315218843,0,3,1,512,37,1843637729
4880,315234319,3128,315237447,0,0,1,9216,29,6483087542
4881,315242336,20882,315263218,0,1,1,33792,18,9716990788
4882,315291741,12995,315304736,0,5,1,25088,20,9328290977
4883,315316307,2470,315318777,0,3,1,2560,37,2822325862
4884,315433663,35829,315469492,0,5,1,62976,20,5364890657
4885,315477003,125840,315602843,0,8,0,113152,21,7099256334
4886,315522653,1994,315524647,0,1,1,2048,18,5291621113
4887,315524878,2946,315527824,0,5,1,3072,20,2332927263
4888,315557526,13600,315571126,0,7,1,23040,40,1447573885
4889,315599518,4162,315603680,0,7,1,11264,40,739054950
4890,315677959,6754,315684713,0,3,1,7168,37,860524099
4891,315693725,12995,315706720,0,5,1,25088,20,2333485050
4892,315738000,7230,315745230,0,1,1,7680,18,4913318498
4893,315764569,3645,315768214,0,3,1,10240,37,5455660319
4894,315810721,2946,315813667,0,3,1,3072,37,2462540778
4895,315837440,10241,315847681,0,0,1,16384,29,4691133250
4896,315902045,6278,315908323,0,3,1,6656,37,8630289527
4897,315912886,4937,315917823,0,7,1,12800,40,7414872571
4898,316008891,15837,316024728,0,7,1,30720,40,6117482718
4899,316251559,190124,316441683,0,0,0,162816,29,3542146738
4900,316267174,100256,316367430,0,7,0,29184,40,10704753874
4901,316281094,282479,316563573,0,0,0,239104,29,4654492670
4902,316352397,45596,316397993,0,6,0,1024,14,10472393632
4903,316380617,217112,316597729,0,8,0,251392,21,5639019608
4904,316508932,90372,316599304,0,8,0,5120,21,7958806999
4905,316548907,15062,316563969,0,3,1,29184,37,436963569
4906,316558035,12566,316570601,0,1,1,20992,18,5485972504
4907,316564957,11791,316576748,0,1,1,19456,18,3361866151
4908,316582998,12049,316595047,0,7,1,19968,40,9411441588
4909,316614640,2870,316617510,0,0,1,8704,29,5641713359
4910,316637125,2470,316639595,0,3,1,2560,37,670810404
4911,316662659,10241,316672900,0,1,1,16384,18,9970228430
4912,316710615,52364,316762979,0,7,0,3072,40,9101364750
4913,316778603,5454,316784057,0,0,1,13824,29,9168408290
4914,316884399,78392,316962791,0,0,0,17920,29,9348968584
4915,316947953,380624,317328577,0,8,0,465408,21,20613055
4916,317033636,4162,317037798,0,2,1,11264,14,574883589
4917,317195243,1518,317196761,0,3,1,1536,37,321991566
4918,317210839,43904,317254743,0,6,0,512,14,2915147798
4919,317310937,566,317311503,0,3,1,512,37,4126608384
4920,317410558,1518,317412076,0,3,1,1536,37,307097379
4921,317557742,31007,317588749,0,0,1,50176,29,8108774504
4922,317612532,4937,317617469,0,1,1,12800,18,9884027649
4923,317757805,93308,317851113,0,8,0,21504,21,6919909488
4924,317944497,7706,317952203,0,3,1,8192,37,7517247466
4925,318005649,7230,318012879,0,1,1,7680,18,1906474338
4926,318041410,11791,318053201,0,1,1,19456,18,10821819
4927,318081769,4850,318086619,0,0,1,5120,29,320673827
4928,318099746,5802,318105548,0,1,1,6144,18,7794507296
4929,318262993,254228,318517221,0,0,0,272384,29,1139024769
4930,318504966,304328,318809294,0,8,0,376320,21,5467545439
4931,318590809,3128,318593937,0,3,1,9216,37,9864118584
4932,318723346,427862,319151208,0,3,1,696320,37,21130369
4933,318733885,118508,318852393,0,0,0,89088,29,6566846842
4934,318898039,43904,318941943,0,6,0,512,14,5718868599
4935,318902352,61437,318963789,0,6,0,512,14,10026327353
4936,318904379,3422,318907801,0,9,1,3584,45,6516106077
4937,318938581,47288,318985869,0,6,0,1536,14,5039040463
4938,318946136,260142,319206278,0,7,0,228864,40,683626200
4939,318954558,300719,319255277,0,7,0,160768,40,1541214337
4940,318960849,201356,319162205,0,8,0,199680,21,6055101188
4941,319057234,5326,319062560,0,1,1,5632,18,3392843589
4942,319091357,4420,319095777,0,1,1,11776,18,2551330614
4943,319103409,21141,319124550,0,1,1,34304,18,2702647638
4944,319122116,50672,319172788,0,6,0,2560,14,8557242445
4945,319251835,116326,319368161,0,7,0,70656,40,9731801919
4946,319309206,63452,319372658,0,6,0,9216,14,4300052338
4947,319326426,3645,319330071,0,1,1,10240,18,9844117307
4948,319328868,125921,319454789,0,7,0,55296,40,8760152725
4949,319369034,4374,319373408,0,9,1,4608,45,3327581468
4950,319384767,5802,319390569,0,9,1,6144,45,4863102889
4951,319463587,60824,319524411,0,6,0,5632,14,6731278466
4952,319478657,12825,319491482,0,9,1,21504,45,4465692613
4953,319490526,91772,319582298,0,7,0,21504,40,354751154
4954,319493859,191840,319685699,0,0,0,168448,29,4842038422
4955,319495262,3422,319498684,0,6,1,3584,14,5252935011
4956,319597146,15579,319612725,0,9,1,30208,45,7998358531
4957,319665218,12995,319678213,0,9,1,25088,45,3538163623
4958,319669790,1042,319670832,0,1,1,1024,18,8045103186
4959,319690129,6488,319696617,0,1,1,15872,18,9368550424
4960,319712412,5971,319718383,0,1,1,14848,18,5292798204
4961,319749428,13600,319763028,0,3,1,23040,37,8796117813
4962,319770436,1042,319771478,0,9,1,1024,45,7364319884
4963,319780958,70976,319851934,0,0,0,8704,29,1983838346
4964,319793222,108524,319901746,0,8,0,56320,21,1221415459
4965,319868792,5326,319874118,0,9,1,5632,45,4513633366
4966,319884493,189500,320073993,0,8,0,160768,21,8380280585
4967,319902916,117416,320020332,0,7,0,85504,40,4080024306
4968,319905527,43904,319949431,0,4,0,512,12,1128094303
4969,319931040,566,319931606,0,1,1,512,18,9173503556
4970,319956054,43904,319999958,0,6,0,512,14,2175259404
4971,319983478,30491,320013969,0,3,1,49152,37,4788334475
4972,320075080,59132,320134212,0,4,0,5120,12,9908887394
4973,320153895,25187,320179082,0,3,1,45568,37,6932060100
4974,320159460,47600,320207060,0,6,0,2560,14,1998613180
4975,320180491,50672,320231163,0,4,0,2560,12,3642642095
4976,320279716,3904,320283620,0,7,1,10752,40,9128966698
4977,320414720,4937,320419657,0,1,1,12800,18,3858614807
4978,320439698,44920,320484618,0,3,1,77312,37,10239699699
4979,320661823,55821,320717644,0,3,1,95232,37,2232484049
4980,320662335,48980,320711315,0,6,0,2048,14,7070048782
4981,320770732,45596,320816328,0,6,0,1024,14,1570297349
4982,320800273,5802,320806075,0,1,1,6144,18,3961334438
4983,320818050,57440,320875490,0,4,0,4608,12,9730622502
4984,320821905,54529,320876434,0,3,1,92672,37,9398709823
4985,320846642,43904,320890546,0,4,0,512,12,3800089852
4986,320990465,177920,321168385,0,7,0,147968,40,7908875383
4987,321153740,33333,321187073,0,3,1,54784,37,923328125
4988,321237316,2870,321240186,0,1,1,8704,18,2532737743
4989,321293276,5196,321298472,0,1,1,13312,18,298285264
4990,321321497,47288,321368785,0,4,0,1536,12,1115079653
4991,321382822,3898,321386720,0,1,1,4096,18,2497638835
4992,321403073,45596,321448669,0,4,0,1024,12,10484500518
4993,321554524,4850,321559374,0,9,1,5120,45,10427934980
4994,321606244,566,321606810,0,1,1,512,18,1705286546
4995,321667009,125996,321793005,0,8,0,113664,21,6269862946
4996,321671528,5802,321677330,0,1,1,6144,18,9274732055
4997,321689892,126437,321816329,0,3,1,209408,37,3167395939
4998,321797653,105248,321902901,0,8,0,45568,21,7073673007
4999,321864493,96248,321960741,0,7,0,26112,40,10557860029
5000,321869766,405338,322275104,0,8,0,520192,21,9634839150
5001,321881687,4850,321886537,0,9,1,5120,45,5675043443
5002,321947886,4374,321952260,0,9,1,4608,45,6519167830
5003,321974672,50672,322025344,0,6,0,2560,14,3310809408
5004,321976829,2470,321979299,0,1,1,2560,18,1150868698
5005,322077649,43904,322121553,0,6,0,512,14,2317319819
5006,322089002,2470,322091472,0,1,1,2560,18,6253360473
5007,322185613,5802,322191415,0,1,1,6144,18,1516429250
5008,322344202,187160,322531362,0,8,0,153088,21,4899772763
5009,322363406,6488,322369894,0,9,1,15872,45,737166252
5010,322382677,86228,322468905,0,0,0,18432,29,3053211110
5011,322447486,123812,322571298,0,0,0,106496,29,4839093443
5012,322570533,43904,322614437,0,4,0,512,12,9075959860
5013,322574861,4850,322579711,0,9,1,5120,45,3619042303
5014,322589973,2470,322592443,0,7,1,2560,40,8450087249
5015,322725816,4850,322730666,0,1,1,5120,18,10370447943
5016,322789875,11791,322801666,0,7,1,19456,40,9591247586
5017,322806065,110084,322916149,0,7,0,61440,40,4990061595
5018,322827976,4420,322832396,0,1,1,11776,18,7800745210
5019,322880556,106808,322987364,0,8,0,50688,21,8107138011
5020,322915324,288416,323203740,0,0,0,324096,29,1768342181
5021,322936095,129272,323065367,0,6,0,124416,14,2504011256
5022,322955350,113620,323068970,0,6,0,11776,14,5484402793
5023,322977445,201595,323179040,0,8,0,167936,21,4022439497
5024,323030148,20366,323050514,0,9,1,32768,45,6938446756
5025,323072653,201668,323274321,0,7,0,200704,40,6860742416
5026,323106687,4679,323111366,0,7,1,12288,40,5517550790
5027,323167583,133545,323301128,0,8,0,100864,21,7132733508
5028,323235758,158394,323394152,0,8,0,106496,21,269314015
5029,323240104,48496,323288600,0,7,1,27648,40,4025535195
5030,323263361,73160,323336521,0,0,0,15872,29,3367937969
5031,323274111,132466,323406577,0,0,0,84480,29,763224481
5032,323312754,16613,323329367,0,9,1,32256,45,5040395827
5033,323330379,215863,323546242,0,7,0,74240,40,9812050045
5034,323351299,79813,323431112,0,8,0,13824,21,4590686799
5035,323384870,11016,323395886,0,1,1,17920,18,10633111203
5036,323416964,48980,323465944,0,4,0,2048,12,9014313345
5037,323442009,15321,323457330,0,1,1,29696,18,6720335315
5038,323526756,45596,323572352,0,4,0,1024,12,3481727269
5039,323529560,3387,323532947,0,1,1,9728,18,4337429873
5040,323630591,114608,323745199,0,7,0,76288,40,1467378078
5041,323813421,283424,324096845,0,7,0,307712,40,4480277054
5042,323989219,14545,324003764,0,9,1,28160,45,1214242067
5043,324078472,279212,324357684,0,8,0,293888,21,8092593172
5044,324109493,4420,324113913,0,9,1,11776,45,5494976705
5045,324177023,118352,324295375,0,6,0,88576,14,4916868562
5046,324186434,196364,324382798,0,0,0,183296,29,7882905154
5047,324200328,2946,324203274,0,5,1,3072,20,6314372794
5048,324223837,390150,324613987,0,6,0,411136,14,3295331984
5049,324249913,253965,324503878,0,0,0,144896,29,7665810786
5050,324349023,287131,324636154,0,6,0,72704,14,790661082
5051,324407210,5196,324412406,0,9,1,13312,45,296773592
5052,324436737,206452,324643189,0,6,0,23040,14,4311779409
5053,324466961,3645,324470606,0,9,1,10240,45,8947518174
5054,324502819,204008,324706827,0,7,0,208384,40,2943807936
5055,324503078,14804,324517882,0,1,1,28672,18,3401610981
5056,324583949,307916,324891865,0,8,0,388096,21,1805576917
5057,324661490,4850,324666340,0,4,1,5120,12,4771803281
5058,324701418,2870,324704288,0,5,1,8704,20,9718781941
5059,324720761,6278,324727039,0,5,1,6656,20,10253905165
5060,324735939,15579,324751518,0,1,1,30208,18,5999781692
5061,324746005,6229,324752234,0,9,1,15360,45,2517135821
5062,324844887,21141,324866028,0,9,1,34304,45,1480392892
5063,325042145,45596,325087741,0,8,0,1024,21,4481637396
5064,325093465,10757,325104222,0,5,1,17408,20,9768172705
5065,325213847,5971,325219818,0,1,1,14848,18,8504989550
5066,325218495,5196,325223691,0,9,1,13312,45,1259028923
5067,325229383,13512,325242895,0,7,1,26112,40,533913747
5068,325287915,58532,325346447,0,8,0,8192,21,2108945110
5069,325390272,7230,325397502,0,7,1,7680,40,2614539217
5070,325629044,45596,325674640,0,4,0,1024,12,7824725028
5071,325680351,4850,325685201,0,5,1,5120,20,10477487582
5072,325707734,25962,325733696,0,5,1,47104,20,9957897389
5073,325730681,6488,325737169,0,7,1,15872,40,4098689866
5074,325739882,47288,325787170,0,4,0,1536,12,7243362528
5075,325745371,6754,325752125,0,7,1,7168,40,4820016169
5076,325790567,10499,325801066,0,7,1,16896,40,5931263330
5077,325824511,101348,325925859,0,6,0,32768,14,9638149441
5078,325827909,124748,325952657,0,8,0,109568,21,9865859182
5079,325922414,23120,325945534,0,7,1,41472,40,7660593585
5080,325988379,114140,326102519,0,8,0,74752,21,1484172918
5081,325996110,10241,326006351,0,0,1,16384,29,143481401
5082,325997310,194121,326191431,0,0,0,163328,29,5793669520
5083,326067611,5802,326073413,0,5,1,6144,20,8403797389
5084,326159477,115388,326274865,0,8,0,78848,21,191956563
5085,326189939,14029,326203968,0,3,1,27136,37,6590498043
5086,326224709,6278,326230987,0,0,1,6656,29,5006694846
5087,326231980,47288,326279268,0,4,0,1536,12,10261518150
5088,326269981,47288,326317269,0,4,0,1536,12,2454356156
5089,326272386,193868,326466254,0,7,0,175104,40,2260756633
5090,326287237,119461,326406698,0,7,0,19968,40,1673456136
5091,326306274,102128,326408402,0,8,0,35328,21,9700275513
5092,326390623,4374,326394997,0,5,1,4608,20,5688619816
5093,326397141,11533,326408674,0,7,1,18944,40,3643596981
5094,326427954,4162,326432116,0,0,1,11264,29,8363345842
5095,326438145,12995,326451140,0,0,1,25088,29,7817561900
5096,326441853,133271,326575124,0,7,0,56320,40,6829165845
5097,326524922,3128,326528050,0,0,1,9216,29,40548772
5098,326603869,6278,326610147,0,5,1,6656,20,3091004461
5099,326628589,65924,326694513,0,8,0,12288,21,4368933201
5100,326629914,120536,326750450,0,7,0,95744,40,3571063328
5101,326706365,124112,326830477,0,3,1,204800,37,405325615
5102,326744922,4937,326749859,0,0,1,12800,29,5895376321
5103,326745884,140934,326886818,0,7,0,132608,40,812239537
5104,326888985,4850,326893835,0,0,1,5120,29,1617877069
5105,326901706,6278,326907984,0,2,1,6656,14,4445949346
5106,326953423,5454,326958877,0,7,1,13824,40,400222934
5107,326967159,4162,326971321,0,7,1,11264,40,8149925720
5108,326981003,12566,326993569,0,9,1,20992,45,3433989104
5109,326997740,223928,327221668,0,7,0,186880,40,5144535922
5110,327001216,43904,327045120,0,4,0,512,12,9727140763
5111,327017381,47288,327064669,0,4,0,1536,12,8955727484
5112,327023764,114850,327138614,0,3,1,186880,37,3538198576
5113,327038246,11016,327049262,0,6,1,17920,14,1169163113
5114,327105239,74520,327179759,0,3,1,124928,37,3605874717
5115,327117249,6278,327123527,0,7,1,6656,40,5278378105
5116,327121903,22862,327144765,0,8,1,40960,21,10384944202
5117,327139341,49136,327188477,0,4,0,2560,12,4835489757
5118,327213375,485186,327698561,0,0,0,580608,29,2514643422
5119,327275118,2870,327277988,0,7,1,8704,40,6525149949
5120,327309049,15062,327324111,0,0,1,29184,29,3185088648
5121,327345010,193400,327538410,0,6,0,173568,14,305365896
5122,327354416,199609,327554025,0,6,0,51200,14,8874918411
5123,327395261,391544,327786805,0,8,0,501248,21,5245984060
5124,327396318,209532,327605850,0,6,0,95232,14,9825315487
5125,327463013,12049,327475062,0,6,1,19968,14,483496243
5126,327607810,50672,327658482,0,4,0,2560,12,9408511664
5127,327695311,48980,327744291,0,4,0,2048,12,7803390401
5128,327734659,5326,327739985,0,7,1,5632,40,1386964359
5129,327806549,2470,327809019,0,0,1,2560,29,7614134293
5130,327846802,164700,328011502,0,3,1,267264,37,7270528172
5131,327858732,373760,328232492,0,6,0,442880,14,22121229
5132,327939110,5196,327944306,0,6,1,13312,14,8373064317
5133,328049485,394664,328444149,0,8,0,511488,21,2032617001
5134,328095403,3645,328099048,0,7,1,10240,40,8043428830
5135,328096481,207815,328304296,0,7,0,214016,40,4355719222
5136,328272946,63450,328336396,0,3,1,103424,37,3583592436
5137,328306628,24412,328331040,0,0,1,44032,29,3035964740
5138,328315957,65900,328381857,0,7,0,7168,40,604356874
5139,328323490,220283,328543773,0,8,0,27136,21,8648985963
5140,328413164,2946,328416110,0,0,1,3072,29,404655940
5141,328477509,93464,328570973,0,8,0,22016,21,8300580415
5142,328566009,35571,328601580,0,3,1,62464,37,8490407659
5143,328595648,207437,328803085,0,3,1,340480,37,5283955787
5144,328643151,45596,328688747,0,4,0,1024,12,1100118681
5145,328750733,57844,328808577,0,3,1,26112,37,7946620233
5146,328797802,106187,328903989,0,3,1,176640,37,5468189930
5147,328813360,102596,328915956,0,8,0,36864,21,7502832659
5148,328814326,139760,328954086,0,0,0,133632,29,1709857806
5149,328829322,196988,329026310,0,7,0,185344,40,811953315
5150,328927885,192620,329120505,0,6,0,171008,14,3128763083
5151,329072969,43904,329116873,0,4,0,512,12,1770250497
5152,329091470,3128,329094598,0,0,1,9216,29,6169643277
5153,329107815,132126,329239941,0,6,0,92160,14,1266330416
5154,329109180,81374,329190554,0,3,1,131584,37,7446639810
5155,329160047,275987,329436034,0,3,1,450560,37,10652240573
5156,329280319,3898,329284217,0,0,1,4096,29,1990162459
5157,329323565,1042,329324607,0,4,1,1024,12,3177007500
5158,329359921,14287,329374208,0,7,1,27648,40,2673382229
5159,329440226,469742,329909968,0,3,1,761344,37,4852412649
5160,329462135,12566,329474701,0,1,1,20992,18,1850474204
5161,329470781,6278,329477059,0,6,1,6656,14,1829012850
5162,329487509,33503,329521012,0,0,1,58368,29,6820118032
5163,329494466,3645,329498111,0,6,1,10240,14,196604692
5164,329518731,45596,329564327,0,4,0,1024,12,5364341665
5165,329549874,16354,329566228,0,7,1,31744,40,3969889002
5166,329601631,95624,329697255,0,0,0,24064,29,10292352490
5167,329621467,566,329622033,0,0,1,512,29,4936366840
5168,329623355,1994,329625349,0,0,1,2048,29,7286807153
5169,329682003,155243,329837246,0,0,0,82432,29,756542540
5170,329682085,3422,329685507,0,5,1,3584,20,4562315085
5171,329695500,5909,329701409,0,0,1,11264,29,8048506739
5172,329708866,73579,329782445,0,0,0,7680,29,9216616727
5173,329755380,82820,329838200,0,6,0,12288,14,4669609886
5174,329807970,213810,330021780,0,0,0,180224,29,1423082217
5175,329849138,346614,330195752,0,0,0,281088,29,1487288612
5176,329941793,24412,329966205,0,3,1,44032,37,170735722
5177,329964560,13600,329978160,0,8,1,23040,21,1816285270
5178,329976677,5971,329982648,0,5,1,14848,20,7478983627
5179,330033144,372200,330405344,0,7,0,437760,40,1995561198
5180,330048872,368811,330417683,0,7,0,40448,40,7848519057
5181,330090889,175843,330266732,0,0,0,138752,29,8750032514
5182,330147936,34020,330181956,0,6,1,59392,14,1321398554
5183,330163605,240047,330403652,0,0,0,202752,29,8167353068
5184,330194780,5802,330200582,0,7,1,6144,40,4569415130
5185,330300924,6278,330307202,0,8,1,6656,21,4231712692
5186,330368942,1042,330369984,0,8,1,1024,21,7919640815
5187,330390915,117509,330508424,0,0,0,44032,29,7156262291
5188,330432808,111332,330544140,0,6,0,65536,14,5557452926
5189,330449735,100568,330550303,0,8,0,30208,21,5172903222
5190,330503355,139660,330643015,0,8,0,100352,21,4546652602
5191,330633811,58844,330692655,0,6,0,9216,14,2401105654
5192,330664429,2946,330667375,0,1,1,3072,18,8084749870
5193,330686873,23208,330710081,0,8,1,38400,21,10043550917
5194,330702290,12049,330714339,0,6,1,19968,14,920505383
5195,330719778,25187,330744965,0,6,1,45568,14,2497435639
5196,330770251,64208,330834459,0,4,0,6656,12,10555077284
5197,330788397,22174,330810571,0,0,1,36352,29,579616647
5198,330797118,16679,330813797,0,0,1,5120,29,6021568134
5199,330832167,511346,331343513,0,8,0,656384,21,10432930215
5200,330856132,4679,330860811,0,0,1,12288,29,3044107303
5201,330962440,24154,330986594,0,6,1,43520,14,1828697755
5202,330979935,365621,331345556,0,8,0,6656,21,9563608437
5203,331218830,2470,331221300,0,6,1,2560,14,343063638
5204,331222076,91241,331313317,0,3,1,147456,37,7544006926
5205,331252834,4420,331257254,0,0,1,11776,29,8030909977
5206,331269910,10757,331280667,0,1,1,17408,18,1949397646
5207,331343522,11016,331354538,0,0,1,17920,29,4658927340
5208,331403814,1042,331404856,0,0,1,1024,29,4968881312
5209,331435321,2470,331437791,0,1,1,2560,18,1945950309
5210,331438602,7706,331446308,0,1,1,8192,18,6814027076
5211,331518314,115856,331634170,0,6,0,80384,14,1680525687
5212,331587142,279524,331866666,0,0,0,294912,29,273099620
5213,331683247,11791,331695038,0,6,1,19456,14,7388466087
5214,331773021,14804,331787825,0,8,1,28672,21,3427876397
5215,331828605,44282,331872887,0,0,1,15360,29,660857312
5216,331888696,45752,331934448,0,4,0,1536,12,5711690653
5217,331996798,203072,332199870,0,0,0,205312,29,4179322101
5218,331998471,209058,332207529,0,0,0,25088,29,6187813930
5219,332041286,11016,332052302,0,6,1,17920,14,3304031767
5220,332208863,7230,332216093,0,6,1,7680,14,4032100569
5221,332230534,7706,332238240,0,0,1,8192,29,10299719053
5222,332292078,14287,332306365,0,0,1,27648,29,4874599426
5223,332332115,288104,332620219,0,6,0,323072,14,7846333490
5224,332414229,3128,332417357,0,8,1,9216,21,6936283332
5225,332483184,4374,332487558,0,8,1,4608,21,8088605313
5226,332621173,11791,332632964,0,4,1,19456,12,3711864046
5227,332653944,7230,332661174,0,3,1,7680,37,2970134956
5228,332724524,20366,332744890,0,8,1,32768,21,4006253595
5229,332810408,102284,332912692,0,0,0,35840,29,2725287479
5230,332889015,65900,332954915,0,6,0,7168,14,6125737869
5231,332949149,43904,332993053,0,4,0,512,12,5479078651
5232,332979403,196108,333175511,0,3,1,318464,37,1459543513
5233,332984795,4679,332989474,0,0,1,12288,29,5814373919
5234,333033476,3898,333037374,0,6,1,4096,14,5477089549
5235,333095359,7230,333102589,0,0,1,7680,29,31342317
5236,333100932,4937,333105869,0,0,1,12800,29,3739377183
5237,333108411,11274,333119685,0,8,1,18432,21,2173508827
5238,333113649,1042,333114691,0,6,1,1024,14,3980520173
5239,333129061,10757,333139818,0,0,1,17408,29,8617120997
5240,333163868,121760,333285628,0,0,0,7680,29,3677307890
5241,333189627,31524,333221151,0,3,1,51200,37,5137102542
5242,333239354,6229,333245583,0,8,1,15360,21,8881145398
5243,333261927,2946,333264873,0,6,1,3072,14,3480819706
5244,333322143,6229,333328372,0,6,1,15360,14,10603140234
5245,333337591,308946,333646537,0,3,1,504832,37,935469434
5246,333346401,108212,333454613,0,0,0,55296,29,9041259871
5247,333377295,566,333377861,0,6,1,512,14,7464194271
5248,333380230,111956,333492186,0,8,0,67584,21,5819747076
5249,333420148,114404,333534552,0,8,0,54272,21,9660338795
5250,333427696,480034,333907730,0,3,1,673792,37,5842128930
5251,333477372,23120,333500492,0,0,1,41472,29,8995257997
5252,333523658,1042,333524700,0,0,1,1024,29,8932865140
5253,333523815,264548,333788363,0,6,0,245760,14,2806873601
5254,333528233,295565,333823798,0,6,0,116224,14,6696804730
5255,333637600,275622,333913222,0,3,1,17920,37,3243662660
5256,333719374,200281,333919655,0,6,0,131072,14,3547275363
5257,333733268,191603,333924871,0,3,1,47616,37,3110188022
5258,333837320,25704,333863024,0,4,1,46592,12,10290279169
5259,333963454,1994,333965448,0,0,1,2048,29,2954525099
5260,333996321,204788,334201109,0,8,0,210944,21,1413390768
5261,334042406,23208,334065614,0,8,1,38400,21,10527654734
5262,334094062,4850,334098912,0,4,1,5120,12,5192484458
5263,334101363,12825,334114188,0,0,1,21504,29,6597269233
5264,334264874,120380,334385254,0,8,0,95232,21,4127087484
5265,334314576,4937,334319513,0,0,1,12800,29,7558338255
5266,334319263,121472,334440735,0,6,0,98816,14,10169282958
5267,334406512,2470,334408982,0,4,1,2560,12,9680112961
5268,334411727,1042,334412769,0,8,1,1024,21,7505270181
5269,334420706,4374,334425080,0,8,1,4608,21,9208354703
5270,334470464,15837,334486301,0,4,1,30720,12,4307720452
5271,334497304,3645,334500949,0,3,1,10240,37,10268416526
5272,334531289,13770,334545059,0,8,1,26624,21,1053419426
5273,334550920,7230,334558150,0,8,1,7680,21,1115793021
5274,334575784,48980,334624764,0,4,0,2048,12,2243913994
5275,334660566,2870,334663436,0,4,1,8704,12,7713021750
5276,334740247,6488,334746735,0,0,1,15872,29,1887620666
5277,334786423,20366,334806789,0,4,1,32768,12,6526385376
5278,334795569,139760,334935329,0,6,0,133632,14,2512973969
5279,334896428,106340,335002768,0,0,0,49152,29,6165103378
5280,334939631,3645,334943276,0,3,1,10240,37,8387733663
5281,335030885,7230,335038115,0,3,1,7680,37,5208290050
5282,335236467,4374,335240841,0,4,1,4608,12,5809511896
5283,335239798,23895,335263693,0,4,1,43008,12,8581393281
5284,335241745,3645,335245390,0,0,1,10240,29,572194195
5285,335267676,104156,335371832,0,8,0,41984,21,2070263154
5286,335386463,47288,335433751,0,4,0,1536,12,4966827768
5287,335546662,63140,335609802,0,0,0,8192,29,3295660755
5288,335581879,48980,335630859,0,4,0,2048,12,2298615765
5289,335596566,566,335597132,0,3,1,512,37,3282804392
5290,335621823,50672,335672495,0,4,0,2560,12,10605533535
5291,335647789,12825,335660614,0,3,1,21504,37,10452861739
5292,335797297,196052,335993349,0,6,0,182272,14,7361417853
5293,335798290,22433,335820723,0,0,1,36864,29,1582584196
5294,335837425,14287,335851712,0,4,1,27648,12,7322748642
5295,335852939,12995,335865934,0,8,1,25088,21,3341289454
5296,335906936,62672,335969608,0,8,0,6656,21,887762079
5297,336047997,208532,336256529,0,0,0,223232,29,4392001184
5298,336065946,5196,336071142,0,1,1,13312,18,5410733805
5299,336080441,3422,336083863,0,3,1,3584,37,8806957622
5300,336126403,3422,336129825,0,8,1,3584,21,8597245192
5301,336228188,101816,336330004,0,6,0,34304,14,5931080146
5302,336277461,1518,336278979,0,3,1,1536,37,2786228131
5303,336483573,52364,336535937,0,4,0,3072,12,8870658876
5304,336680574,99476,336780050,0,8,0,26624,21,5185495764
5305,336733772,11533,336745305,0,8,1,18944,21,6066878407
5306,336810297,43904,336854201,0,4,0,512,12,490897950
5307,336842690,290600,337133290,0,6,0,331264,14,6122594558
5308,336937412,6754,336944166,0,0,1,7168,29,9695266810
5309,336983792,4679,336988471,0,0,1,12288,29,1871906470
5310,337056269,13341,337069610,0,0,1,22528,29,7904969079
5311,337125697,2946,337128643,0,0,1,3072,29,10112818415
5312,337138533,216176,337354709,0,6,0,248320,14,2820686473
5313,337383266,76520,337459786,0,0,0,11776,29,9484259545
5314,337418779,1518,337420297,0,8,1,1536,21,1371247349
5315,337473779,648326,338122105,0,6,0,813568,14,9733610880
5316,337615521,3904,337619425,0,8,1,10752,21,5567875272
5317,337748526,25446,337773972,0,8,1,46080,21,7674163459
5318,338006870,77168,338084038,0,8,0,18944,21,8040802057
5319,338174602,102284,338276886,0,0,0,35840,29,640262261
5320,338187002,43904,338230906,0,4,0,512,12,6843724820
5321,338202395,33245,338235640,0,8,1,57856,21,8558178719
5322,338222377,236927,338459304,0,0,0,245248,29,3607295826
5323,338227920,11906,338239826,0,8,1,6656,21,4074255798
5324,338294431,390998,338685429,0,0,0,72704,29,7104257505
5325,338305931,54056,338359987,0,4,0,3584,12,5476698399
5326,338323515,339747,338663262,0,0,0,364032,29,9878248233
5327,338393840,95288,338489128,0,8,0,17920,21,1843980988
5328,338450969,11016,338461985,0,6,1,17920,14,682740967
5329,338469357,5971,338475328,0,6,1,14848,14,3518762667
5330,338698470,57440,338755910,0,4,0,4608,12,9371558445
5331,338739655,5712,338745367,0,3,1,14336,37,2922303064
5332,338744030,1518,338745548,0,8,1,1536,21,2954215284
5333,338806324,2870,338809194,0,8,1,8704,21,786618666
5334,338841049,129584,338970633,0,2,0,125440,14,2870361733
5335,339076174,111644,339187818,0,8,0,66560,21,3714059952
5336,339115147,99788,339214935,0,2,0,27648,14,6380737820
5337,339148317,25187,339173504,0,6,1,45568,14,5550139770
5338,339174874,84092,339258966,0,8,0,14336,21,9680712876
5339,339207687,14029,339221716,0,6,1,27136,14,8442732521
5340,339225754,173624,339399378,0,2,0,148992,14,2003933415
5341,339271074,23725,339294799,0,8,1,39424,21,3517997615
5342,339318415,202196,339520611,0,8,0,69632,21,2470189496
5343,339407330,108992,339516322,0,0,0,57856,29,4344540415
5344,339442042,6754,339448796,0,8,1,7168,21,5397870711
5345,339537771,1518,339539289,0,6,1,1536,14,2921921138
5346,339673853,3422,339677275,0,8,1,3584,21,873895630
5347,339686700,156680,339843380,0,6,0,138752,14,8065274913
5348,339741845,231537,339973382,0,6,0,176128,14,7389385210
5349,339874292,199655,340073947,0,8,0,141312,21,10423215907
5350,339889564,141312,340030876,0,8,0,52736,21,7934850703
5351,339954263,89588,340043851,0,0,0,14336,29,1327367748
5352,340155899,11533,340167432,0,1,1,18944,18,2927417930
5353,340164752,124904,340289656,0,6,0,110080,14,9236502863
5354,340172301,60980,340233281,0,4,0,6144,12,7554973020
5355,340241193,115232,340356425,0,8,0,78336,21,4965730829
5356,340288844,200576,340489420,0,2,0,197120,14,4020261225
5357,340355341,12049,340367390,0,6,1,19968,14,4322116793
5358,340367835,1042,340368877,0,5,1,1024,20,3105351691
5359,340457688,156628,340614316,0,2,0,110080,14,7182913070
5360,340483287,47288,340530575,0,4,0,1536,12,5537169586
5361,340507064,189656,340696720,0,8,0,161280,21,8456753044
5362,340524300,10499,340534799,0,1,1,16896,18,4106944006
5363,340586260,192588,340778848,0,2,0,144384,14,5030025131
5364,340613783,5802,340619585,0,1,1,6144,18,1536582875
5365,340655927,5971,340661898,0,6,1,14848,14,4490896795
5366,340682695,1518,340684213,0,1,1,1536,18,4724961422
5367,340725971,2870,340728841,0,6,1,8704,14,290017613
5368,340740027,242726,340982753,0,6,0,268800,14,2736046864
5369,340783861,4850,340788711,0,1,1,5120,18,5135249923
5370,340806142,111644,340917786,0,8,0,66560,21,9921329155
5371,340827671,7230,340834901,0,1,1,7680,18,2360482284
5372,340842158,7230,340849388,0,1,1,7680,18,2161990907
5373,341007629,59132,341066761,0,2,0,5120,14,1859635440
5374,341026937,2470,341029407,0,8,1,2560,21,1965982426
5375,341028925,23120,341052045,0,6,1,41472,14,10220413831
5376,341031609,47444,341079053,0,8,0,2048,21,6678370106
5377,341108572,1042,341109614,0,8,1,1024,21,5574690783
5378,341118150,4850,341123000,0,1,1,5120,18,7930128537
5379,341157597,248062,341405659,0,8,0,152064,21,3564767753
5380,341177845,10499,341188344,0,6,1,16896,14,3288246165
5381,341237285,43904,341281189,0,4,0,512,12,328776104
5382,341314619,6278,341320897,0,6,1,6656,14,9957113447
5383,341456284,194648,341650932,0,6,0,177664,14,3420454658
5384,341468929,4850,341473779,0,1,1,5120,18,5562656205
5385,341491842,101660,341593502,0,8,0,33792,21,9255982556
5386,341507630,50672,341558302,0,4,0,2560,12,685195680
5387,341519770,201512,341721282,0,8,0,200192,21,6066265669
5388,341528348,22950,341551298,0,6,1,37888,14,6993561847
5389,341567601,4374,341571975,0,8,1,4608,21,3364656900
5390,341686367,164412,341850779,0,6,0,112640,14,621760439
5391,341720292,3452,341723744,0,8,1,2560,21,8586324780
5392,341799832,397975,342197807,0,6,0,467968,14,8727498139
5393,341983262,14117,341997379,0,6,1,24064,14,9230225171
5394,341987114,50828,342037942,0,4,0,3072,12,2579323326
5395,342005016,5326,342010342,0,6,1,5632,14,7810713762
5396,342128869,191684,342320553,0,2,0,167936,14,4432336879
5397,342169363,60735,342230098,0,6,1,52736,14,3954590943
5398,342192152,10757,342202909,0,1,1,17408,18,10696768260
5399,342236731,13512,342250243,0,1,1,26112,18,2552710300
5400,342277612,53174,342330786,0,2,1,16384,14,5473555097
5401,342287979,305888,342593867,0,8,0,381440,21,9950863879
5402,342544129,7230,342551359,0,2,1,7680,14,5710495372
5403,342618316,23466,342641782,0,6,1,38912,14,1594995137
5404,342638698,109148,342747846,0,2,0,58368,14,10687196644
5405,342663951,83340,342747291,0,6,0,1536,14,742905758
5406,342815433,2870,342818303,0,2,1,8704,14,7528340221
5407,342861583,1518,342863101,0,8,1,1536,21,9604311611
5408,342892335,7706,342900041,0,1,1,8192,18,5124404771
5409,342907590,276404,343183994,0,2,0,284672,14,886104251
5410,342940502,6754,342947256,0,8,1,7168,21,6466813641
5411,342956141,4850,342960991,0,8,1,5120,21,3718314651
5412,342979964,255920,343235884,0,0,0,272896,29,1600498118
5413,342993885,243353,343237238,0,2,0,159744,14,513937393
5414,343067648,4679,343072327,0,6,1,12288,14,5545058453
5415,343114606,116948,343231554,0,6,0,83968,14,7537551017
5416,343122453,65178,343187631,0,2,1,10240,14,5981641435
5417,343268496,55748,343324244,0,6,0,4096,14,2873997614
5418,343276631,60866,343337497,0,8,1,98304,21,5476427461
5419,343400985,10241,343411226,0,8,1,16384,21,3590585152
5420,343431427,75008,343506435,0,0,0,16896,29,10524981868
5421,343434750,50672,343485422,0,4,0,2560,12,693843574
5422,343492690,61292,343553982,0,4,0,7168,12,1844825173
5423,343682903,14029,343696932,0,8,1,27136,21,648122430
5424,343854514,55904,343910418,0,4,0,4608,12,7055755029
5425,343863668,104312,343967980,0,0,0,42496,29,10209193113
5426,343881033,566,343881599,0,2,1,512,14,10192811396
5427,343932083,106340,344038423,0,2,0,49152,14,788941391
5428,343979388,126883,344106271,0,2,0,57856,14,7423699659
5429,344014654,191691,344206345,0,2,0,133120,14,7840915693
5430,344027859,16268,344044127,0,2,1,14336,14,1388774881
5431,344228893,14545,344243438,0,2,1,28160,14,4828182538
5432,344237309,124280,344361589,0,6,0,108032,14,8085928252
5433,344249955,57440,344307395,0,4,0,4608,12,1340650768
5434,344286889,3904,344290793,0,2,1,10752,14,3982537564
5435,344374575,16613,344391188,0,8,1,32256,21,4149442327
5436,344381372,5802,344387174,0,7,1,6144,40,878345406
5437,344389430,172753,344562183,0,2,0,76800,14,2036333366
5438,344477412,1042,344478454,0,0,1,1024,29,7652092518
5439,344510641,41132,344551773,0,8,1,66560,21,2505221166
5440,344610594,10499,344621093,0,7,1,16896,40,4323271656
5441,344686997,2946,344689943,0,8,1,3072,21,10214092236
5442,344789100,67928,344857028,0,4,0,13824,12,5726464721
5443,344831179,10499,344841678,0,7,1,16896,40,4426158392
5444,344837978,102752,344940730,0,0,0,37376,29,166638115
5445,344876180,5802,344881982,0,5,1,6144,20,5557709173
5446,344912595,5326,344917921,0,5,1,5632,20,3340885214
5447,344917177,4850,344922027,0,5,1,5120,20,7665250592
5448,344992018,5196,344997214,0,8,1,13312,21,8995326231
5449,345010829,64208,345075037,0,4,0,6656,12,8890724515
5450,345055943,100256,345156199,0,8,0,29184,21,3965650876
5451,345354407,12566,345366973,0,7,1,20992,40,7666080943
5452,345435650,5454,345441104,0,5,1,13824,20,9068835296
5453,345564677,45596,345610273,0,4,0,1024,12,6267570933
5454,345624575,58064,345682639,0,4,0,6656,12,7034311284
5455,345675137,114764,345789901,0,6,0,76800,14,6455578818
5456,345742084,4162,345746246,0,5,1,11264,20,9206531541
5457,345746014,3904,345749918,0,5,1,10752,20,5972624805
5458,345815981,5712,345821693,0,7,1,14336,40,7419908464
5459,345859755,4374,345864129,0,7,1,4608,40,6533466131
5460,345869168,129428,345998596,0,8,0,124928,21,7833446646
5461,345945077,101504,346046581,0,2,0,33280,14,10482323780
5462,345975913,131199,346107112,0,8,0,56320,21,1494167148
5463,345982096,2946,345985042,0,7,1,3072,40,3772374067
5464,345994703,126308,346121011,0,6,0,114688,14,4224350212
5465,346013092,117572,346130664,0,0,0,86016,29,4066929286
5466,346015595,11791,346027386,0,7,1,19456,40,6166710501
5467,346408512,370172,346778684,0,2,0,431104,14,7561944157
5468,346635641,113984,346749625,0,6,0,74240,14,6004011852
5469,346804927,55748,346860675,0,2,0,4096,14,9606299811
5470,347016682,104780,347121462,0,2,0,44032,14,4770660696
5471,347033668,47756,347081424,0,8,0,3072,21,8213715737
5472,347149909,14029,347163938,0,5,1,27136,20,5029548223
5473,347276011,195896,347471907,0,6,0,181760,14,1835998931
5474,347332951,43904,347376855,0,4,0,512,12,10229874208
5475,347378261,115120,347493381,0,6,0,69632,14,5441112429
5476,347387485,282176,347669661,0,0,0,303616,29,1411747041
5477,347387581,191060,347578641,0,2,0,165888,14,10658893736
5478,347563199,7706,347570905,0,4,1,8192,12,3763122675
5479,347613630,3387,347617017,0,4,1,9728,12,6674608848
5480,347629457,48980,347678437,0,4,0,2048,12,10022054697
5481,347631885,10499,347642384,0,5,1,16896,20,8653884251
5482,347638030,1518,347639548,0,4,1,1536,12,935396989
5483,347666013,112268,347778281,0,8,0,68608,21,10051074657
5484,347668697,6754,347675451,0,5,1,7168,20,7871775085
5485,347774612,156680,347931292,0,6,0,138752,14,2655743465
5486,347919380,3422,347922802,0,4,1,3584,12,10590784695
5487,348004274,95288,348099562,0,4,0,17920,12,3729429883
5488,348062751,3645,348066396,0,4,1,10240,12,7042944416
5489,348157921,245636,348403557,0,0,0,274432,29,5877643060
5490,348168259,111020,348279279,0,2,0,64512,14,8750750925
5491,348194172,12049,348206221,0,5,1,19968,20,1009212515
5492,348212960,195916,348408876,0,0,0,17408,29,7621591523
5493,348264480,167889,348432369,0,0,0,49152,29,2365894131
5494,348284520,10241,348294761,0,5,1,16384,20,10562977852
5495,348288403,118664,348407067,0,6,0,89600,14,7296333336
5496,348398925,5454,348404379,0,5,1,13824,20,10456958192
5497,348553675,12995,348566670,0,4,1,25088,12,3631865007
5498,348557543,19404,348576947,0,4,1,30208,12,5502389276
5499,348632811,4420,348637231,0,0,1,11776,29,2287481052
5500,348759973,106652,348866625,0,4,0,50176,12,1796946402
5501,348793510,98072,348891582,0,6,0,22016,14,7670101240
5502,348827619,134684,348962303,0,4,0,132096,12,3083758963
5503,348925976,59269,348985245,0,4,1,37888,12,5159755268
5504,348957559,101348,349058907,0,0,0,32768,29,3150544146
5505,348989543,3387,348992930,0,5,1,9728,20,5243230744
5506,349066828,3904,349070732,0,1,1,10752,18,7471406686
5507,349082478,111956,349194434,0,2,0,67584,14,7929881155
5508,349279107,294344,349573451,0,6,0,343552,14,7039951453
5509,349294373,3904,349298277,0,1,1,10752,18,4713579290
5510,349404646,3422,349408068,0,4,1,3584,12,7074386054
5511,349463211,202916,349666127,0,6,0,204800,14,5517481529
5512,349512639,61846,349574485,0,6,1,1024,14,6407537994
5513,349536274,148220,349684494,0,2,0,136192,14,3302402577
5514,349571150,5196,349576346,0,4,1,13312,12,1618483265
5515,349604824,268423,349873247,0,6,0,218624,14,8887256951
5516,349612206,107900,349720106,0,0,0,54272,29,5068591583
5517,349723684,5196,349728880,0,5,1,13312,20,7607992043
5518,349804521,3898,349808419,0,4,1,4096,12,1488735853
5519,349829038,342322,350171360,0,6,0,351744,14,3685630858
5520,349843942,103688,349947630,0,8,0,40448,21,4976868492
5521,349849085,14117,349863202,0,5,1,24064,20,3776698356
5522,349866578,10584,349877162,0,6,1,4096,14,4453954591
5523,349987436,117104,350104540,0,2,0,84480,14,2928132396
5524,349988006,211652,350199658,0,4,0,233472,12,9872093246
5525,350250358,141452,350391810,0,0,0,134144,29,10067169971
5526,350486225,123812,350610037,0,0,0,106496,29,5166278854
5527,350553206,128492,350681698,0,8,0,121856,21,9366120325
5528,350553985,127080,350681065,0,0,0,39936,29,4240214984
5529,350572594,32041,350604635,0,6,1,52224,14,1031810989
5530,350642988,99788,350742776,0,6,0,27648,14,10550789512
5531,350651499,5196,350656695,0,2,1,13312,14,6931757126
5532,351146863,148220,351295083,0,6,0,136192,14,4115085104
5533,351152066,21658,351173724,0,7,1,35328,40,7562371113
5534,351160841,103532,351264373,0,2,0,39936,14,2148208022
5535,351377979,107276,351485255,0,6,0,52224,14,7449257785
5536,351389737,86204,351475941,0,8,0,13312,21,7905231999
5537,351391524,195428,351586952,0,2,0,180224,14,8583211399
5538,351391807,193868,351585675,0,0,0,175104,29,376198961
5539,351408476,317370,351725846,0,2,0,246784,14,1218160953
5540,351447300,156680,351603980,0,6,0,138752,14,7437504674
5541,351549724,1042,351550766,0,7,1,1024,40,4767295046
5542,351737225,1518,351738743,0,6,1,1536,14,4702688308
5543,351743078,119444,351862522,0,0,0,92160,29,6181053850
5544,351985323,149624,352134947,0,6,0,140800,14,7111592435
5545,352057577,12308,352069885,0,8,1,20480,21,9671770935
5546,352135324,12308,352147632,0,7,1,20480,40,8664597149
5547,352151680,117104,352268784,0,2,0,84480,14,395580999
5548,352204839,103844,352308683,0,6,0,40960,14,3916194453
5549,352207877,278052,352485929,0,6,0,228352,14,4701137845
5550,352221301,5971,352227272,0,7,1,14848,40,5764449409
5551,352228248,6488,352234736,0,3,1,15872,37,5978734467
5552,352249531,238144,352487675,0,6,0,3584,14,4890231230
5553,352288765,107276,352396041,0,2,0,52224,14,7251024822
5554,352368454,118114,352486568,0,6,0,2048,14,9104101110
5555,352407904,81658,352489562,0,6,0,6144,14,740080932
5556,352436991,107900,352544891,0,8,0,54272,21,6820133942
5557,352514862,47288,352562150,0,6,0,1536,14,2422657676
5558,352543024,130520,352673544,0,0,0,128512,29,1934046024
5559,352627371,11016,352638387,0,8,1,17920,21,5316224491
5560,352660591,5712,352666303,0,3,1,14336,37,6513251867
5561,352729414,130364,352859778,0,0,0,128000,29,4601847661
5562,352756589,12825,352769414,0,7,1,21504,40,1017517546
5563,352760445,62516,352822961,0,6,0,6144,14,7758717162
5564,352797786,47288,352845074,0,6,0,1536,14,6049859618
5565,352823942,3422,352827364,0,6,1,3584,14,9138638338
5566,352881021,67748,352948769,0,0,0,8192,29,9168306445
5567,352971176,50672,353021848,0,6,0,2560,14,4559600470
5568,352976514,119756,353096270,0,0,0,93184,29,1506402278
5569,353023908,43904,353067812,0,6,0,512,14,8043128814
5570,353053050,2946,353055996,0,8,1,3072,21,3768896862
5571,353091602,5454,353097056,0,8,1,13824,21,3878099156
5572,353094465,50672,353145137,0,6,0,2560,14,9026028621
5573,353113754,101660,353215414,0,8,0,33792,21,7576000871
5574,353197009,4850,353201859,0,6,1,5120,14,5913649761
5575,353309117,108992,353418109,0,8,0,57856,21,2646103847
5576,353483730,1042,353484772,0,8,1,1024,21,5233070511
5577,353576885,13770,353590655,0,7,1,26624,40,9570295060
5578,353584156,10365,353594521,0,7,1,6144,40,1068475992
5579,353623756,11791,353635547,0,7,1,19456,40,4183190207
5580,353673318,5802,353679120,0,8,1,6144,21,3481028817
5581,353824930,115076,353940006,0,0,0,77824,29,5276457996
5582,353824985,4850,353829835,0,8,1,5120,21,9272297883
5583,353904292,43904,353948196,0,6,0,512,14,10213487671
5584,353950513,1518,353952031,0,6,1,1536,14,326007102
5585,353970709,5454,353976163,0,6,1,13824,14,5448643540
5586,354049974,23466,354073440,0,7,1,38912,40,9177739751
5587,354050641,5802,354056443,0,8,1,6144,21,4496233857
5588,354052670,47288,354099958,0,6,0,1536,14,6451275194
5589,354061677,375476,354437153,0,0,0,448512,29,317263265
5590,354170032,45596,354215628,0,6,0,1024,14,961815110
5591,354203160,108056,354311216,0,8,0,54784,21,8349171916
5592,354206578,130520,354337098,0,2,0,128512,14,7881883012
5593,354279661,14029,354293690,0,7,1,27136,40,9072201432
5594,354305354,106422,354411776,0,8,0,30208,21,7826405320
5595,354372485,20366,354392851,0,6,1,32768,14,216969799
5596,354388518,566,354389084,0,8,1,512,21,6423647410
5597,354389383,165320,354554703,0,2,0,146944,14,3817356844
5598,354475949,108430,354584379,0,2,0,40448,14,10369954476
5599,354524740,107900,354632640,0,0,0,54272,29,7863451864
5600,354575075,50672,354625747,0,8,0,2560,21,10593146209
5601,354648464,6278,354654742,0,6,1,6656,14,5569732811
5602,354685227,67616,354752843,0,2,0,12800,14,8603308174
5603,354803857,6229,354810086,0,7,1,15360,40,10482366368
5604,354813100,2946,354816046,0,7,1,3072,40,69898276
5605,354843219,13341,354856560,0,8,1,22528,21,1724062183
5606,354867917,123968,354991885,0,0,0,107008,29,5966253448
5607,354881137,35829,354916966,0,2,1,62976,14,1059120593
5608,354966877,54529,355021406,0,8,1,92672,21,1631714505
5609,354976975,4374,354981349,0,7,1,4608,40,2873767405
5610,355041272,2470,355043742,0,2,1,2560,14,6707331770
5611,355078393,185156,355263549,0,2,0,151552,14,7036393374
5612,355154008,48980,355202988,0,6,0,2048,14,8431672353
5613,355156723,66419,355223142,0,6,0,1536,14,6327578448
5614,355222437,12737,355235174,0,6,1,24576,14,5765089464
5615,355265865,13600,355279465,0,1,1,23040,18,3752115024
5616,355297260,10499,355307759,0,2,1,16896,14,1105143914
5617,355524556,1042,355525598,0,2,1,1024,14,6720135600
5618,355525730,12308,355538038,0,6,1,20480,14,6221369214
5619,355604476,15062,355619538,0,6,1,29184,14,9731911038
5620,355729975,59132,355789107,0,6,0,5120,14,8271033669
5621,355773195,200576,355973771,0,0,0,197120,29,175644496
5622,355799267,3128,355802395,0,6,1,9216,14,10023031016
5623,355893618,106709,356000327,0,6,0,1024,14,8636647453
5624,355900368,3387,355903755,0,6,1,9728,14,5523153122
5625,355940112,237191,356177303,0,0,0,206848,29,520651186
5626,356032099,2470,356034569,0,2,1,2560,14,8641530516
5627,356036145,100568,356136713,0,5,0,30208,20,2255858186
5628,356190839,116324,356307163,0,8,0,81920,21,9178075551
5629,356203163,3422,356206585,0,2,1,3584,14,693682946
5630,356216778,3128,356219906,0,2,1,9216,14,5509356625
5631,356216941,2470,356219411,0,8,1,2560,21,5259643077
5632,356277217,2946,356280163,0,9,1,3072,45,5674589670
5633,356295661,420566,356716227,0,5,0,524800,20,3543633864
5634,356313554,450900,356764454,0,5,0,158208,20,10736185512
5635,356384862,205256,356590118,0,2,0,212480,14,7099359407
5636,356498754,3904,356502658,0,8,1,10752,21,1886262354
5637,356571167,223070,356794237,0,8,0,204288,21,134234854
5638,356616105,11791,356627896,0,2,1,19456,14,4208754717
5639,356621927,187156,356809083,0,5,0,25088,20,2671720426
5640,356634078,16354,356650432,0,8,1,31744,21,1704926293
5641,356651768,174646,356826414,0,2,0,11264,14,10382549813
5642,356664524,566,356665090,0,2,1,512,14,8406949657
5643,356742921,11016,356753937,0,2,1,17920,14,5016509148
5644,356750576,13253,356763829,0,2,1,25600,14,6754004951
5645,356855944,3128,356859072,0,2,1,9216,14,9526974404
5646,356911721,112736,357024457,0,0,0,70144,29,1620163383
5647,356916669,7230,356923899,0,6,1,7680,14,2401094038
5648,356926468,6278,356932746,0,7,1,6656,40,6995428988
5649,356983789,4850,356988639,0,7,1,5120,40,4018547989
5650,357115264,11016,357126280,0,7,1,17920,40,9905165349
5651,357169428,3898,357173326,0,2,1,4096,14,7084628203
5652,357177777,216740,357394517,0,2,0,231936,14,1229523898
5653,357206140,43904,357250044,0,6,0,512,14,6937005412
5654,357248769,4162,357252931,0,3,1,11264,37,2857544792
5655,357258325,2470,357260795,0,7,1,2560,40,6168624941
5656,357275444,296216,357571660,0,5,0,349696,20,9047756244
5657,357488329,204320,357692649,0,2,0,209408,14,7026863255
5658,357505176,221679,357726855,0,2,0,93696,14,3444188875
5659,357543289,5326,357548615,0,3,1,5632,37,2619425599
5660,357545670,119288,357664958,0,8,0,91648,21,3667151449
5661,357599972,97784,357697756,0,0,0,26112,29,356513409
5662,357706120,106808,357812928,0,5,0,50688,20,5612992975
5663,357711827,28620,357740447,0,2,1,23040,14,4939064138
5664,357723091,149753,357872844,0,5,0,86016,20,10238602876
5665,357737046,3422,357740468,0,6,1,3584,14,9377846998
5666,357756284,104468,357860752,0,0,0,43008,29,1280905822
5667,357815848,213438,358029286,0,0,0,206848,29,6017588036
5668,357844362,5712,357850074,0,7,1,14336,40,1798563214
5669,358028270,100412,358128682,0,5,0,29696,20,10736447981
5670,358212512,216858,358429370,0,0,0,248832,29,10441860897
5671,358213038,397144,358610182,0,0,0,293376,29,824972839
5672,358243923,105716,358349639,0,7,0,47104,40,4127339391
5673,358246973,10757,358257730,0,7,1,17408,40,9426828276
5674,358290405,113516,358403921,0,2,0,72704,14,4896307537
5675,358311542,190748,358502290,0,8,0,164864,21,7082484375
5676,358386370,2470,358388840,0,3,1,2560,37,2533735037
5677,358389037,12049,358401086,0,7,1,19968,40,10184045271
5678,358403007,3422,358406429,0,7,1,3584,40,9038361574
5679,358421730,62516,358484246,0,7,0,6144,40,108629264
5680,358512510,116324,358628834,0,8,0,81920,21,7133236337
5681,358584081,112268,358696349,0,5,0,68608,20,5299424475
5682,358585685,134417,358720102,0,0,0,60928,29,4077837549
5683,358604248,4162,358608410,0,7,1,11264,40,4287228451
5684,358672022,54992,358727014,0,7,0,6656,40,2929058328
5685,358695266,2470,358697736,0,6,1,2560,14,3035399250
5686,358805741,3645,358809386,0,2,1,10240,14,9704091844
5687,358907294,64676,358971970,0,2,0,8192,14,5283554513
5688,358950611,3387,358953998,0,6,1,9728,14,2592593563
5689,358954723,52760,359007483,0,6,0,3072,14,1150109167
5690,359045322,45596,359090918,0,6,0,1024,14,7989735788
5691,359105497,197300,359302797,0,7,0,186368,40,935426744
5692,359134197,277652,359411849,0,8,0,288768,21,9672481941
5693,359243273,186687,359429960,0,8,0,59392,21,2230039246
5694,359254137,154212,359408349,0,7,0,46592,40,8846465108
5695,359314132,4937,359319069,0,7,1,12800,40,8683693260
5696,359318866,154837,359473703,0,8,0,125440,21,375612287
5697,359411405,1042,359412447,0,0,1,1024,29,3467018818
5698,359479340,3128,359482468,0,6,1,9216,14,1237886556
5699,359593474,21658,359615132,0,6,1,35328,14,978718486
5700,359641202,198860,359840062,0,2,0,191488,14,201905191
5701,359646711,7706,359654417,0,6,1,8192,14,2502168022
5702,359662743,92684,359755427,0,6,0,19456,14,5398098901
5703,359735525,170372,359905897,0,8,0,143360,21,7406358918
5704,359854986,13858,359868844,0,2,1,23552,14,797139627
5705,359896038,6754,359902792,0,6,1,7168,14,6735306362
5706,360000095,4374,360004469,0,1,1,4608,18,824031174
5707,360014159,16096,360030255,0,7,1,31232,40,9249619990
5708,360082559,218984,360301543,0,5,0,257536,20,7123282441
5709,360095819,4162,360099981,0,7,1,11264,40,252317505
5710,360108861,3898,360112759,0,2,1,4096,14,5738064236
5711,360122229,5454,360127683,0,6,1,13824,14,478452494
5712,360191678,55748,360247426,0,8,0,4096,21,1403633161
5713,360277171,131300,360408471,0,7,0,131072,40,6052092717
5714,360291156,112112,360403268,0,8,0,68096,21,6601372955
5715,360438737,3904,360442641,0,1,1,10752,18,1996015864
5716,360472704,102908,360575612,0,2,0,37888,14,10203212407
5717,360489199,114140,360603339,0,5,0,74752,20,7653161200
5718,360491056,206972,360698028,0,7,0,218112,40,6819682988
5719,360501733,3387,360505120,0,7,1,9728,40,6386846314
5720,360535131,164940,360700071,0,7,0,6656,40,4301186540
5721,360583338,3904,360587242,0,1,1,10752,18,8063827519
5722,360686007,63036,360749043,0,7,0,2048,40,9133337617
5723,360735195,94244,360829439,0,2,0,24576,14,9320051615
5724,360790002,47288,360837290,0,7,0,1536,40,9591904505
5725,360823627,307324,361130951,0,2,0,367104,14,3147634258
5726,360878695,53144,360931839,0,0,0,5632,29,4477338680
5727,360912146,225464,361137610,0,8,0,263680,21,4971096903
5728,360919769,2870,360922639,0,0,1,8704,29,9086555128
5729,360933338,10499,360943837,0,0,1,16896,29,2234939064
5730,360949284,13600,360962884,0,0,1,23040,29,3791675254
5731,360987091,24242,361011333,0,0,1,40448,29,578637879
5732,361015770,283415,361299185,0,0,0,190464,29,2058927764
5733,361017670,54056,361071726,0,7,0,3584,40,6270817134
5734,361076540,23208,361099748,0,0,1,38400,29,7867592950
5735,361174014,220388,361394402,0,5,0,262144,20,7918695764
5736,361200082,143456,361343538,0,0,0,25088,29,3116407039
5737,361215315,175784,361391099,0,8,0,151040,21,6596477647
5738,361218361,80839,361299200,0,0,1,52224,29,3515829806
5739,361268685,13770,361282455,0,7,1,26624,40,1429859172
5740,361269789,43904,361313693,0,6,0,512,14,5654604741
5741,361378904,4374,361383278,0,0,1,4608,29,5590057941
5742,361389462,15579,361405041,0,6,1,30208,14,1289855063
5743,361442481,115974,361558455,0,6,0,1024,14,2464057683
5744,361446044,45596,361491640,0,0,0,1024,29,3318223305
5745,361509406,43904,361553310,0,6,0,512,14,4194432971
5746,361686694,6754,361693448,0,6,1,7168,14,1571158772
5747,361736357,98852,361835209,0,0,0,24576,29,9338298421
5748,361805648,4937,361810585,0,6,1,12800,14,7559122763
5749,361814488,43904,361858392,0,7,0,512,40,10224341036
5750,361869307,153646,362022953,0,6,0,35840,14,6840562515
5751,361960419,54056,362014475,0,7,0,3584,40,1521683943
5752,362008269,45596,362053865,0,8,0,1024,21,671870816
5753,362146013,279524,362425537,0,0,0,294912,29,4420882971
5754,362152989,301735,362454724,0,0,0,95744,29,7275686595
5755,362245823,104312,362350135,0,5,0,42496,20,1705461858
5756,362312234,181715,362493949,0,0,0,63488,29,7569833416
5757,362450680,2946,362453626,0,6,1,3072,14,5998849433
5758,362453669,204233,362657902,0,5,0,197120,20,6472904356
5759,362481953,26017,362507970,0,0,1,27136,29,1007615469
5760,362484771,113056,362597827,0,5,0,15872,20,5071498573
5761,362491270,99944,362591214,0,8,0,28160,21,5483545499
5762,362491368,81284,362572652,0,2,0,12288,14,368299647
5763,362545045,107588,362652633,0,6,0,53248,14,6418042031
5764,362574136,169307,362743443,0,6,0,118272,14,7969026326
5765,362645494,207908,362853402,0,0,0,221184,29,10089540070
5766,362768306,1994,362770300,0,0,1,2048,29,2794230785
5767,362820831,113516,362934347,0,2,0,72704,14,7023120315
5768,362905960,43904,362949864,0,7,0,512,40,7704623066
5769,362912980,59132,362972112,0,6,0,5120,14,8471908039
5770,363125532,12825,363138357,0,6,1,21504,14,10382489447
5771,363169941,4162,363174103,0,6,1,11264,14,1969785608
5772,363257428,110864,363368292,0,8,0,64000,21,8700689991
5773,363294880,16354,363311234,0,9,1,31744,45,9081543601
5774,363349675,1994,363351669,0,6,1,2048,14,6556522013
5775,363468715,105716,363574431,0,6,0,47104,14,9949692138
5776,363477265,90236,363567501,0,5,0,21504,20,4575779087
5777,363485616,108992,363594608,0,0,0,57856,29,1049855936
5778,363530647,47288,363577935,0,7,0,1536,40,5166311623
5779,363586629,75140,363661769,0,2,0,12288,14,8296649943
5780,363589083,127088,363716171,0,5,0,117248,20,5470491631
5781,363594862,4937,363599799,0,9,1,12800,45,6764587666
5782,363603710,115856,363719566,0,0,0,80384,29,9132997562
5783,363645209,193415,363838624,0,0,0,142336,29,1661483613
5784,363660502,215240,363875742,0,8,0,245248,21,5734930222
5785,363704697,2870,363707567,0,8,1,8704,21,5138672210
5786,363734119,104936,363839055,0,5,0,44544,20,2056146877
5787,363830211,11533,363841744,0,6,1,18944,14,2236201261
5788,363833322,9088,363842410,0,6,1,1024,14,789874239
5789,363835029,273039,364108068,0,6,0,167936,14,7340147474
5790,363837237,12566,363849803,0,9,1,20992,45,1276452923
5791,363864125,207440,364071565,0,5,0,219648,20,3603196604
5792,363898459,14545,363913004,0,9,1,28160,45,8628474866
5793,364034119,216488,364250607,0,8,0,249344,21,5807129668
5794,364043975,140293,364184268,0,6,0,123392,14,2755881080
5795,364052134,129896,364182030,0,0,0,126464,29,3639840655
5796,364118328,4850,364123178,0,9,1,5120,45,9202242019
5797,364243261,229418,364472679,0,8,0,262656,21,4346795256
5798,364253959,194648,364448607,0,2,0,177664,14,7632036629
5799,364275646,22950,364298596,0,9,1,37888,45,1077255327
5800,364397742,291512,364689254,0,6,0,329216,14,7220521963
5801,364419107,94664,364513771,0,5,0,15872,20,5794661086
5802,364429654,1994,364431648,0,6,1,2048,14,4843747853
5803,364444294,247361,364691655,0,8,0,257536,21,7253606336
5804,364639242,123188,364762430,0,0,0,104448,29,4437459381
5805,364691447,43904,364735351,0,7,0,512,40,7934917471
5806,364706276,47288,364753564,0,7,0,1536,40,3133086715
5807,364708597,146528,364855125,0,5,0,135680,20,7835262603
5808,364791642,57752,364849394,0,6,0,5632,14,2888476125
5809,364916663,47288,364963951,0,7,0,1536,40,7400846313
5810,365038614,181328,365219942,0,8,0,154112,21,1595064420
5811,365042445,1994,365044439,0,6,1,2048,14,10550849789
5812,365077663,83468,365161131,0,0,0,19456,29,4186958991
5813,365106040,145145,365251185,0,0,0,87040,29,3799452826
5814,365119129,55748,365174877,0,7,0,4096,40,1495126764
5815,365136839,200420,365337259,0,2,0,196608,14,87705264
5816,365168566,105872,365274438,0,6,0,47616,14,9528809268
5817,365273298,43904,365317202,0,7,0,512,40,4612406826
5818,365287002,6278,365293280,0,6,1,6656,14,9992323768
5819,365376357,114452,365490809,0,2,0,75776,14,10497827968
5820,365406098,256809,365662907,0,2,0,246272,14,2649806665
5821,365407668,5326,365412994,0,6,1,5632,14,6076014830
5822,365413410,107744,365521154,0,5,0,53760,20,6829330004
5823,365425254,187340,365612594,0,6,0,158720,14,9475262077
5824,365431487,146361,365577848,0,5,0,82432,20,2191370192
5825,365510400,155432,365665832,0,6,0,105472,14,4696895709
5826,365529359,197768,365727127,0,0,0,187904,29,8639158044
5827,365555390,230046,365785436,0,5,0,220160,20,7270316485
5828,365568458,50099,365618557,0,6,1,14848,14,892742125
5829,365583789,235616,365819405,0,8,0,266752,21,10260410378
5830,365600532,55748,365656280,0,7,0,4096,40,2706211178
5831,365637941,2470,365640411,0,7,1,2560,40,7064833499
5832,365701234,4420,365705654,0,5,1,11776,20,1072029701
5833,365815478,11791,365827269,0,7,1,19456,40,6556943673
5834,365864723,113828,365978551,0,0,0,73728,29,9571815801
5835,366013004,566,366013570,0,7,1,512,40,3185157645
5836,366264276,56216,366320492,0,7,0,5632,40,9622623513
5837,366336483,47288,366383771,0,7,0,1536,40,3027851305
5838,366383303,197768,366581071,0,5,0,187904,20,5324147083
5839,366421161,105716,366526877,0,0,0,47104,29,2504748345
5840,366577169,67592,366644761,0,8,0,7680,21,4639912719
5841,366941239,117572,367058811,0,2,0,86016,14,7685335938
5842,367502870,47288,367550158,0,7,0,1536,40,6593543001
5843,367708821,198704,367907525,0,6,0,190976,14,9357266227
5844,367748917,210224,367959141,0,2,0,223744,14,8816544572
5845,367755189,101816,367857005,0,8,0,34304,21,3162950911
5846,367779866,219565,367999431,0,2,0,128000,14,5390171297
5847,367813406,233371,368046777,0,2,0,30208,14,10707138612
5848,367876181,126385,368002566,0,2,0,10240,14,10377555757
5849,367930567,99788,368030355,0,0,0,27648,29,8986522670
5850,368017825,52364,368070189,0,7,0,3072,40,8085276149
5851,368185758,136376,368322134,0,6,0,132608,14,4106573870
5852,368262120,69284,368331404,0,2,0,8192,14,4023317472
5853,368283560,143034,368426594,0,6,0,43008,14,6816619771
5854,368370234,57440,368427674,0,8,0,4608,21,6913373876
5855,368696800,55748,368752548,0,7,0,4096,40,6998237800
5856,368732852,100568,368833420,0,5,0,30208,20,10666426197
5857,369005920,24242,369030162,0,2,1,40448,14,10517412509
5858,369108748,2946,369111694,0,9,1,3072,45,4454558231
5859,369187044,93488,369280532,0,2,0,27136,14,4349023618
5860,369254844,284048,369538892,0,2,0,309760,14,6531437238
5861,369375639,209780,369585419,0,0,0,227328,29,9355419015
5862,369425620,163246,369588866,0,0,0,11264,29,1124851075
5863,369443360,566,369443926,0,0,1,512,29,10432618939
5864,369559930,45596,369605526,0,7,0,1024,40,9003388214
5865,369616359,5802,369622161,0,3,1,6144,37,5679998148
5866,369634521,199640,369834161,0,6,0,194048,14,5248915575
5867,369733626,170627,369904253,0,6,0,124416,14,5057384165
5868,369798360,170057,369968417,0,6,0,35328,14,192203527
5869,369847729,1518,369849247,0,3,1,1536,37,2670318033
5870,369958018,96068,370054086,0,0,0,20480,29,4371404629
5871,370039379,54056,370093435,0,7,0,3584,40,2757074310
5872,370127943,7230,370135173,0,8,1,7680,21,1527281769
5873,370378267,187784,370566051,0,6,0,155136,14,2400885756
5874,370481811,16613,370498424,0,0,1,32256,29,1586648805
5875,370598660,3904,370602564,0,0,1,10752,29,9330746396
5876,370608259,5802,370614061,0,0,1,6144,29,8057001871
5877,370617579,44060,370661639,0,7,0,1024,40,5433749501
5878,370659607,122096,370781703,0,0,0,100864,29,3635006029
5879,370785098,106028,370891126,0,8,0,48128,21,2087979261
5880,370885399,102440,370987839,0,2,0,36352,14,3713972187
5881,370965141,106964,371072105,0,0,0,51200,29,3959875998
5882,371078958,104936,371183894,0,2,0,44544,14,4643590711
5883,371090031,180017,371270048,0,2,0,99328,14,5474822739
5884,371172782,48980,371221762,0,7,0,2048,40,8606450101
5885,371330793,1042,371331835,0,0,1,1024,29,9725611048
5886,371341360,6488,371347848,0,2,1,15872,14,7541308740
5887,371392579,10499,371403078,0,2,1,16896,14,2862108681
5888,371433247,120380,371553627,0,8,0,95232,21,1503169770
5889,371455828,13083,371468911,0,2,1,22016,14,125753653
5890,371459280,218672,371677952,0,0,0,256512,29,4767025303
5891,371481650,10757,371492407,0,0,1,17408,29,6745985351
5892,371545182,45596,371590778,0,7,0,1024,40,761011919
5893,371552251,120536,371672787,0,6,0,95744,14,3190395266
5894,371590151,147586,371737737,0,0,0,40960,29,1747524884
5895,371612315,16613,371628928,0,4,1,32256,12,7932173519
5896,371642513,3904,371646417,0,4,1,10752,12,6141929132
5897,371710880,10499,371721379,0,6,1,16896,14,7753468486
5898,371755336,294160,372049496,0,6,0,103424,14,604699513
5899,371757038,260931,372017969,0,6,0,245760,14,2545159119
5900,371782590,120380,371902970,0,8,0,95232,21,4047623674
5901,371989555,160033,372149588,0,6,0,28672,14,3069083888
5902,372059856,102752,372162608,0,6,0,37376,14,7446741124
5903,372063359,50672,372114031,0,2,0,2560,14,8860569094
5904,372265265,136376,372401641,0,2,0,132608,14,3093410964
5905,372292969,245382,372538351,0,2,0,192000,14,4295186525
5906,372433395,4374,372437769,0,2,1,4608,14,6632824953
5907,372437331,5454,372442785,0,2,1,13824,14,10042821314
5908,372639916,5712,372645628,0,9,1,14336,45,4572372348
5909,372710718,106028,372816746,0,0,0,48128,29,2998651005
5910,372798773,4679,372803452,0,3,1,12288,37,6837432167
5911,372812441,4374,372816815,0,3,1,4608,37,3053779074
5912,372827087,6754,372833841,0,0,1,7168,29,1133345377
5913,372914647,4850,372919497,0,9,1,5120,45,3317511986
5914,372962986,4937,372967923,0,9,1,12800,45,4183689959
5915,373084628,15579,373100207,0,2,1,30208,14,9918071267
5916,373161374,4420,373165794,0,0,1,11776,29,2261407150
5917,373207822,12737,373220559,0,6,1,24576,14,1411199150
5918,373303520,52364,373355884,0,7,0,3072,40,9654709922
5919,373318779,3128,373321907,0,0,1,9216,29,7846109252
5920,373320769,124436,373445205,0,6,0,108544,14,5850415382
5921,373448699,16613,373465312,0,6,1,32256,14,8408147364
5922,373455327,1518,373456845,0,9,1,1536,45,2038557176
5923,373706497,6488,373712985,0,2,1,15872,14,10332787742
5924,373742217,266863,374009080,0,2,0,130048,14,8806895244
5925,373755914,12308,373768222,0,0,1,20480,29,10532782638
5926,373816397,120827,373937224,0,2,0,5120,14,9724622678
5927,373925333,1042,373926375,0,6,1,1024,14,7684531022
5928,373967518,3422,373970940,0,9,1,3584,45,1474348234
5929,374041271,13600,374054871,0,9,1,23040,45,4682547717
5930,374097829,5326,374103155,0,0,1,5632,29,4198450438
5931,374157227,13253,374170480,0,9,1,25600,45,8077913106
5932,374180895,5802,374186697,0,0,1,6144,29,2425389049
5933,374250674,214460,374465134,0,2,0,242688,14,8057255269
5934,374261635,14029,374275664,0,6,1,27136,14,1700540869
5935,374326477,45752,374372229,0,7,0,1536,40,9180404411
5936,374408060,257798,374665858,0,2,0,197632,14,7807530798
5937,374460516,3128,374463644,0,0,1,9216,29,1699254578
5938,374495371,47288,374542659,0,7,0,1536,40,6186993825
5939,374690717,169616,374860333,0,2,0,145920,14,8826393766
5940,374715063,67772,374782835,0,0,0,13312,29,8533698128
5941,374802209,45596,374847805,0,7,0,1024,40,4560652995
5942,374851621,5802,374857423,0,0,1,6144,29,5571052948
5943,374893913,1042,374894955,0,2,1,1024,14,2867745576
5944,374911741,14804,374926545,0,0,1,28672,29,644629845
5945,374928639,103064,375031703,0,8,0,38400,21,7480450085
5946,374949725,4374,374954099,0,0,1,4608,29,4685546354
5947,374996241,15837,375012078,0,6,1,30720,14,1854082771
5948,375007109,3128,375010237,0,0,1,9216,29,114309041
5949,375053021,22174,375075195,0,2,1,36352,14,6314108073
5950,375055814,52364,375108178,0,7,0,3072,40,9205347654
5951,375068617,21141,375089758,0,9,1,34304,45,6312276702
5952,375070563,33503,375104066,0,2,1,58368,14,7889654478
5953,375114391,12995,375127386,0,6,1,25088,14,1738043942
5954,375120756,566,375121322,0,0,1,512,29,2300722125
5955,375210963,48980,375259943,0,7,0,2048,40,1117363661
5956,375265657,13253,375278910,0,0,1,25600,29,1447623983
5957,375375084,3898,375378982,0,9,1,4096,45,1684483184
5958,375485242,4850,375490092,0,6,1,5120,14,1249497247
5959,375514282,5326,375519608,0,0,1,5632,29,3286895566
5960,375618904,286856,375905760,0,6,0,318976,14,5895006311
5961,375713692,100724,375814416,0,2,0,30720,14,9457399408
5962,375724034,14117,375738151,0,6,1,24064,14,1529729738
5963,375771309,76364,375847673,0,0,0,11264,29,5313066876
5964,375926060,52520,375978580,0,7,0,3584,40,9639048251
5965,376017402,196208,376213610,0,8,0,182784,21,4037676792
5966,376104453,118508,376222961,0,0,0,89088,29,2612699452
5967,376113149,119132,376232281,0,2,0,91136,14,4505090629
5968,376189283,205766,376395049,0,2,0,164352,14,4187626313
5969,376217559,288662,376506221,0,0,0,307200,29,8333867339
5970,376224614,294258,376518872,0,0,0,41472,29,10576419517
5971,376279745,71249,376350994,0,6,1,115200,14,6631949443
5972,376304197,98511,376402708,0,2,0,25088,14,4823222815
5973,376305455,105560,376411015,0,8,0,46592,21,3196690192
5974,376308039,10757,376318796,0,9,1,17408,45,4217595385
5975,376341849,444476,376786325,0,0,0,442880,29,2345765790
5976,376361896,15062,376376958,0,9,1,29184,45,3821921016
5977,376435295,1518,376436813,0,9,1,1536,45,2071737674
5978,376566691,64208,376630899,0,7,0,6656,40,2863295717
5979,376688878,11791,376700669,0,9,1,19456,45,437192994
5980,376707037,24670,376731707,0,7,1,44544,40,7826069357
5981,376755624,171946,376927570,0,7,0,4608,40,5511454348
5982,376976601,7230,376983831,0,9,1,7680,45,4953456238
5983,377096601,102752,377199353,0,2,0,37376,14,9690844837
5984,377174026,5326,377179352,0,7,1,5632,40,8590135678
5985,377218326,106652,377324978,0,2,0,50176,14,8030303248
5986,377257660,62072,377319732,0,8,0,9728,21,2951865588
5987,377280460,106184,377386644,0,0,0,48640,29,1168406523
5988,377408977,124124,377533101,0,8,0,107520,21,481171856
5989,377479347,12825,377492172,0,9,1,21504,45,6762823968
5990,377533243,81752,377614995,0,6,0,13824,14,9374127109
5991,377563208,54680,377617888,0,7,0,5632,40,4092847258
5992,377571605,11274,377582879,0,6,1,18432,14,6784211123
5993,377598631,120536,377719167,0,6,0,95744,14,8202517751
5994,377607634,333713,377941347,0,6,0,340992,14,9305187837
5995,377612913,367457,377980370,0,6,0,128000,14,5346060367
5996,377660123,55748,377715871,0,7,0,4096,40,9057968098
5997,377751806,3898,377755704,0,0,1,4096,29,4748589085
5998,377796919,154756,377951675,0,0,0,27648,29,5081512998
5999,377826441,59912,377886353,0,7,0,7680,40,8142989367
6000,377828277,3898,377832175,0,7,1,4096,40,8767628470
6001,377872106,111376,377983482,0,6,1,9216,14,9970810744
6002,377940423,48065,377988488,0,6,1,5632,14,2394651475
6003,378074586,3387,378077973,0,9,1,9728,45,2813520380
6004,378091960,179612,378271572,0,0,0,148480,29,7109147585
6005,378104860,69464,378174324,0,8,0,13824,21,9802443917
6006,378110960,4420,378115380,0,6,1,11776,14,9374416142
6007,378129462,6229,378135691,0,4,1,15360,12,3496416792
6008,378194879,200767,378395646,0,0,0,166400,29,4895281314
6009,378196900,3904,378200804,0,6,1,10752,14,1619797488
6010,378197032,118352,378315384,0,8,0,88576,21,3765422062
6011,378245555,5454,378251009,0,9,1,13824,45,898189105
6012,378400465,566,378401031,0,6,1,512,14,8563656852
6013,378425367,283580,378708947,0,2,0,308224,14,4539151449
6014,378442360,108056,378550416,0,8,0,54784,21,7299726190
6015,378484828,357368,378842196,0,6,0,419328,14,716412646
6016,378498460,5326,378503786,0,9,1,5632,45,7307413834
6017,378525535,366612,378892147,0,6,0,163840,14,1664447983
6018,378554041,4679,378558720,0,9,1,12288,45,1647968347
6019,378608925,136697,378745622,0,2,0,120320,14,8031659029
6020,378656033,100412,378756445,0,0,0,29696,29,59263670
6021,378683802,128737,378812539,0,0,0,61440,29,5128910935
6022,378754583,151293,378905876,0,6,1,26624,14,3231776391
6023,378806836,45596,378852432,0,7,0,1024,40,7913158503
6024,378817227,89008,378906235,0,6,1,9728,14,3290347601
6025,378915321,98072,379013393,0,6,0,22016,14,8267264596
6026,378970782,5802,378976584,0,7,1,6144,40,5297966580
6027,378988755,217268,379206023,0,0,0,251904,29,9572160549
6028,378992122,2870,378994992,0,6,1,8704,14,2884379721
6029,379072806,22950,379095756,0,7,1,37888,40,2053394214
6030,379084801,285764,379370565,0,8,0,315392,21,10509906854
6031,379090156,127363,379217519,0,0,0,35328,29,1190724040
6032,379221330,113048,379334378,0,0,0,71168,29,7383339390
6033,379256594,2870,379259464,0,9,1,8704,45,483396503
6034,379372269,48980,379421249,0,7,0,2048,40,730030328
6035,379398530,80216,379478746,0,2,0,13824,14,7771829784
6036,379421322,3422,379424744,0,9,1,3584,45,9330509463
6037,379468286,114872,379583158,0,2,0,56832,14,4607335392
6038,379513709,4420,379518129,0,6,1,11776,14,6322443681
6039,379591879,4162,379596041,0,7,1,11264,40,2352003894
6040,379710661,31007,379741668,0,0,1,50176,29,6930795902
6041,379756221,4374,379760595,0,7,1,4608,40,1028464435
6042,379782588,329780,380112368,0,8,0,399360,21,2953789760
6043,379840461,2470,379842931,0,6,1,2560,14,8022053519
6044,379857364,415888,380273252,0,8,0,365568,21,8613366076
6045,379863873,43904,379907777,0,7,0,512,40,5990233132
6046,379870199,5971,379876170,0,7,1,14848,40,837673430
6047,379870269,69152,379939421,0,2,0,12800,14,6717789582
6048,380078035,52364,380130399,0,7,0,3072,40,5720316778
6049,380093799,64208,380158007,0,2,0,6656,14,3410732769
6050,380283218,51296,380334514,0,8,0,4608,21,2094619131
6051,380470423,42683,380513106,0,6,1,69632,14,10435956875
6052,380579402,3422,380582824,0,6,1,3584,14,4046328089
6053,380583373,113204,380696577,0,2,0,71680,14,6017095889
6054,380620462,125996,380746458,0,8,0,113664,21,2874007355
6055,380650774,52520,380703294,0,7,0,3584,40,3112338494
6056,380747762,111176,380858938,0,2,0,65024,14,6546815786
6057,380765471,12825,380778296,0,6,1,21504,14,5905360438
6058,380860810,5971,380866781,0,6,1,14848,14,3110868690
6059,380890880,120685,381011565,0,6,0,29696,14,7918198732
6060,380903264,45596,380948860,0,7,0,1024,40,1510049448
6061,380920325,118196,381038521,0,8,0,88064,21,2332083516
6062,381033896,45596,381079492,0,7,0,1024,40,771696519
6063,381199840,51452,381251292,0,7,0,5120,40,7662252856
6064,381246984,84560,381331544,0,6,0,23040,14,7480770023
6065,381249988,76520,381326508,0,8,0,11776,21,10377550968
6066,381404122,6229,381410351,0,6,1,15360,14,2155592973
6067,381426472,12737,381439209,0,6,1,24576,14,4154018817
6068,381453771,48980,381502751,0,7,0,2048,40,8224476701
6069,381504365,163563,381667928,0,6,0,13312,14,2283097858
6070,381524273,101660,381625933,0,2,0,33792,14,231834464
6071,381557826,118976,381676802,0,8,0,90624,21,3387446046
6072,381584790,566,381585356,0,7,1,512,40,6989252183
6073,381716197,43904,381760101,0,7,0,512,40,5621738082
6074,381741338,220232,381961570,0,2,0,261632,14,1173913636
6075,381786023,110240,381896263,0,6,0,61952,14,1755761686
6076,381869924,209000,382078924,0,6,0,224768,14,5474233391
6077,382199424,2870,382202294,0,1,1,8704,18,1999159820
6078,382208085,43904,382251989,0,7,0,512,40,6812957674
6079,382231888,1518,382233406,0,4,1,1536,12,7609367734
6080,382306350,22950,382329300,0,6,1,37888,14,2594001565
6081,382311624,88256,382399880,0,2,0,25088,14,8106108324
6082,382360326,104000,382464326,0,8,0,41472,21,8765981267
6083,382363729,246106,382609835,0,6,0,196096,14,10432349910
6084,382406591,3387,382409978,0,4,1,9728,12,3090438839
6085,382413015,10499,382423514,0,4,1,16896,12,2315250501
6086,382433090,566,382433656,0,6,1,512,14,6203424633
6087,382435925,6278,382442203,0,4,1,6656,12,3364169386
6088,382447852,105560,382553412,0,2,0,46592,14,4947654957
6089,382536289,260781,382797070,0,6,0,273408,14,8353066643
6090,382561042,79436,382640478,0,8,0,11264,21,3184695625
6091,382562203,4162,382566365,0,7,1,11264,40,4171195214
6092,382563760,22950,382586710,0,4,1,37888,12,10540102740
6093,382579173,7230,382586403,0,7,1,7680,40,7175069936
6094,382608704,85968,382694672,0,7,0,8704,40,610243555
6095,382719007,100412,382819419,0,8,0,29696,21,8558066956
6096,382737999,4850,382742849,0,4,1,5120,12,6887364730
6097,382830802,11016,382841818,0,4,1,17920,12,10449982272
6098,382893441,24670,382918111,0,4,1,44544,12,8282657099
6099,382910880,186116,383096996,0,1,0,159744,18,7323187999
6100,382972726,177664,383150390,0,1,0,107008,18,4346181606
6101,382984914,43904,383028818,0,7,0,512,40,2025589217
6102,383049612,110954,383160566,0,1,0,2048,18,3175935667
6103,383128280,120068,383248348,0,6,0,94208,14,963000729
6104,383223249,139855,383363104,0,6,0,76800,14,10072566475
6105,383288720,3387,383292107,0,6,1,9728,14,278219867
6106,383494084,98384,383592468,0,8,0,23040,21,4981607445
6107,383605486,7230,383612716,0,7,1,7680,40,2225511427
6108,383610831,45596,383656427,0,7,0,1024,40,4080217580
6109,383657076,33850,383690926,0,6,1,55808,14,1261985100
6110,383688616,14029,383702645,0,6,1,27136,14,8063375631
6111,383891977,3645,383895622,0,5,1,10240,20,7887771547
6112,383913403,14117,383927520,0,8,1,24064,21,9948366336
6113,383960059,45596,384005655,0,7,0,1024,40,1617685805
6114,384178210,116948,384295158,0,8,0,83968,21,10288950050
6115,384183990,278588,384462578,0,2,0,291840,14,10100299755
6116,384200407,123500,384323907,0,6,0,105472,14,7034419638
6117,384209059,185558,384394617,0,6,0,109568,14,715909863
6118,384280112,566,384280678,0,6,1,512,14,1631933669
6119,384350424,22174,384372598,0,7,1,36352,40,1441493378
6120,384384402,6278,384390680,0,7,1,6656,40,1366315142
6121,384409082,5196,384414278,0,5,1,13312,20,7114258084
6122,384452836,16222,384469058,0,2,1,15872,14,6522713385
6123,384454344,5802,384460146,0,7,1,6144,40,4241468776
6124,384480607,11533,384492140,0,7,1,18944,40,5116739263
6125,384511811,198236,384710047,0,6,0,189440,14,229576890
6126,384524164,43904,384568068,0,8,0,512,21,2709861853
6127,384560753,1042,384561795,0,7,1,1024,40,6539054031
6128,384570984,47288,384618272,0,7,0,1536,40,1661225112
6129,384597983,1042,384599025,0,6,1,1024,14,10331129227
6130,384852641,210560,385063201,0,8,0,229888,21,6821587436
6131,384854934,219046,385073980,0,8,0,35328,21,6313481303
6132,384927190,45596,384972786,0,7,0,1024,40,7494772376
6133,384976377,43904,385020281,0,7,0,512,40,4046025184
6134,385049899,153296,385203195,0,6,0,137728,14,3904823842
6135,385155580,60824,385216404,0,8,0,5632,21,4668730188
6136,385192975,44404,385237379,0,5,1,76288,20,148400498
6137,385295421,48980,385344401,0,7,0,2048,40,1117355836
6138,385381197,15062,385396259,0,5,1,29184,20,6511238414
6139,385429018,122252,385551270,0,6,0,101376,14,1000077152
6140,385480510,106496,385587006,0,8,0,49664,21,8258462926
6141,385509037,12308,385521345,0,2,1,20480,14,8794208048
6142,385548678,7706,385556384,0,0,1,8192,29,1014395401
6143,385645560,54992,385700552,0,1,0,6656,18,5663081816
6144,385661157,4850,385666007,0,0,1,5120,29,5112616758
6145,385815554,121940,385937494,0,6,0,100352,14,10506293973
6146,385974309,2946,385977255,0,5,1,3072,20,3371320008
6147,385984975,113672,386098647,0,8,0,73216,21,7600058366
6148,386027983,73019,386101002,0,8,0,7680,21,3350157020
6149,386062225,319190,386381415,0,8,0,384000,21,9145770471
6150,386314180,566,386314746,0,5,1,512,20,5860469477
6151,386326839,1994,386328833,0,2,1,2048,14,9408946829
6152,386328097,100542,386428639,0,2,0,27136,14,10167780277
6153,386408966,98384,386507350,0,1,0,23040,18,9430150748
6154,386418382,102440,386520822,0,8,0,36352,21,309938842
6155,386435731,12825,386448556,0,2,1,21504,14,5400240797
6156,386458572,13512,386472084,0,2,1,26112,14,8791713695
6157,386735410,2870,386738280,0,2,1,8704,14,7467577484
6158,386781264,104936,386886200,0,6,0,44544,14,7618681923
6159,386899998,48980,386948978,0,1,0,2048,18,4997228242
6160,386975501,65924,387041425,0,6,0,12288,14,448627283
6161,386977080,3422,386980502,0,2,1,3584,14,688928035
6162,387026968,104000,387130968,0,6,0,41472,14,1297550920
6163,387034982,60980,387095962,0,2,0,6144,14,2157988318
6164,387038462,44404,387082866,0,2,1,76288,14,1404214864
6165,387193515,25962,387219477,0,3,1,47104,37,8548948099
6166,387223583,182576,387406159,0,2,0,158208,14,9191370243
6167,387233503,200907,387434410,0,2,0,92672,14,3366597189
6168,387263391,43904,387307295,0,7,0,512,40,6112112602
6169,387318714,217268,387535982,0,6,0,251904,14,1793305937
6170,387325662,6229,387331891,0,2,1,15360,14,1832254497
6171,387331199,107744,387438943,0,5,0,53760,20,6819151985
6172,387363964,1994,387365958,0,7,1,2048,40,7759446573
6173,387439306,566,387439872,0,0,1,512,29,3910370388
6174,387475837,106496,387582333,0,8,0,49664,21,7580988995
6175,387487179,14545,387501724,0,7,1,28160,40,1905199937
6176,387510424,15321,387525745,0,3,1,29696,37,9375725785
6177,387532124,45596,387577720,0,7,0,1024,40,4388021966
6178,387586516,7230,387593746,0,5,1,7680,20,2441613157
6179,387592683,112736,387705419,0,5,0,70144,20,3774390708
6180,387602767,4374,387607141,0,7,1,4608,40,9857466384
6181,387625366,238947,387864313,0,5,0,199168,20,49961332
6182,387651232,20366,387671598,0,7,1,32768,40,5533266152
6183,387683225,4850,387688075,0,2,1,5120,14,4360024607
6184,387704488,17536,387722024,0,5,1,32256,20,5510911415
6185,387714519,32035,387746554,0,5,1,50688,20,8918063534
6186,387732317,263624,387995941,0,1,0,278016,18,1608136327
6187,387740429,4850,387745279,0,7,1,5120,40,4961373241
6188,387796097,360572,388156669,0,1,0,309248,18,9323428350
6189,387934932,5802,387940734,0,7,1,6144,40,6180468047
6190,387960586,12995,387973581,0,3,1,25088,37,9384958242
6191,387982713,146528,388129241,0,2,0,135680,14,3195716362
6192,387989134,32816,388021950,0,5,1,53760,20,678657616
6193,388004474,566,388005040,0,9,1,512,45,3259681576
6194,388006409,48980,388055389,0,7,0,2048,40,4374845899
6195,388015024,57440,388072464,0,7,0,4608,40,7171878956
6196,388046405,16354,388062759,0,0,1,31744,29,6431051597
6197,388112191,2946,388115137,0,3,1,3072,37,9659378176
6198,388157364,34367,388191731,0,7,1,56832,40,5647946091
6199,388174794,47288,388222082,0,7,0,1536,40,2429345832
6200,388226805,12049,388238854,0,9,1,19968,45,7038485556
6201,388234042,57601,388291643,0,7,0,1024,40,4588150294
6202,388345612,295436,388641048,0,5,0,347136,20,5933365949
6203,388354938,3387,388358325,0,5,1,9728,20,4817386478
6204,388360666,3128,388363794,0,5,1,9216,20,9718689490
6205,388369134,121784,388490918,0,1,0,99840,18,1000413534
6206,388387334,101192,388488526,0,6,0,32256,14,10047985155
6207,388423830,40616,388464446,0,3,1,65536,37,38555749
6208,388425980,49398,388475378,0,3,1,44032,37,5012989296
6209,388437610,15837,388453447,0,7,1,30720,40,4953128315
6210,388444646,121940,388566586,0,2,0,100352,14,4145838327
6211,388460545,24412,388484957,0,5,1,44032,20,501321823
6212,388536211,43904,388580115,0,7,0,512,40,1663101106
6213,388561512,111956,388673468,0,8,0,67584,21,4847468633
6214,388610785,1994,388612779,0,0,1,2048,29,8665827815
6215,388665001,118231,388783232,0,8,0,60416,21,10000573887
6216,388675105,5454,388680559,0,5,1,13824,20,10108017790
6217,388702700,23466,388726166,0,2,1,38912,14,6044629825
6218,388707852,6754,388714606,0,5,1,7168,20,6824378443
6219,388847628,301676,389149304,0,8,0,367616,21,6898760752
6220,388879266,203384,389082650,0,1,0,206336,18,3503179555
6221,388899749,2870,388902619,0,2,1,8704,14,2897750088
6222,388932437,130520,389062957,0,6,0,128512,14,3102710755
6223,388994540,201668,389196208,0,2,0,200704,14,4960842486
6224,389029955,31266,389061221,0,9,1,50688,45,9545410426
6225,389117277,2870,389120147,0,2,1,8704,14,7429740220
6226,389118871,12995,389131866,0,0,1,25088,29,2754882799
6227,389144971,15321,389160292,0,0,1,29696,29,9645422937
6228,389207028,5712,389212740,0,5,1,14336,20,4682931019
6229,389253798,14029,389267827,0,3,1,27136,37,9504155461
6230,389311871,101972,389413843,0,6,0,34816,14,1078051014
6231,389372575,4850,389377425,0,3,1,5120,37,6171812378
6232,389509907,6229,389516136,0,3,1,15360,37,5643514128
6233,389591455,122408,389713863,0,6,0,101888,14,2669522703
6234,389714537,21141,389735678,0,9,1,34304,45,5627644384
6235,389798009,15321,389813330,0,5,1,29696,20,1475208578
6236,389815789,3645,389819434,0,3,1,10240,37,10523596902
6237,389825443,7706,389833149,0,3,1,8192,37,1779124329
6238,389828573,199640,390028213,0,5,0,194048,20,6221335983
6239,389829689,4024,389833713,0,3,1,10752,37,5718936099
6240,389918751,193556,390112307,0,6,0,174080,14,7747258715
6241,389945398,197235,390142633,0,5,0,143872,20,5631704576
6242,389999701,34992,390034693,0,5,1,15872,20,7184540750
6243,390033900,4679,390038579,0,1,1,12288,18,6122247702
6244,390041251,293252,390334503,0,8,0,339968,21,4100827498
6245,390089729,566,390090295,0,5,1,512,20,905332348
6246,390163527,100568,390264095,0,2,0,30208,14,6938695378
6247,390384447,20882,390405329,0,4,1,33792,12,2593093002
6248,390390935,114296,390505231,0,1,0,75264,18,4971791258
6249,390493921,7230,390501151,0,5,1,7680,20,547166390
6250,390633116,213212,390846328,0,6,0,238592,14,5422645087
6251,390759653,102284,390861937,0,2,0,35840,14,7014435301
6252,390762348,305732,391068080,0,1,0,380928,18,4416545519
6253,390763560,86839,390850399,0,6,0,13312,14,1254627609
6254,390809202,63140,390872342,0,8,0,8192,21,2569752827
6255,390875874,239408,391115282,0,6,0,126464,14,2074723803
6256,390887082,306839,391193921,0,6,0,258048,14,5752412014
6257,390955623,181304,391136927,0,2,0,148992,14,6351499191
6258,391056552,13083,391069635,0,9,1,22016,45,4273618401
6259,391091471,54358,391145829,0,9,1,89088,45,1554067245
6260,391099376,191996,391291372,0,8,0,168960,21,8907904409
6261,391191472,99632,391291104,0,2,0,27136,14,5635721421
6262,391225853,168877,391394730,0,2,0,139264,14,1717186969
6263,391262897,179468,391442365,0,2,0,75776,14,4997575729
6264,391292067,109616,391401683,0,6,0,59904,14,9095436277
6265,391296052,100100,391396152,0,8,0,28672,21,3743776570
6266,391354301,195896,391550197,0,6,0,181760,14,1346882891
6267,391434969,25187,391460156,0,9,1,45568,45,4438528228
6268,391437877,25505,391463382,0,9,1,5120,45,4063489312
6269,391505130,3904,391509034,0,1,1,10752,18,5364466680
6270,391542482,196297,391738779,0,1,0,51200,18,4336498626
6271,391542837,10241,391553078,0,9,1,16384,45,5422980009
6272,391589003,3128,391592131,0,9,1,9216,45,8523975737
6273,391606967,11791,391618758,0,9,1,19456,45,8818652779
6274,391626741,2870,391629611,0,9,1,8704,45,10342302473
6275,391729545,138030,391867575,0,1,0,122880,18,4020765918
6276,391821275,12737,391834012,0,9,1,24576,45,5726055088
6277,391856425,5196,391861621,0,9,1,13312,45,1247706175
6278,391895659,13341,391909000,0,9,1,22528,45,248428315
6279,391899489,41391,391940880,0,5,1,67072,20,9134810443
6280,392012549,293096,392305645,0,2,0,339456,14,327764953
6281,392034811,3128,392037939,0,5,1,9216,20,7565027801
6282,392133730,7230,392140960,0,4,1,7680,12,5836863263
6283,392147526,3387,392150913,0,9,1,9728,45,3914209433
6284,392190977,106340,392297317,0,1,0,49152,18,7552271625
6285,392207899,5802,392213701,0,0,1,6144,29,7823560123
6286,392259998,117260,392377258,0,6,0,84992,14,3225394628
6287,392317488,50672,392368160,0,7,0,2560,40,5170270968
6288,392351113,99476,392450589,0,2,0,26624,14,2031090013
6289,392369662,566,392370228,0,0,1,512,29,4110497338
6290,392395392,5326,392400718,0,4,1,5632,12,694250238
6291,392397252,1518,392398770,0,5,1,1536,20,8958367565
6292,392469437,213056,392682493,0,6,0,238080,14,10719796264
6293,392489406,3645,392493051,0,4,1,10240,12,7601806993
6294,392556681,47288,392603969,0,2,0,1536,14,7973428356
6295,392602582,5326,392607908,0,4,1,5632,12,4504152724
6296,392604014,119444,392723458,0,2,0,92160,14,2861128474
6297,392605986,109627,392715613,0,6,0,47104,14,4823573655
6298,392641523,422678,393064201,0,6,0,468992,14,292142563
6299,392671708,1994,392673702,0,0,1,2048,29,6521226671
6300,392675254,2870,392678124,0,5,1,8704,20,3452851994
6301,392684766,102284,392787050,0,1,0,35840,18,391106407
6302,392692478,4374,392696852,0,4,1,4608,12,9974940291
6303,392712194,6278,392718472,0,0,1,6656,29,8397591697
6304,392725157,172688,392897845,0,8,0,145920,21,10255855267
6305,392791666,101192,392892858,0,2,0,32256,14,8632339757
6306,392841531,6278,392847809,0,9,1,6656,45,3934841094
6307,392855251,7230,392862481,0,7,1,7680,40,3258452142
6308,392914652,2946,392917598,0,0,1,3072,29,3168826947
6309,392973929,15062,392988991,0,9,1,29184,45,3600319446
6310,393008131,12308,393020439,0,4,1,20480,12,10429092001
6311,393091075,4162,393095237,0,4,1,11264,12,2547744400
6312,393202267,104624,393306891,0,2,0,43520,14,3206626072
6313,393211484,5326,393216810,0,4,1,5632,12,9344003846
6314,393219757,5971,393225728,0,1,1,14848,18,2414561497
6315,393268051,43904,393311955,0,7,0,512,40,8315260257
6316,393301655,109616,393411271,0,1,0,59904,18,7237843865
6317,393326122,294032,393620154,0,8,0,342528,21,1933415742
6318,393485530,144311,393629841,0,8,0,31744,21,2120060021
6319,393516828,759626,394276454,0,2,0,997376,14,2638971312
6320,393521370,1518,393522888,0,4,1,1536,12,1288802104
6321,393529378,823687,394353065,0,2,0,251392,14,2416739057
6322,393607875,147486,393755361,0,8,0,112128,21,6141493595
6323,393637631,1994,393639625,0,0,1,2048,29,10642611212
6324,393761827,6754,393768581,0,0,1,7168,29,8781254739
6325,393862022,30749,393892771,0,1,1,49664,18,3558439787
6326,393933166,1518,393934684,0,0,1,1536,29,2476854989
6327,393980525,4420,393984945,0,5,1,11776,20,1555144601
6328,394069878,1518,394071396,0,1,1,1536,18,7074803407
6329,394080000,14804,394094804,0,9,1,28672,45,8737395672
6330,394091015,228556,394319571,0,1,0,173568,18,4112681286
6331,394093590,6278,394099868,0,0,1,6656,29,783186658
6332,394101213,239901,394341114,0,1,0,70656,18,8488028373
6333,394104672,7230,394111902,0,0,1,7680,29,5208347863
6334,394145575,307426,394453001,0,2,0,28160,14,8519908124
6335,394203052,13341,394216393,0,4,1,22528,12,9712742300
6336,394242631,112921,394355552,0,2,1,2560,14,5877497376
6337,394276689,42683,394319372,0,5,1,69632,20,7478626398
6338,394295892,51296,394347188,0,7,0,4608,40,1275067515
6339,394339348,121160,394460508,0,6,0,97792,14,3917086685
6340,394354065,64208,394418273,0,8,0,6656,21,2225059679
6341,394450409,45596,394496005,0,7,0,1024,40,2820087225
6342,394486386,6754,394493140,0,5,1,7168,20,9566077765
6343,394488079,13623,394501702,0,5,1,22016,20,8197144778
6344,394506191,216644,394722835,0,6,0,249856,14,401642819
6345,394514115,215599,394729714,0,6,0,22528,14,4222221314
6346,394518399,286204,394804603,0,6,0,82432,14,667193818
6347,394525042,6488,394531530,0,9,1,15872,45,10526820229
6348,394604889,1042,394605931,0,4,1,1024,12,4874339926
6349,394636934,566,394637500,0,9,1,512,45,9065913604
6350,394675556,7230,394682786,0,4,1,7680,12,2960566804
6351,394744339,23895,394768234,0,9,1,43008,45,5600589781
6352,394823313,1042,394824355,0,9,1,1024,45,105298000
6353,394869103,1042,394870145,0,4,1,1024,12,2309837956
6354,394967755,12737,394980492,0,5,1,24576,20,7404960350
6355,394993956,324704,395318660,0,6,0,397824,14,5365462636
6356,395009833,100568,395110401,0,8,0,30208,21,3538875635
6357,395046199,43904,395090103,0,7,0,512,40,9116184896
6358,395053084,1518,395054602,0,9,1,1536,45,2707681670
6359,395071138,277801,395348939,0,6,0,99328,14,6785515999
6360,395074931,5802,395080733,0,9,1,6144,45,9936665144
6361,395123005,5971,395128976,0,3,1,14848,37,4409501320
6362,395159403,2470,395161873,0,4,1,2560,12,3571469853
6363,395264371,45596,395309967,0,7,0,1024,40,10130025837
6364,395311275,4850,395316125,0,8,1,5120,21,3562561375
6365,395339046,10499,395349545,0,3,1,16896,37,6990696738
6366,395340422,51296,395391718,0,1,0,4608,18,7261011545
6367,395379374,12995,395392369,0,4,1,25088,12,1242697298
6368,395405010,136134,395541144,0,8,0,69632,21,7541560603
6369,395434783,2946,395437729,0,9,1,3072,45,467452824
6370,395438421,22691,395461112,0,4,1,37376,12,1923388977
6371,395491086,21399,395512485,0,3,1,34816,37,10527727700
6372,395525792,2946,395528738,0,1,1,3072,18,5723059743
6373,395529752,47288,395577040,0,7,0,1536,40,10639653801
6374,395593917,566,395594483,0,9,1,512,45,8729913596
6375,395609469,123656,395733125,0,8,0,105984,21,7886064924
6376,395655289,5712,395661001,0,1,1,14336,18,4044682667
6377,395825570,3128,395828698,0,9,1,9216,45,683741872
6378,395879435,5802,395885237,0,3,1,6144,37,1497246203
6379,396000565,10499,396011064,0,9,1,16896,45,10467553729
6380,396028850,11274,396040124,0,3,1,18432,37,9291567879
6381,396106145,127088,396233233,0,1,0,117248,18,3464401306
6382,396138894,12308,396151202,0,4,1,20480,12,7467842
6383,396141850,138201,396280051,0,1,0,37888,18,1204866375
6384,396157353,32558,396189911,0,3,1,53248,37,727511476
6385,396179580,207284,396386864,0,2,0,219136,14,3802344275
6386,396229969,60824,396290793,0,8,0,5632,21,9059475967
6387,396259175,3898,396263073,0,3,1,4096,37,2647884256
6388,396272702,1994,396274696,0,9,1,2048,45,1074792246
6389,396377446,43904,396421350,0,7,0,512,40,3241436977
6390,396443867,31783,396475650,0,9,1,51712,45,9421028375
6391,396508864,5326,396514190,0,3,1,5632,37,7380719580
6392,396523955,2470,396526425,0,4,1,2560,12,10567503297
6393,396535444,12566,396548010,0,1,1,20992,18,4748804701
6394,396661943,104312,396766255,0,8,0,42496,21,5090093067
6395,396731677,113048,396844725,0,8,0,71168,21,6250780412
6396,396803842,293252,397097094,0,2,0,339968,14,7584523708
6397,397031996,3904,397035900,0,8,1,10752,21,4634351161
6398,397104434,3904,397108338,0,6,1,10752,14,3033715037
6399,397266030,7706,397273736,0,8,1,8192,21,3261690103
6400,397334815,11274,397346089,0,9,1,18432,45,6542919369
6401,397358460,7706,397366166,0,8,1,8192,21,2765284798
6402,397431017,171152,397602169,0,1,0,145920,18,5633835928
6403,397432713,57440,397490153,0,7,0,4608,40,9375205404
6404,397533107,2470,397535577,0,1,1,2560,18,2630843536
6405,397540361,3898,397544259,0,5,1,4096,20,1389290332
6406,397581265,22414,397603679,0,1,1,1536,18,9620504395
6407,397608702,152852,397761554,0,8,0,141312,21,4552358866
6408,397654035,4374,397658409,0,1,1,4608,18,2612506487
6409,397669620,145466,397815086,0,8,0,77824,21,675337559
6410,397683641,22950,397706591,0,6,1,37888,14,5057990556
6411,397692453,14394,397706847,0,6,1,9216,14,7238573395
6412,397830791,21916,397852707,0,9,1,35840,45,8301454425
6413,397839023,10757,397849780,0,8,1,17408,21,7489097153
6414,397839727,107588,397947315,0,1,0,53248,18,10057688304
6415,397859228,15062,397874290,0,5,1,29184,20,8964761832
6416,397922305,3645,397925950,0,5,1,10240,20,5261613839
6417,397969517,2870,397972387,0,9,1,8704,45,7280930424
6418,398063014,5326,398068340,0,6,1,5632,14,928066596
6419,398137188,11016,398148204,0,5,1,17920,20,4042788511
6420,398145590,125840,398271430,0,2,0,113152,14,5363990481
6421,398168706,1994,398170700,0,5,1,2048,20,161420168
6422,398183517,276259,398459776,0,2,0,276480,14,5919833538
6423,398191374,64208,398255582,0,1,0,6656,18,6581316969
6424,398353192,369704,398722896,0,1,0,429568,18,8631014658
6425,398404211,361296,398765507,0,1,0,139776,18,68089905
6426,398512931,209000,398721931,0,8,0,224768,21,2521731300
6427,398558313,11016,398569329,0,9,1,17920,45,4699669565
6428,398573419,1994,398575413,0,6,1,2048,14,6496580752
6429,398636355,153057,398789412,0,1,0,9216,18,8439212440
6430,398660235,4937,398665172,0,5,1,12800,20,4836954493
6431,398690854,36871,398727725,0,8,1,6144,21,6044089225
6432,398749544,196832,398946376,0,2,0,184832,14,7291077861
6433,398882419,7230,398889649,0,8,1,7680,21,119782270
6434,398898519,238753,399137272,0,2,0,165376,14,3275981304
6435,398903416,295790,399199206,0,8,0,286208,21,5890862189
6436,398913104,4850,398917954,0,9,1,5120,45,10273432326
6437,398954228,11791,398966019,0,5,1,19456,20,7235796847
6438,398999337,55748,399055085,0,7,0,4096,40,853620933
6439,399034936,13083,399048019,0,5,1,22016,20,61697920
6440,399064513,57440,399121953,0,7,0,4608,40,7176713533
6441,399064878,257316,399322194,0,8,0,228864,21,6754116387
6442,399105431,186692,399292123,0,1,0,151552,18,8532899412
6443,399159948,114296,399274244,0,2,0,75264,14,8305382032
6444,399167891,126507,399294398,0,2,0,9216,14,7995821719
6445,399263643,5454,399269097,0,5,1,13824,20,1640486414
6446,399297792,2470,399300262,0,9,1,2560,45,7542995768
6447,399351781,58844,399410625,0,7,0,9216,40,6042748212
6448,399466434,11791,399478225,0,5,1,19456,20,9392661160
6449,399611521,5802,399617323,0,9,1,6144,45,8323607514
6450,399612796,3387,399616183,0,6,1,9728,14,6770112880
6451,399654728,230540,399885268,0,8,0,265216,21,6086803336
6452,399679964,295022,399974986,0,8,0,195584,21,8866888160
6453,399754914,128960,399883874,0,2,0,123392,14,10561989540
6454,399768839,4162,399773001,0,5,1,11264,20,6846497121
6455,399822099,5712,399827811,0,1,1,14336,18,6520792321
6456,399836592,6488,399843080,0,5,1,15872,20,9927267291
6457,399868895,2870,399871765,0,5,1,8704,20,1987703826
6458,399884041,5454,399889495,0,1,1,13824,18,10120748731
6459,399939476,45437,399984913,0,6,1,78336,14,7892216459
6460,399957029,13858,399970887,0,9,1,23552,45,8521787049
6461,400035429,10757,400046186,0,9,1,17408,45,3038403118
6462,400217323,207284,400424607,0,1,0,219136,18,9143354398
6463,400222382,2870,400225252,0,9,1,8704,45,8858929740
6464,400282675,2470,400285145,0,5,1,2560,20,5542202223
6465,400341566,5802,400347368,0,1,1,6144,18,4715888650
6466,400371563,45596,400417159,0,7,0,1024,40,7119266456
6467,400413497,43904,400457401,0,7,0,512,40,5744054184
6468,400488411,3422,400491833,0,1,1,3584,18,4267390010
6469,400520330,43904,400564234,0,7,0,512,40,1958421753
6470,400604622,5196,400609818,0,1,1,13312,18,3163257163
6471,400704533,59288,400763821,0,7,0,5632,40,4798158484
6472,400831523,1042,400832565,0,5,1,1024,20,4805932392
6473,400896831,2470,400899301,0,6,1,2560,14,4786317828
6474,400935201,5196,400940397,0,6,1,13312,14,6149872416
6475,401018677,120692,401139369,0,1,0,96256,18,10408954814
6476,401023425,228186,401251611,0,1,0,145920,18,7935968874
6477,401033313,6488,401039801,0,6,1,15872,14,8754135608
6478,401098378,43904,401142282,0,7,0,512,40,4430959329
6479,401163721,138476,401302197,0,1,0,83968,18,5454355685
6480,401174863,45596,401220459,0,7,0,1024,40,6863010151
6481,401249241,7706,401256947,0,9,1,8192,45,7603281219
6482,401275289,3128,401278417,0,5,1,9216,20,7198212383
6483,401301252,47288,401348540,0,7,0,1536,40,7847107454
6484,401303666,20366,401324032,0,1,1,32768,18,2751203787
6485,401311484,2470,401313954,0,9,1,2560,45,7351367914
6486,401329584,4850,401334434,0,0,1,5120,29,311697881
6487,401378076,33762,401411838,0,4,1,58880,12,10019198818
6488,401387978,67616,401455594,0,1,0,12800,18,10095195056
6489,401457187,10757,401467944,0,5,1,17408,20,8534270413
6490,401591333,181304,401772637,0,1,0,148992,18,2957063586
6491,401631772,32558,401664330,0,6,1,53248,14,5359061818
6492,401639561,77744,401717305,0,8,0,10752,21,5868821983
6493,401666662,6488,401673150,0,6,1,15872,14,1642928839
6494,401704997,4162,401709159,0,2,1,11264,14,5266362342
6495,401718653,57440,401776093,0,8,0,4608,21,7667113351
6496,401723484,1994,401725478,0,1,1,2048,18,3929716673
6497,401790543,6278,401796821,0,4,1,6656,12,4604480732
6498,401804892,1042,401805934,0,2,1,1024,14,8645004603
6499,401811900,43904,401855804,0,8,0,512,21,7223573171
6500,401870174,43904,401914078,0,7,0,512,40,2273840342
6501,401900846,78931,401979777,0,2,0,9216,14,2412070432
6502,401901688,23208,401924896,0,2,1,38400,14,3009474109
6503,401941847,130364,402072211,0,1,0,128000,18,341994471
6504,401985075,5196,401990271,0,6,1,13312,14,6760363499
6505,402000749,5196,402005945,0,4,1,13312,12,4678303515
6506,402124842,109148,402233990,0,4,0,58368,12,8683626989
6507,402184985,12308,402197293,0,2,1,20480,14,9427477476
6508,402230005,1042,402231047,0,8,1,1024,21,10283340876
6509,402236210,21658,402257868,0,8,1,35328,21,4097218051
6510,402362917,62516,402425433,0,8,0,6144,21,3749833777
6511,402382824,386864,402769688,0,1,0,485888,18,4225040411
6512,402412688,380415,402793103,0,1,0,76800,18,770656405
6513,402423395,50672,402474067,0,8,0,2560,21,9028321826
6514,402471267,6278,402477545,0,0,1,6656,29,2166038225
6515,402471457,4374,402475831,0,8,1,4608,21,4126133907
6516,402522398,31266,402553664,0,5,1,50688,20,4651974
6517,402532401,320161,402852562,0,1,0,195072,18,10499800076
6518,402545881,5454,402551335,0,3,1,13824,37,3681965360
6519,402592853,566,402593419,0,8,1,512,21,2294854133
6520,402643838,5802,402649640,0,6,1,6144,14,279311354
6521,402648515,12566,402661081,0,8,1,20992,21,1805975796
6522,402685403,4850,402690253,0,5,1,5120,20,6918361528
6523,402703691,284364,402988055,0,1,0,178688,18,5773582711
6524,402734138,3645,402737783,0,8,1,10240,21,2969356968
6525,403006155,22950,403029105,0,3,1,37888,37,8246182943
6526,403031877,14117,403045994,0,6,1,24064,14,10583001945
6527,403111055,5802,403116857,0,8,1,6144,21,9232452589
6528,403116285,4850,403121135,0,4,1,5120,12,4313417327
6529,403119926,99944,403219870,0,2,0,28160,14,2568821490
6530,403186225,113984,403300209,0,0,0,74240,29,4099975002
6531,403204524,4420,403208944,0,4,1,11776,12,2406833010
6532,403269781,566,403270347,0,6,1,512,14,9834466275
6533,403305082,198392,403503474,0,1,0,189952,18,3369853154
6534,403316504,5196,403321700,0,6,1,13312,14,193901943
6535,403316595,12995,403329590,0,4,1,25088,12,6653848341
6536,403375956,15837,403391793,0,6,1,30720,14,4440527754
6537,403385660,11016,403396676,0,8,1,17920,21,1805708692
6538,403409943,146487,403556430,0,4,0,5632,12,5732965959
6539,403425153,7230,403432383,0,5,1,7680,20,1137400331
6540,403426286,52772,403479058,0,5,1,83456,20,1819702185
6541,403428763,53201,403481964,0,5,1,4608,20,1656349379
6542,403487243,5196,403492439,0,4,1,13312,12,5612214634
6543,403517034,3128,403520162,0,4,1,9216,12,8654677745
6544,403542152,13770,403555922,0,5,1,26624,20,5789657401
6545,403591494,111956,403703450,0,2,0,67584,14,2620641663
6546,403672021,5326,403677347,0,4,1,5632,12,469569874
6547,403745727,4679,403750406,0,2,1,12288,14,6287094795
6548,403826317,110396,403936713,0,4,0,62464,12,451970371
6549,404053667,36087,404089754,0,2,1,63488,14,5495506603
6550,404062393,29947,404092340,0,2,1,4096,14,8353762435
6551,404101979,118508,404220487,0,1,0,89088,18,3515113088
6552,404141413,3422,404144835,0,6,1,3584,14,2154667411
6553,404206631,11274,404217905,0,6,1,18432,14,7783858768
6554,404338965,45596,404384561,0,8,0,1024,21,2948152285
6555,404387668,3904,404391572,0,6,1,10752,14,109255766
6556,404402783,12308,404415091,0,5,1,20480,20,10411733617
6557,404408840,1518,404410358,0,6,1,1536,14,3331790575
6558,404555341,3422,404558763,0,4,1,3584,12,9392821077
6559,404590848,45596,404636444,0,8,0,1024,21,1990812630
6560,404714872,10241,404725113,0,5,1,16384,20,6510811829
6561,404736442,13341,404749783,0,6,1,22528,14,5761247610
6562,404753524,197924,404951448,0,4,0,188416,12,9632286228
6563,404756055,22174,404778229,0,2,1,36352,14,10129543517
6564,404764053,164754,404928807,0,6,0,146432,14,436338959
6565,404817276,176646,404993922,0,4,0,99840,12,3172466380
6566,404841130,43904,404885034,0,8,0,512,21,5008509500
6567,404963497,33333,404996830,0,2,1,54784,14,10018069284
6568,405014117,21658,405035775,0,5,1,35328,20,4176486264
6569,405053977,10499,405064476,0,2,1,16896,14,10344883352
6570,405125772,99944,405225716,0,1,0,28160,18,5520216440
6571,405156843,83444,405240287,0,4,0,14336,12,6133395237
6572,405240206,12122,405252328,0,4,1,19968,12,8203078276
6573,405246035,13341,405259376,0,2,1,22528,14,2419826045
6574,405307780,66368,405374148,0,6,0,8704,14,6625645199
6575,405362399,4420,405366819,0,2,1,11776,14,3911940294
6576,405372083,26479,405398562,0,2,1,48128,14,9171775888
6577,405536485,113672,405650157,0,2,0,73216,14,6107104695
6578,405565514,162482,405727996,0,2,0,79360,14,3711839691
6579,405576083,7230,405583313,0,2,1,7680,14,7887551289
6580,405633393,48980,405682373,0,1,0,2048,18,6978298965
6581,405681160,11533,405692693,0,6,1,18944,14,3317056120
6582,405688966,107921,405796887,0,2,0,27136,14,6827725325
6583,405702826,2870,405705696,0,6,1,8704,14,5760114362
6584,405754030,566,405754596,0,5,1,512,20,3083729286
6585,405798809,126932,405925741,0,6,0,116736,14,6287011197
6586,405841420,2870,405844290,0,7,1,8704,40,1888089514
6587,405892167,195428,406087595,0,5,0,180224,20,10006151224
6588,405921197,6754,405927951,0,5,1,7168,20,3763892139
6589,405976695,5326,405982021,0,7,1,5632,40,797382991
6590,405982263,5196,405987459,0,7,1,13312,40,3260475421
6591,405992372,10241,406002613,0,5,1,16384,20,6872953444
6592,406005792,108212,406114004,0,1,0,55296,18,5962570187
6593,406093328,6278,406099606,0,5,1,6656,20,8417062511
6594,406107690,6278,406113968,0,7,1,6656,40,7445491487
6595,406255469,3387,406258856,0,4,1,9728,12,9449161944
6596,406359539,130364,406489903,0,6,0,128000,14,4472247562
6597,406392634,5802,406398436,0,6,1,6144,14,3641447963
6598,406457957,76083,406534040,0,6,1,75776,14,5823852851
6599,406468760,6278,406475038,0,4,1,6656,12,8862851465
6600,406556004,10757,406566761,0,7,1,17408,40,9728173939
6601,406584405,109197,406693602,0,6,0,45568,14,772130101
6602,406588354,209342,406797696,0,6,0,159232,14,3813961203
6603,406589495,4374,406593869,0,7,1,4608,40,5344405109
6604,406672508,2470,406674978,0,6,1,2560,14,3136887072
6605,406689902,109681,406799583,0,6,0,6144,14,6144993724
6606,406745258,566,406745824,0,5,1,512,20,5530384749
6607,406817476,2870,406820346,0,2,1,8704,14,10262226291
6608,406855473,1994,406857467,0,6,1,2048,14,506747330
6609,406916734,6278,406923012,0,4,1,6656,12,3589864955
6610,406948146,2870,406951016,0,7,1,8704,40,8100621040
6611,406980149,20882,407001031,0,6,1,33792,14,6178289522
6612,407079335,113204,407192539,0,4,0,71680,12,6589167703
6613,407164982,6278,407171260,0,7,1,6656,40,6356188030
6614,407227394,304172,407531566,0,2,0,375808,14,8123845841
6615,407282782,43904,407326686,0,8,0,512,21,4987047794
6616,407316388,13512,407329900,0,0,1,26112,29,2422762983
6617,407323681,293121,407616802,0,2,0,194560,14,4087120067
6618,407360469,193868,407554337,0,1,0,175104,18,6594940888
6619,407369881,7230,407377111,0,0,1,7680,29,3618368123
6620,407399864,6229,407406093,0,6,1,15360,14,2760278822
6621,407415602,10241,407425843,0,7,1,16384,40,1248785287
6622,407509100,55748,407564848,0,4,0,4096,12,3986169155
6623,407522583,45596,407568179,0,8,0,1024,21,3355828968
6624,407626583,45908,407672491,0,8,0,2048,21,7765957307
6625,407647651,6229,407653880,0,9,1,15360,45,3929099998
6626,407737480,12566,407750046,0,6,1,20992,14,8250194649
6627,407748953,16613,407765566,0,6,1,32256,14,7200294539
6628,407802400,54368,407856768,0,4,0,4608,12,6458782331
6629,407959831,195584,408155415,0,2,0,180736,14,9845884687
6630,407986449,54992,408041441,0,4,0,6656,12,9998777076
6631,408042696,86696,408129392,0,1,0,19968,18,9850351790
6632,408053502,5802,408059304,0,2,1,6144,14,5217276669
6633,408054501,6278,408060779,0,6,1,6656,14,397672120
6634,408123699,133680,408257379,0,2,0,34816,14,5827831480
6635,408217693,45596,408263289,0,8,0,1024,21,2354750349
6636,408358524,108056,408466580,0,1,0,54784,18,5069337105
6637,408373301,11533,408384834,0,6,1,18944,14,1644300452
6638,408418055,45596,408463651,0,6,0,1024,14,8121465638
6639,408519245,1042,408520287,0,7,1,1024,40,5556941698
6640,408550553,12825,408563378,0,6,1,21504,14,6604497670
6641,408675624,3898,408679522,0,7,1,4096,40,3066322157
6642,408683580,108524,408792104,0,2,0,56320,14,784918952
6643,408744437,52364,408796801,0,6,0,3072,14,10273802923
6644,408746613,209468,408956081,0,4,0,226304,12,2291182869
6645,408917210,12566,408929776,0,6,1,20992,14,1988878365
6646,408924858,100633,409025491,0,6,0,3072,14,5199425317
6647,408996137,1518,408997655,0,7,1,1536,40,4700795138
6648,409021093,193712,409214805,0,2,0,174592,14,8200261898
6649,409154494,48980,409203474,0,8,0,2048,21,2882034578
6650,409169642,97519,409267161,0,2,0,3072,14,4406306086
6651,409250340,101348,409351688,0,4,0,32768,12,9181228657
6652,409291589,3904,409295493,0,7,1,10752,40,7085722365
6653,409342495,220993,409563488,0,4,0,233984,12,1291298282
6654,409377513,187550,409565063,0,4,0,5120,12,2982377244
6655,409441294,13083,409454377,0,1,1,22016,18,3931725705
6656,409619498,12308,409631806,0,0,1,20480,29,1832606116
6657,409644011,4679,409648690,0,6,1,12288,14,8598255991
6658,409743810,125840,409869650,0,1,0,113152,18,1656983625
6659,409798161,194180,409992341,0,2,0,176128,14,1080959259
6660,409897832,5454,409903286,0,6,1,13824,14,3607308896
6661,409974653,13083,409987736,0,7,1,22016,40,6479948373
6662,410048813,14545,410063358,0,7,1,28160,40,3724848797
6663,410079499,116324,410195823,0,2,0,81920,14,3382478617
6664,410184969,1042,410186011,0,7,1,1024,40,6393794080
6665,410189309,5196,410194505,0,5,1,13312,20,6395294925
6666,410229637,280772,410510409,0,2,0,299008,14,3453607515
6667,410246165,76700,410322865,0,1,0,17408,18,3823558768
6668,410316033,43904,410359937,0,6,0,512,14,7858672062
6669,410324912,2870,410327782,0,7,1,8704,40,1052228247
6670,410379949,5712,410385661,0,7,1,14336,40,8245872125
6671,410497670,45596,410543266,0,8,0,1024,21,1786686961
6672,410527631,16354,410543985,0,7,1,31744,40,3220214532
6673,410589342,3387,410592729,0,6,1,9728,14,3255506244
6674,410639838,4850,410644688,0,7,1,5120,40,8035646547
6675,410692671,45437,410738108,0,5,1,78336,20,6057376933
6676,410705764,81845,410787609,0,6,0,512,14,983738475
6677,410706697,74633,410781330,0,5,1,105984,20,3235715749
6678,410780731,129116,410909847,0,2,0,123904,14,6661284999
6679,410792894,277964,411070858,0,4,0,289792,12,3062675018
6680,410844316,2470,410846786,0,6,1,2560,14,6784579718
6681,410847416,224705,411072121,0,4,0,4096,12,1063611592
6682,410977233,45696,411022929,0,5,1,78848,20,2076200828
6683,411090298,3422,411093720,0,6,1,3584,14,2465753860
6684,411170560,12308,411182868,0,9,1,20480,45,7920249532
6685,411193220,45596,411238816,0,6,0,1024,14,1650322702
6686,411214409,4374,411218783,0,9,1,4608,45,4119945253
6687,411222114,13341,411235455,0,6,1,22528,14,9451147851
6688,411278625,105404,411384029,0,2,0,46080,14,7637304034
6689,411296336,7230,411303566,0,9,1,7680,45,2023227480
6690,411303667,1518,411305185,0,9,1,1536,45,4630664618
6691,411303677,169908,411473585,0,2,0,65536,14,4801720474
6692,411354190,3422,411357612,0,9,1,3584,45,859421545
6693,411359175,68216,411427391,0,1,0,9728,18,5069013210
6694,411373622,566,411374188,0,9,1,512,45,5630819974
6695,411471603,127556,411599159,0,4,0,118784,12,9844418775
6696,411534182,55748,411589930,0,8,0,4096,21,4025434661
6697,411543315,4937,411548252,0,6,1,12800,14,3362422473
6698,411584234,6488,411590722,0,9,1,15872,45,3719057599
6699,411601854,107432,411709286,0,2,0,52736,14,4288463403
6700,411622245,5712,411627957,0,7,1,14336,40,1041521487
6701,411699189,243891,411943080,0,5,1,394752,20,9996490405
6702,411769790,205724,411975514,0,2,0,214016,14,7016201593
6703,411835266,267412,412102678,0,5,1,437248,20,4307027142
6704,411861296,165122,412026418,0,2,0,81408,14,51785532
6705,411887755,57440,411945195,0,6,0,4608,14,9865274438
6706,411903619,4420,411908039,0,7,1,11776,40,4969975570
6707,411927777,108836,412036613,0,1,0,57344,18,5358769012
6708,412065209,154316,412219525,0,5,1,250368,20,2833970763
6709,412067837,6278,412074115,0,9,1,6656,45,8703461689
6710,412123653,23466,412147119,0,9,1,38912,45,469599521
6711,412327705,85628,412413333,0,4,0,21504,12,9221808394
6712,412348402,178076,412526478,0,2,0,148480,14,2201140676
6713,412357540,185645,412543185,0,2,0,54784,14,6272257022
6714,412441841,600333,413042174,0,5,1,972288,20,7096096366
6715,412526679,2870,412529549,0,7,1,8704,40,3618831844
6716,412570502,493177,413063679,0,5,1,78336,20,9620637128
6717,412574995,605577,413180572,0,5,0,172544,20,2216600972
6718,412587528,2470,412589998,0,9,1,2560,45,8478336101
6719,412681328,499259,413180587,0,5,1,247296,20,7615046807
6720,412703323,121160,412824483,0,1,0,97792,18,4594047783
6721,412723336,4679,412728015,0,7,1,12288,40,10562349450
6722,412748809,474404,413223213,0,5,1,262144,20,8217362822
6723,412795980,43904,412839884,0,6,0,512,14,8918985208
6724,412879095,11533,412890628,0,9,1,18944,45,1552977479
6725,412907475,2470,412909945,0,7,1,2560,40,3778079808
6726,412928436,50672,412979108,0,8,0,2560,21,6022263902
6727,413056188,164072,413220260,0,2,0,142848,14,7113951769
6728,413092502,5712,413098214,0,7,1,14336,40,5591400733
6729,413094654,23208,413117862,0,9,1,38400,45,3396873712
6730,413193170,4850,413198020,0,9,1,5120,45,8512983098
6731,413225048,143416,413368464,0,5,1,232448,20,9644222337
6732,413263297,104780,413368077,0,2,0,44032,14,3648677191
6733,413311315,185208,413496523,0,5,1,300544,20,5464797594
6734,413415501,191372,413606873,0,1,0,166912,18,733667948
6735,413478637,73058,413551695,0,5,1,118784,20,9406505708
6736,413492300,75665,413567965,0,5,1,61440,20,7610132224
6737,413532532,55748,413588280,0,6,0,4096,14,9279019182
6738,413608173,129896,413738069,0,2,0,126464,14,7053790332
6739,413620783,54056,413674839,0,8,0,3584,21,2874794401
6740,413888609,55748,413944357,0,4,0,4096,12,4434714672
6741,413985683,53583,414039266,0,5,1,87552,20,2061937299
6742,413990518,47444,414037962,0,8,0,2048,21,8892520537
6743,413997495,3422,414000917,0,7,1,3584,40,10282669458
6744,414008139,43904,414052043,0,6,0,512,14,2755319419
6745,414028726,5454,414034180,0,0,1,13824,29,456407127
6746,414029925,5326,414035251,0,9,1,5632,45,10122207985
6747,414050159,5326,414055485,0,9,1,5632,45,9791645235
6748,414075678,5802,414081480,0,8,1,6144,21,8966584960
6749,414091137,7706,414098843,0,9,1,8192,45,10183602148
6750,414091858,147311,414239169,0,4,0,117248,12,5687606858
6751,414112081,249082,414361163,0,4,0,194048,12,5710154196
6752,414130778,103174,414233952,0,5,1,167424,20,486303381
6753,414184909,6488,414191397,0,9,1,15872,45,8067939341
6754,414213033,43458,414256491,0,5,1,71168,20,9443276905
6755,414235387,5326,414240713,0,0,1,5632,29,7381638013
6756,414404231,45752,414449983,0,8,0,1536,21,7183807099
6757,414444457,3904,414448361,0,8,1,10752,21,5733822595
6758,414457220,46988,414504208,0,5,1,81408,20,8429260672
6759,414508032,48980,414557012,0,4,0,2048,12,4120334260
6760,414530784,3128,414533912,0,8,1,9216,21,69384366
6761,414550959,247937,414798896,0,5,1,406016,20,709830401
6762,414582139,94532,414676671,0,2,0,20480,14,309043446
6763,414630415,170747,414801162,0,5,1,3584,20,3391048529
6764,414703180,22691,414725871,0,8,1,37376,21,1798992323
6765,414775838,13253,414789091,0,3,1,25600,37,7244686087
6766,414779840,47992,414827832,0,3,1,75776,37,2100220894
6767,414855606,103532,414959138,0,4,0,39936,12,9004961354
6768,415107458,1994,415109452,0,7,1,2048,40,7984966938
6769,415136214,113204,415249418,0,4,0,71680,12,5130043644
6770,415216859,47288,415264147,0,8,0,1536,21,7244370216
6771,415283127,3645,415286772,0,9,1,10240,45,7766629841
6772,415380524,64225,415444749,0,3,1,104960,37,1482606787
6773,415390540,49136,415439676,0,8,0,2560,21,8298952888
6774,415405861,111332,415517193,0,2,0,65536,14,6516851651
6775,415489373,102399,415591772,0,3,1,165888,37,7824369684
6776,415612785,4850,415617635,0,7,1,5120,40,4420944721
6777,415631860,566,415632426,0,7,1,512,40,5323711793
6778,415640966,3645,415644611,0,9,1,10240,45,4440649143
6779,415657948,59288,415717236,0,2,0,5632,14,5837632788
6780,415700429,225708,415926137,0,3,1,366080,37,8817858031
6781,415725233,55748,415780981,0,4,0,4096,12,1320308397
6782,415774479,384212,416158691,0,4,0,477184,12,2809690839
6783,415791346,3898,415795244,0,7,1,4096,40,9377531102
6784,415910014,3387,415913401,0,9,1,9728,45,9480771388
6785,415921912,249898,416171810,0,4,0,43008,12,2815979093
6786,415956984,11533,415968517,0,9,1,18944,45,6477734419
6787,415987221,95117,416082338,0,3,1,155136,37,6587101192
6788,416030624,287948,416318572,0,1,0,322560,18,4051111555
6789,416211706,33762,416245468,0,3,1,58880,37,3776502339
6790,416218439,95214,416313653,0,3,1,136704,37,3478826900
6791,416236816,113828,416350644,0,4,0,73728,12,9442418381
6792,416237297,14804,416252101,0,9,1,28672,45,4891652857
6793,416263639,55506,416319145,0,3,1,26112,37,534344437
6794,416275557,125541,416401098,0,4,0,16384,12,5616321341
6795,416318458,23725,416342183,0,9,1,39424,45,2425796391
6796,416325038,25621,416350659,0,4,1,22016,12,4716743518
6797,416435394,25446,416460840,0,7,1,46080,40,3208799987
6798,416438508,5712,416444220,0,4,1,14336,12,3808520855
6799,416457148,150224,416607372,0,2,0,137728,14,6959410994
6800,416480584,196052,416676636,0,2,0,120832,14,795378903
6801,416482981,43904,416526885,0,8,0,512,21,9252926059
6802,416518370,7706,416526076,0,7,1,8192,40,1999665352
6803,416538982,15321,416554303,0,7,1,29696,40,5067744873
6804,416706749,4374,416711123,0,4,1,4608,12,1306168234
6805,416714227,45437,416759664,0,3,1,78336,37,77595296
6806,416733766,36728,416770494,0,3,1,43520,37,8466404444
6807,416863114,50828,416913942,0,8,0,3072,21,4096405213
6808,416923075,6488,416929563,0,4,1,15872,12,4869876578
6809,416989500,270080,417259580,0,2,0,279040,14,5366293466
6810,417002901,52364,417055265,0,8,0,3072,21,2921954193
6811,417052133,240092,417292225,0,4,0,15360,12,6440994375
6812,417052816,15579,417068395,0,4,1,30208,12,10059726890
6813,417215599,48980,417264579,0,6,0,2048,14,3748668973
6814,417238257,267154,417505411,0,3,1,436736,37,10123772308
6815,417324300,57440,417381740,0,8,0,4608,21,9094672711
6816,417359867,15321,417375188,0,4,1,29696,12,7229343162
6817,417543146,2470,417545616,0,7,1,2560,40,2717457013
6818,417569429,194804,417764233,0,2,0,178176,14,2328282113
6819,417689453,15062,417704515,0,7,1,29184,40,6655180086
6820,417716167,90056,417806223,0,4,0,15872,12,8694208281
6821,417750982,20366,417771348,0,4,1,32768,12,7024793630
6822,417947190,12049,417959239,0,9,1,19968,45,7090480149
6823,418004261,7230,418011491,0,8,1,7680,21,5792910510
6824,418029000,121316,418150316,0,2,0,98304,14,7319292578
6825,418040874,4162,418045036,0,4,1,11264,12,3723225647
6826,418164310,4679,418168989,0,7,1,12288,40,6090866797
6827,418257700,7706,418265406,0,7,1,8192,40,4962346305
6828,418263672,54056,418317728,0,8,0,3584,21,2687795776
6829,418318595,15837,418334432,0,4,1,30720,12,5586193826
6830,418341242,126464,418467706,0,1,0,115200,18,8089123094
6831,418343175,6278,418349453,0,0,1,6656,29,684425537
6832,418395814,10757,418406571,0,9,1,17408,45,616123954
6833,418409363,66680,418476043,0,4,0,9728,12,6230806415
6834,418426157,196676,418622833,0,1,0,184320,18,299348477
6835,418463489,14287,418477776,0,0,1,27648,29,4287943053
6836,418621439,4374,418625813,0,4,1,4608,12,3860755485
6837,418629380,3898,418633278,0,7,1,4096,40,5298014558
6838,418684919,25962,418710881,0,9,1,47104,45,6797992959
6839,418769276,103064,418872340,0,1,0,38400,18,8292354375
6840,418819281,199796,419019077,0,1,0,194560,18,8648743836
6841,418856505,65900,418922405,0,8,0,7168,21,1069416162
6842,418890719,48980,418939699,0,6,0,2048,14,8742040903
6843,418899455,12308,418911763,0,0,1,20480,29,5262680883
6844,418908465,121472,419029937,0,2,0,98816,14,213201896
6845,418911678,128024,419039702,0,4,0,120320,12,9686880458
6846,418931378,3128,418934506,0,9,1,9216,45,5669636082
6847,418957287,4679,418961966,0,7,1,12288,40,3426657835
6848,419070959,67592,419138551,0,2,0,7680,14,721277476
6849,419078333,45596,419123929,0,8,0,1024,21,6953729563
6850,419169950,11791,419181741,0,7,1,19456,40,9767029002
6851,419248134,125216,419373350,0,4,0,111104,12,399126023
6852,419291124,54056,419345180,0,1,0,3584,18,8676546596
6853,419315651,4374,419320025,0,0,1,4608,29,5170763400
6854,419386814,12737,419399551,0,0,1,24576,29,636192611
6855,419390725,1994,419392719,0,9,1,2048,45,724155807
6856,419431560,100724,419532284,0,1,0,30720,18,4257513667
6857,419439344,43904,419483248,0,2,0,512,14,10618889545
6858,419446184,44404,419490588,0,4,1,76288,12,1534110642
6859,419478612,43904,419522516,0,8,0,512,21,7358507568
6860,419521457,43904,419565361,0,8,0,512,21,8696138766
6861,419816704,12566,419829270,0,9,1,20992,45,8712120372
6862,419823849,9927,419833776,0,9,1,7168,45,7499368456
6863,419839630,3898,419843528,0,4,1,4096,12,6840415844
6864,419890441,13341,419903782,0,0,1,22528,29,9481886270
6865,419993758,3128,419996886,0,9,1,9216,45,6572299476
6866,420005701,4374,420010075,0,0,1,4608,29,6427672543
6867,420074052,34108,420108160,0,7,1,56320,40,1507634646
6868,420119418,3645,420123063,0,7,1,10240,40,5645588014
6869,420155425,7706,420163131,0,4,1,8192,12,1012607674
6870,420157202,4420,420161622,0,0,1,11776,29,10140573495
6871,420209994,57440,420267434,0,8,0,4608,21,5299162974
6872,420238732,122623,420361355,0,4,0,47616,12,1724295700
6873,420240720,118352,420359072,0,2,0,88576,14,53833382
6874,420255007,1518,420256525,0,4,1,1536,12,6540057588
6875,420454838,102141,420556979,0,5,1,165376,20,3682883703
6876,420480697,54056,420534753,0,8,0,3584,21,6369629951
6877,420482249,11016,420493265,0,4,1,17920,12,6136498156
6878,420555980,128336,420684316,0,2,0,121344,14,3813544265
6879,420577302,22691,420599993,0,7,1,37376,40,6577590737
6880,420607913,48980,420656893,0,6,0,2048,14,796226514
6881,420689081,14545,420703626,0,7,1,28160,40,5973520637
6882,420697087,34020,420731107,0,0,1,59392,29,6676070356
6883,420736155,52364,420788519,0,6,0,3072,14,7699472626
6884,420749069,4420,420753489,0,7,1,11776,40,5432140619
6885,420784776,105404,420890180,0,1,0,46080,18,2066823780
6886,420891551,3422,420894973,0,0,1,3584,29,6045503052
6887,420900552,25704,420926256,0,5,1,46592,20,5189933976
6888,420974603,2470,420977073,0,4,1,2560,12,8617743560
6889,420992973,6754,420999727,0,7,1,7168,40,6390733771
6890,421022783,3904,421026687,0,0,1,10752,29,1014709508
6891,421054662,3904,421058566,0,4,1,10752,12,4574552327
6892,421073802,48980,421122782,0,6,0,2048,14,2377013515
6893,421081816,33591,421115407,0,5,1,55296,20,6032707341
6894,421108693,5712,421114405,0,7,1,14336,40,2470343399
6895,421307590,80396,421387986,0,2,0,19456,14,2360866954
6896,421343331,64912,421408243,0,5,1,109568,20,3508654253
6897,421447293,92528,421539821,0,2,0,18944,14,4357814817
6898,421559717,12308,421572025,0,5,1,20480,20,7768658739
6899,421676242,43904,421720146,0,6,0,512,14,2560869066
6900,421678318,43904,421722222,0,8,0,512,21,4282798830
6901,421689625,174560,421864185,0,4,0,152064,12,486910095
6902,421862658,50672,421913330,0,8,0,2560,21,680354179
6903,421906234,99788,422006022,0,4,0,27648,12,4267190904
6904,421926289,43904,421970193,0,8,0,512,21,7987439328
6905,421985061,23637,422008698,0,4,1,42496,12,942276206
6906,422096940,208532,422305472,0,1,0,223232,18,1682675036
6907,422145133,43904,422189037,0,6,0,512,14,7889821947
6908,422156238,154085,422310323,0,1,0,15872,18,364929700
6909,422205800,167792,422373592,0,2,0,150016,14,4111405197
6910,422208423,4937,422213360,0,4,1,12800,12,4731518393
6911,422291994,111442,422403436,0,2,0,13824,14,5721132982
6912,422317446,125684,422443130,0,4,0,112640,12,4513638346
6913,422425180,118040,422543220,0,2,0,87552,14,5075857802
6914,422434419,121784,422556203,0,1,0,99840,18,2118369694
6915,422600657,154745,422755402,0,5,1,254464,20,6861236171
6916,422887480,11791,422899271,0,0,1,19456,29,9780354430
6917,422902982,21141,422924123,0,5,1,34304,20,9145045568
6918,423033108,15321,423048429,0,0,1,29696,29,4596979722
6919,423065109,123032,423188141,0,2,0,103936,14,1868369832
6920,423109160,247053,423356213,0,2,0,194560,14,640277181
6921,423140801,426916,423567717,0,5,1,691200,20,10466175380
6922,423181879,50672,423232551,0,8,0,2560,21,6318733035
6923,423218371,45596,423263967,0,8,0,1024,21,8948560316
6924,423255424,47600,423303024,0,8,0,2560,21,4814457212
6925,423267146,3422,423270568,0,0,1,3584,29,5077499297
6926,423298680,167921,423466601,0,2,0,62464,14,6535340274
6927,423417879,189968,423607847,0,4,0,162304,12,3548362202
6928,423534072,11016,423545088,0,0,1,17920,29,8191773651
6929,423563824,13858,423577682,0,7,1,23552,40,9225147197
6930,423594617,127674,423722291,0,4,0,75776,12,3462837955
6931,423614193,43904,423658097,0,8,0,512,21,1897600235
6932,423621493,117256,423738749,0,4,0,7680,12,9213829656
6933,423655975,48980,423704955,0,6,0,2048,14,7646234945
6934,423672732,277808,423950540,0,2,0,289280,14,1576522260
6935,423707654,1042,423708696,0,0,1,1024,29,891431236
6936,423821303,123968,423945271,0,4,0,107008,12,5168383977
6937,423918308,7706,423926014,0,9,1,8192,45,6356157493
6938,423961585,14804,423976389,0,0,1,28672,29,45849914
6939,424123349,5196,424128545,0,0,1,13312,29,8985202637
6940,424280991,187187,424468178,0,5,1,307712,20,1043298653
6941,424352292,130676,424482968,0,2,0,129024,14,6732098437
6942,424485829,101660,424587489,0,4,0,33792,12,6639724060
6943,424585500,155867,424741367,0,5,1,253440,20,3735271066
6944,424643797,134577,424778374,0,5,1,119808,20,9621819190
6945,424654866,138959,424793825,0,5,1,49152,20,1661332717
6946,424661650,43904,424705554,0,8,0,512,21,1178207074
6947,424693073,3422,424696495,0,8,1,3584,21,2544350776
6948,424796077,4679,424800756,0,5,1,12288,20,4084536077
6949,424889528,43904,424933432,0,8,0,512,21,1080346223
6950,424972944,324704,425297648,0,4,0,397824,12,7087376429
6951,424982958,50672,425033630,0,6,0,2560,14,3980128438
6952,425012254,129896,425142150,0,1,0,126464,18,6587417262
6953,425027852,100256,425128108,0,2,0,29184,14,10087803938
6954,425092971,15321,425108292,0,9,1,29696,45,3254323448
6955,425227271,187629,425414900,0,4,0,84992,12,9375056969
6956,425268633,123188,425391821,0,0,0,104448,29,8851086643
6957,425386681,65900,425452581,0,2,0,7168,14,4008380585
6958,425488972,106652,425595624,0,4,0,50176,12,2497228966
6959,425576084,134684,425710768,0,0,0,132096,29,7178897455
6960,425771000,110864,425881864,0,0,0,64000,29,1020316287
6961,425813039,102752,425915791,0,1,0,37376,18,9189247932
6962,425863602,89230,425952832,0,0,0,8704,29,1131008878
6963,425887176,337040,426224216,0,2,0,408064,14,9752865006
6964,425935912,235487,426171399,0,5,1,385024,20,9197409064
6965,425979676,197522,426177198,0,5,1,27648,20,5320019485
6966,426024058,43904,426067962,0,6,0,512,14,3389893786
6967,426038391,202688,426241079,0,2,0,55296,14,10201116000
6968,426088680,247484,426336164,0,1,0,275456,18,4931178195
6969,426195527,98072,426293599,0,0,0,22016,29,6306415922
6970,426296234,48980,426345214,0,6,0,2048,14,3726430094
6971,426365356,47288,426412644,0,6,0,1536,14,3833577745
6972,426415984,45596,426461580,0,6,0,1024,14,4921211459
6973,426665321,104780,426770101,0,0,0,44032,29,10208237754
6974,426780500,136532,426917032,0,1,0,133120,18,5979744061
6975,426845422,1518,426846940,0,5,1,1536,20,7159930485
6976,426998016,58220,427056236,0,4,0,7168,12,2053271866
6977,427045896,114452,427160348,0,1,0,75776,18,6474112699
6978,427052076,15321,427067397,0,0,1,29696,29,9367391374
6979,427083558,10241,427093799,0,0,1,16384,29,8405548206
6980,427092121,24929,427117050,0,4,1,45056,12,5430484149
6981,427242240,47288,427289528,0,6,0,1536,14,1094255118
6982,427252074,100724,427352798,0,2,0,30720,14,2001929484
6983,427332324,45596,427377920,0,8,0,1024,21,9073578648
6984,427382312,153296,427535608,0,2,0,137728,14,4687148110
6985,427416353,2946,427419299,0,6,1,3072,14,927594186
6986,427418516,100568,427519084,0,0,0,30208,29,4907804773
6987,427502570,5802,427508372,0,1,1,6144,18,5780557663
6988,427546143,117373,427663516,0,1,0,83968,18,10119637703
6989,427547338,16096,427563434,0,5,1,31232,20,923918778
6990,427563594,3904,427567498,0,1,1,10752,18,5440806094
6991,427704159,15837,427719996,0,6,1,30720,14,931042307
6992,427717718,58688,427776406,0,8,0,8704,21,9823692852
6993,427720461,43904,427764365,0,8,0,512,21,1324980151
6994,427788763,43904,427832667,0,8,0,512,21,10583416290
6995,427846863,48980,427895843,0,8,0,2048,21,28898640
6996,427856715,125216,427981931,0,0,0,111104,29,1041267821
6997,427870015,11016,427881031,0,8,1,17920,21,6273171532
6998,427882782,13341,427896123,0,0,1,22528,29,2004325929
6999,427884583,120692,428005275,0,1,0,96256,18,2118710493
7000,427896205,4374,427900579,0,0,1,4608,29,3580980159
7001,427910876,2470,427913346,0,1,1,2560,18,9920127288
7002,427935437,10757,427946194,0,8,1,17408,21,2754569259
7003,427956854,110222,428067076,0,8,0,512,21,2491101812
7004,427993876,11016,428004892,0,4,1,17920,12,3396216728
7005,428004917,190904,428195821,0,0,0,165376,29,7290864293
7006,428059698,2870,428062568,0,5,1,8704,20,5848573806
7007,428086913,43904,428130817,0,6,0,512,14,959270800
7008,428141586,5196,428146782,0,4,1,13312,12,10632664023
7009,428144124,3644,428147768,0,4,1,1536,12,5594906191
7010,428151866,55748,428207614,0,1,0,4096,18,4719429711
7011,428183845,60824,428244669,0,6,0,5632,14,3803970152
7012,428188620,55748,428244368,0,8,0,4096,21,7621355241
7013,428190151,3128,428193279,0,5,1,9216,20,9229609967
7014,428193728,279425,428473153,0,0,0,287744,29,143776414
7015,428201781,113833,428315614,0,1,0,58880,18,488818641
7016,428267370,21399,428288769,0,0,1,34816,29,2399939225
7017,428282388,245936,428528324,0,0,0,78336,29,8664735368
7018,428307408,6278,428313686,0,4,1,6656,12,3747937896
7019,428318485,276619,428595104,0,0,0,136192,29,3120933953
7020,428351562,245235,428596797,0,4,0,248320,12,4600624806
7021,428364370,193244,428557614,0,1,0,173056,18,9585710144
7022,428379785,99632,428479417,0,2,0,27136,14,5756696338
7023,428386706,566,428387272,0,8,1,512,21,9671390279
7024,428407082,2870,428409952,0,6,1,8704,14,5009050681
7025,428408549,1042,428409591,0,4,1,1024,12,7824363330
7026,428408814,5802,428414616,0,8,1,6144,21,590390879
7027,428412830,63737,428476567,0,0,1,3584,29,8822156849
7028,428421049,11791,428432840,0,1,1,19456,18,6309572864
7029,428532293,70315,428602608,0,4,1,6144,12,3945165122
7030,428543658,51461,428595119,0,0,1,24064,29,10569225388
7031,428570014,187940,428757954,0,2,0,155648,14,4140178161
7032,428583561,221254,428804815,0,0,0,129536,29,8507749596
7033,428583815,125735,428709550,0,4,0,70144,12,4328714708
7034,428586383,43904,428630287,0,6,0,512,14,4589958488
7035,428661776,3387,428665163,0,0,1,9728,29,7848559486
7036,428662828,32558,428695386,0,6,1,53248,14,7563967221
7037,428684366,15206,428699572,0,6,1,6656,14,2933240019
7038,428711383,118692,428830075,0,0,0,12800,29,1291893802
7039,428763460,132769,428896229,0,0,0,59904,29,1292926085
7040,428803803,1518,428805321,0,8,1,1536,21,2993708875
7041,428804922,566,428805488,0,0,1,512,29,5152879668
7042,428812023,5802,428817825,0,0,1,6144,29,3525685817
7043,428872511,59132,428931643,0,8,0,5120,21,7375637438
7044,428951046,1994,428953040,0,8,1,2048,21,6398635985
7045,428967045,61641,429028686,0,3,1,99840,37,1166746298
7046,429014601,50999,429065600,0,3,1,82432,37,8332913880
7047,429085015,74360,429159375,0,1,0,9728,18,9007055172
7048,429104112,127556,429231668,0,0,0,118784,29,9458468227
7049,429114202,1518,429115720,0,6,1,1536,14,9219478921
7050,429121261,10241,429131502,0,8,1,16384,21,2515705871
7051,429128685,5454,429134139,0,1,1,13824,18,833588714
7052,429131855,13341,429145196,0,4,1,22528,12,4022132462
7053,429195845,1042,429196887,0,3,1,1024,37,9509466304
7054,429214461,2946,429217407,0,1,1,3072,18,10066878734
7055,429251001,3645,429254646,0,5,1,10240,20,5265663954
7056,429275198,4937,429280135,0,6,1,12800,14,8632101757
7057,429301392,52364,429353756,0,8,0,3072,21,495129736
7058,429333613,101972,429435585,0,1,0,34816,18,3264720077
7059,429368585,14287,429382872,0,4,1,27648,12,3807697262
7060,429381520,7706,429389226,0,5,1,8192,20,2413532202
7061,429399290,110084,429509374,0,0,0,61440,29,2746380882
7062,429433063,2470,429435533,0,5,1,2560,20,8802177864
7063,429453835,1518,429455353,0,1,1,1536,18,585749091
7064,429455825,3898,429459723,0,5,1,4096,20,5157019275
7065,429470102,23120,429493222,0,6,1,41472,14,2532726675
7066,429477933,6754,429484687,0,0,1,7168,29,191594470
7067,429480300,127868,429608168,0,2,0,119808,14,8551801984
7068,429534490,118976,429653466,0,0,0,90624,29,7749836643
7069,429562146,164052,429726198,0,0,0,59904,29,1669559433
7070,429580257,5712,429585969,0,5,1,14336,20,6857310851
7071,429592383,391721,429984104,0,2,0,450048,14,2184058060
7072,429592400,45596,429637996,0,6,0,1024,14,6563626611
7073,429653011,2470,429655481,0,4,1,2560,12,9215809284
7074,429696883,1994,429698877,0,1,1,2048,18,6815110325
7075,429728474,3422,429731896,0,4,1,3584,12,520049662
7076,429738650,54529,429793179,0,3,1,92672,37,3116230139
7077,429740929,15837,429756766,0,6,1,30720,14,9516324785
7078,429758947,10757,429769704,0,0,1,17408,29,6958498659
7079,429786270,82924,429869194,0,3,1,134656,37,2190104249
7080,429818473,86516,429904989,0,4,0,14336,12,8225002362
7081,429841961,115232,429957193,0,4,0,78336,12,9466273235
7082,429845752,153039,429998791,0,2,0,48128,14,10310021455
7083,429857305,70976,429928281,0,4,0,8704,12,7839539911
7084,429873478,566,429874044,0,0,1,512,29,4715570031
7085,429910271,23120,429933391,0,5,1,41472,20,6937471574
7086,429912227,130713,430042940,0,2,0,9216,14,4147125077
7087,429920176,576983,430497159,0,1,0,618496,18,8071571260
7088,429956043,4420,429960463,0,0,1,11776,29,187050531
7089,429961543,23378,429984921,0,5,1,41984,20,9452429460
7090,429970516,25526,429996042,0,5,1,35328,20,9114687326
7091,429972278,336418,430308696,0,1,0,70656,18,7056736676
7092,430081586,73760,430155346,0,2,0,12800,14,5345599660
7093,430130049,14117,430144166,0,6,1,24064,14,4020610885
7094,430162395,5712,430168107,0,5,1,14336,20,9811933869
7095,430201904,245870,430447774,0,3,1,401920,37,7160049988
7096,430218171,57440,430275611,0,8,0,4608,21,5509376163
7097,430262501,202055,430464556,0,3,1,55808,37,4951791468
7098,430275625,5971,430281596,0,1,1,14848,18,3986558916
7099,430289026,3904,430292930,0,4,1,10752,12,4049654726
7100,430291930,193210,430485140,0,3,1,73728,37,4017084998
7101,430342108,411119,430753227,0,1,0,273408,18,653390687
7102,430347348,1518,430348866,0,5,1,1536,20,718497054
7103,430385958,99848,430485806,0,3,1,11264,37,5801030336
7104,430491007,382652,430873659,0,4,0,472064,12,9903701142
7105,430498751,50672,430549423,0,6,0,2560,14,6086323704
7106,430536414,14117,430550531,0,7,1,24064,40,3061602131
7107,430583754,4679,430588433,0,1,1,12288,18,1154901809
7108,430619954,101816,430721770,0,2,0,34304,14,2192078328
7109,430642578,3645,430646223,0,5,1,10240,20,4147137005
7110,430677595,6278,430683873,0,6,1,6656,14,8737765087
7111,430680721,2470,430683191,0,0,1,2560,29,5944617561
7112,430699567,179025,430878592,0,6,0,69120,14,10652580849
7113,430863413,13660,430877073,0,4,1,3584,12,2276001481
7114,430901015,21399,430922414,0,5,1,34816,20,3660102793
7115,430929167,2470,430931637,0,5,1,2560,20,7586592701
7116,430941599,11274,430952873,0,6,1,18432,14,2805100325
7117,430974052,256312,431230364,0,6,0,168960,14,51819778
7118,431009287,60824,431070111,0,4,0,5632,12,7706152646
7119,431062117,117416,431179533,0,0,0,85504,29,4233011830
7120,431110712,15062,431125774,0,0,1,29184,29,5870135443
7121,431176847,4420,431181267,0,7,1,11776,40,7651812724
7122,431194397,197768,431392165,0,1,0,187904,18,8575243035
7123,431232678,84475,431317153,0,3,1,137728,37,5916899434
7124,431275778,60980,431336758,0,8,0,6144,21,7475049746
7125,431305936,566,431306502,0,0,1,512,29,10419561716
7126,431332753,74852,431407605,0,2,0,16384,14,1251336914
7127,431425389,4374,431429763,0,7,1,4608,40,5463676563
7128,431437307,3898,431441205,0,7,1,4096,40,936654005
7129,431464456,25446,431489902,0,5,1,46080,20,9571002171
7130,431518077,122096,431640173,0,1,0,100864,18,2306040651
7131,431610651,13770,431624421,0,6,1,26624,14,7602472370
7132,431675039,4162,431679201,0,4,1,11264,12,6565427069
7133,431733801,3904,431737705,0,4,1,10752,12,2523222087
7134,431946516,112424,432058940,0,1,0,69120,18,1895667209
7135,431952772,124904,432077676,0,4,0,110080,12,4911920394
7136,432050766,12566,432063332,0,0,1,20992,29,3765253751
7137,432057692,144362,432202054,0,3,1,237568,37,526388348
7138,432088372,192932,432281304,0,2,0,172032,14,9090602506
7139,432152254,52364,432204618,0,8,0,3072,21,5459921543
7140,432293617,82712,432376329,0,4,0,22016,12,5920965480
7141,432318798,112112,432430910,0,2,0,68096,14,10264425903
7142,432371793,145745,432517538,0,2,0,52736,14,2172681254
7143,432393830,59132,432452962,0,8,0,5120,21,1946568841
7144,432416396,3898,432420294,0,6,1,4096,14,4438002034
7145,432420293,20882,432441175,0,4,1,33792,12,5580467312
7146,432447680,111800,432559480,0,6,0,67072,14,2894812642
7147,432478715,4679,432483394,0,6,1,12288,14,10657711827
7148,432503909,135012,432638921,0,3,1,222720,37,2716728141
7149,432508648,48980,432557628,0,8,0,2048,21,9767511430
7150,432521073,112424,432633497,0,2,0,69120,14,2175424463
7151,432563073,101872,432664945,0,3,1,83456,37,5825636293
7152,432587654,136740,432724394,0,6,0,52736,14,8222374109
7153,432587904,4162,432592066,0,5,1,11264,20,2894418163
7154,432634636,1994,432636630,0,4,1,2048,12,6056930384
7155,432684128,10499,432694627,0,9,1,16896,45,4077835491
7156,432748100,275468,433023568,0,6,0,281600,14,2073620671
7157,432749124,1994,432751118,0,4,1,2048,12,10174511183
7158,432756836,227137,432983973,0,4,0,119296,12,5237757166
7159,432890594,10757,432901351,0,5,1,17408,20,6340996089
7160,432907459,81116,432988575,0,3,1,131072,37,5040335525
7161,433004313,203228,433207541,0,4,0,205824,12,8169815940
7162,433063143,4374,433067517,0,6,1,4608,14,9247713929
7163,433067013,2946,433069959,0,6,1,3072,14,9703527611
7164,433071481,1994,433073475,0,6,1,2048,14,4326964843
7165,433084102,6754,433090856,0,4,1,7168,12,8901077492
7166,433236620,1042,433237662,0,9,1,1024,45,4795163527
7167,433383931,112112,433496043,0,6,0,68096,14,4723508555
7168,433420073,105872,433525945,0,0,0,47616,29,118620032
7169,433558937,127244,433686181,0,0,0,117760,29,4792349147
7170,433636732,34795,433671527,0,3,1,60928,37,8964291529
7171,433656398,3898,433660296,0,5,1,4096,20,1827278551
7172,433677355,110864,433788219,0,4,0,64000,12,5329203581
7173,433681161,11274,433692435,0,9,1,18432,45,9939825374
7174,433692356,382964,434075320,0,0,0,473088,29,7717025086
7175,433739231,189188,433928419,0,6,0,159744,14,2018396747
7176,433913421,566,433913987,0,9,1,512,45,3596433790
7177,433942156,128492,434070648,0,6,0,121856,14,8579776895
7178,433967125,110240,434077365,0,2,0,61952,14,1781198478
7179,433988102,60224,434048326,0,8,0,8704,21,6628710227
7180,434098167,141452,434239619,0,2,0,134144,14,5029833517
7181,434117996,177608,434295604,0,6,0,146944,14,1598087717
7182,434175726,5326,434181052,0,2,1,5632,14,1326831820
7183,434297246,14804,434312050,0,2,1,28672,14,3761079806
7184,434317384,566,434317950,0,2,1,512,14,848512193
7185,434443250,13083,434456333,0,5,1,22016,20,7365426076
7186,434459400,148220,434607620,0,4,0,136192,12,1107198806
7187,434479407,13083,434492490,0,2,1,22016,14,10563556407
7188,434492988,3898,434496886,0,9,1,4096,45,2456407353
7189,434534873,123656,434658529,0,6,0,105984,14,5600151934
7190,434563521,47288,434610809,0,8,0,1536,21,5415890688
7191,434576843,20366,434597209,0,5,1,32768,20,817222743
7192,434635088,3645,434638733,0,2,1,10240,14,7363712615
7193,434653021,54212,434707233,0,8,0,4096,21,7971670198
7194,434703954,1518,434705472,0,0,1,1536,29,1225718913
7195,434795832,57440,434853272,0,8,0,4608,21,2047968810
7196,434799798,4679,434804477,0,4,1,12288,12,6608975430
7197,434808238,5802,434814040,0,5,1,6144,20,6312411726
7198,434826825,104156,434930981,0,0,0,41984,29,4969179686
7199,434838577,2470,434841047,0,4,1,2560,12,1617947464
7200,434903767,83312,434987079,0,2,0,18944,14,1933586153
7201,434905955,149156,435055111,0,1,0,139264,18,5411484760
7202,434945040,2470,434947510,0,0,1,2560,29,4615774140
7203,434965631,11791,434977422,0,4,1,19456,12,2041569220
7204,434988665,115388,435104053,0,6,0,78848,14,7574145705
7205,434994490,168057,435162547,0,2,0,133120,14,5637369918
7206,435000188,5712,435005900,0,5,1,14336,20,8871773157
7207,435006416,5454,435011870,0,2,1,13824,14,7170944764
7208,435024231,7706,435031937,0,2,1,8192,14,7511533070
7209,435047751,187720,435235471,0,1,0,145920,18,3937773856
7210,435091741,7706,435099447,0,9,1,8192,45,3128609050
7211,435098373,124124,435222497,0,4,0,107520,12,5405313856
7212,435109162,2946,435112108,0,5,1,3072,20,2254264994
7213,435137896,3904,435141800,0,8,1,10752,21,10619688207
7214,435266172,3387,435269559,0,0,1,9728,29,1337682646
7215,435287141,92528,435379669,0,6,0,18944,14,1043271512
7216,435288217,5196,435293413,0,2,1,13312,14,8562380049
7217,435362768,12566,435375334,0,8,1,20992,21,1578704036
7218,435514436,128804,435643240,0,0,0,122880,29,3664784267
7219,435629116,115464,435744580,0,0,0,32768,29,10719852005
7220,435642046,3128,435645174,0,2,1,9216,14,9832764458
7221,435710435,118508,435828943,0,6,0,89088,14,8076368887
7222,435786136,2470,435788606,0,9,1,2560,45,8813039235
7223,435837131,4162,435841293,0,5,1,11264,20,1437064537
7224,435899616,3904,435903520,0,0,1,10752,29,7590266050
7225,435922145,191060,436113205,0,1,0,165888,18,3507676177
7226,436031698,118352,436150050,0,6,0,88576,14,8762717940
7227,436069069,10241,436079310,0,5,1,16384,20,5594420322
7228,436117375,136619,436253994,0,6,0,130048,14,3967193586
7229,436148592,57440,436206032,0,1,0,4608,18,1730854294
7230,436159811,22691,436182502,0,2,1,37376,14,10318500608
7231,436162626,2470,436165096,0,5,1,2560,20,3958429885
7232,436181124,132042,436313166,0,6,0,24576,14,5279044350
7233,436231966,2470,436234436,0,0,1,2560,29,10680347369
7234,436310875,99887,436410762,0,6,0,20480,14,9337173499
7235,436343002,1518,436344520,0,0,1,1536,29,8559228092
7236,436364584,216800,436581384,0,4,0,250368,12,4025935993
7237,436385131,6488,436391619,0,4,1,15872,12,10577144680
7238,436407512,191372,436598884,0,2,0,166912,14,2218243722
7239,436429060,54100,436483160,0,5,1,88576,20,818786178
7240,436433037,1042,436434079,0,2,1,1024,14,7317905934
7241,436479340,8966,436488306,0,5,1,8192,20,10160902679
7242,436505908,84380,436590288,0,1,0,17408,18,8861506564
7243,436515129,173835,436688964,0,4,0,53248,12,2080426238
7244,436613699,89300,436702999,0,1,0,18432,18,8541724211
7245,436644860,24242,436669102,0,0,1,40448,29,5440061293
7246,436651409,10241,436661650,0,4,1,16384,12,6781839603
7247,436674978,1994,436676972,0,0,1,2048,29,1354839292
7248,436683180,14545,436697725,0,5,1,28160,20,3381628333
7249,436728741,12825,436741566,0,2,1,21504,14,6826175894
7250,436750882,57440,436808322,0,2,0,4608,14,907377874
7251,436961106,5196,436966302,0,8,1,13312,21,3124667341
7252,436977508,94820,437072328,0,8,0,16384,21,10568240794
7253,436991891,41908,437033799,0,8,1,68096,21,7469686756
7254,437041424,1994,437043418,0,0,1,2048,29,7625870358
7255,437281467,1518,437282985,0,4,1,1536,12,872573597
7256,437384881,11791,437396672,0,4,1,19456,12,6239850997
7257,437392106,121784,437513890,0,6,0,99840,14,9126693308
7258,437462700,3422,437466122,0,8,1,3584,21,6942004955
7259,437513847,125095,437638942,0,6,0,110592,14,6346262104
7260,437538612,238264,437776876,0,6,0,168960,14,9752896661
7261,437578720,3422,437582142,0,0,1,3584,29,9261782715
7262,437587877,207110,437794987,0,6,0,59392,14,6427758621
7263,437667030,3422,437670452,0,8,1,3584,21,6801598476
7264,437696544,22433,437718977,0,0,1,36864,29,2216226196
7265,437935617,48980,437984597,0,8,0,2048,21,2081688104
7266,437957715,31007,437988722,0,0,1,50176,29,193151052
7267,437971875,51516,438023391,0,4,1,83456,12,8456647345
7268,437996569,105248,438101817,0,1,0,45568,18,5666373134
7269,438134927,98096,438233023,0,0,0,27136,29,6105121854
7270,438159326,13341,438172667,0,9,1,22528,45,1875836576
7271,438184707,7706,438192413,0,2,1,8192,14,8648657574
7272,438249404,69284,438318688,0,2,0,8192,14,3447594976
7273,438308849,3422,438312271,0,4,1,3584,12,3806616276
7274,438332153,22691,438354844,0,6,1,37376,14,4044285953
7275,438355144,7230,438362374,0,2,1,7680,14,4078814052
7276,438359131,99032,438458163,0,0,0,30208,29,601860548
7277,438420401,23466,438443867,0,8,1,38912,21,9100968547
7278,438424491,10757,438435248,0,4,1,17408,12,1530886703
7279,438453478,147484,438600962,0,6,0,54272,14,9198633483
7280,438474883,86204,438561087,0,0,0,13312,29,7692766465
7281,438480420,4937,438485357,0,8,1,12800,21,2178812772
7282,438493686,6754,438500440,0,2,1,7168,14,270852367
7283,438530949,171908,438702857,0,4,0,143360,12,4418789029
7284,438563230,1518,438564748,0,6,1,1536,14,2608807262
7285,438606409,16613,438623022,0,6,1,32256,14,8684340168
7286,438632106,292784,438924890,0,1,0,338432,18,6532357318
7287,438642828,23637,438666465,0,8,1,42496,21,4670472812
7288,438749248,64232,438813480,0,6,0,11776,14,8889538608
7289,438770669,118664,438889333,0,4,0,89600,12,5482411383
7290,438791204,3422,438794626,0,6,1,3584,14,4540466942
7291,438855895,6488,438862383,0,8,1,15872,21,9781596327
7292,438869906,258048,439127954,0,1,0,205312,18,8023942191
7293,438872582,13512,438886094,0,6,1,26112,14,10124332557
7294,438898312,14545,438912857,0,4,1,28160,12,2185583680
7295,438988643,36604,439025247,0,8,1,64512,21,6104120667
7296,439003243,4162,439007405,0,2,1,11264,14,2591479288
7297,439010591,21377,439031968,0,8,1,24064,21,6212414412
7298,439022105,13729,439035834,0,8,1,6144,21,5147565272
7299,439039927,7230,439047157,0,2,1,7680,14,1665503790
7300,439066756,3898,439070654,0,6,1,4096,14,3379600332
7301,439070678,261710,439332388,0,2,0,247296,14,8868239626
7302,439248606,123812,439372418,0,4,0,106496,12,3606575422
7303,439251355,81048,439332403,0,2,1,18944,14,7831864251
7304,439268303,157389,439425692,0,4,0,93696,12,4489073382
7305,439330643,110240,439440883,0,6,0,61952,14,983221413
7306,439344557,179948,439524505,0,2,0,154624,14,6300296618
7307,439352953,59912,439412865,0,0,0,7680,29,5355044756
7308,439384494,1994,439386488,0,8,1,2048,21,7805249818
7309,439409484,4937,439414421,0,8,1,12800,21,9840288600
7310,439526670,92060,439618730,0,6,0,17408,14,643331875
7311,439585174,5971,439591145,0,2,1,14848,14,1016110750
7312,439625889,54056,439679945,0,8,0,3584,21,8814134060
7313,439682466,171481,439853947,0,2,0,101888,14,9397648905
7314,439732180,13512,439745692,0,4,1,26112,12,600922407
7315,439737747,13083,439750830,0,8,1,22016,21,680888596
7316,439762182,244699,440006881,0,2,0,214528,14,9438326906
7317,439793910,323655,440117565,0,4,0,345600,12,6886074346
7318,439812850,41120,439853970,0,2,1,35840,14,6123010915
7319,439827130,106952,439934082,0,8,0,2048,21,9673211091
7320,439828236,26745,439854981,0,2,1,1024,14,9590148217
7321,439866745,106652,439973397,0,0,0,50176,29,4221225479
7322,439928722,2946,439931668,0,4,1,3072,12,4348282954
7323,439941074,4937,439946011,0,4,1,12800,12,7093532626
7324,439966164,76052,440042216,0,1,0,10240,18,3681619362
7325,440065363,65964,440131327,0,4,1,26624,12,7466950388
7326,440080415,55748,440136163,0,8,0,4096,21,6085400465
7327,440152140,7230,440159370,0,8,1,7680,21,3847824209
7328,440186611,15579,440202190,0,8,1,30208,21,8727670775
7329,440401556,72380,440473936,0,0,0,13312,29,1561622063
7330,440406859,153201,440560060,0,0,0,134656,29,357074709
7331,440428724,84704,440513428,0,8,0,5632,21,1591743055
7332,440431463,7230,440438693,0,8,1,7680,21,412281661
7333,440451367,102284,440553651,0,6,0,35840,14,3671230177
7334,440456634,10241,440466875,0,8,1,16384,21,7073210687
7335,440523514,49275,440572789,0,0,1,24576,29,7733913081
7336,440756830,119132,440875962,0,6,0,91136,14,1597648959
7337,440915650,5454,440921104,0,2,1,13824,14,10196758244
7338,440965356,3898,440969254,0,2,1,4096,14,9217035197
7339,441007916,199172,441207088,0,4,0,192512,12,8586146158
7340,441073177,210404,441283581,0,2,0,229376,14,1218028925
7341,441141978,43904,441185882,0,8,0,512,21,8784743084
7342,441199452,130504,441329956,0,4,0,103424,12,4184301735
7343,441274381,4162,441278543,0,0,1,11264,29,6059909620
7344,441284541,566,441285107,0,4,1,512,12,7763323844
7345,441371857,117728,441489585,0,4,0,86528,12,3078848334
7346,441475363,76052,441551415,0,1,0,10240,18,737020839
7347,441491843,4850,441496693,0,4,1,5120,12,2681235592
7348,441539198,20624,441559822,0,0,1,33280,29,5299272146
7349,441558467,11016,441569483,0,4,1,17920,12,5896844034
7350,441625210,10757,441635967,0,4,1,17408,12,5496802669
7351,441659112,3128,441662240,0,2,1,9216,14,748782184
7352,441687445,3128,441690573,0,2,1,9216,14,1407659366
7353,441707377,54056,441761433,0,8,0,3584,21,7764049255
7354,441726534,15579,441742113,0,2,1,30208,14,482990117
7355,441749761,4937,441754698,0,2,1,12800,14,8757051853
7356,441783357,1994,441785351,0,2,1,2048,14,1646948528
7357,441818866,5196,441824062,0,2,1,13312,14,9198500731
7358,441824429,24154,441848583,0,8,1,43520,21,645731155
7359,441854479,257930,442112409,0,2,0,268288,14,4999293340
7360,441867042,4937,441871979,0,0,1,12800,29,9316895918
7361,441892440,11533,441903973,0,0,1,18944,29,619368076
7362,441953412,110240,442063652,0,4,0,61952,12,6806434466
7363,442038469,109772,442148241,0,0,0,60416,29,10438133343
7364,442061247,96353,442157600,0,4,0,28672,12,4660129730
7365,442114233,243263,442357496,0,4,0,223744,12,5132978737
7366,442117381,45596,442162977,0,8,0,1024,21,630852829
7367,442231966,4850,442236816,0,4,1,5120,12,1530161951
7368,442270369,1042,442271411,0,4,1,1024,12,1737778729
7369,442304976,76052,442381028,0,1,0,10240,18,1381863046
7370,442528376,89300,442617676,0,4,0,18432,12,7830427700
7371,442531020,59132,442590152,0,8,0,5120,21,10021106641
7372,442584137,11274,442595411,0,4,1,18432,12,3572486283
7373,442647657,5454,442653111,0,0,1,13824,29,4521825995
7374,442693838,10241,442704079,0,9,1,16384,45,5217145597
7375,442740534,1042,442741576,0,0,1,1024,29,7313730967
7376,442952153,13600,442965753,0,0,1,23040,29,2483966613
7377,443053520,200420,443253940,0,4,0,196608,12,7396897083
7378,443193001,1518,443194519,0,0,1,1536,29,6758576641
7379,443204411,177389,443381800,0,4,0,119808,12,1141035347
7380,443250309,45596,443295905,0,8,0,1024,21,4233716539
7381,443324962,168414,443493376,0,4,0,80384,12,1497909215
7382,443331911,10757,443342668,0,4,1,17408,12,271763992
7383,443396949,15062,443412011,0,4,1,29184,12,1973794967
7384,443449006,3904,443452910,0,4,1,10752,12,8204281137
7385,443461609,62516,443524125,0,8,0,6144,21,100367495
7386,443589378,64208,443653586,0,8,0,6656,21,6043755997
7387,443590656,4374,443595030,0,0,1,4608,29,2355266734
7388,443592228,125684,443717912,0,1,0,112640,18,4662201911
7389,443670430,3645,443674075,0,7,1,10240,40,1540500830
7390,443699446,118040,443817486,0,6,0,87552,14,3165800790
7391,443866262,47288,443913550,0,8,0,1536,21,1415850245
7392,443919796,3387,443923183,0,2,1,9728,14,10434263356
7393,443928140,2470,443930610,0,6,1,2560,14,9382060854
7394,443989451,3128,443992579,0,0,1,9216,29,5015067358
7395,444010641,128492,444139133,0,4,0,121856,12,2476274226
7396,444030714,297620,444328334,0,1,0,354304,18,1395436637
7397,444046484,12737,444059221,0,0,1,24576,29,1234421125
7398,444095665,2946,444098611,0,6,1,3072,14,5581827096
7399,444154715,101348,444256063,0,6,0,32768,14,2754809128
7400,444199486,11016,444210502,0,6,1,17920,14,8289710098
7401,444293760,110864,444404624,0,6,0,64000,14,528810311
7402,444410355,21141,444431496,0,6,1,34304,14,294355973
7403,444522163,106028,444628191,0,1,0,48128,18,4867897878
7404,444548325,15062,444563387,0,0,1,29184,29,10198790107
7405,444551757,99320,444651077,0,4,0,26112,12,6663803254
7406,444620250,67460,444687710,0,4,0,12288,12,9442004018
7407,444631187,100724,444731911,0,4,0,30720,12,4110294718
7408,444670429,295236,444965665,0,4,0,312832,12,3958870127
7409,444718165,289947,445008112,0,4,0,139264,12,7714431845
7410,444737719,294120,445031839,0,4,0,77824,12,4723813158
7411,444788743,106340,444895083,0,6,0,49152,14,3486366670
7412,444789780,288260,445078040,0,0,0,323584,29,340883785
7413,444828723,12049,444840772,0,0,1,19968,29,10473042124
7414,444854750,2870,444857620,0,9,1,8704,45,1989730581
7415,445038059,204476,445242535,0,4,0,209920,12,4486478489
7416,445059260,108836,445168096,0,6,0,57344,14,6996722854
7417,445075445,46491,445121936,0,0,0,512,29,4000760593
7418,445257085,35571,445292656,0,9,1,62464,45,5147629246
7419,445326080,196520,445522600,0,1,0,183808,18,1760376373
7420,445376065,160629,445536694,0,1,0,37376,18,5054339
7421,445439889,123188,445563077,0,2,0,104448,14,2721053952
7422,445477585,3898,445481483,0,6,1,4096,14,2567134172
7423,445501585,14804,445516389,0,6,1,28672,14,2457162585
7424,445518807,2470,445521277,0,9,1,2560,45,5585440641
7425,445631866,2870,445634736,0,9,1,8704,45,2773760530
7426,445765772,127244,445893016,0,2,0,117760,14,240751184
7427,445773696,196216,445969912,0,2,0,138240,14,6658796425
7428,445839759,50984,445890743,0,8,0,3584,21,9561751802
7429,445950343,85604,446035947,0,4,0,16384,12,635877753
7430,446070346,16613,446086959,0,1,1,32256,18,692220196
7431,446080762,185180,446265942,0,6,0,156672,14,5985679850
7432,446237948,24242,446262190,0,9,1,40448,45,5365064948
7433,446286864,81020,446367884,0,4,0,21504,12,3313572810
7434,446326479,45596,446372075,0,8,0,1024,21,5711099598
7435,446356254,48980,446405234,0,8,0,2048,21,9362102913
7436,446395135,5326,446400461,0,5,1,5632,20,6629142826
7437,446469372,125811,446595183,0,6,0,512,14,5913543531
7438,446474476,120536,446595012,0,6,0,95744,14,1196127692
7439,446660850,45596,446706446,0,0,0,1024,29,3785295741
7440,446866841,123188,446990029,0,6,0,104448,14,4847080196
7441,446965462,6229,446971691,0,8,1,15360,21,1295328251
7442,446978785,5196,446983981,0,2,1,13312,14,6502279839
7443,447147709,45596,447193305,0,0,0,1024,29,3679820721
7444,447175096,100724,447275820,0,6,0,30720,14,10416862232
7445,447196268,70976,447267244,0,0,0,8704,29,970769805
7446,447201355,566,447201921,0,9,1,512,45,8349666139
7447,447232747,84824,447317571,0,8,0,13824,21,4985602652
7448,447342863,121784,447464647,0,1,0,99840,18,9936910751
7449,447394871,22174,447417045,0,2,1,36352,14,2992698231
7450,447522305,3645,447525950,0,7,1,10240,40,6312609927
7451,447674802,6278,447681080,0,9,1,6656,45,8780567258
7452,447720349,4374,447724723,0,9,1,4608,45,4357951981
7453,447781918,11016,447792934,0,8,1,17920,21,9141593881
7454,447782880,3128,447786008,0,2,1,9216,14,5838204414
7455,447782954,158775,447941729,0,2,0,120320,14,10362669456
7456,447807248,43904,447851152,0,0,0,512,29,8115367617
7457,447807678,109148,447916826,0,1,0,58368,18,1930845601
7458,447829858,172791,448002649,0,8,0,512,21,9802227994
7459,447836672,2470,447839142,0,2,1,2560,14,1038460782
7460,447845445,45596,447891041,0,0,0,1024,29,5727654346
7461,447852672,12049,447864721,0,7,1,19968,40,10349064024
7462,447886763,122876,448009639,0,4,0,103424,12,5014962091
7463,447890342,4162,447894504,0,7,1,11264,40,2168626647
7464,447922088,216956,448139044,0,6,0,250880,14,9573813260
7465,447954750,4162,447958912,0,9,1,11264,45,2636428864
7466,448140795,14545,448155340,0,6,1,28160,14,5454531207
7467,448157532,7706,448165238,0,8,1,8192,21,1865507752
7468,448166908,13512,448180420,0,8,1,26112,21,377847564
7469,448185357,23208,448208565,0,8,1,38400,21,3857133450
7470,448228843,71659,448300502,0,8,0,8192,21,1870315461
7471,448247475,4162,448251637,0,5,1,11264,20,9765780499
7472,448250302,54212,448304514,0,8,0,4096,21,2158371678
7473,448275076,2870,448277946,0,4,1,8704,12,107916932
7474,448342742,13253,448355995,0,2,1,25600,14,3484268924
7475,448346640,1994,448348634,0,7,1,2048,40,6846877672
7476,448355778,11791,448367569,0,2,1,19456,14,3130459782
7477,448391993,1042,448393035,0,7,1,1024,40,5347637419
7478,448400159,3128,448403287,0,6,1,9216,14,962128988
7479,448410553,47288,448457841,0,3,0,1536,37,3409036864
7480,448414666,128648,448543314,0,1,0,122368,18,6789627037
7481,448495774,2946,448498720,0,2,1,3072,14,6962066159
7482,448541334,3387,448544721,0,8,1,9728,21,4853567103
7483,448587347,5326,448592673,0,6,1,5632,14,10644512650
7484,448632742,3898,448636640,0,4,1,4096,12,1937248192
7485,448639956,45596,448685552,0,3,0,1024,37,9772805417
7486,448649911,21658,448671569,0,4,1,35328,12,10446740220
7487,448658246,1518,448659764,0,2,1,1536,14,4226457685
7488,448686480,103064,448789544,0,1,0,38400,18,4263009509
7489,448707306,112112,448819418,0,6,0,68096,14,6826909412
7490,448779840,101972,448881812,0,2,0,34816,14,5011742581
7491,448782324,12049,448794373,0,2,1,19968,14,4698065487
7492,448789468,70532,448860000,0,4,0,12288,12,9738949708
7493,448826426,3422,448829848,0,8,1,3584,21,10276065710
7494,448850825,2870,448853695,0,5,1,8704,20,2121382660
7495,448895373,20624,448915997,0,2,1,33280,14,7511224532
7496,449021301,12049,449033350,0,4,1,19968,12,8165060261
7497,449025404,110240,449135644,0,6,0,61952,14,4462363241
7498,449045181,6488,449051669,0,6,1,15872,14,3364411325
7499,449047620,1042,449048662,0,8,1,1024,21,7502963104
7500,449090401,52364,449142765,0,8,0,3072,21,1358711113
7501,449204403,148860,449353263,0,6,0,67584,14,9920643681
7502,449253235,3422,449256657,0,5,1,3584,20,2391907848
7503,449272039,2946,449274985,0,6,1,3072,14,7216125363
7504,449339784,59132,449398916,0,3,0,5120,37,2143842726
7505,449343579,101972,449445551,0,1,0,34816,18,3044306849
7506,449358607,6754,449365361,0,6,1,7168,14,3798108896
7507,449451693,12995,449464688,0,6,1,25088,14,6706382916
7508,449499430,133570,449633000,0,6,0,71168,14,3110913399
7509,449521346,43904,449565250,0,3,0,512,37,6776458642
7510,449521965,4162,449526127,0,6,1,11264,14,3063617300
7511,449645428,6229,449651657,0,7,1,15360,40,5141032419
7512,449657433,3128,449660561,0,6,1,9216,14,5905298236
7513,449684197,13858,449698055,0,5,1,23552,20,8147350348
7514,449720036,2946,449722982,0,6,1,3072,14,6542441261
7515,449738419,61136,449799555,0,0,0,6656,29,8820813809
7516,449765333,54056,449819389,0,3,0,3584,37,10378099700
7517,449785844,189968,449975812,0,4,0,162304,12,9644296550
7518,449804789,107744,449912533,0,6,0,53760,14,10443517683
7519,449853429,5196,449858625,0,6,1,13312,14,2227647611
7520,449853889,50672,449904561,0,8,0,2560,21,7392376490
7521,449880365,1042,449881407,0,7,1,1024,40,1403317579
7522,449915208,11533,449926741,0,5,1,18944,20,4069913787
7523,450026052,47288,450073340,0,0,0,1536,29,10609280918
7524,450064494,11274,450075768,0,4,1,18432,12,1548286279
7525,450111251,49604,450160855,0,8,0,4096,21,7166145241
7526,450146204,3898,450150102,0,6,1,4096,14,9367828140
7527,450226150,33850,450260000,0,8,1,55808,21,8468452849
7528,450244643,4679,450249322,0,0,1,12288,29,5899716953
7529,450264653,15579,450280232,0,4,1,30208,12,5098201964
7530,450359801,47444,450407245,0,8,0,2048,21,2199078334
7531,450388834,2946,450391780,0,0,1,3072,29,3124177056
7532,450389135,294968,450684103,0,2,0,345600,14,10189058324
7533,450413993,191840,450605833,0,4,0,168448,12,1605447937
7534,450435141,5802,450440943,0,0,1,6144,29,623334446
7535,450442564,251145,450693709,0,4,0,157184,12,5721160024
7536,450461772,5454,450467226,0,4,1,13824,12,275797433
7537,450480471,120536,450601007,0,1,0,95744,18,7748388159
7538,450494490,59756,450554246,0,6,0,7168,14,6465292467
7539,450544755,1994,450546749,0,4,1,2048,12,2520000605
7540,450555089,4937,450560026,0,6,1,12800,14,6681021645
7541,450562905,6229,450569134,0,7,1,15360,40,2353584626
7542,450576893,3904,450580797,0,5,1,10752,20,9669547174
7543,450588006,5326,450593332,0,6,1,5632,14,3941437067
7544,450590212,26738,450616950,0,6,1,48640,14,9525584976
7545,450721958,13341,450735299,0,0,1,22528,29,7579309027
7546,450742951,7230,450750181,0,6,1,7680,14,1754507250
7547,450748269,15579,450763848,0,0,1,30208,29,1422478996
7548,450810139,96560,450906699,0,1,0,27136,18,7430993791
7549,450872399,1518,450873917,0,8,1,1536,21,6317907425
7550,450896834,189656,451086490,0,6,0,161280,14,3510846515
7551,450897486,5712,450903198,0,8,1,14336,21,10449245342
7552,450901789,6278,450908067,0,6,1,6656,14,859786339
7553,450959987,2946,450962933,0,6,1,3072,14,4785080328
7554,450965144,33591,450998735,0,5,1,55296,20,8333002608
7555,450979988,4162,450984150,0,8,1,11264,21,5263568464
7556,451068507,123032,451191539,0,2,0,103936,14,7396192229
7557,451165117,45596,451210713,0,0,0,1024,29,8511459820
7558,451174129,3898,451178027,0,6,1,4096,14,296024379
7559,451200382,50672,451251054,0,3,0,2560,37,8068231465
7560,451254904,3422,451258326,0,8,1,3584,21,5749198861
7561,451289966,566,451290532,0,9,1,512,45,1491154430
7562,451295140,66462,451361602,0,9,1,112640,45,9448610826
7563,451309784,4374,451314158,0,4,1,4608,12,4136942746
7564,451383015,70976,451453991,0,4,0,8704,12,98625034
7565,451384514,54524,451439038,0,0,0,5120,29,453571293
7566,451405871,11274,451417145,0,7,1,18432,40,5152471689
7567,451418680,111176,451529856,0,1,0,65024,18,4295657844
7568,451425249,15062,451440311,0,7,1,29184,40,4984715303
7569,451434114,107900,451542014,0,6,0,54272,14,289549431
7570,451442122,7230,451449352,0,4,1,7680,12,2479055033
7571,451452170,33503,451485673,0,0,1,58368,29,10339329543
7572,451500189,33503,451533692,0,9,1,58368,45,7078105096
7573,451578965,1518,451580483,0,9,1,1536,45,3120224227
7574,451635349,5196,451640545,0,6,1,13312,14,10132812894
7575,451784125,125060,451909185,0,1,0,110592,18,3948239611
7576,451789853,411454,452201307,0,1,0,279552,18,7466509192
7577,451851902,192721,452044623,0,1,0,160768,18,4886116056
7578,451898261,34108,451932369,0,6,1,56320,14,5402733748
7579,451906473,15837,451922310,0,0,1,30720,29,4102749483
7580,451959826,252728,452212554,0,1,0,36864,18,10519050367
7581,451967164,4374,451971538,0,7,1,4608,40,9950984877
7582,452011198,43904,452055102,0,3,0,512,37,6561573871
7583,452035383,48980,452084363,0,3,0,2048,37,723483713
7584,452051659,54056,452105715,0,3,0,3584,37,5618397793
7585,452065438,107900,452173338,0,4,0,54272,12,2653146736
7586,452105901,3898,452109799,0,6,1,4096,14,3489276565
7587,452157685,5712,452163397,0,8,1,14336,21,3671870154
7588,452185855,1518,452187373,0,5,1,1536,20,5760184439
7589,452341492,50672,452392164,0,6,0,2560,14,4650200105
7590,452343254,122408,452465662,0,4,0,101888,12,506207160
7591,452355197,13600,452368797,0,8,1,23040,21,3110953132
7592,452390789,2470,452393259,0,5,1,2560,20,10443338292
7593,452418197,202916,452621113,0,1,0,204800,18,3235414593
7594,452423072,22691,452445763,0,5,1,37376,20,2711287854
7595,452432466,13553,452446019,0,5,1,9216,20,6773536857
7596,452440681,260820,452701501,0,1,0,168960,18,8402897364
7597,452441744,29236,452470980,0,4,1,5632,12,8973551642
7598,452465773,83468,452549241,0,2,0,19456,14,4335919111
7599,452467048,2946,452469994,0,8,1,3072,21,4624238967
7600,452495372,49639,452545011,0,8,0,1024,21,3205367517
7601,452587847,5802,452593649,0,0,1,6144,29,8853025973
7602,452675212,22174,452697386,0,0,1,36352,29,3266887685
7603,452705836,109616,452815452,0,2,0,59904,14,10449569374
7604,452736161,15579,452751740,0,5,1,30208,20,3284139660
7605,452775632,54836,452830468,0,0,0,6144,29,4318744121
7606,452778003,295904,453073907,0,2,0,348672,14,9472002972
7607,452779981,109460,452889441,0,6,0,59392,14,3623119021
7608,452798247,134684,452932931,0,4,0,132096,12,2995202892
7609,452808702,10499,452819201,0,9,1,16896,45,7921586372
7610,452843857,48980,452892837,0,0,0,2048,29,7056293176
7611,452890429,21141,452911570,0,0,1,34304,29,2904743462
7612,452925205,66809,452992014,0,0,0,3072,29,5715567647
7613,452962835,60172,453023007,0,3,0,1024,37,8727685598
7614,452968257,13083,452981340,0,9,1,22016,45,5160384466
7615,452977411,52364,453029775,0,3,0,3072,37,4328754694
7616,453042985,10757,453053742,0,9,1,17408,45,8317837844
7617,453095734,7706,453103440,0,8,1,8192,21,5957273044
7618,453144743,6229,453150972,0,5,1,15360,20,3765274444
7619,453186134,5326,453191460,0,6,1,5632,14,2176501165
7620,453265198,1042,453266240,0,6,1,1024,14,3070522979
7621,453276880,47288,453324168,0,0,0,1536,29,7082691108
7622,453307050,43904,453350954,0,8,0,512,21,2246470262
7623,453309215,566,453309781,0,5,1,512,20,9950518830
7624,453321082,11533,453332615,0,5,1,18944,20,3844773780
7625,453327049,3898,453330947,0,6,1,4096,14,10421146444
7626,453357963,34795,453392758,0,8,1,60928,21,9906690840
7627,453358646,45596,453404242,0,4,0,1024,12,1714320133
7628,453370440,22779,453393219,0,8,1,10240,21,451210090
7629,453372706,48980,453421686,0,3,0,2048,37,10296349374
7630,453375518,3387,453378905,0,9,1,9728,45,535110053
7631,453390135,1042,453391177,0,9,1,1024,45,5493669788
7632,453428994,10757,453439751,0,7,1,17408,40,4299230931
7633,453441490,6754,453448244,0,5,1,7168,20,9912991929
7634,453458004,34108,453492112,0,6,1,56320,14,4114741548
7635,453463302,112892,453576194,0,9,0,70656,45,5185015833
7636,453476543,21368,453497911,0,6,1,27648,14,1463571717
7637,453503460,45596,453549056,0,8,0,1024,21,666767106
7638,453565524,102752,453668276,0,2,0,37376,14,7136936743
7639,453569638,131741,453701379,0,3,1,212992,37,3178285710
7640,453606079,125264,453731343,0,3,0,1536,37,6302665229
7641,453671787,14117,453685904,0,5,1,24064,20,9348947087
7642,453687516,69284,453756800,0,1,0,8192,18,1436142510
7643,453717422,43904,453761326,0,0,0,512,29,4367802276
7644,453825888,5802,453831690,0,7,1,6144,40,5733450148
7645,453854417,57440,453911857,0,8,0,4608,21,1642693866
7646,453953767,43904,453997671,0,8,0,512,21,3905820421
7647,454058407,45596,454104003,0,3,0,1024,37,2018299677
7648,454085075,48980,454134055,0,8,0,2048,21,6340044897
7649,454135891,13083,454148974,0,5,1,22016,20,5505752988
7650,454145247,97292,454242539,0,2,0,19456,14,5979533915
7651,454255147,566,454255713,0,2,1,512,14,7515412237
7652,454300828,48980,454349808,0,8,0,2048,21,10391634416
7653,454320281,105872,454426153,0,2,0,47616,14,6697233842
7654,454476451,23725,454500176,0,5,1,39424,20,7530313049
7655,454487775,123344,454611119,0,4,0,104960,12,10549297659
7656,454732420,257612,454990032,0,4,0,273408,12,1777241921
7657,454760332,50672,454811004,0,8,0,2560,21,7527231119
7658,454789657,283733,455073390,0,4,0,157696,12,2892012095
7659,454863258,110396,454973654,0,1,0,62464,18,7279323493
7660,454932711,47288,454979999,0,8,0,1536,21,3849366832
7661,455014094,52364,455066458,0,0,0,3072,29,4067917293
7662,455020301,3645,455023946,0,2,1,10240,14,8067086805
7663,455033085,23983,455057068,0,2,1,39936,14,4007970560
7664,455110033,5196,455115229,0,5,1,13312,20,968428406
7665,455110306,216644,455326950,0,1,0,249856,18,7077510689
7666,455178563,110708,455289271,0,4,0,63488,12,8938376128
7667,455207311,121784,455329095,0,2,0,99840,14,2684232048
7668,455213821,566,455214387,0,2,1,512,14,8948469525
7669,455270792,4374,455275166,0,2,1,4608,14,2888730270
7670,455330103,7230,455337333,0,5,1,7680,20,6924873604
7671,455534684,45596,455580280,0,0,0,1024,29,8173369027
7672,455583516,114608,455698124,0,1,0,76288,18,6705417110
7673,455643512,63234,455706746,0,1,0,7680,18,3776739734
7674,455655241,1042,455656283,0,5,1,1024,20,9507948412
7675,455699720,5802,455705522,0,8,1,6144,21,5117295459
7676,455765637,43904,455809541,0,3,0,512,37,7496515998
7677,456069264,13341,456082605,0,2,1,22528,14,7478469492
7678,456178422,245948,456424370,0,4,0,275456,12,5057155952
7679,456200387,54992,456255379,0,0,0,6656,29,9431457877
7680,456260858,193248,456454106,0,4,0,83456,12,6483001733
7681,456303348,54056,456357404,0,2,0,3584,14,666958485
7682,456383899,65900,456449799,0,1,0,7168,18,9151730446
7683,456451566,76520,456528086,0,0,0,11776,29,5885985834
7684,456468340,112268,456580608,0,4,0,68608,12,142220112
7685,456498386,176182,456674568,0,4,0,77312,12,2879783924
7686,456505641,50672,456556313,0,0,0,2560,29,7709196518
7687,456513159,93776,456606935,0,2,0,23040,14,146915440
7688,456529685,221283,456750968,0,1,0,130048,18,4228595278
7689,456547788,281351,456829139,0,1,0,256512,18,7793290670
7690,456593393,21916,456615309,0,2,1,35840,14,310346027
7691,456619983,7706,456627689,0,2,1,8192,14,5373141906
7692,456700557,52364,456752921,0,8,0,3072,21,1766903624
7693,456741800,45596,456787396,0,8,0,1024,21,4938508100
7694,456831198,2470,456833668,0,5,1,2560,20,3560688844
7695,456835575,106184,456941759,0,4,0,48640,12,4996870476
7696,456862210,100100,456962310,0,1,0,28672,18,6502734450
7697,456936214,3128,456939342,0,5,1,9216,20,7275243083
7698,456939441,113828,457053269,0,1,0,73728,18,2449671716
7699,457027572,3422,457030994,0,5,1,3584,20,9549650052
7700,457081723,112268,457193991,0,2,0,68608,14,8975136201
7701,457132687,47288,457179975,0,8,0,1536,21,6725826322
7702,457285102,76052,457361154,0,1,0,10240,18,5449844486
7703,457396531,10757,457407288,0,5,1,17408,20,8776249623
7704,457399552,12308,457411860,0,8,1,20480,21,7562457986
7705,457551198,122096,457673294,0,2,0,100864,14,4554102130
7706,457611692,43904,457655596,0,0,0,512,29,3282134366
7707,457643704,45596,457689300,0,8,0,1024,21,5260940139
7708,457646805,53219,457700024,0,2,1,48640,14,6731379903
7709,457655342,61916,457717258,0,0,0,9216,29,10225666068
7710,457767662,25962,457793624,0,8,1,47104,21,5166923819
7711,457800812,276404,458077216,0,4,0,284672,12,5039697620
7712,457903085,5971,457909056,0,8,1,14848,21,2824716474
7713,457905648,226216,458131864,0,4,0,164352,12,6652281229
7714,457929880,4420,457934300,0,5,1,11776,20,372887087
7715,457980997,4420,457985417,0,5,1,11776,20,5136795118
7716,457992797,257480,458250277,0,1,0,278016,18,7855550451
7717,458025057,57440,458082497,0,0,0,4608,29,5088570729
7718,458121081,45596,458166677,0,3,0,1024,37,7783054778
7719,458186109,61292,458247401,0,8,0,7168,21,1806168661
7720,458281553,12049,458293602,0,8,1,19968,21,8610051361
7721,458291298,43904,458335202,0,3,0,512,37,8659692966
7722,458414491,566,458415057,0,8,1,512,21,7261092457
7723,458425906,47288,458473194,0,3,0,1536,37,4023797663
7724,458437041,2470,458439511,0,8,1,2560,21,6574474788
7725,458457206,45596,458502802,0,8,0,1024,21,6799964631
7726,458503297,45596,458548893,0,8,0,1024,21,1837170993
7727,458512103,122876,458634979,0,2,0,103424,14,312931491
7728,458518434,47288,458565722,0,3,0,1536,37,10374026347
7729,458551969,54680,458606649,0,0,0,5632,29,9537183864
7730,458586344,158363,458744707,0,3,1,261632,37,7437290998
7731,458592160,566,458592726,0,8,1,512,21,499887015
7732,458643546,12308,458655854,0,2,1,20480,14,9881808971
7733,458671031,4420,458675451,0,2,1,11776,14,6417270538
7734,458709174,5712,458714886,0,8,1,14336,21,5168108843
7735,458722275,14029,458736304,0,0,1,27136,29,4404355456
7736,458731180,121316,458852496,0,4,0,98304,12,6341471269
7737,458854843,52520,458907363,0,8,0,3584,21,6393209079
7738,458900098,5326,458905424,0,8,1,5632,21,1499577873
7739,458971074,101192,459072266,0,2,0,32256,14,2431555680
7740,459221754,123344,459345098,0,1,0,104960,18,5584895054
7741,459297629,45596,459343225,0,8,0,1024,21,2328542920
7742,459330567,12049,459342616,0,2,1,19968,14,8015404079
7743,459362528,279992,459642520,0,4,0,296448,12,10388962853
7744,459405799,121784,459527583,0,1,0,99840,18,7254960767
7745,459456905,48980,459505885,0,8,0,2048,21,4765126698
7746,459510544,7230,459517774,0,2,1,7680,14,3967137721
7747,459547167,4850,459552017,0,0,1,5120,29,3616349732
7748,459549782,113501,459663283,0,4,0,68096,12,2055785665
7749,459758337,6278,459764615,0,8,1,6656,21,8912960173
7750,459809709,47288,459856997,0,8,0,1536,21,4045110678
7751,459812226,14117,459826343,0,0,1,24064,29,6932548579
7752,459817103,109148,459926251,0,1,0,58368,18,10235149217
7753,459822728,47288,459870016,0,0,0,1536,29,5085013681
7754,459835932,6278,459842210,0,3,1,6656,37,3533999999
7755,459898492,23895,459922387,0,8,1,43008,21,92329130
7756,459973868,1042,459974910,0,2,1,1024,14,4053752072
7757,459988745,117104,460105849,0,4,0,84480,12,1052632317
7758,460024577,7230,460031807,0,2,1,7680,14,3331740045
7759,460087649,10499,460098148,0,2,1,16896,14,1034486209
7760,460088427,10499,460098926,0,0,1,16896,29,4943448340
7761,460094418,6774,460101192,0,0,1,3584,29,4234925203
7762,460178250,45596,460223846,0,3,0,1024,37,7662286493
7763,460295844,45752,460341596,0,0,0,1536,29,7921155228
7764,460322584,43904,460366488,0,3,0,512,37,10416553649
7765,460327015,5326,460332341,0,0,1,5632,29,2957538178
7766,460348283,99788,460448071,0,4,0,27648,12,6562074765
7767,460399059,108496,460507555,0,4,0,54272,12,2593712560
7768,460429631,99320,460528951,0,2,0,26112,14,9561715797
7769,460505599,168524,460674123,0,1,0,142336,18,5866441508
7770,460520757,2870,460523627,0,0,1,8704,29,7305171553
7771,460737167,20624,460757791,0,2,1,33280,14,3679986992
7772,460763932,194960,460958892,0,2,0,178688,14,931344516
7773,460765968,130676,460896644,0,1,0,129024,18,8840396757
7774,460791568,45596,460837164,0,3,0,1024,37,6591211965
7775,460801961,45596,460847557,0,0,0,1024,29,7021752005
7776,460823902,4374,460828276,0,8,1,4608,21,8720985015
7777,461068546,26479,461095025,0,2,1,48128,14,2559719623
7778,461098210,101036,461199246,0,4,0,31744,12,3174003805
7779,461114786,56060,461170846,0,3,0,5120,37,2001932829
7780,461125666,43904,461169570,0,8,0,512,21,101105613
7781,461233222,33333,461266555,0,8,1,54784,21,5287278685
7782,461238702,5454,461244156,0,2,1,13824,14,4003404520
7783,461315417,51460,461366877,0,8,0,1024,21,1308393568
7784,461359872,1518,461361390,0,8,1,1536,21,2005957255
7785,461392679,3904,461396583,0,2,1,10752,14,1551108095
7786,461462150,278744,461740894,0,2,0,292352,14,9655408007
7787,461690315,63654,461753969,0,2,1,22016,14,3623862513
7788,461715240,108992,461824232,0,4,0,57856,12,4295235328
7789,461769050,2470,461771520,0,8,1,2560,21,2210282740
7790,461844678,3904,461848582,0,2,1,10752,14,6245938995
7791,461930650,2946,461933596,0,8,1,3072,21,7557051685
7792,462132150,120224,462252374,0,1,0,94720,18,6363812696
7793,462181932,103688,462285620,0,2,0,40448,14,18543478
7794,462216527,13253,462229780,0,2,1,25600,14,1958678550
7795,462447723,21141,462468864,0,8,1,34304,21,6619196507
7796,462500493,45596,462546089,0,0,0,1024,29,9595855255
7797,462526194,77744,462603938,0,0,0,10752,29,6370572736
7798,462543062,5802,462548864,0,2,1,6144,14,4173816197
7799,462562711,111956,462674667,0,4,0,67584,12,7029960498
7800,462574696,3422,462578118,0,2,1,3584,14,5122174349
7801,462635330,47288,462682618,0,0,0,1536,29,6752137350
7802,462827502,3422,462830924,0,1,1,3584,18,134867811
7803,462882036,3387,462885423,0,9,1,9728,45,8620281527
7804,462925426,47288,462972714,0,3,0,1536,37,4030549694
7805,462926529,54056,462980585,0,8,0,3584,21,4889161618
7806,462936647,44492,462981139,0,5,1,73216,20,9711592451
7807,462958368,45596,463003964,0,0,0,1024,29,640162092
7808,462992908,43904,463036812,0,8,0,512,21,760665702
7809,463016195,32987,463049182,0,4,1,57344,12,4177417416
7810,463041752,43904,463085656,0,0,0,512,29,7009084370
7811,463042140,180368,463222508,0,1,0,145920,18,194729123
7812,463101460,4374,463105834,0,4,1,4608,12,8004942759
7813,463161657,4937,463166594,0,4,1,12800,12,507558349
7814,463172091,21658,463193749,0,2,1,35328,14,6331558934
7815,463179680,234388,463414068,0,4,0,50688,12,9295253863
7816,463194448,182604,463377052,0,4,0,136192,12,535673474
7817,463201243,185953,463387196,0,1,0,144896,18,888132557
7818,463245287,201088,463446375,0,4,0,105984,12,4689594464
7819,463250040,153395,463403435,0,1,0,53248,18,1572715815
7820,463292328,66368,463358696,0,0,0,8704,29,6180684186
7821,463407433,4679,463412112,0,2,1,12288,14,3791947971
7822,463469824,4420,463474244,0,8,1,11776,21,6472579764
7823,463496331,45596,463541927,0,3,0,1024,37,1810721620
7824,463498257,23208,463521465,0,2,1,38400,14,6765795934
7825,463573506,47288,463620794,0,0,0,1536,29,7897828269
7826,463679352,3387,463682739,0,8,1,9728,21,5326159775
7827,463692976,4679,463697655,0,4,1,12288,12,9876469980
7828,463712385,50672,463763057,0,8,0,2560,21,1686513543
7829,463841885,45596,463887481,0,3,0,1024,37,8397897843
7830,463884400,3128,463887528,0,4,1,9216,12,4701737384
7831,463933843,2946,463936789,0,2,1,3072,14,8649897844
7832,463970681,13858,463984539,0,2,1,23552,14,1313505955
7833,464011020,1994,464013014,0,5,1,2048,20,8668089507
7834,464061602,3898,464065500,0,2,1,4096,14,764816283
7835,464125846,1994,464127840,0,5,1,2048,20,3670749473
7836,464130464,12308,464142772,0,8,1,20480,21,8673219169
7837,464158666,22862,464181528,0,4,1,40960,12,5630731958
7838,464161667,258484,464420151,0,4,0,193536,12,2363830986
7839,464237552,13600,464251152,0,8,1,23040,21,3116617482
7840,464238450,14804,464253254,0,1,1,28672,18,4247376153
7841,464298543,5712,464304255,0,4,1,14336,12,403557259
7842,464333958,127868,464461826,0,2,0,119808,14,6342220240
7843,464334797,225658,464560455,0,4,0,193024,12,6267764649
7844,464377868,50672,464428540,0,0,0,2560,29,4223427714
7845,464428867,43904,464472771,0,0,0,512,29,8436845691
7846,464438779,65900,464504679,0,1,0,7168,18,2845693937
7847,464474699,75178,464549877,0,1,0,8192,18,9549115612
7848,464481316,48980,464530296,0,3,0,2048,37,9398998700
7849,464515783,56684,464572467,0,8,0,7168,21,8565422804
7850,464547730,5802,464553532,0,2,1,6144,14,1683781666
7851,464551764,6278,464558042,0,1,1,6656,18,4292195962
7852,464569409,81128,464650537,0,4,0,11776,12,6391001605
7853,464604069,81284,464685353,0,2,0,12288,14,8779558149
7854,464608400,111933,464720333,0,2,0,36352,14,9642731018
7855,464610622,5802,464616424,0,1,1,6144,18,6690274142
7856,464745719,1994,464747713,0,4,1,2048,12,220656531
7857,464772894,4679,464777573,0,2,1,12288,14,8319809498
7858,464796956,50672,464847628,0,3,0,2560,37,1385547437
7859,464832324,3904,464836228,0,9,1,10752,45,7312010567
7860,464954060,52364,465006424,0,8,0,3072,21,10014822252
7861,464957656,12308,464969964,0,8,1,20480,21,23709213
7862,465073338,12825,465086163,0,8,1,21504,21,2208744102
7863,465087489,5971,465093460,0,8,1,14848,21,7047968656
7864,465162203,110240,465272443,0,1,0,61952,18,7551408286
7865,465180110,47288,465227398,0,0,0,1536,29,2387936329
7866,465188190,107770,465295960,0,8,0,3072,21,2939237793
7867,465194857,187316,465382173,0,2,0,153600,14,1345865435
7868,465207273,55904,465263177,0,0,0,4608,29,1232958687
7869,465312827,4679,465317506,0,2,1,12288,14,4926340351
7870,465315873,45596,465361469,0,8,0,1024,21,6173120314
7871,465325186,50672,465375858,0,3,0,2560,37,505366457
7872,465457333,45596,465502929,0,3,0,1024,37,2081587536
7873,465485466,4850,465490316,0,4,1,5120,12,8645232573
7874,465538731,101036,465639767,0,1,0,31744,18,6840151244
7875,465539616,48980,465588596,0,0,0,2048,29,8845699938
7876,465557085,54056,465611141,0,8,0,3584,21,2675702820
7877,465639845,5454,465645299,0,8,1,13824,21,6765695052
7878,465656079,4850,465660929,0,1,1,5120,18,6314365419
7879,465767765,33333,465801098,0,1,1,54784,18,5745253122
7880,465789939,3422,465793361,0,2,1,3584,14,2502630792
7881,465875315,566,465875881,0,1,1,512,18,3744532565
7882,465949604,45596,465995200,0,3,0,1024,37,5705927113
7883,465960746,48980,466009726,0,8,0,2048,21,339746600
7884,466043358,20624,466063982,0,1,1,33280,18,7145562932
7885,466143838,71132,466214970,0,3,0,9216,37,1189120431
7886,466150502,48980,466199482,0,8,0,2048,21,3674044932
7887,466155233,54056,466209289,0,0,0,3584,29,2846625582
7888,466281857,178232,466460089,0,4,0,148992,12,967558533
7889,466287272,43904,466331176,0,8,0,512,21,8641658190
7890,466332912,162007,466494919,0,4,0,35328,12,8593257325
7891,466349461,2470,466351931,0,2,1,2560,14,2199626230
7892,466401354,2470,466403824,0,8,1,2560,21,8868562457
7893,466411037,194492,466605529,0,2,0,177152,14,1872018284
7894,466419281,43904,466463185,0,0,0,512,29,9378534851
7895,466430280,108415,466538695,0,2,0,2048,14,1887517914
7896,466474394,112268,466586662,0,1,0,68608,18,2394808352
7897,466492215,164452,466656667,0,4,0,140288,12,926002212
7898,466497668,43904,466541572,0,8,0,512,21,7614094042
7899,466505741,3422,466509163,0,5,1,3584,20,1990076430
7900,466513681,14804,466528485,0,4,1,28672,12,4151341513
7901,466550586,43904,466594490,0,0,0,512,29,1565895531
7902,466594134,43904,466638038,0,0,0,512,29,8686521234
7903,466615514,479726,467095240,0,9,0,562688,45,7314321217
7904,466616219,46411,466662630,0,4,1,14848,12,4928607147
7905,466681231,218078,466899309,0,4,0,187904,12,7446424261
7906,466701395,60224,466761619,0,0,0,8704,29,6275200371
7907,466854345,66631,466920976,0,4,1,35328,12,366362966
7908,466883899,37743,466921642,0,4,1,1024,12,1635644940
7909,467010611,43904,467054515,0,0,0,512,29,1575754949
7910,467025359,71306,467096665,0,0,0,6656,29,9000103113
7911,467154866,3387,467158253,0,4,1,9728,12,408125118
7912,467225046,7230,467232276,0,5,1,7680,20,9181602895
7913,467253144,62516,467315660,0,0,0,6144,29,3789549442
7914,467357174,77744,467434918,0,1,0,10752,18,4206251839
7915,467419389,48980,467468369,0,8,0,2048,21,8511625457
7916,467522585,45596,467568181,0,3,0,1024,37,7269741013
7917,467609695,14029,467623724,0,5,1,27136,20,4105759571
7918,467677561,56372,467733933,0,0,0,6144,29,3285170359
7919,467700054,5454,467705508,0,4,1,13824,12,2418887018
7920,467739010,107900,467846910,0,2,0,54272,14,8030386305
7921,467739210,55748,467794958,0,0,0,4096,29,858512532
7922,467853638,530900,468384538,0,1,0,658944,18,4264005253
7923,467872297,11274,467883571,0,4,1,18432,12,3265897449
7924,467958858,432091,468390949,0,1,0,20992,18,7059559326
7925,468033104,1994,468035098,0,4,1,2048,12,8197459398
7926,468075984,12825,468088809,0,9,1,21504,45,6726280088
7927,468085941,13858,468099799,0,4,1,23552,12,2827463027
7928,468094846,1042,468095888,0,8,1,1024,21,591929353
7929,468101457,43904,468145361,0,3,0,512,37,9572041508
7930,468123557,6488,468130045,0,4,1,15872,12,10526267187
7931,468142174,12308,468154482,0,2,1,20480,14,4528595700
7932,468203117,48980,468252097,0,0,0,2048,29,5821965646
7933,468212818,3422,468216240,0,5,1,3584,20,7246248057
7934,468233915,103064,468336979,0,2,0,38400,14,1540564529
7935,468247330,67592,468314922,0,3,0,7680,37,9231784422
7936,468257099,4420,468261519,0,8,1,11776,21,8643737990
7937,468291453,3904,468295357,0,0,1,10752,29,6823368556
7938,468324181,191996,468516177,0,9,0,168960,45,8813410592
7939,468377881,3387,468381268,0,0,1,9728,29,5715488791
7940,468378362,3904,468382266,0,4,1,10752,12,211661615
7941,468391049,13341,468404390,0,0,1,22528,29,1841423935
7942,468398256,11274,468409530,0,8,1,18432,21,9508596347
7943,468482574,45596,468528170,0,0,0,1024,29,10116715230
7944,468629178,11791,468640969,0,0,1,19456,29,7141412335
7945,468701778,125060,468826838,0,2,0,110592,14,4684902811
7946,468726912,2870,468729782,0,2,1,8704,14,3236449702
7947,468739460,104000,468843460,0,1,0,41472,18,1260997702
7948,468742849,1994,468744843,0,0,1,2048,29,5383004304
7949,468750991,115232,468866223,0,9,0,78336,45,7027860041
7950,468758840,117260,468876100,0,4,0,84992,12,5008266115
7951,468843141,1994,468845135,0,8,1,2048,21,8118351446
7952,468848477,108130,468956607,0,9,0,22016,45,1364553989
7953,468864034,57440,468921474,0,1,0,4608,18,5129560786
7954,468890546,251312,469141858,0,1,0,272896,18,5824915340
7955,468907693,126437,469034130,0,3,1,209408,37,8540332828
7956,468940187,12308,468952495,0,2,1,20480,14,622068787
7957,468964615,208533,469173148,0,2,0,190976,14,2657230408
7958,469005376,5454,469010830,0,8,1,13824,21,2728849482
7959,469008624,46609,469055233,0,8,0,1024,21,9474003615
7960,469027696,189803,469217499,0,2,0,69120,14,8017270370
7961,469042582,43904,469086486,0,8,0,512,21,984917694
7962,469166737,6229,469172966,0,9,1,15360,45,1771694281
7963,469173605,13253,469186858,0,3,1,25600,37,9961257213
7964,469192230,2946,469195176,0,2,1,3072,14,5533801568
7965,469197702,20848,469218550,0,2,1,1024,14,3278607415
7966,469211012,10970,469221982,0,2,1,11264,14,9380815636
7967,469282752,177140,469459892,0,9,0,145408,45,6280726556
7968,469304067,22691,469326758,0,2,1,37376,14,3569621073
7969,469339337,490178,469829515,0,1,0,596992,18,1344646008
7970,469386652,391246,469777898,0,9,0,477184,45,8320027615
7971,469416629,26738,469443367,0,5,1,48640,20,1918990473
7972,469434380,31306,469465686,0,9,1,6144,45,6919150986
7973,469545593,111488,469657081,0,2,0,66048,14,813613181
7974,469617469,160444,469777913,0,9,1,37888,45,9518780058
7975,469637674,4374,469642048,0,0,1,4608,29,8238690876
7976,469657097,74360,469731457,0,4,0,9728,12,7775413030
7977,469667315,16354,469683669,0,2,1,31744,14,211707066
7978,469668001,509602,470177603,0,9,0,496640,45,355966159
7979,469674513,24154,469698667,0,7,1,43520,40,2051727055
7980,469702095,3904,469705999,0,0,1,10752,29,7132015865
7981,469759819,101882,469861701,0,3,1,164864,37,7026206475
7982,469802225,102943,469905168,0,3,0,1024,37,8320866706
7983,469848892,86828,469935720,0,4,0,15360,12,10397946007
7984,470047150,21399,470068549,0,0,1,34816,29,10695239016
7985,470055992,17703,470073695,0,0,1,8192,29,8487552343
7986,470077676,1042,470078718,0,0,1,1024,29,1076648756
7987,470101360,32299,470133659,0,2,1,52736,14,3551837546
7988,470119038,242852,470361890,0,4,0,270336,12,9900262191
7989,470198189,4374,470202563,0,9,1,4608,45,1490097295
7990,470211965,12308,470224273,0,9,1,20480,45,9296796256
7991,470229455,22174,470251629,0,7,1,36352,40,5758950028
7992,470252575,3422,470255997,0,0,1,3584,29,1631442345
7993,470272571,24242,470296813,0,9,1,40448,45,5402223838
7994,470282062,154076,470436138,0,2,0,140288,14,1019704179
7995,470307561,566,470308127,0,0,1,512,29,6476307936
7996,470333813,3422,470337235,0,9,1,3584,45,10587050199
7997,470333960,13302,470347262,0,9,1,20480,45,4478331742
7998,470347234,52832,470400066,0,8,0,4608,21,10234559829
7999,470350339,1518,470351857,0,2,1,1536,14,1657406847
8000,470463841,10757,470474598,0,9,1,17408,45,7389085575
8001,470504464,4850,470509314,0,2,1,5120,14,9512590250
8002,470504596,43904,470548500,0,3,0,512,37,9210396350
8003,470544356,4850,470549206,0,7,1,5120,40,9705420404
8004,470551016,150878,470701894,0,9,0,33792,45,9742343256
8005,470554060,3387,470557447,0,4,1,9728,12,3451126959
8006,470582335,3387,470585722,0,4,1,9728,12,3097012802
8007,470673841,5712,470679553,0,2,1,14336,14,1650919198
8008,470790372,12737,470803109,0,0,1,24576,29,7815072674
8009,470868274,110864,470979138,0,1,0,64000,18,2572043857
8010,470911647,207908,471119555,0,2,0,221184,14,2165119328
8011,470923520,47288,470970808,0,3,0,1536,37,779567548
8012,470957657,2946,470960603,0,9,1,3072,45,6906385259
8013,471011527,50672,471062199,0,8,0,2560,21,7823560984
8014,471015586,316357,471331943,0,2,0,295936,14,9571443027
8015,471050156,2946,471053102,0,9,1,3072,45,3782189611
8016,471132139,225106,471357245,0,2,0,13312,14,3303960629
8017,471145216,360346,471505562,0,3,1,588288,37,9525630414
8018,471152573,389893,471542466,0,3,1,127488,37,9235411885
8019,471173873,179301,471353174,0,2,0,69632,14,3628291186
8020,471257359,128648,471386007,0,9,0,122368,45,4090656373
8021,471273180,13083,471286263,0,7,1,22016,40,2611372783
8022,471327349,113516,471440865,0,4,0,72704,12,4428088239
8023,471356423,35871,471392294,0,9,1,6656,45,5119734582
8024,471359259,149485,471508744,0,9,0,102912,45,8900120563
8025,471376272,57440,471433712,0,8,0,4608,21,8918069523
8026,471434858,5454,471440312,0,0,1,13824,29,7610936773
8027,471452873,2946,471455819,0,2,1,3072,14,8699015647
8028,471455381,254252,471709633,0,1,0,277504,18,30123565
8029,471477936,37029,471514965,0,9,1,15360,45,1328236773
8030,471568812,45752,471614564,0,8,0,1536,21,2070491581
8031,471573885,32299,471606184,0,7,1,52736,40,2656488880
8032,471618302,1042,471619344,0,2,1,1024,14,7788586007
8033,471621284,3422,471624706,0,9,1,3584,45,698261448
8034,471639789,5326,471645115,0,7,1,5632,40,4958413892
8035,471677419,43904,471721323,0,3,0,512,37,2742986627
8036,471746259,4374,471750633,0,7,1,4608,40,405273585
8037,471788761,52520,471841281,0,3,0,3584,37,10486243189
8038,471790146,123812,471913958,0,4,0,106496,12,1507585831
8039,471836496,126776,471963272,0,1,0,116224,18,2975408647
8040,471892488,96579,471989067,0,3,1,161280,37,2068971201
8041,471929183,2870,471932053,0,2,1,8704,14,9617514838
8042,471938622,11016,471949638,0,9,1,17920,45,2821922974
8043,472000626,213524,472214150,0,2,0,239616,14,863364503
8044,472065280,201980,472267260,0,4,0,201728,12,5070831228
8045,472082857,60866,472143723,0,3,1,98304,37,4363712600
8046,472181949,106964,472288913,0,1,0,51200,18,489732232
8047,472205113,10241,472215354,0,7,1,16384,40,10416709603
8048,472224524,84668,472309192,0,9,0,13312,45,5534390373
8049,472236258,34279,472270537,0,7,1,59904,40,8667384768
8050,472296450,47288,472343738,0,8,0,1536,21,7870474893
8051,472331796,113672,472445468,0,2,0,73216,14,9633488489
8052,472387797,6278,472394075,0,7,1,6656,40,5817077695
8053,472393999,51484,472445483,0,2,1,55296,14,4476962746
8054,472420890,13512,472434402,0,9,1,26112,45,5021984600
8055,472445491,84475,472529966,0,3,1,137728,37,365328927
8056,472449458,164293,472613751,0,2,0,91648,14,3170025757
8057,472450406,358106,472808512,0,9,0,405504,45,8272506956
8058,472485062,1994,472487056,0,5,1,2048,20,7501572617
8059,472572063,6754,472578817,0,0,1,7168,29,1526447145
8060,472589368,7230,472596598,0,0,1,7680,29,9259903597
8061,472617401,263936,472881337,0,4,0,279040,12,6995268452
8062,472621627,85448,472707075,0,2,0,15872,14,7723286391
8063,472623468,57440,472680908,0,8,0,4608,21,9216571314
8064,472666485,4374,472670859,0,0,1,4608,29,1772622617
8065,472765934,107870,472873804,0,9,0,10240,45,10678577588
8066,472767233,45596,472812829,0,8,0,1024,21,333845496
8067,472795786,4679,472800465,0,2,1,12288,14,859468029
8068,472805990,112623,472918613,0,9,0,61440,45,2013230577
8069,472820786,2946,472823732,0,2,1,3072,14,2800980604
8070,472842037,142138,472984175,0,9,0,48640,45,535270886
8071,472847435,1518,472848953,0,2,1,1536,14,1176786190
8072,472894913,110864,473005777,0,2,0,64000,14,8752223119
8073,472917095,4420,472921515,0,2,1,11776,14,2839571116
8074,472936432,13600,472950032,0,8,1,23040,21,8651858367
8075,472947640,3645,472951285,0,9,1,10240,45,7152228457
8076,472947959,4374,472952333,0,5,1,4608,20,5002928709
8077,472957113,10241,472967354,0,5,1,16384,20,348686746
8078,472961897,1518,472963415,0,4,1,1536,12,4799964359
8079,472965698,1042,472966740,0,0,1,1024,29,195223210
8080,472979815,3387,472983202,0,0,1,9728,29,9464814727
8081,473004657,129116,473133773,0,9,0,123904,45,5045299324
8082,473027442,566,473028008,0,9,1,512,45,5034076127
8083,473038207,2946,473041153,0,4,1,3072,12,95006030
8084,473039705,1042,473040747,0,5,1,1024,20,9416541971
8085,473064325,5326,473069651,0,5,1,5632,20,8461726733
8086,473072724,47288,473120012,0,3,0,1536,37,500781085
8087,473114570,11274,473125844,0,8,1,18432,21,6691775193
8088,473149746,5196,473154942,0,4,1,13312,12,6592132930
8089,473197159,146038,473343197,0,4,0,117760,12,1393720929
8090,473287404,3422,473290826,0,9,1,3584,45,10045159912
8091,473317552,1042,473318594,0,2,1,1024,14,575456492
8092,473365420,566,473365986,0,5,1,512,20,8982997164
8093,473395861,5196,473401057,0,4,1,13312,12,2747192167
8094,473423385,518731,473942116,0,4,0,473600,12,6034718356
8095,473431663,4420,473436083,0,8,1,11776,21,4634573745
8096,473440611,5802,473446413,0,5,1,6144,20,5365107149
8097,473459526,10241,473469767,0,8,1,16384,21,3399530102
8098,473460892,22950,473483842,0,0,1,37888,29,2671421958
8099,473500538,32299,473532837,0,0,1,52736,29,5484988629
8100,473554546,10757,473565303,0,5,1,17408,20,5793018407
8101,473564883,2946,473567829,0,9,1,3072,45,2809412604
8102,473585031,200108,473785139,0,2,0,195584,14,10276472497
8103,473649323,23895,473673218,0,3,1,43008,37,7131171857
8104,473658662,25187,473683849,0,9,1,45568,45,2573924265
8105,473695668,152249,473847917,0,3,1,246272,37,7518624989
8106,473741713,290274,474031987,0,9,0,276480,45,3908152002
8107,473755668,25187,473780855,0,8,1,45568,21,10019465138
8108,473775739,14287,473790026,0,4,1,27648,12,5974513444
8109,473826916,244874,474071790,0,9,0,130560,45,8547033543
8110,473827064,12566,473839630,0,8,1,20992,21,6790594022
8111,473858591,2870,473861461,0,8,1,8704,21,5277575420
8112,473865551,87005,473952556,0,8,0,1536,21,3956802221
8113,473865944,276584,474142528,0,4,0,196608,12,5085141182
8114,473868966,25446,473894412,0,8,1,46080,21,4050686115
8115,473884441,99188,473983629,0,1,0,30720,18,4743257887
8116,473971401,11016,473982417,0,8,1,17920,21,2150700798
8117,474009386,132365,474141751,0,9,0,60416,45,6577979987
8118,474013798,4850,474018648,0,8,1,5120,21,3035872468
8119,474072457,13600,474086057,0,2,1,23040,14,5199957581
8120,474079923,57440,474137363,0,8,0,4608,21,9974241392
8121,474101774,91730,474193504,0,4,0,3584,12,9426607127
8122,474116040,4420,474120460,0,9,1,11776,45,5043077174
8123,474130175,5971,474136146,0,0,1,14848,29,9769663141
8124,474143676,1042,474144718,0,9,1,1024,45,672932575
8125,474189973,59132,474249105,0,8,0,5120,21,6103160846
8126,474226269,16354,474242623,0,8,1,31744,21,6433605704
8127,474232395,34344,474266739,0,8,1,49664,21,4975327100
8128,474337718,3387,474341105,0,0,1,9728,29,4297031705
8129,474338231,108212,474446443,0,1,0,55296,18,8126823186
8130,474447205,11274,474458479,0,0,1,18432,29,454164752
8131,474530520,566,474531086,0,0,1,512,29,3343550307
8132,474555984,121316,474677300,0,1,0,98304,18,6531972051
8133,474599492,6754,474606246,0,8,1,7168,21,10604574501
8134,474701483,11016,474712499,0,2,1,17920,14,3906236943
8135,474743829,52364,474796193,0,8,0,3072,21,9623863594
8136,474914318,118508,475032826,0,1,0,89088,18,10674871179
8137,474952503,11533,474964036,0,0,1,18944,29,5112965266
8138,474991411,45596,475037007,0,8,0,1024,21,10605224917
8139,475038610,128180,475166790,0,2,0,120832,14,8145219373
8140,475080492,4374,475084866,0,2,1,4608,14,6311699431
8141,475094844,47288,475142132,0,3,0,1536,37,7802699735
8142,475170035,72668,475242703,0,3,0,9216,37,5540347945
8143,475181807,12995,475194802,0,2,1,25088,14,246114205
8144,475220092,6754,475226846,0,5,1,7168,20,7164369438
8145,475319792,12049,475331841,0,1,1,19968,18,8791872230
8146,475474992,57440,475532432,0,8,0,4608,21,4719748778
8147,475488175,12308,475500483,0,2,1,20480,14,6390443249
8148,475562927,22691,475585618,0,2,1,37376,14,8190013219
8149,475574600,123407,475698007,0,9,0,13312,45,9260580504
8150,475589575,44060,475633635,0,3,0,1024,37,1855554239
8151,475596443,162779,475759222,0,9,0,128512,45,10284952160
8152,475608191,92972,475701163,0,3,0,15360,37,7770015229
8153,475612691,22862,475635553,0,1,1,40960,18,2111879025
8154,475671705,4937,475676642,0,1,1,12800,18,10037147255
8155,475766695,7230,475773925,0,2,1,7680,14,4180025487
8156,475782802,25187,475807989,0,9,1,45568,45,5520468401
8157,475799321,117572,475916893,0,3,0,86016,37,8893727836
8158,475801883,126725,475928608,0,3,0,38400,37,3828761372
8159,475817854,5196,475823050,0,8,1,13312,21,1012785993
8160,475873557,191938,476065495,0,9,0,91648,45,9429042013
8161,475914316,220788,476135104,0,3,0,216576,37,9703541668
8162,476000719,134712,476135431,0,9,0,21504,45,2338369018
8163,476006510,31783,476038293,0,1,1,51712,18,499679605
8164,476013967,191840,476205807,0,4,0,168448,12,1094843057
8165,476097702,1042,476098744,0,4,1,1024,12,4512625312
8166,476131554,118976,476250530,0,1,0,90624,18,9256356032
8167,476177660,110814,476288474,0,1,0,11264,18,7423707224
8168,476186756,30059,476216815,0,4,1,17920,12,4327264547
8169,476311630,142188,476453818,0,4,0,54784,12,8275607461
8170,476397300,79436,476476736,0,3,0,11264,37,9294544294
8171,476433538,119756,476553294,0,2,0,93184,14,3992328741
8172,476461731,115829,476577560,0,3,0,42496,37,2224014946
8173,476577364,22174,476599538,0,1,1,36352,18,4845357069
8174,476669053,125216,476794269,0,2,0,111104,14,4835735935
8175,476708444,1518,476709962,0,9,1,1536,45,2102695996
8176,476753741,105404,476859145,0,1,0,46080,18,3426034505
8177,476773007,36346,476809353,0,1,1,64000,18,10523241599
8178,476795363,1994,476797357,0,5,1,2048,20,390208327
8179,476810666,79436,476890102,0,8,0,11264,21,8800515357
8180,476854017,3898,476857915,0,2,1,4096,14,8664826702
8181,476870626,5196,476875822,0,1,1,13312,18,4732883387
8182,476915160,33245,476948405,0,3,1,57856,37,7711898475
8183,476974100,2470,476976570,0,5,1,2560,20,10324255301
8184,476991452,99164,477090616,0,9,0,25600,45,7356316349
8185,477022583,34537,477057120,0,9,1,60416,45,1251988700
8186,477113458,26738,477140196,0,4,1,48640,12,9598825730
8187,477155117,81116,477236233,0,3,1,131072,37,5967007107
8188,477171671,131300,477302971,0,1,0,131072,18,3781650288
8189,477208486,144450,477352936,0,3,1,234496,37,8480414789
8190,477223540,44233,477267773,0,2,1,72704,14,155544083
8191,477232016,7230,477239246,0,1,1,7680,18,669452942
8192,477248690,33591,477282281,0,4,1,55296,12,6871525246
8193,477249330,15062,477264392,0,5,1,29184,20,2678876947
8194,477257783,15033,477272816,0,5,1,28160,20,6975240530
8195,477413493,31524,477445017,0,3,1,51200,37,8467912847
8196,477425196,201849,477627045,0,3,0,68608,37,3279559492
8197,477438259,3898,477442157,0,1,1,4096,18,8230505710
8198,477500927,1994,477502921,0,2,1,2048,14,835725580
8199,477509717,87608,477597325,0,4,0,17920,12,4858802773
8200,477527294,3128,477530422,0,5,1,9216,20,1635672380
8201,477541910,1994,477543904,0,1,1,2048,18,1689707901
8202,477629605,24154,477653759,0,5,1,43520,20,10211587604
8203,477651365,2870,477654235,0,2,1,8704,14,7042196492
8204,477703099,124748,477827847,0,3,0,109568,37,9470522084
8205,477717042,113984,477831026,0,2,0,74240,14,7420480993
8206,477719877,3422,477723299,0,4,1,3584,12,5111677563
8207,477744675,5326,477750001,0,9,1,5632,45,4189603342
8208,477822810,13404,477836214,0,2,1,13312,14,2232495769
8209,477832667,123344,477956011,0,3,0,104960,37,5964396875
8210,477836379,5802,477842181,0,5,1,6144,20,3499185675
8211,477868480,246243,478114723,0,3,0,230400,37,10084013192
8212,477868657,208696,478077353,0,2,0,160256,14,7726180616
8213,477893436,55748,477949184,0,8,0,4096,21,8140972045
8214,477951832,7230,477959062,0,9,1,7680,45,8101420128
8215,477952694,5971,477958665,0,4,1,14848,12,7819355246
8216,477996364,11016,478007380,0,1,1,17920,18,6133961246
8217,478092398,75554,478167952,0,3,1,90112,37,3879243609
8218,478137156,118352,478255508,0,9,0,88576,45,9397799737
8219,478159722,105154,478264876,0,3,1,174592,37,2179646976
8220,478223352,13253,478236605,0,4,1,25600,12,7492415408
8221,478269838,13341,478283179,0,2,1,22528,14,8598263143
8222,478300164,357762,478657926,0,3,1,583168,37,2056508695
8223,478358447,89300,478447747,0,1,0,18432,18,4266302755
8224,478378908,4679,478383587,0,0,1,12288,29,10063323495
8225,478380943,14117,478395060,0,9,1,24064,45,8580150379
8226,478421341,7706,478429047,0,2,1,8192,14,7705678303
8227,478435128,4850,478439978,0,2,1,5120,14,10012040132
8228,478595692,176696,478772388,0,2,0,148992,14,8875858803
8229,478615365,240692,478856057,0,1,0,268288,18,7587668963
8230,478673882,6229,478680111,0,4,1,15360,12,4892801574
8231,478715143,11274,478726417,0,1,1,18432,18,3439124225
8232,478810904,54056,478864960,0,9,0,3584,45,4040376576
8233,478831634,80060,478911694,0,3,0,13312,37,3738778331
8234,478836855,3387,478840242,0,2,1,9728,14,492714471
8235,478860753,322805,479183558,0,2,0,342016,14,3392379321
8236,479044153,7706,479051859,0,2,1,8192,14,8675462620
8237,479131251,107291,479238542,0,2,0,6656,14,10088137493
8238,479138935,7706,479146641,0,9,1,8192,45,6758250811
8239,479196630,22691,479219321,0,9,1,37376,45,4788715547
8240,479309503,20624,479330127,0,7,1,33280,40,10671410927
8241,479333851,566,479334417,0,1,1,512,18,6665054164
8242,479394638,7230,479401868,0,4,1,7680,12,3962915507
8243,479425817,47288,479473105,0,8,0,1536,21,1930638514
8244,479467964,118664,479586628,0,3,0,89600,37,81279558
8245,479475495,47288,479522783,0,8,0,1536,21,9147062059
8246,479534705,99944,479634649,0,1,0,28160,18,8268048590
8247,479561141,45596,479606737,0,8,0,1024,21,4869816914
8248,479600814,202136,479802950,0,3,0,202240,37,2261045063
8249,479836802,1994,479838796,0,2,1,2048,14,2029422707
8250,479881420,380000,480261420,0,3,0,463360,37,8094732266
8251,479930755,12566,479943321,0,5,1,20992,20,624196942
8252,479970254,3898,479974152,0,1,1,4096,18,6902754993
8253,480050911,1994,480052905,0,7,1,2048,40,8014841134
8254,480077775,3645,480081420,0,5,1,10240,20,3632364817
8255,480090654,16613,480107267,0,5,1,32256,20,7143025217
8256,480106531,41649,480148180,0,2,1,67584,14,4675234451
8257,480149261,105092,480254353,0,2,0,45056,14,3078995227
8258,480201405,127868,480329273,0,9,0,119808,45,3852132613
8259,480209440,23378,480232818,0,1,1,41984,18,5570395119
8260,480222771,15837,480238608,0,5,1,30720,20,4217394037
8261,480240050,2870,480242920,0,1,1,8704,18,8319190378
8262,480250638,2470,480253108,0,7,1,2560,40,318082170
8263,480291462,209312,480500774,0,3,0,225792,37,3191297133
8264,480330323,26738,480357061,0,2,1,48640,14,5771017955
8265,480356843,47288,480404131,0,8,0,1536,21,1255438442
8266,480358668,329996,480688664,0,3,0,291840,37,8296993430
8267,480445159,23466,480468625,0,7,1,38912,40,2076746385
8268,480535677,45596,480581273,0,8,0,1024,21,10658347056
8269,480572626,23725,480596351,0,3,1,39424,37,4210218426
8270,480593985,1042,480595027,0,1,1,1024,18,497402060
8271,480623041,1518,480624559,0,1,1,1536,18,10183372242
8272,480736520,207908,480944428,0,3,0,221184,37,10417045279
8273,480803674,6754,480810428,0,1,1,7168,18,334180231
8274,480811140,225878,481037018,0,3,1,369664,37,2776059887
8275,480823850,5971,480829821,0,5,1,14848,20,3588408573
8276,480925961,10499,480936460,0,1,1,16896,18,6435637725
8277,480951016,21399,480972415,0,5,1,34816,20,5773039508
8278,481076300,314762,481391062,0,3,0,169984,37,2110047689
8279,481108190,3128,481111318,0,5,1,9216,20,217623423
8280,481136509,107307,481243816,0,3,0,25600,37,9161617845
8281,481159700,4850,481164550,0,1,1,5120,18,6408723723
8282,481164483,129272,481293755,0,2,0,124416,14,3946196030
8283,481240869,79436,481320305,0,9,0,11264,45,4016432289
8284,481251176,7230,481258406,0,5,1,7680,20,1010791216
8285,481407993,163316,481571309,0,1,0,145408,18,8785724330
8286,481492630,247679,481740309,0,3,1,405504,37,1878600493
8287,481521298,4850,481526148,0,5,1,5120,20,2502626173
8288,481530950,171208,481702158,0,1,0,129536,18,8226245128
8289,481540765,306106,481846871,0,1,0,230400,18,5618444897
8290,481607179,200525,481807704,0,3,1,216064,37,10307830107
8291,481631438,111800,481743238,0,2,0,67072,14,4101373870
8292,481651695,50478,481702173,0,1,1,44544,18,9830333198
8293,481653051,155524,481808575,0,3,1,12288,37,4049381912
8294,481693028,45596,481738624,0,8,0,1024,21,10301439624
8295,481724323,379833,482104156,0,3,0,158208,37,6459191257
8296,481791669,28657,481820326,0,3,1,48128,37,5684698591
8297,481810249,146528,481956777,0,2,0,135680,14,7242664318
8298,481865038,12566,481877604,0,3,1,20992,37,6105640462
8299,481872156,6114,481878270,0,3,1,11264,37,2328066530
8300,481992521,1042,481993563,0,1,1,1024,18,5754120769
8301,482041266,4850,482046116,0,3,1,5120,37,9891589237
8302,482044233,144892,482189125,0,1,0,119808,18,4288914747
8303,482061257,145590,482206847,0,1,0,20992,18,9703751583
8304,482074007,36895,482110902,0,3,1,7168,37,184881618
8305,482115326,156548,482271874,0,2,0,143360,14,8019601266
8306,482136725,43904,482180629,0,8,0,512,21,6342390437
8307,482148616,47288,482195904,0,8,0,1536,21,5029244053
8308,482386569,21916,482408485,0,9,1,35840,45,8347627944
8309,482468630,108126,482576756,0,9,0,54272,45,9515263020
8310,482472897,99476,482572373,0,2,0,26624,14,5809517391
8311,482516219,60552,482576771,0,9,1,96768,45,1417487167
8312,482556835,140829,482697664,0,9,0,36352,45,1849670183
8313,482677692,126932,482804624,0,3,0,116736,37,10611106586
8314,482707772,165216,482872988,0,9,1,268288,45,9420808948
8315,482775509,31994,482807503,0,3,1,8704,37,189881007
8316,482803614,278835,483082449,0,3,0,289280,37,4499503953
8317,482814314,418083,483232397,0,9,1,677376,45,9094975409
8318,482845905,59132,482905037,0,8,0,5120,21,1488133555
8319,482981767,3422,482985189,0,5,1,3584,20,10565586197
8320,483095324,142974,483238298,0,9,1,28160,45,6265626148
8321,483113865,23983,483137848,0,5,1,39936,20,7915183724
8322,483497633,13512,483511145,0,3,1,26112,37,10679226329
8323,483543580,128804,483672384,0,2,0,122880,14,8640430667
8324,483563576,107900,483671476,0,9,0,54272,45,5863684697
8325,483763917,233924,483997841,0,2,0,266240,14,10326587152
8326,483909962,50672,483960634,0,3,0,2560,37,1680214066
8327,483939310,60824,484000134,0,8,0,5632,21,7465216012
8328,483941597,47288,483988885,0,8,0,1536,21,2688152486
8329,484190360,109460,484299820,0,2,0,59392,14,8009319836
8330,484320970,204476,484525446,0,3,0,209920,37,7475676271
8331,484364510,13512,484378022,0,5,1,26112,20,8003476933
8332,484401735,126932,484528667,0,2,0,116736,14,3572246349
8333,484480968,5454,484486422,0,5,1,13824,20,8621238899
8334,484560975,195428,484756403,0,1,0,180224,18,8854761007
8335,484573879,208844,484782723,0,3,0,224256,37,3493376017
8336,484751793,35342,484787135,0,3,1,11776,37,8434968688
8337,484802707,23466,484826173,0,9,1,38912,45,5018623056
8338,485024161,104624,485128785,0,3,0,43520,37,731109307
8339,485036044,265004,485301048,0,2,0,277504,14,605237340
8340,485039927,1042,485040969,0,4,1,1024,12,1214135682
8341,485080632,5196,485085828,0,3,1,13312,37,9533066849
8342,485165707,201824,485367531,0,9,0,201216,45,7825206060
8343,485284751,82795,485367546,0,9,1,104448,45,3958593133
8344,485316833,1042,485317875,0,5,1,1024,20,6918609338
8345,485345831,107432,485453263,0,2,0,52736,14,8283562043
8346,485365388,248539,485613927,0,9,0,26624,45,911791486
8347,485426272,116571,485542843,0,9,1,193536,45,9759936909
8348,485450189,1518,485451707,0,5,1,1536,20,4017110507
8349,485512306,116829,485629135,0,9,1,194048,45,2229042643
8350,485532695,43904,485576599,0,8,0,512,21,9479989530
8351,485552924,1518,485554442,0,4,1,1536,12,2871154388
8352,485591288,122252,485713540,0,1,0,101376,18,2524999461
8353,485704574,6754,485711328,0,9,1,7168,45,2346794460
8354,485759260,4937,485764197,0,3,1,12800,37,9104735372
8355,485811791,15321,485827112,0,1,1,29696,18,7333888022
8356,485842457,5326,485847783,0,3,1,5632,37,6341142402
8357,485845135,5802,485850937,0,4,1,6144,12,6189108552
8358,485882202,313718,486195920,0,1,0,340480,18,1834534133
8359,485912809,131815,486044624,0,3,0,85504,37,901037351
8360,485948934,90392,486039326,0,2,0,22016,14,4079062851
8361,485951273,189339,486140612,0,2,0,126464,14,3065009609
8362,485987777,3904,485991681,0,1,1,10752,18,3875042456
8363,486089379,3128,486092507,0,4,1,9216,12,6668012612
8364,486113599,131999,486245598,0,9,1,213504,45,8806209966
8365,486115005,82901,486197906,0,1,1,2048,18,1415868984
8366,486169147,3128,486172275,0,5,1,9216,20,5008971523
8367,486187558,316279,486503837,0,9,0,114176,45,2057721599
8368,486189477,11533,486201010,0,4,1,18944,12,7235323436
8369,486253712,2870,486256582,0,5,1,8704,20,874976487
8370,486311289,112736,486424025,0,2,0,70144,14,7021706336
8371,486610983,5712,486616695,0,5,1,14336,20,3654456528
8372,486625225,105092,486730317,0,1,0,45056,18,8581173953
8373,486673213,7706,486680919,0,4,1,8192,12,1976824472
8374,486698579,105248,486803827,0,1,0,45568,18,6577209335
8375,486881181,24670,486905851,0,5,1,44544,20,180222631
8376,486951804,5971,486957775,0,4,1,14848,12,3572282649
8377,486971819,12737,486984556,0,3,1,24576,37,9986749249
8378,487182094,5196,487187290,0,3,1,13312,37,833293500
8379,487188679,51296,487239975,0,0,0,4608,29,7278771769
8380,487281929,179036,487460965,0,1,0,156672,18,6297891427
8381,487321659,41649,487363308,0,4,1,67584,12,5504509955
8382,487460557,21399,487481956,0,4,1,34816,12,2681490998
8383,487882730,7706,487890436,0,4,1,8192,12,10160549073
8384,488039543,13253,488052796,0,5,1,25600,20,5047276565
8385,488121228,5802,488127030,0,3,1,6144,37,4933710077
8386,488122880,111176,488234056,0,1,0,65024,18,7941888879
8387,488190423,11016,488201439,0,3,1,17920,37,906521247
8388,488205378,109928,488315306,0,2,0,60928,14,3610460055
8389,488265447,5196,488270643,0,7,1,13312,40,7737897802
8390,488292013,169484,488461497,0,9,0,150528,45,2361204814
8391,488318993,4374,488323367,0,5,1,4608,20,992046372
8392,488346773,3904,488350677,0,7,1,10752,40,8431889627
8393,488442640,119261,488561901,0,9,0,29696,45,10171642283
8394,488560508,316244,488876752,0,2,0,395264,14,1596049685
8395,488565230,95492,488660722,0,3,0,28672,37,3650896452
8396,488628094,2946,488631040,0,8,1,3072,21,6265335707
8397,488780333,109148,488889481,0,9,0,58368,45,9172820243
8398,488809002,68784,488877786,0,2,1,1024,14,3541518053
8399,488821794,13858,488835652,0,3,1,23552,37,5432128250
8400,488929936,115388,489045324,0,3,0,78848,37,711382100
8401,488945260,402026,489347286,0,2,0,468992,14,10011132635
8402,489030567,26221,489056788,0,5,1,47616,20,4881764903
8403,489031754,3898,489035652,0,2,1,4096,14,5662829487
8404,489132898,4374,489137272,0,5,1,4608,20,9044273840
8405,489158134,2470,489160604,0,3,1,2560,37,9551776423
8406,489180546,6278,489186824,0,8,1,6656,21,2243732608
8407,489307390,45596,489352986,0,8,0,1024,21,866427937
8408,489362505,112112,489474617,0,3,0,68096,37,6401955708
8409,489376527,25704,489402231,0,8,1,46592,21,10021621430
8410,489385699,28798,489414497,0,8,1,39424,21,5137567102
8411,489416499,7706,489424205,0,2,1,8192,14,2586694035
8412,489422170,54056,489476226,0,1,0,3584,18,4292569968
8413,489462621,76052,489538673,0,1,0,10240,18,7178396516
8414,489466053,45596,489511649,0,8,0,1024,21,2455097678
8415,489495319,26479,489521798,0,2,1,48128,14,9006388842
8416,489545400,217562,489762962,0,9,1,356864,45,9994754139
8417,489567840,12737,489580577,0,5,1,24576,20,2589916344
8418,489593127,22691,489615818,0,2,1,37376,14,2975691550
8419,489661767,20624,489682391,0,5,1,33280,20,1372810987
8420,489717891,461827,490179718,0,9,0,351232,45,3945028617
8421,489782481,40874,489823355,0,9,1,66048,45,5680771212
8422,489788333,53144,489841477,0,1,0,5632,18,268968603
8423,489872811,4850,489877661,0,5,1,5120,20,6521743993
8424,489911081,12566,489923647,0,3,1,20992,37,6340332674
8425,489966806,4162,489970968,0,3,1,11264,37,2861549619
8426,490026955,5802,490032757,0,3,1,6144,37,5269141781
8427,490097532,12995,490110527,0,2,1,25088,14,7451024379
8428,490191673,7706,490199379,0,5,1,8192,20,2333752257
8429,490250567,566,490251133,0,8,1,512,21,2812317965
8430,490304044,14287,490318331,0,8,1,27648,21,3113131698
8431,490311971,1518,490313489,0,2,1,1536,14,5443534434
8432,490469124,1518,490470642,0,8,1,1536,21,10089683518
8433,490472414,217892,490690306,0,1,0,253952,18,55063522
8434,490482191,20366,490502557,0,3,1,32768,37,6144407578
8435,490483441,24929,490508370,0,9,1,45056,45,3634074012
8436,490497727,4162,490501889,0,8,1,11264,21,275657494
8437,490697649,199796,490897445,0,1,0,194560,18,482461626
8438,490796688,6229,490802917,0,8,1,15360,21,6558614427
8439,490814833,2946,490817779,0,5,1,3072,20,3627458284
8440,490832690,2470,490835160,0,8,1,2560,21,10389379032
8441,490907281,5326,490912607,0,3,1,5632,37,10566424540
8442,491090296,93737,491184033,0,9,1,155648,45,5988517822
8443,491097063,3904,491100967,0,5,1,10752,20,9880149760
8444,491119637,166948,491286585,0,9,0,31232,45,482860354
8445,491123203,282488,491405691,0,3,0,304640,37,2778586935
8446,491196323,104156,491300479,0,1,0,41984,18,3378623618
8447,491212212,196302,491408514,0,3,0,9216,37,425058184
8448,491226250,46988,491273238,0,9,1,81408,45,3884272300
8449,491262507,3645,491266152,0,3,1,10240,37,4593582778
8450,491369653,144620,491514273,0,9,1,238080,45,6415760666
8451,491375696,36214,491411910,0,3,1,9728,37,94238288
8452,491395251,105092,491500343,0,2,0,45056,14,5554919007
8453,491401940,67415,491469355,0,3,0,5632,37,2539783374
8454,491591152,4162,491595314,0,8,1,11264,21,7636635347
8455,491753717,4850,491758567,0,3,1,5120,37,885062145
8456,491796760,187708,491984468,0,3,0,20992,37,9424191535
8457,491814697,53144,491867841,0,8,0,5632,21,3069060697
8458,491900389,285140,492185529,0,1,0,313344,18,8841181835
8459,491932656,71600,492004256,0,8,0,10752,21,4417749997
8460,492040330,192152,492232482,0,2,0,169472,14,4619863956
8461,492123339,57440,492180779,0,9,0,4608,45,2451082051
8462,492127995,4162,492132157,0,3,1,11264,37,9306646833
8463,492242819,44060,492286879,0,8,0,1024,21,8975028667
8464,492346993,54056,492401049,0,2,0,3584,14,10573869193
8465,492351918,50672,492402590,0,9,0,2560,45,9856822707
8466,492460006,26738,492486744,0,3,1,48640,37,9282940923
8467,492528486,11791,492540277,0,3,1,19456,37,9090741896
8468,492654654,45596,492700250,0,8,0,1024,21,10423801636
8469,492661758,2946,492664704,0,3,1,3072,37,5157752701
8470,492828359,82688,492911047,0,2,0,16896,14,2710641416
8471,492856818,11533,492868351,0,3,1,18944,37,5059812625
8472,492917046,105404,493022450,0,1,0,46080,18,3743825555
8473,493013261,4679,493017940,0,3,1,12288,37,5049163801
8474,493113483,98852,493212335,0,1,0,24576,18,2526311103
8475,493151307,6488,493157795,0,0,1,15872,29,542509509
8476,493194330,101660,493295990,0,1,0,33792,18,4518731087
8477,493236551,45596,493282147,0,9,0,1024,45,2360815743
8478,493264707,65900,493330607,0,9,0,7168,45,4252484484
8479,493285968,3645,493289613,0,3,1,10240,37,7070684537
8480,493345831,3904,493349735,0,3,1,10752,37,10254365768
8481,493398852,129740,493528592,0,1,0,125952,18,397625739
8482,493524603,57440,493582043,0,8,0,4608,21,1431414763
8483,493623775,4850,493628625,0,0,1,5120,29,6239315211
8484,493779908,120692,493900600,0,1,0,96256,18,6423765644
8485,493811245,4374,493815619,0,3,1,4608,37,3140520432
8486,493835788,248094,494083882,0,3,0,215552,37,5825904140
8487,493895336,22691,493918027,0,0,1,37376,29,8141107242
8488,493974928,5196,493980124,0,0,1,13312,29,2018473103
8489,494042009,152105,494194114,0,3,0,61952,37,4237046925
8490,494256586,21399,494277985,0,4,1,34816,12,3541497669
8491,494403069,22174,494425243,0,4,1,36352,12,260983597
8492,494441251,14545,494455796,0,0,1,28160,29,4325387429
8493,494522139,48980,494571119,0,8,0,2048,21,7325652331
8494,494632948,54056,494687004,0,8,0,3584,21,950878128
8495,494671628,109148,494780776,0,3,0,58368,37,3151295659
8496,494718372,165475,494883847,0,4,1,268800,12,5657710412
8497,494721973,2470,494724443,0,0,1,2560,29,7052389270
8498,494741251,109148,494850399,0,3,0,58368,37,1060939662
8499,494825759,277184,495102943,0,3,0,287232,37,7238811673
8500,494833062,109928,494942990,0,2,0,60928,14,840317175
8501,494966088,288884,495254972,0,1,0,325632,18,373292043
8502,494969577,56216,495025793,0,8,0,5632,21,6402094010
8503,494982493,12825,494995318,0,4,1,21504,12,1813629116
8504,495031289,45596,495076885,0,8,0,1024,21,2582012468
8505,495083005,48980,495131985,0,9,0,2048,45,8837963380
8506,495085049,52364,495137413,0,9,0,3072,45,2872727877
8507,495233383,138685,495372068,0,1,0,84480,18,8255028457
8508,495322289,6229,495328518,0,4,1,15360,12,3991289385
8509,495327234,23208,495350442,0,3,1,38400,37,8948834294
8510,495348858,35054,495383912,0,4,1,61440,12,3545450063
8511,495353194,67592,495420786,0,3,0,7680,37,9525773118
8512,495367875,21938,495389813,0,4,1,28160,12,8917887288
8513,495386402,74867,495461269,0,4,1,122368,12,6574805517
8514,495408176,24242,495432418,0,3,1,40448,37,2298986407
8515,495420313,114140,495534453,0,2,0,74752,14,7375174076
8516,495429347,72824,495502171,0,9,0,9728,45,4570292445
8517,495452713,71756,495524469,0,8,0,11264,21,5889822669
8518,495471038,24412,495495450,0,3,1,44032,37,6445743566
8519,495543879,56216,495600095,0,8,0,5632,21,3124719383
8520,495602237,70976,495673213,0,8,0,8704,21,7838916555
8521,495738664,97448,495836112,0,3,0,19968,37,4757262072
8522,495762659,2470,495765129,0,3,1,2560,37,2906109959
8523,495809493,23120,495832613,0,0,1,41472,29,8471398410
8524,495942253,73833,496016086,0,4,1,120320,12,9055378149
8525,495978816,178988,496157804,0,1,0,146432,18,4820382012
8526,495980471,99788,496080259,0,3,0,27648,37,945776081
8527,495992117,45596,496037713,0,9,0,1024,45,5141935114
8528,496156668,3898,496160566,0,0,1,4096,29,164795083
8529,496193356,278588,496471944,0,3,0,291840,37,5631825979
8530,496269403,43904,496313307,0,8,0,512,21,6782768592
8531,496302521,7230,496309751,0,0,1,7680,29,4362309675
8532,496306728,24929,496331657,0,3,1,45056,37,2340809558
8533,496363414,158481,496521895,0,3,0,115712,37,3970078107
8534,496366278,6278,496372556,0,0,1,6656,29,6922065382
8535,496444167,23466,496467633,0,0,1,38912,29,4392881413
8536,496480844,66680,496547524,0,2,0,9728,14,7657874648
8537,496516723,110864,496627587,0,1,0,64000,18,5674858623
8538,496673429,48980,496722409,0,8,0,2048,21,4113312548
8539,496759409,1042,496760451,0,0,1,1024,29,10253011259
8540,496787238,5802,496793040,0,7,1,6144,40,7135407566
8541,496808160,566,496808726,0,0,1,512,29,3506226101
8542,496877862,7230,496885092,0,3,1,7680,37,1846857966
8543,496894356,110708,497005064,0,1,0,63488,18,2673844950
8544,496941304,50672,496991976,0,9,0,2560,45,3950465801
8545,497087053,48980,497136033,0,7,0,2048,40,1318186241
8546,497112342,6229,497118571,0,0,1,15360,29,8396024656
8547,497114911,1994,497116905,0,3,1,2048,37,5917169218
8548,497157500,7706,497165206,0,0,1,8192,29,4083188530
8549,497301483,48980,497350463,0,8,0,2048,21,10684447633
8550,497314194,47288,497361482,0,9,0,1536,45,9247991166
8551,497319277,47288,497366565,0,7,0,1536,40,5904588010
8552,497336832,13253,497350085,0,7,1,25600,40,477963914
8553,497372106,33503,497405609,0,3,1,58368,37,7602194540
8554,497388426,3128,497391554,0,8,1,9216,21,3830036068
8555,497449862,65900,497515762,0,7,0,7168,40,5227276039
8556,497474885,566,497475451,0,3,1,512,37,6347471069
8557,497490907,5802,497496709,0,3,1,6144,37,10120804023
8558,497499049,3645,497502694,0,3,1,10240,37,10012968331
8559,497569991,54056,497624047,0,8,0,3584,21,8347850611
8560,497588383,11016,497599399,0,8,1,17920,21,5768202866
8561,497619721,11791,497631512,0,8,1,19456,21,2175125316
8562,497621427,15679,497637106,0,8,1,18432,21,2594212102
8563,497718075,108680,497826755,0,1,0,56832,18,7619042642
8564,497718835,24242,497743077,0,3,1,40448,37,8364449737
8565,497856255,48980,497905235,0,8,0,2048,21,7469412399
8566,497911841,366896,498278737,0,1,0,420352,18,3092378352
8567,497947528,299180,498246708,0,3,0,359424,37,4096552737
8568,497970104,115076,498085180,0,2,0,77824,14,1752359635
8569,497983231,566,497983797,0,7,1,512,40,6524960625
8570,498001691,566,498002257,0,7,1,512,40,4960233700
8571,498041219,11791,498053010,0,8,1,19456,21,8175665699
8572,498048882,86196,498135078,0,4,1,144384,12,6692892775
8573,498057476,57140,498114616,0,8,0,1024,21,7477974901
8574,498104444,2870,498107314,0,7,1,8704,40,6983178262
8575,498148948,3904,498152852,0,7,1,10752,40,7612039467
8576,498163192,58348,498221540,0,8,0,3584,21,6450692437
8577,498166192,434024,498600216,0,3,0,416768,37,1752047304
8578,498319650,47444,498367094,0,9,0,2048,45,7391114938
8579,498504535,566,498505101,0,8,1,512,21,1751271413
8580,498599511,110781,498710292,0,3,0,61440,37,9390485599
8581,498738759,153024,498891783,0,4,1,247808,12,3359638397
8582,498763310,289976,499053286,0,2,0,329216,14,4846917022
8583,498890176,65946,498956122,0,4,1,111616,12,916643312
8584,498960008,3645,498963653,0,7,1,10240,40,5715577975
8585,499084743,566,499085309,0,8,1,512,21,6201736196
8586,499148188,104624,499252812,0,1,0,43520,18,10278330957
8587,499170937,11274,499182211,0,7,1,18432,40,942511175
8588,499455233,4679,499459912,0,7,1,12288,40,7123995192
8589,499492714,4850,499497564,0,7,1,5120,40,6896307299
8590,499597212,1994,499599206,0,7,1,2048,40,4284019214
8591,499602471,107588,499710059,0,1,0,53248,18,9620854852
8592,499646803,203852,499850655,0,2,0,207872,14,8104626067
8593,499654268,48980,499703248,0,7,0,2048,40,3871827915
8594,499699582,187151,499886733,0,2,0,98304,14,4140843549
8595,499822342,371420,500193762,0,1,0,435200,18,2915316263
8596,499835253,54270,499889523,0,4,1,92160,12,10188090711
8597,499868132,13253,499881385,0,5,1,25600,20,1322491329
8598,499872601,43904,499916505,0,8,0,512,21,7506531569
8599,499893957,4162,499898119,0,7,1,11264,40,1262032277
8600,499967905,4420,499972325,0,7,1,11776,40,4232816646
8601,500072380,43904,500116284,0,9,0,512,45,634972407
8602,500156802,43904,500200706,0,8,0,512,21,3745367474
8603,500218665,52364,500271029,0,8,0,3072,21,2551333518
8604,500233613,13083,500246696,0,5,1,22016,20,2093944257
8605,500405876,15579,500421455,0,7,1,30208,40,689788161
8606,500435875,135270,500571145,0,4,1,223232,12,4024643732
8607,500447099,2470,500449569,0,5,1,2560,20,7096819827
8608,500546667,43904,500590571,0,8,0,512,21,7221843495
8609,500572057,75140,500647197,0,3,0,12288,37,6568529930
8610,500788074,413798,501201872,0,3,0,522752,37,5842276308
8611,500798520,6754,500805274,0,7,1,7168,40,256275144
8612,500978820,6278,500985098,0,8,1,6656,21,1789137981
8613,500987266,245509,501232775,0,3,0,101376,37,404590324
8614,501000189,62516,501062705,0,2,0,6144,14,3611780551
8615,501058001,256341,501314342,0,4,1,415744,12,8793807746
8616,501165377,566,501165943,0,0,1,512,29,5624146829
8617,501172781,4374,501177155,0,5,1,4608,20,7602484023
8618,501259311,101894,501361205,0,4,1,150528,12,3631344261
8619,501260529,43904,501304433,0,7,0,512,40,6688763873
8620,501277260,6229,501283489,0,5,1,15360,20,8446569867
8621,501463525,222866,501686391,0,4,1,360448,12,27928505
8622,501510737,4374,501515111,0,5,1,4608,20,2218165200
8623,501768138,104120,501872258,0,4,1,172544,12,10102811007
8624,501785252,54056,501839308,0,7,0,3584,40,9809085924
8625,501799731,52364,501852095,0,7,0,3072,40,5487144
8626,501873047,256341,502129388,0,4,1,415744,12,6701994967
8627,501888451,184424,502072875,0,3,0,159232,37,2163184802
8628,501920694,111488,502032182,0,1,0,66048,18,8993272843
8629,501943646,45596,501989242,0,7,0,1024,40,4485754958
8630,501951423,168294,502119717,0,3,0,84992,37,3551134584
8631,501965447,100880,502066327,0,2,0,31232,14,8796013447
8632,502004068,45596,502049664,0,7,0,1024,40,2862400562
8633,502211376,50984,502262360,0,9,0,3584,45,4542187708
8634,502332699,45596,502378295,0,2,0,1024,14,5275484172
8635,502382327,54056,502436383,0,7,0,3584,40,494724556
8636,502416884,43904,502460788,0,8,0,512,21,7476445738
8637,502645827,5326,502651153,0,7,1,5632,40,2787394635
8638,502702868,47288,502750156,0,8,0,1536,21,4084256453
8639,502723102,213056,502936158,0,1,0,238080,18,8469054195
8640,502735758,101568,502837326,0,7,0,2560,40,9947044207
8641,502773720,2870,502776590,0,1,1,8704,18,6399070438
8642,502953703,99008,503052711,0,2,0,25088,14,8005547286
8643,503011926,14804,503026730,0,3,1,28672,37,7863020479
8644,503046255,84560,503130815,0,1,0,23040,18,978131434
8645,503094941,47288,503142229,0,9,0,1536,45,3035948933
8646,503208895,22174,503231069,0,3,1,36352,37,3484852606
8647,503235197,43904,503279101,0,8,0,512,21,552593427
8648,503242917,12049,503254966,0,5,1,19968,20,7820741776
8649,503346308,43904,503390212,0,9,0,512,45,1086696899
8650,503368385,10241,503378626,0,5,1,16384,20,6073131090
8651,503547987,50672,503598659,0,8,0,2560,21,2681361251
8652,503813734,89300,503903034,0,1,0,18432,18,8649133153
8653,503847920,47288,503895208,0,9,0,1536,45,7379303166
8654,503923109,45596,503968705,0,1,0,1024,18,10725205094
8655,503971214,195272,504166486,0,2,0,179712,14,3702665441
8656,503974381,194304,504168685,0,2,0,7168,14,8205693159
8657,504093602,11274,504104876,0,5,1,18432,20,1612196357
8658,504125000,4374,504129374,0,5,1,4608,20,6261736456
8659,504225328,4850,504230178,0,2,1,5120,14,9611997482
8660,504241240,31783,504273023,0,5,1,51712,20,1950634666
8661,504242094,312525,504554619,0,2,0,334848,14,4955785453
8662,504427996,12737,504440733,0,3,1,24576,37,953355625
8663,504454514,43904,504498418,0,9,0,512,45,3486730912
8664,504489141,192870,504682011,0,2,0,118272,14,391479600
8665,504510501,6278,504516779,0,3,1,6656,37,9234605771
8666,504538009,6488,504544497,0,7,1,15872,40,1355564480
8667,504648257,45596,504693853,0,8,0,1024,21,9823578085
8668,504757781,105560,504863341,0,1,0,46592,18,25847268
8669,504841887,99032,504940919,0,3,0,30208,37,7168631806
8670,504843415,20882,504864297,0,7,1,33792,40,8681470554
8671,504872787,114452,504987239,0,2,0,75776,14,3269758251
8672,504891776,43904,504935680,0,8,0,512,21,3331982156
8673,504943750,91460,505035210,0,1,0,20480,18,2003410371
8674,504963564,2470,504966034,0,5,1,2560,20,719938814
8675,504972361,54056,505026417,0,7,0,3584,40,5593006933
8676,504972855,6229,504979084,0,0,1,15360,29,2095162887
8677,504995476,4162,504999638,0,5,1,11264,20,6441632502
8678,505000843,34020,505034863,0,5,1,59392,20,6335414358
8679,505012015,4420,505016435,0,7,1,11776,40,1104786629
8680,505185371,77744,505263115,0,8,0,10752,21,4700994665
8681,505254471,3898,505258369,0,7,1,4096,40,1372165445
8682,505265977,5802,505271779,0,3,1,6144,37,3780264509
8683,505283419,123812,505407231,0,3,0,106496,37,3551844993
8684,505380876,57440,505438316,0,2,0,4608,14,4893184521
8685,505477218,47444,505524662,0,7,0,2048,40,5031389531
8686,505647549,43904,505691453,0,8,0,512,21,754107306
8687,505808015,348392,506156407,0,1,0,404992,18,6413859933
8688,505873973,52364,505926337,0,0,0,3072,29,8881390196
8689,505879072,47288,505926360,0,9,0,1536,45,803804693
8690,505940512,226518,506167030,0,1,0,34816,18,7321097827
8691,506014405,1994,506016399,0,3,1,2048,37,537234464
8692,506030992,48980,506079972,0,9,0,2048,45,4831460352
8693,506101382,55748,506157130,0,9,0,4096,45,2799740045
8694,506134178,43360,506177538,0,1,1,16896,18,5306577213
8695,506157327,20775,506178102,0,1,1,10752,18,2926045150
8696,506181044,22433,506203477,0,1,1,36864,18,9692850218
8697,506200953,7230,506208183,0,7,1,7680,40,2983813679
8698,506292083,2946,506295029,0,1,1,3072,18,3020478563
8699,506307789,1042,506308831,0,3,1,1024,37,7302854242
8700,506357328,84248,506441576,0,2,0,22016,14,9998115271
8701,506391808,54056,506445864,0,7,0,3584,40,3307885474
8702,506510488,4162,506514650,0,3,1,11264,37,2085874090
8703,506538560,121316,506659876,0,3,0,98304,37,5221866962
8704,506583058,5971,506589029,0,7,1,14848,40,4257810782
8705,506584321,3128,506587449,0,3,1,9216,37,3401103654
8706,506586825,134278,506721103,0,3,0,45056,37,2019584770
8707,506643880,47288,506691168,0,0,0,1536,29,4531199862
8708,506667334,3387,506670721,0,7,1,9728,40,7029566387
8709,506669693,3524,506673217,0,7,1,8704,40,1914209955
8710,506842497,6754,506849251,0,7,1,7168,40,3626934935
8711,506842869,7253,506850122,0,7,1,12288,40,5988881281
8712,506860649,258348,507118997,0,2,0,189440,14,5473355317
8713,506861724,16096,506877820,0,2,1,31232,14,1927584364
8714,506915921,55748,506971669,0,8,0,4096,21,8632119210
8715,506933344,50672,506984016,0,9,0,2560,45,5547451618
8716,506998272,1042,506999314,0,2,1,1024,14,10651958914
8717,507042144,4162,507046306,0,7,1,11264,40,8645619894
8718,507042183,5971,507048154,0,2,1,14848,14,2908218212
8719,507061128,52364,507113492,0,7,0,3072,40,5009792362
8720,507086189,45596,507131785,0,9,0,1024,45,4120036873
8721,507121937,43904,507165841,0,9,0,512,45,10652944925
8722,507203539,161756,507365295,0,1,0,140288,18,659221608
8723,507299086,3128,507302214,0,3,1,9216,37,4095478735
8724,507445500,50672,507496172,0,9,0,2560,45,3483122736
8725,507449514,43904,507493418,0,7,0,512,40,6655260118
8726,507539729,5802,507545531,0,1,1,6144,18,3128686089
8727,507560470,10757,507571227,0,7,1,17408,40,5134034073
8728,507580549,245005,507825554,0,1,0,242176,18,4802988718
8729,507586555,13858,507600413,0,3,1,23552,37,6287817424
8730,507628967,50672,507679639,0,7,0,2560,40,3193054958
8731,507649528,12308,507661836,0,7,1,20480,40,6180296201
8732,507666114,5454,507671568,0,3,1,13824,37,4891318805
8733,507676368,21141,507697509,0,8,1,34304,21,5504247926
8734,507689827,163978,507853805,0,1,0,92672,18,6823091343
8735,507699203,2470,507701673,0,1,1,2560,18,1284464893
8736,507743990,194114,507938104,0,3,0,154624,37,8623003685
8737,507825183,185378,508010561,0,4,1,304128,12,1577632737
8738,507858185,47288,507905473,0,7,0,1536,40,1182590314
8739,507874178,33591,507907769,0,7,1,55296,40,3835341847
8740,507966781,222080,508188861,0,2,0,262656,14,986112112
8741,507973550,229522,508203072,0,2,0,46592,14,3131730804
8742,508011927,6754,508018681,0,7,1,7168,40,2024533361
8743,508097066,125893,508222959,0,2,0,25600,14,8832449635
8744,508105458,1518,508106976,0,8,1,1536,21,2545896739
8745,508126020,11274,508137294,0,8,1,18432,21,5661006619
8746,508142464,21141,508163605,0,1,1,34304,18,9261725561
8747,508222757,197300,508420057,0,3,0,186368,37,9928612979
8748,508238682,3898,508242580,0,3,1,4096,37,1548006213
8749,508334525,5712,508340237,0,1,1,14336,18,9698697840
8750,508365365,53300,508418665,0,9,0,6144,45,8675093462
8751,508444269,1042,508445311,0,7,1,1024,40,8611265254
8752,508462272,72024,508534296,0,4,1,116736,12,3022555083
8753,508463263,12566,508475829,0,3,1,20992,37,4772684650
8754,508485519,373604,508859123,0,2,0,442368,14,899630499
8755,508501571,117104,508618675,0,1,0,84480,18,4890837716
8756,508537064,46729,508583793,0,3,1,80896,37,826610190
8757,508545786,43908,508589694,0,3,1,28160,37,7674171227
8758,508559255,10757,508570012,0,1,1,17408,18,10479739761
8759,508595248,5326,508600574,0,7,1,5632,40,6261717472
8760,508605581,267909,508873490,0,2,0,47104,14,6999405022
8761,508619034,261335,508880369,0,2,0,22528,14,6803766989
8762,508695714,10757,508706471,0,1,1,17408,18,5407894982
8763,508709088,5971,508715059,0,8,1,14848,21,7309784437
8764,508709165,6229,508715394,0,3,1,15360,37,7214729305
8765,508714832,262530,508977362,0,3,0,175104,37,3467220589
8766,508723147,76846,508799993,0,4,1,129536,12,9146279850
8767,508757021,1994,508759015,0,8,1,2048,21,10429876902
8768,508826002,11791,508837793,0,1,1,19456,18,10139188997
8769,508830707,13600,508844307,0,7,1,23040,40,7679927711
8770,508844961,52364,508897325,0,9,0,3072,45,7390196861
8771,508859567,164408,509023975,0,3,0,148992,37,672522159
8772,508885386,43904,508929290,0,9,0,512,45,3146391346
8773,508904869,195584,509100453,0,4,0,180736,12,1186636971
8774,508945260,43904,508989164,0,8,0,512,21,7342612503
8775,509029795,201200,509230995,0,1,0,199168,18,8675274809
8776,509036357,200113,509236470,0,1,0,17920,18,7771477420
8777,509076586,245555,509322141,0,1,0,139264,18,9703504051
8778,509113024,62674,509175698,0,4,1,101888,12,5070942679
8779,509120328,45596,509165924,0,9,0,1024,45,447608929
8780,509149968,15837,509165805,0,8,1,30720,21,5718149485
8781,509251803,198756,509450559,0,1,0,184320,18,331244469
8782,509261561,5802,509267363,0,7,1,6144,40,7889074238
8783,509341665,117104,509458769,0,2,0,84480,14,178722104
8784,509373079,3645,509376724,0,0,1,10240,29,3966643118
8785,509373943,22950,509396893,0,7,1,37888,40,5189856683
8786,509393796,3387,509397183,0,3,1,9728,37,3729064241
8787,509396018,81632,509477650,0,4,1,132096,12,151197572
8788,509433866,59644,509493510,0,4,1,59392,12,4190157797
8789,509455017,10757,509465774,0,8,1,17408,21,7885864754
8790,509456255,109002,509565257,0,2,0,49664,14,2600853047
8791,509469949,21141,509491090,0,1,1,34304,18,7724321702
8792,509548893,23637,509572530,0,1,1,42496,18,5368695443
8793,509630950,55748,509686698,0,8,0,4096,21,1309822228
8794,509635633,464450,510100083,0,3,0,547840,37,5997373288
8795,509672374,45596,509717970,0,1,0,1024,18,9504003456
8796,509684390,12995,509697385,0,7,1,25088,40,5044919061
8797,509717169,10499,509727668,0,0,1,16896,29,9008730348
8798,509789797,3128,509792925,0,8,1,9216,21,10527179440
8799,509844270,114764,509959034,0,1,0,76800,18,4458117892
8800,509908022,190592,510098614,0,2,0,164352,14,5813354284
8801,509911610,2470,509914080,0,0,1,2560,29,946670462
8802,510082472,32558,510115030,0,4,1,53248,12,513386408
8803,510088714,2470,510091184,0,0,1,2560,29,8582151722
8804,510090501,71089,510161590,0,2,0,7680,14,5801492251
8805,510384192,52364,510436556,0,7,0,3072,40,5644141001
8806,510427710,52364,510480074,0,2,0,3072,14,3527559670
8807,510438460,43904,510482364,0,7,0,512,40,5969476052
8808,510475760,116829,510592589,0,4,1,194048,12,4387995345
8809,510488557,50672,510539229,0,9,0,2560,45,5451489124
8810,510589362,1042,510590404,0,0,1,1024,29,3313538914
8811,510593617,219452,510813069,0,3,0,259072,37,1954113758
8812,510620322,321351,510941673,0,3,0,220160,37,5116902442
8813,510649850,10757,510660607,0,0,1,17408,29,10336215303
8814,510662013,43904,510705917,0,7,0,512,40,5396249462
8815,510677824,41649,510719473,0,1,1,67584,18,7474153633
8816,510775167,99164,510874331,0,1,0,25600,18,5650197881
8817,510784791,7230,510792021,0,7,1,7680,40,7138782331
8818,510810128,34108,510844236,0,7,1,56320,40,9401892837
8819,510815005,1042,510816047,0,0,1,1024,29,478798969
8820,510827874,218337,511046211,0,4,1,358400,12,4130823686
8821,510929517,54056,510983573,0,8,0,3584,21,6743804688
8822,510942444,12995,510955439,0,7,1,25088,40,2825727263
8823,510978626,45596,511024222,0,9,0,1024,45,1551107956
8824,510981521,2470,510983991,0,1,1,2560,18,10038965650
8825,510999384,5802,511005186,0,3,1,6144,37,4290038447
8826,511014722,6488,511021210,0,3,1,15872,37,6227126055
8827,511024531,48980,511073511,0,8,0,2048,21,8008198407
8828,511024895,57440,511082335,0,9,0,4608,45,7127994481
8829,511084342,4679,511089021,0,3,1,12288,37,139996498
8830,511126526,47600,511174126,0,8,0,2560,21,4905852764
8831,511210223,51140,511261363,0,2,0,4096,14,6216277402
8832,511262480,195272,511457752,0,1,0,179712,18,9062092404
8833,511440986,11016,511452002,0,7,1,17920,40,9262567915
8834,511457126,566,511457692,0,3,1,512,37,8420331835
8835,511560400,1042,511561442,0,1,1,1024,18,6027829274
8836,511652608,43904,511696512,0,2,0,512,14,6126077473
8837,511667709,112424,511780133,0,1,0,69120,18,2937466785
8838,511811012,5326,511816338,0,3,1,5632,37,7211990347
8839,511878713,48980,511927693,0,3,0,2048,37,1098837515
8840,511937447,128180,512065627,0,1,0,120832,18,8816875344
8841,511950645,1994,511952639,0,7,1,2048,40,7043137178
8842,511961248,45596,512006844,0,8,0,1024,21,10324269642
8843,512002781,45596,512048377,0,2,0,1024,14,4448912399
8844,512034758,12049,512046807,0,7,1,19968,40,10266557163
8845,512041360,15579,512056939,0,7,1,30208,40,7838477753
8846,512116163,47288,512163451,0,8,0,1536,21,7722643389
8847,512131661,7230,512138891,0,3,1,7680,37,10311288033
8848,512170363,26738,512197101,0,3,1,48640,37,9914752892
8849,512206979,48980,512255959,0,8,0,2048,21,276498982
8850,512344705,7706,512352411,0,7,1,8192,40,5859816054
8851,512352386,62674,512415060,0,4,1,101888,12,6573194795
8852,512445924,3128,512449052,0,7,1,9216,40,996373913
8853,512449576,31007,512480583,0,7,1,50176,40,10556140736
8854,512503651,6488,512510139,0,0,1,15872,29,1897020727
8855,512511879,69948,512581827,0,7,0,1024,40,2723820908
8856,512523043,3898,512526941,0,7,1,4096,40,2420564708
8857,512576889,566,512577455,0,2,1,512,14,5775104400
8858,512654050,45596,512699646,0,2,0,1024,14,5165471634
8859,512666976,43904,512710880,0,9,0,512,45,7712752692
8860,512696257,3645,512699902,0,2,1,10240,14,311190618
8861,512720017,566,512720583,0,2,1,512,14,5645295192
8862,512732375,52364,512784739,0,9,0,3072,45,1932317607
8863,512791421,47288,512838709,0,3,0,1536,37,9333672779
8864,512890133,10757,512900890,0,1,1,17408,18,4242638002
8865,512914896,5712,512920608,0,2,1,14336,14,4237246044
8866,512916121,48591,512964712,0,2,0,512,14,63584336
8867,512976501,1042,512977543,0,7,1,1024,40,7840778579
8868,513018255,5326,513023581,0,7,1,5632,40,362796230
8869,513018975,4679,513023654,0,1,1,12288,18,1971501754
8870,513022566,43904,513066470,0,2,0,512,14,2536046077
8871,513047707,52520,513100227,0,2,0,3584,14,10288325850
8872,513062526,116571,513179097,0,4,1,193536,12,2653447674
8873,513080611,294173,513374784,0,4,1,409600,12,8821692628
8874,513108005,15321,513123326,0,0,1,29696,29,2326521162
8875,513109640,74228,513183868,0,1,0,14336,18,10504405169
8876,513118309,12566,513130875,0,2,1,20992,14,9752512332
8877,513165558,45596,513211154,0,3,0,1024,37,3652771525
8878,513219937,262999,513482936,0,4,1,345600,12,7854833896
8879,513331279,1994,513333273,0,2,1,2048,14,505533603
8880,513344666,13858,513358524,0,1,1,23552,18,477846040
8881,513381979,54056,513436035,0,8,0,3584,21,2924487638
8882,513385986,4679,513390665,0,1,1,12288,18,6783221174
8883,513505627,52364,513557991,0,3,0,3072,37,7241137037
8884,513601289,6754,513608043,0,7,1,7168,40,1409801781
8885,513619164,43904,513663068,0,7,0,512,40,9051307524
8886,513707984,4850,513712834,0,4,1,5120,12,4489802556
8887,513725433,5454,513730887,0,7,1,13824,40,3298134183
8888,513750651,5326,513755977,0,7,1,5632,40,9449438164
8889,513782305,5802,513788107,0,3,1,6144,37,158677684
8890,513851781,2870,513854651,0,2,1,8704,14,7198555640
8891,513878907,2870,513881777,0,3,1,8704,37,9373320045
8892,513881436,95804,513977240,0,4,1,159744,12,5979479699
8893,513910280,13341,513923621,0,0,1,22528,29,7977836443
8894,513914398,109754,514024152,0,4,1,156160,12,8320285228
8895,513932661,45596,513978257,0,7,0,1024,40,7393422890
8896,513966778,78060,514044838,0,4,1,66048,12,4159731984
8897,513970822,52832,514023654,0,7,0,4608,40,6751246999
8898,514007446,3904,514011350,0,0,1,10752,29,3234702414
8899,514008566,28426,514036992,0,0,1,47616,29,4772112853
8900,514012298,26000,514038298,0,0,1,2048,29,1700637543
8901,514051045,92016,514143061,0,4,1,148992,12,4113584871
8902,514103121,2946,514106067,0,0,1,3072,29,2760769784
8903,514119166,3898,514123064,0,7,1,4096,40,7797532201
8904,514134040,57440,514191480,0,8,0,4608,21,2397943087
8905,514149951,45752,514195703,0,9,0,1536,45,271868447
8906,514151480,107588,514259068,0,1,0,53248,18,6885628281
8907,514209436,88650,514298086,0,1,0,13824,18,3950870392
8908,514216583,12995,514229578,0,2,1,25088,14,3949970103
8909,514275957,126833,514402790,0,2,0,1024,14,7720386140
8910,514304805,43200,514348005,0,9,1,70656,45,4076941358
8911,514321120,45596,514366716,0,8,0,1024,21,5722452397
8912,514372722,47288,514420010,0,3,0,1536,37,6325240402
8913,514382318,6278,514388596,0,3,1,6656,37,4197481785
8914,514409827,14804,514424631,0,0,1,28672,29,390063572
8915,514457228,6488,514463716,0,7,1,15872,40,8674777907
8916,514613200,45596,514658796,0,9,0,1024,45,2695894760
8917,514653354,4374,514657728,0,3,1,4608,37,2375799490
8918,514683720,52832,514736552,0,3,0,4608,37,4135569112
8919,514683957,3904,514687861,0,2,1,10752,14,7514946527
8920,514768272,7230,514775502,0,3,1,7680,37,3658031783
8921,514808831,12566,514821397,0,2,1,20992,14,7949348434
8922,514816138,20624,514836762,0,2,1,33280,14,1833897015
8923,514827803,48980,514876783,0,8,0,2048,21,5308005525
8924,514849508,2470,514851978,0,3,1,2560,37,5959446686
8925,514868458,5454,514873912,0,9,1,13824,45,5523485011
8926,514882850,54056,514936906,0,3,0,3584,37,4336680436
8927,514901116,36346,514937462,0,9,1,64000,45,5603445913
8928,514940074,47288,514987362,0,2,0,1536,14,6328377491
8929,515003073,47288,515050361,0,9,0,1536,45,5939331157
8930,515044159,116948,515161107,0,1,0,83968,18,5312430166
8931,515091047,5454,515096501,0,2,1,13824,14,3317579888
8932,515123001,101882,515224883,0,9,1,164864,45,5044929453
8933,515172562,5971,515178533,0,1,1,14848,18,9406060772
8934,515212381,281864,515494245,0,1,0,302592,18,6242501856
8935,515231000,390462,515621462,0,9,1,636928,45,2048693180
8936,515289316,328937,515618253,0,4,1,537088,12,7787182941
8937,515324325,566,515324891,0,3,1,512,37,7130582454
8938,515336833,20624,515357457,0,2,1,33280,14,4588144741
8939,515405348,91835,515497183,0,1,1,3072,18,1670891984
8940,515483197,153818,515637015,0,9,1,49664,45,4160937221
8941,515512072,64208,515576280,0,7,0,6656,40,9276307811
8942,515516599,54056,515570655,0,7,0,3584,40,1006590035
8943,515522625,20366,515542991,0,1,1,32768,18,4126599163
8944,515541801,1856,515543657,0,1,1,1024,18,6242904597
8945,515625104,4850,515629954,0,2,1,5120,14,6637018053
8946,515625863,57440,515683303,0,8,0,4608,21,4310003952
8947,515755180,99960,515855140,0,9,0,6144,45,7334871383
8948,515765382,43975,515809357,0,9,1,72192,45,4156759428
8949,515818901,5196,515824097,0,2,1,13312,14,3361771825
8950,515930452,4162,515934614,0,2,1,11264,14,9457227619
8951,515964531,47288,516011819,0,9,0,1536,45,953923912
8952,516025055,286700,516311755,0,1,0,318464,18,3230345133
8953,516046519,20366,516066885,0,9,1,32768,45,1771122438
8954,516050604,130576,516181180,0,9,1,205824,45,354871091
8955,516070540,1518,516072058,0,1,1,1536,18,1013367033
8956,516103697,24670,516128367,0,3,1,44544,37,431961450
8957,516106731,45596,516152327,0,2,0,1024,14,9489839885
8958,516117110,86190,516203300,0,9,1,73216,45,1484833389
8959,516130337,199373,516329710,0,1,0,58880,18,6857213784
8960,516297210,63452,516360662,0,8,0,9216,21,7685529943
8961,516306187,64208,516370395,0,8,0,6656,21,8889155566
8962,516308302,121812,516430114,0,1,0,29696,18,462013137
8963,516345499,11533,516357032,0,1,1,18944,18,9886761804
8964,516407714,49292,516457006,0,2,0,3072,14,10148624535
8965,516440470,61899,516502369,0,9,1,100352,45,7229675613
8966,516489423,7230,516496653,0,2,1,7680,14,8388839913
8967,516572985,47288,516620273,0,7,0,1536,40,9551194785
8968,516594700,5802,516600502,0,5,1,6144,20,678371791
8969,516615503,128960,516744463,0,1,0,123392,18,8138665006
8970,516694377,1994,516696371,0,3,1,2048,37,3905587234
8971,516724931,52364,516777295,0,7,0,3072,40,781709672
8972,516738342,11309,516749651,0,1,1,13312,18,8880915937
8973,516751072,2470,516753542,0,1,1,2560,18,3816561985
8974,516753310,113816,516867126,0,9,1,184832,45,7033276547
8975,516786798,3128,516789926,0,2,1,9216,14,8862589549
8976,516796725,155003,516951728,0,4,1,254976,12,1823733486
8977,516839318,21141,516860459,0,3,1,34304,37,5386599147
8978,516918588,52364,516970952,0,2,0,3072,14,6335838349
8979,517009444,48980,517058424,0,8,0,2048,21,9894929008
8980,517094178,56840,517151018,0,8,0,7680,21,6702538613
8981,517100703,14545,517115248,0,1,1,28160,18,5869267015
8982,517103115,17625,517120740,0,1,1,17920,18,7840656469
8983,517161148,45596,517206744,0,3,0,1024,37,6088441289
8984,517245023,205724,517450747,0,1,0,214016,18,3040587892
8985,517250301,15062,517265363,0,1,1,29184,18,6206200386
8986,517374216,45596,517419812,0,9,0,1024,45,10522397131
8987,517483330,203072,517686402,0,1,0,205312,18,8132699552
8988,517530697,48980,517579677,0,2,0,2048,14,3558951343
8989,517532227,43904,517576131,0,9,0,512,45,1937664019
8990,517533006,48980,517581986,0,3,0,2048,37,8588934087
8991,517783534,3128,517786662,0,8,1,9216,21,1396794487
8992,517820057,47288,517867345,0,7,0,1536,40,10512894751
8993,517852880,13770,517866650,0,4,1,26624,12,7404632001
8994,517877312,92020,517969332,0,8,0,1024,21,2775486316
8995,517911679,2946,517914625,0,8,1,3072,21,2370314122
8996,517954154,32987,517987141,0,9,1,57344,45,1209957124
8997,518063555,2946,518066501,0,7,1,3072,40,3066097144
8998,518069689,43904,518113593,0,2,0,512,14,4879744515
8999,518188350,54860,518243210,0,7,0,1536,40,9794757861
9000,518203434,48980,518252414,0,3,0,2048,37,7683755391
9001,518208155,3904,518212059,0,4,1,10752,12,760962675
9002,518231598,566,518232164,0,1,1,512,18,3998122931
9003,518247044,43904,518290948,0,2,0,512,14,3803432198
9004,518349808,45596,518395404,0,3,0,1024,37,9251495686
9005,518424605,55748,518480353,0,8,0,4096,21,5048005097
9006,518454010,59132,518513142,0,9,0,5120,45,8478443973
9007,518628699,52364,518681063,0,2,0,3072,14,1215091083
9008,518679972,194816,518874788,0,4,1,315904,12,5708870123
9009,518699890,4374,518704264,0,7,1,4608,40,106831037
9010,518724112,64829,518788941,0,7,0,5632,40,1894632082
9011,518743013,105560,518848573,0,1,0,46592,18,8161372388
9012,518746170,7706,518753876,0,7,1,8192,40,3901732100
9013,518749752,141101,518890853,0,4,1,60416,12,7796616926
9014,518772666,4850,518777516,0,7,1,5120,40,5015541714
9015,518774176,48980,518823156,0,2,0,2048,14,10106578056
9016,518836499,45596,518882095,0,2,0,1024,14,7927689385
9017,518852346,111332,518963678,0,1,0,65536,18,1408806447
9018,518890170,33333,518923503,0,4,1,54784,12,1484485503
9019,519068381,45596,519113977,0,8,0,1024,21,8552631410
9020,519076052,3422,519079474,0,1,1,3584,18,5067660039
9021,519095270,45596,519140866,0,8,0,1024,21,10160504896
9022,519183073,84128,519267201,0,4,1,140288,12,7712574052
9023,519198811,188876,519387687,0,7,0,158720,40,5591018955
9024,519300766,12995,519313761,0,7,1,25088,40,5911810122
9025,519363949,47288,519411237,0,8,0,1536,21,7892159935
9026,519366984,25545,519392529,0,7,1,5120,40,1499072867
9027,519380253,324891,519705144,0,4,1,525824,12,2146940254
9028,519419382,55748,519475130,0,3,0,4096,37,7549472766
9029,519430142,12308,519442450,0,7,1,20480,40,2979577246
9030,519443337,363436,519806773,0,7,0,358912,40,5875329265
9031,519459026,277480,519736506,0,4,1,109056,12,2213283415
9032,519585197,212120,519797317,0,1,0,235008,18,1571228678
9033,519686344,120444,519806788,0,7,1,23040,40,10705050039
9034,519692776,114027,519806803,0,7,1,1024,40,2254441001
9035,519719038,180285,519899323,0,7,0,18944,40,9267234751
9036,519760529,48980,519809509,0,2,0,2048,14,4253325737
9037,519791665,26946,519818611,0,7,1,19456,40,6934292350
9038,519809358,196537,520005895,0,4,1,322560,12,1286049096
9039,519827433,48980,519876413,0,3,0,2048,37,10257716767
9040,519872047,126207,519998254,0,1,0,44544,18,9354538860
9041,519876749,26479,519903228,0,1,1,48128,18,907752979
9042,519894667,15077,519909744,0,1,1,23040,18,4303252619
9043,519969558,116829,520086387,0,4,1,194048,12,7282907616
9044,519996810,7230,520004040,0,7,1,7680,40,3226924004
9045,520066852,12308,520079160,0,1,1,20480,18,4642377269
9046,520178891,59132,520238023,0,9,0,5120,45,3542495008
9047,520191634,36087,520227721,0,4,1,63488,12,1149033195
9048,520191718,4162,520195880,0,1,1,11264,18,2087969773
9049,520216433,75812,520292245,0,9,1,127488,45,3437381721
9050,520251051,78368,520329419,0,2,0,12800,14,10557351671
9051,520279274,12737,520292011,0,1,1,24576,18,1791498433
9052,520289139,244408,520533547,0,9,1,395776,45,1904313110
9053,520315291,187844,520503135,0,9,0,1536,45,1044780936
9054,520316869,32816,520349685,0,5,1,53760,20,3010044340
9055,520493599,5454,520499053,0,1,1,13824,18,6208172484
9056,520496916,3904,520500820,0,5,1,10752,20,2348056604
9057,520539022,115795,520654817,0,4,1,192000,12,4249212725
9058,520551154,50672,520601826,0,2,0,2560,14,7034165157
9059,520616932,448112,521065044,0,4,1,729088,12,8623755836
9060,520655332,549276,521204608,0,4,1,446976,12,1444050559
9061,520754698,538042,521292740,0,4,1,290816,12,3259094351
9062,520779060,2470,520781530,0,7,1,2560,40,3277888911
9063,520930101,4420,520934521,0,5,1,11776,20,10362582743
9064,520982300,311106,521293406,0,4,1,11264,12,7015186882
9065,520997318,41391,521038709,0,5,1,67072,20,9045067307
9066,521019729,60224,521079953,0,3,0,8704,37,3228709208
9067,521083016,12049,521095065,0,5,1,19968,20,391601915
9068,521086505,84512,521171017,0,7,0,12800,40,9393374467
9069,521115134,102141,521217275,0,9,1,165376,45,7715573229
9070,521140638,122096,521262734,0,7,0,100864,40,9395983104
9071,521201011,188392,521389403,0,9,0,9728,45,2914177064
9072,521225418,66458,521291876,0,9,0,1536,45,3746509346
9073,521226984,35312,521262296,0,1,1,61952,18,7211977006
9074,521254690,12825,521267515,0,5,1,21504,20,5298395018
9075,521255698,53978,521309676,0,4,1,53248,12,1883384013
9076,521268906,45596,521314502,0,2,0,1024,14,2673875919
9077,521288540,13858,521302398,0,5,1,23552,20,1903330609
9078,521481841,50672,521532513,0,3,0,2560,37,6108449291
9079,521575106,205412,521780518,0,7,0,212992,40,45338890
9080,521599165,56079,521655244,0,4,1,95744,12,6090913189
9081,521661294,74091,521735385,0,9,1,120832,45,4198931571
9082,521710789,3422,521714211,0,5,1,3584,20,10423281349
9083,521714395,3128,521717523,0,3,1,9216,37,7921085294
9084,521758075,55304,521813379,0,4,1,94208,12,7881297665
9085,521774469,45596,521820065,0,3,0,1024,37,1928952833
9086,522040708,5454,522046162,0,1,1,13824,18,6858573350
9087,522222903,47288,522270191,0,3,0,1536,37,1605504787
9088,522254589,50672,522305261,0,3,0,2560,37,10597168320
9089,522272396,55748,522328144,0,9,0,4096,45,2428500747
9090,522348930,47288,522396218,0,9,0,1536,45,7230585673
9091,522359749,26479,522386228,0,4,1,48128,12,673077971
9092,522407650,43904,522451554,0,2,0,512,14,985946352
9093,522464006,13600,522477606,0,9,1,23040,45,6904969898
9094,522602138,14117,522616255,0,1,1,24064,18,7918433191
9095,522609324,2870,522612194,0,5,1,8704,20,283933368
9096,522724917,55748,522780665,0,3,0,4096,37,3804786575
9097,522731876,4374,522736250,0,9,1,4608,45,7278540895
9098,522799403,118976,522918379,0,7,0,90624,40,1021320560
9099,522833366,23637,522857003,0,9,1,42496,45,685363380
9100,522930702,1994,522932696,0,1,1,2048,18,7843770511
9101,522934387,1518,522935905,0,5,1,1536,20,2647145193
9102,522940000,3422,522943422,0,1,1,3584,18,729018773
9103,522981885,102752,523084637,0,1,0,37376,18,1144021595
9104,523140586,11791,523152377,0,1,1,19456,18,2454488351
9105,523304011,45596,523349607,0,2,0,1024,14,10032541061
9106,523352077,139916,523491993,0,1,0,134144,18,4877451549
9107,523359218,227017,523586235,0,1,0,144896,18,787365688
9108,523383944,47288,523431232,0,3,0,1536,37,4924145497
9109,523563019,118820,523681839,0,7,0,90112,40,8315647464
9110,523585909,23725,523609634,0,5,1,39424,20,2736647650
9111,523618888,84904,523703792,0,9,1,141824,45,4786742005
9112,523674766,145289,523820055,0,7,0,133632,40,2010848286
9113,523748354,130501,523878855,0,7,0,47104,40,8220321658
9114,523758850,66721,523825571,0,9,1,113152,45,9938644991
9115,523775211,55647,523830858,0,9,1,25088,45,10605966183
9116,523797205,44687,523841892,0,9,1,36352,45,10102000465
9117,523849829,14804,523864633,0,3,1,28672,37,6192258222
9118,523963012,74842,524037854,0,9,0,4608,45,7465111875
9119,524011625,63708,524075333,0,9,1,103936,45,1817859284
9120,524066642,110396,524177038,0,1,0,62464,18,8948438365
9121,524133972,4420,524138392,0,9,1,11776,45,2201639343
9122,524294093,201044,524495137,0,1,0,198656,18,8646144928
9123,524341343,14287,524355630,0,5,1,27648,20,8540566359
9124,524363860,132696,524496556,0,1,0,4608,18,8896404036
9125,524394145,14287,524408432,0,1,1,27648,18,6390270300
9126,524456809,6754,524463563,0,5,1,7168,20,9941562884
9127,524534215,2870,524537085,0,5,1,8704,20,9500808979
9128,524553284,366683,524919967,0,9,1,593920,45,1068464459
9129,524582521,12825,524595346,0,5,1,21504,20,4586740232
9130,524595768,74072,524669840,0,1,0,13824,18,10722142098
9131,524634330,5971,524640301,0,7,1,14848,40,2142492865
9132,524653337,277050,524930387,0,9,1,41472,45,5711437581
9133,524663985,4420,524668405,0,7,1,11776,40,2565136263
9134,524674610,47288,524721898,0,2,0,1536,14,8786889878
9135,524681467,79748,524761215,0,7,0,12288,40,1148165706
9136,524745196,210434,524955630,0,7,0,162816,40,4270091118
9137,524794451,5196,524799647,0,5,1,13312,20,899529094
9138,524810568,221203,525031771,0,9,0,2048,45,2656172218
9139,524889191,12049,524901240,0,7,1,19968,40,2781211048
9140,524892562,9984,524902546,0,7,1,2048,40,8494224419
9141,524973434,49448,525022882,0,3,0,3584,37,5881231290
9142,524980192,128014,525108206,0,9,0,3584,45,6544093930
9143,525081814,6229,525088043,0,1,1,15360,18,2027721935
9144,525092070,5454,525097524,0,1,1,13824,18,3336269349
9145,525155236,196052,525351288,0,3,0,182272,37,6383550190
9146,525217626,51140,525268766,0,2,0,4096,14,4046661497
9147,525284123,207179,525491302,0,9,1,339968,45,8168237051
9148,525288035,267476,525555511,0,7,0,280576,40,8124671681
9149,525423282,1994,525425276,0,5,1,2048,20,2215064478
9150,525480095,50672,525530767,0,2,0,2560,14,9488777527
9151,525496523,13253,525509776,0,9,1,25600,45,2038975749
9152,525520278,1518,525521796,0,1,1,1536,18,3170533093
9153,525599193,3387,525602580,0,7,1,9728,40,6658429008
9154,525629467,21658,525651125,0,1,1,35328,18,3592817804
9155,525664443,2470,525666913,0,1,1,2560,18,10008572142
9156,525667675,80864,525748539,0,3,0,20992,37,7022484008
9157,525700766,34367,525735133,0,9,1,56832,45,2545938170
9158,525716148,1518,525717666,0,5,1,1536,20,7825905487
9159,525753952,103532,525857484,0,7,0,39936,40,10703487588
9160,525782051,4679,525786730,0,5,1,12288,20,1638277332
9161,525807360,3898,525811258,0,1,1,4096,18,10549102613
9162,525850137,54056,525904193,0,9,0,3584,45,10187732131
9163,525867192,12737,525879929,0,5,1,24576,20,8461087553
9164,525903791,196676,526100467,0,7,0,184320,40,8564781916
9165,526065787,37800,526103587,0,7,1,9216,40,3163088771
9166,526149279,76052,526225331,0,1,0,10240,18,4152306110
9167,526299930,131144,526431074,0,7,0,130560,40,1681131084
9168,526317086,31266,526348352,0,5,1,50688,20,1371325801
9169,526363971,1518,526365489,0,1,1,1536,18,8090281804
9170,526435653,103950,526539603,0,9,1,168960,45,3926037530
9171,526538915,1042,526539957,0,5,1,1024,20,3558979023
9172,526547630,7230,526554860,0,5,1,7680,20,9457819769
9173,526641418,53949,526695367,0,9,0,2560,45,2161565025
9174,526676835,218360,526895195,0,7,0,255488,40,675815856
9175,526678037,305933,526983970,0,9,1,495616,45,6269347939
9176,526694106,48980,526743086,0,1,0,2048,18,6040082259
9177,526758199,1994,526760193,0,1,1,2048,18,5451959859
9178,526927559,45596,526973155,0,3,0,1024,37,4428782414
9179,527074909,65900,527140809,0,1,0,7168,18,1445735986
9180,527113524,196988,527310512,0,7,0,185344,40,9863472604
9181,527234947,3904,527238851,0,2,1,10752,14,893987439
9182,527261242,23120,527284362,0,9,1,41472,45,5607628745
9183,527284683,3387,527288070,0,2,1,9728,14,7538288225
9184,527327417,387332,527714749,0,7,0,487424,40,837089112
9185,527456984,31783,527488767,0,9,1,51712,45,1077381802
9186,527634256,256253,527890509,0,9,1,418816,45,9420548692
9187,527789599,127244,527916843,0,7,0,117760,40,7678497919
9188,527798563,108421,527906984,0,9,1,54272,45,6410154510
9189,527825903,137758,527963661,0,7,0,38400,40,4112357754
9190,527830383,82912,527913295,0,9,1,30208,45,121810224
9191,527865892,50672,527916564,0,1,0,2560,18,8720826100
9192,527910256,22862,527933118,0,2,1,40960,14,8211766165
9193,527990637,286458,528277095,0,9,1,464384,45,9757699254
9194,528151847,182885,528334732,0,9,0,3584,45,3764336766
9195,528166652,121375,528288027,0,9,1,35840,45,4671951838
9196,528187814,110084,528297898,0,7,0,61440,40,827796399
9197,528257418,87229,528344647,0,1,1,146432,18,7554259029
9198,528269594,79239,528348833,0,1,1,6656,18,3146129873
9199,528537498,469742,529007240,0,1,1,761344,18,4765694354
9200,528538829,108680,528647509,0,7,0,56832,40,4001550248
9201,528548422,45596,528594018,0,3,0,1024,37,486178941
9202,528629214,343483,528972697,0,1,0,5632,18,8001030677
9203,528677578,54056,528731634,0,9,0,3584,45,1793515471
9204,528677803,11016,528688819,0,2,1,17920,14,3383618936
9205,528708739,43904,528752643,0,9,0,512,45,10702494189
9206,528741035,14545,528755580,0,9,1,28160,45,8896940238
9207,528742077,269669,529011746,0,1,1,7168,18,2110729971
9208,528964131,53066,529017197,0,2,1,86528,14,9119525495
9209,529168182,81632,529249814,0,1,1,132096,18,6676394767
9210,529176765,79770,529256535,0,1,1,24064,18,3382690125
9211,529273087,43904,529316991,0,3,0,512,37,499274607
9212,529291272,124200,529415472,0,9,1,201728,45,7108435172
9213,529352681,99183,529451864,0,9,1,116736,45,4726381578
9214,529377272,47600,529424872,0,1,0,2560,18,2124981980
9215,529514342,74588,529588930,0,9,0,3584,45,2752165376
9216,529644797,43904,529688701,0,9,0,512,45,8385018806
9217,529663022,162374,529825396,0,1,1,262656,18,6359146397
9218,529708616,117104,529825720,0,7,0,84480,40,6349656790
9219,529809265,2946,529812211,0,2,1,3072,14,8376211990
9220,529858092,16096,529874188,0,2,1,31232,14,8395108717
9221,530093236,45596,530138832,0,1,0,1024,18,5414139110
9222,530096180,64742,530160922,0,1,1,105984,18,6981980774
9223,530098945,5712,530104657,0,2,1,14336,14,2721033853
9224,530115678,4374,530120052,0,2,1,4608,14,9262415451
9225,530143424,56854,530200278,0,1,1,97280,18,1842373809
9226,530154398,12308,530166706,0,9,1,20480,45,1541687960
9227,530329836,85266,530415102,0,1,0,512,18,1516847404
9228,530365186,12737,530377923,0,9,1,24576,45,4231320777
9229,530368009,74867,530442876,0,1,1,122368,18,261961297
9230,530414547,109401,530523948,0,1,0,1536,18,8922595327
9231,530436750,123180,530559930,0,1,0,2560,18,1023447067
9232,530460300,71640,530531940,0,1,0,2560,18,4363633423
9233,530575973,236003,530811976,0,1,1,386048,18,9724866017
9234,530591834,2870,530594704,0,2,1,8704,14,6238290519
9235,530628695,239366,530868061,0,1,0,12288,18,6922562166
9236,530647184,171023,530818207,0,1,0,1024,18,1054533016
9237,530670777,71766,530742543,0,9,1,116224,45,10434200292
9238,530711364,277367,530988731,0,9,1,450048,45,3508457705
9239,530779743,13341,530793084,0,2,1,22528,14,4945037927
9240,530803369,165216,530968585,0,1,1,268288,18,7328688124
9241,530872348,50672,530923020,0,3,0,2560,37,3329296408
9242,530891272,92968,530984240,0,1,1,50176,18,1133029421
9243,530924688,288819,531213507,0,1,0,12800,18,3291057063
9244,531003164,5196,531008360,0,2,1,13312,14,7626617145
9245,531028517,117355,531145872,0,9,0,2048,45,6755809948
9246,531030448,6754,531037202,0,2,1,7168,14,9320099703
9247,531129430,116312,531245742,0,1,1,193024,18,7368054500
9248,531282673,91241,531373914,0,1,1,147456,18,5187994952
9249,531467787,106028,531573815,0,7,0,48128,40,2398328461
9250,531470018,5971,531475989,0,3,1,14848,37,7294363113
9251,531595179,48980,531644159,0,9,0,2048,45,2032700950
9252,531676021,72024,531748045,0,9,1,116736,45,4712686017
9253,531677019,113092,531790111,0,9,0,2048,45,6819848168
9254,531699232,1994,531701226,0,1,1,2048,18,6892451770
9255,531720003,7706,531727709,0,1,1,8192,18,1633877863
9256,531751586,55748,531807334,0,3,0,4096,37,8216255553
9257,531920348,67592,531987940,0,3,0,7680,37,6602205094
9258,532003702,3422,532007124,0,1,1,3584,18,1972709202
9259,532020834,5326,532026160,0,1,1,5632,18,5858564017
9260,532039329,16354,532055683,0,2,1,31744,14,7834241183
9261,532144366,4162,532148528,0,1,1,11264,18,1837511071
9262,532239414,12825,532252239,0,2,1,21504,14,2383852595
9263,532299391,100100,532399491,0,7,0,28672,40,8489382022
9264,532400646,50999,532451645,0,9,1,82432,45,3149477725
9265,532459981,5454,532465435,0,2,1,13824,14,1747235157
9266,532521175,99788,532620963,0,7,0,27648,40,163876893
9267,532915666,49292,532964958,0,1,0,3072,18,6910620505
9268,532969367,70976,533040343,0,3,0,8704,37,9650943941
9269,533262277,62516,533324793,0,1,0,6144,18,5270751651
9270,533435845,43904,533479749,0,1,0,512,18,3392423644
9271,533443856,45596,533489452,0,3,0,1024,37,5431200757
9272,533652838,26738,533679576,0,4,1,48640,12,5506144189
9273,533667647,220262,533887909,0,7,0,195072,40,9978207581
9274,533679407,103142,533782549,0,7,0,512,40,3330341074
9275,533866894,49136,533916030,0,1,0,2560,18,139692191
9276,533878689,60723,533939412,0,1,0,2560,18,3804095513
9277,533894879,116636,534011515,0,7,0,82944,40,6011934004
9278,533899719,47444,533947163,0,3,0,2048,37,9842821497
9279,533907437,43904,533951341,0,3,0,512,37,7890394740
9280,533943915,51296,533995211,0,3,0,4608,37,2648604635
9281,534110696,187704,534298400,0,4,1,308736,12,4468024381
9282,534129658,45596,534175254,0,9,0,1024,45,983667326
9283,534175023,65900,534240923,0,1,0,7168,18,974305937
9284,534248021,155520,534403541,0,4,1,256000,12,1478833766
9285,534335127,50672,534385799,0,9,0,2560,45,4625690373
9286,534385228,46159,534431387,0,9,0,1024,45,8865686352
9287,534522512,3645,534526157,0,1,1,10240,18,3747460465
9288,534553838,13858,534567696,0,1,1,23552,18,4311235699
9289,534554047,67748,534621795,0,9,0,8192,45,5149844925
9290,534723190,6278,534729468,0,1,1,6656,18,626526495
9291,534840996,45596,534886592,0,1,0,1024,18,5493265886
9292,534878546,123656,535002202,0,7,0,105984,40,8021986519
9293,535001044,47288,535048332,0,9,0,1536,45,5915197804
9294,535055582,52364,535107946,0,9,0,3072,45,4723438862
9295,535131316,67592,535198908,0,1,0,7680,18,5095618814
9296,535145316,5971,535151287,0,1,1,14848,18,7414907176
9297,535152362,258321,535410683,0,4,1,422912,12,2333915813
9298,535236768,195318,535432086,0,4,1,69632,12,6554036122
9299,535260683,47288,535307971,0,7,0,1536,40,6251321950
9300,535315236,62516,535377752,0,3,0,6144,37,5269719181
9301,535532313,211184,535743497,0,7,0,231936,40,10732650176
9302,536200063,457549,536657612,0,9,1,740864,45,1048303620
9303,536211640,50672,536262312,0,3,0,2560,37,55113639
9304,536214315,59132,536273447,0,1,0,5120,18,2085764876
9305,536315867,7230,536323097,0,3,1,7680,37,8376054117
9306,536331497,5802,536337299,0,1,1,6144,18,10242112471
9307,536388494,129116,536517610,0,7,0,123904,40,1702650638
9308,536475316,1994,536477310,0,7,1,2048,40,4067342774
9309,536609017,158742,536767759,0,9,0,512,45,760120148
9310,536668920,82088,536751008,0,7,0,19968,40,7058251655
9311,536681273,145749,536827022,0,7,0,41472,40,10118965589
9312,536759795,43904,536803699,0,9,0,512,45,7834344685
9313,536791108,52364,536843472,0,3,0,3072,37,8384790988
9314,536910207,45596,536955803,0,1,0,1024,18,7479659018
9315,537134366,43904,537178270,0,3,0,512,37,783109534
9316,537169342,2470,537171812,0,1,1,2560,18,6275690263
9317,537176919,45596,537222515,0,1,0,1024,18,1418054892
9318,537228950,45596,537274546,0,1,0,1024,18,3486473009
9319,537235732,223772,537459504,0,7,0,263168,40,1672020923
9320,537251838,45596,537297434,0,9,0,1024,45,1257124989
9321,537302221,47288,537349509,0,9,0,1536,45,7015767298
9322,537333803,69284,537403087,0,9,0,8192,45,5975888645
9323,537401592,71674,537473266,0,7,1,26624,40,2697612616
9324,537680316,45596,537725912,0,3,0,1024,37,415243012
9325,537709414,45596,537755010,0,3,0,1024,37,8555974288
9326,537742171,48980,537791151,0,3,0,2048,37,4149854596
9327,537855451,68216,537923667,0,7,0,9728,40,1015808113
9328,538089467,10757,538100224,0,7,1,17408,40,3387337931
9329,538115945,262587,538378532,0,7,0,201216,40,7633331562
9330,538124249,55748,538179997,0,1,0,4096,18,8654832979
9331,538832340,43904,538876244,0,1,0,512,18,2492154144
9332,538838963,298712,539137675,0,7,0,357888,40,9718174254
9333,538860254,45752,538906006,0,9,0,1536,45,4203634557
9334,538961098,14029,538975127,0,9,1,27136,45,3716566916
9335,539022715,160074,539182789,0,7,0,121856,40,2675403189
9336,539025347,120299,539145646,0,7,0,26112,40,3905593241
9337,539043609,47288,539090897,0,9,0,1536,45,8751666926
9338,539079268,45596,539124864,0,3,0,1024,37,6441503502
9339,539193112,123500,539316612,0,7,0,105472,40,1298568144
9340,539197981,62516,539260497,0,1,0,6144,18,5911548978
9341,539228202,232116,539460318,0,7,0,182784,40,5293761381
9342,539305540,12737,539318277,0,9,1,24576,45,304894711
9343,539554120,33245,539587365,0,9,1,57856,45,9854545145
9344,539797073,45596,539842669,0,3,0,1024,37,331028582
9345,539870177,45596,539915773,0,3,0,1024,37,5996636145
9346,539882937,22174,539905111,0,9,1,36352,45,7151075271
9347,540079297,4162,540083459,0,7,1,11264,40,8809522229
9348,540092984,43904,540136888,0,3,0,512,37,8245987315
9349,540152577,67592,540220169,0,3,0,7680,37,2980885839
9350,540219550,133549,540353099,0,9,1,216576,45,7019164296
9351,540357170,50672,540407842,0,1,0,2560,18,2273349030
9352,540366722,50672,540417394,0,1,0,2560,18,6196657713
9353,540398177,155529,540553706,0,9,0,1536,45,1556573020
9354,540398412,198392,540596804,0,7,0,189952,40,2915819706
9355,540633877,366584,541000461,0,7,0,419328,40,56435704
9356,540979067,3422,540982489,0,1,1,3584,18,7574084520
9357,541031912,566,541032478,0,1,1,512,18,3167278011
9358,541068429,14029,541082458,0,1,1,27136,18,2996170746
9359,541091516,43904,541135420,0,1,0,512,18,550171776
9360,541163502,43904,541207406,0,3,0,512,37,1413441281
9361,541284958,47288,541332246,0,3,0,1536,37,8193485584
9362,541418770,4162,541422932,0,2,1,11264,14,5745152697
9363,541623596,2870,541626466,0,1,1,8704,18,6251115152
9364,541725536,48980,541774516,0,9,0,2048,45,882858923
9365,541905323,566,541905889,0,1,1,512,18,2591388630
9366,542514456,65900,542580356,0,3,0,7168,37,6871903723
9367,542545615,47288,542592903,0,9,0,1536,45,6530373091
9368,542723800,47288,542771088,0,3,0,1536,37,4348046431
9369,542769644,294032,543063676,0,7,0,342528,40,1779805763
9370,542782737,7706,542790443,0,1,1,8192,18,2668575921
9371,542839071,264556,543103627,0,7,0,131072,40,5895907457
9372,542990894,45596,543036490,0,1,0,1024,18,4938185205
9373,543112040,45752,543157792,0,3,0,1536,37,8596375451
9374,543298044,1994,543300038,0,1,1,2048,18,871572646
9375,543322529,5326,543327855,0,2,1,5632,14,2086697994
9376,543347681,21658,543369339,0,1,1,35328,18,6841869993
9377,543783755,55748,543839503,0,9,0,4096,45,8406488557
9378,543792833,116012,543908845,0,7,0,80896,40,1198357819
9379,543955057,116168,544071225,0,7,0,81408,40,6764045301
9380,544561492,55748,544617240,0,1,0,4096,18,9375341449
9381,544618844,45596,544664440,0,3,0,1024,37,4369822755
9382,544718090,10241,544728331,0,3,1,16384,37,9142501190
9383,544765863,121004,544886867,0,7,0,97280,40,6686735866
9384,544781331,13083,544794414,0,1,1,22016,18,6959227073
9385,544916604,66212,544982816,0,3,0,8192,37,2259782909
9386,545079799,3422,545083221,0,1,1,3584,18,4082250514
9387,545439737,4162,545443899,0,3,1,11264,37,775279426
9388,545669856,1042,545670898,0,3,1,1024,37,7949861834
9389,545680243,1518,545681761,0,1,1,1536,18,9172671633
9390,545695352,1518,545696870,0,7,1,1536,40,757138566
9391,545809774,24154,545833928,0,7,1,43520,40,3174167513
9392,545812901,76862,545889763,0,7,0,9728,40,6888642479
9393,546039386,4420,546043806,0,5,1,11776,20,6195659515
9394,546040081,1518,546041599,0,3,1,1536,37,6129317578
9395,546041808,43904,546085712,0,3,0,512,37,6879191800
9396,546072341,47288,546119629,0,9,0,1536,45,2296333008
9397,546143535,15062,546158597,0,7,1,29184,40,529386567
9398,546162899,40616,546203515,0,1,1,65536,18,5555306729
9399,546176500,73069,546249569,0,1,0,3584,18,2676605664
9400,546198205,149215,546347420,0,1,0,1536,18,3559151729
9401,546291975,45596,546337571,0,3,0,1024,37,1297718034
9402,546303466,60824,546364290,0,9,0,5632,45,9136725064
9403,546321058,5454,546326512,0,7,1,13824,40,7797553678
9404,546374193,4850,546379043,0,2,1,5120,14,4354553782
9405,546396245,3422,546399667,0,7,1,3584,40,8525029190
9406,546426765,13253,546440018,0,5,1,25600,20,1630929382
9407,546582108,1994,546584102,0,1,1,2048,18,2403152448
9408,546614969,4850,546619819,0,1,1,5120,18,2189068314
9409,546690279,11274,546701553,0,3,1,18432,37,8045861678
9410,546698689,45596,546744285,0,3,0,1024,37,8288403161
9411,546768251,43904,546812155,0,1,0,512,18,10385708556
9412,546785261,12049,546797310,0,1,1,19968,18,6745200773
9413,546857664,48980,546906644,0,9,0,2048,45,6404477794
9414,546933102,2470,546935572,0,7,1,2560,40,2475143118
9415,546938981,1994,546940975,0,7,1,2048,40,9244406180
9416,546967918,11274,546979192,0,1,1,18432,18,8690666185
9417,546972905,34108,547007013,0,2,1,56320,14,1737410568
9418,547072578,43904,547116482,0,9,0,512,45,2667171611
9419,547126453,216488,547342941,0,7,0,249344,40,1999279287
9420,547179713,24242,547203955,0,5,1,40448,20,2331015332
9421,547229947,662835,547892782,0,7,0,787968,40,8471632584
9422,547243272,22862,547266134,0,5,1,40960,20,9559592616
9423,547387299,1994,547389293,0,7,1,2048,40,6358561843
9424,547479803,1042,547480845,0,7,1,1024,40,3537557480
9425,547491349,72824,547564173,0,9,0,9728,45,10517753065
9426,547498253,4850,547503103,0,5,1,5120,20,4924097920
9427,547557585,1994,547559579,0,7,1,2048,40,6632565759
9428,547571513,43904,547615417,0,1,0,512,18,2079350750
9429,547591970,66056,547658026,0,3,0,7680,37,1717120927
9430,547623552,48980,547672532,0,3,0,2048,37,1303429163
9431,547834469,181805,548016274,0,7,0,105472,40,4729603261
9432,547845728,48980,547894708,0,9,0,2048,45,3965295296
9433,547856056,11533,547867589,0,2,1,18944,14,10560507267
9434,547967126,43716,548010842,0,2,1,71680,14,1400329196
9435,548018229,4937,548023166,0,1,1,12800,18,6280860134
9436,548096663,30491,548127154,0,2,1,49152,14,6070855086
9437,548117251,11209,548128460,0,2,1,2048,14,293242589
9438,548227749,5454,548233203,0,1,1,13824,18,8409798924
9439,548228221,391856,548620077,0,7,0,502272,40,10067079175
9440,548235552,10757,548246309,0,7,1,17408,40,2489674246
9441,548246135,2946,548249081,0,3,1,3072,37,735969731
9442,548284577,7706,548292283,0,1,1,8192,18,4191425716
9443,548293726,6754,548300480,0,3,1,7168,37,3555395641
9444,548311540,340792,548652332,0,7,0,55808,40,2451744297
9445,548382084,12049,548394133,0,7,1,19968,40,10567671565
9446,548405516,72120,548477636,0,1,0,5120,18,4935342848
9447,548426146,5802,548431948,0,2,1,6144,14,2273178841
9448,548506478,120096,548626574,0,7,1,15872,40,2370789442
9449,548602190,150615,548752805,0,7,0,84480,40,8510583982
9450,548728334,3128,548731462,0,1,1,9216,18,8028286592
9451,548738289,64832,548803121,0,1,0,8704,18,3172417499
9452,548756263,48980,548805243,0,9,0,2048,45,5143337006
9453,548766530,16354,548782884,0,1,1,31744,18,1588839030
9454,548817259,49136,548866395,0,3,0,2560,37,2870178814
9455,548962035,2870,548964905,0,7,1,8704,40,9026581487
9456,548982044,45596,549027640,0,9,0,1024,45,8091749311
9457,549003755,43904,549047659,0,1,0,512,18,9275116382
9458,549054078,11016,549065094,0,5,1,17920,20,5548826027
9459,549089011,566,549089577,0,5,1,512,20,7468027180
9460,549099501,1042,549100543,0,7,1,1024,40,2187696708
9461,549181061,144191,549325252,0,1,1,233984,18,2954146443
9462,549292516,45596,549338112,0,3,0,1024,37,4268402079
9463,549312098,79436,549391534,0,3,0,11264,37,9936805446
9464,549317468,14545,549332013,0,5,1,28160,20,332718137
9465,549319060,130102,549449162,0,1,0,1536,18,10332332822
9466,549432466,50828,549483294,0,9,0,3072,45,5231540313
9467,549576153,48980,549625133,0,9,0,2048,45,5620104961
9468,549652627,41391,549694018,0,2,1,67072,14,6678050908
9469,549655253,1042,549656295,0,1,1,1024,18,1138029448
9470,549670957,26607,549697564,0,2,1,5632,14,2744650591
9471,549901019,11016,549912035,0,3,1,17920,37,7425884419
9472,549931819,91499,550023318,0,1,1,147968,18,10468470835
9473,549961346,15062,549976408,0,2,1,29184,14,6430968191
9474,550012223,34020,550046243,0,1,1,59392,18,8208994391
9475,550086659,50672,550137331,0,9,0,2560,45,10306250315
9476,550109937,16613,550126550,0,5,1,32256,20,2802455789
9477,550234255,4679,550238934,0,5,1,12288,20,10726582414
9478,550252933,55748,550308681,0,3,0,4096,37,3415985553
9479,550454259,1518,550455777,0,3,1,1536,37,2914941664
9480,550646590,2470,550649060,0,3,1,2560,37,6944724752
9481,550703650,30491,550734141,0,2,1,49152,14,9559721631
9482,550907500,11016,550918516,0,5,1,17920,20,8530382501
9483,551019577,3422,551022999,0,2,1,3584,14,3803733067
9484,551065487,43904,551109391,0,3,0,512,37,7479866204
9485,551129179,47288,551176467,0,1,0,1536,18,6078508222
9486,551334301,68840,551403141,0,9,0,11776,45,5262765846
9487,551353584,23466,551377050,0,2,1,38912,14,10682197493
9488,551565634,3645,551569279,0,2,1,10240,14,8395115721
9489,551617685,12308,551629993,0,5,1,20480,20,1973686794
9490,551625834,2946,551628780,0,2,1,3072,14,2975974413
9491,551631453,32558,551664011,0,3,1,53248,37,5447161582
9492,551710212,1042,551711254,0,2,1,1024,14,8798532331
9493,551809839,20366,551830205,0,3,1,32768,37,10592408711
9494,551851399,3898,551855297,0,3,1,4096,37,2589026106
9495,551899876,55904,551955780,0,3,0,4608,37,7469298485
9496,552113645,6754,552120399,0,5,1,7168,20,1936509600
9497,552324346,566,552324912,0,2,1,512,14,3603051833
9498,552360905,566,552361471,0,2,1,512,14,1068504478
9499,552571686,200732,552772418,0,7,0,197632,40,1634578288
9500,552678594,14029,552692623,0,5,1,27136,20,7016906085
9501,552688334,5712,552694046,0,3,1,14336,37,10465514074
9502,552695312,14117,552709429,0,3,1,24064,37,10289680668
9503,552848198,15579,552863777,0,5,1,30208,20,9711081225
9504,552926311,6278,552932589,0,5,1,6656,20,7128616975
9505,552994639,6229,553000868,0,3,1,15360,37,2440399817
9506,553012976,52364,553065340,0,3,0,3072,37,9466762544
9507,553031525,5454,553036979,0,5,1,13824,20,323104840
9508,553057093,52364,553109457,0,7,0,3072,40,10680864003
9509,553259183,73292,553332475,0,1,0,11264,18,8224831274
9510,553319121,73487,553392608,0,1,1,122880,18,8077951937
9511,553320733,129428,553450161,0,7,0,124928,40,9738969570
9512,553638440,48980,553687420,0,3,0,2048,37,3551469471
9513,554368449,50828,554419277,0,3,0,3072,37,5406062617
9514,554377090,16354,554393444,0,2,1,31744,14,1882676283
9515,554488202,58220,554546422,0,1,0,7168,18,2599772246
9516,554653938,109148,554763086,0,7,0,58368,40,2854721835
9517,554874154,45596,554919750,0,3,0,1024,37,1430376539
9518,555305026,47288,555352314,0,3,0,1536,37,9497331769
9519,555563478,47288,555610766,0,1,0,1536,18,9637260711
9520,555680854,43904,555724758,0,1,0,512,18,7746021587
9521,556174257,45596,556219853,0,7,0,1024,40,1577444932
9522,556194119,97136,556291255,0,7,0,18944,40,7066783162
9523,556615488,43904,556659392,0,3,0,512,37,10691558524
9524,556825565,45596,556871161,0,1,0,1024,18,10522297984
9525,556902965,170084,557073049,0,7,0,147456,40,6967715111
9526,556985326,54056,557039382,0,3,0,3584,37,1133815567
9527,557071466,47288,557118754,0,3,0,1536,37,1842947154
9528,557173798,47288,557221086,0,3,0,1536,37,7145286584
9529,557596495,50672,557647167,0,7,0,2560,40,9494080645
9530,557609866,47288,557657154,0,3,0,1536,37,2915811282
9531,557850944,6754,557857698,0,3,1,7168,37,1638901745
9532,558160727,43904,558204631,0,3,0,512,37,9855218656
9533,558215676,47288,558262964,0,3,0,1536,37,10375784899
9534,558353663,43904,558397567,0,1,0,512,18,6813736264
9535,558445156,52520,558497676,0,1,0,3584,18,1945057370
9536,558820740,203228,559023968,0,7,0,205824,40,10696350426
9537,558911635,62516,558974151,0,1,0,6144,18,10673060714
9538,558993107,131109,559124216,0,7,0,29184,40,454993598
9539,559127813,279212,559407025,0,7,0,293888,40,9624050754
9540,559179137,54056,559233193,0,3,0,3584,37,2234717332
9541,559190543,47288,559237831,0,1,0,1536,18,3305682145
9542,559300773,168488,559469261,0,1,1,278016,18,4487621909
9543,559411727,43904,559455631,0,3,0,512,37,5391867503
9544,559656298,64208,559720506,0,3,0,6656,37,793520233
9545,559687575,43904,559731479,0,1,0,512,18,5895198047
9546,559968332,43904,560012236,0,1,0,512,18,1595436498
9547,560365633,121628,560487261,0,7,0,99328,40,733256013
9548,560398209,241962,560640171,0,7,0,206848,40,7197794337
9549,560404428,43904,560448332,0,1,0,512,18,8531038331
9550,561124986,45596,561170582,0,3,0,1024,37,457139642
9551,561163929,45596,561209525,0,1,0,1024,18,9115812633
9552,561175816,45596,561221412,0,1,0,1024,18,8572019235
9553,561415246,111800,561527046,0,7,0,67072,40,379081696
9554,561428716,47600,561476316,0,1,0,2560,18,9438400602
9555,561450574,43904,561494478,0,1,0,512,18,8498108890
9556,561802640,212276,562014916,0,7,0,235520,40,2575719412
9557,561878646,45596,561924242,0,3,0,1024,37,6409867173
9558,561899811,119020,562018831,0,7,0,12800,40,4060814493
9559,562010836,111363,562122199,0,7,0,39424,40,5950538743
9560,562024133,163754,562187887,0,7,0,93696,40,7411522503
9561,562134204,48980,562183184,0,1,0,2048,18,921697147
9562,562170002,139661,562309663,0,7,0,99840,40,7343257825
9563,562785928,103688,562889616,0,7,0,40448,40,8608243490
9564,562932567,86672,563019239,0,7,0,14848,40,10284099704
9565,562996146,48980,563045126,0,3,0,2048,37,9821204365
9566,563044193,47288,563091481,0,3,0,1536,37,10675774368
9567,563188963,48980,563237943,0,3,0,2048,37,3319025998
9568,563270587,43904,563314491,0,3,0,512,37,6604245906
9569,563635949,50672,563686621,0,3,0,2560,37,1055184026
9570,563695567,50672,563746239,0,1,0,2560,18,1966381711
9571,563705889,121628,563827517,0,7,0,99328,40,1637501474
9572,563806443,43904,563850347,0,3,0,512,37,4825122657
9573,563901869,62516,563964385,0,3,0,6144,37,9673732555
9574,564243505,47288,564290793,0,1,0,1536,18,2812123046
9575,564756424,109772,564866196,0,1,0,60416,18,3361189806
9576,564784888,57596,564842484,0,3,0,5120,37,3861108758
9577,565116823,102596,565219419,0,1,0,36864,18,622463993
9578,565344575,1994,565346569,0,2,1,2048,14,652215814
9579,565424710,22950,565447660,0,2,1,37888,14,2564585105
9580,565440660,111020,565551680,0,1,0,64512,18,991778338
9581,565562876,192308,565755184,0,1,0,169984,18,4890949075
9582,565656948,43904,565700852,0,3,0,512,37,8131923805
9583,565725420,10757,565736177,0,5,1,17408,20,288481805
9584,566191008,45596,566236604,0,1,0,1024,18,2603270559
9585,566200042,1042,566201084,0,2,1,1024,14,3301429804
9586,566276862,43904,566320766,0,3,0,512,37,2335573924
9587,566611217,13600,566624817,0,5,1,23040,20,236417640
9588,566649149,108992,566758141,0,1,0,57856,18,6018723742
9589,566679413,3898,566683311,0,2,1,4096,14,6797081119
9590,566791680,14117,566805797,0,1,1,24064,18,244912286
9591,566798565,197732,566996297,0,1,0,169984,18,8137445715
9592,566831403,212546,567043949,0,1,0,31744,18,10626754218
9593,567215721,83183,567298904,0,1,1,135168,18,3433697325
9594,567483177,70976,567554153,0,1,0,8704,18,5066923139
9595,567616129,43904,567660033,0,3,0,512,37,4100555494
9596,567726835,23983,567750818,0,3,1,39936,37,5024009045
9597,567775869,80097,567855966,0,3,0,1024,37,5330456307
9598,567808628,3898,567812526,0,2,1,4096,14,41726674
9599,567846345,3904,567850249,0,1,1,10752,18,4811246127
9600,567846683,45596,567892279,0,3,0,1024,37,8039129288
9601,568403658,566,568404224,0,2,1,512,14,5768795845
9602,568603524,50672,568654196,0,3,0,2560,37,2658407879
9603,568646867,23120,568669987,0,2,1,41472,14,3668158309
9604,568735102,3645,568738747,0,2,1,10240,14,10625343139
9605,568792320,136376,568928696,0,1,0,132608,18,5777903700
9606,568865867,48980,568914847,0,3,0,2048,37,7959622887
9607,568922460,57440,568979900,0,3,0,4608,37,7860684102
9608,569044471,48980,569093451,0,3,0,2048,37,9608743186
9609,569152638,58688,569211326,0,3,0,8704,37,9838487059
9610,569281449,59132,569340581,0,3,0,5120,37,91280975
9611,569305626,3422,569309048,0,2,1,3584,14,4025501511
9612,569358028,13858,569371886,0,2,1,23552,14,2244316481
9613,569363292,15819,569379111,0,2,1,23552,14,6779556417
9614,569451865,43904,569495769,0,3,0,512,37,10470675384
9615,569508535,43904,569552439,0,3,0,512,37,5333234991
9616,569739032,43904,569782936,0,3,0,512,37,6735769241
9617,569863914,50984,569914898,0,3,0,3584,37,3393232218
9618,570143618,56996,570200614,0,1,0,8192,18,3105625847
9619,570332010,2946,570334956,0,2,1,3072,14,4558309229
9620,570434080,3904,570437984,0,2,1,10752,14,7872957199
9621,570589476,116948,570706424,0,3,0,83968,37,1267786201
9622,570762014,376100,571138114,0,1,0,450560,18,6475098824
9623,570999278,47288,571046566,0,2,0,1536,14,6587574239
9624,571129882,52364,571182246,0,2,0,3072,14,3757382611
9625,571322623,50672,571373295,0,2,0,2560,14,6118040649
9626,571368118,3645,571371763,0,2,1,10240,14,7855772349
9627,571502595,52364,571554959,0,2,0,3072,14,7680163999
9628,571503648,67460,571571108,0,1,0,12288,18,8825994578
9629,571746144,45596,571791740,0,2,0,1024,14,2526899841
9630,571799775,43904,571843679,0,2,0,512,14,9643850065
9631,571975346,14287,571989633,0,2,1,27648,14,9941689962
9632,571985049,52522,572037571,0,2,0,1536,14,1823168418
9633,572009071,43904,572052975,0,2,0,512,14,8094972440
9634,572020535,120536,572141071,0,1,0,95744,18,2978786819
9635,572089518,149881,572239399,0,1,0,118784,18,6718958901
9636,572166411,47444,572213855,0,2,0,2048,14,2708844316
9637,572257027,207596,572464623,0,1,0,220160,18,9226518706
9638,572391465,10499,572401964,0,2,1,16896,14,9099885507
9639,572397765,50672,572448437,0,2,0,2560,14,1544428392
9640,572407355,2870,572410225,0,2,1,8704,14,8916471856
9641,572495162,105560,572600722,0,3,0,46592,37,3144719209
9642,572502911,104534,572607445,0,3,0,22016,37,8162108654
9643,572539544,130832,572670376,0,1,0,129536,18,9215143676
9644,572856155,200420,573056575,0,1,0,196608,18,10511502249
9645,573189449,104468,573293917,0,3,0,43008,37,10090686893
9646,573340107,198392,573538499,0,3,0,189952,37,530320988
9647,573359164,23983,573383147,0,2,1,39936,14,10167962416
9648,573539102,7230,573546332,0,2,1,7680,14,2849747021
9649,573582841,45596,573628437,0,2,0,1024,14,479039994
9650,573617543,184556,573802099,0,1,0,154624,18,10082300747
9651,573703897,31783,573735680,0,2,1,51712,14,5576208655
9652,573747606,43904,573791510,0,2,0,512,14,3295807200
9653,573766556,116168,573882724,0,3,0,81408,37,3432535890
9654,573814068,4937,573819005,0,2,1,12800,14,9999568376
9655,573947254,462266,574409520,0,1,0,540672,18,4937493399
9656,573976372,45596,574021968,0,2,0,1024,14,9319672388
9657,574177985,161156,574339141,0,3,0,143360,37,9272213291
9658,574377361,3645,574381006,0,2,1,10240,14,3304299951
9659,574601218,43904,574645122,0,2,0,512,14,2758980833
9660,574666032,113672,574779704,0,1,0,73216,18,7110490500
9661,574789121,116948,574906069,0,1,0,83968,18,3686135400
9662,574837011,65900,574902911,0,2,0,7168,14,941966211
9663,574928318,4937,574933255,0,2,1,12800,14,5830381071
9664,575039993,68684,575108677,0,1,0,11264,18,6287408334
9665,575132810,5712,575138522,0,2,1,14336,14,6794353457
9666,575686220,4850,575691070,0,2,1,5120,14,7335685797
9667,575686559,9657,575696216,0,2,1,8192,14,1939980989
9668,575696278,106652,575802930,0,3,0,50176,37,9346309378
9669,575819212,50672,575869884,0,2,0,2560,14,8409722464
9670,575878591,48980,575927571,0,2,0,2048,14,1579021767
9671,575942564,2470,575945034,0,2,1,2560,14,5429250158
9672,576252003,5802,576257805,0,2,1,6144,14,9458235555
9673,576333873,566,576334439,0,2,1,512,14,1496277449
9674,576445367,4850,576450217,0,2,1,5120,14,3356722149
9675,576501679,87632,576589311,0,1,0,23040,18,1164292647
9676,576766078,47288,576813366,0,2,0,1536,14,8165446199
9677,576892910,65456,576958366,0,1,0,10752,18,3870750546
9678,576900453,566,576901019,0,2,1,512,14,4506799172
9679,577007150,13512,577020662,0,2,1,26112,14,4314461416
9680,577144985,12049,577157034,0,2,1,19968,14,1808130768
9681,577268688,109616,577378304,0,1,0,59904,18,8421956232
9682,577630522,106340,577736862,0,1,0,49152,18,2399673469
9683,577644816,104000,577748816,0,3,0,41472,37,2181656745
9684,577704443,45596,577750039,0,2,0,1024,14,3827288469
9685,577822625,3387,577826012,0,7,1,9728,40,8387538500
9686,577872320,1518,577873838,0,7,1,1536,40,1961018440
9687,578130941,4374,578135315,0,7,1,4608,40,5043169776
9688,578367187,13770,578380957,0,7,1,26624,40,1278650832
9689,578415100,43904,578459004,0,2,0,512,14,9870243681
9690,578642691,48980,578691671,0,2,0,2048,14,76480198
9691,578712689,13512,578726201,0,7,1,26112,40,5065973785
9692,578811458,43904,578855362,0,2,0,512,14,4721876417
9693,578927013,45596,578972609,0,2,0,1024,14,5439158608
9694,578931757,291848,579223605,0,3,0,335360,37,866422481
9695,579376180,566,579376746,0,2,1,512,14,3530053056
9696,579655676,7230,579662906,0,7,1,7680,40,4167188812
9697,579737882,193400,579931282,0,1,0,173568,18,127682365
9698,579954695,3645,579958340,0,7,1,10240,40,4264081450
9699,580178789,6229,580185018,0,7,1,15360,40,597614484
9700,580321233,111020,580432253,0,1,0,64512,18,9078033237
9701,580545813,23120,580568933,0,7,1,41472,40,2929241572
9702,580607353,55748,580663101,0,3,0,4096,37,9348892653
9703,580749618,2470,580752088,0,7,1,2560,40,1914007656
9704,581254595,282956,581537551,0,1,0,306176,18,1711998294
9705,581309502,236020,581545522,0,1,0,26112,18,3343351731
9706,581455816,3128,581458944,0,7,1,9216,40,1751360429
9707,581664938,126464,581791402,0,1,0,115200,18,7392184576
9708,581802520,4420,581806940,0,7,1,11776,40,161113609
9709,581904778,128648,582033426,0,3,0,122368,37,8520184788
9710,581944519,10757,581955276,0,7,1,17408,40,7171071959
9711,582120069,6754,582126823,0,5,1,7168,20,5194180060
9712,582165771,70688,582236459,0,1,0,12800,18,187883287
9713,582261453,259040,582520493,0,1,0,283136,18,1677502476
9714,582305639,4850,582310489,0,7,1,5120,40,2338668505
9715,582446316,10241,582456557,0,7,1,16384,40,3549166983
9716,582768922,126776,582895698,0,3,0,116224,37,8104476080
9717,582777829,168269,582946098,0,3,0,120320,37,3779926918
9718,583253992,160088,583414080,0,1,0,144896,18,496852112
9719,583344626,120692,583465318,0,3,0,96256,37,7746591186
9720,583500026,21399,583521425,0,7,1,34816,40,4388213257
9721,583578992,205412,583784404,0,3,0,212992,37,3172058269
9722,583603944,3645,583607589,0,7,1,10240,40,3089885099
9723,583647358,2946,583650304,0,7,1,3072,40,6029405833
9724,583801724,13083,583814807,0,5,1,22016,20,6615623682
9725,583803238,1042,583804280,0,1,1,1024,18,99168516
9726,583995006,4679,583999685,0,5,1,12288,20,4694484908
9727,584199386,205568,584404954,0,1,0,213504,18,6069287231
9728,584343578,68615,584412193,0,1,1,7680,18,1182525509
9729,584373260,47384,584420644,0,1,1,22528,18,2326215565
9730,584450868,104624,584555492,0,1,0,43520,18,4772463650
9731,584451314,153283,584604597,0,1,1,248320,18,8093545911
9732,584460556,281552,584742108,0,3,0,301568,37,4407809553
9733,584553900,82366,584636266,0,1,1,110592,18,5296713343
9734,584613608,213262,584826870,0,3,0,190464,37,9320037638
9735,584648693,3128,584651821,0,7,1,9216,40,6609127078
9736,584974430,112783,585087213,0,1,1,182784,18,4977333907
9737,585303073,12737,585315810,0,1,1,24576,18,674377181
9738,585402969,20882,585423851,0,1,1,33792,18,513969200
9739,585560357,86971,585647328,0,1,1,145920,18,1776445926
9740,585627362,25355,585652717,0,1,1,25600,18,1597041077
9741,585661220,145912,585807132,0,1,1,240640,18,9325114270
9742,585668775,77744,585746519,0,3,0,10752,37,5655499431
9743,586253376,112892,586366268,0,3,0,70656,37,10610165882
9744,586438649,7230,586445879,0,1,1,7680,18,7132238997
9745,586604336,223382,586827718,0,1,1,361472,18,4424447676
9746,587001733,112112,587113845,0,3,0,68096,37,2539970267
9747,587038903,4850,587043753,0,3,1,5120,37,10640839010
9748,587286422,22862,587309284,0,3,1,40960,37,10335243431
9749,587310537,255770,587566307,0,3,0,87040,37,4302292400
9750,587446485,349187,587795672,0,1,1,569856,18,4065846022
9751,587529871,50672,587580543,0,3,0,2560,37,5057346360
9752,587572193,437915,588010108,0,1,1,635904,18,8490198449
9753,587651679,113672,587765351,0,3,0,73216,37,2145015905
9754,587740618,24748,587765366,0,3,1,4608,37,1562402334
9755,587744455,406188,588150643,0,1,0,60416,18,9060570406
9756,587790834,240574,588031408,0,1,1,77312,18,9347145255
9757,588238837,143416,588382253,0,1,1,232448,18,7143586510
9758,588357377,403841,588761218,0,1,0,69120,18,7721285518
9759,588372097,678867,589050964,0,1,0,630784,18,3054427076
9760,588489664,202136,588691800,0,3,0,202240,37,10285848828
9761,588517518,71766,588589284,0,1,1,116224,18,6768243603
9762,588652973,5196,588658169,0,7,1,13312,40,5193502107
9763,588660562,100671,588761233,0,1,1,155648,18,9556899972
9764,588707082,88947,588796029,0,1,1,134144,18,3814491846
9765,588790278,5196,588795474,0,7,1,13312,40,8923098661
9766,588848532,3898,588852430,0,3,1,4096,37,5979391026
9767,588962362,75608,589037970,0,3,0,13824,37,10564387400
9768,588973723,11274,588984997,0,3,1,18432,37,7821586857
9769,588980470,1994,588982464,0,5,1,2048,20,7288786815
9770,588988230,341624,589329854,0,3,0,402944,37,1591505633
9771,589002848,63170,589066018,0,1,1,29184,18,559353071
9772,589397524,35312,589432836,0,1,1,61952,18,308057012
9773,589485052,5802,589490854,0,5,1,6144,20,349983979
9774,589742994,14117,589757111,0,1,1,24064,18,5380694962
9775,589832964,54056,589887020,0,1,0,3584,18,4247267348
9776,589861379,213257,590074636,0,1,1,345088,18,7859183408
9777,589991533,104711,590096244,0,1,1,78848,18,5447041409
9778,590089825,7706,590097531,0,7,1,8192,40,5104329254
9779,590140464,152249,590292713,0,1,1,246272,18,7142256544
9780,590219709,5971,590225680,0,7,1,14848,40,10356239560
9781,590233314,1518,590234832,0,7,1,1536,40,9563389303
9782,590246641,216590,590463231,0,1,0,11264,18,6925282313
9783,590287251,25187,590312438,0,1,1,45568,18,9010457926
9784,590343374,6754,590350128,0,7,1,7168,40,2549076172
9785,590428304,187362,590615666,0,1,0,4608,18,2826331442
9786,590540997,4850,590545847,0,5,1,5120,20,5748390505
9787,590757547,31266,590788813,0,1,1,50688,18,6487449074
9788,590778043,20624,590798667,0,5,1,33280,20,2921101115
9789,590928495,4937,590933432,0,5,1,12800,20,9054532309
9790,590930148,1042,590931190,0,7,1,1024,40,555295820
9791,591093877,2870,591096747,0,7,1,8704,40,5776883499
9792,591292399,306512,591598911,0,1,0,383488,18,10350223511
9793,591366113,322558,591688671,0,1,0,217088,18,5273427106
9794,591374893,5971,591380864,0,5,1,14848,20,5826090124
9795,591481182,11016,591492198,0,7,1,17920,40,4279263814
9796,591764508,2470,591766978,0,7,1,2560,40,10296655288
9797,591803731,122096,591925827,0,1,0,100864,18,1325004843
9798,591928879,205412,592134291,0,1,0,212992,18,2735351976
9799,592282781,211184,592493965,0,1,0,231936,18,4531710423
9800,592334605,15321,592349926,0,7,1,29696,40,7899990834
9801,592335236,566,592335802,0,5,1,512,20,8591497275
9802,592435885,11533,592447418,0,5,1,18944,20,10371388783
9803,592493682,15321,592509003,0,7,1,29696,40,7538654253
9804,593039550,217892,593257442,0,1,0,253952,18,2703112033
9805,593318452,3387,593321839,0,5,1,9728,20,8108663475
9806,593819628,3387,593823015,0,5,1,9728,20,4811910252
9807,593907165,123812,594030977,0,1,0,106496,18,823700021
9808,594233113,5326,594238439,0,5,1,5632,20,1917781703
9809,594535270,33503,594568773,0,5,1,58368,20,9450242242
9810,594856654,111488,594968142,0,1,0,66048,18,7854596676
9811,594871835,566,594872401,0,5,1,512,20,7798011210
9812,594969107,113984,595083091,0,1,0,74240,18,9194365059
9813,594985021,188718,595173739,0,1,0,144896,18,5925113841
9814,595365571,6229,595371800,0,5,1,15360,20,10021847863
9815,595553322,103064,595656386,0,1,0,38400,18,3973517547
9816,595721492,10241,595731733,0,5,1,16384,20,10486472243
9817,595798588,101504,595900092,0,1,0,33280,18,4181334266
9818,595912911,107120,596020031,0,1,0,51712,18,2791253632
9819,596094826,186670,596281496,0,1,1,306688,18,7458357650
9820,596100241,223497,596323738,0,1,1,136704,18,3294437494
9821,596204179,23895,596228074,0,5,1,43008,20,868737266
9822,596224273,512244,596736517,0,1,0,174080,18,8816483935
9823,596289989,277537,596567526,0,1,1,453632,18,5864179731
9824,596642357,14804,596657161,0,5,1,28672,20,1756912388
9825,596648850,231987,596880837,0,1,0,147968,18,5969659822
9826,596752380,128472,596880852,0,1,1,182784,18,5689972625
9827,596790971,89896,596880867,0,1,1,15872,18,3473159958
9828,596798530,160098,596958628,0,1,1,240128,18,10691365683
9829,596940672,20624,596961296,0,5,1,33280,20,3668399423
9830,597182012,194246,597376258,0,1,0,150016,18,5645344806
9831,597290528,198236,597488764,0,1,0,189440,18,2984333230
9832,597346842,1518,597348360,0,5,1,1536,20,3929437715
9833,597550253,12566,597562819,0,1,1,20992,18,6557643154
9834,597723964,67592,597791556,0,1,0,7680,18,7268320078
9835,597800113,4679,597804792,0,5,1,12288,20,2960965497
9836,597912509,32558,597945067,0,5,1,53248,20,31476181
9837,597945252,1994,597947246,0,5,1,2048,20,6805300437
9838,598008801,1042,598009843,0,1,1,1024,18,9832260359
9839,598026869,1994,598028863,0,5,1,2048,20,2450716672
9840,598056138,3387,598059525,0,1,1,9728,18,7425931004
9841,598298327,113984,598412311,0,1,0,74240,18,8305992578
9842,598300622,2470,598303092,0,5,1,2560,20,9046993449
9843,598449171,566,598449737,0,1,1,512,18,2421785096
9844,598476391,5196,598481587,0,5,1,13312,20,4827298099
9845,598614952,4162,598619114,0,1,1,11264,18,2899696244
9846,598633866,6754,598640620,0,5,1,7168,20,5317454428
9847,598735985,4850,598740835,0,5,1,5120,20,6360153484
9848,598788943,13083,598802026,0,1,1,22016,18,10450038716
9849,598798250,133018,598931268,0,1,0,23040,18,7293393833
9850,598857183,6278,598863461,0,5,1,6656,20,10313783150
9851,599023016,7230,599030246,0,1,1,7680,18,28340548
9852,599066126,12825,599078951,0,1,1,21504,18,2607999086
9853,599159883,1042,599160925,0,5,1,1024,20,5391929194
9854,599181343,12825,599194168,0,1,1,21504,18,6355567943
9855,599364996,4937,599369933,0,5,1,12800,20,4677026682
9856,599493342,23637,599516979,0,5,1,42496,20,1472241479
9857,599642568,4374,599646942,0,5,1,4608,20,8627242098
9858,599836594,25187,599861781,0,5,1,45568,20,312150281
9859,599900048,5802,599905850,0,1,1,6144,18,2677060446
9860,599989326,4162,599993488,0,1,1,11264,18,6805300625
9861,600270068,10757,600280825,0,7,1,17408,40,4816871273
9862,600338770,24929,600363699,0,1,1,45056,18,6083335421
9863,600455785,4420,600460205,0,7,1,11776,40,5154210627
9864,600594567,1518,600596085,0,1,1,1536,18,3181452632
9865,600642357,6754,600649111,0,7,1,7168,40,1265394497
9866,600850060,5712,600855772,0,1,1,14336,18,4494320997
9867,601093373,4937,601098310,0,7,1,12800,40,7874406106
9868,601541199,4679,601545878,0,7,1,12288,40,4122318279
9869,601554228,3898,601558126,0,7,1,4096,40,2861896331
9870,601654401,2870,601657271,0,7,1,8704,40,8776163730
9871,601703336,11016,601714352,0,7,1,17920,40,1168644896
9872,601974028,1042,601975070,0,7,1,1024,40,1296978175
9873,602739508,123344,602862852,0,1,0,104960,18,1457588353
9874,603522724,11791,603534515,0,7,1,19456,40,5668476518
9875,603547672,7230,603554902,0,1,1,7680,18,10108339460
9876,603658320,105092,603763412,0,1,0,45056,18,4653100894
9877,603857657,107588,603965245,0,1,0,53248,18,10145468516
9878,603961374,23466,603984840,0,5,1,38912,20,2750553188
9879,604487504,6278,604493782,0,7,1,6656,40,9506926625
9880,604538298,109148,604647446,0,1,0,58368,18,10335174728
9881,604662463,76388,604738851,0,1,0,16384,18,5532364267
9882,604799055,101504,604900559,0,1,0,33280,18,8057254654
9883,604805956,222487,605028443,0,1,0,150528,18,1461432612
9884,604990202,11533,605001735,0,7,1,18944,40,3815796735
9885,605135987,10241,605146228,0,7,1,16384,40,6312433292
9886,605480484,1042,605481526,0,7,1,1024,40,7434409374
9887,605548072,392792,605940864,0,1,0,505344,18,1881557888
9888,605635130,1042,605636172,0,7,1,1024,40,5052599458
9889,605669887,1042,605670929,0,7,1,1024,40,7631702747
9890,605895175,23466,605918641,0,7,1,38912,40,9172450254
9891,605939084,1042,605940126,0,7,1,1024,40,6951175306
9892,605983282,110084,606093366,0,1,0,61440,18,416786854
9893,606024077,3898,606027975,0,7,1,4096,40,2626585230
9894,606282765,7706,606290471,0,7,1,8192,40,7622692547
9895,606322475,129584,606452059,0,1,0,125440,18,6387506049
9896,606457418,85604,606543022,0,1,0,16384,18,1147279463
9897,606647526,121472,606768998,0,1,0,98816,18,8596466905
9898,606789847,197924,606987771,0,1,0,188416,18,1342058295
9899,607250998,103376,607354374,0,1,0,39424,18,6384186364
9900,607836035,6488,607842523,0,7,1,15872,40,872226872
9901,607907926,12308,607920234,0,7,1,20480,40,9784271740
9902,607972647,3898,607976545,0,7,1,4096,40,5234437970
9903,608363813,12308,608376121,0,1,1,20480,18,2393313151
9904,608766256,566,608766822,0,7,1,512,40,1398914770
9905,609037091,1518,609038609,0,7,1,1536,40,9932575805
9906,609144134,3904,609148038,0,7,1,10752,40,10024009575
9907,610935888,23983,610959871,0,7,1,39936,40,8581604560
9908,617748370,22433,617770803,0,7,1,36864,40,196422459
9909,627156979,16613,627173592,0,7,1,32256,40,3211513226
9910,630860596,6754,630867350,0,7,1,7168,40,4212960794
9911,634915365,13600,634928965,0,7,1,23040,40,1304424009
9912,635254873,6229,635261102,0,7,1,15360,40,1743582786
9913,635287552,12825,635300377,0,7,1,21504,40,7124261784
9914,635474137,7230,635481367,0,7,1,7680,40,6726281726
9915,636174171,4374,636178545,0,7,1,4608,40,6650997849
9916,636903594,22862,636926456,0,7,1,40960,40,1890463666
9917,636964504,12995,636977499,0,7,1,25088,40,3628449440
9918,637119014,7230,637126244,0,7,1,7680,40,2347625494
9919,637320718,3422,637324140,0,7,1,3584,40,10052837965
9920,637395801,4162,637399963,0,7,1,11264,40,664503164
9921,637516498,1994,637518492,0,7,1,2048,40,10593662329
9922,637806702,13253,637819955,0,7,1,25600,40,7860518261
9923,638102699,10499,638113198,0,7,1,16896,40,10335055947
9924,638330364,2946,638333310,0,7,1,3072,40,3629086057
9925,638421831,12825,638434656,0,7,1,21504,40,5949009513
9926,638470441,5802,638476243,0,7,1,6144,40,2269541454
9927,638536673,11791,638548464,0,7,1,19456,40,5355671914
9928,639063423,566,639063989,0,7,1,512,40,1450924790
9929,639140657,2870,639143527,0,7,1,8704,40,8065244484
9930,639487797,4937,639492734,0,7,1,12800,40,5241591738
9931,639780804,2946,639783750,0,7,1,3072,40,2361351187
9932,640177060,16354,640193414,0,7,1,31744,40,7746181472
9933,640640459,1994,640642453,0,7,1,2048,40,8394580134
9934,641121871,5712,641127583,0,7,1,14336,40,8502749237
9935,641228832,33333,641262165,0,7,1,54784,40,4220507325
9936,641264222,1042,641265264,0,7,1,1024,40,2458100933
9937,641706383,11533,641717916,0,7,1,18944,40,461633361
9938,642821493,3898,642825391,0,7,1,4096,40,5689385318
9939,642942235,24670,642966905,0,7,1,44544,40,4997322261
9940,643042860,32299,643075159,0,7,1,52736,40,1683037144
9941,643156820,2870,643159690,0,7,1,8704,40,8901706313
9942,643516490,3904,643520394,0,7,1,10752,40,4962595866
9943,643728065,2470,643730535,0,7,1,2560,40,5327994072
9944,643759316,20366,643779682,0,7,1,32768,40,8145607500
9945,643759697,20331,643780028,0,7,1,512,40,8476876436
9946,644330343,4850,644335193,0,7,1,5120,40,9930159440
9947,644409060,13341,644422401,0,7,1,22528,40,2191403053
9948,645518100,1994,645520094,0,7,1,2048,40,5994059769
9949,645761844,10499,645772343,0,7,1,16896,40,731719355
9950,645764366,8963,645773329,0,7,1,1536,40,4217687912
9951,645771474,3801,645775275,0,7,1,3072,40,1304873020
9952,646412024,4850,646416874,0,7,1,5120,40,4677571227
9953,647163501,2870,647166371,0,7,1,8704,40,5766327911
9954,647260590,14287,647274877,0,7,1,27648,40,4631509378
9955,647444640,7706,647452346,0,7,1,8192,40,8800669124
9956,647596234,88700,647684934,0,7,0,21504,40,5805318062
9957,647653522,95336,647748858,0,7,0,28160,40,9748653215
9958,648067376,31524,648098900,0,7,1,51200,40,8954561533
9959,648108953,231000,648339953,0,7,0,57856,40,4085409200
9960,648314811,25157,648339968,0,7,1,29696,40,8558593238
9961,648440759,138068,648578827,0,7,0,133120,40,3978251331
9962,649061382,4420,649065802,0,7,1,11776,40,5069693814
9963,649394758,196676,649591434,0,7,0,184320,40,9890969726
9964,649581365,41585,649622950,0,7,1,51200,40,518656202
9965,649711849,6229,649718078,0,7,1,15360,40,1995927494
9966,650065736,7230,650072966,0,7,1,7680,40,6739255146
9967,650426027,566,650426593,0,7,1,512,40,6452946133
9968,650779310,132992,650912302,0,7,0,131584,40,8776825055
9969,651020895,23208,651044103,0,7,1,38400,40,6166257398
9970,651123363,108836,651232199,0,7,0,57344,40,7959877104
9971,651192154,122767,651314921,0,7,0,100864,40,2288598073
9972,651392118,99788,651491906,0,7,0,27648,40,1592340606
9973,651482496,9425,651491921,0,7,1,3072,40,2277122052
9974,651498078,235287,651733365,0,7,0,160768,40,6411630986
9975,651518431,25704,651544135,0,7,1,46592,40,7284334025
9976,652114312,1994,652116306,0,7,1,2048,40,4725222695
9977,652311343,81128,652392471,0,7,0,11776,40,4766820135
9978,654199370,218204,654417574,0,7,0,254976,40,3515135201
9979,654899442,118196,655017638,0,7,0,88064,40,6034447771
9980,655076873,172556,655249429,0,7,0,150528,40,2482122128
9981,655290761,188876,655479637,0,7,0,158720,40,6243803415
9982,655446876,141745,655588621,0,7,0,57856,40,2124313441
9983,655457228,208781,655666009,0,7,0,150528,40,651358964
9984,655634710,128895,655763605,0,7,0,20480,40,5757591418
9985,656185899,118664,656304563,0,7,0,89600,40,8473560573
9986,656344104,6278,656350382,0,7,1,6656,40,4660083180
9987,656430279,5326,656435605,0,7,1,5632,40,7309230165
9988,656765590,106028,656871618,0,7,0,48128,40,439840716
9989,656953503,112892,657066395,0,7,0,70656,40,1144380825
9990,656980773,23466,657004239,0,7,1,38912,40,6162110075
9991,657005468,20366,657025834,0,7,1,32768,40,1848638551
9992,657062450,18054,657080504,0,7,1,24064,40,1469105504
9993,657144682,2470,657147152,0,7,1,2560,40,6748451218
9994,657732236,3898,657736134,0,7,1,4096,40,7477047996
9995,657749198,1042,657750240,0,7,1,1024,40,8665555944
9996,658160806,566,658161372,0,7,1,512,40,4240668968
9997,658261750,102752,658364502,0,7,0,37376,40,6081915116
9998,658660655,2870,658663525,0,7,1,8704,40,9728429077
9999,658675665,14117,658689782,0,7,1,24064,40,8773302405
