RequestID,ArrivalTime,DelayTime,FinishTime,InitiatorID,TargetID,IOType,Size,VolumeID,Offset
0,0,12072,12072,0,0,1,19456,10,2008505775
1,1,219918,219919,4,0,0,21504,6,10714576353
2,2,160133,160135,9,0,0,64000,10,8872663469
3,3,119410,119413,7,0,0,1024,18,3402412043
4,4,211461,211465,3,0,0,141824,9,6256242328
5,5,213347,213352,2,0,0,6144,4,9766567834
6,6,140614,140620,6,0,0,19968,9,8660122176
7,7,221643,221650,5,0,0,5632,11,8549734448
8,8,47075,47083,8,0,1,66048,12,338058173
9,9,63753,63762,1,0,1,63488,14,2349598495
10,75880,3898,79778,9,0,1,4096,10,2683701245
11,274760,116630,391390,2,0,0,15360,4,5285649972
12,280890,134950,415840,3,0,0,13824,9,3347977479
13,359270,134339,493609,8,0,0,58368,12,3004856875
14,418580,4850,423430,4,0,1,5120,6,7796834157
15,432960,134756,567716,9,0,0,22016,10,7961660497
16,637200,2470,639670,7,0,1,2560,18,487185320
17,693960,96872,790832,3,0,0,28160,9,2635100033
18,761070,148237,909307,3,0,0,26624,9,4457559627
19,764120,76052,840172,2,0,0,10240,4,3131649962
20,764700,180622,945322,9,0,0,21504,10,8889451142
21,765190,135990,901180,8,0,0,49152,12,2623824270
22,813910,152322,966232,6,0,0,18432,9,4095861487
23,815639,98519,914158,0,0,0,15872,10,9259145448
24,984670,76052,1060722,1,0,0,10240,14,3730854439
25,1014379,46514,1060893,0,0,0,512,10,3896628614
26,1086390,75320,1161710,6,0,0,17920,9,6632547020
27,1099030,106652,1205682,5,0,0,50176,11,510682919
28,1106280,4374,1110654,7,0,1,4608,18,193682319
29,1127380,81593,1208973,1,0,0,10752,14,10483241713
30,1147530,96282,1243812,4,0,0,17920,6,8015356490
31,1193700,126126,1319826,9,0,0,39424,10,545358911
32,1229359,117485,1346844,0,0,0,61440,10,6418979209
33,1287810,78212,1366022,9,0,0,12288,10,1679303787
34,1342470,89214,1431684,4,0,0,18944,6,6920300581
35,1455550,47288,1502838,7,0,0,1536,18,968470120
36,1490710,104000,1594710,2,0,0,41472,4,3481234260
37,1491430,125282,1616712,6,0,0,41984,9,41265876
38,1584691,105298,1689989,6,0,1,158720,9,7519472341
39,1608339,173832,1782171,0,0,0,14336,10,2765410913
40,1701420,196772,1898192,2,0,0,45568,4,4115674749
41,1829620,108646,1938266,7,0,0,34816,18,7338431976
42,1834619,10757,1845376,3,0,1,17408,9,1481914168
43,1867490,185908,2053398,7,0,0,59904,18,7754434800
44,1876351,74779,1951130,6,0,1,125440,9,115269283
45,1910950,116890,2027840,5,0,0,9216,11,132581416
46,1917220,205401,2122621,6,0,0,16384,9,8075122894
47,1926330,255401,2181731,9,0,0,19456,10,3889431550
48,1961420,203482,2164902,9,0,0,2048,10,4451241842
49,1986430,129566,2115996,4,0,0,37376,6,9123587310
50,1993091,2946,1996037,2,0,1,3072,4,3170545595
51,2019350,144905,2164255,3,0,0,64000,9,9254086177
52,2069990,96416,2166406,8,0,0,4096,12,8697195692
53,2080220,143672,2223892,3,0,0,5120,9,10265480631
54,2106320,141320,2247640,9,0,0,57856,10,4046180161
55,2124540,7706,2132246,9,0,1,8192,10,9656042431
56,2128500,47288,2175788,4,0,0,1536,6,5405565296
57,2151410,20230,2171640,7,0,1,7168,18,8940882676
58,2163100,90483,2253583,4,0,0,19456,6,527422701
59,2237009,43321,2280330,3,0,1,48640,9,4694602408
60,2251500,186477,2437977,9,0,0,89088,10,5716334902
61,2297621,2470,2300091,6,0,1,2560,9,6757911675
62,2307300,138024,2445324,2,0,0,24064,4,6247104279
63,2372010,104817,2476827,1,0,0,13824,14,2064049858
64,2474960,92227,2567187,6,0,0,16896,9,10383742911
65,2479770,1042,2480812,8,0,1,1024,12,2883259041
66,2559790,47288,2607078,4,0,0,1536,6,2456453723
67,2615100,54056,2669156,1,0,0,3584,14,9507921796
68,2668440,99092,2767532,8,0,0,23040,12,2420529311
69,2746820,86252,2833072,9,0,0,23552,10,3542522761
70,2747859,105872,2853731,0,0,0,47616,10,922368800
71,2828181,5449,2833630,5,0,1,512,11,3484930533
72,2851250,3991,2855241,7,0,1,1536,18,3714840321
73,2889429,77144,2966573,0,0,0,13824,10,507724812
74,2924430,76595,3001025,3,0,0,7168,9,2862872043
75,3013450,4850,3018300,7,0,1,5120,18,5986426421
76,3043670,102908,3146578,3,0,0,37888,9,8562981596
77,3096430,64208,3160638,7,0,0,6656,18,5548676450
78,3182880,76856,3259736,8,0,0,17920,12,7772712045
79,3241440,60536,3301976,7,0,0,9728,18,4677800276
80,3262910,91616,3354526,4,0,0,20992,6,1685656307
81,3265360,50672,3316032,5,0,0,2560,11,6800394693
82,3403749,99320,3503069,0,0,0,26112,10,893355165
83,3440820,109979,3550799,8,0,0,10240,12,8824206597
84,3451170,78080,3529250,4,0,0,16896,6,670076243
85,3475320,97007,3572327,5,0,0,15360,11,3875086354
86,3504770,68352,3573122,3,0,0,2560,9,319202397
87,3507630,68936,3576566,9,0,0,3584,10,7963013084
88,3601140,60261,3661401,2,0,0,8192,4,5271567700
89,3609910,48980,3658890,3,0,0,2048,9,9397219581
90,3680030,73258,3753288,5,0,0,9216,11,1590079777
91,3700930,73160,3774090,2,0,0,15872,4,1429283439
92,3702709,54056,3756765,0,0,0,3584,10,4254228961
93,3746000,167157,3913157,8,0,0,22528,12,4558249614
94,3746550,75764,3822314,8,0,0,14336,12,7445247978
95,3776529,91748,3868277,0,0,0,16384,10,1560635043
96,3925050,75476,4000526,6,0,0,18432,9,8782998890
97,3954120,122420,4076540,1,0,0,39936,14,5824546623
98,4146710,79436,4226146,6,0,0,11264,9,3994530624
99,4198240,101660,4299900,6,0,0,33792,9,1706765550
100,4238400,126618,4365018,4,0,0,24576,6,7313718014
101,4472499,99476,4571975,0,0,0,26624,10,985914190
102,4496120,54056,4550176,5,0,0,3584,11,10410067660
103,4576800,69284,4646084,1,0,0,8192,14,10452194110
104,4673790,1518,4675308,7,0,1,1536,18,8423171397
105,4700730,86096,4786826,4,0,0,23040,6,3064095335
106,4775570,97916,4873486,5,0,0,21504,11,9052819383
107,4792380,132339,4924719,5,0,0,27136,11,3651118779
108,4816640,99788,4916428,1,0,0,27648,14,5631160110
109,4878540,64208,4942748,4,0,0,6656,6,6695317156
110,4892740,85116,4977856,2,0,0,10240,4,8522032088
111,4908370,105005,5013375,1,0,0,11264,14,4245774800
112,4937260,72668,5009928,5,0,0,9216,11,1848174925
113,4958280,142066,5100346,4,0,0,35840,6,3456679420
114,4972370,99320,5071690,5,0,0,26112,11,852249468
115,5062580,55616,5118196,3,0,0,2560,9,3507027455
116,5246400,48980,5295380,1,0,0,2048,14,1062801761
117,5296820,106652,5403472,9,0,0,50176,10,8614443467
118,5309391,54358,5363749,6,0,1,89088,9,6368189683
119,5521820,97292,5619112,9,0,0,19456,10,9630792598
120,5597640,106808,5704448,9,0,0,50688,10,9906671071
121,5617681,11664,5629345,5,0,1,16384,11,10398650875
122,5703689,11250,5714939,3,0,1,16896,9,3207965115
123,5714121,134495,5848616,6,0,1,221696,9,934518182
124,5721810,199831,5921641,1,0,0,5120,14,7086715941
125,5773460,142864,5916324,2,0,0,3584,4,10479634671
126,5829140,164795,5993935,9,0,0,19456,10,9567883293
127,5844770,64014,5908784,7,0,0,4096,18,1951148904
128,5852250,251621,6103871,6,0,0,24064,9,2451860537
129,5852740,183658,6036398,1,0,1,297472,14,10092684474
130,5866620,237586,6104206,6,0,0,1024,9,5655959902
131,5964630,191995,6156625,4,0,0,17408,6,8230256082
132,6062780,182960,6245740,1,0,0,33280,14,8719076275
133,6100410,110059,6210469,3,0,0,23552,9,1485995873
134,6212749,4420,6217169,3,0,1,11776,9,6297152149
135,6319250,3898,6323148,8,0,1,4096,12,2362812450
136,6336039,66080,6402119,0,0,0,12800,10,481621235
137,6372850,109183,6482033,8,0,0,47104,12,6963220167
138,6564500,101348,6665848,6,0,0,32768,9,4505367718
139,6571320,76052,6647372,6,0,0,10240,9,512717194
140,6578330,65144,6643474,6,0,0,9728,9,1362141235
141,6621940,84540,6706480,2,0,0,2560,4,4327684968
142,6627860,59882,6687742,2,0,0,1536,4,6945762707
143,6979140,57440,7036580,2,0,0,4608,4,1307010539
144,6985260,108212,7093472,5,0,0,55296,11,10357412340
145,6986780,108111,7094891,2,0,0,4608,4,2280042301
146,7017230,99852,7117082,5,0,0,5632,11,5997425245
147,7052030,49292,7101322,6,0,0,3072,9,10259223767
148,7187591,6754,7194345,5,0,1,7168,11,5094946742
149,7220660,69464,7290124,2,0,0,13824,4,5942552562
150,7348440,55748,7404188,6,0,0,4096,9,7075720464
151,7446450,45596,7492046,5,0,0,1024,11,10020578698
152,7509630,4850,7514480,0,0,1,5120,10,242356502
153,7514250,43904,7558154,8,0,0,512,12,8824779891
154,7571360,43904,7615264,6,0,0,512,9,6212034210
155,7601790,103064,7704854,9,0,0,38400,10,2587976483
156,7612380,104468,7716848,6,0,0,1024,9,7573001540
157,7944980,108992,8053972,3,0,0,57856,9,7880030105
158,8002280,74678,8076958,2,0,0,6144,4,6848439231
159,8011640,73472,8085112,1,0,0,16896,14,10419711307
160,8073100,105560,8178660,3,0,0,46592,9,2222108886
161,8093291,144362,8237653,6,0,1,237568,9,6319362446
162,8094350,310197,8404547,1,0,0,11776,14,4685553330
163,8110980,320951,8431931,3,0,0,20992,9,849246940
164,8127680,292518,8420198,9,0,0,18432,10,630549353
165,8176920,198161,8375081,1,0,0,57344,14,8097877164
166,8229380,8619,8237999,8,0,1,512,12,272336683
167,8289140,283968,8573108,5,0,0,43520,11,5620989959
168,8313630,158975,8472605,9,0,0,7168,10,1469245140
169,8348830,303076,8651906,2,0,0,69120,4,100639180
170,8370370,8601,8378971,1,0,1,4096,14,2524387064
171,8384590,135937,8520527,5,0,0,32256,11,8672071850
172,8399340,130307,8529647,4,0,0,11776,6,3627070437
173,8489390,178154,8667544,7,0,0,16896,18,5895109588
174,8550230,112143,8662373,6,0,0,34304,9,8397636417
175,8657770,80359,8738129,7,0,0,14336,18,6198768628
176,8702210,111777,8813987,1,0,0,35328,14,3783057902
177,8752760,101998,8854758,6,0,0,13824,9,9358016881
178,8786930,3387,8790317,0,0,1,9728,10,2574624456
179,8789190,125182,8914372,5,0,0,25088,11,1876146814
180,8815500,122305,8937805,2,0,0,16896,4,4252685534
181,8863190,130628,8993818,2,0,0,57856,4,3709515342
182,8868810,48980,8917790,2,0,0,2048,4,5495733553
183,8880900,140005,9020905,1,0,0,35328,14,9823607462
184,8960950,118701,9079651,2,0,0,10240,4,5796700168
185,9020390,60836,9081226,6,0,0,5120,9,7955201601
186,9022440,5454,9027894,9,0,1,13824,10,3251476395
187,9087600,161001,9248601,7,0,0,23552,18,6345510282
188,9087788,50672,9138460,8,0,0,2560,12,1004341849
189,9102350,97410,9199760,8,0,0,12800,12,4045494662
190,9132770,101660,9234430,3,0,0,33792,9,10575598015
191,9231150,108676,9339826,8,0,0,46080,12,8531861233
192,9237580,77900,9315480,5,0,0,11264,11,2500988830
193,9268719,116299,9385018,0,0,0,5632,10,9856716114
194,9452981,44404,9497385,6,0,1,76288,9,6926874552
195,9489860,216100,9705960,1,0,0,42496,14,246709351
196,9581680,105248,9686928,3,0,0,45568,9,3540471980
197,9594740,148174,9742914,2,0,0,21504,4,3960158417
198,9682620,48204,9730824,3,0,0,512,9,6944413555
199,9704430,92802,9797232,4,0,0,14848,6,7561246878
200,9753330,90704,9844034,2,0,0,23040,4,1145093445
201,9762649,141589,9904238,0,0,0,54272,10,7998544937
202,9783440,87264,9870704,7,0,0,3584,18,552794131
203,9789920,74196,9864116,5,0,0,7168,11,7882838714
204,9848300,154833,10003133,1,0,1,251392,14,2446273822
205,9881900,158417,10040317,4,0,0,7168,6,6396009294
206,10121181,175858,10297039,6,0,1,285696,9,3236039826
207,10133950,291404,10425354,9,0,0,43008,10,3558215895
208,10168790,297994,10466784,6,0,0,26624,9,8997314457
209,10234540,291512,10526052,8,0,0,7168,12,5991084481
210,10394469,141753,10536222,0,0,0,3584,10,3332067554
211,10394509,97853,10492362,0,0,0,3584,10,145147731
212,10425249,2567,10427816,3,0,1,2560,9,9991959734
213,10433750,101365,10535115,5,0,0,29696,11,5130589789
214,10484550,157251,10641801,8,0,0,37376,12,8485571547
215,10532230,7112,10539342,0,0,1,9216,10,2280877018
216,10571230,139490,10710720,1,0,0,18944,14,5175026367
217,10595639,239399,10835038,0,0,0,74752,10,3647675077
218,10616810,123364,10740174,7,0,0,3584,18,7863728899
219,10677191,45179,10722370,6,0,1,77824,9,6353027755
220,10765020,179644,10944664,4,0,0,7680,6,7669290000
221,10794980,108580,10903560,9,0,0,32768,10,5392047138
222,10795020,98541,10893561,1,0,0,23552,14,9530752412
223,10844340,143363,10987703,4,0,0,25600,6,9994251576
224,10860320,78373,10938693,6,0,0,3072,9,9157655272
225,10901180,101503,11002683,2,0,0,15360,4,2008655845
226,10909740,153821,11063561,7,0,0,46592,18,1352533307
227,10945870,120046,11065916,9,0,0,7680,10,8945994290
228,10949110,77375,11026485,2,0,0,6656,4,2872121558
229,11028150,105065,11133215,8,0,0,22016,12,6354225208
230,11106980,100100,11207080,4,0,0,28672,6,6234845368
231,11130460,174474,11304934,1,0,0,121856,14,5792049309
232,11139580,4850,11144430,9,0,1,5120,10,10157187479
233,11154620,211604,11366224,1,0,0,49664,14,9731874364
234,11173620,143497,11317117,1,0,0,39936,14,6547904616
235,11219820,149695,11369515,6,0,0,10752,9,8333474575
236,11383000,53144,11436144,5,0,0,5632,11,5591051257
237,11467930,119444,11587374,4,0,0,92160,6,2949505824
238,11522171,2870,11525041,5,0,1,8704,11,4748353005
239,11760930,50672,11811602,8,0,0,2560,12,1652602444
240,11794340,54056,11848396,6,0,0,3584,9,6915940436
241,11800620,96512,11897132,4,0,0,16896,6,292863648
242,11843561,141866,11985427,6,0,1,229376,9,8026165314
243,11925540,164711,12090251,6,0,0,15872,9,1635906389
244,12030920,137988,12168908,3,0,0,21504,9,5370657451
245,12052720,200695,12253415,6,0,0,5632,9,6971729956
246,12123129,97292,12220421,0,0,0,19456,10,7180131867
247,12127471,566,12128037,5,0,1,512,11,9385819394
248,12129840,168971,12298811,4,0,0,23552,6,8234783496
249,12237630,99008,12336638,1,0,0,25088,14,1565889117
250,12264180,111737,12375917,7,0,0,48640,18,6848562409
251,12303460,76738,12380198,5,0,0,9216,11,5707139704
252,12365940,101873,12467813,1,0,0,16896,14,6377553216
253,12457539,50666,12508205,0,0,0,1024,10,65148232
254,12539059,4374,12543433,3,0,1,4608,9,3038237739
255,12572040,103532,12675572,4,0,0,39936,6,8427120894
256,12592560,216470,12809030,1,0,0,46080,14,5652748909
257,12630230,103737,12733967,9,0,0,16384,10,10454144510
258,12636280,92680,12728960,3,0,0,11264,9,7150681974
259,12649401,177062,12826463,6,0,1,291328,9,778522519
260,12698500,194062,12892562,5,0,0,7680,11,6527062444
261,12788030,243750,13031780,7,0,0,18432,18,5772590305
262,12839320,114116,12953436,5,0,0,512,11,7289784927
263,12873490,308059,13181549,7,0,0,39936,18,6883015992
264,12923230,102919,13026149,5,0,0,31232,11,3709413191
265,12925269,137560,13062829,0,0,0,4096,10,3411918270
266,12970029,109394,13079423,0,0,0,18432,10,5959204945
267,13004070,101608,13105678,5,0,0,1024,11,5773204247
268,13010930,118900,13129830,2,0,0,58368,4,8445832955
269,13099149,102440,13201589,0,0,0,36352,10,9631655567
270,13102650,131861,13234511,5,0,0,7168,11,4768940964
271,13144220,79569,13223789,1,0,0,6144,14,6457324241
272,13154369,214429,13368798,0,0,0,14848,10,6388628653
273,13160450,117090,13277540,4,0,0,17920,6,3197131923
274,13169090,88467,13257557,1,0,0,1024,14,8258492535
275,13175840,96225,13272065,6,0,0,17408,9,9298867008
276,13244811,20624,13265435,5,0,1,33280,11,1684875196
277,13295849,81073,13376922,0,0,0,11264,10,2289556487
278,13302290,2470,13304760,0,0,1,2560,10,1453796209
279,13311830,52414,13364244,3,0,0,1024,9,1059098304
280,13327510,194732,13522242,4,0,0,3072,6,8399566799
281,13398880,107744,13506624,5,0,0,53760,11,2795266700
282,13519330,2946,13522276,9,0,1,3072,10,316185248
283,13581570,60824,13642394,8,0,0,5632,12,9651950524
284,13599790,131565,13731355,4,0,0,33280,6,2395422607
285,13600340,67616,13667956,6,0,0,12800,9,1853325813
286,13644630,90484,13735114,5,0,0,12288,11,8239029968
287,13736880,4374,13741254,7,0,1,4608,18,7870956628
288,13838690,62516,13901206,7,0,0,6144,18,5462943103
289,13899160,54056,13953216,1,0,0,3584,14,10338645745
290,14004490,122720,14127210,6,0,0,102912,9,6823874432
291,14008219,163931,14172150,0,0,0,89088,10,2396748978
292,14060730,125874,14186604,9,0,0,19456,10,7240597823
293,14068200,179346,14247546,6,0,0,36864,9,3620359947
294,14083249,134393,14217642,0,0,0,14336,10,2103522446
295,14200190,76768,14276958,2,0,0,5120,4,979411144
296,14215200,104562,14319762,1,0,0,35328,14,471544177
297,14255450,103376,14358826,6,0,0,39424,9,7915710442
298,14316710,101740,14418450,7,0,0,24064,18,773085884
299,14455770,75764,14531534,7,0,0,14336,18,6849674762
300,14504210,59444,14563654,6,0,0,6144,9,9282272210
301,14537790,57440,14595230,6,0,0,4608,9,1657283238
302,14585660,6278,14591938,7,0,1,6656,18,3186573712
303,14598470,76700,14675170,2,0,0,17408,4,2430838284
304,14635380,2870,14638250,8,0,1,8704,12,3058467507
305,14650170,100412,14750582,7,0,0,29696,18,9859694530
306,14676700,114220,14790920,6,0,0,9728,9,10275692939
307,14707129,95288,14802417,0,0,0,17920,10,5181462298
308,14725880,103807,14829687,7,0,0,8704,18,5547169427
309,14848590,87140,14935730,3,0,0,16384,9,5967410692
310,15068549,57440,15125989,0,0,0,4608,10,2060947338
311,15073190,73136,15146326,6,0,0,10752,9,2496119597
312,15084860,79274,15164134,2,0,0,8704,4,7742516
313,15147400,76520,15223920,8,0,0,11776,12,6809546266
314,15178380,96102,15274482,6,0,0,10240,9,8910155036
315,15222430,11981,15234411,8,0,1,16896,12,3193506080
316,15340080,107477,15447557,9,0,0,15872,10,6788169472
317,15340690,72518,15413208,6,0,0,2560,9,3952837423
318,15360640,566,15361206,0,0,1,512,10,2539369604
319,15384730,100246,15484976,1,0,0,2048,14,784368597
320,15392249,67233,15459482,0,0,0,10240,10,578714098
321,15396240,77456,15473696,5,0,0,14848,11,2017254262
322,15459660,105542,15565202,9,0,0,37376,10,1390244770
323,15500409,148763,15649172,0,0,0,84992,10,2536244898
324,15513780,67592,15581372,3,0,0,7680,9,9847902270
325,15544039,262882,15806921,0,0,0,139264,10,1820482020
326,15550820,171174,15721994,4,0,0,15360,6,7575420883
327,15562230,301772,15864002,6,0,0,93184,9,371534043
328,15573910,131476,15705386,7,0,0,11264,18,9710387159
329,15607970,258699,15866669,9,0,0,8704,10,9311977965
330,15618940,30247,15649187,7,0,1,4608,18,5341641680
331,15651390,156638,15808028,3,0,0,3584,9,6368887104
332,15667860,143467,15811327,5,0,0,10752,11,9713579950
333,15714660,120935,15835595,7,0,0,19968,18,4253343819
334,15756579,117716,15874295,0,0,0,21504,10,8625384377
335,15786900,126383,15913283,8,0,0,1024,12,3091826901
336,15857540,97221,15954761,8,0,0,24576,12,1833962599
337,15881290,145087,16026377,7,0,0,98304,18,9802143959
338,15907310,166978,16074288,8,0,0,14848,12,6188720160
339,15910809,138951,16049760,0,0,0,25088,10,8205792254
340,15937860,149163,16087023,1,0,0,20992,14,6350340525
341,15950690,129922,16080612,5,0,0,20480,11,9184699880
342,15958600,134852,16093452,5,0,0,7168,11,7941795109
343,15967450,205672,16173122,3,0,0,5120,9,2790083018
344,15988500,107874,16096374,1,0,0,512,14,6517384706
345,16007760,187841,16195601,3,0,0,73728,9,1427424497
346,16018590,150899,16169489,7,0,0,64000,18,2949616746
347,16043330,128202,16171532,2,0,0,6656,4,5933493567
348,16054690,181855,16236545,3,0,0,34816,9,9933267774
349,16127969,13770,16141739,3,0,1,26624,9,3827280897
350,16147470,24077,16171547,9,0,1,19968,10,8758962382
351,16259500,71000,16330500,6,0,0,13824,9,2842658420
352,16265960,163466,16429426,5,0,0,64000,11,9069182780
353,16285151,186412,16471563,6,0,1,306176,9,8155076946
354,16308900,133812,16442712,2,0,0,6656,4,10592410331
355,16329610,225894,16555504,5,0,0,30720,11,10488208887
356,16344720,318663,16663383,2,0,0,41472,4,9435295275
357,16558260,136094,16694354,3,0,0,20992,9,1732856302
358,16571930,141277,16713207,7,0,0,6144,18,7787586416
359,16599980,126750,16726730,3,0,0,33792,9,8640898205
360,16630780,125174,16755954,3,0,0,4608,9,7579122597
361,16637780,116755,16754535,1,0,0,40960,14,8546711836
362,16666360,197261,16863621,1,0,0,39936,14,2674847220
363,16676860,129653,16806513,3,0,0,13824,9,9699129883
364,16772690,59444,16832134,2,0,0,6144,4,8801591930
365,16838650,118820,16957470,9,0,0,90112,10,9259869858
366,16849690,74696,16924386,8,0,0,15872,12,4187502444
367,16889430,5196,16894626,7,0,1,13312,18,5293435829
368,16898600,140788,17039388,3,0,0,12800,9,8196737264
369,16919779,79463,16999242,0,0,0,8192,10,4762723054
370,17003160,67068,17070228,2,0,0,1536,4,1007852567
371,17022940,112112,17135052,9,0,0,68096,10,417333320
372,17088150,100412,17188562,7,0,0,29696,18,8905117241
373,17113890,85160,17199050,1,0,0,19968,14,4849389702
374,17168720,87438,17256158,8,0,0,17408,12,10095022088
375,17173409,114381,17287790,0,0,0,15360,10,10605277426
376,17206431,3645,17210076,6,0,1,10240,9,9682839538
377,17324620,103688,17428308,4,0,0,40448,6,4773438560
378,17367300,2470,17369770,0,0,1,2560,10,2805791756
379,17576430,118040,17694470,6,0,0,87552,9,4208465479
380,17577710,158712,17736422,1,0,0,58880,14,8225221971
381,17602300,214222,17816522,9,0,0,8704,10,1991622824
382,17654750,191502,17846252,4,0,0,19456,6,1235919998
383,17681240,62784,17744024,9,0,0,2048,10,1223260000
384,17690020,103198,17793218,3,0,0,17920,9,7493004958
385,17703640,2470,17706110,8,0,1,2560,12,5374285867
386,17710611,2870,17713481,5,0,1,8704,11,40382866
387,17732520,103994,17836514,3,0,0,28672,9,7579039762
388,17740220,53325,17793545,3,0,0,1024,9,7597072761
389,17783850,111794,17895644,2,0,0,19968,4,2712730660
390,17798870,105525,17904395,8,0,0,28672,12,6220077718
391,17810129,113107,17923236,0,0,0,24576,10,2108630632
392,17825759,124427,17950186,0,0,0,28160,10,9498360036
393,17923340,90278,18013618,3,0,0,12288,9,1172303848
394,18067390,92972,18160362,1,0,0,15360,14,363809024
395,18077520,86757,18164277,1,0,0,12800,14,772821095
396,18168469,101192,18269661,0,0,0,32256,10,9521919337
397,18168670,117947,18286617,1,0,0,12288,14,922681233
398,18203360,3898,18207258,0,0,1,4096,10,4910060406
399,18262480,58157,18320637,1,0,0,3584,14,4507300860
400,18298460,101287,18399747,9,0,0,30208,10,4757196431
401,18361500,81932,18443432,9,0,0,19456,10,4421750830
402,18421620,119828,18541448,6,0,0,41472,9,5875093421
403,18451120,48980,18500100,3,0,0,2048,9,1310957714
404,18521770,67460,18589230,1,0,0,12288,14,8358854094
405,18728000,3387,18731387,9,0,1,9728,10,655046679
406,18845100,98228,18943328,6,0,0,22528,9,8134952217
407,18871911,566,18872477,6,0,1,512,9,9155455605
408,18874241,566,18874807,5,0,1,512,11,2798686694
409,18949630,81128,19030758,9,0,0,11776,10,1398085927
410,19099521,1994,19101515,5,0,1,2048,11,4369562337
411,19144941,4850,19149791,6,0,1,5120,9,6362644912
412,19162749,51452,19214201,0,0,0,5120,10,3417100026
413,19186149,12308,19198457,3,0,1,20480,9,6424017249
414,19191460,116546,19308006,4,0,0,32768,6,4815844034
415,19200010,170270,19370280,8,0,0,13312,12,8164128959
416,19202640,73448,19276088,8,0,0,11776,12,9079525687
417,19217440,139412,19356852,3,0,0,25600,9,3908642027
418,19313339,3128,19316467,3,0,1,9216,9,2492086155
419,19352740,80156,19432896,7,0,0,10240,18,5414731239
420,19355470,5819,19361289,9,0,1,11776,10,5493613872
421,19364390,72668,19437058,2,0,0,9216,4,2067113664
422,19365100,212013,19577113,2,0,0,31232,4,2197041191
423,19410839,228609,19639448,0,0,0,28160,10,2929734664
424,19415700,47288,19462988,2,0,0,1536,4,8525261923
425,19453150,100724,19553874,3,0,0,30720,9,8516243831
426,19469510,98072,19567582,4,0,0,22016,6,133607355
427,19525360,161374,19686734,2,0,0,15872,4,5221534009
428,19553930,178068,19731998,8,0,0,38400,12,2592756815
429,19567840,91776,19659616,7,0,0,512,18,5848131477
430,19602740,100314,19703054,3,0,0,24064,9,4212871215
431,19621830,155108,19776938,7,0,0,24576,18,4100059950
432,19673370,158735,19832105,2,0,0,4608,4,585819253
433,19690209,118181,19808390,0,0,0,34816,10,7305422539
434,19708640,125664,19834304,1,0,0,7168,14,3433845754
435,19736030,94656,19830686,4,0,0,7168,6,6674240722
436,19748430,141182,19889612,4,0,0,5632,6,9981606386
437,19812110,2470,19814580,0,0,1,2560,10,3457782727
438,19812380,59691,19872071,9,0,0,5120,10,7746447219
439,19896970,61604,19958574,9,0,0,8192,10,6277500472
440,19932620,3387,19936007,0,0,1,9728,10,7022104931
441,19970280,93020,20063300,8,0,0,25600,12,4355654306
442,20037919,6754,20044673,3,0,1,7168,9,8518309763
443,20044290,48530,20092820,6,0,0,2560,9,9897084410
444,20045500,3898,20049398,9,0,1,4096,10,9480742829
445,20050590,62516,20113106,8,0,0,6144,12,7941829632
446,20055050,145785,20200835,9,0,0,8192,10,2416626231
447,20065650,132674,20198324,8,0,0,57856,12,5275355875
448,20198080,77107,20275187,4,0,0,9728,6,7632929568
449,20325790,48980,20374770,9,0,0,2048,10,9363348270
450,20357000,77744,20434744,4,0,0,10752,6,910475366
451,20374709,89665,20464374,0,0,0,19456,10,933783509
452,20400630,100014,20500644,2,0,0,16384,4,9917127105
453,20435420,73004,20508424,5,0,0,15360,11,4363614513
454,20729530,109304,20838834,2,0,0,58880,4,3784187404
455,20779450,60491,20839941,1,0,0,3584,14,10415139963
456,20797820,73690,20871510,9,0,0,2560,10,4205237972
457,20867590,48980,20916570,9,0,0,2048,10,9809460010
458,20868451,3074,20871525,2,0,1,2560,4,7231830454
459,20871760,101192,20972952,8,0,0,32256,12,1911875650
460,20918740,81776,21000516,9,0,0,18944,10,9068713901
461,20943830,94714,21038544,7,0,0,18432,18,6632338441
462,20974060,57440,21031500,5,0,0,4608,11,4240199756
463,20988890,66664,21055554,7,0,0,2560,18,10244091687
464,21038940,61136,21100076,9,0,0,6656,10,7206339314
465,21076501,2470,21078971,5,0,1,2560,11,5540579452
466,21083130,1994,21085124,8,0,1,2048,12,1499031305
467,21103390,99164,21202554,9,0,0,25600,10,7497906733
468,21242610,96692,21339302,8,0,0,22528,12,7698231070
469,21288480,110108,21398588,6,0,0,14336,9,8902792475
470,21308591,2946,21311537,2,0,1,3072,4,10490038008
471,21394820,64584,21459404,7,0,0,5632,18,2154493151
472,21480980,48980,21529960,1,0,0,2048,14,8210250592
473,21515100,45596,21560696,5,0,0,1024,11,5792998390
474,21557130,72668,21629798,7,0,0,9216,18,150072203
475,21588470,566,21589036,9,0,1,512,10,4512866504
476,21636299,106028,21742327,0,0,0,48128,10,2341545150
477,21646490,128759,21775249,4,0,0,18944,6,8345644750
478,21659391,7706,21667097,6,0,1,8192,9,5481372783
479,21758770,73167,21831937,5,0,0,6144,11,645295243
480,21841440,50672,21892112,3,0,0,2560,9,6889147340
481,21907190,52676,21959866,3,0,0,4096,9,3908999645
482,21912690,49448,21962138,9,0,0,3584,10,1446773437
483,21957300,101660,22058960,4,0,0,33792,6,10131351962
484,21983990,59132,22043122,1,0,0,5120,14,4134484512
485,22053160,102664,22155824,7,0,0,28160,18,6135439044
486,22092790,128716,22221506,8,0,0,40960,12,3933625498
487,22203830,102752,22306582,2,0,0,37376,4,8832445392
488,22215930,63008,22278938,9,0,0,4608,10,6851786894
489,22296360,114994,22411354,9,0,0,44032,10,4569424040
490,22371030,61464,22432494,2,0,0,5632,4,1567421791
491,22385860,185117,22570977,8,0,0,19456,12,263171022
492,22387030,108836,22495866,6,0,0,57344,9,6872972676
493,22388100,176934,22565034,8,0,0,67584,12,4337985439
494,22423180,80000,22503180,2,0,0,4608,4,6916038543
495,22465540,111536,22577076,1,0,0,19968,14,7613302404
496,22510160,68146,22578306,1,0,0,3584,14,4904192916
497,22521480,142650,22664130,8,0,0,57856,12,10547187154
498,22539590,68684,22608274,5,0,0,11264,11,5433505359
499,22623050,119902,22742952,2,0,0,88576,4,5434437586
500,22648539,146691,22795230,0,0,0,27136,10,10298775186
501,22742740,128660,22871400,7,0,0,49152,18,4115935642
502,22765630,52364,22817994,2,0,0,3072,4,5633931350
503,22780730,114058,22894788,6,0,0,9728,9,9936841751
504,22818229,105731,22923960,0,0,0,7680,10,21336393
505,22899800,57440,22957240,9,0,0,4608,10,8838529574
506,22955600,122720,23078320,6,0,0,102912,9,10138094914
507,23085310,55748,23141058,2,0,0,4096,4,6956694867
508,23110480,68060,23178540,9,0,0,9216,10,2009146556
509,23240560,60824,23301384,2,0,0,5632,4,1222871814
510,23269130,97160,23366290,8,0,0,24064,12,7063991614
511,23306620,114360,23420980,9,0,0,51200,10,785651552
512,23329549,172847,23502396,0,0,0,43008,10,7509680975
513,23464730,48256,23512986,3,0,0,1024,9,6383098733
514,23477350,76208,23553558,2,0,0,10752,4,4331551709
515,23488030,62030,23550060,9,0,0,5632,10,1253846060
516,23504080,100376,23604456,3,0,0,15360,9,2713780204
517,23568000,96824,23664824,9,0,0,17920,10,8191100668
518,23575960,145192,23721152,9,0,0,41472,10,946658560
519,23614170,117152,23731322,4,0,0,22016,6,8673261361
520,23635730,88869,23724599,8,0,0,11264,12,1056320427
521,23714290,109576,23823866,8,0,0,24064,12,5780737611
522,23753250,97292,23850542,8,0,0,19456,12,1333699293
523,23800291,4955,23805246,5,0,1,12800,11,9926956851
524,23800300,110881,23911181,8,0,0,64000,12,5955999063
525,23811521,1518,23813039,6,0,1,1536,9,571118159
526,23830610,194184,24024794,5,0,0,6656,11,9447158334
527,23856830,89001,23945831,6,0,0,10240,9,9675776349
528,23878430,144321,24022751,1,0,0,101376,14,9790065661
529,24013819,93787,24107606,0,0,0,12288,10,9510986691
530,24048111,10757,24058868,5,0,1,17408,11,7783503564
531,24142460,100412,24242872,9,0,0,29696,10,7301346947
532,24154630,47288,24201918,8,0,0,1536,12,7299661686
533,24253050,114608,24367658,9,0,0,76288,10,2176687648
534,24304780,183268,24488048,3,0,0,84480,9,4912464001
535,24308370,188437,24496807,4,0,0,28672,6,7558738911
536,24326400,106496,24432896,8,0,0,49664,12,1556061252
537,24462650,129858,24592508,7,0,0,43008,18,9724051726
538,24548510,111643,24660153,3,0,0,15872,9,8833886505
539,24554890,100412,24655302,4,0,0,29696,6,362089821
540,24600170,197024,24797194,2,0,0,78848,4,4460088647
541,24604240,3904,24608144,7,0,1,10752,18,262513655
542,24718670,82291,24800961,7,0,0,12288,18,307866875
543,24736120,66572,24802692,3,0,0,5632,9,1762555045
544,24788630,99836,24888466,7,0,0,14848,18,4610120321
545,24837570,76052,24913622,5,0,0,10240,11,4313511203
546,24881620,98072,24979692,3,0,0,22016,9,4761062777
547,24911710,104968,25016678,7,0,0,38400,18,6952736933
548,24912530,67333,24979863,5,0,0,512,11,3275054925
549,24939090,145646,25084736,3,0,0,33792,9,782579871
550,25025270,87342,25112612,8,0,0,2048,12,5507767561
551,25049130,116606,25165736,9,0,0,30208,10,8867172890
552,25070000,160644,25230644,9,0,0,81920,10,243436512
553,25156740,12116,25168856,8,0,1,9216,12,5773905688
554,25193779,1994,25195773,3,0,1,2048,9,9362757691
555,25271830,66080,25337910,3,0,0,12800,9,4798417362
556,25342119,89768,25431887,0,0,0,19968,10,2987229171
557,25382950,113773,25496723,5,0,0,8704,11,2242042248
558,25430800,4977,25435777,7,0,1,4096,18,6107495185
559,25466680,77425,25544105,5,0,0,16896,11,1966026351
560,25642090,76052,25718142,4,0,0,10240,6,7571195526
561,25739160,74828,25813988,3,0,0,11264,9,3343440172
562,25747330,129376,25876706,6,0,0,14336,9,554996767
563,25798270,101972,25900242,7,0,0,34816,18,4875843689
564,25938570,100412,26038982,5,0,0,29696,11,5529921011
565,25939510,90316,26029826,2,0,0,9728,4,4505074401
566,25988270,64208,26052478,3,0,0,6656,9,6436470887
567,25993630,85434,26079064,4,0,0,2048,6,2742187131
568,26015221,7706,26022927,6,0,1,8192,9,1375404722
569,26082860,100256,26183116,1,0,0,29184,14,1931261970
570,26133190,2470,26135660,9,0,1,2560,10,6191880275
571,26159560,101504,26261064,6,0,0,33280,9,2150601726
572,26228420,4850,26233270,0,0,1,5120,10,8217391438
573,26312260,59132,26371392,2,0,0,5120,4,8462520264
574,26316650,62516,26379166,7,0,0,6144,18,4954585679
575,26324720,102284,26427004,2,0,0,35840,4,3556247558
576,26343430,64676,26408106,8,0,0,8192,12,2494003676
577,26377710,78082,26455792,6,0,0,2048,9,10362238921
578,26381600,12566,26394166,7,0,1,20992,18,9104899107
579,26389310,200157,26589467,9,0,0,1536,10,7764184782
580,26433350,2470,26435820,0,0,1,2560,10,6915778238
581,26445510,79436,26524946,9,0,0,11264,10,2333175265
582,26712160,48980,26761140,1,0,0,2048,14,8468140812
583,26743720,43904,26787624,3,0,0,512,9,5076592077
584,26778590,64520,26843110,7,0,0,7680,18,597774718
585,26808900,102736,26911636,1,0,0,21504,14,5230656158
586,26813720,117119,26930839,1,0,0,62976,14,5261388064
587,26879600,88256,26967856,6,0,0,7168,9,719460926
588,26967860,56688,27024548,2,0,0,7168,4,4124439222
589,26983210,116428,27099638,1,0,0,60928,14,4665481684
590,27010300,114136,27124436,9,0,0,35328,10,7697379147
591,27307570,5802,27313372,8,0,1,6144,12,5866210190
592,27308620,104404,27413024,7,0,0,8704,18,4702294093
593,27309490,100750,27410240,5,0,0,30720,11,4032527881
594,27323620,60068,27383688,8,0,0,8192,12,6781593175
595,27387830,150497,27538327,9,0,0,61440,10,1865310522
596,27454470,15837,27470307,0,0,1,30720,10,8115322149
597,27459750,11543,27471293,9,0,1,1536,10,3496449909
598,27471401,5971,27477372,5,0,1,14848,11,10596590578
599,27514641,1994,27516635,5,0,1,2048,11,7102967452
600,27539220,150066,27689286,2,0,0,3584,4,3021232618
601,27547870,169510,27717380,8,0,0,15872,12,7834392089
602,27589730,6278,27596008,9,0,1,6656,10,8841109162
603,27611550,76621,27688171,6,0,0,15360,9,6270468242
604,27636540,2946,27639486,0,0,1,3072,10,1158493323
605,27686230,148903,27835133,4,0,0,32256,6,6693353040
606,27711650,5745,27717395,0,0,1,2560,10,4853916221
607,27802380,112422,27914802,6,0,0,28160,9,8173511239
608,27853430,100018,27953448,6,0,0,7680,9,4073694625
609,27881480,87452,27968932,9,0,0,17408,10,1925171206
610,27881530,52158,27933688,1,0,0,2560,14,2168581203
611,28025310,71450,28096760,7,0,0,4096,18,3549816699
612,28034270,50672,28084942,8,0,0,2560,12,1320798083
613,28046400,116786,28163186,7,0,0,44544,18,9285932571
614,28082410,123664,28206074,2,0,0,18944,4,6204235586
615,28299840,102752,28402592,2,0,0,37376,4,3018650406
616,28305350,5802,28311152,7,0,1,6144,18,7494877997
617,28346320,118324,28464644,9,0,0,22016,10,4991222867
618,28405410,3904,28409314,7,0,1,10752,18,4656314341
619,28503620,99632,28603252,5,0,0,27136,11,4718734448
620,28519560,116283,28635843,2,0,0,20480,4,4795093972
621,28555670,80500,28636170,1,0,0,1024,14,3981730026
622,28563020,53240,28616260,9,0,0,2048,10,9543408208
623,28609470,99008,28708478,3,0,0,25088,9,4047006263
624,28685879,55748,28741627,0,0,0,4096,10,6064730741
625,28768880,59257,28828137,5,0,0,5120,11,2091440980
626,28772010,98384,28870394,4,0,0,23040,6,7096022612
627,28788371,2946,28791317,6,0,1,3072,9,4285471945
628,28932870,73604,29006474,6,0,0,12288,9,10664466133
629,28973370,107588,29080958,2,0,0,53248,4,6579285987
630,29095601,12737,29108338,6,0,1,24576,9,4693042994
631,29334740,55748,29390488,7,0,0,4096,18,2181078374
632,29414270,45596,29459866,4,0,0,1024,6,1123989662
633,29530930,48980,29579910,6,0,0,2048,9,3761767817
634,29534710,122564,29657274,9,0,0,102400,10,10619718571
635,29663470,3904,29667374,0,0,1,10752,10,8388582442
636,29676400,72848,29749248,6,0,0,14848,9,9770873547
637,29779420,139785,29919205,4,0,0,36864,6,6366998656
638,29881260,161269,30042529,7,0,0,51200,18,1483123011
639,29899110,105560,30004670,6,0,0,13312,9,6910843256
640,29902350,3898,29906248,7,0,1,4096,18,3858514795
641,29909941,15744,29925685,6,0,1,15872,9,8141175599
642,29994430,142762,30137192,5,0,0,8704,11,800710383
643,30035290,67767,30103057,7,0,0,9728,18,1232602262
644,30088860,95323,30184183,2,0,0,8704,4,9235653892
645,30205220,69284,30274504,9,0,0,8192,10,2169273319
646,30219380,102908,30322288,6,0,0,37888,9,2457631358
647,30388030,4850,30392880,0,0,1,5120,10,7391442721
648,30414041,5802,30419843,5,0,1,6144,11,3437904408
649,30495140,4374,30499514,9,0,1,4608,10,221057037
650,30529271,10499,30539770,6,0,1,16896,9,2364468353
651,30684790,78368,30763158,8,0,0,12800,12,9962782567
652,30714200,99944,30814144,8,0,0,28160,12,9250093267
653,30840030,67616,30907646,5,0,0,12800,11,6169214063
654,30849769,84692,30934461,0,0,0,18432,10,3928799687
655,31033719,1042,31034761,3,0,1,1024,9,10621254118
656,31133550,6229,31139779,9,0,1,15360,10,5973249929
657,31210359,102440,31312799,0,0,0,36352,10,9130789619
658,31281541,566,31282107,6,0,1,512,9,7565054620
659,31303691,9666,31313357,6,0,1,512,9,5029703903
660,31387660,113672,31501332,5,0,0,73216,11,9238404400
661,31453060,48755,31501815,9,0,0,1536,10,6345771470
662,31541560,103376,31644936,5,0,0,39424,11,5231370418
663,31795910,43904,31839814,6,0,0,512,9,1798846795
664,31804560,103844,31908404,1,0,0,40960,14,9431126912
665,31853510,11274,31864784,4,0,1,18432,6,9147145078
666,31887390,61760,31949150,4,0,0,8704,6,7888423255
667,31932460,82532,32014992,1,0,0,16384,14,5457538613
668,32045250,97760,32143010,3,0,0,20992,9,3768831675
669,32127320,102440,32229760,5,0,0,36352,11,3018810729
670,32146650,47288,32193938,5,0,0,1536,11,5280445191
671,32176730,134348,32311078,9,0,0,75264,10,4345946992
672,32205970,123570,32329540,9,0,0,8704,10,3271981465
673,32277530,3128,32280658,0,0,1,9216,10,3890111209
674,32285800,99008,32384808,2,0,0,25088,4,2962987248
675,32296470,284106,32580576,9,0,0,12800,10,5145720564
676,32306719,143951,32450670,0,0,0,43520,10,2221470213
677,32307890,6875,32314765,9,0,1,10240,10,2341286549
678,32313800,71959,32385759,3,0,0,3072,9,7151441788
679,32341460,55719,32397179,5,0,0,1536,11,6918115046
680,32350969,156793,32507762,0,0,0,19968,10,2690874567
681,32373450,164130,32537580,9,0,0,95744,10,1442197692
682,32396630,99900,32496530,5,0,0,1024,11,2054540182
683,32418511,2946,32421457,5,0,1,3072,11,10372564053
684,32424850,128584,32553434,4,0,0,16384,6,2232221018
685,32478910,185800,32664710,4,0,0,81920,6,6591790875
686,32525600,97810,32623410,5,0,0,1024,11,771956871
687,32561220,107561,32668781,8,0,0,13312,12,10354330787
688,32568950,182386,32751336,4,0,0,87040,6,4204166814
689,32614100,3422,32617522,0,0,1,3584,10,9378354049
690,32630950,219833,32850783,5,0,0,30720,11,6465970840
691,32708070,165929,32873999,2,0,0,53248,4,8168747298
692,32741530,99878,32841408,3,0,0,20992,9,7040069602
693,32787320,128518,32915838,8,0,0,32256,12,1708636653
694,32803059,2470,32805529,3,0,1,2560,9,2915894358
695,32805580,136766,32942346,3,0,0,33280,9,2591020354
696,32918149,86096,33004245,0,0,0,23040,10,3906529863
697,33093960,59756,33153716,9,0,0,7168,10,2169094171
698,33118710,52220,33170930,3,0,0,2048,9,1197476444
699,33275989,48980,33324969,0,0,0,2048,10,2284795310
700,33290240,11791,33302031,9,0,1,19456,10,7197415532
701,33325619,98696,33424315,0,0,0,24064,10,7038361166
702,33333990,2470,33336460,7,0,1,2560,18,124288834
703,33403729,1994,33405723,3,0,1,2048,9,2366984239
704,33430380,44214,33474594,4,0,0,512,6,8686131751
705,33438480,100568,33539048,4,0,0,30208,6,9629086827
706,33594070,121004,33715074,2,0,0,97280,4,8184678729
707,33642720,119052,33761772,1,0,0,57856,14,10706291682
708,33658710,199907,33858617,5,0,0,70144,11,7975493084
709,33666970,96221,33763191,4,0,0,4608,6,2450031458
710,33688981,31539,33720520,6,0,1,13824,9,4366752739
711,33732410,149566,33881976,4,0,0,61952,6,3765038377
712,33765800,179757,33945557,6,0,0,55808,9,6337465467
713,33768320,92028,33860348,2,0,0,5632,4,5116720643
714,33846549,161384,34007933,0,0,0,11264,10,8838778403
715,33866650,20168,33886818,9,0,1,5120,10,7954991353
716,33891360,138797,34030157,9,0,0,33792,10,9855448167
717,33957500,125157,34082657,9,0,0,12288,10,5653391228
718,34046470,69440,34115910,6,0,0,8704,9,2246168318
719,34144461,566,34145027,6,0,1,512,9,7478741371
720,34223950,120296,34344246,1,0,0,46080,14,3576945508
721,34360889,43904,34404793,0,0,0,512,10,4549621784
722,34392910,103844,34496754,3,0,0,40960,9,6718935936
723,34398590,149074,34547664,2,0,0,15360,4,8820990615
724,34457160,97071,34554231,5,0,0,21504,11,8346764272
725,34599600,82556,34682156,4,0,0,21504,6,853818860
726,34642970,90168,34733138,1,0,0,11264,14,2420710920
727,34721140,51296,34772436,2,0,0,4608,4,8448763576
728,34836760,83912,34920672,2,0,0,15872,4,3545495928
729,34849720,92372,34942092,5,0,0,18432,11,5508505879
730,34862529,1518,34864047,3,0,1,1536,9,369453168
731,34891560,156368,35047928,1,0,0,31232,14,4051244295
732,34911720,103376,35015096,9,0,0,39424,10,6313912292
733,34927750,191786,35119536,7,0,0,44032,18,2057419027
734,34977930,179154,35157084,8,0,0,26112,12,2639225891
735,35067150,111956,35179106,1,0,0,67584,14,2600303734
736,35124460,132850,35257310,1,0,0,24576,14,7553120303
737,35283590,77900,35361490,3,0,0,11264,9,6472122972
738,35318310,116386,35434696,1,0,0,23552,14,6488974930
739,35345130,113416,35458546,5,0,0,25088,11,1229495088
740,35369770,114972,35484742,3,0,0,10240,9,5964280676
741,35480770,111644,35592414,3,0,0,66560,9,4565670141
742,35527130,152224,35679354,4,0,0,52224,6,9231411399
743,35560420,153344,35713764,1,0,0,14848,14,5180471448
744,35593300,89969,35683269,1,0,0,12800,14,2452528804
745,35615780,172126,35787906,1,0,0,30208,14,4602787974
746,35642980,6754,35649734,0,0,1,7168,10,3974419329
747,35806200,80240,35886440,2,0,0,18944,4,1172101259
748,35870950,93752,35964702,9,0,0,17920,10,5574134240
749,35926500,52364,35978864,5,0,0,3072,11,5314751662
750,36040180,81128,36121308,4,0,0,11776,6,5060431687
751,36071820,77898,36149718,4,0,0,3072,6,9802864021
752,36176859,43904,36220763,0,0,0,512,10,3650631692
753,36306630,71600,36378230,3,0,0,10752,9,1643843484
754,36364490,87608,36452098,8,0,0,17920,12,2516915510
755,36393600,84280,36477880,4,0,0,5632,6,5296553785
756,36410950,101504,36512454,5,0,0,33280,11,6077326051
757,36431900,5326,36437226,7,0,1,5632,18,3714389604
758,36447250,72770,36520020,4,0,0,1536,6,2855396860
759,36487210,94712,36581922,2,0,0,26112,4,10690588997
760,36541070,3904,36544974,0,0,1,10752,10,7040909719
761,36556131,1994,36558125,6,0,1,2048,9,6166256607
762,36653690,52364,36706054,5,0,0,3072,11,8646669348
763,36820900,102284,36923184,5,0,0,35840,11,6898352429
764,36822589,100922,36923511,0,0,0,1024,10,6679104071
765,36860850,6278,36867128,8,0,1,6656,12,5202748528
766,36936160,187704,37123864,1,0,1,308736,14,9443885665
767,36940910,261549,37202459,9,0,0,26112,10,9502518096
768,37016110,192462,37208572,4,0,0,9728,6,2372767901
769,37042640,222218,37264858,9,0,0,16896,10,4416433523
770,37103480,250484,37353964,8,0,0,34304,12,4458461698
771,37161800,238070,37399870,5,0,0,22528,11,8175282217
772,37204271,4316,37208587,6,0,1,9728,9,3708997426
773,37217040,112012,37329052,3,0,0,28160,9,2489534000
774,37373451,3387,37376838,6,0,1,9728,9,1399217833
775,37410800,21141,37431941,0,0,1,34304,10,4961901346
776,37491730,67592,37559322,6,0,0,7680,9,7723676477
777,37506430,156769,37663199,3,0,0,2560,9,2790477819
778,37513430,58376,37571806,9,0,0,7680,10,7722481652
779,37562460,99944,37662404,4,0,0,28160,6,8197511978
780,37586060,127974,37714034,1,0,0,25088,14,9537178183
781,37764460,21399,37785859,7,0,1,34816,18,4838843955
782,37777710,107120,37884830,2,0,0,51712,4,6818213037
783,37778590,153275,37931865,8,0,0,52224,12,10230559770
784,37784110,184383,37968493,6,0,0,512,9,895357022
785,37796880,94196,37891076,1,0,0,512,14,5924467189
786,37847650,4374,37852024,7,0,1,4608,18,2410127058
787,37900950,77612,37978562,5,0,0,15360,11,8919172306
788,37986791,3904,37990695,5,0,1,10752,11,10022580578
789,38011310,84512,38095822,9,0,0,12800,10,20218912
790,38186960,566,38187526,9,0,1,512,10,6055665815
791,38191380,4420,38195800,0,0,1,11776,10,4072807377
792,38220320,101192,38321512,8,0,0,32256,12,9381309231
793,38257020,114166,38371186,5,0,0,37888,11,3744408671
794,38417070,62516,38479586,8,0,0,6144,12,5067063394
795,38444221,4850,38449071,2,0,1,5120,4,3091731338
796,38579491,3387,38582878,5,0,1,9728,11,3326263049
797,38586270,110552,38696822,9,0,0,62976,10,2783022900
798,38601730,135508,38737238,9,0,0,34304,10,4511118642
799,38618540,223109,38841649,8,0,0,29184,12,6754703588
800,38630550,126638,38757188,4,0,0,23040,6,582536981
801,38665259,72930,38738189,0,0,0,3072,10,652489137
802,38696849,95097,38791946,0,0,0,25088,10,4352864001
803,38876261,7230,38883491,6,0,1,7680,9,6997100977
804,38982219,105596,39087815,0,0,0,19968,10,229836383
805,38984220,97496,39081716,8,0,0,30208,12,1185566499
806,39064729,65900,39130629,0,0,0,7168,10,2409641705
807,39092910,113360,39206270,5,0,0,72192,11,7492706839
808,39165290,112080,39277370,1,0,0,20992,14,4892163169
809,39176711,7230,39183941,6,0,1,7680,9,4829013650
810,39201539,8110,39209649,3,0,1,9728,9,2836897936
811,39213230,65715,39278945,3,0,0,5120,9,8758192560
812,39283970,101348,39385318,1,0,0,32768,14,8830435277
813,39494790,87320,39582110,3,0,0,22016,9,9182094947
814,39561690,112196,39673886,2,0,0,23552,4,1302576022
815,39592140,97916,39690056,3,0,0,21504,9,5637446236
816,39596750,65900,39662650,4,0,0,7168,6,589470507
817,39622940,83912,39706852,6,0,0,15872,9,2323760071
818,39641421,2946,39644367,6,0,1,3072,9,9376479126
819,39653529,2470,39655999,3,0,1,2560,9,2232582299
820,39926900,60824,39987724,8,0,0,5632,12,5111738031
821,39955800,55748,40011548,9,0,0,4096,10,6846011680
822,40210100,104624,40314724,6,0,0,43520,9,3990882932
823,40230720,88855,40319575,1,0,0,15872,14,8223622660
824,40255370,242200,40497570,8,0,0,45056,12,1844478305
825,40291550,129202,40420752,9,0,0,15872,10,7216226895
826,40298440,108524,40406964,4,0,0,56320,6,9459146073
827,40341610,177770,40519380,5,0,0,4608,11,4609182558
828,40344630,5454,40350084,9,0,1,13824,10,3101335162
829,40442000,109822,40551822,3,0,0,4096,9,372434275
830,40445900,1042,40446942,0,0,1,1024,10,5240168259
831,40518050,100954,40619004,3,0,0,27136,9,7827140305
832,40536519,50710,40587229,0,0,0,2048,10,10437994455
833,40578140,93460,40671600,1,0,0,26112,14,8431067172
834,40582410,5326,40587736,9,0,1,5632,10,7544930569
835,40629890,106652,40736542,5,0,0,50176,11,5319954539
836,40644860,152361,40797221,6,0,0,8192,9,7217072392
837,40652730,18885,40671615,0,0,1,18944,10,6775385292
838,40662710,148076,40810786,1,0,0,14336,14,5293813153
839,40746360,52364,40798724,2,0,0,3072,4,10684849477
840,40885800,57440,40943240,6,0,0,4608,9,3166583090
841,40920140,103532,41023672,2,0,0,39936,4,9143394389
842,41017689,9362,41027051,3,0,1,9728,9,9365934899
843,41070801,266725,41337526,2,0,1,432640,4,6094429546
844,41123541,219131,41342672,5,0,1,8192,11,3579172802
845,41166800,181159,41347959,9,0,1,16896,10,945714707
846,41292490,295163,41587653,6,0,0,46080,9,9155537224
847,41306700,177715,41484415,2,0,0,14336,4,5724230791
848,41377980,111286,41489266,6,0,0,15872,9,6400524039
849,41437201,1994,41439195,6,0,1,2048,9,6062147408
850,41447820,95253,41543073,3,0,0,5632,9,4876857641
851,41452169,4850,41457019,3,0,1,5120,9,2152723889
852,41462280,108069,41570349,5,0,0,24576,11,2351817464
853,41591399,67592,41658991,0,0,0,7680,10,5449506412
854,41611441,3387,41614828,5,0,1,9728,11,4463878574
855,41649530,566,41650096,0,0,1,512,10,6426388351
856,41672040,10499,41682539,9,0,1,16896,10,9683429214
857,41800640,1994,41802634,0,0,1,2048,10,1544761648
858,41813010,111956,41924966,4,0,0,67584,6,9645704416
859,41923490,78456,42001946,2,0,0,13312,4,9585545992
860,42021220,73604,42094824,1,0,0,12288,14,1059377838
861,42198210,99632,42297842,8,0,0,27136,12,5639939707
862,42224910,97916,42322826,5,0,0,21504,11,3840059388
863,42280620,90524,42371144,8,0,0,17408,12,9556628534
864,42343230,124370,42467600,5,0,0,34304,11,9824350691
865,42358050,3387,42361437,9,0,1,9728,10,7716570979
866,42424340,43904,42468244,5,0,0,512,11,3129178514
867,42593810,3904,42597714,0,0,1,10752,10,7654947908
868,42642010,72668,42714678,5,0,0,9216,11,8607923112
869,42729660,54212,42783872,2,0,0,4096,4,10337520116
870,42774510,110708,42885218,3,0,0,63488,9,7505478261
871,42882730,66688,42949418,6,0,0,6656,9,6978253069
872,42932320,1994,42934314,7,0,1,2048,18,8303720710
873,42979340,4374,42983714,0,0,1,4608,10,2241229271
874,43050490,52988,43103478,1,0,0,5120,14,7446948663
875,43063131,12566,43075697,6,0,1,20992,9,7488791274
876,43128609,2946,43131555,3,0,1,3072,9,6143063531
877,43231660,90860,43322520,8,0,0,23552,12,10414973184
878,43286130,4850,43290980,0,0,1,5120,10,5479771634
879,43453750,115700,43569450,9,0,0,79872,10,4210680553
880,43480081,2946,43483027,5,0,1,3072,11,513483767
881,43501110,86959,43588069,6,0,0,2560,9,1786208753
882,43507190,92723,43599913,3,0,0,6144,9,2519858861
883,43515200,114796,43629996,2,0,0,45568,4,10375187007
884,43573131,136821,43709952,2,0,1,226304,4,5559845249
885,43574670,184819,43759489,8,0,0,23552,12,6074105694
886,43602260,222925,43825185,5,0,0,16384,11,6940649877
887,43651550,59068,43710618,0,0,1,1024,10,1025649003
888,43670389,41215,43711604,3,0,1,1536,9,9165883444
889,43707820,20882,43728702,0,0,1,33792,10,6209590239
890,43731210,114663,43845873,6,0,0,12288,9,1504358239
891,43788880,98301,43887181,9,0,0,2560,10,9240534311
892,43889910,98618,43988528,3,0,0,10240,9,1329642017
893,43941300,111846,44053146,5,0,0,6144,11,1370980628
894,43943220,100412,44043632,1,0,0,29696,14,3295697983
895,43974740,129762,44104502,8,0,0,31744,12,1965458010
896,44002360,138940,44141300,6,0,0,10240,9,7479052399
897,44023430,3422,44026852,7,0,1,3584,18,1076828416
898,44024711,5047,44029758,5,0,1,4608,11,2876095289
899,44050790,65900,44116690,3,0,0,7168,9,10519968155
900,44191870,72068,44263938,6,0,0,12288,9,9095399211
901,44192040,96872,44288912,6,0,0,28160,9,6817554308
902,44256281,7706,44263987,6,0,1,8192,9,9632648475
903,44307730,10241,44317971,7,0,1,16384,18,7339514377
904,44312810,47288,44360098,1,0,0,1536,14,2776100527
905,44331820,115334,44447154,9,0,0,26624,10,9873529357
906,44342560,64208,44406768,8,0,0,6656,12,2143902052
907,44364870,101970,44466840,9,0,0,24576,10,6891286680
908,44390850,90504,44481354,1,0,0,512,14,4290227615
909,44393610,74664,44468274,1,0,0,512,14,9694174827
910,44405690,62413,44468103,7,0,0,4096,18,2760916713
911,44557330,14545,44571875,8,0,1,28160,12,9152328651
912,44602460,62516,44664976,6,0,0,6144,9,7759550882
913,44634140,71000,44705140,5,0,0,13824,11,5207170958
914,44647860,120160,44768020,8,0,0,58880,12,914600775
915,44888029,1994,44890023,3,0,1,2048,9,10525439673
916,44933560,59132,44992692,9,0,0,5120,10,4170636389
917,44942700,80454,45023154,3,0,0,8192,9,5556879700
918,45028500,72380,45100880,7,0,0,13312,18,9185125291
919,45059180,134250,45193430,7,0,0,89088,18,5425181593
920,45061120,150834,45211954,2,0,0,18944,4,1542160937
921,45104740,140188,45244928,7,0,0,25088,18,2645544926
922,45235050,51782,45286832,1,0,0,4096,14,7241867321
923,45312510,101036,45413546,2,0,0,31744,4,1114473708
924,45344720,103532,45448252,9,0,0,39936,10,9766714668
925,45410580,106022,45516602,3,0,0,38400,9,4328186803
926,45536310,3128,45539438,7,0,1,9216,18,8676507689
927,45573420,71756,45645176,2,0,0,11264,4,5626123565
928,45627420,116552,45743972,1,0,0,35840,14,7257743047
929,45689340,89924,45779264,5,0,0,20480,11,8694431265
930,45713360,68928,45782288,4,0,0,3072,6,3490846427
931,45759610,103844,45863454,2,0,0,40960,4,2874298885
932,45794420,102088,45896508,8,0,0,7168,12,8659324484
933,45922650,3898,45926548,8,0,1,4096,12,4561101471
934,45934130,91148,46025278,6,0,0,19456,9,3717502403
935,46013931,105412,46119343,2,0,1,175104,4,9304726487
936,46054991,67258,46122249,5,0,1,4608,11,9450524548
937,46096740,216813,46313553,3,0,0,17920,9,10272849212
938,46130711,5802,46136513,5,0,1,6144,11,7044505422
939,46147770,12308,46160078,7,0,1,20480,18,3860874756
940,46197930,1042,46198972,0,0,1,1024,10,1392607016
941,46258070,99460,46357530,9,0,0,26112,10,8011689364
942,46258210,67904,46326114,4,0,0,8704,6,3161963376
943,46381050,74672,46455722,5,0,0,10752,11,9295537449
944,46400400,104624,46505024,9,0,0,43520,10,3761751964
945,46501660,121240,46622900,3,0,0,87040,9,1008925318
946,46515120,114347,46629467,4,0,0,21504,6,5738318931
947,46523400,160034,46683434,1,0,0,24576,14,8266461815
948,46534150,119266,46653416,6,0,0,17920,9,3107268707
949,46557230,105126,46662356,5,0,0,2560,11,6868074204
950,46566560,136416,46702976,8,0,0,50176,12,1910515957
951,46610181,24604,46634785,5,0,1,5632,11,4803302974
952,46691681,65557,46757238,2,0,1,92160,4,7810517144
953,46718330,164655,46882985,6,0,0,31232,9,3073637617
954,46746840,152457,46899297,7,0,0,3584,18,588805727
955,46779440,70575,46850015,8,0,0,2560,12,7567974043
956,46790730,45596,46836326,1,0,0,1024,14,5225126356
957,46843881,5326,46849207,6,0,1,5632,9,2341133711
958,46884610,110444,46995054,8,0,0,57856,12,7341920384
959,46962700,100724,47063424,6,0,0,30720,9,1367282384
960,46970630,108565,47079195,7,0,0,51712,18,849824576
961,47037690,122944,47160634,3,0,0,24064,9,1710539479
962,47072000,69415,47141415,3,0,0,10240,9,362781813
963,47072470,129750,47202220,3,0,0,8192,9,664771338
964,47080630,108893,47189523,2,0,0,16896,4,184031616
965,47121601,186154,47307755,2,0,1,305664,4,14597522
966,47127630,344128,47471758,9,0,0,50176,10,4840447115
967,47240740,68961,47309701,8,0,1,3072,12,2227697642
968,47345890,213379,47559269,2,0,0,105984,4,2613445942
969,47374570,198820,47573390,6,0,0,5120,9,8861025982
970,47405240,190284,47595524,2,0,0,1024,4,6184232391
971,47500510,127135,47627645,3,0,0,30720,9,8126228747
972,47597891,3128,47601019,5,0,1,9216,11,314783437
973,47619270,15138,47634408,0,0,1,7168,10,10192472270
974,47624820,53514,47678334,9,0,0,2560,10,5077249892
975,47642110,105092,47747202,5,0,0,45056,11,6372140239
976,47664690,83931,47748621,8,0,0,4608,12,1800139893
977,47691490,168439,47859929,2,0,0,49152,4,5903003082
978,47742130,79151,47821281,1,0,0,9216,14,7902259018
979,47752620,134495,47887115,2,0,0,41472,4,9460805622
980,47821150,115286,47936436,3,0,0,22528,9,8142819111
981,47869410,69069,47938479,9,0,0,6656,10,2825305954
982,47913421,1518,47914939,5,0,1,1536,11,5002287631
983,47943201,5971,47949172,2,0,1,14848,4,8375662929
984,47979860,185188,48165048,9,0,0,12288,10,2301982001
985,48052760,77744,48130504,6,0,0,10752,9,8557337792
986,48091850,107744,48199594,8,0,0,29696,12,370842308
987,48108310,5802,48114112,9,0,1,6144,10,3026131270
988,48142860,117712,48260572,1,0,0,46080,14,8832282334
989,48177180,113074,48290254,2,0,0,2560,4,2863605677
990,48187001,15579,48202580,2,0,1,30208,4,7905506465
991,48240010,53753,48293763,0,0,1,91136,10,7337255470
992,48243740,228605,48472345,3,0,0,10752,9,3786169576
993,48308550,219301,48527851,4,0,0,62976,6,5567764836
994,48688380,48980,48737360,8,0,0,2048,12,217438635
995,48741340,11791,48753131,7,0,1,19456,18,9867615154
996,48746340,215665,48962005,7,0,0,25088,18,1023130511
997,48840210,1042,48841252,7,0,1,1024,18,4009969759
998,48871970,75140,48947110,6,0,0,12288,9,10110425032
999,48898390,92445,48990835,5,0,0,7680,11,7272155094
1000,48910700,94087,49004787,4,0,0,5632,6,10714523492
1001,48992540,59132,49051672,4,0,0,5120,6,8899940605
1002,49004851,6278,49011129,2,0,1,6656,4,627089340
1003,49023209,1042,49024251,3,0,1,1024,9,8973214049
1004,49032310,108294,49140604,1,0,0,22528,14,2574429870
1005,49066900,107120,49174020,5,0,0,51712,11,8675195980
1006,49102580,116626,49219206,7,0,0,17408,18,4761150194
1007,49108650,75832,49184482,3,0,0,4096,9,4710990494
1008,49203520,65900,49269420,8,0,0,7168,12,1390237223
1009,49209520,76052,49285572,2,0,0,10240,4,2417555714
1010,49212130,117830,49329960,7,0,0,44544,18,7599970825
1011,49273850,75008,49348858,4,0,0,16896,6,4098571980
1012,49286640,65900,49352540,5,0,0,7168,11,1317392548
1013,49297140,97654,49394794,2,0,0,4096,4,6170237940
1014,49364060,97532,49461592,8,0,0,25600,12,5088702692
1015,49407450,139942,49547392,3,0,0,42496,9,4649743582
1016,49416340,59132,49475472,5,0,0,5120,11,5194299602
1017,49425430,60516,49485946,3,0,0,3584,9,2157445621
1018,49480500,13253,49493753,1,0,1,25600,14,5599513994
1019,49529470,74540,49604010,6,0,0,15360,9,5986316236
1020,49613360,64208,49677568,1,0,0,6656,14,357843505
1021,49881660,1518,49883178,8,0,1,1536,12,6732230132
1022,49907661,1518,49909179,2,0,1,1536,4,1401851856
1023,49955339,3904,49959243,3,0,1,10752,9,5453521638
1024,49982020,86814,50068834,4,0,0,4096,6,9911722019
1025,50010500,55748,50066248,9,0,0,4096,10,3074772831
1026,50020200,114790,50134990,8,0,0,59904,12,2615561753
1027,50026500,112240,50138740,5,0,0,512,11,1030006825
1028,50066269,566,50066835,3,0,1,512,9,10386682390
1029,50096850,82562,50179412,2,0,0,8704,4,6124276315
1030,50239670,97472,50337142,2,0,0,25088,4,2873171328
1031,50308730,71756,50380486,6,0,0,11264,9,5064473817
1032,50332870,62226,50395096,7,0,0,7680,18,382094009
1033,50343430,74082,50417512,7,0,0,5632,18,10079099247
1034,50371630,98958,50470588,3,0,0,23552,9,10707240028
1035,50431150,77802,50508952,9,0,0,1024,10,9414405133
1036,50490600,95312,50585912,3,0,0,23040,9,1330010289
1037,50572480,51516,50623996,0,0,1,83456,10,1654606905
1038,50588090,231719,50819809,7,0,0,13312,18,1313014987
1039,50597930,98479,50696409,7,0,0,2048,18,7073424451
1040,50648270,228653,50876923,9,0,0,33280,10,5991447242
1041,50746741,5971,50752712,5,0,1,14848,11,8251618205
1042,50822800,60824,50883624,4,0,0,5632,6,1544844902
1043,50842420,127968,50970388,9,0,0,3072,10,9229978793
1044,50907359,2470,50909829,3,0,1,2560,9,107408820
1045,50932270,98540,51030810,6,0,0,23552,9,8273817455
1046,50935700,3422,50939122,7,0,1,3584,18,6600489416
1047,51011510,115912,51127422,1,0,0,40960,14,1927022878
1048,51027690,105519,51133209,4,0,0,18944,6,6741325787
1049,51066990,118944,51185934,7,0,0,24064,18,9313716077
1050,51103040,65900,51168940,4,0,0,7168,6,8049343453
1051,51172650,47288,51219938,5,0,0,1536,11,4598800261
1052,51252711,6754,51259465,6,0,1,7168,9,7229106390
1053,51255830,113594,51369424,4,0,0,19456,6,8509040486
1054,51269060,78041,51347101,7,0,0,6656,18,951198836
1055,51453660,102596,51556256,8,0,0,36864,12,1938964402
1056,51512200,64208,51576408,1,0,0,6656,14,6759827875
1057,51520870,126538,51647408,4,0,0,36352,6,9851323119
1058,51597530,113442,51710972,9,0,0,15872,10,7378311542
1059,51777250,113828,51891078,9,0,0,73728,10,9264681133
1060,51788710,134876,51923586,3,0,0,29184,9,3964096676
1061,51807909,10757,51818666,3,0,1,17408,9,8811551375
1062,52013380,3904,52017284,1,0,1,10752,14,1378359599
1063,52028180,3898,52032078,9,0,1,4096,10,6506547671
1064,52081140,101645,52182785,6,0,0,14336,9,3614935327
1065,52097910,4374,52102284,9,0,1,4608,10,2816667429
1066,52223940,54368,52278308,4,0,0,4608,6,906895870
1067,52260470,54056,52314526,5,0,0,3584,11,10155079087
1068,52268780,68528,52337308,6,0,0,10752,9,10719608597
1069,52333500,57440,52390940,6,0,0,4608,9,7555343203
1070,52365610,93776,52459386,4,0,0,23040,6,4802164193
1071,52378510,99788,52478298,4,0,0,27648,6,3248994225
1072,52380670,166178,52546848,6,0,0,29696,9,727833283
1073,52389310,97346,52486656,4,0,0,512,6,9844373746
1074,52422210,71358,52493568,7,0,0,1024,18,4052163270
1075,52492830,100662,52593492,9,0,0,4096,10,5139781868
1076,52547990,104326,52652316,4,0,0,35840,6,6256917462
1077,52611750,45596,52657346,8,0,0,1024,12,3737047865
1078,52758910,53144,52812054,5,0,0,5632,11,8367256471
1079,52889981,7230,52897211,5,0,1,7680,11,7462712036
1080,52898710,80669,52979379,1,0,0,8192,14,819152607
1081,52908540,60824,52969364,6,0,0,5632,9,8529668544
1082,52928270,2946,52931216,8,0,1,3072,12,4834530699
1083,52967630,47322,53014952,5,0,0,1024,11,9350797524
1084,52979720,10499,52990219,7,0,1,16896,18,5863350844
1085,53041420,4679,53046099,8,0,1,12288,12,5957223164
1086,53063150,131853,53195003,1,0,0,18944,14,7937724464
1087,53128460,3645,53132105,8,0,1,10240,12,1773052199
1088,53169651,3898,53173549,2,0,1,4096,4,4442554695
1089,53183960,98096,53282056,5,0,0,27136,11,6020650686
1090,53209340,77744,53287084,4,0,0,10752,6,10280569444
1091,53304130,108680,53412810,3,0,0,56832,9,4752717931
1092,53314560,104622,53419182,5,0,0,7168,11,7076551843
1093,53415620,106184,53521804,3,0,0,48640,9,7098513516
1094,53489000,137376,53626376,9,0,0,90624,10,15774196
1095,53500060,21759,53521819,0,0,1,24064,10,9848081073
1096,53551400,94596,53645996,6,0,0,1536,9,7061327494
1097,53568480,155534,53724014,6,0,0,24576,9,5869455571
1098,53600611,27751,53628362,6,0,1,2048,9,360524999
1099,53642660,108212,53750872,2,0,0,55296,4,8792387908
1100,53725470,60824,53786294,9,0,0,5632,10,5119871214
1101,53791390,121435,53912825,6,0,0,31744,9,5618683573
1102,53801790,101348,53903138,5,0,0,32768,11,5389332570
1103,53825201,3898,53829099,2,0,1,4096,4,7497498410
1104,53854190,96816,53951006,7,0,0,6144,18,815048607
1105,53862839,11016,53873855,3,0,1,17920,9,2893440117
1106,53965090,45596,54010686,2,0,0,1024,4,10256197651
1107,53976850,101816,54078666,6,0,0,34304,9,10648988899
1108,54034290,104936,54139226,8,0,0,44544,12,7189841241
1109,54057769,82564,54140333,0,0,0,3584,10,3167908524
1110,54102810,71768,54174578,6,0,0,2048,9,5513406614
1111,54152601,1518,54154119,5,0,1,1536,11,972065428
1112,54163560,99788,54263348,9,0,0,27648,10,272655505
1113,54174710,100724,54275434,3,0,0,30720,9,3631978523
1114,54216960,109594,54326554,8,0,0,9728,12,4727421629
1115,54277559,5196,54282755,3,0,1,13312,9,568450106
1116,54314350,47288,54361638,8,0,0,1536,12,5606720868
1117,54326219,116339,54442558,0,0,0,80896,10,1823563016
1118,54388830,89848,54478678,2,0,0,5632,4,4832902015
1119,54465109,109772,54574881,0,0,0,60416,10,7194882559
1120,54498900,96356,54595256,8,0,0,16384,12,1203601600
1121,54549160,60824,54609984,5,0,0,5632,11,4028666338
1122,54565360,115229,54680589,5,0,0,47104,11,4561098324
1123,54635110,66368,54701478,4,0,0,8704,6,2361063473
1124,54723080,108680,54831760,2,0,0,56832,4,7513946802
1125,54725189,147455,54872644,0,0,0,29696,10,4886057204
1126,54799869,132205,54932074,0,0,0,52224,10,10194203910
1127,54808000,128613,54936613,2,0,0,14848,4,2413801526
1128,54830260,55548,54885808,2,0,0,3584,4,1627283659
1129,54830550,173345,55003895,8,0,0,40960,12,6509852181
1130,54980950,76052,55057002,1,0,0,10240,14,6923557830
1131,55032200,118822,55151022,8,0,0,86016,12,668798597
1132,55053760,113514,55167274,4,0,0,11264,6,9446698927
1133,55100440,3422,55103862,8,0,1,3584,12,2400083855
1134,55130730,130972,55261702,7,0,0,21504,18,8397972594
1135,55133940,586023,55719963,0,0,1,921088,10,1631996713
1136,55201580,520329,55721909,7,0,1,3072,18,1336389558
1137,55264649,328712,55593361,0,0,0,11776,10,881930305
1138,55289801,437254,55727055,5,0,1,8192,11,10544407351
1139,55344490,252630,55597120,7,0,0,12288,18,8075350878
1140,55424880,342332,55767212,5,0,0,29696,11,4057483644
1141,55435089,406936,55842025,0,0,0,90112,10,2005452530
1142,55442119,286562,55728681,3,0,1,2560,9,3577535764
1143,55478740,443850,55922590,4,0,0,54272,6,5320199387
1144,55552140,376237,55928377,6,0,0,18944,9,922805342
1145,55575921,153221,55729142,5,0,1,10240,11,10121741826
1146,55669580,294851,55964431,4,0,0,47104,6,9411887977
1147,55686480,157483,55843963,5,0,0,4608,11,8298402456
1148,55770910,257131,56028041,7,0,0,24576,18,1325408296
1149,55780460,187262,55967722,3,0,0,10752,9,10661569573
1150,55885600,157468,56043068,3,0,0,11264,9,8988117490
1151,55962080,100647,56062727,4,0,0,6656,6,1511408684
1152,56023790,136398,56160188,3,0,0,7168,9,921618335
1153,56049000,101603,56150603,5,0,0,30720,11,8511227946
1154,56079561,13600,56093161,5,0,1,23040,11,1151797377
1155,56137870,2946,56140816,7,0,1,3072,18,7972100321
1156,56167150,5802,56172952,9,0,1,6144,10,5572314897
1157,56187270,88832,56276102,7,0,0,16896,18,6084300791
1158,56275740,81218,56356958,3,0,0,20992,9,1466873900
1159,56320440,127471,56447911,9,0,0,7168,10,2622642202
1160,56557270,3898,56561168,9,0,1,4096,10,4108554188
1161,56655480,78056,56733536,6,0,0,11776,9,3823159562
1162,56684820,105968,56790788,5,0,0,20992,11,73586399
1163,56692310,566,56692876,4,0,1,512,6,1030614025
1164,56700940,96824,56797764,4,0,0,17920,6,8464988250
1165,56707530,182547,56890077,7,0,0,32768,18,3980568845
1166,56770140,44060,56814200,6,0,0,1024,9,6658770076
1167,56819620,82820,56902440,7,0,0,12288,18,8363990144
1168,56826910,44060,56870970,1,0,0,1024,14,8261010139
1169,56921010,64520,56985530,2,0,0,7680,4,2217140605
1170,57100790,67616,57168406,1,0,0,12800,14,1390078066
1171,57123990,69598,57193588,4,0,0,3584,6,4062745483
1172,57182190,98384,57280574,7,0,0,23040,18,7610611476
1173,57190270,167068,57357338,6,0,0,113664,9,577141978
1174,57274480,84277,57358757,2,0,0,4608,4,2802287895
1175,57364080,116168,57480248,2,0,0,81408,4,10157564108
1176,57488220,104780,57593000,2,0,0,44032,4,2267148199
1177,57503890,139510,57643400,2,0,0,48128,4,10136814984
1178,57561320,83967,57645287,3,0,0,6144,9,3420848370
1179,57615610,59132,57674742,1,0,0,5120,14,6118996317
1180,57654660,3645,57658305,0,0,1,10240,10,983501536
1181,57678620,57440,57736060,6,0,0,4608,9,4324193985
1182,57692110,1994,57694104,1,0,1,2048,14,8312706837
1183,57710141,1042,57711183,2,0,1,1024,4,9868896284
1184,57814380,3128,57817508,8,0,1,9216,12,2044425497
1185,57828130,101036,57929166,7,0,0,31744,18,4869135250
1186,57880040,152604,58032644,1,0,0,5632,14,221605598
1187,57905430,54056,57959486,5,0,0,3584,11,3950269386
1188,57907460,115218,58022678,2,0,0,49664,4,5106324904
1189,58020690,107072,58127762,4,0,0,45056,6,2454303100
1190,58029540,84104,58113644,3,0,0,7680,9,9993642330
1191,58064470,74360,58138830,3,0,0,9728,9,4575859202
1192,58097750,99008,58196758,9,0,0,25088,10,7841606580
1193,58115220,98752,58213972,3,0,0,19968,9,8651623397
1194,58119989,62002,58181991,0,0,0,4096,10,8609994875
1195,58180340,115748,58296088,9,0,0,25088,10,5468606022
1196,58288130,79592,58367722,4,0,0,11776,6,6678224284
1197,58341920,52676,58394596,3,0,0,3072,9,6086013088
1198,58358940,55748,58414688,2,0,0,4096,4,294115276
1199,58466760,99788,58566548,7,0,0,27648,18,2448360396
1200,58469590,52988,58522578,9,0,0,5120,10,718668412
1201,58512490,112088,58624578,4,0,0,25088,6,2617477796
1202,58513630,83756,58597386,6,0,0,15360,9,5878460664
1203,58526471,7230,58533701,5,0,1,7680,11,1666092660
1204,58530250,97102,58627352,9,0,0,8192,10,9081455345
1205,58617789,10685,58628474,3,0,1,10752,9,10659236908
1206,58657060,2470,58659530,0,0,1,2560,10,5362247182
1207,58700530,107900,58808430,6,0,0,54272,9,133908733
1208,58721020,566,58721586,7,0,1,512,18,7565365501
1209,58777130,73840,58850970,9,0,0,5120,10,5511636361
1210,58800531,9885,58810416,6,0,1,2048,9,5208777730
1211,58995609,104312,59099921,0,0,0,42496,10,3658076678
1212,59077550,4162,59081712,1,0,1,11264,14,641702288
1213,59107860,104312,59212172,9,0,0,42496,10,6786943724
1214,59126670,98294,59224964,6,0,0,18944,9,5958172977
1215,59164830,106496,59271326,2,0,0,49664,4,974443091
1216,59193640,78333,59271973,5,0,0,2048,11,8425311389
1217,59206201,12241,59218442,6,0,1,6656,9,7285488421
1218,59258040,85658,59343698,8,0,0,13312,12,1215510863
1219,59335750,7963,59343713,8,0,1,4608,12,4609645256
1220,59385200,69284,59454484,4,0,0,8192,6,4849141613
1221,59399280,10499,59409779,1,0,1,16896,14,9693758522
1222,59456960,70976,59527936,6,0,0,8704,9,5154593509
1223,59484820,100962,59585782,3,0,0,20992,9,4145299753
1224,59485880,152888,59638768,5,0,0,12288,11,4822949441
1225,59485900,79842,59565742,4,0,0,5632,6,7106474979
1226,59498740,48980,59547720,5,0,0,2048,11,250114970
1227,59519110,98540,59617650,6,0,0,23552,9,7663831791
1228,59522330,156640,59678970,1,0,0,63488,14,7980151980
1229,59536890,116776,59653666,5,0,0,4608,11,5526881325
1230,59664130,102908,59767038,6,0,0,19456,9,8374601730
1231,59679661,14545,59694206,2,0,1,28160,4,3504533190
1232,59731830,126042,59857872,1,0,0,89600,14,5987312370
1233,59867900,104000,59971900,1,0,0,41472,14,6278408439
1234,59911359,101905,60013264,0,0,0,3584,10,3594713491
1235,60021020,62635,60083655,1,0,0,10752,14,10147379824
1236,60028000,52364,60080364,9,0,0,3072,10,641999520
1237,60052810,79928,60132738,1,0,0,17920,14,4979403785
1238,60079260,74360,60153620,5,0,0,9728,11,300172103
1239,60127681,7519,60135200,5,0,1,2560,11,8367517155
1240,60194159,72668,60266827,0,0,0,9216,10,7053289085
1241,60353990,97136,60451126,2,0,0,18944,4,6221108154
1242,60438230,3422,60441652,7,0,1,3584,18,2320123882
1243,60452870,99008,60551878,4,0,0,25088,6,4685188664
1244,60530211,1518,60531729,5,0,1,1536,11,9829291038
1245,60535290,95990,60631280,6,0,0,24064,9,6515033631
1246,60575490,113852,60689342,2,0,0,16896,4,154888999
1247,60586360,68216,60654576,5,0,0,9728,11,8794206637
1248,60613700,85295,60698995,2,0,0,12800,4,1948892145
1249,60632840,3645,60636485,8,0,1,10240,12,2207818742
1250,60730459,97292,60827751,0,0,0,19456,10,8730100568
1251,60817770,107744,60925514,3,0,0,53760,9,6090476892
1252,60847950,112946,60960896,7,0,0,57856,18,8496589529
1253,60901870,123652,61025522,5,0,0,41984,11,10505589017
1254,60921170,55008,60976178,5,0,0,2560,11,10073658323
1255,61003870,69284,61073154,5,0,0,8192,11,10675643549
1256,61181360,100256,61281616,7,0,0,29184,18,4313376041
1257,61188260,95867,61284127,8,0,0,8192,12,7685702491
1258,61302380,60536,61362916,1,0,0,9728,14,1917552726
1259,61344260,3898,61348158,8,0,1,4096,12,1917844633
1260,61378281,1518,61379799,2,0,1,1536,4,1894951631
1261,61389350,101972,61491322,1,0,0,34816,14,715578293
1262,61414820,134897,61549717,1,0,0,18432,14,10586070704
1263,61477730,13607,61491337,8,0,1,3584,12,8901524441
1264,61533501,3904,61537405,6,0,1,10752,9,3122445370
1265,61588290,110084,61698374,5,0,0,61440,11,2299157643
1266,61597921,10499,61608420,6,0,1,16896,9,3394239062
1267,61610670,5971,61616641,9,0,1,14848,10,7053677179
1268,61613450,252228,61865678,1,0,0,6144,14,3353632884
1269,61641820,91678,61733498,2,0,0,3072,4,7023005664
1270,61650070,107584,61757654,2,0,0,11776,4,10346991512
1271,61703570,132726,61836296,7,0,0,36864,18,10081073474
1272,61713190,4162,61717352,8,0,1,11264,12,7128904258
1273,61828941,10769,61839710,2,0,1,3584,4,6370775841
1274,61897370,82220,61979590,6,0,0,15360,9,1353086441
1275,61967660,105872,62073532,3,0,0,47616,9,5067858577
1276,62019250,6488,62025738,1,0,1,15872,14,6654630499
1277,62037160,106028,62143188,5,0,0,48128,11,2429424402
1278,62087010,4420,62091430,1,0,1,11776,14,9480771577
1279,62252630,57752,62310382,3,0,0,5632,9,643916855
1280,62521420,4374,62525794,0,0,1,4608,10,5045390566
1281,62569220,52364,62621584,6,0,0,3072,9,7235913463
1282,62571270,249361,62820631,9,0,0,32768,10,10538857915
1283,62631080,113672,62744752,9,0,0,73216,10,7664867958
1284,62652961,5454,62658415,5,0,1,13824,11,8294084057
1285,62751660,124109,62875769,2,0,0,46080,4,4906429568
1286,62800530,162023,62962553,7,0,0,31232,18,10473300361
1287,62858980,72668,62931648,4,0,0,9216,6,10397752158
1288,62859040,16744,62875784,9,0,1,3072,10,1721275234
1289,62901960,71132,62973092,5,0,0,9216,11,7821832156
1290,63080941,4420,63085361,6,0,1,11776,9,5365037032
1291,63083400,104710,63188110,5,0,0,39936,11,5892778609
1292,63116680,6278,63122958,7,0,1,6656,18,7641156133
1293,63193470,66212,63259682,9,0,0,8192,10,2595663217
1294,63215290,81152,63296442,9,0,0,16896,10,6215384103
1295,63230269,3904,63234173,3,0,1,10752,9,8769603009
1296,63275200,61448,63336648,5,0,0,7680,11,981641941
1297,63306550,3387,63309937,4,0,1,9728,6,925774679
1298,63309050,2983,63312033,8,0,1,2560,12,6590440903
1299,63321750,60102,63381852,2,0,0,2560,4,1893647166
1300,63379090,130983,63510073,9,0,0,58880,10,9505713756
1301,63405180,144153,63549333,1,0,0,1024,14,2119726196
1302,63439900,77786,63517686,2,0,0,1536,4,7563564280
1303,63531990,79436,63611426,2,0,0,11264,4,393291429
1304,63685261,3128,63688389,2,0,1,9216,4,977969176
1305,63724030,6278,63730308,0,0,1,6656,10,6771383218
1306,63860080,3898,63863978,9,0,1,4096,10,1588771304
1307,63935160,114608,64049768,4,0,0,76288,6,348432639
1308,63966990,91844,64058834,4,0,0,4096,6,3581705305
1309,63976180,12566,63988746,4,0,1,20992,6,8225384922
1310,63979130,150285,64129415,4,0,0,14336,6,7939780593
1311,64011319,113713,64125032,0,0,0,28672,10,8391907423
1312,64092880,47288,64140168,3,0,0,1536,9,7725449386
1313,64120690,59414,64180104,5,0,0,2560,11,4997030187
1314,64126600,89954,64216554,1,0,0,5120,14,4212524340
1315,64149450,97604,64247054,9,0,0,20480,10,5546437496
1316,64226591,12049,64238640,5,0,1,19968,11,7164353505
1317,64271650,65174,64336824,4,0,0,3072,6,8295007418
1318,64286900,1994,64288894,0,0,1,2048,10,7873061984
1319,64333090,99320,64432410,5,0,0,26112,11,1794644532
1320,64389789,108513,64498302,0,0,0,43520,10,7605312422
1321,64445839,168905,64614744,0,0,0,137216,10,6999890375
1322,64565130,57440,64622570,7,0,0,4608,18,8869626727
1323,64622520,47642,64670162,2,0,0,2560,4,4114046651
1324,64670281,21399,64691680,6,0,1,34816,9,2861210966
1325,64674369,94021,64768390,0,0,0,17408,10,9024764418
1326,64741960,154445,64896405,9,0,0,11264,10,7371537569
1327,64771000,99944,64870944,1,0,0,28160,14,1121232377
1328,64775950,150698,64926648,2,0,0,49664,4,3371625713
1329,64918639,109389,65028028,0,0,0,1024,10,6489190145
1330,64924860,102841,65027701,7,0,0,31744,18,8152255726
1331,65003120,92285,65095405,2,0,0,9728,4,818970819
1332,65063219,55748,65118967,0,0,0,4096,10,236936332
1333,65080200,53144,65133344,6,0,0,5632,9,10589106806
1334,65221670,60824,65282494,1,0,0,5632,14,382684330
1335,65228670,69028,65297698,1,0,0,5120,14,6652511918
1336,65277690,108524,65386214,6,0,0,56320,9,5764014733
1337,65350810,566,65351376,0,0,1,512,10,64961757
1338,65442300,57908,65500208,7,0,0,6144,18,4476733371
1339,65487930,72734,65560664,9,0,0,10752,10,7919214547
1340,65622490,102128,65724618,2,0,0,35328,4,8623285521
1341,65694670,110012,65804682,4,0,0,28672,6,10464084333
1342,65859690,100412,65960102,1,0,0,29696,14,1804207188
1343,65863790,6278,65870068,7,0,1,6656,18,1727012362
1344,65940670,89612,66030282,3,0,0,19456,9,7930291170
1345,66026990,69184,66096174,7,0,0,7168,18,4066869056
1346,66027970,106832,66134802,5,0,0,23040,11,6735511846
1347,66070850,94523,66165373,3,0,0,11264,9,6648632866
1348,66081119,54790,66135909,0,0,0,3584,10,2157399669
1349,66217500,45596,66263096,9,0,0,1024,10,1841639077
1350,66289819,3128,66292947,3,0,1,9216,9,3983657257
1351,66290319,46261,66336580,0,0,0,512,10,10172727153
1352,66314369,102240,66416609,0,0,0,35328,10,10446587780
1353,66335510,105170,66440680,1,0,0,42496,14,2998777561
1354,66390050,5802,66395852,0,0,1,6144,10,7758198354
1355,66515560,7230,66522790,0,0,1,7680,10,6861224487
1356,66527011,24412,66551423,6,0,1,44032,9,6920696501
1357,66641639,7706,66649345,3,0,1,8192,9,4970591245
1358,66679370,96872,66776242,1,0,0,28160,14,7298960420
1359,66700250,5802,66706052,7,0,1,6144,18,360222667
1360,66771920,168453,66940373,3,0,0,20480,9,3666402077
1361,66805200,84512,66889712,1,0,0,12800,14,8345398174
1362,66819840,129284,66949124,9,0,0,28672,10,2113830066
1363,66822900,82994,66905894,3,0,0,6656,9,3766397192
1364,66878050,139273,67017323,1,0,0,45056,14,3612650781
1365,66887640,15405,66903045,9,0,1,22528,10,5562828166
1366,66896800,132082,67028882,3,0,0,37888,9,4426057145
1367,66923040,113760,67036800,2,0,0,1024,4,9445788481
1368,66974010,88170,67062180,4,0,0,13824,6,2354708397
1369,66987680,202049,67189729,3,0,0,43520,9,7035500140
1370,67032020,192185,67224205,5,0,0,25600,11,9341477733
1371,67050010,150153,67200163,4,0,0,1024,6,10631794869
1372,67107700,86256,67193956,7,0,0,13824,18,8598358838
1373,67206920,99977,67306897,4,0,0,22528,6,10336307818
1374,67283110,94635,67377745,5,0,0,15872,11,8516815902
1375,67315100,174248,67489348,4,0,0,34304,6,9777866766
1376,67348770,130111,67478881,2,0,0,48128,4,1273061313
1377,67403440,86407,67489847,2,0,0,1536,4,5489070668
1378,67434470,72053,67506523,3,0,0,6656,9,5763462928
1379,67447049,54056,67501105,0,0,0,3584,10,4149126860
1380,67474320,129463,67603783,7,0,0,31232,18,2124579393
1381,67487330,59475,67546805,4,0,0,4608,6,253214453
1382,67530890,95447,67626337,5,0,0,18432,11,9937365789
1383,67616400,102440,67718840,7,0,0,36352,18,7124466823
1384,67625059,185083,67810142,0,0,0,108032,10,6969685076
1385,67735699,127369,67863068,0,0,0,53760,10,5485537642
1386,67738810,2470,67741280,0,0,1,2560,10,852899760
1387,67765520,103873,67869393,5,0,0,11776,11,8993957730
1388,67767400,105284,67872684,3,0,0,10752,9,3291644235
1389,67814670,105069,67919739,4,0,0,29696,6,9480877873
1390,67858940,214320,68073260,2,0,0,49152,4,2189910613
1391,67897010,54992,67952002,3,0,0,6656,9,8734286261
1392,67924200,53840,67978040,5,0,0,1024,11,2590234078
1393,67925001,3128,67928129,2,0,1,9216,4,55281135
1394,67936030,3387,67939417,8,0,1,9728,12,3891626327
1395,68033350,104156,68137506,9,0,0,41984,10,1581886366
1396,68095480,94340,68189820,4,0,0,20992,6,2829973158
1397,68112090,3387,68115477,9,0,1,9728,10,5165090519
1398,68192940,136611,68329551,5,0,0,39424,11,7435957158
1399,68219780,162685,68382465,7,0,0,15360,18,3871904197
1400,68386110,59912,68446022,3,0,0,7680,9,4381923321
1401,68441740,43904,68485644,2,0,0,512,4,3704072759
1402,68554450,108992,68663442,9,0,0,57856,10,3054377335
1403,68593530,92454,68685984,1,0,0,9728,14,1735869048
1404,68604031,5712,68609743,2,0,1,14336,4,9560863078
1405,68651070,146022,68797092,2,0,0,39424,4,3565001413
1406,68658560,81112,68739672,4,0,0,12288,6,5262489303
1407,68688630,51837,68740467,7,0,0,2560,18,8511935039
1408,68730521,5326,68735847,5,0,1,5632,11,1934892454
1409,68743470,66996,68810466,3,0,0,1536,9,5377455337
1410,68754030,112892,68866922,9,0,0,70656,10,9604060003
1411,68896010,13253,68909263,1,0,1,25600,14,6076303884
1412,69005229,60824,69066053,0,0,0,5632,10,5118337672
1413,69027770,76052,69103822,7,0,0,10240,18,218187722
1414,69142390,100256,69242646,9,0,0,29184,10,3981303917
1415,69147660,97185,69244845,4,0,0,7168,6,7768503403
1416,69246100,90548,69336648,7,0,0,22528,18,3500076430
1417,69329550,106340,69435890,4,0,0,49152,6,7097625674
1418,69445839,98696,69544535,0,0,0,24064,10,10382481304
1419,69542230,52969,69595199,5,0,0,2560,11,225171074
1420,69623120,89588,69712708,2,0,0,14336,4,9345613438
1421,69676230,4162,69680392,8,0,1,11264,12,806791146
1422,69696629,72380,69769009,0,0,0,13312,10,10593302386
1423,69706450,113911,69820361,6,0,0,18432,9,9398419236
1424,69793510,64208,69857718,4,0,0,6656,6,6376269101
1425,69830310,79592,69909902,1,0,0,11776,14,7573728071
1426,69850291,7442,69857733,2,0,1,14336,4,3303276551
1427,69871460,68544,69940004,2,0,0,3584,4,9839042855
1428,69888840,566,69889406,1,0,1,512,14,7528524458
1429,69893430,98876,69992306,9,0,0,12800,10,6665896259
1430,69916720,65924,69982644,7,0,0,12288,18,8472414161
1431,69947990,67984,70015974,1,0,0,4608,14,429334022
1432,69978220,101660,70079880,6,0,0,33792,9,2373461672
1433,69993331,1518,69994849,6,0,1,1536,9,106336483
1434,70031270,1518,70032788,8,0,1,1536,12,1156634032
1435,70032220,70688,70102908,1,0,0,12800,14,142155287
1436,70231070,64208,70295278,6,0,0,6656,9,7629622027
1437,70282120,122661,70404781,3,0,0,20992,9,4214427576
1438,70290380,91810,70382190,1,0,0,22528,14,9200900710
1439,70291670,12995,70304665,1,0,1,25088,14,603212705
1440,70353139,85115,70438254,0,0,0,7680,10,2091838899
1441,70394789,93800,70488589,0,0,0,28160,10,6695737921
1442,70578099,1518,70579617,3,0,1,1536,9,10343739057
1443,70600759,104000,70704759,0,0,0,41472,10,10160463914
1444,70612510,99128,70711638,3,0,0,22528,9,8388730793
1445,70660650,258165,70918815,3,0,0,113152,9,5629415823
1446,70670610,6278,70676888,8,0,1,6656,12,3445248160
1447,70678340,76052,70754392,4,0,0,10240,6,7160618943
1448,70678430,147925,70826355,7,0,0,14848,18,5660961637
1449,70680090,129497,70809587,5,0,0,77824,11,10513944357
1450,70700789,23666,70724455,3,0,1,21504,9,5266924125
1451,70774730,151588,70926318,5,0,0,24576,11,10252777158
1452,70805200,183193,70988393,9,0,0,28160,10,2935427803
1453,70823751,3638,70827389,5,0,1,1024,11,10691431079
1454,70872560,151110,71023670,6,0,0,14336,9,225095804
1455,70941259,122368,71063627,0,0,0,47104,10,727384505
1456,70995780,105221,71101001,7,0,0,17408,18,9095731435
1457,71046960,104936,71151896,9,0,0,44544,10,3644639760
1458,71050030,148210,71198240,3,0,0,35328,9,4599174186
1459,71067680,114795,71182475,6,0,0,56832,9,73801118
1460,71087460,147428,71234888,6,0,0,7168,9,2417723782
1461,71102570,127728,71230298,5,0,0,18432,11,8695614289
1462,71318800,45596,71364396,3,0,0,1024,9,5116488622
1463,71543600,76052,71619652,4,0,0,10240,6,494766274
1464,71555690,108982,71664672,2,0,0,27136,4,3005633297
1465,71565040,63764,71628804,3,0,0,10240,9,3587972499
1466,71576400,100030,71676430,4,0,0,24064,6,2221171658
1467,71577750,165153,71742903,3,0,0,57344,9,9748885619
1468,71589630,135786,71725416,9,0,0,27648,10,243556159
1469,71621109,7710,71628819,3,0,1,7680,9,4490256994
1470,71622749,179414,71802163,0,0,0,30208,10,1791336796
1471,71712480,97554,71810034,5,0,0,16896,11,3269705098
1472,71741560,122264,71863824,2,0,0,15872,4,892145802
1473,71807990,73971,71881961,9,0,0,13312,10,6223096045
1474,71810290,67592,71877882,3,0,0,7680,9,7269905213
1475,71818300,129305,71947605,4,0,0,29184,6,3850339066
1476,71869350,114942,71984292,1,0,0,1536,14,3793391514
1477,71876769,61929,71938698,0,0,0,5632,10,10702241066
1478,71964580,79148,72043728,2,0,0,15360,4,5487064713
1479,71992990,170594,72163584,4,0,0,109056,6,6597848420
1480,72026830,60224,72087054,5,0,0,8704,11,827872537
1481,72080060,124750,72204810,6,0,0,16384,9,1032586207
1482,72253090,102284,72355374,2,0,0,35840,4,8944267896
1483,72361220,59132,72420352,9,0,0,5120,10,5510170862
1484,72365501,7230,72372731,6,0,1,7680,9,5925912107
1485,72373961,14287,72388248,5,0,1,27648,11,1491436627
1486,72457970,7230,72465200,7,0,1,7680,18,6876636881
1487,72474120,122821,72596941,2,0,0,17920,4,270633291
1488,72497270,2470,72499740,9,0,1,2560,10,4605306103
1489,72513230,78236,72591466,9,0,0,17408,10,1901649394
1490,72602820,97136,72699956,6,0,0,18944,9,2669950492
1491,72705110,66836,72771946,2,0,0,10240,4,6831693367
1492,72759770,113204,72872974,2,0,0,71680,4,2020572361
1493,72803150,93524,72896674,6,0,0,1024,9,5196050040
1494,72863591,12321,72875912,6,0,1,3072,9,9912420286
1495,72951610,57440,73009050,3,0,0,4608,9,579085703
1496,72952869,104624,73057493,0,0,0,43520,10,7806119311
1497,73074430,103688,73178118,1,0,0,40448,14,4938050889
1498,73097140,100100,73197240,7,0,0,28672,18,3977759959
1499,73185370,11885,73197255,1,0,1,5120,14,2220520724
1500,73251210,173083,73424293,9,0,0,27648,10,9769146453
1501,73275810,65300,73341110,5,0,0,10240,11,9782827381
1502,73416750,113875,73530625,5,0,0,49152,11,9158376553
1503,73587130,48980,73636110,7,0,0,2048,18,5015235863
1504,73601450,50672,73652122,2,0,0,2560,4,2103255976
1505,73650410,68684,73719094,7,0,0,11264,18,1215521305
1506,73687140,95936,73783076,5,0,0,25088,11,3400650220
1507,73704620,136326,73840946,2,0,0,42496,4,7306139582
1508,73760260,95492,73855752,2,0,0,28672,4,9480304159
1509,74082080,51296,74133376,9,0,0,4608,10,10637782678
1510,74159040,115856,74274896,2,0,0,80384,4,4967311570
1511,74166530,113841,74280371,9,0,0,17920,10,10706068050
1512,74166540,115562,74282102,3,0,0,5632,9,5075268106
1513,74277310,9158,74286468,7,0,1,4608,18,10674322444
1514,74286669,3645,74290314,3,0,1,10240,9,1607359039
1515,74292610,128212,74420822,2,0,0,28160,4,3036968009
1516,74318930,156373,74475303,8,0,0,15360,12,1639826166
1517,74412670,91900,74504570,5,0,0,15360,11,6824663927
1518,74481160,64208,74545368,6,0,0,6656,9,8465631010
1519,74529449,48980,74578429,0,0,0,2048,10,3624775595
1520,74650010,108368,74758378,9,0,0,55808,10,1786816366
1521,74657970,3645,74661615,4,0,1,10240,6,7951598575
1522,74680040,90440,74770480,8,0,0,8704,12,9063952751
1523,74712890,45659,74758549,4,0,0,512,6,1893689432
1524,74850310,72824,74923134,4,0,0,9728,6,6743483196
1525,74886600,88988,74975588,9,0,0,17408,10,3581376612
1526,74897270,3645,74900915,1,0,1,10240,14,1242501192
1527,74964420,11183,74975603,7,0,1,8192,18,8327757393
1528,75036730,67592,75104322,3,0,0,7680,9,1593512240
1529,75042500,71326,75113826,8,0,0,3584,12,2770273064
1530,75109861,6229,75116090,2,0,1,15360,4,4092970074
1531,75166511,1994,75168505,2,0,1,2048,4,8484169566
1532,75171530,165510,75337040,7,0,0,29184,18,9579193204
1533,75269240,11533,75280773,1,0,1,18944,14,10606867757
1534,75329900,120336,75450236,6,0,0,71680,9,9402561125
1535,75357920,50828,75408748,4,0,0,3072,6,539730495
1536,75428330,98072,75526402,6,0,0,22016,9,5687973268
1537,75468170,118922,75587092,6,0,0,18432,9,8304988065
1538,75485990,111626,75597616,1,0,0,23040,14,4949091776
1539,75640740,117728,75758468,3,0,0,86528,9,4816773
1540,75664670,98412,75763082,3,0,0,14848,9,9211920692
1541,75667070,128580,75795650,9,0,0,15872,10,861013722
1542,75731330,103626,75834956,9,0,0,37888,10,7492525448
1543,75733600,168646,75902246,9,0,0,66048,10,776111300
1544,75735789,27308,75763097,3,0,1,2048,9,9309076350
1545,75756220,152125,75908345,6,0,0,19968,9,5499999650
1546,75770660,155064,75925724,2,0,0,20992,4,875005173
1547,75796720,278374,76075094,2,0,0,192512,4,6317419908
1548,75980650,149872,76130522,5,0,0,74752,11,271843237
1549,76264970,67592,76332562,5,0,0,7680,11,1105838434
1550,76355669,47288,76402957,0,0,0,1536,10,4987926229
1551,76390770,108212,76498982,2,0,0,55296,4,8504868896
1552,76393650,123200,76516850,6,0,0,33280,9,5205874814
1553,76402510,136576,76539086,7,0,0,25600,18,3863083095
1554,76471290,101036,76572326,1,0,0,31744,14,3908157167
1555,76651850,103532,76755382,7,0,0,39936,18,8551251938
1556,76679109,6278,76685387,3,0,1,6656,9,3365366759
1557,76759810,67592,76827402,1,0,0,7680,14,10723672556
1558,76783010,119878,76902888,3,0,0,47616,9,3616006883
1559,76812199,98660,76910859,0,0,0,26112,10,9632211073
1560,76872830,101588,76974418,4,0,0,28672,6,2031338175
1561,76881320,55748,76937068,6,0,0,4096,9,8084170920
1562,76882720,141630,77024350,9,0,0,31232,10,5183912367
1563,76919180,7706,76926886,8,0,1,8192,12,8112942810
1564,76935159,59132,76994291,0,0,0,5120,10,5128105316
1565,76972060,87798,77059858,5,0,0,15872,11,8225104662
1566,76987660,113641,77101301,5,0,0,44544,11,9901890485
1567,76999500,166716,77166216,9,0,0,6656,10,890844268
1568,77014300,10065,77024365,4,0,1,10752,6,3785648731
1569,77018670,83738,77102408,5,0,0,3584,11,8862367833
1570,77025840,217305,77243145,5,0,0,61440,11,3112877920
1571,77073760,145955,77219715,5,0,0,33280,11,6546634447
1572,77081040,143370,77224410,6,0,0,15360,9,721259024
1573,77290820,69464,77360284,2,0,0,13824,4,26469681
1574,77385690,43904,77429594,5,0,0,512,11,9339766246
1575,77550449,61604,77612053,0,0,0,8192,10,728478587
1576,77644540,71000,77715540,8,0,0,13824,12,1448733936
1577,77686880,95104,77781984,5,0,0,17920,11,8507701069
1578,77735280,128022,77863302,9,0,0,56832,10,7920085572
1579,77765710,108371,77874081,7,0,0,35328,18,1347292888
1580,77863139,109474,77972613,0,0,0,23552,10,554281756
1581,77990831,7230,77998061,2,0,1,7680,4,8007880720
1582,78080560,115700,78196260,6,0,0,79872,9,6154644516
1583,78128230,13341,78141571,9,0,1,22528,10,3883631463
1584,78152370,86826,78239196,4,0,0,16896,6,2942443282
1585,78192670,151868,78344538,4,0,0,134656,6,9791113384
1586,78266700,7706,78274406,1,0,1,8192,14,8489073910
1587,78266910,99330,78366240,2,0,0,13824,4,9732441159
1588,78368950,98384,78467334,4,0,0,23040,6,10450487414
1589,78416020,1518,78417538,1,0,1,1536,14,3978668001
1590,78555749,84512,78640261,0,0,0,12800,10,7843911556
1591,78567290,75950,78643240,6,0,0,9728,9,4479597224
1592,78688860,47288,78736148,5,0,0,1536,11,2918241159
1593,78698220,100412,78798632,7,0,0,29696,18,9019820780
1594,78751671,6278,78757949,2,0,1,6656,4,2522171357
1595,78830010,66680,78896690,2,0,0,9728,4,852718811
1596,79039170,60824,79099994,4,0,0,5632,6,5689829548
1597,79062960,86204,79149164,1,0,0,13312,14,6282899299
1598,79077500,145776,79223276,4,0,0,95232,6,2719023882
1599,79080120,146447,79226567,9,0,0,10752,10,4117021835
1600,79092650,191190,79283840,2,0,0,24576,4,4153959240
1601,79112420,79226,79191646,4,0,0,3072,6,4109678525
1602,79287650,96980,79384630,2,0,0,18432,4,6288277177
1603,79301460,66992,79368452,8,0,0,10752,12,3827130449
1604,79522250,4162,79526412,8,0,1,11264,12,7926078187
1605,79558670,100256,79658926,4,0,0,29184,6,9977608748
1606,79631670,55748,79687418,7,0,0,4096,18,2166436000
1607,79952760,82820,80035580,1,0,0,12288,14,6226064672
1608,79983590,180858,80164448,1,0,0,29696,14,10121158566
1609,79999060,88618,80087678,6,0,0,10752,9,1032134694
1610,79999860,7706,80007566,8,0,1,8192,12,565049857
1611,80079701,11533,80091234,2,0,1,18944,4,3748806836
1612,80190700,119105,80309805,9,0,0,5632,10,6257673143
1613,80220310,87764,80308074,1,0,0,18432,14,5294071348
1614,80222210,109240,80331450,6,0,0,24576,9,1651948370
1615,80232650,140060,80372710,6,0,0,32768,9,2723400270
1616,80240900,7230,80248130,1,0,1,7680,14,74300743
1617,80282320,198438,80480758,4,0,0,32256,6,7408860734
1618,80317550,109304,80426854,5,0,0,58880,11,1961447541
1619,80448620,110336,80558956,9,0,0,60928,10,424959500
1620,80506890,143842,80650732,7,0,0,62464,18,3768406813
1621,80516930,96536,80613466,5,0,0,22016,11,7970456817
1622,80617600,106104,80723704,7,0,0,17408,18,3781570754
1623,80678790,4679,80683469,1,0,1,12288,14,8928784910
1624,80679450,63957,80743407,3,0,0,5632,9,2295010881
1625,80751829,5802,80757631,3,0,1,6144,9,7398924619
1626,80757500,43904,80801404,2,0,0,512,4,6020605163
1627,80806040,74852,80880892,7,0,0,16384,18,2726469677
1628,80808630,129310,80937940,6,0,0,62464,9,8963253283
1629,80828630,241620,81070250,7,0,0,97792,18,5287396917
1630,80880909,198404,81079313,0,0,0,29696,10,5987860550
1631,80937890,147226,81085116,9,0,0,18944,10,3754843419
1632,80999010,133138,81132148,2,0,0,37888,4,1497642815
1633,81056710,174858,81231568,7,0,0,64512,18,8625884676
1634,81058350,120924,81179274,4,0,0,28160,6,7451951282
1635,81120950,191000,81311950,2,0,0,100352,4,6021160262
1636,81143920,106662,81250582,6,0,0,2048,9,8034173087
1637,81225530,111550,81337080,2,0,0,18432,4,1185701816
1638,81230740,85281,81316021,2,0,0,13312,4,2000827304
1639,81249890,67706,81317596,6,0,0,5120,9,4834146071
1640,81264289,171431,81435720,0,0,0,42496,10,7280609229
1641,81367309,109022,81476331,0,0,0,9728,10,8210952622
1642,81373720,99632,81473352,2,0,0,27136,4,9590508635
1643,81378500,143512,81522012,2,0,0,20992,4,1651046203
1644,81379091,2946,81382037,6,0,1,3072,9,9181555063
1645,81379660,123320,81502980,4,0,0,23552,6,4973276277
1646,81411521,566,81412087,2,0,1,512,4,8640334613
1647,81444460,88108,81532568,4,0,0,16896,6,2106590889
1648,81449560,177427,81626987,7,0,0,14848,18,3317905867
1649,81454690,115352,81570042,9,0,0,35840,10,8433770578
1650,81573620,147009,81720629,3,0,0,94208,9,7673787806
1651,81614160,6754,81620914,8,0,1,7168,12,8654733864
1652,81740439,88076,81828515,0,0,0,19456,10,273952326
1653,81768230,120219,81888449,1,0,0,18432,14,3701810182
1654,81851620,59132,81910752,6,0,0,5120,9,1991532459
1655,81916130,3898,81920028,8,0,1,4096,12,1987864755
1656,81942240,191951,82134191,7,0,0,41984,18,4685869681
1657,81986020,1042,81987062,9,0,1,1024,10,3385048499
1658,82091610,101039,82192649,7,0,0,20992,18,243269283
1659,82175160,66524,82241684,3,0,0,9216,9,5292420560
1660,82209270,113048,82322318,3,0,0,71168,9,895079627
1661,82224640,189317,82413957,4,0,0,124928,6,6052197226
1662,82269169,59132,82328301,0,0,0,5120,10,4123543689
1663,82325030,131862,82456892,9,0,0,15360,10,7804793904
1664,82332970,191021,82523991,7,0,0,49152,18,3060306157
1665,82351580,66552,82418132,1,0,0,4096,14,1220188207
1666,82384079,91827,82475906,0,0,0,1024,10,6614463040
1667,82395430,201299,82596729,5,0,0,59904,11,3695890689
1668,82437591,2470,82440061,5,0,1,2560,11,6601087344
1669,82493009,65900,82558909,0,0,0,7168,10,7825865117
1670,82509260,150967,82660227,2,0,0,65536,4,5800827065
1671,82638760,71780,82710540,9,0,0,16384,10,5475712142
1672,82701590,98384,82799974,6,0,0,23040,9,1877897432
1673,82785730,59132,82844862,9,0,0,5120,10,10320171297
1674,82828570,67616,82896186,6,0,0,12800,9,3048706705
1675,82834740,92240,82926980,5,0,0,23040,11,4248783106
1676,82954489,97579,83052068,0,0,0,29696,10,1696318244
1677,82957800,102395,83060195,5,0,0,26624,11,8388749270
1678,82986210,4850,82991060,8,0,1,5120,12,9551017174
1679,83036550,77456,83114006,6,0,0,14848,9,4601688330
1680,83088890,91904,83180794,4,0,0,16896,6,1340388636
1681,83225490,65900,83291390,5,0,0,7168,11,5978499276
1682,83278320,14804,83293124,7,0,1,28672,18,4288714257
1683,83307089,111144,83418233,0,0,0,58880,10,2009278267
1684,83319090,126893,83445983,2,0,0,7680,4,3704773220
1685,83380181,4374,83384555,5,0,1,4608,11,9179371465
1686,83415429,102896,83518325,0,0,0,28672,10,4587606579
1687,83499670,59756,83559426,9,0,0,7168,10,8723079250
1688,83616210,43904,83660114,2,0,0,512,4,731466851
1689,83618200,108524,83726724,1,0,0,56320,14,4352684812
1690,83665060,4850,83669910,7,0,1,5120,18,359158552
1691,83719200,75108,83794308,7,0,0,7680,18,3589497823
1692,83728430,203217,83931647,1,0,0,58368,14,1312333268
1693,83732460,85136,83817596,7,0,0,14848,18,3302038406
1694,83940580,80234,84020814,1,0,0,8192,14,2051986003
1695,83954390,3904,83958294,1,0,1,10752,14,992663283
1696,84072910,112268,84185178,1,0,0,68608,14,8258075047
1697,84145461,1042,84146503,2,0,1,1024,4,3009167122
1698,84220370,45596,84265966,3,0,0,1024,9,5875167151
1699,84225220,172310,84397530,3,0,0,58368,9,9515461274
1700,84239230,138050,84377280,9,0,0,37888,10,5340129723
1701,84551820,48980,84600800,3,0,0,2048,9,7679967658
1702,84591540,55748,84647288,4,0,0,4096,6,7710692553
1703,84597840,101504,84699344,7,0,0,33280,18,2503067911
1704,84697041,6193,84703234,2,0,1,4096,4,5877532591
1705,84747520,12049,84759569,8,0,1,19968,12,8910492844
1706,84776440,217173,84993613,6,0,0,42496,9,5541076660
1707,84832550,106652,84939202,7,0,0,50176,18,4916388089
1708,84858769,88683,84947452,0,0,0,512,10,3434308720
1709,84922550,16667,84939217,0,0,1,2560,10,80769289
1710,84965300,64445,85029745,5,0,0,2560,11,2207794430
1711,84980210,13418,84993628,7,0,1,5632,18,8680281873
1712,85088610,3128,85091738,4,0,1,9216,6,1343714800
1713,85112870,284160,85397030,1,0,0,15360,14,3089191655
1714,85164869,108992,85273861,0,0,0,57856,10,8057179316
1715,85179770,135599,85315369,3,0,0,32768,9,7521027559
1716,85198420,3422,85201842,1,0,1,3584,14,6116382252
1717,85203050,3387,85206437,4,0,1,9728,6,7038726089
1718,85216160,70976,85287136,3,0,0,8704,9,9897321314
1719,85251951,21925,85273876,2,0,1,13312,4,10160642789
1720,85253910,19981,85273891,4,0,1,28672,6,9495069904
1721,85255720,100390,85356110,5,0,0,2048,11,4022295006
1722,85339119,87920,85427039,0,0,0,18944,10,259726214
1723,85357890,193691,85551581,5,0,0,38400,11,7187297911
1724,85366080,138065,85504145,7,0,0,44032,18,3149654887
1725,85392600,95517,85488117,1,0,0,18944,14,10611668780
1726,85405731,6278,85412009,2,0,1,6656,4,1920479935
1727,85421090,5964,85427054,4,0,1,12288,6,6012158008
1728,85468770,225676,85694446,1,0,0,79872,14,6736370101
1729,85516650,217567,85734217,6,0,0,42496,9,8494727206
1730,85566900,197618,85764518,4,0,0,39936,6,7597060116
1731,85574550,137284,85711834,5,0,0,20992,11,4457118175
1732,85700530,86446,85786976,5,0,0,6656,11,7257907256
1733,85731430,85179,85816609,6,0,0,20992,9,10435874277
1734,85739311,1042,85740353,2,0,1,1024,4,2967517933
1735,85995770,54056,86049826,7,0,0,3584,18,5720544871
1736,86013330,92396,86105726,7,0,0,23552,18,7317315649
1737,86034670,75751,86110421,9,0,0,15360,10,2501935121
1738,86086590,109460,86196050,7,0,0,59392,18,6093062765
1739,86131020,67393,86198413,3,0,0,7680,9,3582592053
1740,86177250,140743,86317993,2,0,0,47104,4,4502116588
1741,86179530,22740,86202270,4,0,1,4096,6,6813090049
1742,86250589,2946,86253535,3,0,1,3072,9,9425734442
1743,86378799,98228,86477027,0,0,0,22528,10,2465309436
1744,86382451,7230,86389681,5,0,1,7680,11,4457642619
1745,86509941,1518,86511459,6,0,1,1536,9,9554085420
1746,86579310,6754,86586064,9,0,1,7168,10,6094474149
1747,86656640,116792,86773432,5,0,0,83456,11,3764465742
1748,86705460,192700,86898160,2,0,0,36864,4,1123905544
1749,86706459,112465,86818924,0,0,0,8704,10,3465913570
1750,86718490,127710,86846200,2,0,0,27648,4,9724404485
1751,86776870,78168,86855038,1,0,0,5120,14,8834303588
1752,86890330,114162,87004492,6,0,0,49152,9,5364724241
1753,87007739,103844,87111583,0,0,0,40960,10,6972560378
1754,87024480,3422,87027902,4,0,1,3584,6,1161881263
1755,87046210,67884,87114094,9,0,0,8192,10,5945434775
1756,87088190,78161,87166351,3,0,0,11776,9,2076873201
1757,87228420,60824,87289244,6,0,0,5632,9,2046572417
1758,87249710,102908,87352618,3,0,0,37888,9,3121811986
1759,87276240,163786,87440026,2,0,0,25088,4,10020000025
1760,87308991,6488,87315479,6,0,1,15872,9,564758946
1761,87345290,124166,87469456,3,0,0,4608,9,3160144429
1762,87534850,1994,87536844,4,0,1,2048,6,9336675900
1763,87573190,173649,87746839,2,0,0,59392,4,10670997310
1764,87586890,81620,87668510,3,0,0,18432,9,1378549802
1765,87751870,104578,87856448,1,0,0,40448,14,1612126351
1766,87773070,86357,87859427,6,0,0,9728,9,8544249603
1767,87952700,52078,88004778,5,0,0,2048,11,2688091773
1768,87958870,79436,88038306,1,0,0,11264,14,10468901759
1769,88032330,48980,88081310,7,0,0,2048,18,8319158948
1770,88056751,6278,88063029,2,0,1,6656,4,4772735894
1771,88245120,62516,88307636,7,0,0,6144,18,9286308583
1772,88258090,74852,88332942,4,0,0,16384,6,574483246
1773,88293779,107432,88401211,0,0,0,52736,10,8638976881
1774,88318300,89493,88407793,2,0,0,7680,4,9454608856
1775,88418890,102908,88521798,9,0,0,37888,10,8246560998
1776,88433100,114384,88547484,1,0,0,5120,14,4170711823
1777,88609570,5802,88615372,7,0,1,6144,18,2119711122
1778,88624410,100724,88725134,9,0,0,30720,10,317292943
1779,88738730,80060,88818790,4,0,0,13312,6,2546993577
1780,88750440,1994,88752434,9,0,1,2048,10,8025945503
1781,88769610,133594,88903204,2,0,0,57344,4,9824549762
1782,88815530,8189,88823719,1,0,1,12800,14,6054086685
1783,88913060,45596,88958656,6,0,0,1024,9,5474213099
1784,88945460,118040,89063500,4,0,0,87552,6,3469750920
1785,89012001,12049,89024050,5,0,1,19968,11,2605743817
1786,89062330,109218,89171548,1,0,0,54784,14,6014225358
1787,89104590,190437,89295027,1,0,0,30720,14,2969912002
1788,89116400,213985,89330385,2,0,0,77312,4,3751417167
1789,89220020,202585,89422605,5,0,0,75264,11,10720101694
1790,89226950,128563,89355513,5,0,0,16384,11,5763776346
1791,89301780,28620,89330400,1,0,1,14848,14,8272790536
1792,89397739,107282,89505021,0,0,0,46080,10,5367162054
1793,89437069,70394,89507463,0,0,0,2560,10,6512798655
1794,89586760,45596,89632356,9,0,0,1024,10,4919226223
1795,89742620,107900,89850520,2,0,0,54272,4,4867268977
1796,89749050,112873,89861923,2,0,0,37376,4,4910167849
1797,89891460,106184,89997644,9,0,0,48640,10,4353737155
1798,89997470,85614,90083084,5,0,0,15872,11,4649241637
1799,90042160,105404,90147564,2,0,0,46080,4,6295419318
1800,90070150,142352,90212502,6,0,0,31232,9,8409436878
1801,90070800,87944,90158744,7,0,0,24064,18,10264351269
1802,90101250,47288,90148538,1,0,0,1536,14,9618378086
1803,90141781,8903,90150684,6,0,1,9216,9,3315176162
1804,90158350,86590,90244940,5,0,0,13312,11,6113148479
1805,90221700,95492,90317192,6,0,0,11264,9,2923975243
1806,90240540,56036,90296576,6,0,0,4096,9,9904013586
1807,90411730,90104,90501834,7,0,0,26112,18,3499280038
1808,90427419,103220,90530639,0,0,0,38912,10,7684145757
1809,90468110,181474,90649584,7,0,0,146944,18,7127250361
1810,90861570,16354,90877924,4,0,1,31744,6,9632907531
1811,90900200,66159,90966359,9,0,0,1024,10,8525974580
1812,90970220,3128,90973348,4,0,1,9216,6,5677287014
1813,90979310,85499,91064809,6,0,0,10240,9,2578121331
1814,91133140,3904,91137044,7,0,1,10752,18,8450862414
1815,91159951,1042,91160993,2,0,1,1024,4,1323668814
1816,91191169,104468,91295637,0,0,0,43008,10,8810268775
1817,91199610,148749,91348359,1,0,0,43520,14,3814200618
1818,91249960,136853,91386813,6,0,0,47616,9,10351605402
1819,91284990,130179,91415169,6,0,0,34816,9,7011750736
1820,91416750,1518,91418268,4,0,1,1536,6,9630142219
1821,91515839,55283,91571122,0,0,0,2560,10,2440095885
1822,91520450,100256,91620706,3,0,0,29184,9,1528563123
1823,91614550,73140,91687690,6,0,0,10752,9,5239132816
1824,91666530,48980,91715510,3,0,0,2048,9,10385508292
1825,91719470,45596,91765066,2,0,0,1024,4,1716413320
1826,91877531,4162,91881693,2,0,1,11264,4,9904351760
1827,91918670,108368,92027038,2,0,0,55808,4,5928369496
1828,91952270,115922,92068192,5,0,0,13312,11,5682818025
1829,91967781,13253,91981034,6,0,1,25600,9,1352780633
1830,91976221,11016,91987237,6,0,1,17920,9,6707422680
1831,91992310,205009,92197319,6,0,0,26112,9,7796823683
1832,92002480,43904,92046384,7,0,0,512,18,10479185448
1833,92026810,6022,92032832,8,0,1,6144,12,10359781868
1834,92134990,77779,92212769,4,0,0,5120,6,2962413430
1835,92152590,90236,92242826,3,0,0,21504,9,3056366832
1836,92288000,102908,92390908,6,0,0,37888,9,6477665411
1837,92350949,98072,92449021,0,0,0,22016,10,9693066485
1838,92370200,5971,92376171,8,0,1,14848,12,2876715705
1839,92380060,77517,92457577,2,0,0,6144,4,2427212765
1840,92383320,66808,92450128,2,0,0,3584,4,437613927
1841,92443881,10401,92454282,5,0,1,11264,11,954730739
1842,92458410,94376,92552786,8,0,0,19968,12,4396606496
1843,92534550,70976,92605526,5,0,0,8704,11,6858699721
1844,92686769,62384,92749153,0,0,0,10752,10,4098731156
1845,92693930,118457,92812387,4,0,0,25600,6,6558273893
1846,92741920,99788,92841708,5,0,0,27648,11,6175104912
1847,92767820,60824,92828644,7,0,0,5632,18,5718324495
1848,92774950,102128,92877078,4,0,0,35328,6,8521561034
1849,92811620,78503,92890123,9,0,0,10752,10,6854114368
1850,92861560,108056,92969616,5,0,0,54784,11,8111043027
1851,92956100,74956,93031056,7,0,0,7680,18,2730208276
1852,92981250,62516,93043766,7,0,0,6144,18,10225355112
1853,92997500,113782,93111282,5,0,0,43008,11,4536236747
1854,93016329,102201,93118530,0,0,0,16384,10,6156408083
1855,93110820,66822,93177642,5,0,0,8704,11,7665932207
1856,93282600,103064,93385664,7,0,0,38400,18,5992816124
1857,93353011,3645,93356656,2,0,1,10240,4,7637877232
1858,93589080,100880,93689960,9,0,0,31232,10,6987020693
1859,93638299,157382,93795681,0,0,0,47104,10,2153768599
1860,93646921,2946,93649867,6,0,1,3072,9,9340916653
1861,93647629,47565,93695194,0,0,0,1536,10,5662404895
1862,93667830,32816,93700646,4,0,1,53760,6,3482228768
1863,93765650,47288,93812938,7,0,0,1536,18,4011345539
1864,93802421,3422,93805843,2,0,1,3584,4,6892753801
1865,93825740,73760,93899500,3,0,0,12800,9,6947617483
1866,93896220,9550,93905770,1,0,1,6656,14,1532377333
1867,94083870,90104,94173974,4,0,0,26112,6,1150028103
1868,94091190,58430,94149620,2,0,0,512,4,432799928
1869,94113220,1518,94114738,7,0,1,1536,18,5856467736
1870,94220250,1042,94221292,4,0,1,1024,6,2005772055
1871,94305870,112112,94417982,4,0,0,68096,6,3934301272
1872,94308070,111331,94419401,1,0,0,4608,14,1852155356
1873,94419000,123113,94542113,2,0,0,102912,4,9733434350
1874,94485270,103997,94589267,2,0,0,29696,4,8188335949
1875,94505420,103977,94609397,4,0,0,24064,6,4561136028
1876,94529030,200199,94729229,4,0,0,47104,6,8947946511
1877,94548000,122585,94670585,6,0,0,68608,9,156900360
1878,94555410,92189,94647599,3,0,0,7168,9,5299070627
1879,94881790,566,94882356,1,0,1,512,14,4058014185
1880,94921410,111644,95033054,9,0,0,66560,10,4790075179
1881,94986349,139105,95125454,0,0,0,70144,10,10569515343
1882,95032409,105072,95137481,0,0,0,39424,10,7663442652
1883,95065950,146288,95212238,2,0,0,55296,4,5466210565
1884,95206370,98568,95304938,9,0,0,24576,10,2780202539
1885,95272540,47600,95320140,7,0,0,2560,18,5139159291
1886,95333770,54056,95387826,6,0,0,3584,9,8054413396
1887,95493300,1994,95495294,1,0,1,2048,14,9971280230
1888,95564740,79928,95644668,9,0,0,17920,10,4840962665
1889,95670060,106964,95777024,2,0,0,51200,4,4428164404
1890,95674391,2946,95677337,5,0,1,3072,11,2907595690
1891,95683680,161822,95845502,5,0,0,103424,11,2308267140
1892,95748810,147122,95895932,3,0,0,40960,9,5348068204
1893,95816070,126584,95942654,1,0,0,24064,14,8270149420
1894,95926700,50672,95977372,3,0,0,2560,9,8300918215
1895,95988670,76076,96064746,9,0,0,15360,10,5190937779
1896,95997680,102752,96100432,7,0,0,37376,18,723502035
1897,96302190,113360,96415550,7,0,0,72192,18,3000629664
1898,96407070,62528,96469598,6,0,0,3584,9,5420112400
1899,96522911,1042,96523953,5,0,1,1024,11,9597885250
1900,96574960,64232,96639192,2,0,0,11776,4,667856308
1901,96623910,97604,96721514,6,0,0,20480,9,9906470456
1902,96625290,106770,96732060,9,0,0,16896,10,10281337883
1903,96665110,101348,96766458,9,0,0,32768,10,7331374007
1904,96828410,57440,96885850,8,0,0,4608,12,7562464414
1905,96984380,94532,97078912,5,0,0,20480,11,3052732289
1906,97026041,7230,97033271,5,0,1,7680,11,5124970418
1907,97032001,3128,97035129,5,0,1,9216,11,1876370797
1908,97109110,2470,97111580,1,0,1,2560,14,855816539
1909,97161700,102908,97264608,2,0,0,37888,4,746406726
1910,97280830,67592,97348422,8,0,0,7680,12,1453798798
1911,97293300,36346,97329646,4,0,1,64000,6,5674150131
1912,97305509,73848,97379357,0,0,0,3072,10,1732354526
1913,97320759,114763,97435522,0,0,0,15872,10,9193286926
1914,97405100,132079,97537179,6,0,0,10240,9,4782520843
1915,97454350,101192,97555542,8,0,0,32256,12,4680718525
1916,97546690,81824,97628514,4,0,0,10240,6,5181762844
1917,97575450,69284,97644734,8,0,0,8192,12,5007555339
1918,97594489,98384,97692873,0,0,0,23040,10,1277682107
1919,97609280,137281,97746561,4,0,0,25600,6,9591425947
1920,97616640,66819,97683459,8,0,0,6144,12,5797713300
1921,97754840,97760,97852600,7,0,0,20992,18,10270765174
1922,97872630,88544,97961174,3,0,0,20992,9,7716093294
1923,97897550,100626,97998176,4,0,0,10240,6,8554259343
1924,98043890,62828,98106718,9,0,0,7168,10,4255243602
1925,98111590,116324,98227914,8,0,0,81920,12,6091269307
1926,98150200,80144,98230344,2,0,0,3072,4,1900194876
1927,98215530,114816,98330346,4,0,0,36352,6,154074309
1928,98245480,47288,98292768,1,0,0,1536,14,4033507658
1929,98247880,86069,98333949,2,0,0,11776,4,3951388033
1930,98285280,76052,98361332,4,0,0,10240,6,1257574211
1931,98295280,2946,98298226,1,0,1,3072,14,1124393780
1932,98333680,6063,98339743,8,0,1,6144,12,6702643685
1933,98378080,45596,98423676,2,0,0,1024,4,1880323360
1934,98433050,13600,98446650,1,0,1,23040,14,1820647597
1935,98446680,110374,98557054,5,0,0,36352,11,5299089623
1936,98453110,76089,98529199,7,0,0,1536,18,10131432330
1937,98577760,91280,98669040,1,0,0,14848,14,2059916002
1938,98629530,70524,98700054,8,0,0,4608,12,5269486059
1939,98674700,98852,98773552,6,0,0,24576,9,2149618707
1940,98693800,1518,98695318,1,0,1,1536,14,2105348220
1941,98715000,101816,98816816,5,0,0,34304,11,3777390003
1942,98820450,48980,98869430,6,0,0,2048,9,1988493379
1943,98824680,65900,98890580,4,0,0,7168,6,4695107343
1944,98900050,108524,99008574,5,0,0,56320,11,3646754700
1945,98987369,110240,99097609,0,0,0,61952,10,5454448315
1946,98988480,20109,99008589,8,0,1,5632,12,346860532
1947,98993860,163539,99157399,1,0,0,30208,14,255679968
1948,99065221,3128,99068349,5,0,1,9216,11,570882851
1949,99116530,112449,99228979,1,0,0,15872,14,3887249284
1950,99277430,99632,99377062,8,0,0,27136,12,4579858478
1951,99283920,77300,99361220,3,0,0,14336,9,10291146227
1952,99362600,102908,99465508,2,0,0,37888,4,1678512009
1953,99492320,101036,99593356,2,0,0,31744,4,1019502645
1954,99495960,187918,99683878,7,0,0,100864,18,3041448099
1955,99532360,160737,99693097,5,0,0,30208,11,9055390423
1956,99574580,158636,99733216,8,0,0,34816,12,10733561131
1957,99685610,51383,99736993,4,0,0,512,6,754870182
1958,99726840,161201,99888041,4,0,1,251392,6,4865771943
1959,99742350,245742,99988092,2,0,0,19968,4,3567497021
1960,99788050,239612,100027662,8,0,0,32768,12,9432730962
1961,99861560,216562,100078122,3,0,0,8192,9,9042326464
1962,99868100,249831,100117931,7,0,0,17920,18,9449979092
1963,99879280,100402,99979682,4,0,0,13312,6,7357279725
1964,99892340,218140,100110480,2,0,0,22528,4,6799768280
1965,99892730,268780,100161510,8,0,0,22528,12,9652289827
1966,100005360,196229,100201589,6,0,0,64512,9,6394754476
1967,100040090,92494,100132584,1,0,0,19456,14,2688220240
1968,100091620,183643,100275263,3,0,0,78336,9,9675970983
1969,100116630,86222,100202852,5,0,0,4096,11,9575846248
1970,100152260,125046,100277306,1,0,0,6656,14,9747977254
1971,100398070,51140,100449210,7,0,0,4096,18,10559458872
1972,100411120,68216,100479336,3,0,0,9728,9,2384499771
1973,100563670,7706,100571376,1,0,1,8192,14,5107198853
1974,100645400,3898,100649298,7,0,1,4096,18,8436936049
1975,100741870,47288,100789158,7,0,0,1536,18,8564139348
1976,100764590,88558,100853148,1,0,0,13824,14,6832837443
1977,100827070,108212,100935282,4,0,0,55296,6,520070488
1978,100891729,111935,101003664,0,0,0,28160,10,8594131760
1979,100903720,63764,100967484,3,0,0,3584,9,10048339304
1980,100939150,125384,101064534,8,0,0,30208,12,3577281861
1981,100956980,50672,101007652,7,0,0,2560,18,8420941013
1982,101189050,43904,101232954,9,0,0,512,10,6253126885
1983,101222870,87008,101309878,3,0,0,20992,9,7470365485
1984,101230250,103556,101333806,5,0,0,13824,11,9881624859
1985,101284161,13600,101297761,5,0,1,23040,11,9850350339
1986,101325190,59756,101384946,9,0,0,7168,10,10323423671
1987,101377470,104624,101482094,3,0,0,43520,9,7837979898
1988,101431400,87896,101519296,2,0,0,13824,4,3037333348
1989,101435440,118054,101553494,2,0,0,23552,4,6339636966
1990,101562920,101192,101664112,7,0,0,32256,18,7609319152
1991,101582650,112320,101694970,4,0,0,21504,6,5585126952
1992,101632500,50896,101683396,9,0,0,2560,10,5588783973
1993,101669050,6278,101675328,9,0,1,6656,10,7321791125
1994,101674991,12308,101687299,5,0,1,20480,11,4058337668
1995,101693330,65396,101758726,6,0,0,10240,9,3606387443
1996,101789690,3387,101793077,8,0,1,9728,12,708396287
1997,101843200,162949,102006149,2,0,0,14848,4,5022433986
1998,101847600,45596,101893196,1,0,0,1024,14,7379404512
1999,101923880,47288,101971168,1,0,0,1536,14,3196277551
2000,102025990,109148,102135138,8,0,0,58368,12,4574546177
2001,102045150,117412,102162562,7,0,0,25088,18,1537349098
2002,102047000,225605,102272605,1,0,0,61440,14,5506398390
2003,102064460,143904,102208364,6,0,0,17920,9,2797380548
2004,102147430,106440,102253870,5,0,0,25088,11,7670827379
2005,102222080,51016,102273096,6,0,0,1536,9,603697533
2006,102245310,72668,102317978,6,0,0,9216,9,6195290593
2007,102264440,106422,102370862,7,0,0,4096,18,5657928948
2008,102297721,3387,102301108,5,0,1,9728,11,1486306640
2009,102312950,48980,102361930,1,0,0,2048,14,6156274025
2010,102336260,43904,102380164,5,0,0,512,11,1448898234
2011,102355660,57440,102413100,2,0,0,4608,4,528010666
2012,102408010,108680,102516690,5,0,0,56832,11,1728324565
2013,102452811,3898,102456709,2,0,1,4096,4,3912299350
2014,102593530,105092,102698622,7,0,0,45056,18,5501373904
2015,102638400,15837,102654237,4,0,1,30720,6,7748726199
2016,102850940,71468,102922408,8,0,0,15360,12,3944161393
2017,102890850,103844,102994694,3,0,0,40960,9,10275726761
2018,102906060,101846,103007906,3,0,0,8704,9,10444467426
2019,102921330,126902,103048232,8,0,0,18944,12,6699137572
2020,102928539,71444,102999983,0,0,0,10240,10,1653207901
2021,102941300,124836,103066136,3,0,0,37376,9,6164754585
2022,102970520,119766,103090286,5,0,0,4608,11,3507896524
2023,102973110,95381,103068491,1,0,0,7680,14,6861677972
2024,102976830,59288,103036118,4,0,0,5632,6,2809983093
2025,103062840,17951,103080791,7,0,1,20480,18,7381719950
2026,103083020,88676,103171696,8,0,0,16384,12,5640760825
2027,103107890,190717,103298607,9,0,0,26624,10,4109031006
2028,103175749,111956,103287705,0,0,0,67584,10,3149181585
2029,103195890,135369,103331259,4,0,0,12800,6,4686493703
2030,103226140,130146,103356286,7,0,0,53248,18,2603855890
2031,103228730,71920,103300650,3,0,0,6656,9,9273748525
2032,103247481,3422,103250903,5,0,1,3584,11,2726829837
2033,103258560,106956,103365516,6,0,0,4096,9,8586044125
2034,103308050,74360,103382410,8,0,0,9728,12,5306908811
2035,103334760,74598,103409358,7,0,0,10752,18,8329624814
2036,103461320,94664,103555984,6,0,0,15872,9,10198341820
2037,103555440,61360,103616800,6,0,0,5632,9,1021018955
2038,103570650,48980,103619630,4,0,0,2048,6,2358418420
2039,103653290,111956,103765246,2,0,0,67584,4,3640016100
2040,103664290,163836,103828126,7,0,0,112640,18,2922967046
2041,103690210,254252,103944462,8,0,0,41472,12,423234692
2042,103730040,121708,103851748,7,0,0,32768,18,5373183564
2043,103744240,119223,103863463,8,0,0,38400,12,1219341259
2044,103755220,176336,103931556,7,0,0,49664,18,829805475
2045,103795670,198568,103994238,6,0,0,43520,9,4931998630
2046,103867950,131295,103999245,7,0,0,16384,18,8060774969
2047,103874810,198422,104073232,3,0,0,34304,9,626845248
2048,103879070,162785,104041855,9,0,0,4608,10,6481591208
2049,103880031,1994,103882025,2,0,1,2048,4,10166484915
2050,103945300,242332,104187632,7,0,0,7168,18,1284192923
2051,103977910,96117,104074027,6,0,0,2560,9,1263875162
2052,104059950,115544,104175494,2,0,0,79360,4,685557095
2053,104103510,105188,104208698,5,0,0,4608,11,6395643458
2054,104106850,120928,104227778,4,0,0,11776,6,7677492882
2055,104246590,48980,104295570,3,0,0,2048,9,9501698684
2056,104352570,86564,104439134,3,0,0,24576,9,2647312583
2057,104382909,3645,104386554,3,0,1,10240,9,9827480884
2058,104400429,85529,104485958,0,0,0,11776,10,6491501887
2059,104418690,88520,104507210,3,0,0,15872,9,8264984440
2060,104452310,67460,104519770,8,0,0,12288,12,4125508080
2061,104517570,69784,104587354,7,0,0,7680,18,7917832590
2062,104581610,103916,104685526,8,0,0,30208,12,2687400724
2063,104584480,217562,104802042,4,0,1,356864,6,6758153346
2064,104598560,360101,104958661,6,0,0,77824,9,2819750333
2065,104615670,212191,104827861,4,0,1,90624,6,9326560041
2066,104648911,179514,104828425,2,0,1,10752,4,3700604761
2067,104682120,278059,104960179,8,0,0,1024,12,1068075292
2068,104718550,301867,105020417,4,0,0,12800,6,3777607338
2069,104913750,116656,105030406,9,0,0,6144,10,5589771202
2070,104940900,115210,105056110,6,0,0,2560,9,8386341231
2071,104949660,172000,105121660,6,0,0,15872,9,1357371366
2072,104987790,3898,104991688,1,0,1,4096,14,10330943024
2073,105039109,59912,105099021,0,0,0,7680,10,1505887798
2074,105099790,49136,105148926,1,0,0,2560,14,9445990264
2075,105133220,62516,105195736,1,0,0,6144,14,5820543305
2076,105147870,80956,105228826,4,0,0,12800,6,8892185386
2077,105271560,114452,105386012,3,0,0,75776,9,5250206481
2078,105371899,110665,105482564,0,0,0,27136,10,7523678470
2079,105415820,97448,105513268,8,0,0,19968,12,9062863739
2080,105459730,47288,105507018,7,0,0,1536,18,269390949
2081,105505380,7903,105513283,1,0,1,5120,14,7261341409
2082,105513780,62828,105576608,4,0,0,7168,6,6139015121
2083,105530220,120224,105650444,6,0,0,94720,9,138620139
2084,105579160,1994,105581154,8,0,1,2048,12,874866463
2085,105659580,103844,105763424,1,0,0,40960,14,4718429653
2086,105818431,1042,105819473,2,0,1,1024,4,6541911552
2087,105824320,48980,105873300,2,0,0,2048,4,6407384404
2088,105827450,96068,105923518,9,0,0,20480,10,1445991073
2089,105881630,94400,105976030,1,0,0,25088,14,8319987272
2090,105946850,3898,105950748,4,0,1,4096,6,7954483994
2091,106056910,4374,106061284,7,0,1,4608,18,7109006544
2092,106082920,69464,106152384,9,0,0,13824,10,2246032563
2093,106104840,1042,106105882,7,0,1,1024,18,7497460111
2094,106190920,82820,106273740,2,0,0,12288,4,9956272993
2095,106193950,83393,106277343,3,0,0,11776,9,8382917636
2096,106235050,117652,106352702,9,0,0,23552,10,9498176084
2097,106265151,3128,106268279,2,0,1,9216,4,110990674
2098,106336150,100724,106436874,9,0,0,30720,10,1272569463
2099,106340321,13083,106353404,6,0,1,22016,9,3709015950
2100,106351250,106768,106458018,7,0,0,19456,18,2065156758
2101,106353221,6229,106359450,5,0,1,15360,11,8248205542
2102,106356380,116930,106473310,1,0,0,37376,14,2265474292
2103,106377530,366232,106743762,8,0,0,178688,12,5704188773
2104,106398930,206722,106605652,2,0,0,82432,4,9415681918
2105,106407310,122978,106530288,8,0,0,28672,12,1209410184
2106,106476870,293167,106770037,6,0,0,30720,9,2595626341
2107,106553451,6488,106559939,5,0,1,15872,11,2276354586
2108,106685470,191893,106877363,7,0,0,13312,18,3456007364
2109,106936510,48980,106985490,4,0,0,2048,6,214345231
2110,106964390,59912,107024302,1,0,0,7680,14,6835938840
2111,107147770,91436,107239206,9,0,0,15360,10,8605298779
2112,107177550,64323,107241873,6,0,0,8704,9,715054549
2113,107269101,5802,107274903,2,0,1,6144,4,3253092974
2114,107386820,67148,107453968,6,0,0,11264,9,3831942679
2115,107440530,65900,107506430,2,0,0,7168,4,1481090537
2116,107496200,97573,107593773,7,0,0,6144,18,10514426925
2117,107510590,4679,107515269,1,0,1,12288,14,2243179813
2118,107560980,111423,107672403,8,0,0,61440,12,5966069795
2119,107562540,203123,107765663,8,0,0,37888,12,5859547637
2120,107568510,120711,107689221,5,0,0,4608,11,7408694560
2121,107589650,102552,107692202,4,0,0,8704,6,4997119120
2122,107596420,157684,107754104,4,0,0,34304,6,6366485047
2123,107621180,158778,107779958,7,0,0,19456,18,8170763577
2124,107692350,166136,107858486,8,0,0,12800,12,7786254077
2125,107829910,3128,107833038,9,0,1,9216,10,5350684143
2126,107889580,56372,107945952,9,0,0,6144,10,1435527000
2127,108074450,79436,108153886,8,0,0,11264,12,8940309378
2128,108163910,60824,108224734,2,0,0,5632,4,5943532387
2129,108251000,67592,108318592,2,0,0,7680,4,1794341035
2130,108266570,101816,108368386,2,0,0,34304,4,3063514734
2131,108307840,4374,108312214,7,0,1,4608,18,2965638740
2132,108439770,43904,108483674,9,0,0,512,10,9356903906
2133,108497010,1042,108498052,7,0,1,1024,18,4598009100
2134,108618970,566,108619536,8,0,1,512,12,6557100503
2135,108713770,45596,108759366,7,0,0,1024,18,10071051695
2136,108749670,79148,108828818,2,0,0,15360,4,2699851434
2137,108804390,98696,108903086,7,0,0,24064,18,3774504433
2138,108979880,4850,108984730,1,0,1,5120,14,7875329025
2139,109052580,1518,109054098,7,0,1,1536,18,10267404341
2140,109053150,99344,109152494,9,0,0,31232,10,5127980928
2141,109147770,135597,109283367,6,0,0,69120,9,668610633
2142,109151740,99058,109250798,5,0,0,7680,11,1607693172
2143,109251650,4420,109256070,4,0,1,11776,6,706038423
2144,109258740,54056,109312796,4,0,0,3584,6,4834682383
2145,109263020,127771,109390791,9,0,0,52736,10,4844075332
2146,109286710,187381,109474091,2,0,0,18432,4,8451005082
2147,109436720,47288,109484008,9,0,0,1536,10,8151815697
2148,109539380,90971,109630351,4,0,0,16896,6,8649208550
2149,109545260,79928,109625188,2,0,0,17920,4,6452282511
2150,109551770,136610,109688380,3,0,0,64000,9,7705773644
2151,109590950,6278,109597228,7,0,1,6656,18,10159175357
2152,109665020,56840,109721860,5,0,0,7680,11,8517010517
2153,109674870,103558,109778428,8,0,0,15872,12,10485183960
2154,109741620,112510,109854130,3,0,0,36352,9,1125716698
2155,109799010,69430,109868440,7,0,0,1536,18,2930246128
2156,109804310,3898,109808208,1,0,1,4096,14,9686358992
2157,109871430,12308,109883738,1,0,1,20480,14,814893786
2158,110067950,59132,110127082,6,0,0,5120,9,10195845421
2159,110125550,107240,110232790,2,0,0,47104,4,3644640697
2160,110151290,84167,110235457,9,0,0,8704,10,6374924132
2161,110157670,4679,110162349,9,0,1,12288,10,7571631457
2162,110310430,47288,110357718,9,0,0,1536,10,5515297666
2163,110398450,69908,110468358,7,0,0,10240,18,10589002647
2164,110418730,97136,110515866,3,0,0,18944,9,9178846972
2165,110460359,48727,110509086,0,0,0,512,10,3559388384
2166,110498220,143144,110641364,4,0,0,134656,6,4683447669
2167,110577610,6488,110584098,8,0,1,15872,12,7337159249
2168,110583350,97638,110680988,6,0,0,20480,9,8872660912
2169,110709690,104156,110813846,1,0,0,41984,14,9872815708
2170,110773320,98696,110872016,4,0,0,24064,6,9938115824
2171,110782180,114976,110897156,6,0,0,46080,9,1084155816
2172,110812810,137222,110950032,9,0,0,16896,10,4468160267
2173,110997030,83936,111080966,2,0,0,20992,4,1215891022
2174,111059630,99164,111158794,5,0,0,25600,11,6967267217
2175,111077381,9379,111086760,6,0,1,6144,9,5612279725
2176,111090690,71756,111162446,3,0,0,11264,9,2565706286
2177,111115920,3387,111119307,8,0,1,9728,12,5313409989
2178,111219060,60824,111279884,1,0,0,5632,14,8265132270
2179,111234601,5802,111240403,2,0,1,6144,4,4190162183
2180,111405480,2946,111408426,9,0,1,3072,10,2279703435
2181,111418941,2470,111421411,6,0,1,2560,9,7735463934
2182,111435390,3128,111438518,4,0,1,9216,6,8605795346
2183,111506170,14545,111520715,9,0,1,28160,10,1997151154
2184,111536480,103844,111640324,6,0,0,40960,9,6741243232
2185,111632571,8311,111640882,6,0,1,512,9,8730774186
2186,111652751,4850,111657601,6,0,1,5120,9,2676043290
2187,111703330,93752,111797082,5,0,0,17920,11,1965766555
2188,111746670,109170,111855840,1,0,0,28160,14,6978194301
2189,111751740,154590,111906330,5,0,0,11264,11,1931297892
2190,111850690,60890,111911580,9,0,0,4096,10,2874583214
2191,111912210,4374,111916584,4,0,1,4608,6,3213558031
2192,111934360,2870,111937230,7,0,1,8704,18,1083039240
2193,111952410,79436,112031846,5,0,0,11264,11,1186307652
2194,111973430,86384,112059814,4,0,0,18944,6,9828631171
2195,111980501,2946,111983447,2,0,1,3072,4,5013921716
2196,112128570,79436,112208006,5,0,0,11264,11,3916467625
2197,112153350,1994,112155344,9,0,1,2048,10,9822137944
2198,112217760,50672,112268432,3,0,0,2560,9,167086834
2199,112269400,99068,112368468,2,0,0,15360,4,6666216515
2200,112281640,52364,112334004,5,0,0,3072,11,10693209077
2201,112290940,48980,112339920,2,0,0,2048,4,10464898053
2202,112307940,113793,112421733,2,0,0,2560,4,2607130088
2203,112309240,125534,112434774,6,0,0,18944,9,1425234693
2204,112309990,110948,112420938,5,0,0,60416,11,4372639135
2205,112332160,11791,112343951,4,0,1,19456,6,6051717853
2206,112336000,107057,112443057,6,0,0,27136,9,9957635433
2207,112361721,7706,112369427,5,0,1,8192,11,3395383291
2208,112370350,89807,112460157,7,0,0,2560,18,552272525
2209,112482640,100880,112583520,3,0,0,31232,9,2509659203
2210,112487890,176516,112664406,7,0,0,16384,18,4215895316
2211,112523950,177680,112701630,6,0,0,27648,9,7463180583
2212,112646120,43904,112690024,9,0,0,512,10,263578280
2213,112688970,93596,112782566,1,0,0,17408,14,3394860545
2214,112702580,94532,112797112,6,0,0,20480,9,695839126
2215,112759180,99788,112858968,5,0,0,27648,11,5898166009
2216,112783220,97702,112880922,1,0,0,17920,14,9590493226
2217,112799030,111682,112910712,3,0,0,8704,9,3107436855
2218,112898980,2470,112901450,8,0,1,2560,12,8300650756
2219,112948910,91952,113040862,1,0,0,27136,14,8674921122
2220,113016380,103064,113119444,7,0,0,38400,18,1811371864
2221,113269330,98696,113368026,7,0,0,24064,18,907716790
2222,113321440,2470,113323910,7,0,1,2560,18,7436314244
2223,113365570,112376,113477946,2,0,0,60928,4,927419845
2224,113407740,144606,113552346,3,0,0,25600,9,7859102005
2225,113450580,74360,113524940,5,0,0,9728,11,3756385703
2226,113457131,1042,113458173,6,0,1,1024,9,10578806606
2227,113568910,566,113569476,7,0,1,512,18,9893372900
2228,113569810,100100,113669910,2,0,0,28672,4,9089408804
2229,113635000,61712,113696712,5,0,0,4608,11,5131482693
2230,113681920,102596,113784516,7,0,0,36864,18,8555781379
2231,113764410,98384,113862794,6,0,0,23040,9,6653991125
2232,113769051,3904,113772955,6,0,1,10752,9,7555579962
2233,113817510,566,113818076,1,0,1,512,14,6573583478
2234,113900620,54056,113954676,3,0,0,3584,9,6280511910
2235,113939390,60824,114000214,6,0,0,5632,9,10736658829
2236,114007020,47288,114054308,4,0,0,1536,6,2636276514
2237,114162040,5326,114167366,4,0,1,5632,6,8794228016
2238,114196420,68372,114264792,3,0,0,10240,9,6075685134
2239,114255330,62984,114318314,1,0,0,7680,14,1865310004
2240,114316210,6258,114322468,7,0,1,11264,18,1443758660
2241,114458340,97916,114556256,6,0,0,21504,9,4450219924
2242,114498580,136474,114635054,4,0,0,47104,6,1344105068
2243,114524921,6229,114531150,5,0,1,15360,11,4296457372
2244,114560460,187557,114748017,3,0,0,42496,9,6856379530
2245,114591630,129584,114721214,5,0,0,30208,11,780430638
2246,114662880,113948,114776828,1,0,0,25088,14,2595663398
2247,114709410,80603,114790013,1,0,0,4608,14,10627992093
2248,114746740,98717,114845457,3,0,0,19968,9,6532770650
2249,114796380,64995,114861375,5,0,0,512,11,4554196342
2250,114905710,98876,115004586,3,0,0,29696,9,8573730717
2251,114988090,88364,115076454,6,0,0,15360,9,7146751866
2252,115047280,80060,115127340,5,0,0,13312,11,4486346152
2253,115169890,104624,115274514,3,0,0,43520,9,9044027926
2254,115182440,7706,115190146,7,0,1,8192,18,9405254900
2255,115218030,87140,115305170,2,0,0,16384,4,7571028119
2256,115256481,18048,115274529,5,0,1,14848,11,1351919974
2257,115271290,66683,115337973,6,0,0,9216,9,2770993715
2258,115280800,87011,115367811,7,0,0,10240,18,9389507339
2259,115332320,112892,115445212,3,0,0,70656,9,5228150146
2260,115339560,142657,115482217,2,0,0,2560,4,4705977808
2261,115397740,165504,115563244,3,0,0,87552,9,7917004273
2262,115427580,142231,115569811,4,0,0,21504,6,1643732921
2263,115524780,111832,115636612,5,0,0,28672,11,5810055526
2264,115572640,110166,115682806,6,0,0,12800,9,5230491001
2265,115779280,111644,115890924,2,0,0,66560,4,5620977905
2266,115807590,54056,115861646,3,0,0,3584,9,9668313763
2267,115827560,80314,115907874,5,0,0,5120,11,2955351117
2268,115889910,105942,115995852,6,0,0,37376,9,1285014240
2269,115893100,65900,115959000,1,0,0,7168,14,6022415976
2270,116004260,64208,116068468,6,0,0,6656,9,2899852480
2271,116034960,93440,116128400,7,0,0,16896,18,8929463582
2272,116080140,181232,116261372,1,0,0,36352,14,4487262742
2273,116109780,113516,116223296,1,0,0,72704,14,7615235252
2274,116115590,1518,116117108,4,0,1,1536,6,2917254100
2275,116209480,15802,116225282,4,0,1,2048,6,7921841226
2276,116328211,2470,116330681,2,0,1,2560,4,3451115981
2277,116347150,95024,116442174,7,0,0,27136,18,8545755076
2278,116394370,50672,116445042,4,0,0,2560,6,7003394050
2279,116528620,103220,116631840,1,0,0,38912,14,3842562172
2280,116533960,118818,116652778,4,0,0,6144,6,3937722466
2281,116541110,157042,116698152,1,0,0,95232,14,10714750526
2282,116605940,3387,116609327,8,0,1,9728,12,8274557483
2283,116637980,122775,116760755,3,0,0,44544,9,2571868627
2284,116829980,45596,116875576,6,0,0,1024,9,8134543364
2285,116928260,4850,116933110,1,0,1,5120,14,10357977069
2286,116931771,2005,116933776,5,0,1,1024,11,1715745568
2287,116933490,120559,117054049,3,0,0,51200,9,4129564492
2288,116988630,138507,117127137,3,0,0,43008,9,9242426368
2289,117020710,93308,117114018,3,0,0,21504,9,8518541215
2290,117291261,1042,117292303,5,0,1,1024,11,4522394128
2291,117411500,45596,117457096,4,0,0,1024,6,796275059
2292,117478570,66524,117545094,5,0,0,9216,11,9205694040
2293,117588970,107276,117696246,7,0,0,52224,18,8675579362
2294,117640310,78994,117719304,2,0,0,15872,4,10177548235
2295,117818140,74072,117892212,4,0,0,13824,6,5155034060
2296,117819200,43904,117863104,3,0,0,512,9,5651222032
2297,117875120,104156,117979276,4,0,0,41984,6,4520477142
2298,117895771,2946,117898717,2,0,1,3072,4,7790184548
2299,117920540,1518,117922058,1,0,1,1536,14,2034078373
2300,117961300,100412,118061712,6,0,0,29696,9,10005354425
2301,117994170,77300,118071470,5,0,0,14336,11,8195383912
2302,118025570,110494,118136064,5,0,0,49664,11,7303947980
2303,118052570,99014,118151584,1,0,0,11776,14,10545622052
2304,118108570,57440,118166010,3,0,0,4608,9,3373793476
2305,118453460,97136,118550596,6,0,0,18944,9,4424553533
2306,118509300,102440,118611740,6,0,0,36352,9,1048625918
2307,118511850,114200,118626050,1,0,0,1536,14,3591838768
2308,118516200,202228,118718428,7,0,0,51712,18,6238668234
2309,118583640,107174,118690814,6,0,0,22528,9,244987927
2310,118803711,4679,118808390,5,0,1,12288,11,6348574883
2311,118858690,111220,118969910,4,0,0,39424,6,2117037844
2312,118895060,126984,119022044,7,0,0,12800,18,3593747426
2313,118950170,45596,118995766,6,0,0,1024,9,5245027457
2314,118959540,146786,119106326,1,0,0,61440,14,4680480711
2315,118991860,73292,119065152,2,0,0,11264,4,2563781453
2316,119042700,81362,119124062,2,0,0,12288,4,7221915497
2317,119078721,7706,119086427,5,0,1,8192,11,4194028944
2318,119095990,22136,119118126,8,0,1,19456,12,10572341736
2319,119098280,141230,119239510,5,0,0,18944,11,6377079513
2320,119126620,149424,119276044,4,0,0,6656,6,2285041899
2321,119191551,566,119192117,5,0,1,512,11,1438171913
2322,119255110,1518,119256628,8,0,1,1536,12,6675751049
2323,119270730,100567,119371297,7,0,0,25088,18,6376413082
2324,119287430,76208,119363638,5,0,0,10752,11,10139439143
2325,119300120,122352,119422472,5,0,0,60928,11,10050259640
2326,119331540,209366,119540906,3,0,0,55296,9,8147956601
2327,119363000,125478,119488478,4,0,0,44544,6,9904529544
2328,119445500,164945,119610445,8,0,0,24064,12,7751328143
2329,119763170,111644,119874814,1,0,0,66560,14,5372992245
2330,119850440,104936,119955376,4,0,0,44544,6,7912954545
2331,119856230,22992,119879222,9,0,1,4608,10,626819762
2332,119861870,177122,120038992,8,0,0,9216,12,5787436260
2333,119867440,105176,119972616,8,0,0,20992,12,8361531707
2334,119886520,110442,119996962,8,0,0,28672,12,6965914092
2335,119944090,110706,120054796,4,0,0,5632,6,5701932008
2336,119953890,128442,120082332,1,0,0,81408,14,2144093747
2337,120060050,80806,120140856,7,0,0,8192,18,10634147506
2338,120120800,57440,120178240,3,0,0,4608,9,3619016293
2339,120344270,64208,120408478,1,0,0,6656,14,6662133926
2340,120449180,54056,120503236,3,0,0,3584,9,2504225289
2341,120671701,3387,120675088,6,0,1,9728,9,4281787272
2342,120707780,161606,120869386,5,0,0,14848,11,4348660626
2343,120713170,105092,120818262,8,0,0,45056,12,2203448348
2344,120737600,7706,120745306,7,0,1,8192,18,1955257008
2345,120771631,4937,120776568,5,0,1,12800,11,2624456895
2346,120831760,143563,120975323,1,0,0,2048,14,7875515083
2347,120841030,76052,120917082,7,0,0,10240,18,7121492646
2348,120855440,83288,120938728,1,0,0,13824,14,4464729286
2349,120887001,10757,120897758,5,0,1,17408,11,8293310810
2350,120908511,10757,120919268,6,0,1,17408,9,1838750607
2351,121003070,104624,121107694,6,0,0,43520,9,2514522522
2352,121093450,104772,121198222,3,0,0,40960,9,9048042989
2353,121151490,121966,121273456,7,0,0,59904,18,8962215861
2354,121191340,96174,121287514,7,0,0,4096,18,9027827734
2355,121231500,50672,121282172,2,0,0,2560,4,1444688794
2356,121268130,74626,121342756,1,0,0,13312,14,6594588590
2357,121280570,86894,121367464,7,0,0,8704,18,9655387553
2358,121291140,84668,121375808,2,0,0,13312,4,2541819782
2359,121355900,139299,121495199,5,0,0,23552,11,9367268954
2360,121370280,117728,121488008,8,0,0,86528,12,3660770715
2361,121376630,171012,121547642,6,0,0,54272,9,218206306
2362,121376960,130416,121507376,6,0,0,24064,9,1562567463
2363,121423440,4374,121427814,8,0,1,4608,12,5386460
2364,121503070,155391,121658461,8,0,0,16896,12,3092850095
2365,121586050,4374,121590424,7,0,1,4608,18,2417976519
2366,121635280,23196,121658476,9,0,1,33280,10,7022522262
2367,121637930,124891,121762821,2,0,0,3584,4,10562204587
2368,121659770,4162,121663932,9,0,1,11264,10,93596257
2369,121666320,108648,121774968,5,0,0,31232,11,8552515944
2370,121729200,3387,121732587,8,0,1,9728,12,1279153205
2371,121812260,98696,121910956,8,0,0,24064,12,47049907
2372,121851160,141114,121992274,5,0,0,62976,11,7509254312
2373,121890990,208426,122099416,8,0,0,24064,12,1122420767
2374,121905390,122664,122028054,4,0,0,52736,6,8481600467
2375,121915070,133072,122048142,7,0,0,12800,18,1370255580
2376,121923650,104731,122028381,8,0,0,1024,12,42615854
2377,121973030,25481,121998511,7,0,1,6656,18,5926084040
2378,122162120,100880,122263000,6,0,0,31232,9,6348000907
2379,122167321,2946,122170267,2,0,1,3072,4,8721079492
2380,122259570,74398,122333968,3,0,0,8704,9,375280366
2381,122283530,67208,122350738,2,0,0,7168,4,978223984
2382,122327190,99008,122426198,1,0,0,25088,14,9251693753
2383,122408840,43904,122452744,1,0,0,512,14,6593698930
2384,122417640,100880,122518520,5,0,0,31232,11,6925811337
2385,122438170,61806,122499976,3,0,0,2048,9,3772106270
2386,122548980,62516,122611496,2,0,0,6144,4,2144556333
2387,122617360,43904,122661264,6,0,0,512,9,5253928562
2388,122646340,103532,122749872,9,0,0,39936,10,7958645668
2389,122745390,11228,122756618,8,0,1,7168,12,2016780361
2390,122790710,2470,122793180,7,0,1,2560,18,8232262175
2391,122918170,48980,122967150,5,0,0,2048,11,8609395805
2392,122923620,115262,123038882,1,0,0,74240,14,5379046871
2393,122940831,2946,122943777,5,0,1,3072,11,631102172
2394,122972990,132774,123105764,4,0,0,18432,6,4097632758
2395,123055720,50527,123106247,4,0,0,1536,6,4923059036
2396,123144140,104624,123248764,5,0,0,43520,11,6488562512
2397,123177600,72895,123250495,6,0,0,5632,9,10035425467
2398,123243780,105057,123348837,4,0,0,18432,6,15517152
2399,123259270,83936,123343206,6,0,0,20992,9,9761885989
2400,123400780,57440,123458220,8,0,0,4608,12,5683574687
2401,123504360,104000,123608360,7,0,0,41472,18,9399270270
2402,123728640,64208,123792848,2,0,0,6656,4,680364483
2403,123755480,105560,123861040,7,0,0,46592,18,6637034604
2404,123781760,131918,123913678,6,0,0,61952,9,5390172680
2405,123784781,4850,123789631,2,0,1,5120,4,7592980547
2406,123847350,116278,123963628,7,0,0,36864,18,5281785992
2407,123963070,106890,124069960,5,0,0,49152,11,21714644
2408,124024830,58954,124083784,6,0,0,1536,9,5520651316
2409,124112370,105560,124217930,3,0,0,46592,9,562970846
2410,124153880,4374,124158254,4,0,1,4608,6,7845690587
2411,124232670,47288,124279958,8,0,0,1536,12,3524779603
2412,124413591,5326,124418917,2,0,1,5632,4,154003472
2413,124450400,60824,124511224,6,0,0,5632,9,9840304484
2414,124547600,13512,124561112,9,0,1,26112,10,2584442744
2415,124727440,5802,124733242,7,0,1,6144,18,2195297271
2416,124737310,115211,124852521,7,0,0,62976,18,898904995
2417,124918210,80429,124998639,6,0,0,11264,9,9044131364
2418,124920520,74672,124995192,4,0,0,10752,6,5875670620
2419,124931461,14029,124945490,5,0,1,27136,11,4879158458
2420,125045520,63140,125108660,6,0,0,8192,9,4113971290
2421,125049370,4679,125054049,4,0,1,12288,6,3813387087
2422,125066421,1042,125067463,2,0,1,1024,4,2907285465
2423,125072860,76283,125149143,8,0,0,7680,12,4572683609
2424,125256500,69284,125325784,6,0,0,8192,9,3663907746
2425,125301580,104000,125405580,4,0,0,41472,6,744458470
2426,125616870,53300,125670170,3,0,0,6144,9,7474036535
2427,125620660,89900,125710560,3,0,0,15360,9,8573598618
2428,125678510,45596,125724106,2,0,0,1024,4,5760316443
2429,125731020,103532,125834552,4,0,0,39936,6,10134536705
2430,125761500,83822,125845322,8,0,0,3584,12,5223504649
2431,125858050,163619,126021669,1,0,0,33280,14,49969441
2432,125868280,143234,126011514,5,0,0,42496,11,1720300325
2433,125913910,229154,126143064,2,0,0,55296,4,4561493960
2434,125914580,132367,126046947,2,0,0,1024,4,5180883897
2435,125922440,566,125923006,9,0,1,512,10,7505548159
2436,125995040,105184,126100224,4,0,0,25600,6,3275461901
2437,126021170,202276,126223446,3,0,0,91136,9,4841405654
2438,126118650,5802,126124452,7,0,1,6144,18,8160994278
2439,126131100,13474,126144574,9,0,1,1536,10,142307298
2440,126154410,135066,126289476,6,0,0,79872,9,3301123813
2441,126281450,72226,126353676,6,0,0,6656,9,6222667945
2442,126289000,89817,126378817,2,0,0,23552,4,2653322597
2443,126338180,4162,126342342,9,0,1,11264,10,8479364531
2444,126379590,1994,126381584,7,0,1,2048,18,9183066406
2445,126386550,101348,126487898,2,0,0,32768,4,9331520453
2446,126406730,4937,126411667,1,0,1,12800,14,9181518644
2447,126429120,146738,126575858,4,0,0,6656,6,8514189772
2448,126436510,127930,126564440,6,0,0,101376,9,8783177773
2449,126440600,2946,126443546,9,0,1,3072,10,4397756108
2450,126458930,159107,126618037,1,0,0,60928,14,4307985977
2451,126486580,162117,126648697,4,0,0,15360,6,6293507388
2452,126497690,1042,126498732,8,0,1,1024,12,1394207273
2453,126643280,56429,126699709,2,0,0,4096,4,3865879310
2454,126781630,101816,126883446,3,0,0,34304,9,10515440338
2455,126792730,109460,126902190,3,0,0,59392,9,2353242435
2456,126806890,238079,127044969,4,0,0,39936,6,1773151361
2457,126816660,236600,127053260,8,0,0,27136,12,7122147022
2458,126818420,214366,127032786,6,0,0,93696,9,2028413764
2459,126904910,1042,126905952,8,0,1,1024,12,10640468727
2460,126924580,185048,127109628,2,0,0,14848,4,7682657954
2461,126934680,150786,127085466,8,0,0,12288,12,3681055169
2462,126948110,109377,127057487,4,0,0,13824,6,3977489010
2463,126962110,115346,127077456,5,0,0,6144,11,7288496791
2464,126964480,93958,127058438,3,0,0,3072,9,6196474719
2465,127032160,142964,127175124,8,0,0,93696,12,3495190778
2466,127069380,107015,127176395,2,0,0,4096,4,3958699214
2467,127102990,109580,127212570,1,0,0,13824,14,6807776158
2468,127114850,132691,127247541,4,0,0,19968,6,1081126872
2469,127121180,81301,127202481,5,0,0,8192,11,2828218329
2470,127157660,163711,127321371,1,0,0,34304,14,5108132040
2471,127373740,110084,127483824,3,0,0,61440,9,6988069791
2472,127376100,47288,127423388,8,0,0,1536,12,7011581314
2473,127393330,90704,127484034,7,0,0,512,18,2578844068
2474,127524670,55748,127580418,6,0,0,4096,9,2724877960
2475,127585110,103220,127688330,6,0,0,38912,9,2828431641
2476,127634069,97091,127731160,0,0,0,18432,10,3490285307
2477,127654490,102128,127756618,4,0,0,35328,6,1876992147
2478,127707230,102506,127809736,7,0,0,22016,18,2615990713
2479,127778620,104156,127882776,5,0,0,41984,11,7710899749
2480,127779110,202948,127982058,6,0,0,13824,9,10347776066
2481,127780470,87632,127868102,7,0,0,23040,18,8981187491
2482,127786760,4162,127790922,1,0,1,11264,14,5200935294
2483,127809610,154172,127963782,2,0,0,79872,4,3377138989
2484,127976020,50672,128026692,1,0,0,2560,14,5961368041
2485,128093290,62516,128155806,1,0,0,6144,14,2549132879
2486,128140850,72848,128213698,1,0,0,14848,14,3145404531
2487,128179749,13083,128192832,3,0,1,22016,9,4739977773
2488,128291890,144398,128436288,4,0,0,33280,6,10715714884
2489,128305460,1518,128306978,7,0,1,1536,18,1717744166
2490,128529730,3422,128533152,0,0,1,3584,10,8104729663
2491,128539470,5802,128545272,4,0,1,6144,6,6914181291
2492,128592300,89588,128681888,1,0,0,14336,14,7966225854
2493,128593270,88789,128682059,2,0,0,512,4,5668830678
2494,128694520,74828,128769348,7,0,0,11264,18,2926425292
2495,128817250,7230,128824480,1,0,1,7680,14,2169895732
2496,128842680,87896,128930576,8,0,0,13824,12,10002856287
2497,128895160,110084,129005244,3,0,0,61440,9,1862757520
2498,128914570,6278,128920848,8,0,1,6656,12,648122717
2499,128922530,566,128923096,0,0,1,512,10,9716645124
2500,128922911,1994,128924905,6,0,1,2048,9,4875782859
2501,128946371,5802,128952173,2,0,1,6144,4,2776335736
2502,129033330,111176,129144506,1,0,0,65024,14,10530266118
2503,129069590,1994,129071584,9,0,1,2048,10,992290254
2504,129188780,70376,129259156,7,0,0,11776,18,2681706447
2505,129191370,146236,129337606,8,0,0,61440,12,3524165450
2506,129208690,51105,129259795,8,0,0,2048,12,6527663917
2507,129213140,148858,129361998,4,0,0,41984,6,7282841476
2508,129280350,94934,129375284,8,0,0,10240,12,9012644483
2509,129289040,111894,129400934,4,0,0,2560,6,846681733
2510,129350210,112972,129463182,9,0,0,32256,10,3033909438
2511,129459410,121499,129580909,1,0,0,39424,14,853864674
2512,129475730,93152,129568882,7,0,0,20992,18,120030068
2513,129523950,86852,129610802,2,0,0,20480,4,9408556877
2514,129560330,101348,129661678,9,0,0,32768,10,1304816272
2515,129571980,54517,129626497,4,0,0,1024,6,8834709309
2516,129586460,104780,129691240,8,0,0,44032,12,3863084520
2517,129607990,230679,129838669,8,0,0,43008,12,8944415923
2518,129610070,127916,129737986,6,0,0,14848,9,8464273130
2519,129632140,566,129632706,9,0,1,512,10,6215130053
2520,129818910,86204,129905114,3,0,0,13312,9,4574981854
2521,129909020,69284,129978304,8,0,0,8192,12,6575687907
2522,129931600,89588,130021188,9,0,0,14336,10,988048962
2523,130028180,47288,130075468,9,0,0,1536,10,1682615451
2524,130038590,47288,130085878,4,0,0,1536,6,8788749655
2525,130048960,88520,130137480,2,0,0,15872,4,8725226561
2526,130154110,62072,130216182,3,0,0,9728,9,296551765
2527,130160520,103064,130263584,3,0,0,38400,9,8265073556
2528,130178830,97600,130276430,3,0,0,18944,9,3062995171
2529,130194620,116168,130310788,7,0,0,81408,18,4195297031
2530,130219151,1042,130220193,5,0,1,1024,11,1131890212
2531,130372560,109304,130481864,6,0,0,58880,9,6894494088
2532,130375040,116760,130491800,6,0,0,15872,9,8830307447
2533,130390670,144870,130535540,1,0,0,73728,14,1655466386
2534,130421990,3128,130425118,7,0,1,9216,18,7233276619
2535,130462880,102284,130565164,3,0,0,35840,9,10119035460
2536,130594770,68216,130662986,7,0,0,9728,18,2664891643
2537,130701180,59132,130760312,6,0,0,5120,9,3872598538
2538,130754100,74360,130828460,9,0,0,9728,10,5478354402
2539,130794590,78080,130872670,1,0,0,16896,14,5948697361
2540,130829330,117614,130946944,9,0,0,27648,10,7990853147
2541,130900400,54056,130954456,6,0,0,3584,9,3748333783
2542,130941630,111646,131053276,5,0,0,49152,11,8148699485
2543,131026020,2946,131028966,9,0,1,3072,10,4413900893
2544,131214311,7230,131221541,2,0,1,7680,4,4419138428
2545,131337400,99320,131436720,9,0,0,26112,10,4448255582
2546,131339310,109112,131448422,7,0,0,14336,18,9625222045
2547,131526451,7706,131534157,6,0,1,8192,9,3845397438
2548,131670460,107430,131777890,7,0,0,40448,18,7985277657
2549,131721079,95463,131816542,0,0,0,13824,10,4724727206
2550,131814910,98004,131912914,5,0,0,21504,11,4777095347
2551,131861440,52269,131913709,3,0,0,2560,9,266976082
2552,131913130,102075,132015205,1,0,0,33280,14,7767619934
2553,131948980,105092,132054072,7,0,0,45056,18,2122477486
2554,132006730,82688,132089418,7,0,0,8704,18,202490085
2555,132114061,7230,132121291,2,0,1,7680,4,7819488537
2556,132141690,7230,132148920,7,0,1,7680,18,3713088786
2557,132184040,188591,132372631,8,0,0,44032,12,2868604131
2558,132219011,6278,132225289,6,0,1,6656,9,6743557731
2559,132243860,147823,132391683,9,0,0,24064,10,2513980729
2560,132251330,22950,132274280,1,0,1,37888,14,10629035832
2561,132330280,54056,132384336,1,0,0,3584,14,2973792416
2562,132421291,566,132421857,2,0,1,512,4,9778351733
2563,132423850,2946,132426796,9,0,1,3072,10,6773688689
2564,132489140,69284,132558424,9,0,0,8192,10,4502601707
2565,132490030,108368,132598398,7,0,0,55808,18,1464007415
2566,132490760,115141,132605901,2,0,0,24576,4,1922391994
2567,132637630,59132,132696762,8,0,0,5120,12,10377899918
2568,132682460,25187,132707647,1,0,1,45568,14,10573960033
2569,132710120,135845,132845965,4,0,0,28672,6,3892809460
2570,132785090,152640,132937730,3,0,0,15872,9,7066746242
2571,132787140,1994,132789134,8,0,1,2048,12,8488808606
2572,132804350,128529,132932879,1,0,0,14848,14,10380701617
2573,132818229,99164,132917393,0,0,0,25600,10,5114415641
2574,132837390,20358,132857748,7,0,1,19456,18,10149394171
2575,132891300,115355,133006655,4,0,0,25088,6,8812783472
2576,132941890,5802,132947692,9,0,1,6144,10,5755381768
2577,133012490,60824,133073314,5,0,0,5632,11,7301797854
2578,133114619,103532,133218151,0,0,0,39936,10,8556600420
2579,133148220,1994,133150214,1,0,1,2048,14,372541931
2580,133173250,97916,133271166,5,0,0,21504,11,5157366871
2581,133235121,1518,133236639,6,0,1,1536,9,9485896060
2582,133257740,1994,133259734,1,0,1,2048,14,6797242287
2583,133338459,93284,133431743,0,0,0,16384,10,10176574137
2584,133341550,76052,133417602,8,0,0,10240,12,3704753640
2585,133345000,97604,133442604,2,0,0,20480,4,9536735543
2586,133371211,1042,133372253,2,0,1,1024,4,7117231216
2587,133428379,102520,133530899,0,0,0,25600,10,4903902206
2588,133464330,89855,133554185,8,0,0,5120,12,6365221369
2589,133477579,85042,133562621,0,0,0,2560,10,10334758157
2590,133490460,3898,133494358,9,0,1,4096,10,5190777589
2591,133490840,112713,133603553,5,0,0,51200,11,7948615692
2592,133495750,118393,133614143,3,0,0,9216,9,9664008172
2593,133584010,129679,133713689,8,0,0,102912,12,2804199555
2594,133603669,129437,133733106,0,0,0,28160,10,7895241757
2595,133611090,142361,133753451,2,0,0,25600,4,3119694825
2596,133616830,98138,133714968,3,0,0,4096,9,9074263744
2597,133692830,92139,133784969,1,0,0,9728,14,7507054508
2598,133700160,20221,133720381,0,0,1,13824,10,5401129816
2599,133746920,8041,133754961,9,0,1,1536,10,5021439693
2600,133783391,6420,133789811,2,0,1,5120,4,5033760048
2601,133823310,47288,133870598,7,0,0,1536,18,291148365
2602,133868030,3422,133871452,9,0,1,3584,10,4967598070
2603,133952199,120266,134072465,0,0,0,11776,10,1966032368
2604,134058920,78992,134137912,6,0,0,14848,9,3147347479
2605,134125230,102128,134227358,5,0,0,35328,11,1650890044
2606,134141330,100722,134242052,5,0,0,16896,11,5406315391
2607,134228440,1994,134230434,8,0,1,2048,12,9361905029
2608,134259570,60824,134320394,4,0,0,5632,6,3611476961
2609,134308380,50672,134359052,3,0,0,2560,9,8905783587
2610,134323240,73448,134396688,3,0,0,11776,9,2104133549
2611,134452750,566,134453316,1,0,1,512,14,10118768653
2612,134453070,1518,134454588,0,0,1,1536,10,1510621743
2613,134524240,5712,134529952,8,0,1,14336,12,8764470274
2614,134544350,50672,134595022,7,0,0,2560,18,3393073001
2615,134737250,88520,134825770,1,0,0,15872,14,4067766266
2616,134742010,111948,134853958,2,0,0,32768,4,2063160848
2617,134746670,125620,134872290,9,0,0,11776,10,2634072095
2618,134815420,43904,134859324,9,0,0,512,10,10575833741
2619,134993640,84092,135077732,7,0,0,21504,18,5316789607
2620,135001410,79613,135081023,9,0,0,10752,10,4148843274
2621,135016390,182392,135198782,9,0,0,49664,10,7508222291
2622,135040620,100742,135141362,9,0,0,22528,10,9739664496
2623,135087949,125356,135213305,0,0,0,47616,10,5419160493
2624,135217810,3898,135221708,7,0,1,4096,18,8918359994
2625,135234510,43904,135278414,1,0,0,512,14,3131078311
2626,135346880,7706,135354586,4,0,1,8192,6,3333133991
2627,135352250,220923,135573173,5,0,0,24576,11,4044278674
2628,135369650,84980,135454630,6,0,0,14336,9,9079221859
2629,135491940,121121,135613061,2,0,0,14336,4,8115618720
2630,135584240,80996,135665236,7,0,0,16384,18,9883163250
2631,135609590,86660,135696250,2,0,0,6144,4,5675546005
2632,135670230,99632,135769862,2,0,0,27136,4,739495738
2633,135706929,116969,135823898,0,0,0,5632,10,9213012432
2634,135728320,77122,135805442,8,0,0,512,12,4815015192
2635,135750720,5454,135756174,4,0,1,13824,6,872429478
2636,135834200,48980,135883180,7,0,0,2048,18,7090870519
2637,135924510,73604,135998114,9,0,0,12288,10,4974308376
2638,136002120,100724,136102844,1,0,0,30720,14,2815371912
2639,136092741,10118,136102859,6,0,1,3072,9,2729475417
2640,136112960,100100,136213060,1,0,0,28672,14,109132722
2641,136193770,71624,136265394,6,0,0,15872,9,4190120559
2642,136199569,59132,136258701,0,0,0,5120,10,5336566704
2643,136253320,93128,136346448,3,0,0,15872,9,7845287327
2644,136279900,5971,136285871,9,0,1,14848,10,8476418334
2645,136299710,139450,136439160,9,0,0,20480,10,5870069981
2646,136363380,178938,136542318,3,0,0,131072,9,429052832
2647,136409800,134732,136544532,1,0,0,3584,14,3228668071
2648,136412150,140298,136552448,7,0,0,20992,18,8739518711
2649,136413030,85562,136498592,8,0,0,512,12,1814388817
2650,136468070,75355,136543425,6,0,0,3584,9,7120372045
2651,136574330,56996,136631326,8,0,0,8192,12,4305514454
2652,136690390,114608,136804998,5,0,0,76288,11,409167277
2653,136697221,5802,136703023,2,0,1,6144,4,4946915766
2654,136710290,137926,136848216,5,0,0,15360,11,8671991225
2655,136716050,2470,136718520,1,0,1,2560,14,10331093518
2656,136748470,145256,136893726,9,0,0,17408,10,1926948816
2657,136784140,111629,136895769,1,0,0,6656,14,10207524320
2658,136805341,4374,136809715,5,0,1,4608,11,1072592582
2659,136929620,105248,137034868,4,0,0,45568,6,1027369207
2660,137167050,5971,137173021,0,0,1,14848,10,1615091300
2661,137174719,243296,137418015,0,0,0,38400,10,5219629131
2662,137208080,11016,137219096,7,0,1,17920,18,5380565962
2663,137231720,218157,137449877,5,0,0,45568,11,5229666238
2664,137245661,1518,137247179,2,0,1,1536,4,7114825895
2665,137283420,81776,137365196,9,0,0,18944,10,2917993520
2666,137393840,107120,137500960,8,0,0,51712,12,10110722384
2667,137556760,68084,137624844,2,0,0,14336,4,983120914
2668,137561920,67772,137629692,9,0,0,13312,10,2295133907
2669,137575950,5712,137581662,1,0,1,14336,14,4411172409
2670,137602100,89612,137691712,1,0,0,19456,14,9667110273
2671,137617650,107860,137725510,5,0,0,13312,11,5755673506
2672,137655040,55748,137710788,3,0,0,4096,9,6036970033
2673,137668760,110390,137779150,1,0,0,5632,14,9136651667
2674,137969010,45752,138014762,1,0,0,1536,14,7701382651
2675,138030939,80060,138110999,0,0,0,13312,10,1712891018
2676,138106490,191372,138297862,4,0,0,166912,6,2806883362
2677,138110931,10559,138121490,5,0,1,16896,11,8667679071
2678,138232870,6278,138239148,8,0,1,6656,12,7539788999
2679,138252910,97308,138350218,2,0,0,3072,4,3151913926
2680,138254830,101376,138356206,6,0,0,2560,9,7796089532
2681,138363370,55748,138419118,9,0,0,4096,10,9448914754
2682,138393130,103376,138496506,4,0,0,39424,6,5032829694
2683,138397831,1042,138398873,5,0,1,1024,11,1116869469
2684,138444210,90762,138534972,7,0,0,13312,18,6658795020
2685,138483160,87632,138570792,9,0,0,23040,10,5834234757
2686,138496340,109712,138606052,6,0,0,43008,9,7441797687
2687,138579319,115791,138695110,0,0,0,14336,10,1662711607
2688,138586330,55386,138641716,8,0,0,1536,12,9047864147
2689,138701780,53300,138755080,6,0,0,6144,9,1963804698
2690,138701881,7706,138709587,6,0,1,8192,9,10594205714
2691,138704230,81324,138785554,3,0,0,11776,9,5277284962
2692,138716740,104935,138821675,2,0,0,38400,4,3937194467
2693,138731780,59620,138791400,7,0,0,3584,18,7634667188
2694,138760790,126406,138887196,4,0,0,15360,6,1901554343
2695,138782170,91164,138873334,8,0,0,23552,12,6115525732
2696,139005870,3387,139009257,9,0,1,9728,10,7938051224
2697,139066050,184725,139250775,8,0,0,94208,12,3746903562
2698,139068569,133821,139202390,0,0,0,26624,10,9086556160
2699,139109600,169429,139279029,6,0,0,19456,9,6528913543
2700,139146430,105148,139251578,5,0,0,2560,11,1570864316
2701,139185630,97938,139283568,7,0,0,14848,18,93397531
2702,139226550,127281,139353831,6,0,0,38400,9,7728576671
2703,139260650,4850,139265500,1,0,1,5120,14,4818490489
2704,139268960,154021,139422981,4,0,0,37376,6,6263792277
2705,139437940,59132,139497072,4,0,0,5120,6,8144960210
2706,139464050,101036,139565086,7,0,0,31744,18,6146137797
2707,139491660,137302,139628962,7,0,0,12288,18,10082257033
2708,139499560,71610,139571170,2,0,0,4096,4,8328383628
2709,139613660,126110,139739770,5,0,0,76288,11,4401981800
2710,139634810,153200,139788010,3,0,0,78336,9,5075876553
2711,139677139,194166,139871305,0,0,0,4096,10,751704971
2712,139725270,144772,139870042,7,0,0,98304,18,6701058111
2713,139730170,201896,139932066,7,0,0,52736,18,8484046622
2714,139736500,136692,139873192,8,0,0,6144,12,9951197508
2715,139884110,1518,139885628,7,0,1,1536,18,9486264189
2716,139900340,113954,140014294,8,0,0,55296,12,7892764057
2717,139923690,59040,139982730,8,0,0,2560,12,6297885524
2718,139939080,142780,140081860,2,0,0,44032,4,52795116
2719,140013920,4264,140018184,0,0,1,4096,10,4151633818
2720,140085020,76388,140161408,9,0,0,16384,10,2729299026
2721,140091990,89948,140181938,2,0,0,25600,4,9232835714
2722,140132380,65436,140197816,2,0,0,2560,4,8887929319
2723,140141119,101377,140242496,0,0,0,26624,10,502662
2724,140380540,13770,140394310,9,0,1,26624,10,6226871195
2725,140409391,6754,140416145,2,0,1,7168,4,1204089106
2726,140418150,45596,140463746,1,0,0,1024,14,7967520273
2727,140423160,249439,140672599,9,0,0,69632,10,3641708641
2728,140482180,191378,140673558,8,0,0,3072,12,4541286066
2729,140484140,54056,140538196,3,0,0,3584,9,5040355841
2730,140659450,20321,140679771,1,0,1,15360,14,1829634646
2731,140661060,90726,140751786,4,0,0,17408,6,9852139150
2732,140726970,92974,140819944,7,0,0,15360,18,1186027299
2733,140726980,102339,140829319,6,0,0,30720,9,6671571346
2734,140736570,156682,140893252,7,0,0,89600,18,3153370631
2735,140751909,166057,140917966,0,0,0,13312,10,1171935391
2736,140765450,137192,140902642,7,0,0,14336,18,1550933066
2737,140768290,129969,140898259,5,0,0,16384,11,5511595255
2738,140820060,126020,140946080,6,0,0,16384,9,3192057615
2739,140892490,57432,140949922,2,0,0,1536,4,696764482
2740,140924909,77159,141002068,0,0,0,10240,10,404370590
2741,140937640,100864,141038504,2,0,0,25088,4,3304850989
2742,140941520,134682,141076202,4,0,0,31744,6,488707321
2743,140989860,164072,141153932,5,0,0,58880,11,9576235488
2744,141066310,140356,141206666,2,0,0,68096,4,6249613371
2745,141123910,55904,141179814,5,0,0,4608,11,1082598879
2746,141150770,143148,141293918,8,0,0,54784,12,737926617
2747,141198120,170289,141368409,7,0,0,34816,18,5562128620
2748,141216060,3645,141219705,7,0,1,10240,18,3185778969
2749,141295040,126804,141421844,9,0,0,27648,10,454516418
2750,141313671,2470,141316141,6,0,1,2560,9,8016998857
2751,141368890,57440,141426330,8,0,0,4608,12,2360766098
2752,141409430,122092,141531522,5,0,0,50176,11,5016507510
2753,141416790,148830,141565620,8,0,0,9728,12,7165112716
2754,141443010,128596,141571606,3,0,0,18432,9,714676914
2755,141517150,88748,141605898,4,0,0,14848,6,9234395434
2756,141605230,114020,141719250,1,0,0,72192,14,9447020957
2757,141733280,68840,141802120,1,0,0,11776,14,8727865748
2758,141738840,124912,141863752,9,0,0,52736,10,8436271730
2759,141886030,90080,141976110,4,0,0,20992,6,3947446129
2760,141891220,115634,142006854,2,0,0,26112,4,10567524432
2761,141926130,1042,141927172,4,0,1,1024,6,7676858716
2762,142006890,159173,142166063,5,0,0,15360,11,10051118932
2763,142055821,3128,142058949,2,0,1,9216,4,9705559150
2764,142071959,55904,142127863,0,0,0,4608,10,1772893503
2765,142094810,566,142095376,4,0,1,512,6,4424498915
2766,142203961,2946,142206907,5,0,1,3072,11,7811864646
2767,142242390,93128,142335518,2,0,0,15872,4,2148525470
2768,142247660,190952,142438612,6,0,0,35840,9,5540628500
2769,142282450,78056,142360506,5,0,0,11776,11,8963340647
2770,142366780,140802,142507582,8,0,0,29184,12,1515787067
2771,142399930,223866,142623796,8,0,0,41472,12,8242535752
2772,142413340,5802,142419142,7,0,1,6144,18,595525502
2773,142417490,96920,142514410,6,0,0,11264,9,1593182514
2774,142435830,208737,142644567,5,0,0,68096,11,8460437276
2775,142439960,82850,142522810,4,0,0,5632,6,6020397749
2776,142491209,159965,142651174,0,0,0,9216,10,8582886402
2777,142496770,10827,142507597,7,0,1,2560,18,1208735377
2778,142561780,103380,142665160,6,0,0,3584,9,900887785
2779,142612920,93688,142706608,5,0,0,12288,11,7216366655
2780,142631230,118733,142749963,2,0,0,46080,4,3531576455
2781,142649950,4162,142654112,8,0,1,3072,12,5759560210
2782,142746730,124192,142870922,9,0,0,96256,10,3111293297
2783,142750230,178467,142928697,3,0,0,53760,9,6566460243
2784,142777750,11274,142789024,8,0,1,18432,12,9355048008
2785,142798630,165425,142964055,8,0,0,9216,12,1345614361
2786,142816570,144662,142961232,9,0,0,72704,10,1376851174
2787,142963420,110087,143073507,4,0,0,59392,6,713688552
2788,143090149,78392,143168541,0,0,0,17920,10,5483006858
2789,143210360,6488,143216848,4,0,1,15872,6,5912170369
2790,143270860,114627,143385487,7,0,0,39936,18,9638344931
2791,143309580,126035,143435615,7,0,0,17408,18,4792115775
2792,143310849,45596,143356445,0,0,0,1024,10,10703235798
2793,143349620,87882,143437502,5,0,0,6144,11,6087441294
2794,143391060,83468,143474528,6,0,0,19456,9,9144982445
2795,143416280,100703,143516983,6,0,0,13312,9,8909613028
2796,143440010,128471,143568481,7,0,0,14848,18,9550428136
2797,143643360,120457,143763817,3,0,0,59904,9,7492341362
2798,143643680,2946,143646626,7,0,1,3072,18,1660745105
2799,143870160,57440,143927600,5,0,0,4608,11,5337920928
2800,143878271,5712,143883983,2,0,1,14336,4,8294713654
2801,143898220,66804,143965024,7,0,0,4608,18,1394306618
2802,143919199,190619,144109818,0,0,0,3584,10,8274486956
2803,143986300,111218,144097518,6,0,0,60416,9,5991263612
2804,143990419,88676,144079095,0,0,0,16384,10,1643472955
2805,144020690,121981,144142671,4,0,0,31232,6,1688335856
2806,144035780,82171,144117951,2,0,0,512,4,8748467098
2807,144084930,23337,144108267,8,0,1,17408,12,6324877225
2808,144117070,231526,144348596,7,0,0,57856,18,4711162474
2809,144258980,48980,144307960,4,0,0,2048,6,10314571841
2810,144303080,96668,144399748,5,0,0,17408,11,1956653568
2811,144505230,73004,144578234,2,0,0,15360,4,5578147565
2812,144546700,2470,144549170,8,0,1,2560,12,8422985924
2813,144629040,75608,144704648,3,0,0,13824,9,1971788440
2814,144639790,77612,144717402,7,0,0,15360,18,1385205036
2815,144711880,48980,144760860,4,0,0,2048,6,9338571430
2816,144746980,67592,144814572,8,0,0,7680,12,4648948135
2817,144772650,97604,144870254,3,0,0,20480,9,942300857
2818,144780809,145617,144926426,0,0,0,43520,10,9749520315
2819,145028050,52364,145080414,5,0,0,3072,11,4303598389
2820,145090390,64208,145154598,4,0,0,6656,6,8516011364
2821,145166240,91484,145257724,2,0,0,25600,4,8615786305
2822,145219960,101192,145321152,8,0,0,32256,12,10132563807
2823,145417740,63140,145480880,5,0,0,8192,11,3094177875
2824,145429739,62516,145492255,9,0,0,6144,10,2592444097
2825,145479980,51564,145531544,3,0,0,2560,9,8021637460
2826,145506590,45596,145552186,6,0,0,1024,9,10220194201
2827,145541471,12566,145554037,2,0,1,20992,4,3909876538
2828,145575820,99882,145675702,5,0,0,26624,11,8796240332
2829,145618780,123024,145741804,4,0,0,96256,6,3427513839
2830,145640280,119898,145760178,4,0,0,16896,6,3460887951
2831,145664120,144664,145808784,9,0,0,24064,10,9863066649
2832,145664449,179327,145843776,0,0,0,17920,10,7625386021
2833,145763360,145162,145908522,7,0,0,27648,18,8319479841
2834,145866530,4850,145871380,8,0,1,5120,12,1680980761
2835,145881320,117834,145999154,7,0,0,47104,18,7576641954
2836,145891090,7230,145898320,7,0,1,7680,18,2262879813
2837,145900691,14101,145914792,2,0,1,6656,4,2932072441
2838,145956950,131539,146088489,6,0,0,3072,9,8921358620
2839,146002391,133549,146135940,2,0,1,216576,4,2158575461
2840,146054740,342983,146397723,6,0,0,10752,9,2430704751
2841,146088030,269331,146357361,2,0,0,25600,4,4889148754
2842,146092190,357780,146449970,5,0,0,59392,11,7140338312
2843,146131181,4913,146136094,5,0,1,8704,11,1671532602
2844,146167250,142549,146309799,5,0,0,71168,11,9012803008
2845,146253520,178339,146431859,6,0,0,70656,9,8084531594
2846,146446550,60852,146507402,5,0,0,4608,11,6177777229
2847,146499400,58220,146557620,7,0,0,7168,18,9179561175
2848,146513570,60976,146574546,2,0,0,6144,4,2577837625
2849,146641019,69908,146710927,0,0,0,10240,10,1971597180
2850,146728550,193088,146921638,3,0,0,172544,9,2884702081
2851,146767170,164958,146932128,5,0,0,30720,11,5421969941
2852,146776560,159654,146936214,6,0,0,11776,9,601362383
2853,146784440,138313,146922753,3,0,0,3584,9,8333540453
2854,146823559,109052,146932611,0,0,0,1536,10,6059388292
2855,146895960,78190,146974150,3,0,0,3584,9,9352319387
2856,146985260,93896,147079156,9,0,0,23040,10,5822444289
2857,147005400,111736,147117136,2,0,0,31744,4,7060615638
2858,147151230,72668,147223898,5,0,0,9216,11,2638497634
2859,147184680,566,147185246,9,0,1,512,10,4598917549
2860,147214060,50672,147264732,2,0,0,2560,4,10322264297
2861,147238039,86852,147324891,0,0,0,20480,10,2704160560
2862,147245910,153123,147399033,4,0,0,35840,6,9941311801
2863,147249150,1042,147250192,1,0,1,1024,14,3899306918
2864,147267919,153056,147420975,0,0,0,44544,10,6212166069
2865,147311100,111450,147422550,9,0,0,5120,10,10202322445
2866,147359681,4162,147363843,5,0,1,11264,11,7211080530
2867,147406650,97136,147503786,3,0,0,18944,9,6287304860
2868,147427940,156828,147584768,9,0,0,51712,10,4807516034
2869,147473730,178880,147652610,7,0,0,66560,18,10730830389
2870,147478960,211621,147690581,8,0,0,84992,12,5193735651
2871,147519660,1518,147521178,7,0,1,1536,18,6243621770
2872,147524560,140110,147664670,2,0,0,27136,4,3196924608
2873,147562910,129886,147692796,2,0,0,7168,4,2252137114
2874,147582890,113197,147696087,3,0,0,10752,9,7863659382
2875,147583100,151188,147734288,3,0,0,27648,9,5775090109
2876,147610859,114867,147725726,9,0,0,12288,10,5652762867
2877,147618330,101306,147719636,4,0,0,14848,6,10234861305
2878,147654810,212184,147866994,2,0,0,5632,4,3991626964
2879,147661610,37883,147699493,8,0,1,3584,12,94301404
2880,147663580,125870,147789450,3,0,0,24576,9,1262075514
2881,147671450,140256,147811706,1,0,0,53760,14,879439296
2882,147692330,158874,147851204,2,0,0,34816,4,4323719407
2883,147792271,19450,147811721,5,0,1,10240,11,1224281799
2884,147831240,104780,147936020,2,0,0,44032,4,8528892189
2885,147857879,3898,147861777,3,0,1,4096,9,9101779153
2886,147876380,69908,147946288,6,0,0,10240,9,2025361039
2887,148008031,12049,148020080,5,0,1,19968,11,9120751796
2888,148082900,113540,148196440,3,0,0,24576,9,421278845
2889,148104260,74534,148178794,7,0,0,8704,18,2900401513
2890,148137291,7230,148144521,5,0,1,7680,11,3604528212
2891,148219049,102908,148321957,0,0,0,37888,10,8544868857
2892,148232979,154744,148387723,0,0,0,35840,10,5362094038
2893,148248710,77320,148326030,2,0,0,1536,4,4560194394
2894,148276231,6754,148282985,5,0,1,7168,11,7248505265
2895,148303250,192818,148496068,3,0,0,24576,9,9116348046
2896,148341050,110489,148451539,5,0,0,36352,11,3302475281
2897,148366920,149287,148516207,3,0,0,66048,9,6706408230
2898,148376520,145006,148521526,4,0,0,17408,6,1833484542
2899,148422590,160235,148582825,2,0,0,70656,4,10030684684
2900,148537900,13600,148551500,1,0,1,23040,14,5239005436
2901,148686480,54056,148740536,8,0,0,3584,12,1075453907
2902,148707260,74228,148781488,7,0,0,14336,18,9535241610
2903,148739181,12308,148751489,6,0,1,20480,9,4867085814
2904,148754240,233530,148987770,3,0,0,115712,9,1040150312
2905,148784400,140314,148924714,4,0,0,26624,6,8096249933
2906,148869300,1042,148870342,1,0,1,1024,14,497487801
2907,148902680,150444,149053124,8,0,0,17408,12,6478744954
2908,148908840,105404,149014244,7,0,0,46080,18,9692209511
2909,148963470,122832,149086302,5,0,0,23552,11,6908465591
2910,148979620,200624,149180244,9,0,0,68608,10,9508155093
2911,148999230,142620,149141850,5,0,0,44544,11,525345952
2912,149013070,142407,149155477,9,0,0,22528,10,4543926556
2913,149062530,84157,149146687,5,0,0,7680,11,4768845163
2914,149097600,83291,149180891,6,0,0,2048,9,6881937957
2915,149154270,108787,149263057,2,0,0,53248,4,2643018981
2916,149167020,153475,149320495,4,0,0,44032,6,5379921088
2917,149257850,114005,149371855,3,0,0,8704,9,7695398329
2918,149377180,99788,149476968,7,0,0,27648,18,7196028186
2919,149395470,136032,149531502,6,0,0,54272,9,2464298694
2920,149463220,4420,149467640,9,0,1,11776,10,1910293397
2921,149501539,74384,149575923,0,0,0,14848,10,5908004588
2922,149521439,141106,149662545,0,0,0,71168,10,8320161455
2923,149608640,566,149609206,1,0,1,512,14,2001116068
2924,149773260,43904,149817164,5,0,0,512,11,5694935846
2925,149777070,82532,149859602,8,0,0,16384,12,2307489622
2926,149793090,83870,149876960,9,0,1,139776,10,1030332101
2927,149810850,197231,150008081,3,0,0,31744,9,1554353103
2928,149845960,75089,149921049,7,0,0,1024,18,10526640011
2929,149852160,120064,149972224,7,0,0,15872,18,9974514327
2930,149866880,12666,149879546,8,0,1,4096,12,7528653559
2931,149963570,60068,150023638,4,0,0,8192,6,3542864665
2932,150091300,59132,150150432,2,0,0,5120,4,6537132713
2933,150108880,1994,150110874,1,0,1,2048,14,4538806615
2934,150145240,1042,150146282,1,0,1,1024,14,5031652796
2935,150154429,55748,150210177,0,0,0,4096,10,4470420257
2936,150216940,52364,150269304,6,0,0,3072,9,9541060488
2937,150231930,48980,150280910,9,0,0,2048,10,10638069163
2938,150241260,87320,150328580,6,0,0,22016,9,3855182950
2939,150307250,78016,150385266,8,0,0,12288,12,7651173614
2940,150401900,95624,150497524,2,0,0,24064,4,10550466538
2941,150462300,13341,150475641,8,0,1,22528,12,4399085780
2942,150522650,5326,150527976,4,0,1,5632,6,5156536101
2943,150531630,117774,150649404,6,0,0,37888,9,3492506839
2944,150584719,164553,150749272,9,0,0,42496,10,8644653295
2945,150689870,5802,150695672,0,0,1,6144,10,4320599277
2946,150699820,105404,150805224,8,0,0,46080,12,10090583134
2947,150707469,182474,150889943,0,0,0,36352,10,5333879021
2948,150757320,109014,150866334,5,0,0,33792,11,620407128
2949,150773210,95947,150869157,5,0,0,9216,11,4512660123
2950,150804751,3335,150808086,6,0,1,8704,9,746397303
2951,150815050,115941,150930991,8,0,0,5632,12,1711537450
2952,150843389,50672,150894061,0,0,0,2560,10,1329519956
2953,150886570,124023,151010593,2,0,0,38912,4,6968393978
2954,150930590,133445,151064035,2,0,0,32768,4,3942080738
2955,150967190,3128,150970318,8,0,1,9216,12,3164517364
2956,150971150,98672,151069822,3,0,0,18944,9,4397816007
2957,151033730,71288,151105018,8,0,0,9728,12,9817178059
2958,151062641,12023,151074664,2,0,1,5120,4,2696915697
2959,151220510,36863,151257373,9,0,1,65024,10,7151157405
2960,151248179,125912,151374091,0,0,0,22016,10,6077966055
2961,151254449,60824,151315273,9,0,0,5632,10,6641850691
2962,151269220,5802,151275022,7,0,1,6144,18,863850074
2963,151389920,99513,151489433,2,0,0,10752,4,6783100514
2964,151395700,98740,151494440,8,0,0,16384,12,133479894
2965,151443379,131999,151575378,9,0,0,17408,10,478927079
2966,151463350,100412,151563762,5,0,0,29696,11,9929667578
2967,151499839,93017,151592856,9,0,0,3072,10,9261143799
2968,151589609,54056,151643665,0,0,0,3584,10,4866479082
2969,151601690,62516,151664206,2,0,0,6144,4,10498792840
2970,151636000,70800,151706800,6,0,0,8704,9,5681266522
2971,151643551,55151,151698702,2,0,1,93696,4,3476627143
2972,151672590,162028,151834618,5,0,0,70656,11,6128049157
2973,151771330,3898,151775228,7,0,1,4096,18,5066062691
2974,151798020,104780,151902800,8,0,0,44032,12,7419458189
2975,151816750,99556,151916306,6,0,0,1536,9,1278394324
2976,151844420,89118,151933538,8,0,0,7680,12,3199056817
2977,151867980,4374,151872354,1,0,1,4608,14,8532395127
2978,151922850,101036,152023886,3,0,0,31744,9,4670908381
2979,151956210,79436,152035646,8,0,0,11264,12,7915977792
2980,152024610,96560,152121170,2,0,0,27136,4,4273443719
2981,152099690,21495,152121185,0,0,1,23552,10,1482882246
2982,152127530,60824,152188354,8,0,0,5632,12,3218826514
2983,152176840,92840,152269680,3,0,0,19968,9,4710875316
2984,152178710,141838,152320548,5,0,0,25600,11,9411275183
2985,152201410,152858,152354268,8,0,0,28160,12,3912767356
2986,152268009,95841,152363850,0,0,0,15360,10,9529020335
2987,152330209,73583,152403792,0,0,0,9216,10,4189803705
2988,152340910,72338,152413248,4,0,0,12800,6,6049018928
2989,152348559,79557,152428116,9,0,0,6144,10,9315933758
2990,152376749,52474,152429223,0,0,0,3584,10,744533150
2991,152432220,71780,152504000,2,0,0,16384,4,5638942094
2992,152577560,70976,152648536,5,0,0,8704,11,7882210301
2993,152614320,64208,152678528,7,0,0,6656,18,3983863729
2994,152627530,75164,152702694,5,0,0,17408,11,5001267534
2995,152698940,83338,152782278,3,0,0,11776,9,8949503270
2996,152773070,67304,152840374,4,0,0,11776,6,4716147637
2997,152790910,59132,152850042,4,0,0,5120,6,9147790430
2998,152799470,79474,152878944,3,0,0,3072,9,288801399
2999,152828160,566,152828726,1,0,1,512,14,2774423167
3000,152856530,1994,152858524,8,0,1,2048,12,3472119166
3001,152913460,86984,153000444,3,0,0,15872,9,203793755
3002,152932610,101320,153033930,6,0,0,8704,9,6103733334
3003,152933930,43904,152977834,6,0,0,512,9,7541427684
3004,152989100,118296,153107396,6,0,0,87552,9,3478117091
3005,153012450,157855,153170305,6,0,0,22528,9,6984631557
3006,153026970,136448,153163418,2,0,0,38400,4,5284288122
3007,153118450,141048,153259498,9,0,0,95232,10,8711662271
3008,153148220,113789,153262009,6,0,0,8192,9,2443647692
3009,153159109,129819,153288928,0,0,0,9216,10,8463195664
3010,153205519,106809,153312328,9,0,0,20480,10,10445982992
3011,153270910,86204,153357114,8,0,0,13312,12,6546842591
3012,153275350,107220,153382570,1,0,0,23040,14,8765275418
3013,153357301,566,153357867,6,0,1,512,9,6147316773
3014,153378600,58798,153437398,4,0,0,6144,6,7872252918
3015,153473130,22862,153495992,9,0,1,40960,10,8375180950
3016,153498290,2470,153500760,4,0,1,2560,6,7483059398
3017,153604700,99476,153704176,7,0,0,26624,18,8113546632
3018,153611560,4420,153615980,4,0,1,11776,6,1451715658
3019,153627470,60824,153688294,2,0,0,5632,4,9814699780
3020,153687309,61375,153748684,0,0,0,4096,10,4340199448
3021,153739090,5196,153744286,0,0,1,13312,10,6272801311
3022,153777980,2946,153780926,7,0,1,3072,18,1644587100
3023,153833580,162978,153996558,7,0,0,8704,18,8045408080
3024,153894520,99008,153993528,4,0,0,25088,6,8031176471
3025,153991250,15095,154006345,1,0,1,21504,14,8115126351
3026,154022530,25187,154047717,9,0,1,45568,10,8449098548
3027,154060601,14804,154075405,6,0,1,28672,9,319568844
3028,154069560,90917,154160477,7,0,0,5120,18,5069179083
3029,154074720,173234,154247954,2,0,0,6656,4,3503528024
3030,154276510,2946,154279456,7,0,1,3072,18,6236129597
3031,154308189,76052,154384241,0,0,0,10240,10,4366246852
3032,154487650,97292,154584942,3,0,0,19456,9,3524412249
3033,154521800,103532,154625332,6,0,0,39936,9,5081665786
3034,154622240,116132,154738372,8,0,0,71168,12,3899789835
3035,154790420,104780,154895200,8,0,0,44032,12,2492620955
3036,154914670,106652,155021322,8,0,0,50176,12,6655871178
3037,155049230,10757,155059987,8,0,1,17408,12,4131974649
3038,155138890,78056,155216946,6,0,0,11776,9,2887496477
3039,155175300,1994,155177294,7,0,1,2048,18,1414249746
3040,155216749,88421,155305170,9,0,0,19968,10,3931950181
3041,155350500,74360,155424860,6,0,0,9728,9,616875787
3042,155446840,74228,155521068,7,0,0,14336,18,9690653994
3043,155485769,107432,155593201,9,0,0,52736,10,54577484
3044,155536090,104208,155640298,9,0,1,169472,10,6607163546
3045,155585610,144502,155730112,9,0,0,13824,10,6484935399
3046,155590380,164937,155755317,5,0,0,20992,11,7934753630
3047,155631239,160037,155791276,0,0,0,53248,10,1581468872
3048,155666790,98587,155765377,6,0,0,3072,9,4393570621
3049,155807440,3422,155810862,7,0,1,3584,18,514036512
3050,156005399,66524,156071923,0,0,0,9216,10,1896519346
3051,156114330,72668,156186998,5,0,0,9216,11,3389660137
3052,156129081,11274,156140355,6,0,1,18432,9,1100789864
3053,156176760,23120,156199880,4,0,1,41472,6,2140504964
3054,156202120,1042,156203162,0,0,1,1024,10,4734244393
3055,156253690,4162,156257852,0,0,1,11264,10,4419477405
3056,156359600,90056,156449656,7,0,0,15872,18,9614485049
3057,156403530,2870,156406400,8,0,1,8704,12,568076101
3058,156411770,566,156412336,0,0,1,512,10,9755793728
3059,156417510,153827,156571337,5,0,0,28672,11,10011676886
3060,156451230,72863,156524093,2,0,0,9728,4,6591386712
3061,156578770,112416,156691186,5,0,0,9728,11,4626250330
3062,156614150,67592,156681742,2,0,0,7680,4,2895232015
3063,156655110,52364,156707474,8,0,0,3072,12,7051046035
3064,156734220,77924,156812144,4,0,0,16384,6,1827272652
3065,156757740,72506,156830246,8,0,0,4096,12,10611756468
3066,156783709,99331,156883040,9,0,0,19968,10,1061849228
3067,156889420,109460,156998880,3,0,0,59392,9,9346387238
3068,156997270,4072,157001342,1,0,1,2560,14,1688706073
3069,157001001,1042,157002043,5,0,1,1024,11,4086422491
3070,157177669,104312,157281981,0,0,0,42496,10,9728912399
3071,157194990,47756,157242746,6,0,0,3072,9,10070510744
3072,157216200,96524,157312724,3,0,0,14848,9,3863908706
3073,157271800,91769,157363569,7,0,0,13312,18,5274502459
3074,157289790,139467,157429257,7,0,0,67584,18,7717241659
3075,157425790,99083,157524873,8,0,0,24064,12,6506823295
3076,157446130,68729,157514859,3,0,0,10240,9,1108857688
3077,157492600,83312,157575912,3,0,0,18944,9,7057021030
3078,157578941,4374,157583315,5,0,1,4608,11,4075648810
3079,157609991,11016,157621007,5,0,1,17920,11,3972177969
3080,157741240,83468,157824708,7,0,0,19456,18,1687492137
3081,157885660,13600,157899260,7,0,1,23040,18,8952967113
3082,157887530,59304,157946834,3,0,0,512,9,1838749028
3083,157894551,5580,157900131,5,0,1,12288,11,9627738196
3084,157943610,11791,157955401,7,0,1,19456,18,115426434
3085,158073460,78548,158152008,3,0,0,18432,9,4643814858
3086,158147150,53830,158200980,5,0,0,2048,11,1346178920
3087,158165560,16096,158181656,9,0,1,31232,10,9770537647
3088,158427171,2470,158429641,6,0,1,2560,9,7749860097
3089,158456870,113360,158570230,6,0,0,72192,9,3389411424
3090,158464210,145968,158610178,8,0,0,41984,12,3399401142
3091,158602010,110600,158712610,7,0,0,36352,18,9803791627
3092,158621240,4374,158625614,4,0,1,4608,6,10172398713
3093,158690670,71188,158761858,2,0,0,9216,4,3863722807
3094,158742340,47288,158789628,8,0,0,1536,12,8298878306
3095,158831729,59132,158890861,0,0,0,5120,10,8620537454
3096,158843690,59132,158902822,7,0,0,5120,18,153713195
3097,158906730,109616,159016346,3,0,0,59904,9,3334877150
3098,158954600,30491,158985091,9,0,1,49152,10,7586318992
3099,158958910,84992,159043902,4,0,0,13824,6,8883905363
3100,158989850,55807,159045657,8,0,0,2560,12,3457978749
3101,159021529,133142,159154671,0,0,0,51712,10,7131385760
3102,159035599,268467,159304066,0,0,0,75264,10,1193106737
3103,159064790,153902,159218692,7,0,0,23040,18,8415360294
3104,159080970,113173,159194143,6,0,0,11776,9,306946513
3105,159084980,105560,159190540,5,0,0,46592,11,5202939434
3106,159123680,5802,159129482,1,0,1,6144,14,9292620104
3107,159159460,5712,159165172,1,0,1,14336,14,2359514061
3108,159186659,117890,159304549,9,0,0,1536,10,2951575351
3109,159296330,110651,159406981,9,0,0,36352,10,9522634511
3110,159314020,105300,159419320,3,0,0,40448,9,6124674216
3111,159390440,74488,159464928,2,0,0,6656,4,10100527377
3112,159449320,33333,159482653,9,0,1,54784,10,1443427579
3113,159504620,54817,159559437,4,0,0,512,6,8270624848
3114,159599240,123569,159722809,4,0,0,52224,6,8599136532
3115,159665380,5326,159670706,4,0,1,5632,6,1425068697
3116,159709279,90042,159799321,0,0,0,11776,10,1798836349
3117,159731519,149185,159880704,0,0,0,15872,10,2195666635
3118,159738430,65900,159804330,3,0,0,7168,9,1402050881
3119,159800230,64208,159864438,8,0,0,6656,12,6203881632
3120,159801960,87138,159889098,6,0,0,20992,9,8748527907
3121,160065070,5802,160070872,8,0,1,6144,12,2973384052
3122,160069420,183073,160252493,6,0,0,4096,9,192132401
3123,160082739,110436,160193175,0,0,0,52736,10,3749986346
3124,160085100,115110,160200210,2,0,0,23040,4,4513853182
3125,160106870,136299,160243169,6,0,0,13824,9,5385829919
3126,160113860,13770,160127630,8,0,1,26624,12,10647244399
3127,160186670,162872,160349542,4,0,0,18432,6,8651996559
3128,160323080,62516,160385596,6,0,0,6144,9,7747506057
3129,160337280,21141,160358421,9,0,1,34304,10,6130598303
3130,160339550,113828,160453378,6,0,0,40960,9,1896386315
3131,160518570,12737,160531307,1,0,1,24576,14,2290405493
3132,160641060,77900,160718960,5,0,0,11264,11,6842982120
3133,160685740,233766,160919506,9,0,1,378368,10,3955353651
3134,160692090,380284,161072374,4,0,0,16896,6,2890669451
3135,160719350,298758,161018108,7,0,0,4608,18,5432524933
3136,160796550,181252,160977802,5,0,0,10752,11,9004455393
3137,160807519,292231,161099750,0,0,0,79872,10,679132807
3138,160813690,106162,160919852,1,0,1,512,14,6897852034
3139,160818210,311755,161129965,3,0,0,24064,9,2055743955
3140,160895160,172051,161067211,4,0,0,16384,6,6868288318
3141,160897590,324457,161222047,3,0,0,98304,9,3979651223
3142,161118030,73825,161191855,3,0,0,2560,9,10561629609
3143,161239100,60380,161299480,5,0,0,9216,11,6697963475
3144,161242590,4850,161247440,8,0,1,5120,12,8404992179
3145,161274060,48466,161322526,5,0,0,3072,11,9642558905
3146,161466330,112736,161579066,5,0,0,70144,11,5333991301
3147,161503130,135390,161638520,5,0,0,32256,11,1841147863
3148,161538430,3422,161541852,8,0,1,3584,12,8055184226
3149,161550600,111974,161662574,3,0,0,44544,9,4816823116
3150,161612670,80228,161692898,3,0,0,10752,9,5051480209
3151,161669530,105092,161774622,2,0,0,45056,4,3000037025
3152,161728691,25704,161754395,2,0,1,46592,4,7723828299
3153,161744850,146722,161891572,9,0,0,25600,10,5294908765
3154,161855370,108784,161964154,7,0,0,35840,18,1361697341
3155,162007759,65924,162073683,0,0,0,12288,10,2333348434
3156,162045900,98384,162144284,5,0,0,23040,11,9756429520
3157,162080620,92182,162172802,2,0,0,4608,4,3509962722
3158,162197560,13858,162211418,1,0,1,23552,14,8456798435
3159,162263250,6488,162269738,7,0,1,15872,18,8558255699
3160,162297339,81464,162378803,0,0,0,17920,10,10410437550
3161,162297660,5326,162302986,1,0,1,5632,14,9815380546
3162,162309790,54056,162363846,6,0,0,3584,9,5599093576
3163,162321460,3422,162324882,0,0,1,3584,10,1353789177
3164,162323770,100987,162424757,8,0,0,16384,12,8036847051
3165,162421540,66037,162487577,6,0,0,7168,9,10344036409
3166,162471010,96980,162567990,4,0,0,18432,6,7866067421
3167,162673150,98852,162772002,1,0,0,24576,14,8439209563
3168,162705751,157329,162863080,2,0,1,259584,4,1381062290
3169,162776350,203946,162980296,3,0,0,7168,9,6619006384
3170,162849270,156325,163005595,3,0,0,12800,9,9881414821
3171,162852469,239754,163092223,0,0,0,54784,10,3971115999
3172,162852889,202800,163055689,0,0,0,9728,10,6005842851
3173,162871540,170899,163042439,3,0,0,7168,9,7671563875
3174,162886440,358406,163244846,7,0,0,32256,18,10270861229
3175,162923790,7230,162931020,0,0,1,7680,10,2138986445
3176,162929380,180141,163109521,8,0,0,25088,12,6652517019
3177,162933760,75812,163009572,9,0,1,127488,10,10586990841
3178,162978430,166221,163144651,5,0,0,8192,11,167869875
3179,163076109,98326,163174435,0,0,0,15360,10,5110473319
3180,163137610,153736,163291346,4,0,0,23552,6,3752549524
3181,163183210,190647,163373857,9,0,0,1536,10,2393901170
3182,163191680,213443,163405123,9,0,0,12288,10,2561622660
3183,163204671,86690,163291361,2,0,1,131584,4,10665040125
3184,163215890,199805,163415695,3,0,0,6656,9,3042406551
3185,163399979,61669,163461648,0,0,0,8192,10,2357575412
3186,163441910,79748,163521658,3,0,0,12288,9,10206459781
3187,163549140,566,163549706,8,0,1,512,12,2887378797
3188,163551849,60380,163612229,0,0,0,9216,10,2126461845
3189,163566890,147691,163714581,4,0,0,59392,6,728499694
3190,163625890,6278,163632168,9,0,1,6656,10,4032680930
3191,163626770,193650,163820420,6,0,0,38912,9,5616038650
3192,163635740,84940,163720680,4,0,0,19968,6,4791622183
3193,163716550,91999,163808549,4,0,0,14848,6,5747530610
3194,163777880,131708,163909588,3,0,0,37888,9,7639919431
3195,163797040,5712,163802752,8,0,1,14336,12,1065512960
3196,163887860,97448,163985308,7,0,0,19968,18,1354111549
3197,163973700,82820,164056520,3,0,0,12288,9,9653285728
3198,164031700,4679,164036379,1,0,1,12288,14,8589237294
3199,164164470,54056,164218526,6,0,0,3584,9,255537577
3200,164186900,85472,164272372,7,0,0,20992,18,8840725515
3201,164264830,102284,164367114,7,0,0,35840,18,2435288632
3202,164375940,108680,164484620,7,0,0,56832,18,7142892586
3203,164385750,99361,164485111,7,0,0,1536,18,2240813627
3204,164452260,91508,164543768,8,0,0,11776,12,9155312953
3205,164469990,126145,164596135,3,0,0,35840,9,5304966990
3206,164537600,47600,164585200,8,0,0,2560,12,2700641980
3207,164610010,1994,164612004,4,0,1,2048,6,9001366741
3208,164735530,72668,164808198,2,0,0,9216,4,6792458372
3209,164844411,7706,164852117,6,0,1,8192,9,5800983636
3210,164979730,77612,165057342,2,0,0,15360,4,6583621779
3211,165225620,103376,165328996,8,0,0,39424,12,2407699891
3212,165288760,110076,165398836,8,0,0,14336,12,2714355144
3213,165317400,16981,165334381,8,0,1,5632,12,10643050133
3214,165318720,57581,165376301,2,0,0,1536,4,6203472107
3215,165319700,17587,165337287,8,0,1,4608,12,1556669395
3216,165319850,108557,165428407,6,0,0,31232,9,4993129471
3217,165370610,156413,165527023,3,0,0,50176,9,9109084402
3218,165389450,165662,165555112,3,0,0,26624,9,3241632900
3219,165459550,87435,165546985,6,0,0,8704,9,2045682255
3220,165507560,102128,165609688,3,0,0,35328,9,2843237326
3221,165627549,74072,165701621,0,0,0,13824,10,8149703411
3222,165697060,4576,165701636,0,0,1,512,10,8193722443
3223,165748101,71766,165819867,2,0,1,116224,4,5678651
3224,165801740,19113,165820853,7,0,1,1536,18,86851902
3225,165810960,13119,165824079,1,0,1,5120,14,464394874
3226,165847171,2470,165849641,2,0,1,2560,4,438666903
3227,165874370,179986,166054356,4,0,0,26624,6,5952374972
3228,165888680,177258,166065938,4,0,0,3584,6,9793685019
3229,165900730,110409,166011139,2,0,0,10752,4,1497521454
3230,165903690,54056,165957746,4,0,0,3584,6,4957799747
3231,165939510,125313,166064823,2,0,0,34304,4,9404802802
3232,166049560,122375,166171935,9,0,0,51712,10,8717294929
3233,166102400,73825,166176225,4,0,0,9216,6,5326169374
3234,166111910,116593,166228503,3,0,0,13312,9,2548567752
3235,166161540,14700,166176240,1,0,1,3072,14,2120645066
3236,166162060,91956,166254016,5,0,0,11776,11,61724808
3237,166173160,3095,166176255,4,0,1,8704,6,4007637782
3238,166207749,75102,166282851,0,0,0,13824,10,6528354124
3239,166224850,6515,166231365,4,0,1,8704,6,7527348755
3240,166240150,67103,166307253,7,0,0,2048,18,2025105041
3241,166323350,45596,166368946,5,0,0,1024,11,10516626043
3242,166463691,5971,166469662,5,0,1,14848,11,1801629155
3243,166497210,47288,166544498,4,0,0,1536,6,5582136126
3244,166528170,6229,166534399,7,0,1,15360,18,1137267931
3245,166771480,122096,166893576,4,0,0,100864,6,6331794008
3246,166830580,130148,166960728,7,0,0,26624,18,1019581313
3247,166881770,144904,167026674,8,0,0,30208,12,4909168769
3248,166936400,52520,166988920,7,0,0,3584,18,4029090072
3249,166939870,127256,167067126,9,0,0,41984,10,4088819524
3250,167055620,72322,167127942,4,0,0,5632,6,6888208402
3251,167129420,98696,167228116,9,0,0,24064,10,9075323382
3252,167140671,87460,167228131,2,0,1,138240,4,796940122
3253,167181760,61304,167243064,3,0,0,8704,9,6355996275
3254,167244530,126237,167370767,2,0,0,13824,4,5861410744
3255,167271829,114634,167386463,9,0,0,19968,10,785827970
3256,167337640,58465,167396105,5,0,0,5120,11,2445463002
3257,167379420,82820,167462240,8,0,0,12288,12,3670190919
3258,167449480,3387,167452867,1,0,1,9728,14,5555697666
3259,167554899,92708,167647607,0,0,0,24576,10,2287708003
3260,167592831,1994,167594825,6,0,1,2048,9,3754136681
3261,167600430,110496,167710926,6,0,0,13312,9,7902910558
3262,167615700,2470,167618170,7,0,1,2560,18,4199474101
3263,167688840,134301,167823141,4,0,0,38912,6,1534024099
3264,167738990,103844,167842834,4,0,0,40960,6,10524267075
3265,167762240,3898,167766138,8,0,1,4096,12,5103366421
3266,167783260,59589,167842849,9,0,1,83456,10,8174258735
3267,167818430,118732,167937162,2,0,0,14336,4,3748201953
3268,167836120,215646,168051766,8,0,0,16896,12,1419782724
3269,167906150,78214,167984364,3,0,0,16896,9,9528502507
3270,167908960,158904,168067864,1,0,0,8704,14,7592010096
3271,167933980,131217,168065197,2,0,0,44032,4,7232982949
3272,168119500,91904,168211404,9,0,0,16896,10,6095814880
3273,168175979,100100,168276079,0,0,0,28672,10,6664581558
3274,168188670,62516,168251186,9,0,0,6144,10,9099834537
3275,168213420,155477,168368897,2,0,0,1536,4,2579551008
3276,168251310,117104,168368414,3,0,0,84480,9,588341187
3277,168302961,6488,168309449,6,0,1,15872,9,4386914450
3278,168321250,74520,168395770,9,0,1,124928,10,6281749657
3279,168345170,120855,168466025,8,0,0,18944,12,7364125565
3280,168368990,222282,168591272,3,0,0,9216,9,3278257960
3281,168439410,103148,168542558,3,0,0,11776,9,8292792195
3282,168567630,98540,168666170,9,0,0,23552,10,8534830484
3283,168592910,104936,168697846,5,0,0,44544,11,4641808066
3284,168701550,43904,168745454,5,0,0,512,11,4179851809
3285,168843490,50672,168894162,2,0,0,2560,4,3069202224
3286,168876880,1518,168878398,7,0,1,1536,18,504365048
3287,168880030,106340,168986370,4,0,0,49152,6,9727569744
3288,168881430,132270,169013700,6,0,0,6656,9,8832353120
3289,169257789,102440,169360229,0,0,0,36352,10,1765743278
3290,169335209,112892,169448101,0,0,0,70656,10,7839433197
3291,169356580,113991,169470571,4,0,0,7168,6,200169480
3292,169569810,62516,169632326,8,0,0,6144,12,9644253415
3293,169706661,13600,169720261,5,0,1,23040,11,183564419
3294,169748290,108368,169856658,2,0,0,55808,4,8873769180
3295,169774690,178424,169953114,8,0,0,7168,12,8133726752
3296,169800900,128808,169929708,7,0,0,67584,18,10213023491
3297,169807090,125129,169932219,5,0,0,8192,11,7137500022
3298,169897490,84904,169982394,9,0,1,141824,10,8954958055
3299,169909219,226506,170135725,0,0,0,105984,10,7195886002
3300,169965660,18680,169984340,8,0,1,3072,12,8158124328
3301,170010650,186225,170196875,5,0,0,50176,11,8797826399
3302,170030420,108448,170138868,5,0,0,10240,11,824574484
3303,170050070,105953,170156023,7,0,0,5120,18,5387083286
3304,170085940,158725,170244665,7,0,0,14336,18,8157391197
3305,170120871,21084,170141955,5,0,1,9216,11,10452257155
3306,170186950,21191,170208141,0,0,1,18432,10,6532621075
3307,170231990,137112,170369102,7,0,0,43008,18,8493086415
3308,170296680,1518,170298198,1,0,1,1536,14,1813944101
3309,170426590,62516,170489106,5,0,0,6144,11,5481949771
3310,170511810,111644,170623454,5,0,0,66560,11,7155034464
3311,170557180,106762,170663942,9,0,0,5632,10,4298718481
3312,170559549,77315,170636864,0,0,0,3584,10,7118171277
3313,170615520,131144,170746664,4,0,0,49152,6,2243736317
3314,170624111,2870,170626981,5,0,1,8704,11,3231956379
3315,170734730,110778,170845508,8,0,0,24576,12,8482247604
3316,170735760,154502,170890262,8,0,0,29184,12,2899298000
3317,171051590,81128,171132718,7,0,0,11776,18,10130554238
3318,171059550,81424,171140974,2,0,0,3584,4,3858120319
3319,171121780,62540,171184320,8,0,0,11264,12,3910220980
3320,171139731,1258,171140989,5,0,1,512,11,2722042720
3321,171198020,81908,171279928,3,0,0,14336,9,5012365351
3322,171201500,10499,171211999,8,0,1,16896,12,7770032198
3323,171237410,71708,171309118,4,0,0,8192,6,6757416724
3324,171312509,114684,171427193,0,0,0,18944,10,4088487750
3325,171324239,63888,171388127,0,0,0,512,10,1384891454
3326,171461719,98852,171560571,0,0,0,24576,10,780168094
3327,171541770,55748,171597518,9,0,0,4096,10,859993485
3328,171582170,50672,171632842,2,0,0,2560,4,6211158310
3329,171646869,55748,171702617,0,0,0,4096,10,468671000
3330,171713430,70976,171784406,9,0,0,8704,10,5111072550
3331,171806500,87476,171893976,6,0,0,22528,9,2188270124
3332,171821430,566,171821996,7,0,1,512,18,7247795583
3333,171922020,91148,172013168,7,0,0,19456,18,9471180146
3334,171981900,84512,172066412,2,0,0,12800,4,1345500098
3335,172021920,106496,172128416,5,0,0,49664,11,2218234722
3336,172033580,59394,172092974,7,0,0,3072,18,8342655167
3337,172068670,60385,172129055,7,0,0,2048,18,6958748658
3338,172173250,59132,172232382,2,0,0,5120,4,10005292132
3339,172215901,7230,172223131,5,0,1,7680,11,4539879666
3340,172243100,99320,172342420,4,0,0,26112,6,10151391609
3341,172249950,216526,172466476,4,0,0,53248,6,6436576688
3342,172290810,239470,172530280,9,0,0,18432,10,2757851114
3343,172391670,78253,172469923,8,0,0,11264,12,2977655949
3344,172412070,102334,172514404,8,0,0,6656,12,2002900769
3345,172636770,194987,172831757,9,0,1,319488,10,3900081241
3346,172641129,443915,173085044,0,0,0,66048,10,4588535249
3347,172648960,232747,172881707,1,0,0,22016,14,2103143931
3348,172656570,308990,172965560,4,0,0,6144,6,6302527858
3349,172657059,365938,173022997,0,0,0,10240,10,7039521466
3350,172663630,190149,172853779,9,0,0,6656,10,1052961261
3351,172666280,226468,172892748,3,0,0,6656,9,9720008121
3352,172773050,175284,172948334,9,0,0,6656,10,5230784782
3353,172793230,343532,173136762,9,0,0,31744,10,3395157514
3354,172799150,220712,173019862,3,0,0,18944,9,9886754272
3355,172805790,232213,173038003,2,0,0,15872,4,2477482363
3356,172809380,223772,173033152,5,0,0,33280,11,7775264262
3357,172821470,342934,173164404,4,0,0,6656,6,9344451586
3358,172825770,280828,173106598,4,0,0,6144,6,8183565446
3359,172851720,310641,173162361,2,0,0,83968,4,6686235154
3360,173032390,210851,173243241,6,0,0,37376,9,7013851
3361,173120141,2470,173122611,5,0,1,2560,11,6891828239
3362,173158580,164201,173322781,5,0,0,30720,11,2648511959
3363,173224380,165181,173389561,9,0,0,88576,10,9191817918
3364,173295410,138083,173433493,6,0,0,8704,9,7676072678
3365,173391830,68909,173460739,8,0,0,1024,12,9096482060
3366,173404760,5454,173410214,8,0,1,13824,12,4351493620
3367,173527460,2946,173530406,0,0,1,3072,10,7330425987
3368,173561530,4162,173565692,4,0,1,11264,6,5508145722
3369,173585730,2946,173588676,0,0,1,3072,10,7250072617
3370,173622950,58220,173681170,9,0,0,7168,10,3581903542
3371,173629319,216285,173845604,0,0,0,36864,10,5465062109
3372,173633200,80996,173714196,2,0,0,16384,4,6137921479
3373,173651700,100724,173752424,3,0,0,30720,9,3728605193
3374,173715960,12566,173728526,4,0,1,20992,6,6846136165
3375,173790210,1994,173792204,8,0,1,2048,12,3428187453
3376,173795800,148288,173944088,2,0,0,60416,4,9930539872
3377,173836420,254620,174091040,8,0,0,101888,12,3097513276
3378,173866570,140200,174006770,1,0,0,23040,14,2929996629
3379,173896120,74032,173970152,2,0,0,2560,4,5158473714
3380,173926900,30192,173957092,4,0,1,25088,6,2532766808
3381,173928910,165733,174094643,2,0,0,11776,4,10641277813
3382,173974210,126220,174100430,1,0,0,18944,14,8251995079
3383,173989200,169553,174158753,8,0,0,11776,12,7204461692
3384,174027070,128080,174155150,3,0,0,57344,9,7630762688
3385,174150570,75011,174225581,6,0,0,10240,9,4720055896
3386,174293110,76052,174369162,9,0,0,10240,10,8349884037
3387,174297780,81128,174378908,6,0,0,11776,9,8498071909
3388,174302240,70976,174373216,7,0,0,8704,18,9484067755
3389,174369090,98448,174467538,7,0,0,23040,18,10058162199
3390,174386889,133857,174520746,0,0,0,36352,10,9735957514
3391,174394650,88709,174483359,2,0,0,512,4,10438164826
3392,174642340,14287,174656627,1,0,1,27648,14,2558219649
3393,174651450,237823,174889273,6,0,0,17408,9,415123579
3394,174668340,296167,174964507,8,0,0,36352,12,3866536288
3395,174731340,3422,174734762,1,0,1,3584,14,9593208599
3396,174741689,59132,174800821,0,0,0,5120,10,8616491454
3397,174813870,102752,174916622,9,0,0,37376,10,838036398
3398,174859750,140643,175000393,2,0,0,16896,4,8795569550
3399,174937060,128680,175065740,2,0,0,19968,4,4835066919
3400,174961370,121559,175082929,2,0,0,13312,4,7684702435
3401,174968670,108317,175076987,8,0,0,36864,12,7296991822
3402,174984969,74672,175059641,0,0,0,10752,10,9019789225
3403,175024550,212624,175237174,4,0,0,12800,6,2359177613
3404,175029460,159374,175188834,5,0,0,56320,11,194178934
3405,175054561,22441,175077002,6,0,1,7680,9,7268046749
3406,175079300,150462,175229762,1,0,0,3072,14,8961989118
3407,175340290,3898,175344188,4,0,1,4096,6,6526257388
3408,175362090,101816,175463906,5,0,0,34304,11,9004858199
3409,175372170,94715,175466885,7,0,0,9728,18,4857683868
3410,175372380,2946,175375326,8,0,1,3072,12,7972196411
3411,175437610,12308,175449918,0,0,1,20480,10,2902184059
3412,175551490,24154,175575644,9,0,1,43520,10,2202014524
3413,175567340,68060,175635400,1,0,0,9216,14,4928451247
3414,175650410,59132,175709542,3,0,0,5120,9,4629825027
3415,175651140,44710,175695850,6,0,0,512,9,3666094504
3416,175697960,116774,175814734,5,0,0,50688,11,3856327398
3417,175721320,115194,175836514,6,0,0,11264,9,2596743718
3418,175944250,82976,176027226,7,0,0,12800,18,6377771269
3419,175964690,4374,175969064,9,0,1,4608,10,7543613651
3420,176141080,10757,176151837,9,0,1,17408,10,4494357867
3421,176148590,3503,176152093,4,0,1,9216,6,2054837692
3422,176153530,67460,176220990,3,0,0,12288,9,7935553011
3423,176208899,86204,176295103,0,0,0,13312,10,9533644446
3424,176212710,124051,176336761,2,0,0,5632,4,8071561061
3425,176270970,108368,176379338,9,0,0,55808,10,6359011768
3426,176319360,134588,176453948,1,0,0,72704,14,6741884318
3427,176355210,115544,176470754,6,0,0,19456,9,6571151143
3428,176406570,106946,176513516,8,0,0,18944,12,8054082541
3429,176565670,5971,176571641,0,0,1,14848,10,8823607146
3430,176625820,67592,176693412,1,0,0,7680,14,3924337160
3431,176706730,75296,176782026,9,0,0,12800,10,9587254793
3432,176709570,170216,176879786,5,0,0,142848,11,5723026592
3433,176843560,138970,176982530,3,0,0,37376,9,10537973272
3434,176888790,53300,176942090,9,0,0,6144,10,8616979158
3435,176939690,55146,176994836,8,0,0,1024,12,4928533047
3436,176942900,64704,177007604,8,0,0,1024,12,7095546519
3437,176981150,83124,177064274,9,0,0,13824,10,946408796
3438,177079280,47288,177126568,8,0,0,1536,12,10202334856
3439,177114860,6229,177121089,9,0,1,15360,10,2355862894
3440,177127030,50672,177177702,3,0,0,2560,9,9942769454
3441,177154280,73720,177228000,4,0,0,10240,6,2624307388
3442,177267629,105560,177373189,0,0,0,46592,10,1746326793
3443,177269980,4374,177274354,9,0,1,4608,10,9473601373
3444,177270440,133949,177404389,4,0,0,17920,6,5533849668
3445,177305100,82975,177388075,8,0,0,3584,12,9164204249
3446,177372200,95069,177467269,7,0,0,24064,18,2151300013
3447,177451530,102440,177553970,2,0,0,36352,4,3776422073
3448,177493100,112254,177605354,1,0,0,6144,14,5237909600
3449,177516800,114390,177631190,2,0,0,45568,4,283150236
3450,177621520,112258,177733778,6,0,0,36864,9,1881708594
3451,177660030,140234,177800264,6,0,0,57344,9,3004303942
3452,177693099,140483,177833582,0,0,0,20480,10,5305928085
3453,177760410,100646,177861056,8,0,0,8704,12,6373105555
3454,177879920,111176,177991096,2,0,0,65024,4,2308909979
3455,177883860,123631,178007491,1,0,0,53760,14,5322858513
3456,177962400,85748,178048148,9,0,0,10240,10,6110573595
3457,177998540,56231,178054771,5,0,0,1536,11,8444554869
3458,178018830,76832,178095662,1,0,0,12800,14,10077901191
3459,178155940,96668,178252608,8,0,0,17408,12,9800059099
3460,178180570,1042,178181612,1,0,1,1024,14,5737576179
3461,178378090,99320,178477410,1,0,0,26112,14,9811137262
3462,178434910,66368,178501278,6,0,0,8704,9,3561929532
3463,178493760,67592,178561352,5,0,0,7680,11,2835852235
3464,178497890,47288,178545178,8,0,0,1536,12,6188675852
3465,178528240,75862,178604102,5,0,0,10752,11,645835480
3466,178585140,59132,178644272,3,0,0,5120,9,3423836910
3467,178678950,77300,178756250,4,0,0,14336,6,8581639892
3468,178718080,100256,178818336,7,0,0,29184,18,4196409383
3469,178843290,96040,178939330,8,0,0,1024,12,6619863327
3470,178849190,110396,178959586,4,0,0,62464,6,8031744959
3471,178857899,162329,179020228,0,0,0,48640,10,4952892810
3472,179153530,59132,179212662,4,0,0,5120,6,6213726560
3473,179258361,3645,179262006,5,0,1,10240,11,7256737615
3474,179276600,6278,179282878,9,0,1,6656,10,6561861087
3475,179296600,97760,179394360,3,0,0,20992,9,5009615517
3476,179313390,67904,179381294,4,0,0,8704,6,1532782942
3477,179357159,136920,179494079,9,0,0,38912,10,6279615982
3478,179362310,151521,179513831,2,0,0,58368,4,5103340053
3479,179368500,4937,179373437,0,0,1,12800,10,8693583362
3480,179502940,112075,179615015,4,0,0,32256,6,1913083243
3481,179528170,106663,179634833,7,0,0,25600,18,4219185398
3482,179686970,104000,179790970,8,0,0,41472,12,946229013
3483,179693670,78080,179771750,4,0,0,16896,6,3833792939
3484,179823100,101036,179924136,4,0,0,31744,6,6832628157
3485,179842310,61916,179904226,5,0,0,9216,11,3052114968
3486,180031380,68840,180100220,6,0,0,11776,9,9229371661
3487,180074720,4374,180079094,1,0,1,4608,14,8528916840
3488,180134930,100256,180235186,6,0,0,29184,9,5723289381
3489,180203480,43904,180247384,3,0,0,512,9,5782666881
3490,180342110,105716,180447826,8,0,0,47104,12,2112214390
3491,180348760,61230,180409990,2,0,0,3584,4,6642221677
3492,180353660,73760,180427420,8,0,0,12800,12,8955166741
3493,180391360,7230,180398590,0,0,1,7680,10,1664264012
3494,180462430,81752,180544182,6,0,0,13824,9,3521725787
3495,180497630,60824,180558454,2,0,0,5632,4,4575246570
3496,180499810,85896,180585706,1,0,0,19456,14,2607738096
3497,180629659,76676,180706335,9,0,0,12288,10,9420960104
3498,180663200,54524,180717724,7,0,0,5120,18,5038016283
3499,180698960,7390,180706350,7,0,1,7168,18,2394761108
3500,180718210,122096,180840306,4,0,0,100864,6,10480000971
3501,180732401,2870,180735271,5,0,1,8704,11,8291117477
3502,180806500,100022,180906522,1,0,0,23552,14,5663890431
3503,180854590,128266,180982856,9,0,0,26624,10,3537336332
3504,180879800,79460,180959260,9,0,0,16384,10,9831336273
3505,181170050,103376,181273426,8,0,0,39424,12,798314085
3506,181224300,110396,181334696,6,0,0,62464,9,9956947111
3507,181449590,104156,181553746,2,0,0,41984,4,4865907507
3508,181514720,93141,181607861,4,0,0,25088,6,2449442312
3509,181517070,83132,181600202,3,0,0,13312,9,7963814811
3510,181563130,113364,181676494,7,0,0,38400,18,6907920670
3511,181593910,60980,181654890,4,0,0,6144,6,8585792977
3512,181673410,95760,181769170,5,0,0,19456,11,5238967297
3513,181683500,3904,181687404,7,0,1,10752,18,6622755796
3514,181720109,113141,181833250,0,0,0,10752,10,9627066263
3515,181834560,1518,181836078,0,0,1,1536,10,4437845958
3516,181860430,155477,182015907,5,0,0,3584,11,6116148208
3517,181861190,104000,181965190,8,0,0,41472,12,8895950865
3518,181961880,56446,182018326,1,0,0,5632,14,8201570486
3519,181973951,4374,181978325,5,0,1,4608,11,9611498850
3520,181978460,101348,182079808,2,0,0,32768,4,5024108816
3521,182055370,216675,182272045,9,0,0,47104,10,516657539
3522,182090330,110994,182201324,1,0,0,61952,14,5310581270
3523,182106060,151618,182257678,3,0,0,88064,9,1381551800
3524,182210700,120808,182331508,7,0,0,54784,18,1126469382
3525,182340210,70976,182411186,1,0,0,8704,14,2755780905
3526,182386670,54056,182440726,7,0,0,3584,18,8648476220
3527,182573561,2870,182576431,2,0,1,8704,4,1623877201
3528,182593649,99944,182693593,0,0,0,28160,10,8460355673
3529,182594130,57440,182651570,9,0,0,4608,10,9697352914
3530,182628030,99164,182727194,1,0,0,25600,14,9473358288
3531,182716670,86204,182802874,6,0,0,13312,9,5746314594
3532,182746790,65900,182812690,1,0,0,7168,14,2912208625
3533,182768610,167518,182936128,8,0,0,55808,12,2426241867
3534,182797040,76052,182873092,4,0,0,10240,6,7327955049
3535,182879570,105248,182984818,5,0,0,45568,11,10381020421
3536,182889500,112070,183001570,1,0,0,14848,14,8941380939
3537,182902140,85041,182987181,1,0,0,7680,14,10289567423
3538,182977110,112168,183089278,6,0,0,43008,9,577021448
3539,183015030,132358,183147388,3,0,0,46080,9,1008620506
3540,183017490,4162,183021652,4,0,1,11264,6,1053035439
3541,183079890,98860,183178750,8,0,0,24064,12,2532799589
3542,183104341,566,183104907,5,0,1,512,11,5260398402
3543,183218751,5971,183224722,5,0,1,14848,11,4525506463
3544,183243020,64676,183307696,8,0,0,8192,12,7549949242
3545,183283280,55748,183339028,7,0,0,4096,18,6617475421
3546,183363269,63296,183426565,0,0,0,8704,10,5562795634
3547,183440720,106451,183547171,9,0,0,48640,10,5195269993
3548,183459669,165409,183625078,0,0,0,72192,10,3635043997
3549,183479101,4679,183483780,2,0,1,12288,4,3845043944
3550,183491330,61137,183552467,5,0,0,3584,11,9920748337
3551,183505720,13770,183519490,1,0,1,26624,14,1922949736
3552,183520260,5326,183525586,0,0,1,5632,10,343173028
3553,183578480,566,183579046,0,0,1,512,10,3147999040
3554,183590310,131765,183722075,8,0,0,29184,12,6881531347
3555,183599840,25253,183625093,1,0,1,4096,14,1225096471
3556,183702820,96899,183799719,5,0,0,11264,11,8143693628
3557,183716101,9388,183725489,6,0,1,3584,9,3835249857
3558,183801520,101348,183902868,2,0,0,32768,4,1902355615
3559,183817740,67592,183885332,6,0,0,7680,9,13929960
3560,183826160,139534,183965694,1,0,0,26112,14,9868549061
3561,183872720,67240,183939960,4,0,0,1024,6,1867352759
3562,183919330,98720,184018050,1,0,0,29184,14,7449760510
3563,183927300,3645,183930945,4,0,1,10240,6,855957421
3564,184022010,120638,184142648,4,0,0,65024,6,7967278971
3565,184029401,1518,184030919,2,0,1,1536,4,8329529984
3566,184036080,70976,184107056,2,0,0,8704,4,9205460834
3567,184055230,114766,184169996,6,0,0,13312,9,6443817769
3568,184177560,107744,184285304,1,0,0,53760,14,6891532660
3569,184227640,96976,184324616,7,0,0,4096,18,9157588465
3570,184241340,106874,184348214,6,0,0,32256,9,6959366556
3571,184265901,2946,184268847,5,0,1,3072,11,4238070301
3572,184323949,58411,184382360,0,0,0,5632,10,2542913309
3573,184347780,24321,184372101,1,0,1,43008,14,8926521356
3574,184488990,80750,184569740,5,0,0,36864,11,1653959101
3575,184593850,1994,184595844,1,0,1,2048,14,9518926217
3576,184650720,126511,184777231,2,0,0,44032,4,10512456464
3577,184657460,5454,184662914,9,0,1,13824,10,5183129386
3578,184680820,97689,184778509,7,0,0,4096,18,6307845956
3579,184681610,2470,184684080,0,0,1,2560,10,1797189980
3580,184756879,92465,184849344,0,0,0,3584,10,7394650433
3581,184760299,16947,184777246,3,0,1,12800,9,994096974
3582,184777150,147452,184924602,1,0,0,27648,14,9434255677
3583,184817610,566,184818176,4,0,1,512,6,3047837260
3584,184872440,102128,184974568,7,0,0,35328,18,5681511567
3585,184969350,94066,185063416,7,0,0,22016,18,3065119822
3586,185004060,60931,185064991,8,0,0,5120,12,1768204432
3587,185004871,11274,185016145,2,0,1,18432,4,5037815873
3588,185030550,91436,185121986,5,0,0,15360,11,8503403487
3589,185146840,94532,185241372,9,0,0,20480,10,7553924915
3590,185160540,64076,185224616,1,0,0,11264,14,5250141812
3591,185262800,77744,185340544,9,0,0,10752,10,934893066
3592,185266300,2946,185269246,0,0,1,3072,10,3907524145
3593,185276610,101632,185378242,5,0,0,17408,11,6852668691
3594,185314119,6754,185320873,3,0,1,7168,9,880490347
3595,185374940,55658,185430598,3,0,0,3072,9,6844595907
3596,185399630,145510,185545140,8,0,0,51200,12,5149666639
3597,185490980,55283,185546263,8,0,0,3584,12,9820494050
3598,185500460,76052,185576512,1,0,0,10240,14,2467012225
3599,185535180,82620,185617800,2,0,0,9216,4,9827421633
3600,185537330,90778,185628108,3,0,0,12800,9,8468964421
3601,185572720,80000,185652720,1,0,0,5632,14,4537721223
3602,185639390,74074,185713464,7,0,0,6144,18,6650281163
3603,185691230,84824,185776054,4,0,0,13824,6,1317024158
3604,185697480,118524,185816004,3,0,0,43008,9,6640958237
3605,185699381,4850,185704231,5,0,1,5120,11,23164281
3606,185744700,88506,185833206,4,0,0,2560,6,5679016051
3607,185752880,131602,185884482,5,0,0,29696,11,726809839
3608,185761380,86408,185847788,5,0,0,24064,11,6619072134
3609,185762150,108942,185871092,3,0,0,14848,9,7727231916
3610,185772541,5023,185777564,2,0,1,1536,4,4518995803
3611,185817870,74982,185892852,3,0,0,5632,9,8212491041
3612,185856240,84774,185941014,9,0,0,16384,10,9632559628
3613,185878780,110792,185989572,7,0,0,13312,18,9871454516
3614,185958620,59132,186017752,3,0,0,5120,9,3678482186
3615,186143780,100256,186244036,6,0,0,29184,9,6396032524
3616,186261610,43904,186305514,9,0,0,512,10,582470133
3617,186308710,102128,186410838,9,0,0,35328,10,9098828454
3618,186428660,100412,186529072,3,0,0,29696,9,1814220120
3619,186484060,60824,186544884,4,0,0,5632,6,10294210251
3620,186501320,87452,186588772,6,0,0,17408,9,3668228357
3621,186525351,7628,186532979,2,0,1,4096,4,5505674803
3622,186528230,125576,186653806,3,0,0,23040,9,272167534
3623,186592201,5712,186597913,2,0,1,14336,4,7020785815
3624,186594960,201454,186796414,4,0,0,26624,6,6270475443
3625,186686230,131123,186817353,9,0,0,27648,10,2608832440
3626,186833140,104000,186937140,4,0,0,41472,6,3625259504
3627,186903920,111176,187015096,1,0,0,65024,14,7291398958
3628,186904159,134361,187038520,0,0,0,15872,10,8466244470
3629,186957610,112206,187069816,9,0,0,25600,10,4384248795
3630,186974520,55748,187030268,7,0,0,4096,18,10669941798
3631,187031770,74838,187106608,7,0,0,10240,18,2954809741
3632,187130050,54056,187184106,9,0,0,3584,10,8039748493
3633,187201201,3904,187205105,6,0,1,10752,9,4458813968
3634,187225339,53375,187278714,0,0,0,3072,10,5191772944
3635,187250960,62672,187313632,7,0,0,6656,18,2443629267
3636,187308150,6754,187314904,7,0,1,7168,18,495611843
3637,187328510,62516,187391026,1,0,0,6144,14,1176459658
3638,187380440,69284,187449724,4,0,0,8192,6,5446794238
3639,187411640,60536,187472176,1,0,0,9728,14,751374487
3640,187428030,77744,187505774,2,0,0,10752,4,1096958565
3641,187458450,5802,187464252,7,0,1,6144,18,928228036
3642,187636340,5802,187642142,0,0,1,6144,10,2678573172
3643,187643590,250363,187893953,1,0,0,154624,14,289182356
3644,187649240,100630,187749870,5,0,0,3584,11,6443955391
3645,187678000,11274,187689274,9,0,1,18432,10,4588855012
3646,187721971,2946,187724917,6,0,1,3072,9,5549102729
3647,187776441,3422,187779863,2,0,1,3584,4,6530800849
3648,187784580,118132,187902712,9,0,0,28672,10,6859863768
3649,187874060,63789,187937849,7,0,0,512,18,4908863916
3650,187889660,91280,187980940,5,0,0,17408,11,7703977001
3651,187991930,72668,188064598,2,0,0,9216,4,4657671169
3652,188033411,2946,188036357,2,0,1,3072,4,1839419382
3653,188064270,72700,188136970,4,0,0,13312,6,6417049036
3654,188100369,52364,188152733,0,0,0,3072,10,2958290673
3655,188135040,50902,188185942,7,0,0,2048,18,7222897831
3656,188188461,2946,188191407,5,0,1,3072,11,1345795716
3657,188213660,24154,188237814,8,0,1,43520,12,10562123068
3658,188235780,280094,188515874,9,0,0,38400,10,8622189577
3659,188240811,2470,188243281,2,0,1,2560,4,595983589
3660,188251720,1042,188252762,1,0,1,1024,14,6060758230
3661,188337600,112556,188450156,9,0,0,50688,10,9549533483
3662,188354980,96439,188451419,1,0,0,4096,14,4782696766
3663,188357740,59008,188416748,8,0,0,1536,12,2927783226
3664,188392960,192220,188585180,1,0,0,37888,14,6814035756
3665,188401110,566,188401676,1,0,1,512,14,5573303231
3666,188492970,99557,188592527,1,0,0,24064,14,8471393
3667,188543260,143424,188686684,2,0,0,9728,4,2812659567
3668,188562830,151608,188714438,6,0,0,51712,9,6264715813
3669,188591380,60552,188651932,6,0,0,1536,9,9728548110
3670,188601869,214073,188815942,0,0,0,48640,10,2222327861
3671,188625869,13341,188639210,3,0,1,22528,9,9205002298
3672,188632261,7615,188639876,2,0,1,11264,4,8379110001
3673,188636090,3940,188640030,1,0,1,8704,14,1444408383
3674,188677619,96815,188774434,0,0,0,4608,10,8294044143
3675,188680130,114093,188794223,5,0,0,50176,11,5931097492
3676,188697360,17101,188714461,1,0,1,3072,14,3454091938
3677,188699740,352598,189052338,4,0,0,22016,6,10471605881
3678,188777420,104156,188881576,2,0,0,41984,4,62021330
3679,188778860,142376,188921236,9,0,0,15872,10,7184532189
3680,188791670,26699,188818369,4,0,1,43520,6,3027191354
3681,188828920,59448,188888368,4,0,0,1536,6,781088643
3682,188844370,222120,189066490,2,0,0,15360,4,9203683364
3683,188853250,119802,188973052,9,0,0,12288,10,1463203535
3684,188854539,154777,189009316,0,0,0,15360,10,3307330847
3685,188887790,170176,189057966,1,0,0,16896,14,3230453178
3686,188889550,110714,189000264,1,0,0,35328,14,5537862296
3687,188905900,249229,189155129,8,0,1,408576,12,1045855145
3688,188999510,156605,189156115,4,0,1,1536,6,1014535961
3689,189020950,135729,189156679,9,0,1,10752,10,6077655597
3690,189050880,207560,189258440,9,0,0,50176,10,6613148812
3691,189071260,213463,189284723,1,0,0,31232,14,9828025907
3692,189159111,1518,189160629,5,0,1,1536,11,1913760925
3693,189184990,171746,189356736,5,0,0,14336,11,1153416313
3694,189206880,95405,189302285,2,0,0,2048,4,5449497185
3695,189221310,137179,189358489,5,0,0,1536,11,7562753284
3696,189261580,80426,189342006,5,0,0,10240,11,3822218554
3697,189281289,8276,189289565,3,0,1,5120,9,9981508624
3698,189345181,2946,189348127,5,0,1,3072,11,8485139109
3699,189348190,73223,189421413,1,0,0,1536,14,8189055474
3700,189381750,7230,189388980,1,0,1,7680,14,8399973765
3701,189429840,98852,189528692,2,0,0,24576,4,3214397043
3702,189472460,1042,189473502,0,0,1,1024,10,8507203507
3703,189508970,85292,189594262,6,0,0,15360,9,4042102073
3704,189509270,221621,189730891,2,0,0,50176,4,2180550244
3705,189684470,90833,189775303,8,0,0,7168,12,7157268441
3706,189686580,64208,189750788,2,0,0,6656,4,2226706097
3707,189752160,43904,189796064,8,0,0,512,12,5731044214
3708,189754999,102128,189857127,0,0,0,35328,10,4183927896
3709,189809900,98486,189908386,1,0,0,1536,14,3809368945
3710,189833450,99632,189933082,8,0,0,27136,12,9938595178
3711,189836550,6488,189843038,9,0,1,15872,10,9231906591
3712,189851640,134092,189985732,1,0,0,12288,14,5210423869
3713,189903839,115379,190019218,0,0,0,5120,10,7602933312
3714,189912260,83936,189996196,2,0,0,20992,4,7422496139
3715,189928670,128684,190057354,6,0,0,18944,9,5386007188
3716,190039880,94376,190134256,1,0,0,19968,14,4675282453
3717,190181740,52364,190234104,8,0,0,3072,12,373592336
3718,190284320,102440,190386760,8,0,0,36352,12,231936983
3719,190340570,89888,190430458,5,0,0,12288,11,7887376873
3720,190352980,206844,190559824,8,0,0,208896,12,3397635911
3721,190362450,48980,190411430,6,0,0,2048,9,2223810061
3722,190433600,165244,190598844,7,0,0,46080,18,5436943813
3723,190471520,92227,190563747,8,0,0,12800,12,3964327741
3724,190524090,152118,190676208,4,0,0,20480,6,9756067808
3725,190585480,139718,190725198,9,0,0,44032,10,197308418
3726,190629910,212876,190842786,2,0,0,79872,4,3907077614
3727,190632770,55748,190688518,1,0,0,4096,14,7078243491
3728,190640640,88998,190729638,4,0,0,8192,6,2203515669
3729,190687250,103388,190790638,9,0,0,35328,10,3318875058
3730,190714890,145071,190859961,6,0,0,56320,9,1762148927
3731,190838000,89545,190927545,2,0,0,7680,4,4746673795
3732,190873610,106964,190980574,4,0,0,51200,6,2060421862
3733,190874709,12825,190887534,3,0,1,21504,9,9821172337
3734,190903760,116906,191020666,4,0,0,4096,6,10691554751
3735,190943200,121284,191064484,5,0,0,71680,11,10301352231
3736,190981910,143432,191125342,2,0,0,38400,4,2363923506
3737,191069511,3422,191072933,2,0,1,3584,4,10392685410
3738,191090540,160326,191250866,5,0,0,67584,11,3836608463
3739,191108190,77300,191185490,5,0,0,14336,11,71145996
3740,191204190,48980,191253170,7,0,0,2048,18,6770719359
3741,191290841,3904,191294745,2,0,1,10752,4,4071407986
3742,191293840,123930,191417770,4,0,0,59392,6,9648757884
3743,191466029,3904,191469933,3,0,1,10752,9,5659848311
3744,191537221,1042,191538263,6,0,1,1024,9,1701709636
3745,191677760,107900,191785660,1,0,0,54272,14,1808962496
3746,191779310,13572,191792882,7,0,1,7680,18,9878992501
3747,191966631,2470,191969101,5,0,1,2560,11,1451307065
3748,191967940,53379,192021319,7,0,0,3072,18,4461041387
3749,191996210,67904,192064114,9,0,0,8704,10,5283545711
3750,192072850,1042,192073892,7,0,1,1024,18,6072965255
3751,192201880,125019,192326899,7,0,0,13824,18,1538248921
3752,192218150,4420,192222570,1,0,1,11776,14,9572493802
3753,192239549,62384,192301933,0,0,0,10752,10,3188573045
3754,192266959,130494,192397453,0,0,0,24576,10,6535989851
3755,192364800,55627,192420427,1,0,0,3072,14,4009634680
3756,192612970,99632,192712602,9,0,0,27136,10,5189707245
3757,192625180,59684,192684864,6,0,0,512,9,2541481275
3758,192655690,1042,192656732,4,0,1,1024,6,10457208143
3759,192684730,4976,192689706,9,0,1,5120,10,2569282617
3760,192691210,138169,192829379,2,0,0,8192,4,10102175054
3761,192716199,224456,192940655,0,0,0,73728,10,7727550254
3762,192747370,100412,192847782,2,0,0,29696,4,540086894
3763,192897070,93601,192990671,8,0,0,13824,12,2181026510
3764,193010050,102284,193112334,5,0,0,35840,11,2451954755
3765,193020350,140218,193160568,7,0,0,61952,18,9205336788
3766,193125530,129584,193255114,2,0,0,125440,4,5590854121
3767,193396680,114608,193511288,5,0,0,76288,11,7382127514
3768,193433089,3422,193436511,3,0,1,3584,9,2606298803
3769,193458240,100724,193558964,7,0,0,30720,18,3330178138
3770,193482170,116088,193598258,7,0,0,17408,18,3730248392
3771,193561680,3898,193565578,1,0,1,4096,14,2416945882
3772,193573300,93596,193666896,2,0,0,17408,4,2792823777
3773,193721591,3904,193725495,5,0,1,10752,11,2081005717
3774,193744620,86204,193830824,9,0,0,13312,10,4820051012
3775,193922871,34108,193956979,2,0,1,56320,4,1357306012
3776,194068950,202614,194271564,5,0,0,103936,11,10311334656
3777,194079070,103688,194182758,6,0,0,40448,9,9943995386
3778,194109130,54056,194163186,5,0,0,3584,11,9388170720
3779,194138271,5712,194143983,5,0,1,14336,11,5918976159
3780,194153270,5971,194159241,8,0,1,14848,12,1378130153
3781,194210400,107052,194317452,5,0,0,15360,11,9112734851
3782,194249560,98048,194347608,2,0,0,10240,4,2082213195
3783,194307759,58629,194366388,0,0,0,4096,10,1333330298
3784,194319380,1518,194320898,9,0,1,1536,10,3484865743
3785,194390740,69284,194460024,9,0,0,8192,10,2290898177
3786,194419289,1518,194420807,3,0,1,1536,9,183624666
3787,194506369,135335,194641704,0,0,0,6144,10,1017003895
3788,194551540,78992,194630532,6,0,0,14848,9,7273438037
3789,194597440,55748,194653188,1,0,0,4096,14,2430124198
3790,194672820,48980,194721800,5,0,0,2048,11,1587758105
3791,194694850,74360,194769210,2,0,0,9728,4,2377930726
3792,194697950,103074,194801024,8,0,0,12800,12,3888832841
3793,194701270,2470,194703740,4,0,1,2560,6,10644114873
3794,194803550,65768,194869318,1,0,0,11776,14,5277295892
3795,194894750,111800,195006550,6,0,0,67072,9,9789757432
3796,195123300,43904,195167204,5,0,0,512,11,3324031610
3797,195130390,52364,195182754,7,0,0,3072,18,8354651436
3798,195182570,101524,195284094,9,0,0,32768,10,5667827657
3799,195224750,68996,195293746,7,0,0,12288,18,4308440207
3800,195252690,188785,195441475,1,0,0,34304,14,4971423170
3801,195252940,132624,195385564,6,0,0,95744,9,10136517758
3802,195257850,3645,195261495,4,0,1,10240,6,1173114978
3803,195313980,10499,195324479,1,0,1,16896,14,10625808345
3804,195328460,14029,195342489,8,0,1,27136,12,2692469491
3805,195559600,69284,195628884,8,0,0,8192,12,3050083885
3806,195626251,7706,195633957,5,0,1,8192,11,5162833251
3807,195661690,102284,195763974,8,0,0,35840,12,2557542393
3808,195735030,64832,195799862,6,0,0,8704,9,8688241304
3809,195880920,102284,195983204,7,0,0,35840,18,9285107455
3810,195927000,106202,196033202,2,0,0,12288,4,5568585765
3811,196126870,103064,196229934,5,0,0,38400,11,2956031574
3812,196161290,101660,196262950,5,0,0,33792,11,5292496131
3813,196185280,148242,196333522,9,0,0,4608,10,6572450172
3814,196202040,130055,196332095,6,0,0,66048,9,4134700385
3815,196215999,47434,196263433,0,0,0,1536,10,8984626354
3816,196246140,4162,196250302,0,0,1,11264,10,2736295720
3817,196297830,91298,196389128,3,0,0,24576,9,1127270503
3818,196316239,23044,196339283,3,0,1,6144,9,9929667784
3819,196342640,96570,196439210,2,0,0,5632,4,2957869007
3820,196358960,91796,196450756,5,0,0,26624,11,6794665700
3821,196409560,5326,196414886,1,0,1,5632,14,5524701185
3822,196474119,2870,196476989,3,0,1,8704,9,1326299106
3823,196555330,4374,196559704,1,0,1,4608,14,5498622282
3824,196570660,84536,196655196,7,0,0,17920,18,10656688515
3825,196745170,3904,196749074,0,0,1,10752,10,9727955456
3826,196763520,45596,196809116,6,0,0,1024,9,2137925544
3827,196789450,101504,196890954,5,0,0,33280,11,1806435078
3828,196812869,118867,196931736,0,0,0,9728,10,8737840411
3829,196964010,101348,197065358,6,0,0,32768,9,10467363735
3830,196985580,84005,197069585,2,0,0,13824,4,5997755446
3831,197040830,121628,197162458,2,0,0,99328,4,8562830979
3832,197099451,5326,197104777,2,0,1,5632,4,5547593582
3833,197215760,13341,197229101,1,0,1,22528,14,5481127321
3834,197220440,63640,197284080,2,0,0,7680,4,728648726
3835,197363230,95312,197458542,2,0,0,23040,4,737316226
3836,197368790,48980,197417770,5,0,0,2048,11,7670088728
3837,197387290,3422,197390712,7,0,1,3584,18,3590068316
3838,197404870,14287,197419157,7,0,1,27648,18,1598899072
3839,197419149,109790,197528939,0,0,0,512,10,907287802
3840,197459340,101597,197560937,4,0,0,3584,6,7047197958
3841,197665420,57440,197722860,3,0,0,4608,9,8760977039
3842,197704140,60224,197764364,8,0,0,8704,12,334309910
3843,197727859,98852,197826711,0,0,0,24576,10,10600037331
3844,197839600,80996,197920596,6,0,0,16384,9,8889269938
3845,197865839,99476,197965315,0,0,0,26624,10,9133258197
3846,197929871,6278,197936149,2,0,1,6656,4,2957783524
3847,197939830,138789,198078619,3,0,0,98816,9,9140479442
3848,197948400,166573,198114973,6,0,0,15360,9,2865902693
3849,198066260,163265,198229525,5,0,0,91648,11,5903472045
3850,198167090,132683,198299773,1,0,0,22528,14,8789681018
3851,198227230,6661,198233891,7,0,1,4608,18,1530199750
3852,198241860,147475,198389335,8,0,0,83456,12,3302165585
3853,198292260,149461,198441721,1,0,0,77824,14,8320132486
3854,198358379,3645,198362024,3,0,1,10240,9,3992008792
3855,198413361,3422,198416783,5,0,1,3584,11,8861296927
3856,198510500,88544,198599044,9,0,0,20992,10,3691639760
3857,198567710,113744,198681454,3,0,0,63488,9,10464632784
3858,198639200,119918,198759118,1,0,0,28672,14,121666830
3859,198664910,126422,198791332,8,0,0,12288,12,10651836174
3860,198873950,52364,198926314,6,0,0,3072,9,7459975111
3861,199015050,67304,199082354,9,0,0,11776,10,8723535630
3862,199033160,43904,199077064,1,0,0,512,14,7879492176
3863,199034380,59912,199094292,9,0,0,7680,10,6794457299
3864,199066550,1042,199067592,9,0,1,1024,10,8950755377
3865,199073990,102792,199176782,1,0,0,22016,14,8355646071
3866,199198010,98696,199296706,7,0,0,24064,18,8532874542
3867,199292760,105754,199398514,6,0,0,34304,9,8646581972
3868,199301550,43904,199345454,6,0,0,512,9,6266849323
3869,199337121,5326,199342447,5,0,1,5632,11,7485734586
3870,199373930,43904,199417834,5,0,0,512,11,2667022891
3871,199379560,75140,199454700,6,0,0,12288,9,5490021515
3872,199403340,5326,199408666,7,0,1,5632,18,8145227525
3873,199597939,80396,199678335,0,0,0,19456,10,2205515662
3874,199661840,4374,199666214,0,0,1,4608,10,9744900472
3875,199765420,4374,199769794,9,0,1,4608,10,5493728018
3876,199782810,5971,199788781,0,0,1,14848,10,6709639780
3877,199858350,43904,199902254,3,0,0,512,9,5067158398
3878,200019980,65900,200085880,3,0,0,7168,9,5054752548
3879,200039290,69284,200108574,2,0,0,8192,4,3330123682
3880,200065960,54368,200120328,3,0,0,4608,9,4815251703
3881,200244520,77768,200322288,9,0,0,15872,10,1757628533
3882,200259111,2946,200262057,2,0,1,3072,4,9937407030
3883,200299720,2870,200302590,7,0,1,8704,18,1055835625
3884,200334080,45596,200379676,6,0,0,1024,9,34127175
3885,200422850,111332,200534182,5,0,0,65536,11,8034541400
3886,200469600,171502,200641102,5,0,0,20992,11,5789289003
3887,200489130,257590,200746720,3,0,0,33792,9,1753063211
3888,200494590,118264,200612854,2,0,0,24064,4,6542714904
3889,200533410,179620,200713030,2,0,0,95744,4,4977761284
3890,200569220,91856,200661076,8,0,0,4608,12,3591805886
3891,200593380,4162,200597542,9,0,1,11264,10,9020607917
3892,200620750,99479,200720229,5,0,0,23552,11,5548326817
3893,200648120,76180,200724300,9,0,0,13312,10,6256814705
3894,200684150,143253,200827403,7,0,0,24064,18,7544789366
3895,200719979,122729,200842708,0,0,0,49152,10,24729312
3896,200763560,7706,200771266,9,0,1,8192,10,4568326405
3897,200781659,139548,200921207,0,0,0,32256,10,7466046875
3898,200894330,79592,200973922,7,0,0,11776,18,10092363002
3899,200935460,141782,201077242,5,0,0,51200,11,6092151110
3900,201017570,133880,201151450,6,0,0,40448,9,5211345101
3901,201073850,6330,201080180,0,0,1,3072,10,7295238712
3902,201148170,8122,201156292,9,0,1,5120,10,3456794497
3903,201167390,12566,201179956,1,0,1,20992,14,2994401183
3904,201177820,3645,201181465,1,0,1,10240,14,6509984059
3905,201243441,1994,201245435,5,0,1,2048,11,3612187767
3906,201318340,54368,201372708,9,0,0,4608,10,5208746172
3907,201474990,59132,201534122,8,0,0,5120,12,4955887595
3908,201490170,93956,201584126,3,0,0,28672,9,3551545155
3909,201555720,97292,201653012,8,0,0,19456,12,8920687638
3910,201657920,45596,201703516,8,0,0,1024,12,5715753675
3911,201704120,4679,201708799,0,0,1,12288,10,9864678951
3912,201805400,104865,201910265,8,0,0,14848,12,4510387247
3913,201848440,2946,201851386,1,0,1,3072,14,5271600513
3914,201901161,566,201901727,2,0,1,512,4,7020729862
3915,201986380,107588,202093968,5,0,0,53248,11,7284421668
3916,202016910,129216,202146126,5,0,0,31744,11,10645839368
3917,202157870,103844,202261714,8,0,0,40960,12,5966898130
3918,202181390,4937,202186327,0,0,1,12800,10,7619519818
3919,202192150,134016,202326166,3,0,0,13312,9,3262832587
3920,202202800,207605,202410405,9,0,0,22016,10,4481584177
3921,202480751,11274,202492025,5,0,1,18432,11,898496413
3922,202495820,76621,202572441,8,0,0,9728,12,394041217
3923,202501870,67592,202569462,1,0,0,7680,14,7517856361
3924,202538630,181260,202719890,7,0,0,60416,18,10486891418
3925,202555420,52520,202607940,5,0,0,3584,11,2971759550
3926,202572351,1600,202573951,6,0,1,1536,9,5895230334
3927,202665380,4679,202670059,9,0,1,12288,10,5554295077
3928,202674330,54056,202728386,1,0,0,3584,14,217871685
3929,202748670,138561,202887231,6,0,0,4096,9,1322892023
3930,202802410,14804,202817214,8,0,1,28672,12,10379245359
3931,202843110,47288,202890398,5,0,0,1536,11,602825728
3932,202949100,101504,203050604,1,0,0,33280,14,9681650444
3933,202986520,119767,203106287,6,0,0,12288,9,5667106845
3934,202991480,111048,203102528,2,0,0,19968,4,5331801766
3935,202992250,71908,203064158,2,0,0,1024,4,645826600
3936,203189821,4374,203194195,6,0,1,4608,9,3173773339
3937,203257530,3904,203261434,4,0,1,10752,6,4247400478
3938,203329940,11274,203341214,7,0,1,18432,18,705229920
3939,203412800,5326,203418126,1,0,1,5632,14,9933003435
3940,203419000,47288,203466288,5,0,0,1536,11,9259477161
3941,203437350,5802,203443152,9,0,1,6144,10,1229552176
3942,203451440,72541,203523981,8,0,1,117760,12,1370466918
3943,203460620,283653,203744273,7,0,0,52736,18,9177398978
3944,203511460,91131,203602591,8,0,0,512,12,10062253155
3945,203719760,100100,203819860,6,0,0,28672,9,1337385937
3946,203921800,100724,204022524,3,0,0,30720,9,3308014298
3947,203980450,100256,204080706,5,0,0,29184,11,5736354802
3948,204186300,43904,204230204,5,0,0,512,11,3898131523
3949,204234080,107744,204341824,1,0,0,53760,14,5287214418
3950,204343909,45596,204389505,0,0,0,1024,10,7304826472
3951,204387970,2870,204390840,1,0,1,8704,14,6208040317
3952,204501550,5712,204507262,7,0,1,14336,18,2329736065
3953,204859700,100568,204960268,3,0,0,30208,9,7879291996
3954,204875560,90912,204966472,8,0,0,10240,12,9315145870
3955,204883849,6754,204890603,3,0,1,7168,9,8495845106
3956,204908420,133088,205041508,3,0,0,12288,9,5148033755
3957,204941169,116422,205057591,0,0,0,52736,10,1578091041
3958,204966240,106349,205072589,2,0,0,12288,4,1572262415
3959,204997280,108789,205106069,3,0,0,11264,9,9252110108
3960,205064300,113567,205177867,3,0,0,8704,9,5483373668
3961,205069200,104105,205173305,6,0,0,30720,9,245894055
3962,205088940,86260,205175200,3,0,0,6144,9,7654687194
3963,205165090,89491,205254581,6,0,0,12288,9,396473503
3964,205226360,43904,205270264,8,0,0,512,12,8449028567
3965,205234950,81128,205316078,6,0,0,11776,9,210373218
3966,205285610,13858,205299468,4,0,1,23552,6,5645371908
3967,205293080,239118,205532198,4,0,0,6144,6,5139317262
3968,205302930,89456,205392386,4,0,0,18944,6,4067096739
3969,205359049,156715,205515764,0,0,0,79360,10,9100995216
3970,205400220,90716,205490936,2,0,0,16384,4,1014522476
3971,205441390,78994,205520384,1,0,0,1536,14,5851589957
3972,205480950,43904,205524854,1,0,0,512,14,794818632
3973,205502570,76680,205579250,3,0,0,2048,9,418928432
3974,205558720,74360,205633080,4,0,0,9728,6,6765054590
3975,205617140,102596,205719736,5,0,0,36864,11,9176020615
3976,205640600,132794,205773394,4,0,0,40448,6,3099738194
3977,205695380,62594,205757974,4,0,0,3584,6,702106716
3978,205697850,95506,205793356,7,0,0,7680,18,991663833
3979,205737660,128914,205866574,8,0,0,46592,12,5179498078
3980,205843470,103456,205946926,8,0,0,35840,12,10503081704
3981,205875630,166365,206041995,7,0,0,22528,18,5635260437
3982,205898460,136648,206035108,5,0,0,97280,11,7766944361
3983,205967760,168262,206136022,5,0,0,51712,11,6867470726
3984,205979750,136304,206116054,5,0,0,89600,11,6649622171
3985,205995830,249854,206245684,1,0,0,108032,14,7675144076
3986,206018090,147866,206165956,3,0,0,7680,9,1099097008
3987,206030620,15787,206046407,8,0,1,11776,12,4387752257
3988,206077420,2946,206080366,7,0,1,3072,18,3864839026
3989,206202310,99632,206301942,7,0,0,27136,18,2500505048
3990,206207179,122555,206329734,0,0,0,57856,10,4841290873
3991,206209320,74681,206284001,1,0,0,8192,14,6731849302
3992,206240620,168716,206409336,3,0,0,91136,9,1266277303
3993,206360529,49134,206409663,0,0,0,1024,10,8008132451
3994,206394980,20477,206415457,0,0,1,6144,10,6636181036
3995,206467439,75140,206542579,0,0,0,12288,10,518407885
3996,206470010,169154,206639164,4,0,0,57344,6,8505352987
3997,206511400,102941,206614341,1,0,0,9216,14,2784124991
3998,206521930,89588,206611518,1,0,0,14336,14,7201046497
3999,206558779,137553,206696332,0,0,0,15872,10,7685542960
4000,206572550,68780,206641330,3,0,0,3072,9,6252743518
4001,206626300,82140,206708440,7,0,0,8192,18,1213197008
4002,206744180,100412,206844592,7,0,0,29696,18,5742506318
4003,206780730,75320,206856050,3,0,0,17920,9,7947484075
4004,206812430,7706,206820136,9,0,1,8192,10,8374559900
4005,206816650,127039,206943689,4,0,0,61440,6,617563979
4006,206885490,128591,207014081,5,0,0,23040,11,3068090693
4007,206910030,51296,206961326,3,0,0,4608,9,10315672054
4008,206912760,76232,206988992,6,0,0,15872,9,3393972883
4009,206955219,117425,207072644,0,0,0,20992,10,4408857348
4010,206961419,78888,207040307,0,0,0,7168,10,803648352
4011,206972930,99729,207072659,8,0,1,153600,12,8475698411
4012,207165319,78860,207244179,0,0,0,19456,10,5228703340
4013,207166130,57440,207223570,3,0,0,4608,9,216406049
4014,207298910,97448,207396358,3,0,0,19968,9,6664724732
4015,207370620,110220,207480840,1,0,0,22528,14,6642311009
4016,207384961,11412,207396373,6,0,1,17408,9,10223741059
4017,207460160,60824,207520984,5,0,0,5632,11,3455963504
4018,207519680,106700,207626380,1,0,0,46080,14,2063739202
4019,207562150,130080,207692230,4,0,0,29184,6,6491858250
4020,207667790,74540,207742330,2,0,0,15360,4,9235417168
4021,207758570,102284,207860854,6,0,0,35840,9,5742816104
4022,207831410,72680,207904090,1,0,0,4096,14,6686962268
4023,207935199,100412,208035611,0,0,0,29696,10,4986816179
4024,207998060,1518,207999578,5,0,1,1536,11,8819166026
4025,208046550,1518,208048068,4,0,1,1536,6,9675177041
4026,208096789,4850,208101639,3,0,1,5120,9,9527243828
4027,208117330,99788,208217118,8,0,0,27648,12,6476034651
4028,208181680,4374,208186054,5,0,1,4608,11,2719691895
4029,208207420,9713,208217133,9,0,1,10752,10,10468241670
4030,208272640,84470,208357110,3,0,0,9216,9,9938876674
4031,208336400,60824,208397224,7,0,0,5632,18,6072192269
4032,208360830,103144,208463974,7,0,0,16896,18,6480650274
4033,208393080,74360,208467440,3,0,0,9728,9,1905983304
4034,208425960,66712,208492672,4,0,0,4096,6,7393766179
4035,208444950,50672,208495622,8,0,0,2560,12,8308303303
4036,208504030,4374,208508404,7,0,1,4608,18,6555089563
4037,208525650,48980,208574630,6,0,0,2048,9,711240712
4038,208542630,71468,208614098,5,0,0,15360,11,1461945906
4039,208597720,111488,208709208,8,0,0,66048,12,6527152449
4040,208622220,114414,208736634,8,0,0,44032,12,8248242675
4041,208673330,70014,208743344,6,0,0,9728,9,6145038935
4042,208717280,112062,208829342,4,0,0,64000,6,3659001951
4043,208745710,154407,208900117,7,0,0,25600,18,6824801296
4044,208752020,187763,208939783,6,0,0,29696,9,9265700681
4045,208765150,127152,208892302,2,0,0,46592,4,8371350898
4046,208790040,140680,208930720,2,0,0,10240,4,8807186804
4047,208921050,33245,208954295,8,0,1,57856,12,5725095116
4048,208988209,93304,209081513,0,0,0,15360,10,9113769292
4049,209033290,6754,209040044,1,0,1,7168,14,10225259391
4050,209085559,102752,209188311,0,0,0,37376,10,5270554009
4051,209300580,111176,209411756,7,0,0,65024,18,10451544400
4052,209305460,120330,209425790,8,0,0,4096,12,10658036104
4053,209319701,7706,209327407,6,0,1,8192,9,10417420189
4054,209342020,2946,209344966,7,0,1,3072,18,7563682834
4055,209430190,125331,209555521,1,0,0,3584,14,2301335057
4056,209432790,4420,209437210,0,0,1,11776,10,9927642859
4057,209489220,128491,209617711,4,0,0,25088,6,4045417223
4058,209544970,98228,209643198,1,0,0,22528,14,2617231416
4059,209596730,110886,209707616,2,0,0,8704,4,9117036149
4060,209605920,113942,209719862,8,0,0,35328,12,5195146592
4061,209636959,51827,209688786,0,0,0,1024,10,6486576059
4062,209846160,566,209846726,0,0,1,512,10,6207159331
4063,209892810,176421,210069231,1,0,0,25600,14,5980937391
4064,209901070,47288,209948358,7,0,0,1536,18,5815712289
4065,209957671,13083,209970754,6,0,1,22016,9,4631097705
4066,210004170,169653,210173823,5,0,0,8704,11,2796070074
4067,210010949,80996,210091945,0,0,0,16384,10,8351003922
4068,210019140,132165,210151305,7,0,0,61952,18,7353272994
4069,210138300,114345,210252645,3,0,0,32768,9,6220595331
4070,210305460,110396,210415856,2,0,0,62464,4,8499298481
4071,210398490,68030,210466520,3,0,0,2560,9,2934593238
4072,210429590,67592,210497182,6,0,0,7680,9,1712071489
4073,210511810,55748,210567558,3,0,0,4096,9,256945507
4074,210526229,45752,210571981,0,0,0,1536,10,3252652158
4075,210562519,106652,210669171,0,0,0,50176,10,6311988452
4076,210676140,58563,210734703,1,0,0,1024,14,8870080464
4077,210688780,45596,210734376,4,0,0,1024,6,4357054964
4078,210774530,7230,210781760,7,0,1,7680,18,9056692228
4079,210778860,88232,210867092,2,0,0,19968,4,4770427089
4080,210826469,22950,210849419,3,0,1,37888,9,9858604672
4081,210946890,88208,211035098,2,0,0,14848,4,9974962977
4082,210956210,88038,211044248,6,0,0,6144,9,9361627340
4083,210989640,55559,211045199,7,0,0,3072,18,9045274382
4084,211017910,106446,211124356,8,0,1,177152,12,3621341620
4085,211089910,138504,211228414,8,0,0,8704,12,3584074772
4086,211116140,260316,211376456,2,0,0,41472,4,2504161949
4087,211226519,113125,211339644,0,0,0,13824,10,10425157616
4088,211285201,1042,211286243,6,0,1,1024,9,2288677130
4089,211290320,7230,211297550,7,0,1,7680,18,5836048533
4090,211317989,1042,211319031,3,0,1,1024,9,616077522
4091,211420280,162968,211583248,2,0,0,55296,4,8681103376
4092,211457080,109305,211566385,1,0,0,30720,14,6683979936
4093,211519360,2470,211521830,5,0,1,2560,11,1365690793
4094,211535320,111986,211647306,7,0,0,4096,18,10099720525
4095,211548550,90836,211639386,7,0,0,18432,18,1688164920
4096,211617670,21731,211639401,8,0,1,32768,12,5654907868
4097,211673150,1994,211675144,0,0,1,2048,10,5084515869
4098,211747421,7706,211755127,6,0,1,8192,9,3873590623
4099,211765359,3387,211768746,3,0,1,9728,9,4463714954
4100,211776660,146573,211923233,6,0,0,47616,9,4158888088
4101,211791839,76520,211868359,0,0,0,11776,10,7161169722
4102,211811949,87209,211899158,0,0,0,11264,10,4498473508
4103,211852570,95077,211947647,6,0,0,5632,9,1545764777
4104,211856440,201991,212058431,1,0,0,46592,14,2465988466
4105,211864650,221909,212086559,8,0,0,17920,12,10044497315
4106,211882580,153108,212035688,7,0,0,65024,18,2443892295
4107,211941000,63450,212004450,8,0,1,103424,12,3458453847
4108,212009069,3898,212012967,3,0,1,4096,9,5421119004
4109,212047421,15681,212063102,6,0,1,12288,9,120276965
4110,212105360,157082,212262442,1,0,0,16384,14,4036377176
4111,212150739,88507,212239246,0,0,0,15872,10,7830067977
4112,212169290,74360,212243650,2,0,0,9728,4,7839721032
4113,212213560,119064,212332624,6,0,0,38912,9,6661077549
4114,212243260,130452,212373712,5,0,0,27136,11,3420618280
4115,212290020,85267,212375287,6,0,0,5120,9,10187628577
4116,212305650,96321,212401971,8,0,1,160768,12,1691807853
4117,212315419,164525,212479944,0,0,0,8192,10,6348599630
4118,212392771,9546,212402317,5,0,1,512,11,4789685753
4119,212548079,72668,212620747,0,0,0,9216,10,918257902
4120,212626900,6754,212633654,9,0,1,7168,10,5701809614
4121,212872149,59288,212931437,0,0,0,5632,10,8888332891
4122,212905540,566,212906106,4,0,1,512,6,4990913477
4123,213004540,79436,213083976,3,0,0,11264,9,2768744809
4124,213019100,91460,213110560,4,0,0,20480,6,8438860464
4125,213050330,103220,213153550,8,0,0,38912,12,2648844052
4126,213083050,104762,213187812,4,0,0,40960,6,4119567960
4127,213155360,108524,213263884,6,0,0,56320,9,852629917
4128,213170290,104217,213274507,4,0,0,34816,6,3553270316
4129,213176109,117615,213293724,0,0,0,18432,10,4350885227
4130,213201400,92339,213293739,8,0,1,145920,12,791753118
4131,213243820,49934,213293754,9,0,1,2560,10,1574879819
4132,213313910,211755,213525665,3,0,0,24576,9,7146204516
4133,213431760,7230,213438990,5,0,1,7680,11,495550713
4134,213433520,6456,213439976,9,0,1,1536,10,662415884
4135,213458750,87140,213545890,5,0,0,16384,11,6190519799
4136,213475360,76975,213552335,1,0,0,5120,14,1219059850
4137,213565020,11791,213576811,7,0,1,19456,18,7709384254
4138,213590820,125249,213716069,8,0,0,18944,12,7703960023
4139,213625950,238200,213864150,7,0,0,56832,18,3148156517
4140,213646150,47288,213693438,1,0,0,1536,14,4254165645
4141,213684009,6229,213690238,3,0,1,15360,9,10064326407
4142,213686660,72298,213758958,8,0,0,11264,12,247527760
4143,213741230,127600,213868830,9,0,0,6656,10,4277627306
4144,213745850,81128,213826978,7,0,0,11776,18,1589598983
4145,213776630,51455,213828085,8,0,0,3584,12,5030791993
4146,213807900,5326,213813226,0,0,1,5632,10,5999030214
4147,213858730,85551,213944281,6,0,0,12800,9,4811073299
4148,213953670,102128,214055798,9,0,0,35328,10,3758287442
4149,214121430,92972,214214402,5,0,0,15360,11,9750206396
4150,214164090,86696,214250786,9,0,0,19968,10,5319729904
4151,214224900,71780,214296680,1,0,0,16384,14,1156819280
4152,214286420,100056,214386476,2,0,0,21504,4,1799489090
4153,214304450,106554,214411004,6,0,0,11264,9,3420569915
4154,214397110,50672,214447782,9,0,0,2560,10,10686028609
4155,214459840,96980,214556820,5,0,0,18432,11,1951788700
4156,214543310,78548,214621858,1,0,0,18432,14,4182800746
4157,214543530,2870,214546400,0,0,1,8704,10,4501982578
4158,214568619,155407,214724026,0,0,0,74240,10,656208996
4159,214590679,177351,214768030,0,0,0,57344,10,8106287501
4160,214592930,14117,214607047,5,0,1,24064,11,1970767877
4161,214635670,175236,214810906,5,0,0,14336,11,2339517867
4162,214742010,114112,214856122,2,0,0,26624,4,8095506849
4163,214744700,111749,214856449,6,0,0,1024,9,505327442
4164,214841131,3904,214845035,6,0,1,10752,9,5859785287
4165,214885360,56216,214941576,5,0,0,5632,11,7511457877
4166,214900180,67772,214967952,4,0,0,13312,6,4847110640
4167,214996170,62516,215058686,1,0,0,6144,14,9034365964
4168,215025700,79304,215105004,9,0,0,15872,10,8734164818
4169,215038019,114762,215152781,3,0,1,189952,9,7980629048
4170,215066050,229609,215295659,1,0,0,24576,14,6417260096
4171,215169980,166119,215336099,6,0,0,66560,9,10459451586
4172,215207141,21916,215229057,2,0,1,35840,4,1513403509
4173,215212200,20403,215232603,4,0,1,5632,6,9559721191
4174,215419270,5454,215424724,7,0,1,13824,18,5151938200
4175,215504390,566,215504956,4,0,1,512,6,6638193804
4176,215522450,98540,215620990,6,0,0,23552,9,938052094
4177,215580500,130076,215710576,5,0,0,89600,11,6613419711
4178,215660900,63584,215724484,8,0,0,4096,12,6792487115
4179,215680570,48980,215729550,5,0,0,2048,11,1109260976
4180,215685510,143903,215829413,5,0,0,90112,11,303325855
4181,215702590,148998,215851588,5,0,0,41984,11,5388820518
4182,215712920,566,215713486,0,0,1,512,10,3083811171
4183,215744510,225473,215969983,5,0,0,12800,11,1747692760
4184,215753840,203850,215957690,2,0,0,79360,4,1639821679
4185,215756079,95524,215851603,3,0,1,146944,9,4823188960
4186,215805810,45808,215851618,7,0,1,3072,18,2235942892
4187,215883630,141054,216024684,2,0,0,4096,4,1788797191
4188,216055120,110240,216165360,4,0,0,61952,6,4321522014
4189,216082660,138758,216221418,6,0,0,53248,9,9751888825
4190,216157640,77152,216234792,7,0,0,8704,18,1354526192
4191,216162850,100862,216263712,2,0,0,14848,4,5889600316
4192,216166060,80732,216246792,6,0,0,9728,9,1464879967
4193,216182780,4850,216187630,4,0,1,5120,6,4804258181
4194,216183671,5265,216188936,6,0,1,2048,9,9579970037
4195,216199300,125816,216325116,5,0,0,2048,11,5137446049
4196,216203220,99632,216302852,5,0,0,27136,11,8305073641
4197,216226410,186341,216412751,6,0,0,47104,9,8069805957
4198,216238940,209260,216448200,2,0,0,30720,4,8443113895
4199,216241200,93204,216334404,7,0,0,10752,18,3114514136
4200,216265489,108101,216373590,0,0,0,13824,10,8880665772
4201,216295050,180143,216475193,6,0,0,24064,9,2365117817
4202,216300060,94089,216394149,3,0,0,14848,9,3936589665
4203,216325020,127875,216452895,9,0,0,15360,10,2383513168
4204,216411150,7871,216419021,1,0,1,6656,14,2329994372
4205,216434530,167852,216602382,2,0,0,24576,4,4177789025
4206,216437140,45596,216482736,9,0,0,1024,10,9573564077
4207,216450460,110966,216561426,7,0,0,36352,18,7035363390
4208,216451820,44996,216496816,1,0,0,512,14,3324614758
4209,216545931,15510,216561441,5,0,1,5120,11,8624796941
4210,216557350,9409,216566759,0,0,1,5632,10,427514508
4211,216561700,103314,216665014,5,0,0,34304,11,2874089240
4212,216607950,108094,216716044,2,0,0,34304,4,1625635912
4213,216626860,101508,216728368,9,0,0,9216,10,3985235795
4214,216640531,3904,216644435,5,0,1,10752,11,5211370198
4215,216680900,138773,216819673,6,0,0,12288,9,5624995092
4216,216683030,162710,216845740,8,0,0,85504,12,4907488288
4217,216685191,1994,216687185,6,0,1,2048,9,3015427182
4218,216718440,164259,216882699,1,0,0,13824,14,5449208554
4219,216784770,143218,216927988,5,0,0,65024,11,8347930959
4220,216820510,40026,216860536,4,0,1,28672,6,2763502716
4221,216856640,140732,216997372,9,0,0,8192,10,5804937727
4222,216867240,83242,216950482,5,0,0,6656,11,10453073772
4223,217133570,58688,217192258,7,0,0,8704,18,803631799
4224,217189070,124124,217313194,6,0,0,107520,9,4816093816
4225,217217200,121242,217338442,8,0,0,6656,12,8106733683
4226,217218700,169578,217388278,7,0,0,54272,18,1419722973
4227,217260620,67046,217327666,7,0,0,1536,18,6076824999
4228,217306780,13653,217320433,7,0,1,7680,18,3824492241
4229,217312590,97156,217409746,7,0,0,13824,18,3993386490
4230,217345270,45596,217390866,5,0,0,1024,11,9337782681
4231,217420061,5802,217425863,6,0,1,6144,9,3249795932
4232,217427940,84692,217512632,6,0,0,18432,9,9557363664
4233,217429100,1994,217431094,7,0,1,2048,18,1892110601
4234,217460830,5326,217466156,4,0,1,5632,6,833246647
4235,217472309,66861,217539170,9,0,0,3584,10,420577010
4236,217553650,69152,217622802,7,0,0,12800,18,9982408493
4237,217572540,77300,217649840,6,0,0,14336,9,7499215061
4238,217673570,83000,217756570,3,0,0,17920,9,7010733137
4239,217726810,47288,217774098,3,0,0,1536,9,3907471675
4240,217764379,99008,217863387,0,0,0,25088,10,4446028562
4241,217838170,67592,217905762,6,0,0,7680,9,9823599455
4242,217861630,63794,217925424,9,0,0,512,10,2346703475
4243,217939340,66080,218005420,5,0,0,12800,11,9913222832
4244,217975020,64988,218040008,6,0,0,9216,9,6555743824
4245,218167260,3128,218170388,4,0,1,9216,6,10582332466
4246,218206940,105872,218312812,5,0,0,47616,11,26957114
4247,218248250,2470,218250720,9,0,1,2560,10,10480004491
4248,218257900,89328,218347228,6,0,0,2048,9,5720418338
4249,218293650,100839,218394489,7,0,0,29184,18,4910571973
4250,218330710,110909,218441619,8,0,0,16384,12,10458925504
4251,218417421,4162,218421583,2,0,1,11264,4,1573118592
4252,218425190,47288,218472478,7,0,0,1536,18,8920412238
4253,218457421,566,218457987,2,0,1,512,4,8692693372
4254,218518670,51140,218569810,4,0,0,4096,6,5571876155
4255,218576850,126308,218703158,5,0,0,114688,11,3886425497
4256,218635620,84902,218720522,5,0,0,3072,11,448098743
4257,218642920,566,218643486,5,0,1,512,11,1606139985
4258,218642979,61787,218704766,3,0,1,99840,9,7414601846
4259,218662990,246445,218909435,8,0,0,115712,12,1584921637
4260,218719040,124052,218843092,7,0,0,12288,18,434493002
4261,218773490,187509,218960999,4,0,0,25600,6,1410442312
4262,218822210,145980,218968190,6,0,0,23552,9,1885507047
4263,218939980,65900,219005880,7,0,0,7168,18,6426027903
4264,219009090,54056,219063146,6,0,0,3584,9,900048591
4265,219032720,193868,219226588,8,0,0,175104,12,6538645259
4266,219070529,290358,219360887,0,0,0,39936,10,7884677115
4267,219102460,1994,219104454,9,0,1,2048,10,6085384303
4268,219135140,107030,219242170,2,0,0,18432,4,5949246498
4269,219150200,151772,219301972,2,0,0,22016,4,10607164195
4270,219173201,58672,219231873,6,0,1,5632,9,1288694169
4271,219189070,279523,219468593,7,0,0,15872,18,6547954847
4272,219195700,152988,219348688,1,0,0,58880,14,627392359
4273,219307939,62674,219370613,3,0,1,101888,9,10714411439
4274,219309830,66172,219376002,8,0,1,25600,12,2713252675
4275,219341560,101935,219443495,8,0,0,10240,12,6282149718
4276,219412310,139471,219551781,6,0,0,1024,9,8909224129
4277,219496890,170395,219667285,2,0,0,14336,4,5700500616
4278,219500450,99344,219599794,6,0,0,31232,9,3742223712
4279,219562490,100412,219662902,1,0,0,29696,14,2044761605
4280,219564900,131164,219696064,2,0,0,51712,4,3507632547
4281,219619700,189110,219808810,8,0,0,77824,12,5838354254
4282,219630390,114448,219744838,3,0,0,29184,9,9150521932
4283,219637790,2470,219640260,1,0,1,2560,14,315079785
4284,219776690,68372,219845062,1,0,0,10240,14,7265820248
4285,219780660,101348,219882008,6,0,0,32768,9,5252755448
4286,219812730,127940,219940670,5,0,0,22528,11,9413483009
4287,219847990,105331,219953321,3,0,0,41472,9,836550280
4288,219862770,91034,219953804,5,0,0,1536,11,4891494555
4289,219976490,2946,219979436,4,0,1,3072,6,2522046487
4290,219977880,83132,220061012,2,0,0,13312,4,4093089830
4291,219992999,133539,220126538,9,0,0,25600,10,7670486306
4292,220001980,1518,220003498,8,0,1,1536,12,8991623167
4293,220055050,5985,220061035,5,0,1,5120,11,6461609721
4294,220057160,118707,220175867,5,0,0,22016,11,423342854
4295,220140860,98852,220239712,6,0,0,24576,9,854208855
4296,220240960,52364,220293324,8,0,0,3072,12,668056616
4297,220247970,143914,220391884,7,0,0,71680,18,8152253275
4298,220261980,52364,220314344,5,0,0,3072,11,6584148895
4299,220340980,66294,220407274,5,0,0,5120,11,2958720977
4300,220408180,1994,220410174,0,0,1,2048,10,7739172842
4301,220411090,72692,220483782,4,0,0,14336,6,4408943
4302,220456960,178119,220635079,1,0,0,21504,14,10479134451
4303,220475900,7897,220483797,5,0,1,7168,11,3089969515
4304,220516980,59295,220576275,2,0,0,5120,4,3366612199
4305,220645081,566,220645647,2,0,1,512,4,9592858609
4306,220659080,4937,220664017,7,0,1,12800,18,6540565793
4307,220725180,99476,220824656,6,0,0,26624,9,6201093591
4308,220810269,101624,220911893,3,0,1,164352,9,7235620973
4309,220862680,50493,220913173,8,0,1,14336,12,7166862893
4310,220873610,142321,221015931,3,0,0,11776,9,1252368496
4311,221025430,112533,221137963,4,0,0,58880,6,4418033956
4312,221031310,76052,221107362,5,0,0,10240,11,574664458
4313,221074759,116202,221190961,0,0,0,19968,10,6230645791
4314,221207570,52364,221259934,6,0,0,3072,9,6758883560
4315,221253800,106028,221359828,1,0,0,48128,14,411402931
4316,221329750,127088,221456838,6,0,0,117248,9,3393463640
4317,221334870,81684,221416554,8,0,0,10240,12,8248765247
4318,221348160,170622,221518782,1,0,0,46080,14,797056091
4319,221392389,173673,221566062,0,0,0,39936,10,10075834957
4320,221498790,73604,221572394,8,0,0,12288,12,8717433782
4321,221499260,103558,221602818,3,0,0,2048,9,7695628096
4322,221549900,16177,221566077,5,0,1,14848,11,4038871623
4323,221599840,100568,221700408,7,0,0,30208,18,8929158136
4324,221649299,101336,221750635,0,0,0,14336,10,10277612511
4325,221665760,4374,221670134,8,0,1,4608,12,5588071157
4326,221696160,109585,221805745,2,0,0,32768,4,10024744680
4327,222019500,66212,222085712,6,0,0,8192,9,3971150705
4328,222067980,48980,222116960,2,0,0,2048,4,1594399004
4329,222135859,85760,222221619,0,0,0,16896,10,330375448
4330,222232800,16096,222248896,4,0,1,31232,6,2179408736
4331,222304370,68601,222372971,6,0,0,5632,9,522420645
4332,222311760,5326,222317086,4,0,1,5632,6,503596587
4333,222402949,149738,222552687,9,0,0,28672,10,544293355
4334,222602840,90080,222692920,3,0,0,20992,9,2492699780
4335,222604559,125920,222730479,3,0,1,208384,9,1584716601
4336,222605410,164974,222770384,7,0,0,35840,18,4966688226
4337,222681550,52155,222733705,5,0,1,5120,11,6910839253
4338,222760860,162340,222923200,9,0,0,14336,10,7982093989
4339,222761810,134761,222896571,3,0,0,13824,9,4692093020
4340,222775440,164920,222940360,7,0,0,5120,18,8112464601
4341,222811730,126865,222938595,8,0,0,512,12,9007780783
4342,222896859,99634,222996493,0,0,0,25600,10,7133479004
4343,222912190,76488,222988678,2,0,0,16384,4,8263002060
4344,222935190,101660,223036850,7,0,0,33792,18,9944902921
4345,222961110,141560,223102670,9,0,0,35840,10,457894193
4346,222970500,67301,223037801,3,0,0,3072,9,9645797909
4347,223015879,45596,223061475,0,0,0,1024,10,6823489163
4348,223083910,104624,223188534,2,0,0,43520,4,5335401876
4349,223268160,94868,223363028,7,0,0,26624,18,8336777765
4350,223279039,95893,223374932,0,0,0,10240,10,6024218194
4351,223488139,56216,223544355,0,0,0,5632,10,7317773754
4352,223518090,52364,223570454,7,0,0,3072,18,4797234284
4353,223539590,98384,223637974,3,0,0,23040,9,9967382321
4354,223622310,57596,223679906,8,0,0,5120,12,8726084275
4355,223623040,75450,223698490,6,0,0,7680,9,4652459811
4356,223648251,3898,223652149,6,0,1,4096,9,5134298101
4357,223665850,100256,223766106,8,0,0,29184,12,3050062781
4358,223719630,95288,223814918,7,0,0,17920,18,1911145569
4359,223745050,193418,223938468,1,0,0,37888,14,488333654
4360,223765609,147067,223912676,0,0,0,25088,10,7629370733
4361,223857430,148582,224006012,1,0,0,31744,14,4700269633
4362,223887080,6754,223893834,5,0,1,7168,11,10215985611
4363,223888860,78197,223967057,6,0,0,10752,9,9780247039
4364,223975040,4374,223979414,7,0,1,4608,18,10299633343
4365,224018920,60980,224079900,7,0,0,6144,18,1899438645
4366,224022440,6754,224029194,5,0,1,7168,11,172865692
4367,224049990,73572,224123562,2,0,0,7168,4,5410539118
4368,224078670,147588,224226258,8,0,0,44544,12,5592562240
4369,224141270,99164,224240434,7,0,0,25600,18,243340240
4370,224161120,150804,224311924,8,0,0,32256,12,5602375108
4371,224385610,106496,224492106,3,0,0,49664,9,5704044370
4372,224420540,13858,224434398,8,0,1,23552,12,5143696730
4373,224445960,91824,224537784,4,0,0,22016,6,9791014534
4374,224601660,54056,224655716,9,0,0,3584,10,9566752223
4375,224628320,199050,224827370,4,0,0,177664,6,10201155011
4376,224715479,113622,224829101,9,0,0,5632,10,2191000843
4377,224743840,147264,224891104,2,0,0,51200,4,2180471012
4378,224895951,4850,224900801,2,0,1,5120,4,1038682831
4379,224934650,50984,224985634,6,0,0,3584,9,2827629437
4380,224940269,180848,225121117,0,0,0,36864,10,8889003700
4381,224963290,6278,224969568,7,0,1,6656,18,9995725469
4382,225014690,95180,225109870,8,0,0,27648,12,10380833826
4383,225063570,61726,225125296,9,0,0,1536,10,4334025820
4384,225085580,77924,225163504,2,0,0,16384,4,733316844
4385,225141619,74145,225215764,0,0,0,9216,10,10185035019
4386,225150150,79616,225229766,1,0,0,16896,14,8248286791
4387,225161670,104266,225265936,2,0,0,36352,4,4063394490
4388,225231950,200804,225432754,8,0,0,194560,12,6900264109
4389,225353560,566,225354126,0,0,1,512,10,7531030124
4390,225390880,123873,225514753,8,0,0,5120,12,2962647151
4391,225391480,130776,225522256,2,0,0,24576,4,10381474178
4392,225405650,31537,225437187,0,0,1,4608,10,8253328208
4393,225429909,151238,225581147,0,0,0,71168,10,8753150607
4394,225466320,566,225466886,7,0,1,512,18,1961893981
4395,225485020,187567,225672587,3,0,0,66560,9,8386933371
4396,225502840,1518,225504358,5,0,1,1536,11,7066363856
4397,225509330,124281,225633611,7,0,0,9216,18,3070245963
4398,225653510,134301,225787811,2,0,0,78336,4,884629813
4399,225695740,5802,225701542,7,0,1,6144,18,1826960546
4400,225704390,145215,225849605,7,0,0,48128,18,2080932477
4401,225744080,1042,225745122,4,0,1,1024,6,4915634602
4402,225820400,83468,225903868,4,0,0,19456,6,4268737007
4403,225842130,63215,225905345,1,0,0,4096,14,4234007403
4404,225856869,78301,225935170,0,0,0,5120,10,6303427587
4405,225952780,111176,226063956,7,0,0,65024,18,1516980463
4406,225956440,145280,226101720,3,0,0,27648,9,7884365099
4407,225987170,3645,225990815,5,0,1,10240,11,6904990333
4408,226168171,1518,226169689,6,0,1,1536,9,8782194930
4409,226187790,94064,226281854,2,0,0,18944,4,2255739064
4410,226234000,24929,226258929,5,0,1,45056,11,2775722896
4411,226265310,78368,226343678,7,0,0,12800,18,6415902344
4412,226272699,82538,226355237,0,0,0,7168,10,8317265890
4413,226322560,214833,226537393,7,0,0,30720,18,1218787937
4414,226387780,68216,226455996,7,0,0,9728,18,7362229145
4415,226486670,74832,226561502,4,0,0,10752,6,9839068110
4416,226494510,104156,226598666,7,0,0,41984,18,7121726505
4417,226505990,21141,226527131,7,0,1,34304,18,5966733609
4418,226513360,88129,226601489,2,0,0,9216,4,1525422061
4419,226625649,48980,226674629,0,0,0,2048,10,402188837
4420,226664870,89768,226754638,6,0,0,19968,9,7429260401
4421,226809380,64208,226873588,3,0,0,6656,9,6489691853
4422,226865830,54056,226919886,3,0,0,3584,9,6969483108
4423,226909850,101653,227011503,6,0,0,24064,9,4873701786
4424,226924720,72224,226996944,2,0,0,12800,4,1262429272
4425,226926020,78136,227004156,6,0,0,11264,9,2934656055
4426,226978410,113845,227092255,3,0,0,24064,9,1093833163
4427,226981010,3387,226984397,0,0,1,9728,10,10164591562
4428,227007980,5985,227013965,5,0,1,2560,11,2017104113
4429,227030510,3422,227033932,0,0,1,3584,10,7884353219
4430,227048240,109304,227157544,2,0,0,58880,4,8961043273
4431,227117430,68830,227186260,6,0,0,9728,9,4580618320
4432,227164280,566,227164846,9,0,1,512,10,10514344560
4433,227189320,82220,227271540,1,0,0,15360,14,1624448889
4434,227225149,84980,227310129,9,0,0,14336,10,2405581084
4435,227244430,3904,227248334,9,0,1,10752,10,10254640023
4436,227257920,2470,227260390,8,0,1,2560,12,7496387599
4437,227296981,1042,227298023,2,0,1,1024,4,10587195073
4438,227351990,52364,227404354,7,0,0,3072,18,9978303338
4439,227399840,566,227400406,1,0,1,512,14,3024590053
4440,227421950,55748,227477698,4,0,0,4096,6,6916674885
4441,227515930,47288,227563218,8,0,0,1536,12,10309218496
4442,227542740,2470,227545210,9,0,1,2560,10,1032361941
4443,227612140,3904,227616044,8,0,1,10752,12,5484428521
4444,227612690,105527,227718217,2,0,0,37376,4,3515199850
4445,227638979,114344,227753323,0,0,0,15360,10,8287211670
4446,227672490,84904,227757394,8,0,0,13312,12,3268992618
4447,227679760,4420,227684180,5,0,1,11776,11,10002836573
4448,227683810,2946,227686756,9,0,1,3072,10,9679627885
4449,227811630,67304,227878934,8,0,0,11776,12,3475170262
4450,227821339,3898,227825237,3,0,1,4096,9,10052100750
4451,227861710,6278,227867988,0,0,1,6656,10,3809493252
4452,227912620,7706,227920326,4,0,1,8192,6,2019232782
4453,228005279,79772,228085051,0,0,0,17408,10,4040253329
4454,228066420,105451,228171871,8,0,0,43008,12,4357431630
4455,228277600,100880,228378480,8,0,0,31232,12,7016313702
4456,228313840,68226,228382066,4,0,0,6144,6,3743213634
4457,228319230,1042,228320272,0,0,1,1024,10,7209577741
4458,228373900,51860,228425760,6,0,0,1536,9,7755257416
4459,228389990,52364,228442354,4,0,0,3072,6,1421860235
4460,228468090,67748,228535838,6,0,0,8192,9,9104168397
4461,228494939,66721,228561660,3,0,1,113152,9,3525741581
4462,228517520,44601,228562121,8,0,1,10240,12,9393072430
4463,228574880,209928,228784808,8,0,0,47616,12,6707304984
4464,228621220,94896,228716116,6,0,0,27136,9,2981384902
4465,228765170,126302,228891472,2,0,0,33792,4,9353004589
4466,228772771,16208,228788979,2,0,1,11264,4,1257150776
4467,228773770,102515,228876285,4,0,0,20480,6,1039754740
4468,228791880,121431,228913311,2,0,0,14848,4,3309408990
4469,228847270,57440,228904710,4,0,0,4608,6,604059861
4470,229119880,100724,229220604,6,0,0,30720,9,10372451840
4471,229185609,98564,229284173,9,0,0,28672,10,5696078431
4472,229413320,76232,229489552,1,0,0,15872,14,8372076105
4473,229479339,105092,229584431,0,0,0,45056,10,2940102590
4474,229482320,175473,229657793,2,0,0,57856,4,520804059
4475,229557200,75963,229633163,1,0,0,6144,14,8780762209
4476,229593250,92839,229686089,1,0,0,17408,14,900490936
4477,229597700,92772,229690472,8,0,0,14336,12,343795327
4478,229612690,4162,229616852,7,0,1,11264,18,6719650900
4479,229862029,104624,229966653,9,0,0,43520,10,2069402909
4480,229933069,98228,230031297,0,0,0,22528,10,9339658007
4481,230169550,2470,230172020,1,0,1,2560,14,547906892
4482,230181860,57440,230239300,6,0,0,4608,9,4473395860
4483,230312290,1994,230314284,9,0,1,2048,10,2698349259
4484,230408100,66212,230474312,8,0,0,8192,12,4167942588
4485,230434030,84880,230518910,7,0,0,12288,18,6553583028
4486,230436950,62516,230499466,6,0,0,6144,9,1155562979
4487,230467580,2870,230470450,0,0,1,8704,10,8150658550
4488,230470810,132694,230603504,6,0,0,61952,9,7951752322
4489,230581029,63608,230644637,9,0,0,9728,10,6916305782
4490,230607930,89456,230697386,8,0,0,18944,12,1100555941
4491,230724560,52364,230776924,6,0,0,3072,9,2421798549
4492,230751829,47288,230799117,9,0,0,1536,10,1764754114
4493,230760920,128180,230889100,2,0,0,120832,4,1832397764
4494,230798940,112150,230911090,2,0,0,20480,4,1794483307
4495,230818180,131652,230949832,4,0,0,20480,6,1867786812
4496,230941080,97604,231038684,7,0,0,20480,18,2798021919
4497,230957290,67592,231024882,4,0,0,7680,6,4571823233
4498,231054999,62516,231117515,0,0,0,6144,10,10483619371
4499,231128150,54212,231182362,2,0,0,4096,4,5852635639
4500,231246869,14287,231261156,3,0,1,27648,9,8403399075
4501,231285650,63920,231349570,4,0,0,10752,6,17360759
4502,231329440,95312,231424752,2,0,0,23040,4,3519285776
4503,231353600,5326,231358926,8,0,1,5632,12,3173017333
4504,231396480,4850,231401330,5,0,1,5120,11,45708578
4505,231458749,96808,231555557,9,0,0,12800,10,8164576732
4506,231521300,99788,231621088,2,0,0,27648,4,159146167
4507,231611920,76832,231688752,1,0,0,12800,14,3280801690
4508,231774750,3898,231778648,1,0,1,4096,14,9811370713
4509,231783170,102752,231885922,4,0,0,37376,6,9179138649
4510,231850880,107588,231958468,1,0,0,53248,14,4548570856
4511,231861570,183832,232045402,2,0,0,110592,4,7784641493
4512,231922260,53144,231975404,2,0,0,5632,4,6482626743
4513,231932370,113367,232045737,8,0,0,1024,12,1203690761
4514,232029189,118801,232147990,0,0,0,36864,10,8806889011
4515,232053940,2470,232056410,0,0,1,2560,10,3062921228
4516,232065850,54056,232119906,6,0,0,3584,9,5169894014
4517,232104610,90524,232195134,7,0,0,17408,18,3222292953
4518,232226931,4374,232231305,6,0,1,4608,9,3549860566
4519,232277381,7230,232284611,2,0,1,7680,4,2811345301
4520,232309350,74360,232383710,6,0,0,9728,9,2907847392
4521,232343739,99164,232442903,0,0,0,25600,10,278933015
4522,232345620,47288,232392908,7,0,0,1536,18,3886495437
4523,232388589,64520,232453109,9,0,0,7680,10,8737028826
4524,232406260,127795,232534055,7,0,0,25088,18,7584873975
4525,232480139,112626,232592765,9,0,0,25088,10,8270293251
4526,232590930,109259,232700189,3,0,0,52736,9,530099594
4527,232608790,4162,232612952,4,0,1,11264,6,9929283962
4528,232664040,91380,232755420,1,0,0,19968,14,4944422027
4529,232682640,75603,232758243,4,0,0,9216,6,9247956836
4530,232732659,116792,232849451,0,0,0,83456,10,3724353238
4531,232831349,22961,232854310,3,0,1,5120,9,5672203021
4532,232837289,69619,232906908,0,0,0,4608,10,2491041076
4533,232954689,100880,233055569,9,0,0,31232,10,9259094069
4534,232975070,43904,233018974,4,0,0,512,6,67837716
4535,233018890,72853,233091743,8,0,0,7680,12,8445242949
4536,233093420,59288,233152708,7,0,0,5632,18,2319619317
4537,233104210,101972,233206182,7,0,0,34816,18,9826203429
4538,233122390,1518,233123908,1,0,1,1536,14,5443616145
4539,233234160,108680,233342840,9,0,0,56832,10,291468478
4540,233295089,77667,233372756,0,0,0,1536,10,4081755794
4541,233309759,113937,233423696,0,0,0,22528,10,9611993787
4542,233315219,120036,233435255,9,0,0,37888,10,8822770019
4543,233355800,87870,233443670,4,0,0,16384,6,7662030917
4544,233357399,162071,233519470,0,0,0,49664,10,9143931668
4545,233413211,22059,233435270,6,0,1,17408,9,9233878850
4546,233435289,105983,233541272,0,0,0,23040,10,889250155
4547,233464970,59132,233524102,8,0,0,5120,12,3255935721
4548,233529970,65658,233595628,1,0,0,4096,14,3353469211
4549,233545349,6754,233552103,3,0,1,7168,9,7828550161
4550,233567920,1518,233569438,8,0,1,1536,12,5469536895
4551,233639840,103220,233743060,6,0,0,38912,9,2960298581
4552,233641770,172510,233814280,8,0,0,13312,12,6690144293
4553,233743770,81776,233825546,4,0,0,18944,6,1253498698
4554,233787020,6278,233793298,4,0,1,6656,6,6520346773
4555,233816850,55748,233872598,4,0,0,4096,6,2738213010
4556,233826520,168517,233995037,6,0,0,26624,9,6802886757
4557,233851200,2946,233854146,4,0,1,3072,6,2625797191
4558,233924250,120911,234045161,4,0,0,17408,6,9145368971
4559,233942550,97292,234039842,7,0,0,19456,18,7231281499
4560,234109760,70856,234180616,8,0,0,9728,12,10553327416
4561,234110489,67148,234177637,0,0,0,11264,10,3301085617
4562,234221860,56372,234278232,6,0,0,6144,9,4008562874
4563,234346469,10757,234357226,3,0,1,17408,9,2815019334
4564,234398580,110552,234509132,9,0,0,62976,10,3286165113
4565,234565490,1994,234567484,1,0,1,2048,14,5430265408
4566,234590700,105872,234696572,6,0,0,47616,9,6794680738
4567,234663000,132038,234795038,1,0,0,19968,14,7233477482
4568,234666870,117260,234784130,4,0,0,84992,6,2001453619
4569,234882370,60824,234943194,7,0,0,5632,18,985998596
4570,234886660,6278,234892938,8,0,1,6656,12,638585648
4571,234993231,5971,234999202,6,0,1,14848,9,1998374101
4572,235031640,54056,235085696,8,0,0,3584,12,10474764012
4573,235069580,47288,235116868,4,0,0,1536,6,3110894318
4574,235082140,87764,235169904,1,0,0,18432,14,7113695283
4575,235153860,80840,235234700,8,0,0,15872,12,7765422484
4576,235197820,71780,235269600,4,0,0,16384,6,5907092846
4577,235203010,120730,235323740,1,0,0,23552,14,1910876079
4578,235237190,69412,235306602,7,0,0,5632,18,3748479348
4579,235255400,73204,235328604,6,0,0,6144,9,1716245127
4580,235256730,127536,235384266,9,0,0,11264,10,2205540775
4581,235283480,210340,235493820,6,0,0,142848,9,2325050231
4582,235409020,112652,235521672,7,0,0,40448,18,6064806637
4583,235499529,110368,235609897,0,0,0,19968,10,3525549154
4584,235504550,97136,235601686,6,0,0,18944,9,3073364123
4585,235505000,2946,235507946,5,0,1,3072,11,3060369708
4586,235635810,102752,235738562,4,0,0,37376,6,3436092170
4587,235636160,5326,235641486,1,0,1,5632,14,3919530208
4588,235748620,99944,235848564,7,0,0,28160,18,9369132747
4589,235820201,6488,235826689,6,0,1,15872,9,6492887484
4590,235844890,89606,235934496,6,0,0,22528,9,5352366314
4591,235850671,2470,235853141,6,0,1,2560,9,1923094653
4592,235881929,69620,235951549,0,0,0,14336,10,10229444172
4593,235928530,62499,235991029,8,0,0,512,12,10300555156
4594,235982119,13341,235995460,3,0,1,22528,9,842042738
4595,235997210,91390,236088600,7,0,0,10752,18,292977264
4596,236011960,81380,236093340,6,0,0,6144,9,7885867636
4597,236040630,11016,236051646,4,0,1,17920,6,9835678222
4598,236082520,1994,236084514,5,0,1,2048,11,2534196060
4599,236122449,127092,236249541,0,0,0,2048,10,10559471888
4600,236177940,85497,236263437,3,0,0,17408,9,5570362701
4601,236226470,110293,236336763,7,0,0,55296,18,5882824549
4602,236229230,107860,236337090,8,0,0,1024,12,1028183928
4603,236391800,11791,236403591,4,0,1,19456,6,4086949480
4604,236393850,51215,236445065,7,0,0,1536,18,8418269267
4605,236442580,6754,236449334,7,0,1,7168,18,2733091240
4606,236638849,85905,236724754,9,0,0,15360,10,3749529843
4607,236647859,150904,236798763,9,0,0,67584,10,523877356
4608,236656770,2870,236659640,5,0,1,8704,11,950004263
4609,236768510,101660,236870170,6,0,0,33792,9,6203368827
4610,236909240,67460,236976700,6,0,0,12288,9,424206258
4611,236909860,111176,237021036,5,0,0,65024,11,4558703622
4612,236970470,120538,237091008,3,0,0,35328,9,4915009728
4613,236985320,5712,236991032,7,0,1,14336,18,8204239535
4614,236992509,186990,237179499,0,0,0,96768,10,5860362060
4615,237129799,119456,237249255,0,0,0,20992,10,2968049849
4616,237141560,110518,237252078,7,0,0,9216,18,3950702302
4617,237143280,94419,237237699,1,0,0,13312,14,2593733764
4618,237218199,84984,237303183,0,0,0,9216,10,493259383
4619,237242110,62804,237304914,4,0,0,5632,6,7593269969
4620,237269110,5196,237274306,9,0,1,13312,10,3620014936
4621,237335600,72668,237408268,6,0,0,9216,9,833905829
4622,237375270,69268,237444538,4,0,0,6144,6,8767234459
4623,237487100,5712,237492812,5,0,1,14336,11,7208871538
4624,237572529,45596,237618125,0,0,0,1024,10,6802450379
4625,237746229,98228,237844457,9,0,0,22528,10,8094537591
4626,237783580,10499,237794079,4,0,1,16896,6,1980156126
4627,237808050,5326,237813376,0,0,1,5632,10,2857321579
4628,237825790,68159,237893949,8,0,0,9728,12,2431169045
4629,237830980,48980,237879960,4,0,0,2048,6,7924132770
4630,237834949,96896,237931845,9,0,0,17408,10,5813152219
4631,237883320,120951,238004271,5,0,0,27136,11,4283502798
4632,237890289,73472,237963761,0,0,0,16896,10,8980876363
4633,237980309,76988,238057297,9,0,0,13312,10,7787096265
4634,238040770,2470,238043240,4,0,1,2560,6,9542074796
4635,238145609,101816,238247425,0,0,0,34304,10,1245413475
4636,238170250,13083,238183333,7,0,1,22016,18,1380910410
4637,238228159,4850,238233009,3,0,1,5120,9,5934156854
4638,238272050,70976,238343026,6,0,0,8704,9,9939370945
4639,238275850,4850,238280700,5,0,1,5120,11,2191773819
4640,238299580,179695,238479275,3,0,0,17408,9,5244732415
4641,238332720,112314,238445034,4,0,0,30208,6,5051897101
4642,238338210,135746,238473956,3,0,0,22528,9,3303143695
4643,238462920,77924,238540844,8,0,0,16384,12,4637324050
4644,238591760,106184,238697944,2,0,0,48640,4,1650645035
4645,238595630,62072,238657702,3,0,0,9728,9,4830950323
4646,238646090,87920,238734010,2,0,0,18944,4,9294583682
4647,238749819,102128,238851947,0,0,0,35328,10,4734939340
4648,238800620,133899,238934519,8,0,0,72192,12,8153275893
4649,238843230,96616,238939846,7,0,0,17408,18,8689464516
4650,238856120,122769,238978889,6,0,0,14848,9,9638608558
4651,238928630,90105,239018735,4,0,0,16896,6,10651338866
4652,238932340,145063,239077403,1,0,0,48128,14,4176242552
4653,238959370,164299,239123669,7,0,0,47616,18,841470352
4654,239001520,171403,239172923,2,0,0,61952,4,1039938547
4655,239147790,54056,239201846,4,0,0,3584,6,7836790045
4656,239153941,18997,239172938,2,0,1,12800,4,2592578099
4657,239189360,3645,239193005,7,0,1,10240,18,6224291759
4658,239197420,113171,239310591,2,0,0,7680,4,2851577951
4659,239201171,3613,239204784,2,0,1,3072,4,2847245578
4660,239207200,101036,239308236,2,0,0,31744,4,5096653876
4661,239225650,199713,239425363,3,0,0,47616,9,7991344979
4662,239349360,114964,239464324,4,0,0,17408,6,4508305292
4663,239365620,60070,239425690,2,0,0,1024,4,8468414405
4664,239409180,102284,239511464,2,0,0,35840,4,7070432828
4665,239441410,52832,239494242,3,0,0,4608,9,1413445885
4666,239541310,47288,239588598,4,0,0,1536,6,3050417232
4667,239549480,103844,239653324,8,0,0,40960,12,5429742995
4668,239647390,81846,239729236,2,0,0,14848,4,4134515348
4669,239811620,566,239812186,5,0,1,512,11,8332918670
4670,239848270,56528,239904798,1,0,0,6656,14,2466015319
4671,239896050,68840,239964890,8,0,0,11776,12,7995295028
4672,239914320,127022,240041342,5,0,0,101376,11,2282834147
4673,239946499,102433,240048932,0,0,0,9216,10,3542068821
4674,240059230,4420,240063650,5,0,1,11776,11,3533636543
4675,240116280,63296,240179576,6,0,0,8704,9,1825896955
4676,240162840,163073,240325913,2,0,0,30208,4,4643793186
4677,240216750,99944,240316694,1,0,0,28160,14,2579210959
4678,240245119,116419,240361538,9,0,0,11776,10,7758236584
4679,240286779,166063,240452842,0,0,0,7680,10,8409483436
4680,240306570,143917,240450487,4,0,0,89088,6,9923431896
4681,240327190,135042,240462232,8,0,0,30720,12,2220672176
4682,240357650,208388,240566038,8,0,0,14336,12,4099624441
4683,240362780,100247,240463027,1,0,0,2560,14,3382024147
4684,240367770,193885,240561655,3,0,0,98816,9,2521087200
4685,240397620,55237,240452857,5,0,1,61440,11,2892581434
4686,240475529,116516,240592045,0,0,0,20992,10,967322780
4687,240520580,184342,240704922,4,0,0,36864,6,6549931012
4688,240525380,146111,240671491,4,0,0,53760,6,2359650439
4689,240730390,100256,240830646,6,0,0,29184,9,7317837563
4690,240771499,48980,240820479,0,0,0,2048,10,6914369217
4691,240794720,89588,240884308,1,0,0,14336,14,3713385023
4692,240833210,133016,240966226,3,0,0,50176,9,3991717435
4693,240896670,141826,241038496,2,0,0,59392,4,6517356858
4694,240926770,230097,241156867,4,0,0,29184,6,907810933
4695,240972490,6754,240979244,8,0,1,7168,12,9496548534
4696,241016209,75111,241091320,9,0,0,8704,10,6502312638
4697,241079210,84068,241163278,8,0,0,16384,12,9575232020
4698,241105100,88520,241193620,6,0,0,15872,9,3303945860
4699,241113820,93540,241207360,1,0,0,8704,14,3527400485
4700,241146750,241385,241388135,1,0,0,36352,14,77686743
4701,241180250,1518,241181768,4,0,1,1536,6,5733320182
4702,241211090,81128,241292218,8,0,0,11776,12,8231131420
4703,241293690,107063,241400753,1,0,0,1024,14,7710990052
4704,241443770,70976,241514746,6,0,0,8704,9,4288472768
4705,241456921,12308,241469229,6,0,1,20480,9,5674398839
4706,241470259,4162,241474421,3,0,1,11264,9,1042639549
4707,241492029,45596,241537625,0,0,0,1024,10,8380395848
4708,241506660,43904,241550564,3,0,0,512,9,202903980
4709,241510320,45908,241556228,3,0,0,2048,9,7801942043
4710,241620659,50672,241671331,0,0,0,2560,10,9747280300
4711,241625571,3422,241628993,2,0,1,3584,4,7895973090
4712,241635069,566,241635635,3,0,1,512,9,6432074193
4713,241853119,92684,241945803,0,0,0,19456,10,8313830335
4714,241866680,65900,241932580,3,0,0,7168,9,176226926
4715,241961929,63920,242025849,0,0,0,10752,10,3441995411
4716,242025440,56997,242082437,5,0,1,96768,11,2101745727
4717,242058231,24974,242083205,6,0,1,11776,9,8497422725
4718,242110700,11274,242121974,0,0,1,18432,10,9216203781
4719,242163800,1994,242165794,7,0,1,2048,18,5111413348
4720,242193900,187556,242381456,2,0,0,14848,4,9784962059
4721,242206330,111895,242318225,3,0,0,1536,9,5645567603
4722,242256310,120607,242376917,6,0,0,60928,9,4800009160
4723,242342979,123045,242466024,9,0,0,74752,10,483697387
4724,242382000,1042,242383042,8,0,1,1024,12,772613804
4725,242390639,76960,242467599,0,0,0,5120,10,9352117370
4726,242407090,204805,242611895,1,0,0,33792,14,6645089534
4727,242430350,99476,242529826,7,0,0,26624,18,7707777594
4728,242440560,89749,242530309,1,0,0,1536,14,5386418536
4729,242458230,73307,242531537,4,0,0,3072,6,4696028083
4730,242461771,12123,242473894,6,0,1,6656,9,10233821883
4731,242728619,106028,242834647,9,0,0,48128,10,1884259418
4732,242772340,134241,242906581,7,0,0,51200,18,7639949641
4733,242801570,108146,242909716,7,0,0,10240,18,9182874700
4734,242815080,53827,242868907,4,0,0,2048,6,7066019529
4735,242965140,97472,243062612,4,0,0,25088,6,6821125739
4736,243017290,113711,243131001,3,0,0,15872,9,2856415069
4737,243038160,101592,243139752,3,0,0,28672,9,4335307691
4738,243061599,114575,243176174,0,0,0,15872,10,5399237892
4739,243075010,51140,243126150,2,0,0,4096,4,9477058359
4740,243135380,90420,243225800,6,0,0,11264,9,5436035338
4741,243184330,66808,243251138,4,0,0,2560,6,84046091
4742,243187270,111956,243299226,1,0,0,67584,14,3715488793
4743,243199610,3387,243202997,9,0,1,9728,10,5747345334
4744,243217410,194689,243412099,7,0,0,46592,18,6938524080
4745,243228590,135622,243364212,6,0,0,62976,9,6857436782
4746,243345650,21517,243367167,0,0,1,3072,10,6550345529
4747,243348320,21753,243370073,1,0,1,4608,14,5670766446
4748,243400951,14562,243415513,2,0,1,3584,4,704287699
4749,243476430,91269,243567699,6,0,0,11264,9,5378385478
4750,243487900,5802,243493702,1,0,1,6144,14,688478024
4751,243616119,69620,243685739,0,0,0,14336,10,778775313
4752,243735600,1518,243737118,9,0,1,1536,10,6605648481
4753,243789280,3128,243792408,7,0,1,9216,18,5146536562
4754,243826409,129836,243956245,0,0,0,15360,10,8553409687
4755,243919020,56840,243975860,3,0,0,7680,9,1626089656
4756,243936989,109679,244046668,0,0,0,20480,10,3511168470
4757,243950600,77070,244027670,6,0,0,10240,9,7636159136
4758,244006980,115858,244122838,1,0,0,42496,14,9141756114
4759,244100070,115076,244215146,8,0,0,77824,12,7265385552
4760,244129200,117944,244247144,7,0,0,15360,18,865533685
4761,244137930,7706,244145636,9,0,1,8192,10,5103598212
4762,244163700,93554,244257254,4,0,0,2048,6,7640735481
4763,244177050,119258,244296308,6,0,0,3072,9,3138937101
4764,244203130,109612,244312742,3,0,0,20480,9,8288604569
4765,244207770,112226,244319996,3,0,0,10240,9,10536878110
4766,244218820,167284,244386104,6,0,0,33280,9,1228948372
4767,244277109,150917,244428026,0,0,0,23552,10,2081793203
4768,244301459,104624,244406083,0,0,0,43520,10,4079937357
4769,244397029,116166,244513195,0,0,0,51712,10,5532774684
4770,244431119,137594,244568713,9,0,0,26112,10,2966639559
4771,244497610,140368,244637978,4,0,0,7680,6,888659321
4772,244504889,110139,244615028,9,0,0,34304,10,7372026713
4773,244577590,162632,244740222,5,0,1,263168,11,10261559024
4774,244598729,178858,244777587,9,0,0,26624,10,3345262642
4775,244639790,70438,244710228,6,0,0,3072,9,8859702880
4776,244659000,174892,244833892,3,0,0,33792,9,5632580532
4777,244666030,134321,244800351,6,0,0,512,9,5697354963
4778,244670779,252528,244923307,9,0,0,80896,10,6619741462
4779,244737929,157131,244895060,9,0,0,7168,10,8406470647
4780,244743830,4850,244748680,1,0,1,5120,14,9320173775
4781,244766530,179351,244945881,3,0,0,12800,9,2082234013
4782,244873189,2946,244876135,3,0,1,3072,9,978246567
4783,244963680,101192,245064872,7,0,0,32256,18,5232006667
4784,245027201,566,245027767,2,0,1,512,4,10675405073
4785,245058850,106738,245165588,8,0,0,30720,12,2788311091
4786,245270770,74228,245344998,4,0,0,14336,6,2649925453
4787,245364470,52718,245417188,3,0,0,1536,9,4796675116
4788,245369900,99008,245468908,2,0,0,25088,4,4878386110
4789,245374220,127196,245501416,6,0,0,46080,9,7852445398
4790,245403610,156246,245559856,8,0,0,13824,12,4691513822
4791,245452830,6278,245459108,8,0,1,6656,12,7280011125
4792,245547330,173457,245720787,2,0,0,15872,4,3700355332
4793,245561269,126464,245687733,0,0,0,115200,10,8629781693
4794,245610080,160849,245770929,6,0,0,88576,9,4021707075
4795,245627869,566,245628435,3,0,1,512,9,4287056790
4796,245697150,101097,245798247,7,0,0,10752,18,6871354204
4797,245699560,88853,245788413,2,0,0,2560,4,3853825735
4798,245778110,3422,245781532,7,0,1,3584,18,7127759145
4799,245845370,82064,245927434,6,0,0,14848,9,10394064053
4800,245873840,125342,245999182,3,0,0,36352,9,7423645681
4801,245914850,149390,246064240,6,0,0,47104,9,9170197776
4802,245942170,126453,246068623,7,0,0,14336,18,9531123920
4803,245999030,103160,246102190,1,0,0,9216,14,3777710500
4804,246081750,117832,246199582,1,0,0,29184,14,10703300233
4805,246086899,99567,246186466,0,0,0,16384,10,2415372761
4806,246139439,137393,246276832,9,0,0,34304,10,6199450881
4807,246158120,106964,246265084,6,0,0,51200,9,8158432049
4808,246223630,4374,246228004,8,0,1,4608,12,5199272885
4809,246225790,124210,246350000,2,0,0,8192,4,2273084336
4810,246241131,23976,246265107,6,0,1,43008,9,5836454831
4811,246250430,150110,246400540,8,0,0,17408,12,2235319581
4812,246312500,90863,246403363,4,0,0,9216,6,7783710154
4813,246398299,11810,246410109,3,0,1,7168,9,2379567956
4814,246411580,152507,246564087,5,0,1,246784,11,5546123548
4815,246706360,108880,246815240,6,0,0,53248,9,9857593580
4816,246738760,143110,246881870,8,0,0,38912,12,8396549733
4817,246814010,5126,246819136,9,0,1,10752,10,5076645062
4818,246837870,99004,246936874,4,0,0,16896,6,8221578459
4819,246855730,154038,247009768,3,0,0,28160,9,7610744783
4820,246951100,6754,246957854,1,0,1,7168,14,5606234838
4821,246995850,52364,247048214,7,0,0,3072,18,7737429811
4822,247049040,63920,247112960,2,0,0,10752,4,6085025844
4823,247132739,103532,247236271,0,0,0,39936,10,9215385567
4824,247260149,47288,247307437,9,0,0,1536,10,1006240136
4825,247296310,64742,247361052,5,0,1,105984,11,2756742666
4826,247349000,12820,247361820,8,0,1,11776,12,341112259
4827,247414010,92216,247506226,7,0,0,17920,18,3859538361
4828,247495730,3128,247498858,1,0,1,9216,14,8238156897
4829,247507670,220857,247728527,2,0,0,34816,4,5005828696
4830,247519920,65900,247585820,6,0,0,7168,9,3060189711
4831,247538790,109906,247648696,2,0,0,35840,4,9929578382
4832,247793960,104780,247898740,8,0,0,44032,12,5058741998
4833,247808989,149925,247958914,0,0,0,28672,10,6076710914
4834,247896479,77705,247974184,9,0,0,13312,10,6212675786
4835,247899200,75155,247974355,2,0,0,512,4,1981758521
4836,247910369,49028,247959397,9,0,0,1536,10,6719098474
4837,248015369,63764,248079133,0,0,0,10240,10,718494296
4838,248040109,119718,248159827,0,0,0,47104,10,5476074284
4839,248188350,70976,248259326,1,0,0,8704,14,2464301057
4840,248257679,47547,248305226,0,0,0,2048,10,9443549178
4841,248298689,82844,248381533,9,0,0,17408,10,1683293705
4842,248358779,128804,248487583,0,0,0,122880,10,5373397569
4843,248387910,133621,248521531,1,0,0,10240,14,908199238
4844,248536290,102596,248638886,8,0,0,36864,12,7656302797
4845,248633770,9958,248643728,8,0,1,5120,12,5911609913
4846,248652181,5802,248657983,6,0,1,6144,9,2495446744
4847,248673430,152651,248826081,2,0,0,4096,4,4086716038
4848,248785270,97760,248883030,3,0,0,20992,9,6106844152
4849,248804740,47305,248852045,1,0,0,1536,14,212974625
4850,248819680,113108,248932788,4,0,0,11776,6,2688482314
4851,248990479,101036,249091515,0,0,0,31744,10,4279160354
4852,249053709,89144,249142853,9,0,0,17920,10,9251627156
4853,249063940,162891,249226831,5,0,1,263680,11,6112120645
4854,249101179,160706,249261885,9,0,0,14336,10,9355169902
4855,249106830,188868,249295698,3,0,0,18432,9,1817836104
4856,249169260,263872,249433132,1,0,0,34304,14,8354649143
4857,249170140,57459,249227599,8,0,1,11776,12,7717001203
4858,249206550,26195,249232745,4,0,1,8192,6,7206301603
4859,249208890,196787,249405677,1,0,0,25600,14,4926074020
4860,249242750,250596,249493346,2,0,0,49152,4,10160923887
4861,249322410,112453,249434863,2,0,0,5632,4,5928462288
4862,249333780,1518,249335298,7,0,1,1536,18,835496292
4863,249455059,168423,249623482,0,0,0,30720,10,5575908301
4864,249608550,83132,249691682,1,0,0,13312,14,1839517854
4865,249636540,4850,249641390,8,0,1,5120,12,4468427673
4866,249671811,93825,249765636,5,0,1,152576,11,5373021094
4867,249684420,229724,249914144,2,0,0,17408,4,10653907591
4868,250051920,86204,250138124,6,0,0,13312,9,10280406113
4869,250151030,4374,250155404,9,0,1,4608,10,9670187131
4870,250187880,82220,250270100,8,0,0,15360,12,10657515620
4871,250189580,110778,250300358,7,0,0,7680,18,10395340628
4872,250218570,160661,250379231,1,0,0,74752,14,1545168969
4873,250304699,119598,250424297,0,0,0,14848,10,438855044
4874,250401480,47288,250448768,4,0,0,1536,6,3724094061
4875,250457869,57440,250515309,9,0,0,4608,10,2626247283
4876,250504400,566,250504966,8,0,1,512,12,9779736095
4877,250570090,5326,250575416,1,0,1,5632,14,2202382287
4878,250584480,177535,250762015,4,0,0,35328,6,9937014479
4879,250700040,106340,250806380,8,0,0,49152,12,8647489348
4880,250730010,129332,250859342,7,0,0,35328,18,8302191644
4881,250850450,93552,250944002,7,0,0,13312,18,10461283234
4882,250856639,107094,250963733,9,0,0,22016,10,4419687485
4883,250860330,118532,250978862,4,0,0,11776,6,7339427486
4884,250875450,2946,250878396,7,0,1,3072,18,10271630910
4885,250878280,110398,250988678,3,0,0,8704,9,671116694
4886,250969580,51140,251020720,6,0,0,4096,9,7440315322
4887,251062641,3422,251066063,2,0,1,3584,4,8874248686
4888,251115240,4850,251120090,4,0,1,5120,6,502517831
4889,251187590,3387,251190977,9,0,1,9728,10,7058349632
4890,251259489,52364,251311853,0,0,0,3072,10,1013536243
4891,251311510,49315,251360825,8,0,0,2048,12,6166246178
4892,251318940,99008,251417948,7,0,0,25088,18,987171764
4893,251334330,62516,251396846,3,0,0,6144,9,7073794690
4894,251358040,70624,251428664,7,0,0,3584,18,1591015789
4895,251396110,71704,251467814,7,0,0,8704,18,9824487681
4896,251425199,118761,251543960,0,0,0,25600,10,1399909363
4897,251429920,88676,251518596,7,0,0,16384,18,8852043329
4898,251452460,144354,251596814,1,0,0,21504,14,5495570922
4899,251563660,23725,251587385,9,0,1,39424,10,3051586701
4900,251568891,27938,251596829,2,0,1,7168,4,297215443
4901,251592330,176506,251768836,3,0,0,58368,9,10715252613
4902,251636410,175335,251811745,6,0,0,54784,9,7809105467
4903,251674650,67592,251742242,7,0,0,7680,18,9044094724
4904,251685170,6278,251691448,7,0,1,6656,18,390658009
4905,251739450,3387,251742837,1,0,1,9728,14,8905704144
4906,251784529,168878,251953407,9,0,0,78336,10,5822899432
4907,251811440,6575,251818015,1,0,1,6656,14,7114141056
4908,251834840,6229,251841069,7,0,1,15360,18,2723570629
4909,251870420,137744,252008164,1,0,0,50176,14,3461504388
4910,251894960,153002,252047962,2,0,0,13312,4,6173971401
4911,251975861,7706,251983567,6,0,1,8192,9,9638054704
4912,251986250,121652,252107902,2,0,0,6144,4,5847556107
4913,252004710,16012,252020722,9,0,1,20992,10,7737228721
4914,252262510,47288,252309798,4,0,0,1536,6,402215762
4915,252310340,125034,252435374,8,0,0,94720,12,4352269755
4916,252315150,122579,252437729,4,0,0,7680,6,9968244976
4917,252396380,99164,252495544,7,0,0,25600,18,2617701239
4918,252505089,62228,252567317,9,0,0,10240,10,4494729301
4919,252545750,117884,252663634,6,0,0,87040,9,4489972955
4920,252554260,147606,252701866,1,0,0,51200,14,6449725764
4921,252559540,112194,252671734,7,0,0,12800,18,5663999737
4922,252561260,155441,252716701,4,0,0,48640,6,7820496542
4923,252737320,14117,252751437,4,0,1,24064,6,4054881566
4924,252737361,20836,252758197,6,0,1,26112,9,3316975687
4925,252935590,5971,252941561,4,0,1,14848,6,9279937346
4926,252951440,100880,253052320,4,0,0,31232,6,5366451299
4927,252973060,157158,253130218,6,0,0,94208,9,4377211525
4928,253014280,124910,253139190,4,0,0,17408,6,7015939034
4929,253016590,5712,253022302,0,0,1,14336,10,5100848531
4930,253068590,195657,253264247,4,0,0,89600,6,7332945424
4931,253109259,118381,253227640,0,0,0,14336,10,4920184417
4932,253116060,162109,253278169,2,0,0,38400,4,2730054275
4933,253190930,75524,253266454,2,0,0,7168,4,1597535743
4934,253244850,114413,253359263,7,0,0,27136,18,440684840
4935,253261450,89379,253350829,6,0,0,9216,9,2851723371
4936,253282581,2470,253285051,2,0,1,2560,4,4130741695
4937,253308960,1042,253310002,7,0,1,1024,18,3087517376
4938,253423960,65300,253489260,2,0,0,10240,4,1381221145
4939,253428630,92165,253520795,4,0,0,12800,6,5593857578
4940,253449959,166789,253616748,0,0,0,28160,10,10411076711
4941,253453740,63140,253516880,6,0,0,8192,9,9952618360
4942,253475760,13515,253489275,4,0,1,18944,6,10040509647
4943,253549830,78828,253628658,2,0,0,5632,4,2227405929
4944,253678990,81440,253760430,4,0,0,12800,6,1185929598
4945,253739510,104468,253843978,4,0,0,43008,6,8475781238
4946,253842230,4210,253846440,8,0,1,2560,12,9322976309
4947,253869890,66836,253936726,5,0,0,10240,11,1836038554
4948,253928171,13083,253941254,6,0,1,22016,9,1438497609
4949,253931870,147230,254079100,6,0,0,56320,9,6543887383
4950,253936710,5210,253941920,8,0,1,1024,12,1397641215
4951,254064470,94058,254158528,2,0,0,11264,4,1592965799
4952,254067450,137830,254205280,7,0,0,23552,18,4510787468
4953,254075809,89173,254164982,0,0,0,18944,10,3450176780
4954,254131190,2946,254134136,0,0,1,3072,10,3789114835
4955,254168220,79616,254247836,7,0,0,16896,18,6010502129
4956,254180070,12308,254192378,1,0,1,20480,14,6908327509
4957,254217130,80372,254297502,3,0,0,14336,9,4394500072
4958,254238050,128410,254366460,6,0,0,37888,9,2643971248
4959,254274570,70976,254345546,2,0,0,8704,4,947925029
4960,254357910,120835,254478745,1,0,0,68608,14,4220970426
4961,254363650,131396,254495046,6,0,0,5120,9,4940010033
4962,254364130,76370,254440500,6,0,0,8704,9,2038444620
4963,254367980,4679,254372659,7,0,1,12288,18,1267974136
4964,254451350,79592,254530942,3,0,0,11776,9,5198314685
4965,254452070,114083,254566153,7,0,0,55808,18,9754897705
4966,254666660,11274,254677934,1,0,1,18432,14,1255776085
4967,254676799,97760,254774559,0,0,0,20992,10,1703442622
4968,254728650,10757,254739407,4,0,1,17408,6,2641513547
4969,254735740,45596,254781336,3,0,0,1024,9,1196690557
4970,254771180,71587,254842767,8,0,0,9728,12,5601271674
4971,254832441,3898,254836339,6,0,1,4096,9,4001703682
4972,254888580,170020,255058600,4,0,0,40960,6,7224333529
4973,254938031,3422,254941453,2,0,1,3584,4,6274358652
4974,255227220,4850,255232070,4,0,1,5120,6,4578718490
4975,255249100,1518,255250618,7,0,1,1536,18,9350390638
4976,255277070,84216,255361286,5,0,1,137216,11,5405140044
4977,255306520,138717,255445237,7,0,0,6656,18,4810760759
4978,255435139,102394,255537533,9,0,0,1536,10,6460742500
4979,255457630,1994,255459624,4,0,1,2048,6,8546779902
4980,255490350,115211,255605561,4,0,0,63488,6,7754973493
4981,255504010,1518,255505528,4,0,1,1536,6,9460288973
4982,255534070,105208,255639278,4,0,0,10240,6,2216177602
4983,255540090,179570,255719660,8,0,0,46080,12,2396885421
4984,255600230,192060,255792290,1,0,0,66560,14,5870582464
4985,255614861,2946,255617807,2,0,1,3072,4,2558398197
4986,255629360,93279,255722639,4,0,0,9728,6,5711189622
4987,255640480,227824,255868304,7,0,0,88064,18,1421823090
4988,255654280,151597,255805877,8,0,0,44544,12,8879396116
4989,255910931,11533,255922464,2,0,1,18944,4,5163493630
4990,256034121,13512,256047633,6,0,1,26112,9,4747039932
4991,256143600,106808,256250408,2,0,0,50688,4,9908654830
4992,256153090,102202,256255292,3,0,0,11264,9,3373406022
4993,256195880,4937,256200817,1,0,1,12800,14,6873253997
4994,256257749,94712,256352461,0,0,0,26112,10,2950235554
4995,256320980,1042,256322022,8,0,1,1024,12,3872631170
4996,256391210,5454,256396664,4,0,1,13824,6,9110849264
4997,256553020,48980,256602000,8,0,0,2048,12,1385773852
4998,256558309,83912,256642221,0,0,0,15872,10,3526778535
4999,256655279,105716,256760995,0,0,0,47104,10,6742123712
5000,256694620,128349,256822969,8,0,0,22528,12,6874624725
5001,256792880,116609,256909489,1,0,0,16896,14,4351825467
5002,256808450,79592,256888042,1,0,0,11776,14,2407919017
5003,256915740,5454,256921194,1,0,1,13824,14,250773912
5004,256928620,12825,256941445,4,0,1,21504,6,6244414708
5005,256972510,167885,257140395,7,0,0,22528,18,9697204655
5006,256981360,83156,257064516,8,0,0,18432,12,6339281254
5007,256986870,5802,256992672,0,0,1,6144,10,5188260981
5008,257055230,125901,257181131,2,0,0,19456,4,8048274264
5009,257083839,78462,257162301,0,0,0,2560,10,10276982443
5010,257181299,93932,257275231,9,0,0,23552,10,4909330925
5011,257235850,23466,257259316,9,0,1,38912,10,6209383326
5012,257256710,57440,257314150,4,0,0,4608,6,7196952643
5013,257348170,128492,257476662,8,0,0,121856,12,1329188656
5014,257348240,147136,257495376,4,0,0,10752,6,8322714494
5015,257458340,215530,257673870,4,0,0,23552,6,8089092655
5016,257465460,124500,257589960,4,0,0,21504,6,10068426547
5017,257560350,59532,257619882,8,0,0,7680,12,9348142163
5018,257590929,154899,257745828,9,0,0,8704,10,658682277
5019,257605390,104000,257709390,1,0,0,41472,14,4592968571
5020,257632939,164171,257797110,0,0,0,29696,10,1003284156
5021,257775490,45596,257821086,7,0,0,1024,18,8403386152
5022,257952410,45596,257998006,1,0,0,1024,14,4068913331
5023,258153849,45596,258199445,0,0,0,1024,10,10724429428
5024,258164169,75013,258239182,0,0,0,16896,10,1403793617
5025,258172880,96980,258269860,3,0,0,18432,9,8893794843
5026,258192681,3898,258196579,2,0,1,4096,4,6531841808
5027,258231720,52364,258284084,8,0,0,3072,12,6467315375
5028,258233970,5227,258239197,1,0,1,1536,14,10531241953
5029,258245189,118943,258364132,0,0,0,28160,10,7800389885
5030,258329720,102908,258432628,7,0,0,37888,18,7783696052
5031,258338120,54056,258392176,7,0,0,3584,18,5493064815
5032,258460900,76052,258536952,7,0,0,10240,18,6824344807
5033,258527870,53300,258581170,3,0,0,6144,9,10525597845
5034,258581490,54056,258635546,2,0,0,3584,4,6268946473
5035,258629639,82820,258712459,9,0,0,12288,10,6905607716
5036,258710650,54165,258764815,7,0,0,3072,18,9718867432
5037,258734930,103844,258838774,8,0,0,40960,12,1387469940
5038,259013819,110396,259124215,9,0,0,62464,10,2077311147
5039,259059080,16613,259075693,0,0,1,32256,10,8653204981
5040,259067510,251104,259318614,3,0,0,62464,9,1274457616
5041,259073870,12566,259086436,4,0,1,20992,6,3853407787
5042,259107119,89624,259196743,9,0,0,13824,10,856928950
5043,259110770,138647,259249417,2,0,0,4096,4,5213390943
5044,259135830,566,259136396,4,0,1,512,6,7058770194
5045,259187180,82844,259270024,8,0,0,17408,12,8602697381
5046,259215449,107548,259322997,9,0,0,14336,10,2364869069
5047,259280419,170122,259450541,9,0,0,38912,10,2933230270
5048,259324641,3422,259328063,6,0,1,3584,9,6474148285
5049,259357830,76413,259434243,3,0,0,6144,9,3669087023
5050,259380050,84248,259464298,1,0,0,22016,14,6587171430
5051,259384619,101348,259485967,9,0,0,32768,10,1024147624
5052,259460380,49089,259509469,5,0,1,77824,11,333008199
5053,259505040,105228,259610268,2,0,0,29696,4,4994234904
5054,259529440,82293,259611733,3,0,0,3072,9,9510844616
5055,259572880,566,259573446,8,0,1,512,12,7660066862
5056,259614459,77612,259692071,0,0,0,15360,10,4259607220
5057,259787650,6278,259793928,8,0,1,6656,12,346286888
5058,259824099,79748,259903847,0,0,0,12288,10,6451552615
5059,259858940,64520,259923460,7,0,0,7680,18,2578531741
5060,259869280,225521,260094801,4,0,0,43520,6,8807256601
5061,259876440,96161,259972601,1,0,0,25088,14,2696408162
5062,259910839,99944,260010783,0,0,0,28160,10,2885886217
5063,259971451,14742,259986193,6,0,1,23040,9,2771145051
5064,259973840,12609,259986449,1,0,1,9216,14,10116816411
5065,259991630,84512,260076142,1,0,0,12800,14,79044071
5066,260043940,249193,260293133,8,0,0,75264,12,6121590434
5067,260047920,84828,260132748,7,0,0,11776,18,10520356253
5068,260048210,7230,260055440,7,0,1,7680,18,5963534022
5069,260056790,110281,260167071,6,0,0,52736,9,9358769653
5070,260064530,71249,260135779,5,0,1,115200,11,6145772686
5071,260066130,76370,260142500,8,0,1,32256,12,9389700145
5072,260108299,112757,260221056,9,0,0,27136,10,2949073477
5073,260139400,187108,260326508,3,0,0,11264,9,593028952
5074,260157150,147521,260304671,8,0,0,6144,12,6330153977
5075,260170430,260663,260431093,3,0,0,43520,9,8375021017
5076,260191440,248716,260440156,8,0,0,29696,12,8745412275
5077,260226860,190950,260417810,4,0,0,82944,6,9676200732
5078,260348990,107193,260456183,3,0,0,37376,9,1675093889
5079,260383880,140451,260524331,6,0,0,11776,9,5176424860
5080,260405090,169304,260574394,5,0,0,19456,11,6227254672
5081,260452409,116034,260568443,9,0,0,68608,10,2036372205
5082,260480350,117955,260598305,1,0,0,9216,14,2593093632
5083,260548210,136861,260685071,2,0,0,82944,4,3036819806
5084,260596210,145063,260741273,8,0,0,39424,12,3511937356
5085,260618470,4850,260623320,7,0,1,5120,18,2927642396
5086,260727200,50672,260777872,6,0,0,2560,9,7633954668
5087,260864489,74360,260938849,0,0,0,9728,10,5899618526
5088,260904290,68684,260972974,7,0,0,11264,18,550312121
5089,260920300,3898,260924198,8,0,1,4096,12,9695759455
5090,260937180,8149,260945329,0,0,1,15872,10,7219834890
5091,260964470,64148,261028618,8,0,0,5120,12,50786981
5092,261058240,83468,261141708,3,0,0,19456,9,3744899792
5093,261084039,135063,261219102,9,0,0,40448,10,7415959058
5094,261138540,100164,261238704,4,0,0,23552,6,8604012941
5095,261169090,164972,261334062,8,0,0,108544,12,9974961215
5096,261186460,157609,261344069,6,0,0,32768,9,4577939458
5097,261207491,17405,261224896,6,0,1,6144,9,8902115212
5098,261301990,48009,261349999,9,0,1,14848,10,7273739541
5099,261342179,113994,261456173,0,0,0,53248,10,630778006
5100,261384450,76208,261460658,7,0,0,10752,18,8655567931
5101,261470490,47288,261517778,3,0,0,1536,9,2582296792
5102,261476959,69596,261546555,9,0,0,9216,10,9377991980
5103,261514270,66863,261581133,3,0,0,5632,9,7882702580
5104,261639150,102596,261741746,1,0,0,36864,14,9851679830
5105,261737660,51366,261789026,8,0,0,1536,12,367241338
5106,261795449,94820,261890269,0,0,0,16384,10,1728214079
5107,261808340,138131,261946471,3,0,0,38400,9,3576892748
5108,261848410,159450,262007860,1,0,0,55296,14,9996534353
5109,261942010,148770,262090780,3,0,0,2560,9,1860118952
5110,261949501,3898,261953399,6,0,1,4096,9,6495699187
5111,261956580,114970,262071550,4,0,0,36352,6,5917809800
5112,262103900,77744,262181644,6,0,0,10752,9,4252463235
5113,262180210,4372,262184582,8,0,1,3072,12,1533663388
5114,262193840,65429,262259269,5,0,1,110592,11,7218562885
5115,262249830,118721,262368551,7,0,0,10240,18,4271521236
5116,262336480,184897,262521377,2,0,0,10240,4,4783273861
5117,262345249,123538,262468787,0,0,0,5120,10,916690826
5118,262350070,232810,262582880,3,0,0,23040,9,1082514458
5119,262376370,119393,262495763,5,0,0,58368,11,3299642140
5120,262376970,56840,262433810,3,0,0,7680,9,7429672629
5121,262447290,105716,262553006,1,0,0,47104,14,8964744114
5122,262518799,140875,262659674,0,0,0,47104,10,7350357229
5123,262525049,92396,262617445,9,0,0,23552,10,7871232065
5124,262526840,96579,262623419,5,0,1,161280,11,5344845184
5125,262567530,93103,262660633,3,0,0,3072,9,4396879370
5126,262593860,169274,262763134,5,0,0,35328,11,2498764365
5127,262616570,267043,262883613,7,0,0,14336,18,6043238105
5128,262618730,233696,262852426,4,0,0,14848,6,9502669418
5129,262650070,205538,262855608,5,0,0,6144,11,1012546739
5130,262673900,7706,262681606,4,0,1,8192,6,3261268384
5131,262718891,6229,262725120,6,0,1,15360,9,5204919241
5132,262729770,139438,262869208,4,0,0,30720,6,10064057787
5133,262756321,11242,262767563,6,0,1,11776,9,8840112160
5134,262763000,175866,262938866,5,0,0,5632,11,2822310275
5135,262765349,111206,262876555,9,0,0,24064,10,4792498718
5136,262777321,10241,262787562,2,0,1,16384,4,6123241105
5137,262793979,85251,262879230,9,0,0,8704,10,424173925
5138,262794190,141367,262935557,7,0,0,3072,18,8053116690
5139,262815240,203059,263018299,2,0,0,41984,4,3040705714
5140,262843280,162212,263005492,1,0,0,50688,14,2851349025
5141,262850680,4943,262855623,8,0,1,8704,12,538331631
5142,262856640,317374,263174014,8,0,0,48128,12,10412150028
5143,262859420,206546,263065966,2,0,0,1024,4,6393966437
5144,262867960,155172,263023132,4,0,0,12800,6,3017353325
5145,262897480,207564,263105044,8,0,0,54784,12,4192713458
5146,262973870,107558,263081428,3,0,0,15360,9,2017689246
5147,262975620,145006,263120626,5,0,0,29184,11,6862693638
5148,263040960,13600,263054560,8,0,1,23040,12,7842936952
5149,263113540,133761,263247301,1,0,0,12288,14,8274449348
5150,263129799,79998,263209797,9,0,0,7680,10,284820823
5151,263133560,109982,263243542,8,0,0,22016,12,1200747403
5152,263140520,3645,263144165,8,0,1,10240,12,6165900324
5153,263189220,3898,263193118,9,0,1,4096,10,5202071581
5154,263213691,10499,263224190,2,0,1,16896,4,3765534090
5155,263238620,76614,263315234,2,0,0,4096,4,8501758796
5156,263340470,75608,263416078,4,0,0,13824,6,6620436202
5157,263435480,95600,263531080,2,0,0,18944,4,268188058
5158,263438970,97905,263536875,9,0,0,18944,10,3212486518
5159,263473340,108134,263581474,7,0,0,47104,18,1848113711
5160,263513730,143056,263656786,5,0,0,74240,11,7344181759
5161,263528400,11856,263540256,1,0,1,3584,14,1610825637
5162,263585579,151907,263737486,0,0,0,39424,10,2658423193
5163,263588910,174898,263763808,9,0,0,44032,10,6654383073
5164,263687820,4162,263691982,1,0,1,11264,14,4571866732
5165,263716360,3898,263720258,7,0,1,4096,18,1605675465
5166,263749970,85916,263835886,2,0,0,17408,4,8702012307
5167,263851180,104936,263956116,6,0,0,44544,9,1901206257
5168,263954640,77676,264032316,5,0,0,10752,11,9830314440
5169,264124750,51452,264176202,4,0,0,5120,6,1547286843
5170,264150930,85878,264236808,6,0,0,16384,9,2200688950
5171,264164069,82735,264246804,9,0,0,18944,10,340783375
5172,264184120,65195,264249315,9,0,0,8192,10,5415413659
5173,264287620,92060,264379680,7,0,0,17408,18,1027759811
5174,264292200,103688,264395888,2,0,0,40448,4,3692543826
5175,264373450,103154,264476604,8,0,0,35840,12,6595379998
5176,264436300,20366,264456666,4,0,1,32768,6,3214839376
5177,264437040,144987,264582027,2,0,0,42496,4,5170774153
5178,264437620,190709,264628329,8,0,0,16896,12,949240436
5179,264509220,171267,264680487,1,0,0,60928,14,4307394707
5180,264531320,103753,264635073,4,0,0,13824,6,8663688994
5181,264597160,566,264597726,0,0,1,512,10,4201707853
5182,264597480,87531,264685011,9,0,0,10240,10,7789286951
5183,264615050,124729,264739779,1,0,0,94208,14,1566284115
5184,264693680,52364,264746044,3,0,0,3072,9,8172330602
5185,264726810,16876,264743686,7,0,1,4096,18,8997112234
5186,264729061,14971,264744032,6,0,1,512,9,7913751434
5187,264791420,204298,264995718,1,0,0,11264,14,6701205292
5188,264794830,3904,264798734,0,0,1,10752,10,2792427031
5189,264808720,78851,264887571,1,0,0,7680,14,8477367814
5190,264839120,65456,264904576,4,0,0,10752,6,10663627987
5191,264843160,193806,265036966,8,0,0,66048,12,4757268892
5192,264854500,252421,265106921,2,0,0,126976,4,1934699234
5193,264878880,20882,264899762,1,0,1,33792,14,4159131289
5194,264893601,84216,264977817,5,0,1,137216,11,8721819557
5195,264955260,194640,265149900,5,0,0,3584,11,5247366849
5196,264993980,218800,265212780,4,0,0,48640,6,10325007019
5197,265044790,145333,265190123,6,0,0,5120,9,4275672635
5198,265070960,199077,265270037,6,0,0,39424,9,6484389632
5199,265092480,123435,265215915,8,0,0,10240,12,124721019
5200,265184340,101141,265285481,1,0,0,24576,14,3139525682
5201,265188800,158454,265347254,5,0,0,35840,11,5580551981
5202,265206150,149855,265356005,4,0,0,28672,6,6795232351
5203,265209760,126559,265336319,6,0,0,49152,9,10646416803
5204,265359680,77744,265437424,5,0,0,10752,11,4620295233
5205,265368230,75320,265443550,9,0,0,17920,10,6145519052
5206,265534480,89792,265624272,9,0,0,25088,10,5179186407
5207,265603749,68571,265672320,0,0,0,4096,10,8836984942
5208,265652310,52364,265704674,2,0,0,3072,4,3951448536
5209,265702750,110708,265813458,8,0,0,63488,12,2466568258
5210,265713310,108298,265821608,1,0,0,25088,14,2074060021
5211,265747950,65991,265813941,8,0,0,1536,12,2035324650
5212,265777309,58220,265835529,9,0,0,7168,10,557765435
5213,265799751,22382,265822133,2,0,1,512,4,5950342772
5214,265902540,100100,266002640,7,0,0,28672,18,9917385397
5215,265906190,76232,265982422,1,0,0,15872,14,3683973260
5216,265913940,98186,266012126,8,0,0,13312,12,9950010097
5217,266014050,77744,266091794,3,0,0,10752,9,7368914143
5218,266044980,100724,266145704,8,0,0,30720,12,4767430388
5219,266224860,107900,266332760,6,0,0,54272,9,7212353142
5220,266298860,65900,266364760,1,0,0,7168,14,1442905071
5221,266415860,108212,266524072,1,0,0,55296,14,6435168021
5222,266472880,99788,266572668,4,0,0,27648,6,8975096952
5223,266508640,274938,266783578,9,0,0,42496,10,8361690302
5224,266526860,102128,266628988,3,0,0,35328,9,1741678763
5225,266537210,142958,266680168,1,0,0,41984,14,3951814569
5226,266543120,181712,266724832,5,0,0,67584,11,3526212179
5227,266601360,3422,266604782,7,0,1,3584,18,695905765
5228,266607330,93786,266701116,4,0,0,6144,6,9904420670
5229,266615930,1518,266617448,8,0,1,1536,12,213015435
5230,266711430,157840,266869270,2,0,0,24064,4,8103856344
5231,266749230,85604,266834834,1,0,0,16384,14,6358522692
5232,266785090,129190,266914280,7,0,0,49152,18,6430952716
5233,266858861,10424,266869285,6,0,1,11264,9,7334667488
5234,266881840,121408,267003248,9,0,0,41472,10,8561312998
5235,266970670,109928,267080598,5,0,0,60928,11,5564814346
5236,267072140,70054,267142194,4,0,0,8192,6,8196847927
5237,267115470,12566,267128036,9,0,1,20992,10,6378452522
5238,267117990,146225,267264215,3,0,0,50176,9,1210758697
5239,267146099,57440,267203539,0,0,0,4608,10,10552232712
5240,267211580,1518,267213098,1,0,1,1536,14,6643381320
5241,267239820,67748,267307568,6,0,0,8192,9,2563216144
5242,267240700,2470,267243170,7,0,1,2560,18,10394976790
5243,267245210,65900,267311110,8,0,0,7168,12,2475254065
5244,267245620,76842,267322462,3,0,0,4096,9,5716897065
5245,267258961,10700,267269661,6,0,1,13824,9,8912911383
5246,267330980,69284,267400264,4,0,0,8192,6,6185992356
5247,267340759,566,267341325,3,0,1,512,9,4565271506
5248,267345410,98696,267444106,9,0,0,24064,10,3993948127
5249,267424740,43904,267468644,8,0,0,512,12,4990661776
5250,267436789,56289,267493078,0,0,0,2048,10,5393986624
5251,267469490,113984,267583474,7,0,0,74240,18,9198996135
5252,267535649,130865,267666514,9,0,0,47104,10,8132342056
5253,267554440,142188,267696628,7,0,0,8704,18,601829724
5254,267600090,81620,267681710,4,0,0,18432,6,3514767785
5255,267639160,112578,267751738,3,0,0,27136,9,7504810003
5256,267646670,68996,267715666,8,0,0,12288,12,3292785366
5257,267692850,139426,267832276,1,0,0,63488,14,8851149807
5258,267729020,2470,267731490,9,0,1,2560,10,1982167781
5259,267734370,78212,267812582,8,0,0,12288,12,5856882569
5260,267772639,100332,267872971,0,0,0,21504,10,2921947714
5261,267875579,65900,267941479,9,0,0,7168,10,117294272
5262,267879300,69149,267948449,1,0,0,2560,14,7769764545
5263,267883890,63764,267947654,5,0,0,10240,11,3215700471
5264,268001980,3645,268005625,4,0,1,10240,6,8652832416
5265,268120530,98228,268218758,1,0,0,22528,14,8582962972
5266,268154710,116260,268270970,2,0,0,5120,4,9328279886
5267,268160260,47288,268207548,8,0,0,1536,12,2439348874
5268,268200850,107432,268308282,3,0,0,52736,9,4884259685
5269,268240280,139486,268379766,6,0,0,17920,9,9430269794
5270,268348580,78392,268426972,8,0,0,17920,12,5047218954
5271,268381199,64232,268445431,9,0,0,11776,10,9460076880
5272,268394440,6754,268401194,9,0,1,7168,10,236484500
5273,268467260,62516,268529776,7,0,0,6144,18,3243669023
5274,268585250,98228,268683478,8,0,0,22528,12,4409475285
5275,268659161,2946,268662107,2,0,1,3072,4,5703787394
5276,268681449,108985,268790434,9,0,0,51200,10,7318484537
5277,268716881,7230,268724111,2,0,1,7680,4,10325673951
5278,268748879,103865,268852744,9,0,0,32768,10,9394790013
5279,268821340,2946,268824286,1,0,1,3072,14,8560600213
5280,268859020,7706,268866726,0,0,1,8192,10,5750294351
5281,269164280,103688,269267968,9,0,0,40448,10,501065665
5282,269234600,94244,269328844,1,0,0,24576,14,2384703330
5283,269257290,95938,269353228,4,0,0,1536,6,5530763014
5284,269297470,139563,269437033,9,0,0,2560,10,4010263053
5285,269322330,113908,269436238,5,0,0,40960,11,4115988721
5286,269341769,55748,269397517,0,0,0,4096,10,869455694
5287,269461950,50828,269512778,9,0,0,3072,10,2075527486
5288,269475680,101504,269577184,6,0,0,33280,9,2467709380
5289,269480799,118429,269599228,0,0,0,50176,10,7573763691
5290,269506830,92725,269599555,6,0,0,1024,9,895555464
5291,269529470,103130,269632600,4,0,0,11264,6,5563499380
5292,269544990,108514,269653504,4,0,0,14336,6,6622158851
5293,269554300,59820,269614120,7,0,0,1024,18,9028527841
5294,269605840,123102,269728942,8,0,0,44032,12,5377824256
5295,269612220,81440,269693660,8,0,0,12800,12,3095148680
5296,269638670,134726,269773396,1,0,0,17408,14,4785696241
5297,269680510,2946,269683456,8,0,1,3072,12,892179617
5298,269709100,3128,269712228,4,0,1,9216,6,6014788830
5299,269749070,73448,269822518,4,0,0,11776,6,10434492649
5300,269849660,106808,269956468,7,0,0,50688,18,3308033422
5301,269862320,3128,269865448,9,0,1,9216,10,420570386
5302,269863100,141272,270004372,5,0,0,46592,11,626561671
5303,269918400,86971,270005371,8,0,1,145920,12,4552392753
5304,270043580,161426,270205006,3,0,0,8192,9,6248633911
5305,270081620,106028,270187648,2,0,0,48128,4,3444947448
5306,270198340,101816,270300156,5,0,0,34304,11,3357855289
5307,270237280,146534,270383814,3,0,0,80896,9,4093767457
5308,270239761,13341,270253102,2,0,1,22528,4,6357692860
5309,270454350,47288,270501638,7,0,0,1536,18,9254745156
5310,270470450,77744,270548194,3,0,0,10752,9,8255317959
5311,270578440,56840,270635280,6,0,0,7680,9,2407205048
5312,270588820,566,270589386,0,0,1,512,10,2739224338
5313,270773280,91772,270865052,5,0,0,21504,11,1197431698
5314,270813070,62516,270875586,4,0,0,6144,6,1369438470
5315,270860059,16776,270876835,3,0,1,19456,9,8090156764
5316,270890300,131777,271022077,5,0,0,35840,11,9217009115
5317,270933670,69620,271003290,6,0,0,14336,9,2614996272
5318,271031830,73448,271105278,9,0,0,11776,10,6045252523
5319,271041060,59288,271100348,1,0,0,5632,14,10096916561
5320,271090580,100724,271191304,8,0,0,30720,12,6483230829
5321,271223800,60824,271284624,8,0,0,5632,12,7784132360
5322,271291009,77744,271368753,0,0,0,10752,10,161343233
5323,271291739,106340,271398079,0,0,0,49152,10,3898303268
5324,271295670,119272,271414942,2,0,0,55296,4,4501861242
5325,271328410,134883,271463293,6,0,0,60416,9,1758434514
5326,271341029,3898,271344927,3,0,1,4096,9,2888350022
5327,271358651,10117,271368768,6,0,1,8192,9,6775673028
5328,271428500,127177,271555677,7,0,0,29696,18,5017118745
5329,271441709,82820,271524529,0,0,0,12288,10,9797916067
5330,271489890,77744,271567634,3,0,0,10752,9,2522973120
5331,271527800,122773,271650573,3,0,0,41472,9,4390757539
5332,271582250,95756,271678006,2,0,0,19456,4,8305563421
5333,271596830,123205,271720035,9,0,0,41472,10,9567988658
5334,271709970,113121,271823091,9,0,0,38400,10,6149136038
5335,271723460,53134,271776594,5,0,0,3072,11,8203819788
5336,271724230,109187,271833417,6,0,0,9216,9,5860801182
5337,271726340,104254,271830594,3,0,0,24576,9,2039370017
5338,271806310,158492,271964802,8,0,0,56832,12,8809749795
5339,271809700,89768,271899468,1,0,0,19968,14,3654918788
5340,271831340,71353,271902693,5,0,0,8192,11,3985227231
5341,271840921,3645,271844566,2,0,1,10240,4,6487609949
5342,271886440,113021,271999461,1,0,0,26112,14,8391763694
5343,271909430,100377,272009807,2,0,0,20992,4,5615557473
5344,271917690,4850,271922540,0,0,1,5120,10,8394790710
5345,271924300,1518,271925818,7,0,1,1536,18,1071103289
5346,271928630,112957,272041587,6,0,0,27136,9,3455862222
5347,271955069,144760,272099829,9,0,0,25600,10,5015715780
5348,271995340,87090,272082430,6,0,0,1024,9,3530106508
5349,272033780,112735,272146515,1,0,0,44544,14,1550849908
5350,272046090,193934,272240024,8,0,0,29184,12,9060901237
5351,272112209,60824,272173033,9,0,0,5632,10,9413328350
5352,272112889,77744,272190633,0,0,0,10752,10,2485170531
5353,272237279,46641,272283920,9,0,0,512,10,2915618836
5354,272251450,84536,272335986,8,0,0,17920,12,7613964229
5355,272307040,6754,272313794,7,0,1,7168,18,7640835183
5356,272382099,1994,272384093,3,0,1,2048,9,5773727524
5357,272437299,73004,272510303,0,0,0,15360,10,6947231824
5358,272456790,85481,272542271,7,0,0,19456,18,1135122284
5359,272531680,49604,272581284,4,0,0,4096,6,6943672313
5360,272570031,2470,272572501,6,0,1,2560,9,7918323151
5361,272774670,53495,272828165,8,0,1,90624,12,2084524263
5362,272797090,155281,272952371,7,0,0,30208,18,67582552
5363,272808360,163157,272971517,4,0,0,11264,6,38440525
5364,272902220,132396,273034616,1,0,0,5120,14,9291040868
5365,272904700,91304,272996004,8,0,0,19968,12,2582810516
5366,272944310,109401,273053711,3,0,0,32768,9,10352532933
5367,272961660,57440,273019100,3,0,0,4608,9,8750566247
5368,273084539,99944,273184483,0,0,0,28160,10,9964020121
5369,273092160,129307,273221467,2,0,0,53760,4,6243073470
5370,273102720,153913,273256633,9,0,0,11776,10,3166340793
5371,273136850,175421,273312271,5,0,0,11776,11,9986461373
5372,273175900,130167,273306067,3,0,0,31744,9,3291028266
5373,273244230,120271,273364501,5,0,0,2560,11,6278397876
5374,273267749,93752,273361501,0,0,0,17920,10,1971186587
5375,273299240,136025,273435265,7,0,0,10752,18,4161940045
5376,273351530,106496,273458026,6,0,0,49664,9,7957676508
5377,273417399,45596,273462995,0,0,0,1024,10,4924728228
5378,273446130,120452,273566582,1,0,0,8704,14,6732654735
5379,273448580,115335,273563915,2,0,0,47616,4,1499334292
5380,273471979,151126,273623105,9,0,0,18944,10,9675573949
5381,273487760,209601,273697361,2,0,0,18432,4,3690207152
5382,273560630,70308,273630938,6,0,0,7168,9,3707674622
5383,273578380,84649,273663029,5,0,0,1536,11,8822654490
5384,273699461,2470,273701931,2,0,1,2560,4,2899381713
5385,273726659,3387,273730046,3,0,1,9728,9,5581013021
5386,273810790,1042,273811832,9,0,1,1024,10,3572623206
5387,273868900,109928,273978828,6,0,0,60928,9,7145099197
5388,273904671,6278,273910949,2,0,1,6656,4,2497632058
5389,274030770,1518,274032288,7,0,1,1536,18,4830597926
5390,274110800,103844,274214644,7,0,0,40960,18,5356410404
5391,274232940,94532,274327472,1,0,0,20480,14,5361114112
5392,274267329,86261,274353590,0,0,0,14336,10,5059887641
5393,274275460,58064,274333524,5,0,0,6656,11,1862193847
5394,274349669,102921,274452590,9,0,0,25088,10,7610831983
5395,274381990,47288,274429278,8,0,0,1536,12,5526293067
5396,274500640,93620,274594260,1,0,0,22528,14,5048124737
5397,274561450,141278,274702728,7,0,0,78848,18,5796483468
5398,274601150,110017,274711167,3,0,0,27648,9,4700811083
5399,274645009,134277,274779286,9,0,0,15360,10,2461143199
5400,274656599,73331,274729930,0,0,0,4608,10,9636653743
5401,274761299,3898,274765197,3,0,1,4096,9,1861609935
5402,274936440,74228,275010668,7,0,0,14336,18,2187415277
5403,275159071,7230,275166301,2,0,1,7680,4,9748695089
5404,275239590,4162,275243752,7,0,1,11264,18,9905784172
5405,275245140,83495,275328635,3,0,0,5120,9,1224428001
5406,275275720,48980,275324700,6,0,0,2048,9,5533436021
5407,275299960,84385,275384345,3,0,0,20480,9,6521705961
5408,275336580,109835,275446415,4,0,0,16384,6,9791755991
5409,275361899,1518,275363417,3,0,1,1536,9,8988973268
5410,275393710,53656,275447366,6,0,0,3072,9,4796341610
5411,275477270,70532,275547802,1,0,0,12288,14,1740912624
5412,275520730,48980,275569710,4,0,0,2048,6,3461621078
5413,275535270,58532,275593802,1,0,0,8192,14,8364309203
5414,275536100,69752,275605852,1,0,0,9728,14,9813216428
5415,275604010,116910,275720920,9,0,0,77824,10,8387415581
5416,275646150,76033,275722183,8,0,0,4096,12,9475859215
5417,275673130,92660,275765790,9,0,0,7168,10,4389773406
5418,275684530,59132,275743662,8,0,0,5120,12,3092397164
5419,275728859,81308,275810167,0,0,0,17408,10,216441898
5420,275768100,111937,275880037,7,0,0,38912,18,7497211117
5421,275773710,4374,275778084,9,0,1,4608,10,1458847290
5422,275832610,5971,275838581,1,0,1,14848,14,1720038517
5423,275854519,52088,275906607,0,0,0,2560,10,4138200770
5424,275855340,88983,275944323,4,0,0,20480,6,2645055595
5425,275951289,2470,275953759,3,0,1,2560,9,1142787396
5426,275985150,180684,276165834,8,0,0,47104,12,10329304602
5427,276002530,99164,276101694,6,0,0,25600,9,6748448445
5428,276125700,84692,276210392,3,0,0,18432,9,4955814226
5429,276291770,58064,276349834,3,0,0,6656,9,4603313653
5430,276401350,5196,276406546,0,0,1,13312,10,2156369148
5431,276508750,97472,276606222,4,0,0,25088,6,685664673
5432,276517080,54680,276571760,1,0,0,5632,14,744641849
5433,276579040,51143,276630183,4,0,0,4096,6,3428232730
5434,276627590,104780,276732370,6,0,0,44032,9,8552710478
5435,276628871,1994,276630865,6,0,1,2048,9,2728717500
5436,276654271,5326,276659597,6,0,1,5632,9,8454212421
5437,276667860,107896,276775756,6,0,0,18944,9,4356414314
5438,276801060,91304,276892364,9,0,0,19968,10,3813040611
5439,276802400,136332,276938732,4,0,0,15872,6,3050983391
5440,276985270,57440,277042710,6,0,0,4608,9,6938873826
5441,276999179,2470,277001649,3,0,1,2560,9,7419500615
5442,277001250,88988,277090238,6,0,0,17408,9,6896905462
5443,277081710,15062,277096772,0,0,1,29184,10,9425266793
5444,277110270,97625,277207895,8,0,0,13312,12,1231769250
5445,277136889,2870,277139759,3,0,1,8704,9,6841923316
5446,277190510,52832,277243342,1,0,0,4608,14,9804350713
5447,277295430,102752,277398182,4,0,0,37376,6,124005022
5448,277323130,140458,277463588,8,0,0,24064,12,6229324653
5449,277351159,83000,277434159,0,0,0,17920,10,2283100712
5450,277382290,71195,277453485,8,0,0,4608,12,4618547772
5451,277448680,80188,277528868,6,0,0,9216,9,362550880
5452,277633750,59288,277693038,8,0,0,5632,12,7681148915
5453,277645750,63296,277709046,1,0,0,8704,14,3026415482
5454,277709160,99320,277808480,8,0,0,26112,12,5483903418
5455,277853710,95468,277949178,2,0,0,23552,4,109734434
5456,278050120,80552,278130672,8,0,0,19968,12,3034857709
5457,278266010,87608,278353618,8,0,0,17920,12,10347421153
5458,278323000,143502,278466502,5,0,0,70656,11,1272413551
5459,278347530,43904,278391434,8,0,0,512,12,1488465483
5460,278352140,55526,278407666,1,0,0,3584,14,2302134572
5461,278459160,118666,278577826,9,0,0,65536,10,2002685646
5462,278482560,109165,278591725,7,0,0,45568,18,5791026804
5463,278505430,139414,278644844,5,0,0,8704,11,4525278817
5464,278518770,136792,278655562,6,0,0,20992,9,8043214297
5465,278707771,13600,278721371,2,0,1,23040,4,2089227685
5466,278714140,81637,278795777,8,0,0,5120,12,5850072161
5467,278793470,566,278794036,0,0,1,512,10,1715402384
5468,278826020,68372,278894392,7,0,0,10240,18,7292552536
5469,278882030,81128,278963158,4,0,0,11776,6,9879631173
5470,278886250,1518,278887768,4,0,1,1536,6,9939374887
5471,278910790,61136,278971926,3,0,0,6656,9,2747615636
5472,278957830,107120,279064950,1,0,0,51712,14,4204137102
5473,279058350,19417,279077767,4,0,1,21504,6,6860918031
5474,279167810,59132,279226942,1,0,0,5120,14,5064594402
5475,279199200,87904,279287104,3,0,0,19968,9,3757948879
5476,279227380,101660,279329040,5,0,0,33792,11,10292188418
5477,279301980,107460,279409440,8,0,0,33280,12,177253644
5478,279335579,95444,279431023,0,0,0,18432,10,10629617308
5479,279376330,55488,279431818,8,0,0,2560,12,4030241767
5480,279398150,103253,279501403,8,0,0,10240,12,6257667364
5481,279513939,11016,279524955,3,0,1,17920,9,9007435679
5482,279602640,47288,279649928,1,0,0,1536,14,5239130421
5483,279720140,119288,279839428,3,0,0,91648,9,9040911771
5484,279783550,106932,279890482,5,0,0,31232,11,234565271
5485,279831030,92211,279923241,3,0,0,14848,9,6546949701
5486,279859570,59132,279918702,1,0,0,5120,14,1152972975
5487,279883340,123832,280007172,6,0,0,62464,9,2144813649
5488,279939480,78702,280018182,8,0,0,11776,12,6045014969
5489,280033489,47288,280080777,0,0,0,1536,10,6918149843
5490,280039620,49292,280088912,9,0,0,3072,10,493966174
5491,280056591,12308,280068899,2,0,1,20480,4,7035754229
5492,280181680,101660,280283340,6,0,0,33792,9,3035537937
5493,280343050,50984,280394034,3,0,0,3584,9,7618206043
5494,280409321,4374,280413695,2,0,1,4608,4,2599470635
5495,280461100,99632,280560732,9,0,0,27136,10,5917570046
5496,280463551,4850,280468401,6,0,1,5120,9,3554902810
5497,280604920,7706,280612626,4,0,1,8192,6,6601796873
5498,280686560,67592,280754152,9,0,0,7680,10,230966949
5499,280711960,138018,280849978,1,0,0,94208,14,4339756382
5500,280715280,174928,280890208,8,0,0,18432,12,9818667155
5501,280731690,4374,280736064,1,0,1,4608,14,5348310463
5502,280737030,113275,280850305,2,0,0,1024,4,3411027942
5503,280768290,82350,280850640,2,0,0,1024,4,6572607222
5504,280846510,103632,280950142,9,0,0,17408,10,2099697303
5505,280938960,95312,281034272,1,0,0,23040,14,7562322094
5506,280970190,152420,281122610,5,0,0,84992,11,5075522927
5507,281012230,115387,281127617,8,0,0,16384,12,2938494992
5508,281047820,81546,281129366,1,0,0,4096,14,2961706115
5509,281091429,106601,281198030,0,0,0,19968,10,3170020665
5510,281125090,149166,281274256,5,0,0,35840,11,6248570210
5511,281140910,62516,281203426,4,0,0,6144,6,749428593
5512,281182720,126462,281309182,7,0,0,8192,18,2057683857
5513,281251490,104936,281356426,3,0,0,44544,9,4154833675
5514,281268630,152068,281420698,7,0,0,11264,18,4850590748
5515,281276890,4937,281281827,7,0,1,12800,18,4530102870
5516,281294020,172164,281466184,7,0,0,8192,18,8081519429
5517,281302480,3128,281305608,4,0,1,9216,6,8634687480
5518,281622260,94976,281717236,2,0,0,16896,4,6034800190
5519,281638110,145594,281783704,5,0,0,73728,11,7943527661
5520,281668800,267850,281936650,5,0,0,43008,11,1892090399
5521,281687360,174524,281861884,3,0,0,25600,9,7943527740
5522,281704240,141186,281845426,2,0,0,1024,4,2818355091
5523,281714819,89549,281804368,0,0,0,16384,10,8346098966
5524,281728490,347054,282075544,6,0,0,109568,9,758485398
5525,281749130,74162,281823292,4,0,0,5120,6,96613001
5526,281887620,123952,282011572,4,0,0,60928,6,1977031949
5527,282007800,16072,282023872,0,0,1,20480,10,6045164565
5528,282031590,103220,282134810,9,0,0,38912,10,7191998299
5529,282040940,216247,282257187,8,0,0,3584,12,6612772200
5530,282050040,27490,282077530,7,0,1,2048,18,6601779060
5531,282090950,116754,282207704,1,0,0,50176,14,10288912704
5532,282103219,120613,282223832,0,0,0,17408,10,1291255663
5533,282307740,3645,282311385,1,0,1,10240,14,7700583824
5534,282378090,108992,282487082,4,0,0,57856,6,3608889924
5535,282396109,92548,282488657,0,0,0,5120,10,9695246919
5536,282409330,142666,282551996,1,0,0,37888,14,950285992
5537,282459280,97879,282557159,4,0,0,16896,6,8015354425
5538,282584660,76052,282660712,8,0,0,10240,12,4118786848
5539,282617750,43904,282661654,5,0,0,512,11,6772930423
5540,282635650,81464,282717114,3,0,0,17920,9,5718344113
5541,282668939,72668,282741607,0,0,0,9216,10,8440320545
5542,282698210,100724,282798934,6,0,0,30720,9,6391883160
5543,282779209,74852,282854061,0,0,0,16384,10,6334631055
5544,282796470,51436,282847906,2,0,0,2048,4,7527052877
5545,282804850,59132,282863982,6,0,0,5120,9,181864047
5546,282957529,101660,283059189,0,0,0,33792,10,8692170821
5547,282961450,6229,282967679,0,0,1,15360,10,8960911065
5548,283040620,109148,283149768,4,0,0,58368,6,637369926
5549,283051449,169102,283220551,0,0,0,69632,10,557994687
5550,283089371,4937,283094308,2,0,1,12800,4,5708120589
5551,283097230,1518,283098748,8,0,1,1536,12,7300812564
5552,283097520,171348,283268868,2,0,0,23552,4,9702945062
5553,283125210,122862,283248072,8,0,0,76288,12,8105269293
5554,283140849,140982,283281831,9,0,0,42496,10,6065512370
5555,283294920,93440,283388360,6,0,0,16896,9,8798642425
5556,283399970,102752,283502722,1,0,0,37376,14,8270018059
5557,283427660,108524,283536184,8,0,0,56320,12,10192573310
5558,283538470,2870,283541340,7,0,1,8704,18,9213957009
5559,283557280,4162,283561442,9,0,1,11264,10,768865896
5560,283616130,1518,283617648,7,0,1,1536,18,3194350566
5561,283618250,163836,283782086,1,0,0,5632,14,4059119692
5562,283641070,45596,283686666,4,0,0,1024,6,3830221746
5563,283649240,81128,283730368,5,0,0,11776,11,1847260193
5564,283672110,155020,283827130,9,0,0,101376,10,5546627776
5565,283682540,102906,283785446,1,0,0,1536,14,6730744388
5566,283699090,171678,283870768,2,0,0,31744,4,9556762911
5567,283724330,103907,283828237,1,0,0,3584,14,2690857322
5568,283956850,69284,284026134,1,0,0,8192,14,7212641799
5569,283990990,101630,284092620,3,0,0,28672,9,4980354016
5570,284071120,88052,284159172,3,0,0,14336,9,9385480737
5571,284087620,59048,284146668,9,0,0,3584,10,7865231071
5572,284141010,5673,284146683,1,0,1,12288,14,7669924024
5573,284141870,6578,284148448,4,0,1,10240,6,2578523248
5574,284201980,101504,284303484,8,0,0,33280,12,5310467077
5575,284317000,57752,284374752,9,0,0,5632,10,10017276217
5576,284327400,59132,284386532,6,0,0,5120,9,2810290119
5577,284419850,103064,284522914,6,0,0,38400,9,5316288047
5578,284435119,106496,284541615,0,0,0,49664,10,8925375937
5579,284440450,4937,284445387,8,0,1,12800,12,2183085556
5580,284761430,43904,284805334,1,0,0,512,14,9933444235
5581,284787720,59600,284847320,8,0,0,6656,12,320778525
5582,284799759,92108,284891867,0,0,0,27648,10,9780823393
5583,284881760,76052,284957812,5,0,0,10240,11,7022839556
5584,284951790,110708,285062498,1,0,0,63488,14,6798871166
5585,285037859,79599,285117458,0,0,0,9728,10,3964132162
5586,285123090,103363,285226453,5,0,0,27136,11,3081451115
5587,285135350,82820,285218170,4,0,0,12288,6,7889516741
5588,285218450,111683,285330133,8,0,0,40448,12,1198288419
5589,285237110,80060,285317170,8,0,0,13312,12,1438377354
5590,285258040,138933,285396973,4,0,0,30720,6,4234673910
5591,285259450,113802,285373252,5,0,0,9728,11,4198448277
5592,285278210,84182,285362392,1,0,0,19456,14,10080126308
5593,285291260,92861,285384121,5,0,0,8704,11,5186641605
5594,285302450,6278,285308728,1,0,1,6656,14,8065115196
5595,285431600,99944,285531544,1,0,0,28160,14,1320697210
5596,285446749,54056,285500805,0,0,0,3584,10,3684735469
5597,285455840,119432,285575272,1,0,0,3072,14,2885060199
5598,285567910,94664,285662574,3,0,0,15872,9,2360251519
5599,285623940,58220,285682160,5,0,0,7168,11,4155325749
5600,285649830,62984,285712814,4,0,0,7680,6,4724859611
5601,285704540,63452,285767992,1,0,0,9216,14,8605334704
5602,285757340,67772,285825112,8,0,0,13312,12,1322702450
5603,285798890,95336,285894226,8,0,0,28160,12,1481033766
5604,285805991,2946,285808937,2,0,1,3072,4,8786032131
5605,285891981,3755,285895736,2,0,1,1536,4,900747407
5606,286001790,5802,286007592,1,0,1,6144,14,7744152543
5607,286084410,97760,286182170,7,0,0,20992,18,9879017563
5608,286137710,63660,286201370,4,0,0,6144,6,3745956270
5609,286223210,82220,286305430,7,0,0,15360,18,7231675462
5610,286412460,12825,286425285,0,0,1,21504,10,9347728242
5611,286418270,86672,286504942,9,0,0,11264,10,7742739667
5612,286550119,5712,286555831,3,0,1,14336,9,7676156726
5613,286604740,3904,286608644,9,0,1,10752,10,4319343472
5614,286629230,50672,286679902,1,0,0,2560,14,6997590325
5615,286679390,92906,286772296,9,0,0,25088,10,3833412901
5616,286729980,109148,286839128,6,0,0,58368,9,6630981813
5617,286806830,566,286807396,0,0,1,512,10,8388509497
5618,286960150,48980,287009130,7,0,0,2048,18,7150516015
5619,287056320,94844,287151164,3,0,0,21504,9,5468508736
5620,287119500,126711,287246211,9,0,0,8192,10,2112592839
5621,287126750,103688,287230438,8,0,0,40448,12,4287312285
5622,287170220,73472,287243692,8,0,0,16896,12,2471188591
5623,287184929,101348,287286277,0,0,0,32768,10,5246459943
5624,287196020,10757,287206777,8,0,1,17408,12,820868826
5625,287238699,127714,287366413,0,0,0,41472,10,4212544253
5626,287271320,4420,287275740,4,0,1,11776,6,7112186233
5627,287296170,90877,287387047,7,0,0,12288,18,5852590971
5628,287317250,1994,287319244,1,0,1,2048,14,4166671452
5629,287407760,5196,287412956,4,0,1,13312,6,3717069538
5630,287455170,64388,287519558,1,0,0,12288,14,7394259921
5631,287605609,89168,287694777,0,0,0,23040,10,4686729188
5632,287674180,75140,287749320,7,0,0,12288,18,4783471627
5633,287705700,68996,287774696,8,0,0,12288,12,6669368686
5634,287718360,71702,287790062,1,0,0,6144,14,9511660044
5635,287781440,82820,287864260,5,0,0,12288,11,1243378048
5636,287784380,102918,287887298,3,0,0,25600,9,118536791
5637,287852380,77884,287930264,7,0,0,9216,18,7325762401
5638,287873430,82408,287955838,9,0,1,133632,10,10281098321
5639,287903040,124235,288027275,7,0,0,9728,18,1629953177
5640,287974820,193693,288168513,7,0,0,17920,18,5024148263
5641,288010890,118527,288129417,5,0,0,512,11,9655778985
5642,288273550,100568,288374118,3,0,0,30208,9,4394859696
5643,288349610,102284,288451894,1,0,0,35840,14,6759091642
5644,288391600,140208,288531808,4,0,0,70144,6,1761286772
5645,288517719,88597,288606316,0,0,0,10240,10,652930637
5646,288546520,87896,288634416,4,0,0,13824,6,3549604256
5647,288614170,100880,288715050,8,0,0,31232,12,5942319517
5648,288632110,71582,288703692,4,0,0,8192,6,10529388926
5649,288659200,116048,288775248,8,0,0,20992,12,6051307703
5650,288698160,1042,288699202,8,0,1,1024,12,8096472007
5651,288881350,4374,288885724,4,0,1,4608,6,2290734848
5652,288885140,4850,288889990,0,0,1,5120,10,4769469980
5653,288910459,188304,289098763,0,0,0,34304,10,4398098407
5654,288963850,174849,289138699,5,0,0,34304,11,7917150979
5655,288993010,81128,289074138,3,0,0,11776,9,8456620380
5656,289053111,6488,289059599,6,0,1,15872,9,3150940743
5657,289079090,99471,289178561,5,0,0,13824,11,9826874076
5658,289122220,89875,289212095,8,0,0,16896,12,2592520439
5659,289216370,43904,289260274,3,0,0,512,9,9918613755
5660,289293860,566,289294426,1,0,1,512,14,299173698
5661,289296691,14545,289311236,6,0,1,28160,9,1824921929
5662,289348170,145067,289493237,3,0,0,24576,9,9141882685
5663,289411520,98072,289509592,3,0,0,22016,9,8395601362
5664,289502380,7706,289510086,4,0,1,8192,6,7937346943
5665,289574969,90704,289665673,9,0,0,23040,10,1127556965
5666,289663140,87037,289750177,1,0,0,12800,14,4283723838
5667,289675320,123097,289798417,3,0,0,80384,9,9262629194
5668,289706090,94284,289800374,1,0,0,3584,14,7471831720
5669,289783871,19388,289803259,2,0,1,5120,4,5662485127
5670,289806360,3422,289809782,8,0,1,3584,12,3517447042
5671,289813960,106340,289920300,5,0,0,49152,11,8432388861
5672,289865830,128300,289994130,3,0,0,63488,9,1831850496
5673,289973370,64656,290038026,9,0,0,512,10,6748686871
5674,289982500,97826,290080326,3,0,0,13312,9,7748393697
5675,290063440,71906,290135346,8,0,0,5120,12,8570546123
5676,290111550,84512,290196062,5,0,0,12800,11,7016031229
5677,290135591,7706,290143297,2,0,1,8192,4,8128089429
5678,290176450,72940,290249390,1,0,0,4096,14,442511366
5679,290190590,70644,290261234,3,0,0,7680,9,8182140060
5680,290203530,94688,290298218,3,0,0,20992,9,7671536063
5681,290235120,65624,290300744,5,0,0,6144,11,3854027069
5682,290247730,51127,290298857,5,0,0,2048,11,6096633273
5683,290320410,7230,290327640,8,0,1,7680,12,8381377661
5684,290435700,65900,290501600,5,0,0,7168,11,10208509194
5685,290514410,1042,290515452,1,0,1,1024,14,3346956083
5686,290548130,96380,290644510,9,0,0,21504,10,4908417395
5687,290649590,99632,290749222,4,0,0,27136,6,3195960373
5688,290658169,75920,290734089,0,0,0,14848,10,8060342217
5689,290684170,84692,290768862,3,0,0,18432,9,5246690674
5690,290793570,55748,290849318,3,0,0,4096,9,1419906808
5691,290839710,10757,290850467,9,0,1,17408,10,4899145544
5692,290863609,101348,290964957,0,0,0,32768,10,4756958124
5693,290953910,139195,291093105,7,0,0,22528,18,9534898700
5694,291238489,112580,291351069,9,0,0,69632,10,1769428324
5695,291271059,51296,291322355,0,0,0,4608,10,9814793239
5696,291296190,131835,291428025,5,0,0,22528,11,7207603890
5697,291418230,566,291418796,0,0,1,512,10,1521316847
5698,291445350,5802,291451152,1,0,1,6144,14,6623578695
5699,291508891,2946,291511837,6,0,1,3072,9,5462165180
5700,291860240,69284,291929524,3,0,0,8192,9,10421031147
5701,291949450,70532,292019982,9,0,0,12288,10,4052365078
5702,291982470,86196,292068666,9,0,1,144384,10,196070171
5703,291990379,80233,292070612,3,0,1,3072,9,9309281287
5704,292055270,138939,292194209,1,0,0,21504,14,520459413
5705,292289770,101972,292391742,3,0,0,34816,9,9373292586
5706,292290920,7706,292298626,7,0,1,8192,18,9592580525
5707,292308160,3387,292311547,0,0,1,9728,10,8076765861
5708,292338250,4162,292342412,8,0,1,11264,12,4677475661
5709,292434640,72531,292507171,9,0,0,4608,10,10185586790
5710,292448250,70976,292519226,7,0,0,8704,18,2824234113
5711,292559590,6229,292565819,4,0,1,15360,6,7942232244
5712,292560409,10664,292571073,3,0,1,7168,9,5917613077
5713,292647610,62828,292710438,8,0,0,7168,12,2903497149
5714,292653870,122588,292776458,1,0,0,13312,14,1783737660
5715,292704280,133876,292838156,1,0,0,28160,14,7676710942
5716,292732190,2870,292735060,4,0,1,8704,6,3862419344
5717,292853180,106652,292959832,5,0,0,50176,11,5341697052
5718,292918100,87212,293005312,7,0,0,5632,18,8828771712
5719,292927410,106964,293034374,8,0,0,51200,12,210030265
5720,293030120,63403,293093523,3,0,0,5120,9,131552292
5721,293033700,51363,293085063,7,0,0,2560,18,167846986
5722,293228000,97004,293325004,8,0,0,23552,12,1776266273
5723,293330901,13253,293344154,6,0,1,25600,9,10665095632
5724,293383170,51140,293434310,3,0,0,4096,9,8008872247
5725,293385900,101024,293486924,1,0,0,17920,14,7420669005
5726,293401149,142119,293543268,9,0,0,10752,10,2643522962
5727,293546350,65900,293612250,3,0,0,7168,9,8451451082
5728,293683390,63296,293746686,5,0,0,8704,11,6437364721
5729,293726260,107432,293833692,8,0,0,52736,12,3052168837
5730,293828500,50780,293879280,1,0,0,1024,14,8055773097
5731,293842710,48980,293891690,1,0,0,2048,14,6126373389
5732,293848979,87777,293936756,0,0,0,7680,10,3279785989
5733,293879390,48980,293928370,4,0,0,2048,6,1965444568
5734,293938989,57440,293996429,9,0,0,4608,10,5655248930
5735,293991800,54056,294045856,4,0,0,3584,6,9465176080
5736,294088961,6754,294095715,6,0,1,7168,9,10651678874
5737,294217049,1518,294218567,3,0,1,1536,9,3538152643
5738,294264149,59132,294323281,0,0,0,5120,10,4893289009
5739,294274340,49580,294323920,7,0,0,2048,18,6140135487
5740,294330320,22950,294353270,9,0,1,37888,10,4783321853
5741,294360449,54368,294414817,9,0,0,4608,10,7836612982
5742,294518360,56840,294575200,3,0,0,7680,9,1468504472
5743,294591680,67772,294659452,4,0,0,13312,6,7763333777
5744,294673010,45752,294718762,4,0,0,1536,6,4120685180
5745,294712340,4850,294717190,1,0,1,5120,14,5299475913
5746,294750960,52364,294803324,5,0,0,3072,11,3164413689
5747,294811911,7230,294819141,2,0,1,7680,4,9497572848
5748,294814820,55748,294870568,8,0,0,4096,12,3848635017
5749,294855170,131978,294987148,4,0,0,87040,6,3398860155
5750,294914509,142779,295057288,0,0,0,27648,10,2798240257
5751,294937130,4162,294941292,7,0,1,11264,18,7469237703
5752,295034460,77176,295111636,8,0,0,7168,12,993535348
5753,295058850,101972,295160822,7,0,0,34816,18,3407709917
5754,295060700,75582,295136282,1,0,0,9728,14,8854379717
5755,295126879,124096,295250975,9,0,0,30720,10,1170792149
5756,295178699,72759,295251458,0,0,0,1536,10,4664093194
5757,295192620,48980,295241600,3,0,0,2048,9,4748395187
5758,295207360,85240,295292600,1,0,0,10240,14,2635903965
5759,295316070,48980,295365050,4,0,0,2048,6,4905405360
5760,295350080,54056,295404136,3,0,0,3584,9,10618647729
5761,295378280,79304,295457584,2,0,0,15872,4,4751341161
5762,295385200,112580,295497780,1,0,0,69632,14,9506035363
5763,295402980,95751,295498731,5,0,0,3072,11,7835523295
5764,295436640,116820,295553460,7,0,0,38400,18,2582330891
5765,295561490,45596,295607086,3,0,0,1024,9,7951251187
5766,295670310,47600,295717910,8,0,0,2560,12,9678388122
5767,295693120,71884,295765004,3,0,0,14848,9,5993650831
5768,295715489,43904,295759393,0,0,0,512,10,9387440698
5769,295717659,103931,295821590,0,0,0,40448,10,3803872718
5770,295834069,104468,295938537,0,0,0,43008,10,3452362690
5771,295899130,84536,295983666,3,0,0,17920,9,8999856068
5772,295910210,128380,296038590,5,0,0,36864,11,2737052071
5773,296049350,83288,296132638,4,0,0,13824,6,9293042148
5774,296090589,112603,296203192,9,0,0,17408,10,9686523868
5775,296102869,86228,296189097,0,0,0,18432,10,7744360484
5776,296186280,199176,296385456,9,0,1,318976,10,1313254153
5777,296197060,342676,296539736,7,0,0,39424,18,2166130663
5778,296239479,258173,296497652,0,0,0,7168,10,7715169585
5779,296265350,123332,296388682,1,0,1,5120,14,5382550419
5780,296331640,255391,296587031,7,0,0,32768,18,1158512527
5781,296402160,213821,296615981,1,0,0,22016,14,2542618823
5782,296420459,247212,296667671,9,0,0,64512,10,9612620249
5783,296523120,247873,296770993,8,0,0,11264,12,2971826546
5784,296594860,2946,296597806,1,0,1,3072,14,7520060276
5785,296728880,90524,296819404,1,0,0,17408,14,419880186
5786,296759250,15062,296774312,1,0,1,29184,14,224414099
5787,296764170,75160,296839330,7,0,0,1024,18,4664661783
5788,296769620,8878,296778498,7,0,1,6656,18,8268681084
5789,296837160,138183,296975343,1,0,0,37376,14,6839780567
5790,296899959,124531,297024490,0,0,0,19456,10,3799683799
5791,297057730,95446,297153176,5,0,0,2048,11,9197610669
5792,297068540,98696,297167236,8,0,0,24064,12,6915789074
5793,297071940,78524,297150464,4,0,0,13312,6,4622744217
5794,297083530,114862,297198392,9,0,0,14336,10,3651477156
5795,297159530,68522,297228052,7,0,0,5632,18,4692278887
5796,297163390,81738,297245128,5,0,0,11264,11,7361118428
5797,297188450,5196,297193646,4,0,1,13312,6,7457099412
5798,297335620,2470,297338090,9,0,1,2560,10,1367486935
5799,297345500,55748,297401248,4,0,0,4096,6,1058642819
5800,297382110,1518,297383628,1,0,1,1536,14,4315155918
5801,297409071,7230,297416301,2,0,1,7680,4,3248202482
5802,297494700,107744,297602444,7,0,0,53760,18,7833996763
5803,297539800,84118,297623918,4,0,0,7168,6,1601057558
5804,297588289,119083,297707372,0,0,0,44544,10,7335726178
5805,297653900,128394,297782294,1,0,0,62464,14,4895030390
5806,297690340,140500,297830840,4,0,0,24064,6,1724775011
5807,297775320,149792,297925112,8,0,0,33792,12,1769168825
5808,297891080,7706,297898786,0,0,1,8192,10,1216618896
5809,297943110,55748,297998858,4,0,0,4096,6,7783601123
5810,298021150,2946,298024096,4,0,1,3072,6,10674417760
5811,298062930,91748,298154678,8,0,0,16384,12,9419114745
5812,298111960,57908,298169868,3,0,0,6144,9,7423916730
5813,298130310,101972,298232282,7,0,0,34816,18,9891162486
5814,298217370,65900,298283270,4,0,0,7168,6,2130973164
5815,298248000,56216,298304216,6,0,0,5632,9,9142950420
5816,298353890,3898,298357788,0,0,1,4096,10,346345351
5817,298409630,101972,298511602,9,0,0,34816,10,1236205555
5818,298425970,70976,298496946,8,0,0,8704,12,2824640452
5819,298511681,5196,298516877,6,0,1,13312,9,234491667
5820,298555639,4374,298560013,3,0,1,4608,9,1734910843
5821,298612670,140923,298753593,5,0,0,23040,11,4639268170
5822,298677830,80926,298758756,8,0,0,16896,12,5053842442
5823,298682529,4937,298687466,3,0,1,12800,9,1375736599
5824,298893560,74360,298967920,9,0,0,9728,10,3986806793
5825,298969170,100724,299069894,5,0,0,30720,11,1288987259
5826,298994380,139852,299134232,5,0,0,18944,11,3078317177
5827,299030531,10241,299040772,2,0,1,16384,4,6927508927
5828,299031760,112708,299144468,3,0,0,7168,9,1784907899
5829,299107160,2946,299110106,4,0,1,3072,6,392579930
5830,299350640,105404,299456044,5,0,0,46080,11,10412041274
5831,299460070,105716,299565786,5,0,0,47104,11,1708479126
5832,299507510,102284,299609794,1,0,0,35840,14,9712052527
5833,299574470,101036,299675506,5,0,0,31744,11,4100265074
5834,299690210,114296,299804506,9,0,0,75264,10,10207148904
5835,299719839,11274,299731113,3,0,1,18432,9,6585714282
5836,299858930,72668,299931598,9,0,0,9216,10,7087586880
5837,299866820,129686,299996506,7,0,0,60928,18,6580767491
5838,299904980,135590,300040570,4,0,0,37376,6,1982947725
5839,299934990,2946,299937936,1,0,1,3072,14,5358272839
5840,299980740,16324,299997064,8,0,1,512,12,10600367566
5841,300035411,9055,300044466,2,0,1,10752,4,2185291863
5842,300073910,43904,300117814,9,0,0,512,10,7752082317
5843,300299360,1518,300300878,0,0,1,1536,10,8598536247
5844,300307000,45596,300352596,1,0,0,1024,14,4362106838
5845,300436609,43904,300480513,9,0,0,512,10,4296180473
5846,300464741,5326,300470067,6,0,1,5632,9,7078278183
5847,300490130,112363,300602493,7,0,0,27648,18,8504155148
5848,300492550,101504,300594054,5,0,0,33280,11,1803060600
5849,300552860,169216,300722076,5,0,0,139776,11,10517077115
5850,300639760,84991,300724751,4,0,0,8704,6,9580614303
5851,300696830,135033,300831863,7,0,0,51712,18,4737480358
5852,300714070,132158,300846228,3,0,0,16896,9,10061752212
5853,300734920,69284,300804204,7,0,0,8192,18,8294186076
5854,300773240,75940,300849180,1,0,0,9216,14,8826468911
5855,300827980,78560,300906540,1,0,0,8704,14,2507937784
5856,300933840,59912,300993752,4,0,0,7680,6,1943958395
5857,300956289,158681,301114970,9,0,0,137216,10,6871061653
5858,301137260,64208,301201468,8,0,0,6656,12,9748160231
5859,301190950,96692,301287642,5,0,0,22528,11,2375619762
5860,301197649,163643,301361292,9,0,0,31232,10,1619656628
5861,301214359,91649,301306008,9,0,0,1024,10,4246416140
5862,301250690,3387,301254077,1,0,1,9728,14,4419374114
5863,301276270,121341,301397611,5,0,0,27136,11,2571369346
5864,301364159,58220,301422379,9,0,0,7168,10,9780026675
5865,301436890,97136,301534026,7,0,0,18944,18,7183782616
5866,301446490,3898,301450388,0,0,1,4096,10,1142186635
5867,301643019,102284,301745303,0,0,0,35840,10,1289386221
5868,301740051,6762,301746813,2,0,1,1536,4,7777091749
5869,301892550,6488,301899038,7,0,1,15872,18,5144208506
5870,301959860,91616,302051476,4,0,0,20992,6,1353366788
5871,301969860,153171,302123031,3,0,0,25600,9,6676182369
5872,302053210,566,302053776,7,0,1,512,18,9352499561
5873,302089790,52364,302142154,1,0,0,3072,14,3390066103
5874,302182210,100724,302282934,8,0,0,30720,12,1976509445
5875,302221061,1994,302223055,6,0,1,2048,9,5723863282
5876,302228240,111332,302339572,8,0,0,65536,12,5929126446
5877,302242720,53636,302296356,3,0,0,3072,9,9149689602
5878,302316120,71444,302387564,7,0,0,10240,18,1999225262
5879,302326380,94336,302420716,4,0,0,16896,6,6540055762
5880,302332210,58051,302390261,7,0,0,2560,18,187439106
5881,302386179,84887,302471066,9,0,0,8704,10,4447221184
5882,302739970,112934,302852904,4,0,0,39936,6,3735083520
5883,302750701,5326,302756027,2,0,1,5632,4,9949126436
5884,302757870,175884,302933754,4,0,0,77312,6,3119578335
5885,302834080,154922,302989002,5,0,0,19456,11,962169260
5886,303415369,101036,303516405,0,0,0,31744,10,6714466438
5887,303490270,110708,303600978,5,0,0,63488,11,5439170012
5888,303614210,11533,303625743,7,0,1,18944,18,10351533173
5889,303624769,170698,303795467,0,0,0,7168,10,6096937580
5890,303652700,59132,303711832,5,0,0,5120,11,9299470563
5891,303688370,95132,303783502,5,0,0,17408,11,7162634974
5892,303800940,99944,303900884,6,0,0,28160,9,3556441144
5893,303846710,81020,303927730,7,0,0,21504,18,5902710025
5894,303875960,60192,303936152,2,0,0,512,4,2832532978
5895,303897040,153823,304050863,2,0,0,78848,4,798360895
5896,303914340,5454,303919794,7,0,1,13824,18,8963555396
5897,303995940,55726,304051666,7,0,0,2560,18,6989117189
5898,304005760,12995,304018755,1,0,1,25088,14,1796886051
5899,304034231,22848,304057079,2,0,1,13824,4,6879306644
5900,304066210,75074,304141284,3,0,0,9216,9,8921268268
5901,304074160,125210,304199370,5,0,0,72704,11,1695582110
5902,304163580,45596,304209176,7,0,0,1024,18,6655949804
5903,304203830,127529,304331359,9,0,0,60416,10,1547757945
5904,304209530,2946,304212476,4,0,1,3072,6,8093495236
5905,304217640,159563,304377203,5,0,0,8704,11,8373393364
5906,304230350,5326,304235676,0,0,1,5632,10,2800065285
5907,304301499,92524,304394023,0,0,0,11776,10,4299348255
5908,304332640,104156,304436796,4,0,0,41984,6,4137043524
5909,304376409,131451,304507860,9,0,0,15872,10,8762754390
5910,304379460,64410,304443870,6,0,0,3584,9,5518403718
5911,304397150,152704,304549854,7,0,0,21504,18,7919036978
5912,304404630,2870,304407500,0,0,1,8704,10,10613864633
5913,304442040,160266,304602306,9,0,0,37376,10,3748051493
5914,304618620,98540,304717160,4,0,0,23552,6,5618331069
5915,304637120,72692,304709812,9,0,0,14336,10,4895481875
5916,304659120,104936,304764056,6,0,0,44544,9,2249103947
5917,304846419,94820,304941239,0,0,0,16384,10,1487135617
5918,304863990,111482,304975472,5,0,0,17408,11,8906462639
5919,304880340,62942,304943282,4,0,0,6656,6,8480312505
5920,304942260,111098,305053358,7,0,0,61440,18,4595892804
5921,304990359,142655,305133014,9,0,0,33280,10,10354201735
5922,305064551,12566,305077117,2,0,1,20992,4,1320831383
5923,305099420,107744,305207164,1,0,0,53760,14,8735923942
5924,305216359,96978,305313337,0,0,0,12288,10,5804662673
5925,305242820,1042,305243862,7,0,1,1024,18,5760531761
5926,305306910,54836,305361746,8,0,0,6144,12,9195675797
5927,305322700,99632,305422332,4,0,0,27136,6,9332760246
5928,305366050,20882,305386932,7,0,1,33792,18,1550907665
5929,305452120,7706,305459826,1,0,1,8192,14,7775939243
5930,305535910,104156,305640066,6,0,0,41984,9,8891541731
5931,305655161,3898,305659059,6,0,1,4096,9,7423313423
5932,305712510,95912,305808422,7,0,0,19968,18,4559636671
5933,305735069,144375,305879444,0,0,0,25088,10,2051386290
5934,305752100,96980,305849080,7,0,0,18432,18,4737969914
5935,305816179,70976,305887155,9,0,0,8704,10,2516946533
5936,305855100,103220,305958320,4,0,0,38912,6,672424056
5937,305861830,67012,305928842,4,0,0,1536,6,5682523851
5938,305987260,72068,306059328,6,0,0,12288,9,924954607
5939,306037820,84560,306122380,3,0,0,23040,9,1355994858
5940,306072410,109928,306182338,1,0,0,60928,14,2577378851
5941,306160579,106047,306266626,0,0,0,37888,10,7328090008
5942,306254060,59132,306313192,7,0,0,5120,18,6784311948
5943,306262480,112038,306374518,3,0,0,54272,9,3110750415
5944,306288920,166378,306455298,1,0,0,36864,14,2469588739
5945,306312719,108829,306421548,0,0,0,53248,10,4552882740
5946,306334270,91193,306425463,5,0,0,12800,11,7059604666
5947,306356151,18382,306374533,6,0,1,21504,9,2983023461
5948,306398821,4420,306403241,2,0,1,11776,4,1013123688
5949,306411720,130206,306541926,3,0,0,21504,9,791823070
5950,306453890,138856,306592746,7,0,0,82432,18,4212336361
5951,306557060,78859,306635919,5,0,0,8192,11,6508684554
5952,306844670,76052,306920722,4,0,0,10240,6,1457985323
5953,306899689,122720,307022409,9,0,0,102912,10,5255060437
5954,306902920,3387,306906307,8,0,1,9728,12,6097300688
5955,307135710,129208,307264918,8,0,0,70144,12,1018009000
5956,307150770,4374,307155144,0,0,1,4608,10,1747903499
5957,307272811,11016,307283827,2,0,1,17920,4,1853944425
5958,307341720,100696,307442416,1,0,0,17408,14,633539647
5959,307391630,152502,307544132,7,0,0,23040,18,6460407963
5960,307452070,4420,307456490,8,0,1,11776,12,5460696670
5961,307453250,46361,307499611,6,0,0,512,9,2781819780
5962,307474500,278458,307752958,8,0,0,69120,12,8782184447
5963,307522710,101780,307624490,3,0,0,6144,9,3854799241
5964,307526340,17807,307544147,8,0,1,20992,12,4460076536
5965,307567539,164328,307731867,0,0,0,95232,10,6990728188
5966,307576890,181863,307758753,1,0,0,18944,14,778423813
5967,307623550,4060,307627610,4,0,1,9216,6,5163672500
5968,307629469,194768,307824237,9,0,0,34304,10,10558768608
5969,307712760,121476,307834236,6,0,0,32768,9,8850945720
5970,307723040,35728,307758768,9,0,1,4096,10,173856868
5971,307764210,93483,307857693,7,0,0,6144,18,3622428468
5972,307840170,2470,307842640,4,0,1,2560,6,6966462530
5973,307846000,1042,307847042,4,0,1,1024,6,1896370923
5974,307966200,82844,308049044,3,0,0,17408,9,4867585907
5975,308032880,105092,308137972,8,0,0,45056,12,2948440400
5976,308055200,162978,308218178,4,0,0,37888,6,7386227896
5977,308094960,88364,308183324,8,0,0,15360,12,7891897602
5978,308134640,127478,308262118,3,0,0,30720,9,6702021277
5979,308168180,141518,308309698,3,0,0,18944,9,2319891387
5980,308199740,101972,308301712,3,0,0,34816,9,2546702324
5981,308227190,99164,308326354,1,0,0,8704,14,6402990101
5982,308228209,75702,308303911,0,0,0,7168,10,9485125545
5983,308236990,133080,308370070,5,0,0,9728,11,5816093903
5984,308308260,1996,308310256,0,0,1,512,10,6863554969
5985,308313469,181804,308495273,9,0,0,29184,10,3048602507
5986,308379470,57752,308437222,5,0,0,5632,11,7286197435
5987,308385450,85760,308471210,5,0,0,16896,11,5416104406
5988,308398590,87776,308486366,8,0,0,6144,12,1949734126
5989,308448700,116185,308564885,8,0,0,30208,12,7704595727
5990,308511120,54872,308565992,6,0,0,3584,9,1315692055
5991,308531600,80528,308612128,7,0,0,14848,18,6699605046
5992,308569090,129348,308698438,8,0,0,70144,12,6343519986
5993,308732400,119756,308852156,7,0,0,93184,18,2870362984
5994,308828520,84452,308912972,4,0,0,5632,6,8201900012
5995,308944270,100568,309044838,5,0,0,30208,11,2901218704
5996,308955599,71317,309026916,0,0,0,512,10,8613177557
5997,308960950,3904,308964854,4,0,1,10752,6,6247136497
5998,308979820,108920,309088740,8,0,0,16896,12,2873338285
5999,309097040,48980,309146020,4,0,0,2048,6,4544011983
6000,309105010,98540,309203550,6,0,0,23552,9,3372145342
6001,309129920,63608,309193528,5,0,0,9728,11,1727689337
6002,309190400,48980,309239380,8,0,0,2048,12,2459757772
6003,309243849,64208,309308057,0,0,0,6656,10,8682425163
6004,309250021,6278,309256299,2,0,1,6656,4,8251800497
6005,309254880,118902,309373782,1,0,0,43008,14,6513068437
6006,309285990,133549,309419539,7,0,1,216576,18,6360994387
6007,309454160,1994,309456154,0,0,1,2048,10,4625410380
6008,309467380,4937,309472317,9,0,1,12800,10,3733308041
6009,309523950,3387,309527337,9,0,1,9728,10,9861670139
6010,309574220,100568,309674788,7,0,0,30208,18,3273825387
6011,309675490,43904,309719394,8,0,0,512,12,8619591979
6012,309746380,114920,309861300,8,0,0,77312,12,7463107350
6013,309771950,148516,309920466,8,0,0,43520,12,3799010367
6014,309835729,91547,309927276,0,0,0,14336,10,6604486910
6015,309890449,118925,310009374,9,0,0,55808,10,6170245109
6016,309902450,18031,309920481,1,0,1,7680,14,9469081923
6017,309926740,82649,310009389,7,0,1,110592,18,7304888340
6018,310071309,80684,310151993,9,0,0,15360,10,2593844201
6019,310081491,3422,310084913,6,0,1,3584,9,13082920
6020,310144440,104936,310249376,1,0,0,44544,14,5764010654
6021,310267840,82820,310350660,8,0,0,12288,12,10666318691
6022,310366899,87944,310454843,9,0,0,24064,10,6706988132
6023,310397809,122200,310520009,9,0,0,25088,10,1815325867
6024,310598880,5196,310604076,1,0,1,13312,14,1119222042
6025,310610910,111020,310721930,1,0,0,64512,14,3931303564
6026,310628039,194242,310822281,0,0,0,25088,10,9904762116
6027,310754959,69209,310824168,0,0,0,6144,10,2848851667
6028,310860410,104000,310964410,3,0,0,41472,9,8588392971
6029,310881630,113662,310995292,4,0,0,35840,6,7849424334
6030,310890879,145933,311036812,0,0,0,46080,10,489267552
6031,310996810,7230,311004040,4,0,1,7680,6,3771922137
6032,311130190,3387,311133577,8,0,1,9728,12,9886787531
6033,311192410,95156,311287566,4,0,0,22528,6,5249378016
6034,311207450,140968,311348418,1,0,0,60928,14,1271237023
6035,311274740,92864,311367604,7,0,0,25088,18,5871902498
6036,311338869,121809,311460678,0,0,0,68608,10,5761614587
6037,311417370,99320,311516690,4,0,0,26112,6,10029273228
6038,311423550,1994,311425544,1,0,1,2048,14,60934280
6039,311464999,78236,311543235,0,0,0,17408,10,855590130
6040,311817250,83600,311900850,5,0,0,14848,11,4220961606
6041,311820520,55748,311876268,5,0,0,4096,11,4299336613
6042,311861130,66056,311927186,9,0,0,7680,10,7143372175
6043,312022069,113191,312135260,0,0,0,69632,10,3698032748
6044,312042990,140718,312183708,7,0,0,19968,18,7026708130
6045,312068550,109059,312177609,6,0,0,11776,9,2223561492
6046,312241750,52364,312294114,5,0,0,3072,11,3870320050
6047,312243001,566,312243567,6,0,1,512,9,932138209
6048,312265930,70976,312336906,3,0,0,8704,9,9674901126
6049,312314180,111946,312426126,7,0,0,22016,18,5469956687
6050,312336830,52136,312388966,3,0,0,512,9,584667390
6051,312379409,109885,312489294,9,0,0,15360,10,9797599066
6052,312433400,1042,312434442,8,0,1,1024,12,1051891222
6053,312451770,78680,312530450,3,0,0,13824,9,1269043403
6054,312496150,45752,312541902,3,0,0,1536,9,7976299291
6055,312501900,96980,312598880,9,0,0,18432,10,8730085178
6056,312577439,86204,312663643,0,0,0,13312,10,6858940835
6057,312642630,60224,312702854,5,0,0,8704,11,10190679572
6058,312646500,98696,312745196,1,0,0,24064,14,6248584378
6059,312652760,73026,312725786,1,0,0,4608,14,9510342217
6060,312800880,74384,312875264,4,0,0,14848,6,445855374
6061,312889670,68684,312958354,7,0,0,11264,18,8786704845
6062,312928790,59978,312988768,4,0,0,4096,6,4234721473
6063,313003671,12049,313015720,2,0,1,19968,4,9562313386
6064,313040190,85136,313125326,7,0,0,14848,18,3094808315
6065,313162731,2470,313165201,2,0,1,2560,4,3788869890
6066,313205480,48980,313254460,7,0,0,2048,18,6616693932
6067,313242099,77456,313319555,0,0,0,14848,10,2425802198
6068,313276060,101660,313377720,4,0,0,33792,6,9439470110
6069,313311959,54056,313366015,0,0,0,3584,10,9291523742
6070,313333930,111650,313445580,4,0,0,12288,6,3837599562
6071,313415960,77744,313493704,5,0,0,10752,11,9725835202
6072,313429630,4850,313434480,4,0,1,5120,6,2104841008
6073,313466920,91616,313558536,4,0,0,20992,6,8949102671
6074,313473100,158330,313631430,8,0,0,32256,12,8784408660
6075,313532210,137740,313669950,7,0,0,10240,18,7870664609
6076,313532430,124596,313657026,3,0,0,20480,9,3582126922
6077,313589480,91636,313681116,8,0,0,7680,12,8780362322
6078,313676211,7230,313683441,6,0,1,7680,9,8946364030
6079,313788560,1042,313789602,0,0,1,1024,10,2103803133
6080,313864661,3645,313868306,2,0,1,10240,4,3360237544
6081,313928849,59132,313987981,0,0,0,5120,10,8894356015
6082,313931960,45596,313977556,5,0,0,1024,11,8848607677
6083,314053040,102596,314155636,4,0,0,36864,6,4594443741
6084,314147171,14686,314161857,2,0,1,15360,4,10561781391
6085,314165500,263082,314428582,1,0,0,73728,14,4068008709
6086,314267280,112558,314379838,3,0,0,29696,9,10292756580
6087,314270210,52364,314322574,5,0,0,3072,11,2663522689
6088,314433920,101192,314535112,7,0,0,32256,18,5719340873
6089,314476160,243374,314719534,7,0,1,393728,18,3318992703
6090,314501470,275290,314776760,6,0,0,27136,9,8525690906
6091,314653440,370220,315023660,9,0,0,92160,10,4519015915
6092,314654929,243514,314898443,9,0,0,17920,10,9243606222
6093,314675459,254559,314930018,0,0,0,12800,10,4838880304
6094,314771250,143897,314915147,8,0,0,1024,12,8039501533
6095,314808300,84668,314892968,5,0,0,13312,11,4959740229
6096,314933071,2470,314935541,6,0,1,2560,9,4938297172
6097,314957370,81620,315038990,7,0,0,18432,18,491837194
6098,314981429,84802,315066231,9,0,0,12800,10,2247461183
6099,315024819,123888,315148707,0,0,0,14848,10,7532935854
6100,315029779,99164,315128943,0,0,0,25600,10,4179474066
6101,315092099,145414,315237513,9,0,0,78336,10,3191051128
6102,315096059,186388,315282447,9,0,0,23040,10,8788671114
6103,315224820,65049,315289869,1,0,0,3072,14,10188662402
6104,315250370,119481,315369851,2,0,0,80384,4,9176646110
6105,315258060,4420,315262480,9,0,1,11776,10,8634787699
6106,315283140,3422,315286562,4,0,1,3584,6,9810440360
6107,315391951,1994,315393945,2,0,1,2048,4,2871916324
6108,315426790,11791,315438581,1,0,1,19456,14,8722185985
6109,315462940,99467,315562407,8,0,0,25088,12,277832095
6110,315473620,81128,315554748,7,0,0,11776,18,273594851
6111,315484750,4937,315489687,4,0,1,12800,6,5797444228
6112,315516670,124514,315641184,7,0,0,20992,18,5242112624
6113,315648950,113516,315762466,7,0,0,72704,18,6380998562
6114,315656000,76388,315732388,7,0,0,16384,18,175205965
6115,315656160,57440,315713600,9,0,0,4608,10,328127895
6116,315695860,80928,315776788,7,0,0,7680,18,3173426097
6117,315787399,99632,315887031,0,0,0,27136,10,3926038672
6118,316005320,43904,316049224,3,0,0,512,9,7079216826
6119,316005950,96824,316102774,8,0,0,17920,12,5196270109
6120,316124909,86228,316211137,0,0,0,18432,10,7378682226
6121,316200379,80396,316280775,0,0,0,19456,10,3510694894
6122,316349940,52364,316402304,4,0,0,3072,6,421805009
6123,316401050,81908,316482958,3,0,0,14336,9,9544149093
6124,316415040,55748,316470788,8,0,0,4096,12,1824675136
6125,316559330,65900,316625230,9,0,0,7168,10,5194627998
6126,316583939,51296,316635235,0,0,0,4608,10,9076965848
6127,316750700,3422,316754122,0,0,1,3584,10,1608199214
6128,316938060,122720,317060780,3,0,0,102912,9,10315204915
6129,317103901,4850,317108751,2,0,1,5120,4,10486694852
6130,317124970,47288,317172258,3,0,0,1536,9,2310500595
6131,317244340,24154,317268494,4,0,1,43520,6,3791252828
6132,317252910,17850,317270760,9,0,1,3584,10,5535695316
6133,317275850,133555,317409405,9,0,0,35840,10,7493375064
6134,317329910,121115,317451025,4,0,0,512,6,384690272
6135,317379570,106652,317486222,8,0,0,50176,12,9643243196
6136,317423790,175412,317599202,3,0,0,20480,9,4093974981
6137,317430450,125366,317555816,1,0,0,45568,14,2393079766
6138,317447299,109468,317556767,0,0,0,3072,10,9112910059
6139,317587720,91460,317679180,3,0,0,20480,9,7149459233
6140,317930350,76856,318007206,7,0,0,17920,18,8767965452
6141,317991311,1994,317993305,6,0,1,2048,9,8530938720
6142,318143400,70376,318213776,8,0,0,11776,12,6377726358
6143,318202420,96980,318299400,9,0,0,18432,10,4546322300
6144,318257730,47288,318305018,4,0,0,1536,6,8260307968
6145,318288380,98384,318386764,3,0,0,23040,9,2196878707
6146,318352350,50672,318403022,8,0,0,2560,12,3314193265
6147,318371670,94512,318466182,7,0,1,157184,18,10021780451
6148,318687750,54056,318741806,4,0,0,3584,6,7463493489
6149,318730220,97916,318828136,4,0,0,21504,6,6505598328
6150,318830830,566,318831396,9,0,1,512,10,4596739470
6151,318914441,3898,318918339,6,0,1,4096,9,4569143244
6152,319260110,104378,319364488,7,0,1,173056,18,4684803273
6153,319278050,87104,319365154,9,0,1,1024,10,6672801532
6154,319292700,146685,319439385,7,0,0,17408,18,5142193022
6155,319385829,180128,319565957,0,0,0,39936,10,1502144309
6156,319433270,95613,319528883,8,0,0,9216,12,686784242
6157,319452450,1042,319453492,9,0,1,1024,10,319111141
6158,319680060,111079,319791139,8,0,0,27648,12,10289805715
6159,319680599,118043,319798642,0,0,0,24576,10,7644409460
6160,319868521,2870,319871391,2,0,1,8704,4,9676487543
6161,319933490,1042,319934532,4,0,1,1024,6,8806437585
6162,319939131,1994,319941125,2,0,1,2048,4,1580654229
6163,319942710,117362,320060072,3,0,0,68608,9,734292897
6164,320071270,56060,320127330,4,0,0,5120,6,4343871036
6165,320202200,3898,320206098,8,0,1,4096,12,7132390407
6166,320233630,57908,320291538,4,0,0,6144,6,9769012883
6167,320352770,111956,320464726,8,0,0,67584,12,794919946
6168,320582940,99476,320682416,3,0,0,26624,9,2330144274
6169,320690890,52364,320743254,2,0,0,3072,4,9842300354
6170,320744850,4374,320749224,9,0,1,4608,10,7035250744
6171,320761380,102128,320863508,3,0,0,35328,9,6227377498
6172,320776190,129253,320905443,4,0,0,4096,6,5343954745
6173,321002740,104468,321107208,7,0,0,43008,18,4261975390
6174,321178610,48980,321227590,8,0,0,2048,12,5044024033
6175,321209970,116571,321326541,7,0,1,193536,18,5275457474
6176,321286100,134548,321420648,3,0,0,4096,9,2442540331
6177,321455680,83132,321538812,8,0,0,13312,12,10518332451
6178,321472510,74828,321547338,3,0,0,11264,9,427113117
6179,321532060,60824,321592884,7,0,0,5632,18,1356631589
6180,321756139,98540,321854679,0,0,0,23552,10,8357219702
6181,321871320,55748,321927068,8,0,0,4096,12,9678343235
6182,321886679,79016,321965695,0,0,0,19968,10,4761619211
6183,321896930,5802,321902732,0,0,1,6144,10,465893317
6184,322296400,59600,322356000,4,0,0,6656,6,9309320857
6185,322315210,81128,322396338,4,0,0,11776,6,2254219653
6186,322315670,1518,322317188,1,0,1,1536,14,8940762416
6187,322446410,78704,322525114,3,0,0,18944,9,3818986926
6188,322454560,2470,322457030,4,0,1,2560,6,9402103225
6189,322458870,5712,322464582,1,0,1,14336,14,8261546245
6190,322500740,5712,322506452,7,0,1,14336,18,3935511202
6191,322558920,104468,322663388,7,0,0,43008,18,98540268
6192,322774379,99788,322874167,9,0,0,27648,10,9471043126
6193,322802101,2946,322805047,2,0,1,3072,4,6556219171
6194,322863780,1042,322864822,9,0,1,1024,10,7136230913
6195,322882100,61604,322943704,6,0,0,8192,9,2234345268
6196,322916050,106496,323022546,8,0,0,49664,12,4410003408
6197,322955419,5326,322960745,3,0,1,5632,9,387218288
6198,322959260,63925,323023185,8,0,0,2048,12,5111813562
6199,323072610,104000,323176610,6,0,0,41472,9,796815763
6200,323076969,103400,323180369,0,0,0,12288,10,5702569610
6201,323149090,70420,323219510,6,0,0,3584,9,9374626594
6202,323282610,48980,323331590,7,0,0,2048,18,6741095295
6203,323652781,4850,323657631,2,0,1,5120,4,2605045418
6204,323737110,102596,323839706,3,0,0,36864,9,613716467
6205,323740060,111205,323851265,8,0,0,37888,12,3272208297
6206,323917310,70976,323988286,7,0,0,8704,18,10387569884
6207,324013860,100880,324114740,8,0,0,31232,12,4508628738
6208,324374090,89948,324464038,8,0,0,25600,12,379350982
6209,324431580,566,324432146,1,0,1,512,14,5324218686
6210,324435140,90326,324525466,7,0,0,8192,18,3626537453
6211,324503410,79748,324583158,4,0,0,12288,6,9221645286
6212,324547450,52364,324599814,3,0,0,3072,9,6059761053
6213,324622110,67148,324689258,3,0,0,11264,9,9294528142
6214,324800200,105404,324905604,3,0,0,46080,9,1524788008
6215,324816959,129253,324946212,0,0,0,58368,10,1983195357
6216,324898130,112246,325010376,8,0,0,44032,12,2099297848
6217,324935339,143875,325079214,0,0,0,41984,10,5132030226
6218,325024210,3645,325027855,8,0,1,10240,12,7893127696
6219,325032320,3422,325035742,9,0,1,3584,10,2407286321
6220,325063309,15920,325079229,3,0,1,4608,9,8777035339
6221,325084699,62516,325147215,0,0,0,6144,10,1217237450
6222,325263091,13512,325276603,6,0,1,26112,9,4589822929
6223,325360730,6488,325367218,1,0,1,15872,14,9155346663
6224,325365119,3624,325368743,3,0,1,9216,9,6789479535
6225,325368570,45596,325414166,8,0,0,1024,12,7168221246
6226,325447790,3904,325451694,0,0,1,10752,10,9356474112
6227,325478310,97136,325575446,3,0,0,18944,9,5709618393
6228,325533439,1518,325534957,3,0,1,1536,9,9909844974
6229,325539240,119996,325659236,4,0,0,60928,6,8268757705
6230,325561670,3904,325565574,4,0,1,10752,6,8566857182
6231,325611309,104156,325715465,0,0,0,41984,10,4405228903
6232,325657970,8488,325666458,4,0,1,7680,6,1574224198
6233,325764720,92528,325857248,7,0,0,18944,18,8793858943
6234,325817450,79748,325897198,4,0,0,12288,6,2099387837
6235,325848459,2470,325850929,3,0,1,2560,9,6282850716
6236,325858119,170767,326028886,0,0,0,512,10,10049951633
6237,325924890,74360,325999250,7,0,0,9728,18,5424381513
6238,325935830,133893,326069723,6,0,0,82944,9,1673455428
6239,325937340,4162,325941502,0,0,1,11264,10,1904449983
6240,325985090,94568,326079658,7,0,0,3584,18,8179698966
6241,325989900,112384,326102284,4,0,0,6144,6,371544378
6242,326011719,4850,326016569,3,0,1,5120,9,6148356810
6243,326104160,98696,326202856,3,0,0,24064,9,753837969
6244,326185240,79592,326264832,4,0,0,11776,6,9768324774
6245,326208810,134841,326343651,7,0,1,219136,18,8822441497
6246,326221150,322906,326544056,8,0,0,33792,12,9785224827
6247,326228619,192686,326421305,0,0,0,9728,10,7746934114
6248,326239600,294145,326533745,6,0,0,44032,9,8040883333
6249,326267900,110195,326378095,8,0,0,9728,12,342262961
6250,326403860,62891,326466751,3,0,0,1024,9,5328044483
6251,326540290,8132,326548422,4,0,1,4608,6,1611992901
6252,326579070,13512,326592582,1,0,1,26112,14,5954313887
6253,326609691,13858,326623549,2,0,1,23552,4,5924352087
6254,326646750,123068,326769818,3,0,0,12800,9,3944836164
6255,326656370,52364,326708734,7,0,0,3072,18,9071330699
6256,326701330,5196,326706526,0,0,1,13312,10,2805239660
6257,326823930,566,326824496,1,0,1,512,14,7338543328
6258,326857530,1994,326859524,0,0,1,2048,10,4130352079
6259,326933200,107900,327041100,8,0,0,54272,12,4017414458
6260,326977999,101903,327079902,0,0,0,34304,10,5206524427
6261,327001650,147159,327148809,8,0,0,32768,12,4158974475
6262,327107770,103220,327210990,4,0,0,38912,6,10199628771
6263,327275120,566,327275686,8,0,1,512,12,6307083134
6264,327332370,91016,327423386,4,0,0,24064,6,2396419332
6265,327404139,77168,327481307,0,0,0,18944,10,8456708618
6266,327411400,91280,327502680,4,0,0,14848,6,7928669245
6267,327442620,43904,327486524,8,0,0,512,12,8839967881
6268,327474499,65900,327540399,0,0,0,7168,10,2509339234
6269,327498390,4848,327503238,0,0,1,512,10,1974253181
6270,327504990,7706,327512696,0,0,1,8192,10,6661892324
6271,327722239,114140,327836379,0,0,0,74752,10,9432004535
6272,327786579,3645,327790224,3,0,1,10240,9,1959469562
6273,327965620,99008,328064628,4,0,0,25088,6,6169727027
6274,327979211,4850,327984061,2,0,1,5120,4,1147156448
6275,328029071,1518,328030589,6,0,1,1536,9,4189838215
6276,328044561,6229,328050790,2,0,1,15360,4,10674792724
6277,328106910,10757,328117667,1,0,1,17408,14,9336886753
6278,328413631,3422,328417053,6,0,1,3584,9,587209597
6279,328431090,3898,328434988,0,0,1,4096,10,4036840921
6280,328576189,1042,328577231,3,0,1,1024,9,5189216973
6281,328795059,98696,328893755,0,0,0,24064,10,3097972434
6282,329017290,62516,329079806,7,0,0,6144,18,2581246927
6283,329039170,45596,329084766,6,0,0,1024,9,2923014224
6284,329068890,4374,329073264,1,0,1,4608,14,6442673375
6285,329087010,2470,329089480,9,0,1,2560,10,2069384636
6286,329119640,3422,329123062,4,0,1,3584,6,507673071
6287,329255830,101972,329357802,6,0,0,34816,9,6418130725
6288,329308030,54226,329362256,3,0,0,3584,9,6750472072
6289,329328510,48980,329377490,8,0,0,2048,12,10232509875
6290,329339870,3387,329343257,9,0,1,9728,10,1977915578
6291,329571130,3904,329575034,9,0,1,10752,10,7690400049
6292,329688081,4374,329692455,2,0,1,4608,4,5672462437
6293,329693300,110142,329803442,8,0,0,22528,12,6599862521
6294,329711630,124890,329836520,3,0,0,59392,9,1394290569
6295,329717370,100568,329817938,6,0,0,30208,9,8606608175
6296,329871320,121616,329992936,7,0,1,196608,18,10247567619
6297,329926751,70691,329997442,6,0,1,7168,9,2146638264
6298,329939539,204502,330144041,0,0,0,8704,10,575264955
6299,330137080,252226,330389306,7,0,0,36864,18,8802683068
6300,330210590,77768,330288358,7,0,0,15872,18,9575403921
6301,330255990,78392,330334382,6,0,0,17920,9,4692075727
6302,330311070,2870,330313940,0,0,1,8704,10,4634577668
6303,330414390,3904,330418294,4,0,1,10752,6,607403752
6304,330424679,1518,330426197,3,0,1,1536,9,3731953179
6305,330451850,113984,330565834,4,0,0,74240,6,10468783804
6306,330509560,123810,330633370,4,0,0,16384,6,1559763716
6307,330583370,43904,330627274,7,0,0,512,18,7928640937
6308,330626070,105560,330731630,3,0,0,46592,9,1511072541
6309,330821920,73160,330895080,2,0,0,15872,4,6666012108
6310,330883460,69284,330952744,7,0,0,8192,18,1540208875
6311,330905730,2946,330908676,1,0,1,3072,14,3745094111
6312,330934580,101816,331036396,2,0,0,34304,4,2119403842
6313,330935900,67592,331003492,3,0,0,7680,9,9344589863
6314,330977750,105092,331082842,4,0,0,45056,6,4809014711
6315,330983040,104824,331087864,4,0,0,4096,6,4709592074
6316,330990540,96061,331086601,3,0,0,12288,9,2358703775
6317,331136239,43904,331180143,0,0,0,512,10,7652828963
6318,331145950,102284,331248234,3,0,0,35840,9,9077344147
6319,331261930,54056,331315986,3,0,0,3584,9,118929696
6320,331398760,105748,331504508,2,0,0,12800,4,194390886
6321,331402401,4679,331407080,2,0,1,12288,4,8209868122
6322,331500230,7230,331507460,9,0,1,7680,10,5721259803
6323,331562011,1042,331563053,2,0,1,1024,4,3544281549
6324,331666650,106496,331773146,3,0,0,49664,9,7144609284
6325,331751689,43904,331795593,0,0,0,512,10,6055649288
6326,331770209,101001,331871210,0,0,0,22016,10,8889178809
6327,332036190,3645,332039835,0,0,1,10240,10,4277537841
6328,332066400,117065,332183465,6,0,0,34816,9,2758014551
6329,332105600,80844,332186444,8,0,0,9728,12,1468509892
6330,332116620,5971,332122591,4,0,1,14848,6,9735095288
6331,332198880,52364,332251244,7,0,0,3072,18,779720306
6332,332231309,96046,332327355,0,0,0,1024,10,2209015812
6333,332233850,60980,332294830,3,0,0,6144,9,8454747057
6334,332290420,54056,332344476,2,0,0,3584,4,7703149860
6335,332299660,111434,332411094,2,0,0,19456,4,5857837091
6336,332302730,126697,332429427,4,0,0,36352,6,2461377504
6337,332311790,5802,332317592,8,0,1,6144,12,9571800222
6338,332325450,127750,332453200,7,0,0,51712,18,10077561734
6339,332432559,56528,332489087,0,0,0,6656,10,7182964312
6340,332508800,50741,332559541,7,0,1,81920,18,3233540866
6341,332513800,51642,332565442,8,0,1,19968,12,10274502186
6342,332532450,34298,332566748,9,0,1,2048,10,2737933990
6343,332609071,3422,332612493,6,0,1,3584,9,4675915888
6344,332685200,4162,332689362,9,0,1,11264,10,6287215628
6345,332686640,99645,332786285,4,0,0,20480,6,2016505757
6346,332699590,198648,332898238,7,0,0,40960,18,4623724620
6347,332862390,76456,332938846,2,0,0,5632,4,3987594585
6348,332938930,100256,333039186,6,0,0,29184,9,6334622205
6349,333288020,115388,333403408,4,0,0,78848,6,6351817653
6350,333383070,72694,333455764,8,0,0,3072,12,1629686540
6351,333523000,118508,333641508,8,0,0,89088,12,3260211066
6352,333595110,86790,333681900,6,0,0,7680,9,8516573088
6353,333607030,110810,333717840,4,0,0,39936,6,4861900313
6354,333636390,63348,333699738,6,0,0,4608,9,9929950839
6355,333709060,9814,333718874,4,0,1,1024,6,8356637187
6356,333767690,100412,333868102,2,0,0,29696,4,9425828071
6357,333854080,89792,333943872,5,0,0,25088,11,10419087716
6358,334076620,1042,334077662,8,0,1,1024,12,10590775765
6359,334159840,97628,334257468,8,0,0,25600,12,3814381932
6360,334229999,87073,334317072,0,0,0,12288,10,6922406831
6361,334268600,124300,334392900,8,0,0,99840,12,6958756861
6362,334329550,116568,334446118,9,0,0,54784,10,631118609
6363,334511920,64208,334576128,6,0,0,6656,9,594665891
6364,334526980,103844,334630824,6,0,0,40960,9,5158842962
6365,334549470,103728,334653198,4,0,0,22528,6,9297180201
6366,334566950,4937,334571887,0,0,1,12800,10,3009145068
6367,334635370,71780,334707150,3,0,0,16384,9,9943984972
6368,334665520,93020,334758540,3,0,0,25600,9,5000399042
6369,334691790,1518,334693308,9,0,1,1536,10,7298456627
6370,334732401,5326,334737727,2,0,1,5632,4,4569132199
6371,334794610,2470,334797080,8,0,1,2560,12,4936796786
6372,334841030,48980,334890010,4,0,0,2048,6,10409813280
6373,334874020,75015,334949035,2,0,0,1024,4,6073813874
6374,334912940,94664,335007604,6,0,0,15872,9,911893985
6375,334958090,7706,334965796,1,0,1,8192,14,10310938472
6376,334997990,1042,334999032,4,0,1,1024,6,581383368
6377,335039761,1518,335041279,2,0,1,1536,4,5315500920
6378,335125510,135084,335260594,2,0,0,78848,4,6825315399
6379,335172980,94834,335267814,9,0,0,3584,10,6863539034
6380,335231671,28938,335260609,2,0,1,6656,4,4103171412
6381,335281570,94220,335375790,6,0,0,19456,9,9054449406
6382,335320090,56963,335377053,3,0,0,4096,9,4648714338
6383,335360180,105092,335465272,4,0,0,45056,6,9517208521
6384,335398290,158104,335556394,7,0,1,261120,18,675639767
6385,335417230,345152,335762382,8,0,0,38400,12,6242944337
6386,335519879,223519,335743398,0,0,0,33792,10,6365045560
6387,335570829,267633,335838462,0,0,0,15872,10,1245540562
6388,335668790,113408,335782198,8,0,0,19456,12,5132173546
6389,335691080,121738,335812818,4,0,0,17408,6,8868949471
6390,335736301,83935,335820236,5,0,1,129536,11,156543854
6391,335862650,103064,335965714,3,0,0,38400,9,13756757
6392,335885870,45596,335931466,6,0,0,1024,9,8491323853
6393,335914779,85160,335999939,0,0,0,19968,10,8505688548
6394,336077080,70656,336147736,8,0,0,13312,12,1892154131
6395,336081500,54056,336135556,9,0,0,3584,10,3953391056
6396,336133730,103220,336236950,6,0,0,38912,9,10186051217
6397,336181460,566,336182026,8,0,1,512,12,10485930305
6398,336193550,69284,336262834,4,0,0,8192,6,8104245889
6399,336205530,5196,336210726,0,0,1,13312,10,5060595950
6400,336211929,69308,336281237,0,0,0,13312,10,465189429
6401,336221730,135624,336357354,4,0,0,85504,6,662130260
6402,336237450,4374,336241824,4,0,1,4608,6,7244158177
6403,336244700,4850,336249550,4,0,1,5120,6,2395238558
6404,336290320,68684,336359004,6,0,0,4096,9,4792409242
6405,336376300,96980,336473280,8,0,0,18432,12,4370819356
6406,336403040,144982,336548022,6,0,0,30720,9,8544480565
6407,336477551,10499,336488050,2,0,1,16896,4,5297778341
6408,336493720,70352,336564072,2,0,0,6656,4,7995729251
6409,336543459,48459,336591918,0,0,0,512,10,7337928517
6410,336557200,62228,336619428,4,0,0,4608,6,4909450594
6411,336726630,47288,336773918,6,0,0,1536,9,9693029109
6412,336791080,53144,336844224,6,0,0,5632,9,10009802006
6413,336808030,3422,336811452,8,0,1,3584,12,3816594087
6414,336820210,61438,336881648,7,0,0,2560,18,9917116417
6415,336918620,116480,337035100,6,0,0,82432,9,4381304222
6416,336930620,126614,337057234,2,0,0,12800,4,4699834355
6417,337014820,22266,337037086,8,0,1,2048,12,9192492228
6418,337042920,79642,337122562,4,0,0,8192,6,3477761347
6419,337047040,105872,337152912,3,0,0,47616,9,9547657088
6420,337110130,98384,337208514,3,0,0,23040,9,205735423
6421,337178650,113048,337291698,8,0,0,71168,12,2221685071
6422,337195870,12659,337208529,9,0,1,20480,10,9937212113
6423,337229370,121026,337350396,3,0,0,35840,9,62937749
6424,337261130,100627,337361757,6,0,0,14336,9,326768351
6425,337318510,3898,337322408,4,0,1,4096,6,4228396999
6426,337324500,77823,337402323,8,0,0,10240,12,8389636695
6427,337338990,149269,337488259,8,0,0,24576,12,5817813978
6428,337505570,86384,337591954,8,0,0,18944,12,1935435316
6429,337593040,56684,337649724,8,0,0,7168,12,7179803637
6430,337762359,5326,337767685,3,0,1,5632,9,9083516498
6431,337821090,132816,337953906,2,0,0,12800,4,5220303858
6432,337943270,68372,338011642,2,0,0,10240,4,5216001615
6433,338031780,86828,338118608,7,0,0,15360,18,8922852578
6434,338215580,66080,338281660,4,0,0,12800,6,5288789169
6435,338228760,111214,338339974,3,0,0,26624,9,9507525061
6436,338237209,47288,338284497,0,0,0,1536,10,5263072568
6437,338377620,107432,338485052,9,0,0,52736,10,8807246574
6438,338491629,57596,338549225,0,0,0,5120,10,1477865079
6439,338496790,108056,338604846,4,0,0,54784,6,10212291517
6440,338565420,98540,338663960,8,0,0,23552,12,166366994
6441,338621749,76928,338698677,0,0,0,3072,10,5429496121
6442,338638870,3128,338641998,8,0,1,9216,12,6809788716
6443,338660310,50930,338711240,3,0,0,1536,9,1003419082
6444,338715330,76676,338792006,9,0,0,12288,10,3032900747
6445,338715830,4374,338720204,1,0,1,4608,14,6715037867
6446,338772130,114937,338887067,6,0,0,13824,9,1882466699
6447,338828190,100568,338928758,3,0,0,30208,9,6117563597
6448,338946350,69284,339015634,4,0,0,8192,6,9749739910
6449,338971490,119690,339091180,4,0,0,28160,6,8297149034
6450,339011390,107432,339118822,7,0,0,52736,18,10519066354
6451,339133590,84692,339218282,2,0,0,18432,4,2328025223
6452,339143509,64208,339207717,0,0,0,6656,10,2365134161
6453,339188910,74360,339263270,7,0,0,9728,18,6488986179
6454,339213690,70816,339284506,1,0,0,1536,14,6336421270
6455,339232610,107922,339340532,6,0,0,35328,9,5014857276
6456,339251180,12105,339263285,8,0,1,19968,12,8335631563
6457,339321940,103220,339425160,8,0,0,38912,12,1294258693
6458,339328110,127998,339456108,2,0,0,54784,4,2318678588
6459,339383210,136776,339519986,2,0,0,30208,4,7694299976
6460,339393610,1518,339395128,8,0,1,1536,12,6111266012
6461,339398050,129464,339527514,6,0,0,10752,9,1102913864
6462,339558500,97448,339655948,5,0,0,19968,11,6336908123
6463,339613230,102469,339715699,4,0,0,35328,6,7830335258
6464,339641931,2470,339644401,5,0,1,2560,11,1318189042
6465,339651750,53170,339704920,8,0,0,2048,12,9649873123
6466,339684060,60824,339744884,8,0,0,5632,12,5732086631
6467,339726350,88832,339815182,4,0,0,16896,6,3491914777
6468,339778180,69284,339847464,6,0,0,8192,9,3795189130
6469,339789810,65456,339855266,4,0,0,10752,6,6683384565
6470,339838480,110396,339948876,4,0,0,62464,6,3293790825
6471,339864230,363753,340227983,8,0,0,30720,12,8272554217
6472,339873639,1994,339875633,3,0,1,2048,9,646277857
6473,339884550,5971,339890521,9,0,1,14848,10,7721916786
6474,339916750,218767,340135517,7,0,0,71168,18,4387342976
6475,339919540,6754,339926294,4,0,1,7168,6,7224483848
6476,339938250,42401,339980651,7,0,1,51712,18,1995340839
6477,340069699,110692,340180391,0,0,0,35840,10,5278452943
6478,340103100,43904,340147004,7,0,0,512,18,8692418977
6479,340113770,151787,340265557,9,0,0,30208,10,2149719738
6480,340132190,155835,340288025,8,0,0,19968,12,2362491892
6481,340244990,89012,340334002,8,0,0,22528,12,7992431818
6482,340254230,80099,340334329,8,0,0,1024,12,3529190203
6483,340406120,99788,340505908,7,0,0,27648,18,8809559854
6484,340488189,97604,340585793,0,0,0,20480,10,9559287226
6485,340562590,45596,340608186,4,0,0,1024,6,4405322928
6486,340591920,109772,340701692,8,0,0,60416,12,5826840454
6487,340652259,134189,340786448,0,0,0,38912,10,8299950606
6488,340691551,132007,340823558,5,0,1,197120,11,1105241447
6489,340808309,122262,340930571,0,0,0,55296,10,4515706362
6490,340810650,120092,340930742,6,0,0,512,9,10036654588
6491,340817479,287558,341105037,0,0,0,65024,10,6493457590
6492,340824780,178763,341003543,8,0,0,10240,12,6969196765
6493,340830430,4420,340834850,0,0,1,11776,10,2207285640
6494,340855381,2946,340858327,5,0,1,3072,11,4988962309
6495,340907460,177750,341085210,8,0,0,71168,12,5309776987
6496,340922050,192061,341114111,7,0,0,23040,18,4861626264
6497,341120580,99320,341219900,9,0,0,26112,10,6367869359
6498,341204120,106152,341310272,7,0,0,23040,18,1075746107
6499,341263630,101192,341364822,4,0,0,32256,6,4066458454
6500,341335639,72224,341407863,0,0,0,12800,10,2997508046
6501,341368711,3128,341371839,6,0,1,9216,9,10162781499
6502,341418710,78836,341497546,3,0,0,14336,9,5859299305
6503,341566590,94532,341661122,4,0,0,20480,6,6227071967
6504,341612950,60824,341673774,3,0,0,5632,9,8458834879
6505,341728071,1518,341729589,6,0,1,1536,9,749692035
6506,341787390,97916,341885306,2,0,0,21504,4,5736456180
6507,341819300,141528,341960828,8,0,0,36352,12,838873044
6508,341915380,100568,342015948,7,0,0,30208,18,2687832234
6509,341929649,2870,341932519,3,0,1,8704,9,6621369751
6510,341950630,85198,342035828,7,0,0,16896,18,8137701901
6511,342104900,105872,342210772,7,0,0,47616,18,8391856774
6512,342158040,96824,342254864,4,0,0,17920,6,7910895386
6513,342319580,45596,342365176,7,0,0,1024,18,6633485629
6514,342359220,109616,342468836,6,0,0,59904,9,194299934
6515,342496800,73472,342570272,3,0,0,16896,9,2663942254
6516,342519930,80732,342600662,8,0,0,4608,12,9480526365
6517,342634420,82064,342716484,8,0,0,14848,12,2579463385
6518,342742100,102440,342844540,8,0,0,36352,12,9308508188
6519,342854880,116516,342971396,7,0,0,77824,18,10461363875
6520,342876630,115496,342992126,6,0,0,48640,9,3939591992
6521,342887681,3422,342891103,5,0,1,3584,11,1079556994
6522,342924530,90846,343015376,7,0,0,8192,18,1649742670
6523,342981940,92578,343074518,9,0,0,20992,10,10438904168
6524,342989310,5779,342995089,9,0,1,3072,10,9567484421
6525,343027620,2470,343030090,1,0,1,2560,14,3287311178
6526,343032610,90466,343123076,9,0,0,17920,10,1637138766
6527,343041900,126710,343168610,5,0,0,25088,11,3674132463
6528,343064020,83176,343147196,3,0,0,4096,9,8115833384
6529,343083749,6754,343090503,3,0,1,7168,9,5970790881
6530,343203490,58844,343262334,6,0,0,3072,9,8730813947
6531,343217650,133802,343351452,6,0,0,67584,9,5515789250
6532,343280190,107916,343388106,6,0,0,15360,9,1712816086
6533,343293539,106594,343400133,0,0,0,39424,10,3214348078
6534,343312700,12566,343325266,9,0,1,20992,10,7888066489
6535,343420119,1994,343422113,3,0,1,2048,9,3083902313
6536,343435270,116324,343551594,7,0,0,81920,18,4401454064
6537,343463030,137146,343600176,4,0,0,18432,6,9341308694
6538,343530600,25360,343555960,0,0,1,4608,10,409948567
6539,343553569,121217,343674786,0,0,0,35328,10,7833500668
6540,343589690,188949,343778639,9,0,0,95744,10,5225583056
6541,343656560,163743,343820303,6,0,0,71168,9,1954129055
6542,343737510,188375,343925885,3,0,0,20992,9,936387500
6543,343750820,126687,343877507,4,0,0,29696,6,10464800896
6544,343754550,71213,343825763,3,0,0,1024,9,9964460764
6545,343822740,115721,343938461,3,0,0,16896,9,5871508861
6546,343976030,7706,343983736,8,0,1,8192,12,4141719600
6547,344222490,55748,344278238,2,0,0,4096,4,8097741254
6548,344267040,99788,344366828,3,0,0,27648,9,8364199451
6549,344300260,5802,344306062,1,0,1,6144,14,6887602959
6550,344329330,14287,344343617,9,0,1,27648,10,821483337
6551,344352960,1518,344354478,0,0,1,1536,10,7144862394
6552,344465100,54056,344519156,3,0,0,3584,9,5888576134
6553,344518300,61672,344579972,1,0,0,5632,14,5120420945
6554,344556790,2470,344559260,4,0,1,2560,6,4565738748
6555,344557250,97817,344655067,2,0,0,19968,4,4850606781
6556,344640200,92996,344733196,8,0,0,20480,12,9022855377
6557,344651140,106983,344758123,4,0,0,38400,6,1519471225
6558,344652980,120410,344773390,3,0,0,35328,9,9769723122
6559,344770200,82618,344852818,6,0,0,11264,9,10670716896
6560,344795190,76270,344871460,5,0,0,15872,11,573306260
6561,344824940,102800,344927740,6,0,0,29184,9,2363723231
6562,344830450,110394,344940844,3,0,0,6656,9,9456805855
6563,344910899,99008,345009907,0,0,0,25088,10,6091431421
6564,345041620,1518,345043138,9,0,1,1536,10,6069621101
6565,345153031,3898,345156929,5,0,1,4096,11,3208142387
6566,345187900,3422,345191322,9,0,1,3584,10,1321345592
6567,345263060,59132,345322192,8,0,0,5120,12,8659464334
6568,345292690,106964,345399654,4,0,0,51200,6,1557009361
6569,345328710,128310,345457020,7,0,0,26624,18,9854151909
6570,345332720,4162,345336882,0,0,1,11264,10,8543644143
6571,345335560,68672,345404232,5,0,0,4608,11,115137314
6572,345347790,22174,345369964,7,0,1,36352,18,7119525541
6573,345385700,18547,345404247,9,0,1,11776,10,10575070627
6574,345436810,1994,345438804,4,0,1,2048,6,4665892652
6575,345497840,50672,345548512,5,0,0,2560,11,8711302804
6576,345512390,105560,345617950,1,0,0,46592,14,2415427635
6577,345539600,134742,345674342,3,0,0,59392,9,6921490340
6578,345577821,2870,345580691,6,0,1,8704,9,2083564564
6579,345673499,7113,345680612,3,0,1,6656,9,6722601658
6580,345747810,100100,345847910,9,0,0,28672,10,5445931279
6581,345790780,69869,345860649,6,0,0,1536,9,6477496202
6582,345791021,3898,345794919,5,0,1,4096,11,8957482043
6583,345839900,70518,345910418,1,0,0,6144,14,536046084
6584,345907910,106452,346014362,8,0,0,47616,12,2728025919
6585,345951490,192258,346143748,2,0,0,52224,4,4920474478
6586,345967010,101660,346068670,7,0,0,33792,18,2617523355
6587,346002561,16167,346018728,6,0,1,4608,9,2832992388
6588,346071709,4679,346076388,3,0,1,12288,9,1993868296
6589,346107400,12308,346119708,1,0,1,20480,14,6393292975
6590,346121289,70683,346191972,0,0,0,4608,10,6911135852
6591,346121590,101348,346222938,1,0,0,32768,14,7023792115
6592,346123691,20072,346143763,2,0,1,11776,4,3566158342
6593,346160301,3387,346163688,2,0,1,9728,4,9147695009
6594,346233449,105145,346338594,0,0,0,6656,10,3766107283
6595,346242680,83939,346326619,4,0,0,3072,6,9050731899
6596,346370990,76208,346447198,4,0,0,10752,6,673323423
6597,346377370,151302,346528672,5,0,0,50176,11,3195116127
6598,346447040,97142,346544182,9,0,0,9216,10,9810692023
6599,346518360,54208,346572568,1,0,0,512,14,3672719519
6600,346524170,115071,346639241,1,0,0,62976,14,3486271460
6601,346572350,69558,346641908,4,0,0,8704,6,5348387186
6602,346579750,1994,346581744,1,0,1,2048,14,5165880426
6603,346729150,72668,346801818,2,0,0,9216,4,9399928198
6604,346753200,81128,346834328,3,0,0,11776,9,2975615814
6605,346780790,92060,346872850,4,0,0,17408,6,8347380063
6606,346914780,108836,347023616,6,0,0,57344,9,4149463265
6607,346957060,159175,347116235,2,0,0,42496,4,8958114997
6608,346959910,143362,347103272,7,0,0,29184,18,2565978911
6609,346964740,160276,347125016,5,0,0,14848,11,6417174545
6610,347006940,186026,347192966,2,0,0,19968,4,3968295201
6611,347026070,7230,347033300,0,0,1,7680,10,3033299830
6612,347066540,58803,347125343,2,0,0,1024,4,8940945538
6613,347104450,193396,347297846,7,0,0,64512,18,28696601
6614,347131450,141736,347273186,8,0,0,13824,12,1463935910
6615,347176050,83999,347260049,3,0,0,9728,9,2019078982
6616,347280390,20576,347300966,4,0,1,9216,6,2335079058
6617,347339860,55748,347395608,6,0,0,4096,9,3339979178
6618,347352090,116832,347468922,2,0,0,72192,4,840754216
6619,347405780,191238,347597018,2,0,0,43008,4,5588984574
6620,347418160,127210,347545370,7,0,0,34816,18,9815471874
6621,347615190,65900,347681090,1,0,0,7168,14,3992552368
6622,347654930,93152,347748082,7,0,0,20992,18,7497941297
6623,347722200,47288,347769488,2,0,0,1536,4,4943802383
6624,347780780,92864,347873644,6,0,0,25088,9,806523243
6625,347812910,84512,347897422,6,0,0,12800,9,4455621154
6626,347842580,82820,347925400,8,0,0,12288,12,3012549856
6627,347875680,81562,347957242,2,0,0,14848,4,3578319352
6628,347901989,154979,348056968,0,0,0,114176,10,9788169281
6629,348007750,108992,348116742,4,0,0,57856,6,7348173047
6630,348027560,131684,348159244,5,0,0,35840,11,5596899779
6631,348067930,2870,348070800,9,0,1,8704,10,8036714433
6632,348069270,131668,348200938,1,0,0,10240,14,2174966252
6633,348223510,103064,348326574,9,0,0,38400,10,10688811210
6634,348254370,2946,348257316,7,0,1,3072,18,156733858
6635,348283040,140215,348423255,7,0,0,60416,18,10665200363
6636,348380240,106237,348486477,2,0,0,39936,4,5190074851
6637,348386611,2870,348389481,6,0,1,8704,9,10113351875
6638,348410860,18665,348429525,0,0,1,6656,10,1711315961
6639,348534950,104468,348639418,4,0,0,43008,6,197380875
6640,348573799,119115,348692914,0,0,0,19456,10,4499803339
6641,348615590,57440,348673030,8,0,0,4608,12,10291444329
6642,348663390,87898,348751288,7,0,0,13312,18,6577134051
6643,348676820,52320,348729140,2,0,0,512,4,8758874395
6644,348716800,4374,348721174,8,0,1,4608,12,3622801379
6645,348798410,96536,348894946,4,0,0,22016,6,9176598493
6646,348807200,66080,348873280,7,0,0,12800,18,9847494543
6647,348809360,116162,348925522,9,0,0,56832,10,7029839864
6648,348830711,5802,348836513,6,0,1,6144,9,591900529
6649,348941521,7230,348948751,2,0,1,7680,4,4780892894
6650,349044940,102596,349147536,5,0,0,36864,11,9127703328
6651,349141160,7410,349148570,1,0,1,1024,14,9883082098
6652,349208040,6278,349214318,0,0,1,6656,10,8438033370
6653,349213190,4850,349218040,0,0,1,5120,10,7886802398
6654,349262600,206606,349469206,8,0,0,114176,12,4607484108
6655,349263960,125380,349389340,6,0,0,10240,9,9518060674
6656,349280300,4162,349284462,9,0,1,11264,10,7577913105
6657,349282760,143030,349425790,4,0,0,12800,6,9514056338
6658,349304010,170359,349474369,2,0,0,16896,4,963257462
6659,349304620,181167,349485787,7,0,0,16896,18,3322301005
6660,349383100,97524,349480624,6,0,0,20480,9,1874503176
6661,349410640,1994,349412634,8,0,1,2048,12,7290144710
6662,349425900,4374,349430274,9,0,1,4608,10,4851387841
6663,349431490,244537,349676027,1,0,0,119296,14,3896940821
6664,349569619,4374,349573993,3,0,1,4608,9,1158746878
6665,349618730,162290,349781020,2,0,0,29696,4,8137435901
6666,349625560,99320,349724880,6,0,0,26112,9,7435193722
6667,349636030,89645,349725675,3,0,0,2560,9,6666841523
6668,349697240,139298,349836538,4,0,0,4096,6,1142952708
6669,349708180,152532,349860712,5,0,0,55296,11,4717896612
6670,349752500,89513,349842013,4,0,0,17920,6,6271332469
6671,349778720,101240,349879960,6,0,0,19456,9,4925993548
6672,349798910,109016,349907926,7,0,0,14336,18,3136253365
6673,349813221,2946,349816167,2,0,1,3072,4,9615792483
6674,349846860,87628,349934488,2,0,0,4608,4,3301225148
6675,349972570,87527,350060097,5,0,0,16896,11,3426054252
6676,350039640,198392,350238032,9,0,0,189952,10,2944946846
6677,350089300,290892,350380192,2,0,0,62464,4,985614569
6678,350114390,126949,350241339,7,0,0,10752,18,8253514651
6679,350123460,197732,350321192,9,0,0,57344,10,9784155785
6680,350131350,197306,350328656,3,0,0,11264,9,5841439382
6681,350133930,166192,350300122,2,0,0,27648,4,9699203871
6682,350163470,101660,350265130,2,0,0,33792,4,4848547575
6683,350185089,201061,350386150,0,0,0,14848,10,236466350
6684,350189040,192571,350381611,4,0,0,4608,6,8076372091
6685,350305740,123482,350429222,2,0,0,27648,4,2666939296
6686,350379130,19766,350398896,1,0,1,24576,14,9693198059
6687,350384649,15233,350399882,3,0,1,1536,9,4849688600
6688,350399450,85822,350485272,7,0,0,9728,18,1485780057
6689,350499500,45596,350545096,3,0,0,1024,9,962842040
6690,350506040,52364,350558404,1,0,0,3072,14,3286091241
6691,350602950,102752,350705702,1,0,0,37376,14,2268197876
6692,350676810,72668,350749478,8,0,0,9216,12,3730804832
6693,350724830,5802,350730632,4,0,1,6144,6,4735715651
6694,350770750,68840,350839590,6,0,0,11776,9,6297493397
6695,350876020,3898,350879918,8,0,1,4096,12,10120516647
6696,350901660,60824,350962484,9,0,0,5632,10,3980726417
6697,350936550,109108,351045658,7,0,0,1024,18,1734143753
6698,350939621,22878,350962499,5,0,1,35840,11,9052579925
6699,350946790,17653,350964443,9,0,1,4608,10,2309741752
6700,350978020,110685,351088705,3,0,0,9216,9,7576056943
6701,350980530,105352,351085882,1,0,0,14848,14,821189945
6702,350984080,1042,350985122,9,0,1,1024,10,2408469708
6703,350988850,103878,351092728,7,0,0,8192,18,6973697287
6704,351048381,3422,351051803,5,0,1,3584,11,3077385220
6705,351123820,86081,351209901,4,0,0,23040,6,10623767877
6706,351181600,100412,351282012,9,0,0,29696,10,6719213100
6707,351206220,10427,351216647,0,0,1,7168,10,9171846038
6708,351248709,63608,351312317,0,0,0,9728,10,10145215732
6709,351258601,1994,351260595,2,0,1,2048,4,6580405115
6710,351344200,55748,351399948,4,0,0,4096,6,5794760884
6711,351360230,1994,351362224,9,0,1,2048,10,7516332228
6712,351526210,3904,351530114,4,0,1,10752,6,8955502215
6713,351643420,97360,351740780,3,0,0,29696,9,3617547427
6714,351663460,127408,351790868,2,0,0,32768,4,2405003197
6715,351765770,86408,351852178,6,0,0,24064,9,3612752295
6716,351777790,13093,351790883,1,0,1,9216,14,6266996085
6717,351788650,148278,351936928,2,0,0,74240,4,10558254215
6718,351902330,2470,351904800,7,0,1,2560,18,7140165742
6719,351923900,109731,352033631,1,0,0,24576,14,8789203333
6720,351948060,4420,351952480,0,0,1,11776,10,2386628723
6721,351967560,74228,352041788,1,0,0,14336,14,9253399594
6722,352004129,3128,352007257,3,0,1,9216,9,7640452270
6723,352069981,7706,352077687,2,0,1,8192,4,7870550623
6724,352076850,87029,352163879,5,0,0,12800,11,10018750401
6725,352099740,60224,352159964,1,0,0,8704,14,9111307314
6726,352137950,48980,352186930,7,0,0,2048,18,6470298385
6727,352197969,1518,352199487,3,0,1,1536,9,4848380300
6728,352205780,118508,352324288,2,0,0,89088,4,3466786761
6729,352248040,80976,352329016,3,0,0,1536,9,3858266772
6730,352276839,97597,352374436,0,0,0,24576,10,8377888258
6731,352318760,6562,352325322,1,0,1,1024,14,2574798901
6732,352330350,97990,352428340,1,0,0,7680,14,6238523656
6733,352375521,10499,352386020,2,0,1,16896,4,8331160932
6734,352407380,99828,352507208,9,0,0,12288,10,369321042
6735,352408480,50672,352459152,1,0,0,2560,14,321028885
6736,352428010,3967,352431977,7,0,1,10240,18,6474476966
6737,352443739,98072,352541811,0,0,0,22016,10,4514094779
6738,352526660,59132,352585792,2,0,0,5120,4,19547529
6739,352546230,118540,352664770,9,0,0,36352,10,8517272946
6740,352645150,108992,352754142,8,0,0,57856,12,2108023886
6741,352719460,83468,352802928,6,0,0,19456,9,9245228421
6742,352728990,64388,352793378,1,0,0,12288,14,8379309072
6743,352748060,117124,352865184,5,0,0,14848,11,7888192790
6744,352776910,107444,352884354,6,0,0,1024,9,8799012911
6745,352927740,105404,353033144,8,0,0,46080,12,6224443406
6746,352933760,146508,353080268,8,0,0,39424,12,2442035459
6747,352967321,2946,352970267,6,0,1,3072,9,1002096199
6748,353013080,132156,353145236,5,0,0,23552,11,1386896406
6749,353083300,12049,353095349,1,0,1,19968,14,2457614661
6750,353094830,12995,353107825,0,0,1,25088,10,8721103794
6751,353227220,2946,353230166,7,0,1,3072,18,9705228796
6752,353264430,65900,353330330,1,0,0,7168,14,692931201
6753,353325740,48980,353374720,9,0,0,2048,10,6874779577
6754,353347590,97940,353445530,8,0,0,26624,12,10286254438
6755,353411420,104664,353516084,9,0,0,30208,10,7299655023
6756,353450019,11533,353461552,3,0,1,18944,9,1427367820
6757,353537690,88657,353626347,7,0,0,12800,18,9742156885
6758,353540380,3387,353543767,1,0,1,9728,14,3449476710
6759,353689680,99008,353788688,5,0,0,25088,11,6681805645
6760,353694109,101527,353795636,0,0,0,16896,10,7045541571
6761,353708340,104906,353813246,3,0,0,13824,9,650047611
6762,353717249,79962,353797211,9,0,0,5120,10,695231572
6763,353796801,3272,353800073,5,0,1,8704,11,7557243057
6764,353807959,215633,354023592,0,0,0,44544,10,32905600
6765,353831610,104576,353936186,3,0,0,4096,9,2829513289
6766,353959390,129218,354088608,4,0,0,38912,6,5741654786
6767,353993020,122181,354115201,5,0,0,16896,11,8299995476
6768,353996150,107680,354103830,5,0,0,2048,11,9685663281
6769,354005490,110506,354115996,1,0,0,2560,14,1292812647
6770,354017920,6706,354024626,7,0,1,1024,18,837473118
6771,354026499,5802,354032301,3,0,1,6144,9,4927513974
6772,354030810,139530,354170340,1,0,0,27648,14,1474307282
6773,354102269,150613,354252882,9,0,0,65536,10,9622277024
6774,354247620,110814,354358434,6,0,0,46592,9,4046615717
6775,354274879,170489,354445368,0,0,0,103936,10,3511394150
6776,354285270,100854,354386124,4,0,0,15360,6,6950615316
6777,354337560,194415,354531975,5,0,0,82944,11,1045204312
6778,354365670,104985,354470655,8,0,0,43008,12,8246339393
6779,354376399,164186,354540585,0,0,0,15360,10,6227724323
6780,354387110,148780,354535890,8,0,0,12800,12,333959582
6781,354399000,6229,354405229,9,0,1,15360,10,10278705667
6782,354441530,103282,354544812,8,0,0,13824,12,2461814230
6783,354443580,137757,354581337,6,0,0,22016,9,980036436
6784,354444630,115416,354560046,1,0,0,3072,14,4263041719
6785,354479041,3422,354482463,2,0,1,3584,4,6872225224
6786,354480721,4008,354484729,5,0,1,3584,11,10556781592
6787,354494650,95013,354589663,4,0,0,18432,6,2389329103
6788,354551279,1042,354552321,3,0,1,1024,9,7534393065
6789,354578390,114069,354692459,8,0,0,57856,12,5131597209
6790,354725680,100412,354826092,4,0,0,29696,6,3276241654
6791,354789920,5326,354795246,9,0,1,5632,10,8181716534
6792,354836669,72700,354909369,9,0,0,16384,10,10065674315
6793,354857899,131384,354989283,0,0,0,50688,10,1177230128
6794,354904269,89553,354993822,0,0,0,14848,10,7943268773
6795,354909130,87515,354996645,1,0,0,9216,14,249436346
6796,354918821,14029,354932850,6,0,1,27136,9,7900354374
6797,354951220,89347,355040567,4,0,0,10240,6,5144550042
6798,354964090,122248,355086338,6,0,0,27136,9,8290394938
6799,355018739,106577,355125316,9,0,0,45056,10,9908818055
6800,355080429,152887,355233316,0,0,0,99840,10,1261813782
6801,355145380,183156,355328536,3,0,0,16896,9,1241103187
6802,355171840,108474,355280314,5,0,0,26112,11,1642561359
6803,355205179,82653,355287832,0,0,0,5120,10,570015705
6804,355358990,97916,355456906,3,0,0,21504,9,4696652534
6805,355473660,61448,355535108,1,0,0,7680,14,5932501498
6806,355482231,6278,355488509,2,0,1,6656,4,4641843169
6807,355569529,104156,355673685,9,0,0,41984,10,1973983595
6808,355578670,55748,355634418,6,0,0,4096,9,1715144242
6809,355602750,102369,355705119,8,0,0,23040,12,2412308401
6810,355653039,90773,355743812,9,0,0,10752,10,805938126
6811,355709590,101660,355811250,3,0,0,33792,9,9928593748
6812,355743560,72912,355816472,1,0,0,9216,14,8166439494
6813,355754520,4162,355758682,4,0,1,11264,6,2860263832
6814,355766000,163986,355929986,8,0,0,1024,12,9278190779
6815,355814879,101217,355916096,0,0,0,27136,10,837920658
6816,355876651,2946,355879597,5,0,1,3072,11,4803513325
6817,355881911,6278,355888189,6,0,1,6656,9,7954620092
6818,355985080,59132,356044212,8,0,0,5120,12,2431580750
6819,355987289,1042,355988331,3,0,1,1024,9,2951308884
6820,356007650,3645,356011295,0,0,1,10240,10,906361336
6821,356033660,183302,356216962,5,0,0,512,11,8977437059
6822,356040160,60861,356101021,4,0,0,4096,6,6463808897
6823,356081750,106028,356187778,1,0,0,48128,14,4658749627
6824,356109820,155508,356265328,1,0,0,69632,14,8836671171
6825,356204439,133201,356337640,0,0,0,47616,10,1871088345
6826,356250680,90103,356340783,4,0,0,10240,6,3545203581
6827,356290120,97136,356387256,5,0,0,18944,11,10251014555
6828,356312770,62228,356374998,7,0,0,10240,18,2890792534
6829,356330540,15528,356346068,7,0,1,5632,18,9290120506
6830,356373331,5557,356378888,5,0,1,4096,11,9042289622
6831,356400310,60536,356460846,4,0,0,9728,6,8286944915
6832,356431561,7706,356439267,5,0,1,8192,11,9964515409
6833,356448590,54056,356502646,7,0,0,3584,18,7366209632
6834,356542820,123123,356665943,5,0,0,23552,11,4751599675
6835,356678350,56372,356734722,7,0,0,6144,18,1304042684
6836,356698390,102440,356800830,7,0,0,36352,18,1958343454
6837,356701790,168142,356869932,4,0,0,90624,6,5918165103
6838,356704119,117783,356821902,9,0,0,9728,10,9281424425
6839,356805840,121784,356927624,6,0,0,99840,9,5790412326
6840,356883460,52364,356935824,1,0,0,3072,14,5403139509
6841,356899469,154339,357053808,9,0,0,90624,10,6202632431
6842,356940131,5802,356945933,6,0,1,6144,9,559564204
6843,357056630,1518,357058148,7,0,1,1536,18,1685794891
6844,357066569,45596,357112165,9,0,0,1024,10,4211474509
6845,357089999,106028,357196027,9,0,0,48128,10,4968962429
6846,357142671,1042,357143713,2,0,1,1024,4,465939159
6847,357150981,4374,357155355,2,0,1,4608,4,6981294084
6848,357154299,98072,357252371,9,0,0,22016,10,2851910941
6849,357265250,45596,357310846,8,0,0,1024,12,8729916436
6850,357299850,79436,357379286,8,0,0,11264,12,8043534563
6851,357350220,85604,357435824,4,0,0,16384,6,4578682213
6852,357378630,58613,357437243,8,0,0,4608,12,4461997899
6853,357457140,100100,357557240,3,0,0,28672,9,4011529196
6854,357480220,52676,357532896,1,0,0,4096,14,10615902389
6855,357540230,93932,357634162,5,0,0,23552,11,8909054699
6856,357613660,92240,357705900,6,0,0,23040,9,3215904078
6857,357670480,73004,357743484,8,0,0,15360,12,1828823859
6858,357799580,54368,357853948,6,0,0,4608,9,3057670680
6859,357810979,97604,357908583,9,0,0,20480,10,9876741723
6860,357835989,61136,357897125,0,0,0,6656,10,4564221171
6861,357873280,81521,357954801,5,0,0,9728,11,1700793190
6862,357876550,84683,357961233,7,0,0,5632,18,7166222712
6863,357905930,92881,357998811,1,0,0,21504,14,4882805635
6864,357951551,4937,357956488,2,0,1,12800,4,6296537472
6865,357951890,9358,357961248,0,0,1,13312,10,5614659861
6866,357965290,147312,358112602,6,0,0,29696,9,6256666491
6867,358011180,68608,358079788,3,0,0,1536,9,3522595332
6868,358029300,128328,358157628,3,0,0,32768,9,8362037787
6869,358056280,190934,358247214,1,0,0,98816,14,4043728014
6870,358089960,215489,358305449,6,0,0,30720,9,4166272067
6871,358114129,14029,358128158,3,0,1,27136,9,5832606024
6872,358206661,1994,358208655,5,0,1,2048,11,3019693139
6873,358321309,111352,358432661,0,0,0,24064,10,5253918053
6874,358357860,50672,358408532,3,0,0,2560,9,2995909145
6875,358402540,21916,358424456,0,0,1,35840,10,3666004036
6876,358413589,171332,358584921,9,0,0,100352,10,2736952821
6877,358492930,149105,358642035,4,0,0,54784,6,7484849177
6878,358524880,61156,358586036,3,0,0,3584,9,6509994233
6879,358573129,175147,358748276,0,0,0,43520,10,3460415859
6880,358594500,109701,358704201,1,0,0,26112,14,4904861585
6881,358606810,566,358607376,7,0,1,512,18,2260986327
6882,358675680,108992,358784672,1,0,0,57856,14,3957638339
6883,358776260,110532,358886792,6,0,0,35328,9,759937075
6884,359089410,96248,359185658,4,0,0,26112,6,3108136938
6885,359089510,6754,359096264,0,0,1,7168,10,220501401
6886,359091959,140727,359232686,9,0,0,64512,10,10351216018
6887,359138640,102067,359240707,3,0,0,4608,9,9964599455
6888,359167560,65765,359233325,4,0,0,2048,6,1390708654
6889,359175240,102740,359277980,5,0,0,20480,11,7542650370
6890,359265000,12995,359277995,1,0,1,8192,14,1175059415
6891,359322080,64208,359386288,3,0,0,6656,9,6701594213
6892,359382339,74360,359456699,9,0,0,9728,10,7414745665
6893,359383419,101348,359484767,9,0,0,32768,10,4045643607
6894,359443530,4937,359448467,1,0,1,12800,14,4181346856
6895,359578810,76520,359655330,1,0,0,11776,14,7708650554
6896,359582969,54056,359637025,9,0,0,3584,10,2398318507
6897,359613670,104049,359717719,5,0,0,40448,11,7591121541
6898,359624260,3387,359627647,4,0,1,9728,6,3617051198
6899,359692990,52364,359745354,5,0,0,3072,11,6333615625
6900,359844810,106808,359951618,5,0,0,50688,11,3379612261
6901,359867429,162069,360029498,0,0,0,36864,10,6719974833
6902,359872750,190343,360063093,3,0,0,8704,9,877401814
6903,359892031,12566,359904597,2,0,1,20992,4,5442180083
6904,359943580,101026,360044606,3,0,0,20480,9,10506602814
6905,360043019,4966,360047985,3,0,1,9728,9,6717701036
6906,360083031,10757,360093788,6,0,1,17408,9,3464192435
6907,360174700,1994,360176694,9,0,1,2048,10,3474673993
6908,360230449,100100,360330549,0,0,0,28672,10,3303243559
6909,360290160,1994,360292154,0,0,1,2048,10,3656222795
6910,360376630,46726,360423356,4,0,0,1024,6,748769404
6911,360377760,102128,360479888,4,0,0,35328,6,10415433455
6912,360381450,3898,360385348,0,0,1,4096,10,554985444
6913,360475789,114019,360589808,0,0,0,60928,10,205064850
6914,360556850,6488,360563338,1,0,1,15872,14,4922762949
6915,360621340,3128,360624468,7,0,1,9216,18,10629937660
6916,360725090,98072,360823162,7,0,0,22016,18,4537046260
6917,360843990,102440,360946430,4,0,0,36352,6,6709595644
6918,360895280,92372,360987652,7,0,0,18432,18,1709113145
6919,360913120,129502,361042622,6,0,0,7680,9,5823111612
6920,360928950,108680,361037630,7,0,0,56832,18,752124054
6921,360975981,1042,360977023,5,0,1,1024,11,1275880545
6922,361154750,43904,361198654,7,0,0,512,18,4028516688
6923,361245050,89588,361334638,5,0,0,14336,11,9537939966
6924,361351559,57440,361408999,9,0,0,4608,10,1334642319
6925,361417729,3904,361421633,3,0,1,10752,9,2237707619
6926,361449470,86516,361535986,1,0,0,14336,14,9154739106
6927,361543501,7230,361550731,5,0,1,7680,11,8289623408
6928,361581150,99788,361680938,6,0,0,27648,9,8696736
6929,361639640,74540,361714180,8,0,0,15360,12,3014465037
6930,361680789,81269,361762058,9,0,0,11776,10,6751763935
6931,361793400,72668,361866068,8,0,0,9216,12,290503085
6932,361816399,108836,361925235,9,0,0,57344,10,10670978612
6933,361841210,140119,361981329,6,0,0,23552,9,2539582030
6934,362041670,59756,362101426,1,0,0,7168,14,7226371769
6935,362113459,72692,362186151,0,0,0,14336,10,10275582154
6936,362124259,163538,362287797,0,0,0,130048,10,1194394308
6937,362146760,148639,362295399,1,0,0,7680,14,8050930058
6938,362179560,108735,362288295,6,0,0,1536,9,2734300412
6939,362244621,43191,362287812,5,0,1,14848,11,7752543720
6940,362244640,130673,362375313,4,0,0,41984,6,7654557284
6941,362284890,102873,362387763,3,0,0,26624,9,6316639413
6942,362368440,109617,362478057,4,0,0,37376,6,5662591977
6943,362425410,53450,362478860,1,0,0,2560,14,7342306931
6944,362468110,58919,362527029,3,0,0,2048,9,8081383939
6945,362478990,72380,362551370,6,0,0,13312,9,7534665588
6946,362565610,67592,362633202,6,0,0,7680,9,290322915
6947,362659719,3387,362663106,3,0,1,9728,9,8907478570
6948,362740910,93440,362834350,7,0,0,16896,18,5963935675
6949,362750929,45596,362796525,0,0,0,1024,10,4105258219
6950,362809881,4420,362814301,5,0,1,11776,11,2086463630
6951,362988900,97916,363086816,6,0,0,21504,9,5201885562
6952,363055369,70976,363126345,9,0,0,8704,10,3869257163
6953,363072669,2870,363075539,3,0,1,8704,9,4887524215
6954,363082790,88285,363171075,7,0,0,8192,18,7405912828
6955,363105260,127915,363233175,3,0,0,50688,9,1878303468
6956,363152920,55748,363208668,5,0,0,4096,11,525595818
6957,363224949,14496,363239445,3,0,1,6656,9,7164062427
6958,363239730,132954,363372684,1,0,0,94720,14,8456397262
6959,363298090,108862,363406952,8,0,0,20992,12,6261234972
6960,363395120,118352,363513472,7,0,0,88576,18,4686537898
6961,363400760,118184,363518944,6,0,0,10752,9,507291902
6962,363455580,128188,363583768,6,0,0,29696,9,7215244609
6963,363460080,73816,363533896,8,0,0,7168,12,898783031
6964,363541020,25704,363566724,0,0,1,46592,10,2403277509
6965,363545791,22009,363567800,2,0,1,13312,4,4066417283
6966,363581930,2396,363584326,4,0,1,512,6,6156176386
6967,363667609,74780,363742389,9,0,0,10240,10,6739981482
6968,363717930,4679,363722609,7,0,1,12288,18,7057087909
6969,363725080,151507,363876587,4,0,0,76288,6,8090526110
6970,363727769,169837,363897606,0,0,0,38400,10,7757103802
6971,363809589,149745,363959334,9,0,0,99840,10,6752837857
6972,363809600,154444,363964044,4,0,0,15360,6,3499687575
6973,363835770,155490,363991260,6,0,0,22016,9,2316086219
6974,363913080,90396,364003476,7,0,0,6656,18,3332120052
6975,363928760,30589,363959349,0,0,1,9216,10,5740055632
6976,363963500,151267,364114767,4,0,0,7168,6,10679418263
6977,363985060,127508,364112568,6,0,0,98304,9,9009698719
6978,364017630,198576,364216206,6,0,0,1536,9,6962280177
6979,364055680,142940,364198620,1,0,0,25600,14,8818343153
6980,364065690,179562,364245252,7,0,0,77824,18,719822767
6981,364142390,133388,364275778,3,0,0,7168,9,352867765
6982,364152860,162292,364315152,5,0,0,32768,11,3886529052
6983,364172509,114605,364287114,0,0,0,22528,10,9880900100
6984,364177280,94688,364271968,8,0,0,20992,12,3225998721
6985,364291910,109237,364401147,6,0,0,33280,9,6900339116
6986,364292920,98072,364390992,4,0,0,22016,6,6659328854
6987,364311120,107946,364419066,6,0,0,7168,9,2162257527
6988,364409200,103064,364512264,8,0,0,38400,12,6365676168
6989,364431600,150882,364582482,1,0,0,35840,14,7496553531
6990,364470690,127719,364598409,7,0,0,52224,18,5242441904
6991,364522631,566,364523197,5,0,1,512,11,3748767398
6992,364540471,1994,364542465,2,0,1,2048,4,6455902147
6993,364548880,103995,364652875,6,0,0,4096,9,10217406359
6994,364597959,174716,364772675,9,0,0,81408,10,8468783440
6995,364756760,104163,364860923,6,0,0,25088,9,2910525958
6996,364774949,116052,364891001,9,0,0,11776,10,8278928690
6997,364803560,90576,364894136,1,0,0,10240,14,9547884882
6998,364861890,88601,364950491,1,0,0,14336,14,3273186874
6999,364927360,123188,365050548,1,0,0,104448,14,8992080695
7000,365182891,1994,365184885,6,0,1,2048,9,8730835068
7001,365258780,11533,365270313,1,0,1,18944,14,8335617035
7002,365337780,48980,365386760,6,0,0,2048,9,815051354
7003,365481660,87164,365568824,5,0,0,21504,11,3067582638
7004,365613469,91772,365705241,0,0,0,21504,10,6675844559
7005,365639849,136414,365776263,0,0,0,26624,10,7403127001
7006,365678029,84294,365762323,0,0,0,10240,10,5470749984
7007,365709871,33503,365743374,6,0,1,58368,9,594727119
7008,365733860,171784,365905644,7,0,0,54784,18,4596137948
7009,365768750,283820,366052570,3,0,0,64512,9,9894103198
7010,365777310,62672,365839982,5,0,0,6656,11,7397889404
7011,365822099,179519,366001618,9,0,0,8192,10,8758809970
7012,365870210,79946,365950156,5,0,0,10240,11,4912030685
7013,365925919,166599,366092518,9,0,0,34304,10,3673748426
7014,365971730,82883,366054613,7,0,0,6656,18,7785140031
7015,366059300,43904,366103204,4,0,0,512,6,10423827084
7016,366060470,43904,366104374,4,0,0,512,6,10390573483
7017,366096860,7706,366104566,1,0,1,8192,14,10618526334
7018,366134470,6278,366140748,1,0,1,6656,14,2890190633
7019,366346890,124124,366471014,5,0,0,107520,11,8234773997
7020,366390050,100356,366490406,8,0,0,2560,12,6718493624
7021,366414030,566,366414596,4,0,1,512,6,3520072126
7022,366435510,62288,366497798,8,0,0,6656,12,8101513010
7023,366441660,135374,366577034,6,0,0,48128,9,4454922935
7024,366477120,48980,366526100,6,0,0,2048,9,5910153642
7025,366483120,124958,366608078,6,0,0,18944,9,189121254
7026,366484031,3422,366487453,2,0,1,3584,4,5025596445
7027,366734270,47600,366781870,4,0,0,2560,6,6040121531
7028,366757999,50672,366808671,0,0,0,2560,10,8080916041
7029,366839720,102128,366941848,3,0,0,35328,9,9914980923
7030,366873639,144691,367018330,9,0,0,58368,10,7117129214
7031,366909270,109863,367019133,4,0,0,2560,6,6906077039
7032,367002960,117490,367120450,8,0,0,35328,12,2873760102
7033,367060400,566,367060966,7,0,1,512,18,2221515226
7034,367072570,88824,367161394,7,0,0,6144,18,7240037631
7035,367092490,84512,367177002,7,0,0,12800,18,3393960260
7036,367257210,2946,367260156,0,0,1,3072,10,226826890
7037,367263349,59444,367322793,9,0,0,6144,10,359474742
7038,367342809,47288,367390097,9,0,0,1536,10,5272360364
7039,367456420,73004,367529424,7,0,0,15360,18,7911715472
7040,367470990,4374,367475364,9,0,1,4608,10,5271971171
7041,367508909,149242,367658151,0,0,0,35840,10,6108881443
7042,367635029,111332,367746361,9,0,0,65536,10,10711961135
7043,367654569,180514,367835083,9,0,0,17408,10,7551013316
7044,367678169,126674,367804843,9,0,0,49664,10,9538998401
7045,367724280,198361,367922641,5,0,0,76800,11,10292906910
7046,367848790,115941,367964731,7,0,0,37376,18,1567270858
7047,367867960,55320,367923280,8,0,0,2048,12,6563827879
7048,367877580,87322,367964902,4,0,0,512,6,8564295149
7049,367996290,12825,368009115,4,0,1,21504,6,10641331925
7050,368018660,102752,368121412,8,0,0,37376,12,3000148234
7051,368109029,12398,368121427,3,0,1,5632,9,10332359161
7052,368152150,102128,368254278,3,0,0,35328,9,9406992721
7053,368189000,4937,368193937,9,0,1,12800,10,8862329428
7054,368215990,112358,368328348,3,0,0,35328,9,6415509807
7055,368221660,62936,368284596,8,0,0,7680,12,10271370864
7056,368361439,5971,368367410,3,0,1,14848,9,3666169500
7057,368408150,99008,368507158,5,0,0,25088,11,7844829970
7058,368447309,121583,368568892,0,0,0,14848,10,5049568033
7059,368453950,43904,368497854,8,0,0,512,12,2336721290
7060,368475150,111100,368586250,4,0,0,22016,6,6715807968
7061,368529800,85016,368614816,1,0,0,13824,14,9291833847
7062,368576000,45752,368621752,7,0,0,1536,18,1243325310
7063,368583710,75200,368658910,3,0,0,9216,9,6875182667
7064,368631660,92396,368724056,7,0,0,23552,18,7419566699
7065,368649900,129146,368779046,8,0,0,16384,12,2630162823
7066,368852130,47288,368899418,6,0,0,1536,9,6785795585
7067,368900069,70976,368971045,0,0,0,8704,10,7128715523
7068,368905409,70976,368976385,9,0,0,8704,10,6120604319
7069,368926089,54056,368980145,0,0,0,3584,10,4994659573
7070,368941779,2470,368944249,3,0,1,2560,9,7149238563
7071,368978490,52364,369030854,5,0,0,3072,11,9467292544
7072,368981029,5802,368986831,3,0,1,6144,9,6416044273
7073,369228000,78056,369306056,4,0,0,11776,6,4620723561
7074,369245779,73292,369319071,9,0,0,11264,10,4908995404
7075,369284079,186875,369470954,0,0,0,153600,10,5947693904
7076,369288860,187257,369476117,2,0,0,16896,4,4179792797
7077,369361450,122794,369484244,6,0,0,26624,9,8518724404
7078,369664480,101816,369766296,4,0,0,34304,6,9562456467
7079,369691710,50672,369742382,5,0,0,2560,11,5480337392
7080,369769879,107588,369877467,9,0,0,53248,10,4144824737
7081,369770130,115185,369885315,5,0,0,23552,11,2051441401
7082,369818180,72301,369890481,4,0,0,4096,6,1646890148
7083,369861361,49190,369910551,6,0,1,54272,9,8136524965
7084,369875970,64035,369940005,8,0,0,3072,12,5055866621
7085,369923861,2470,369926331,5,0,1,2560,11,1712453551
7086,369972780,48980,370021760,4,0,0,2048,6,3716006736
7087,370032529,101972,370134501,9,0,0,34816,10,7735068436
7088,370066110,94820,370160930,8,0,0,16384,12,9387818427
7089,370104300,57453,370161753,3,0,0,1024,9,8539817635
7090,370267800,1518,370269318,7,0,1,1536,18,9443516917
7091,370273069,77768,370350837,0,0,0,15872,10,1442246485
7092,370466230,79436,370545666,3,0,0,11264,9,7479866372
7093,370492230,90618,370582848,2,0,0,6144,4,8743096507
7094,370501170,3898,370505068,1,0,1,4096,14,1681768263
7095,370564999,97136,370662135,9,0,0,18944,10,4546590650
7096,370725439,3387,370728826,3,0,1,9728,9,2215730682
7097,370846370,1518,370847888,7,0,1,1536,18,248374846
7098,370864340,3128,370867468,1,0,1,9216,14,1526773175
7099,370942789,148474,371091263,9,0,0,19456,10,6510447491
7100,371010199,67168,371077367,0,0,0,4096,10,7592607141
7101,371131510,100100,371231610,3,0,0,28672,9,9580801508
7102,371256290,103376,371359666,6,0,0,39424,9,9662803578
7103,371276670,151522,371428192,5,0,0,36352,11,10417396080
7104,371313980,4937,371318917,0,0,1,12800,10,525469485
7105,371369270,105560,371474830,1,0,0,46592,14,3784606471
7106,371486480,7706,371494186,9,0,1,8192,10,5812461330
7107,371577970,48980,371626950,3,0,0,2048,9,9101350101
7108,371605110,109928,371715038,5,0,0,60928,11,6295296294
7109,371652760,119266,371772026,6,0,0,13824,9,8893243177
7110,371801660,49136,371850796,4,0,0,2560,6,4378485021
7111,371918680,78056,371996736,5,0,0,11776,11,8074837818
7112,371955279,105872,372061151,9,0,0,47616,10,3637921240
7113,371961359,107919,372069278,9,0,0,26624,10,1039557517
7114,371977650,3898,371981548,9,0,1,4096,10,4694820363
7115,372003369,66080,372069449,0,0,0,512,10,1132336722
7116,372230739,79436,372310175,0,0,0,11264,10,9897746982
7117,372282310,92587,372374897,6,0,0,15872,9,3723685155
7118,372357470,81652,372439122,1,0,0,13312,14,6796960666
7119,372377070,1518,372378588,7,0,1,1536,18,5514372588
7120,372381510,102752,372484262,3,0,0,37376,9,1767810841
7121,372396410,4420,372400830,7,0,1,11776,18,5207078185
7122,372413850,218323,372632173,2,0,0,15872,4,5080730954
7123,372417699,295786,372713485,9,0,0,13312,10,524246852
7124,372547019,69284,372616303,9,0,0,8192,10,10563876988
7125,372625900,102573,372728473,8,0,0,32256,12,4799237348
7126,372679400,144281,372823681,4,0,0,45056,6,5073852915
7127,372704940,48980,372753920,5,0,0,2048,11,3100127267
7128,372727570,61659,372789229,3,0,0,2560,9,7455693891
7129,372732100,102267,372834367,8,0,0,23552,12,9388083536
7130,372790080,88501,372878581,1,0,0,11264,14,3309071898
7131,372803320,47288,372850608,2,0,0,1536,4,3498012424
7132,372812210,22172,372834382,7,0,1,10240,18,3874330433
7133,372845410,174748,373020158,4,0,0,20480,6,3643838240
7134,372874420,4176,372878596,9,0,1,2560,10,5122165003
7135,372907260,4374,372911634,7,0,1,4608,18,5722053471
7136,372957000,3128,372960128,0,0,1,9216,10,7638861954
7137,373027840,103532,373131372,2,0,0,39936,4,6364154236
7138,373058369,98065,373156434,9,0,0,5120,10,2879156613
7139,373088030,80372,373168402,5,0,0,14336,11,8796127766
7140,373126800,113288,373240088,4,0,0,11264,6,2759497026
7141,373134540,85472,373220012,8,0,0,20992,12,1938807631
7142,373173051,3904,373176955,5,0,1,10752,11,3181884884
7143,373255710,1518,373257228,7,0,1,1536,18,9134045142
7144,373261849,7230,373269079,3,0,1,7680,9,530919682
7145,373269270,73448,373342718,8,0,0,11776,12,6198840619
7146,373277630,84248,373361878,2,0,0,22016,4,5650943850
7147,373303119,172230,373475349,0,0,0,13312,10,5645116172
7148,373329380,94730,373424110,8,0,0,12288,12,7022976407
7149,373334680,165756,373500436,1,0,0,34816,14,10044211355
7150,373375640,169892,373545532,3,0,0,21504,9,9652492437
7151,373514570,4420,373518990,0,0,1,11776,10,1203616890
7152,373606510,157763,373764273,7,0,0,29696,18,3646340480
7153,373625571,3422,373628993,2,0,1,3584,4,1886465028
7154,373645301,2946,373648247,6,0,1,3072,9,7317580324
7155,373757260,107261,373864521,4,0,0,29184,6,415773389
7156,373778159,98696,373876855,9,0,0,24064,10,4530825872
7157,373799411,7706,373807117,6,0,1,8192,9,3333292122
7158,373849340,1518,373850858,4,0,1,1536,6,952149507
7159,373936720,56216,373992936,5,0,0,5632,11,2132049372
7160,374016810,85604,374102414,5,0,0,16384,11,1547847271
7161,374056319,60824,374117143,9,0,0,5632,10,771266835
7162,374116470,109501,374225971,8,0,0,57344,12,5211180495
7163,374193580,75476,374269056,2,0,0,18432,4,9914619562
7164,374223240,85168,374308408,7,0,0,512,18,6192013489
7165,374241521,5971,374247492,5,0,1,14848,11,1594147484
7166,374361370,1042,374362412,0,0,1,1024,10,4872853313
7167,374371850,566,374372416,7,0,1,512,18,135949174
7168,374466840,73292,374540132,8,0,0,11264,12,1540761020
7169,374558160,71624,374629784,4,0,0,15872,6,926230929
7170,374732370,80684,374813054,6,0,0,15360,9,5639524744
7171,374767039,75296,374842335,0,0,0,12800,10,1632581274
7172,374807190,10241,374817431,7,0,1,16384,18,8581163101
7173,374812110,108981,374921091,6,0,0,22016,9,8350203271
7174,374821490,91436,374912926,5,0,0,15360,11,10302112474
7175,375029680,69284,375098964,2,0,0,8192,4,8071329641
7176,375095230,92533,375187763,8,0,0,14848,12,4869364930
7177,375095280,87944,375183224,2,0,0,24064,4,4924520549
7178,375153960,117836,375271796,5,0,0,30208,11,5289105432
7179,375157970,117273,375275243,4,0,0,11264,6,8345993601
7180,375235340,57908,375293248,6,0,0,6144,9,180032861
7181,375318270,81776,375400046,9,0,0,18944,10,954730225
7182,375324301,566,375324867,2,0,1,512,4,501392893
7183,375357790,57752,375415542,6,0,0,5632,9,5275013429
7184,375419930,88256,375508186,5,0,0,25088,11,10254108835
7185,375456080,5802,375461882,9,0,1,6144,10,642822239
7186,375493400,95156,375588556,1,0,0,22528,14,1102017890
7187,375502680,91039,375593719,8,0,0,16896,12,6344992818
7188,375510970,105210,375616180,1,0,0,3072,14,3741581655
7189,375518920,138936,375657856,7,0,0,13824,18,5729631036
7190,375544210,99320,375643530,9,0,0,26112,10,9046587242
7191,375556400,97010,375653410,2,0,0,8192,4,3341060129
7192,375640860,75330,375716190,8,0,0,9216,12,165671749
7193,375702020,55148,375757168,2,0,0,7168,4,2245640600
7194,375729610,97891,375827501,3,0,0,25600,9,895550499
7195,375736239,132291,375868530,0,0,0,19968,10,2602265121
7196,375748530,71156,375819686,7,0,0,14336,18,1319527024
7197,375817601,11886,375829487,5,0,1,2048,11,4811773040
7198,375916740,136847,376053587,6,0,0,18432,9,4422589542
7199,375948171,4374,375952545,2,0,1,4608,4,3590444595
7200,375974080,136459,376110539,5,0,0,44032,11,9882441785
7201,376029270,65900,376095170,6,0,0,7168,9,7883503522
7202,376044929,8673,376053602,3,0,1,6656,9,4487970570
7203,376179030,65456,376244486,9,0,0,10752,10,10209828878
7204,376179830,65139,376244969,2,0,0,1536,4,9053281787
7205,376337210,2470,376339680,7,0,1,2560,18,8487050872
7206,376550780,58688,376609468,5,0,0,8704,11,5020958230
7207,376566890,71312,376638202,6,0,0,14848,9,5542985518
7208,376572170,101504,376673674,7,0,0,33280,18,5920819827
7209,376627360,48980,376676340,3,0,0,2048,9,2455885426
7210,376670310,62644,376732954,1,0,0,5632,14,9365019259
7211,376866390,99008,376965398,6,0,0,25088,9,2727803677
7212,376874270,74360,376948630,2,0,0,9728,4,4515284617
7213,376910330,67046,376977376,3,0,0,7168,9,3068499865
7214,376916370,123730,377040100,7,0,0,51712,18,5697117560
7215,377004950,4374,377009324,0,0,1,4608,10,304781399
7216,377030760,133132,377163892,6,0,0,70144,9,9807120809
7217,377043210,133156,377176366,5,0,0,4096,11,5327886258
7218,377054411,5196,377059607,6,0,1,13312,9,9266711690
7219,377065759,149741,377215500,0,0,0,512,10,4546865244
7220,377092529,13600,377106129,3,0,1,23040,9,2779547711
7221,377148760,112274,377261034,1,0,0,7680,14,8003698762
7222,377157780,96146,377253926,1,0,0,1024,14,9423355017
7223,377248190,57596,377305786,2,0,0,5120,4,3062005790
7224,377404330,60824,377465154,6,0,0,5632,9,8990549222
7225,377588100,97940,377686040,4,0,0,26624,6,4626679753
7226,377652350,128982,377781332,6,0,0,90112,9,7592588575
7227,377678050,121984,377800034,7,0,0,9216,18,9659767832
7228,377722870,129580,377852450,9,0,0,2560,10,8182962888
7229,377739590,48980,377788570,5,0,0,2048,11,9398894949
7230,377743480,80980,377824460,8,0,0,2560,12,3052377792
7231,377752269,86399,377838668,0,0,0,18944,10,9051744975
7232,377777110,97804,377874914,3,0,0,10752,9,5001018526
7233,377810770,80684,377891454,1,0,0,15360,14,8083924870
7234,377820580,55285,377875865,3,0,0,3072,9,6186578987
7235,377938070,106652,378044722,4,0,0,50176,6,569513500
7236,377983380,104780,378088160,2,0,0,44032,4,8986135743
7237,378030470,109230,378139700,3,0,0,14336,9,8483586953
7238,378047540,86748,378134288,5,0,0,6656,11,2572200705
7239,378057160,118564,378175724,2,0,0,31744,4,6918411036
7240,378108239,86187,378194426,0,0,0,16384,10,132654249
7241,378181870,47288,378229158,7,0,0,1536,18,963360691
7242,378192830,52260,378245090,7,0,0,2560,18,232770597
7243,378224450,116792,378341242,9,0,0,83456,10,9981400322
7244,378265540,132192,378397732,3,0,0,35840,9,3066865743
7245,378315120,26137,378341257,9,0,1,20480,10,6479659135
7246,378356760,104156,378460916,8,0,0,41984,12,2446994851
7247,378363200,81905,378445105,7,0,0,1536,18,9425507665
7248,378375790,116541,378492331,4,0,0,9216,6,9070532648
7249,378400449,115264,378515713,0,0,0,9216,10,8246422796
7250,378592400,110864,378703264,8,0,0,64000,12,9763718001
7251,378646900,56847,378703747,4,0,0,1536,6,2448594769
7252,378654070,97916,378751986,6,0,0,21504,9,3710204763
7253,378672010,133184,378805194,6,0,0,34816,9,6352897849
7254,378681960,71445,378753405,6,0,0,4608,9,1704723458
7255,378717990,211122,378929112,3,0,0,52224,9,2094076755
7256,378735139,151685,378886824,0,0,0,74752,10,9844409690
7257,378751580,184419,378935999,1,0,0,22528,14,3151066271
7258,378845610,199464,379045074,6,0,0,43520,9,3794020940
7259,378855920,152196,379008116,1,0,0,30720,14,8086811483
7260,378882600,163113,379045713,8,0,0,2048,12,7115520346
7261,378910880,146548,379057428,5,0,0,38400,11,6157242133
7262,378917880,185784,379103664,4,0,0,17920,6,6189688420
7263,378981110,103220,379084330,8,0,0,38912,12,605985022
7264,379005670,148098,379153768,3,0,0,33792,9,489415428
7265,379022580,82511,379105091,6,0,0,4608,9,10409504950
7266,379090370,119252,379209622,7,0,0,14336,18,8921855514
7267,379096181,10241,379106422,6,0,1,16384,9,3158201221
7268,379099969,96371,379196340,0,0,0,19456,10,7894253908
7269,379101980,186054,379288034,3,0,0,9216,9,4730493037
7270,379131260,117358,379248618,9,0,0,23552,10,8182081858
7271,379221220,3422,379224642,4,0,1,3584,6,9575334913
7272,379298950,62516,379361466,7,0,0,6144,18,186818865
7273,379371080,110283,379481363,5,0,0,37376,11,8038611947
7274,379408801,3904,379412705,6,0,1,10752,9,3346969267
7275,379441940,190130,379632070,7,0,0,32256,18,9755858320
7276,379510740,99632,379610372,8,0,0,27136,12,6428890458
7277,379536730,166822,379703552,6,0,0,33280,9,6957426227
7278,379612830,94793,379707623,8,0,0,13312,12,7019653644
7279,379709810,84362,379794172,3,0,0,6144,9,6119155584
7280,379730180,53996,379784176,7,0,0,3584,18,7995239099
7281,379800650,48980,379849630,7,0,0,2048,18,5661676974
7282,379807530,101660,379909190,9,0,0,33792,10,7851344218
7283,379843310,143608,379986918,1,0,0,11264,14,6229828794
7284,379850090,4374,379854464,1,0,1,4608,14,1605880320
7285,379863360,109464,379972824,6,0,0,26624,9,2445416659
7286,379905940,106618,380012558,4,0,0,39424,6,1619176225
7287,379914651,12566,379927217,2,0,1,20992,4,5189849251
7288,379914730,165706,380080436,7,0,0,29184,18,10562451252
7289,380123150,109772,380232922,2,0,0,60416,4,3268791959
7290,380126570,107771,380234341,4,0,0,4608,6,7060626098
7291,380240129,120501,380360630,0,0,0,49152,10,3599528841
7292,380254290,77744,380332034,4,0,0,10752,6,8046709245
7293,380277910,105754,380383664,4,0,0,7680,6,8628183091
7294,380332930,69752,380402682,8,0,0,9728,12,7195793274
7295,380446510,104624,380551134,9,0,0,43520,10,7530238019
7296,380527940,4850,380532790,0,0,1,5120,10,4294221167
7297,380561330,3422,380564752,7,0,1,3584,18,1100962164
7298,380600740,5196,380605936,1,0,1,13312,14,3630980347
7299,380617050,116477,380733527,4,0,0,23040,6,5584822135
7300,380716590,151177,380867767,5,0,0,51200,11,10015202063
7301,380780270,113123,380893393,7,0,0,38400,18,5878284400
7302,380811260,98852,380910112,2,0,0,24576,4,5171767503
7303,380823850,13770,380837620,4,0,1,26624,6,4156348202
7304,380950470,105092,381055562,4,0,0,45056,6,3082150966
7305,381016321,1042,381017363,5,0,1,1024,11,4874893068
7306,381045600,53858,381099458,9,0,0,512,10,5676442924
7307,381073990,103220,381177210,8,0,0,38912,12,4358577951
7308,381168550,71036,381239586,8,0,0,10752,12,1213750742
7309,381169630,73965,381243595,2,0,0,8704,4,6966213530
7310,381193720,1994,381195714,0,0,1,2048,10,9283243457
7311,381218910,99344,381318254,5,0,0,31232,11,4971596864
7312,381222320,83218,381305538,3,0,0,8192,9,3265923240
7313,381235930,71807,381307737,7,0,0,7168,18,5033296522
7314,381248861,4937,381253798,5,0,1,12800,11,3298672172
7315,381294251,4679,381298930,2,0,1,12288,4,9605733592
7316,381453650,61916,381515566,3,0,0,9216,9,4881031347
7317,381511011,12049,381523060,2,0,1,19968,4,6363106724
7318,381589861,6488,381596349,2,0,1,15872,4,6576558771
7319,381598030,85160,381683190,9,0,0,19968,10,1968858097
7320,381668019,122235,381790254,0,0,0,71680,10,373336257
7321,381771230,95068,381866298,7,0,0,10240,18,6632518944
7322,381802121,16096,381818217,6,0,1,31232,9,10544648316
7323,381957290,129714,382087004,9,0,0,41472,10,7861932370
7324,381981699,46901,382028600,0,0,0,1024,10,6568494563
7325,381991750,205966,382197716,1,0,0,19456,14,9120901244
7326,382014100,158851,382172951,1,0,0,74752,14,6642818812
7327,382044150,224603,382268753,6,0,0,43008,9,3974253831
7328,382057711,3422,382061133,2,0,1,3584,4,262144104
7329,382095680,113883,382209563,6,0,0,6144,9,1935721718
7330,382121110,107983,382229093,5,0,0,3584,11,4801739620
7331,382185850,103376,382289226,6,0,0,39424,9,2495575446
7332,382189939,7792,382197731,3,0,1,12288,9,6251010956
7333,382274060,157348,382431408,2,0,0,13824,4,6327412580
7334,382312450,130361,382442811,3,0,0,37376,9,8055234387
7335,382355250,156048,382511298,2,0,0,43008,4,4433966179
7336,382411790,109351,382521141,4,0,0,32256,6,2607958281
7337,382424620,98954,382523574,5,0,0,7680,11,3279610499
7338,382433480,129080,382562560,8,0,0,17408,12,186554644
7339,382459060,96246,382555306,1,0,0,2560,14,7425233423
7340,382661170,76912,382738082,3,0,0,10240,9,10000373379
7341,382662030,52364,382714394,6,0,0,3072,9,4172875469
7342,382726450,60824,382787274,4,0,0,5632,6,9010128752
7343,382785690,8330,382794020,4,0,1,7168,6,8847865843
7344,382837460,150659,382988119,5,0,0,103424,11,466597909
7345,382857939,149707,383007646,0,0,0,30720,10,1795779396
7346,382917830,1994,382919824,9,0,1,2048,10,6395294039
7347,382921290,67468,382988758,2,0,0,2048,4,3227464404
7348,382943700,76588,383020288,4,0,0,512,6,9296271734
7349,382995760,100977,383096737,1,0,0,20480,14,5453715992
7350,383002020,88462,383090482,8,0,0,17408,12,6544827762
7351,383062720,108906,383171626,1,0,0,44544,14,2585637543
7352,383115519,80684,383196203,0,0,0,15360,10,4225174632
7353,383129710,70976,383200686,7,0,0,8704,18,7551833154
7354,383143720,76794,383220514,4,0,0,6144,6,5366812803
7355,383240440,52364,383292804,3,0,0,3072,9,5977786974
7356,383245490,91306,383336796,1,0,0,16384,14,6007701847
7357,383258160,45596,383303756,9,0,0,1024,10,10627899936
7358,383261820,4374,383266194,4,0,1,4608,6,2256791675
7359,383349040,78368,383427408,1,0,0,12800,14,10405233527
7360,383383610,2870,383386480,1,0,1,8704,14,2572374517
7361,383409590,131094,383540684,6,0,0,58368,9,5817079991
7362,383411470,166278,383577748,2,0,0,24064,4,2217082875
7363,383417951,3128,383421079,5,0,1,9216,11,280972736
7364,383591860,77744,383669604,9,0,0,10752,10,8538022503
7365,383595180,82400,383677580,5,0,0,20992,11,1807225802
7366,383608250,102284,383710534,3,0,0,35840,9,7069086185
7367,383642260,93296,383735556,7,0,0,8192,18,7986131047
7368,383651000,101564,383752564,3,0,0,16384,9,8922689308
7369,383691411,566,383691977,2,0,1,512,4,7716435995
7370,383706300,7354,383713654,1,0,1,9216,14,1037562639
7371,383710880,145375,383856255,6,0,0,31232,9,2315383325
7372,383824909,61790,383886699,0,0,0,5120,10,4728172840
7373,383944390,52520,383996910,1,0,0,3584,14,10305793205
7374,383972320,566,383972886,0,0,1,512,10,10621212224
7375,383973771,3898,383977669,6,0,1,4096,9,3942754412
7376,384013390,93932,384107322,6,0,0,23552,9,5775144097
7377,384098030,95468,384193498,4,0,0,23552,6,6411488511
7378,384192140,45254,384237394,2,0,0,512,4,849308427
7379,384245840,130988,384376828,1,0,0,130048,14,1682756599
7380,384300021,566,384300587,5,0,1,512,11,1038193589
7381,384316240,88056,384404296,9,0,0,11264,10,7906593296
7382,384316520,108524,384425044,4,0,0,13824,6,634791520
7383,384343600,200670,384544270,7,0,0,46080,18,707778591
7384,384354730,83407,384438137,5,0,0,7168,11,5480829587
7385,384376820,196551,384573371,3,0,0,46592,9,8087932477
7386,384398540,184640,384583180,8,0,0,16384,12,9782912334
7387,384416350,183655,384600005,9,0,0,52224,10,3655484124
7388,384522961,4374,384527335,6,0,1,4608,9,7365978349
7389,384543070,70344,384613414,2,0,0,12800,4,1122813233
7390,384565360,67135,384632495,5,0,0,5120,11,4116533897
7391,384618450,101348,384719798,1,0,0,32768,14,7495742887
7392,384646780,48980,384695760,1,0,0,2048,14,370390385
7393,384651120,145094,384796214,5,0,0,34304,11,7582559335
7394,384753110,91728,384844838,9,0,0,5120,10,5128137105
7395,384801539,55748,384857287,0,0,0,4096,10,5077559230
7396,384902640,67592,384970232,2,0,0,7680,4,4995288416
7397,384931119,112703,385043822,0,0,0,36352,10,10656639537
7398,385067680,55748,385123428,5,0,0,4096,11,6110144773
7399,385098289,5802,385104091,3,0,1,6144,9,7720377890
7400,385116400,224658,385341058,1,0,0,100864,14,9585051279
7401,385207569,163759,385371328,0,0,0,62976,10,2978769981
7402,385209030,71468,385280498,8,0,0,15360,12,1178984400
7403,385248030,153592,385401622,4,0,0,84992,6,9024835888
7404,385294269,81442,385375711,0,0,0,14336,10,6689748464
7405,385351750,50511,385402261,8,0,0,2048,12,2183359180
7406,385406040,116012,385522052,9,0,0,80896,10,8815965403
7407,385483800,72668,385556468,9,0,0,9216,10,6068905156
7408,385544790,76988,385621778,7,0,0,13312,18,2515393931
7409,385660349,62516,385722865,0,0,0,6144,10,7767754175
7410,385702150,57908,385760058,5,0,0,6144,11,4410857013
7411,385741890,100256,385842146,5,0,0,29184,11,6586093866
7412,385765140,140288,385905428,3,0,0,54272,9,1617864941
7413,385772890,74422,385847312,8,0,0,9728,12,2764450249
7414,385838270,109272,385947542,1,0,0,19968,14,10014662690
7415,385880139,130457,386010596,0,0,0,29184,10,6579361607
7416,385899690,6296,385905986,1,0,1,512,14,3974536965
7417,385918820,230895,386149715,4,0,0,16384,6,5734006920
7418,385926890,20667,385947557,1,0,1,30208,14,9675240071
7419,385967560,296527,386264087,6,0,0,21504,9,2118856550
7420,386001160,215665,386216825,4,0,0,38912,6,4037561507
7421,386047340,131871,386179211,2,0,0,17408,4,8160277613
7422,386153329,81970,386235299,0,0,0,7680,10,9627873170
7423,386225560,77221,386302781,7,0,0,11264,18,2511596177
7424,386324660,78056,386402716,4,0,0,11776,6,10068287705
7425,386344490,91904,386436394,5,0,0,16896,11,827286140
7426,386403630,114862,386518492,2,0,0,58368,4,487932799
7427,386449670,48980,386498650,9,0,0,2048,10,3784068417
7428,386470760,95156,386565916,8,0,0,22528,12,6115813391
7429,386499490,101660,386601150,1,0,0,33792,14,1016209858
7430,386563510,69674,386633184,3,0,0,11776,9,1908669139
7431,386576439,85983,386662422,0,0,0,15872,10,5618462060
7432,386586421,14744,386601165,6,0,1,14848,9,8103355271
7433,386619239,76676,386695915,0,0,0,12288,10,3183754955
7434,386622489,74377,386696866,0,0,0,3072,10,3914173348
7435,386648690,89639,386738329,7,0,0,9216,18,1551345853
7436,386707230,50672,386757902,9,0,0,2560,10,8286445629
7437,386708640,94435,386803075,9,0,0,18944,10,8220139969
7438,386737560,7039,386744599,0,0,1,6656,10,5287134185
7439,386759990,57440,386817430,5,0,0,4608,11,6954151172
7440,386779170,102586,386881756,6,0,0,23040,9,2273063686
7441,386848440,112112,386960552,5,0,0,68096,11,5328943186
7442,386881281,6269,386887550,2,0,1,6144,4,6511155678
7443,386892450,5326,386897776,9,0,1,5632,10,1511730833
7444,386899230,82130,386981360,1,0,0,3072,14,3116970505
7445,387104450,3904,387108354,5,0,1,10752,11,2632119694
7446,387110320,117154,387227474,4,0,0,41984,6,7633945888
7447,387118710,140706,387259416,2,0,0,28160,4,7177673524
7448,387207620,6754,387214374,4,0,1,7168,6,6503506022
7449,387207640,104161,387311801,6,0,0,4096,9,4248131211
7450,387350840,92216,387443056,6,0,0,17920,9,7998249110
7451,387442110,46534,387488644,4,0,0,1024,6,3516810004
7452,387446500,120186,387566686,3,0,0,29184,9,6671768806
7453,387542360,56372,387598732,2,0,0,6144,4,2738240215
7454,387647919,5454,387653373,3,0,1,13824,9,8778720403
7455,387831580,1518,387833098,1,0,1,1536,14,4965147665
7456,387885230,116750,388001980,4,0,0,46592,6,6453800508
7457,387896420,107611,388004031,4,0,0,6656,6,3861213974
7458,387991370,76970,388068340,6,0,0,8704,9,9909113486
7459,388218070,106184,388324254,7,0,0,48640,18,8292963656
7460,388301270,47288,388348558,1,0,0,1536,14,6007157433
7461,388321191,8857,388330048,6,0,1,6144,9,6394692523
7462,388329290,117399,388446689,1,0,0,44032,14,2235950695
7463,388378749,133190,388511939,0,0,0,30208,10,3733678980
7464,388388161,1994,388390155,6,0,1,2048,9,2614861401
7465,388401160,121879,388523039,5,0,0,6144,11,7099809960
7466,388451970,3422,388455392,1,0,1,3584,14,3126176362
7467,388488090,65231,388553321,3,0,0,3584,9,2869890977
7468,388491620,141123,388632743,2,0,0,31232,4,5607389330
7469,388571220,102284,388673504,6,0,0,35840,9,7570641139
7470,388604580,2870,388607450,7,0,1,8704,18,5621460847
7471,388678460,45596,388724056,6,0,0,1024,9,6844759813
7472,388705380,45596,388750976,6,0,0,1024,9,3749993798
7473,388751340,112892,388864232,9,0,0,70656,10,5508845868
7474,388883370,88256,388971626,1,0,0,25088,14,2548337991
7475,388891530,101443,388992973,7,0,0,32768,18,1500123282
7476,388912151,1994,388914145,6,0,1,2048,9,384452627
7477,388912229,174321,389086550,0,0,0,16896,10,3519203912
7478,388913129,116091,389029220,0,0,0,16384,10,7915015991
7479,388935230,138228,389073458,9,0,0,9216,10,4517211004
7480,388952210,71754,389023964,3,0,0,9216,9,3342579569
7481,389130410,51296,389181706,8,0,0,4608,12,5428163321
7482,389158820,102440,389261260,7,0,0,36352,18,746724273
7483,389181250,141540,389322790,6,0,0,15360,9,1101460706
7484,389181360,118996,389300356,9,0,0,6144,10,8550631489
7485,389189700,104468,389294168,1,0,0,43008,14,6180358230
7486,389194960,196794,389391754,9,0,0,80384,10,2575344521
7487,389212740,243874,389456614,4,0,0,1536,6,2179529457
7488,389324480,122900,389447380,6,0,0,45056,9,7238784735
7489,389345280,110851,389456131,9,0,0,28672,10,9892480420
7490,389359860,70462,389430322,4,0,0,1024,6,888566076
7491,389512690,2470,389515160,0,0,1,2560,10,8539067685
7492,389585010,2870,389587880,0,0,1,8704,10,7995621381
7493,389604090,3904,389607994,8,0,1,10752,12,1897283988
7494,389648460,3904,389652364,1,0,1,10752,14,3317130501
7495,389710110,43904,389754014,6,0,0,512,9,6212860444
7496,389748400,85760,389834160,9,0,0,16896,10,8829991363
7497,389803960,139916,389943876,5,0,0,77312,11,721871530
7498,389854320,91287,389945607,6,0,0,5632,9,3616022095
7499,389865600,138735,390004335,7,0,0,29696,18,2831906168
7500,389880200,115072,389995272,1,0,0,16896,14,876514350
7501,389970880,101192,390072072,3,0,0,32256,9,3665921994
7502,389980849,63140,390043989,0,0,0,8192,10,7148022129
7503,390042810,94098,390136908,7,0,0,20992,18,6184821584
7504,390048860,102752,390151612,1,0,0,37376,14,10332213419
7505,390050580,157204,390207784,7,0,0,60416,18,6456460427
7506,390196709,13954,390210663,3,0,1,8704,9,4847542374
7507,390205470,113975,390319445,7,0,0,66560,18,8992547047
7508,390308069,15272,390323341,3,0,1,10752,9,2029259401
7509,390324710,141625,390466335,2,0,0,51712,4,8305570427
7510,390332960,117596,390450556,7,0,0,41472,18,1877160965
7511,390412430,127874,390540304,4,0,0,36352,6,7355280160
7512,390433600,114914,390548514,4,0,0,26112,6,504284521
7513,390444610,25846,390470456,8,0,1,11264,12,3466378006
7514,390454060,157573,390611633,1,0,0,37376,14,6546721797
7515,390477111,4162,390481273,5,0,1,11264,11,5547795036
7516,390512220,114560,390626780,1,0,0,49664,14,5498400094
7517,390516861,10241,390527102,2,0,1,16384,4,3847619139
7518,390634690,86984,390721674,8,0,0,15872,12,8160570551
7519,390652850,5326,390658176,8,0,1,5632,12,6339703788
7520,390666610,148148,390814758,3,0,0,1536,9,1675824776
7521,390671501,5802,390677303,6,0,1,6144,9,8340873787
7522,390703350,159396,390862746,3,0,0,47616,9,6469000026
7523,390724710,110552,390835262,6,0,0,62976,9,9919357657
7524,390729600,3422,390733022,1,0,1,3584,14,1384341411
7525,390848400,15856,390864256,4,0,1,1536,6,2238902185
7526,390890329,59132,390949461,0,0,0,5120,10,8708169823
7527,390954650,81752,391036402,3,0,0,13824,9,719950601
7528,390981140,75320,391056460,6,0,0,17920,9,1840428399
7529,391028070,107744,391135814,4,0,0,53760,6,10492130569
7530,391047930,8545,391056475,0,0,1,9216,10,5763465119
7531,391078500,57329,391135829,0,0,1,72704,10,9578180788
7532,391106680,128629,391235309,8,0,0,14848,12,7117318884
7533,391217210,117476,391334686,1,0,0,18944,14,9008719702
7534,391218830,89900,391308730,5,0,0,15360,11,6513895873
7535,391225140,103759,391328899,5,0,0,512,11,8242419940
7536,391232071,7621,391239692,6,0,1,4608,9,3577043232
7537,391234530,94198,391328728,9,0,0,14336,10,10265401313
7538,391238251,2107,391240358,6,0,1,1024,9,1396385869
7539,391246320,50672,391296992,4,0,0,2560,6,4336121727
7540,391255280,119084,391374364,3,0,0,17920,9,6357357622
7541,391395029,62516,391457545,9,0,0,6144,10,3039122987
7542,391428730,63764,391492494,2,0,0,10240,4,3943350839
7543,391431619,5454,391437073,3,0,1,13824,9,9074368266
7544,391434041,4658,391438699,6,0,1,2560,9,5652180289
7545,391451210,80303,391531513,3,0,0,10240,9,7736349398
7546,391476910,142699,391619609,4,0,0,26624,6,6955353548
7547,391524720,100676,391625396,7,0,0,18944,18,7731344568
7548,391578080,48980,391627060,9,0,0,2048,10,8622580808
7549,391627670,93308,391720978,7,0,0,21504,18,4572000705
7550,391628441,1994,391630435,6,0,1,2048,9,10192921201
7551,391685680,70976,391756656,4,0,0,8704,6,8552562534
7552,391705210,162454,391867664,4,0,0,61952,6,3337977510
7553,391789680,171506,391961186,4,0,0,50176,6,241720710
7554,391790840,81510,391872350,6,0,0,5632,9,8598653081
7555,391791670,122380,391914050,8,0,0,21504,12,5073075916
7556,391804900,130060,391934960,4,0,0,18432,6,5135708935
7557,391819601,5326,391824927,6,0,1,5632,9,6467574727
7558,391830610,1994,391832604,9,0,1,2048,10,3863082673
7559,391959070,195387,392154457,4,0,0,71680,6,3815552360
7560,392026970,162632,392189602,0,0,1,263168,10,3973193631
7561,392033110,228826,392261936,9,0,0,4096,10,6533867631
7562,392118329,76867,392195196,3,0,1,18432,9,1851593789
7563,392189100,258636,392447736,3,0,0,41472,9,2213339459
7564,392211490,79660,392291150,4,0,0,3072,6,5414679651
7565,392217790,154772,392372562,8,0,0,2560,12,325706847
7566,392220060,85568,392305628,4,0,0,4096,6,7776687498
7567,392233359,3422,392236781,3,0,1,3584,9,5559975699
7568,392336700,47288,392383988,2,0,0,1536,4,6503788982
7569,392438290,66878,392505168,2,0,0,4608,4,7248616714
7570,392447180,167769,392614949,0,0,1,275456,10,5172911039
7571,392515080,287563,392802643,6,0,0,45568,9,2990967618
7572,392561100,177157,392738257,2,0,0,47104,4,8956316955
7573,392561700,241894,392803594,7,0,0,3072,18,969101687
7574,392694540,163425,392857965,8,0,0,46080,12,9739200756
7575,392804610,53526,392858136,4,0,0,512,6,7809658529
7576,392828990,58499,392887489,9,0,0,3072,10,4401359385
7577,392887750,82244,392969994,8,0,0,20480,12,3422522889
7578,392897680,106808,393004488,3,0,0,50688,9,5804214090
7579,392897710,55915,392953625,2,0,0,4608,4,8182469588
7580,392898890,137884,393036774,3,0,0,78336,9,5595578560
7581,392921380,3128,392924508,8,0,1,9216,12,891799934
7582,393010681,26108,393036789,2,0,1,13312,4,9803861264
7583,393028900,228144,393257044,3,0,0,33792,9,7678143945
7584,393059880,77744,393137624,1,0,0,10752,14,1574702949
7585,393089620,100732,393190352,4,0,0,5120,6,9842210650
7586,393089860,74360,393164220,1,0,0,9728,14,929203913
7587,393139900,70976,393210876,7,0,0,8704,18,1109011466
7588,393287671,7230,393294901,2,0,1,7680,4,1626633824
7589,393305230,160844,393466074,2,0,0,142336,4,9418949367
7590,393333370,4937,393338307,4,0,1,12800,6,5513435453
7591,393343910,129199,393473109,6,0,0,23040,9,5805159088
7592,393399310,123908,393523218,3,0,0,30208,9,916979804
7593,393498309,64629,393562938,0,0,0,2048,10,6817968209
7594,393586501,5802,393592303,6,0,1,6144,9,7776274505
7595,393664950,43904,393708854,5,0,0,512,11,8083526319
7596,393820200,101660,393921860,9,0,0,33792,10,6586282234
7597,393861900,77744,393939644,9,0,0,10752,10,5824931558
7598,393914220,125048,394039268,7,0,0,85504,18,3604549373
7599,393971520,149696,394121216,1,0,0,54784,14,709484716
7600,393972111,1994,393974105,5,0,1,2048,11,4165516318
7601,394034030,95460,394129490,3,0,0,10240,9,1690566553
7602,394087480,82376,394169856,1,0,0,15872,14,8913650373
7603,394113090,139020,394252110,4,0,0,57856,6,1505407870
7604,394193330,132234,394325564,1,0,0,71168,14,4488847413
7605,394203850,71114,394274964,3,0,0,10752,9,4442448595
7606,394266610,75178,394341788,4,0,0,11264,6,2061101530
7607,394350460,79436,394429896,9,0,0,11264,10,985255236
7608,394393740,112158,394505898,4,0,0,62976,6,5635050973
7609,394431240,93878,394525118,4,0,0,9216,6,108643734
7610,394475420,100256,394575676,4,0,0,29184,6,5915188315
7611,394540389,4374,394544763,3,0,1,4608,9,4566249101
7612,394545000,116860,394661860,7,0,0,17408,18,4564958299
7613,394550620,58198,394608818,1,0,0,4608,14,5327908729
7614,394595010,7706,394602716,9,0,1,8192,10,5416378974
7615,394647011,4850,394651861,5,0,1,5120,11,4978127164
7616,394668071,1042,394669113,2,0,1,1024,4,10295477610
7617,394680040,209837,394889877,8,0,0,71168,12,3718303074
7618,394818639,43904,394862543,0,0,0,512,10,2090508184
7619,394895740,108212,395003952,4,0,0,55296,6,6015800771
7620,394923440,146206,395069646,6,0,0,37888,9,10243688265
7621,394959799,149879,395109678,0,0,0,10752,10,3022097531
7622,395014990,124184,395139174,6,0,0,11776,9,5147486276
7623,395053590,64032,395117622,7,0,0,1536,18,4473457289
7624,395092690,91592,395184282,6,0,0,15872,9,6917330171
7625,395103170,50672,395153842,3,0,0,2560,9,2882567417
7626,395159410,60224,395219634,4,0,0,8704,6,7462558998
7627,395248260,97448,395345708,2,0,0,19968,4,948503644
7628,395532621,13253,395545874,5,0,1,25600,11,3853295730
7629,395563000,86540,395649540,6,0,0,19456,9,6220775460
7630,395605930,115474,395721404,4,0,0,59904,6,859095135
7631,395666580,106136,395772716,6,0,0,14336,9,1496950867
7632,395678430,88898,395767328,1,0,0,11776,14,551752852
7633,395782000,60824,395842824,3,0,0,5632,9,2702144104
7634,395828980,72380,395901360,9,0,0,13312,10,9616053171
7635,396006669,67772,396074441,0,0,0,13312,10,3381353681
7636,396008660,100568,396109228,3,0,0,30208,9,7762643224
7637,396051870,141574,396193444,2,0,0,57344,4,9445803795
7638,396092080,107151,396199231,1,0,0,18944,14,4299785150
7639,396104381,5881,396110262,5,0,1,1024,11,1387052544
7640,396186729,103174,396289903,0,0,0,17920,10,2466466339
7641,396188719,171114,396359833,0,0,0,19456,10,3464772192
7642,396215050,97916,396312966,3,0,0,21504,9,1012703162
7643,396261670,5326,396266996,1,0,1,5632,14,3926747109
7644,396280420,111052,396391472,7,0,0,12288,18,9580371046
7645,396298090,64208,396362298,6,0,0,6656,9,6977858637
7646,396326889,60824,396387713,0,0,0,5632,10,1229034738
7647,396384550,100568,396485118,1,0,0,30208,14,4950926479
7648,396413169,60824,396473993,0,0,0,5632,10,4350470251
7649,396423550,100568,396524118,7,0,0,30208,18,7742560495
7650,396438440,53753,396492193,0,0,1,91136,10,2712109821
7651,396510640,115257,396625897,6,0,0,13824,9,6406388887
7652,396580030,69464,396649494,7,0,0,13824,18,5674749295
7653,396771960,72068,396844028,5,0,0,12288,11,6186232054
7654,396798840,96980,396895820,1,0,0,18432,14,6314203804
7655,396813690,109286,396922976,3,0,0,11776,9,3223042971
7656,396950930,65768,397016698,5,0,0,11776,11,2952696949
7657,396968010,3128,396971138,9,0,1,9216,10,5306615169
7658,397043450,110552,397154002,1,0,0,62976,14,4153759839
7659,397120031,4374,397124405,5,0,1,4608,11,6662343739
7660,397126300,74382,397200682,3,0,0,12288,9,2326135861
7661,397130190,61564,397191754,2,0,0,8192,4,3401020887
7662,397233191,6278,397239469,5,0,1,6656,11,5493885064
7663,397268740,185668,397454408,6,0,0,24576,9,281805437
7664,397357210,78368,397435578,8,0,0,12800,12,9236994983
7665,397530450,53144,397583594,7,0,0,5632,18,2531904730
7666,397633870,109193,397743063,4,0,0,39424,6,10377958824
7667,397634820,192693,397827513,6,0,0,48640,9,5654403760
7668,397644400,4374,397648774,8,0,1,4608,12,787887562
7669,397674080,138598,397812678,4,0,0,27648,6,300388866
7670,397680230,157282,397837512,7,0,0,32768,18,5364590200
7671,397733550,10071,397743621,9,0,1,512,10,1607102613
7672,397776290,125983,397902273,3,0,0,34304,9,8583081518
7673,397816561,26311,397842872,5,0,1,5632,11,8901995774
7674,397823771,29520,397853291,6,0,1,27136,9,1980432408
7675,397824680,142604,397967284,2,0,0,23552,4,3503689726
7676,397868940,76618,397945558,8,0,0,1536,12,10092368324
7677,397947170,88643,398035813,4,0,0,4608,6,9547372722
7678,397989760,102596,398092356,6,0,0,36864,9,7847969610
7679,398129239,110670,398239909,0,0,0,42496,10,5672635183
7680,398131700,93464,398225164,3,0,0,22016,9,8727662303
7681,398148770,1994,398150764,8,0,1,2048,12,3165198675
7682,398224430,44354,398268784,0,0,1,74752,10,7586605357
7683,398353620,167651,398521271,2,0,0,34816,4,8791117252
7684,398414650,117712,398532362,3,0,0,36352,9,10165954427
7685,398461210,4420,398465630,4,0,1,11776,6,918373319
7686,398476780,210463,398687243,2,0,0,1024,4,657725382
7687,398485101,2870,398487971,6,0,1,8704,9,1647347692
7688,398486760,134956,398621716,3,0,0,54784,9,971564261
7689,398492870,112139,398605009,5,0,0,30208,11,8862679446
7690,398521100,122045,398643145,6,0,0,11264,9,2135149652
7691,398589490,55748,398645238,6,0,0,4096,9,3706177482
7692,398617180,55200,398672380,4,0,0,2560,6,3185228181
7693,398635630,119611,398755241,2,0,0,16384,4,739106748
7694,398703899,73584,398777483,0,0,0,2560,10,6913619578
7695,399111191,13341,399124532,5,0,1,22528,11,3721116658
7696,399163010,4850,399167860,1,0,1,5120,14,2048067743
7697,399174851,13858,399188709,5,0,1,23552,11,5219164699
7698,399243980,54680,399298660,2,0,0,5632,4,3826211931
7699,399329190,97604,399426794,8,0,0,20480,12,10160926932
7700,399347610,105032,399452642,2,0,0,29696,4,3866675696
7701,399349720,87454,399437174,2,0,0,9216,4,687714084
7702,399364300,104680,399468980,4,0,0,1536,6,9810456044
7703,399442780,76520,399519300,6,0,0,11776,9,9066978632
7704,399596160,67592,399663752,5,0,0,7680,11,2402789315
7705,399630290,93620,399723910,4,0,0,22528,6,4512156303
7706,399631280,105494,399736774,2,0,0,14336,4,6895138227
7707,399650989,161487,399812476,0,0,0,34816,10,1746352265
7708,399655019,228293,399883312,0,0,0,105984,10,10102947612
7709,399703390,186570,399889960,2,0,0,16896,4,2187461268
7710,399727571,1042,399728613,5,0,1,1024,11,2186403884
7711,399839429,127085,399966514,0,0,0,55296,10,3157979298
7712,399851031,38944,399889975,2,0,1,3072,4,10021336697
7713,399913450,121818,400035268,7,0,0,34816,18,3896026765
7714,399933869,90776,400024645,0,0,0,18432,10,7413881810
7715,399941260,103695,400044955,3,0,0,31744,9,10605543721
7716,400048819,87608,400136427,0,0,0,17920,10,10478782625
7717,400059100,50828,400109928,5,0,0,3072,11,8698566939
7718,400119180,87896,400207076,4,0,0,13824,6,1855424257
7719,400123840,93488,400217328,9,0,0,27136,10,3238930371
7720,400124840,102175,400227015,4,0,0,31744,6,8280682880
7721,400165529,130529,400296058,0,0,0,54272,10,1386179652
7722,400242600,118462,400361062,7,0,0,13312,18,2624487848
7723,400383800,82820,400466620,7,0,0,12288,18,565060225
7724,400410531,5802,400416333,5,0,1,6144,11,6908906526
7725,400421420,131666,400553086,4,0,0,68096,6,5115244887
7726,400426650,182764,400609414,7,0,0,91648,18,1625724969
7727,400497160,1518,400498678,8,0,1,1536,12,7783160380
7728,400599820,14265,400614085,1,0,1,12288,14,8097235325
7729,400635060,102908,400737968,8,0,0,37888,12,4769757219
7730,400738250,104156,400842406,1,0,0,41984,14,10318242795
7731,400755731,7706,400763437,6,0,1,8192,9,3736295531
7732,400783290,63016,400846306,2,0,0,7168,4,7441270673
7733,400790220,98620,400888840,5,0,0,11776,11,2944318242
7734,400873479,4374,400877853,3,0,1,4608,9,5803925375
7735,400883220,171862,401055082,1,0,0,1536,14,6322324611
7736,400888240,2110,400890350,1,0,1,1536,14,307173462
7737,400968210,58532,401026742,8,0,0,8192,12,1597690583
7738,400986290,83312,401069602,4,0,0,18944,6,7711096463
7739,401010571,7230,401017801,6,0,1,7680,9,2680401031
7740,401030681,7706,401038387,6,0,1,8192,9,10340787548
7741,401100991,6278,401107269,6,0,1,6656,9,2739423809
7742,401138310,101192,401239502,5,0,0,32256,11,5147238279
7743,401200830,103844,401304674,6,0,0,40960,9,10119520006
7744,401248090,89668,401337758,1,0,0,6144,14,10157793758
7745,401262250,103330,401365580,5,0,0,17920,11,8645495326
7746,401273140,105382,401378522,5,0,0,18944,11,2560847847
7747,401367280,104156,401471436,8,0,0,41984,12,7675629750
7748,401414450,120190,401534640,6,0,0,10240,9,7077207041
7749,401559510,76052,401635562,2,0,0,10240,4,3861569568
7750,401626340,9237,401635577,1,0,1,6656,14,9242075751
7751,401674070,74516,401748586,1,0,0,10240,14,694665311
7752,401892380,57908,401950288,3,0,0,6144,9,4984845685
7753,401892419,116326,402008745,0,0,0,81920,10,3817574820
7754,401974891,3898,401978789,2,0,1,4096,4,1006046587
7755,401993130,115863,402108993,6,0,0,29184,9,8547644420
7756,402046490,155251,402201741,3,0,0,74240,9,9921896649
7757,402056039,186076,402242115,0,0,0,29184,10,4695510693
7758,402058660,148868,402207528,4,0,0,18944,6,6294053197
7759,402100750,108353,402209103,2,0,0,5120,4,6077231138
7760,402152470,3128,402155598,1,0,1,9216,14,10602613332
7761,402330840,69596,402400436,6,0,0,9216,9,9015916716
7762,402333020,102128,402435148,6,0,0,35328,9,9773515745
7763,402405330,6278,402411608,8,0,1,6656,12,8317465667
7764,402436109,102752,402538861,0,0,0,37376,10,9040832008
7765,402504520,68517,402573037,9,0,0,6144,10,2608107143
7766,402651570,58844,402710414,3,0,0,9216,9,1233248151
7767,402725070,81908,402806978,6,0,0,14336,9,9410760581
7768,402796429,80996,402877425,0,0,0,16384,10,5783191124
7769,402845550,86204,402931754,3,0,0,13312,9,9923015905
7770,402847880,3898,402851778,9,0,1,4096,10,4209385150
7771,402893430,100298,402993728,7,0,0,7680,18,8406438747
7772,402904290,97292,403001582,6,0,0,19456,9,2830978173
7773,402923150,108680,403031830,6,0,0,56832,9,8686283213
7774,402935320,131428,403066748,6,0,0,20480,9,6768742961
7775,402949120,95242,403044362,1,0,0,21504,14,7440965537
7776,403026680,113826,403140506,4,0,0,37376,6,6408126337
7777,403105641,7230,403112871,6,0,1,7680,9,9939572755
7778,403177499,16096,403193595,3,0,1,31232,9,5558335818
7779,403208580,3898,403212478,0,0,1,4096,10,1360112713
7780,403308240,100412,403408652,2,0,0,29696,4,4984137562
7781,403324930,62516,403387446,2,0,0,6144,4,2349245217
7782,403363739,65170,403428909,3,0,1,110080,9,6778074103
7783,403444260,121834,403566094,2,0,0,19968,4,9190599225
7784,403509820,205006,403714826,5,0,0,94208,11,5922964262
7785,403512040,58688,403570728,9,0,0,8704,10,7613564148
7786,403522820,97604,403620424,7,0,0,20480,18,2488198327
7787,403546710,2946,403549656,4,0,1,3072,6,10632866616
7788,403557829,187034,403744863,0,0,0,23040,10,7989361216
7789,403634620,98454,403733074,5,0,0,26112,11,8322625217
7790,403849169,101504,403950673,0,0,0,33280,10,1952307210
7791,403863560,99788,403963348,5,0,0,27648,11,3280333686
7792,404025950,93644,404119594,7,0,0,27648,18,511202980
7793,404060930,101660,404162590,3,0,0,33792,9,8392812241
7794,404069400,147270,404216670,9,0,0,40448,10,1498292792
7795,404086980,134697,404221677,6,0,0,16384,9,3785356265
7796,404102230,101816,404204046,2,0,0,34304,4,9681759354
7797,404266630,101036,404367666,6,0,0,31744,9,5398900170
7798,404330690,11791,404342481,9,0,1,19456,10,8310331948
7799,404351430,130884,404482314,2,0,0,61440,4,4640846073
7800,404372230,149829,404522059,4,0,0,35328,6,1551418415
7801,404427460,181431,404608891,5,0,0,30720,11,2014030425
7802,404428550,145979,404574529,3,0,0,14848,9,2660396603
7803,404455621,4850,404460471,6,0,1,5120,9,4904863689
7804,404568600,5944,404574544,9,0,1,4608,10,9072319219
7805,404849930,81097,404931027,2,0,0,13824,4,10245996454
7806,404860120,66680,404926800,1,0,0,9728,14,7431758895
7807,404867450,124997,404992447,3,0,0,25088,9,7120490497
7808,404877770,107018,404984788,3,0,0,30720,9,7692445099
7809,404894050,6754,404900804,9,0,1,7168,10,2400192639
7810,404900200,93666,404993866,5,0,0,4608,11,7206589510
7811,404990670,176770,405167440,7,0,0,3584,18,4243667299
7812,405009371,10241,405019612,2,0,1,16384,4,8449187342
7813,405024640,113412,405138052,5,0,0,34304,11,2628818140
7814,405061709,104624,405166333,0,0,0,43520,10,258208354
7815,405066680,2470,405069150,8,0,1,2560,12,1606506500
7816,405088100,86687,405174787,1,0,0,4608,14,670721962
7817,405125631,12444,405138075,5,0,1,7168,11,7119474621
7818,405129310,67011,405196321,6,0,0,3584,9,5203837885
7819,405135860,8495,405144355,7,0,1,6656,18,6236649330
7820,405170329,113799,405284128,0,0,0,26112,10,7054651303
7821,405182630,88818,405271448,1,0,0,20992,14,7749329513
7822,405192210,97234,405289444,2,0,0,13312,4,7084265841
7823,405241789,15321,405257110,3,0,1,29696,9,655996362
7824,405654620,10757,405665377,9,0,1,17408,10,690679334
7825,405655970,51291,405707261,2,0,0,1536,4,1347399346
7826,405746821,6278,405753099,6,0,1,6656,9,5740387230
7827,405800230,72824,405873054,2,0,0,9728,4,128049183
7828,405846200,94556,405940756,7,0,0,25600,18,8216989511
7829,405944309,56079,406000388,3,0,1,95744,9,5520071027
7830,405983610,200372,406183982,4,0,0,6144,6,6945471196
7831,406075170,118777,406193947,7,0,0,5632,18,5846913
7832,406179889,52832,406232721,0,0,0,4608,10,6107061303
7833,406197330,79460,406276790,4,0,0,16384,6,7652031762
7834,406290970,52364,406343334,6,0,0,3072,9,1001346960
7835,406313169,105228,406418397,0,0,0,28672,10,107913225
7836,406332790,76856,406409646,7,0,0,17920,18,1849124272
7837,406342850,14763,406357613,0,0,1,27648,10,9649944368
7838,406394449,6278,406400727,3,0,1,6656,9,3508205055
7839,406531360,2470,406533830,0,0,1,2560,10,10409189222
7840,406621129,56840,406677969,0,0,0,7680,10,5468457463
7841,406666701,15837,406682538,6,0,1,30720,9,3199695517
7842,406707830,127992,406835822,4,0,0,61952,6,8645330046
7843,406789510,164532,406954042,5,0,0,8192,11,229515916
7844,406796010,47288,406843298,9,0,0,1536,10,5313378971
7845,406799109,166843,406965952,0,0,0,33280,10,4174638240
7846,406813760,101972,406915732,9,0,0,34816,10,10493104570
7847,406815810,237038,407052848,1,0,0,20480,14,8703735703
7848,406840400,152246,406992646,6,0,0,18944,9,10323567514
7849,406878460,91996,406970456,3,0,0,7168,9,10621045038
7850,406952200,93762,407045962,6,0,0,22016,9,5297328911
7851,406980800,119010,407099810,1,0,0,37376,14,349687986
7852,407042390,103820,407146210,3,0,0,29184,9,7940482835
7853,407090280,110402,407200682,6,0,0,31232,9,9323232228
7854,407130810,98696,407229506,4,0,0,24064,6,1074150076
7855,407160839,4850,407165689,3,0,1,5120,9,8132863689
7856,407165939,13600,407179539,3,0,1,23040,9,418609924
7857,407189220,114064,407303284,4,0,0,40960,6,10034755353
7858,407279160,104299,407383459,9,0,0,2048,10,9013979924
7859,407296330,71154,407367484,9,0,0,6656,10,5827663660
7860,407313980,61136,407375116,5,0,0,6656,11,5627711452
7861,407368130,48806,407416936,7,0,0,512,18,644825386
7862,407390070,98696,407488766,6,0,0,24064,9,3006235706
7863,407417820,146312,407564132,1,0,0,38400,14,4864814122
7864,407455821,4850,407460671,5,0,1,5120,11,372876991
7865,407469050,3645,407472695,0,0,1,10240,10,1416044248
7866,407476040,94971,407571011,2,0,0,22528,4,6387278051
7867,407521040,245628,407766668,3,0,0,28160,9,10572349693
7868,407531600,101904,407633504,1,0,0,11776,14,2870781951
7869,407567950,111262,407679212,3,0,0,30720,9,924757470
7870,407574750,65900,407640650,7,0,0,7168,18,796589703
7871,407667790,170368,407838158,9,0,0,34816,10,6108979954
7872,407750760,59756,407810516,4,0,0,7168,6,6258835833
7873,407762110,7496,407769606,0,0,1,3072,10,9966829991
7874,407779721,14287,407794008,2,0,1,27648,4,2568385643
7875,407819260,58064,407877324,4,0,0,6656,6,7246549460
7876,407827820,109650,407937470,9,0,0,26112,10,2591667442
7877,407995370,74696,408070066,6,0,0,15872,9,9096424266
7878,408105979,2946,408108925,3,0,1,3072,9,4458290427
7879,408237090,55748,408292838,1,0,0,4096,14,3961556264
7880,408242730,66368,408309098,3,0,0,8704,9,4038757776
7881,408268030,123322,408391352,7,0,0,50688,18,4352832072
7882,408308310,100724,408409034,7,0,0,28160,18,6013542899
7883,408334180,81742,408415922,4,0,0,9216,6,6516377234
7884,408485850,3904,408489754,7,0,1,10752,18,2257183875
7885,408557550,52364,408609914,9,0,0,3072,10,2562445239
7886,408568240,71756,408639996,5,0,0,11264,11,4241509229
7887,408569750,134158,408703908,1,0,0,79872,14,6228935521
7888,408647880,75164,408723044,5,0,0,17408,11,6764393611
7889,408763091,10499,408773590,2,0,1,16896,4,9459646122
7890,408817740,72536,408890276,7,0,0,13824,18,10371126026
7891,408913880,64962,408978842,9,0,0,11776,10,6583063378
7892,408914610,101348,409015958,2,0,0,32768,4,8332285058
7893,408973639,103813,409077452,0,0,0,36864,10,4054094184
7894,409068500,10462,409078962,4,0,1,1536,6,9788157675
7895,409156010,72668,409228678,5,0,0,9216,11,4714530146
7896,409185560,78080,409263640,9,0,0,16896,10,3554975627
7897,409190700,4850,409195550,1,0,1,5120,14,10712345051
7898,409191950,100395,409292345,5,0,0,12288,11,2044843077
7899,409320110,76076,409396186,3,0,0,15360,9,7529724138
7900,409345410,107276,409452686,2,0,0,52224,4,10121825655
7901,409402830,124880,409527710,3,0,0,18944,9,8979097267
7902,409425930,1518,409427448,7,0,1,1536,18,10519944299
7903,409572089,47600,409619689,0,0,0,2560,10,8212115929
7904,409612820,70976,409683796,9,0,0,8704,10,399999117
7905,409725860,109304,409835164,6,0,0,58880,9,9511939622
7906,409739320,1518,409740838,8,0,1,1536,12,8207562439
7907,409778200,58227,409836427,2,0,0,4096,4,3152503542
7908,409810421,566,409810987,2,0,1,512,4,554332007
7909,409887330,136827,410024157,9,0,0,45056,10,2088064077
7910,409964090,7230,409971320,1,0,1,7680,14,8377317071
7911,409989060,54056,410043116,4,0,0,3584,6,1085993647
7912,410046691,3128,410049819,2,0,1,9216,4,3515113932
7913,410132370,49448,410181818,7,0,0,3584,18,9104093208
7914,410133360,59132,410192492,7,0,0,5120,18,8562354064
7915,410133911,12049,410145960,5,0,1,19968,11,6186030822
7916,410161280,1518,410162798,0,0,1,1536,10,4452933112
7917,410168710,100190,410268900,2,0,0,9216,4,940932762
7918,410186779,91829,410278608,0,0,0,15872,10,6422819887
7919,410238280,70118,410308398,6,0,0,6656,9,2667065402
7920,410287770,70688,410358458,1,0,0,12800,14,5767858165
7921,410312980,2470,410315450,0,0,1,2560,10,2790318846
7922,410364280,1518,410365798,9,0,1,1536,10,8991300071
7923,410386849,128340,410515189,0,0,0,70656,10,301156712
7924,410403100,131307,410534407,7,0,0,55296,18,2437040905
7925,410404230,113314,410517544,4,0,0,7680,6,4169591452
7926,410581200,101192,410682392,5,0,0,32256,11,10682819512
7927,410661190,91690,410752880,6,0,0,14336,9,4922612444
7928,410663291,2946,410666237,2,0,1,3072,4,10344893954
7929,410679680,80472,410760152,5,0,0,15872,11,470145548
7930,410710900,5802,410716702,8,0,1,6144,12,2135125872
7931,410722570,65900,410788470,9,0,0,7168,10,8762893964
7932,410769370,105248,410874618,7,0,0,45568,18,2196100769
7933,410810670,117462,410928132,6,0,0,18432,9,5731124802
7934,410901460,55904,410957364,6,0,0,4608,9,7970184956
7935,410903160,99738,411002898,1,0,0,11776,14,10518210803
7936,410935800,87980,411023780,6,0,0,13824,9,10689976638
7937,410991460,7230,410998690,8,0,1,7680,12,3858419609
7938,411141530,3645,411145175,1,0,1,10240,14,2495188006
7939,411151330,1518,411152848,7,0,1,1536,18,8253862294
7940,411165319,83088,411248407,0,0,0,9216,10,10643216164
7941,411188780,228093,411416873,3,0,0,1536,9,6226639405
7942,411195860,83000,411278860,3,0,0,17920,9,2719580051
7943,411237750,105560,411343310,1,0,0,46592,14,1687188480
7944,411298480,115540,411414020,2,0,0,50688,4,6962326776
7945,411330449,85941,411416390,0,0,0,7680,10,7131609017
7946,411360530,1518,411362048,4,0,1,1536,6,2802992049
7947,411398131,15904,411414035,5,0,1,10240,11,5275998364
7948,411436201,1994,411438195,2,0,1,2048,4,1478112345
7949,411644871,4374,411649245,5,0,1,4608,11,7619046630
7950,411775940,92528,411868468,2,0,0,18944,4,843834595
7951,411800171,12308,411812479,6,0,1,20480,9,3295808901
7952,411855341,5802,411861143,6,0,1,6144,9,715043063
7953,411859360,83539,411942899,2,0,0,18944,4,283212204
7954,411865570,102522,411968092,6,0,0,27136,9,2069566491
7955,411887220,121745,412008965,5,0,0,48128,11,7460151369
7956,411888690,1042,411889732,1,0,1,1024,14,3382702159
7957,411977980,2870,411980850,1,0,1,8704,14,310227820
7958,412100290,11274,412111564,9,0,1,18432,10,7292066240
7959,412165990,63764,412229754,4,0,0,10240,6,9355800468
7960,412237610,108992,412346602,3,0,0,57856,9,588031561
7961,412296370,69908,412366278,5,0,0,10240,11,3461020603
7962,412315500,118932,412434432,9,0,0,26112,10,1652301764
7963,412370270,93280,412463550,4,0,0,4608,6,10286551227
7964,412370820,138978,412509798,9,0,0,40448,10,3469807140
7965,412595180,55748,412650928,1,0,0,4096,14,7204929429
7966,412616620,94026,412710646,5,0,0,22528,11,5042608929
7967,412625800,99632,412725432,7,0,0,27136,18,3224720212
7968,412625851,566,412626417,2,0,1,512,4,10508068876
7969,412665360,75052,412740412,2,0,0,8192,4,10230140471
7970,412682280,102284,412784564,7,0,0,35840,18,4150070967
7971,412702430,8231,412710661,0,0,1,2048,10,9529358973
7972,412717460,14242,412731702,7,0,1,6656,18,5555314476
7973,412786371,3898,412790269,5,0,1,4096,11,2361574475
7974,412795240,84536,412879776,2,0,0,17920,4,6318756261
7975,412797780,5326,412803106,7,0,1,5632,18,5108733200
7976,412842180,70976,412913156,5,0,0,8704,11,9695882469
7977,412902531,3128,412905659,6,0,1,9216,9,903632713
7978,412907120,60313,412967433,7,0,0,2560,18,2402468866
7979,412935759,87788,413023547,0,0,0,23552,10,3198541318
7980,413010470,64388,413074858,7,0,0,12288,18,3885535539
7981,413027300,4850,413032150,7,0,1,5120,18,4379810457
7982,413111060,99788,413210848,7,0,0,27648,18,5325224303
7983,413130660,99008,413229668,3,0,0,25088,9,7767237785
7984,413356990,47288,413404278,3,0,0,1536,9,4883658975
7985,413513480,76988,413590468,1,0,0,13312,14,2962631641
7986,413540281,1042,413541323,5,0,1,1024,11,9881599714
7987,413562070,71509,413633579,2,0,0,9216,4,6393895740
7988,413568820,85760,413654580,6,0,0,16896,9,3503162519
7989,413622669,3898,413626567,3,0,1,4096,9,5815064498
7990,413629510,4084,413633594,8,0,1,9216,12,1060204821
7991,413678629,110552,413789181,0,0,0,62976,10,9616836172
7992,413682880,118640,413801520,3,0,0,40448,9,6688846550
7993,413782750,129314,413912064,5,0,0,62976,11,5383119438
7994,413841350,73233,413914583,5,0,0,8192,11,3382288397
7995,413852940,5326,413858266,9,0,1,5632,10,6320447737
7996,413896580,21349,413917929,4,0,1,9728,6,2162706069
7997,414002859,60824,414063683,0,0,0,5632,10,5017778353
7998,414020469,1518,414021987,3,0,1,1536,9,6387322066
7999,414099950,64208,414164158,3,0,0,6656,9,1509102251
8000,414161560,95936,414257496,2,0,0,25088,4,492205421
8001,414198780,215892,414414672,3,0,0,150528,9,6033746280
8002,414211320,6754,414218074,0,0,1,7168,10,9095711172
8003,414223450,96824,414320274,6,0,0,17920,9,1794638240
8004,414325480,128678,414454158,6,0,0,47104,9,5674425065
8005,414411640,100802,414512442,9,0,0,14336,10,6641558111
8006,414428490,94664,414523154,3,0,0,15872,9,3008873376
8007,414540730,101192,414641922,9,0,0,32256,10,4133389095
8008,414655491,1994,414657485,5,0,1,2048,11,667160470
8009,414658810,74794,414733604,2,0,0,8704,4,4691419790
8010,414659340,1994,414661334,4,0,1,2048,6,5290082735
8011,414682080,3422,414685502,8,0,1,3584,12,3793353474
8012,414881970,115232,414997202,4,0,0,78336,6,8322048974
8013,414885100,166432,415051532,7,0,0,28672,18,7339880169
8014,414947580,65900,415013480,5,0,0,7168,11,9700295617
8015,414967190,2946,414970136,1,0,1,3072,14,1234945856
8016,414991280,158892,415150172,4,0,0,52736,6,2973939581
8017,414995200,69611,415064811,5,0,0,7680,11,3682499210
8018,415107409,72824,415180233,0,0,0,9728,10,2670508653
8019,415142510,104214,415246724,2,0,0,27136,4,1079566345
8020,415222930,172942,415395872,5,0,0,59392,11,658037572
8021,415237260,112148,415349408,1,0,0,29184,14,3389418108
8022,415240960,53044,415294004,7,0,0,1536,18,2960813844
8023,415276371,1518,415277889,5,0,1,1536,11,82655714
8024,415289570,71616,415361186,1,0,0,11264,14,7424829261
8025,415336160,100256,415436416,2,0,0,29184,4,4253338070
8026,415350840,10361,415361201,7,0,1,7680,18,5578617119
8027,415406970,201182,415608152,3,0,0,187904,9,9377235074
8028,415489811,1042,415490853,2,0,1,1024,4,2975667607
8029,415491630,123416,415615046,7,0,0,22016,18,4537498377
8030,415516060,92263,415608323,2,0,0,512,4,3188459379
8031,415592681,45565,415638246,2,0,1,38400,4,10619041081
8032,415640701,1518,415642219,5,0,1,1536,11,6095291495
8033,415717560,77900,415795460,5,0,0,11264,11,694707595
8034,415726190,47288,415773478,2,0,0,1536,4,3970480133
8035,415731580,98852,415830432,3,0,0,24576,9,6736465837
8036,415778419,93185,415871604,0,0,0,11264,10,5792962713
8037,415799150,49180,415848330,7,0,0,1536,18,7044602813
8038,415822250,12995,415835245,4,0,1,25088,6,10220799051
8039,415842769,1518,415844287,3,0,1,1536,9,7242818446
8040,415943100,13770,415956870,0,0,1,26624,10,2900607152
8041,415946430,152531,416098961,1,0,0,22528,14,2330136501
8042,415962279,6754,415969033,3,0,1,7168,9,9914422937
8043,415965410,78837,416044247,9,0,0,8704,10,7323361881
8044,416007740,74360,416082100,5,0,0,9728,11,7327451625
8045,416053070,101643,416154713,4,0,0,6656,6,6810318588
8046,416197920,60824,416258744,9,0,0,5632,10,621500424
8047,416217350,104312,416321662,9,0,0,42496,10,7179553247
8048,416289430,78548,416367978,5,0,0,18432,11,4285206318
8049,416345970,86360,416432330,1,0,0,13824,14,1590693951
8050,416572440,86540,416658980,2,0,0,19456,4,9536021251
8051,416580101,3898,416583999,2,0,1,4096,4,8899450596
8052,416596120,78860,416674980,7,0,0,19456,18,3622925003
8053,416648280,10715,416658995,4,0,1,15872,6,4757678822
8054,416670620,10630,416681250,8,0,1,6656,12,9070161303
8055,416740900,145099,416885999,1,0,0,11264,14,254920916
8056,416757350,147081,416904431,9,0,0,11264,10,493320228
8057,416770810,191827,416962637,4,0,0,34816,6,9291248849
8058,416812000,174031,416986031,2,0,0,4608,4,7262073820
8059,416936680,132511,417069191,3,0,0,116224,9,10028275302
8060,416964570,143388,417107958,2,0,0,34304,4,9080925084
8061,417018700,154610,417173310,9,0,0,82432,10,4804490066
8062,417031700,200308,417232008,1,0,0,47104,14,6261299848
8063,417058950,173853,417232803,1,0,0,2560,14,1879112100
8064,417099760,89792,417189552,3,0,0,1536,9,3616985346
8065,417144250,93716,417237966,5,0,0,16896,11,8549173470
8066,417150999,112851,417263850,9,0,0,22528,10,6195593836
8067,417212010,566,417212576,8,0,1,512,12,6694494544
8068,417215900,119908,417335808,9,0,0,30720,10,3766638964
8069,417286710,165164,417451874,4,0,0,146432,6,7557350898
8070,417383830,69151,417452981,4,0,0,3584,6,3328753882
8071,417551790,75476,417627266,1,0,0,18432,14,6134360139
8072,417558170,12308,417570478,0,0,1,20480,10,4033706940
8073,417571390,6278,417577668,8,0,1,6656,12,1080312412
8074,417667570,135556,417803126,1,0,0,45056,14,4857150645
8075,417684210,58220,417742430,5,0,0,7168,11,9625001939
8076,417697130,72291,417769421,5,0,0,7168,11,939174053
8077,417919519,45596,417965115,0,0,0,1024,10,4103341048
8078,417977280,57440,418034720,1,0,0,4608,14,4226969613
8079,418051980,101504,418153484,3,0,0,33280,9,9798834055
8080,418139880,13619,418153499,9,0,1,8192,10,4447814802
8081,418152480,100955,418253435,1,0,0,28160,14,623814645
8082,418186830,143333,418330163,1,0,0,30720,14,7224013526
8083,418205170,109033,418314203,4,0,0,33792,6,2440689737
8084,418212970,129580,418342550,5,0,0,17408,11,1317539778
8085,418213560,59012,418272572,5,0,0,5632,11,9785995448
8086,418213709,142524,418356233,0,0,0,14336,10,2007657026
8087,418254670,60016,418314686,1,0,0,1536,14,3189205912
8088,418312840,76198,418389038,9,0,0,9728,10,5718651528
8089,418350380,43904,418394284,2,0,0,512,4,946698082
8090,418392520,11016,418403536,8,0,1,17920,12,7615981444
8091,418418680,14287,418432967,7,0,1,27648,18,294061864
8092,418445039,1042,418446081,3,0,1,1024,9,6217104314
8093,418448330,51300,418499630,7,0,0,2560,18,2146563307
8094,418492021,13512,418505533,5,0,1,26112,11,9881609547
8095,418625890,4374,418630264,0,0,1,4608,10,10061708096
8096,418658200,48980,418707180,4,0,0,2048,6,2242518114
8097,418692760,6278,418699038,9,0,1,6656,10,6061192456
8098,418793580,54524,418848104,5,0,0,5120,11,5255864283
8099,418837420,113692,418951112,8,0,0,43520,12,8609903586
8100,418854740,104031,418958771,4,0,0,25088,6,9406645351
8101,418870140,141350,419011490,9,0,0,38912,10,1769705935
8102,418930290,61978,418992268,7,0,0,3072,18,263479488
8103,418980730,47288,419028018,5,0,0,1536,11,5186876363
8104,419062390,83912,419146302,2,0,0,15872,4,4299342999
8105,419173070,101816,419274886,1,0,0,34304,14,6586087385
8106,419262920,60824,419323744,2,0,0,5632,4,5497068369
8107,419290480,4162,419294642,9,0,1,11264,10,2964164003
8108,419302120,98072,419400192,2,0,0,22016,4,3074476858
8109,419337110,102440,419439550,5,0,0,36352,11,6648440009
8110,419352580,147276,419499856,2,0,0,16384,4,2476466913
8111,419467530,124882,419592412,7,0,0,20480,18,9300930425
8112,419538140,117266,419655406,5,0,0,49664,11,1129201034
8113,419732560,78524,419811084,5,0,0,13312,11,2930348858
8114,419825020,60824,419885844,5,0,0,5632,11,10003334408
8115,419913700,105716,420019416,1,0,0,47104,14,800150155
8116,419914460,160225,420074685,1,0,0,45568,14,3497388397
8117,419960530,100256,420060786,1,0,0,29184,14,315227928
8118,420005610,182622,420188232,5,0,0,34304,11,4001208449
8119,420032260,128036,420160296,3,0,0,103936,9,8478599551
8120,420102721,6278,420108999,2,0,1,6656,4,6745576007
8121,420122500,122210,420244710,9,0,0,16896,10,1851297177
8122,420122560,3387,420125947,8,0,1,9728,12,7118013080
8123,420221960,116573,420338533,9,0,0,25088,10,1955647888
8124,420270799,56921,420327720,0,0,0,7680,10,7855042805
8125,420270880,94712,420365592,7,0,0,26112,18,6027590151
8126,420280069,2946,420283015,3,0,1,3072,9,9817109702
8127,420321470,109945,420431415,3,0,0,13312,9,7667682123
8128,420401121,5326,420406447,5,0,1,5632,11,2392013448
8129,420465490,100880,420566370,9,0,0,31232,10,5313927787
8130,420490280,5326,420495606,4,0,1,5632,6,359619125
8131,420491030,134254,420625284,1,0,0,41984,14,3900701576
8132,420594100,65900,420660000,3,0,0,7168,9,2289869831
8133,420641580,54992,420696572,7,0,0,6656,18,3930474009
8134,420686869,102128,420788997,0,0,0,35328,10,3466917938
8135,420704710,94664,420799374,1,0,0,15872,14,4208700030
8136,420729860,148921,420878781,3,0,0,70656,9,1862995631
8137,420820310,114829,420935139,9,0,0,27648,10,8825627386
8138,420841650,108792,420950442,1,0,0,50176,14,8264801635
8139,420861850,120358,420982208,9,0,0,34304,10,5524898862
8140,420889430,159876,421049306,7,0,0,21504,18,9804998806
8141,420979260,122714,421101974,4,0,0,35840,6,3037804137
8142,421108280,117572,421225852,5,0,0,86016,11,6947690904
8143,421180081,3422,421183503,5,0,1,3584,11,5359582853
8144,421328590,113672,421442262,3,0,0,73216,9,1830835055
8145,421375560,120588,421496148,3,0,0,27136,9,5790129098
8146,421390600,7230,421397830,4,0,1,7680,6,4449896121
8147,421413500,129557,421543057,2,0,0,28672,4,7747012281
8148,421485270,10901,421496171,4,0,1,6144,6,4036645454
8149,421490859,10131,421500990,3,0,1,5120,9,6197907959
8150,421498110,87426,421585536,6,0,0,10752,9,10719216269
8151,421537130,180093,421717223,5,0,0,1536,11,10529840454
8152,421604280,79772,421684052,5,0,0,17408,11,7543346960
8153,421672640,80060,421752700,3,0,0,13312,9,7890242841
8154,421737240,92972,421830212,3,0,0,15360,9,2718446463
8155,421747300,566,421747866,4,0,1,512,6,4365237020
8156,421755279,3898,421759177,3,0,1,4096,9,9889773062
8157,421842130,117884,421960014,2,0,0,87040,4,842211276
8158,421988870,59132,422048002,7,0,0,5120,18,3250066176
8159,422040259,48980,422089239,9,0,0,2048,10,10107841074
8160,422119120,49292,422168412,2,0,0,3072,4,2050589147
8161,422159840,97448,422257288,3,0,0,19968,9,10557943739
8162,422183400,154894,422338294,6,0,0,57856,9,8757804714
8163,422191620,65839,422257459,3,0,0,512,9,4256323247
8164,422313609,100724,422414333,0,0,0,30720,10,3416388019
8165,422335140,105586,422440726,6,0,0,36352,9,9288873738
8166,422356960,5326,422362286,4,0,1,5632,6,2031626237
8167,422417930,94064,422511994,3,0,0,18944,9,5309577760
8168,422557280,6229,422563509,1,0,1,15360,14,762748020
8169,422563150,64568,422627718,3,0,0,512,9,9808325166
8170,422585320,84380,422669700,6,0,0,17408,9,1593809334
8171,422622190,109628,422731818,5,0,0,42496,11,3709594327
8172,422685830,4162,422689992,4,0,1,11264,6,10373054466
8173,422841710,109304,422951014,6,0,0,58880,9,6481832304
8174,422981250,104468,423085718,5,0,0,43008,11,3827010735
8175,423012460,118144,423130604,9,0,0,43008,10,7067502454
8176,423038280,123062,423161342,6,0,0,6656,9,7106888608
8177,423042710,160920,423203630,6,0,0,49664,9,6206249698
8178,423083900,46875,423130775,1,0,0,512,14,8438183572
8179,423137720,106808,423244528,5,0,0,50688,11,6634530123
8180,423180480,99220,423279700,2,0,0,2560,4,7472833949
8181,423223220,66056,423289276,6,0,0,7680,9,7011148412
8182,423234290,112202,423346492,3,0,0,34816,9,7014402328
8183,423309400,92484,423401884,4,0,0,7680,6,4729551938
8184,423318701,2470,423321171,2,0,1,2560,4,3466465764
8185,423461070,81752,423542822,3,0,0,13824,9,6420561401
8186,423488219,79161,423567380,0,0,0,2560,10,9908826369
8187,423682010,1518,423683528,7,0,1,1536,18,9362774774
8188,423711220,64364,423775584,7,0,0,7168,18,7975028252
8189,423719860,123596,423843456,5,0,0,68608,11,9218492429
8190,423841850,77650,423919500,9,0,0,10240,10,6822860163
8191,423877630,71132,423948762,5,0,0,9216,11,5586019341
8192,423879081,3422,423882503,2,0,1,3584,4,10714104276
8193,423947651,3573,423951224,6,0,1,2560,9,2502504647
8194,423958400,65900,424024300,2,0,0,7168,4,2516393217
8195,423961680,36863,423998543,1,0,1,65024,14,8144545603
8196,423963530,125235,424088765,5,0,0,5632,11,7108378747
8197,424038249,4374,424042623,3,0,1,4608,9,8272674228
8198,424103850,47288,424151138,9,0,0,1536,10,8425556545
8199,424104720,93482,424198202,2,0,0,14848,4,919681086
8200,424128020,77136,424205156,5,0,0,16384,11,8064806378
8201,424137640,7230,424144870,0,0,1,7680,10,7886982391
8202,424151259,67592,424218851,0,0,0,7680,10,10267053695
8203,424191150,74696,424265846,7,0,0,15872,18,7622896651
8204,424262981,9611,424272592,6,0,1,7168,9,8603417885
8205,424299310,47288,424346598,4,0,0,1536,6,923223201
8206,424450930,86072,424537002,2,0,0,17920,4,6834232307
8207,424511210,2946,424514156,7,0,1,3072,18,9865651430
8208,424543880,4850,424548730,4,0,1,5120,6,3790692794
8209,424564379,4850,424569229,3,0,1,5120,9,3057156684
8210,424655070,98852,424753922,7,0,0,24576,18,8564921328
8211,424737170,108056,424845226,7,0,0,54784,18,4584271976
8212,424846721,4937,424851658,2,0,1,12800,4,6711503906
8213,424942920,83756,425026676,2,0,0,15360,4,2696198617
8214,425051791,6754,425058545,5,0,1,7168,11,6939480655
8215,425057620,95444,425153064,5,0,0,18432,11,8072412119
8216,425108620,6278,425114898,1,0,1,6656,14,3988803883
8217,425149080,77448,425226528,5,0,0,16896,11,7420731372
8218,425161730,76726,425238456,7,0,0,5632,18,6076254987
8219,425246370,1994,425248364,1,0,1,2048,14,381928887
8220,425277460,84512,425361972,1,0,0,12800,14,9266476611
8221,425315519,158039,425473558,0,0,0,56320,10,1949474991
8222,425336180,76766,425412946,1,0,0,3584,14,10320966653
8223,425379200,72856,425452056,9,0,0,13824,10,1233151890
8224,425400010,124610,425524620,5,0,0,12800,11,4315595895
8225,425514520,92552,425607072,3,0,0,24064,9,1748191940
8226,425545240,3128,425548368,4,0,1,9216,6,4820823651
8227,425642130,1042,425643172,8,0,1,1024,12,3998141269
8228,425717920,116104,425834024,7,0,0,40960,18,8550062561
8229,425723281,2946,425726227,6,0,1,3072,9,2483571079
8230,425737860,122882,425860742,1,0,0,31744,14,9501704612
8231,425907280,50672,425957952,4,0,0,2560,6,6421953330
8232,426119870,110708,426230578,7,0,0,63488,18,7758616619
8233,426170930,126458,426297388,7,0,0,54784,18,6178983725
8234,426286670,109313,426395983,4,0,0,26112,6,2555610091
8235,426298669,89343,426388012,0,0,0,7680,10,3535164634
8236,426356390,112736,426469126,2,0,0,70144,4,4338412582
8237,426360990,124732,426485722,7,0,0,38912,18,8674511771
8238,426481960,85974,426567934,4,0,0,15360,6,1694765449
8239,426506150,158255,426664405,9,0,0,78336,10,4703827014
8240,426509310,131212,426640522,1,0,0,65536,14,8978379981
8241,426538900,132274,426671174,7,0,0,17408,18,9688929033
8242,426548170,5196,426553366,9,0,1,13312,10,6309820786
8243,426596370,76223,426672593,2,0,0,4608,4,8568678372
8244,426603130,83733,426686863,5,0,0,9216,11,6292392584
8245,426716450,3898,426720348,8,0,1,4096,12,182208277
8246,426824350,3898,426828248,9,0,1,4096,10,6066616315
8247,426845241,3898,426849139,5,0,1,4096,11,9567740010
8248,426918970,1994,426920964,4,0,1,2048,6,3262444465
8249,426922580,59132,426981712,3,0,0,5120,9,9216983564
8250,426952410,5326,426957736,9,0,1,5632,10,567667386
8251,427006541,3422,427009963,6,0,1,3584,9,1353839864
8252,427043559,113984,427157543,0,0,0,74240,10,7822124861
8253,427121020,36538,427157558,1,0,1,31744,14,7878006248
8254,427288210,76208,427364418,4,0,0,10752,6,9042123720
8255,427302340,58376,427360716,7,0,0,7680,18,7989108979
8256,427390510,68528,427459038,2,0,0,10752,4,2755399513
8257,427404279,56022,427460301,0,0,0,4096,10,2030707404
8258,427477930,68840,427546770,5,0,0,11776,11,6900914382
8259,427673220,1994,427675214,1,0,1,2048,14,1277189842
8260,427680860,108212,427789072,4,0,0,55296,6,3543937465
8261,427688720,124580,427813300,7,0,0,13824,18,9168286137
8262,427738160,148502,427886662,2,0,0,26624,4,3197787563
8263,427747019,55748,427802767,0,0,0,4096,10,6691150402
8264,427759740,189322,427949062,5,0,0,100352,11,7783656643
8265,427780290,229318,428009608,9,0,0,66048,10,7573360544
8266,427809260,101832,427911092,3,0,0,3072,9,10671647007
8267,427838240,115829,427954069,4,0,0,16384,6,7708910718
8268,427847789,182605,428030394,0,0,0,512,10,1641439682
8269,427859650,184034,428043684,7,0,0,29696,18,6527673093
8270,427869360,160855,428030215,9,0,0,67584,10,8405644574
8271,427942479,92142,428034621,0,0,0,13824,10,2400799979
8272,428008210,77901,428086111,2,0,0,4608,4,7426409205
8273,428120600,1518,428122118,9,0,1,1536,10,1547926887
8274,428124520,13512,428138032,4,0,1,26112,6,10346164044
8275,428168630,101816,428270446,9,0,0,34304,10,219662815
8276,428215900,111337,428327237,4,0,0,32256,6,5089704797
8277,428230719,2946,428233665,3,0,1,3072,9,6208860267
8278,428230800,78648,428309448,2,0,0,10752,4,7928956062
8279,428256730,13731,428270461,9,0,1,4096,10,6114245724
8280,428277290,566,428277856,0,0,1,512,10,2527914001
8281,428464790,103844,428568634,4,0,0,40960,6,10217272480
8282,428489850,54992,428544842,4,0,0,6656,6,3525643065
8283,428536121,6229,428542350,5,0,1,15360,11,3070406134
8284,428777899,69464,428847363,0,0,0,13824,10,9218997040
8285,428845450,77580,428923030,2,0,0,10240,4,5303619791
8286,428857319,10241,428867560,3,0,1,16384,9,10647304611
8287,428869900,3904,428873804,9,0,1,10752,10,5416012924
8288,428879550,61448,428940998,2,0,0,7680,4,8726929777
8289,428905540,105017,429010557,7,0,0,16896,18,7596989025
8290,428949780,48980,428998760,3,0,0,2048,9,5609828106
8291,428975930,5326,428981256,4,0,1,5632,6,3716834797
8292,429124650,104312,429228962,4,0,0,42496,6,5493518069
8293,429161120,96756,429257876,3,0,0,10240,9,9085024019
8294,429210490,94220,429304710,7,0,0,19456,18,907776706
8295,429236550,76052,429312602,3,0,0,10240,9,4695556228
8296,429265039,128389,429393428,0,0,0,42496,10,4804670239
8297,429531980,54680,429586660,5,0,0,5632,11,3677543355
8298,429534250,76700,429610950,1,0,0,17408,14,811582989
8299,429534510,82588,429617098,4,0,0,3584,6,7997620942
8300,429589749,64208,429653957,0,0,0,6656,10,8498964767
8301,429677170,102440,429779610,4,0,0,36352,6,8746844330
8302,429849889,57752,429907641,0,0,0,5632,10,3945437885
8303,429905380,11274,429916654,4,0,1,18432,6,6653617380
8304,429929040,4374,429933414,4,0,1,4608,6,5827478176
8305,429934180,7230,429941410,1,0,1,7680,14,591710742
8306,429941830,108485,430050315,4,0,0,18944,6,1440700364
8307,430029040,274233,430303273,7,0,0,71168,18,3226187480
8308,430093859,93152,430187011,0,0,0,20992,10,10606829391
8309,430106720,143189,430249909,7,0,0,57344,18,202323198
8310,430131030,67592,430198622,7,0,0,7680,18,181178500
8311,430137430,49908,430187338,8,0,0,1024,12,6247964960
8312,430167420,240325,430407745,7,0,0,28672,18,2664616661
8313,430171040,167891,430338931,9,0,0,35840,10,977673163
8314,430193820,4817,430198637,9,0,1,2560,10,7779239963
8315,430294920,86779,430381699,9,0,0,2560,10,3765092783
8316,430316690,7230,430323920,1,0,1,7680,14,10005768332
8317,430350930,175562,430526492,2,0,0,56832,4,10288298149
8318,430363710,101036,430464746,8,0,0,31744,12,8485828737
8319,430486660,57657,430544317,6,0,0,3584,9,2315314463
8320,430492520,80808,430573328,7,0,0,6656,18,6254480319
8321,430567810,76052,430643862,6,0,0,10240,9,10127302301
8322,430603820,98852,430702672,3,0,0,24576,9,8600084910
8323,430604240,120448,430724688,5,0,0,42496,11,9718128164
8324,430607130,1994,430609124,0,0,1,2048,10,4179968186
8325,430767840,100724,430868564,5,0,0,30720,11,4910983574
8326,430823100,4420,430827520,0,0,1,11776,10,8164186636
8327,430887910,129627,431017537,8,0,0,86528,12,9070238554
8328,430895230,4850,430900080,4,0,1,5120,6,10245347363
8329,430899489,1257,430900746,3,0,1,1024,9,3973137
8330,430917490,2870,430920360,4,0,1,8704,6,1840431774
8331,431096991,2946,431099937,2,0,1,3072,4,10392696375
8332,431294770,107432,431402202,5,0,0,52736,11,5317301486
8333,431297710,121268,431418978,1,0,0,27136,14,4207359950
8334,431391310,80168,431471478,5,0,0,8192,11,3048287055
8335,431415180,102138,431517318,3,0,0,22528,9,1397847855
8336,431493650,119812,431613462,4,0,0,38400,6,6535317497
8337,431527080,155064,431682144,9,0,0,35840,10,1692031211
8338,431582010,43904,431625914,3,0,0,512,9,9041840730
8339,431710250,62516,431772766,8,0,0,6144,12,3655200178
8340,431754849,84559,431839408,0,0,0,19456,10,2230990256
8341,431776250,99560,431875810,5,0,0,11776,11,657360565
8342,431813100,78202,431891302,4,0,0,7168,6,5651378107
8343,431813150,91688,431904838,1,0,0,11264,14,6032223957
8344,431843630,70437,431914067,5,0,0,2560,11,8531219831
8345,431967330,54212,432021542,3,0,0,4096,9,3061208184
8346,431996820,47168,432043988,4,0,0,1024,6,5750855028
8347,432029270,99632,432128902,3,0,0,27136,9,9383597485
8348,432042870,3904,432046774,4,0,1,10752,6,9064874075
8349,432050130,88234,432138364,5,0,0,6656,11,7229889697
8350,432066810,67709,432134519,5,0,0,4096,11,1445672839
8351,432069720,44081,432113801,9,0,0,512,10,2648984354
8352,432076900,207143,432284043,1,0,0,50688,14,4542006824
8353,432129070,82556,432211626,4,0,0,21504,6,7813560041
8354,432161530,55748,432217278,6,0,0,4096,9,2155133225
8355,432173710,164783,432338493,4,0,0,26624,6,5320432453
8356,432221010,186371,432407381,2,0,0,1536,4,8495877967
8357,432305550,101348,432406898,7,0,0,32768,18,557421627
8358,432305801,4162,432309963,2,0,1,11264,4,10234689214
8359,432319119,107789,432426908,0,0,0,1536,10,2758031703
8360,432392160,60824,432452984,7,0,0,5632,18,698832943
8361,432395980,45596,432441576,3,0,0,1024,9,9162112847
8362,432428540,95826,432524366,9,0,0,22016,10,1490115459
8363,432481879,106964,432588843,0,0,0,51200,10,869955362
8364,432483700,147095,432630795,3,0,0,22528,9,9611742805
8365,432509420,148825,432658245,7,0,0,5632,18,6908826485
8366,432515951,8430,432524381,5,0,1,8192,11,8106802671
8367,432566739,81432,432648171,0,0,0,11776,10,5152085491
8368,432637700,125562,432763262,7,0,0,15872,18,6708611297
8369,432709770,96038,432805808,2,0,0,8192,4,9252445160
8370,432724580,82740,432807320,6,0,0,3072,9,10464090617
8371,432771070,69284,432840354,2,0,0,8192,4,8565163084
8372,432789880,117952,432907832,1,0,0,33280,14,8720531965
8373,432867440,98072,432965512,1,0,0,22016,14,9849698716
8374,432884940,98612,432983552,8,0,0,17408,12,6632284372
8375,432991860,56216,433048076,4,0,0,5632,6,9228458745
8376,433005570,106184,433111754,5,0,0,48640,11,9553875553
8377,433009910,52364,433062274,4,0,0,3072,6,7170136812
8378,433021540,95393,433116933,9,0,0,16896,10,2280586946
8379,433033910,11533,433045443,7,0,1,18944,18,298985878
8380,433103160,143208,433246368,4,0,0,67072,6,2521359797
8381,433107130,198686,433305816,7,0,0,100864,18,10195697524
8382,433122469,11791,433134260,3,0,1,19456,9,8381523979
8383,433138580,5196,433143776,0,0,1,13312,10,4762709003
8384,433161360,5326,433166686,0,0,1,5632,10,601637622
8385,433294510,211898,433506408,9,0,0,99840,10,3901446116
8386,433324920,129630,433454550,6,0,0,10752,9,3713236101
8387,433352950,111758,433464708,8,0,0,7680,12,1242849067
8388,433441430,66865,433508295,1,0,0,6144,14,375784903
8389,433465440,47288,433512728,9,0,0,1536,10,5692956841
8390,433515900,7706,433523606,0,0,1,8192,10,9179169646
8391,433524480,2946,433527426,7,0,1,3072,18,5277864101
8392,433553749,1994,433555743,3,0,1,2048,9,6001526086
8393,433554560,129817,433684377,5,0,0,11264,11,1837627285
8394,433617590,88741,433706331,5,0,0,1536,11,10490548862
8395,433624260,104936,433729196,3,0,0,44544,9,4826738213
8396,433746980,83312,433830292,2,0,0,18944,4,2657971720
8397,433847360,88412,433935772,6,0,0,25600,9,5603157733
8398,433848860,7706,433856566,1,0,1,8192,14,2818985513
8399,433888230,120748,434008978,7,0,0,37888,18,7433126847
8400,433889700,107500,433997200,7,0,0,8192,18,3782899821
8401,433935120,93004,434028124,4,0,0,18944,6,10553147653
8402,433986330,52364,434038694,4,0,0,3072,6,9238924845
8403,434011960,68216,434080176,8,0,0,9728,12,3440337051
8404,434139860,102128,434241988,4,0,0,35328,6,7120158729
8405,434249810,69308,434319118,8,0,0,13312,12,8746965233
8406,434387649,6278,434393927,3,0,1,6656,9,5845685633
8407,434450500,100100,434550600,3,0,0,28672,9,758396279
8408,434452550,36863,434489413,4,0,1,65024,6,9303056156
8409,434462589,181474,434644063,0,0,0,25600,10,5910017933
8410,434511370,87146,434598516,6,0,0,12288,9,10474294782
8411,434575400,95074,434670474,9,0,0,20480,10,8946859333
8412,434718620,95648,434814268,2,0,0,29184,4,4468611234
8413,434807340,121840,434929180,1,0,0,77312,14,5287741006
8414,434817600,3898,434821498,8,0,1,4096,12,7149878813
8415,434877480,128494,435005974,3,0,0,101376,9,449495041
8416,434936990,88862,435025852,5,0,0,9216,11,6970734685
8417,435087720,47288,435135008,9,0,0,1536,10,1831673232
8418,435107180,43904,435151084,4,0,0,512,6,2493771467
8419,435179160,65900,435245060,1,0,0,7168,14,2832904453
8420,435193460,74072,435267532,3,0,0,13824,9,10367193065
8421,435206390,63341,435269731,1,0,0,7168,14,3961118140
8422,435281780,24154,435305934,9,0,1,43520,10,103199772
8423,435287860,95157,435383017,6,0,0,17920,9,10727666290
8424,435325350,63115,435388465,3,0,0,512,9,2755791695
8425,435381211,2364,435383575,5,0,1,512,11,9292543614
8426,435429181,3645,435432826,2,0,1,10240,4,8930074629
8427,435453610,100880,435554490,1,0,0,31232,14,9274841125
8428,435770431,4850,435775281,6,0,1,5120,9,932795833
8429,435813920,59132,435873052,1,0,0,5120,14,3235271604
8430,435821280,106496,435927776,4,0,0,49664,6,7878646068
8431,435847730,119706,435967436,7,0,0,512,18,5376094645
8432,435854070,110396,435964466,6,0,0,62464,9,9112171417
8433,435910180,122878,436033058,2,0,0,33280,4,4184156238
8434,435953160,18052,435971212,1,0,1,7168,14,9797980147
8435,435989510,206828,436196338,1,0,0,17920,14,2418670737
8436,436093370,80216,436173586,9,0,0,13824,10,8645229190
8437,436276070,107588,436383658,4,0,0,53248,6,7360794629
8438,436405639,92864,436498503,0,0,0,25088,10,10441776262
8439,436493720,89599,436583319,8,0,0,13824,12,8267122787
8440,436496170,70502,436566672,5,0,0,9216,11,3379045017
8441,436503220,45596,436548816,9,0,0,1024,10,3585609203
8442,436531131,3128,436534259,5,0,1,9216,11,8674178304
8443,436540630,1518,436542148,9,0,1,1536,10,5465155725
8444,436606470,57440,436663910,8,0,0,4608,12,2487284680
8445,436648531,10241,436658772,6,0,1,16384,9,1297342967
8446,436662000,119624,436781624,8,0,0,20480,12,7245470072
8447,436679430,67592,436747022,7,0,0,7680,18,2138050623
8448,437084400,82820,437167220,3,0,0,12288,9,10518103010
8449,437182990,6278,437189268,8,0,1,6656,12,10138248117
8450,437268930,6278,437275208,7,0,1,6656,18,10044950452
8451,437278950,102908,437381858,9,0,0,37888,10,5366372042
8452,437320730,161974,437482704,8,0,0,13312,12,9953349302
8453,437328479,74516,437402995,0,0,0,10240,10,2785259326
8454,437390730,73297,437464027,4,0,0,6656,6,7775239328
8455,437400319,3234,437403553,3,0,1,512,9,3691138881
8456,437456641,3898,437460539,6,0,1,4096,9,6611955026
8457,437658240,80396,437738636,3,0,0,19456,9,9214203943
8458,437775100,106340,437881440,5,0,0,49152,11,701016310
8459,437850250,85136,437935386,3,0,0,14848,9,10558189730
8460,437885860,80408,437966268,5,0,0,9216,11,6590341523
8461,437938590,100880,438039470,3,0,0,31232,9,8347213928
8462,437971639,102596,438074235,0,0,0,36864,10,7158736926
8463,438095270,81620,438176890,7,0,0,18432,18,5161310096
8464,438101800,6278,438108078,8,0,1,6656,12,10481132736
8465,438169340,7565,438176905,9,0,1,5120,10,6414029170
8466,438211929,196490,438408419,0,0,0,28160,10,120786843
8467,438324060,113003,438437063,8,0,0,11264,12,8847964324
8468,438388361,7706,438396067,2,0,1,8192,4,1148420509
8469,438425330,76052,438501382,7,0,0,10240,18,4502231401
8470,438443000,104624,438547624,2,0,0,43520,4,9837969152
8471,438566040,97916,438663956,4,0,0,21504,6,4118042134
8472,438593550,50528,438644078,5,0,0,512,11,5299330000
8473,438628370,85136,438713506,8,0,0,14848,12,1161858812
8474,438695870,113312,438809182,6,0,0,29184,9,8488323670
8475,438721590,66056,438787646,8,0,0,7680,12,10186635693
8476,438752100,98806,438850906,9,0,0,2560,10,10650800719
8477,438832279,72980,438905259,0,0,0,10240,10,4726209212
8478,438839200,50672,438889872,7,0,0,2560,18,1047574326
8479,438923880,52832,438976712,9,0,0,4608,10,4533556315
8480,438993510,43904,439037414,3,0,0,512,9,9456093730
8481,438994550,6278,439000828,9,0,1,6656,10,525202866
8482,439079050,65300,439144350,6,0,0,10240,9,4796171735
8483,439147500,87896,439235396,7,0,0,13824,18,7675407328
8484,439209050,114296,439323346,9,0,0,75264,10,767344225
8485,439211290,7706,439218996,7,0,1,8192,18,5174069050
8486,439211390,229565,439440955,8,0,0,55808,12,9278346524
8487,439262580,148409,439410989,4,0,0,23552,6,7384246985
8488,439294980,3904,439298884,0,0,1,10752,10,9605042877
8489,439299750,23611,439323361,7,0,1,1024,18,1015922900
8490,439308120,103672,439411792,2,0,0,2560,4,5928353014
8491,439321380,3992,439325372,8,0,1,2048,12,788611760
8492,439335350,154617,439489967,7,0,0,54784,18,2585981103
8493,439407560,82905,439490465,6,0,0,512,9,9521954545
8494,439419110,71184,439490294,8,0,0,1024,12,8012300522
8495,439526750,65924,439592674,4,0,0,12288,6,5499702353
8496,439610470,6278,439616748,7,0,1,6656,18,10201580401
8497,439644440,125528,439769968,8,0,0,112128,12,5021347388
8498,439691790,200008,439891798,1,0,0,29696,14,9068552633
8499,439706760,74584,439781344,5,0,0,1024,11,5201115271
8500,439729400,101060,439830460,4,0,0,26112,6,2825240265
8501,439737110,85214,439822324,2,0,0,3072,4,2969753868
8502,439788469,76388,439864857,0,0,0,16384,10,5468766347
8503,439885999,65703,439951702,0,0,0,7680,10,6301854707
8504,439901520,75608,439977128,6,0,0,13824,9,1148616216
8505,439961760,87620,440049380,8,0,0,11776,12,5510682666
8506,439994520,12049,440006569,0,0,1,19968,10,1962187710
8507,439998920,102925,440101845,7,0,0,32256,18,9335945788
8508,440003430,112149,440115579,3,0,0,5632,9,2248377909
8509,440104250,146952,440251202,1,0,0,31744,14,9782417333
8510,440274710,114608,440389318,6,0,0,76288,9,428094397
8511,440274850,127743,440402593,9,0,0,43520,10,5387162957
8512,440307080,129472,440436552,6,0,0,23040,9,968096869
8513,440383630,127011,440510641,5,0,0,54784,11,2928283527
8514,440484769,89744,440574513,0,0,0,14848,10,1568353855
8515,440489860,20796,440510656,9,0,1,5120,10,2662992898
8516,440546430,102069,440648499,5,0,0,29696,11,7261125427
8517,440565650,62516,440628166,1,0,0,6144,14,7535291871
8518,440595120,154983,440750103,2,0,0,63488,4,988297978
8519,440596779,154119,440750898,0,0,0,2560,10,10706848515
8520,440621830,88839,440710669,3,0,0,4608,9,4059664124
8521,440685130,84512,440769642,5,0,0,12800,11,407810243
8522,440743020,82854,440825874,5,0,0,11776,11,746831309
8523,440743250,86644,440829894,2,0,0,6656,4,5441808049
8524,440757790,78398,440836188,9,0,0,9216,10,25382778
8525,440799480,75114,440874594,2,0,0,3072,4,6906284261
8526,440841391,5802,440847193,6,0,1,6144,9,9947534764
8527,440849810,3898,440853708,4,0,1,4096,6,5149346738
8528,440865540,55748,440921288,5,0,0,4096,11,9940806659
8529,440871110,4420,440875530,9,0,1,11776,10,1507849108
8530,440933360,70976,441004336,1,0,0,8704,14,1447530312
8531,440961840,52291,441014131,4,0,1,84992,6,9992492303
8532,440977010,105843,441082853,8,0,0,1024,12,4005217396
8533,440998740,56777,441055517,8,0,0,2048,12,250583315
8534,441030190,89941,441120131,5,0,0,16384,11,7320513027
8535,441043540,44233,441087773,4,0,1,72704,6,4986093131
8536,441043980,44869,441088849,1,0,1,13312,14,3831734394
8537,441144170,5802,441149972,8,0,1,6144,12,7360275725
8538,441182660,106496,441289156,4,0,0,49664,6,10429822971
8539,441239180,111638,441350818,4,0,0,24064,6,10361114870
8540,441424380,85784,441510164,5,0,0,22016,11,9043837161
8541,441490510,100100,441590610,1,0,0,28672,14,6637260524
8542,441515970,52364,441568334,2,0,0,3072,4,4426174326
8543,441559080,102284,441661364,2,0,0,35840,4,5133958716
8544,441636590,72668,441709258,1,0,0,9216,14,8807077056
8545,441844720,3898,441848618,9,0,1,4096,10,7285260513
8546,441876750,69284,441946034,7,0,0,8192,18,6286175144
8547,441953519,100100,442053619,0,0,0,28672,10,4862273196
8548,441974570,146876,442121446,7,0,0,17408,18,1888054718
8549,442014450,195561,442210011,4,0,0,30720,6,7895079846
8550,442045680,70447,442116127,2,0,0,6144,4,9188224511
8551,442050590,179123,442229713,8,0,0,14848,12,1553902341
8552,442073720,198191,442271911,5,0,0,117760,11,6170236991
8553,442086669,1518,442088187,3,0,1,1536,9,6026048779
8554,442107460,212505,442319965,8,0,0,7168,12,237205960
8555,442122890,188987,442311877,6,0,0,51200,9,1554276294
8556,442155840,119362,442275202,6,0,0,10752,9,7620625759
8557,442188830,166049,442354879,2,0,0,36352,4,8484769275
8558,442400070,50672,442450742,9,0,0,2560,10,6557782207
8559,442459121,566,442459687,2,0,1,512,4,7659241608
8560,442512850,99944,442612794,7,0,0,28160,18,6187402698
8561,442557790,21916,442579706,7,0,1,35840,18,7308862628
8562,442572970,123029,442695999,9,0,0,15872,10,1688988837
8563,442574110,247863,442821973,4,0,0,120320,6,8615160499
8564,442621270,105501,442726771,3,0,0,35840,9,9557539525
8565,442741430,86345,442827775,1,0,0,7168,14,6562717148
8566,442745020,93893,442838913,5,0,0,7680,11,2875763714
8567,442776780,45208,442821988,4,0,1,40448,6,10197039117
8568,442821100,1446,442822546,7,0,1,512,18,8749288981
8569,442943580,149250,443092830,6,0,0,2560,9,6416865683
8570,442971160,101192,443072352,8,0,0,32256,12,2831283747
8571,442988180,95272,443083452,1,0,0,8192,14,3233478439
8572,443026940,3422,443030362,9,0,1,3584,10,2576311352
8573,443038029,14287,443052316,3,0,1,27648,9,1139678797
8574,443119839,3422,443123261,3,0,1,3584,9,8800194675
8575,443188800,101348,443290148,8,0,0,32768,12,7046664182
8576,443204260,54056,443258316,3,0,0,3584,9,6667281232
8577,443274620,98408,443373028,9,0,0,28160,10,8540471197
8578,443279370,152014,443431384,8,0,0,58368,12,9490418830
8579,443299350,64208,443363558,5,0,0,6656,11,9215565666
8580,443302650,251554,443554204,3,0,0,30720,9,463862073
8581,443356750,136410,443493160,4,0,0,16896,6,3343075011
8582,443376900,130048,443506948,2,0,0,41984,4,7680664085
8583,443420370,178720,443599090,5,0,0,30720,11,4729566549
8584,443441210,2870,443444080,1,0,1,8704,14,1440006268
8585,443450400,152761,443603161,1,0,0,13312,14,8127550548
8586,443504709,4225,443508934,3,0,1,2048,9,10674112339
8587,443515380,4679,443520059,1,0,1,12288,14,4677295981
8588,443554180,100740,443654920,2,0,0,30720,4,1747911817
8589,443577190,129132,443706322,3,0,0,11776,9,9169162724
8590,443579480,111327,443690807,6,0,0,14848,9,6500444797
8591,443621921,1994,443623915,5,0,1,2048,11,2589770943
8592,443655200,46502,443701702,6,0,0,512,9,9185684955
8593,443676290,97789,443774079,7,0,0,11264,18,2551014154
8594,443717010,159291,443876301,2,0,0,118784,4,1372186868
8595,443768610,145845,443914455,9,0,0,26112,10,5163488897
8596,443840150,138427,443978577,7,0,0,35840,18,2337142918
8597,443865900,190603,444056503,3,0,0,13312,9,6971377310
8598,443940200,38392,443978592,4,0,1,58368,6,7877025600
8599,444004230,62516,444066746,6,0,0,6144,9,1842876355
8600,444069810,56684,444126494,4,0,0,7168,6,10483349397
8601,444157500,71756,444229256,7,0,0,11264,18,3845016942
8602,444177620,45596,444223216,4,0,0,1024,6,3538209412
8603,444178540,3387,444181927,0,0,1,9728,10,1471273747
8604,444191020,124961,444315981,2,0,0,74752,4,10066190800
8605,444274250,111841,444386091,6,0,0,51712,9,5195141219
8606,444286540,83780,444370320,9,0,0,20480,10,3448128008
8607,444287740,117290,444405030,9,0,0,12288,10,6457202707
8608,444311440,126674,444438114,3,0,0,25088,9,7849044544
8609,444321159,84042,444405201,0,0,0,512,10,2287300044
8610,444406130,2946,444409076,1,0,1,3072,14,3324989900
8611,444455130,52364,444507494,7,0,0,3072,18,9278398848
8612,444470040,97316,444567356,7,0,0,24576,18,337837679
8613,444479260,187943,444667203,7,0,0,64512,18,1447606873
8614,444543460,12825,444556285,4,0,1,21504,6,9184670091
8615,444569790,116679,444686469,8,0,0,5632,12,10278551950
8616,444642750,47288,444690038,9,0,0,1536,10,10377791279
8617,444659640,117819,444777459,8,0,0,59904,12,4484769387
8618,444661329,153714,444815043,0,0,0,24064,10,8764210544
8619,444663750,219507,444883257,4,0,0,19968,6,3255907961
8620,444708520,50672,444759192,7,0,0,2560,18,5925341004
8621,444725600,131467,444857067,2,0,0,28672,4,2360700337
8622,444734660,137710,444872370,1,0,0,50176,14,6308515049
8623,444792100,116285,444908385,7,0,0,24576,18,10285031328
8624,444825220,141983,444967203,2,0,0,14848,4,2785344466
8625,444829200,116631,444945831,4,0,0,10240,6,8349278415
8626,444830220,126399,444956619,2,0,0,32768,4,9811047024
8627,444879800,82357,444962157,3,0,0,12288,9,724372752
8628,444888810,127851,445016661,3,0,0,5120,9,4694519340
8629,444905769,148368,445054137,0,0,0,72192,10,6278463676
8630,444967381,566,444967947,5,0,1,512,11,1684693194
8631,445006289,72068,445078357,0,0,0,12288,10,4742625655
8632,445017180,10757,445027937,0,0,1,17408,10,855779865
8633,445050870,177891,445228761,5,0,0,22528,11,10432068333
8634,445065930,5802,445071732,0,0,1,6144,10,6655480369
8635,445077749,215686,445293435,0,0,0,16896,10,1152470013
8636,445108670,52364,445161034,9,0,0,3072,10,1703445379
8637,445246440,130013,445376453,9,0,0,46592,10,8741660914
8638,445261050,101192,445362242,9,0,0,32256,10,10407625582
8639,445304130,168514,445472644,7,0,0,18432,18,261716121
8640,445331120,101504,445432624,6,0,0,33280,9,2070450309
8641,445333070,47288,445380358,2,0,0,1536,4,7459684407
8642,445345990,67746,445413736,4,0,0,4096,6,1376783410
8643,445366560,74093,445440653,2,0,0,6656,4,4891047423
8644,445388280,113031,445501311,7,0,0,3072,18,8911661747
8645,445398700,101660,445500360,3,0,0,33792,9,5284051736
8646,445462010,75286,445537296,8,0,0,1536,12,2702944791
8647,445528780,50672,445579452,2,0,0,2560,4,2591429935
8648,445613280,78236,445691516,2,0,0,17408,4,4522512112
8649,445663210,71312,445734522,4,0,0,14848,6,6279451440
8650,445744590,3387,445747977,0,0,1,9728,10,2531978113
8651,445746219,127580,445873799,0,0,0,22528,10,8019571055
8652,445813360,1518,445814878,8,0,1,1536,12,8546655115
8653,445850289,45596,445895885,0,0,0,1024,10,10730426071
8654,445874910,126951,446001861,2,0,0,37888,4,8887562325
8655,445901570,14029,445915599,0,0,1,27136,10,9665845350
8656,445983220,18656,446001876,4,0,1,27648,6,9532944000
8657,446059780,113558,446173338,4,0,1,184320,6,3808858988
8658,446094979,79665,446174644,3,0,1,2048,9,6987287152
8659,446178590,1994,446180584,0,0,1,2048,10,6536052939
8660,446192610,4420,446197030,7,0,1,11776,18,2585428252
8661,446240790,113524,446354314,8,0,0,32768,12,7275773836
8662,446260120,65900,446326020,3,0,0,7168,9,5139682410
8663,446273391,4374,446277765,6,0,1,4608,9,3635035306
8664,446364940,7706,446372646,0,0,1,8192,10,5468927873
8665,446381251,6754,446388005,5,0,1,7168,11,6735884816
8666,446504150,3422,446507572,0,0,1,3584,10,2477804554
8667,446586060,105716,446691776,6,0,0,47104,9,4946720120
8668,446595201,7230,446602431,5,0,1,7680,11,5777434215
8669,446638040,3422,446641462,0,0,1,3584,10,7420256176
8670,446650641,5802,446656443,5,0,1,6144,11,5172400456
8671,446662999,118531,446781530,0,0,0,56832,10,1622343573
8672,446736780,47288,446784068,2,0,0,1536,4,9463503731
8673,446834091,566,446834657,2,0,1,512,4,8442622324
8674,446855700,89300,446945000,7,0,0,18432,18,2651095204
8675,446901989,104156,447006145,0,0,0,41984,10,973300693
8676,446917731,1518,446919249,2,0,1,1536,4,9468052474
8677,446940120,15371,446955491,9,0,1,16896,10,6862158902
8678,447040590,69596,447110186,3,0,0,9216,9,9918897996
8679,447055960,50672,447106632,2,0,0,2560,4,10364937582
8680,447061149,2470,447063619,3,0,1,2560,9,6445276422
8681,447076300,144995,447221295,1,0,0,5120,14,3197393692
8682,447105580,114140,447219720,7,0,0,74752,18,7888739156
8683,447139980,104346,447244326,3,0,0,8192,9,6895381699
8684,447360690,76052,447436742,7,0,0,10240,18,4230457509
8685,447399209,99408,447498617,0,0,0,10752,10,10247744027
8686,447412050,2870,447414920,8,0,1,8704,12,4033529387
8687,447454330,187889,447642219,7,0,0,31744,18,4325638677
8688,447586680,110240,447696920,9,0,0,61952,10,2718037636
8689,447655649,73604,447729253,0,0,0,12288,10,4656061048
8690,447758380,71756,447830136,9,0,0,11264,10,6324606444
8691,447820809,84380,447905189,0,0,0,17408,10,3785528533
8692,447857291,566,447857857,6,0,1,512,9,7830418751
8693,447884980,53481,447938461,6,0,0,6144,9,9839491286
8694,447904470,77387,447981857,7,0,0,12288,18,3551031019
8695,447933940,48244,447982184,7,0,0,1024,18,3772157720
8696,448018770,46471,448065241,1,0,1,80384,14,2202378789
8697,448019201,46706,448065907,2,0,1,1024,4,8910802028
8698,448038510,125117,448163627,1,0,0,13312,14,5831769128
8699,448042440,95173,448137613,7,0,0,24576,18,4953662443
8700,448087270,131839,448219109,2,0,0,12800,4,5181012263
8701,448181250,111644,448292894,1,0,0,66560,14,2342154058
8702,448193110,114442,448307552,8,0,0,7680,12,6878076277
8703,448233680,145230,448378910,6,0,0,18944,9,7294799228
8704,448250990,83756,448334746,9,0,0,15360,10,7685492453
8705,448262580,64076,448326656,9,0,0,11264,10,2775797555
8706,448265229,88525,448353754,0,0,0,7168,10,5844949993
8707,448280130,116972,448397102,2,0,0,24576,4,828830770
8708,448311440,85989,448397429,3,0,0,1024,9,3105987779
8709,448414180,100880,448515060,5,0,0,31232,11,9866639463
8710,448622080,59132,448681212,6,0,0,5120,9,10450989231
8711,448799300,85784,448885084,1,0,0,22016,14,5766743558
8712,448801620,89251,448890871,6,0,0,18944,9,177337235
8713,448802480,105440,448907920,1,0,0,11264,14,7679858979
8714,449007760,69908,449077668,2,0,0,10240,4,4131649530
8715,449029800,67592,449097392,6,0,0,7680,9,2279871016
8716,449076480,104072,449180552,3,0,0,37376,9,9789949193
8717,449092900,216718,449309618,6,0,0,71680,9,2286656027
8718,449097820,167193,449265013,2,0,0,1024,4,1441598820
8719,449113850,150828,449264678,7,0,0,85504,18,5123951877
8720,449167990,12577,449180567,7,0,1,9216,18,7489480830
8721,449224510,100100,449324610,1,0,0,28672,14,5319093839
8722,449241070,84850,449325920,9,0,0,3072,10,5981119305
8723,449265970,13083,449279053,9,0,1,22016,10,5365246826
8724,449336380,102284,449438664,3,0,0,35840,9,334870060
8725,449354230,88037,449442267,3,0,0,11776,9,3267958243
8726,449387360,23208,449410568,0,0,1,38400,10,9958979044
8727,449423980,129657,449553637,3,0,0,26624,9,7056392934
8728,449434639,56164,449490803,0,0,0,512,10,975910025
8729,449471600,1994,449473594,9,0,1,2048,10,157803113
8730,449564859,113048,449677907,0,0,0,71168,10,1151744020
8731,449619130,155575,449774705,9,0,0,22528,10,4728572203
8732,449626280,135291,449761571,1,0,0,46080,14,4802394321
8733,449842120,73760,449915880,6,0,0,12800,9,8427981898
8734,449876040,116034,449992074,1,0,0,39936,14,6047873086
8735,449889160,48980,449938140,9,0,0,2048,10,5739493283
8736,449897390,79020,449976410,4,0,0,13312,6,6441077224
8737,449928400,117812,450046212,5,0,0,14848,11,1783791462
8738,450001260,107900,450109160,7,0,0,54272,18,6688009165
8739,450038590,108190,450146780,9,0,0,4096,10,9893342747
8740,450152869,10499,450163368,3,0,1,16896,9,3033680055
8741,450198720,133585,450332305,1,0,0,46080,14,57506631
8742,450215810,102440,450318250,7,0,0,36352,18,6704784345
8743,450290369,1042,450291411,3,0,1,1024,9,4040360087
8744,450295110,3128,450298238,8,0,1,9216,12,10076646516
8745,450305290,111685,450416975,5,0,0,29184,11,9345786541
8746,450367600,67592,450435192,8,0,0,7680,12,6537569447
8747,450414600,78731,450493331,3,0,0,11264,9,4477964988
8748,450433990,103790,450537780,3,0,0,36864,9,735732079
8749,450459330,83880,450543210,7,0,0,8192,18,1729849430
8750,450552000,101660,450653660,4,0,0,33792,6,8415130828
8751,450649119,123509,450772628,0,0,0,90624,10,4319933457
8752,450699750,151238,450850988,5,0,0,48128,11,5963400259
8753,450761960,149022,450910982,1,0,0,27136,14,8907668293
8754,450821440,108196,450929636,6,0,0,1536,9,2557302241
8755,450839370,149948,450989318,8,0,0,45056,12,1663215985
8756,450999270,52364,451051634,9,0,0,3072,10,7679205987
8757,451142870,86828,451229698,7,0,0,15360,18,1090952038
8758,451195290,6488,451201778,1,0,1,15872,14,6286707230
8759,451212841,2470,451215311,5,0,1,2560,11,4096170095
8760,451218260,119806,451338066,9,0,0,31744,10,4349546356
8761,451219820,214089,451433909,7,0,0,69632,18,4002316598
8762,451223410,12566,451235976,7,0,1,20992,18,9151482226
8763,451224079,117478,451341557,0,0,0,10752,10,1988752380
8764,451299700,103513,451403213,6,0,0,9216,9,7052681496
8765,451327800,10281,451338081,1,0,1,2560,14,8247950596
8766,451334760,176249,451511009,6,0,0,42496,9,3089086323
8767,451345270,145926,451491196,6,0,0,54272,9,4300487074
8768,451394250,123456,451517706,6,0,0,11776,9,3105970500
8769,451414840,202832,451617672,1,0,0,44032,14,470692014
8770,451460500,166688,451627188,7,0,0,9728,18,6432465324
8771,451492240,100880,451593120,3,0,0,31232,9,5780676112
8772,451547560,4374,451551934,1,0,1,4608,14,3976123385
8773,451581220,63152,451644372,2,0,0,5632,4,8531382912
8774,451609430,110986,451720416,4,0,0,37376,6,3664855749
8775,451658480,23983,451682463,4,0,1,39936,6,6490611086
8776,451666820,132730,451799550,7,0,0,69120,18,5761432705
8777,451685320,118925,451804245,8,0,0,15360,12,8378889467
8778,451781790,27384,451809174,1,0,1,12800,14,5382700970
8779,451845750,134644,451980394,9,0,0,6656,10,9789641158
8780,451928360,94664,452023024,2,0,0,15872,4,3914995743
8781,451994200,2870,451997070,8,0,1,8704,12,9053705044
8782,452025720,566,452026286,0,0,1,512,10,5703791748
8783,452064160,85136,452149296,8,0,0,14848,12,10537220727
8784,452080300,3422,452083722,8,0,1,3584,12,4498376795
8785,452147050,148755,452295805,4,0,0,54272,6,10708372273
8786,452198560,155283,452353843,7,0,0,107520,18,4715736176
8787,452289690,8577,452298267,7,0,1,2560,18,6794828443
8788,452312900,187038,452499938,7,0,0,23040,18,8873217939
8789,452336180,73403,452409583,2,0,0,4096,4,351073608
8790,452343770,84450,452428220,1,0,0,9728,14,8221358431
8791,452376410,89640,452466050,4,0,0,11776,6,9116913265
8792,452406770,122618,452529388,7,0,0,29696,18,2571353970
8793,452463020,129176,452592196,2,0,0,11776,4,6991044077
8794,452464721,14171,452478892,2,0,1,21504,4,4609312454
8795,452517650,83762,452601412,7,0,0,11776,18,7176149568
8796,452569711,5326,452575037,2,0,1,5632,4,6138589455
8797,452635529,66524,452702053,0,0,0,9216,10,8976994894
8798,452686690,109479,452796169,3,0,0,18432,9,8440736280
8799,452736150,110713,452846863,8,0,0,12288,12,10166508312
8800,452754760,182157,452936917,5,0,0,79872,11,1821244918
8801,452776250,43904,452820154,5,0,0,512,11,1625751200
8802,452854840,85524,452940364,1,0,0,11264,14,5198377368
8803,452873530,67785,452941315,1,0,0,3072,14,1477794687
8804,452941570,566,452942136,7,0,1,512,18,43006583
8805,452953650,105404,453059054,1,0,0,46080,14,2836926134
8806,453078560,108524,453187084,5,0,0,56320,11,6732373239
8807,453102280,3128,453105408,7,0,1,9216,18,5310420539
8808,453111500,105830,453217330,5,0,0,13312,11,157938548
8809,453151860,71624,453223484,2,0,0,15872,4,10506156523
8810,453152650,104278,453256928,9,0,0,39936,10,4698194079
8811,453178061,11485,453189546,5,0,1,2560,11,8346264335
8812,453198160,2946,453201106,0,0,1,3072,10,53192913
8813,453250230,60746,453310976,2,0,0,3584,4,2780739938
8814,453300550,62321,453362871,7,0,0,3072,18,3901528188
8815,453383520,51140,453434660,2,0,0,4096,4,8299929559
8816,453457360,88832,453546192,2,0,0,16896,4,9901280481
8817,453521660,6229,453527889,9,0,1,15360,10,8110648219
8818,453548329,14029,453562358,3,0,1,27136,9,7547499518
8819,453551800,259011,453810811,6,0,0,66048,9,3797611011
8820,453562460,3387,453565847,8,0,1,9728,12,5596138002
8821,453563040,77987,453641027,4,0,1,126976,6,10619990800
8822,453596880,111157,453708037,7,0,0,18432,18,9342474754
8823,453683659,144326,453827985,0,0,0,3072,10,3111214915
8824,453707390,131408,453838798,4,0,0,19456,6,9843230475
8825,453712990,133647,453846637,8,0,0,1024,12,4782681388
8826,453733590,4374,453737964,1,0,1,4608,14,8152680428
8827,453804400,64935,453869335,1,0,0,8192,14,10041044978
8828,453825870,108851,453934721,2,0,0,55296,4,2089810823
8829,453830370,87488,453917858,4,0,1,146944,6,1690241866
8830,453865240,273791,454139031,3,0,0,8192,9,117405635
8831,453899720,118116,454017836,6,0,0,8192,9,6741032333
8832,453951610,78700,454030310,2,0,0,7680,4,8081793527
8833,453961360,4850,453966210,1,0,1,5120,14,9998800841
8834,453961790,135319,454097109,7,0,0,17920,18,2234596035
8835,454114380,50672,454165052,8,0,0,2560,12,1592770434
8836,454143890,66992,454210882,3,0,0,10752,9,6656812815
8837,454153340,99320,454252660,9,0,0,26112,10,8167913775
8838,454173840,99008,454272848,4,0,0,25088,6,468003248
8839,454203270,149590,454352860,1,0,0,55296,14,10204050221
8840,454247800,112719,454360519,1,0,0,25088,14,3885326802
8841,454295770,90858,454386628,7,0,0,2560,18,5044691630
8842,454369940,33075,454403015,4,0,1,54272,6,5374505037
8843,454399730,45596,454445326,5,0,0,1024,11,2957116718
8844,454401920,65090,454467010,9,0,0,6656,10,5264501548
8845,454448980,108495,454557475,1,0,0,27136,14,1910746379
8846,454460180,190425,454650605,6,0,0,76288,9,6581588232
8847,454537310,73916,454611226,6,0,0,13312,9,8312580074
8848,454565701,137674,454703375,6,0,0,21504,9,8195801208
8849,454586670,196433,454783103,2,0,0,121856,4,6001316799
8850,454648850,7549,454656399,1,0,1,6144,14,7791341315
8851,454786130,16613,454802743,4,0,1,32256,6,9542736930
8852,454821580,89877,454911457,5,0,0,16384,11,6932784324
8853,454831981,188938,455020919,6,0,0,43520,9,6200539867
8854,454843510,102339,454945849,9,0,0,13312,10,9870993206
8855,454866779,6278,454873057,3,0,1,6656,9,4243524126
8856,454896280,96771,454993051,3,0,0,15872,9,3857087706
8857,454897310,132516,455029826,5,0,0,29184,11,9004325179
8858,455060050,68888,455128938,5,0,0,6144,11,9888998661
8859,455076211,2946,455079157,6,0,1,3072,9,2209701137
8860,455090600,62672,455153272,2,0,0,6656,4,6316082801
8861,455111970,98696,455210666,4,0,0,24064,6,10130807440
8862,455130160,110240,455240400,6,0,0,61952,9,273457661
8863,455265200,3422,455268622,8,0,1,3584,12,1151774651
8864,455342940,82400,455425340,7,0,0,20992,18,1653793066
8865,455388659,101192,455489851,0,0,0,32256,10,3392514807
8866,455491810,11791,455503601,0,0,1,19456,10,10680217651
8867,455599200,65900,455665100,5,0,0,7168,11,4089679654
8868,455602370,79172,455681542,1,0,0,20480,14,5589959018
8869,455650760,3898,455654658,0,0,1,4096,10,8638593364
8870,455660240,114197,455774437,7,0,0,60416,18,7170991655
8871,455682349,6754,455689103,3,0,1,7168,9,9192826662
8872,455768000,8899,455776899,9,0,1,2560,10,5342710039
8873,455840800,74228,455915028,3,0,0,14336,9,2486810037
8874,455955620,98540,456054160,9,0,0,23552,10,2992581109
8875,455959700,67970,456027670,3,0,0,1024,9,3829391921
8876,456049970,111770,456161740,2,0,0,53248,4,1866788464
8877,456050641,6006,456056647,6,0,1,2560,9,6026179585
8878,456087440,81686,456169126,8,0,0,15872,12,3070907471
8879,456113330,121436,456234766,5,0,0,36352,11,1301341241
8880,456145521,17270,456162791,2,0,1,1024,4,933300632
8881,456150830,26293,456177123,9,0,1,29184,10,4263108876
8882,456252280,2470,456254750,1,0,1,2560,14,10571699353
8883,456277221,6754,456283975,5,0,1,7168,11,4242763620
8884,456289441,67399,456356840,6,0,0,4096,9,3099150173
8885,456311769,3645,456315414,3,0,1,10240,9,381090642
8886,456365950,183920,456549870,1,0,0,4096,14,6901471373
8887,456393140,98720,456491860,3,0,0,29184,9,9847957666
8888,456405060,179194,456584254,3,0,0,104448,9,3876957992
8889,456467189,6229,456473418,3,0,1,15360,9,3156623382
8890,456616480,108212,456724692,7,0,0,55296,18,9260596419
8891,456619110,110130,456729240,7,0,0,9728,18,9949186501
8892,456688839,106184,456795023,0,0,0,48640,10,6875214382
8893,456719549,109728,456829277,0,0,0,8704,10,4761418855
8894,456804340,83227,456887567,8,0,0,17408,12,942547285
8895,456818170,62072,456880242,9,0,0,3584,10,2342062799
8896,456850850,69226,456920076,8,0,0,7168,12,1836465973
8897,456862940,70574,456933514,5,0,0,2560,11,7567177222
8898,456872090,97604,456969694,1,0,0,20480,14,9416570843
8899,456960230,9479,456969709,1,0,1,6144,14,1713985232
8900,457051180,105404,457156584,9,0,0,46080,10,5247856052
8901,457061870,3128,457064998,7,0,1,9216,18,9984530431
8902,457069900,48980,457118880,1,0,0,2048,14,10629841577
8903,457071640,3898,457075538,9,0,1,4096,10,289187733
8904,457142020,14579,457156599,7,0,1,2048,18,4353252051
8905,457146070,115311,457261381,9,0,0,28672,10,7001538051
8906,457163830,102714,457266544,4,0,0,16896,6,10391327540
8907,457178950,6754,457185704,7,0,1,7168,18,7072450534
8908,457238180,105872,457344052,3,0,0,47616,9,7779701156
8909,457382970,5454,457388424,4,0,1,13824,6,2482132660
8910,457438431,94664,457533095,6,0,0,15872,9,1259687168
8911,457444050,94372,457538422,1,0,0,17408,14,4522702490
8912,457485960,164212,457650172,3,0,0,72704,9,10559271855
8913,457519949,108056,457628005,0,0,0,54784,10,7969025853
8914,457531320,263189,457794509,3,0,0,10240,9,6405626748
8915,457551940,278115,457830055,8,0,0,13824,12,2865702260
8916,457556410,233685,457790095,9,0,0,187392,10,923504971
8917,457685020,106354,457791374,3,0,0,4096,9,1952789931
8918,457745950,96501,457842451,3,0,0,3072,9,3362627896
8919,457757530,91870,457849400,3,0,0,5632,9,2192726270
8920,457817830,72939,457890769,1,0,0,14336,14,3688583794
8921,457883550,7234,457890784,9,0,1,8704,10,7055639776
8922,457901810,88052,457989862,4,0,0,14336,6,7014366012
8923,457957139,3898,457961037,3,0,1,4096,9,4896977149
8924,457995951,158579,458154530,6,0,0,48640,9,4621757577
8925,458024400,159209,458183609,9,0,0,88064,10,2172000311
8926,458030450,165030,458195480,7,0,0,38912,18,1132140300
8927,458031270,182690,458213960,7,0,0,27648,18,5432417792
8928,458139400,15145,458154545,7,0,1,6144,18,4267295771
8929,458228660,101192,458329852,8,0,0,32256,12,7200711124
8930,458363300,100412,458463712,1,0,0,29696,14,7878343443
8931,458475760,73448,458549208,7,0,0,11776,18,10581410550
8932,458537430,99632,458637062,3,0,0,27136,9,2065417586
8933,458591890,118846,458710736,1,0,0,40960,14,2609024639
8934,458644820,15837,458660657,4,0,1,30720,6,5965293985
8935,458656030,152680,458808710,9,0,0,94208,10,1942203670
8936,458663510,105436,458768946,2,0,0,10240,4,10266963055
8937,458674230,165090,458839320,8,0,0,73728,12,10029699036
8938,458788869,135987,458924856,0,0,0,54784,10,1085458163
8939,458922330,5940,458928270,1,0,1,3584,14,7374642111
8940,458927490,50672,458978162,7,0,0,2560,18,8738419558
8941,458949000,2470,458951470,8,0,1,2560,12,9574783978
8942,459044220,81128,459125348,9,0,0,11776,10,3937876422
8943,459045940,97652,459143592,3,0,0,30720,9,3315983905
8944,459058570,70976,459129546,7,0,0,8704,18,3475570317
8945,459066720,164288,459231008,1,0,0,58880,14,10424505333
8946,459132770,167628,459300398,3,0,0,43520,9,10201724921
8947,459143560,98224,459241784,3,0,0,16384,9,2763541452
8948,459167700,74567,459242267,5,0,0,1536,11,10572232216
8949,459228570,116102,459344672,9,0,0,11264,10,4086018309
8950,459256359,98027,459354386,0,0,0,11776,10,6215947660
8951,459350360,5802,459356162,8,0,1,6144,12,5907075946
8952,459393430,80372,459473802,2,0,0,14336,4,1659829354
8953,459405549,163088,459568637,0,0,0,20480,10,4226649945
8954,459410860,50672,459461532,1,0,0,2560,14,6479760127
8955,459427690,101504,459529194,9,0,0,33280,10,2692594
8956,459472320,284676,459756996,3,0,0,94720,9,2268794391
8957,459496781,1994,459498775,6,0,1,2048,9,3337283094
8958,459498249,2870,459501119,3,0,1,8704,9,4731366223
8959,459567290,99256,459666546,4,0,0,10752,6,7674335973
8960,459635580,2470,459638050,4,0,1,2560,6,7656677033
8961,459635781,6430,459642211,5,0,1,6144,11,8328199229
8962,459665600,95943,459761543,5,0,0,14848,11,3614116288
8963,459681699,7230,459688929,3,0,1,7680,9,6694595861
8964,459698241,104907,459803148,6,0,0,11264,9,4073934680
8965,459749971,110104,459860075,6,0,0,23552,9,8557563931
8966,459756430,65156,459821586,3,0,0,5120,9,1778508619
8967,459760450,6436,459766886,7,0,1,5632,18,9311318417
8968,459780240,57440,459837680,4,0,0,4608,6,5477805924
8969,459790080,1042,459791122,7,0,1,1024,18,2265887775
8970,459798159,74696,459872855,0,0,0,15872,10,9812675786
8971,459841380,65519,459906899,4,0,0,3584,6,6209161223
8972,459914370,108212,460022582,5,0,0,55296,11,2137105708
8973,459932970,5326,459938296,8,0,1,5632,12,145047723
8974,459954970,128656,460083626,7,0,0,21504,18,4980096757
8975,459970100,80840,460050940,7,0,0,15872,18,5031832757
8976,459971591,117510,460089101,6,0,0,17920,9,4469101380
8977,459999680,54056,460053736,8,0,0,3584,12,5993181749
8978,460029830,93440,460123270,4,0,0,16896,6,6992634559
8979,460144250,97448,460241698,1,0,0,19968,14,4827135038
8980,460489650,82244,460571894,1,0,0,20480,14,3555817673
8981,460632520,64676,460697196,2,0,0,8192,4,4001254353
8982,460711240,103220,460814460,9,0,0,38912,10,7552355932
8983,460808401,78719,460887120,6,0,0,9216,9,9019421181
8984,460819289,89768,460909057,0,0,0,19968,10,1556301620
8985,460820660,2870,460823530,1,0,1,8704,14,2139643694
8986,460826900,1994,460828894,0,0,1,2048,10,5931761711
8987,460866641,7230,460873871,2,0,1,7680,4,8956754422
8988,460914301,5802,460920103,2,0,1,6144,4,443213823
8989,460918880,142512,461061392,9,0,0,6144,10,1880065503
8990,460948811,1042,460949853,6,0,1,1024,9,4580474265
8991,460999460,69284,461068744,8,0,0,8192,12,5821389440
8992,461030961,6229,461037190,5,0,1,15360,11,4282949612
8993,461045871,47288,461093159,6,0,0,1536,9,6117915137
8994,461094460,77744,461172204,5,0,0,10752,11,3579582568
8995,461123840,566,461124406,4,0,1,512,6,7486075941
8996,461136020,68684,461204704,7,0,0,11264,18,2000099536
8997,461241830,110965,461352795,3,0,0,51200,9,8013119781
8998,461254380,2946,461257326,8,0,1,3072,12,6116336279
8999,461255620,3652,461259272,4,0,1,3072,6,9529045104
9000,461409530,49136,461458666,8,0,0,2560,12,2960050907
9001,461455890,65900,461521790,3,0,0,7168,9,7320167215
9002,461467601,1518,461469119,2,0,1,1536,4,9401095653
9003,461511461,13083,461524544,5,0,1,22016,11,2394914833
9004,461543141,47288,461590429,6,0,0,1536,9,4648465018
9005,461620780,133738,461754518,9,0,0,15360,10,1208207139
9006,461697981,24242,461722223,2,0,1,40448,4,8087940121
9007,461701780,21416,461723196,4,0,1,12800,6,2725750887
9008,461707830,21165,461728995,9,0,1,19456,10,2714942212
9009,461734071,82820,461816891,6,0,0,12288,9,2479494532
9010,461750020,268623,462018643,1,0,0,71680,14,91954139
9011,461771800,156321,461928121,3,0,0,2560,9,820854824
9012,461972070,118219,462090289,2,0,0,78848,4,6142809578
9013,462078860,22954,462101814,7,0,1,18944,18,3234438964
9014,462099459,102218,462201677,0,0,0,14336,10,8641977878
9015,462104410,87296,462191706,5,0,0,16896,11,7632381622
9016,462117560,124720,462242280,2,0,0,50688,4,1498503015
9017,462122840,43904,462166744,8,0,0,512,12,6523892212
9018,462156899,103751,462260650,0,0,0,5120,10,7878953572
9019,462164680,221819,462386499,4,0,0,28160,6,5093714996
9020,462182660,119448,462302108,4,0,0,512,6,5874593045
9021,462187460,222002,462409462,5,0,0,11776,11,10564905760
9022,462188390,157166,462345556,5,0,0,55808,11,7970804313
9023,462245781,1994,462247775,5,0,1,2048,11,9965369665
9024,462250070,202756,462452826,4,0,0,52736,6,10022848121
9025,462290029,105221,462395250,0,0,0,25088,10,8941638557
9026,462387040,66581,462453621,2,0,0,2560,4,3680074707
9027,462398430,151476,462549906,8,0,0,71680,12,2271192823
9028,462472981,6278,462479259,6,0,1,6656,9,1372580487
9029,462486300,65025,462551325,1,0,0,4608,14,1306983058
9030,462598650,5326,462603976,4,0,1,5632,6,5791965712
9031,462612440,70976,462683416,5,0,0,8704,11,5487996611
9032,462617971,6488,462624459,2,0,1,15872,4,1536084390
9033,462689200,69284,462758484,3,0,0,8192,9,5548851591
9034,462708479,103915,462812394,0,0,0,32768,10,5410421805
9035,462771481,10757,462782238,5,0,1,17408,11,7665451609
9036,462804380,8589,462812969,8,0,1,512,12,8268745392
9037,462806480,53219,462859699,3,0,0,1536,9,7128535830
9038,462864571,5802,462870373,6,0,1,6144,9,5285445639
9039,462947050,104936,463051986,5,0,0,44544,11,8968609927
9040,462986679,67506,463054185,0,0,0,7168,10,2497892132
9041,463034379,84375,463118754,0,0,0,19456,10,9654167275
9042,463174851,94220,463269071,6,0,0,19456,9,5639622966
9043,463199630,81128,463280758,2,0,0,11776,4,3375328229
9044,463353020,77104,463430124,0,0,1,130048,10,1858170697
9045,463382380,53953,463436333,4,0,1,21504,6,9960103356
9046,463396240,145474,463541714,8,0,0,30720,12,4803498799
9047,463462250,230776,463693026,5,0,0,32768,11,4227351461
9048,463505940,210396,463716336,1,0,0,17408,14,10575450782
9049,463592260,2946,463595206,0,0,1,3072,10,4273469293
9050,463637090,56575,463693665,3,0,0,2048,9,2910763237
9051,463665860,4162,463670022,0,0,1,11264,10,3446567321
9052,463725510,55748,463781258,5,0,0,4096,11,9009107484
9053,463805480,5326,463810806,9,0,1,5632,10,2945468514
9054,463812710,54056,463866766,7,0,0,3584,18,9763304229
9055,463853600,108680,463962280,8,0,0,56832,12,345946805
9056,463891840,208986,464100826,7,0,0,5632,18,8787386981
9057,463896470,120722,464017192,7,0,0,58368,18,9801429586
9058,463910530,156720,464067250,5,0,0,99328,11,8892681455
9059,463914640,176496,464091136,7,0,0,38912,18,7203019214
9060,463952119,267777,464219896,0,0,0,44032,10,2968927254
9061,463975380,261676,464237056,9,0,0,28160,10,8232231382
9062,464011951,118263,464130214,6,0,0,16384,9,5166368476
9063,464032190,171452,464203642,4,0,0,116224,6,5804367633
9064,464066559,139906,464206465,0,0,0,9216,10,2408329626
9065,464073311,180734,464254045,6,0,0,512,9,7128144099
9066,464144610,109264,464253874,4,0,0,36864,6,812472649
9067,464145601,129555,464275156,6,0,0,14848,9,7436582281
9068,464199410,161042,464360452,2,0,0,10240,4,139737491
9069,464220600,101158,464321758,8,0,0,20480,12,2340597863
9070,464330631,6754,464337385,2,0,1,7168,4,3610891400
9071,464345931,4162,464350093,2,0,1,11264,4,9472458316
9072,464362300,43904,464406204,7,0,0,512,18,5494751445
9073,464587819,67904,464655723,0,0,0,8704,10,10282569260
9074,464617810,52364,464670174,4,0,0,3072,6,5309743198
9075,464703100,6754,464709854,8,0,1,7168,12,9502012817
9076,464732850,278418,465011268,2,0,0,31744,4,10517246179
9077,464740810,296324,465037134,7,0,0,4608,18,5438034472
9078,464771591,1042,464772633,6,0,1,1024,9,10413462658
9079,464817801,2946,464820747,6,0,1,3072,9,5827382832
9080,464886440,163984,465050424,9,0,0,29184,10,3354094519
9081,464931061,50672,464981733,6,0,0,2560,9,4843464109
9082,464965231,88796,465054027,6,0,0,11776,9,9476908892
9083,465092340,103220,465195560,2,0,0,38912,4,10334543295
9084,465234600,45596,465280196,2,0,0,1024,4,9865818136
9085,465243070,108680,465351750,5,0,0,56832,11,3080651377
9086,465267210,257220,465524430,8,0,0,147456,12,5639852993
9087,465289290,125370,465414660,7,0,0,35328,18,2325594753
9088,465374490,160126,465534616,5,0,0,33280,11,9877833826
9089,465442561,1518,465444079,6,0,1,1536,9,9820416770
9090,465446399,566,465446965,3,0,1,512,9,212665622
9091,465466859,110509,465577368,0,0,0,15360,10,6690580251
9092,465477811,46634,465524445,2,0,1,2560,4,6918273972
9093,465487200,205019,465692219,3,0,0,33792,9,7515719583
9094,465517190,97171,465614361,1,0,0,20480,14,5275846736
9095,465642640,50672,465693312,5,0,0,2560,11,4630471639
9096,465792420,127658,465920078,8,0,0,81408,12,6577300675
9097,465803910,83258,465887168,2,0,0,1024,4,10219749877
9098,465858250,138514,465996764,1,0,0,101376,14,7582582285
9099,465920470,132430,466052900,7,0,0,36352,18,7827984792
9100,465945140,2870,465948010,7,0,1,8704,18,9782952271
9101,465960499,147787,466108286,0,0,0,15360,10,4212166851
9102,465986580,221174,466207754,1,0,0,26624,14,2872328980
9103,465989690,29265,466018955,7,0,1,36352,18,5424445560
9104,466106149,76494,466182643,0,0,0,5632,10,7481067591
9105,466136400,151712,466288112,5,0,0,57344,11,9343515584
9106,466219380,134582,466353962,4,0,0,40448,6,9832955637
9107,466250410,3422,466253832,4,0,1,3584,6,2268281643
9108,466269690,566,466270256,8,0,1,512,12,6521734224
9109,466330700,1994,466332694,0,0,1,2048,10,5815019442
9110,466384351,7706,466392057,5,0,1,8192,11,10613004945
9111,466412990,56996,466469986,9,0,0,8192,10,7075069301
9112,466436470,97916,466534386,3,0,0,21504,9,4901799643
9113,466499150,45596,466544746,8,0,0,1024,12,1443036183
9114,466564540,63852,466628392,3,0,0,5120,9,6141246433
9115,466607420,1042,466608462,8,0,1,1024,12,8968938241
9116,466620410,101660,466722070,8,0,0,33792,12,643024073
9117,466689629,50672,466740301,0,0,0,2560,10,5857408798
9118,466755600,79460,466835060,9,0,0,16384,10,5664059081
9119,466762900,16613,466779513,4,0,1,32256,6,5776960580
9120,466776940,11533,466788473,4,0,1,18944,6,4088190120
9121,466825341,180479,467005820,6,0,0,11264,9,1485637206
9122,466920240,98233,467018473,2,0,0,20992,4,7290379842
9123,466922040,97696,467019736,5,0,0,4096,11,3161478712
9124,466926520,99471,467025991,5,0,0,20480,11,7835045850
9125,466963230,140880,467104110,8,0,0,70144,12,9713068656
9126,466975390,85328,467060718,1,0,0,6144,14,5016172328
9127,467001080,136846,467137926,9,0,0,27648,10,4897390275
9128,467007260,3387,467010647,7,0,1,9728,18,4258915575
9129,467281411,73160,467354571,6,0,0,15872,9,6645130319
9130,467294180,74360,467368540,4,0,0,9728,6,7320971389
9131,467421560,1518,467423078,7,0,1,1536,18,1087375947
9132,467496380,4937,467501317,7,0,1,12800,18,2048066925
9133,467721529,1042,467722571,3,0,1,1024,9,1931806119
9134,467722220,50672,467772892,4,0,0,2560,6,7968200437
9135,467743620,99476,467843096,7,0,0,26624,18,5832026293
9136,467851070,98696,467949766,5,0,0,24064,11,8482528018
9137,468021690,58688,468080378,4,0,0,8704,6,4719867381
9138,468031840,114764,468146604,2,0,0,76800,4,7518627626
9139,468068011,1518,468069529,2,0,1,1536,4,5368618035
9140,468073581,566,468074147,6,0,1,512,9,8972655518
9141,468113270,82244,468195514,5,0,0,20480,11,2988508713
9142,468129350,84838,468214188,3,0,0,7680,9,269512194
9143,468249490,45596,468295086,2,0,0,1024,4,711056454
9144,468255900,98540,468354440,8,0,0,23552,12,4073083518
9145,468295310,137460,468432770,2,0,0,47616,4,10605794258
9146,468306930,3422,468310352,1,0,1,3584,14,6386456838
9147,468409830,84512,468494342,7,0,0,12800,18,9989867710
9148,468456910,177654,468634564,8,0,0,47616,12,1611550060
9149,468461310,70976,468532286,5,0,0,8704,11,10590504030
9150,468479540,103064,468582604,5,0,0,38400,11,3142259582
9151,468517059,192271,468709330,0,0,0,65024,10,7009712492
9152,468590430,185680,468776110,6,0,0,122880,9,6925837905
9153,468595510,183275,468778785,7,0,0,8704,18,2072174260
9154,468645610,216234,468861844,3,0,0,55296,9,1772379987
9155,468646359,84359,468730718,0,0,0,2048,10,1119928419
9156,468711380,2470,468713850,4,0,1,2560,6,3047550359
9157,468722141,1994,468724135,6,0,1,2048,9,9981647825
9158,468724460,163250,468887710,1,0,0,28160,14,27210871
9159,468738771,170161,468908932,6,0,0,26112,9,563341361
9160,468756780,117021,468873801,2,0,0,27136,4,6079031525
9161,468831300,151306,468982606,2,0,0,39936,4,2686626858
9162,468848210,109418,468957628,2,0,0,12288,4,7137127871
9163,468915770,68567,468984337,1,0,0,5632,14,9030400043
9164,468940681,1042,468941723,5,0,1,1024,11,8933256054
9165,469022800,60824,469083624,3,0,0,5632,9,6256567178
9166,469030940,156680,469187620,1,0,0,138752,14,10668123071
9167,469089640,143940,469233580,3,0,0,65536,9,6943446612
9168,469133171,133859,469267030,6,0,0,65536,9,5830026944
9169,469174480,173568,469348048,5,0,0,25600,11,6792128855
9170,469179370,115314,469294684,1,0,0,11776,14,1963801443
9171,469185160,131361,469316521,5,0,0,6144,11,8459434646
9172,469200270,89098,469289368,7,0,0,6656,18,7574381264
9173,469238100,88162,469326262,7,0,0,5632,18,7134051006
9174,469259799,159115,469418914,0,0,0,30208,10,7394552412
9175,469271930,181400,469453330,5,0,0,32256,11,8967331123
9176,469346930,2628,469349558,9,0,1,1536,10,5577729764
9177,469357909,43904,469401813,0,0,0,512,10,10171740861
9178,469433781,109148,469542929,6,0,0,58368,9,1657954620
9179,469474590,87785,469562375,7,0,0,5120,18,5240937610
9180,469490540,113115,469603655,3,0,0,29696,9,8922359594
9181,469499759,78836,469578595,0,0,0,14336,10,5422913239
9182,469569400,109177,469678577,5,0,0,47616,11,4057645865
9183,469616979,152349,469769328,0,0,0,11264,10,8471158669
9184,469656541,92087,469748628,6,0,0,18944,9,10525551984
9185,469774720,67904,469842624,5,0,0,8704,11,8777069914
9186,469844260,3645,469847905,4,0,1,10240,6,2378002780
9187,469914730,45596,469960326,2,0,0,1024,4,5079292562
9188,469975080,73004,470048084,7,0,0,15360,18,10051980750
9189,470069160,4374,470073534,8,0,1,4608,12,10076623362
9190,470170490,100412,470270902,2,0,0,29696,4,4647554512
9191,470232481,4679,470237160,6,0,1,12288,9,5222967627
9192,470282360,57440,470339800,8,0,0,4608,12,9535205519
9193,470487911,7706,470495617,6,0,1,8192,9,4757799550
9194,470545600,94220,470639820,2,0,0,19456,4,753941154
9195,470561410,149456,470710866,2,0,0,29696,4,2123901828
9196,470562609,64208,470626817,0,0,0,6656,10,2082903910
9197,470577160,6754,470583914,9,0,1,7168,10,6315275633
9198,470583920,47290,470631210,2,0,0,1536,4,3083046923
9199,470651070,155622,470806692,1,0,0,116224,14,3702029823
9200,470700621,10260,470710881,5,0,1,4608,11,3786070198
9201,470750470,69464,470819934,8,0,0,13824,12,7493005521
9202,470789590,229684,471019274,1,0,0,59392,14,2468866364
9203,470844960,93464,470938424,3,0,0,22016,9,5912532289
9204,470863970,126192,470990162,8,0,0,9216,12,7582193271
9205,471021960,105092,471127052,7,0,0,45056,18,6167606799
9206,471068050,100966,471169016,5,0,0,4096,11,2405656831
9207,471106820,102136,471208956,1,0,0,27648,14,466369708
9208,471115050,114435,471229485,3,0,0,28160,9,2600192113
9209,471129541,70976,471200517,6,0,0,8704,9,3894825793
9210,471159870,12737,471172607,4,0,1,24576,6,6847714086
9211,471185360,133006,471318366,3,0,0,34304,9,9552722744
9212,471227210,96475,471323685,8,0,0,17408,12,9347611636
9213,471270451,1994,471272445,5,0,1,2048,11,6787617108
9214,471273161,136849,471410010,6,0,0,40448,9,7008811133
9215,471314110,103871,471417981,7,0,0,26112,18,10271299332
9216,471330260,197021,471527281,1,0,0,70144,14,3144762721
9217,471350620,5454,471356074,8,0,1,13824,12,2143932326
9218,471356029,75962,471431991,0,0,0,4096,10,6348682747
9219,471368741,124344,471493085,6,0,0,30208,9,4025121834
9220,471423510,117937,471541447,5,0,0,4608,11,608601513
9221,471437709,155482,471593191,0,0,0,33280,10,2140203130
9222,471467830,109483,471577313,2,0,0,27136,4,9265991648
9223,471502820,132245,471635065,8,0,0,31232,12,3918623328
9224,471503510,1994,471505504,7,0,1,2048,18,4461347678
9225,471616679,100568,471717247,0,0,0,30208,10,721653802
9226,472020110,99032,472119142,1,0,0,30208,14,8210793344
9227,472074679,1518,472076197,3,0,1,1536,9,1111460235
9228,472096190,54056,472150246,3,0,0,3584,9,10586724527
9229,472225570,64520,472290090,7,0,0,7680,18,709836126
9230,472267319,1994,472269313,3,0,1,2048,9,127173209
9231,472273760,73760,472347520,8,0,0,12800,12,6253397942
9232,472414890,103688,472518578,4,0,0,40448,6,9094155514
9233,472489000,566,472489566,7,0,1,512,18,3650593305
9234,472498490,59132,472557622,5,0,0,5120,11,3887930053
9235,472553200,566,472553766,7,0,1,512,18,2149246392
9236,472651810,102908,472754718,2,0,0,37888,4,1437534794
9237,472680521,110708,472791229,6,0,0,63488,9,10690449303
9238,472728160,123795,472851955,8,0,0,34816,12,58859974
9239,472829290,77901,472907191,4,0,0,7168,6,4280525156
9240,472849970,76337,472926307,8,0,0,9728,12,10603175484
9241,472854870,43904,472898774,1,0,0,512,14,10231187365
9242,472885590,3422,472889012,4,0,1,3584,6,3854074612
9243,472892141,164794,473056935,6,0,0,5120,9,4025316332
9244,473031121,4420,473035541,6,0,1,11776,9,6365908138
9245,473042590,135014,473177604,2,0,0,4608,4,10141987344
9246,473047630,103376,473151006,1,0,0,39424,14,10463295955
9247,473096329,134021,473230350,0,0,0,10240,10,4708881496
9248,473119699,103931,473223630,0,0,0,18432,10,515437620
9249,473132890,118068,473250958,8,0,0,19968,12,8739452323
9250,473166540,104688,473271228,3,0,0,7168,9,3459169603
9251,473201990,91802,473293792,2,0,0,8192,4,4396292648
9252,473273200,4374,473277574,7,0,1,4608,18,6836662885
9253,473371550,103688,473475238,8,0,0,40448,12,9764473255
9254,473449580,54992,473504572,3,0,0,6656,9,3525042041
9255,473628000,123500,473751500,4,0,0,105472,6,8517689987
9256,473719279,61477,473780756,0,0,0,7680,10,1016177916
9257,473796230,64208,473860438,3,0,0,6656,9,1663331842
9258,473884989,76052,473961041,0,0,0,10240,10,3475560741
9259,473905710,118435,474024145,1,0,0,18432,14,858281743
9260,473914670,103844,474018514,2,0,0,40960,4,5341582698
9261,473943230,150210,474093440,8,0,0,32768,12,916811499
9262,473976980,120375,474097355,3,0,0,12800,9,9292673411
9263,473989020,115912,474104932,3,0,0,20992,9,2166644493
9264,474175950,103376,474279326,8,0,0,39424,12,3077202839
9265,474211921,45596,474257517,6,0,0,1024,9,6333351665
9266,474216749,111746,474328495,0,0,0,15360,10,8736435776
9267,474223750,3387,474227137,1,0,1,9728,14,2000447166
9268,474246900,69284,474316184,5,0,0,8192,11,5437908107
9269,474275821,4063,474279884,2,0,1,512,4,5597515873
9270,474383599,90368,474473967,0,0,0,16896,10,4757789017
9271,474391861,109928,474501789,6,0,0,60928,9,3247195062
9272,474422420,94207,474516627,1,0,0,7680,14,7312874165
9273,474533550,93644,474627194,5,0,0,27648,11,4472996484
9274,474568989,3898,474572887,3,0,1,4096,9,10693052149
9275,474708149,59132,474767281,0,0,0,5120,10,7655171853
9276,474785449,64208,474849657,0,0,0,6656,10,4243531268
9277,474867560,3387,474870947,0,0,1,9728,10,1377597327
9278,474953770,101192,475054962,7,0,0,32256,18,1919787164
9279,474995731,1042,474996773,6,0,1,1024,9,7441440583
9280,475032030,107538,475139568,8,0,0,5120,12,10513041274
9281,475043230,62828,475106058,3,0,0,7168,9,9716945552
9282,475094160,54056,475148216,2,0,0,3584,4,6107420719
9283,475113640,98096,475211736,2,0,0,27136,4,132027585
9284,475209139,5059,475214198,3,0,1,2560,9,3499262404
9285,475259100,97760,475356860,7,0,0,20992,18,5323653114
9286,475448360,48980,475497340,7,0,0,2048,18,7495243166
9287,475493910,101036,475594946,5,0,0,31744,11,3602218600
9288,475505730,89707,475595437,1,0,0,1536,14,10548948872
9289,475519040,131004,475650044,1,0,0,14848,14,7591360580
9290,475564890,111309,475676199,5,0,0,15872,11,6250748019
9291,475587010,84338,475671348,7,0,0,8704,18,2699550643
9292,475591940,90552,475682492,1,0,0,8192,14,9042186753
9293,475609381,5326,475614707,6,0,1,5632,9,10176126363
9294,475770030,68372,475838402,7,0,0,10240,18,6606133144
9295,475778730,73316,475852046,8,0,1,119296,12,2641703607
9296,475875329,2870,475878199,3,0,1,8704,9,3153576419
9297,475905400,155615,476061015,1,0,0,14336,14,3258408482
9298,475970119,70143,476040262,0,0,0,6656,10,8812391912
9299,476020009,566,476020575,3,0,1,512,9,7509133229
9300,476062651,55748,476118399,6,0,0,4096,9,8706580896
9301,476117111,2765,476119876,6,0,1,1536,9,3072542473
9302,476137489,95132,476232621,0,0,0,17408,10,6478731614
9303,476212679,60824,476273503,0,0,0,5632,10,5267860328
9304,476273260,101115,476374375,1,0,0,31232,14,1276114060
9305,476309150,100100,476409250,5,0,0,28672,11,2797228231
9306,476384110,66524,476450634,7,0,0,9216,18,6661614489
9307,476397610,104040,476501650,3,0,0,32256,9,3568442215
9308,476419270,130596,476549866,1,0,0,29184,14,8902895478
9309,476430820,93180,476524000,3,0,0,8704,9,6688477721
9310,476453140,101577,476554717,4,0,0,15872,6,6535641310
9311,476651330,99188,476750518,1,0,0,30720,14,7017464958
9312,476664490,130450,476794940,2,0,0,22528,4,1149735367
9313,476670600,83677,476754277,7,0,0,12288,18,6811788226
9314,476682510,86038,476768548,7,0,0,3072,18,6104106397
9315,476794060,51544,476845604,4,0,0,2560,6,7990501672
9316,476857840,54056,476911896,1,0,0,3584,14,9735801705
9317,476870410,54056,476924466,7,0,0,3584,18,7765445258
9318,477022570,4420,477026990,4,0,1,11776,6,1765526637
9319,477070270,50672,477120942,7,0,0,2560,18,5755301636
9320,477081990,102596,477184586,1,0,0,36864,14,10074967139
9321,477108350,110694,477219044,2,0,0,7680,4,7602760831
9322,477173510,26147,477199657,8,0,1,29184,12,283090001
9323,477183010,49037,477232047,1,0,0,2048,14,10558294746
9324,477256680,4374,477261054,0,0,1,4608,10,849713372
9325,477300140,193150,477493290,8,0,0,3072,12,4514709612
9326,477301940,328112,477630052,2,0,0,55296,4,2846971670
9327,477321090,1042,477322132,9,0,1,1024,10,2393377915
9328,477334209,3904,477338113,3,0,1,10752,9,1509227085
9329,477363800,84848,477448648,9,0,0,18944,10,5300909670
9330,477406330,157139,477563469,2,0,0,48128,4,9580650496
9331,477473950,89690,477563640,4,0,0,512,6,401082898
9332,477493560,148414,477641974,7,0,0,2560,18,7376828736
9333,477514430,1518,477515948,7,0,1,1536,18,5467445987
9334,477567730,62805,477630535,1,0,0,1536,14,6839281967
9335,477572620,566,477573186,0,0,1,512,10,1261382497
9336,477675610,106808,477782418,2,0,0,50688,4,6893180821
9337,477883710,92972,477976682,3,0,0,15360,9,3143444641
9338,477885040,157763,478042803,7,0,0,78848,18,4107848969
9339,477934521,84213,478018734,6,0,0,11776,9,9182346896
9340,477948620,70129,478018749,8,0,1,113664,12,5960711115
9341,477978601,40163,478018764,6,0,1,10240,9,2282673866
9342,478069890,10499,478080389,1,0,1,16896,14,8395368615
9343,478084410,137219,478221629,5,0,0,7168,11,7085515493
9344,478126109,159952,478286061,0,0,0,11776,10,376827065
9345,478150700,187843,478338543,7,0,0,26624,18,10485369289
9346,478238170,52364,478290534,3,0,0,3072,9,1073907526
9347,478289590,76700,478366290,3,0,0,14336,9,10270514162
9348,478299730,121418,478421148,4,0,0,11776,6,8589861630
9349,478330360,102440,478432800,2,0,0,36352,4,6704320833
9350,478364590,168578,478533168,4,0,0,61440,6,10388135787
9351,478393900,85784,478479684,8,0,0,22016,12,7240155338
9352,478467389,80179,478547568,0,0,0,5632,10,3395435315
9353,478477921,5653,478483574,6,0,1,4096,9,3773964634
9354,478554680,102440,478657120,5,0,0,36352,11,10599857841
9355,478571200,2470,478573670,0,0,1,2560,10,1911403892
9356,478578669,158749,478737418,0,0,0,87040,10,2763380952
9357,478615140,124173,478739313,8,0,0,6144,12,2117566951
9358,478681040,98072,478779112,3,0,0,22016,9,9517470869
9359,478716069,135001,478851070,0,0,0,30208,10,1044983709
9360,478737380,122285,478859665,7,0,0,28160,18,7471692746
9361,478739950,88364,478828314,7,0,0,15360,18,378567433
9362,478757300,138872,478896172,3,0,0,18432,9,3024802256
9363,478787180,156194,478943374,2,0,0,20992,4,10650472855
9364,478859360,12863,478872223,7,0,1,20992,18,8896179297
9365,478920961,1994,478922955,5,0,1,2048,11,5011547710
9366,479007100,78212,479085312,1,0,0,12288,14,586069547
9367,479059090,43904,479102994,2,0,0,512,4,3655422414
9368,479127289,76856,479204145,0,0,0,17920,10,10177201544
9369,479140170,50672,479190842,5,0,0,2560,11,3747753458
9370,479166370,48980,479215350,5,0,0,2048,11,1019774502
9371,479218770,57752,479276522,2,0,0,5632,4,3743101046
9372,479232070,47288,479279358,3,0,0,1536,9,4969751536
9373,479302760,58220,479360980,3,0,0,7168,9,5780342357
9374,479307690,134176,479441866,1,0,0,19456,14,2500509011
9375,479310789,90463,479401252,0,0,0,13312,10,746153535
9376,479454910,104468,479559378,3,0,0,43008,9,6572046750
9377,479511231,3898,479515129,6,0,1,4096,9,5080362255
9378,479546840,99557,479646397,5,0,0,20992,11,7812547117
9379,479589620,3387,479593007,4,0,1,9728,6,8644620343
9380,479594390,45596,479639986,1,0,0,1024,14,8688949933
9381,479600830,2946,479603776,4,0,1,3072,6,3357004836
9382,479626859,201648,479828507,0,0,0,50176,10,4463127019
9383,479658411,1994,479660405,2,0,1,2048,4,2073017805
9384,479761390,566,479761956,0,0,1,512,10,10084213738
9385,479776610,65612,479842222,8,0,0,11264,12,3423184662
9386,479781410,70976,479852386,7,0,0,8704,18,472500165
9387,479807280,148498,479955778,5,0,0,104448,11,8140720008
9388,479907030,566,479907596,0,0,1,512,10,10684694576
9389,479920040,124994,480045034,5,0,0,92672,11,9903217531
9390,479922610,134958,480057568,1,0,0,30720,14,3539678988
9391,479926800,121377,480048177,3,0,0,10240,9,7384127841
9392,479991769,135167,480126936,0,0,0,11264,10,2280278750
9393,480027821,121100,480148921,6,0,0,40448,9,1707342340
9394,480040740,82749,480123489,8,0,0,17920,12,9016099210
9395,480042970,93612,480136582,5,0,0,12800,11,9414651851
9396,480078310,146651,480224961,1,0,0,56320,14,3004669222
9397,480199110,97472,480296582,5,0,0,25088,11,10247173225
9398,480287010,76052,480363062,8,0,0,10240,12,9434473123
9399,480287179,59143,480346322,0,0,0,4608,10,1962197779
9400,480290400,98126,480388526,8,0,0,27136,12,7095725122
9401,480308459,149817,480458276,0,0,0,23040,10,338854197
9402,480343170,80936,480424106,1,0,0,512,14,5749804595
9403,480427470,3898,480431368,1,0,1,4096,14,798864332
9404,480477800,54056,480531856,1,0,0,3584,14,9341974025
9405,480500430,101348,480601778,1,0,0,32768,14,6518292940
9406,480524470,135058,480659528,1,0,0,24576,14,6593162183
9407,480530910,148048,480678958,2,0,0,4096,4,4922851502
9408,480545620,193354,480738974,8,0,0,57344,12,6498700252
9409,480550310,1042,480551352,4,0,1,1024,6,1778614992
9410,480582470,108332,480690802,7,0,0,7680,18,9593413121
9411,480753309,59756,480813065,0,0,0,7168,10,1847313814
9412,480753720,117572,480871292,5,0,0,86016,11,2181337306
9413,480804339,141569,480945908,0,0,0,31232,10,1505789324
9414,480856449,19685,480876134,3,0,1,5120,9,6680013876
9415,480892580,123498,481016078,4,0,0,45568,6,9887120311
9416,480910830,55748,480966578,6,0,0,4096,9,3093955975
9417,480923060,50672,480973732,2,0,0,2560,4,4985311335
9418,480932049,142332,481074381,0,0,0,27136,10,849556783
9419,480973881,72161,481046042,6,0,0,512,9,1191127524
9420,480992850,81858,481074708,5,0,0,1024,11,7531619656
9421,481021979,133672,481155651,0,0,0,55808,10,3884956472
9422,481055631,3904,481059535,2,0,1,10752,4,2655904003
9423,481093980,5326,481099306,0,0,1,5632,10,9886353585
9424,481139329,123122,481262451,0,0,0,50688,10,5517764520
9425,481231610,104156,481335766,1,0,0,41984,14,9310609850
9426,481351499,2470,481353969,3,0,1,2560,9,10474197803
9427,481405960,74516,481480476,1,0,0,10240,14,1103176909
9428,481493520,96704,481590224,2,0,0,27136,4,6720790463
9429,481535530,65350,481600880,6,0,0,6656,9,2905944788
9430,481544599,93331,481637930,0,0,0,6144,10,3118734292
9431,481819390,98252,481917642,8,0,0,27648,12,7659664318
9432,481867430,85316,481952746,5,0,0,20480,11,5792242734
9433,481959290,55904,482015194,5,0,0,4608,11,712908671
9434,481984230,88786,482073016,2,0,0,11776,4,9333674373
9435,482177200,50672,482227872,6,0,0,2560,9,7996590831
9436,482299220,74360,482373580,3,0,0,9728,9,6830672038
9437,482336410,106808,482443218,8,0,0,50688,12,7106784956
9438,482371360,12711,482384071,0,0,1,16896,10,6495248696
9439,482376660,115416,482492076,2,0,0,13312,4,8985124539
9440,482381000,124995,482505995,6,0,0,40960,9,1824858984
9441,482449520,95859,482545379,7,0,0,6656,18,8697168780
9442,482501820,100679,482602499,2,0,0,16896,4,2416016735
9443,482548630,3387,482552017,4,0,1,9728,6,10382675370
9444,482625220,64520,482689740,8,0,0,7680,12,1961697331
9445,482759980,7706,482767686,1,0,1,8192,14,9381310061
9446,482996840,4374,483001214,1,0,1,4608,14,5512801194
9447,483020580,52364,483072944,8,0,0,3072,12,4219684270
9448,483109200,104780,483213980,7,0,0,44032,18,6871862182
9449,483274530,99008,483373538,8,0,0,25088,12,7533387062
9450,483391130,5326,483396456,9,0,1,5632,10,1908528204
9451,483393659,102596,483496255,0,0,0,36864,10,2626780770
9452,483464590,566,483465156,9,0,1,512,10,1388155367
9453,483481140,15130,483496270,1,0,1,6144,14,2446687115
9454,483494610,14647,483509257,4,0,1,25088,6,318124751
9455,483523400,49292,483572692,6,0,0,3072,9,8532406072
9456,483574670,57440,483632110,8,0,0,4608,12,1341514934
9457,483580930,175585,483756515,5,0,0,43520,11,1003815649
9458,483613310,114272,483727582,3,0,0,8192,9,5756745010
9459,483627640,198277,483825917,1,0,0,63488,14,4574114942
9460,483646380,116622,483763002,4,0,0,7168,6,9201766566
9461,483712320,66836,483779156,3,0,0,10240,9,6336665935
9462,483718570,115162,483833732,2,0,0,25600,4,9744740456
9463,483728780,62828,483791608,2,0,0,7168,4,9563228602
9464,483754051,10162,483764213,6,0,1,8192,9,10458911810
9465,483836070,99632,483935702,5,0,0,27136,11,4858229335
9466,483883570,97600,483981170,5,0,0,12800,11,8000438213
9467,483910100,243632,484153732,8,0,1,394240,12,5673860661
9468,483970670,332486,484303156,2,0,0,21504,4,10207857002
9469,484070230,337813,484408043,8,0,0,50176,12,10291907447
9470,484095009,105996,484201005,3,0,1,160768,9,3234084931
9471,484098600,227969,484326569,5,0,0,10752,11,8192942467
9472,484159590,214340,484373930,1,0,0,5120,14,4656771616
9473,484186570,14781,484201351,0,0,1,512,10,10642723873
9474,484216980,209777,484426757,2,0,0,4608,4,2515466973
9475,484248760,169192,484417952,3,0,0,17408,9,3510335754
9476,484317170,119424,484436594,1,0,0,4096,14,5039175167
9477,484395570,22397,484417967,0,0,1,15360,10,7465387299
9478,484571500,81596,484653096,3,0,0,13312,9,2301516584
9479,484649740,55712,484705452,3,0,0,3072,9,527766595
9480,484668970,64208,484733178,3,0,0,6656,9,10327679103
9481,484759120,12737,484771857,1,0,1,24576,14,8084173098
9482,484776110,7706,484783816,4,0,1,8192,6,4632285888
9483,484868990,196471,485065461,2,0,0,26624,4,6143098778
9484,484885429,97161,484982590,0,0,0,27648,10,1464639399
9485,484887410,84668,484972078,1,0,0,13312,14,2280168486
9486,484939660,82073,485021733,6,0,0,4096,9,5856977993
9487,485047840,79592,485127432,3,0,0,11776,9,7491682556
9488,485067860,109108,485176968,2,0,0,28160,4,5172124132
9489,485087751,1994,485089745,5,0,1,2048,11,10414363453
9490,485143999,87164,485231163,0,0,0,21504,10,1051313423
9491,485224760,17928,485242688,9,0,1,18944,10,5419021020
9492,485345340,5802,485351142,1,0,1,6144,14,5081031707
9493,485437790,52364,485490154,5,0,0,3072,11,7331979464
9494,485456789,75320,485532109,0,0,0,17920,10,10205478505
9495,485507210,70976,485578186,1,0,0,8704,14,206645923
9496,485521430,61916,485583346,5,0,0,9216,11,5975711959
9497,485531140,58170,485589310,6,0,0,3584,9,9991180534
9498,485535761,6278,485542039,2,0,1,6656,4,4648804392
9499,485579139,93825,485672964,3,0,1,152576,9,4564470224
9500,485596060,135616,485731676,1,0,0,6656,14,129385019
9501,485676199,232619,485908818,0,0,0,6656,10,7818406928
9502,485682620,253469,485936089,4,0,0,86016,6,7518772876
9503,485682919,171227,485854146,0,0,0,8704,10,6492549013
9504,485717280,5326,485722606,0,0,1,5632,10,2709952491
9505,485808629,132467,485941096,0,0,0,16384,10,8578911675
9506,485863340,114635,485977975,8,0,0,35840,12,10558477284
9507,485868020,141593,486009613,2,0,0,27648,4,4160507419
9508,486009660,2470,486012130,4,0,1,2560,6,8776447746
9509,486018840,104624,486123464,1,0,0,43520,14,10049907175
9510,486048950,127723,486176673,6,0,0,32256,9,6581811650
9511,486115110,101810,486216920,8,0,0,10240,12,8856982240
9512,486283560,99944,486383504,8,0,0,28160,12,6825057866
9513,486346370,5326,486351696,0,0,1,5632,10,6800512854
9514,486402229,10241,486412470,3,0,1,16384,9,2807616838
9515,486536359,59132,486595491,0,0,0,5120,10,2474532082
9516,486578720,11533,486590253,9,0,1,18944,10,2604861152
9517,486581530,58143,486639673,4,0,0,1024,6,1207547928
9518,486713911,2946,486716857,2,0,1,3072,4,6656371004
9519,486721981,3898,486725879,2,0,1,4096,4,2258210020
9520,486722260,48774,486771034,8,0,0,3072,12,2896618108
9521,486763000,134112,486897112,4,0,0,75776,6,10660582712
9522,486782660,43904,486826564,3,0,0,512,9,9794494775
9523,486825110,137456,486962566,3,0,0,72704,9,644478818
9524,486869469,276075,487145544,3,0,1,447488,9,1931402819
9525,486901840,292691,487194531,2,0,0,34816,4,2113383379
9526,486915980,240291,487156271,0,0,1,34816,10,4347519870
9527,486987080,270585,487257665,5,0,0,39424,11,3294937029
9528,487145550,328886,487474436,8,0,0,31744,12,74549398
9529,487153989,212236,487366225,0,0,0,67072,10,8810344569
9530,487265360,165469,487430829,2,0,0,17408,4,8869746624
9531,487273430,3898,487277328,1,0,1,4096,14,8038230566
9532,487442470,83062,487525532,2,0,0,5632,4,1046308069
9533,487480110,6754,487486864,1,0,1,7168,14,6740126039
9534,487539000,122655,487661655,8,0,0,14848,12,3085456242
9535,487590520,95920,487686440,2,0,0,20480,4,4972441035
9536,487638811,2946,487641757,2,0,1,3072,4,2701767330
9537,487732550,566,487733116,1,0,1,512,14,3257163390
9538,487756910,45596,487802506,3,0,0,1024,9,230413113
9539,487827420,1518,487828938,1,0,1,1536,14,6593630443
9540,487952770,44115,487996885,9,0,0,512,10,9741025577
9541,487954310,5326,487959636,4,0,1,5632,6,5837816867
9542,487957680,74852,488032532,2,0,0,16384,4,2803803889
9543,488136920,66524,488203444,4,0,0,9216,6,8455810510
9544,488193710,70688,488264398,1,0,0,12800,14,6046914317
9545,488244849,106496,488351345,0,0,0,49664,10,1055878062
9546,488355330,48980,488404310,6,0,0,2048,9,1467077237
9547,488371910,91172,488463082,5,0,0,24576,11,7852753698
9548,488458060,95118,488553178,1,0,0,26112,14,4040436900
9549,488475870,64364,488540234,4,0,0,7168,6,9519365115
9550,488507750,112730,488620480,3,0,0,24064,9,8879202956
9551,488568790,64208,488632998,8,0,0,6656,12,6847614220
9552,488596819,56153,488652972,0,0,0,512,10,7297805084
9553,488633009,81908,488714917,0,0,0,14336,10,1439235689
9554,488645090,93359,488738449,6,0,0,20992,9,5883388528
9555,488679510,130429,488809939,2,0,0,27648,4,2950970195
9556,488753080,142701,488895781,3,0,0,81408,9,8959896308
9557,488805860,142988,488948848,8,0,0,20992,12,9265877008
9558,488805889,91935,488897824,0,0,0,6656,10,6432872339
9559,489059000,4374,489063374,9,0,1,4608,10,6049230338
9560,489222569,143317,489365886,0,0,0,16384,10,9730182256
9561,489225040,135839,489360879,6,0,0,43520,9,7300392515
9562,489228640,54056,489282696,1,0,0,3584,14,3045916141
9563,489231440,116164,489347604,3,0,0,55296,9,3654757319
9564,489261609,135358,489396967,3,0,1,220160,9,6623807223
9565,489279780,120733,489400513,8,0,1,5632,12,4228424779
9566,489296000,213141,489509141,6,0,0,11776,9,8186857942
9567,489326520,221226,489547746,6,0,0,29184,9,803790036
9568,489401370,43370,489444740,8,0,1,74240,12,2364152448
9569,489437020,149264,489586284,2,0,0,18432,4,3919243585
9570,489450269,2470,489452739,3,0,1,2560,9,1370931109
9571,489464230,90812,489555042,5,0,0,12800,11,2701618539
9572,489681410,54056,489735466,8,0,0,3584,12,4886993835
9573,489686490,61916,489748406,1,0,0,9216,14,5481559763
9574,489793570,71600,489865170,4,0,0,10752,6,3174909403
9575,489803069,43904,489846973,0,0,0,512,10,1605100941
9576,489830599,97757,489928356,0,0,0,15360,10,7719691738
9577,489890610,3128,489893738,9,0,1,9216,10,7659572567
9578,489921049,102827,490023876,0,0,0,29184,10,9914838216
9579,489937690,236258,490173948,3,0,0,15360,9,1828359355
9580,489974430,100008,490074438,5,0,0,27648,11,2810086073
9581,489976370,246928,490223298,8,0,0,50176,12,9838279888
9582,489990109,158246,490148355,0,0,0,30720,10,10619549789
9583,490036320,102660,490138980,5,0,0,26624,11,8041819044
9584,490075830,81648,490157478,8,0,0,512,12,1138874267
9585,490097860,81620,490179480,3,0,0,1024,9,9971283759
9586,490134740,156430,490291170,8,0,0,111616,12,2982298714
9587,490271570,96424,490367994,5,0,0,12800,11,10132426311
9588,490372610,55748,490428358,5,0,0,4096,11,5175380257
9589,490429150,67592,490496742,4,0,0,7680,6,2216471974
9590,490474700,96536,490571236,4,0,0,22016,6,10735612796
9591,490931920,100568,491032488,4,0,0,30208,6,7692398195
9592,490944869,103447,491048316,0,0,0,31744,10,8044045374
9593,490968980,99719,491068699,4,0,0,4608,6,36196687
9594,491027320,115112,491142432,6,0,0,40960,9,8088503365
9595,491046180,130128,491176308,6,0,0,26112,9,7391150703
9596,491071540,3128,491074668,0,0,1,9216,10,2124909934
9597,491158040,47288,491205328,1,0,0,1536,14,7832849791
9598,491234040,73604,491307644,5,0,0,12288,11,7119100875
9599,491247730,60553,491308283,1,0,0,2048,14,7834911964
9600,491276510,112590,491389100,2,0,0,40448,4,276804693
9601,491335220,148776,491483996,2,0,0,52224,4,981767712
9602,491427550,77764,491505314,4,0,0,5120,6,1581557354
9603,491564390,83624,491648014,1,0,0,19968,14,4655118855
9604,491615120,87296,491702416,8,0,0,16896,12,8028115522
9605,491643830,139280,491783110,8,0,0,53760,12,6798086423
9606,491685849,103204,491789053,0,0,0,19456,10,2306892483
9607,491700260,90836,491791096,2,0,0,6656,4,5883267448
9608,491942330,87140,492029470,8,0,0,16384,12,480980358
9609,491945329,101972,492047301,0,0,0,34816,10,377078993
9610,491974140,76608,492050748,1,0,0,11264,14,9085000247
9611,492059829,4850,492064679,3,0,1,5120,9,2303940541
9612,492069489,81752,492151241,0,0,0,13824,10,5429138138
9613,492091300,6278,492097578,1,0,1,6656,14,6351337188
9614,492097341,1994,492099335,2,0,1,2048,4,10493434341
9615,492209930,153912,492363842,3,0,0,11264,9,1509636336
9616,492244470,104936,492349406,6,0,0,44544,9,2160998335
9617,492260780,92541,492353321,6,0,0,12800,9,4901103265
9618,492275850,77642,492353492,8,0,0,512,12,1284668185
9619,492304551,5802,492310353,2,0,1,6144,4,5719367848
9620,492448300,125120,492573420,1,0,0,65536,14,1172585302
9621,492465160,139724,492604884,4,0,0,52736,6,8647041629
9622,492482320,1042,492483362,1,0,1,1024,14,10391047092
9623,492502030,153176,492655206,1,0,0,65536,14,6555646191
9624,492588230,67615,492655845,3,0,0,2048,9,5360910754
9625,492609229,76625,492685854,0,0,0,2560,10,3311802450
9626,492621970,3898,492625868,1,0,1,4096,14,1705277057
9627,492652620,48813,492701433,8,0,0,1024,12,3153116814
9628,492783720,104468,492888188,8,0,0,43008,12,422766543
9629,492889040,20366,492909406,4,0,1,32768,6,7795299406
9630,492951150,55748,493006898,3,0,0,4096,9,7371433619
9631,492968120,106881,493075001,3,0,0,13824,9,6865546395
9632,492999400,93330,493092730,1,0,0,7168,14,4928599206
9633,493190951,566,493191517,5,0,1,512,11,1242086385
9634,493265010,10757,493275767,1,0,1,17408,14,9183647188
9635,493278639,14287,493292926,3,0,1,27648,9,9073836267
9636,493318560,104228,493422788,3,0,0,13312,9,10575403261
9637,493378570,157178,493535748,6,0,0,25600,9,7505634288
9638,493473550,70230,493543780,2,0,0,8704,4,9669091995
9639,493474340,96980,493571320,6,0,0,18432,9,10194318775
9640,493508550,111172,493619722,4,0,0,14848,6,3543717517
9641,493519790,63020,493582810,4,0,0,4608,6,9214557351
9642,493533680,73372,493607052,8,0,0,14848,12,3723195983
9643,493535960,76232,493612192,8,0,0,15872,12,4858029803
9644,493658709,104624,493763333,0,0,0,43520,10,3519763932
9645,493671550,123067,493794617,2,0,0,65536,4,240137584
9646,493691620,1042,493692662,9,0,1,1024,10,6416323039
9647,493744950,147648,493892598,8,0,0,125952,12,6336794577
9648,493856950,129860,493986810,2,0,0,19456,4,7536005343
9649,493877270,155708,494032978,1,0,0,109568,14,1627545853
9650,493908230,85901,493994131,2,0,0,3072,4,3981620256
9651,493947030,137461,494084491,5,0,0,30208,11,6542170917
9652,494038350,119539,494157889,5,0,0,83456,11,10477092507
9653,494125550,97596,494223146,8,0,0,27136,12,266671268
9654,494172400,75140,494247540,8,0,0,12288,12,8904576617
9655,494200950,105092,494306042,5,0,0,45056,11,447898776
9656,494379510,79081,494458591,5,0,0,9728,11,6032220209
9657,494393259,5326,494398585,3,0,1,5632,9,8027037653
9658,494414640,47288,494461928,3,0,0,1536,9,792622714
9659,494476120,106028,494582148,2,0,0,48128,4,4895493642
9660,494533090,4162,494537252,8,0,1,11264,12,407383609
9661,494586781,13083,494599864,5,0,1,22016,11,4773372234
9662,494620019,74917,494694936,0,0,0,512,10,8997600628
9663,494665270,47288,494712558,1,0,0,1536,14,8068749437
9664,494729810,121845,494851655,1,0,0,13312,14,1794825841
9665,494742911,7706,494750617,5,0,1,8192,11,4671193455
9666,494744870,102714,494847584,1,0,0,35328,14,10270403218
9667,494766700,56528,494823228,6,0,0,6656,9,1043953752
9668,494823600,61916,494885516,5,0,0,9216,11,8681285937
9669,494880590,55748,494936338,2,0,0,4096,4,10519472161
9670,494898080,85292,494983372,3,0,0,15360,9,9238920931
9671,494998340,100568,495098908,2,0,0,30208,4,2103799543
9672,495033300,181720,495215020,6,0,0,111616,9,7954087501
9673,495040650,118952,495159602,4,0,0,7680,6,2865396344
9674,495150559,180223,495330782,0,0,0,79872,10,4644443909
9675,495165930,119600,495285530,4,0,0,92672,6,3213862904
9676,495182240,222378,495404618,8,0,0,22528,12,4219976414
9677,495314990,20204,495335194,1,0,1,11776,14,5799536825
9678,495371930,4162,495376092,0,0,1,11264,10,2025147645
9679,495430091,1994,495432085,2,0,1,2048,4,975950559
9680,495485550,191876,495677426,8,0,0,19968,12,2411758868
9681,495547900,60824,495608724,4,0,0,5632,6,144988928
9682,495565030,96700,495661730,1,0,0,13824,14,309049016
9683,495610059,99476,495709535,0,0,0,26624,10,4786462798
9684,495668440,99025,495767465,4,0,0,24064,6,150909002
9685,495724300,126925,495851225,2,0,0,19456,4,2942138453
9686,495762460,65821,495828281,2,0,0,5632,4,9050856327
9687,495803540,128643,495932183,4,0,0,47104,6,6881898041
9688,495809440,45596,495855036,1,0,0,1024,14,6197116053
9689,495818300,87141,495905441,8,0,0,3584,12,427221374
9690,495972990,97760,496070750,8,0,0,20992,12,2765358429
9691,496010510,50672,496061182,2,0,0,2560,4,748732648
9692,496021850,4937,496026787,0,0,1,12800,10,9460065832
9693,496159660,1518,496161178,1,0,1,1536,14,7818111347
9694,496251610,45596,496297206,1,0,0,1024,14,2258368095
9695,496296480,89792,496386272,2,0,0,25088,4,10574571969
9696,496408120,99008,496507128,1,0,0,25088,14,1366107765
9697,496412739,68216,496480955,0,0,0,9728,10,3002488624
9698,496613570,72686,496686256,8,0,0,3584,12,3216632307
9699,496626980,90392,496717372,5,0,0,22016,11,8540720545
9700,496628679,92920,496721599,0,0,0,13824,10,10320864320
9701,496632200,158332,496790532,8,0,0,98304,12,3618767224
9702,496636909,166274,496803183,0,0,0,41472,10,4968538957
9703,496641290,3904,496645194,9,0,1,10752,10,9517275538
9704,496641740,9121,496650861,9,0,1,15360,10,881719236
9705,496643390,168708,496812098,4,0,0,29184,6,8573977267
9706,496654870,6278,496661148,9,0,1,6656,10,2599461179
9707,496699370,167834,496867204,1,0,0,22528,14,1798647300
9708,496704720,165463,496870183,6,0,0,9728,9,5473721934
9709,496746260,66321,496812581,6,0,0,1536,9,2312857674
9710,496782800,140937,496923737,8,0,0,45568,12,225395893
9711,496817079,173312,496990391,0,0,0,36352,10,9100759203
9712,496853020,51997,496905017,1,0,0,2048,14,630552142
9713,496919750,96295,497016045,8,0,0,12288,12,3244400093
9714,497018060,104312,497122372,1,0,0,42496,14,7359000807
9715,497028650,96233,497124883,3,0,0,8192,9,5919255022
9716,497103460,69690,497173150,3,0,0,5632,9,558901756
9717,497120931,7842,497128773,2,0,1,4096,4,2439509505
9718,497173310,104468,497277778,2,0,0,43008,4,5452064585
9719,497222671,1042,497223713,5,0,1,1024,11,1353880379
9720,497247780,96092,497343872,6,0,0,25600,9,1407583084
9721,497262320,43904,497306224,8,0,0,512,12,3666456760
9722,497423570,102440,497526010,2,0,0,36352,4,4954716223
9723,497460320,82652,497542972,1,0,0,10240,14,10360164216
9724,497495810,1042,497496852,0,0,1,1024,10,4999263458
9725,497616960,64520,497681480,8,0,0,7680,12,1483887902
9726,497650020,86828,497736848,5,0,0,15360,11,497818694
9727,497714670,43904,497758574,4,0,0,512,6,5428848958
9728,497725590,99944,497825534,4,0,0,28160,6,4618574552
9729,497803980,45596,497849576,8,0,0,1024,12,4579759429
9730,498009820,5196,498015016,9,0,1,13312,10,1740327231
9731,498122810,104000,498226810,3,0,0,41472,9,5117957737
9732,498180170,110360,498290530,6,0,0,21504,9,5971130193
9733,498258900,101014,498359914,2,0,0,30208,4,8955599714
9734,498495201,566,498495767,2,0,1,512,4,1885077234
9735,498508790,1518,498510308,1,0,1,1536,14,9182798073
9736,498510469,61760,498572229,0,0,0,8704,10,7959933970
9737,498578660,43904,498622564,1,0,0,512,14,640844584
9738,498606960,66212,498673172,4,0,0,8192,6,8641206350
9739,498620740,68572,498689312,1,0,0,10752,14,364870486
9740,498674900,3128,498678028,1,0,1,9216,14,2880183842
9741,498728190,95312,498823502,1,0,0,23040,14,8064701342
9742,498738681,566,498739247,2,0,1,512,4,8286410286
9743,498848150,2470,498850620,4,0,1,2560,6,1732764748
9744,498854970,124417,498979387,1,0,0,101888,14,1924967662
9745,498883130,130139,499013269,2,0,0,15360,4,8590409538
9746,498897020,4374,498901394,8,0,1,4608,12,2003785294
9747,499053080,110084,499163164,8,0,0,61440,12,3604113698
9748,499132069,58844,499190913,0,0,0,9216,10,9363276595
9749,499145030,21089,499166119,1,0,1,3072,14,9711052821
9750,499155330,11775,499167105,4,0,1,1536,6,1558804114
9751,499420690,87452,499508142,2,0,0,17408,4,9302881442
9752,499432250,102184,499534434,8,0,0,23040,12,436102019
9753,499437770,111499,499549269,8,0,0,48640,12,1720324384
9754,499600260,100568,499700828,2,0,0,30208,4,9733172625
9755,499605900,153596,499759496,8,0,0,61440,12,3389197208
9756,499655880,118742,499774622,2,0,0,4096,4,8559525300
9757,499671770,105198,499776968,4,0,0,5632,6,4261583393
9758,499827080,58376,499885456,5,0,0,7680,11,9910626454
9759,499859710,1518,499861228,4,0,1,1536,6,9056249633
9760,499887150,109616,499996766,5,0,0,59904,11,2957634269
9761,499888150,64208,499952358,8,0,0,6656,12,5054152358
9762,499977031,19750,499996781,5,0,1,2560,11,4562354226
9763,500073930,109148,500183078,1,0,0,58368,14,3851375477
9764,500088671,566,500089237,2,0,1,512,4,2299511096
9765,500340040,10757,500350797,4,0,1,17408,6,617322464
9766,500443610,5454,500449064,4,0,1,13824,6,8531057106
9767,500445150,53393,500498543,1,0,0,2560,14,9250560277
9768,500473330,59288,500532618,9,0,0,5632,10,8899043698
9769,500508570,51140,500559710,5,0,0,4096,11,8830790585
9770,500518220,178694,500696914,1,0,0,30720,14,6355284563
9771,500520651,7706,500528357,5,0,1,8192,11,10366098162
9772,500771740,72668,500844408,2,0,0,9216,4,1261581635
9773,500882940,60824,500943764,1,0,0,5632,14,4989172563
9774,500958910,84380,501043290,5,0,0,17408,11,9772398770
9775,500963750,120886,501084636,1,0,0,15872,14,4652839597
9776,501122740,62516,501185256,1,0,0,6144,14,5756779983
9777,501234870,71000,501305870,5,0,0,13824,11,5498153331
9778,501371550,102128,501473678,1,0,0,35328,14,2251887819
9779,501412730,137118,501549848,1,0,0,57344,14,3968312528
9780,501721300,116480,501837780,9,0,0,82432,10,7056430853
9781,501789241,2946,501792187,2,0,1,3072,4,8516026851
9782,501825290,74998,501900288,8,0,0,6144,12,9266462667
9783,501888020,84512,501972532,5,0,0,12800,11,6538838397
9784,501963750,70726,502034476,5,0,0,7168,11,3787878691
9785,502038290,89612,502127902,5,0,0,19456,11,2832990020
9786,502177120,3422,502180542,8,0,1,3584,12,6082343427
9787,502235700,327733,502563433,1,0,1,531456,14,2331419663
9788,502659400,113895,502773295,1,0,0,10240,14,6062495488
9789,502841411,1994,502843405,2,0,1,2048,4,5410362290
9790,502917220,62384,502979604,9,0,0,10752,10,6102523506
9791,502917620,2946,502920566,8,0,1,3072,12,4854069701
9792,503063130,85628,503148758,5,0,0,21504,11,2902762893
9793,503080020,1042,503081062,9,0,1,1024,10,2143225200
9794,503125330,158813,503284143,2,0,0,13312,4,2718829850
9795,503230640,101660,503332300,2,0,0,33792,4,10472793289
9796,503299220,45596,503344816,5,0,0,1024,11,2717388379
9797,503401330,101036,503502366,9,0,0,31744,10,2166369145
9798,503492850,99432,503592282,9,0,0,20480,10,6922191120
9799,503509390,54212,503563602,8,0,0,4096,12,13303199
9800,503651290,50984,503702274,2,0,0,3584,4,2584409786
9801,503771920,45596,503817516,2,0,0,1024,4,6535690405
9802,503977070,101660,504078730,5,0,0,33792,11,7790007939
9803,504124800,47288,504172088,4,0,0,1536,6,5722622970
9804,504126980,94820,504221800,8,0,0,16384,12,1363947551
9805,504186180,73448,504259628,1,0,0,11776,14,1026557646
9806,504220730,102722,504323452,2,0,0,33792,4,2682436729
9807,504546030,52364,504598394,2,0,0,3072,4,7719604183
9808,504639980,65900,504705880,4,0,0,7168,6,3988071824
9809,504777650,76364,504854014,5,0,0,11264,11,2708507307
9810,504820201,3904,504824105,5,0,1,10752,11,10020830899
9811,504842250,99008,504941258,9,0,0,25088,10,9869885964
9812,504901280,86204,504987484,8,0,0,13312,12,6255080386
9813,504999820,135358,505135178,1,0,1,220160,14,7088848871
9814,505059520,253581,505313101,8,0,0,52736,12,8759616003
9815,505091020,263358,505354378,4,0,0,18944,6,1951001374
9816,505095110,44574,505139684,1,0,1,7168,14,5781049407
9817,505207520,125327,505332847,4,0,0,30720,6,10428095937
9818,505262870,143651,505406521,8,0,0,44544,12,1398732495
9819,505627750,3422,505631172,9,0,1,3584,10,8116726034
9820,505828790,45596,505874386,5,0,0,1024,11,10395470261
9821,505865370,102440,505967810,1,0,0,36352,14,1967677260
9822,505871340,105533,505976873,5,0,0,29696,11,9152325618
9823,505972000,108865,506080865,9,0,0,41472,10,2113921370
9824,506214009,89588,506303597,9,0,0,14336,10,3819972258
9825,506331220,105872,506437092,5,0,0,47616,11,3276899995
9826,506355000,108198,506463198,1,0,0,6144,14,8640602273
9827,506430650,8428,506439078,8,0,1,2048,12,9178429966
9828,506504450,101504,506605954,1,0,0,33280,14,9989049010
9829,506651740,101348,506753088,8,0,0,32768,12,8392676991
9830,506721230,99274,506820504,8,0,0,14848,12,1808117431
9831,506742560,92864,506835424,1,0,0,25088,14,9951985984
9832,506829740,105152,506934892,4,0,0,26624,6,1278399578
9833,506884169,134009,507018178,9,0,0,92160,10,9975305412
9834,506939770,102840,507042610,5,0,0,13824,11,3250516286
9835,507149540,98072,507247612,8,0,0,22016,12,5430766358
9836,507178340,71627,507249967,8,0,0,7680,12,5936426092
9837,507206960,6754,507213714,1,0,1,7168,14,6515284682
9838,507237390,78080,507315470,4,0,0,16896,6,10551442958
9839,507304829,100412,507405241,9,0,0,29696,10,3671951002
9840,507351840,59132,507410972,4,0,0,5120,6,7832966796
9841,507659050,101972,507761022,8,0,0,34816,12,7000902991
9842,507703100,99008,507802108,4,0,0,25088,6,4789691827
9843,507801260,66740,507868000,1,0,0,7168,14,836631242
9844,507849830,69440,507919270,1,0,0,8704,14,9526587771
9845,507929340,100100,508029440,4,0,0,28672,6,8999636507
9846,507972530,4850,507977380,8,0,1,5120,12,3874723776
9847,508003780,123520,508127300,1,0,0,50176,14,7857539001
9848,508064410,11791,508076201,1,0,1,19456,14,9763268662
9849,508106670,100724,508207394,9,0,0,30720,10,3628976488
9850,508314470,52364,508366834,4,0,0,3072,6,5965518879
9851,508338360,100724,508439084,5,0,0,30720,11,6631824359
9852,508353900,54056,508407956,5,0,0,3584,11,8764087969
9853,508482170,161686,508643856,1,0,0,107008,14,2438007397
9854,508492240,186107,508678347,4,0,0,113152,6,9065447409
9855,508562649,153049,508715698,9,0,0,35840,10,4563418988
9856,508744720,105872,508850592,8,0,0,47616,12,3867413494
9857,508928690,110552,509039242,8,0,0,62976,12,2679292654
9858,509098210,43904,509142114,1,0,0,512,14,8630230469
9859,509099770,52364,509152134,9,0,0,3072,10,6750962066
9860,509371690,65144,509436834,5,0,0,9728,11,323325466
9861,509702910,3387,509706297,1,0,1,9728,14,9464800284
9862,509911160,59132,509970292,9,0,0,5120,10,4407554385
9863,510048670,64388,510113058,5,0,0,12288,11,9068332016
9864,510261580,85604,510347184,5,0,0,16384,11,5541548375
9865,510369820,1518,510371338,8,0,1,1536,12,2399669580
9866,510524210,84512,510608722,8,0,0,12800,12,3604294916
9867,510928030,50984,510979014,5,0,0,3584,11,7273767195
9868,511327780,58688,511386468,5,0,0,8704,11,10334933683
9869,511392430,95912,511488342,8,0,0,19968,12,4566918838
9870,511413740,122369,511536109,5,0,0,33280,11,2297088134
9871,511434511,3422,511437933,5,0,1,3584,11,8114609861
9872,511491780,13600,511505380,8,0,1,23040,12,9112003565
9873,511563600,103376,511666976,8,0,0,39424,12,992370439
9874,511663290,65126,511728416,9,0,0,7680,10,7215603609
9875,511883260,25962,511909222,8,0,1,47104,12,3061876548
9876,511884890,105899,511990789,5,0,0,15872,11,4361996832
9877,512003380,47288,512050668,8,0,0,1536,12,9219056375
9878,512101460,76052,512177512,8,0,0,10240,12,4889681609
9879,512247481,566,512248047,5,0,1,512,11,7533985915
9880,512292270,76052,512368322,9,0,0,10240,10,6551970693
9881,512309970,119672,512429642,9,0,0,50176,10,960633718
9882,512328830,7706,512336536,5,0,1,8192,11,9181057194
9883,512383310,230541,512613851,8,0,0,16896,12,5596143267
9884,512427240,95185,512522425,8,0,1,150528,12,10188265314
9885,512544600,95237,512639837,9,0,0,15360,10,8169581853
9886,512739990,76676,512816666,9,0,0,12288,10,9593078616
9887,513028460,118664,513147124,9,0,0,89600,10,9416362865
9888,513088450,122622,513211072,5,0,0,19968,11,2637821411
9889,513366790,103064,513469854,9,0,0,38400,10,5488426791
9890,513386271,5712,513391983,5,0,1,14336,11,753668390
9891,513387530,102322,513489852,8,0,0,25600,12,3844214706
9892,513533770,125528,513659298,5,0,0,112128,11,622213016
9893,513715450,105872,513821322,5,0,0,47616,11,2294505830
9894,513886880,86360,513973240,9,0,0,13824,10,1197392063
9895,513998150,140873,514139023,5,0,0,33280,11,4224963441
9896,514004180,14804,514018984,8,0,1,28672,12,3979491684
9897,514118840,162495,514281335,9,0,0,33792,10,3960421203
9898,514225559,119052,514344611,9,0,0,17408,10,9880490187
9899,514388460,94532,514482992,5,0,0,20480,11,9551201534
9900,514567180,56528,514623708,9,0,0,6656,10,3012705370
9901,514586180,106750,514692930,5,0,0,20992,11,8156920656
9902,514732210,60536,514792746,5,0,0,9728,11,1433133334
9903,514855880,43904,514899784,8,0,0,512,12,4926545226
9904,514875820,82976,514958796,5,0,0,12800,11,3046344350
9905,515086129,97604,515183733,9,0,0,20480,10,508350336
9906,515253050,70991,515324041,8,0,1,114688,12,4370385601
9907,515871220,99008,515970228,8,0,0,25088,12,7041241815
9908,515882230,145418,516027648,9,0,0,52224,10,3552906671
9909,516127239,99164,516226403,9,0,0,25600,10,2795903799
9910,516256760,77300,516334060,8,0,0,14336,12,9117531400
9911,516565240,102440,516667680,9,0,0,36352,10,8813861315
9912,516787920,48980,516836900,8,0,0,2048,12,1851852599
9913,516842670,62516,516905186,9,0,0,6144,10,9286065058
9914,516857830,3387,516861217,9,0,1,9728,10,10673037134
9915,516925320,48980,516974300,8,0,0,2048,12,220318073
9916,516996080,107120,517103200,8,0,0,51712,12,8036241620
9917,517745020,107588,517852608,9,0,0,53248,10,8629372543
9918,517758040,75920,517833960,8,0,0,14848,12,1727698774
9919,517828789,94688,517923477,9,0,0,20992,10,7740967442
9920,517921639,106610,518028249,9,0,0,44032,10,1083675452
9921,518071180,43904,518115084,9,0,0,512,10,2259881033
9922,518465259,104780,518570039,9,0,0,44032,10,2256262280
9923,518507549,120666,518628215,9,0,0,20992,10,4320189446
9924,518643969,62516,518706485,9,0,0,6144,10,297244516
9925,518815250,7230,518822480,9,0,1,7680,10,6916372951
9926,519071030,48980,519120010,8,0,0,2048,12,2687775810
9927,519138060,1994,519140054,9,0,1,2048,10,3621254464
9928,519245400,60824,519306224,8,0,0,5632,12,4705910021
9929,519345480,82376,519427856,8,0,0,15872,12,10427189796
9930,519515900,11016,519526916,9,0,1,17920,10,9687785110
9931,519736290,54680,519790970,8,0,0,5632,12,4957752282
9932,519824119,57440,519881559,9,0,0,4608,10,903328654
9933,519978720,3904,519982624,9,0,1,10752,10,2478821829
9934,520164249,86984,520251233,9,0,0,15872,10,721863494
9935,520185260,85448,520270708,8,0,0,15872,12,10292443605
9936,520634270,104936,520739206,8,0,0,44544,12,9687141969
9937,520680050,67328,520747378,8,0,0,3584,12,413334199
9938,520912549,52832,520965381,9,0,0,4608,10,5197063163
9939,521143280,89636,521232916,8,0,0,24576,12,10296578917
9940,521490060,88676,521578736,9,0,0,16384,10,8858340119
9941,521500350,66080,521566430,8,0,0,5120,12,2300620216
9942,521623220,101972,521725192,8,0,0,34816,12,6084533883
9943,521629990,11274,521641264,8,0,1,18432,12,1082916865
9944,521703360,76780,521780140,9,0,0,11264,10,3832492050
9945,521854650,112112,521966762,8,0,0,68096,12,6767611799
9946,521976880,104624,522081504,8,0,0,43520,12,6265302696
9947,522033390,123930,522157320,8,0,0,48128,12,5044317651
9948,522160960,52520,522213480,8,0,0,3584,12,8716976571
9949,522241770,119600,522361370,8,0,0,92672,12,1343348329
9950,522263730,163490,522427220,8,0,0,75776,12,465973956
9951,522500350,93776,522594126,8,0,0,23040,12,4348841934
9952,522561400,64208,522625608,9,0,0,6656,10,7551788393
9953,522841710,1994,522843704,9,0,1,2048,10,9008863817
9954,522856810,63608,522920418,8,0,0,9728,12,1248644121
9955,523285080,85784,523370864,9,0,0,22016,10,7505656906
9956,523591630,79928,523671558,9,0,0,17920,10,7200247279
9957,523633710,126966,523760676,9,0,0,82432,10,2794359548
9958,524040060,105716,524145776,9,0,0,47104,10,4659057770
9959,524172670,62516,524235186,9,0,0,6144,10,9895537989
9960,524192530,5802,524198332,9,0,1,6144,10,4139993728
9961,524289850,60824,524350674,9,0,0,5632,10,7305774338
9962,524372530,69776,524442306,9,0,0,14848,10,10545225644
9963,524504450,57752,524562202,9,0,0,5632,10,3665564925
9964,524836610,55748,524892358,9,0,0,4096,10,1630869840
9965,525070700,92552,525163252,8,0,0,24064,12,2594297763
9966,525266140,3422,525269562,8,0,1,3584,12,4665696022
9967,525933160,115232,526048392,9,0,0,78336,10,86730554
9968,526503410,52364,526555774,9,0,0,3072,10,8927735912
9969,526597289,122720,526720009,9,0,0,102912,10,4507563618
9970,526621370,131297,526752667,8,0,0,17408,12,9469141394
9971,526958920,103220,527062140,8,0,0,38912,12,6979961763
9972,527524999,101192,527626191,9,0,0,32256,10,3339961335
9973,527679460,113048,527792508,8,0,0,71168,12,8079362370
9974,528009940,108992,528118932,8,0,0,57856,12,1539467757
9975,528042570,145152,528187722,8,0,0,45568,12,587742919
9976,528052360,208724,528261084,8,0,0,58368,12,3659182054
9977,528200489,69889,528270378,9,0,0,2048,10,7846198796
9978,528471429,104156,528575585,9,0,0,41984,10,3133411850
9979,528601120,1518,528602638,9,0,1,1536,10,9651148149
9980,528617470,91616,528709086,8,0,0,20992,12,1738529156
9981,528776040,2946,528778986,9,0,1,3072,10,4192755969
9982,529034070,86984,529121054,9,0,0,15872,10,2263948997
9983,529082760,69752,529152512,8,0,0,9728,12,9630723244
9984,529098280,74854,529173134,8,0,0,3072,12,6486296263
9985,529378750,4374,529383124,9,0,1,4608,10,1359692222
9986,529618920,6488,529625408,8,0,1,15872,12,10526811584
9987,529725450,84512,529809962,8,0,0,12800,12,4481540479
9988,529862160,6278,529868438,8,0,1,6656,12,8577470027
9989,529874280,50672,529924952,9,0,0,2560,10,2753259049
9990,529917040,96512,530013552,9,0,0,16896,10,6231913884
9991,530322660,98696,530421356,9,0,0,24064,10,10462691277
9992,530504220,100724,530604944,9,0,0,30720,10,6300385553
9993,530753200,7706,530760906,9,0,1,8192,10,8268859573
9994,530868800,88676,530957476,9,0,0,16384,10,5456064473
9995,531287890,3422,531291312,9,0,1,3584,10,2822509323
9996,532038630,81128,532119758,9,0,0,11776,10,5901367462
9997,532064890,128854,532193744,9,0,0,26624,10,8086179213
9998,532828000,49136,532877136,9,0,0,2560,10,2791528798
9999,534592390,115076,534707466,9,0,0,77824,10,3429928625
