RequestID,ArrivalTime,DelayTime,FinishTime,InitiatorID,TargetID,IOType,Size,VolumeID,Offset
0,0,150840,150840,0,0,0,77824,8,5044131670
1,1,63072,63073,6,0,0,7680,24,10213190872
2,2,2908195,2908197,5,0,0,15872,4,886603474
3,3,2226575,2226578,8,0,0,73216,1,1379445075
4,4,898980,898984,4,0,0,15872,14,3387834128
5,5,4955,4960,3,0,1,12288,5,1061193583
6,6,20373,20379,9,0,1,31744,12,9539762626
7,7,76544,76551,2,0,0,2560,3,3985458449
8,8,1791510,1791518,1,0,0,48128,26,582155539
9,9,92011,92020,7,0,0,6656,29,9049031979
10,2150,22095,24245,1,0,1,6144,26,8334137519
11,2980,1199624,1202604,32,3,0,82944,17,29938134
12,3500,540280,543780,15,1,0,123392,19,7133040645
13,3830,2453536,2457366,10,1,0,71168,4,7471221950
14,4680,915585,920265,14,1,0,9216,8,2905355414
15,4810,1026758,1031568,29,2,0,5120,26,2443423489
16,6540,946830,953370,30,3,0,41984,3,3512327856
17,7620,1922704,1930324,8,0,0,4608,1,6197044320
18,9020,1342762,1351782,5,0,0,24064,4,8621535099
19,9300,1467870,1477170,14,1,0,67584,8,3565897
20,10130,1371898,1382028,1,0,0,13312,26,1030619675
21,10220,2272626,2282846,21,2,0,27648,25,3747518244
22,11270,13961,25231,1,0,1,1536,26,1504120784
23,13470,1270851,1284321,0,0,0,15872,8,117024323
24,13930,11455,25385,1,0,1,8704,26,9524845569
25,15180,949289,964469,12,1,0,36352,3,3045403756
26,16450,10241,26691,24,2,1,2048,10,8996052714
27,16980,12617,29597,2,0,1,4608,3,8521598947
28,17770,1037190,1054960,27,2,0,43520,9,9988659411
29,18980,1147388,1166368,13,1,0,9728,6,9872421724
30,20721,9235,29956,31,3,1,9728,27,9035469660
31,22911,8031,30942,7,0,1,1536,29,9987228629
32,24690,1119672,1144362,19,1,0,18944,5,1369553288
33,25610,535966,561576,26,2,0,20480,29,3078274654
34,26260,1376635,1402895,13,1,0,39936,6,513932163
35,26730,1108437,1135167,39,3,0,6144,2,857860607
36,28070,419030,447100,0,0,0,3584,8,7557700138
37,29740,336144,365884,26,2,0,1536,29,2632041986
38,31370,1268184,1299554,18,1,0,15872,13,10153414023
39,32701,514853,547554,34,3,0,12288,2,4615827715
40,32970,24242,57212,16,1,1,40448,10,10452853379
41,33541,1577941,1611482,9,0,0,18944,12,4516214513
42,34680,28408,63088,0,0,1,16896,8,10679901567
43,36441,1982670,2019111,25,2,0,7680,4,1429762339
44,36980,1469993,1506973,10,1,0,56832,4,7729602475
45,37111,2889686,2926797,9,0,0,51712,12,10428950394
46,37390,457686,495076,16,1,0,14848,10,8241237022
47,37850,26915,64765,9,0,1,3584,12,3585533665
48,37991,1214262,1252253,25,2,0,55808,4,8307327874
49,39120,30471,69591,32,3,1,7680,17,9432556478
50,41260,3438765,3480025,14,1,0,32768,8,5267560699
51,41440,1274259,1315699,4,0,0,41472,14,3602604336
52,42160,27687,69847,2,0,1,9216,3,8830020213
53,42610,647713,690323,19,1,0,3584,5,5066814675
54,42700,2033882,2076582,13,1,0,14336,6,2695477813
55,43000,1998644,2041644,15,1,0,7680,19,473154066
56,44750,237344,282094,3,0,0,7168,5,8393747205
57,46180,29568,75748,12,1,1,28160,3,10716863158
58,49030,1475098,1524128,36,3,0,10752,3,2468205446
59,49381,1619350,1668731,25,2,0,35328,4,3594925360
60,51060,2057412,2108472,13,1,0,16384,6,685280581
61,52520,1318582,1371102,35,3,0,16896,8,8198801224
62,54481,22101,76582,19,1,1,1024,5,1446533600
63,54830,3029463,3084293,5,0,0,15872,4,1398234864
64,55760,2181972,2237732,6,0,0,18944,24,122718586
65,56690,2217709,2274399,24,2,0,64512,10,7884867718
66,58130,1450293,1508423,27,2,0,3072,9,7506715075
67,61300,644711,706011,29,2,0,41472,26,852053024
68,63500,1700863,1764363,31,3,0,19968,27,6371414663
69,64080,2136392,2200472,2,0,0,25600,3,4648084052
70,64280,991171,1055451,23,2,0,1536,4,7392228090
71,66040,2595412,2661452,30,3,0,56320,3,9072454923
72,66350,998217,1064567,27,2,0,512,9,6420549041
73,68370,1001498,1069868,18,1,0,1536,13,7115711503
74,71030,6370,77400,0,0,1,1536,8,2555580524
75,71300,1436164,1507464,22,2,0,1536,10,6344140701
76,75960,1348142,1424102,35,3,0,11264,8,9376462472
77,76360,2861980,2938340,37,3,0,23040,15,5732315230
78,76920,1146,78066,32,3,1,1024,17,720521861
79,77380,2397059,2474439,29,2,0,3584,26,9923331638
80,77590,813180,890770,15,1,0,17920,19,1121158956
81,78320,1299629,1377949,4,0,0,9728,14,5875370179
82,80610,581194,661804,4,0,0,15360,14,8288963612
83,80771,23120,103891,7,0,1,41472,29,8003024151
84,83880,23877,107757,39,3,1,6144,2,9204661198
85,84140,1178167,1262307,4,0,0,30208,14,5220327102
86,84290,1145496,1229786,35,3,0,31232,8,7304583126
87,85400,75335,160735,16,1,1,109568,10,5080677439
88,86210,2349449,2435659,23,2,0,26624,4,1370613052
89,86260,1059098,1145358,18,1,0,2048,13,9420555672
90,86890,1990651,2077541,19,1,0,3072,5,4977498246
91,87160,2657313,2744473,8,0,0,57344,1,8639358493
92,88670,2418015,2506685,3,0,0,36352,5,1001470531
93,88840,75761,164601,25,2,1,6144,4,8568179353
94,89650,992882,1082532,6,0,0,8704,24,5825601668
95,91440,1947841,2039281,4,0,0,1536,14,129308981
96,91840,1397794,1489634,7,0,0,24576,29,7452068400
97,92351,2723514,2815865,25,2,0,40448,4,3690295989
98,92410,2837920,2930330,29,2,0,10752,26,3358054959
99,93260,1120757,1214017,29,2,0,1536,26,6143703114
100,93600,2949712,3043312,4,0,0,21504,14,10193139076
101,95001,1064579,1159580,25,2,0,3584,4,8354327321
102,95810,2907250,3003060,23,2,0,1536,4,4884918349
103,97880,1204661,1302541,14,1,0,9728,8,6944905918
104,98569,67338,165907,4,0,1,2048,14,2602384713
105,98790,67373,166163,34,3,1,9216,2,5969058244
106,99640,72732,172372,28,2,1,21504,24,2273419696
107,100510,72323,172833,13,1,1,10240,6,1269034234
108,101570,2836949,2938519,8,0,0,512,1,9819280935
109,102230,2253239,2355469,13,1,0,17920,6,3820804508
110,104250,2580001,2684251,31,3,0,74752,27,8317352064
111,104700,1912048,2016748,11,1,0,26112,6,8981209704
112,105250,1306515,1411765,39,3,0,14848,2,3185284023
113,106440,2892362,2998802,3,0,0,123904,5,6685527958
114,107230,508698,615928,5,0,0,1024,4,3808087047
115,107390,1304554,1411944,26,2,0,512,29,3176722633
116,109530,505042,614572,37,3,0,6656,15,6828330517
117,109670,1343392,1453062,15,1,0,21504,19,11182567
118,112230,3404786,3517016,31,3,0,82432,27,4654740841
119,112500,2174936,2287436,1,0,0,5632,26,8465823337
120,112770,2268848,2381618,10,1,0,29184,4,5158956172
121,116380,984763,1101143,30,3,0,4608,3,4432756142
122,123890,3492677,3616567,6,0,0,78336,24,5425531931
123,127980,69805,197785,29,2,1,53760,26,754256748
124,129060,1608411,1737471,26,2,0,17408,29,3720096641
125,134691,68586,203277,22,2,1,26112,10,5897128238
126,134791,2215195,2349986,33,3,0,38400,22,3224675436
127,138469,67394,205863,37,3,1,4096,15,5709085786
128,138500,4214392,4352892,19,1,0,17408,5,2581426143
129,138570,1389565,1528135,14,1,0,4096,8,2176887980
130,138580,1900210,2038790,13,1,0,64512,6,9188793357
131,140340,776656,916996,36,3,0,2048,3,9319394089
132,141050,3095005,3236055,36,3,0,512,3,5186131786
133,141400,1812408,1953808,22,2,0,59392,10,523382926
134,141550,2657577,2799127,32,3,0,44032,17,3486011994
135,142110,1160922,1303032,35,3,0,1536,8,8059917593
136,143099,63110,206209,15,1,1,512,19,4363326258
137,143670,3207476,3351146,1,0,0,28160,26,8381792233
138,143770,3224316,3368086,19,1,0,11776,5,8340416110
139,144410,1385776,1530186,8,0,0,6656,1,4018769353
140,144540,3264494,3409034,32,3,0,56832,17,1858409460
141,144879,62636,207515,5,0,1,2048,4,6745924172
142,146460,62361,208821,33,3,1,2048,22,1324012427
143,151360,3566057,3717417,1,0,0,19456,26,4794742641
144,151370,3964154,4115524,29,2,0,7680,26,4802401106
145,151870,2174021,2325891,36,3,0,6656,3,6716517058
146,151910,57257,209167,9,0,1,512,12,2040804503
147,153640,60712,214352,32,3,1,16384,17,1895984817
148,154960,2981293,3136253,35,3,0,25088,8,14370511
149,155080,1939813,2094893,18,1,0,9728,13,4622538087
150,155150,3074786,3229936,11,1,0,6656,6,8466608686
151,155551,59672,215223,31,3,1,12288,27,5179085016
152,155860,722371,878231,14,1,0,3584,8,237504709
153,158451,68318,226769,26,2,1,38912,29,10377943621
154,158680,1798115,1956795,23,2,0,9728,4,2741917990
155,160870,2405686,2566556,22,2,0,14848,10,10317133560
156,160881,1496572,1657453,25,2,0,17408,4,4427366860
157,162650,104638,267288,16,1,1,90624,10,8922928316
158,165159,106955,272114,4,0,1,7680,14,9389835089
159,165930,1885432,2051362,2,0,0,20480,3,6382738228
160,166000,1509641,1675641,15,1,0,19456,19,8733341913
161,168170,1532520,1700690,19,1,0,19456,5,9485509476
162,168710,1682749,1851459,0,0,0,29184,8,1956705122
163,170560,1709728,1880288,7,0,0,53248,29,6188097120
164,171660,127092,298752,16,1,1,86528,10,6488874566
165,174760,3374983,3549743,12,1,0,10240,3,8252143613
166,175879,123219,299098,37,3,1,512,15,3404628363
167,180361,4162189,4342550,34,3,0,13312,2,2543860237
168,183770,1569325,1753095,38,3,0,8192,26,8696606931
169,184081,2045484,2229565,34,3,0,9728,2,6144599664
170,187430,289180,476610,8,0,0,1024,1,10278094913
171,189980,4148491,4338471,38,3,0,79360,26,1692267011
172,190530,5738105,5928635,37,3,0,29184,15,9825156630
173,191170,3985527,4176697,23,2,0,51712,4,2048979787
174,191450,3837830,4029280,23,2,0,54272,4,1954371563
175,192870,2634176,2827046,32,3,0,18944,17,4627947863
176,194620,4535087,4729707,22,2,0,3584,10,1351886402
177,194800,2989649,3184449,16,1,0,74240,10,858374638
178,196530,4021984,4218514,1,0,0,15872,26,9263542621
179,197030,2398217,2595247,29,2,0,29696,26,4197334015
180,200970,100394,301364,17,1,1,3584,28,3547669104
181,201500,4560455,4761955,2,0,0,4608,3,7769130038
182,202500,99428,301928,28,2,1,10752,24,3817111227
183,205040,1851345,2056385,31,3,0,16384,27,6663309935
184,205799,97755,303554,37,3,1,2560,15,10018501104
185,205821,2160042,2365863,9,0,0,8192,12,9826502824
186,207940,1351721,1559661,36,3,0,4608,3,8499055592
187,208250,3369041,3577291,4,0,0,35840,14,6439479343
188,210220,2854109,3064329,31,3,0,19968,27,1393027536
189,211830,3464467,3676297,0,0,0,12800,8,7250204137
190,211990,1833109,2045099,10,1,0,11264,4,9866588218
191,212490,2591028,2803518,38,3,0,14336,26,10707101823
192,212780,5224379,5437159,2,0,0,88576,3,5275988986
193,213631,1141450,1355081,25,2,0,10752,4,7285508062
194,213690,1638104,1851794,35,3,0,1024,8,4024886642
195,218620,3093392,3312012,13,1,0,2560,6,4320414658
196,219430,2907072,3126502,1,0,0,1024,26,9080632878
197,220240,610368,830608,38,3,0,3072,26,3542543406
198,223630,3521156,3744786,38,3,0,26112,26,7334811796
199,224680,1551305,1775985,13,1,0,1536,6,2035969769
200,225140,2777429,3002569,29,2,0,12288,26,9189754245
201,226280,79860,306140,32,3,1,4096,17,2293034717
202,226310,96305,322615,29,2,1,62464,26,9219752490
203,227970,3140295,3368265,10,1,0,512,4,4096038740
204,228220,3316165,3544385,30,3,0,37376,3,984232324
205,229340,3211238,3440578,0,0,0,512,8,10228311904
206,230260,190598,420858,29,2,1,199168,26,2424248060
207,234420,807257,1041677,37,3,0,7168,15,1088601758
208,234490,187034,421524,32,3,1,1024,17,2445302340
209,234990,3578493,3813483,22,2,0,30720,10,4306183982
210,235470,3495698,3731168,39,3,0,45056,2,8654154613
211,236960,5219620,5456580,27,2,0,26624,9,429387754
212,238280,184627,422907,3,0,1,14848,5,5787699235
213,240250,3675950,3916200,4,0,0,7680,14,9832716144
214,244570,2848782,3093352,29,2,0,14336,26,346195830
215,245111,2182413,2427524,25,2,0,17408,4,2158215568
216,245500,177753,423253,32,3,1,512,17,5852798151
217,245751,3892797,4138548,34,3,0,3584,2,10179144686
218,249550,4301520,4551070,30,3,0,41984,3,4964678646
219,250841,2507108,2757949,25,2,0,15872,4,5083313229
220,251721,3279202,3530923,9,0,0,45568,12,1508354344
221,251870,2438020,2689890,39,3,0,18432,2,9160045445
222,252280,2221044,2473324,38,3,0,19456,26,2751583888
223,252580,3740761,3993341,14,1,0,18944,8,2746115773
224,252651,3023891,3276542,34,3,0,8192,2,2712917908
225,254570,173829,428399,33,3,1,8192,22,2518336658
226,255800,174225,430025,29,2,1,2560,26,5157917712
227,256500,176111,432611,0,0,1,4096,8,8959765824
228,257291,1834615,2091906,25,2,0,39424,4,5057101625
229,257730,3855431,4113161,30,3,0,35840,3,9650558625
230,258331,2433142,2691473,33,3,0,5120,22,7260305477
231,258740,3932270,4191010,8,0,0,44544,1,6898877109
232,260280,4649208,4909488,27,2,0,10752,9,4377527526
233,261731,4771948,5033679,34,3,0,28160,2,886390083
234,263050,3314740,3577790,19,1,0,1536,5,1361080622
235,264339,173866,438205,18,1,1,18432,13,4132066751
236,265260,461261,726521,14,1,0,9216,8,3034016492
237,268549,172882,441431,8,0,1,5120,1,3990066538
238,268551,2088981,2357532,25,2,0,2560,4,8333464064
239,270450,1851846,2122296,12,1,0,16384,3,5399117639
240,271220,4634969,4906189,27,2,0,63488,9,5027894085
241,271361,3769855,4041216,9,0,0,19968,12,8783408391
242,271550,6025913,6297463,14,1,0,31232,8,3848412148
243,272130,1795626,2067756,24,2,0,6656,10,3754947189
244,279650,4248442,4528092,1,0,0,72704,26,3773250708
245,282520,4411488,4694008,36,3,0,67584,3,8502291326
246,282710,161307,444017,6,0,1,4096,24,9847973822
247,282900,2951271,3234171,1,0,0,13824,26,978622141
248,283840,3479891,3763731,32,3,0,28160,17,7781444664
249,286189,1440614,1726803,31,3,0,2560,27,8373654951
250,286670,2180703,2467373,39,3,0,32768,2,1568553459
251,287280,3811574,4098854,27,2,0,37376,9,9522156828
252,289060,206748,495808,10,1,1,165888,4,8776954241
253,289860,212566,502426,20,2,1,31744,24,9531909328
254,292080,3391416,3683496,35,3,0,23552,8,3442733746
255,293510,763836,1057346,4,0,0,6144,14,10716807240
256,294430,2092118,2386548,8,0,0,7168,1,10000810288
257,294760,2952983,3247743,26,2,0,3584,29,1060934982
258,294900,4460974,4755874,6,0,0,32768,24,4686567670
259,294990,208422,503412,6,0,1,1536,24,570426542
260,295090,2829313,3124403,18,1,0,9728,13,10532314549
261,295110,248685,543795,1,0,1,4608,26,6285625756
262,295510,1804031,2099541,13,1,0,2560,6,3474594039
263,295580,266011,561591,17,1,1,175616,28,193303763
264,296870,5019223,5316093,31,3,0,18432,27,4402396393
265,297080,264526,561606,1,0,1,9216,26,9767763701
266,297860,4326308,4624168,12,1,0,53248,3,1256472414
267,301540,3403819,3705359,31,3,0,71680,27,514012068
268,301700,260518,562218,14,1,1,5632,8,8058665594
269,302440,260034,562474,13,1,1,9216,6,10001687250
270,303300,3283384,3586684,35,3,0,10752,8,3990417194
271,303440,4416229,4719669,11,1,0,49152,6,480311601
272,305870,2884397,3190267,23,2,0,6656,4,5476240561
273,310040,253740,563780,33,3,1,2048,22,8189123570
274,310771,2174182,2484953,33,3,0,11776,22,4159923184
275,311320,2534366,2845686,13,1,0,23552,6,2050114869
276,314280,1678972,1993252,36,3,0,12288,3,4751927563
277,314421,253865,568286,30,3,1,7168,3,6274886192
278,318020,4131395,4449415,15,1,0,51200,19,7971428746
279,322239,248313,570552,37,3,1,3584,15,8938139797
280,322430,4616651,4939081,4,0,0,8704,14,3288452240
281,322750,279471,602221,10,1,1,110592,4,604695768
282,323810,2587062,2910872,10,1,0,8704,4,3641521328
283,325500,4539112,4864612,31,3,0,5632,27,4062276854
284,327210,2821145,3148355,15,1,0,7680,19,2508224174
285,327300,3037175,3364475,37,3,0,16896,15,1301795178
286,330340,4401730,4732070,36,3,0,7680,3,5861949285
287,330810,1558935,1889745,18,1,0,22016,13,720393435
288,332580,2183332,2515912,16,1,0,30208,10,3824516278
289,333670,268705,602375,3,0,1,8704,5,4821069620
290,334699,269622,604321,15,1,1,3072,19,248681422
291,335040,274773,609813,6,0,1,17920,24,9304918309
292,336380,2237148,2573528,31,3,0,9728,27,5974424936
293,336811,274308,611119,31,3,1,2048,27,5624082841
294,339190,1865049,2204239,3,0,0,12288,5,2021080361
295,340680,2970521,3311201,22,2,0,13312,10,10733030686
296,340920,3370546,3711466,13,1,0,19968,6,4919522783
297,341710,4143815,4485525,39,3,0,44032,2,4668865144
298,342060,272527,614587,20,2,1,2560,24,7914873396
299,342180,272422,614602,9,0,1,1536,12,9772179927
300,342560,287031,629591,16,1,1,51200,10,4867173473
301,346399,324410,670809,11,1,1,131584,6,8029213397
302,347310,2237439,2584749,32,3,0,34816,17,8385072792
303,347570,3909075,4256645,14,1,0,5120,8,3661745062
304,348379,322776,671155,18,1,1,512,13,8777096536
305,348680,1787915,2136595,6,0,0,8704,24,3621971142
306,348900,327542,676442,2,0,1,16896,3,5061414522
307,351440,325668,677108,27,2,1,11264,9,6347869878
308,351731,2255193,2606924,33,3,0,23552,22,8478667841
309,352210,326076,678286,16,1,1,13824,10,10154329350
310,352580,2693095,3045675,18,1,0,7680,13,9519538085
311,352829,326123,678952,23,2,1,1024,4,7070552127
312,354220,328918,683138,27,2,1,6656,9,10683420836
313,354790,329654,684444,36,3,1,2048,3,5084342140
314,355540,334798,690338,10,1,1,17408,4,4707674102
315,357130,3189462,3546592,1,0,0,7168,26,10138016651
316,359130,331223,690353,1,0,1,8704,26,2841144010
317,360810,4484616,4845426,13,1,0,81920,6,5168722578
318,363129,328484,691613,4,0,1,2560,14,4727194052
319,363430,601842,965272,8,0,0,2560,1,1161578328
320,365351,327235,692586,22,2,1,12800,10,6534802531
321,365720,327122,692842,9,0,1,9216,12,3055867523
322,367160,6278664,6645824,4,0,0,27136,14,5205890183
323,368490,337536,706026,6,0,1,12288,24,1358718254
324,369200,1950228,2319428,12,1,0,7680,3,10679858305
325,370200,3384928,3755128,15,1,0,31232,19,9027975899
326,371490,3442274,3813764,19,1,0,512,5,3500428567
327,371680,3288191,3659871,31,3,0,10240,27,6402380662
328,374010,1468534,1842544,6,0,0,6656,24,8527850758
329,374950,4694218,5069168,5,0,0,57344,4,10408394688
330,375230,628523,1003753,36,3,0,1024,3,5992969164
331,376590,3760508,4137098,6,0,0,59392,24,3895702166
332,378210,3358597,3736807,1,0,0,18432,26,1397876119
333,378430,327611,706041,35,3,1,7168,8,2688094316
334,379240,1278704,1657944,26,2,0,1536,29,7418992489
335,379344,5769025,6148369,29,2,0,78336,26,6292050950
336,379551,3068082,3447633,34,3,0,2048,2,9049726451
337,379560,326496,706056,13,1,1,3584,6,1628266230
338,379630,555033,934663,31,3,0,512,27,9287361368
339,381220,2676120,3057340,12,1,0,32256,3,4806973080
340,381670,5095689,5477359,15,1,0,68096,19,6768416223
341,382790,4468431,4851221,0,0,0,18944,8,3797550219
342,385280,5351361,5736641,32,3,0,44544,17,7979010726
343,390220,3071929,3462149,36,3,0,15872,3,9465878920
344,390360,4736379,5126739,20,2,0,50176,24,7045377782
345,391460,4803019,5194479,37,3,0,28672,15,3033995780
346,392680,4212699,4605379,31,3,0,11264,27,354207269
347,395321,4020736,4416057,34,3,0,59392,2,7034134024
348,395400,2190776,2586176,31,3,0,4608,27,967766796
349,396100,2877923,3274023,38,3,0,25600,26,822942538
350,396471,6168822,6565293,34,3,0,2048,2,9838079283
351,397660,3235778,3633438,18,1,0,55296,13,51786805
352,401699,304372,706071,23,2,1,1024,4,5522790844
353,403790,4765995,5169785,1,0,0,57344,26,7302313937
354,405051,301035,706086,21,2,1,12288,25,7874524478
355,405920,4826114,5232034,4,0,0,24576,14,5085133799
356,410130,3948588,4358718,8,0,0,12288,1,7914536130
357,410411,4641262,5051673,25,2,0,30208,4,2870254302
358,411960,296578,708538,12,1,1,23040,3,3409608740
359,412160,5773888,6186048,6,0,0,11776,24,3183431470
360,412481,3120493,3532974,25,2,0,6656,4,1624301429
361,412550,3415703,3828253,22,2,0,4608,10,6133149940
362,413050,3259324,3672374,11,1,0,40960,6,2167170825
363,413270,5769167,6182437,4,0,0,38912,14,8086948110
364,416570,3816795,4233365,20,2,0,19456,24,1334157487
365,416920,294204,711124,34,3,1,4096,2,2672249712
366,419310,3951500,4370810,8,0,0,8192,1,8878117523
367,420510,3498718,3919228,27,2,0,5632,9,10454138610
368,421880,5105585,5527465,22,2,0,28672,10,1753284164
369,424140,5477218,5901358,5,0,0,15872,4,2072811051
370,426600,5591785,6018385,37,3,0,116224,15,9090374226
371,426970,4111285,4538255,37,3,0,33280,15,8647072180
372,429060,1212198,1641258,19,1,0,22016,5,106527524
373,429830,5540305,5970135,6,0,0,22528,24,1543970326
374,429880,2877242,3307122,3,0,0,15872,5,3318442390
375,432220,4951588,5383808,39,3,0,10240,2,9212028550
376,433050,4791473,5224523,39,3,0,41984,2,10169062875
377,433170,7754427,8187597,24,2,0,66560,10,4743693142
378,434551,6331972,6766523,25,2,0,76288,4,6488852817
379,434781,4589180,5023961,9,0,0,52224,12,9431365470
380,434891,282646,717537,26,2,1,22528,29,4950849154
381,436461,2938348,3374809,25,2,0,13312,4,3813940430
382,436510,1271559,1708069,31,3,0,2048,27,3099609557
383,436531,281352,717883,31,3,1,512,27,8492610094
384,437920,2703293,3141213,19,1,0,5120,5,2875863234
385,438859,12256956,12695815,11,1,1,300544,6,582545428
386,441771,12282684,12724455,30,3,1,2560,3,5575354629
387,442799,12330014,12772813,8,0,1,5632,1,1858331529
388,447091,2639877,3086968,25,2,0,8704,4,4514439356
389,448291,3021727,3470018,33,3,0,17920,22,5427686276
390,448430,4256240,4704670,24,2,0,24576,10,9298417077
391,452650,3292939,3745589,13,1,0,2560,6,5223861800
392,453490,4909833,5363323,35,3,0,15360,8,7596018733
393,455520,4620067,5075587,1,0,0,20992,26,9652545871
394,455990,5196353,5652343,10,1,0,54272,4,2688950098
395,458070,12336683,12794753,36,3,1,3072,3,4600144975
396,458990,4347062,4806052,39,3,0,30720,2,2180200644
397,459820,4101779,4561599,8,0,0,4608,1,4695974984
398,460680,5984448,6445128,8,0,0,7168,1,5237012713
399,465680,5865469,6331149,18,1,0,29696,13,5745444627
400,468441,2786587,3255028,9,0,0,18432,12,3138071601
401,468890,6599706,7068596,29,2,0,5632,26,6690489376
402,469390,2301121,2770511,22,2,0,25088,10,760922243
403,471430,6521097,6992527,27,2,0,37888,9,1678081575
404,471730,5197172,5668902,14,1,0,54272,8,6610858611
405,472950,5558209,6031159,35,3,0,3072,8,5738184219
406,473480,12321296,12794776,39,3,1,2560,2,8982674729
407,474010,6536673,7010683,27,2,0,11776,9,6177889591
408,474590,4099676,4574266,18,1,0,41472,13,7439145510
409,476610,4269257,4745867,29,2,0,23552,26,7189022030
410,477360,1691826,2169186,11,1,0,10752,6,4308743451
411,477700,4130221,4607921,18,1,0,1024,13,3950228652
412,477965,2146226,2624191,30,3,0,5632,3,7423917011
413,478040,6329493,6807533,22,2,0,13312,10,8300389112
414,479790,12315009,12794799,28,2,1,512,24,877752835
415,481900,7798075,8279975,3,0,0,9728,5,4215751478
416,482671,4660164,5142835,33,3,0,21504,22,744899273
417,483620,5412388,5896008,31,3,0,50176,27,6455262904
418,483979,12310843,12794822,18,1,1,5632,13,3155691234
419,484800,4712510,5197310,26,2,0,9216,29,2707228371
420,485260,12314764,12800024,27,2,1,8192,9,9263378983
421,485570,6891440,7377010,31,3,0,29184,27,4024533833
422,488980,2870324,3359304,23,2,0,26112,4,4968767010
423,491460,12357702,12849162,25,2,1,1536,4,4615920087
424,493430,4817024,5310454,26,2,0,12288,29,2077888588
425,494000,3666910,4160910,22,2,0,53248,10,4007975025
426,497160,3850405,4347565,39,3,0,16384,2,7761968002
427,497980,4234581,4732561,37,3,0,1536,15,6574570848
428,499410,4381927,4881337,23,2,0,10752,4,3739816376
429,500460,4101464,4601924,12,1,0,53248,3,287341316
430,501040,2927638,3428678,26,2,0,13312,29,2626894197
431,501090,3060555,3561645,3,0,0,26112,5,826526779
432,501940,3863353,4365293,35,3,0,21504,8,8919464553
433,502741,1973133,2475874,33,3,0,4608,22,205535773
434,503200,2023420,2526620,0,0,0,14848,8,10155913725
435,506181,12346303,12852484,19,1,1,3584,5,10103913677
436,506739,12345768,12852507,4,0,1,15872,14,3017789597
437,507610,4477564,4985174,36,3,0,18432,3,3155370284
438,507990,6487680,6995670,15,1,0,10240,19,9384769703
439,508690,13051219,13559909,17,1,1,142848,28,3371275466
440,508940,4415414,4924354,8,0,0,24576,1,3971403672
441,509860,4618462,5128322,19,1,0,5120,5,2253149319
442,510421,13049511,13559932,26,2,1,2048,29,1684724536
443,511810,3843133,4354943,36,3,0,6656,3,8543333953
444,513000,3318100,3831100,1,0,0,4096,26,8103473700
445,514320,4563950,5078270,1,0,0,8704,26,5872083514
446,517490,2858399,3375889,1,0,0,2560,26,6393090749
447,519620,13054375,13573995,25,2,1,4608,4,1529714782
448,522951,1836552,2359503,9,0,0,1024,12,7275704267
449,525610,3891718,4417328,24,2,0,4096,10,537731491
450,527250,4779437,5306687,16,1,0,98816,10,596450063
451,527510,2731597,3259107,24,2,0,13312,10,3315789009
452,527840,2475399,3003239,11,1,0,512,6,10204013597
453,529480,3747319,4276799,10,1,0,7168,4,8815268323
454,529680,6414512,6944192,12,1,0,87552,3,5762253665
455,533199,13278835,13812034,37,3,1,27648,15,2392894099
456,533681,13284483,13818164,19,1,1,6656,5,3732363467
457,533860,3585119,4118979,19,1,0,11264,5,939496942
458,534790,4138603,4673393,37,3,0,70656,15,9483994001
459,535670,4327195,4862865,26,2,0,19968,29,4975147797
460,537340,13428929,13966269,39,3,1,2560,2,457184654
461,537850,3675805,4213655,11,1,0,6144,6,6827609332
462,538751,740711,1279462,33,3,0,11776,22,2169543015
463,539230,5704347,6243577,32,3,0,73216,17,5607056451
464,539469,13915315,14454784,18,1,1,38400,13,1327760727
465,541480,1128210,1669690,22,2,0,3072,10,6110511080
466,541960,5257127,5799087,19,1,0,18432,5,900656465
467,542640,6458513,7001153,11,1,0,17920,6,446724688
468,543139,13912004,14455143,37,3,1,9728,15,4601370212
469,543210,4905235,5448445,39,3,0,13824,2,6144903753
470,544161,8760977,9305138,25,2,0,34816,4,406863188
471,544340,4935382,5479722,18,1,0,7680,13,9707354010
472,545020,2806305,3351325,16,1,0,512,10,9389732510
473,545021,13910378,14455399,21,2,1,9216,25,5696927121
474,545930,7441752,7987682,5,0,0,12288,4,7164954963
475,546900,4638820,5185720,7,0,0,52224,29,10285860247
476,549440,14018795,14568235,29,2,1,26624,26,309406049
477,552590,7164846,7717436,3,0,0,29696,5,6847031579
478,553550,6497262,7050812,36,3,0,12800,3,5815410448
479,553620,5296588,5850208,5,0,0,88576,4,9250912207
480,554520,5515630,6070150,18,1,0,4608,13,6403531874
481,554971,14045866,14600837,31,3,1,8704,27,9749776631
482,555330,3011018,3566348,22,2,0,15360,10,3145768314
483,558890,4077313,4636203,11,1,0,39424,6,61297710
484,559310,14295031,14854341,1,0,1,27136,26,4513356338
485,559561,5336938,5896499,34,3,0,1536,2,2501901300
486,560340,5562634,6122974,0,0,0,1536,8,1478378100
487,561750,2991916,3553666,39,3,0,12800,2,368801618
488,561790,4446236,5008026,1,0,0,38912,26,6974498769
489,564220,4784938,5349158,3,0,0,13312,5,1470745320
490,564310,6624405,7188715,16,1,0,512,10,9775801078
491,565280,4646428,5211708,26,2,0,34816,29,6851801546
492,565380,1837023,2402403,27,2,0,37376,9,6752293804
493,567910,14286454,14854364,38,3,1,1536,26,8719025764
494,568500,2849605,3418105,7,0,0,29696,29,2005152088
495,568630,3643130,4211760,32,3,0,30208,17,165961481
496,573400,3508864,4082264,13,1,0,62464,6,20209661
497,573540,7259576,7833116,31,3,0,37376,27,3419636530
498,573920,5132723,5706643,12,1,0,71168,3,778684887
499,574550,14286100,14860650,14,1,1,1024,8,3164123872
500,576090,6567874,7143964,15,1,0,26112,19,656657753
501,576860,6315379,6892239,1,0,0,16384,26,9535208741
502,577779,14282894,14860673,23,2,1,4608,4,6616207630
503,578340,4073494,4651834,23,2,0,51200,4,2775497006
504,579260,4272296,4851556,37,3,0,1024,15,1655685001
505,579560,4293898,4873458,19,1,0,5120,5,9854831145
506,580270,5271365,5851635,11,1,0,4608,6,6438997366
507,580550,3076178,3656728,4,0,0,22016,14,2422274800
508,585331,14597820,15183151,19,1,1,512,5,8528242895
509,585371,2697882,3283253,34,3,0,14336,2,5259387595
510,585400,14597774,15183174,13,1,1,9728,6,2900030411
511,586181,4339444,4925625,33,3,0,4096,22,9619876304
512,586790,3971479,4558269,18,1,0,23552,13,1816592757
513,587080,7005027,7592107,38,3,0,61952,26,10638957010
514,587760,6046375,6634135,10,1,0,45056,4,8539032286
515,589859,14806183,15396042,5,0,1,2048,4,6699759993
516,589940,5220451,5810391,30,3,0,5120,3,7647530054
517,590240,4452206,5042446,13,1,0,28672,6,2218664320
518,590350,5742538,6332888,31,3,0,5632,27,10645243482
519,592190,3057807,3649997,29,2,0,54272,26,9161345199
520,597280,7921978,8519258,0,0,0,16896,8,645029177
521,597771,14798302,15396073,10,1,1,6656,4,7783804531
522,598110,3465099,4063209,36,3,0,8704,3,10397242769
523,599791,7272604,7872395,9,0,0,51200,12,275927732
524,600320,4096839,4697159,12,1,0,10240,3,7272549264
525,600340,4254835,4855175,11,1,0,11776,6,9707726753
526,600850,6055054,6655904,30,3,0,14848,3,4476084629
527,601060,4496541,5097601,0,0,0,45568,8,6744903131
528,603720,5276977,5880697,10,1,0,92160,4,2469959722
529,605751,8485335,9091086,9,0,0,7168,12,3571508826
530,606210,14789886,15396096,1,0,1,2560,26,3547144662
531,606400,1576951,2183351,19,1,0,9728,5,4537432621
532,608751,5861522,6470273,33,3,0,25600,22,2824631691
533,609170,15043197,15652367,13,1,1,7680,6,5420729216
534,611760,4366972,4978732,39,3,0,9728,2,6185749193
535,612791,15989692,16602483,22,2,1,113664,10,1921255677
536,613960,3679237,4293197,36,3,0,4096,3,3525844134
537,614680,3970997,4585677,26,2,0,37376,29,9395079357
538,614890,3629983,4244873,30,3,0,16896,3,8334171317
539,615130,5410188,6025318,26,2,0,6144,29,2117267201
540,616930,3806193,4423123,12,1,0,18944,3,9092500913
541,618730,3941442,4560172,3,0,0,6144,5,5330355960
542,618850,16015228,16634078,28,2,1,2048,24,283374731
543,619281,16014820,16634101,10,1,1,2048,4,2903511675
544,619560,3664296,4283856,39,3,0,9728,2,406402090
545,619870,2866163,3486033,35,3,0,2048,8,282304486
546,621910,3515523,4137433,18,1,0,1024,13,1116692806
547,621970,16015609,16637579,12,1,1,1536,3,1297657517
548,623179,16300662,16923841,11,1,1,16896,6,2851502279
549,624290,1903289,2527579,1,0,0,3072,26,4659182932
550,624890,6463139,7088029,32,3,0,24064,17,3847393250
551,625560,4650996,5276556,30,3,0,72192,3,7969899276
552,626280,3660636,4286916,6,0,0,2048,24,9017054481
553,627220,5619032,6246252,19,1,0,8704,5,11476485
554,629870,8554536,9184406,30,3,0,50688,3,3055584859
555,631420,7990971,8622391,38,3,0,51712,26,4864687322
556,633310,6577786,7211096,13,1,0,10752,6,4604271693
557,634270,1220373,1854643,24,2,0,3072,10,9771630797
558,634810,3649225,4284035,15,1,0,512,19,7272583995
559,634880,5117228,5752108,0,0,0,50688,8,3360293114
560,637020,7277930,7914950,15,1,0,13824,19,2703428187
561,637120,5345830,5982950,23,2,0,41984,4,4277510277
562,637351,7436837,8074188,9,0,0,2560,12,9022560614
563,638790,6191024,6829814,14,1,0,4096,8,4252570130
564,638990,4089594,4728584,32,3,0,29184,17,3276008330
565,642090,4178353,4820443,35,3,0,42496,8,5708540030
566,642160,3124574,3766734,7,0,0,9728,29,8632111147
567,642340,4889448,5531788,0,0,0,8704,8,9163937165
568,642380,7082868,7725248,0,0,0,25088,8,4381144152
569,643030,5380393,6023423,19,1,0,6656,5,6169991635
570,643520,5512726,6156246,16,1,0,19968,10,1575814524
571,646180,7564418,8210598,29,2,0,36352,26,638670428
572,647410,5952838,6600248,39,3,0,3584,2,1718502814
573,647621,16276243,16923864,19,1,1,4608,5,2786822167
574,649050,8009423,8658473,19,1,0,1536,5,6241815874
575,649541,2616659,3266200,33,3,0,9728,22,8738999091
576,649931,5381875,6031806,33,3,0,2048,22,2592472245
577,651231,7674311,8325542,33,3,0,58880,22,9570150859
578,652400,5070646,5723046,26,2,0,53760,29,10053354588
579,652560,16271327,16923887,9,0,1,512,12,9038941143
580,652780,3745158,4397938,24,2,0,27648,10,5150685442
581,653540,4931355,5584895,36,3,0,6144,3,9728851880
582,653630,4595641,5249271,37,3,0,7680,15,6081212110
583,654400,16274369,16928769,25,2,1,512,4,7745872855
584,654820,4324715,4979535,3,0,0,2560,5,4136397397
585,657610,4734489,5392099,31,3,0,27136,27,7089653758
586,658270,6995760,7654030,4,0,0,51712,14,6143213860
587,658460,7414917,8073377,15,1,0,28672,19,6965325194
588,659101,16269691,16928792,30,3,1,8704,3,3704357731
589,660640,5689771,6350411,30,3,0,21504,3,6052506511
590,660660,16268155,16928815,0,0,1,2560,8,6481540651
591,663210,4253633,4916843,19,1,0,24064,5,7089539157
592,664040,4711377,5375417,37,3,0,20480,15,760379819
593,666330,8704965,9371295,1,0,0,33280,26,6283943215
594,667081,7598583,8265664,9,0,0,110592,12,1195741830
595,667110,6536841,7203951,6,0,0,17408,24,6673045625
596,668030,16263015,16931045,12,1,1,7680,3,6133049765
597,669760,7291169,7960929,10,1,0,51200,4,9021892933
598,670550,8375682,9046232,16,1,0,49664,10,1340368463
599,671110,6059175,6730285,1,0,0,74752,26,4724510926
600,671250,6604042,7275292,16,1,0,5632,10,10305802659
601,671480,5496957,6168437,36,3,0,39936,3,10410990487
602,671500,5248220,5919720,37,3,0,35840,15,10593091825
603,676460,2345749,3022209,12,1,0,512,3,9306357564
604,677570,16255081,16932651,34,3,1,1536,2,9298297038
605,677960,16254714,16932674,25,2,1,6144,4,1638574526
606,679100,5284148,5963248,5,0,0,13824,4,3501777398
607,679240,3808336,4487576,29,2,0,6656,26,7100716869
608,683310,5616552,6299862,31,3,0,5120,27,5048882070
609,683870,4468420,5152290,32,3,0,13312,17,6780909313
610,684160,4725988,5410148,37,3,0,48640,15,2475559340
611,684320,6543090,7227410,13,1,0,20480,6,8803563387
612,685540,5752834,6438374,26,2,0,16896,29,2916601959
613,686480,5728034,6414514,30,3,0,2048,3,8475232789
614,687200,5689408,6376608,10,1,0,8192,4,628005123
615,687890,4279564,4967454,32,3,0,67072,17,4893196927
616,689000,4822191,5511191,12,1,0,11264,3,5225832101
617,689970,5269043,5959013,14,1,0,5632,8,9698326687
618,691570,5827982,6519552,36,3,0,28672,3,4919624163
619,692520,5110649,5803169,16,1,0,512,10,9251885729
620,692680,4884330,5577010,37,3,0,9728,15,5742094359
621,693270,16239427,16932697,39,3,1,2048,2,7389670839
622,693620,8119782,8813402,11,1,0,67584,6,10615065094
623,696390,416606,1112996,26,2,0,9216,29,2893281642
624,696520,16236200,16932720,36,3,1,11264,3,2749185057
625,698680,5584669,6283349,12,1,0,9216,3,2560764856
626,699450,6703369,7402819,29,2,0,69632,26,3992187361
627,700570,6916599,7617169,3,0,0,57344,5,8688862966
628,702190,6817314,7519504,15,1,0,25088,19,4157413602
629,702930,16474980,17177910,0,0,1,4096,8,6216415350
630,705270,5574020,6279290,7,0,0,2048,29,4786813755
631,706510,16556587,17263097,3,0,1,10752,5,7427794548
632,706761,7071274,7778035,34,3,0,125440,2,4263587057
633,707370,5368419,6075789,36,3,0,18432,3,214492148
634,707940,6658549,7366489,18,1,0,38400,13,3645358025
635,710450,4960355,5670805,23,2,0,6144,4,10377932031
636,710780,6425205,7135985,13,1,0,15872,6,3539202465
637,710811,16625684,17336495,30,3,1,10240,3,2961691637
638,711010,6955080,7666090,16,1,0,1536,10,10236123673
639,712090,16625075,17337165,32,3,1,13824,17,9340712789
640,713630,5729291,6442921,13,1,0,14848,6,3273784052
641,714090,5849753,6563843,14,1,0,89600,8,1299768432
642,718470,8876798,9595268,19,1,0,110080,5,7831331781
643,718570,16966177,17684747,25,2,1,7680,4,1764255411
644,718811,8466554,9185365,9,0,0,3072,12,9198462545
645,721791,16962979,17684770,26,2,1,14848,29,9677564794
646,721810,7714668,8436478,38,3,0,512,26,1055002348
647,724670,17676381,18401051,1,0,1,9728,26,2360209305
648,725900,3305743,4031643,12,1,0,7680,3,10658710603
649,730750,4380678,5111428,39,3,0,30208,2,3585060193
650,731050,3356393,4087443,32,3,0,16896,17,10617019832
651,731370,7484305,8215675,36,3,0,3072,3,8659833187
652,736510,3652981,4389491,31,3,0,37888,27,9531722497
653,737210,4601130,5338340,12,1,0,42496,3,1342867530
654,737490,5851272,6588762,19,1,0,1024,5,6455803524
655,737811,18695244,19433055,22,2,1,153088,10,3561836179
656,740150,4871120,5611270,38,3,0,11264,26,10403727141
657,740730,9098231,9838961,18,1,0,7680,13,9121378616
658,742221,19004683,19746904,21,2,1,40448,25,8931390212
659,742520,19004407,19746927,10,1,1,9216,4,2938853101
660,742551,19175162,19917713,31,3,1,5120,27,9042396697
661,742910,5287290,6030200,37,3,0,12288,15,10709801679
662,746920,6056534,6803454,15,1,0,10240,19,6737270372
663,747120,7526078,8273198,4,0,0,23552,14,4001541989
664,748071,6724865,7472936,9,0,0,12288,12,9810250437
665,749000,7310066,8059066,27,2,0,89088,9,6194409719
666,749960,5663907,6413867,10,1,0,58368,4,9844698970
667,754020,19182927,19936947,2,0,1,1536,3,818458143
668,754250,9211062,9965312,26,2,0,47104,29,3993851381
669,754360,5267012,6021372,39,3,0,9728,2,9146938127
670,755440,19181530,19936970,1,0,1,7168,26,6919961694
671,757050,10195309,10952359,35,3,0,23040,8,3330412105
672,758391,4442686,5201077,34,3,0,12288,2,3757715761
673,758570,19179070,19937640,1,0,1,2560,26,8757547538
674,759280,6709889,7469169,36,3,0,24064,3,2415668625
675,762850,6054986,6817836,22,2,0,20480,10,9747377608
676,763350,9392276,10155626,3,0,0,105984,5,5565399797
677,764940,7091832,7856772,37,3,0,10240,15,7921798497
678,765011,8529496,9294507,25,2,0,61440,4,3628182452
679,765650,19172013,19937663,28,2,1,4608,24,4398638145
680,771620,19182839,19954459,9,0,1,24576,12,3751947137
681,772940,19447673,20220613,33,3,1,21504,22,10028641
682,774210,6113014,6887224,19,1,0,65024,5,3001075743
683,774390,19450089,20224479,0,0,1,6144,8,3601448850
684,774451,6863800,7638251,9,0,0,48128,12,4741919950
685,776491,6796717,7573208,34,3,0,38912,2,9462929398
686,776620,6009894,6786514,11,1,0,65536,6,8455067060
687,777440,7389846,8167286,39,3,0,24064,2,6630553176
688,778790,5809637,6588427,14,1,0,55296,8,6482515712
689,779070,19449275,20228345,34,3,1,6144,2,1816074414
690,779210,9639432,10418642,0,0,0,4096,8,5988006717
691,779549,19449462,20229011,11,1,1,1024,6,4064214957
692,779730,4196015,4975745,10,1,0,27136,4,6284856904
693,782290,6632275,7414565,6,0,0,13312,24,7140271722
694,782670,6536167,7318837,31,3,0,48128,27,608368746
695,783210,8059957,8843167,27,2,0,48128,9,8194213585
696,783339,19448898,20232237,11,1,1,5120,6,5195161187
697,783720,3360943,4144663,29,2,0,19968,26,9315652000
698,784081,7350313,8134394,9,0,0,48640,12,2301064042
699,785120,3822466,4607586,26,2,0,7168,29,4844081467
700,786880,7003970,7790850,22,2,0,41984,10,8350696568
701,787490,8916960,9704450,0,0,0,13824,8,7771950427
702,787960,7122755,7910715,35,3,0,49664,8,6249446129
703,790290,5812250,6602540,30,3,0,1024,3,4030429071
704,790380,6244425,7034805,30,3,0,18432,3,9313048003
705,790610,4066148,4856758,16,1,0,5120,10,1740650581
706,795550,19436841,20232391,32,3,1,8704,17,8905476130
707,796080,7134181,7930261,4,0,0,50176,14,543223564
708,796290,8324840,9121130,32,3,0,68096,17,4200077561
709,801330,19503036,20304366,36,3,1,8704,3,5555255769
710,803641,5222792,6026433,9,0,0,3584,12,6341131819
711,803760,4182373,4986133,38,3,0,3072,26,9071668300
712,804680,5700168,6504848,27,2,0,10240,9,7470811669
713,805220,9804599,10609819,27,2,0,18432,9,1412889902
714,806850,7222062,8028912,18,1,0,121344,13,2119327021
715,807080,6889290,7696370,35,3,0,54272,8,6137060958
716,807170,9067091,9874261,11,1,0,14848,6,2923569982
717,808380,5561402,6369782,38,3,0,29696,26,10471592284
718,811050,4726707,5537757,23,2,0,5632,4,4983795419
719,812930,10022616,10835546,24,2,0,29184,10,6237672466
720,815450,5236975,6052425,37,3,0,16384,15,5171694528
721,817680,19488916,20306596,2,0,1,7680,3,6945044890
722,818120,19607635,20425755,39,3,1,1536,2,5212867711
723,819300,6440190,7259490,22,2,0,62464,10,542762853
724,819820,6993852,7813672,5,0,0,10752,4,7650746581
725,819890,5602478,6422368,18,1,0,6656,13,4178879457
726,820080,20489014,21309094,17,1,1,251904,28,10254177076
727,821080,5972633,6793713,8,0,0,23552,1,393840566
728,822310,3491958,4314268,30,3,0,1536,3,9645130351
729,823491,20485626,21309117,30,3,1,3584,3,3309882982
730,826500,6655416,7481916,11,1,0,25088,6,9421593426
731,829760,7716070,8545830,30,3,0,43008,3,1226891881
732,830279,20478861,21309140,37,3,1,2048,15,4764752893
733,831001,5788193,6619194,9,0,0,11776,12,9307742974
734,831330,10345412,11176742,26,2,0,57856,29,1643714807
735,831940,6012785,6844725,6,0,0,11776,24,8389038767
736,832030,7494003,8326033,10,1,0,1536,4,10237527957
737,833100,6320137,7153237,8,0,0,20992,1,3240526545
738,834020,6312798,7146818,37,3,0,8704,15,9058205951
739,834080,7229579,8063659,26,2,0,10240,29,9122572269
740,834130,6083363,6917493,13,1,0,57856,6,5357955803
741,835450,20473899,21309349,34,3,1,3584,2,3877638817
742,836280,20475015,21311295,28,2,1,3072,24,1949487970
743,838600,2349616,3188216,30,3,0,12288,3,7208808735
744,839440,5903816,6743256,22,2,0,42496,10,8580499519
745,839960,3124724,3964684,10,1,0,3584,4,7426448895
746,841360,20470281,21311641,2,0,1,512,3,4689319941
747,841900,5411551,6253451,37,3,0,23552,15,5348095293
748,843881,8004480,8848361,9,0,0,512,12,5936299142
749,844791,6257319,7102110,34,3,0,9728,2,4441352835
750,844901,7871945,8716846,34,3,0,24576,2,438916449
751,844970,4500101,5345071,8,0,0,22016,1,7406997329
752,845290,6106771,6952061,3,0,0,7680,5,6872257789
753,845871,20468356,21314227,10,1,1,4096,4,7298666964
754,846320,6053522,6899842,30,3,0,18944,3,479874281
755,846370,6627681,7474051,22,2,0,3584,10,6289651151
756,846620,7341624,8188244,10,1,0,2048,4,7173094141
757,846761,7137154,7983915,25,2,0,58368,4,10465150622
758,849920,6593338,7443258,38,3,0,7680,26,7229830705
759,853181,4171895,5025076,34,3,0,3584,2,6044995854
760,853730,20542013,21395743,13,1,1,512,6,3160245568
761,853830,8680057,9533887,7,0,0,23552,29,19422588
762,854500,6115170,6969670,1,0,0,6144,26,5338501136
763,855080,4276385,5131465,26,2,0,10240,29,3961836999
764,855200,5737173,6592373,29,2,0,11776,26,623032815
765,856949,21117986,21974935,5,0,1,227840,4,2121724225
766,859861,21126742,21986603,26,2,1,16384,29,9599962971
767,860560,3946451,4807011,7,0,0,3072,29,4298192370
768,860910,3595860,4456770,24,2,0,24064,10,9767256217
769,861210,7360572,8221782,11,1,0,19968,6,3715024574
770,861681,8602926,9464607,25,2,0,29696,4,7306590696
771,862369,21502091,22364460,5,0,1,44544,4,4360265422
772,862630,7695900,8558530,4,0,0,34304,14,7728937524
773,863690,10366158,11229848,39,3,0,74752,2,2169804221
774,864351,7237526,8101877,34,3,0,24576,2,2582779038
775,864990,8645410,9510400,7,0,0,512,29,6269031484
776,866850,7415644,8282494,26,2,0,8192,29,6707010453
777,867320,21497341,22364661,13,1,1,1024,6,1620444539
778,867360,8090230,8957590,4,0,0,48640,14,7330808395
779,868650,21496677,22365327,34,3,1,11264,2,8295163427
780,869161,4685106,5554267,34,3,0,4608,2,3408347209
781,870410,7074896,7945306,4,0,0,19456,14,2445034573
782,871410,4572800,5444210,7,0,0,23040,29,9964283277
783,872470,10483808,11356278,39,3,0,7168,2,667139383
784,872560,8329543,9202103,29,2,0,24576,26,2466522899
785,874230,5163215,6037445,23,2,0,18432,4,5943645196
786,875570,21511959,22387529,36,3,1,4608,3,2471574844
787,875760,7485063,8360823,39,3,0,23552,2,2984017279
788,878070,7281845,8159915,22,2,0,36864,10,6708465078
789,879661,21508534,22388195,21,2,1,11264,25,1856066224
790,879830,7492872,8372702,30,3,0,38912,3,454740387
791,880050,6067597,6947647,19,1,0,11264,5,5698768635
792,880090,6930283,7810373,39,3,0,64000,2,6093111075
793,880530,8785631,9666161,3,0,0,126464,5,6214872019
794,884381,5680265,6564646,33,3,0,2560,22,2855252660
795,884830,21695123,22579953,25,2,1,5120,4,2720086103
796,885811,21694165,22579976,19,1,1,4096,5,1260782189
797,886151,21712123,22598274,31,3,1,5632,27,10583647200
798,886280,21720940,22607220,3,0,1,18944,5,5715297817
799,888910,21739751,22628661,9,0,1,8192,12,9363111757
800,890830,21739281,22630111,39,3,1,7168,2,3828471450
801,892790,7197489,8090279,16,1,0,52736,10,4445000353
802,893490,5904146,6797636,27,2,0,12800,9,3566437597
803,895360,4699452,5594812,19,1,0,18944,5,8308846174
804,896010,5773283,6669293,11,1,0,1024,6,3591553958
805,896230,21740666,22636896,2,0,1,11264,3,6985388109
806,896769,22377500,23274269,5,0,1,139264,4,9999421899
807,897000,22389961,23286961,14,1,1,3584,8,4157453906
808,897380,3475169,4372549,37,3,0,5632,15,9722372539
809,902481,8858273,9760754,33,3,0,1024,22,1549203771
810,902570,6916140,7818710,12,1,0,12288,3,7056638954
811,902861,5477046,6379907,9,0,0,10752,12,8669027441
812,904080,5284019,6188099,7,0,0,6656,29,3437639142
813,904190,22383744,23287934,12,1,1,12800,3,6630433815
814,905410,5800470,6705880,22,2,0,21504,10,9213942549
815,907140,5400258,6307398,36,3,0,8704,3,9369108564
816,907970,9554673,10462643,18,1,0,57856,13,1206018526
817,908240,22455877,23364117,12,1,1,5632,3,6662801977
818,909400,7696117,8605517,10,1,0,32768,4,3442945454
819,909870,22454593,23364463,17,1,1,512,28,10333832678
820,910730,6247998,7158728,39,3,0,17920,2,1752332981
821,911191,22676298,23587489,21,2,1,27648,25,9853601604
822,911391,5935073,6846464,33,3,0,5632,22,946195106
823,911500,3827168,4738668,16,1,0,19968,10,2851916191
824,912450,8786182,9698632,3,0,0,106496,5,5704805485
825,912540,7485043,8397583,11,1,0,39424,6,2857428077
826,912960,5679904,6592864,31,3,0,1536,27,7164524733
827,913030,9101744,10014774,12,1,0,38400,3,5554135087
828,916750,7591807,8508557,6,0,0,27136,24,3446022577
829,919630,8066756,8986386,36,3,0,48128,3,6381476476
830,922810,6458770,7381580,10,1,0,9216,4,4072056981
831,925200,22662320,23587520,17,1,1,4096,28,3534986461
832,931270,7008085,7939355,23,2,0,20992,4,9365734510
833,931820,5600148,6531968,5,0,0,28672,4,5578290480
834,932330,22674776,23607106,13,1,1,5632,6,2410941142
835,934810,6433285,7368095,0,0,0,1536,8,3901645749
836,935640,8396688,9332328,11,1,0,73216,6,6824528838
837,936010,5484299,6420309,31,3,0,18944,27,1846889230
838,936890,9365776,10302666,30,3,0,55808,3,6400851201
839,937420,22670045,23607465,25,2,1,9728,4,63404538
840,938091,22670360,23608451,21,2,1,1536,25,8349657930
841,938130,8092947,9031077,37,3,0,90112,15,9444003434
842,938640,8798263,9736903,38,3,0,37376,26,620035455
843,939101,7387423,8326524,25,2,0,1536,4,5172089360
844,939930,6739881,7679811,5,0,0,28672,4,4480271779
845,940670,8797036,9737706,16,1,0,2560,10,2783380064
846,943540,7116976,8060516,6,0,0,1024,24,1501152004
847,943710,6909911,7853621,30,3,0,25600,3,8220163752
848,943880,7288065,8231945,11,1,0,33280,6,3570375487
849,945801,7202843,8148644,33,3,0,29696,22,10285161934
850,951120,3982635,4933755,14,1,0,17920,8,4303222745
851,951270,3920605,4871875,29,2,0,4608,26,4923488722
852,952011,22708254,23660265,30,3,1,4608,3,7447332601
853,952720,22710451,23663171,35,3,1,4608,8,32218089
854,953780,22710057,23663837,35,3,1,1024,8,10002641570
855,954740,4897854,5852594,18,1,0,3072,13,712957011
856,955030,4984783,5939813,18,1,0,2048,13,2819571786
857,955630,7681806,8637436,38,3,0,14336,26,8326089124
858,955730,8798847,9754577,6,0,0,55296,24,9884915370
859,955870,22715125,23670995,2,0,1,8192,3,1287036298
860,956191,22723129,23679320,30,3,1,8192,3,6599800699
861,956471,22722872,23679343,7,0,1,6144,29,3755159938
862,956890,5614666,6571556,39,3,0,20480,2,3815603052
863,957441,22816937,23774378,26,2,1,10240,29,2342642993
864,959840,8394070,9353910,27,2,0,58880,9,3259851641
865,961440,5988258,6949698,39,3,0,6656,2,113008849
866,963310,22811091,23774401,14,1,1,1024,8,9465224951
867,963390,7775406,8738796,38,3,0,24064,26,3022523789
868,963530,7068369,8031899,12,1,0,9728,3,404972047
869,963820,10652758,11616578,30,3,0,45056,3,3790105150
870,965530,7311458,8276988,16,1,0,512,10,5327818025
871,966160,22808944,23775104,6,0,1,4608,24,10375773944
872,970851,22844980,23815831,7,0,1,3072,29,3567579932
873,973850,6117478,7091328,15,1,0,10752,19,4429127218
874,974460,6727728,7702188,30,3,0,14848,3,2396491532
875,975270,6138996,7114266,30,3,0,14336,3,658479210
876,975460,22841242,23816702,28,2,1,12288,24,8136884070
877,975660,4641427,5617087,1,0,0,4096,26,3956448583
878,975881,6862406,7838287,33,3,0,16896,22,3215323791
879,978910,4008338,4987248,6,0,0,3584,24,7467893558
880,979810,6164333,7144143,5,0,0,512,4,260826552
881,980659,22837989,23818648,11,1,1,3072,6,5537581405
882,982120,22914535,23896655,17,1,1,18432,28,1377343363
883,982770,9200514,10183284,14,1,0,48640,8,1755451662
884,985470,7864185,8849655,7,0,0,3584,29,6245116563
885,985910,7357204,8343114,0,0,0,19968,8,9568625186
886,987671,6391078,7378749,9,0,0,5632,12,7671116251
887,988110,7423629,8411739,11,1,0,26624,6,6824001440
888,989260,8090182,9079442,16,1,0,73216,10,10163456070
889,989480,6284073,7273553,11,1,0,46080,6,6954558351
890,990810,6824133,7814943,7,0,0,4096,29,3458068171
891,991879,22904799,23896678,4,0,1,2560,14,344509066
892,993530,9058239,10051769,26,2,0,121344,29,3615478252
893,994701,22904683,23899384,19,1,1,4608,5,9759924739
894,996569,22908921,23905490,5,0,1,20992,4,5996875571
895,1001220,8249149,9250369,24,2,0,13312,10,3871155291
896,1004220,8077772,9081992,18,1,0,6144,13,7959303777
897,1004770,7870839,8875609,26,2,0,7168,29,8795392475
898,1004880,7653772,8658652,37,3,0,512,15,1167412811
899,1005150,22959100,23964250,33,3,1,23040,22,1677226316
900,1005460,10939305,11944765,11,1,0,88576,6,3375466900
901,1005620,8694595,9700215,5,0,0,5120,4,1037047473
902,1006061,23013142,24019203,7,0,1,3584,29,10444502720
903,1007050,7282487,8289537,6,0,0,23040,24,10402570975
904,1009640,9696756,10706396,37,3,0,75264,15,1983480346
905,1012150,5828964,6841114,12,1,0,34816,3,6025704305
906,1014700,23005809,24020509,28,2,1,2048,24,1513146672
907,1014940,9305119,10320059,32,3,0,12800,17,10610032246
908,1015680,7612194,8627874,36,3,0,17920,3,1274837172
909,1015900,8545805,9561705,37,3,0,53248,15,6187577488
910,1017590,6581895,7599485,38,3,0,16896,26,2781970123
911,1018580,8840730,9859310,12,1,0,22528,3,2563044503
912,1018940,8342192,9361132,15,1,0,5632,19,2445832294
913,1019710,10227334,11247044,10,1,0,40448,4,254259715
914,1019757,8037354,9057111,36,3,0,13824,3,9970383322
915,1020260,8315679,9335939,6,0,0,11776,24,175203804
916,1020861,23002234,24023095,19,1,1,4096,5,3514342697
917,1020920,23005105,24026025,33,3,1,9728,22,6714071081
918,1021380,7398850,8420230,23,2,0,9216,4,4413832195
919,1022640,10000556,11023196,13,1,0,109568,6,8999922107
920,1022710,7860566,8883276,10,1,0,25088,4,2996465055
921,1023251,8861383,9884634,9,0,0,13312,12,8629794457
922,1023300,7242699,8265999,1,0,0,1024,26,9816967293
923,1023520,5052612,6076132,13,1,0,1024,6,5554218568
924,1027001,23257856,24284857,10,1,1,27648,4,4272282834
925,1027081,7901572,8928653,25,2,0,101376,4,4937270588
926,1028490,11123796,12152286,26,2,0,7680,29,8482853203
927,1028670,6565644,7594314,38,3,0,7168,26,1035131901
928,1029899,23281141,24311040,23,2,1,512,4,4954157673
929,1032010,7543905,8575915,15,1,0,3584,19,4175881586
930,1033289,23282897,24316186,5,0,1,8192,4,6323058378
931,1033590,5766721,6800311,30,3,0,8704,3,5571938743
932,1034420,8775566,9809986,39,3,0,7168,2,1577856724
933,1034919,23282253,24317172,8,0,1,1536,1,3497783161
934,1037630,6784067,7821697,36,3,0,9728,3,884317616
935,1038790,9431520,10470310,13,1,0,25088,6,9723805196
936,1038800,7362261,8401061,26,2,0,6144,29,4641177204
937,1039070,23281648,24320718,28,2,1,5632,24,7760480482
938,1042510,10356494,11399004,3,0,0,53760,5,7931395400
939,1043311,23278393,24321704,26,2,1,1536,29,9126683268
940,1045720,8816756,9862476,27,2,0,8704,9,226706764
941,1048900,5980266,7029166,5,0,0,29696,4,6658307878
942,1051470,6249736,7301206,38,3,0,28672,26,4253474356
943,1051620,6167008,7218628,38,3,0,15872,26,8242821152
944,1051860,11453708,12505568,22,2,0,15872,10,2448893493
945,1051980,4708503,5760483,37,3,0,7680,15,4778617158
946,1052201,9442724,10494925,33,3,0,9216,22,7023526929
947,1053150,23316600,24369750,36,3,1,9216,3,4665304107
948,1055240,7991327,9046567,29,2,0,1024,26,1125541034
949,1055620,6456217,7511837,6,0,0,22528,24,177537995
950,1057440,7503297,8560737,4,0,0,7168,14,5118915709
951,1057910,23313134,24371044,32,3,1,2048,17,3377468324
952,1058270,7327270,8385540,22,2,0,23040,10,10417761009
953,1059870,8078074,9137944,30,3,0,17920,3,10371077642
954,1060051,23311016,24371067,21,2,1,8704,25,9039313856
955,1060640,6068496,7129136,27,2,0,24064,9,5736257061
956,1060900,11340526,12401426,24,2,0,23040,10,4055750435
957,1062050,8190526,9252576,18,1,0,7168,13,9403851935
958,1062710,6347776,7410486,3,0,0,25088,5,3206372939
959,1063850,9193742,10257592,3,0,0,29184,5,1681741433
960,1065030,6133594,7198624,11,1,0,30208,6,7505326895
961,1065260,7416074,8481334,37,3,0,3072,15,9594152970
962,1068380,7310117,8378497,28,2,0,18944,24,2686385819
963,1069070,7145638,8214708,36,3,0,2048,3,4274885662
964,1070930,7587052,8657982,8,0,0,2560,1,10133771281
965,1071430,8826198,9897628,3,0,0,12288,5,2827582423
966,1071850,7327316,8399166,16,1,0,5120,10,7783020084
967,1072190,8374289,9446479,3,0,0,40448,5,7835912064
968,1072940,9012180,10085120,6,0,0,30720,24,8622110587
969,1073591,7598211,8671802,9,0,0,33280,12,2842027289
970,1076270,6769528,7845798,32,3,0,24576,17,4118122023
971,1077500,5776446,6853946,32,3,0,7680,17,9778193421
972,1078310,23292780,24371090,1,0,1,1024,26,10483657085
973,1080460,7419806,8500266,26,2,0,54784,29,3885940281
974,1080470,10438780,11519250,1,0,0,67584,26,5539462205
975,1083450,5271299,6354749,13,1,0,3072,6,2237621313
976,1083700,23287413,24371113,34,3,1,3584,2,7755236873
977,1084470,9661525,10745995,6,0,0,15872,24,1962060061
978,1086870,23323337,24410207,34,3,1,14848,2,9545187987
979,1087830,9948851,11036681,11,1,0,12288,6,6690636832
980,1088290,8623093,9711383,31,3,0,2560,27,5804974451
981,1088320,8169427,9257747,26,2,0,16896,29,38092610
982,1088330,7731202,8819532,12,1,0,12800,3,9222678518
983,1088391,23417270,24505661,7,0,1,11776,29,2705557420
984,1089860,9282939,10372799,14,1,0,1024,8,894969454
985,1089880,5721693,6811573,7,0,0,11264,29,4823703778
986,1093927,7958949,9052876,35,3,0,17920,8,2643151689
987,1098780,9271165,10369945,39,3,0,48640,2,9009691379
988,1098820,6795305,7894125,30,3,0,33792,3,7657361220
989,1099040,9393054,10492094,6,0,0,2560,24,9027442293
990,1100850,7841897,8942747,18,1,0,23552,13,2481124296
991,1101470,9434606,10536076,22,2,0,33280,10,3872398300
992,1102870,7016681,8119551,4,0,0,25600,14,5115250263
993,1104700,7942693,9047393,27,2,0,1536,9,7948824959
994,1105100,23400584,24505684,0,0,1,6144,8,7675011787
995,1106859,23681339,24788198,37,3,1,61440,15,6632313485
996,1109300,7465500,8574800,0,0,0,46080,8,5762480019
997,1109600,7738940,8848540,11,1,0,512,6,380533381
998,1110459,23691669,24802128,8,0,1,512,1,9334338974
999,1111431,9174208,10285639,25,2,0,11264,4,6182264460
1000,1111779,23690372,24802151,18,1,1,8704,13,4603571298
1001,1113560,6439787,7553347,23,2,0,15360,4,2738541542
1002,1113620,23703600,24817220,3,0,1,15360,5,1561790466
1003,1113730,8341806,9455536,24,2,0,11776,10,7787671915
1004,1113800,7783942,8897742,30,3,0,38400,3,6944186843
1005,1113850,8721321,9835171,26,2,0,51712,29,6270034108
1006,1114700,7413721,8528421,5,0,0,2048,4,4850974758
1007,1116760,23767144,24883904,29,2,1,2048,26,5533904561
1008,1119020,9204986,10324006,23,2,0,12800,4,5816201072
1009,1120730,8589850,9710580,37,3,0,4608,15,4924147780
1010,1122550,23761377,24883927,6,0,1,3584,24,8428451608
1011,1123020,8311112,9434132,4,0,0,102912,14,3796482838
1012,1123370,9511954,10635324,29,2,0,36352,26,9858692772
1013,1124050,9680821,10804871,18,1,0,14336,13,4097351856
1014,1124290,5096503,6220793,24,2,0,512,10,1800724925
1015,1125691,7169797,8295488,9,0,0,19456,12,669615146
1016,1127100,7721082,8848182,10,1,0,16384,4,2681625235
1017,1127480,6838628,7966108,26,2,0,16896,29,4032443906
1018,1129900,9966115,11096015,12,1,0,14848,3,1515206290
1019,1130190,23763993,24894183,12,1,1,3072,3,5424571447
1020,1130220,7834257,8964477,30,3,0,22528,3,7774019306
1021,1130470,9630547,10761017,13,1,0,37376,6,7834435896
1022,1131900,10566098,11697998,1,0,0,14848,26,4835569724
1023,1131940,7956939,9088879,7,0,0,22528,29,1852974106
1024,1132551,23762400,24894951,7,0,1,11776,29,6292956034
1025,1134840,23777591,24912431,16,1,1,5632,10,6722634009
1026,1135531,23982103,25117634,19,1,1,13824,5,153204894
1027,1135770,9032671,10168441,35,3,0,41984,8,10723359374
1028,1139640,8569513,9709153,7,0,0,15360,29,8639099649
1029,1139999,23981643,25121642,4,0,1,4096,14,10053060412
1030,1140950,24034576,25175526,39,3,1,12800,2,8110412158
1031,1140960,6970768,8111728,16,1,0,32256,10,4529894860
1032,1141412,8576078,9717490,30,3,0,19968,3,9639973693
1033,1142231,9136654,10278885,34,3,0,38400,2,3106407129
1034,1142510,7194489,8336999,11,1,0,34304,6,3265236159
1035,1143260,6996313,8139573,32,3,0,16896,17,3576227270
1036,1143420,8963031,10106451,38,3,0,18432,26,8579780461
1037,1145150,8477285,9622435,4,0,0,89088,14,8032038971
1038,1146000,9327632,10473632,7,0,0,6144,29,2810593897
1039,1147309,24029066,25176375,11,1,1,6144,6,3595392478
1040,1147940,6946426,8094366,24,2,0,13312,10,9113027176
1041,1150860,6841057,7991917,26,2,0,13824,29,3306498414
1042,1151011,24025403,25176414,26,2,1,6144,29,242104143
1043,1153850,24046494,25200344,29,2,1,9728,26,8356813158
1044,1154040,8918078,10072118,18,1,0,27648,13,8770716442
1045,1155900,5805139,6961039,6,0,0,6656,24,6682811108
1046,1157051,7057010,8214061,9,0,0,11264,12,6053303027
1047,1157740,8622069,9779809,19,1,0,62464,5,9154245767
1048,1159550,9072023,10231573,15,1,0,63488,19,1987964687
1049,1162530,9243941,10406471,37,3,0,32768,15,147756444
1050,1164600,7581097,8745697,3,0,0,8704,5,438581404
1051,1164650,7830058,8994708,24,2,0,4608,10,6670956780
1052,1166530,10216071,11382601,4,0,0,27136,14,9507300995
1053,1167110,7601409,8768519,23,2,0,13312,4,3211182130
1054,1167171,6363074,7530245,25,2,0,17408,4,3060754642
1055,1167370,6892811,8060181,39,3,0,3584,2,1284225538
1056,1171599,24100742,25272341,23,2,1,6656,4,6067974152
1057,1173270,6710536,7883806,19,1,0,37376,5,2828872859
1058,1173950,9249138,10423088,39,3,0,8192,2,6176383361
1059,1178330,24094677,25273007,39,3,1,1024,2,6520528571
1060,1180060,7584380,8764440,27,2,0,61440,9,10022395171
1061,1180181,7019318,8199499,34,3,0,36864,2,5203802895
1062,1180490,6715070,7895560,36,3,0,4608,3,4632316498
1063,1182310,10052241,11234551,36,3,0,15360,3,4011287689
1064,1183080,10765483,11948563,36,3,0,9216,3,5782405167
1065,1184410,6036737,7221147,0,0,0,8192,8,8397374384
1066,1186291,24116737,25303028,7,0,1,5120,29,5025717143
1067,1186740,7341034,8527774,32,3,0,14336,17,8510164990
1068,1187030,9388400,10575430,10,1,0,13824,4,4003897186
1069,1187220,8440386,9627606,6,0,0,16896,24,5329482649
1070,1187330,10006874,11194204,27,2,0,8192,9,9222881576
1071,1187769,24115823,25303592,8,0,1,10752,1,1454342166
1072,1191880,7743668,8935548,36,3,0,22528,3,8660634793
1073,1192120,24119730,25311850,12,1,1,6144,3,4570283990
1074,1195591,7797690,8993281,34,3,0,22528,2,2467792348
1075,1196380,7436665,8633045,5,0,0,16896,4,8897412171
1076,1196401,7850501,9046902,9,0,0,1024,12,2622824507
1077,1197280,6364049,7561329,15,1,0,24064,19,3936320653
1078,1198131,10860185,12058316,25,2,0,19456,4,3746017114
1079,1199550,10983090,12182640,8,0,0,4608,1,7502073146
1080,1200080,8061590,9261670,7,0,0,12800,29,5357556360
1081,1200150,6497491,7697641,39,3,0,4096,2,2190422480
1082,1200240,24121328,25321568,6,0,1,8192,24,3650127082
1083,1200830,24189903,25390733,33,3,1,9216,22,2415567831
1084,1201311,9313168,10514479,34,3,0,21504,2,3200775872
1085,1204050,24203444,25407494,36,3,1,1536,3,7662626722
1086,1205121,7874976,9080097,9,0,0,2048,12,2979905865
1087,1206350,11444976,12651326,36,3,0,104960,3,10454559167
1088,1207900,8597204,9805104,12,1,0,82944,3,3455389183
1089,1209580,8034027,9243607,10,1,0,25088,4,9696911844
1090,1210910,10263207,11474117,23,2,0,12288,4,5857145008
1091,1210960,9530176,10741136,5,0,0,23040,4,3434390181
1092,1211590,6156014,7367604,6,0,0,3584,24,10408546140
1093,1213891,24365790,25579681,26,2,1,65536,29,3363777549
1094,1213970,8686177,9900147,12,1,0,8192,3,2087762322
1095,1214230,10283446,11497676,1,0,0,34816,26,3542817248
1096,1214520,7438580,8653100,11,1,0,21504,6,5150013994
1097,1216340,9274943,10491283,37,3,0,57856,15,7405349421
1098,1218900,10041941,11260841,8,0,0,3584,1,2736097108
1099,1219140,8873023,10092163,13,1,0,23040,6,1685933224
1100,1220490,10195177,11415667,12,1,0,49152,3,6439150978
1101,1221691,24358013,25579704,7,0,1,2048,29,579895704
1102,1223420,6709516,7932936,19,1,0,8704,5,9974756251
1103,1224371,9446749,10671120,33,3,0,37376,22,8976034266
1104,1224390,24355337,25579727,16,1,1,1024,10,7950034781
1105,1227770,9168694,10396464,6,0,0,52224,24,6839598531
1106,1227950,7966642,9194592,24,2,0,30208,10,3582986525
1107,1228400,8641314,9869714,11,1,0,11264,6,5958069144
1108,1229290,24350460,25579750,28,2,1,1024,24,9363183559
1109,1236680,7624000,8860680,5,0,0,11776,4,8467235860
1110,1236910,9729980,10966890,24,2,0,47616,10,3739431463
1111,1237500,9104843,10342343,24,2,0,12288,10,2130651559
1112,1238411,9358391,10596802,25,2,0,25600,4,4562983177
1113,1238760,8071237,9309997,18,1,0,15872,13,891531304
1114,1243260,11506685,12749945,39,3,0,46080,2,1228953882
1115,1245460,8634752,9880212,12,1,0,19456,3,6034628839
1116,1246320,10550229,11796549,26,2,0,10240,29,9371122980
1117,1247020,8987696,10234716,23,2,0,10240,4,6530144873
1118,1249380,9524320,10773700,12,1,0,41472,3,3758669854
1119,1249880,24357735,25607615,2,0,1,20992,3,7511272768
1120,1252220,7409419,8661639,1,0,0,9728,26,8548596667
1121,1252540,10308475,11561015,37,3,0,29184,15,1043821233
1122,1252710,9255186,10507896,10,1,0,42496,4,8838160178
1123,1252760,7993522,9246282,30,3,0,8704,3,5770009164
1124,1254110,11068229,12322339,12,1,0,13824,3,4042838089
1125,1255920,8551859,9807779,39,3,0,8704,2,2229787377
1126,1256539,24364283,25620822,18,1,1,22528,13,8568648634
1127,1259320,24407787,25667107,1,0,1,2560,26,5042520989
1128,1261131,7470310,8731441,9,0,0,35328,12,1889230749
1129,1262070,7973870,9235940,36,3,0,75264,3,790226866
1130,1264050,8616505,9880555,30,3,0,1024,3,3275676502
1131,1264680,10281650,11546330,18,1,0,16896,13,5080515704
1132,1267461,10402280,11669741,25,2,0,82432,4,5630563401
1133,1267700,8661358,9929058,30,3,0,16896,3,72048445
1134,1272810,8199296,9472106,11,1,0,4608,6,8444863559
1135,1273390,8643542,9916932,19,1,0,21504,5,2307259128
1136,1273540,6791078,8064618,29,2,0,3072,26,3631413460
1137,1274460,9857755,11132215,8,0,0,52224,1,416882335
1138,1274791,24393392,25668183,21,2,1,13312,25,6507188614
1139,1276700,8534713,9811413,8,0,0,4608,1,4041164352
1140,1276741,24882115,26158856,22,2,1,124416,10,347194826
1141,1277850,9667466,10945316,0,0,0,15872,8,4779917592
1142,1278370,11167015,12445385,13,1,0,83456,6,7877962064
1143,1278550,7994687,9273237,28,2,0,37888,24,8563256401
1144,1278911,24906578,26185489,19,1,1,512,5,7313943527
1145,1279820,10719963,11999783,11,1,0,1536,6,6530465849
1146,1283040,10791946,12074986,8,0,0,6144,1,8515178062
1147,1283301,24904774,26188075,22,2,1,4096,10,7169177620
1148,1284970,7310540,8595510,27,2,0,31744,9,2845855193
1149,1285190,10787901,12073091,4,0,0,26624,14,743361211
1150,1285530,9427753,10713283,5,0,0,22528,4,7540385688
1151,1289350,7832583,9121933,31,3,0,2560,27,9990141937
1152,1289580,24905530,26195110,34,3,1,512,2,7455767785
1153,1290950,9886283,11177233,13,1,0,1536,6,1196356201
1154,1293080,7522529,8815609,16,1,0,7168,10,1976146057
1155,1295080,10838885,12133965,38,3,0,9216,26,1276528929
1156,1296100,7674016,8970116,4,0,0,18432,14,8643199964
1157,1296220,7444167,8740387,31,3,0,5120,27,6593673262
1158,1296380,8764148,10060528,11,1,0,28672,6,3662512891
1159,1296850,24898441,26195291,35,3,1,4608,8,10411472849
1160,1298960,9039616,10338576,11,1,0,23552,6,3532407560
1161,1299900,24911737,26211637,3,0,1,3584,5,2496900379
1162,1300330,9372373,10672703,6,0,0,5120,24,251176824
1163,1301180,7792893,9094073,11,1,0,9728,6,9085867128
1164,1301240,8795938,10097178,39,3,0,16384,2,2573851344
1165,1301280,6975529,8276809,13,1,0,11776,6,7519412693
1166,1301630,9300967,10602597,26,2,0,18944,29,1090493292
1167,1303701,24907959,26211660,22,2,1,3072,10,394494461
1168,1304670,11081648,12386318,0,0,0,23040,8,2071238552
1169,1306340,9738062,11044402,12,1,0,4608,3,4043990278
1170,1307290,11207362,12514652,38,3,0,20480,26,6579608858
1171,1308290,10027194,11335484,39,3,0,68608,2,1940070114
1172,1310190,11351166,12661356,5,0,0,30720,4,3754599179
1173,1310490,9575813,10886303,6,0,0,19456,24,10194822537
1174,1310830,9722084,11032914,10,1,0,30720,4,592547982
1175,1311410,8949013,10260423,31,3,0,9216,27,1927784916
1176,1314830,11485163,12799993,12,1,0,16896,3,9141199187
1177,1316320,8043073,9359393,29,2,0,17920,26,8147586026
1178,1316680,24895003,26211683,34,3,1,1024,2,2393843513
1179,1318460,7117839,8436299,1,0,0,8704,26,9782488773
1180,1318570,8170270,9488840,15,1,0,3584,19,4294288927
1181,1318970,24906880,26225850,12,1,1,1024,3,9549388493
1182,1319620,8995557,10315177,13,1,0,40960,6,3684612997
1183,1321770,11140563,12462333,10,1,0,11776,4,2714724177
1184,1322280,24904407,26226687,27,2,1,2048,9,10067233716
1185,1328500,11722838,13051338,13,1,0,18432,6,2614418008
1186,1329271,10442717,11771988,33,3,0,32768,22,6785926717
1187,1331220,10201024,11532244,6,0,0,3072,24,6835504749
1188,1332620,9187654,10520274,6,0,0,18944,24,4403966981
1189,1333770,11192817,12526587,7,0,0,13824,29,3114677166
1190,1337170,7938586,9275756,26,2,0,8192,29,9285154065
1191,1339240,10486261,11825501,10,1,0,7168,4,10323038286
1192,1339780,10158855,11498635,11,1,0,3072,6,5000718557
1193,1340650,24890543,26231193,39,3,1,7168,2,5621593792
1194,1341420,9682111,11023531,18,1,0,1024,13,1263535553
1195,1341630,7235712,8577342,3,0,0,4608,5,6815836012
1196,1342821,8558301,9901122,9,0,0,3072,12,862440053
1197,1344490,9941637,11286127,4,0,0,9216,14,1914642034
1198,1344710,9931028,11275738,2,0,0,26624,3,1637510310
1199,1345100,8867090,10212190,38,3,0,86016,26,5770144472
1200,1345730,7785141,9130871,26,2,0,25088,29,5828235876
1201,1346390,24890866,26237256,25,2,1,5632,4,5610746755
1202,1347699,24889580,26237279,37,3,1,1024,15,6369564255
1203,1348910,11431578,12780488,14,1,0,25088,8,739910194
1204,1349040,24928458,26277498,33,3,1,1536,22,5249040237
1205,1349830,9274395,10624225,13,1,0,33280,6,2106830996
1206,1351210,10610191,11961401,11,1,0,3072,6,9137343106
1207,1351320,9727391,11078711,31,3,0,22528,27,1848777583
1208,1352170,9466908,10819078,3,0,0,5632,5,7253295770
1209,1354800,10131245,11486045,26,2,0,1024,29,5545859757
1210,1355030,10692818,12047848,38,3,0,34304,26,3736354876
1211,1359130,8167558,9526688,16,1,0,26624,10,4214650602
1212,1361120,9906483,11267603,37,3,0,20480,15,99147128
1213,1363461,24914060,26277521,7,0,1,1536,29,10563310102
1214,1363670,9550774,10914444,6,0,0,59392,24,2773056219
1215,1364220,10310224,11674444,7,0,0,15360,29,2414926798
1216,1364340,7039248,8403588,29,2,0,8192,26,6793530913
1217,1364900,7292279,8657179,16,1,0,13312,10,3483320546
1218,1367130,25027770,26394900,25,2,1,31744,4,419534518
1219,1367420,7065230,8432650,22,2,0,4608,10,2652808977
1220,1368460,7731899,9100359,36,3,0,18944,3,10461973428
1221,1370280,10227885,11598165,36,3,0,4096,3,6283593832
1222,1370680,11424050,12794730,32,3,0,1024,17,5360202816
1223,1372420,8353072,9725492,37,3,0,13824,15,9221033213
1224,1372490,11889174,13261664,3,0,0,38400,5,6253139007
1225,1373400,10103494,11476894,11,1,0,4608,6,1275867909
1226,1374210,10775713,12149923,15,1,0,49664,19,5828860222
1227,1375050,25042446,26417496,35,3,1,3584,8,6064398554
1228,1375200,25048426,26423626,36,3,1,1024,3,6580825109
1229,1378919,25044730,26423649,11,1,1,5120,6,2431037796
1230,1379560,9767479,11147039,1,0,0,20992,26,717180573
1231,1380420,11609508,12989928,36,3,0,6144,3,10507276192
1232,1383390,10579781,11963171,1,0,0,1536,26,7527324179
1233,1383780,25039892,26423672,36,3,1,7680,3,8851707592
1234,1384410,25061886,26446296,6,0,1,10240,24,8217180227
1235,1384950,11493937,12878887,39,3,0,65536,2,8557315627
1236,1387120,25092356,26479476,13,1,1,12288,6,10621585621
1237,1388471,25159980,26548451,10,1,1,5632,4,9120794161
1238,1388761,25924169,27312930,26,2,1,161792,29,3545959531
1239,1390120,11029814,12419934,27,2,0,26112,9,8567157321
1240,1390970,8550396,9941366,10,1,0,28160,4,8653921235
1241,1392200,9869132,11261332,24,2,0,1536,10,58632064
1242,1395240,10196639,11591879,18,1,0,59904,13,7528344374
1243,1396450,11999663,13396113,23,2,0,77312,4,1033644206
1244,1396551,8497310,9893861,25,2,0,30208,4,87370676
1245,1399421,25922256,27321677,22,2,1,11264,10,1365052995
1246,1401299,25920401,27321700,11,1,1,10752,6,347393731
1247,1402130,7569569,8971699,26,2,0,5120,29,3751964134
1248,1402960,12102706,13505666,10,1,0,38912,4,3467766326
1249,1404130,8448293,9852423,26,2,0,17920,29,8055791822
1250,1405841,8669888,10075729,25,2,0,11776,4,5406216691
1251,1406680,10470567,11877247,10,1,0,50688,4,10665587660
1252,1406780,7716424,9123204,14,1,0,4096,8,156306114
1253,1407540,8656131,10063671,19,1,0,10240,5,5675556592
1254,1407580,10415714,11823294,28,2,0,44032,24,6464893035
1255,1409220,8857934,10267154,12,1,0,22016,3,8549764934
1256,1409540,10706275,12115815,36,3,0,9728,3,3715791902
1257,1410640,8348804,9759444,0,0,0,15872,8,8623253531
1258,1413210,10896759,12309969,2,0,0,45568,3,4324239542
1259,1413240,8433700,9846940,6,0,0,26112,24,2328351973
1260,1416200,8450059,9866259,15,1,0,12288,19,9097926939
1261,1416220,11476277,12892497,15,1,0,23552,19,5276906563
1262,1416700,11645488,13062188,6,0,0,31232,24,5465165911
1263,1417070,25939358,27356428,36,3,1,7680,3,5460489556
1264,1418460,25941446,27359906,6,0,1,4608,24,8775618677
1265,1419560,8563758,9983318,2,0,0,10240,3,6388337697
1266,1419870,7297935,8717805,16,1,0,3072,10,2188181740
1267,1421781,25938148,27359929,30,3,1,512,3,1034394995
1268,1423980,10283669,11707649,8,0,0,10240,1,6065444790
1269,1424670,25935282,27359952,16,1,1,1024,10,501228102
1270,1425631,25934352,27359983,19,1,1,1024,5,9959295696
1271,1425900,25934106,27360006,27,2,1,4096,9,593553300
1272,1427420,10365807,11793227,16,1,0,69632,10,10375604324
1273,1430210,10700916,12131126,26,2,0,50176,29,9894290585
1274,1430741,25933212,27363953,30,3,1,7168,3,315423171
1275,1432281,25954423,27386704,7,0,1,3072,29,3514098461
1276,1432511,9171669,10604180,9,0,0,5120,12,9183630817
1277,1433540,25953187,27386727,16,1,1,2560,10,1998630476
1278,1436331,11133312,12569643,33,3,0,24064,22,501288587
1279,1437389,25949361,27386750,8,0,1,1536,1,7112851172
1280,1437620,8472729,9910349,20,2,0,30208,24,7127749310
1281,1438230,10371625,11809855,19,1,0,23552,5,3135807897
1282,1439441,7331753,8771194,34,3,0,8704,2,5540536011
1283,1440210,8320193,9760403,6,0,0,3072,24,3417742587
1284,1441580,9283582,10725162,23,2,0,38912,4,8312927685
1285,1443081,25943692,27386773,22,2,1,13824,10,1086334112
1286,1445260,9113395,10558655,29,2,0,19456,26,856418222
1287,1446700,10120913,11567613,24,2,0,13312,10,4416557406
1288,1448441,26121854,27570295,30,3,1,7680,3,1820078490
1289,1448931,26121387,27570318,7,0,1,3072,29,3633144082
1290,1451570,8797107,10248677,7,0,0,38912,29,8780663743
1291,1451930,11739850,13191780,23,2,0,56320,4,1200109055
1292,1452470,9407846,10860316,38,3,0,13824,26,9132319123
1293,1452570,9360637,10813207,36,3,0,5632,3,4236707834
1294,1454050,8053168,9507218,27,2,0,24064,9,186726436
1295,1456539,26113991,27570530,37,3,1,3584,15,3062263808
1296,1457670,8378928,9836598,22,2,0,4608,10,10421798174
1297,1457740,8643072,10100812,26,2,0,8192,29,7723438907
1298,1459060,26136808,27595868,12,1,1,8192,3,5606472648
1299,1461210,26142752,27603962,9,0,1,16384,12,2877761274
1300,1463891,9813898,11277789,33,3,0,6656,22,8027572566
1301,1464290,8634003,10098293,1,0,0,3584,26,2892055772
1302,1464490,9285116,10749606,12,1,0,11776,3,1050054020
1303,1466090,26166382,27632472,34,3,1,1536,2,268726534
1304,1466350,8978642,10444992,10,1,0,50176,4,8906995698
1305,1467230,8254027,9721257,23,2,0,12288,4,4590616896
1306,1467430,11840578,13308008,1,0,0,29184,26,3309596455
1307,1469960,26166305,27636265,33,3,1,7680,22,8929523079
1308,1471500,9054413,10525913,6,0,0,18432,24,7105752914
1309,1474400,11100102,12574502,22,2,0,15872,10,2373173261
1310,1474500,8528551,10003051,37,3,0,17408,15,5673097718
1311,1476140,26179700,27655840,6,0,1,5120,24,4670938950
1312,1477110,11847545,13324655,37,3,0,20480,15,6864647607
1313,1478140,7893654,9371794,39,3,0,1536,2,4432514512
1314,1479541,10721975,12201516,34,3,0,1024,2,9194302833
1315,1480050,11802465,13282515,19,1,0,56832,5,879287954
1316,1482160,11282940,12765100,24,2,0,49664,10,3913705480
1317,1482480,11971389,13453869,23,2,0,54272,4,3903669029
1318,1483059,26172804,27655863,23,2,1,1024,4,6527730734
1319,1483430,9063901,10547331,10,1,0,36864,4,6286334667
1320,1483910,8702049,10185959,29,2,0,8704,26,9089720838
1321,1484410,9104569,10588979,12,1,0,33280,3,6773509068
1322,1486130,8928663,10414793,37,3,0,14848,15,1519944782
1323,1486781,26173652,27660433,10,1,1,7168,4,1792882554
1324,1487010,9170648,10657658,8,0,0,23552,1,10432669325
1325,1488510,26176769,27665279,28,2,1,4096,24,3794008830
1326,1489860,9952256,11442116,3,0,0,10240,5,4627529564
1327,1493910,8618932,10112842,2,0,0,3584,3,2498228767
1328,1494371,8325021,9819392,9,0,0,26112,12,3863057788
1329,1494620,26192500,27687120,3,0,1,2048,5,4003490467
1330,1496350,10502942,11999292,4,0,0,103424,14,988587221
1331,1496440,10774610,12271050,3,0,0,16384,5,6498474586
1332,1497170,12168924,13666094,24,2,0,81920,10,8381995464
1333,1499580,10446152,11945732,8,0,0,3072,1,10498586168
1334,1500620,26186523,27687143,32,3,1,11264,17,4030105925
1335,1500680,12271152,13771832,24,2,0,54784,10,6227475773
1336,1501980,26367323,27869303,20,2,1,11264,24,3906317349
1337,1502230,26385191,27887421,0,0,1,3072,8,10262420193
1338,1502580,10876695,12379275,24,2,0,11776,10,6135793098
1339,1505000,10381942,11886942,23,2,0,31744,4,4323081504
1340,1505070,9867969,11373039,7,0,0,25088,29,4662869966
1341,1506080,11038934,12545014,4,0,0,5632,14,5271700248
1342,1506130,8810006,10316136,27,2,0,3072,9,3436168353
1343,1506220,11519369,13025589,23,2,0,56320,4,8100899538
1344,1507970,11777399,13285369,22,2,0,4096,10,4156805281
1345,1510999,26436650,27947649,5,0,1,11776,4,3879554892
1346,1512080,10669133,12181213,15,1,0,26112,19,7962098601
1347,1512540,12104402,13616942,36,3,0,81920,3,7226942464
1348,1512620,8769564,10282184,11,1,0,10752,6,9946624217
1349,1512900,9221193,10734093,2,0,0,29184,3,9624169587
1350,1513110,10499900,12013010,37,3,0,13824,15,10225842315
1351,1513510,11942418,13455928,11,1,0,6656,6,6653967776
1352,1514800,11922510,13437310,31,3,0,33792,27,2244479838
1353,1514920,9099134,10614054,13,1,0,13824,6,4467277288
1354,1518351,26429321,27947672,10,1,1,3584,4,6232370771
1355,1520390,10974772,12495162,10,1,0,46592,4,5669783919
1356,1523410,10794694,12318104,7,0,0,26624,29,2018531728
1357,1524020,8851409,10375429,36,3,0,6144,3,10293676252
1358,1524320,9518647,11042967,38,3,0,7680,26,8904705426
1359,1524760,10268646,11793406,7,0,0,512,29,3883340900
1360,1526520,10646714,12173234,24,2,0,17408,10,6213368872
1361,1527799,26542228,28070027,23,2,1,4608,4,5780914552
1362,1527870,26543463,28071333,13,1,1,2048,6,10689297639
1363,1527900,26595368,28123268,2,0,1,18944,3,7348488958
1364,1530400,11891568,13421968,39,3,0,5120,2,6113858911
1365,1531270,9038328,10569598,11,1,0,35840,6,6680405794
1366,1531510,10040338,11571848,7,0,0,13824,29,6950396103
1367,1532800,9531925,11064725,39,3,0,64512,2,5386850876
1368,1533940,11953037,13486977,28,2,0,21504,24,8847626818
1369,1536050,26661329,28197379,3,0,1,9216,5,10649830158
1370,1539730,11794152,13333882,29,2,0,30208,26,8795418189
1371,1540970,9712025,11252995,22,2,0,19456,10,7200488469
1372,1541400,9391229,10932629,10,1,0,53760,4,4826481108
1373,1542250,9821851,11364101,10,1,0,25600,4,7906146529
1374,1544870,26655095,28199965,2,0,1,4096,3,6807154085
1375,1545100,11061558,12606658,5,0,0,17408,4,5255125373
1376,1549090,10513617,12062707,36,3,0,14336,3,3132831820
1377,1550580,11960413,13510993,3,0,0,17408,5,3007051676
1378,1553260,12299775,13853035,3,0,0,4096,5,7063639111
1379,1554380,26647531,28201911,17,1,1,3072,28,8620966632
1380,1554520,8817944,10372464,26,2,0,8192,29,888558699
1381,1554830,8304971,9859801,23,2,0,1536,4,7492781713
1382,1555630,26646947,28202577,32,3,1,1024,17,4967037660
1383,1555991,9324200,10880191,34,3,0,8704,2,6549718998
1384,1557690,12533455,14091145,36,3,0,6144,3,9217066290
1385,1558350,12326280,13884630,31,3,0,35328,27,8106088972
1386,1559790,12415581,13975371,29,2,0,13312,26,3231631951
1387,1559909,26643334,28203243,8,0,1,1024,1,7682235728
1388,1560530,11212260,12772790,31,3,0,1024,27,7210971172
1389,1563045,11553580,13116625,14,1,0,17408,8,4823165169
1390,1563290,26642859,28206149,9,0,1,4608,12,5590797009
1391,1563340,11373428,12936768,28,2,0,32768,24,6821045818
1392,1563770,12402476,13966246,12,1,0,41984,3,694292069
1393,1563840,9221977,10785817,14,1,0,2560,8,8297604083
1394,1564540,10894003,12458543,38,3,0,29696,26,9832820923
1395,1565500,9694226,11259726,38,3,0,22016,26,2936255707
1396,1565630,12592781,14158411,1,0,0,1024,26,10402623043
1397,1567921,11645570,13213491,25,2,0,18432,4,7684190679
1398,1568980,11653733,13222713,5,0,0,20480,4,133705435
1399,1569099,26658110,28227209,18,1,1,1024,13,3633952756
1400,1570600,9850394,11420994,3,0,0,17408,5,329897889
1401,1571400,10925033,12496433,22,2,0,4096,10,9882344337
1402,1573010,12161882,13734892,12,1,0,2048,3,4318453928
1403,1573271,12907977,14481248,33,3,0,18432,22,1205622355
1404,1573430,26658605,28232035,35,3,1,7680,8,817314836
1405,1574560,26700564,28275124,13,1,1,6656,6,2119921375
1406,1574901,10324856,11899757,9,0,0,41984,12,4181478305
1407,1575890,11119878,12695768,27,2,0,49664,9,6986913697
1408,1577190,12655035,14232225,37,3,0,79872,15,6488891635
1409,1577230,10790588,12367818,22,2,0,16384,10,3981660782
1410,1577740,12626922,14204662,12,1,0,66048,3,1795023485
1411,1577970,9081739,10659709,19,1,0,6656,5,193873960
1412,1578240,11484595,13062835,37,3,0,2048,15,5966055800
1413,1581410,26697554,28278964,17,1,1,512,28,6743393361
1414,1582670,8889067,10471737,28,2,0,4608,24,6499426719
1415,1582749,26709263,28292012,11,1,1,5632,6,508611524
1416,1585950,11263189,12849139,23,2,0,43520,4,9345566896
1417,1587090,9944195,11531285,0,0,0,39424,8,634165344
1418,1587930,9526868,11114798,4,0,0,15872,14,2397975872
1419,1588270,11110220,12698490,15,1,0,8704,19,4247770984
1420,1589310,11323759,12913069,2,0,0,10240,3,7792347048
1421,1590731,26752322,28343053,10,1,1,3584,4,1074264521
1422,1591560,10376197,11967757,31,3,0,512,27,6749023467
1423,1591841,9384455,10976296,33,3,0,23552,22,9179082719
1424,1592700,12794262,14386962,15,1,0,45056,19,1559302461
1425,1597180,13032415,14629595,12,1,0,83968,3,6490050843
1426,1598130,10941428,12539558,8,0,0,42496,1,7146749022
1427,1598160,12815984,14414144,1,0,0,33792,26,9989167934
1428,1598670,9195572,10794242,31,3,0,5120,27,10661964283
1429,1600540,26747659,28348199,27,2,1,8192,9,7695423896
1430,1600800,26803940,28404740,39,3,1,17920,2,8588250019
1431,1601560,9693037,11294597,26,2,0,21504,29,7467168704
1432,1601980,12287087,13889067,30,3,0,2048,3,3868107703
1433,1603420,9373523,10976943,28,2,0,2048,24,6698341338
1434,1604320,26800443,28404763,34,3,1,11264,2,7069682205
1435,1605720,27044230,28649950,1,0,1,6656,26,1014434821
1436,1606770,11338741,12945511,0,0,0,9728,8,2405195194
1437,1607230,10648948,12256178,10,1,0,20992,4,9720130356
1438,1609431,12747144,14356575,34,3,0,29184,2,3760407465
1439,1612410,27201963,28814373,39,3,1,5632,2,8807285205
1440,1612720,8797518,10410238,7,0,0,12288,29,250814885
1441,1612940,27226541,28839481,35,3,1,4608,8,6433906799
1442,1614190,12954022,14568212,32,3,0,53248,17,5400962781
1443,1614330,9739741,11354071,29,2,0,60928,26,2546087190
1444,1617060,11063553,12680613,11,1,0,45056,6,4842021162
1445,1618670,27273304,28891974,28,2,1,512,24,10402545515
1446,1618760,11808223,13426983,31,3,0,16384,27,8465047239
1447,1622630,10703382,12326012,19,1,0,2048,5,4113067041
1448,1622761,10615357,12238118,9,0,0,2048,12,6302573855
1449,1623120,11458148,13081268,36,3,0,9728,3,4896004985
1450,1624330,9510092,11134422,10,1,0,7168,4,4889790067
1451,1624440,27308098,28932538,20,2,1,11264,24,6253602450
1452,1626850,27313222,28940072,32,3,1,5632,17,7899192923
1453,1629839,27310256,28940095,18,1,1,5632,13,2753801174
1454,1630259,27325022,28955281,23,2,1,10752,4,8173437266
1455,1631019,27324285,28955304,18,1,1,1024,13,9307598664
1456,1632660,11847742,13480402,5,0,0,31744,4,9805036280
1457,1633171,27322156,28955327,19,1,1,11264,5,9135349135
1458,1633431,10825291,12458722,9,0,0,512,12,5103611957
1459,1633700,27321650,28955350,6,0,1,3584,24,803557582
1460,1634080,11218381,12852461,14,1,0,10752,8,5793350012
1461,1634290,27321083,28955373,13,1,1,1024,6,4587663327
1462,1636130,9647142,11283272,7,0,0,17920,29,4988085778
1463,1637090,12966890,14603980,22,2,0,10240,10,8002796124
1464,1638270,12625646,14263916,23,2,0,103936,4,9828267381
1465,1639751,27316136,28955887,7,0,1,3072,29,305592517
1466,1640360,13068358,14708718,27,2,0,87040,9,3903838798
1467,1641000,9508870,11149870,14,1,0,9216,8,6627255081
1468,1641960,27313950,28955910,33,3,1,11776,22,1726118661
1469,1643580,12498310,14141890,30,3,0,56320,3,2254952343
1470,1644670,27350209,28994879,32,3,1,3584,17,1927229070
1471,1644681,27350221,28994902,30,3,1,3584,3,7512602680
1472,1647670,27354009,29001679,13,1,1,6144,6,9103241223
1473,1648441,9029457,10677898,25,2,0,1024,4,4139785879
1474,1648490,10727174,12375664,29,2,0,9728,26,1587337696
1475,1651230,11511020,13162250,38,3,0,42496,26,856432511
1476,1653080,9896634,11549714,12,1,0,2048,3,2993117264
1477,1653720,11321296,12975016,4,0,0,50176,14,4546438859
1478,1654610,13015734,14670344,14,1,0,6656,8,757593724
1479,1654810,10898631,12553441,29,2,0,13824,26,8054135279
1480,1655850,27361529,29017379,16,1,1,4608,10,8657204888
1481,1658370,10302072,11960442,31,3,0,38912,27,5250986440
1482,1659310,27465602,29124912,20,2,1,2048,24,6550364341
1483,1660890,9627132,11288022,1,0,0,6144,26,9143750467
1484,1661470,11424938,13086408,7,0,0,15360,29,6114128791
1485,1662850,27463325,29126175,2,0,1,6144,3,4603955749
1486,1663300,9377304,11040604,29,2,0,12800,26,6112346111
1487,1663350,9877809,11541159,38,3,0,29184,26,931378433
1488,1664390,9304707,10969097,8,0,0,7168,1,3130695916
1489,1664869,27509134,29174003,18,1,1,512,13,10349293981
1490,1665630,13252166,14917796,27,2,0,25088,9,9666064942
1491,1667080,9698292,11365372,26,2,0,4096,29,9668360177
1492,1668110,10080753,11748863,32,3,0,13312,17,483727295
1493,1669200,10811743,12480943,11,1,0,25600,6,2130641616
1494,1670930,27505019,29175949,27,2,1,3072,9,3379113029
1495,1670940,12747848,14418788,12,1,0,8704,3,5535661109
1496,1671440,11052992,12724432,28,2,0,45056,24,1493402998
1497,1672890,13573652,15246542,8,0,0,55808,1,1055783214
1498,1673200,11355243,13028443,32,3,0,2048,17,8964628788
1499,1673600,13180383,14853983,19,1,0,80896,5,1973742872
1500,1673950,27559419,29233369,9,0,1,12800,12,7958806417
1501,1675050,27558342,29233392,12,1,1,512,3,6326936393
1502,1675331,13396632,15071963,22,2,0,20480,10,7565699115
1503,1676780,13689048,15365828,38,3,0,68096,26,5639394045
1504,1677090,9886444,11563534,19,1,0,8192,5,5939775025
1505,1678410,27557292,29235702,20,2,1,20992,24,6603915819
1506,1678590,11815197,13493787,12,1,0,4096,3,7298498069
1507,1679240,11495357,13174597,10,1,0,40448,4,7072999323
1508,1681960,10179820,11861780,11,1,0,16896,6,7621824311
1509,1682590,10871654,12554244,10,1,0,2560,4,1300066094
1510,1683100,12787596,14470696,16,1,0,35840,10,175452848
1511,1684940,27639958,29324898,9,0,1,4608,12,615217578
1512,1685160,10041170,11726330,24,2,0,5120,10,1998359045
1513,1686540,11049326,12735866,24,2,0,37376,10,1337640752
1514,1686670,12125341,13812011,7,0,0,61952,29,5991179959
1515,1686940,27671937,29358877,9,0,1,9728,12,9105906465
1516,1688070,13495058,15183128,26,2,0,56832,29,2850478883
1517,1688110,27670790,29358900,36,3,1,7680,3,8672810561
1518,1688190,27742907,29431097,25,2,1,10240,4,8252474425
1519,1692190,13861276,15553466,20,2,0,69120,24,6581716322
1520,1695379,27735741,29431120,11,1,1,3072,6,9252647304
1521,1695960,27735183,29431143,1,0,1,4608,26,3834090329
1522,1696140,11098255,12794395,27,2,0,45568,9,1296206263
1523,1699890,27731276,29431166,0,0,1,13824,8,3329765828
1524,1700800,10964791,12665591,2,0,0,13824,3,9774839248
1525,1702880,13798468,15501348,15,1,0,20480,19,2492631631
1526,1704001,10393690,12097691,34,3,0,20992,2,6139314847
1527,1704540,13970504,15675044,24,2,0,13312,10,5666360419
1528,1704880,12374519,14079399,27,2,0,12288,9,293308770
1529,1706450,27803479,29509929,1,0,1,512,26,2904546477
1530,1709390,11063065,12772455,22,2,0,24064,10,1475700136
1531,1710370,12107771,13818141,4,0,0,19968,14,3500622796
1532,1711320,9890046,11601366,10,1,0,1536,4,9420122381
1533,1712410,10422358,12134768,3,0,0,2560,5,9050294520
1534,1714820,11569278,13284098,39,3,0,5120,2,1012644759
1535,1715710,9658600,11374310,8,0,0,4096,1,5983878765
1536,1716889,27795306,29512195,5,0,1,3584,4,10348151028
1537,1718530,14194939,15913469,8,0,0,81920,1,9703998000
1538,1722780,12909022,14631802,3,0,0,7168,5,4646428850
1539,1725800,10723672,12449472,20,2,0,13312,24,1052718362
1540,1725960,11897533,13623493,29,2,0,12288,26,9853884184
1541,1727210,11158088,12885298,20,2,0,14848,24,8233958854
1542,1727360,9869534,11596894,15,1,0,16384,19,8356983920
1543,1728500,10852265,12580765,7,0,0,20480,29,1720825926
1544,1730220,13032046,14762266,1,0,0,21504,26,4992725138
1545,1730640,12394067,14124707,22,2,0,43520,10,8211005130
1546,1730790,27821543,29552333,36,3,1,17408,3,1257723457
1547,1734041,10739079,12473120,34,3,0,35328,2,4562343388
1548,1737450,12233834,13971284,1,0,0,16384,26,2976920514
1549,1738220,27814779,29552999,28,2,1,1024,24,7016085852
1550,1738781,11241094,12979875,25,2,0,15872,4,10400858442
1551,1740050,11247648,12987698,37,3,0,25600,15,7532665047
1552,1740220,13155163,14895383,10,1,0,16384,4,4122795169
1553,1741300,10221372,11962672,8,0,0,4096,1,9150700809
1554,1741530,27815335,29556865,39,3,1,6144,2,2833085195
1555,1742060,13118567,14860627,29,2,0,20480,26,10550913877
1556,1742690,27818681,29561371,39,3,1,7168,2,1306536802
1557,1743910,10173844,11917754,1,0,0,23040,26,9515012177
1558,1746270,27817367,29563637,39,3,1,3584,2,6555399619
1559,1747300,10220262,11967562,32,3,0,14336,17,8020446386
1560,1747570,10055086,11802656,20,2,0,19968,24,6885323503
1561,1747760,11789079,13536839,11,1,0,71680,6,8511972245
1562,1749261,12124582,13873843,9,0,0,18944,12,7066584585
1563,1749441,27814862,29564303,10,1,1,11264,4,5583293731
1564,1750230,11295469,13045699,31,3,0,1536,27,9483347403
1565,1750260,12691604,14441864,11,1,0,5120,6,5309896550
1566,1750340,11447258,13197598,16,1,0,12288,10,2672202470
1567,1751850,27953125,29704975,25,2,1,23040,4,6085852629
1568,1753130,12611626,14364756,23,2,0,25088,4,4643813220
1569,1753961,27966192,29720153,21,2,1,2048,25,71987899
1570,1754420,27993895,29748315,25,2,1,11776,4,4165197296
1571,1755050,11665335,13420385,30,3,0,32768,3,1764511573
1572,1755130,11655248,13410378,6,0,0,17920,24,9110199755
1573,1755860,11707579,13463439,2,0,0,24576,3,3866718259
1574,1756210,27992128,29748338,20,2,1,512,24,6801094043
1575,1756960,14272178,16029138,29,2,0,30208,26,10543449924
1576,1757841,14678152,16435993,33,3,0,24576,22,1409102414
1577,1760900,14521038,16281938,38,3,0,13312,26,629268073
1578,1763170,12338217,14101387,12,1,0,17408,3,426836739
1579,1764540,11280668,13045208,5,0,0,46080,4,4157555191
1580,1764720,11638436,13403156,20,2,0,23040,24,1084392606
1581,1765010,13850505,15615515,28,2,0,60416,24,6294972495
1582,1765260,12834275,14599535,27,2,0,31232,9,8076269271
1583,1766930,11637965,13404895,26,2,0,5632,29,2295468664
1584,1767390,27980971,29748361,28,2,1,3072,24,9259350974
1585,1767960,11699870,13467830,31,3,0,14336,27,2946668932
1586,1768050,10523689,12291739,0,0,0,10240,8,8574634994
1587,1768181,27980203,29748384,26,2,1,7680,29,10169909763
1588,1770210,12866451,14636661,27,2,0,15872,9,5543577729
1589,1770750,12521049,14291799,38,3,0,16384,26,7933928910
1590,1770901,10726655,12497556,25,2,0,3584,4,3716013120
1591,1771421,14189903,15961324,33,3,0,3072,22,2754468433
1592,1772140,11907439,13679579,11,1,0,32768,6,932048709
1593,1773240,10439408,12212648,12,1,0,15360,3,3307812121
1594,1773540,11936247,13709787,38,3,0,13824,26,324600681
1595,1776380,11596154,13372534,5,0,0,1536,4,6861316951
1596,1776650,12565207,14341857,12,1,0,30720,3,3075743767
1597,1780061,28087386,29867447,22,2,1,18944,10,7813374707
1598,1781070,12040237,13821307,15,1,0,10240,19,1844696889
1599,1781280,10885582,12666862,12,1,0,4096,3,2723779960
1600,1782190,11329108,13111298,31,3,0,14848,27,10712458567
1601,1782390,11115304,12897694,6,0,0,5120,24,9319105478
1602,1785420,14079672,15865092,3,0,0,6656,5,6574475350
1603,1785833,13032613,14818446,4,0,0,59392,14,4741371103
1604,1786830,11419444,13206274,23,2,0,2560,4,2606404925
1605,1787550,14779909,16567459,0,0,0,60928,8,7769160046
1606,1788500,28108822,29897322,32,3,1,5632,17,2467656730
1607,1790099,28109489,29899588,18,1,1,3584,13,3428303020
1608,1790470,15005525,16795995,24,2,0,61440,10,1748170254
1609,1794321,11761174,13555495,33,3,0,22016,22,5120603732
1610,1794920,12775834,14570754,19,1,0,8192,5,6684812741
1611,1796350,13622720,15419070,29,2,0,11776,26,5771321522
1612,1797121,11914249,13711370,34,3,0,5120,2,3185239364
1613,1797340,14279291,16076631,29,2,0,43520,26,1036385617
1614,1800820,13308865,15109685,29,2,0,28160,26,4561998044
1615,1801200,12050073,13851273,29,2,0,31232,26,10585579787
1616,1802780,12589353,14392133,37,3,0,16896,15,10092325896
1617,1803960,12227811,14031771,28,2,0,33792,24,10199562316
1618,1804800,13908336,15713136,7,0,0,5632,29,5825917096
1619,1804980,11738278,13543258,23,2,0,20992,4,7254163388
1620,1805270,12036464,13841734,23,2,0,30720,4,7632107130
1621,1806200,12197420,14003620,23,2,0,12288,4,5180533101
1622,1807910,28129672,29937582,39,3,1,14336,2,7705361218
1623,1807961,13813551,15621512,25,2,0,3072,4,8785148576
1624,1809640,13461619,15271259,19,1,0,19968,5,7233164781
1625,1809690,28127915,29937605,36,3,1,1024,3,1383854327
1626,1809770,28127866,29937636,0,0,1,2048,8,6075162527
1627,1812300,12276950,14089250,28,2,0,32256,24,4852207165
1628,1814020,14410998,16225018,3,0,0,24576,5,8811393315
1629,1815671,28130814,29946485,31,3,1,7680,27,3262506676
1630,1817780,28128859,29946639,13,1,1,8704,6,1123794164
1631,1817820,13556010,15373830,7,0,0,12288,29,922252008
1632,1818630,14646606,16465236,7,0,0,54784,29,7098958887
1633,1819620,13455718,15275338,14,1,0,13312,8,2736785238
1634,1820960,11178500,12999460,15,1,0,15360,19,3019743434
1635,1823600,28123385,29946985,2,0,1,512,3,1418140663
1636,1823941,11203855,13027796,33,3,0,7168,22,628156802
1637,1824120,13691066,15515186,37,3,0,7680,15,10172238654
1638,1825801,12901550,14727351,34,3,0,3584,2,969762563
1639,1826571,28136050,29962621,31,3,1,512,27,7810175558
1640,1828820,10543857,12372677,16,1,0,15872,10,5369984721
1641,1828860,15183938,17012798,11,1,0,38912,6,6442268954
1642,1830391,13754346,15584737,34,3,0,43008,2,1591156470
1643,1830570,15123458,16954028,16,1,0,43008,10,5782593581
1644,1830710,28134817,29965527,12,1,1,4608,3,9652928856
1645,1831170,13825588,15656758,8,0,0,14336,1,9289477836
1646,1831180,11374291,13205471,16,1,0,9728,10,4255713163
1647,1832630,12325446,14158076,21,2,0,12288,25,8544488486
1648,1832760,12498599,14331359,6,0,0,57344,24,2080336008
1649,1832831,15248970,17081801,25,2,0,8192,4,277533301
1650,1833130,12959733,14792863,14,1,0,25600,8,5476010106
1651,1833791,12539412,14373203,11,1,0,27648,6,6553041564
1652,1834170,28145418,29979588,16,1,1,1536,10,9163433104
1653,1834370,14105829,15940199,6,0,0,26624,24,3482743704
1654,1835050,28146484,29981534,35,3,1,3072,8,3073463777
1655,1835090,11709751,13544841,38,3,0,5120,26,8110451539
1656,1835830,28176236,30012066,3,0,1,512,5,1130831408
1657,1836450,28192728,30029178,17,1,1,12800,28,2356942301
1658,1837710,13321808,15159518,10,1,0,32768,4,2374826599
1659,1837900,13200410,15038310,31,3,0,6656,27,8060182879
1660,1838000,28191201,30029201,29,2,1,1024,26,6573278127
1661,1838540,11255354,13093894,4,0,0,1536,14,10004165843
1662,1839860,10870821,12710681,23,2,0,39936,4,1769456846
1663,1840731,10811242,12651973,33,3,0,2048,22,9235669503
1664,1842491,10656336,12498827,34,3,0,4096,2,10037754131
1665,1844760,13434657,15279417,19,1,0,13312,5,6355454248
1666,1845260,13894271,15739531,8,0,0,13312,1,2945009658
1667,1847470,11346361,13193831,32,3,0,6656,17,2971608251
1668,1847550,14251807,16099357,36,3,0,11264,3,9777431291
1669,1849250,28310185,30159435,3,0,1,24576,5,8211059900
1670,1849630,13435894,15285524,28,2,0,19968,24,8779062645
1671,1851540,14011501,15863041,6,0,0,9216,24,5759547631
1672,1853171,15419332,17272503,33,3,0,28672,22,8774542928
1673,1853509,28324380,30177889,11,1,1,7168,6,8567642881
1674,1857310,12031110,13888420,30,3,0,11264,3,8699465877
1675,1857810,11847742,13705552,29,2,0,9216,26,4600017522
1676,1858630,14161281,16019911,5,0,0,109568,4,3662363426
1677,1859680,15583415,17443095,5,0,0,34304,4,3703590711
1678,1862260,11606396,13468656,23,2,0,2048,4,2304791508
1679,1862920,28314992,30177912,39,3,1,512,2,10225977448
1680,1863150,14836201,16699351,27,2,0,40448,9,6980703238
1681,1863270,13631815,15495085,5,0,0,28160,4,7748523544
1682,1864070,11628446,13492516,28,2,0,14336,24,2418623177
1683,1865240,14066816,15932056,28,2,0,60928,24,8382217763
1684,1865870,11604837,13470707,16,1,0,6656,10,801946086
1685,1866300,11693586,13559886,36,3,0,14336,3,1629574331
1686,1866779,28366986,30233765,4,0,1,15872,14,6443176270
1687,1867400,12150998,14018398,4,0,0,36864,14,1480213647
1688,1867600,12403717,14271317,11,1,0,512,6,7204143561
1689,1868040,13831550,15699590,32,3,0,10752,17,6406873399
1690,1868160,11119873,12988033,24,2,0,1024,10,7204018068
1691,1869440,12206192,14075632,24,2,0,16896,10,1461891205
1692,1870080,12879270,14749350,16,1,0,31744,10,6265484286
1693,1871190,12644101,14515291,36,3,0,18944,3,6447535724
1694,1874340,28359448,30233788,9,0,1,2560,12,3520945134
1695,1875840,28410714,30286554,39,3,1,5632,2,3564550416
1696,1877140,28410883,30288023,28,2,1,5120,24,7080978043
1697,1878090,14623187,16501277,0,0,0,5120,8,9747434812
1698,1878390,11988184,13866574,36,3,0,12288,3,4133880421
1699,1878500,28411789,30290289,28,2,1,3584,24,494282785
1700,1887700,28438939,30326639,33,3,1,12288,22,10196618553
1701,1889080,12423045,14312125,19,1,0,66048,5,3731695807
1702,1891610,14325897,16217507,6,0,0,1536,24,6425274876
1703,1892960,14417460,16310420,8,0,0,13824,1,3896238052
1704,1894740,28436725,30331465,36,3,1,7680,3,5032180073
1705,1894750,12313116,14207866,11,1,0,6144,6,8311650482
1706,1895250,12396728,14291978,27,2,0,512,9,8988030837
1707,1898480,11473563,13372043,19,1,0,69120,5,2586568866
1708,1899030,12387754,14286784,7,0,0,50688,29,3715331539
1709,1899980,14678391,16578371,10,1,0,4096,4,5192218427
1710,1903600,12583755,14487355,1,0,0,19968,26,3068670011
1711,1904110,12925202,14829312,10,1,0,10752,4,8106338587
1712,1904180,11795944,13700124,29,2,0,6656,26,2555718863
1713,1906630,11642134,13548764,36,3,0,12800,3,8329999795
1714,1906970,12533222,14440192,22,2,0,16384,10,5593125519
1715,1907440,28425101,30332541,36,3,1,13312,3,8787115906
1716,1907490,11722601,13630091,0,0,0,10752,8,393644543
1717,1907870,15776854,17684724,4,0,0,37888,14,4574341196
1718,1908370,15613837,17522207,11,1,0,52736,6,7707027824
1719,1908460,11440235,13348695,1,0,0,19456,26,1333155860
1720,1908910,11923441,13832351,2,0,0,32768,3,10435177660
1721,1909070,13615767,15524837,37,3,0,15360,15,8250042046
1722,1910821,28604569,30515390,7,0,1,512,29,890531581
1723,1912631,28722062,30634693,7,0,1,12800,29,1687690408
1724,1912710,12853479,14766189,2,0,0,12800,3,9921337227
1725,1913130,13476314,15389444,14,1,0,15872,8,5659970400
1726,1913420,14515062,16428482,24,2,0,92672,10,8869061276
1727,1913570,14635302,16548872,28,2,0,12800,24,10364290013
1728,1913690,11784383,13698073,6,0,0,6656,24,8036827541
1729,1915560,14428620,16344180,28,2,0,20480,24,1920557730
1730,1915910,28718806,30634716,2,0,1,8704,3,1768150947
1731,1916620,15024281,16940901,30,3,0,8192,3,8057902808
1732,1917110,12740130,14657240,6,0,0,29184,24,8671372099
1733,1917191,28771526,30688717,10,1,1,16384,4,5739886576
1734,1917550,12439360,14356910,11,1,0,1024,6,1444304715
1735,1917610,14948723,16866333,15,1,0,99328,19,2480203726
1736,1917930,28772375,30690305,25,2,1,15872,4,10366527483
1737,1918099,28839114,30757213,23,2,1,10240,4,5553976492
1738,1919530,14143818,16063348,23,2,0,36864,4,842351371
1739,1921830,15009192,16931022,2,0,0,7168,3,1899840831
1740,1922280,14674526,16596806,15,1,0,7680,19,1096464087
1741,1922851,28917606,30840457,21,2,1,22016,25,4194200709
1742,1923500,28916980,30840480,32,3,1,10240,17,35800807
1743,1928130,15779017,17707147,0,0,0,5120,8,9889831517
1744,1928310,11698482,13626792,23,2,0,10752,4,6189232168
1745,1928519,28924596,30853115,8,0,1,1024,1,1285219266
1746,1932230,12892658,14824888,24,2,0,15872,10,4342259010
1747,1932450,15858891,17791341,38,3,0,96768,26,7684142361
1748,1932940,11968558,13901498,6,0,0,6144,24,3027955908
1749,1933920,12613797,14547717,20,2,0,3584,24,6497918891
1750,1934820,15066099,17000919,26,2,0,9216,29,6193270244
1751,1939661,11912103,13851764,25,2,0,1536,4,6225941473
1752,1940680,11727621,13668301,8,0,0,7168,1,2866535586
1753,1942571,28913130,30855701,10,1,1,4096,4,7646313003
1754,1942650,12965316,14907966,12,1,0,5632,3,9352182561
1755,1943421,28915186,30858607,30,3,1,4608,3,9502484947
1756,1944421,13561006,15505427,34,3,0,13312,2,7888633958
1757,1944630,12909688,14854318,3,0,0,1024,5,10148968600
1758,1948101,12825861,14773962,25,2,0,6656,4,1839484710
1759,1948151,11519858,13468009,33,3,0,512,22,6459007601
1760,1948920,12641068,14589988,15,1,0,15872,19,8050177210
1761,1953230,11737431,13690661,3,0,0,2560,5,2110661930
1762,1954100,13698244,15652344,10,1,0,12800,4,6680260713
1763,1954740,12228375,14183115,20,2,0,29184,24,5231528798
1764,1957470,14119504,16076974,31,3,0,1024,27,4450621709
1765,1957760,12027772,13985532,27,2,0,5120,9,1882871744
1766,1957881,12081223,14039104,33,3,0,12800,22,2603425129
1767,1958370,14419275,16377645,6,0,0,41472,24,4275881009
1768,1959220,14291434,16250654,28,2,0,35328,24,7461442828
1769,1959580,13023490,14983070,5,0,0,16384,4,1753812833
1770,1962140,16167787,18129927,4,0,0,19968,14,10280035136
1771,1962530,11822517,13785047,19,1,0,33792,5,4905950080
1772,1962610,28987017,30949627,34,3,1,6144,2,6966766613
1773,1963339,28987604,30950943,5,0,1,6144,4,8692402928
1774,1963840,11705732,13669572,11,1,0,4096,6,7272907971
1775,1964620,11934983,13899603,8,0,0,18432,1,7087474827
1776,1965120,14483401,16448521,39,3,0,24064,2,3575089042
1777,1968600,12757636,14726236,6,0,0,38400,24,9617130629
1778,1971470,13424549,15396019,38,3,0,21504,26,8230123002
1779,1972980,28983109,30956089,35,3,1,8192,8,1388231967
1780,1973369,29151381,31124750,5,0,1,4096,4,2633252445
1781,1976220,11972245,13948465,28,2,0,5632,24,10705628681
1782,1978040,14488935,16466975,4,0,0,5632,14,10118938437
1783,1979180,11703550,13682730,2,0,0,10240,3,133743083
1784,1979370,29146366,31125736,13,1,1,1536,6,1124409050
1785,1985230,15049321,17034551,32,3,0,17920,17,10073138076
1786,1988681,13084397,15073078,33,3,0,3584,22,6024377967
1787,1989100,14991603,16980703,20,2,0,24064,24,1002277170
1788,1991190,12365899,14357089,39,3,0,512,2,4409559615
1789,1991850,29136472,31128322,16,1,1,4096,10,873071747
1790,1993540,13470202,15463742,36,3,0,31744,3,5312576850
1791,1997100,12350552,14347652,39,3,0,18944,2,2433861015
1792,1997350,12505792,14503142,12,1,0,7168,3,177497150
1793,1999230,15106764,17105994,15,1,0,10240,19,10038571929
1794,1999680,13149831,15149511,2,0,0,95232,3,4718928494
1795,2001700,15261374,17263074,1,0,0,49664,26,9176275624
1796,2003260,14628588,16631848,27,2,0,39424,9,3959409423
1797,2004780,11880185,13884965,27,2,0,1024,9,6954181852
1798,2005130,16230082,18235212,14,1,0,29696,8,8860485231
1799,2005770,29126444,31132214,14,1,1,6144,8,3502580857
1800,2006121,11815833,13821954,33,3,0,2048,22,452997094
1801,2006390,13195703,15202093,24,2,0,11776,10,9515923337
1802,2007080,12325394,14332474,2,0,0,3584,3,7624730489
1803,2008260,12776780,14785040,29,2,0,26624,26,386208816
1804,2009911,29392421,31402332,38,3,1,24064,26,2332653144
1805,2010520,13586564,15597084,10,1,0,40448,4,9243848558
1806,2012509,29510115,31522624,5,0,1,26624,4,6596015454
1807,2015720,15336743,17352463,8,0,0,25088,1,1979834663
1808,2016480,12568649,14585129,0,0,0,47104,8,4584697276
1809,2017630,13602923,15620553,5,0,0,1536,4,4524718116
1810,2018720,15324400,17343120,32,3,0,13824,17,4014351546
1811,2020110,12526492,14546602,27,2,0,67072,9,2976020641
1812,2020600,13099872,15120472,30,3,0,35328,3,180917384
1813,2020610,29775724,31796334,39,3,1,12800,2,3655082972
1814,2022060,29954678,31976738,14,1,1,2048,8,9791754233
1815,2025950,15399003,17424953,30,3,0,58368,3,3871876699
1816,2029060,12023015,14052075,10,1,0,42496,4,3338763947
1817,2030921,29979114,32010035,22,2,1,8192,10,8168896878
1818,2032059,12033668,14065727,17,1,0,11264,28,4744610789
1819,2033790,12625189,14658979,29,2,0,5632,26,1354140510
1820,2034010,29976056,32010066,35,3,1,4608,8,3256198317
1821,2035820,13444369,15480189,39,3,0,13824,2,10559547526
1822,2037890,12562924,14600814,38,3,0,4096,26,2567579065
1823,2038700,14051337,16090037,10,1,0,5632,4,6454106227
1824,2040219,29970361,32010580,8,0,1,2048,1,1145123252
1825,2040451,13908191,15948642,33,3,0,6144,22,7264605617
1826,2040810,12621156,14661966,14,1,0,9728,8,3773914492
1827,2042920,12227259,14270179,6,0,0,20480,24,4458235603
1828,2043801,16321761,18365562,33,3,0,2048,22,7627696486
1829,2043940,12620233,14664173,1,0,0,7168,26,8246416856
1830,2046180,12385512,14431692,36,3,0,26624,3,7943218383
1831,2046440,12224698,14271138,36,3,0,3072,3,4961231830
1832,2047049,29963554,32010603,5,0,1,1536,4,10029095119
1833,2047290,12981926,15029216,11,1,0,34304,6,7110751018
1834,2048640,12771389,14820029,11,1,0,5120,6,8079646859
1835,2048990,29961644,32010634,0,0,1,6656,8,53231210
1836,2050080,14239205,16289285,0,0,0,5120,8,1132231451
1837,2052690,30092761,32145451,13,1,1,31232,6,10678323100
1838,2053100,12471957,14525057,10,1,0,17408,4,7756374241
1839,2053160,12629015,14682175,23,2,0,19968,4,3693324937
1840,2053189,30111299,32164488,23,2,1,2048,4,4634444429
1841,2053310,13211842,15265152,29,2,0,29696,26,39817328
1842,2054721,30109790,32164511,7,0,1,3584,29,10209841295
1843,2055650,15067428,17123078,0,0,0,4096,8,8375403222
1844,2056180,13127953,15184133,2,0,0,3072,3,8647110728
1845,2060590,30103944,32164534,35,3,1,6656,8,10271109549
1846,2061180,15387554,17448734,6,0,0,18432,24,5056070787
1847,2061470,30103087,32164557,20,2,1,16896,24,4768082192
1848,2062240,12889419,14951659,11,1,0,19968,6,10058368368
1849,2064550,12249314,14313864,6,0,0,5632,24,3049490187
1850,2066121,30190570,32256691,22,2,1,16896,10,6798766689
1851,2066360,13303703,15370063,1,0,0,13824,26,9178398898
1852,2066560,12666898,14733458,6,0,0,19968,24,10628514481
1853,2067450,30189264,32256714,29,2,1,9216,26,1414990741
1854,2067570,30189167,32256737,34,3,1,1024,2,2656804205
1855,2067911,30188849,32256760,21,2,1,512,25,5211906237
1856,2069801,12666340,14736141,9,0,0,8704,12,4576312641
1857,2070760,30205652,32276412,14,1,1,36352,8,9236230221
1858,2071039,30253940,32324979,8,0,1,3584,1,3223862483
1859,2076141,13179940,15256081,25,2,0,31232,4,4983330139
1860,2078000,12812368,14890368,22,2,0,27136,10,9388328415
1861,2079151,14282272,16361423,25,2,0,18944,4,2697081883
1862,2079721,14635917,16715638,25,2,0,15872,4,6293203251
1863,2082510,15209916,17292426,12,1,0,19968,3,5834844304
1864,2084090,12787237,14871327,36,3,0,25088,3,532996485
1865,2084770,30240232,32325002,9,0,1,2560,12,10579777472
1866,2085080,13803406,15888486,7,0,0,50688,29,9082499157
1867,2085520,13749818,15835338,22,2,0,17408,10,9233212316
1868,2085650,12879826,14965476,24,2,0,11776,10,3539247392
1869,2085870,12849820,14935690,6,0,0,8704,24,10414360743
1870,2086330,14180415,16266745,39,3,0,52736,2,1900917095
1871,2087860,15463925,17551785,38,3,0,24576,26,4982327077
1872,2089550,12976150,15065700,5,0,0,60928,4,4936379280
1873,2090050,12836846,14926896,32,3,0,20992,17,1492497392
1874,2090780,13246036,15336816,24,2,0,1024,10,8656367653
1875,2092240,30232785,32325025,17,1,1,3072,28,8160950123
1876,2095610,12675613,14771223,36,3,0,6144,3,3447426508
1877,2095840,15572591,17668431,2,0,0,129024,3,10590342510
1878,2100880,12979384,15080264,1,0,0,1536,26,2085871989
1879,2101030,12613483,14714513,4,0,0,18944,14,1272379375
1880,2103570,12997512,15101082,39,3,0,32256,2,7598100210
1881,2103980,14575513,16679493,23,2,0,53248,4,4260779880
1882,2105890,30219158,32325048,33,3,1,16384,22,2216682868
1883,2107660,13944433,16052093,14,1,0,75264,8,3346746412
1884,2108710,30395879,32504589,36,3,1,1024,3,7608905074
1885,2109480,30395132,32504612,36,3,1,5632,3,6289507902
1886,2111070,15613314,17724384,12,1,0,3584,3,5568245563
1887,2113690,14915378,17029068,1,0,0,51200,26,6532609271
1888,2113760,30390875,32504635,13,1,1,5632,6,8877767236
1889,2114730,15856240,17970970,28,2,0,229376,24,536961148
1890,2116440,14277889,16394329,38,3,0,41472,26,6375340265
1891,2116480,15089956,17206436,5,0,0,19456,4,9383419580
1892,2116510,15074259,17190769,39,3,0,9728,2,6813325632
1893,2118580,15501997,17620577,24,2,0,62976,10,5761322152
1894,2124350,15255230,17379580,39,3,0,11264,2,6136370491
1895,2124961,30491384,32616345,22,2,1,5120,10,6897686898
1896,2127150,13498753,15625903,12,1,0,14336,3,5528859588
1897,2127270,13849137,15976407,14,1,0,10752,8,1943913593
1898,2130870,30485498,32616368,29,2,1,4096,26,3808653024
1899,2131289,30485102,32616391,37,3,1,4608,15,3958432109
1900,2132641,15618176,17750817,34,3,0,64000,2,9132842627
1901,2133110,13430963,15564073,8,0,0,25600,1,480848366
1902,2134780,13723126,15857906,26,2,0,17920,29,8115971127
1903,2135440,13285442,15420882,27,2,0,3584,9,6448583468
1904,2138660,30479082,32617742,32,3,1,15872,17,3855311000
1905,2138850,16336251,18475101,23,2,0,5120,4,8324252259
1906,2142660,14084409,16227069,19,1,0,6656,5,9839822358
1907,2143890,12719770,14863660,15,1,0,9728,19,7568787139
1908,2145581,30599702,32745283,21,2,1,512,25,6967472619
1909,2145750,15856144,18001894,7,0,0,10752,29,3850011195
1910,2146410,31147573,33293983,36,3,1,129024,3,3861035864
1911,2147111,12889148,15036259,9,0,0,23040,12,6151214824
1912,2148330,14370126,16518456,15,1,0,25600,19,6095846290
1913,2148360,13480218,15628578,16,1,0,8704,10,3433276768
1914,2148690,14780056,16928746,30,3,0,15872,3,7991222020
1915,2148991,15523519,17672510,25,2,0,13312,4,337694247
1916,2150850,15426736,17577586,1,0,0,10752,26,6165558768
1917,2153279,31225615,33378894,23,2,1,5632,4,7363032426
1918,2155740,13804625,15960365,30,3,0,38400,3,6800217294
1919,2156480,31224040,33380520,39,3,1,2560,2,9764617599
1920,2156650,31227096,33383746,16,1,1,5120,10,8466652719
1921,2157700,14341994,16499694,1,0,0,1024,26,1182272062
1922,2158300,13694123,15852423,12,1,0,4608,3,4373387266
1923,2159520,15639644,17799164,23,2,0,25600,4,1690476232
1924,2162501,31240024,33402525,26,2,1,512,29,2347208811
1925,2164360,15541204,17705564,5,0,0,35328,4,8444887749
1926,2164680,13483733,15648413,11,1,0,65024,6,6199945889
1927,2165290,13988708,16153998,32,3,0,22528,17,3084852356
1928,2166930,14577329,16744259,7,0,0,9728,29,2518547045
1929,2167990,31234558,33402548,0,0,1,512,8,3847422761
1930,2168090,15973404,18141494,26,2,0,37888,29,1045744317
1931,2170431,13776251,15946682,25,2,0,17920,4,7560867672
1932,2171360,16072611,18243971,7,0,0,28672,29,9388392180
1933,2171480,13524292,15695772,7,0,0,4096,29,566803903
1934,2174380,16382621,18557001,29,2,0,34304,26,8507109982
1935,2175091,31237027,33412118,10,1,1,7680,4,5222842787
1936,2175800,14458255,16634055,37,3,0,7168,15,74213545
1937,2175950,13113676,15289626,26,2,0,4608,29,4421477708
1938,2176800,13111399,15288199,14,1,0,8704,8,217454768
1939,2180229,31231912,33412141,15,1,1,2048,19,3639133465
1940,2183490,15815097,17998587,27,2,0,9216,9,5612074163
1941,2184100,16419514,18603614,6,0,0,15360,24,2741915505
1942,2184420,13901827,16086247,8,0,0,15360,1,60643606
1943,2184960,14556312,16741272,8,0,0,64000,1,6303372180
1944,2185890,14863551,17049441,19,1,0,43520,5,167004957
1945,2185950,13894791,16080741,32,3,0,12288,17,2760846683
1946,2186749,13211562,15398311,17,1,0,7168,28,7370952836
1947,2187819,31224345,33412164,4,0,1,8192,14,2482389237
1948,2188030,31233729,33421759,9,0,1,3584,12,7949617382
1949,2188890,13472571,15661461,15,1,0,15360,19,8950251765
1950,2190960,13649667,15840627,5,0,0,11264,4,3158674924
1951,2193051,14079356,16272407,9,0,0,16896,12,6595023494
1952,2193250,14023766,16217016,19,1,0,24064,5,4296247039
1953,2194020,13256154,15450174,4,0,0,8704,14,2797652200
1954,2194470,14729348,16923818,12,1,0,92672,3,1067564013
1955,2195280,16154316,18349596,30,3,0,63488,3,5056287779
1956,2195310,14032258,16227568,37,3,0,1536,15,8213944100
1957,2195651,16071053,18266704,34,3,0,6144,2,4027987158
1958,2195900,13918292,16114192,32,3,0,4096,17,3971874491
1959,2196351,14372231,16568582,9,0,0,3584,12,4661036136
1960,2196390,14639656,16836046,26,2,0,3584,29,5231318044
1961,2196560,14128393,16324953,29,2,0,39936,26,5467083250
1962,2197400,13890898,16088298,15,1,0,6656,19,9748584071
1963,2197721,13946990,16144711,34,3,0,12800,2,8291631569
1964,2197920,14765358,16963278,37,3,0,25088,15,5488051801
1965,2198260,13254121,15452381,27,2,0,7168,9,1106260942
1966,2198871,15619706,17818577,9,0,0,49152,12,7563653392
1967,2198990,15854504,18053494,15,1,0,18432,19,157100371
1968,2199070,13999074,16198144,36,3,0,13824,3,357099946
1969,2201060,13590143,15791203,30,3,0,26624,3,6470074056
1970,2201460,15162639,17364099,4,0,0,512,14,60633633
1971,2202301,14064935,16267236,34,3,0,1536,2,3388607004
1972,2202830,14770518,16973348,12,1,0,6656,3,10246430136
1973,2204300,16292684,18496984,31,3,0,7168,27,8122405600
1974,2205010,15800027,18005037,37,3,0,10240,15,10625268488
1975,2205110,13414952,15620062,38,3,0,14848,26,4219969278
1976,2206221,14002013,16208234,25,2,0,18432,4,2718625871
1977,2206820,31239396,33446216,32,3,1,1536,17,178985040
1978,2208660,13967082,16175742,6,0,0,8192,24,5353484194
1979,2208790,15773325,17982115,2,0,0,9728,3,2942999369
1980,2209131,31239671,33448802,31,3,1,4096,27,1549422023
1981,2209300,14853029,17062329,36,3,0,4608,3,1505317225
1982,2209391,31239757,33449148,30,3,1,512,3,2363619415
1983,2209650,14388739,16598389,16,1,0,5120,10,4579025329
1984,2209960,14787169,16997129,32,3,0,30208,17,7691258999
1985,2210330,16536013,18746343,35,3,0,39936,8,9915743855
1986,2213120,16609142,18822262,0,0,0,151040,8,10539433774
1987,2213650,16682735,18896385,4,0,0,32256,14,5608140901
1988,2216181,31233313,33449494,21,2,1,512,25,5706288033
1989,2216520,14672612,16889132,4,0,0,74752,14,3683286228
1990,2218510,15608834,17827344,19,1,0,28672,5,6025218314
1991,2218850,14323690,16542540,27,2,0,10240,9,5050057480
1992,2219730,31231710,33451440,14,1,1,3072,8,1677489572
1993,2219950,14177366,16397316,31,3,0,9728,27,10487293423
1994,2220110,14134857,16354967,11,1,0,17920,6,773517575
1995,2221080,14465924,16687004,37,3,0,24576,15,4495930753
1996,2221330,13988331,16209661,22,2,0,4608,10,1815559652
1997,2221340,13948703,16170043,23,2,0,10240,4,33554415
1998,2221490,15141292,17362782,22,2,0,33792,10,6117462528
1999,2222060,15608739,17830799,3,0,0,11264,5,3543770921
2000,2224670,13715708,15940378,36,3,0,512,3,1514959709
2001,2225290,14670269,16895559,32,3,0,20992,17,10459790463
2002,2226030,16649620,18875650,29,2,0,40448,26,4741516540
2003,2226540,14588689,16815229,37,3,0,61952,15,8637362043
2004,2227350,31224436,33451786,34,3,1,512,2,2968851240
2005,2227630,16632054,18859684,8,0,0,41472,1,8825895604
2006,2228020,14759882,16987902,8,0,0,23552,1,8877133888
2007,2228580,16838470,19067050,4,0,0,4096,14,4409433211
2008,2228620,31223832,33452452,2,0,1,1024,3,87141188
2009,2229740,14849542,17079282,14,1,0,13312,8,8509862045
2010,2230940,14147352,16378292,32,3,0,2048,17,1414005204
2011,2231070,14920842,17151912,1,0,0,33792,26,10684106160
2012,2231610,14098286,16329896,38,3,0,7168,26,10213910751
2013,2232510,16086620,18319130,27,2,0,10240,9,1327239487
2014,2233090,14266269,16499359,24,2,0,27136,10,575567108
2015,2233150,31222208,33455358,34,3,1,4608,2,6309302574
2016,2234230,16915260,19149490,5,0,0,16384,4,10409914231
2017,2237060,14837721,17074781,15,1,0,20480,19,2416848175
2018,2237690,14700045,16937735,37,3,0,16384,15,4496125315
2019,2238790,17100911,19339701,2,0,0,40960,3,8418230859
2020,2240740,15161084,17401824,6,0,0,12800,24,179184751
2021,2241580,31214764,33456344,14,1,1,1536,8,3654701602
2022,2242140,14297257,16539397,0,0,0,3584,8,8761027021
2023,2243270,31235489,33478759,3,0,1,7168,5,2540317687
2024,2245060,13836484,16081544,31,3,0,2560,27,903190538
2025,2245709,31368985,33614694,23,2,1,18432,4,9922038571
2026,2247330,16813723,19061053,29,2,0,32768,26,1593926372
2027,2247370,16169148,18416518,3,0,0,50688,5,9380844875
2028,2247700,31435838,33683538,27,2,1,10240,9,2603857484
2029,2248770,14328330,16577100,35,3,0,12288,8,1988641903
2030,2249640,16115267,18364907,38,3,0,50176,26,3200858849
2031,2249760,15024638,17274398,0,0,0,6144,8,6925995899
2032,2250410,15132382,17382792,27,2,0,512,9,118446442
2033,2251110,14964295,17215405,1,0,0,512,26,9959237561
2034,2254911,15719514,17974425,34,3,0,11264,2,5684916490
2035,2255160,14385742,16640902,22,2,0,10752,10,4308840437
2036,2255560,31428001,33683561,3,0,1,2560,5,4647394747
2037,2256470,14184696,16441166,5,0,0,13312,4,9478864868
2038,2256510,17223927,19480437,8,0,0,1536,1,9506724459
2039,2257630,16837962,19095592,26,2,0,7680,29,10139098102
2040,2260120,31549470,33809590,39,3,1,14848,2,9945141158
2041,2260471,14448985,16709456,33,3,0,13312,22,10498006749
2042,2261920,17171112,19433032,23,2,0,15360,4,8078247501
2043,2262330,16284196,18546526,22,2,0,10240,10,48465484
2044,2262951,16231826,18494777,33,3,0,25600,22,4317343738
2045,2263630,16159018,18422648,21,2,0,14848,25,5580147739
2046,2264760,14372796,16637556,4,0,0,11264,14,1633739979
2047,2265520,15070952,17336472,37,3,0,37376,15,10712379567
2048,2265590,14396057,16661647,10,1,0,25600,4,4340991900
2049,2265810,16974008,19239818,6,0,0,43008,24,2800747478
2050,2266440,14314606,16581046,0,0,0,8704,8,2860072899
2051,2268850,14686761,16955611,10,1,0,5120,4,6393028146
2052,2269470,14766680,17036150,15,1,0,5120,19,734724585
2053,2270160,15066982,17337142,21,2,0,2048,25,505304235
2054,2271050,31538563,33809613,29,2,1,2560,26,1960624954
2055,2271250,15321611,17592861,15,1,0,7168,19,8205340008
2056,2271390,16460723,18732113,8,0,0,15872,1,7783497004
2057,2271900,15210866,17482766,11,1,0,11264,6,1102655868
2058,2273000,15458294,17731294,32,3,0,11776,17,9851244018
2059,2274390,14696899,16971289,22,2,0,26112,10,65779099
2060,2274699,31534937,33809636,37,3,1,1024,15,5522532766
2061,2274879,31680900,33955779,4,0,1,16384,14,7536607979
2062,2275930,15007264,17283194,24,2,0,3072,10,9248865786
2063,2276700,14655928,16932628,8,0,0,5120,1,5630576546
2064,2277060,14736385,17013445,35,3,0,2048,8,10272241403
2065,2277520,14547248,16824768,21,2,0,31232,25,7516235770
2066,2280040,31792859,34072899,29,2,1,3072,26,549550186
2067,2281010,14553921,16834931,39,3,0,33280,2,5619429065
2068,2281890,16136211,18418101,6,0,0,5120,24,5972194452
2069,2281940,16563814,18845754,14,1,0,33280,8,6949841164
2070,2282400,14513930,16796330,6,0,0,1024,24,471121514
2071,2283000,16997104,19280104,16,1,0,1024,10,5714157797
2072,2283121,15222995,17506116,34,3,0,37376,2,6142126708
2073,2283630,15088416,17372046,4,0,0,16896,14,4756992698
2074,2283800,15617259,17901059,21,2,0,2048,25,760251753
2075,2284590,14713498,16998088,20,2,0,3072,24,10490553383
2076,2285430,16229752,18515182,31,3,0,8192,27,6038408244
2077,2286210,17324697,19610907,14,1,0,40448,8,5284511862
2078,2286370,15096243,17382613,31,3,0,2560,27,10093400419
2079,2286560,15276480,17563040,10,1,0,36864,4,1284319369
2080,2287740,15562137,17849877,38,3,0,55296,26,2401204608
2081,2288690,15406087,17694777,21,2,0,32768,25,5080820081
2082,2289370,31871303,34160673,12,1,1,512,3,9750533185
2083,2289900,15610512,17900412,8,0,0,52736,1,3857124011
2084,2292450,15186861,17479311,36,3,0,38912,3,406180644
2085,2294381,16583788,18878169,33,3,0,8192,22,7331505566
2086,2294700,15081425,17376125,36,3,0,13312,3,6592541278
2087,2296950,31863877,34160827,16,1,1,8704,10,4936725746
2088,2297180,16699445,18996625,26,2,0,26112,29,1976381041
2089,2298130,17445452,19743582,0,0,0,6656,8,4404575354
2090,2299920,14915306,17215226,22,2,0,4608,10,6911560898
2091,2303500,15263151,17566651,19,1,0,11776,5,9505024467
2092,2304250,15718172,18022422,4,0,0,23552,14,2933951204
2093,2304290,15264814,17569104,30,3,0,7168,3,9815377057
2094,2304980,14633402,16938382,21,2,0,2048,25,4256923448
2095,2305709,31862266,34167975,11,1,1,8192,6,8481077574
2096,2305860,16024369,18330229,28,2,0,36352,24,7129586817
2097,2307620,31895079,34202699,1,0,1,6656,26,5425303711
2098,2307639,31968594,34276233,15,1,1,4096,19,9377509983
2099,2310301,31970118,34280419,30,3,1,6656,3,6063514622
2100,2312000,16322552,18634552,39,3,0,5632,2,730832203
2101,2312440,15548396,17860836,20,2,0,35840,24,2989965652
2102,2312720,15119900,17432620,2,0,0,25088,3,2819027618
2103,2314640,16606283,18920923,14,1,0,50688,8,3036647901
2104,2315080,32307451,34622531,27,2,1,36864,9,8244323747
2105,2315700,17578798,19894498,35,3,0,22528,8,3881636674
2106,2316371,16734675,19051046,9,0,0,78848,12,5783743277
2107,2317960,15672781,17990741,29,2,0,4096,26,5665444536
2108,2318139,32404849,34722988,18,1,1,16896,13,8772544008
2109,2318220,15543598,17861818,5,0,0,1024,4,6024999860
2110,2318640,16957992,19276632,26,2,0,7168,29,10213438256
2111,2320190,14943554,17263744,10,1,0,2048,4,7190027217
2112,2321650,14909164,17230814,15,1,0,2560,19,1900344552
2113,2322520,14736572,17059092,22,2,0,2560,10,595226621
2114,2322550,16805975,19128525,7,0,0,55808,29,6791618886
2115,2322680,15059130,17381810,24,2,0,512,10,4435074769
2116,2323131,32399880,34723011,30,3,1,1024,3,7953111167
2117,2323878,14889913,17213791,31,3,0,24064,27,1889231084
2118,2324910,15348247,17673157,20,2,0,2048,24,3356833873
2119,2325040,15753575,18078615,7,0,0,17920,29,1882320982
2120,2325170,17363381,19688551,26,2,0,34304,29,4750435541
2121,2326030,15746946,18072976,14,1,0,1536,8,2216403855
2122,2327270,32395772,34723042,27,2,1,2560,9,6140546762
2123,2327840,15423796,17751636,12,1,0,2560,3,9247525009
2124,2329530,15271836,17601366,19,1,0,12288,5,10056356090
2125,2329560,15780034,18109594,32,3,0,10752,17,1809355111
2126,2329670,15718185,18047855,6,0,0,4608,24,8835914913
2127,2329900,15121220,17451120,19,1,0,7168,5,3399863540
2128,2330850,32392215,34723065,27,2,1,1024,9,1852002052
2129,2330900,18303511,20634411,29,2,0,28160,26,5212381262
2130,2332420,14833490,17165910,5,0,0,9216,4,4535895561
2131,2332510,17058912,19391422,27,2,0,17408,9,3243783102
2132,2334950,32388138,34723088,13,1,1,1536,6,2771114849
2133,2335460,17721052,20056512,22,2,0,22016,10,8575699562
2134,2338150,32384961,34723111,6,0,1,1536,24,3077186968
2135,2339120,15194030,17533150,6,0,0,35840,24,5493595659
2136,2339140,32383994,34723134,0,0,1,512,8,3001705671
2137,2340260,16435959,18776219,27,2,0,6144,9,1061794444
2138,2342680,15822593,18165273,6,0,0,9216,24,9520143857
2139,2342970,15038661,17381631,0,0,0,6656,8,10108315888
2140,2343730,15379531,17723261,21,2,0,30208,25,9589366806
2141,2344240,16357678,18701918,19,1,0,46592,5,6266032269
2142,2344791,15062355,17407146,34,3,0,12288,2,4057754381
2143,2345071,17984768,20329839,25,2,0,13824,4,2159165273
2144,2345600,17147372,19492972,29,2,0,13312,26,4835581142
2145,2345911,15880230,18226141,9,0,0,71168,12,5418340906
2146,2348521,17228217,19576738,33,3,0,32256,22,4160964791
2147,2350210,15628918,17979128,21,2,0,15360,25,405859395
2148,2350401,32372756,34723157,26,2,1,7680,29,6611844302
2149,2350431,32466711,34817142,10,1,1,1536,4,255321879
2150,2351000,15182329,17533329,21,2,0,512,25,2907912518
2151,2352391,32465417,34817808,19,1,1,1024,5,8603904376
2152,2353329,32465043,34818372,37,3,1,10752,15,7796299174
2153,2354000,16105391,18459391,35,3,0,49152,8,5861815202
2154,2362890,32501001,34863891,9,0,1,8192,12,7729608740
2155,2363941,32523822,34887763,21,2,1,8192,25,10596858296
2156,2364610,15778155,18142765,14,1,0,4096,8,8056723593
2157,2364940,15803031,18167971,24,2,0,2048,10,1794094853
2158,2365021,16843216,19208237,25,2,0,158720,4,10362682749
2159,2365090,15630666,17995756,23,2,0,16384,4,9101182137
2160,2368250,15621220,17989470,36,3,0,24064,3,5872139612
2161,2370940,32541234,34912174,29,2,1,2048,26,9231819529
2162,2371050,15461956,17833006,31,3,0,7168,27,9654118225
2163,2374150,15487333,17861483,0,0,0,2048,8,1610271448
2164,2375520,15631412,18006932,21,2,0,6144,25,8606290771
2165,2375690,32645991,35021681,1,0,1,8704,26,1306822026
2166,2376360,16457180,18833540,3,0,0,16384,5,4506870771
2167,2376390,33622931,35999321,36,3,1,223232,3,7624923502
2168,2377150,15071763,17448913,2,0,0,512,3,4943085859
2169,2378120,33650602,36028722,0,0,1,1024,8,5586274423
2170,2381280,33665494,36046774,12,1,1,1536,3,10008514061
2171,2382210,33664587,36046797,32,3,1,18432,17,9323842986
2172,2382321,18789324,21171645,34,3,0,23040,2,518145635
2173,2382390,16606256,18988646,31,3,0,40960,27,6689391785
2174,2385120,17152296,19537416,21,2,0,8704,25,230806192
2175,2385220,16273320,18658540,1,0,0,24576,26,2677725905
2176,2386329,33670521,36056850,8,0,1,512,1,8345019868
2177,2387430,16475873,18863303,3,0,0,11776,5,8621202888
2178,2388600,17263470,19652070,10,1,0,15872,4,6500145565
2179,2389410,17390995,19780405,22,2,0,27136,10,4391906499
2180,2390119,33667245,36057364,4,0,1,7168,14,204341071
2181,2390190,33741861,36132051,9,0,1,2560,12,8844411406
2182,2393340,17597004,19990344,28,2,0,3584,24,4584860843
2183,2394000,15712295,18106295,3,0,0,19968,5,1743814812
2184,2394010,15407985,17801995,7,0,0,9216,29,2466686201
2185,2394560,15866016,18260576,1,0,0,17408,26,2752642470
2186,2395320,15767122,18162442,37,3,0,54784,15,9316388640
2187,2395357,17361140,19756497,16,1,0,24576,10,3869513622
2188,2396150,15317884,17714034,19,1,0,22528,5,3702545918
2189,2398450,16875967,19274417,24,2,0,8704,10,10706836056
2190,2401120,16664659,19065779,29,2,0,9216,26,1920585339
2191,2404660,15398918,17803578,2,0,0,5120,3,1045256393
2192,2404740,16906722,19311462,8,0,0,8704,1,5831726004
2193,2407510,16191401,18598911,2,0,0,45056,3,8344167498
2194,2407620,15960149,18367769,20,2,0,7168,24,9847622524
2195,2410480,15905507,18315987,24,2,0,114176,10,1294313315
2196,2411791,33722206,36133997,19,1,1,3072,5,4071627113
2197,2412860,15314823,17727683,20,2,0,10752,24,621895642
2198,2414169,33759222,36173391,23,2,1,2560,4,4166036420
2199,2414590,15836892,18251482,3,0,0,24576,5,5203209554
2200,2414660,17042217,19456877,8,0,0,70144,1,3853116975
2201,2414880,33758534,36173414,24,2,1,512,10,5778399247
2202,2416470,16204344,18620814,24,2,0,4608,10,5280738323
2203,2419360,16502678,18922038,35,3,0,3584,8,5385753633
2204,2420051,15956945,18376996,25,2,0,30208,4,5140708643
2205,2421260,17105955,19527215,39,3,0,25088,2,4910288733
2206,2421440,17391087,19812527,15,1,0,29184,19,3142436424
2207,2423061,33782387,36205448,26,2,1,13824,29,4006932178
2208,2424010,17314066,19738076,21,2,0,99840,25,4931441369
2209,2424150,16983253,19407403,16,1,0,3072,10,6777015451
2210,2425010,17602149,20027159,21,2,0,25600,25,5669555016
2211,2430090,17702855,20132945,37,3,0,8704,15,9257676102
2212,2430709,33839282,36269991,37,3,1,3584,15,3215130527
2213,2433120,17503804,19936924,28,2,0,62976,24,7137259506
2214,2434590,16233832,18668422,20,2,0,2048,24,6613671548
2215,2434850,18857163,21292013,14,1,0,49152,8,1588074002
2216,2436960,18055511,20492471,14,1,0,40960,8,8131992900
2217,2438600,15728724,18167324,2,0,0,6656,3,4037425573
2218,2439231,17498386,19937617,9,0,0,2048,12,3357958996
2219,2439670,16577059,19016729,12,1,0,10752,3,8609100161
2220,2439850,33830164,36270014,32,3,1,19968,17,1467418318
2221,2440150,16023944,18464094,36,3,0,15360,3,1477760804
2222,2440661,33858574,36299235,7,0,1,3072,29,9406178411
2223,2441851,33857407,36299258,7,0,1,512,29,3731716270
2224,2441921,16225846,18667767,34,3,0,30208,2,5365272894
2225,2442920,17572579,20015499,15,1,0,12800,19,5562153843
2226,2442980,15812269,18255249,10,1,0,12288,4,5566366153
2227,2444390,18425131,20869521,7,0,0,151552,29,4683645526
2228,2446241,16555555,19001796,9,0,0,16896,12,4929194975
2229,2447090,33852191,36299281,32,3,1,1024,17,8867125915
2230,2447570,16650541,19098111,24,2,0,8192,10,7631350154
2231,2448230,33851984,36300214,32,3,1,14336,17,4569608443
2232,2448310,15952718,18401028,32,3,0,62976,17,3236603045
2233,2449551,16526592,18976143,34,3,0,66048,2,8536833844
2234,2450051,17069497,19519548,9,0,0,30720,12,1906777489
2235,2450440,33920250,36370690,35,3,1,19968,8,2648207853
2236,2454050,16814705,19268755,37,3,0,56320,15,1842528412
2237,2454930,33956997,36411927,35,3,1,2560,8,8609867117
2238,2456180,16449276,18905456,7,0,0,29696,29,8982584201
2239,2457150,16013412,18470562,29,2,0,12800,26,5101651229
2240,2458000,15920891,18378891,36,3,0,6144,3,5417890496
2241,2459370,18550554,21009924,2,0,0,59904,3,3274839522
2242,2461830,15961465,18423295,16,1,0,2048,10,294479824
2243,2461970,16682505,19144475,5,0,0,24576,4,8929034765
2244,2464900,16478377,18943277,24,2,0,69632,10,5899973020
2245,2465641,16222058,18687699,34,3,0,18944,2,1408105550
2246,2466190,17364479,19830669,12,1,0,13312,3,286764758
2247,2466760,33988483,36455243,20,2,1,2048,24,7996308521
2248,2467200,18697394,21164594,37,3,0,44032,15,2947911260
2249,2469150,16359375,18828525,28,2,0,20480,24,9335998418
2250,2469730,16091974,18561704,21,2,0,15360,25,5854528216
2251,2470130,15791660,18261790,2,0,0,512,3,6804772681
2252,2470260,16556739,19026999,39,3,0,31232,2,173922213
2253,2470810,33984689,36455499,13,1,1,9216,6,5523995819
2254,2471161,33984684,36455845,21,2,1,512,25,641517095
2255,2471480,18204839,20676319,36,3,0,49152,3,4208949454
2256,2471760,16748824,19220584,21,2,0,40448,25,1176865679
2257,2475560,16587388,19062948,19,1,0,6144,5,804165576
2258,2476970,18021631,20498601,27,2,0,10240,9,137434831
2259,2476990,18418918,20895908,28,2,0,86528,24,6426344899
2260,2477660,18762071,21239731,27,2,0,62464,9,2918133192
2261,2479470,33983055,36462525,29,2,1,14848,26,7295160092
2262,2479481,16772091,19251572,34,3,0,22528,2,5828394608
2263,2481440,16745251,19226691,16,1,0,19968,10,5004149084
2264,2481890,16122215,18604105,14,1,0,1536,8,7817026504
2265,2482301,34182109,36664410,7,0,1,8192,29,4446573894
2266,2483860,16802245,19286105,24,2,0,19456,10,8691716647
2267,2485299,34179717,36665016,37,3,1,3072,15,7268135967
2268,2485500,34203811,36689311,3,0,1,512,5,1790316207
2269,2489090,15977475,18466565,36,3,0,3584,3,2064728630
2270,2492950,16847086,19340036,6,0,0,1024,24,1134356446
2271,2493510,18435851,20929361,14,1,0,8704,8,3507011574
2272,2496160,17198388,19694548,3,0,0,1536,5,2755840682
2273,2496820,16823578,19320398,2,0,0,2560,3,4889542784
2274,2498230,34204643,36702873,14,1,1,4096,8,1080217480
2275,2502270,34200626,36702896,0,0,1,512,8,7616322689
2276,2502320,16590740,19093060,32,3,0,24576,17,5792103406
2277,2502780,16867775,19370555,31,3,0,24064,27,1709334440
2278,2504430,18919819,21424249,8,0,0,20992,1,5915859780
2279,2505039,34209323,36714362,23,2,1,7680,4,10040379300
2280,2505380,17059768,19565148,15,1,0,59392,19,7137267249
2281,2505450,16000540,18505990,8,0,0,13312,1,7487578932
2282,2506151,34226540,36732691,30,3,1,2560,3,6497560080
2283,2506190,34226524,36732714,24,2,1,1024,10,2580514728
2284,2508850,16919479,19428329,19,1,0,20992,5,664477570
2285,2509320,34223417,36732737,39,3,1,12288,2,6624011418
2286,2510070,16336955,18847025,24,2,0,4096,10,8209253055
2287,2511060,16977833,19488893,6,0,0,18944,24,8162107184
2288,2512010,17031901,19543911,23,2,0,2048,4,4090735206
2289,2512750,17325773,19838523,2,0,0,10240,3,5831420220
2290,2513030,17313560,19826590,39,3,0,46080,2,7071372921
2291,2513380,16758362,19271742,13,1,0,9728,6,5782214727
2292,2514810,18945857,21460667,14,1,0,41984,8,6531199279
2293,2517490,34328575,36846065,28,2,1,4608,24,6147732822
2294,2519640,19061580,21581220,10,1,0,27648,4,6630791185
2295,2520570,16315021,18835591,31,3,0,6656,27,1930342604
2296,2520630,34328021,36848651,20,2,1,4096,24,684723074
2297,2522110,34999314,37521424,0,0,1,231424,8,1383745648
2298,2524890,18518069,21042959,22,2,0,17920,10,6455101948
2299,2527379,35210738,37738117,4,0,1,24576,14,4814688624
2300,2528910,17388780,19917690,8,0,0,43520,1,3679877791
2301,2529340,16353050,18882390,1,0,0,1536,26,2941257254
2302,2530270,17051639,19581909,4,0,0,16896,14,1164881676
2303,2533980,17481698,20015678,37,3,0,512,15,4267756463
2304,2534439,35203701,37738140,23,2,1,1024,4,4257886881
2305,2534790,18614283,21149073,15,1,0,69120,19,3262458840
2306,2535070,35203093,37738163,13,1,1,14336,6,2750191873
2307,2536130,35364361,37900491,14,1,1,23040,8,2066721436
2308,2536181,16769447,19305628,25,2,0,64000,4,5619745410
2309,2537430,35379244,37916674,14,1,1,13824,8,1225859187
2310,2538720,16705965,19244685,37,3,0,15872,15,7933772812
2311,2540690,17749833,20290523,16,1,0,30720,10,1563821603
2312,2542540,17124084,19666624,1,0,0,7680,26,10587405083
2313,2542580,16784295,19326875,30,3,0,11776,3,699932861
2314,2543091,16567814,19110905,25,2,0,5632,4,6640697162
2315,2545390,18647092,21192482,31,3,0,16896,27,5867572456
2316,2545560,17342051,19887611,15,1,0,49152,19,3742756555
2317,2545700,19188868,21734568,21,2,0,1536,25,2118918718
2318,2551600,19279664,21831264,27,2,0,9216,9,9716987217
2319,2551770,17448393,20000163,6,0,0,17920,24,3365724504
2320,2551780,17155853,19707633,38,3,0,24064,26,4184417880
2321,2552190,35364507,37916697,9,0,1,2048,12,8490610535
2322,2552430,17428408,19980838,22,2,0,17408,10,6004902501
2323,2552480,17014407,19566887,20,2,0,5632,24,7333190345
2324,2552520,17644720,20197240,16,1,0,19968,10,3341832066
2325,2552900,16515897,19068797,1,0,0,5632,26,987864041
2326,2554071,16754716,19308787,34,3,0,10240,2,4112135671
2327,2554340,19179737,21734077,0,0,0,132608,8,1444104681
2328,2554420,17582916,20137336,7,0,0,14336,29,3410378859
2329,2555811,17108450,19664261,33,3,0,39936,22,799220746
2330,2557440,35359296,37916736,20,2,1,13312,24,3872915558
2331,2557801,35358958,37916759,7,0,1,4608,29,10427083516
2332,2559370,17623932,20183302,31,3,0,39424,27,3344314428
2333,2561280,17228991,19790271,0,0,0,16896,8,7893132097
2334,2562089,35354693,37916782,5,0,1,1536,4,362455304
2335,2562161,35354644,37916805,21,2,1,512,25,3650003814
2336,2562370,17758669,20321039,32,3,0,19968,17,4307286317
2337,2565200,18228561,20793761,35,3,0,42496,8,5677029417
2338,2565500,16840453,19405953,20,2,0,47616,24,9308723400
2339,2565980,35353263,37919243,12,1,1,12288,3,3076005524
2340,2568390,35540075,38108465,28,2,1,57856,24,5301335189
2341,2568680,16893289,19461969,23,2,0,11776,4,3668244754
2342,2568890,17523352,20092242,14,1,0,9216,8,4579050919
2343,2571730,16837412,19409142,37,3,0,5632,15,6005683657
2344,2574070,17320763,19894833,4,0,0,1024,14,3320920959
2345,2574680,18248642,20823322,20,2,0,28160,24,2122830440
2346,2575420,17779893,20355313,12,1,0,78848,3,6838058623
2347,2576920,17714874,20291794,37,3,0,4096,15,786552489
2348,2577390,16829054,19406444,32,3,0,1536,17,3467741622
2349,2579100,16888681,19467781,0,0,0,3072,8,7233812427
2350,2581090,35527398,38108488,3,0,1,1024,5,7218675168
2351,2581490,17160041,19741531,11,1,0,11264,6,3101652205
2352,2583250,35525261,38108511,12,1,1,10752,3,6781101180
2353,2584820,19196554,21781374,15,1,0,24576,19,4319951924
2354,2589590,18828240,21417830,35,3,0,38400,8,4347211963
2355,2590730,17962953,20553683,2,0,0,25088,3,7457402391
2356,2591950,17599183,20191133,8,0,0,25600,1,1658779061
2357,2592580,18068740,20661320,27,2,0,62976,9,8703274757
2358,2593430,19314634,21908064,10,1,0,10752,4,2857850731
2359,2595540,35608841,38204381,6,0,1,10240,24,7494983381
2360,2596450,17035669,19632119,21,2,0,5120,25,3058054691
2361,2596760,35743565,38340325,1,0,1,33792,26,8804863864
2362,2597420,35762649,38360069,27,2,1,7168,9,5357760678
2363,2598121,35831841,38429962,26,2,1,16384,29,9497897731
2364,2599470,17867124,20466594,0,0,0,18432,8,6724491702
2365,2599780,17530373,20130153,13,1,0,19968,6,5201331776
2366,2599841,35847598,38447439,26,2,1,1024,29,7184210834
2367,2600061,17090385,19690446,33,3,0,6144,22,5259826865
2368,2600140,35847555,38447695,20,2,1,9216,24,4116398278
2369,2601161,36156342,38757503,21,2,1,17408,25,5982912157
2370,2601871,18019066,20620937,33,3,0,12800,22,5732803631
2371,2606051,36187032,38793083,7,0,1,3584,29,4127428304
2372,2607780,17637063,20244843,3,0,0,2048,5,2837015932
2373,2608710,17151710,19760420,6,0,0,12800,24,8768373440
2374,2611251,17003267,19614518,34,3,0,11776,2,5909652168
2375,2611420,36200697,38812117,20,2,1,22016,24,474700786
2376,2612749,36227735,38840484,4,0,1,8704,14,9143563402
2377,2614060,17331738,19945798,7,0,0,26624,29,5969797579
2378,2615150,17535619,20150769,12,1,0,6656,3,9794657040
2379,2615710,36355694,38971404,20,2,1,46080,24,2896511801
2380,2616001,19460441,22076442,9,0,0,43008,12,2876355361
2381,2617011,17129870,19746881,34,3,0,10752,2,6083499039
2382,2617050,18020192,20637242,37,3,0,9216,15,2848418869
2383,2617100,17076957,19694057,28,2,0,11776,24,1289361797
2384,2619750,17437097,20056847,8,0,0,1024,1,2094251226
2385,2620121,17686452,20306573,33,3,0,7168,22,6550517169
2386,2620691,18148000,20768691,34,3,0,7168,2,4318050710
2387,2623320,36405374,39028694,9,0,1,5632,12,3481979014
2388,2623561,18360367,20983928,25,2,0,86528,4,6016268399
2389,2623910,17125068,19748978,0,0,0,6656,8,9604775171
2390,2624260,17235589,19859849,32,3,0,2048,17,2262641991
2391,2625170,18919530,21544700,7,0,0,30208,29,5849829581
2392,2625440,17209940,19835380,12,1,0,15360,3,8516903162
2393,2625730,36574736,39200466,33,3,1,11776,22,9765468013
2394,2628240,19041434,21669674,30,3,0,10752,3,10240506842
2395,2628530,36573882,39202412,34,3,1,3072,2,10031769811
2396,2628860,18327090,20955950,6,0,0,29696,24,6887980683
2397,2629940,18355914,20985854,19,1,0,5632,5,3249034856
2398,2630110,17229092,19859202,11,1,0,17920,6,9942661279
2399,2630320,17865138,20495458,31,3,0,9728,27,7488045725
2400,2631770,19334399,21966169,11,1,0,22528,6,4229288768
2401,2632300,17908699,20540999,11,1,0,512,6,4742292394
2402,2635010,18291676,20926686,29,2,0,70144,26,2108079821
2403,2635390,18269901,20905291,11,1,0,30720,6,2991170654
2404,2635430,17731816,20367246,20,2,0,8192,24,3103694365
2405,2636889,36567008,39203897,5,0,1,15360,4,616987070
2406,2637020,17960044,20597064,6,0,0,57344,24,10629356718
2407,2637810,17411971,20049781,35,3,0,36864,8,6520682436
2408,2637940,19804064,22442004,20,2,0,93184,24,6982289458
2409,2638300,17722348,20360648,36,3,0,17408,3,1105610719
2410,2639510,18434378,21073888,37,3,0,70144,15,7913098889
2411,2640280,17817953,20458233,22,2,0,35840,10,9213888595
2412,2640839,36591055,39231894,23,2,1,5632,4,482743188
2413,2642460,36589457,39231917,17,1,1,9216,28,4888805327
2414,2644370,19604241,22248611,32,3,0,28672,17,4613221153
2415,2645140,18481579,21126719,27,2,0,22016,9,6285444703
2416,2646380,17524887,20171267,36,3,0,29696,3,490614767
2417,2646460,36630797,39277257,20,2,1,36864,24,3899831668
2418,2646490,17515706,20162196,28,2,0,15872,24,10646694299
2419,2647980,18571269,21219249,11,1,0,62976,6,6920380971
2420,2648500,19591352,22239852,19,1,0,64000,5,9252977188
2421,2651760,36647429,39299189,3,0,1,7168,5,9371621717
2422,2654421,17649922,20304343,9,0,0,38400,12,10319404738
2423,2655591,18094927,20750518,25,2,0,61440,4,1414069322
2424,2658740,36688253,39346993,2,0,1,9216,3,10385941633
2425,2659550,36702445,39361995,16,1,1,19456,10,9923213165
2426,2659651,18491005,21150656,34,3,0,5120,2,3707301117
2427,2660120,17918755,20578875,27,2,0,42496,9,7879422792
2428,2662100,17669166,20331266,11,1,0,4608,6,1893727523
2429,2663550,18270826,20934376,1,0,0,16384,26,1284704649
2430,2664910,17699817,20364727,22,2,0,13312,10,6621522714
2431,2666240,36744019,39410259,13,1,1,3584,6,8115198963
2432,2666600,36743682,39410282,1,0,1,6144,26,8489393798
2433,2667050,18146397,20813447,14,1,0,37376,8,1932696997
2434,2667246,19640635,22307881,1,0,0,15872,26,2071727992
2435,2668550,36742108,39410658,29,2,1,2048,26,5032913809
2436,2672110,18708603,21380713,36,3,0,50176,3,7409505850
2437,2672430,19865066,22537496,35,3,0,28160,8,5761659666
2438,2674581,18988234,21662815,34,3,0,35328,2,3462486639
2439,2674790,19845210,22520000,4,0,0,45056,14,5950224103
2440,2674970,19932219,22607189,8,0,0,29184,1,9665627409
2441,2676130,18270749,20946879,16,1,0,40960,10,7857580871
2442,2676970,19207345,21884315,27,2,0,14848,9,6884232285
2443,2677139,36735145,39412284,11,1,1,2560,6,2096077457
2444,2679349,36735841,39415190,18,1,1,4608,13,517629668
2445,2680260,17860560,20540820,23,2,0,18944,4,719708336
2446,2680481,36783441,39463922,30,3,1,512,3,1525294163
2447,2680960,17944368,20625328,29,2,0,14336,26,4744563213
2448,2684110,18081875,20765985,2,0,0,50688,3,5697866398
2449,2684670,17957431,20642101,15,1,0,15872,19,2105755352
2450,2684840,18084966,20769806,30,3,0,3584,3,8331007133
2451,2685160,36778785,39463945,14,1,1,512,8,3972516749
2452,2685991,18745279,21431270,9,0,0,22016,12,10219743471
2453,2689600,18603372,21292972,39,3,0,3072,2,4145817523
2454,2690050,18386825,21076875,16,1,0,9728,10,9649433004
2455,2690420,20152989,22843409,37,3,0,16384,15,9449137452
2456,2692159,36774172,39466331,11,1,1,3584,6,2744565833
2457,2692170,20236928,22929098,15,1,0,7168,19,4589286211
2458,2694970,19042920,21737890,7,0,0,1536,29,1198706398
2459,2695320,36797497,39492817,28,2,1,2560,24,6561514413
2460,2695980,19983872,22679852,6,0,0,104960,24,7187468250
2461,2698600,17862584,20561184,7,0,0,5120,29,10340990880
2462,2698730,18421258,21119988,20,2,0,88064,24,6952105841
2463,2698811,36794029,39492840,31,3,1,4608,27,7930742209
2464,2699290,36810007,39509297,29,2,1,512,26,2817977394
2465,2700960,36950255,39651215,20,2,1,47616,24,3847180024
2466,2701546,18638311,21339857,20,2,0,14848,24,10640175763
2467,2701760,18079030,20780790,13,1,0,9728,6,3831969798
2468,2701909,37120132,39822041,4,0,1,1536,14,10436565293
2469,2702340,37119724,39822064,25,2,1,6656,4,6771220138
2470,2704850,19196872,21901722,30,3,0,32256,3,2602039265
2471,2705670,18331806,21037476,8,0,0,28160,1,9245913235
2472,2706680,18059796,20766476,13,1,0,1536,6,1795046914
2473,2707690,18022009,20729699,16,1,0,30208,10,4626493379
2474,2708000,20347628,23055628,28,2,0,26112,24,6589062231
2475,2709890,18418100,21127990,21,2,0,4096,25,10200414643
2476,2710600,19391986,22102586,28,2,0,3584,24,8847508199
2477,2710821,18982829,21693650,34,3,0,13824,2,8909982701
2478,2711151,19474869,22186020,33,3,0,48640,22,6527928423
2479,2711380,18306529,21017909,36,3,0,3072,3,322132423
2480,2713160,37620253,40333413,20,2,1,96256,24,3252406406
2481,2714260,18537038,21251298,3,0,0,37888,5,261397662
2482,2714691,18959530,21674221,25,2,0,14848,4,6036580487
2483,2716220,19771240,22487460,12,1,0,82944,3,626479584
2484,2717090,19187471,21904561,22,2,0,9216,10,8259003384
2485,2717970,19041494,21759464,27,2,0,46080,9,1373620217
2486,2719020,19048290,21767310,37,3,0,15360,15,437789099
2487,2719641,37736320,40455961,26,2,1,31232,29,1602185456
2488,2724069,37788773,40512842,18,1,1,7680,13,1707151706
2489,2725690,18551238,21276928,35,3,0,55808,8,10490403260
2490,2726560,37833813,40560373,1,0,1,3584,26,2406660347
2491,2726660,19153108,21879768,31,3,0,18944,27,8784744831
2492,2727800,18822549,21550349,11,1,0,12800,6,6149300404
2493,2728170,37832767,40560937,2,0,1,10752,3,1973500152
2494,2729250,37882716,40611966,17,1,1,14336,28,8346633052
2495,2729531,37934892,40664423,31,3,1,2048,27,5716624461
2496,2730830,18803272,21534102,14,1,0,10240,8,4247555382
2497,2732160,18225373,20957533,14,1,0,5120,8,7497635525
2498,2733080,19865171,22598251,39,3,0,59904,2,5183826987
2499,2735420,37943744,40679164,35,3,1,2048,8,8137370037
2500,2737650,18522251,21259901,31,3,0,28160,27,9427326446
2501,2739350,18568918,21308268,0,0,0,23552,8,1239239492
2502,2740770,18243345,20984115,20,2,0,512,24,8430040214
2503,2741370,18409777,21151147,8,0,0,1536,1,3373436226
2504,2742260,19953417,22695677,24,2,0,12800,10,4378925156
2505,2742920,18652800,21395720,5,0,0,49152,4,4129355285
2506,2744600,37938518,40683118,27,2,1,5120,9,1135798878
2507,2745150,37937991,40683141,12,1,1,1024,3,857347285
2508,2746800,20091594,22838394,36,3,0,51712,3,8511865400
2509,2750390,19552632,22303022,19,1,0,3584,5,187762045
2510,2750970,18558101,21309071,32,3,0,2560,17,745877787
2511,2751020,18446466,21197486,13,1,0,3072,6,6204749806
2512,2752670,18468006,21220676,23,2,0,4608,4,6552713022
2513,2754470,18894415,21648885,8,0,0,51712,1,5232044361
2514,2755360,19283868,22039228,37,3,0,8704,15,9434498012
2515,2755770,18609632,21365402,2,0,0,27648,3,2427570895
2516,2756509,37926655,40683164,4,0,1,4096,14,8019497073
2517,2757590,20475546,23233136,35,3,0,64000,8,7859334087
2518,2757620,18857668,21615288,36,3,0,53760,3,1946449384
2519,2760020,18640270,21400290,37,3,0,14848,15,7554585275
2520,2760179,37923008,40683187,23,2,1,4096,4,1856825474
2521,2764660,18747191,21511851,14,1,0,6656,8,6567845502
2522,2766610,37916600,40683210,1,0,1,11264,26,7945446605
2523,2767080,37920083,40687163,35,3,1,23040,8,9134371662
2524,2767990,18977411,21745401,29,2,0,24576,26,4472570905
2525,2768110,18864996,21633106,14,1,0,34304,8,7845167745
2526,2768710,19057500,21826210,3,0,0,25600,5,6715409241
2527,2769900,19687625,22457525,11,1,0,22528,6,5829173727
2528,2770150,18727865,21498015,16,1,0,36864,10,2556045200
2529,2772380,18905764,21678144,32,3,0,12800,17,4031210892
2530,2775450,19752420,22527870,14,1,0,12800,8,1469817184
2531,2775729,37989993,40765722,37,3,1,13312,15,72530276
2532,2775870,19668965,22444835,35,3,0,9216,8,7171836022
2533,2776850,19064746,21841596,8,0,0,17920,1,5804473376
2534,2777900,37987845,40765745,39,3,1,14336,2,1201579358
2535,2778970,19595130,22374100,14,1,0,12800,8,8172850888
2536,2780390,18696876,21477266,37,3,0,3584,15,183933182
2537,2780760,18871268,21652028,14,1,0,10240,8,1274126817
2538,2781010,19859676,22640686,29,2,0,6656,26,8610354535
2539,2781040,19255513,22036553,1,0,0,141312,26,4537811455
2540,2781170,38031217,40812387,25,2,1,5632,4,4288594166
2541,2783870,20171014,22954884,32,3,0,26112,17,7498189928
2542,2784251,18978356,21762607,25,2,0,10240,4,8842196790
2543,2784670,19061728,21846398,12,1,0,13824,3,1006922212
2544,2784910,18684178,21469088,36,3,0,9216,3,5029565987
2545,2788380,19184000,21972380,20,2,0,12800,24,8184379845
2546,2788890,19192128,21981018,21,2,0,2048,25,9696035943
2547,2790390,19322827,22113217,13,1,0,34816,6,1650638910
2548,2791920,18887763,21679683,37,3,0,4096,15,4688867280
2549,2793450,20268137,23061587,0,0,0,19456,8,7751017567
2550,2795522,38044172,40839694,10,1,1,31232,4,7259222823
2551,2796340,19695667,22492007,6,0,0,14848,24,211355344
2552,2796400,19002446,21798846,19,1,0,31744,5,2757760895
2553,2796520,20280230,23076750,4,0,0,30208,14,6484623662
2554,2799840,19092031,21891871,8,0,0,20992,1,8812992010
2555,2800081,19243538,22043619,25,2,0,14336,4,5109311393
2556,2803060,19156222,21959282,14,1,0,26624,8,9231309824
2557,2803760,19113219,21916979,29,2,0,29184,26,5584890382
2558,2803839,38038121,40841960,8,0,1,3584,1,7448376837
2559,2804320,19832553,22636873,3,0,0,4608,5,2330609285
2560,2804900,20351613,23156513,3,0,0,512,5,7893909855
2561,2808960,18928439,21737399,6,0,0,9216,24,6190055343
2562,2810671,38053036,40863707,21,2,1,16384,25,4327516555
2563,2811630,19816361,22627991,2,0,0,68096,3,3794648169
2564,2811980,19358502,22170482,20,2,0,11776,24,7885822193
2565,2812039,38086306,40898345,23,2,1,3072,4,4403144766
2566,2812730,19335539,22148269,37,3,0,7168,15,3881222935
2567,2813310,19283458,22096768,13,1,0,15360,6,627622438
2568,2813611,19388358,22201969,33,3,0,27136,22,1273003810
2569,2815640,19486267,22301907,37,3,0,69120,15,7064291195
2570,2816330,18968187,21784517,13,1,0,10240,6,4783424249
2571,2820560,38168403,40988963,32,3,1,22016,17,5112474887
2572,2821580,20334754,23156334,29,2,0,4608,26,4661967723
2573,2821730,38218870,41040600,39,3,1,512,2,877649421
2574,2821940,38260414,41082354,14,1,1,9728,8,10521312467
2575,2823280,19942252,22765532,20,2,0,122880,24,10513195051
2576,2823310,20450936,23274246,5,0,0,40960,4,10442274400
2577,2823640,19268425,22092065,0,0,0,51200,8,8580481235
2578,2824050,20652882,23476932,15,1,0,84992,19,9141613855
2579,2825310,19507466,22332776,6,0,0,23040,24,8940636298
2580,2825870,19275601,22101471,36,3,0,15360,3,9457013402
2581,2825980,19632192,22458172,8,0,0,2048,1,7661207435
2582,2827201,38317055,41144256,31,3,1,7168,27,2084308923
2583,2829330,38314949,41144279,28,2,1,13312,24,7834082367
2584,2830180,19330527,22160707,30,3,0,2048,3,5902979393
2585,2833650,19430584,22264234,10,1,0,51200,4,7255613399
2586,2836661,38319757,41156418,7,0,1,512,29,8698135475
2587,2837390,19576199,22413589,4,0,0,69120,14,3225510956
2588,2837420,19333241,22170661,36,3,0,512,3,6689073169
2589,2837920,20503950,23341870,20,2,0,59904,24,4888780844
2590,2838190,38394481,41232671,34,3,1,25088,2,9759149146
2591,2838550,38421433,41259983,2,0,1,3584,3,930680196
2592,2841290,19872864,22714154,39,3,0,12800,2,1310342716
2593,2841478,19609160,22450638,20,2,0,18944,24,4034962767
2594,2841621,38419348,41260969,19,1,1,1536,5,1386914721
2595,2841820,19738110,22579930,15,1,0,9728,19,832122609
2596,2845580,19310580,22156160,3,0,0,13824,5,2978598364
2597,2848331,19289233,22137564,25,2,0,512,4,1298409568
2598,2849900,19841854,22691754,24,2,0,6656,10,2354733053
2599,2850570,20045579,22896149,19,1,0,14336,5,8283624181
2600,2852090,19427299,22279389,28,2,0,49664,24,5228154544
2601,2854140,19835563,22689703,4,0,0,32256,14,5920921540
2602,2855871,38435655,41291526,31,3,1,15360,27,2400386947
2603,2855940,19772698,22628638,24,2,0,2048,10,9366454420
2604,2857460,19719483,22576943,4,0,0,55296,14,10241749353
2605,2858490,20219219,23077709,18,1,0,3072,13,8430124425
2606,2858790,19647459,22506249,39,3,0,11776,2,3305544601
2607,2860399,38431150,41291549,15,1,1,12800,19,2530597238
2608,2860811,19420005,22280816,34,3,0,4608,2,3286354401
2609,2861041,19783256,22644297,9,0,0,11776,12,3228358566
2610,2861190,19641448,22502638,21,2,0,34816,25,1306490333
2611,2862040,19502397,22364437,12,1,0,7168,3,9300910288
2612,2862150,20649670,23511820,13,1,0,8704,6,1777170744
2613,2865380,19862681,22728061,30,3,0,45568,3,2959592542
2614,2865950,38487184,41353134,25,2,1,10752,4,5671465651
2615,2867410,19470285,22337695,29,2,0,7680,26,2331796014
2616,2869960,19936930,22806890,28,2,0,67072,24,8824144638
2617,2871080,19839151,22710231,32,3,0,43008,17,9884453015
2618,2871740,20034260,22906000,15,1,0,32256,19,5782990166
2619,2872090,38481067,41353157,12,1,1,11264,3,3004305219
2620,2872650,19687422,22560072,27,2,0,48640,9,3158394121
2621,2872700,20651272,23523972,30,3,0,27648,3,3758990154
2622,2874210,19755878,22630088,7,0,0,4608,29,2427524798
2623,2875131,20272236,23147367,34,3,0,37376,2,8331677073
2624,2877620,38512124,41389744,3,0,1,512,5,10473540025
2625,2877840,19902666,22780506,37,3,0,23040,15,5326620255
2626,2879961,19758674,22638635,9,0,0,5632,12,121605411
2627,2880040,19817064,22697104,20,2,0,4608,24,88130731
2628,2881540,19979656,22861196,13,1,0,11264,6,1314175678
2629,2882420,20845852,23728272,14,1,0,15360,8,3382520687
2630,2882800,19966996,22849796,28,2,0,5120,24,9904549448
2631,2883860,20716162,23600022,36,3,0,24064,3,8305563238
2632,2885120,19887143,22772263,0,0,0,22016,8,4614310390
2633,2885290,38508640,41393930,29,2,1,6656,26,3742737927
2634,2885540,21067588,23953128,7,0,0,95744,29,1276396975
2635,2886191,38579221,41465412,22,2,1,28160,10,9204175951
2636,2891940,20197492,23089432,16,1,0,38400,10,5099208014
2637,2892410,20738389,23630799,12,1,0,69632,3,1740507362
2638,2895080,38609557,41504637,25,2,1,11264,4,1619958198
2639,2896500,39048626,41945126,20,2,1,117760,24,8188271764
2640,2896550,20012437,22908987,31,3,0,9728,27,6060325710
2641,2897030,20795118,23692148,32,3,0,18432,17,8055950704
2642,2898290,20501758,23400048,23,2,0,34304,4,6789783415
2643,2898741,20048164,22946905,9,0,0,58368,12,5418038660
2644,2898950,20016661,22915611,30,3,0,1024,3,3021599677
2645,2899590,19946338,22845928,21,2,0,8192,25,3204461594
2646,2901150,19734288,22635438,18,1,0,17408,13,146468626
2647,2901591,20078600,22980191,25,2,0,11776,4,2162546671
2648,2902991,20931103,23834094,9,0,0,38912,12,4010191924
2649,2903220,19950492,22853712,23,2,0,9728,4,9894590718
2650,2903370,20122460,23025830,12,1,0,14336,3,1443957417
2651,2905290,39150156,42055446,16,1,1,4608,10,8302921460
2652,2905510,20142139,23047649,24,2,0,10240,10,6815038933
2653,2908990,39146479,42055469,17,1,1,8192,28,4682309471
2654,2911480,19942879,22854359,35,3,0,2048,8,4376041121
2655,2912900,20773609,23686509,36,3,0,19456,3,4117970717
2656,2912970,20493029,23405999,16,1,0,19456,10,323859841
2657,2912989,39143774,42056763,23,2,1,7680,4,8939073169
2658,2914180,20130088,23044268,31,3,0,26112,27,176238631
2659,2915320,21263900,24179220,5,0,0,13824,4,1610520938
2660,2916060,20330671,23246731,2,0,0,44544,3,3324702791
2661,2917331,20395165,23312496,9,0,0,26624,12,889788666
2662,2917770,20079137,22996907,31,3,0,6144,27,183193577
2663,2919129,39137657,42056786,37,3,1,14848,15,9762322390
2664,2919920,20234987,23154907,29,2,0,12800,26,6972395940
2665,2921150,20382727,23303877,12,1,0,36352,3,6321275112
2666,2922060,20661795,23583855,13,1,0,39424,6,4205080538
2667,2922850,20499115,23421965,30,3,0,35840,3,6018709279
2668,2924091,39132726,42056817,22,2,1,4096,10,9358786225
2669,2924610,20783283,23707893,22,2,0,16896,10,7248762065
2670,2925050,20188674,23113724,2,0,0,6144,3,643983239
2671,2925210,39142729,42067939,27,2,1,1536,9,1019814684
2672,2928490,20968142,23896632,26,2,0,36352,29,4011767582
2673,2928920,20742052,23670972,19,1,0,13824,5,6364216135
2674,2930660,39137310,42067970,24,2,1,1024,10,8245782718
2675,2931480,20495344,23426824,18,1,0,15872,13,6730291509
2676,2932451,20746846,23679297,9,0,0,20992,12,1613856819
2677,2932550,21150711,24083261,5,0,0,39936,4,400718106
2678,2935110,20159337,23094447,32,3,0,16384,17,7829091268
2679,2935960,20310950,23246910,30,3,0,512,3,9223867959
2680,2936190,21537003,24473193,24,2,0,34304,10,5475503141
2681,2937490,21026737,23964227,14,1,0,36352,8,845614490
2682,2938881,20197075,23135956,9,0,0,37888,12,10607863780
2683,2938950,20384645,23323595,20,2,0,36352,24,2006426772
2684,2939040,39128961,42068001,14,1,1,14848,8,7711245710
2685,2939290,20404631,23343921,23,2,0,6656,4,66850727
2686,2940760,20122722,23063482,20,2,0,6144,24,2092998418
2687,2941840,20242299,23184139,4,0,0,23040,14,10445609130
2688,2943880,39126819,42070699,35,3,1,4608,8,8259833294
2689,2945050,20897384,23842434,24,2,0,17408,10,1468116367
2690,2945080,20334828,23279908,7,0,0,18432,29,1417329497
2691,2945610,20119923,23065533,15,1,0,6656,19,3983411584
2692,2946220,39125773,42071993,24,2,1,4096,10,10111681782
2693,2946410,20555505,23501915,14,1,0,81920,8,8859544326
2694,2947930,20259086,23207016,11,1,0,3072,6,5532444948
2695,2948100,20170520,23118620,8,0,0,2048,1,7473260434
2696,2948310,21023451,23971761,7,0,0,24576,29,8025525287
2697,2949040,21249557,24198597,29,2,0,52224,26,8280548607
2698,2949680,21174107,24123787,35,3,0,59392,8,4388784783
2699,2950680,20604320,23555000,4,0,0,29696,14,9012698030
2700,2950891,39196553,42147444,19,1,1,5120,5,7470910518
2701,2953000,20606726,23559726,29,2,0,12800,26,153202547
2702,2954021,39193446,42147467,19,1,1,1536,5,10251236565
2703,2954140,21439610,24393750,11,1,0,34304,6,1250622717
2704,2954660,20693174,23647834,29,2,0,55808,26,7439083161
2705,2956800,39262107,42218907,13,1,1,8704,6,3742690872
2706,2957931,21141296,24099227,9,0,0,47616,12,7172742896
2707,2958940,20713326,23672266,11,1,0,4096,6,8244737245
2708,2960100,21124588,24084688,20,2,0,4608,24,3649842807
2709,2960610,21908340,24868950,31,3,0,3584,27,10098557790
2710,2961110,20475790,23436900,27,2,0,9216,9,4467822598
2711,2962320,20574311,23536631,5,0,0,41472,4,1715008468
2712,2963550,39373497,42337047,24,2,1,39424,10,8986323757
2713,2963680,21398224,24361904,12,1,0,27648,3,5193331581
2714,2963750,21053795,24017545,21,2,0,50688,25,7945879787
2715,2964850,39856484,42821334,0,0,1,114176,8,3530049080
2716,2966070,20621396,23587466,16,1,0,11776,10,2594990779
2717,2966660,39858724,42825384,32,3,1,3584,17,5503389725
2718,2967571,39879411,42846982,30,3,1,7680,3,2212034546
2719,2969910,20441104,23411014,7,0,0,16384,29,5211301553
2720,2971510,21162486,24133996,38,3,0,2560,26,7164665084
2721,2972040,21201251,24173291,29,2,0,26112,26,10494407460
2722,2973721,39880988,42854709,30,3,1,3584,3,1524218822
2723,2976620,21076947,24053567,6,0,0,38400,24,433134987
2724,2977170,20531975,23509145,29,2,0,8192,26,4964225150
2725,2977930,21249448,24227378,21,2,0,13824,25,6173444947
2726,2980450,20526168,23506618,20,2,0,15360,24,6603813367
2727,2980840,21429336,24410176,14,1,0,41472,8,1379344408
2728,2983369,21592514,24575883,17,1,0,49664,28,5385971236
2729,2985130,20672867,23657997,4,0,0,33280,14,4668015840
2730,2985250,20895508,23880758,21,2,0,18432,25,9596258279
2731,2985680,20820133,23805813,37,3,0,32768,15,3487784078
2732,2986480,20723776,23710256,16,1,0,7680,10,8939214641
2733,2987200,21225551,24212751,26,2,0,16896,29,5427419483
2734,2988610,21381117,24369727,7,0,0,25600,29,7111898327
2735,2988990,39865742,42854732,3,0,1,1536,5,3940513559
2736,2992620,21995259,24987879,27,2,0,33792,9,1072218704
2737,2993410,21699803,24693213,4,0,0,17408,14,3033319980
2738,2995390,21594182,24589572,6,0,0,8192,24,4051112979
2739,2996100,21521838,24517938,3,0,0,36352,5,8262070753
2740,2996450,20777905,23774355,24,2,0,32256,10,7080324537
2741,2997099,39857656,42854755,8,0,1,1024,1,10141591291
2742,2997340,20877779,23875119,7,0,0,32256,29,6825027473
2743,2997660,21002410,24000070,2,0,0,14848,3,8249631915
2744,2997750,21204234,24201984,39,3,0,6144,2,5299729290
2745,2998410,39864815,42863225,20,2,1,3072,24,1858211728
2746,2998551,21910062,24908613,25,2,0,6656,4,2564529010
2747,2998651,22217160,25215811,33,3,0,50688,22,4222530666
2748,2999650,39867379,42867029,14,1,1,512,8,1170987080
2749,3000179,39870396,42870575,8,0,1,5632,1,9334974905
2750,3000591,40103554,43104145,21,2,1,82432,25,8570110741
2751,3003770,21784405,24788175,12,1,0,50688,3,4122861558
2752,3004331,40123250,43127581,26,2,1,5632,29,6905115528
2753,3005540,21730512,24736052,29,2,0,16384,26,10579901828
2754,3005650,21404736,24410386,29,2,0,512,26,9249607149
2755,3007091,40238950,43246041,10,1,1,14848,4,7648376747
2756,3012440,21120753,24133193,20,2,0,27136,24,2165768816
2757,3012990,21681962,24694952,37,3,0,5632,15,4426911765
2758,3014630,21056432,24071062,30,3,0,57344,3,1891596985
2759,3015150,20961626,23976776,19,1,0,16384,5,8537800560
2760,3017620,21205523,24223143,14,1,0,2560,8,7609554849
2761,3018790,21334667,24353457,27,2,0,44032,9,6512564778
2762,3021970,21004032,24026002,26,2,0,9216,29,6854571170
2763,3022580,21631993,24654573,8,0,0,41984,1,7577477957
2764,3022931,21129200,24152131,9,0,0,17408,12,4895131631
2765,3023311,40244285,43267596,31,3,1,7168,27,4506180138
2766,3025520,40243459,43268979,6,0,1,14848,24,3068005049
2767,3026510,20893939,23920449,16,1,0,9216,10,6650690005
2768,3026780,21413727,24440507,36,3,0,9728,3,4734652367
2769,3027839,40259228,43287067,15,1,1,8192,19,3900537344
2770,3028911,40258720,43287631,19,1,1,10752,5,4745009312
2771,3030950,20961469,23992419,11,1,0,16896,6,4253248046
2772,3031940,21693199,24725139,23,2,0,5120,4,2634747421
2773,3031950,40267183,43299133,14,1,1,4096,8,2314104115
2774,3033171,21189169,24222340,34,3,0,14848,2,9495987561
2775,3038020,21121560,24159580,16,1,0,23040,10,4868273310
2776,3039519,40262840,43302359,5,0,1,5120,4,1699803267
2777,3039660,21602042,24641702,22,2,0,46080,10,6455946398
2778,3040061,21709241,24749302,33,3,0,6656,22,2569085528
2779,3041650,22387168,25428818,12,1,0,11776,3,9560865396
2780,3042460,22051327,25093787,14,1,0,9728,8,10362562345
2781,3045740,21325281,24371021,24,2,0,4096,10,1109518606
2782,3046461,40259124,43305585,7,0,1,5120,29,9987457084
2783,3047440,21458198,24505638,26,2,0,18432,29,7973316599
2784,3047600,21499845,24547445,30,3,0,96768,3,6658651844
2785,3048870,21654061,24702931,13,1,0,26112,6,8562518106
2786,3048900,21331476,24380376,14,1,0,4608,8,5704830358
2787,3050950,21526844,24577794,11,1,0,6144,6,10199976292
2788,3051910,21435893,24487803,24,2,0,25088,10,6138356254
2789,3051990,21679047,24731037,13,1,0,14336,6,5159390163
2790,3052550,21508178,24560728,4,0,0,43520,14,1659267178
2791,3053080,21244922,24298002,13,1,0,2560,6,705071518
2792,3053770,21071132,24124902,3,0,0,3584,5,782735576
2793,3054090,21829791,24883881,28,2,0,46080,24,567417067
2794,3055600,21393185,24448785,20,2,0,4608,24,8272118115
2795,3056260,21562768,24619028,8,0,0,39424,1,3409495090
2796,3056760,21184465,24241225,28,2,0,5120,24,5315082260
2797,3058960,21808875,24867835,39,3,0,39936,2,7742799991
2798,3059189,22401706,25460895,17,1,0,8192,28,9843981945
2799,3059292,40256713,43316005,27,2,1,9728,9,1387994203
2800,3060620,21157173,24217793,19,1,0,9728,5,2887615780
2801,3060960,40284544,43345504,35,3,1,5120,8,899100618
2802,3061020,21614035,24675055,5,0,0,36864,4,5080314753
2803,3061640,21700435,24762075,26,2,0,36352,29,1802711933
2804,3062010,40299150,43361160,16,1,1,1536,10,2685018181
2805,3062680,21183254,24245934,24,2,0,3072,10,8013865876
2806,3063689,40297625,43361314,23,2,1,8704,4,9090675018
2807,3068789,40316943,43385732,11,1,1,8192,6,4648106925
2808,3070079,21536914,24606993,17,1,0,22528,28,3405245561
2809,3070500,22092336,25162836,4,0,0,10752,14,7889292438
2810,3071860,22194700,25266560,2,0,0,27136,3,6233300092
2811,3072850,21520091,24592941,7,0,0,6656,29,3900549730
2812,3072980,21668243,24741223,4,0,0,16896,14,9851667495
2813,3074920,40324503,43399423,13,1,1,12288,6,7814793225
2814,3075100,40457343,43532443,16,1,1,30720,10,4387362287
2815,3075791,40507430,43583221,10,1,1,512,4,8597672004
2816,3076099,40507634,43583733,11,1,1,3584,6,9128335582
2817,3077020,21193706,24270726,11,1,0,3072,6,4443014408
2818,3078810,40506511,43585321,13,1,1,15872,6,8985799448
2819,3079190,21318327,24397517,7,0,0,12288,29,10134958070
2820,3079960,40542496,43622456,24,2,1,4096,10,7757499181
2821,3083720,22387608,25471328,19,1,0,16384,5,2343567982
2822,3086870,21859563,24946433,30,3,0,6144,3,7467565075
2823,3088560,22454616,25543176,7,0,0,9728,29,1108296273
2824,3088960,21348560,24437520,2,0,0,25600,3,10185392377
2825,3089320,22087032,25176352,5,0,0,1024,4,271170102
2826,3093920,21712006,24805926,4,0,0,12288,14,2622604670
2827,3094040,40651554,43745594,1,0,1,13312,26,2850538368
2828,3097770,21704335,24802105,39,3,0,45568,2,9153265643
2829,3098100,21839441,24937541,3,0,0,36352,5,9220354251
2830,3098599,40659278,43757877,18,1,1,1536,13,3632691714
2831,3100610,21563190,24663800,12,1,0,30208,3,3426108316
2832,3101029,40656871,43757900,25,2,1,1024,4,6250316831
2833,3101931,21483530,24585461,33,3,0,25088,22,5576209611
2834,3102600,22122446,25225046,22,2,0,30208,10,5294242438
2835,3102950,21740237,24843187,27,2,0,6144,9,804343209
2836,3103260,21980865,25084125,39,3,0,29184,2,638792113
2837,3103520,22018099,25121619,15,1,0,5120,19,3698278104
2838,3103870,40654053,43757923,16,1,1,9728,10,8027489028
2839,3104280,40748519,43852799,27,2,1,7680,9,3335693684
2840,3105800,22434389,25540189,4,0,0,47104,14,1282616636
2841,3107530,22598993,25706523,8,0,0,30720,1,3253315418
2842,3108810,40744012,43852822,2,0,1,13312,3,9392103951
2843,3108970,40750328,43859298,35,3,1,8704,8,5982336268
2844,3109290,21569844,24679134,35,3,0,13312,8,9486024622
2845,3111380,21569337,24680717,30,3,0,5120,3,294129099
2846,3112650,22043900,25156550,31,3,0,60416,27,2016574822
2847,3116079,40772631,43888710,15,1,1,16384,19,8439149417
2848,3118120,21590797,24708917,23,2,0,4096,4,3984413441
2849,3118690,21647464,24766154,4,0,0,13312,14,4429138103
2850,3120300,21714320,24834620,1,0,0,41984,26,3870548407
2851,3122990,21763783,24886773,22,2,0,512,10,1269412978
2852,3123040,21694141,24817181,23,2,0,36864,4,7575314113
2853,3124230,21885865,25010095,36,3,0,41984,3,4812775105
2854,3125030,21949533,25074563,6,0,0,37376,24,4331547412
2855,3126630,22622331,25748961,0,0,0,32768,8,3423736690
2856,3127660,22031877,25159537,21,2,0,9728,25,8476463058
2857,3129940,40761036,43890976,28,2,1,3584,24,3737658713
2858,3132060,40922091,44054151,6,0,1,35328,24,4580581278
2859,3132320,22097011,25229331,21,2,0,9216,25,4074971753
2860,3132661,40921513,44054174,7,0,1,1024,29,9469144340
2861,3134370,40926878,44061248,29,2,1,9216,26,8085163197
2862,3136399,40990227,44126626,15,1,1,13824,19,6055073395
2863,3137780,22037723,25175503,6,0,0,41472,24,10232381894
2864,3138329,40988320,44126649,5,0,1,512,4,9762068752
2865,3138730,22091092,25229822,27,2,0,1536,9,7810592056
2866,3138970,22444235,25583205,20,2,0,11264,24,9582441726
2867,3139169,40987503,44126672,15,1,1,11264,19,3590506594
2868,3140260,21681545,24821805,24,2,0,8704,10,7116245790
2869,3140310,22267161,25407471,31,3,0,33792,27,796063831
2870,3142080,22179465,25321545,3,0,0,31744,5,3576767025
2871,3142220,21904220,25046440,0,0,0,32256,8,2470899942
2872,3143109,22308159,25451268,17,1,0,12800,28,5828553750
2873,3144250,22537576,25681826,20,2,0,8192,24,7795865748
2874,3146920,22377155,25524075,5,0,0,64512,4,7344941808
2875,3149220,22767448,25916668,18,1,0,35328,13,4297868904
2876,3150890,22281835,25432725,5,0,0,2560,4,8456581226
2877,3150960,22469839,25620799,27,2,0,35840,9,4863714291
2878,3155770,21919440,25075210,27,2,0,2048,9,7122847059
2879,3158220,22067751,25225971,28,2,0,2560,24,7747109109
2880,3160950,22775295,25936245,19,1,0,23040,5,7059867974
2881,3163480,21873109,25036589,11,1,0,16384,6,812928026
2882,3164411,22624005,25788416,34,3,0,64512,2,9795458452
2883,3165690,22475560,25641250,5,0,0,37888,4,8962812164
2884,3166020,22647870,25813890,37,3,0,52736,15,279198972
2885,3166040,22495076,25661116,35,3,0,49152,8,9067269208
2886,3166090,21850029,25016119,11,1,0,5120,6,2100940945
2887,3169881,41062631,44232512,30,3,1,18944,3,5238707073
2888,3174719,41057816,44232535,23,2,1,4096,4,4283942963
2889,3175880,41061148,44237028,32,3,1,9216,17,3303849610
2890,3178390,21927276,25105666,30,3,0,38912,3,3152525406
2891,3178710,22544436,25723146,21,2,0,19968,25,173584647
2892,3180070,41242459,44422529,33,3,1,5120,22,4021609974
2893,3180420,22019901,25200321,14,1,0,10240,8,7095345889
2894,3181640,22747562,25929202,32,3,0,31232,17,10072583683
2895,3182100,22758224,25940324,29,2,0,13312,26,8448753037
2896,3186601,41280260,44466861,10,1,1,19456,4,1342262396
2897,3187230,21988787,25176017,37,3,0,1536,15,4435745314
2898,3188460,22966294,26154754,35,3,0,42496,8,9096174166
2899,3189090,22829686,26018776,28,2,0,6144,24,1292074120
2900,3189919,41276965,44466884,4,0,1,1024,14,722549556
2901,3189960,41324637,44514597,32,3,1,14848,17,5458639702
2902,3190020,21834077,25024097,3,0,0,5632,5,7913797134
2903,3193900,22163486,25357386,7,0,0,67072,29,7808700919
2904,3193980,22231227,25425207,19,1,0,24064,5,8000478915
2905,3194720,22062463,25257183,28,2,0,9216,24,8965933021
2906,3195650,22384008,25579658,31,3,0,83456,27,8189608585
2907,3196390,41365471,44561861,9,0,1,12800,12,4643584999
2908,3198171,41505997,44704168,10,1,1,15360,4,10074883657
2909,3199881,22166724,25366605,33,3,0,14336,22,9555395530
2910,3200730,22303666,25504396,30,3,0,19968,3,7561426399
2911,3200901,22189809,25390710,25,2,0,14336,4,124665793
2912,3201140,22343619,25544759,3,0,0,5120,5,5927231718
2913,3201630,22964425,26166055,3,0,0,23552,5,257449052
2914,3201710,22090930,25292640,7,0,0,6144,29,2641584564
2915,3201790,22195362,25397152,32,3,0,20992,17,2322404622
2916,3201849,41510490,44712339,5,0,1,3072,4,10356884168
2917,3203000,22073930,25276930,3,0,0,4608,5,1543922533
2918,3203290,22482808,25686098,27,2,0,2048,9,1339940507
2919,3204660,22278845,25483505,37,3,0,16384,15,3687236531
2920,3205390,22320424,25525814,29,2,0,5632,26,7630888140
2921,3206500,22611648,25818148,21,2,0,10240,25,1027455628
2922,3207330,23265949,26473279,27,2,0,21504,9,9226963020
2923,3207420,22438697,25646117,29,2,0,15872,26,8353778723
2924,3207490,41506155,44713645,2,0,1,2048,3,2751629762
2925,3208360,22836662,26045022,37,3,0,8192,15,9907191033
2926,3212660,41505171,44717831,13,1,1,6656,6,10279841241
2927,3213651,22388146,25601797,25,2,0,29184,4,10570060709
2928,3214390,41504747,44719137,29,2,1,2048,26,1417116905
2929,3215110,22704553,25919663,11,1,0,9728,6,154162248
2930,3216910,22922520,26139430,6,0,0,5632,24,754798864
2931,3218020,22280269,25498289,19,1,0,24576,5,9013618548
2932,3218560,41538798,44757358,27,2,1,13824,9,5849403407
2933,3219130,22992484,26211614,26,2,0,48640,29,9153073473
2934,3219490,41539174,44758664,35,3,1,2048,8,771593310
2935,3219929,41539708,44759637,37,3,1,12800,15,7796069987
2936,3220321,23349837,26570158,25,2,0,71168,4,4343341562
2937,3221690,22783312,26005002,7,0,0,19968,29,695404849
2938,3222311,22362477,25584788,9,0,0,5120,12,9676209033
2939,3223300,22406383,25629683,13,1,0,22016,6,2761052841
2940,3225380,41722803,44948183,17,1,1,26624,28,68154751
2941,3225490,22665445,25890935,30,3,0,18432,3,3040875090
2942,3228171,41740000,44968171,10,1,1,15872,4,10201990695
2943,3228440,22446501,25674941,37,3,0,12288,15,2348144566
2944,3229760,22377832,25607592,5,0,0,18944,4,588018614
2945,3229809,41796197,45026006,15,1,1,23040,19,8269815174
2946,3230120,22675761,25905881,13,1,0,28160,6,6804074713
2947,3231481,23354323,26585804,33,3,0,28672,22,10247069311
2948,3232320,22604424,25836744,1,0,0,24576,26,398094199
2949,3235000,41873611,45108611,39,3,1,18432,2,5401729756
2950,3235029,41876904,45111933,5,0,1,3072,4,5074694443
2951,3236040,22747992,25984032,20,2,0,6656,24,3213800102
2952,3237900,22577105,25815005,30,3,0,3584,3,6528937220
2953,3239150,23543569,26782719,7,0,0,512,29,1176294505
2954,3240070,41910712,45150782,27,2,1,11776,9,1325364946
2955,3240369,41949730,45190099,18,1,1,1024,13,4449731995
2956,3240970,22581434,25822404,1,0,0,12800,26,7084951981
2957,3241280,23101808,26343088,39,3,0,19968,2,8097959543
2958,3241330,22556469,25797799,8,0,0,30720,1,9738425506
2959,3244220,23033255,26277475,13,1,0,26624,6,3373810155
2960,3246250,22695033,25941283,24,2,0,3072,10,6797223690
2961,3248290,22464140,25712430,5,0,0,9728,4,3716537640
2962,3248330,23555628,26803958,11,1,0,69632,6,173671743
2963,3249120,22744919,25994039,13,1,0,18944,6,2125757126
2964,3249200,23145677,26394877,14,1,0,62976,8,9508016348
2965,3249930,22433011,25682941,26,2,0,3584,29,1725323069
2966,3250530,22634766,25885296,10,1,0,26624,4,8124697429
2967,3251490,23191993,26443483,16,1,0,4608,10,648851707
2968,3251770,22918676,26170446,27,2,0,14336,9,6296619825
2969,3251940,22906893,26158833,27,2,0,13312,9,8094352601
2970,3254230,22865566,26119796,35,3,0,30720,8,7664891521
2971,3254290,23589211,26843501,37,3,0,9216,15,5541885821
2972,3254391,22762490,26016881,34,3,0,38912,2,8257178455
2973,3256100,23161373,26417473,19,1,0,51200,5,9049806370
2974,3256250,23449340,26705590,24,2,0,35840,10,9740660298
2975,3256580,23334551,26591131,39,3,0,17408,2,897517208
2976,3256810,22915687,26172497,11,1,0,6656,6,2847283786
2977,3257360,23079621,26336981,5,0,0,7168,4,6123804031
2978,3257380,23039703,26297083,11,1,0,15360,6,9776005389
2979,3258590,23690816,26949406,37,3,0,32256,15,260337740
2980,3259550,22966277,26225827,30,3,0,18432,3,3289053445
2981,3262310,22795782,26058092,30,3,0,4096,3,8108620255
2982,3262430,22715812,25978242,2,0,0,15872,3,68868881
2983,3262581,41927541,45190122,19,1,1,5632,5,1691895690
2984,3263220,22871172,26134392,22,2,0,35328,10,362103579
2985,3264250,23805695,27069945,19,1,0,512,5,5850818155
2986,3265740,22765554,26031294,5,0,0,28672,4,3763890418
2987,3265881,23131694,26397575,9,0,0,8704,12,7401089690
2988,3265950,42132953,45398903,28,2,1,40448,24,5642096593
2989,3267000,23281428,26548428,37,3,0,50176,15,10404075678
2990,3269130,22696806,25965936,1,0,0,12800,26,10499620251
2991,3269540,23065234,26334774,2,0,0,38400,3,5253835938
2992,3272030,23261087,26533117,3,0,0,15360,5,3695196694
2993,3272770,22864921,26137691,5,0,0,10752,4,8039103657
2994,3273200,22921887,26195087,37,3,0,10752,15,902777582
2995,3273291,23816847,27090138,33,3,0,10240,22,504461552
2996,3273940,23077640,26351580,32,3,0,11776,17,5771926728
2997,3275090,23350661,26625751,1,0,0,10752,26,7087071256
2998,3275530,23535471,26811001,37,3,0,23040,15,4098616054
2999,3276200,42228841,45505041,0,0,1,2560,8,10689189736
3000,3277039,42228025,45505064,23,2,1,8704,4,6754304135
3001,3277391,23959759,27237150,34,3,0,33792,2,2324982109
3002,3277860,23437113,26714973,21,2,0,30720,25,1329933187
3003,3279080,23749923,27029003,19,1,0,57344,5,5074862871
3004,3280720,23240992,26521712,11,1,0,7168,6,7246134148
3005,3281040,23156143,26437183,29,2,0,4096,26,3399625992
3006,3282609,42235917,45518526,37,3,1,1536,15,2500026529
3007,3283130,23573576,26856706,7,0,0,15360,29,9492102733
3008,3283150,23328392,26611542,11,1,0,4608,6,3085155307
3009,3283691,22966957,26250648,33,3,0,17408,22,8428474524
3010,3283750,23392780,26676530,14,1,0,30208,8,1631718025
3011,3286400,42232149,45518549,34,3,1,2048,2,10528775887
3012,3286830,23136773,26423603,30,3,0,19968,3,5792404713
3013,3287281,23455488,26742769,33,3,0,30720,22,9212810209
3014,3287620,23529831,26817451,37,3,0,6144,15,9365291305
3015,3289626,23623007,26912633,18,1,0,26112,13,1368948713
3016,3290460,23878935,27169395,28,2,0,18944,24,8120062325
3017,3291110,23844849,27135959,8,0,0,55808,1,1289799595
3018,3292210,23743680,27035890,7,0,0,22528,29,630943334
3019,3293280,22994808,26288088,6,0,0,7680,24,8463848223
3020,3295450,42223122,45518572,33,3,1,2048,22,9602119633
3021,3297161,23022968,26320129,9,0,0,9216,12,7734682906
3022,3297470,22939763,26237233,24,2,0,10240,10,10496780743
3023,3297720,23948836,27246556,18,1,0,3072,13,2841540246
3024,3298180,23746842,27045022,21,2,0,1024,25,2510066541
3025,3298760,42219835,45518595,1,0,1,1024,26,7029783954
3026,3299220,23605434,26904654,12,1,0,9728,3,6237074470
3027,3300380,23450128,26750508,26,2,0,20992,29,4772599005
3028,3300870,23068503,26369373,20,2,0,512,24,2436283324
3029,3301350,23836816,27138166,3,0,0,7168,5,6282632564
3030,3301710,23194788,26496498,32,3,0,12800,17,7499565331
3031,3302550,23382342,26684892,37,3,0,7680,15,8594299950
3032,3302640,23274405,26577045,2,0,0,22528,3,5764132580
3033,3303960,24090012,27393972,28,2,0,23552,24,3328935133
3034,3309330,23409137,26718467,12,1,0,5632,3,7996996006
3035,3309480,23982358,27291838,2,0,0,47616,3,5468306473
3036,3310000,42256665,45566665,12,1,1,12288,3,51875184
3037,3310190,23564363,26874553,24,2,0,47616,10,7032046090
3038,3310461,42267656,45578117,7,0,1,15872,29,8963778517
3039,3310890,42372169,45683059,29,2,1,29696,26,8354562638
3040,3311900,42389349,45701249,34,3,1,5120,2,1181876914
3041,3312210,23571882,26884092,5,0,0,31232,4,10223565781
3042,3313743,23209281,26523024,36,3,0,2560,3,9555413483
3043,3316040,24191621,27507661,19,1,0,43008,5,3431571621
3044,3317191,42391904,45709095,38,3,1,10240,26,9485925189
3045,3318160,23908671,27226831,11,1,0,106496,6,6160421767
3046,3320600,23170974,26491574,7,0,0,15360,29,5756593337
3047,3320970,23461570,26782540,18,1,0,25600,13,3148366926
3048,3323120,23640920,26964040,29,2,0,19968,26,261806835
3049,3324801,42384325,45709126,7,0,1,2048,29,219431211
3050,3327120,23367420,26694540,39,3,0,8704,2,5248289762
3051,3327590,24049084,27376674,21,2,0,39424,25,8446988672
3052,3327660,24032223,27359883,7,0,0,11264,29,8425578100
3053,3327900,23487648,26815548,12,1,0,14848,3,4111528498
3054,3328881,42380268,45709149,19,1,1,2048,5,3300516385
3055,3329750,23440108,26769858,30,3,0,38400,3,2980801238
3056,3331861,42418617,45750478,19,1,1,25088,5,5727447138
3057,3332910,23441807,26774717,24,2,0,15872,10,961844023
3058,3334161,23735605,27069766,25,2,0,36864,4,370921249
3059,3335841,23261405,26597246,9,0,0,19968,12,8967179590
3060,3336330,23343031,26679361,13,1,0,9216,6,177443528
3061,3337581,23908016,27245597,25,2,0,27648,4,5682573077
3062,3337950,42412551,45750501,33,3,1,3072,22,5427458881
3063,3339201,23555281,26894482,25,2,0,13312,4,3314983014
3064,3343341,24252504,27595845,34,3,0,68608,2,835076560
3065,3343570,23820030,27163600,35,3,0,26112,8,69116732
3066,3343601,24396230,27739831,33,3,0,13312,22,5232799823
3067,3344549,42405975,45750524,11,1,1,11264,6,6975338380
3068,3345300,24315110,27660410,19,1,0,14848,5,39959139
3069,3346930,24253352,27600282,8,0,0,512,1,4544264313
3070,3348190,42469098,45817288,27,2,1,9216,9,2110048542
3071,3349291,42867031,46216322,21,2,1,129536,25,6103274459
3072,3351880,23969774,27321654,26,2,0,28160,29,1579541408
3073,3354950,24187838,27542788,37,3,0,51200,15,1094168112
3074,3355260,42928239,46283499,16,1,1,512,10,2167717413
3075,3357990,24058918,27416908,37,3,0,48640,15,3792545079
3076,3358660,23595662,26954322,13,1,0,11264,6,7945810596
3077,3359490,42924995,46284485,1,0,1,1536,26,625735798
3078,3359550,24952649,28312199,15,1,0,62976,19,9844817427
3079,3359660,24272454,27632114,24,2,0,24576,10,1732220903
3080,3365381,24204891,27570272,34,3,0,44544,2,10217634021
3081,3366110,23910767,27276877,12,1,0,27648,3,9272571080
3082,3366409,23965142,27331551,17,1,0,32256,28,952939366
3083,3366429,42921282,46287711,11,1,1,5120,6,2403009880
3084,3367160,23590773,26957933,23,2,0,11776,4,6824448645
3085,3367230,24152310,27519540,19,1,0,38912,5,1766988135
3086,3367520,24264929,27632449,19,1,0,1024,5,8191290887
3087,3369140,24611788,27980928,39,3,0,18432,2,10354856837
3088,3372640,23512879,26885519,11,1,0,4608,6,10201012428
3089,3374390,24152372,27526762,4,0,0,12288,14,8613105567
3090,3374730,23923476,27298206,31,3,0,9216,27,6726082603
3091,3376450,24977815,28354265,13,1,0,18432,6,6879123829
3092,3377031,23596503,26973534,25,2,0,13824,4,5722460082
3093,3378200,24720922,28099122,14,1,0,27136,8,2568541074
3094,3378680,23740252,27118932,28,2,0,26112,24,6448811917
3095,3378710,24308387,27687097,26,2,0,23552,29,1454179187
3096,3378760,23700880,27079640,28,2,0,31744,24,4434767078
3097,3379330,42918554,46297884,20,2,1,7680,24,2798912271
3098,3380850,23952448,27333298,13,1,0,5632,6,10590876146
3099,3382540,24357626,27740166,39,3,0,1024,2,7206874716
3100,3385210,23705263,27090473,32,3,0,1024,17,721535262
3101,3386251,24317945,27704196,25,2,0,27136,4,9694652785
3102,3386569,42929848,46316417,18,1,1,9216,13,4420470013
3103,3390771,23696224,27086995,33,3,0,24064,22,10243688133
3104,3391471,42957915,46349386,22,2,1,1024,10,5713697373
3105,3393870,24048333,27442203,16,1,0,82944,10,7960915924
3106,3394050,42956104,46350154,14,1,1,11776,8,997807301
3107,3394981,43496893,46891874,21,2,1,113152,25,841833924
3108,3396539,25010275,28406814,17,1,0,6656,28,8314074761
3109,3396630,23955852,27352482,0,0,0,18432,8,9873472654
3110,3400120,24052134,27452254,24,2,0,12288,10,2604337752
3111,3400580,25101038,28501618,13,1,0,4096,6,1364949628
3112,3401780,24393560,27795340,20,2,0,28672,24,5519481141
3113,3402450,43489447,46891897,29,2,1,22528,26,3038399627
3114,3405130,23981551,27386681,18,1,0,32768,13,3148909834
3115,3405740,25124253,28529993,7,0,0,38400,29,5298114677
3116,3405790,23855571,27261361,28,2,0,8192,24,6204063200
3117,3406340,24490308,27896648,24,2,0,30208,10,1851329480
3118,3406930,43599782,47006712,25,2,1,2048,4,8050049660
3119,3408260,23898893,27307153,1,0,0,12288,26,2796104515
3120,3409150,43598228,47007378,2,0,1,1024,3,8768539623
3121,3409220,24113775,27522995,38,3,0,11264,26,8038758650
3122,3409860,23885515,27295375,19,1,0,1536,5,2206941199
3123,3411830,23928511,27340341,31,3,0,23040,27,9455615694
3124,3412330,24143337,27555667,21,2,0,4096,25,3742340254
3125,3414670,43593374,47008044,24,2,1,1024,10,9283230426
3126,3414770,24185333,27600103,15,1,0,13824,19,3066525274
3127,3415161,43595149,47010310,21,2,1,3584,25,10372002602
3128,3415620,23940785,27356405,38,3,0,12800,26,4327122626
3129,3415710,23981717,27397427,30,3,0,11264,3,3906319685
3130,3416400,24437689,27854089,32,3,0,61440,17,6438169746
3131,3417580,24301746,27719326,35,3,0,7168,8,3178114658
3132,3418010,43594886,47012896,3,0,1,4096,5,2636442575
3133,3418810,24024352,27443162,12,1,0,3072,3,7101159429
3134,3419671,24623680,28043351,9,0,0,30720,12,6983825482
3135,3421230,24256617,27677847,16,1,0,24064,10,2536629508
3136,3424640,24231177,27655817,18,1,0,4608,13,5923414443
3137,3425010,24462388,27887398,3,0,0,32256,5,3390428241
3138,3425710,24314963,27740673,20,2,0,1536,24,1899749481
3139,3426489,43625586,47052075,15,1,1,7168,19,2349380761
3140,3427469,43633700,47061169,11,1,1,3584,6,9942016686
3141,3427540,24680520,28108060,11,1,0,4096,6,3049732710
3142,3427680,24173561,27601241,8,0,0,3072,1,5942841568
3143,3427900,43637683,47065583,14,1,1,1024,8,5892099925
3144,3428641,25303308,28731949,9,0,0,17408,12,1371680366
3145,3429131,43639649,47068780,22,2,1,9728,10,10709438486
3146,3430060,24249838,27679898,32,3,0,6656,17,7895062806
3147,3430330,24219045,27649375,1,0,0,6144,26,7509239365
3148,3430510,24399193,27829703,20,2,0,3584,24,131288629
3149,3432420,24536032,27968452,39,3,0,14848,2,4710136182
3150,3432620,24168956,27601576,6,0,0,1024,24,5985611368
3151,3434570,43634233,47068803,12,1,1,3584,3,3304188311
3152,3435060,24219330,27654390,18,1,0,16384,13,3578312143
3153,3436911,43642429,47079340,26,2,1,7680,29,2975599424
3154,3438920,24165019,27603939,2,0,0,7680,3,7613192723
3155,3442291,43697968,47140259,22,2,1,23552,10,200070640
3156,3442561,24293191,27735752,34,3,0,40960,2,1888936120
3157,3442780,24265183,27707963,22,2,0,12288,10,6109283374
3158,3442990,24375462,27818452,32,3,0,44032,17,1696969844
3159,3443350,24997619,28440969,16,1,0,54272,10,2794301959
3160,3443420,24590548,28033968,27,2,0,61440,9,5739041156
3161,3443680,43744863,47188543,12,1,1,28160,3,7467703896
3162,3443920,24780723,28224643,8,0,0,7168,1,62498714
3163,3444870,24810086,28254956,11,1,0,10240,6,1637599566
3164,3446430,24372513,27818943,16,1,0,1536,10,2497387026
3165,3446730,24010956,27457686,28,2,0,5632,24,9437536399
3166,3447490,24719273,28166763,0,0,0,54272,8,1078267116
3167,3448120,24410516,27858636,35,3,0,14848,8,5615823044
3168,3448250,43748829,47197079,35,3,1,10752,8,2047998709
3169,3449567,24842422,28291989,37,3,0,36864,15,3506526354
3170,3449780,24123095,27572875,0,0,0,5120,8,7154079149
3171,3450800,24319617,27770417,28,2,0,11776,24,365392949
3172,3451350,25605265,29056615,14,1,0,51200,8,8182940243
3173,3454890,24731286,28186176,15,1,0,19456,19,8598647186
3174,3455630,24927374,28383004,30,3,0,35840,3,7069998703
3175,3455880,24446407,27902287,12,1,0,18432,3,908405903
3176,3456560,24876487,28333047,35,3,0,7680,8,4831158087
3177,3459040,24721185,28180225,38,3,0,16384,26,6185738144
3178,3461470,25493780,28955250,21,2,0,49664,25,298527241
3179,3462090,24485536,27947626,15,1,0,68608,19,9894777855
3180,3462221,43807587,47269808,26,2,1,9728,29,69353236
3181,3462949,25074711,28537660,17,1,0,25088,28,10575655062
3182,3463940,43806534,47270474,34,3,1,1024,2,803440386
3183,3466470,24355460,27821930,24,2,0,9728,10,4930824354
3184,3466670,24332437,27799107,2,0,0,12288,3,344956370
3185,3467730,24956680,28424410,20,2,0,45568,24,9888324853
3186,3470570,24851324,28321894,39,3,0,31744,2,7966947250
3187,3473410,24524659,27998069,23,2,0,512,4,10720190769
3188,3473720,44689783,48163503,6,0,1,294912,24,9388593825
3189,3473830,44720815,48194645,24,2,1,20480,10,1048673404
3190,3474529,44722702,48197231,5,0,1,4096,4,3832278604
3191,3475460,24699750,28175210,32,3,0,27648,17,4883089148
3192,3476500,25210590,28687090,12,1,0,37376,3,2096771437
3193,3477000,44722177,48199177,29,2,1,3072,26,1316727777
3194,3477149,44725254,48202403,5,0,1,5120,4,9776537954
3195,3486330,25747016,29233346,29,2,0,36864,26,694594112
3196,3486470,24765343,28251813,2,0,0,34816,3,7836210407
3197,3488160,24882041,28370201,31,3,0,10240,27,6586225237
3198,3488530,44717625,48206155,33,3,1,5632,22,9100931264
3199,3488730,25262758,28751488,3,0,0,5632,5,3395907758
3200,3489890,25293994,28783884,23,2,0,3072,4,7728748453
3201,3490000,44717141,48207141,39,3,1,1536,2,8108350404
3202,3490190,44717297,48207487,14,1,1,512,8,3496695415
3203,3490751,44716992,48207743,30,3,1,9216,3,184308972
3204,3490989,44735717,48226706,4,0,1,11776,14,10416577468
3205,3492810,24657394,28150204,24,2,0,9216,10,8472106087
3206,3492871,25057760,28550631,9,0,0,42496,12,2870139425
3207,3493100,24481195,27974295,15,1,0,17408,19,4796733648
3208,3494480,24832437,28326917,36,3,0,16384,3,9992565833
3209,3496070,24694497,28190567,26,2,0,14336,29,2122139590
3210,3496799,44831042,48327841,23,2,1,12800,4,2695768970
3211,3497250,24765997,28263247,31,3,0,27136,27,6623449872
3212,3498610,44829254,48327864,12,1,1,512,3,3545637181
3213,3499050,44828837,48327887,0,0,1,6144,8,1785217798
3214,3499540,24486465,27986005,21,2,0,3584,25,9126351944
3215,3500070,25421970,28922040,8,0,0,52736,1,7273752207
3216,3500330,24606459,28106789,20,2,0,25088,24,1643124193
3217,3500751,24890544,28391295,33,3,0,27136,22,10293279042
3218,3500921,24555146,28056067,25,2,0,512,4,6575205697
3219,3501259,44841919,48343178,15,1,1,49664,19,10355440266
3220,3502900,44846015,48348915,1,0,1,2560,26,6385476444
3221,3504870,24951113,28455983,30,3,0,18432,3,3415175245
3222,3505920,24539096,28045016,6,0,0,1024,24,3683170217
3223,3507210,25756544,29263754,16,1,0,23040,10,5035358638
3224,3508480,24896237,28404717,36,3,0,35328,3,3151396811
3225,3509330,25505811,29015141,1,0,0,34304,26,2343402061
3226,3510840,25483984,28994824,5,0,0,124416,4,4873043593
3227,3511290,24836738,28348028,28,2,0,8192,24,2636711186
3228,3511940,44862774,48374714,24,2,1,10240,10,3457246864
3229,3513489,44959646,48473135,15,1,1,74752,19,1938049544
3230,3514631,24816053,28330684,9,0,0,12288,12,8646907652
3231,3515031,24985316,28500347,34,3,0,47104,2,7833129682
3232,3516599,44980231,48496830,11,1,1,512,6,349917145
3233,3516870,44979983,48496853,39,3,1,22528,2,1896578183
3234,3517590,25278797,28796387,0,0,0,40960,8,10007706678
3235,3518030,45020902,48538932,28,2,1,14336,24,9906125876
3236,3518080,25833232,29351312,0,0,0,29696,8,1130802511
3237,3522079,45385933,48908012,15,1,1,126976,19,8817705160
3238,3522440,25116906,28639346,2,0,0,38400,3,10674975971
3239,3523690,25897354,29421044,31,3,0,88064,27,5412100155
3240,3525300,45384018,48909318,27,2,1,2048,9,3369313812
3241,3525740,25840849,29366589,13,1,0,20480,6,9948524414
3242,3530890,45405002,48935892,2,0,1,1536,3,6869508894
3243,3531101,25092099,28623200,34,3,0,34304,2,1086959389
3244,3531600,45489386,49020986,0,0,1,7168,8,3200379764
3245,3532860,26215432,29748292,2,0,0,81920,3,3471373862
3246,3535580,25396935,28932515,0,0,0,34304,8,6389574464
3247,3536010,25420859,28956869,16,1,0,3072,10,2418748156
3248,3539030,24919004,28458034,39,3,0,6656,2,1469428978
3249,3539850,25956836,29496686,0,0,0,36864,8,809781812
3250,3541770,45479865,49021635,14,1,1,512,8,1751654280
3251,3542060,26433387,29975447,24,2,0,11264,10,6841200983
3252,3546190,45488420,49034610,9,0,1,3584,12,5072170747
3253,3546310,25458356,29004666,18,1,0,9728,13,6235548955
3254,3546930,24956271,28503201,0,0,0,5120,8,6385293350
3255,3547190,24845376,28392566,32,3,0,4096,17,4295573200
3256,3547510,26292972,29840482,5,0,0,15360,4,809604732
3257,3549190,25585939,29135129,21,2,0,14848,25,2375621508
3258,3552420,45499317,49051737,36,3,1,11264,3,4895259563
3259,3553520,45498240,49051760,35,3,1,10752,8,10097323080
3260,3557810,25256540,28814350,20,2,0,58880,24,9440891920
3261,3558691,25299759,28858450,9,0,0,8704,12,7982427464
3262,3562540,25220385,28782925,7,0,0,78848,29,6621739480
3263,3563220,26575398,30138618,21,2,0,53248,25,195591796
3264,3563490,25026547,28590037,26,2,0,12800,29,9615279375
3265,3563790,25090687,28654477,19,1,0,5120,5,8150051945
3266,3567260,26637062,30204322,24,2,0,11776,10,8955757941
3267,3568960,25371089,28940049,30,3,0,24576,3,2234510305
3268,3569600,25734761,29304361,2,0,0,19968,3,4489484296
3269,3571380,26262461,29833841,7,0,0,13312,29,8077550947
3270,3571721,45480062,49051783,31,3,1,3584,27,8123249638
3271,3573350,25039375,28612725,29,2,0,60416,26,47743367
3272,3577780,45489345,49067125,1,0,1,2560,26,9819136481
3273,3578180,26539222,30117402,21,2,0,49152,25,8064771326
3274,3579670,26378845,29958515,20,2,0,36352,24,7885297707
3275,3580440,25891083,29471523,16,1,0,51200,10,8854268832
3276,3580670,25895111,29475781,13,1,0,12288,6,4074161301
3277,3583659,26647830,30231489,17,1,0,89088,28,4505611189
3278,3585656,26955394,30541050,23,2,0,23552,4,3282136930
3279,3586601,25538288,29124889,33,3,0,14336,22,8978928800
3280,3587040,26117912,29704952,35,3,0,55808,8,2188255320
3281,3587550,25429806,29017356,37,3,0,7168,15,1298609939
3282,3587810,25478968,29066778,27,2,0,33280,9,3364241366
3283,3588409,45478739,49067148,15,1,1,10752,19,7682231551
3284,3589000,25086489,28675489,36,3,0,9216,3,4309797507
3285,3590020,45509655,49099675,33,3,1,512,22,5135840030
3286,3590830,26779444,30370274,23,2,0,21504,4,7639237965
3287,3592400,26196846,29789246,19,1,0,8704,5,4665555373
3288,3592700,25475661,29068361,22,2,0,5120,10,7313745497
3289,3593100,25608680,29201780,5,0,0,47616,4,1361093807
3290,3593850,25566574,29160424,28,2,0,18432,24,10350541850
3291,3595020,25703234,29298254,16,1,0,88576,10,6124527073
3292,3595620,25159903,28755523,27,2,0,3584,9,8821803648
3293,3596210,27154840,30751050,36,3,0,14848,3,1779491430
3294,3596320,27074744,30671064,29,2,0,30720,26,2433261396
3295,3597878,26688653,30286531,22,2,0,31232,10,9803727171
3296,3601240,25834941,29436181,31,3,0,16384,27,10133008489
3297,3601510,25491309,29092819,19,1,0,3072,5,3881228934
3298,3604493,25765239,29369732,30,3,0,10240,3,2078447640
3299,3604949,25396707,29001656,17,1,0,8704,28,4515594990
3300,3606380,26371503,29977883,6,0,0,4608,24,4428687782
3301,3610330,45566850,49177180,6,0,1,23552,24,6063121727
3302,3610769,25429671,29040440,17,1,0,16896,28,1080101912
3303,3612749,25815650,29428399,17,1,0,24064,28,4716388597
3304,3613149,45652225,49265374,15,1,1,46592,19,8735404407
3305,3613461,45869754,49483215,38,3,1,3072,26,4137167688
3306,3614290,25384691,28998981,16,1,0,13312,10,4503090864
3307,3614430,25456294,29070724,2,0,0,7680,3,5738131139
3308,3616000,25592043,29208043,35,3,0,20480,8,3626000620
3309,3617210,25338654,28955864,31,3,0,1536,27,6270099926
3310,3621000,25980680,29601680,2,0,0,55808,3,2051611274
3311,3622271,26184777,29807048,33,3,0,6656,22,1326545690
3312,3622840,25522579,29145419,14,1,0,17920,8,9115369739
3313,3626240,25465620,29091860,20,2,0,9216,24,4598939391
3314,3627580,25827151,29454731,2,0,0,1024,3,10082811140
3315,3627871,46126967,49754838,19,1,1,74752,5,9894338379
3316,3629400,46161818,49791218,33,3,1,18944,22,2800551174
3317,3629870,26874554,30504424,23,2,0,40960,4,3456977459
3318,3630870,25471524,29102394,1,0,0,3584,26,10222662594
3319,3630991,46164413,49795404,38,3,1,6656,26,10105729741
3320,3635070,46162920,49797990,14,1,1,4096,8,9148508166
3321,3636821,46209408,49846229,30,3,1,512,3,4099861026
3322,3639530,46206722,49846252,39,3,1,8704,2,9982817924
3323,3640410,46208282,49848692,27,2,1,7168,9,274822176
3324,3641690,46246053,49887743,24,2,1,13312,10,3153014700
3325,3642220,46249709,49891929,34,3,1,6656,2,625406232
3326,3644420,26556291,30200711,0,0,0,74752,8,1240834854
3327,3645360,26291240,29936600,14,1,0,14336,8,9831975696
3328,3646261,25959654,29605915,33,3,0,13824,22,7366764397
3329,3646360,25537441,29183801,31,3,0,6656,27,9519186984
3330,3646770,26073360,29720130,31,3,0,49664,27,226949851
3331,3647480,25567800,29215280,28,2,0,11264,24,6602740653
3332,3647720,46264992,49912712,2,0,1,22016,3,589469252
3333,3648080,25875147,29523227,16,1,0,16896,10,5497655778
3334,3648810,25704085,29352895,38,3,0,5120,26,5487508646
3335,3649981,27241308,30891289,25,2,0,12800,4,6535398733
3336,3651099,46296966,49948065,18,1,1,22528,13,5858451229
3337,3651271,46312106,49963377,21,2,1,4608,25,7952858213
3338,3655230,26504182,30159412,23,2,0,30208,4,7201552883
3339,3655470,27333977,30989447,23,2,0,30720,4,3474312789
3340,3655650,25578545,29234195,29,2,0,2560,26,3952979331
3341,3657091,25594879,29251970,25,2,0,14336,4,3312831996
3342,3657910,25700944,29358854,26,2,0,19456,29,5321992
3343,3658380,25656317,29314697,36,3,0,2048,3,9922933648
3344,3658500,25995000,29653500,23,2,0,27648,4,2902973135
3345,3661161,46302882,49964043,22,2,1,1024,10,9130061015
3346,3663600,26086991,29750591,32,3,0,7168,17,125994755
3347,3664379,46313935,49978314,5,0,1,23552,4,1548608173
3348,3664730,25766344,29431074,3,0,0,8704,5,10144865412
3349,3665280,25728909,29394189,8,0,0,10240,1,1232701612
3350,3665290,26969380,30634670,8,0,0,27648,1,7374484568
3351,3666961,25776419,29443380,9,0,0,23552,12,9959150733
3352,3667550,26052782,29720332,3,0,0,512,5,5003871239
3353,3667920,26566203,30234123,19,1,0,1024,5,7662137010
3354,3668040,25916613,29584653,16,1,0,28160,10,1868681888
3355,3668760,26801550,30470310,12,1,0,33792,3,6234344963
3356,3669100,25802914,29472014,10,1,0,1536,4,9347583516
3357,3669360,26198064,29867424,13,1,0,36864,6,7938261203
3358,3670610,27374853,31045463,32,3,0,53248,17,8197259796
3359,3671031,26723469,30394500,33,3,0,69632,22,8195227291
3360,3671630,46376030,50047660,1,0,1,31232,26,4796007886
3361,3671890,26505976,30177866,6,0,0,60416,24,1808823266
3362,3673680,25982674,29656354,1,0,0,3584,26,6880896231
3363,3674211,46425104,50099315,10,1,1,18432,4,1486681226
3364,3676900,46422761,50099661,12,1,1,512,3,713085959
3365,3678710,46424817,50103527,17,1,1,6144,28,9228463768
3366,3679140,25976099,29655239,39,3,0,5632,2,8702900076
3367,3680080,46431936,50112016,34,3,1,7680,2,1479385645
3368,3680320,25927498,29607818,35,3,0,6144,8,7571651872
3369,3680630,25962656,29643286,8,0,0,35840,1,2971383122
3370,3683090,26674338,30357428,39,3,0,27136,2,6900199046
3371,3683941,25853704,29537645,9,0,0,35840,12,7088941963
3372,3687281,26305372,29992653,33,3,0,29184,22,6155905119
3373,3689141,46423951,50113092,7,0,1,13312,29,7483732
3374,3690210,26139552,29829762,1,0,0,18432,26,5196843513
3375,3690610,46427148,50117758,14,1,1,14336,8,6289099475
3376,3690980,25826631,29517611,10,1,0,14336,4,8769597116
3377,3691330,27414674,31106004,20,2,0,13824,24,4658447228
3378,3692280,26245279,29937559,15,1,0,3072,19,1976116688
3379,3693570,26190606,29884176,7,0,0,19456,29,6234354365
3380,3693810,26456375,30150185,19,1,0,37888,5,10341308033
3381,3694740,26962043,30656783,24,2,0,23040,10,7883108979
3382,3697160,26063750,29760910,18,1,0,33792,13,9337111981
3383,3697660,27482594,31180254,15,1,0,12288,19,946232935
3384,3698050,26847990,30546040,38,3,0,2048,26,2161124410
3385,3698130,46446295,50144425,20,2,1,8192,24,6282847863
3386,3698201,26234008,29932209,9,0,0,47104,12,9261164675
3387,3698890,26578102,30276992,35,3,0,23552,8,3663601905
3388,3702200,46458949,50161149,14,1,1,6144,8,3084209883
3389,3702970,26354327,30057297,24,2,0,11776,10,8584208580
3390,3704230,26787691,30491921,24,2,0,52736,10,10689441937
3391,3705650,46458405,50164055,9,0,1,4608,12,4572027112
3392,3706380,26934622,30641002,38,3,0,3072,26,3757407282
3393,3706570,26110294,29816864,0,0,0,3584,8,1856947255
3394,3707280,27138355,30845635,22,2,0,3072,10,3970422844
3395,3707680,46459281,50166961,36,3,1,4608,3,10543476059
3396,3709450,26319697,30029147,12,1,0,41472,3,5577326251
3397,3709520,26408685,30118205,21,2,0,2560,25,9334271501
3398,3710131,26301912,30012043,34,3,0,37376,2,8093484270
3399,3711980,46519003,50230983,25,2,1,26112,4,2333375080
3400,3712170,26302891,30015061,8,0,0,9728,1,5216656733
3401,3713030,27649622,31362652,19,1,0,46080,5,631886164
3402,3713120,27093574,30806694,21,2,0,4096,25,456645120
3403,3713610,26229367,29942977,37,3,0,17408,15,7188357155
3404,3714300,26804545,30518845,16,1,0,11264,10,10724708817
3405,3715400,46516276,50231676,1,0,1,2048,26,7487280287
3406,3715759,46515940,50231699,5,0,1,12288,4,404893223
3407,3716260,26284372,30000632,20,2,0,26112,24,10001385402
3408,3718100,26540428,30258528,8,0,0,49152,1,3480212922
3409,3718860,26176949,29895809,6,0,0,3072,24,6283243111
3410,3720289,46591104,50311393,4,0,1,8192,14,10035152123
3411,3720960,27186372,30907332,38,3,0,35840,26,4917343209
3412,3721990,26641701,30363691,13,1,0,20480,6,8678850549
3413,3722190,26511373,30233563,23,2,0,4608,4,9780745069
3414,3722890,27164476,30887366,1,0,0,45056,26,3964908004
3415,3723040,26377318,30100358,10,1,0,3072,4,8204292399
3416,3724681,27495958,31220639,34,3,0,20992,2,4238042996
3417,3725230,46608391,50333621,33,3,1,30208,22,4518499168
3418,3725440,46698317,50423757,16,1,1,512,10,3116661529
3419,3726060,27068633,30794693,28,2,0,76288,24,7153830553
3420,3726371,26290117,30016488,25,2,0,4608,4,2762771239
3421,3726600,27010379,30736979,7,0,0,14336,29,10477416071
3422,3727930,26851741,30579671,23,2,0,14336,4,7813766882
3423,3728550,26958405,30686955,0,0,0,51200,8,1326604457
3424,3728880,27735755,31464635,5,0,0,23040,4,3145193050
3425,3730810,27416719,31147529,30,3,0,29184,3,9457796427
3426,3730920,26844360,30575280,32,3,0,39424,17,8844646408
3427,3731111,46707075,50438186,38,3,1,24576,26,3634119366
3428,3731170,46763050,50494220,33,3,1,11776,22,3736377045
3429,3731330,46804451,50535781,33,3,1,12288,22,2414467638
3430,3732030,26505392,30237422,29,2,0,10752,26,4140298292
3431,3733040,26500702,30233742,26,2,0,512,29,9043036038
3432,3733510,26970936,30704446,4,0,0,9216,14,8451055482
3433,3733700,46806267,50539967,27,2,1,6656,9,9023579707
3434,3735110,27214494,30949604,26,2,0,11264,29,580795597
3435,3736160,26495976,30232136,27,2,0,2048,9,6651388613
3436,3737140,27242835,30979975,5,0,0,8192,4,1993132824
3437,3737430,26506099,30243529,31,3,0,19968,27,52893804
3438,3737990,26611147,30349137,7,0,0,29696,29,4230444200
3439,3738110,46854791,50592901,13,1,1,1024,6,930375273
3440,3739800,26657925,30397725,38,3,0,1536,26,1387608626
3441,3743850,26771517,30515367,27,2,0,35840,9,5850572323
3442,3745130,26881093,30626223,16,1,0,52224,10,1643342230
3443,3745510,26987078,30732588,4,0,0,29184,14,5587643907
3444,3746570,28208346,31954916,14,1,0,157696,8,430187598
3445,3746630,46847142,50593772,0,0,1,12288,8,5165953595
3446,3747340,27899859,31647199,21,2,0,52224,25,10269599344
3447,3747400,28073407,31820807,11,1,0,35328,6,5340630871
3448,3747490,46916421,50663911,35,3,1,6144,8,5596946599
3449,3748260,26625001,30373261,22,2,0,9728,10,10059879503
3450,3748370,46915564,50663934,29,2,1,5632,26,10198661823
3451,3748851,27191988,30940839,25,2,0,33280,4,6028682779
3452,3750069,46992925,50742994,23,2,1,14336,4,3612493869
3453,3753230,27177446,30930676,0,0,0,23552,8,9917693371
3454,3753480,26674001,30427481,22,2,0,2560,10,576706233
3455,3754710,47036569,50791279,13,1,1,23040,6,5578742018
3456,3754750,27310883,31065633,5,0,0,43008,4,957342907
3457,3755890,27084544,30840434,1,0,0,27136,26,1979839476
3458,3758459,47038122,50796581,11,1,1,8192,6,5255313694
3459,3758680,27478050,31236730,24,2,0,52736,10,7484472211
3460,3759200,47080794,50839994,13,1,1,512,6,3361708507
3461,3761220,27712665,31473885,0,0,0,12800,8,5451190969
3462,3761331,47079741,50841072,10,1,1,17920,4,4852564285
3463,3761381,47138411,50899792,26,2,1,10752,29,5824768029
3464,3761860,27290646,31052506,7,0,0,23040,29,7307778260
3465,3762941,47158714,50921655,21,2,1,9216,25,2975067197
3466,3768110,27646147,31414257,32,3,0,17920,17,3577428451
3467,3769490,47221160,50990650,9,0,1,12800,12,4887869608
3468,3769510,27502637,31272147,30,3,0,17920,3,7735896595
3469,3769820,27490558,31260378,7,0,0,18432,29,5123300326
3470,3773070,27243140,31016210,6,0,0,57344,24,458345338
3471,3774690,27627619,31402309,8,0,0,70144,1,7218745724
3472,3778920,27166809,30945729,19,1,0,6656,5,4578942429
3473,3779390,27214351,30993741,24,2,0,6144,10,7410091216
3474,3781620,26858423,30640043,0,0,0,17408,8,9000571424
3475,3782680,27305284,31087964,19,1,0,73216,5,9537330882
3476,3783496,27535954,31319450,20,2,0,13824,24,10370807568
3477,3783590,27013622,30797212,24,2,0,8192,10,10264475946
3478,3783721,27471018,31254739,33,3,0,27648,22,6644643407
3479,3784100,27482564,31266664,21,2,0,12288,25,8868147810
3480,3785240,47224580,51009820,0,0,1,8192,8,3854322441
3481,3787230,27312800,31100030,0,0,0,20992,8,2250050494
3482,3787501,47222342,51009843,21,2,1,3584,25,1879977272
3483,3787720,47248775,51036495,16,1,1,2560,10,2151319336
3484,3787760,26607387,30395147,30,3,0,2048,3,10607290835
3485,3790130,27038536,30828666,11,1,0,5632,6,2388566298
3486,3791340,28219217,32010557,35,3,0,1536,8,8178102619
3487,3791960,27690684,31482644,1,0,0,28672,26,10584570013
3488,3792330,27380234,31172564,19,1,0,14848,5,1195128802
3489,3795680,27447157,31242837,1,0,0,19968,26,3557336221
3490,3795719,47240799,51036518,8,0,1,3584,1,1398930903
3491,3795819,47240722,51036541,4,0,1,10240,14,4592667281
3492,3796290,47281524,51077814,20,2,1,15872,24,2784245377
3493,3800810,26998297,30799107,11,1,0,6144,6,5593663709
3494,3805630,27542959,31348589,22,2,0,55296,10,8442024814
3495,3807060,27936885,31743945,11,1,0,31744,6,6677567430
3496,3808290,47269757,51078047,14,1,1,2048,8,10430596262
3497,3809360,27311299,31120659,24,2,0,8192,10,7663934681
3498,3809470,27660492,31469962,2,0,0,17408,3,138637631
3499,3809980,27103303,30913283,26,2,0,19456,29,3234534336
3500,3810530,27112947,30923477,29,2,0,6656,26,9957606570
3501,3810940,28512277,32323217,11,1,0,125952,6,1939646664
3502,3811680,27205801,31017481,28,2,0,4096,24,1581026567
3503,3812130,27817239,31629369,29,2,0,24576,26,6423809774
3504,3812720,27920760,31733480,16,1,0,29184,10,1972125669
3505,3813211,27680430,31493641,33,3,0,11264,22,6063395161
3506,3815000,47265953,51080953,6,0,1,4608,24,4218332455
3507,3815760,27634951,31450711,4,0,0,1024,14,1695853319
3508,3816270,27127408,30943678,10,1,0,9216,4,5366171228
3509,3816510,27104916,30921426,23,2,0,26624,4,3295205254
3510,3816570,28153726,31970296,28,2,0,25088,24,6321591217
3511,3816911,27498304,31315215,9,0,0,14336,12,6917081284
3512,3821050,27664269,31485319,10,1,0,8704,4,5076954035
3513,3821570,27788713,31610283,36,3,0,32768,3,770255317
3514,3822050,27424242,31246292,18,1,0,11264,13,10332761615
3515,3824620,28362628,32187248,31,3,0,16896,27,2794812653
3516,3824729,47299216,51123945,8,0,1,22016,1,1225169319
3517,3825251,27351236,31176487,33,3,0,12800,22,9751110329
3518,3825460,27149711,30975171,22,2,0,13312,10,8550255148
3519,3827480,27274289,31101769,1,0,0,5632,26,3403946289
3520,3828669,47329567,51158236,37,3,1,1536,15,9010938644
3521,3830150,27717251,31547401,12,1,0,9728,3,2784541691
3522,3830380,27276271,31106651,30,3,0,2048,3,2131324898
3523,3831470,28130356,31961826,29,2,0,20480,26,3377660133
3524,3831490,27159696,30991186,36,3,0,5632,3,6721898057
3525,3835679,47322580,51158259,4,0,1,1024,14,4349324706
3526,3837040,27425857,31262897,21,2,0,8192,25,6443662497
3527,3837110,27256493,31093603,39,3,0,18432,2,8145030795
3528,3837440,28214479,32051919,13,1,0,19456,6,3282955483
3529,3838630,47319652,51158282,20,2,1,10240,24,4808441199
3530,3839290,27666680,31505970,3,0,0,2048,5,6651915942
3531,3840939,47349962,51190901,5,0,1,4608,4,8956921008
3532,3841890,47356985,51198875,3,0,1,30208,5,2967775640
3533,3842060,27529739,31371799,15,1,0,9216,19,10084223502
3534,3843830,28336506,32180336,10,1,0,51712,4,3517710706
3535,3850421,27304931,31155352,33,3,0,25600,22,7566241638
3536,3850770,27863149,31713919,19,1,0,71168,5,181068552
3537,3851280,47377199,51228479,33,3,1,17408,22,360696340
3538,3852680,28545615,32398295,36,3,0,13312,3,176572769
3539,3852960,27778304,31631264,5,0,0,6144,4,7545192230
3540,3854890,28051955,31906845,4,0,0,34304,14,4783141112
3541,3855721,28420668,32276389,9,0,0,14848,12,10412179892
3542,3855970,28251527,32107497,35,3,0,30208,8,3675708445
3543,3857099,47371403,51228502,18,1,1,1536,13,1201170672
3544,3859181,47509854,51369035,7,0,1,20992,29,5577011743
3545,3860610,27789272,31649882,0,0,0,8704,8,7637279064
3546,3862110,27894962,31757072,29,2,0,43008,26,9262268886
3547,3862949,47507072,51370021,11,1,1,1536,6,2022183632
3548,3863040,28146972,32010012,24,2,0,73216,10,1669986052
3549,3863090,28099539,31962629,2,0,0,2560,3,1167598826
3550,3867350,27719699,31587049,18,1,0,13824,13,335554567
3551,3867600,47502767,51370367,24,2,1,512,10,8552526201
3552,3868211,27978003,31846214,9,0,0,19968,12,3654503911
3553,3870360,28117321,31987681,39,3,0,35840,2,10337146992
3554,3872580,27658482,31531062,12,1,0,13824,3,5825433233
3555,3873251,47503429,51376680,21,2,1,3072,25,5561929076
3556,3873280,27532039,31405319,28,2,0,9728,24,9187640887
3557,3873730,28344041,32217771,26,2,0,20480,29,2898455641
3558,3874830,27615348,31490178,0,0,0,15872,8,5852287928
3559,3875730,48047004,51922734,9,0,1,57344,12,1659001201
3560,3876220,28145836,32022056,10,1,0,30720,4,9437859656
3561,3878030,27396168,31274198,2,0,0,6656,3,2756498369
3562,3878150,27992418,31870568,28,2,0,4608,24,2872723591
3563,3878440,28378228,32256668,36,3,0,66048,3,8553858039
3564,3878550,48044207,51922757,34,3,1,15872,2,10344666093
3565,3879130,27657872,31537002,12,1,0,3072,3,5905802164
3566,3879270,28737052,32616322,1,0,0,23040,26,8863333723
3567,3883460,27738390,31621850,8,0,0,37888,1,7080946488
3568,3885510,28483258,32368768,22,2,0,61952,10,7210141530
3569,3887210,28272529,32159739,18,1,0,1024,13,9801727599
3570,3887621,48044097,51931718,26,2,1,10240,29,3188559352
3571,3889100,28524470,32413570,29,2,0,11264,26,2233810382
3572,3889949,48047587,51937536,4,0,1,9728,14,7952629535
3573,3892260,28253168,32145428,6,0,0,124416,24,3121247885
3574,3892320,27541485,31433805,2,0,0,9216,3,250017741
3575,3893630,28634486,32528116,18,1,0,28160,13,9722634449
3576,3894950,48053887,51948837,24,2,1,2048,10,9604372381
3577,3895340,28523235,32418575,12,1,0,14336,3,6795343984
3578,3898480,48055239,51953719,25,2,1,7680,4,5625426791
3579,3898760,28282863,32181623,29,2,0,4096,26,3993378838
3580,3899871,27508903,31408774,9,0,0,11264,12,5952611520
3581,3900040,28311468,32211508,13,1,0,16896,6,7041768641
3582,3901180,28435591,32336771,38,3,0,38400,26,6520244362
3583,3902470,27632429,31534899,2,0,0,7168,3,10322578365
3584,3903370,28985599,32888969,36,3,0,72704,3,4023453484
3585,3904220,28287107,32191327,31,3,0,13312,27,9629924783
3586,3905081,28599485,32504566,34,3,0,103936,2,5467725191
3587,3905910,28839350,32745260,29,2,0,47616,26,5665911639
3588,3908050,28146331,32054381,30,3,0,2048,3,7534459748
3589,3908210,28068505,31976715,11,1,0,20992,6,2117300776
3590,3909449,48092145,52001594,5,0,1,22528,4,6502033327
3591,3911510,28937981,32849491,13,1,0,51712,6,3461071052
3592,3912000,28412956,32324956,24,2,0,5632,10,3525774353
3593,3912730,28251735,32164465,15,1,0,13312,19,9433935148
3594,3912810,28464873,32377683,30,3,0,29184,3,315677510
3595,3912970,48144783,52057753,35,3,1,3072,8,4052807471
3596,3913130,28910396,32823526,22,2,0,156672,10,2849768249
3597,3913400,29100903,33014303,28,2,0,8192,24,6510297820
3598,3913600,28559275,32472875,8,0,0,31232,1,4577342535
3599,3914250,28660834,32575084,36,3,0,20480,3,5983456522
3600,3914810,28508624,32423434,29,2,0,15872,26,2798959283
3601,3914840,28243449,32158289,3,0,0,35840,5,3000169785
3602,3914960,29003488,32918448,6,0,0,44032,24,3046337715
3603,3915361,29048865,32964226,25,2,0,50688,4,8160343263
3604,3916750,28724979,32641729,12,1,0,23040,3,3947540060
3605,3921280,28034283,31955563,20,2,0,2048,24,4047220487
3606,3922250,29579354,33501604,27,2,0,15872,9,6645759478
3607,3922981,48134795,52057776,21,2,1,11776,25,722127516
3608,3923020,28348822,32271842,22,2,0,36352,10,1282212905
3609,3924530,28980479,32905009,11,1,0,13312,6,4351236381
3610,3925639,48132168,52057807,11,1,1,512,6,5723600924
3611,3926780,28096531,32023311,0,0,0,2048,8,4272058117
3612,3928720,27903579,31832299,22,2,0,26112,10,108131469
3613,3928960,28577726,32506686,7,0,0,6656,29,5002259383
3614,3930911,29170197,33101108,25,2,0,19968,4,5115342959
3615,3932090,28228296,32160386,15,1,0,2048,19,3493997623
3616,3932091,48189800,52121891,30,3,1,14336,3,6156475496
3617,3934490,48187424,52121914,12,1,1,1024,3,5368577673
3618,3935010,48186927,52121937,25,2,1,4608,4,1359679945
3619,3935050,29248087,33183137,24,2,0,15360,10,9461821004
3620,3936300,29190983,33127283,5,0,0,5632,4,890679894
3621,3937129,48185714,52122843,8,0,1,1536,1,10517903219
3622,3938430,29178948,33117378,4,0,0,45568,14,7798724322
3623,3938580,28140654,32079234,4,0,0,9216,14,1569943459
3624,3938970,28786900,32725870,18,1,0,35840,13,2154675607
3625,3940270,29735734,33676004,6,0,0,32768,24,3991520237
3626,3940390,29373270,33313660,30,3,0,7680,3,3660405625
3627,3940900,28668379,32609279,21,2,0,85504,25,4529117075
3628,3942410,48214373,52156783,12,1,1,13824,3,656215657
3629,3942850,28204496,32147346,18,1,0,6144,13,5305962932
3630,3943101,29308514,33251615,33,3,0,2048,22,8595873380
3631,3943140,28083478,32026618,35,3,0,1024,8,6511736258
3632,3944890,28214514,32159404,23,2,0,3584,4,551977058
3633,3945991,28594324,32540315,34,3,0,20480,2,7184795517
3634,3946481,28567428,32513909,34,3,0,23552,2,2956000197
3635,3952160,29485058,33437218,15,1,0,29696,19,8358300857
3636,3952400,28881312,32833712,1,0,0,18432,26,3742705777
3637,3953750,29521778,33475528,6,0,0,3072,24,7667968987
3638,3954189,48203900,52158089,8,0,1,2048,1,5346003577
3639,3955370,29126036,33081406,6,0,0,93696,24,2210781496
3640,3955371,48217040,52172411,30,3,1,14336,3,5744740498
3641,3956200,48216234,52172434,12,1,1,1536,3,4059841066
3642,3956370,29689324,33645694,6,0,0,56320,24,7988295524
3643,3956540,28678146,32634686,39,3,0,48128,2,106382825
3644,3957330,29160695,33118025,14,1,0,2048,8,4065417963
3645,3959590,28989169,32948759,39,3,0,40960,2,4428137313
3646,3959820,29813348,33773168,7,0,0,36864,29,4519946432
3647,3961910,29174048,33135958,0,0,0,1024,8,9497760971
3648,3962140,48210317,52172457,3,0,1,2048,5,4179068439
3649,3966940,28899060,32866000,23,2,0,5632,4,2401998531
3650,3967780,29127221,33095001,2,0,0,44544,3,2805320304
3651,3969950,28930980,32900930,32,3,0,12288,17,7639293732
3652,3970071,48295635,52265706,10,1,1,24064,4,4609464403
3653,3970300,28696177,32666477,22,2,0,10752,10,7341324745
3654,3970611,29471466,33442077,9,0,0,15872,12,1226031706
3655,3971890,29983866,33955756,6,0,0,80896,24,7006436776
3656,3972450,30195502,34167952,36,3,0,19456,3,5881668842
3657,3973360,29038416,33011776,5,0,0,54272,4,7542672996
3658,3975650,28755079,32730729,39,3,0,15872,2,4268432927
3659,3975750,29761060,33736810,3,0,0,27648,5,6896911242
3660,3978420,30281932,34260352,10,1,0,28160,4,9707933440
3661,3980726,29149203,33129929,38,3,0,2048,26,7472597595
3662,3981840,28448895,32430735,3,0,0,4096,5,6080621968
3663,3981911,28846162,32828073,9,0,0,14848,12,1213764104
3664,3982050,48286242,52268292,33,3,1,4096,22,6920245475
3665,3983840,29141704,33125544,27,2,0,24576,9,6740758574
3666,3984620,28868178,32852798,7,0,0,10752,29,127014450
3667,3984890,48283748,52268638,16,1,1,512,10,7808497122
3668,3989380,29242088,33231468,29,2,0,38400,26,9854422970
3669,3989580,29170025,33159605,21,2,0,8704,25,6700086369
3670,3993750,29502995,33496745,10,1,0,41984,4,7692547946
3671,3994330,29000879,32995209,1,0,0,41984,26,5258287102
3672,3994371,29047199,33041570,34,3,0,9728,2,10164425012
3673,3995100,28780667,32775767,28,2,0,11264,24,5602202012
3674,3997461,29313836,33311297,25,2,0,45568,4,2254146069
3675,3998610,28983784,32982394,7,0,0,23552,29,9002269122
3676,3999080,29237403,33236483,21,2,0,16384,25,7153786450
3677,3999881,29872553,33872434,9,0,0,112640,12,6002175881
3678,3999940,28674409,32674349,39,3,0,512,2,709977767
3679,4000820,48276120,52276940,9,0,1,20992,12,6393281041
3680,4002470,29387313,33389783,8,0,0,4608,1,10544672115
3681,4003120,30361296,34364416,31,3,0,72192,27,2964504590
3682,4003190,29028564,33031754,2,0,0,12800,3,3252919090
3683,4004170,28931892,32936062,19,1,0,2560,5,6177453781
3684,4004530,29048305,33052835,7,0,0,14336,29,5034497930
3685,4005000,29783105,33788105,11,1,0,23040,6,1140838508
3686,4005151,29974074,33979225,34,3,0,47104,2,6376176582
3687,4009610,29268818,33278428,39,3,0,44032,2,9947101597
3688,4010540,28920830,32931370,13,1,0,17408,6,8696058561
3689,4010541,30024747,34035288,33,3,0,3072,22,5148569338
3690,4010790,30119779,34130569,0,0,0,2560,8,1842119902
3691,4010799,48297727,52308526,18,1,1,1024,13,2223510421
3692,4011510,29997759,34009269,5,0,0,47616,4,3836857644
3693,4017770,29349970,33367740,4,0,0,29696,14,7318148780
3694,4017961,48290588,52308549,22,2,1,512,10,9528162469
3695,4018320,29085151,33103471,28,2,0,7680,24,10559036371
3696,4020500,30195193,34215693,20,2,0,10240,24,5108700875
3697,4020799,48576684,52597483,15,1,1,70656,19,9614960883
3698,4020879,48578990,52599869,5,0,1,6144,4,5567008844
3699,4021750,48666977,52688727,24,2,1,1536,10,4029322569
3700,4022720,29643277,33665997,35,3,0,66560,8,5174971750
3701,4023311,49054189,53077500,19,1,1,99328,5,2761397782
3702,4023880,29873606,33897486,21,2,0,28672,25,4167398843
3703,4025889,49064605,53090494,5,0,1,4608,4,10571286217
3704,4026860,29691340,33718200,13,1,0,20992,6,8052416499
3705,4027419,49063098,53090517,4,0,1,5632,14,8196653056
3706,4029050,29585621,33614671,18,1,0,40448,13,1183296474
3707,4029690,29859037,33888727,18,1,0,13824,13,128165212
3708,4029910,29503915,33533825,28,2,0,22528,24,9663179104
3709,4030980,29139240,33170220,14,1,0,6656,8,7293589579
3710,4033100,28939179,32972279,30,3,0,10752,3,3576588342
3711,4033219,49061959,53095178,5,0,1,6656,4,3976875166
3712,4033450,30089443,34122893,36,3,0,13312,3,5895016021
3713,4036650,30645086,34681736,31,3,0,4096,27,10685732858
3714,4037091,49058753,53095844,7,0,1,1024,29,4254580944
3715,4040280,29359703,33399983,36,3,0,17920,3,1258813820
3716,4040730,30935284,34976014,12,1,0,110592,3,2724731703
3717,4041379,49056987,53098366,15,1,1,12800,19,5399913100
3718,4041551,49202357,53243908,26,2,1,11776,29,4314279424
3719,4041940,30030757,34072697,10,1,0,68096,4,10343588088
3720,4043350,28929576,32972926,14,1,0,2048,8,1190865404
3721,4043440,49206432,53249872,13,1,1,3072,6,7695140747
3722,4044550,29357952,33402502,39,3,0,8192,2,717660302
3723,4045100,29131509,33176609,19,1,0,1024,5,243456956
3724,4045161,49259455,53304616,30,3,1,3072,3,5898178844
3725,4045920,30166630,34212550,4,0,0,32256,14,4522007019
3726,4047000,30200350,34247350,20,2,0,34304,24,9583176692
3727,4049630,29453557,33503187,29,2,0,5120,26,8032807377
3728,4050460,29096852,33147312,13,1,0,2048,6,1834403676
3729,4050630,31025626,35076256,28,2,0,101376,24,6089929199
3730,4050710,30286189,34336899,29,2,0,22016,26,8387919097
3731,4051640,29360447,33412087,15,1,0,31232,19,7666056223
3732,4051790,31125870,35177660,1,0,0,45056,26,5459731649
3733,4054990,30270501,34325491,16,1,0,13824,10,207297521
3734,4055250,31257922,35313172,29,2,0,24064,26,9452760857
3735,4055980,29966104,34022084,31,3,0,41984,27,7431079032
3736,4056641,29277511,33334152,9,0,0,40448,12,9214293486
3737,4058290,49249232,53307522,39,3,1,4608,2,4844265282
3738,4060719,49366625,53427344,8,0,1,28160,1,6143935764
3739,4062030,29755841,33817871,28,2,0,8704,24,7971395152
3740,4062660,29539664,33602324,23,2,0,3584,4,7831546709
3741,4063801,49452808,53516609,30,3,1,7168,3,1312729710
3742,4064240,30509341,34573581,29,2,0,31232,26,943810482
3743,4064630,29289060,33353690,29,2,0,2560,26,3400636742
3744,4066880,29616635,33683515,8,0,0,24576,1,4600547268
3745,4067930,30351585,34419515,22,2,0,26624,10,381913282
3746,4068031,49555510,53623541,19,1,1,49152,5,1108045224
3747,4069120,29960171,34029291,31,3,0,23552,27,2740982677
3748,4069130,29621162,33690292,10,1,0,22016,4,5817163855
3749,4071710,49559962,53631672,24,2,1,11776,10,3730735953
3750,4071860,29632204,33704064,7,0,0,19968,29,1174387400
3751,4072330,29727979,33800309,2,0,0,37888,3,7645463832
3752,4073450,49559528,53632978,16,1,1,2048,10,10690567213
3753,4073690,49560261,53633951,9,0,1,12800,12,3503025621
3754,4075330,29673918,33749248,21,2,0,22016,25,8964074959
3755,4076350,49576469,53652819,3,0,1,2560,5,4792259318
3756,4076640,30504787,34581427,15,1,0,23040,19,408387833
3757,4076790,30301241,34378031,14,1,0,25600,8,5731764801
3758,4078630,29852455,33931085,35,3,0,36352,8,8385241972
3759,4078860,29885990,33964850,5,0,0,29696,4,6951478032
3760,4080331,30122010,34202341,25,2,0,107008,4,4803504926
3761,4081530,29802962,33884492,38,3,0,3072,26,3122854881
3762,4082211,31378697,35460908,34,3,0,17920,2,9463448321
3763,4083350,29645013,33728363,1,0,0,33280,26,10730036108
3764,4085380,29721660,33807040,11,1,0,22016,6,6850044578
3765,4085460,30435645,34521105,6,0,0,16384,24,8176813435
3766,4085970,29895618,33981588,35,3,0,7680,8,344779666
3767,4086170,29723397,33809567,32,3,0,8192,17,5566506136
3768,4086331,49566511,53652842,10,1,1,5120,4,4452896254
3769,4086690,49566666,53653356,24,2,1,2048,10,3904378646
3770,4086920,29944734,34031654,3,0,0,7680,5,3238805585
3771,4087610,29964316,34051926,30,3,0,9216,3,1599899697
3772,4089431,49563948,53653379,26,2,1,1024,29,6114842586
3773,4090870,30385880,34476750,19,1,0,29696,5,4787208752
3774,4090880,49562522,53653402,36,3,1,512,3,5421545120
3775,4090920,30141721,34232641,23,2,0,15360,4,2382099094
3776,4091250,30013331,34104581,1,0,0,38912,26,10337243164
3777,4094730,29667183,33761913,0,0,0,9728,8,526907195
3778,4096550,29898188,33994738,0,0,0,12288,8,797552049
3779,4098630,49556041,53654671,14,1,1,3584,8,5505938012
3780,4099220,31485800,35585020,1,0,0,30208,26,573315843
3781,4100610,29982286,34082896,15,1,0,18432,19,3519334561
3782,4101390,30414692,34516082,38,3,0,4608,26,4615304820
3783,4101969,30608002,34709971,17,1,0,80896,28,8182579558
3784,4102390,49587527,53689917,29,2,1,4608,26,8682306666
3785,4102420,30617870,34720290,22,2,0,33792,10,117824745
3786,4102760,29932871,34035631,20,2,0,1024,24,10378733492
3787,4103970,30716990,34820960,10,1,0,8192,4,4741292923
3788,4104010,49588245,53692255,39,3,1,6656,2,3656185629
3789,4105120,30306260,34411380,3,0,0,33280,5,9161750199
3790,4106480,49609236,53715716,20,2,1,1024,24,3385088969
3791,4106690,30904291,35010981,8,0,0,114688,1,9056465109
3792,4106880,29927449,34034329,39,3,0,8704,2,5414166577
3793,4107310,30572820,34680130,13,1,0,10240,6,2499004622
3794,4107880,29775653,33883533,4,0,0,36352,14,2128774890
3795,4108290,30913189,35021479,7,0,0,29696,29,1445802998
3796,4111460,30655362,34766822,13,1,0,33280,6,8546993448
3797,4111740,49646577,53758317,16,1,1,4608,10,4586364627
3798,4111831,30909827,35021658,33,3,0,512,22,9144960251
3799,4112691,30124184,34236875,33,3,0,8192,22,9674770299
3800,4113540,30749057,34862597,5,0,0,48640,4,5872142017
3801,4114470,30163321,34277791,18,1,0,3584,13,10285019600
3802,4114490,30568385,34682875,11,1,0,3584,6,6794595465
3803,4114541,30562446,34676987,1,0,0,23552,26,10316070249
3804,4115500,29975654,34091154,12,1,0,22016,3,2436929289
3805,4115690,30112248,34227938,26,2,0,4608,29,4357240218
3806,4118291,31538747,35657038,9,0,0,90624,12,5319657748
3807,4119310,30990976,35110286,22,2,0,15872,10,2238838366
3808,4119790,29871181,33990971,29,2,0,30720,26,3161875304
3809,4120110,49638230,53758340,32,3,1,9728,17,6633139397
3810,4120670,30049044,34169714,7,0,0,5632,29,2349748200
3811,4121450,30279767,34401217,27,2,0,34304,9,6822752903
3812,4122620,30142302,34264922,32,3,0,3584,17,9131046920
3813,4122810,31016125,35138935,4,0,0,35328,14,1356081353
3814,4122860,49635503,53758363,13,1,1,5632,6,5862123937
3815,4123170,31329290,35452460,15,1,0,13824,19,10422335956
3816,4124180,31088961,35213141,36,3,0,26624,3,480507195
3817,4124810,49633576,53758386,20,2,1,9216,24,5006657419
3818,4126650,49709702,53836352,16,1,1,12800,10,5601761678
3819,4127650,31156735,35284385,16,1,0,52224,10,9107237081
3820,4132601,30406286,34538887,9,0,0,16384,12,8040688304
3821,4133740,30130067,34263807,2,0,0,11264,3,2321637504
3822,4134260,30160250,34294510,21,2,0,10240,25,9564900611
3823,4135000,30091503,34226503,20,2,0,9728,24,9016245904
3824,4136120,30201114,34337234,30,3,0,1024,3,8848016240
3825,4136490,31607081,35743571,36,3,0,78848,3,784613480
3826,4136950,30096338,34233288,14,1,0,2048,8,5592513108
3827,4137710,30064966,34202676,31,3,0,1024,27,10320631200
3828,4138150,49698225,53836375,16,1,1,15872,10,3744641791
3829,4138520,30989628,35128148,15,1,0,13312,19,327173518
3830,4140550,30082966,34223516,29,2,0,25600,26,8754917983
3831,4140700,29932176,34072876,27,2,0,512,9,2291113824
3832,4140750,30752777,34893527,7,0,0,16896,29,10122890500
3833,4141450,30012906,34154356,11,1,0,6144,6,957409748
3834,4142421,30387211,34529632,25,2,0,12288,4,9041588507
3835,4142521,49852447,53994968,10,1,1,5120,4,5772898546
3836,4143320,30108429,34251749,15,1,0,14336,19,7946314010
3837,4144021,30901316,35045337,33,3,0,15360,22,351721549
3838,4144281,49854233,53998514,7,0,1,5632,29,8438227006
3839,4145550,30945923,35091473,2,0,0,2560,3,3475633526
3840,4150950,30774600,34925550,4,0,0,13824,14,1461082173
3841,4151500,31895251,36046751,26,2,0,58368,29,7243518901
3842,4151790,31012119,35163909,22,2,0,24064,10,8365515886
3843,4152590,31694367,35846957,36,3,0,8704,3,4487728893
3844,4152610,30434462,34587072,15,1,0,5632,19,65393974
3845,4154930,30175238,34330168,35,3,0,14336,8,10716834365
3846,4156511,49845966,54002477,38,3,1,512,26,7481652549
3847,4156861,30509316,34666177,33,3,0,130560,22,9653928440
3848,4158890,30178991,34337881,4,0,0,2048,14,2556583042
3849,4161450,30640069,34801519,19,1,0,15872,5,9901539201
3850,4162471,30352184,34514655,34,3,0,25600,2,9642189252
3851,4167010,30976160,35143170,39,3,0,13824,2,900930566
3852,4168290,31575928,35744218,28,2,0,2048,24,8446599955
3853,4170491,30867304,35037795,34,3,0,33280,2,10316153108
3854,4170551,30509914,34680465,34,3,0,1024,2,7432458495
3855,4172180,32039086,36211266,7,0,0,8704,29,6420848604
3856,4172360,30334472,34506832,30,3,0,63488,3,4477579227
3857,4172570,30839838,35012408,11,1,0,4608,6,3290659089
3858,4173260,30496528,34669788,19,1,0,11776,5,8121236953
3859,4174780,31171631,35346411,22,2,0,87552,10,2918048332
3860,4176540,30304542,34481082,16,1,0,3584,10,9885501035
3861,4176570,30387472,34564042,4,0,0,12288,14,9099005485
3862,4178020,31270205,35448225,24,2,0,42496,10,9069917250
3863,4180160,49835141,54015301,12,1,1,11264,3,2696211606
3864,4180890,31817566,35998456,32,3,0,28160,17,771780353
3865,4180900,32344327,36525227,26,2,0,31232,29,196783324
3866,4181980,32185459,36367439,31,3,0,4608,27,7381474284
3867,4183301,49873251,54056552,21,2,1,1536,25,9139597674
3868,4183550,31488487,35672037,22,2,0,49152,10,10386501217
3869,4183941,49872969,54056910,7,0,1,3072,29,3297742848
3870,4184231,30703509,34887740,33,3,0,66048,22,5211385860
3871,4185591,30919820,35105411,34,3,0,44032,2,9351913391
3872,4186530,30419747,34606277,26,2,0,17408,29,6735332707
3873,4192330,30621146,34813476,22,2,0,4608,10,799031443
3874,4192760,30549458,34742218,23,2,0,30208,4,5618601011
3875,4192770,31172453,35365223,35,3,0,12800,8,555594936
3876,4195481,30735206,34930687,34,3,0,12288,2,2864927434
3877,4197340,30377044,34574384,7,0,0,2560,29,10424489148
3878,4199140,31273359,35472499,10,1,0,9728,4,377028594
3879,4200240,32005177,36205417,39,3,0,104960,2,5956749425
3880,4201070,30521895,34722965,35,3,0,8704,8,7690123670
3881,4202140,31016024,35218164,0,0,0,16384,8,8476051472
3882,4203250,31210153,35413403,35,3,0,10752,8,8880328674
3883,4205570,31370223,35575793,28,2,0,43520,24,1692497860
3884,4208230,32702982,36911212,32,3,0,17408,17,4485356259
3885,4209130,32071694,36280824,28,2,0,10752,24,6466335227
3886,4211519,49845414,54056933,8,0,1,1024,1,5829309632
3887,4213430,31470642,35684072,35,3,0,39424,8,10268400806
3888,4214210,30673888,34888098,22,2,0,1024,10,6828085978
3889,4214230,31544744,35758974,20,2,0,16384,24,10275305060
3890,4215350,30812282,35027632,19,1,0,19456,5,1162859000
3891,4215370,32763983,36979353,0,0,0,18432,8,10509095416
3892,4216459,49840497,54056956,11,1,1,512,6,1451569801
3893,4217400,49839579,54056979,2,0,1,512,3,496336460
3894,4218180,30869651,35087831,18,1,0,37888,13,5976118440
3895,4218810,31622500,35841310,22,2,0,24576,10,10297687629
3896,4219401,31527492,35746893,25,2,0,8704,4,10139369095
3897,4227121,31560357,35787478,33,3,0,9216,22,273338457
3898,4228389,51089460,55317849,23,2,1,316416,4,1735488685
3899,4228831,31380615,35609446,9,0,0,22016,12,1128381556
3900,4229850,31559991,35789841,12,1,0,7680,3,4031205252
3901,4232060,30631808,34863868,15,1,0,4096,19,10519549443
3902,4235240,30969766,35205006,36,3,0,72192,3,3765602002
3903,4238201,31252988,35491189,9,0,0,11264,12,3173166004
3904,4238440,30853524,35091964,1,0,0,1536,26,9541799623
3905,4239121,51114499,55353620,31,3,1,16384,27,5955678518
3906,4239330,51114313,55353643,20,2,1,2048,24,5490980515
3907,4240850,30658920,34899770,18,1,0,3584,13,3303579752
3908,4242000,51118795,55360795,1,0,1,1024,26,4802867297
3909,4242040,51119114,55361154,27,2,1,9728,9,5587062024
3910,4245400,30845262,35090662,6,0,0,9216,24,7536307880
3911,4246351,51115789,55362140,22,2,1,1536,10,8171137086
3912,4246930,31104831,35351761,28,2,0,11776,24,8077723060
3913,4247010,31114290,35361300,3,0,0,31232,5,4546403300
3914,4248170,33061705,37309875,30,3,0,25600,3,2498000342
3915,4248970,32842892,37091862,32,3,0,2560,17,1863924982
3916,4249620,32264721,36514341,15,1,0,81408,19,9178536625
3917,4250750,31371231,35621981,12,1,0,33792,3,777607633
3918,4251130,32107866,36358996,4,0,0,7168,14,5459298550
3919,4251500,31720111,35971611,16,1,0,73216,10,10451356220
3920,4251650,31334329,35585979,7,0,0,3072,29,6147209986
3921,4252901,31041327,35294228,9,0,0,2048,12,10364918048
3922,4253890,31644998,35898888,23,2,0,13824,4,5537834606
3923,4254550,31265522,35520072,24,2,0,94720,10,1312623045
3924,4255800,30927187,35182987,38,3,0,17408,26,271428244
3925,4256330,31816760,36073090,32,3,0,41984,17,472088889
3926,4256960,51110006,55366966,20,2,1,7680,24,126110865
3927,4261559,51112209,55373768,15,1,1,12288,19,5424189409
3928,4262590,30778036,35040626,36,3,0,9216,3,9267268451
3929,4264141,31358019,35622160,33,3,0,512,22,2712637204
3930,4266770,33084519,37351289,28,2,0,12288,24,4036156147
3931,4266780,31213354,35480134,23,2,0,16384,4,6386918373
3932,4267740,31422135,35689875,23,2,0,18944,4,5361845762
3933,4269100,31186325,35455425,4,0,0,5632,14,7966621027
3934,4270790,31077360,35348150,4,0,0,5632,14,5409091012
3935,4271970,31099516,35371486,3,0,0,20480,5,1342905935
3936,4272340,31599133,35871473,3,0,0,28672,5,9758564528
3937,4272440,31601708,35874148,5,0,0,8704,4,8100728322
3938,4273130,32632755,36905885,13,1,0,21504,6,1982664478
3939,4273280,32429570,36702850,3,0,0,38400,5,892355294
3940,4273469,51114894,55388363,8,0,1,9216,1,8508119060
3941,4274740,32769220,37043960,26,2,0,211968,29,2652357570
3942,4274760,31477772,35752532,32,3,0,18432,17,4114973629
3943,4277000,51115683,55392683,3,0,1,5632,5,1321886011
3944,4277650,30964798,35242448,15,1,0,3072,19,2696977279
3945,4277740,51180228,55457968,32,3,1,50688,17,6531499519
3946,4279180,31190332,35469512,6,0,0,25600,24,6763892282
3947,4280451,51179463,55459914,7,0,1,3072,29,9280044205
3948,4281050,31613603,35894653,21,2,0,45568,25,1569349241
3949,4282290,31033089,35315379,21,2,0,7168,25,4964853415
3950,4282760,51186870,55469630,25,2,1,1536,4,6860386734
3951,4283749,51185904,55469653,8,0,1,512,1,7125773335
3952,4284191,31482652,35766843,33,3,0,12800,22,6540290377
3953,4284330,31492068,35776398,39,3,0,31232,2,8358082342
3954,4284580,51185096,55469676,28,2,1,28672,24,179335525
3955,4284600,51235475,55520075,36,3,1,18432,3,7708484888
3956,4284771,31664509,35949280,9,0,0,23040,12,9509775861
3957,4285520,33168327,37453847,39,3,0,60416,2,1406583029
3958,4287880,31414209,35702089,38,3,0,20480,26,1773622888
3959,4289559,51238631,55528190,8,0,1,4608,1,2476367763
3960,4290410,31882958,36173368,2,0,0,62464,3,3830952448
3961,4292690,31977278,36269968,1,0,0,72192,26,3038021222
3962,4295700,31557094,35852794,5,0,0,16896,4,10095696754
3963,4296100,51234676,55530776,2,0,1,4096,3,1098760071
3964,4296420,31228511,35524931,10,1,0,15872,4,1952660030
3965,4298020,31949929,36247949,28,2,0,47104,24,331017692
3966,4298310,31397516,35695826,27,2,0,19456,9,1726504578
3967,4301021,31801384,36102405,25,2,0,10752,4,7334447552
3968,4301360,31461560,35762920,10,1,0,6656,4,1390515010
3969,4301890,32872626,37174516,11,1,0,65536,6,3062796243
3970,4303740,31181946,35485686,11,1,0,1024,6,3136606024
3971,4304651,51229671,55534322,38,3,1,5632,26,3960054790
3972,4305740,32156762,36462502,5,0,0,19968,4,889672024
3973,4305960,32014906,36320866,15,1,0,39424,19,9730059795
3974,4307010,32262903,36569913,11,1,0,27136,6,2237756132
3975,4307429,51279437,55586866,11,1,1,2560,6,8030834367
3976,4309250,31444709,35753959,7,0,0,4608,29,3706492364
3977,4310760,31395096,35705856,39,3,0,12288,2,9557534115
3978,4314510,32399797,36714307,10,1,0,37376,4,7231629370
3979,4315380,51271832,55587212,32,3,1,512,17,10330737734
3980,4316211,31592060,35908271,33,3,0,30720,22,7767321466
3981,4316721,33015999,37332720,34,3,0,30208,2,9690613468
3982,4317660,31965714,36283374,24,2,0,4096,10,5201667854
3983,4318560,32052107,36370667,27,2,0,5120,9,7783395579
3984,4319420,51269098,55588518,2,0,1,2048,3,8622260239
3985,4320430,31440439,35760869,30,3,0,6144,3,5302867074
3986,4320560,31956965,36277525,21,2,0,24576,25,5520179083
3987,4324540,31556206,35880746,38,3,0,2048,26,6055834387
3988,4325160,32269759,36594919,6,0,0,1024,24,6966529124
3989,4327811,31552288,35880099,9,0,0,19456,12,9131286556
3990,4328490,32404178,36732668,28,2,0,54784,24,3113207518
3991,4329610,32533244,36862854,8,0,0,46080,1,5013228477
3992,4330160,33425685,37755845,2,0,0,9728,3,6873815017
3993,4330740,32434312,36765052,19,1,0,15360,5,5262474448
3994,4331350,31793718,36125068,23,2,0,29696,4,1773173565
3995,4331760,32212494,36544254,4,0,0,15872,14,9561893456
3996,4332130,32323631,36655761,15,1,0,13312,19,10348836632
3997,4333579,51331393,55664972,5,0,1,11264,4,4702026199
3998,4334330,32049290,36383620,7,0,0,17408,29,6527385321
3999,4334400,31721312,36055712,0,0,0,29184,8,6924595941
4000,4335280,51343466,55678746,13,1,1,4608,6,6716123236
4001,4336190,32258394,36594584,20,2,0,80896,24,4945701338
4002,4336351,51397156,55733507,19,1,1,52736,5,8021531555
4003,4336820,32730024,37066844,29,2,0,13312,26,8041383424
4004,4337900,31961312,36299212,12,1,0,24576,3,2557466939
4005,4338180,32326207,36664387,11,1,0,16896,6,5752669764
4006,4338280,33764055,38102335,20,2,0,94720,24,7995467888
4007,4338460,51395070,55733530,27,2,1,3072,9,8607385877
4008,4340740,32632974,36973714,13,1,0,26624,6,5036207946
4009,4342030,32461471,36803501,38,3,0,20480,26,6575339593
4010,4342949,51417298,55760247,5,0,1,22528,4,9037079076
4011,4343300,51444684,55787984,32,3,1,512,17,7491085546
4012,4345180,51443163,55788343,12,1,1,9728,3,10546627742
4013,4345210,33571441,37916651,29,2,0,5632,26,4123852531
4014,4346340,33901582,38247922,35,3,0,3072,8,177960191
4015,4346461,51480381,55826842,7,0,1,1024,29,9604222050
4016,4346840,31861751,36208591,26,2,0,10240,29,9834840681
4017,4346941,51480669,55827610,22,2,1,11776,10,8725342354
4018,4347070,32931919,37278989,26,2,0,61440,29,2664844946
4019,4347380,31934723,36282103,20,2,0,4096,24,10630201462
4020,4351861,32403573,36755434,9,0,0,49664,12,209746908
4021,4352110,32519355,36871465,8,0,0,28160,1,10169387799
4022,4352420,31704407,36056827,0,0,0,3584,8,5071365801
4023,4352611,31704730,36057341,34,3,0,1536,2,7378540951
4024,4353511,51512817,55866328,31,3,1,13824,27,3303352720
4025,4355029,51513565,55868594,11,1,1,3584,6,4440939350
4026,4356420,32048033,36404453,10,1,0,29184,4,10691523747
4027,4356951,32559464,36916415,25,2,0,16896,4,5388581473
4028,4358130,32095602,36453732,30,3,0,12288,3,7041493580
4029,4359169,51604788,55963957,15,1,1,23552,19,1859699543
4030,4359680,32317383,36677063,31,3,0,17408,27,8588438196
4031,4360380,32129134,36489514,32,3,0,10240,17,7366532031
4032,4360440,33198766,37559206,22,2,0,36864,10,1563338453
4033,4360510,34023317,38383827,26,2,0,60416,29,3468459446
4034,4360661,51630938,55991599,26,2,1,14336,29,3017833791
4035,4360740,32265388,36626128,18,1,0,29696,13,7873781529
4036,4361430,51754702,56116132,32,3,1,7680,17,9873889257
4037,4362620,32890575,37253195,3,0,0,60928,5,9410232586
4038,4362720,32580691,36943411,7,0,0,29696,29,10209281824
4039,4363091,32480523,36843614,9,0,0,5120,12,6238581967
4040,4363121,32009938,36373059,9,0,0,2560,12,6815908126
4041,4364320,33114845,37479165,12,1,0,62464,3,3942726293
4042,4365990,32162224,36528214,16,1,0,9728,10,10194069595
4043,4368200,32283482,36651682,11,1,0,58880,6,1266300728
4044,4369070,32923724,37292794,32,3,0,18944,17,644106521
4045,4369540,51746615,56116155,0,0,1,10752,8,9605837479
4046,4370080,33346550,37716630,3,0,0,51200,5,4060217537
4047,4375450,32694265,37069715,2,0,0,3584,3,10305937523
4048,4375810,51849230,56225040,13,1,1,29696,6,4441555692
4049,4375961,33240985,37616946,33,3,0,51712,22,7097202970
4050,4376440,32683798,37060238,24,2,0,41984,10,8255771727
4051,4378930,33394178,37773108,31,3,0,33792,27,6381645006
4052,4379370,51847296,56226666,20,2,1,2560,24,6662631526
4053,4382360,32287989,36670349,35,3,0,17408,8,7185995475
4054,4383310,32515992,36899302,26,2,0,51200,29,2392469540
4055,4385800,32957574,37343374,10,1,0,33280,4,10008300451
4056,4387740,32800261,37188001,8,0,0,28672,1,8287654708
4057,4387750,33072360,37460110,39,3,0,20480,2,273113530
4058,4390001,32171621,36561622,33,3,0,25088,22,6849751721
4059,4390380,32720258,37110638,39,3,0,22016,2,6790861053
4060,4390620,33474702,37865322,35,3,0,37888,8,8641415882
4061,4391410,33429560,37820970,7,0,0,13312,29,1774536221
4062,4392030,32237154,36629184,13,1,0,6144,6,8602179906
4063,4393510,34036429,38429939,31,3,0,31232,27,5159175925
4064,4398050,51861995,56260045,0,0,1,11264,8,2049913873
4065,4398101,51931861,56329962,30,3,1,6144,3,9585007314
4066,4399060,32775791,37174851,4,0,0,1024,14,583854100
4067,4399520,33096525,37496045,31,3,0,11264,27,4957300962
4068,4400380,51929605,56329985,13,1,1,2048,6,8399040105
4069,4402170,32969468,37371638,0,0,0,6144,8,8276891996
4070,4404910,32911228,37316138,10,1,0,20480,4,4226617205
4071,4405060,32418201,36823261,31,3,0,7168,27,8866575987
4072,4405400,32560179,36965579,14,1,0,30208,8,8977341365
4073,4406390,33471435,37877825,24,2,0,40960,10,2610875040
4074,4407030,32476649,36883679,16,1,0,30720,10,1455994914
4075,4407110,32252106,36659216,11,1,0,11264,6,331492402
4076,4411000,33490941,37901941,39,3,0,4096,2,3413947147
4077,4412950,32347399,36760349,30,3,0,10752,3,7249043871
4078,4414021,51922816,56336837,30,3,1,12800,3,2540990181
4079,4414760,32421915,36836675,19,1,0,33280,5,9342654357
4080,4419141,32296804,36715945,9,0,0,5120,12,6865149880
4081,4424320,32449976,36874296,1,0,0,9216,26,1035337696
4082,4424540,33535453,37959993,32,3,0,49664,17,1329178321
4083,4427090,33540570,37967660,11,1,0,25088,6,9529661940
4084,4427160,32874884,37302044,8,0,0,24576,1,5913447746
4085,4427650,33150780,37578430,5,0,0,9216,4,994360576
4086,4427920,52680251,57108171,28,2,1,328704,24,10145548305
4087,4428170,33547374,37975544,20,2,0,2048,24,3621759765
4088,4430030,32499189,36929219,13,1,0,2048,6,3563711916
4089,4434280,52711001,57145281,28,2,1,39936,24,7451843775
4090,4434740,52710564,57145304,12,1,1,16896,3,1297667478
4091,4436059,52709268,57145327,15,1,1,2560,19,5518823382
4092,4437140,32717385,37154525,35,3,0,33792,8,10044218225
4093,4437791,52707559,57145350,22,2,1,11776,10,4910905122
4094,4438800,32677321,37116121,35,3,0,17920,8,9314128994
4095,4439440,32794833,37234273,35,3,0,28160,8,5655827238
4096,4440110,33531637,37971747,8,0,0,13312,1,6015747050
4097,4440540,34091576,38532116,7,0,0,38400,29,8256456872
4098,4441630,32639885,37081515,22,2,0,6144,10,1808404406
4099,4443160,52791078,57234238,39,3,1,12288,2,2630965397
4100,4444630,32602793,37047423,32,3,0,11264,17,8393864594
4101,4444810,33053466,37498276,11,1,0,6144,6,4639444308
4102,4445540,52844883,57290423,17,1,1,1024,28,8387944080
4103,4445590,32789018,37234608,30,3,0,1024,3,4626230309
4104,4447890,32614867,37062757,19,1,0,8192,5,320294199
4105,4448050,32846483,37294533,6,0,0,5632,24,7483577020
4106,4448120,52842326,57290446,6,0,1,1024,24,2467546268
4107,4448271,52842198,57290469,30,3,1,1024,3,8574265462
4108,4448650,32838349,37286999,0,0,0,14336,8,6787991931
4109,4450030,32832570,37282600,4,0,0,11776,14,2714428643
4110,4451370,52839122,57290492,9,0,1,1024,12,4065571127
4111,4451480,32872013,37323493,20,2,0,24064,24,1717922215
4112,4451711,33621741,38073452,33,3,0,81408,22,8470801104
4113,4453030,32638029,37091059,21,2,0,14848,25,9702069628
4114,4453599,52938638,57392237,4,0,1,29696,14,8943895812
4115,4453970,52967571,57421541,9,0,1,13824,12,3460944309
4116,4455100,33687930,38143030,27,2,0,12288,9,8080787988
4117,4457300,32912443,37369743,0,0,0,31232,8,6395856644
4118,4457420,32642556,37099976,2,0,0,9728,3,133555870
4119,4458300,33766508,38224808,35,3,0,46592,8,1928047812
4120,4460819,52983260,57444079,15,1,1,7680,19,7799160449
4121,4461190,32718052,37179242,26,2,0,14336,29,4906001466
4122,4463869,53007583,57471452,4,0,1,2560,14,6033018541
4123,4464580,33267517,37732097,5,0,0,50688,4,9670266785
4124,4465310,32917280,37382590,35,3,0,10752,8,103903165
4125,4466670,32793576,37260246,18,1,0,23040,13,8206336664
4126,4466900,32912391,37379291,22,2,0,5632,10,9291716132
4127,4467260,33019470,37486730,29,2,0,3072,26,3005838973
4128,4467491,32725221,37192712,9,0,0,15360,12,8105136199
4129,4468140,53006538,57474678,13,1,1,5120,6,4649342141
4130,4469110,33221965,37691075,18,1,0,29696,13,5557734748
4131,4469720,53006264,57475984,35,3,1,2048,8,4923449385
4132,4469971,53006679,57476650,31,3,1,1024,27,6937925491
4133,4470260,53015402,57485662,2,0,1,14336,3,4522753137
4134,4470740,32889464,37360204,15,1,0,29184,19,3531824016
4135,4471940,32861271,37333211,18,1,0,1536,13,6506258779
4136,4473311,33967755,38441066,34,3,0,22016,2,3390089996
4137,4473850,33323450,37797300,27,2,0,17408,9,7754407660
4138,4474121,53043144,57517265,10,1,1,14336,4,6745596130
4139,4475240,33008324,37483564,21,2,0,14336,25,6309781858
4140,4476999,53040932,57517931,5,0,1,1024,4,1773458322
4141,4477270,53041122,57518392,12,1,1,10240,3,1706143810
4142,4477600,33259223,37736823,14,1,0,3072,8,8627212273
4143,4477670,33855246,38332916,20,2,0,26112,24,2349827859
4144,4478630,32930863,37409493,13,1,0,11776,6,4371836055
4145,4480100,53053126,57533226,20,2,1,5632,24,4093010637
4146,4481301,53369781,57851082,19,1,1,123904,5,7096947218
4147,4481770,34126104,38607874,4,0,0,12288,14,9864149215
4148,4481830,53412301,57894131,12,1,1,1536,3,4344164079
4149,4481960,33683688,38165648,14,1,0,8704,8,4838473981
4150,4484101,53410053,57894154,30,3,1,1536,3,9134747470
4151,4484570,33770551,38255121,36,3,0,23552,3,4348597938
4152,4484651,33253443,37738094,21,2,0,4096,25,9495899789
4153,4484730,33344225,37828955,27,2,0,1536,9,7889500902
4154,4485980,33523622,38009602,10,1,0,7680,4,4961091594
4155,4486240,53416563,57902803,32,3,1,7168,17,1900807330
4156,4486680,33053442,37540122,7,0,0,14848,29,4893951097
4157,4487820,33301809,37789629,18,1,0,14336,13,1747775860
4158,4492000,33137137,37629137,6,0,0,39936,24,7943734589
4159,4492290,32993481,37485771,15,1,0,7168,19,7006170009
4160,4492930,33189074,37682004,31,3,0,30720,27,879664003
4161,4492950,53409876,57902826,16,1,1,3584,10,2215827101
4162,4496690,33239174,37735864,16,1,0,12288,10,5281645400
4163,4496820,33028197,37525017,27,2,0,512,9,9848464306
4164,4497470,33402998,37900468,29,2,0,74240,26,3946060335
4165,4497980,33509251,38007231,4,0,0,30208,14,924902054
4166,4498340,34690694,39189034,20,2,0,7168,24,9102455015
4167,4498350,33499654,37998004,30,3,0,55808,3,9597668848
4168,4498400,33416512,37914912,4,0,0,42496,14,3551995020
4169,4498940,33022461,37521401,38,3,0,7680,26,6773056322
4170,4499610,53408038,57907648,20,2,1,8704,24,8140246149
4171,4500370,53410184,57910554,13,1,1,4608,6,6364137810
4172,4501561,33636743,38138304,33,3,0,54272,22,6716994687
4173,4502220,33324389,37826609,15,1,0,18432,19,2007738506
4174,4502550,33398120,37900670,36,3,0,512,3,6336361113
4175,4502950,33510887,38013837,14,1,0,13824,8,10007348360
4176,4504930,53405983,57910913,0,0,1,9728,8,3073601380
4177,4504970,34594635,39099605,4,0,0,30720,14,9703010539
4178,4506970,33192476,37699446,3,0,0,1024,5,10403607602
4179,4507380,33252552,37759932,31,3,0,4608,27,1526277704
4180,4508360,33518695,38027055,27,2,0,23040,9,7254968240
4181,4509580,33722271,38231851,15,1,0,23040,19,7773472956
4182,4510070,33289749,37799819,3,0,0,8192,5,8124267158
4183,4511480,33735483,38246963,21,2,0,23552,25,7875704347
4184,4512630,33432208,37944838,29,2,0,36352,26,5610263089
4185,4512660,33727104,38239764,4,0,0,12288,14,8040872296
4186,4513710,33328776,37842486,32,3,0,12288,17,7620482621
4187,4514290,33845756,38360046,35,3,0,20480,8,4856470436
4188,4514710,33525160,38039870,35,3,0,41984,8,5376913548
4189,4515600,34088507,38604107,27,2,0,17920,9,7139834127
4190,4517399,33640942,38158341,17,1,0,50176,28,4489744744
4191,4517940,33319208,37837148,27,2,0,2048,9,8509439284
4192,4517980,33621283,38139263,11,1,0,3072,6,4653655269
4193,4518500,33526229,38044729,32,3,0,15872,17,7477055347
4194,4518930,33648457,38167387,35,3,0,5632,8,6446663295
4195,4520360,53424280,57944640,6,0,1,5120,24,8100039175
4196,4521650,34163258,38684908,31,3,0,16384,27,7955699934
4197,4522530,33497482,38020012,19,1,0,9728,5,1158232662
4198,4524870,34729066,39253936,13,1,0,72192,6,8647720183
4199,4524949,33893400,38418349,17,1,0,62464,28,4061680408
4200,4525370,53419293,57944663,9,0,1,5632,12,1792629786
4201,4525770,53418916,57944686,28,2,1,7168,24,7903002046
4202,4528030,34162072,38690102,23,2,0,6144,4,5843051509
4203,4528161,53416548,57944709,30,3,1,3584,3,8179256091
4204,4530750,33814926,38345676,1,0,0,14848,26,1028538527
4205,4530770,33769296,38300066,36,3,0,68096,3,714252836
4206,4530840,33742733,38273573,10,1,0,17408,4,3027036230
4207,4533711,53423912,57957623,31,3,1,23552,27,153657003
4208,4533790,33578176,38111966,28,2,0,11264,24,2772540671
4209,4534510,33573932,38108442,1,0,0,19968,26,5605271087
4210,4535620,33829776,38365396,1,0,0,17408,26,6744939106
4211,4536200,53443571,57979771,36,3,1,3072,3,7872320967
4212,4536580,53443214,57979794,32,3,1,1536,17,4867005255
4213,4537730,34566578,39104308,30,3,0,15360,3,7271277513
4214,4537970,33963555,38501525,10,1,0,67072,4,2064201786
4215,4539031,53440786,57979817,31,3,1,14848,27,7829700821
4216,4540150,34795861,39336011,6,0,0,65024,24,10495136155
4217,4540350,33880050,38420400,31,3,0,6656,27,8033347753
4218,4540820,34028446,38569266,10,1,0,9216,4,4554966983
4219,4542090,34118918,38661008,26,2,0,11776,29,1329407240
4220,4542640,34067129,38609769,26,2,0,6144,29,10540772999
4221,4543310,34469091,39012401,6,0,0,25088,24,3734748562
4222,4543441,34404734,38948175,25,2,0,92160,4,1157619115
4223,4544520,33761185,38305705,29,2,0,18432,26,5386189948
4224,4545400,53501753,58047153,0,0,1,30720,8,10688272684
4225,4545611,53666210,58211821,31,3,1,39424,27,818273035
4226,4545690,33664212,38209902,13,1,0,6144,6,1183605392
4227,4546090,33853204,38399294,13,1,0,50688,6,10674500573
4228,4546390,53668587,58214977,25,2,1,2560,4,3930354241
4229,4546770,34927072,39473842,11,1,0,24576,6,10370003402
4230,4546940,33566141,38113081,14,1,0,3584,8,2965663027
4231,4550120,34048504,38598624,15,1,0,38912,19,8230099071
4232,4550570,33909864,38460434,14,1,0,25088,8,4854115602
4233,4550640,33891073,38441713,4,0,0,2048,14,1829687399
4234,4551790,34114352,38666142,36,3,0,4608,3,2107818623
4235,4552500,34101750,38654250,7,0,0,11776,29,8614308437
4236,4554629,53662614,58217243,11,1,1,3584,6,7463328836
4237,4555190,34180607,38735797,0,0,0,6144,8,4304975252
4238,4555690,34182758,38738448,19,1,0,1536,5,9257223350
4239,4557330,53725507,58282837,3,0,1,23040,5,6237340468
4240,4558820,33976127,38534947,29,2,0,9216,26,5018805305
4241,4559880,34389566,38949446,18,1,0,4096,13,8429700877
4242,4561410,34293240,38854650,24,2,0,31232,10,4692071282
4243,4561620,34230814,38792434,36,3,0,10240,3,1069548292
4244,4562260,53722843,58285103,27,2,1,3584,9,9791776838
4245,4563070,34061830,38624900,8,0,0,9216,1,10726885379
4246,4563820,34324771,38888591,27,2,0,28672,9,4270903705
4247,4563980,34315852,38879832,8,0,0,22016,1,2574798169
4248,4565460,33942372,38507832,26,2,0,11264,29,1602493751
4249,4565720,34458092,39023812,18,1,0,37376,13,8058148737
4250,4567410,35244711,39812121,38,3,0,87040,26,5080847077
4251,4569150,34127190,38696340,22,2,0,11776,10,9164715465
4252,4569231,33943928,38513159,33,3,0,17408,22,7777693234
4253,4570580,34564335,39134915,18,1,0,100352,13,7878966635
4254,4572259,53755500,58327759,23,2,1,47616,4,3976617024
4255,4573080,53781807,58354887,6,0,1,4096,24,928143345
4256,4575950,34890358,39466308,31,3,0,7680,27,1416333496
4257,4575960,34655911,39231871,35,3,0,56832,8,10119956799
4258,4576350,34814484,39390834,3,0,0,6656,5,5284282111
4259,4576570,34564475,39141045,4,0,0,512,14,80514977
4260,4576700,34235394,38812094,38,3,0,37888,26,3873225256
4261,4577162,34195618,38772780,13,1,0,5632,6,4688255364
4262,4578780,34726680,39305460,26,2,0,20480,29,7627074460
4263,4579280,53775630,58354910,27,2,1,3584,9,10061146775
4264,4579810,34287925,38867735,38,3,0,34304,26,9101406177
4265,4580681,34153221,38733902,25,2,0,3072,4,10390697074
4266,4584080,34370849,38954929,7,0,0,17920,29,2325221717
4267,4585920,34418814,39004734,30,3,0,74752,3,12543289
4268,4585990,34710657,39296647,11,1,0,48640,6,1618970518
4269,4586860,34101347,38688207,36,3,0,10752,3,5921930567
4270,4586960,34175372,38762332,11,1,0,512,6,9447872802
4271,4588601,34567310,39155911,25,2,0,27648,4,1790819023
4272,4590400,34099881,38690281,14,1,0,512,8,964747292
4273,4590980,34482013,39072993,39,3,0,72192,2,6819559648
4274,4591250,34444809,39036059,27,2,0,14848,9,55960566
4275,4592120,34934055,39526175,36,3,0,512,3,9123146660
4276,4592351,34837597,39429948,34,3,0,20992,2,4883374501
4277,4592380,34548486,39140866,28,2,0,19456,24,6821420451
4278,4593320,53761613,58354933,2,0,1,512,3,9844546827
4279,4594780,34944449,39539229,24,2,0,7680,10,5846261505
4280,4596000,35077609,39673609,18,1,0,23552,13,3973074088
4281,4599790,53755166,58354956,34,3,1,1024,2,4997202995
4282,4599880,34614652,39214532,22,2,0,32768,10,10075944990
4283,4599990,53754989,58354979,33,3,1,512,22,2445903736
4284,4601050,34443608,39044658,20,2,0,17408,24,5592036234
4285,4601560,34574717,39176277,11,1,0,5632,6,10563955472
4286,4601710,35348951,39950661,4,0,0,27136,14,9951998840
4287,4603781,53751221,58355002,19,1,1,2048,5,10612818281
4288,4604940,34209852,38814792,16,1,0,8704,10,7284951078
4289,4607010,35211085,39818095,23,2,0,14848,4,9609888691
4290,4607400,34470296,39077696,19,1,0,15360,5,10267553882
4291,4608851,34906005,39514856,25,2,0,2048,4,1785150682
4292,4609141,53747208,58356349,30,3,1,17408,3,8203677704
4293,4609920,34537544,39147464,23,2,0,20992,4,8687279642
4294,4610290,35332080,39942370,15,1,0,22016,19,5978708717
4295,4611360,34369160,38980520,2,0,0,15360,3,6458144089
4296,4613550,34662873,39276423,15,1,0,73728,19,2844726094
4297,4613760,34696411,39310171,28,2,0,15360,24,4856797160
4298,4617781,34410890,39028671,25,2,0,15872,4,9596392493
4299,4618850,34767414,39386264,38,3,0,11264,26,2942772309
4300,4618851,53737652,58356503,38,3,1,8704,26,1773743144
4301,4620191,34678975,39299166,34,3,0,8192,2,10723099473
4302,4620370,53736799,58357169,9,0,1,1024,12,6156502413
4303,4621690,34842209,39463899,22,2,0,99328,10,2116420243
4304,4625260,34736712,39361972,31,3,0,34304,27,9606404697
4305,4625440,34740011,39365451,36,3,0,3072,3,4238709246
4306,4625460,34763323,39388783,30,3,0,8192,3,2938433205
4307,4626800,34994694,39621494,19,1,0,3584,5,5534131562
4308,4627461,53768337,58395798,38,3,1,12288,26,2551128600
4309,4628360,34781876,39410236,28,2,0,41472,24,34695949
4310,4628410,35402986,40031396,14,1,0,13312,8,7867722733
4311,4629290,53785477,58414767,14,1,1,4608,8,1113940497
4312,4629590,35303842,39933432,18,1,0,15872,13,7088440327
4313,4629811,35439745,40069556,33,3,0,48128,22,567991171
4314,4630220,34651584,39281804,11,1,0,14848,6,3219420154
4315,4630530,53874203,58504733,1,0,1,16384,26,1223665219
4316,4631400,34683686,39315086,6,0,0,5632,24,8154998391
4317,4632729,53872027,58504756,37,3,1,9728,15,9195408734
4318,4634270,35630779,40265049,10,1,0,74240,4,4656936589
4319,4636840,34877369,39514209,14,1,0,11264,8,7071075096
4320,4637741,35003222,39640963,33,3,0,15872,22,5099220135
4321,4638160,35712748,40350908,3,0,0,57344,5,4772392587
4322,4638250,34525512,39163762,18,1,0,11776,13,1880588323
4323,4638710,34887286,39525996,30,3,0,16384,3,7614735486
4324,4638830,35748806,40387636,35,3,0,44032,8,6310891512
4325,4640170,35141789,39781959,35,3,0,36352,8,7398720771
4326,4640260,34723430,39363690,3,0,0,3584,5,1493609364
4327,4640360,35130500,39770860,38,3,0,54272,26,9639642886
4328,4640770,53872167,58512937,16,1,1,3584,10,1388204101
4329,4640840,35144738,39785578,35,3,0,11776,8,5535116430
4330,4641570,34850733,39492303,27,2,0,31232,9,9323326176
4331,4642171,34833410,39475581,34,3,0,5632,2,765585881
4332,4642400,35545298,40187698,15,1,0,3072,19,3344385201
4333,4643031,34634195,39277226,33,3,0,2560,22,9976958022
4334,4645510,35345803,39991313,24,2,0,7680,10,1955962695
4335,4645520,35103446,39748966,7,0,0,75264,29,8109562860
4336,4646480,35830367,40476847,7,0,0,22016,29,10062414263
4337,4648040,34844754,39492794,0,0,0,1536,8,1464148604
4338,4648220,35077783,39726003,24,2,0,44544,10,10490679084
4339,4650320,35103973,39754293,16,1,0,17408,10,5910446191
4340,4650650,36080036,40730686,31,3,0,67584,27,2952516053
4341,4651231,34889640,39540871,25,2,0,2560,4,6793517969
4342,4652580,35275993,39928573,20,2,0,71680,24,10308462439
4343,4652690,34824341,39477031,0,0,0,3072,8,294424872
4344,4653840,34998493,39652333,7,0,0,2048,29,9273271421
4345,4655630,53878360,58533990,2,0,1,2048,3,3910042955
4346,4655800,35333150,39988950,10,1,0,47616,4,1519559452
4347,4660321,35188873,39849194,25,2,0,2560,4,10334547041
4348,4660369,53873644,58534013,4,0,1,3584,14,8395529108
4349,4660960,34815112,39476072,26,2,0,1536,29,5828992502
4350,4661311,35220325,39881636,34,3,0,28160,2,715358170
4351,4666220,53870659,58536879,1,0,1,4608,26,10584367007
4352,4667240,34904766,39572006,6,0,0,23552,24,7298462414
4353,4667560,34988380,39655940,18,1,0,4608,13,8601753711
4354,4668400,35164701,39833101,7,0,0,2560,29,738717203
4355,4668770,34967334,39636104,39,3,0,26112,2,2662572282
4356,4669110,53869075,58538185,9,0,1,2048,12,4825088389
4357,4669750,35612290,40282040,5,0,0,12288,4,6278485648
4358,4673209,54063968,58737177,23,2,1,78848,4,2501051304
4359,4673591,54063609,58737200,31,3,1,4608,27,5576505344
4360,4673651,35148367,39822018,34,3,0,12800,2,8963129044
4361,4675000,35295028,39970028,20,2,0,63488,24,6286540041
4362,4675479,54075172,58750651,15,1,1,10240,19,10057375791
4363,4675530,35036878,39712408,19,1,0,20480,5,5559454812
4364,4675580,35350540,40026120,0,0,0,8704,8,6276052523
4365,4676350,35225105,39901455,22,2,0,11776,10,9967029965
4366,4676400,36002733,40679133,6,0,0,45568,24,4674663051
4367,4676460,35210659,39887119,10,1,0,17920,4,7434223375
4368,4676770,35136778,39813548,29,2,0,4608,26,1076445275
4369,4677750,54089594,58767344,33,3,1,8704,22,7455423126
4370,4680790,35254849,39935639,11,1,0,7168,6,7930751859
4371,4681139,54152450,58833589,37,3,1,12288,15,6702379895
4372,4681430,35150868,39832298,22,2,0,29696,10,4240627572
4373,4681880,54180017,58861897,16,1,1,4608,10,3937063835
4374,4683040,35713823,40396863,1,0,0,30208,26,3284586234
4375,4685740,35715381,40401121,8,0,0,7680,1,4158988728
4376,4686109,35620941,40307050,17,1,0,5632,28,9544362157
4377,4691650,54180393,58872043,28,2,1,15360,24,2572200138
4378,4695081,54181148,58876229,22,2,1,6656,10,7279642580
4379,4695120,35505482,40200602,16,1,0,13312,10,5941900982
4380,4695700,35278719,39974419,36,3,0,14336,3,6507888177
4381,4695780,36077944,40773724,13,1,0,26112,6,10504363185
4382,4697700,35372191,40069891,21,2,0,1024,25,3035415970
4383,4698271,54179584,58877855,31,3,1,2560,27,2547907399
4384,4702700,35468720,40171420,36,3,0,40960,3,6976382486
4385,4703950,35825474,40529424,30,3,0,32768,3,2350714029
4386,4705100,35814317,40519417,13,1,0,21504,6,4295312363
4387,4705510,54173331,58878841,3,0,1,1536,5,10002555316
4388,4706050,35873132,40579182,29,2,0,29184,26,10593838850
4389,4706270,35627120,40333390,2,0,0,21504,3,4504430897
4390,4707380,35290352,39997732,38,3,0,20992,26,3891168216
4391,4708210,36255685,40963895,32,3,0,69632,17,262063347
4392,4708340,35731710,40440050,2,0,0,40448,3,4870191552
4393,4708760,35477971,40186731,1,0,0,50176,26,75645318
4394,4710070,54174622,58884692,13,1,1,17408,6,8248938588
4395,4713110,54172888,58885998,27,2,1,2048,9,5363563580
4396,4713570,54172774,58886344,24,2,1,512,10,8259257694
4397,4713980,35385484,40099464,18,1,0,10240,13,3087858705
4398,4714821,35605158,40319979,9,0,0,39936,12,5476601300
4399,4715600,35654207,40369807,20,2,0,61952,24,7101221193
4400,4717020,54221951,58938971,39,3,1,25088,2,8187457280
4401,4717591,35777098,40494689,33,3,0,30208,22,9497455171
4402,4718680,54229001,58947681,24,2,1,6144,10,9366476291
4403,4720470,36077971,40798441,3,0,0,64000,5,2297588437
4404,4720651,54964992,59685643,7,0,1,181248,29,7150876287
4405,4721030,35356461,40077491,6,0,0,15360,24,5880811361
4406,4721031,55008566,59729597,10,1,1,15872,4,3888133602
4407,4721500,55246372,59967872,39,3,1,178176,2,8439411328
4408,4721950,35942450,40664400,31,3,0,115200,27,1286734522
4409,4722380,36043319,40765699,23,2,0,87040,4,1878223409
4410,4722970,36156429,40879399,4,0,0,39936,14,3252505643
4411,4723590,36207655,40931245,20,2,0,82944,24,8774993309
4412,4724880,35673878,40398758,8,0,0,6144,1,2101038005
4413,4726831,55258219,59985050,26,2,1,2560,29,8931728053
4414,4729149,35429768,40158917,32,3,0,44544,17,2448044593
4415,4729830,35723838,40453668,5,0,0,29184,4,9317135497
4416,4732551,36245259,40977810,25,2,0,45568,4,8993468173
4417,4733010,36044793,40777803,22,2,0,13312,10,4902356467
4418,4734330,35821862,40556192,27,2,0,57856,9,7055857469
4419,4735650,35958080,40693730,7,0,0,6656,29,722350041
4420,4736680,35708073,40444753,28,2,0,15360,24,6506555498
4421,4736810,35946285,40683095,6,0,0,12800,24,1727850564
4422,4737020,35863818,40600838,32,3,0,6656,17,4735914166
4423,4737341,35567970,40305311,34,3,0,39936,2,2841138797
4424,4737420,36460769,41198189,21,2,0,64512,25,3569010166
4425,4741211,36071153,40812364,25,2,0,45568,4,2439349513
4426,4741850,36246123,40987973,36,3,0,33280,3,2130791885
4427,4742060,35770759,40512819,30,3,0,40448,3,2580334207
4428,4742421,55258243,60000664,22,2,1,2048,10,1030636611
4429,4746230,36136073,40882303,4,0,0,4096,14,5599773249
4430,4747450,55281639,60029089,28,2,1,14336,24,7650175185
4431,4747660,35788027,40535687,32,3,0,20480,17,5573798785
4432,4748480,55307499,60055979,3,0,1,18432,5,6791957953
4433,4749040,36532924,41281964,0,0,0,13824,8,3531902460
4434,4750240,55334971,60085211,36,3,1,25088,3,8177429535
4435,4751160,36105412,40856572,14,1,0,46080,8,5811458989
4436,4751780,55334507,60086287,29,2,1,13312,26,6402082273
4437,4751840,35985421,40737261,30,3,0,21504,3,8846549396
4438,4752450,36253105,41005555,14,1,0,3072,8,10700246327
4439,4753560,36390673,41144233,24,2,0,4608,10,2644285755
4440,4754040,55367984,60122024,6,0,1,14848,24,1224537147
4441,4754550,36188106,40942656,10,1,0,37376,4,3578315985
4442,4755020,36247663,41002683,19,1,0,11776,5,7471691508
4443,4755370,55392041,60147411,6,0,1,10752,24,3284830900
4444,4755540,36079652,40835192,8,0,0,1024,1,5485521784
4445,4755730,36290361,41046091,22,2,0,17920,10,3251894739
4446,4755991,35742233,40498224,9,0,0,1536,12,7089459239
4447,4756720,36134206,40890926,10,1,0,21504,4,7689706608
4448,4757140,36247126,41004266,10,1,0,5120,4,3696432195
4449,4757180,36820625,41577805,30,3,0,11264,3,1098845390
4450,4757280,55390154,60147434,28,2,1,6144,24,8546259742
4451,4758120,35981036,40739156,18,1,0,6144,13,3081147307
4452,4758629,55388828,60147457,11,1,1,7680,6,922454367
4453,4759660,36019258,40778918,35,3,0,3584,8,8849535127
4454,4759710,36101270,40860980,8,0,0,5120,1,3885370022
4455,4759850,36838048,41597898,2,0,0,65024,3,3423669665
4456,4761770,35903456,40665226,14,1,0,2560,8,4383451364
4457,4761820,36278757,41040577,30,3,0,24064,3,5463339098
4458,4761890,36380916,41142806,15,1,0,40448,19,10719658875
4459,4763361,36360983,41124344,9,0,0,66048,12,1342444360
4460,4764070,36224862,40988932,6,0,0,3072,24,534019432
4461,4766880,36266342,41033222,24,2,0,67584,10,3474349939
4462,4767380,36433359,41200739,22,2,0,2048,10,10669108565
4463,4768121,55385303,60153424,19,1,1,13312,5,3154788146
4464,4769339,55394178,60163517,37,3,1,11264,15,8385017236
4465,4769820,36134873,40904693,24,2,0,15872,10,9231505150
4466,4770240,55455671,60225911,33,3,1,14848,22,2836677075
4467,4772410,55492164,60264574,25,2,1,11264,4,9084026441
4468,4774290,55491667,60265957,13,1,1,14848,6,4021422043
4469,4774510,36904741,41679251,20,2,0,9728,24,2972591641
4470,4776490,36353969,41130459,1,0,0,19968,26,5832967237
4471,4777750,36796600,41574350,14,1,0,7680,8,8002470230
4472,4777780,55526381,60304161,14,1,1,512,8,9976074636
4473,4778810,55526017,60304827,38,3,1,1024,26,6607737284
4474,4780380,36533511,41313891,16,1,0,17920,10,469875413
4475,4781390,36510113,41291503,1,0,0,31232,26,6916012601
4476,4781580,36496149,41277729,36,3,0,44032,3,3727996573
4477,4782570,36321627,41104197,32,3,0,11776,17,6531322767
4478,4784550,36307251,41091801,26,2,0,10752,29,9927631582
4479,4785590,37104537,41890127,16,1,0,11264,10,14281965
4480,4786221,36275775,41061996,9,0,0,13824,12,5204376076
4481,4786550,36865644,41652194,36,3,0,1536,3,1700835957
4482,4787240,36412844,41200084,5,0,0,6144,4,6830528085
4483,4787580,36376863,41164443,2,0,0,1024,3,3252825074
4484,4788610,36648570,41437180,37,3,0,30720,15,354370170
4485,4789100,36982460,41771560,14,1,0,17920,8,7669959632
4486,4789790,36202628,40992418,5,0,0,11264,4,8921064947
4487,4793040,36560071,41353111,22,2,0,30208,10,3328852060
4488,4795120,55510053,60305173,6,0,1,512,24,3492818517
4489,4798000,36663033,41461033,23,2,0,10240,4,8913256539
4490,4799751,36526306,41326057,34,3,0,33280,2,8225499199
4491,4800270,37179024,41979294,2,0,0,87040,3,8634288249
4492,4800810,55506309,60307119,38,3,1,3072,26,4132256940
4493,4801500,36344362,41145862,0,0,0,5120,8,5100780675
4494,4801940,37253483,42055423,16,1,0,36352,10,7194677240
4495,4802659,55505766,60308425,8,0,1,2048,1,5725146688
4496,4802690,36570629,41373319,19,1,0,15872,5,6935387950
4497,4806470,36501938,41308408,8,0,0,27648,1,8229206666
4498,4807090,36614938,41422028,36,3,0,11776,3,1845193360
4499,4808200,36291728,41099928,5,0,0,12288,4,478253569
4500,4808409,55525490,60333899,37,3,1,15360,15,88536794
4501,4808440,55532993,60341433,14,1,1,5120,8,3466865775
4502,4808480,36749889,41558369,15,1,0,78336,19,6732444045
4503,4809040,36614727,41423767,36,3,0,5632,3,3274237929
4504,4809980,55541018,60350998,9,0,1,1024,12,7293583730
4505,4811730,36419105,41230835,8,0,0,9216,1,7577042693
4506,4812820,36575213,41388033,18,1,0,17920,13,9531877216
4507,4812970,36412253,41225223,20,2,0,8704,24,3967526083
4508,4814310,55537994,60352304,35,3,1,2048,8,5094588298
4509,4814750,36717772,41532522,0,0,0,11776,8,9337772044
4510,4815210,55582749,60397959,36,3,1,21504,3,1482732917
4511,4817130,36868696,41685826,5,0,0,21504,4,5294440502
4512,4818150,36520089,41338239,7,0,0,19456,29,5729314206
4513,4818540,55592808,60411348,9,0,1,1024,12,6397305657
4514,4820880,55613480,60434360,33,3,1,4096,22,660040215
4515,4823470,36393965,41217435,7,0,0,3584,29,6019266678
4516,4824219,55610807,60435026,37,3,1,1024,15,6179449371
4517,4824220,36747767,41571987,29,2,0,43520,26,6315871916
4518,4826570,55628684,60455254,14,1,1,18944,8,1726299141
4519,4827390,36887629,41715019,18,1,0,38912,13,9305684294
4520,4828510,36785386,41613896,31,3,0,15872,27,2855333170
4521,4828620,36888918,41717538,27,2,0,8192,9,10296671190
4522,4829520,36588897,41418417,13,1,0,44544,6,7212113588
4523,4829800,37281758,42111558,1,0,0,9728,26,10288805352
4524,4829990,36846274,41676264,31,3,0,48640,27,5154133232
4525,4830560,37056112,41886672,37,3,0,126976,15,2766316357
4526,4832021,55624219,60456240,38,3,1,1536,26,5329672004
4527,4832090,37061804,41893894,29,2,0,12288,26,2648574820
4528,4832620,36900894,41733514,23,2,0,27648,4,9166366708
4529,4833381,37321677,42155058,25,2,0,16384,4,2628533221
4530,4834500,36924534,41759034,29,2,0,52224,26,860114846
4531,4834911,37209413,42044324,9,0,0,42496,12,6822882656
4532,4835410,36955539,41790949,11,1,0,9728,6,6416779317
4533,4835731,37419869,42255600,9,0,0,27648,12,6217135083
4534,4837130,36652970,41490100,39,3,0,3072,2,4623667088
4535,4837820,55756719,60594539,14,1,1,20480,8,4139260865
4536,4838250,55850240,60688490,0,0,1,12288,8,256868256
4537,4838850,37192503,42031353,28,2,0,39936,24,1323079301
4538,4839880,36926197,41766077,0,0,0,23040,8,3345560486
4539,4841211,56062051,60903262,30,3,1,5632,3,5933851062
4540,4841400,36764812,41606212,36,3,0,22528,3,7051063450
4541,4841570,37077064,41918634,8,0,0,16896,1,8966331070
4542,4848890,36623034,41471924,31,3,0,20992,27,6230991107
4543,4851980,36940240,41792220,23,2,0,4096,4,8045240337
4544,4852110,37060706,41912816,32,3,0,34816,17,4345000747
4545,4852560,37049625,41902185,32,3,0,27136,17,8769487353
4546,4853060,36994471,41847531,28,2,0,30720,24,4144854982
4547,4856470,37511882,42368352,39,3,0,12288,2,8375723234
4548,4858810,36920048,41778858,15,1,0,6144,19,8742068454
4549,4859090,37086013,41945103,18,1,0,30208,13,1347876480
4550,4859890,36698814,41558704,8,0,0,1024,1,10721175940
4551,4860710,56054142,60914852,2,0,1,10240,3,8602032389
4552,4860910,37139669,42000579,11,1,0,23040,6,4632693271
4553,4861740,36737585,41599325,23,2,0,4608,4,10665343032
4554,4862740,56119608,60982348,6,0,1,21504,24,7304470489
4555,4866199,56153105,61019304,15,1,1,2560,19,9629891324
4556,4866540,37204136,42070676,36,3,0,8704,3,4451431405
4557,4866650,56210545,61077195,0,0,1,13312,8,4860911959
4558,4867160,36654899,41522059,15,1,0,12800,19,5879203136
4559,4871090,56206128,61077218,33,3,1,7168,22,7417625933
4560,4871610,37536663,42408273,5,0,0,64512,4,9696160246
4561,4872280,37275141,42147421,21,2,0,36864,25,1196679154
4562,4872610,37403066,42275676,19,1,0,17920,5,2174089969
4563,4872830,56204411,61077241,33,3,1,2048,22,10530124186
4564,4873441,36867116,41740557,9,0,0,23040,12,2989236393
4565,4874431,36959447,41833878,34,3,0,20992,2,3450673264
4566,4875210,37045163,41920373,8,0,0,5632,1,3110714576
4567,4875811,37588877,42464688,33,3,0,86528,22,3656242600
4568,4876070,37427765,42303835,39,3,0,39936,2,9927876100
4569,4876250,37136114,42012364,21,2,0,15872,25,9985532083
4570,4878050,37378977,42257027,22,2,0,4608,10,2130520579
4571,4878060,37127690,42005750,16,1,0,16896,10,8600025651
4572,4878720,37128769,42007489,15,1,0,5632,19,1844485562
4573,4879470,37188446,42067916,29,2,0,36352,26,5592851036
4574,4879630,37113906,41993536,29,2,0,7680,26,1087946447
4575,4879840,56197915,61077755,2,0,1,12288,3,1723677680
4576,4880460,37692345,42572805,13,1,0,74752,6,8815324238
4577,4882350,37108823,41991173,6,0,0,38912,24,10322605394
4578,4884430,37647285,42531715,11,1,0,44544,6,4095946502
4579,4886461,56191944,61078405,10,1,1,3584,4,3800513936
4580,4886920,37600278,42487198,22,2,0,36864,10,7957412178
4581,4888390,37476195,42364585,36,3,0,16384,3,2642075907
4582,4888660,37024803,41913463,8,0,0,2048,1,3046592140
4583,4889220,37129456,42018676,1,0,0,6656,26,9645077061
4584,4891360,37611663,42503023,4,0,0,40448,14,379462618
4585,4892321,56224126,61116447,10,1,1,28672,4,7776279254
4586,4893140,37411030,42304170,24,2,0,1024,10,1536156188
4587,4893299,56240536,61133835,4,0,1,11776,14,9772663994
4588,4894690,37493904,42388594,13,1,0,57344,6,10070281539
4589,4895461,37161279,42056740,33,3,0,4096,22,4299398337
4590,4896750,56282661,61179411,14,1,1,512,8,7204330539
4591,4899700,37719312,42619012,29,2,0,14848,26,9300700946
4592,4899761,37780199,42679960,33,3,0,91136,22,633649071
4593,4900141,56279293,61179434,10,1,1,1536,4,9615816695
4594,4901020,56278437,61179457,28,2,1,2560,24,5940108747
4595,4901480,37793019,42694499,36,3,0,47616,3,631513364
4596,4902500,37711965,42614465,2,0,0,49664,3,8007724582
4597,4902700,37911162,42813862,19,1,0,25600,5,7234536199
4598,4902780,37308079,42210859,16,1,0,22528,10,8227710332
4599,4905880,37166090,42071970,19,1,0,4096,5,9117058718
4600,4906960,37502116,42409076,6,0,0,2560,24,4891389289
4601,4908270,56303113,61211383,20,2,1,10752,24,5432919694
4602,4908460,56307963,61216423,38,3,1,10240,26,3339556381
4603,4909090,37954112,42863202,24,2,0,27648,10,2067320155
4604,4911760,37509405,42421165,15,1,0,512,19,1950091797
4605,4913350,37628833,42542183,35,3,0,31232,8,8231465047
4606,4914760,37354312,42269072,31,3,0,19968,27,9239161250
4607,4914800,37396024,42310824,15,1,0,12288,19,7960271326
4608,4916531,56323846,61240377,26,2,1,10752,29,5934680672
4609,4916700,38044474,42961174,18,1,0,12800,13,8623247340
4610,4917079,56376865,61293944,11,1,1,2560,6,4377713466
4611,4918370,37570255,42488625,20,2,0,4608,24,7131267311
4612,4919640,37670090,42589730,35,3,0,22528,8,3557274021
4613,4921130,37655918,42577048,15,1,0,13824,19,10565057223
4614,4922520,37498458,42420978,15,1,0,33792,19,7855919704
4615,4922700,37989105,42911805,16,1,0,20992,10,6034078533
4616,4922910,56475297,61398207,27,2,1,3072,9,10293499387
4617,4924010,37930676,42854686,2,0,0,18432,3,3603322359
4618,4924040,56542710,61466750,13,1,1,7168,6,4939279510
4619,4924400,37510346,42434746,13,1,0,9728,6,5429126210
4620,4924780,37485879,42410659,7,0,0,5120,29,8398867241
4621,4927520,37563156,42490676,1,0,0,6656,26,4489405803
4622,4928740,56571707,61500447,29,2,1,5632,26,1097687464
4623,4928870,37653973,42582843,11,1,0,18944,6,1230588409
4624,4929301,37849524,42778825,34,3,0,24064,2,1966374028
4625,4930840,37405917,42336757,0,0,0,36352,8,8952197474
4626,4932470,37719699,42652169,10,1,0,32256,4,1874814781
4627,4932960,37887139,42820099,27,2,0,7168,9,2368324997
4628,4933660,37542283,42475943,23,2,0,36864,4,8199742097
4629,4935410,37614596,42550006,20,2,0,25600,24,7795166902
4630,4937040,37758106,42695146,23,2,0,2048,4,6616248316
4631,4937510,37772198,42709708,26,2,0,7168,29,2763239811
4632,4938800,37700929,42639729,39,3,0,6656,2,8562924684
4633,4938949,56575687,61514636,37,3,1,7168,15,4841179946
4634,4939011,37686428,42625439,33,3,0,20992,22,6821003901
4635,4939090,37572232,42511322,16,1,0,27136,10,2106508950
4636,4939211,56575448,61514659,22,2,1,1536,10,3744773030
4637,4941110,37924957,42866067,22,2,0,2560,10,4114852435
4638,4942240,56591529,61533769,13,1,1,6144,6,3290463449
4639,4942320,37981024,42923344,23,2,0,10752,4,1509457148
4640,4942419,56605283,61547702,23,2,1,9216,4,3634526650
4641,4943370,56707443,61650813,13,1,1,20480,6,7224769907
4642,4944070,38147058,43091128,35,3,0,39936,8,1999092977
4643,4944979,56720634,61665613,11,1,1,5120,6,627474119
4644,4945280,37794083,42739363,14,1,0,10752,8,868406188
4645,4946260,38150975,43097235,5,0,0,19968,4,9647744149
4646,4946280,38586140,43532420,14,1,0,13824,8,1668781076
4647,4946700,37681734,42628434,31,3,0,9728,27,10019094237
4648,4947740,38091474,43039214,16,1,0,5632,10,3542693188
4649,4949200,37649757,42598957,38,3,0,30208,26,7775182886
4650,4951900,37799840,42751740,10,1,0,14848,4,3816888921
4651,4952880,38328364,43281244,20,2,0,16384,24,4992046600
4652,4953870,56712409,61666279,3,0,1,1024,5,2296470932
4653,4954600,37848763,42803363,27,2,0,14336,9,614988391
4654,4955230,38093380,43048610,10,1,0,11264,4,4804215641
4655,4956180,37936680,42892860,23,2,0,19968,4,8921203938
4656,4956540,56813331,61769871,13,1,1,11264,6,1640718909
4657,4958440,38787131,43745571,2,0,0,49664,3,4249017880
4658,4959219,37946167,42905386,17,1,0,11776,28,5801973195
4659,4960430,37838542,42798972,19,1,0,66048,5,8884337352
4660,4961150,56935734,61896884,16,1,1,14848,10,10490374569
4661,4962370,37939405,42901775,14,1,0,29184,8,10123961204
4662,4962500,38066702,43029202,23,2,0,74752,4,7479827622
4663,4963642,38039110,43002752,26,2,0,27648,29,1060815771
4664,4964240,37731553,42695793,2,0,0,2048,3,8942671661
4665,4964580,56933360,61897940,27,2,1,8192,9,4752581015
4666,4965160,38185818,43150978,7,0,0,14848,29,2565863240
4667,4965300,38207668,43172968,21,2,0,66560,25,6389826703
4668,4965320,38459566,43424886,14,1,0,38912,8,6178374011
4669,4965550,38958922,43924472,8,0,0,31232,1,8568672216
4670,4966890,38069401,43036291,31,3,0,11264,27,5562208540
4671,4967090,38160468,43127558,4,0,0,37888,14,7116227234
4672,4968469,56930777,61899246,4,0,1,2048,14,8029345317
4673,4968790,56975686,61944476,14,1,1,1536,8,1886771499
4674,4968930,38541714,43510644,20,2,0,93184,24,6786396356
4675,4969931,56974568,61944499,31,3,1,9216,27,653537786
4676,4970670,38059335,43030005,21,2,0,2560,25,8500307369
4677,4970860,56973662,61944522,16,1,1,6144,10,5228673050
4678,4972030,38672833,43644863,13,1,0,25600,6,3062895358
4679,4972100,38132022,43104122,6,0,0,22528,24,897466755
4680,4972800,38233594,43206394,10,1,0,13824,4,2284621815
4681,4974160,38270119,43244279,8,0,0,19456,1,1381247934
4682,4974610,38223166,43197776,36,3,0,40960,3,4544398162
4683,4974840,38271178,43246018,39,3,0,5632,2,9270690553
4684,4975529,38076908,43052437,17,1,0,8704,28,4937522913
4685,4975960,38202527,43178487,18,1,0,3072,13,4797479831
4686,4976070,38028889,43004959,27,2,0,7168,9,8841094731
4687,4976270,38829285,43805555,39,3,0,16384,2,567517698
4688,4979760,38546842,43526602,5,0,0,44032,4,3864294189
4689,4980350,38087916,43068266,23,2,0,4608,4,9430389438
4690,4980520,38582236,43562756,14,1,0,49664,8,1937482824
4691,4980910,39184969,44165879,24,2,0,14848,10,8836935136
4692,4982180,38349402,43331582,22,2,0,16384,10,1197553916
4693,4982450,39054651,44037101,36,3,0,41984,3,6323893933
4694,4983881,56960664,61944545,10,1,1,1536,4,3166814276
4695,4984700,38048136,43032836,15,1,0,9216,19,1284177184
4696,4984840,38767196,43752036,38,3,0,17920,26,5612470353
4697,4985580,38160309,43145889,18,1,0,3072,13,5722491006
4698,4986310,38866466,43852776,1,0,0,43008,26,7341090161
4699,4988100,38261372,43249472,0,0,0,5120,8,10329686509
4700,4988140,38993143,43981283,18,1,0,36352,13,4915032523
4701,4988870,56955980,61944850,6,0,1,6656,24,3569344085
4702,4989550,38580405,43569955,6,0,0,23552,24,2957967718
4703,4991340,39123361,44114701,13,1,0,44544,6,4822188057
4704,4992760,38320756,43313516,30,3,0,10240,3,6414736961
4705,4992780,57311450,62304230,6,0,1,18944,24,76656509
4706,4993150,38475016,43468166,16,1,0,62976,10,9856107839
4707,4994511,57314408,62308919,21,2,1,16896,25,7299507290
4708,4994520,57319265,62313785,35,3,1,1024,8,690542333
4709,4995610,39426896,44422506,14,1,0,71168,8,7073247899
4710,4996820,38300805,43297625,11,1,0,11264,6,9972218916
4711,5000679,38896861,43897540,17,1,0,18432,28,2825301155
4712,5001850,38581348,43583198,21,2,0,38400,25,949129414
4713,5003910,38726506,43730416,0,0,0,13824,8,2539503726
4714,5004830,38523355,43528185,32,3,0,5120,17,7666075771
4715,5005149,57379904,62385053,15,1,1,3584,19,4923653671
4716,5005990,39599930,44605920,31,3,0,55296,27,6287719047
4717,5008190,38474039,43482229,39,3,0,46080,2,9362364626
4718,5010290,38502873,43513163,38,3,0,8192,26,7521393591
4719,5011120,38367589,43378709,18,1,0,3584,13,3062617809
4720,5011760,38993700,44005460,21,2,0,1024,25,1424882297
4721,5011780,38902038,43913818,23,2,0,2560,4,5969863770
4722,5011840,38376492,43388332,36,3,0,1024,3,3662568062
4723,5012300,38827349,43839649,4,0,0,81920,14,3877164481
4724,5013740,38899267,43913007,26,2,0,50688,29,1616712082
4725,5014775,57542116,62556891,28,2,1,22528,24,3340968796
4726,5015200,38658400,43673600,26,2,0,16384,29,5404302066
4727,5017310,39731494,44748804,22,2,0,59904,10,6501782210
4728,5017580,38863643,43881223,24,2,0,19456,10,7086170621
4729,5019960,57651926,62671886,1,0,1,1024,26,1496262985
4730,5020280,39045671,44065951,29,2,0,15360,26,2613587669
4731,5020490,38737364,43757854,27,2,0,8704,9,9829372697
4732,5021280,38335616,43356896,23,2,0,2560,4,2101317622
4733,5021760,39207742,44229502,0,0,0,18944,8,7579361489
4734,5021770,38653257,43675027,14,1,0,4608,8,5227451688
4735,5025241,39803553,44828794,34,3,0,8192,2,2990990613
4736,5027749,57645431,62673180,23,2,1,4096,4,7702589843
4737,5027770,39073336,44101106,10,1,0,81920,4,7411664205
4738,5027771,38698410,43726181,33,3,0,64512,22,5736609017
4739,5028029,57742069,62770098,15,1,1,512,19,7711890244
4740,5029160,57740961,62770121,38,3,1,9728,26,8344890418
4741,5030200,38908999,43939199,2,0,0,4096,3,1810781980
4742,5031720,38746023,43777743,21,2,0,39424,25,6390266729
4743,5032340,57737812,62770152,16,1,1,3072,10,3643662786
4744,5034040,57746040,62780080,32,3,1,5120,17,9059856576
4745,5034750,38959196,43993946,11,1,0,32256,6,4960017206
4746,5034940,38614158,43649098,18,1,0,13824,13,4616978746
4747,5039510,38814427,43853937,1,0,0,3584,26,1474586478
4748,5040000,38774666,43814666,23,2,0,26624,4,1157654820
4749,5041389,57738714,62780103,5,0,1,1536,4,9067500843
4750,5044679,38830593,43875272,17,1,0,25088,28,1514048650
4751,5044931,39237405,44282336,25,2,0,1024,4,9421216761
4752,5045110,39384462,44429572,13,1,0,23040,6,5281800114
4753,5045500,39008628,44054128,26,2,0,55808,29,7492072342
4754,5047780,38976265,44024045,23,2,0,9216,4,3220661251
4755,5048541,39078062,44126603,33,3,0,30720,22,673800611
4756,5048970,39233031,44282001,39,3,0,11264,2,8668688805
4757,5049430,39727766,44777196,29,2,0,10240,26,3721732289
4758,5049750,57730376,62780126,9,0,1,512,12,7617085274
4759,5052130,39895695,44947825,16,1,0,89600,10,1885143063
4760,5053420,38861513,43914933,8,0,0,3584,1,1563778173
4761,5055610,39629636,44685246,31,3,0,44032,27,4332036778
4762,5056790,38689763,43746553,30,3,0,3072,3,10411419474
4763,5057380,39092665,44150045,32,3,0,512,17,255710685
4764,5058470,38696709,43755179,22,2,0,10240,10,9198977711
4765,5061191,39439906,44501097,33,3,0,12288,22,4633670641
4766,5062831,38998386,44061217,33,3,0,23040,22,10393554512
4767,5064350,39159357,44223707,0,0,0,44544,8,7736376446
4768,5068210,38788558,43856768,24,2,0,9216,10,7275578694
4769,5069060,38708862,43777922,35,3,0,512,8,7355734866
4770,5072319,57707830,62780149,11,1,1,1024,6,8315711282
4771,5073700,39752575,44826275,2,0,0,38912,3,4950681221
4772,5075900,39189199,44265099,11,1,0,52736,6,1248708328
4773,5075940,39222081,44298021,39,3,0,23552,2,7476150259
4774,5076720,40458325,45535045,29,2,0,33792,26,398431422
4775,5077270,39116532,44193802,1,0,0,34816,26,7021989229
4776,5077320,39839265,44916585,19,1,0,5120,5,5135842742
4777,5077700,39367518,44445218,10,1,0,31744,4,421311794
4778,5077730,39945809,45023539,6,0,0,14336,24,8101289994
4779,5078300,39260236,44338536,16,1,0,23552,10,7453362443
4780,5080541,39036679,44117220,9,0,0,8192,12,4385847100
4781,5081880,40108196,45190076,20,2,0,28672,24,6514011031
4782,5082091,39581581,44663672,33,3,0,1024,22,1258674674
4783,5082310,57701749,62784059,12,1,1,9728,3,8557764369
4784,5083790,39194748,44278538,2,0,0,44032,3,4361163851
4785,5086511,39054860,44141371,25,2,0,6656,4,647662145
4786,5088089,39495670,44583759,17,1,0,10240,28,956949970
4787,5089150,39373921,44463071,27,2,0,35840,9,174027441
4788,5090680,40470362,45561042,15,1,0,18944,19,5763644034
4789,5090710,40060049,45150759,23,2,0,90112,4,1743781767
4790,5092250,39695983,44788233,32,3,0,27648,17,6561626362
4791,5093540,39385405,44478945,10,1,0,5120,4,3807342073
4792,5095530,57720404,62815934,25,2,1,4096,4,7158883133
4793,5098670,39451102,44549772,39,3,0,37376,2,6066394237
4794,5099470,39098879,44198349,38,3,0,14848,26,8412721951
4795,5099640,38903753,44003393,1,0,0,8704,26,6430307101
4796,5103140,39568667,44671807,13,1,0,26624,6,1262358033
4797,5105310,57737396,62842706,25,2,1,4608,4,9383564959
4798,5105810,39361028,44466838,1,0,0,12288,26,4196023456
4799,5106230,39234201,44340431,5,0,0,6144,4,9012214068
4800,5107209,57753218,62860427,11,1,1,1024,6,5892926073
4801,5108620,39427351,44535971,13,1,0,47104,6,936275474
4802,5110410,39122079,44232489,19,1,0,9728,5,1593620748
4803,5113570,57746880,62860450,25,2,1,1024,4,5119127540
4804,5114210,40284670,45398880,36,3,0,36352,3,5559079404
4805,5115200,39336928,44452128,24,2,0,9216,10,4409197187
4806,5119750,39251647,44371397,19,1,0,8192,5,5010101342
4807,5120070,40122589,45242659,2,0,0,50688,3,9590208437
4808,5120110,39233350,44353460,21,2,0,2048,25,6029031572
4809,5120980,39221965,44342945,39,3,0,512,2,9368459368
4810,5121200,40383810,45505010,31,3,0,4608,27,621572094
4811,5123600,40079501,45203101,18,1,0,42496,13,1374765516
4812,5127610,57732863,62860473,16,1,1,2560,10,2108946487
4813,5127880,39459646,44587526,20,2,0,12288,24,7464054165
4814,5129450,39346137,44475587,35,3,0,10240,8,3444762150
4815,5129570,39990723,45120293,32,3,0,2560,17,6180835998
4816,5130899,57729837,62860736,18,1,1,3584,13,7525721613
4817,5131080,40043327,45174407,29,2,0,46080,26,2641376385
4818,5132440,39979470,45111910,31,3,0,10752,27,9018791376
4819,5133191,39302332,44435523,34,3,0,19456,2,2320033070
4820,5133310,39380758,44514068,19,1,0,7680,5,2236971127
4821,5133329,39176432,44309761,17,1,0,8704,28,1545348161
4822,5133950,40581672,45715622,11,1,0,8192,6,6236643091
4823,5136460,40523631,45660091,21,2,0,21504,25,6819133187
4824,5137929,57722961,62860890,18,1,1,8704,13,10716916809
4825,5138571,57821820,62960391,26,2,1,1024,29,2535800720
4826,5138730,39399448,44538178,39,3,0,7168,2,3395999341
4827,5139090,39329533,44468623,15,1,0,5632,19,10256712803
4828,5139800,39206363,44346163,36,3,0,1024,3,2965565511
4829,5142370,39306927,44449297,24,2,0,13312,10,3349836664
4830,5143880,40243901,45387781,2,0,0,49152,3,4468126668
4831,5144090,39406329,44550419,15,1,0,2048,19,2633612148
4832,5149080,40150818,45299898,16,1,0,6144,10,5942171622
4833,5149090,39687371,44836461,38,3,0,25088,26,8790729551
4834,5152640,39510697,44663337,19,1,0,38400,5,4748721854
4835,5153599,57806815,62960414,37,3,1,1024,15,6713704724
4836,5154120,57819946,62974066,3,0,1,5632,5,5417845743
4837,5156210,40310948,45467158,0,0,0,48128,8,7692883153
4838,5158180,39403650,44561830,15,1,0,37376,19,7340697091
4839,5159291,57816721,62976012,22,2,1,3072,10,3190227650
4840,5159571,40541655,45701226,33,3,0,50176,22,6498852686
4841,5163520,39522849,44686369,14,1,0,3584,8,4512200236
4842,5164390,40103139,45267529,0,0,0,28672,8,5594464679
4843,5164620,57821402,62986022,16,1,1,11776,10,3390772078
4844,5166280,39677224,44843504,26,2,0,23040,29,1948481356
4845,5167390,39939615,45107005,7,0,0,151040,29,7522155791
4846,5167680,40485836,45653516,5,0,0,58368,4,3806654786
4847,5167730,39947346,45115076,15,1,0,10240,19,10372299562
4848,5169120,40329284,45498404,24,2,0,49152,10,6666120437
4849,5169500,39518452,44687952,11,1,0,5120,6,7667076933
4850,5170740,40054979,45225719,39,3,0,31232,2,2470727504
4851,5173680,39804467,44978147,15,1,0,15872,19,10647837611
4852,5173900,40124095,45297995,16,1,0,13312,10,8322451341
4853,5174141,39835749,45009890,9,0,0,1536,12,4979923341
4854,5175261,40669061,45844322,33,3,0,52736,22,7985646841
4855,5176340,40436204,45612544,27,2,0,90624,9,1173068194
4856,5176810,39942680,45119490,27,2,0,4096,9,7909808536
4857,5177240,39940979,45118219,29,2,0,10240,26,7991434859
4858,5179620,57806748,62986368,6,0,1,512,24,8012663548
4859,5183510,39996380,45179890,36,3,0,17920,3,8514971729
4860,5183710,39679099,44862809,0,0,0,20480,8,3328205910
4861,5183760,40188492,45372252,29,2,0,22528,26,4338515056
4862,5184950,57804644,62989594,28,2,1,5120,24,3336853643
4863,5187930,39656541,44844471,0,0,0,3072,8,9092666501
4864,5188700,39562311,44751011,7,0,0,7168,29,3664611861
4865,5188850,40704789,45893639,26,2,0,2560,29,8816646137
4866,5188909,57859916,63048825,15,1,1,1536,19,6002688135
4867,5189820,40757255,45947075,39,3,0,7168,2,5711048701
4868,5190551,58218759,63409310,30,3,1,102400,3,1664603668
4869,5190900,39615639,44806539,19,1,0,10240,5,1629584795
4870,5192100,58283343,63475443,35,3,1,34304,8,1762085078
4871,5193109,58389475,63582584,18,1,1,30720,13,4116671867
4872,5195210,39714777,44909987,4,0,0,17920,14,9314263848
4873,5196340,39718662,44915002,27,2,0,16384,9,4148477146
4874,5197241,41179832,46377073,33,3,0,34304,22,10636257539
4875,5199180,58419168,63618348,12,1,1,18432,3,9552545578
4876,5199280,40094457,45293737,35,3,0,60928,8,9954121484
4877,5199300,40771042,45970342,37,3,0,6656,15,2214663423
4878,5200680,40644601,45845281,21,2,0,3072,25,823390379
4879,5201369,58449324,63650693,4,0,1,4096,14,9095073012
4880,5202310,39746520,44948830,16,1,0,2048,10,7827018933
4881,5202610,39920670,45123280,38,3,0,9728,26,2808240217
4882,5202741,40659434,45862175,33,3,0,47104,22,4626986899
4883,5203889,58467652,63671541,5,0,1,24064,4,9702989052
4884,5204951,40002869,45207820,25,2,0,15360,4,6624321062
4885,5205890,40954614,46160504,13,1,0,41472,6,10551143618
4886,5206550,39902038,45108588,36,3,0,5120,3,3391984773
4887,5206690,39952383,45159073,36,3,0,27136,3,7243037831
4888,5207310,41064918,46272228,23,2,0,35328,4,1135023067
4889,5207870,40809949,46017819,7,0,0,14336,29,7275119387
4890,5208020,39740140,44948160,26,2,0,1024,29,9432134945
4891,5208490,58463074,63671564,35,3,1,16896,8,51079898
4892,5208710,40274695,45483405,16,1,0,53248,10,1497846625
4893,5210691,58501423,63712114,10,1,1,2560,4,1949464328
4894,5212370,41307401,46519771,26,2,0,27648,29,3484118241
4895,5212990,40819075,46032065,8,0,0,43008,1,6773914780
4896,5213510,39846303,45059813,31,3,0,2048,27,4255166316
4897,5213750,39967567,45181317,23,2,0,4608,4,238523273
4898,5213940,40341074,45555014,2,0,0,2560,3,7186425343
4899,5214520,40112981,45327501,5,0,0,6144,4,10020165982
4900,5215210,39945134,45160344,30,3,0,4096,3,4612867147
4901,5217190,41423355,46640545,10,1,0,29696,4,5085231589
4902,5217320,58494817,63712137,35,3,1,11264,8,5916916770
4903,5218600,40733958,45952558,2,0,0,13824,3,5085413627
4904,5218670,58510253,63728923,24,2,1,3584,10,1535458252
4905,5219120,40074796,45293916,19,1,0,512,5,3027460454
4906,5220150,40298353,45518503,2,0,0,44032,3,4734592109
4907,5221300,40191335,45412635,14,1,0,5632,8,978857224
4908,5222650,40581490,45804140,11,1,0,10240,6,8032086773
4909,5222990,58506394,63729384,13,1,1,10240,6,9071652712
4910,5223010,39986045,45209055,29,2,0,3584,26,6757535570
4911,5223020,40098965,45321985,13,1,0,4608,6,4023778007
4912,5224060,40279523,45503583,13,1,0,16896,6,6716561721
4913,5224460,40111909,45336369,5,0,0,2560,4,766104709
4914,5227000,40482072,45709072,23,2,0,25600,4,8669670926
4915,5227220,40297482,45524702,19,1,0,19968,5,10532266127
4916,5227921,40088640,45316561,33,3,0,6144,22,6707781409
4917,5228570,40521885,45750455,36,3,0,37376,3,4060081240
4918,5230240,40086500,45316740,38,3,0,512,26,2598580771
4919,5230900,40500937,45731837,11,1,0,19968,6,1824224199
4920,5233120,40173780,45406900,31,3,0,3072,27,6076835618
4921,5233310,40092296,45325606,1,0,0,10752,26,6732779600
4922,5234460,40392147,45626607,24,2,0,46080,10,9149641790
4923,5234891,41226782,46461673,33,3,0,37888,22,3409818757
4924,5236010,40645236,45881246,4,0,0,62464,14,256489995
4925,5236170,40165408,45401578,6,0,0,8704,24,6856437611
4926,5236261,58586801,63823062,10,1,1,512,4,2757602350
4927,5237880,41069075,46306955,8,0,0,29696,1,5445780860
4928,5237950,58587378,63825328,20,2,1,3584,24,3453342732
4929,5238290,41544532,46782822,0,0,0,32768,8,3872497896
4930,5238450,40396292,45634742,6,0,0,26624,24,7688526924
4931,5243011,58582663,63825674,26,2,1,512,29,8167799407
4932,5243430,41345709,46589139,5,0,0,46592,4,10260484170
4933,5246390,40292266,45538656,30,3,0,11776,3,5191781674
4934,5249340,58577960,63827300,34,3,1,2560,2,8132065222
4935,5249410,40567855,45817265,26,2,0,27136,29,2232596641
4936,5250600,40160296,45410896,27,2,0,12288,9,922143042
4937,5250969,58577407,63828376,5,0,1,13312,4,8889108575
4938,5251870,40576361,45828231,20,2,0,35840,24,841817424
4939,5253910,58597701,63851611,13,1,1,1536,6,2284101746
4940,5254210,58671426,63925636,29,2,1,18944,26,3963526277
4941,5254950,41442940,46697890,21,2,0,28160,25,8600125314
4942,5256050,58669609,63925659,33,3,1,12288,22,9867663412
4943,5256180,40321914,45578094,14,1,0,19456,8,5400550579
4944,5256239,58695361,63951600,15,1,1,4608,19,5356116012
4945,5256440,40322948,45579388,36,3,0,4096,3,188341444
4946,5258740,58694166,63952906,2,0,1,2048,3,10223618234
4947,5258919,58695613,63954532,4,0,1,2560,14,7911709645
4948,5258921,58697557,63956478,10,1,1,3072,4,778943923
4949,5258980,40424056,45683036,13,1,0,20992,6,6608547624
4950,5263270,40728847,45992117,13,1,0,7680,6,3768436212
4951,5265600,58824634,64090234,13,1,1,23040,6,7590853208
4952,5267120,58922419,64189539,29,2,1,29696,26,251994832
4953,5269230,41503585,46772815,18,1,0,38912,13,10343781550
4954,5269520,40366189,45635709,30,3,0,3072,3,2324071300
4955,5270020,40737555,46007575,14,1,0,23552,8,5628670822
4956,5271320,58976265,64247585,28,2,1,20992,24,7333210919
4957,5273230,58985083,64258313,33,3,1,6144,22,9866814031
4958,5273570,41657248,46930818,32,3,0,15872,17,518050823
4959,5275820,40737608,46013428,39,3,0,15872,2,4014844139
4960,5275980,40829356,46105336,7,0,0,26624,29,7635178556
4961,5277980,40931711,46209691,21,2,0,69632,25,6698123549
4962,5281430,40613488,45894918,23,2,0,4096,4,7292470889
4963,5282570,59014569,64297139,32,3,1,1536,17,7442793894
4964,5284940,59073166,64358106,0,0,1,15360,8,9097830152
4965,5285010,40605463,45890473,18,1,0,30208,13,422263299
4966,5290110,59079655,64369765,24,2,1,29696,10,3969610096
4967,5292480,40555320,45847800,7,0,0,8192,29,3844571084
4968,5292631,40751316,46043947,25,2,0,16896,4,2620979046
4969,5292690,59088875,64381565,32,3,1,6144,17,9003516743
4970,5293340,40660021,45953361,35,3,0,2560,8,152018404
4971,5294161,40848958,46143119,25,2,0,68608,4,1732445296
4972,5296800,40810899,46107699,19,1,0,7680,5,6505090546
4973,5297388,59084536,64381924,34,3,1,9728,2,835539143
4974,5297949,40864918,46162867,17,1,0,7680,28,3928163936
4975,5303440,40589396,45892836,6,0,0,7680,24,2885543337
4976,5303711,40994150,46297861,9,0,0,30208,12,7870724198
4977,5306800,40589677,45896477,32,3,0,2560,17,2934887331
4978,5306959,59238046,64545005,15,1,1,2048,19,5513444730
4979,5307210,40600401,45907611,19,1,0,13824,5,4937695168
4980,5307300,40427828,45735128,21,2,0,512,25,224506128
4981,5307410,41003243,46310653,32,3,0,6656,17,3701163875
4982,5307750,41599706,46907456,35,3,0,7168,8,6540949138
4983,5310380,40628039,45938419,11,1,0,7168,6,517670732
4984,5311205,40785996,46097201,19,1,0,13824,5,9248125087
4985,5313060,40720432,46033492,21,2,0,4608,25,2593227855
4986,5314520,59396678,64711198,6,0,1,15360,24,3731644908
4987,5316769,59454751,64771520,15,1,1,512,19,3603039781
4988,5317580,41003643,46321223,27,2,0,5632,9,8332493022
4989,5317750,41124065,46441815,14,1,0,31232,8,4737894283
4990,5318170,59453373,64771543,25,2,1,8704,4,8552858216
4991,5318450,40829395,46147845,26,2,0,11776,29,7754996443
4992,5321661,40853172,46174833,9,0,0,15360,12,7602883755
4993,5324610,40912775,46237385,29,2,0,18944,26,3336062418
4994,5325010,41660757,46985767,23,2,0,2048,4,5289685507
4995,5325760,41245471,46571231,11,1,0,77824,6,8031662261
4996,5327040,41752277,47079317,10,1,0,28672,4,807222227
4997,5330220,59446681,64776901,2,0,1,8704,3,7483168766
4998,5330840,41162675,46493515,20,2,0,62464,24,8192019098
4999,5331030,41131922,46462952,31,3,0,4096,27,10221237688
5000,5331540,41323445,46654985,35,3,0,13824,8,2002943457
5001,5331581,41011592,46343173,9,0,0,44032,12,5627189450
5002,5332071,59461249,64793320,26,2,1,12800,29,3656218255
5003,5332150,59493817,64825967,1,0,1,8192,26,6691101486
5004,5332980,41162586,46495566,12,1,0,6656,3,1304941937
5005,5333260,40810974,46144234,13,1,0,3584,6,1890756095
5006,5334030,59564780,64898810,20,2,1,17920,24,10255887068
5007,5335150,41698893,47034043,6,0,0,47104,24,2901971099
5008,5335640,40728545,46064185,19,1,0,1536,5,1252112231
5009,5336160,41336036,46672196,16,1,0,8704,10,7369166009
5010,5336920,40924521,46261441,21,2,0,26624,25,6487370566
5011,5337370,41024105,46361475,4,0,0,22528,14,3626087815
5012,5337400,41044064,46381464,35,3,0,14336,8,5380927376
5013,5337440,40839949,46177389,14,1,0,3584,8,5219922107
5014,5338100,40939455,46277555,5,0,0,17408,4,4895683355
5015,5338810,41460192,46799002,13,1,0,29696,6,4774900454
5016,5338840,41385747,46724587,27,2,0,27136,9,80977665
5017,5339820,42065643,47405463,30,3,0,33280,3,2621201517
5018,5340340,41077067,46417407,14,1,0,1536,8,6282405842
5019,5342000,59591409,64933409,27,2,1,28160,9,1682663514
5020,5344420,41255662,46600082,27,2,0,35840,9,8074426048
5021,5345840,42212100,47557940,11,1,0,3584,6,3942885547
5022,5346400,41579559,46925959,32,3,0,1024,17,4368044399
5023,5347290,41713856,47061146,37,3,0,29696,15,9315993876
5024,5347430,41322091,46669521,31,3,0,39424,27,9799621894
5025,5348310,42528930,47877240,0,0,0,111104,8,5153724702
5026,5348341,41101765,46450106,33,3,0,27136,22,10700906343
5027,5350481,59621074,64971555,10,1,1,8192,4,6778150733
5028,5352290,42590980,47943270,38,3,0,34304,26,6998671025
5029,5355680,59616763,64972443,36,3,1,3072,3,4639381790
5030,5355730,41831273,47187003,11,1,0,3072,6,8841185118
5031,5356040,41316647,46672687,16,1,0,1536,10,3320003328
5032,5357350,41265593,46622943,21,2,0,16384,25,7598227361
5033,5358380,42754480,48112860,38,3,0,110080,26,6630745693
5034,5359690,41544132,46903822,39,3,0,17920,2,5505224968
5035,5360790,59616799,64977589,20,2,1,8192,24,3969081097
5036,5362630,41562994,46925624,16,1,0,47104,10,7374458143
5037,5362980,42051242,47414222,26,2,0,28672,29,2811566348
5038,5366090,59639852,65005942,34,3,1,13312,2,7746222160
5039,5366479,41372639,46739118,17,1,0,47616,28,5431982657
5040,5366670,41525181,46891851,21,2,0,130560,25,7316869237
5041,5370140,41174598,46544738,0,0,0,45568,8,9811240509
5042,5373090,41233154,46606244,21,2,0,19456,25,10590485851
5043,5375890,40971695,46347585,36,3,0,1024,3,2617739212
5044,5376530,41660968,47037498,5,0,0,11264,4,6975684880
5045,5377400,41408409,46785809,18,1,0,9728,13,4512187442
5046,5377870,59628418,65006288,16,1,1,512,10,8922882267
5047,5379120,41789431,47168551,35,3,0,20992,8,3226238146
5048,5379350,41771347,47150697,3,0,0,31232,5,9649668655
5049,5382530,59656105,65038635,20,2,1,19456,24,6514498752
5050,5383070,41515269,46898339,32,3,0,2560,17,6726495200
5051,5384410,41331676,46716086,23,2,0,15872,4,9746853198
5052,5387230,41790557,47177787,20,2,0,3072,24,8824422007
5053,5388270,41135580,46523850,23,2,0,13312,4,6495288891
5054,5388460,41662477,47050937,26,2,0,44032,29,7943674207
5055,5388790,42161969,47550759,39,3,0,59904,2,6098162453
5056,5389840,41440789,46830629,22,2,0,9728,10,7016419197
5057,5392170,41856699,47248869,15,1,0,6144,19,10326502934
5058,5392660,59687757,65080417,17,1,1,1024,28,10259519434
5059,5393231,41849690,47242921,33,3,0,3072,22,7677269343
5060,5393450,59686990,65080440,17,1,1,4608,28,1719249807
5061,5393529,59721121,65114650,8,0,1,6144,1,6446751726
5062,5394410,41845813,47240223,2,0,0,51200,3,124379596
5063,5395530,41589590,46985120,30,3,0,25088,3,6922028566
5064,5398200,41540152,46938352,20,2,0,9216,24,3426295265
5065,5399630,41935310,47334940,36,3,0,17408,3,7411620921
5066,5400720,41665042,47065762,13,1,0,512,6,9596345904
5067,5400780,41386144,46786924,13,1,0,3584,6,1254036109
5068,5401170,41496366,46897536,22,2,0,18432,10,6471803290
5069,5403080,41856949,47260029,32,3,0,9728,17,7703585392
5070,5404120,41664637,47068757,14,1,0,9728,8,9253865217
5071,5406120,41982112,47388232,21,2,0,67584,25,6036149570
5072,5406471,59750827,65157298,38,3,1,17920,26,3897369945
5073,5407860,41987440,47395300,24,2,0,12800,10,7746636374
5074,5409649,59924860,65334509,8,0,1,6144,1,8886156886
5075,5411531,41692715,47104246,25,2,0,35328,4,3924435853
5076,5411560,41809617,47221177,5,0,0,68096,4,4439714336
5077,5412190,41493059,46905249,23,2,0,4608,4,9942928591
5078,5415600,41636452,47052052,30,3,0,3584,3,9804318896
5079,5415901,42013085,47428986,34,3,0,12800,2,2853152893
5080,5415969,60145192,65561161,23,2,1,19456,4,6944945499
5081,5416970,41518551,46935521,38,3,0,15360,26,1372506506
5082,5417280,41648280,47065560,10,1,0,14336,4,9720839636
5083,5417711,60145289,65563000,10,1,1,2560,4,1284549008
5084,5418500,41652050,47070550,20,2,0,5632,24,1736207754
5085,5418900,41692919,47111819,24,2,0,6656,10,1043948108
5086,5420440,60176892,65597332,17,1,1,12288,28,10529768324
5087,5420840,41891798,47312638,37,3,0,2048,15,8598824120
5088,5423190,42235629,47658819,26,2,0,12288,29,6255022833
5089,5424190,42734840,48159030,10,1,0,9216,4,9572606870
5090,5425720,41816242,47241962,27,2,0,5632,9,6897348934
5091,5425850,41860961,47286811,37,3,0,3584,15,6747889135
5092,5426581,41827008,47253589,25,2,0,1536,4,5736923891
5093,5428330,41724106,47152436,39,3,0,5632,2,3695800147
5094,5428541,41688830,47117371,33,3,0,15872,22,6864497830
5095,5432230,41991866,47424096,1,0,0,18944,26,9474890282
5096,5432241,60165114,65597355,21,2,1,9216,25,10084622533
5097,5433120,42141417,47574537,20,2,0,44032,24,8953088366
5098,5434630,41724743,47159373,35,3,0,13824,8,5830483199
5099,5435590,41932027,47367617,8,0,0,61440,1,4975592672
5100,5435781,42549702,47985483,25,2,0,5120,4,162869777
5101,5436090,41982211,47418301,32,3,0,13312,17,10447488552
5102,5437720,42045095,47482815,24,2,0,46592,10,239487355
5103,5438600,41952307,47390907,32,3,0,8704,17,671956480
5104,5439780,42864927,48304707,6,0,0,15872,24,5356823958
5105,5441569,60177093,65618662,37,3,1,26112,15,9124611202
5106,5442479,60359631,65802110,11,1,1,9728,6,3500393989
5107,5443711,43044649,48488360,25,2,0,24576,4,3959869580
5108,5444670,42257384,47702054,30,3,0,9216,3,4313831805
5109,5445510,41809303,47254813,26,2,0,512,29,3877267186
5110,5445663,41805725,47251388,27,2,0,8192,9,944072331
5111,5446080,42198569,47644649,7,0,0,50176,29,5920873447
5112,5447770,60377239,65825009,2,0,1,13312,3,6682726990
5113,5447921,60431187,65879108,22,2,1,13824,10,19848726
5114,5448180,42077031,47525211,16,1,0,16384,10,7759006206
5115,5449990,42358121,47808111,3,0,0,60416,5,1122024438
5116,5450470,42003636,47454106,36,3,0,33280,3,10447978791
5117,5450950,42079123,47530073,14,1,0,2560,8,6100382794
5118,5451499,60526557,65978056,8,0,1,26112,1,8691740218
5119,5451750,42198390,47650140,8,0,0,17920,1,4305157103
5120,5451910,42301375,47753285,7,0,0,33280,29,337199598
5121,5452010,42330010,47782020,30,3,0,14848,3,1474005871
5122,5452011,42434776,47886787,34,3,0,31232,2,10129091066
5123,5453809,42965626,48419435,17,1,0,8704,28,10354301080
5124,5454280,41982642,47436922,18,1,0,24576,13,740368553
5125,5454390,41970673,47425063,18,1,0,3072,13,4300396645
5126,5454770,42161551,47616321,19,1,0,47104,5,10272767429
5127,5455330,60522749,65978079,17,1,1,12288,28,5339356762
5128,5456250,42214834,47671084,7,0,0,21504,29,1333065150
5129,5456800,42706680,48163480,37,3,0,6144,15,9798907386
5130,5460120,42194932,47655052,0,0,0,9216,8,3690780119
5131,5461619,42325871,47787490,17,1,0,1024,28,9423924456
5132,5461940,60624077,66086017,3,0,1,13312,5,1497233180
5133,5462371,60625912,66088283,26,2,1,3584,29,9664544541
5134,5464840,42086722,47551562,36,3,0,2560,3,1941772020
5135,5466410,42464791,47931201,31,3,0,65024,27,6090843897
5136,5466881,42754201,48221082,34,3,0,40960,2,4976239940
5137,5474420,42224803,47699223,10,1,0,30720,4,4345424659
5138,5474520,42366018,47840538,13,1,0,4096,6,3294015015
5139,5475160,42368174,47843334,21,2,0,4608,25,6124564698
5140,5475360,42151748,47627108,15,1,0,35328,19,4700558464
5141,5477260,42152078,47629338,29,2,0,512,26,10323349604
5142,5478130,42037492,47515622,3,0,0,32768,5,7663005109
5143,5479420,42112963,47592383,13,1,0,14848,6,1725341810
5144,5480440,42262682,47743122,13,1,0,14336,6,2666581638
5145,5482171,60609338,66091509,19,1,1,5120,5,306627263
5146,5482810,42276434,47759244,19,1,0,19456,5,6916872505
5147,5482941,42328863,47811804,25,2,0,11776,4,5303282554
5148,5485240,60692982,66178222,17,1,1,2048,28,9133193605
5149,5486440,60695008,66181448,27,2,1,5120,9,10609490198
5150,5486530,42592767,48079297,11,1,0,49664,6,1377802337
5151,5486660,42142499,47629159,36,3,0,6656,3,5597402344
5152,5486679,60705713,66192392,15,1,1,6656,19,1130707675
5153,5486800,42193667,47680467,5,0,0,30720,4,4368162376
5154,5486990,42290290,47777280,1,0,0,19968,26,4895896233
5155,5487030,60860050,66347080,35,3,1,12288,8,7699043339
5156,5487520,42412885,47900405,16,1,0,16896,10,7570159810
5157,5488541,42332821,47821362,9,0,0,3072,12,6154864609
5158,5489730,42463512,47953242,22,2,0,31232,10,8222060933
5159,5489770,60857333,66347103,14,1,1,3584,8,1577355876
5160,5490710,42570289,48060999,10,1,0,91648,4,4245113007
5161,5492490,60856375,66348865,29,2,1,5632,26,4771708694
5162,5493550,60855338,66348888,17,1,1,1536,28,10689432163
5163,5494030,42437350,47931380,7,0,0,512,29,7277843869
5164,5497370,42336592,47833962,29,2,0,4096,26,9313533163
5165,5499510,42514234,48013744,18,1,0,27648,13,10040628064
5166,5499990,42740884,48240874,3,0,0,27136,5,7278457079
5167,5500820,42826998,48327818,10,1,0,75776,4,6911932529
5168,5500960,42476131,47977091,29,2,0,23040,26,7740336133
5169,5503700,42454592,47958292,39,3,0,4608,2,6889324506
5170,5505010,60843901,66348911,6,0,1,14336,24,4531483965
5171,5505299,42389935,47895234,17,1,0,27648,28,2552309042
5172,5505940,60850388,66356328,29,2,1,2560,26,2178322445
5173,5508120,42523092,48031212,32,3,0,44544,17,998385270
5174,5508380,42400081,47908461,10,1,0,1536,4,6471020373
5175,5508610,43021508,48530118,39,3,0,30208,2,749814329
5176,5509481,42773547,48283028,25,2,0,48128,4,2573361736
5177,5509820,42920402,48430222,19,1,0,35328,5,1892873820
5178,5511271,42458777,47970048,34,3,0,5120,2,955859361
5179,5511620,42552522,48064142,23,2,0,10240,4,831930451
5180,5513580,42753022,48266602,30,3,0,76288,3,2266322801
5181,5513990,43109926,48623916,8,0,0,25600,1,9585647173
5182,5514250,60844374,66358624,33,3,1,5120,22,1619862917
5183,5514600,60886884,66401484,6,0,1,5632,24,220348716
5184,5516490,42895567,48412057,37,3,0,54272,15,7374235837
5185,5518960,61050304,66569264,38,3,1,19456,26,4918533283
5186,5521421,61048714,66570135,31,3,1,12288,27,352670053
5187,5521870,42610692,48132562,1,0,0,57344,26,5476171500
5188,5521940,43022489,48544429,14,1,0,10752,8,6704965897
5189,5522320,43077120,48599440,27,2,0,17920,9,8032564154
5190,5524240,42871258,48395498,20,2,0,13312,24,201047729
5191,5526310,43077677,48603987,31,3,0,14848,27,3719206649
5192,5526340,43239950,48766290,38,3,0,48128,26,4250245166
5193,5527850,61805778,67333628,3,0,1,27136,5,3796865138
5194,5528840,61804811,67333651,29,2,1,1024,26,6870763150
5195,5531220,42914336,48445556,3,0,0,26624,5,101292735
5196,5532019,61823747,67355766,18,1,1,4608,13,9613848984
5197,5533570,42581497,48115067,14,1,0,7168,8,3167469794
5198,5534640,43097676,48632316,18,1,0,7168,13,4658753527
5199,5535470,42760381,48295851,20,2,0,41984,24,3136605490
5200,5535710,61820079,67355789,14,1,1,4608,8,1437173328
5201,5536570,43057387,48593957,11,1,0,11264,6,6421190872
5202,5537290,61835754,67373044,1,0,1,10752,26,7304686385
5203,5538220,42964208,48502428,22,2,0,8192,10,1383597955
5204,5538750,62006762,67545512,29,2,1,12288,26,9881857393
5205,5538800,43104456,48643256,21,2,0,5120,25,1320802868
5206,5539400,42898021,48437421,14,1,0,23552,8,2610994376
5207,5539830,43313094,48852924,27,2,0,8704,9,431537782
5208,5539960,43050542,48590502,19,1,0,13824,5,10360306811
5209,5540280,42728061,48268341,16,1,0,5632,10,9277367093
5210,5540820,43017618,48558438,30,3,0,23552,3,6864758377
5211,5541250,43024187,48565437,10,1,0,11264,4,3586714086
5212,5542059,43296292,48838351,17,1,0,61952,28,6391235396
5213,5542710,42757138,48299848,26,2,0,7168,29,10709720778
5214,5543430,43027802,48571232,36,3,0,18944,3,3504822620
5215,5543440,42788682,48332122,21,2,0,13824,25,8011252492
5216,5544570,62009732,67554302,12,1,1,2048,3,5426944600
5217,5545120,62496873,68041993,39,3,1,182272,2,6672984975
5218,5546770,62496361,68043131,6,0,1,10240,24,3447608381
5219,5546990,43619825,49166815,35,3,0,26112,8,2314812774
5220,5549651,43246736,48796387,25,2,0,59392,4,5512231590
5221,5549850,43219739,48769589,32,3,0,10752,17,1265951609
5222,5550090,43313621,48863711,19,1,0,35328,5,7172633578
5223,5550879,62523518,68074397,18,1,1,8192,13,2757098865
5224,5551061,62523359,68074420,26,2,1,512,29,7171720954
5225,5551601,42865159,48416760,9,0,0,15360,12,10701462577
5226,5552991,43290063,48843054,25,2,0,15360,4,4166716097
5227,5556120,43078608,48634728,7,0,0,5632,29,10175953253
5228,5558561,62515882,68074443,10,1,1,2048,4,1761732982
5229,5558610,43758188,49316798,5,0,0,112128,4,8797368578
5230,5559770,43410509,48970279,14,1,0,48128,8,8000251041
5231,5560819,62596772,68157591,8,0,1,3072,1,9072294661
5232,5562350,43504744,49067094,21,2,0,50176,25,3538124115
5233,5562740,42958151,48520891,6,0,0,10240,24,669829944
5234,5562890,42933917,48496807,14,1,0,27648,8,5483858193
5235,5563630,43442699,49006329,5,0,0,23552,4,5616981048
5236,5564650,43409396,48974046,3,0,0,12288,5,8711178861
5237,5565190,43359117,48924307,2,0,0,45568,3,3528229471
5238,5566470,44058392,49624862,1,0,0,52224,26,522412265
5239,5567240,43607866,49175106,39,3,0,27136,2,3339721215
5240,5571000,43110588,48681588,37,3,0,32768,15,5857428739
5241,5572410,43247042,48819452,20,2,0,26624,24,108113443
5242,5572990,62584624,68157614,24,2,1,2560,10,7135994058
5243,5575631,43419732,48995363,34,3,0,45056,2,4688928720
5244,5575859,43084470,48660329,17,1,0,9216,28,8694089660
5245,5576380,43441360,49017740,1,0,0,37376,26,6483297189
5246,5576780,43494820,49071600,21,2,0,7680,25,1227368614
5247,5578700,43462828,49041528,10,1,0,11776,4,5704127164
5248,5579260,43991126,49570386,22,2,0,56320,10,2933134663
5249,5580321,43327371,48907692,25,2,0,27136,4,3310261333
5250,5580600,43268413,48849013,39,3,0,19456,2,9406854557
5251,5581010,63037402,68618412,33,3,1,176128,22,9387949007
5252,5583720,63034715,68618435,29,2,1,6144,26,6541968140
5253,5584150,43453759,49037909,20,2,0,10752,24,5488895438
5254,5585350,43413780,48999130,29,2,0,12288,26,3016340125
5255,5585530,44424884,50010414,31,3,0,12288,27,5562567278
5256,5588910,43618555,49207465,29,2,0,7168,26,10083832173
5257,5589750,63049601,68639351,16,1,1,35328,10,5360201219
5258,5589840,44455464,50045304,1,0,0,9728,26,7343483731
5259,5589860,63062660,68652520,39,3,1,19968,2,9387734031
5260,5591840,44639120,50230960,8,0,0,35840,1,5577629304
5261,5596510,44634808,50231318,31,3,0,1024,27,6718486372
5262,5597221,63065608,68662829,26,2,1,7168,29,3245798882
5263,5597320,43199246,48796566,38,3,0,512,26,48713492
5264,5599260,43625144,49224404,20,2,0,36864,24,504011239
5265,5599290,44467781,50067071,23,2,0,7680,4,7937736627
5266,5600281,44534049,50134330,25,2,0,41984,4,5308190344
5267,5602860,43448675,49051535,3,0,0,32768,5,3194963701
5268,5604740,43331129,48935869,3,0,0,22016,5,9086626532
5269,5605030,44335427,49940457,32,3,0,29184,17,5438153360
5270,5605881,43342580,48948461,9,0,0,8192,12,6641838649
5271,5606530,43639002,49245532,7,0,0,512,29,10686944027
5272,5606691,43318887,48925578,25,2,0,4096,4,5375791062
5273,5606740,44657350,50264090,24,2,0,11776,10,1142973515
5274,5607010,44026611,49633621,29,2,0,28672,26,8209530443
5275,5607480,43427107,49034587,14,1,0,37376,8,118218435
5276,5607650,43745779,49353429,22,2,0,8192,10,9142024381
5277,5607840,63084912,68692752,34,3,1,16896,2,10224099991
5278,5608720,63114880,68723600,32,3,1,2048,17,903221120
5279,5613410,44695845,50309255,37,3,0,43008,15,5697077887
5280,5613780,43437934,49051714,16,1,0,512,10,901166546
5281,5614880,43704281,49319161,26,2,0,7680,29,5658256381
5282,5615270,43827041,49442311,2,0,0,9216,3,9842941420
5283,5615500,43629853,49245353,39,3,0,28160,2,4920387973
5284,5617231,43962850,49580081,25,2,0,31744,4,6216729666
5285,5619230,63114510,68733740,0,0,1,1536,8,7749836869
5286,5619250,44063729,49682979,21,2,0,37888,25,6174133263
5287,5619790,43748794,49368584,18,1,0,49664,13,8655296210
5288,5621040,44127043,49748083,19,1,0,56832,5,6246210882
5289,5621358,63167851,68789209,24,2,1,10240,10,2690414224
5290,5621630,43555527,49177157,0,0,0,6656,8,8638290720
5291,5622120,44912327,50534447,38,3,0,16384,26,9695572152
5292,5623190,43746665,49369855,1,0,0,4096,26,9598625122
5293,5623750,44146390,49770140,14,1,0,512,8,3919418955
5294,5625231,43847854,49473085,34,3,0,13312,2,7201014985
5295,5625840,43704264,49330104,37,3,0,35840,15,4647696726
5296,5626310,44018612,49644922,38,3,0,23552,26,5855426396
5297,5626460,44988587,50615047,13,1,0,38912,6,6360305488
5298,5626469,43892966,49519435,17,1,0,19456,28,7446743626
5299,5627840,43902850,49530690,35,3,0,36864,8,1305437611
5300,5629390,63161765,68791155,9,0,1,3072,12,7819589011
5301,5631230,43715685,49346915,13,1,0,27648,6,10081879196
5302,5631340,44840857,50472197,24,2,0,14848,10,3141060019
5303,5632530,43908479,49541009,22,2,0,33792,10,9465349006
5304,5632941,43877466,49510407,25,2,0,3072,4,7061673239
5305,5635090,44211116,49846206,18,1,0,42496,13,5626679384
5306,5638600,44809749,50448349,24,2,0,33280,10,9656956959
5307,5639190,43856063,49495253,22,2,0,34816,10,9977527097
5308,5640260,63156067,68796327,27,2,1,8192,9,1548399451
5309,5646500,44016416,49662916,20,2,0,38912,24,2601778361
5310,5647190,45012440,50659630,13,1,0,13312,6,222428340
5311,5647460,43687460,49334920,19,1,0,512,5,8654582582
5312,5647520,43602633,49250153,5,0,0,3584,4,8610272677
5313,5648020,43960907,49608927,32,3,0,48128,17,10400201698
5314,5649270,44691933,50341203,32,3,0,22016,17,2109580889
5315,5651110,43827770,49478880,6,0,0,18944,24,1297776283
5316,5651180,43986543,49637723,26,2,0,10240,29,671434809
5317,5652290,44214034,49866324,29,2,0,10240,26,8413004115
5318,5653030,63237886,68890916,38,3,1,3072,26,3063139532
5319,5654720,44070793,49725513,39,3,0,41472,2,256435989
5320,5657050,63233889,68890939,14,1,1,4096,8,4179046633
5321,5657840,43976740,49634580,4,0,0,3072,14,5856827398
5322,5660791,44094024,49754815,9,0,0,18432,12,7616993905
5323,5661510,44329971,49991481,35,3,0,35328,8,755207581
5324,5662380,63228582,68890962,27,2,1,2560,9,9013543942
5325,5662520,44003857,49666377,19,1,0,8704,5,136358477
5326,5662610,45080361,50742971,38,3,0,53248,26,3329529193
5327,5663460,43987577,49651037,38,3,0,19968,26,3084743654
5328,5664331,63226654,68890985,31,3,1,1536,27,2559504494
5329,5664800,44105161,49769961,19,1,0,39936,5,7918034916
5330,5665660,44399048,50064708,38,3,0,53248,26,8389778040
5331,5665910,44122465,49788375,35,3,0,9728,8,128070190
5332,5666100,63224908,68891008,28,2,1,3584,24,1181962167
5333,5666260,44166975,49833235,19,1,0,2560,5,7432618317
5334,5668290,44783649,50451939,5,0,0,5120,4,4785275729
5335,5668580,63222451,68891031,25,2,1,10752,4,877900545
5336,5671730,45228039,50899769,26,2,0,62976,29,7615643410
5337,5672020,44160412,49832432,16,1,0,17920,10,7442761112
5338,5675460,44519262,50194722,10,1,0,60416,4,8631555673
5339,5677930,44022958,49700888,36,3,0,4096,3,7219177524
5340,5682521,63246104,68928625,31,3,1,41984,27,2558377149
5341,5685330,45139967,50825297,27,2,0,45056,9,4697967269
5342,5686610,44211871,49898481,35,3,0,7680,8,8255314706
5343,5687760,45261107,50948867,16,1,0,86528,10,9796607124
5344,5687961,63266132,68954093,7,0,1,3072,29,5086272638
5345,5688120,44531897,50220017,15,1,0,82944,19,3732419686
5346,5688920,45636365,51325285,13,1,0,14336,6,6372659048
5347,5691940,45804251,51496191,2,0,0,34816,3,3998899750
5348,5693589,63323624,69017213,8,0,1,3072,1,2370594730
5349,5694520,45367646,51062166,2,0,0,13312,3,1098576968
5350,5695090,44375436,50070526,8,0,0,11264,1,7610044049
5351,5697570,44595646,50293216,36,3,0,21504,3,3299690612
5352,5697830,44384041,50081871,24,2,0,31744,10,8855462882
5353,5698490,44192401,49890891,8,0,0,2048,1,6064949230
5354,5699711,44117914,49817625,25,2,0,9728,4,10140563424
5355,5704010,44435514,50139524,1,0,0,6144,26,4849925588
5356,5704240,63312996,69017236,12,1,1,512,3,4574998169
5357,5704600,44170961,49875561,37,3,0,12800,15,5282857252
5358,5706440,44383489,50089929,5,0,0,10240,4,8266469387
5359,5707460,44524193,50231653,24,2,0,1024,10,2299462512
5360,5708219,63987339,69695558,8,0,1,182784,1,4058852339
5361,5708960,45453713,51162673,31,3,0,14336,27,10613166519
5362,5709740,44619097,50328837,38,3,0,7168,26,2050636017
5363,5712180,45283242,50995422,37,3,0,1536,15,4708598438
5364,5712249,44815453,50527702,17,1,0,1024,28,1700412736
5365,5712719,64038939,69751658,8,0,1,29184,1,4965593163
5366,5714880,44422749,50137629,7,0,0,10752,29,441112930
5367,5715100,44733896,50448996,4,0,0,2048,14,5942195060
5368,5715410,44611220,50326630,29,2,0,35328,26,5470314739
5369,5715461,44545018,50260479,25,2,0,10752,4,6368356046
5370,5717840,45162710,50880550,0,0,0,15872,8,5184704330
5371,5718730,44513772,50232502,37,3,0,2560,15,5726196930
5372,5718810,44713706,50432516,29,2,0,28672,26,624556007
5373,5720059,64035465,69755524,15,1,1,6144,19,10064690805
5374,5720480,44672294,50392774,22,2,0,19456,10,10604354664
5375,5722280,44545054,50267334,3,0,0,4096,5,758326876
5376,5723240,44635013,50358253,30,3,0,9728,3,7948169519
5377,5723910,44385519,50109429,23,2,0,5120,4,5717434336
5378,5724830,44802537,50527367,27,2,0,13312,9,5326712236
5379,5726361,44628905,50355266,34,3,0,46080,2,4329682193
5380,5726440,45300446,51026886,13,1,0,55808,6,466233658
5381,5726670,64031120,69757790,27,2,1,3584,9,3942347935
5382,5726840,45307729,51034569,24,2,0,25088,10,4320257757
5383,5727430,64046710,69774140,6,0,1,2048,24,4976790836
5384,5727840,44513236,50241076,37,3,0,6656,15,9982955152
5385,5730190,45264741,50994931,22,2,0,2048,10,466128800
5386,5731670,44692064,50423734,20,2,0,59392,24,8378549958
5387,5731839,64179225,69911064,8,0,1,87040,1,8724592535
5388,5732489,64212640,69945129,8,0,1,53248,1,3800774601
5389,5733760,45505217,51238977,15,1,0,34304,19,10269446571
5390,5734551,64232293,69966844,19,1,1,1536,5,5344338754
5391,5736320,44823407,50559727,18,1,0,1024,13,3367156762
5392,5737681,44700482,50438163,25,2,0,18432,4,4247634864
5393,5737780,44776440,50514220,39,3,0,22528,2,8295271172
5394,5738090,44891488,50629578,35,3,0,47616,8,3712351415
5395,5739950,44570264,50310214,24,2,0,3072,10,5683553497
5396,5741340,44620171,50361511,31,3,0,512,27,2054999140
5397,5741360,44909020,50650380,19,1,0,36352,5,8984337192
5398,5742040,64226263,69968303,9,0,1,4608,12,7879378462
5399,5743010,44973815,50716825,16,1,0,18944,10,1961572735
5400,5744120,44756335,50500455,3,0,0,16896,5,9017028251
5401,5744230,64224419,69968649,28,2,1,512,24,9967849140
5402,5746150,45874020,51620170,14,1,0,20992,8,462575679
5403,5746540,45129151,50875691,31,3,0,7680,27,8806425526
5404,5746640,44825636,50572276,1,0,0,21504,26,6040373498
5405,5749470,64243135,69992605,16,1,1,10752,10,2074121581
5406,5751480,45615852,51367332,13,1,0,20480,6,3114589602
5407,5751770,44724350,50476120,29,2,0,12800,26,6233352399
5408,5752360,44708958,50461318,26,2,0,16384,29,5516977950
5409,5756440,45957925,51714365,35,3,0,7168,8,8861300850
5410,5757290,45082681,50839971,21,2,0,21504,25,5485740325
5411,5758080,45394182,51152262,31,3,0,11776,27,7569866382
5412,5758160,44815231,50573391,27,2,0,3584,9,4955983584
5413,5759731,64239353,69999084,7,0,1,31744,29,10280375202
5414,5759820,45194218,50954038,21,2,0,16896,25,1416148948
5415,5761160,44812566,50573726,15,1,0,1024,19,2776304557
5416,5761270,44996990,50758260,36,3,0,512,3,4561221016
5417,5763450,44892101,50655551,29,2,0,16896,26,5692579167
5418,5764649,64238621,70003270,8,0,1,6656,1,9598685686
5419,5765310,45202175,50967485,32,3,0,44032,17,2697640543
5420,5765740,45002142,50767882,38,3,0,18432,26,3647594150
5421,5765909,45274711,51040620,17,1,0,13312,28,8962080044
5422,5766830,64276283,70043113,35,3,1,14336,8,314495310
5423,5767060,64347149,70114209,9,0,1,512,12,3728738233
5424,5767120,44923678,50690798,16,1,0,25600,10,5347207690
5425,5767460,45029098,50796558,38,3,0,4096,26,10675619978
5426,5767531,44871742,50639273,33,3,0,31744,22,5977546849
5427,5771080,45447213,51218293,23,2,0,54784,4,1325215675
5428,5771610,45091822,50863432,27,2,0,13312,9,9848278445
5429,5772430,44806080,50578510,29,2,0,4096,26,10162812882
5430,5772810,45351112,51123922,18,1,0,28672,13,4546269895
5431,5773390,64343405,70116795,36,3,1,4096,3,8282136561
5432,5773650,45236147,51009797,4,0,0,47104,14,2191616805
5433,5773980,44887857,50661837,23,2,0,7168,4,6692530490
5434,5774430,44947918,50722348,31,3,0,7680,27,6964549930
5435,5775390,46095905,51871295,29,2,0,74240,26,1513922612
5436,5777171,64357495,70134666,10,1,1,9728,4,1272983672
5437,5777460,45140803,50918263,39,3,0,4608,2,323558107
5438,5779400,45278687,51058087,28,2,0,21504,24,4084202848
5439,5779710,44884178,50663888,19,1,0,6656,5,10281523530
5440,5780829,45024326,50805155,17,1,0,5120,28,2201522418
5441,5782080,45064875,50846955,38,3,0,4096,26,10434214192
5442,5782210,46339471,52121681,13,1,0,10240,6,6447243179
5443,5782660,45514742,51297402,4,0,0,18944,14,3135163573
5444,5783790,45206034,50989824,38,3,0,73216,26,9893175023
5445,5784740,46787535,52572275,21,2,0,54784,25,1764268123
5446,5787800,64351163,70138963,28,2,1,6656,24,5041995680
5447,5788040,64399671,70187711,32,3,1,5120,17,4433112114
5448,5789530,45887091,51676621,26,2,0,7168,29,2526605725
5449,5790090,64397644,70187734,36,3,1,13312,3,7845783088
5450,5790280,45200347,50990627,20,2,0,2560,24,4325075308
5451,5792040,46618157,52410197,31,3,0,23040,27,3212702013
5452,5792860,46921513,52714373,30,3,0,51200,3,3038710123
5453,5792870,46391497,52184367,26,2,0,4608,29,1393341554
5454,5793041,46552953,52345994,25,2,0,41472,4,668567627
5455,5793880,45242584,51036464,14,1,0,6144,8,2723699558
5456,5796409,64453409,70249818,8,0,1,13824,1,5581842225
5457,5798001,64938326,70736327,30,3,1,258560,3,1779546519
5458,5798090,45283959,51082049,2,0,0,3072,3,7067143732
5459,5799151,45532093,51331244,9,0,0,19456,12,9635560312
5460,5800431,45779894,51580325,34,3,0,62464,2,7515042764
5461,5800640,45520254,51320894,24,2,0,36352,10,6998238211
5462,5801240,45508555,51309795,20,2,0,14336,24,4479313680
5463,5803470,45424986,51228456,3,0,0,33280,5,9756093728
5464,5804311,45273480,51077791,25,2,0,30720,4,7014243444
5465,5806680,45439387,51246067,35,3,0,12288,8,4609818834
5466,5807919,64951089,70759008,18,1,1,512,13,840186591
5467,5810820,45298375,51109195,10,1,0,24064,4,1866321595
5468,5812680,45181604,50994284,22,2,0,11264,10,2108238762
5469,5812960,45933119,51746079,23,2,0,33792,4,9285249319
5470,5813550,46105527,51919077,23,2,0,153600,4,9260832039
5471,5814540,45176289,50990829,35,3,0,512,8,1817233877
5472,5814810,45589788,51404598,10,1,0,18432,4,3789598278
5473,5815110,45343103,51158213,39,3,0,19456,2,10260712396
5474,5815191,45721802,51536993,33,3,0,37888,22,10094891950
5475,5815710,64943321,70759031,14,1,1,512,8,832331485
5476,5816840,45644767,51461607,18,1,0,14848,13,3606563346
5477,5817350,64941704,70759054,1,0,1,1536,26,2271687702
5478,5818901,45596283,51415184,34,3,0,8192,2,6352676962
5479,5820510,46564347,52384857,21,2,0,23040,25,2474432943
5480,5821220,45293943,51115163,7,0,0,14848,29,10104073218
5481,5821480,46511855,52333335,28,2,0,16384,24,920923287
5482,5822350,45368528,51190878,38,3,0,13312,26,3474569858
5483,5823451,45445447,51268898,9,0,0,3072,12,8998645621
5484,5824520,64934557,70759077,17,1,1,1024,28,9772261572
5485,5825400,46230279,52055679,22,2,0,25088,10,8014047501
5486,5827600,45562421,51390021,23,2,0,7168,4,4990433651
5487,5829730,46092646,51922376,31,3,0,10752,27,9054995285
5488,5831151,64952884,70784035,34,3,1,15872,2,10507880322
5489,5831379,64953322,70784701,18,1,1,1024,13,726715586
5490,5833751,64952256,70786007,26,2,1,2048,29,9894805538
5491,5835760,46270556,52106316,24,2,0,29696,10,6042199618
5492,5838430,46668937,52507367,19,1,0,17920,5,4979893910
5493,5843400,46464144,52307544,4,0,0,82944,14,8957741868
5494,5843471,65064412,70907883,7,0,1,131072,29,2797557365
5495,5845530,65076446,70921976,9,0,1,26112,12,10527719253
5496,5846550,45454151,51300701,20,2,0,10752,24,4969359928
5497,5847401,65100839,70948240,30,3,1,17408,3,2352270934
5498,5848510,65099753,70948263,0,0,1,1024,8,3700607934
5499,5848910,45692474,51541384,4,0,0,14336,14,8127318368
5500,5848990,65099296,70948286,24,2,1,13312,10,4960473315
5501,5850650,47010417,52861067,5,0,0,77824,4,6236839715
5502,5851441,45704402,51555843,33,3,0,3584,22,7728433797
5503,5853521,65129651,70983172,19,1,1,3072,5,9189700151
5504,5853840,45872783,51726623,26,2,0,37376,29,7740305650
5505,5859669,65206222,71065891,37,3,1,53248,15,4229774483
5506,5859900,45445504,51305404,37,3,0,15360,15,4834339724
5507,5860870,45538089,51398959,30,3,0,11264,3,3591079909
5508,5861670,45812744,51674414,21,2,0,53760,25,422743554
5509,5862931,65264326,71127257,30,3,1,23040,3,5240714685
5510,5863350,45589593,51452943,15,1,0,67072,19,9122616247
5511,5863420,46319520,52182940,4,0,0,30208,14,6842579982
5512,5864760,46573384,52438144,28,2,0,91648,24,2995453897
5513,5864830,45635939,51500769,18,1,0,6144,13,5010277672
5514,5865819,46071694,51937513,17,1,0,18944,28,2889664624
5515,5866330,65262233,71128563,6,0,1,2048,24,7337019102
5516,5866520,46005734,51872254,16,1,0,3072,10,10658602602
5517,5867160,45922756,51789916,35,3,0,2560,8,838127471
5518,5869810,45911613,51781423,4,0,0,47104,14,3179987616
5519,5870070,45919043,51789113,4,0,0,9216,14,10712422227
5520,5871010,45955283,51826293,2,0,0,33792,3,9158386710
5521,5871580,45914702,51786282,18,1,0,15872,13,6321801890
5522,5871811,47205666,53077477,33,3,0,104448,22,3428570438
5523,5872611,45839547,51712158,25,2,0,29696,4,8727971198
5524,5873731,45746930,51620661,9,0,0,1536,12,4386046814
5525,5875081,46047630,51922711,33,3,0,1024,22,2965134790
5526,5875120,45952912,51828032,22,2,0,5632,10,3629041486
5527,5875140,45973512,51848652,19,1,0,37888,5,6918807986
5528,5876830,46171182,52048012,28,2,0,58368,24,3673712191
5529,5877459,45888786,51766245,17,1,0,3072,28,7607363884
5530,5878040,47264541,53142581,29,2,0,15360,26,3718268264
5531,5882450,46708568,52591018,7,0,0,61440,29,2816829388
5532,5882570,46133110,52015680,38,3,0,10752,26,1526522100
5533,5883440,46372059,52255499,10,1,0,7680,4,10561639546
5534,5884880,46617004,52501884,19,1,0,43008,5,4464719176
5535,5885430,45849796,51735226,28,2,0,28160,24,3161973968
5536,5886161,45712129,51598290,9,0,0,18944,12,5130242197
5537,5888000,47471097,53359097,8,0,0,53248,1,2797219144
5538,5889410,46325608,52215018,18,1,0,18432,13,2833589209
5539,5889470,46226541,52116011,13,1,0,31744,6,483665630
5540,5890760,65253185,71143945,14,1,1,27136,8,4133318289
5541,5891180,46555887,52447067,16,1,0,29184,10,3473762810
5542,5892390,46039305,51931695,23,2,0,9216,4,10616711235
5543,5892460,46049935,51942395,0,0,0,15872,8,821126058
5544,5893220,46065566,51958786,6,0,0,3584,24,612481605
5545,5893490,46776349,52669839,13,1,0,32256,6,1730475269
5546,5894060,46340937,52234997,2,0,0,1024,3,3770304545
5547,5894440,46309290,52203730,8,0,0,1536,1,5128377639
5548,5895879,65269765,71165644,15,1,1,3584,19,5037357227
5549,5896210,46230402,52126612,18,1,0,6656,13,8761049892
5550,5897171,65271699,71168870,22,2,1,5120,10,6505341966
5551,5897220,46068423,51965643,29,2,0,4096,26,3433477572
5552,5897240,46160490,52057730,3,0,0,6656,5,7975762227
5553,5897570,46468718,52366288,14,1,0,14336,8,622318843
5554,5897630,46103941,52001571,35,3,0,63488,8,2365120739
5555,5899101,65271715,71170816,19,1,1,3072,5,3876807593
5556,5899579,65336176,71235755,8,0,1,43520,1,3894255895
5557,5900260,46048398,51948658,35,3,0,20480,8,3500725867
5558,5900600,46028264,51928864,13,1,0,19968,6,9749683846
5559,5902670,65381989,71284659,16,1,1,2560,10,8514270796
5560,5904360,65721410,71625770,33,3,1,96256,22,9849198260
5561,5904420,45831141,51735561,0,0,0,1024,8,5893721250
5562,5907060,46372608,52279668,1,0,0,7680,26,7467449842
5563,5907070,46099475,52006545,37,3,0,6144,15,7392766917
5564,5907510,46046178,51953688,19,1,0,6144,5,5243093000
5565,5908081,46443552,52351633,33,3,0,18432,22,6465779209
5566,5911949,46602819,52514768,17,1,0,11264,28,5632570724
5567,5913090,47564552,53477642,38,3,0,112640,26,10216094065
5568,5913521,65717434,71630955,26,2,1,16384,29,4758911806
5569,5914570,46257818,52172388,3,0,0,34816,5,3590223692
5570,5916590,65796826,71713416,38,3,1,16384,26,2806497275
5571,5917910,46471962,52389872,39,3,0,16384,2,8633991030
5572,5918291,65809219,71727510,22,2,1,19456,10,3896700520
5573,5918430,46217442,52135872,2,0,0,10752,3,4567241030
5574,5920280,47063484,52983764,5,0,0,81920,4,7396936166
5575,5921689,65829665,71751354,5,0,1,3072,4,1753577214
5576,5921700,46103026,52024726,38,3,0,8192,26,5766173822
5577,5922400,65831860,71754260,20,2,1,4608,24,3496445964
5578,5927271,46320823,52248094,34,3,0,5632,2,5122800897
5579,5927460,46160862,52088322,8,0,0,1024,1,4569672719
5580,5928390,46193470,52121860,30,3,0,512,3,5412863453
5581,5928471,46348446,52276917,34,3,0,13824,2,958740920
5582,5930550,46873513,52804063,19,1,0,56832,5,2688873521
5583,5931050,46296808,52227858,20,2,0,5120,24,770276342
5584,5935100,47688418,53623518,13,1,0,28672,6,6669435724
5585,5938200,46953149,52891349,6,0,0,9728,24,5294146920
5586,5939281,46076578,52015859,25,2,0,512,4,7155139866
5587,5940150,47091885,53032035,21,2,0,16896,25,3891710380
5588,5941140,46732257,52673397,29,2,0,8704,26,10157154811
5589,5942670,46458193,52400863,13,1,0,6656,6,10377774126
5590,5943641,65836860,71780501,21,2,1,13824,25,2104153881
5591,5948950,46973984,52922934,0,0,0,12800,8,8958400760
5592,5949490,46169048,52118538,24,2,0,8192,10,5965158591
5593,5949530,46990119,52939649,8,0,0,54784,1,1982874882
5594,5949791,65888999,71838790,26,2,1,19968,29,5267471204
5595,5950440,46502757,52453197,28,2,0,13312,24,1467529806
5596,5952270,65911722,71863992,0,0,1,8704,8,9391265158
5597,5953750,65913788,71867538,36,3,1,5632,3,7137032740
5598,5955470,46653607,52609077,14,1,0,512,8,6896651961
5599,5955670,46352833,52308503,8,0,0,3072,1,6714990310
5600,5958889,65955740,71914629,8,0,1,15872,1,4249614646
5601,5958900,65986454,71945354,2,0,1,7680,3,2169741425
5602,5958970,47086660,53045630,7,0,0,44544,29,5838403368
5603,5959731,66002080,71961811,19,1,1,9728,5,2012294381
5604,5961120,46176699,52137819,36,3,0,2048,3,2464994222
5605,5962520,66055596,72018116,12,1,1,12288,3,5086783984
5606,5963100,66058294,72021394,33,3,1,18944,22,9508620016
5607,5963500,46784771,52748271,23,2,0,58368,4,7107742835
5608,5964440,46639672,52604112,14,1,0,13824,8,4319203167
5609,5966150,46907992,52874142,31,3,0,6144,27,6447237458
5610,5969560,46787626,52757186,2,0,0,29184,3,858961534
5611,5969660,46479458,52449118,20,2,0,6656,24,7467963835
5612,5972980,66090447,72063427,29,2,1,18432,26,984020827
5613,5973050,66215741,72188791,24,2,1,17408,10,5484308639
5614,5974830,46892055,52866885,20,2,0,18432,24,4217170311
5615,5976470,46534843,52511313,28,2,0,2560,24,136825516
5616,5976670,46552202,52528872,8,0,0,512,1,9157369430
5617,5979080,47247729,53226809,1,0,0,19456,26,860655935
5618,5979710,46617750,52597460,30,3,0,1536,3,5157927169
5619,5979890,47768062,53747952,5,0,0,57856,4,7120821010
5620,5979910,47552041,53531951,35,3,0,22528,8,4352763660
5621,5980010,47392838,53372848,27,2,0,45056,9,10416509465
5622,5982430,46748034,52730464,7,0,0,52736,29,9860034013
5623,5983900,46787661,52771561,32,3,0,47104,17,9910989521
5624,5984810,46801906,52786716,28,2,0,49664,24,984912269
5625,5985305,47151607,53136912,38,3,0,24064,26,2414137858
5626,5985450,66237421,72222871,17,1,1,20480,28,4670489869
5627,5985580,47928621,53914201,1,0,0,23040,26,5911778885
5628,5986170,46610799,52596969,20,2,0,19456,24,2033629393
5629,5986791,46405600,52392391,9,0,0,8192,12,9865491434
5630,5988171,66234723,72222894,21,2,1,8704,25,2817353505
5631,5988420,66312737,72301157,32,3,1,19968,17,708981776
5632,5991250,66378538,72369788,33,3,1,30720,22,7243641300
5633,5991480,46608366,52599846,18,1,0,7680,13,9333362752
5634,5994029,46829314,52823343,17,1,0,9728,28,9655129523
5635,5994740,47095731,53090471,20,2,0,42496,24,6830520822
5636,5995540,46514970,52510510,7,0,0,10240,29,3067460837
5637,5995561,46818103,52813664,33,3,0,13824,22,10021138148
5638,5995711,47247754,53243465,34,3,0,14336,2,5076543139
5639,5998620,46651312,52649932,26,2,0,6656,29,4900917963
5640,5999630,47849272,53848902,18,1,0,25088,13,551087176
5641,5999889,66391250,72391139,4,0,1,3072,14,1670094345
5642,6002190,66388972,72391162,1,0,1,1024,26,6105541767
5643,6002990,46954520,52957510,3,0,0,28160,5,3220568780
5644,6003480,46994713,52998193,36,3,0,3584,3,5994851999
5645,6003900,46857346,52861246,29,2,0,512,26,7113549152
5646,6004340,48308318,54312658,22,2,0,5632,10,5700445019
5647,6005070,66386115,72391185,1,0,1,4096,26,2748910315
5648,6005270,47319344,53324614,10,1,0,14848,4,6978476625
5649,6006081,66640210,72646291,7,0,1,67072,29,8900503394
5650,6006491,66640568,72647059,30,3,1,11776,3,1668931717
5651,6006600,66656721,72663321,6,0,1,7680,24,5087476919
5652,6009700,47135556,53145256,20,2,0,8704,24,4096001103
5653,6010000,48046529,54056529,19,1,0,36352,5,7173035822
5654,6011450,47008133,53019583,38,3,0,2560,26,2658865054
5655,6012040,46936688,52948728,5,0,0,29696,4,2256089960
5656,6014701,66667889,72682590,22,2,1,13824,10,2644243086
5657,6015040,46792174,52807214,29,2,0,10240,26,7883400938
5658,6015380,47114177,53129557,26,2,0,59904,29,3222182784
5659,6018600,46790821,52809421,21,2,0,7168,25,9413521617
5660,6018790,47495901,53514691,18,1,0,106496,13,3062958173
5661,6019660,46974743,52994403,31,3,0,34816,27,7819041919
5662,6021589,66745209,72766798,18,1,1,8192,13,9935030266
5663,6021970,46608306,52630276,0,0,0,7680,8,5794908606
5664,6025360,46933421,52958781,39,3,0,4096,2,3336465408
5665,6026180,48377288,54403468,20,2,0,70656,24,6275940391
5666,6029039,66741438,72770477,15,1,1,5632,19,10068825619
5667,6029770,47623026,53652796,21,2,0,45056,25,2544130094
5668,6030570,46918337,52948907,0,0,0,512,8,6183871620
5669,6031810,66739973,72771783,29,2,1,2048,26,4581103063
5670,6032340,66740429,72772769,1,0,1,1536,26,5847390973
5671,6034849,66966177,73001026,37,3,1,59392,15,1432649451
5672,6035110,67019048,73054158,29,2,1,3584,26,10669947096
5673,6036240,48086210,54122450,15,1,0,34816,19,2653409785
5674,6036460,47235330,53271790,15,1,0,31232,19,1876837567
5675,6036679,46960399,52997078,17,1,0,8704,28,7432989320
5676,6037841,47531377,53569218,9,0,0,11776,12,649458532
5677,6038280,47440953,53479233,20,2,0,5120,24,2930744993
5678,6041200,67413641,73454841,32,3,1,200704,17,9097301552
5679,6042970,48178702,54221672,3,0,0,26624,5,2405183005
5680,6043980,67410884,73454864,9,0,1,2560,12,5805644415
5681,6044190,48397802,54441992,22,2,0,56832,10,7835108331
5682,6044310,47713984,53758294,27,2,0,32256,9,920602429
5683,6044490,47239027,53283517,15,1,0,15360,19,9958155917
5684,6044730,67417684,73462414,3,0,1,8704,5,6326522805
5685,6046520,48420883,54467403,18,1,0,9216,13,3951078011
5686,6046821,67417075,73463896,21,2,1,6656,25,9544037646
5687,6047150,47139005,53186155,7,0,0,2560,29,7944521862
5688,6048110,47108721,53156831,31,3,0,37888,27,1849809358
5689,6049100,48100118,54149218,31,3,0,70656,27,5180235964
5690,6050811,48516726,54567537,25,2,0,8704,4,2709490302
5691,6051390,48132561,54183951,29,2,0,59392,26,437555242
5692,6051940,47501369,53553309,5,0,0,13312,4,2167144104
5693,6055030,47184044,53239074,27,2,0,14336,9,3982312174
5694,6057510,47283688,53341198,6,0,0,27136,24,426639014
5695,6059700,47611054,53670754,37,3,0,2048,15,8524197189
5696,6060210,67407552,73467762,28,2,1,6144,24,10708621759
5697,6061580,67429035,73490615,28,2,1,15872,24,2826193846
5698,6061610,47105613,53167223,18,1,0,5120,13,5466442693
5699,6062300,48702919,54765219,7,0,0,17408,29,4215497557
5700,6063501,47379798,53443299,34,3,0,46592,2,5470703237
5701,6063851,67468604,73532455,21,2,1,512,25,5820301333
5702,6064320,48514784,54579104,20,2,0,30720,24,3140608545
5703,6064590,47546074,53610664,7,0,0,68096,29,8920973763
5704,6065950,47315212,53381162,39,3,0,1536,2,7966558409
5705,6066410,47314261,53380671,0,0,0,25600,8,9467079601
5706,6066701,47245927,53312628,9,0,0,2560,12,6467179281
5707,6069580,48166440,54236020,39,3,0,1536,2,5739900234
5708,6069920,47219069,53288989,6,0,0,3072,24,3055189132
5709,6070701,47341414,53412115,9,0,0,512,12,4368854146
5710,6071230,48416862,54488092,22,2,0,55296,10,8315244243
5711,6071500,47453556,53525056,4,0,0,27648,14,10218352039
5712,6072560,47638922,53711482,1,0,0,39936,26,8585825865
5713,6072660,67496325,73568985,9,0,1,6656,12,2179714358
5714,6073230,48287018,54360248,31,3,0,27136,27,3739166800
5715,6073540,67498031,73571571,28,2,1,4096,24,4790255911
5716,6073720,47408500,53482220,26,2,0,9728,29,6228350298
5717,6075920,48753671,54829591,31,3,0,4096,27,3714351741
5718,6076069,67496808,73572877,11,1,1,2048,6,4233803652
5719,6077439,67496104,73573543,11,1,1,11264,6,109398919
5720,6079289,67506851,73586140,18,1,1,15360,13,2892858508
5721,6079480,48228704,54308184,1,0,0,29696,26,4878426707
5722,6080230,47436356,53516586,13,1,0,6144,6,10670196891
5723,6080260,47317453,53397713,39,3,0,2048,2,9036932040
5724,6080780,48481875,54562655,4,0,0,29696,14,8453932097
5725,6081689,67520220,73601909,5,0,1,5120,4,6507776308
5726,6081920,47607974,53689894,26,2,0,23040,29,8633836446
5727,6082840,47799142,53881982,2,0,0,5632,3,7438547627
5728,6083200,67520975,73604175,24,2,1,3584,10,4158049463
5729,6085121,67520040,73605161,31,3,1,1536,27,122958714
5730,6085201,47460433,53545634,9,0,0,14848,12,391757289
5731,6085599,67519716,73605315,15,1,1,8704,19,2331531027
5732,6088270,47859078,53947348,10,1,0,51712,4,7134915870
5733,6089691,67545077,73634768,21,2,1,13312,25,5742454427
5734,6091990,47815168,53907158,18,1,0,61440,13,1426803679
5735,6092181,67554511,73646692,10,1,1,5120,4,7901113321
5736,6092390,47859817,53952207,30,3,0,15872,3,5034522805
5737,6093250,67584499,73677749,36,3,1,2560,3,1330285616
5738,6093251,47690795,53784046,9,0,0,20992,12,605396778
5739,6093700,47692865,53786565,5,0,0,8192,4,5905557507
5740,6094020,48518932,54612952,21,2,0,4096,25,4217226060
5741,6094560,47480240,53574800,2,0,0,3584,3,6013292560
5742,6094860,67583350,73678210,3,0,1,10240,5,3969093428
5743,6095181,47741148,53836329,34,3,0,34304,2,6570869927
5744,6096230,48790354,54886584,3,0,0,3072,5,4186531691
5745,6096340,67648228,73744568,0,0,1,512,8,5205272126
5746,6098940,47974598,54073538,1,0,0,54272,26,2630502318
5747,6101571,47943859,54045430,25,2,0,95232,4,8365996466
5748,6101780,47551553,53653333,21,2,0,1536,25,626997322
5749,6102510,48608569,54711079,19,1,0,5120,5,2770304092
5750,6103410,67641310,73744720,25,2,1,2048,4,993350464
5751,6104740,47822120,53926860,13,1,0,8192,6,5900616727
5752,6104870,48347129,54451999,19,1,0,32768,5,2567684927
5753,6105441,67671990,73777431,19,1,1,18432,5,8017377765
5754,6105860,47980578,54086438,3,0,0,11776,5,6098760034
5755,6109740,67895963,74005703,32,3,1,97280,17,5588785390
5756,6112160,48903696,55015856,14,1,0,73216,8,3807804985
5757,6113900,48515792,54629692,15,1,0,3584,19,3656474697
5758,6114260,49239337,55353597,39,3,0,115200,2,163898631
5759,6114890,48756984,54871874,27,2,0,35328,9,3400155510
5760,6116400,48039861,54156261,39,3,0,23040,2,886251288
5761,6117320,67901096,74018416,25,2,1,512,4,10229680741
5762,6117690,47749631,53867321,18,1,0,11776,13,2861001348
5763,6119600,47963227,54082827,2,0,0,25600,3,5866926342
5764,6119720,48608954,54728674,18,1,0,9728,13,4209013064
5765,6119770,48589547,54709317,3,0,0,86016,5,1854193607
5766,6120310,47954678,54074988,28,2,0,3584,24,1817086502
5767,6120330,47975647,54095977,0,0,0,31232,8,2017665756
5768,6121310,49264215,55385525,37,3,0,30208,15,3686761086
5769,6121950,67896489,74018439,24,2,1,1024,10,7170874568
5770,6121960,47951913,54073873,14,1,0,1024,8,7151046341
5771,6121989,67987454,74109443,11,1,1,17408,6,1854181451
5772,6122850,68011745,74134595,39,3,1,4608,2,2539986004
5773,6124900,48703420,54828320,19,1,0,24576,5,9211758693
5774,6125630,47931257,54056887,3,0,0,1024,5,984199386
5775,6125820,47798521,53924341,18,1,0,6144,13,6156309505
5776,6126331,68125544,74251875,26,2,1,512,29,575929810
5777,6126460,68125438,74251898,28,2,1,1024,24,3545648588
5778,6126810,48057632,54184442,4,0,0,1536,14,2497047795
5779,6128381,68124499,74252880,10,1,1,3072,4,9871902715
5780,6129430,48472052,54601482,23,2,0,20480,4,4262629459
5781,6130660,48361683,54492343,15,1,0,13824,19,7954846068
5782,6131691,48156635,54288326,33,3,0,17408,22,3951167765
5783,6132300,48406491,54538791,16,1,0,46080,10,9193297361
5784,6132350,68120553,74252903,20,2,1,2048,24,5253106755
5785,6135030,48028660,54163690,37,3,0,12288,15,9653115980
5786,6136570,48072568,54209138,12,1,0,3072,3,4542697378
5787,6137960,48105019,54242979,19,1,0,5120,5,1070406318
5788,6143810,48155303,54299113,31,3,0,35328,27,6279733039
5789,6144060,48761716,54905776,26,2,0,35328,29,10422610990
5790,6144200,48323382,54467582,4,0,0,512,14,3891162952
5791,6145290,49408769,55554059,29,2,0,62976,26,6843339850
5792,6146010,48082389,54228399,2,0,0,7680,3,6857589914
5793,6146060,48062119,54208179,22,2,0,3584,10,6052651224
5794,6146281,47962286,54108567,34,3,0,1536,2,9788117741
5795,6146450,48418412,54564862,21,2,0,7168,25,5256643195
5796,6147759,48996708,55144467,17,1,0,80384,28,8952330210
5797,6148270,48268980,54417250,15,1,0,34816,19,6653340822
5798,6148779,68137975,74286754,23,2,1,15872,4,9410925824
5799,6149620,48171101,54320721,14,1,0,2048,8,10017935261
5800,6149940,48202017,54351957,4,0,0,30720,14,10371722408
5801,6151739,68135038,74286777,15,1,1,8704,19,7553191693
5802,6154550,48633837,54788387,16,1,0,2560,10,678529309
5803,6155670,68131130,74286800,20,2,1,3584,24,8852522246
5804,6156000,48772754,54928754,32,3,0,51712,17,10686001865
5805,6157450,68129373,74286823,17,1,1,5120,28,7252813577
5806,6157600,48107381,54264981,11,1,0,5632,6,1695541142
5807,6158880,47998340,54157220,26,2,0,3072,29,6290601515
5808,6159089,48296209,54455298,17,1,0,10752,28,6275072768
5809,6159580,49112105,55271685,15,1,0,7680,19,3423625557
5810,6162640,48390944,54553584,7,0,0,7680,29,9939537691
5811,6162750,48800272,54963022,19,1,0,30208,5,3065345560
5812,6164060,48387161,54551221,0,0,0,36864,8,5307837660
5813,6164571,48167322,54331893,34,3,0,10240,2,4016524534
5814,6165019,49190051,55355070,17,1,0,4608,28,3413405023
5815,6165219,48415312,54580531,17,1,0,4608,28,2236735318
5816,6169540,68623246,74792786,38,3,1,153088,26,9866180681
5817,6170110,48411224,54581334,0,0,0,2560,8,317263950
5818,6172150,48287859,54460009,13,1,0,15360,6,10288631449
5819,6172781,68701047,74873828,26,2,1,3072,29,4509266727
5820,6176681,48287883,54464564,9,0,0,14848,12,652647910
5821,6178580,48439892,54618472,0,0,0,2048,8,7640400215
5822,6179790,48407272,54587062,22,2,0,5120,10,4858892249
5823,6179820,68715155,74894975,3,0,1,8192,5,5452145996
5824,6180520,48344208,54524728,21,2,0,18432,25,10347773363
5825,6181350,48592168,54773518,37,3,0,27136,15,10257271671
5826,6181890,48385998,54567888,19,1,0,1024,5,1664811996
5827,6182360,48845219,55027579,13,1,0,38400,6,2595108665
5828,6182940,68712058,74894998,0,0,1,1024,8,4038257675
5829,6183271,68719417,74902688,34,3,1,24576,2,5975633064
5830,6184670,48474136,54658806,26,2,0,92672,29,9869838181
5831,6185480,49306059,55491539,21,2,0,12288,25,1383903320
5832,6187540,48306862,54494402,20,2,0,6656,24,7969687816
5833,6187780,48495298,54683078,18,1,0,34304,13,3219280064
5834,6188470,48484133,54672603,35,3,0,6656,8,9858992378
5835,6188731,48931221,55119952,34,3,0,65536,2,4693615691
5836,6189149,49438416,55627565,17,1,0,40960,28,10120263029
5837,6189420,48889334,55078754,28,2,0,27136,24,7849500953
5838,6190230,48473747,54663977,1,0,0,16896,26,9124827920
5839,6192080,48478472,54670552,22,2,0,21504,10,4950958782
5840,6192490,68728729,74921219,34,3,1,4608,2,168736708
5841,6193970,68879192,75073162,34,3,1,46592,2,7681641674
5842,6194190,68887057,75081247,25,2,1,3072,4,835211614
5843,6195230,68890843,75086073,25,2,1,7680,4,8470493231
5844,6196660,48590121,54786781,0,0,0,35328,8,6418935605
5845,6198950,48510546,54709496,10,1,0,512,4,1403339178
5846,6199579,69025441,75225020,8,0,1,40448,1,3674964941
5847,6200539,69066798,75267337,8,0,1,2560,1,2040021938
5848,6204230,69452403,75656633,34,3,1,188416,2,3253379893
5849,6207689,69452490,75660179,15,1,1,5632,19,5423822428
5850,6208430,48537824,54746254,3,0,0,23552,5,2996794579
5851,6208431,48551461,54759892,9,0,0,16896,12,5967346076
5852,6210239,69453166,75663405,8,0,1,5120,1,4509949554
5853,6211401,69493154,75704555,21,2,1,1024,25,484259817
5854,6211630,48673995,54885625,39,3,0,45056,2,5822732928
5855,6213440,48720501,54933941,28,2,0,16896,24,4104537216
5856,6215240,48748429,54963669,32,3,0,2048,17,6685311457
5857,6218820,48671063,54889883,23,2,0,10752,4,9118431152
5858,6218850,48503343,54722193,1,0,0,1536,26,9808798848
5859,6219820,49200529,55420349,18,1,0,53760,13,2715564808
5860,6219870,69979727,76199597,14,1,1,220160,8,6951631330
5861,6220860,48638619,54859479,21,2,0,16896,25,8012927367
5862,6221680,48622000,54843680,38,3,0,22016,26,533095665
5863,6222170,48690805,54912975,23,2,0,23552,4,7045753538
5864,6226290,49036481,55262771,21,2,0,7680,25,4746589254
5865,6227850,48559734,54787584,1,0,0,2560,26,5480958159
5866,6228250,49010116,55238366,0,0,0,86528,8,189831955
5867,6232490,48543504,54775994,23,2,0,7680,4,10232797195
5868,6232570,48939265,55171835,32,3,0,25088,17,2914038623
5869,6233420,48800578,55033998,8,0,0,20992,1,461437659
5870,6236530,69983463,76219993,1,0,1,1536,26,1242773864
5871,6237379,48716416,54953795,17,1,0,35840,28,2482859689
5872,6240460,48809161,55049621,2,0,0,51200,3,10472206004
5873,6241240,48809964,55051204,5,0,0,5120,4,5461898727
5874,6242291,70010094,76252385,21,2,1,2560,25,8559531801
5875,6243850,48808313,55052163,16,1,0,3072,10,1675321591
5876,6244971,48741629,54986600,33,3,0,3072,22,6980663849
5877,6245010,48835015,55080025,13,1,0,4096,6,4939916255
5878,6245951,70007420,76253371,22,2,1,1536,10,6621818701
5879,6246300,48902870,55149170,16,1,0,15360,10,3019156523
5880,6251830,48925979,55177809,1,0,0,6144,26,2380540226
5881,6251870,48902190,55154060,27,2,0,12800,9,7499783738
5882,6252660,48897469,55150129,3,0,0,3072,5,8247061429
5883,6254670,49167262,55421932,38,3,0,5120,26,747095864
5884,6255460,70053852,76309312,0,0,1,16384,8,9484155589
5885,6255680,48945343,55201023,28,2,0,18944,24,5797235183
5886,6256860,70125693,76382553,6,0,1,4096,24,4291107864
5887,6257560,48810386,55067946,7,0,0,12288,29,8471206336
5888,6259250,49228522,55487772,13,1,0,47104,6,8972060126
5889,6260251,48915663,55175914,33,3,0,13312,22,1143141688
5890,6263990,49036365,55300355,21,2,0,14336,25,10727864547
5891,6266220,70127455,76393675,0,0,1,6656,8,8393961717
5892,6267160,49446865,55714025,27,2,0,115712,9,10619103986
5893,6267840,70125858,76393698,17,1,1,512,28,8621703741
5894,6269261,70124460,76393721,26,2,1,1024,29,2120061238
5895,6269560,49587500,55857060,14,1,0,43520,8,262492236
5896,6269780,48941267,55211047,10,1,0,3584,4,1839303580
5897,6271820,48970158,55241978,0,0,0,1024,8,8173785889
5898,6271890,49767474,56039364,2,0,0,24576,3,6954099559
5899,6272611,48820609,55093220,34,3,0,10240,2,2887700994
5900,6272939,70120805,76393744,18,1,1,4608,13,3959906146
5901,6273560,48890608,55164168,39,3,0,19456,2,8996839621
5902,6274230,49038947,55313177,23,2,0,6656,4,4498374272
5903,6275230,49292268,55567498,8,0,0,44032,1,8546424811
5904,6275390,49474152,55749542,7,0,0,15360,29,2419538764
5905,6275840,49010593,55286433,2,0,0,4096,3,5271826376
5906,6276220,48976723,55252943,5,0,0,25088,4,434472131
5907,6279930,70113837,76393767,25,2,1,1536,4,1998841535
5908,6280671,49363609,55644280,9,0,0,54784,12,760033663
5909,6282811,49434981,55717792,33,3,0,12288,22,8662125139
5910,6283259,70110531,76393790,5,0,1,11264,4,270981493
5911,6284761,70109052,76393813,31,3,1,512,27,6496695813
5912,6285040,48979782,55264822,13,1,0,6656,6,5517961776
5913,6285250,49218127,55503377,0,0,0,4608,8,8028644564
5914,6285330,49393393,55678723,0,0,0,45056,8,39049238
5915,6285380,49370155,55655535,28,2,0,36864,24,9444672467
5916,6285400,49374370,55659770,22,2,0,13824,10,10702651645
5917,6288070,49181537,55469607,37,3,0,26624,15,9291107172
5918,6288250,49104410,55392660,0,0,0,3072,8,6698251913
5919,6288371,49444934,55733305,33,3,0,25600,22,809553839
5920,6288630,70105206,76393836,36,3,1,4096,3,9401011034
5921,6289400,49282300,55571700,31,3,0,12800,27,8626328473
5922,6290020,49654766,55944786,38,3,0,7680,26,5708792912
5923,6290091,49319772,55609863,33,3,0,15872,22,2938434178
5924,6291020,49486126,55777146,27,2,0,9216,9,10412875599
5925,6294711,70119552,76414263,10,1,1,1024,4,899548075
5926,6296831,70482143,76778974,34,3,1,142336,2,3352886171
5927,6297060,49428422,55725482,22,2,0,22016,10,1049455778
5928,6298111,49234175,55532286,25,2,0,2048,4,7277448209
5929,6298790,49366151,55664941,32,3,0,16896,17,8622695117
5930,6298840,49461384,55760224,23,2,0,12288,4,10434968898
5931,6299300,49596198,55895498,2,0,0,14848,3,6005513426
5932,6301780,49191974,55493754,31,3,0,7168,27,2038907077
5933,6303240,70479280,76782520,39,3,1,5632,2,10225696010
5934,6305200,70480226,76785426,33,3,1,4608,22,3240305030
5935,6305510,49439329,55744839,8,0,0,15360,1,7044928728
5936,6305590,49618334,55923924,29,2,0,20992,26,1460415046
5937,6307951,49458731,55766682,25,2,0,5120,4,1249707379
5938,6308400,49603033,55911433,15,1,0,52224,19,5365796700
5939,6312821,70481942,76794763,26,2,1,26624,29,3068768746
5940,6314110,49426018,55740128,36,3,0,9728,3,9143013394
5941,6315600,49666892,55982492,5,0,0,52224,4,6148326643
5942,6316260,49402491,55718751,31,3,0,3072,27,8680019376
5943,6316520,70531603,76848123,36,3,1,3072,3,8435802094
5944,6316910,70792257,77109167,38,3,1,53248,26,5097984731
5945,6318160,49479229,55797389,2,0,0,12288,3,9153473734
5946,6319380,49796729,56116109,19,1,0,17920,5,1106214556
5947,6319590,49417551,55737141,23,2,0,11776,4,3483697048
5948,6319850,49619551,55939401,13,1,0,50176,6,64632970
5949,6320060,70789130,77109190,35,3,1,2048,8,3548296595
5950,6321900,70793420,77115320,20,2,1,5632,24,9562802130
5951,6321911,49784480,56106391,33,3,0,50688,22,4753228547
5952,6322389,70792954,77115343,23,2,1,4608,4,3774246448
5953,6329560,70860856,77190416,3,0,1,26112,5,9300431023
5954,6330380,49718211,56048591,38,3,0,30208,26,510715279
5955,6330650,49678766,56009416,29,2,0,41472,26,2670624513
5956,6331860,49511492,55843352,37,3,0,6144,15,3681588205
5957,6333780,49652323,55986103,14,1,0,11776,8,8543361893
5958,6334060,49552195,55886255,4,0,0,55808,14,1465150117
5959,6334240,49578628,55912868,19,1,0,4608,5,2798560412
5960,6334910,70857132,77192042,24,2,1,2560,10,7761663176
5961,6336480,49397004,55733484,32,3,0,512,17,996652736
5962,6339630,71029175,77368805,35,3,1,71168,8,7978056006
5963,6340500,49969854,56310354,37,3,0,35328,15,1861250344
5964,6341610,50070568,56412178,30,3,0,49664,3,2362132170
5965,6342460,71120183,77462643,1,0,1,44032,26,8013668947
5966,6342880,49779511,56122391,14,1,0,4608,8,4799364036
5967,6345580,49642106,55987686,5,0,0,5120,4,1443145421
5968,6345680,49456150,55801830,15,1,0,10240,19,6882076654
5969,6346179,71116479,77462658,15,1,1,1024,19,10436470538
5970,6350620,49816443,56167063,36,3,0,83456,3,7964394041
5971,6351450,49600394,55951844,39,3,0,2048,2,3351165412
5972,6353140,49856682,56209822,31,3,0,10240,27,6819773787
5973,6353330,49823295,56176625,0,0,0,8704,8,2805314171
5974,6353520,49561144,55914664,7,0,0,3072,29,746857484
5975,6354770,49933666,56288436,4,0,0,25600,14,8187794238
5976,6356690,49861267,56217957,0,0,0,26624,8,6336888014
5977,6357460,71142813,77500273,28,2,1,13824,24,9077008291
5978,6359000,50422961,56781961,27,2,0,7680,9,2699196114
5979,6362410,49719652,56082062,22,2,0,19968,10,530829810
5980,6364580,50031640,56396220,8,0,0,64000,1,1897488092
5981,6365239,49661294,56026533,17,1,0,5120,28,5907117704
5982,6365870,71153450,77519320,36,3,1,8192,3,7731831861
5983,6365900,50505264,56871164,18,1,0,74752,13,8197969263
5984,6366750,71154196,77520946,12,1,1,2560,3,7414353153
5985,6367631,49757732,56125363,34,3,0,2560,2,1116053916
5986,6369920,71154572,77524492,29,2,1,5632,26,10564160229
5987,6371631,71166034,77537665,26,2,1,21504,29,3156923530
5988,6372710,50138090,56510800,22,2,0,27136,10,5724989188
5989,6373470,49737156,56110626,36,3,0,13824,3,2671313897
5990,6375530,49620884,55996414,21,2,0,3072,25,9512949002
5991,6376010,50021013,56397023,2,0,0,2560,3,4748212060
5992,6376460,49648490,56024950,18,1,0,16384,13,5751967259
5993,6376470,50063336,56439806,7,0,0,20992,29,3785325091
5994,6376760,50346202,56722962,37,3,0,13824,15,6298390621
5995,6377870,50428223,56806093,8,0,0,2048,1,8350316908
5996,6378890,49824804,56203694,8,0,0,29696,1,8427661553
5997,6378990,50044450,56423440,3,0,0,2560,5,7731507732
5998,6379360,49794590,56173950,18,1,0,22528,13,9723952084
5999,6379590,50312074,56691664,36,3,0,28672,3,4564718365
6000,6380589,71233701,77614290,5,0,1,1536,4,2177838045
6001,6381080,49681607,56062687,24,2,0,11776,10,10674565520
6002,6381330,50562854,56944184,10,1,0,9728,4,4025675739
6003,6381480,49955334,56336814,39,3,0,11264,2,6404261223
6004,6382751,71231554,77614305,21,2,1,2560,25,3629047483
6005,6385110,71229210,77614320,2,0,1,4096,3,888338115
6006,6385721,71228614,77614335,31,3,1,3584,27,2301604756
6007,6385901,50107298,56493199,25,2,0,8192,4,7041721925
6008,6387210,50168184,56555394,8,0,0,30720,1,7992542809
6009,6388170,50025591,56413761,31,3,0,5120,27,2489199457
6010,6389140,49890358,56279498,14,1,0,50688,8,1049986025
6011,6389230,50245836,56635066,16,1,0,20480,10,8220557555
6012,6389930,50385589,56775519,32,3,0,19968,17,7297516507
6013,6391820,49938119,56329939,28,2,0,16384,24,5551620283
6014,6392080,50573840,56965920,26,2,0,5120,29,2914532056
6015,6392230,50260284,56652514,13,1,0,7168,6,6038863113
6016,6392570,50098110,56490680,35,3,0,72192,8,8953506709
6017,6394070,49830143,56224213,4,0,0,13312,14,9929074322
6018,6395621,71218729,77614350,22,2,1,6656,10,2219911086
6019,6397071,49840834,56237905,33,3,0,17408,22,2129119553
6020,6398810,50352265,56751075,30,3,0,25600,3,141586190
6021,6398811,71278519,77677330,19,1,1,2560,5,9872239514
6022,6399830,49976867,56376697,35,3,0,22528,8,9841134975
6023,6402430,50242955,56645385,35,3,0,33792,8,9169451550
6024,6403100,50376498,56779598,13,1,0,13312,6,5111427879
6025,6403420,50541255,56944675,14,1,0,1536,8,4917859174
6026,6403640,50502067,56905707,0,0,0,30720,8,5304705909
6027,6403690,50604744,57008434,13,1,0,11264,6,3608144459
6028,6403840,50170112,56573952,36,3,0,51712,3,8194501525
6029,6404000,50475143,56879143,27,2,0,26112,9,6804134373
6030,6404001,50492323,56896324,9,0,0,45568,12,6075739052
6031,6405500,71390290,77795790,38,3,1,80384,26,3221606501
6032,6406321,50014122,56420443,34,3,0,8704,2,3364042409
6033,6406460,50095441,56501901,27,2,0,10752,9,5546007079
6034,6407090,49873523,56280613,27,2,0,3584,9,9583450321
6035,6409690,71386115,77795805,27,2,1,2560,9,4332952786
6036,6411440,71384598,77796038,34,3,1,1536,2,7160195338
6037,6412450,50269878,56682328,26,2,0,3072,29,10704877830
6038,6413001,50330251,56743252,34,3,0,56832,2,7066398467
6039,6414280,50355132,56769412,2,0,0,14848,3,7680854342
6040,6414480,50549833,56964313,27,2,0,18432,9,3701068329
6041,6415561,71385129,77800690,19,1,1,4608,5,9058028483
6042,6416890,71393480,77810370,27,2,1,38912,9,3323220940
6043,6417669,71492426,77910095,37,3,1,64512,15,1086436559
6044,6419390,50428975,56848365,8,0,0,18432,1,8862575184
6045,6422430,50239178,56661608,11,1,0,2048,6,4955311011
6046,6422650,50513353,56936003,38,3,0,85504,26,8067549164
6047,6424440,50683708,57108148,16,1,0,75264,10,9257095496
6048,6425121,71490259,77915380,34,3,1,5632,2,2622841397
6049,6426060,50289205,56715265,1,0,0,10240,26,551962013
6050,6426340,50234621,56660961,31,3,0,27648,27,6020420492
6051,6426640,50749196,57175836,31,3,0,7168,27,8461482283
6052,6428371,50414355,56842726,34,3,0,22016,2,7030606232
6053,6430040,50528634,56958674,6,0,0,7168,24,2524560234
6054,6432830,50604651,57037481,28,2,0,6144,24,4645824475
6055,6433320,50331537,56764857,19,1,0,14336,5,4368811503
6056,6433410,50267637,56701047,5,0,0,30720,4,5531045473
6057,6434020,50681552,57115572,38,3,0,12288,26,5296366556
6058,6435600,50444822,56880422,28,2,0,4096,24,8492913998
6059,6437150,50323308,56760458,2,0,0,30720,3,1082641256
6060,6437159,71511769,77948928,37,3,1,67072,15,5813425200
6061,6438370,50597216,57035586,6,0,0,11776,24,3837941043
6062,6438500,50501426,56939926,1,0,0,12800,26,1166798399
6063,6439880,71510149,77950029,14,1,1,3584,8,4997838237
6064,6439915,71512700,77952615,9,0,1,4096,12,8209980260
6065,6443080,50513387,56956467,19,1,0,7168,5,2747301891
6066,6443330,50873834,57317164,7,0,0,53248,29,4411319102
6067,6443440,50988395,57431835,8,0,0,3584,1,6726869237
6068,6445150,50710922,57156072,4,0,0,17920,14,9377139741
6069,6446810,50507450,56954260,0,0,0,2560,8,3241646007
6070,6451700,50489497,56941197,10,1,0,4096,4,5219289463
6071,6453180,50563666,57016846,4,0,0,3584,14,8237964903
6072,6453280,50691978,57145258,20,2,0,51712,24,6211603948
6073,6454270,50495576,56949846,8,0,0,16896,1,8401175958
6074,6456320,50497137,56953457,5,0,0,11776,4,4091731150
6075,6456381,71518858,77975239,19,1,1,3584,5,5732511763
6076,6457001,71518253,77975254,26,2,1,1536,29,3789988992
6077,6457600,71517669,77975269,17,1,1,5632,28,10572311156
6078,6462600,50666879,57129479,21,2,0,45568,25,3230724880
6079,6463389,71511895,77975284,20,2,1,12800,24,9664819650
6080,6464381,71534594,77998975,31,3,1,19456,27,7624604241
6081,6465061,50593494,57058555,25,2,0,2560,4,7985505690
6082,6465610,50762810,57228420,39,3,0,18432,2,6933394714
6083,6466320,50832162,57298482,1,0,0,15360,26,758123018
6084,6466490,50504389,56970879,28,2,0,4608,24,7435884004
6085,6468011,50643794,57111805,9,0,0,5632,12,8876245669
6086,6469040,50594004,57063044,0,0,0,11264,8,993256448
6087,6469501,71539742,78009243,22,2,1,512,10,9069512794
6088,6469731,71540383,78010114,30,3,1,12288,3,4256796157
6089,6470331,71545750,78016081,7,0,1,1536,29,6700890387
6090,6471110,71547263,78018373,36,3,1,13824,3,4745904072
6091,6471130,50819270,57290400,5,0,0,21504,4,125117710
6092,6472160,50907430,57379590,1,0,0,9216,26,1059864959
6093,6473300,50675973,57149273,19,1,0,12800,5,8143072991
6094,6473570,50760645,57234215,10,1,0,18944,4,2032216460
6095,6474390,50635676,57110066,3,0,0,6144,5,8687476469
6096,6474730,71544309,78019039,36,3,1,1024,3,558445632
6097,6475540,71545125,78020665,28,2,1,2560,24,3836321402
6098,6476100,71545871,78021971,17,1,1,2048,28,5867889681
6099,6477440,50988407,57465847,28,2,0,31232,24,6468336107
6100,6478000,50805825,57283825,0,0,0,32768,8,689868191
6101,6479080,71561502,78040582,39,3,1,20992,2,4539444157
6102,6481470,51160599,57642069,1,0,0,136192,26,919148523
6103,6482420,51227593,57710013,27,2,0,15872,9,8777045230
6104,6483640,50881654,57365294,1,0,0,102912,26,4151468367
6105,6484371,50892380,57376751,33,3,0,7680,22,1208888742
6106,6484880,50722490,57207370,16,1,0,9216,10,4167788946
6107,6485090,50776986,57262076,3,0,0,12288,5,9819370462
6108,6486580,50961529,57448109,2,0,0,8192,3,5190250291
6109,6487610,51098058,57585668,26,2,0,109568,29,2596103749
6110,6487720,51157671,57645391,21,2,0,3072,25,7362612731
6111,6487951,51258414,57746365,33,3,0,16384,22,4711806201
6112,6488989,50932529,57421518,17,1,0,6656,28,637608041
6113,6491530,50882858,57374388,5,0,0,11264,4,1243119421
6114,6491620,50935318,57426938,38,3,0,512,26,9807100112
6115,6493170,50877763,57370933,6,0,0,18432,24,6431140155
6116,6493230,50944088,57437318,8,0,0,14848,1,7626163781
6117,6494251,71546346,78040597,7,0,1,1024,29,1591389264
6118,6494320,71546292,78040612,24,2,1,12800,10,7330490168
6119,6495910,51148522,57644432,28,2,0,7680,24,1064844077
6120,6496050,50923417,57419467,14,1,0,28160,8,10561416065
6121,6496410,71544217,78040627,33,3,1,13312,22,1026530678
6122,6497480,51089615,57587095,1,0,0,4608,26,2778701379
6123,6497530,51054731,57552261,14,1,0,29696,8,2899932096
6124,6501599,71560691,78062290,8,0,1,4608,1,7470243652
6125,6502390,51005701,57508091,22,2,0,17408,10,2993828137
6126,6502640,51294424,57797064,6,0,0,52736,24,9888951550
6127,6503471,71569524,78072995,10,1,1,4096,4,1430751385
6128,6509459,71564522,78073981,5,0,1,1536,4,6573491355
6129,6509890,51090644,57600534,21,2,0,44032,25,9497413707
6130,6509930,51341129,57851059,0,0,0,126976,8,2557807400
6131,6510237,51469511,57979748,18,1,0,57856,13,8586592542
6132,6511140,51173992,57685132,7,0,0,44032,29,6725672510
6133,6511710,51356272,57867982,26,2,0,4608,29,499678522
6134,6512670,71577070,78089740,38,3,1,32256,26,1788405418
6135,6513020,51158673,57671693,32,3,0,31744,17,786932214
6136,6515831,71599270,78115101,34,3,1,2048,2,3936653181
6137,6516050,71602597,78118647,33,3,1,5632,22,5690978123
6138,6517820,51284206,57802026,18,1,0,4608,13,175598399
6139,6518040,71600966,78119006,2,0,1,9728,3,9563581080
6140,6518540,51170694,57689234,22,2,0,5632,10,1602863975
6141,6518600,51168895,57687495,39,3,0,7680,2,5692360217
6142,6520571,51556397,58076968,25,2,0,4608,4,2502167101
6143,6523170,51224778,57747948,31,3,0,5120,27,402299497
6144,6525240,51233253,57758493,37,3,0,3584,15,3968128989
6145,6525461,51208723,57734184,34,3,0,7680,2,3894336813
6146,6525880,51274015,57799895,18,1,0,9216,13,7503974789
6147,6526369,71648227,78174596,37,3,1,97280,15,7821769081
6148,6526439,51746590,58273029,17,1,0,14848,28,1598885157
6149,6526660,51224465,57751125,37,3,0,4608,15,2069112550
6150,6528230,51420558,57948788,2,0,0,13312,3,6771126589
6151,6529010,71646252,78175262,1,0,1,1024,26,5607451670
6152,6529050,71649438,78178488,33,3,1,5120,22,4125861007
6153,6530100,51205355,57735455,22,2,0,4096,10,2556438939
6154,6530821,71657124,78187945,22,2,1,8704,10,4042370587
6155,6531489,71661197,78192686,4,0,1,3584,14,1625026288
6156,6532220,51370560,57902780,1,0,0,8704,26,220796354
6157,6532261,71665251,78197512,21,2,1,7680,25,7514579191
6158,6532511,71665974,78198485,10,1,1,12800,4,958566206
6159,6532809,71668582,78201391,5,0,1,4608,4,9443135191
6160,6533661,51332894,57866555,33,3,0,39936,22,6834298787
6161,6534290,51359171,57893461,37,3,0,59392,15,697077356
6162,6536230,51363875,57900105,6,0,0,19456,24,6453403128
6163,6536681,51407936,57944617,34,3,0,19968,2,2019345826
6164,6538230,71675421,78213651,1,0,1,13824,26,3684919277
6165,6538409,71678468,78216877,5,0,1,5120,4,9199077796
6166,6538920,51355188,57894108,35,3,0,2048,8,5783040431
6167,6540490,71680253,78220743,35,3,1,6144,8,6327206094
6168,6541060,51397450,57938510,3,0,0,49664,5,5262970284
6169,6541230,51477934,58019164,6,0,0,12800,24,2735304459
6170,6541400,51501183,58042583,14,1,0,17408,8,4744340165
6171,6541570,51505560,58047130,22,2,0,14848,10,6768301418
6172,6543560,71679769,78223329,28,2,1,4096,24,2219865794
6173,6543940,51719366,58263306,7,0,0,23552,29,2205311448
6174,6544390,71852867,78397257,35,3,1,159744,8,9547819876
6175,6545000,51437960,57982960,27,2,0,10240,9,621239385
6176,6545790,71851482,78397272,2,0,1,6656,3,6022196228
6177,6546121,71851166,78397287,19,1,1,13312,5,843797231
6178,6547771,51644536,58192307,33,3,0,27648,22,3890447795
6179,6549520,51768957,58318477,10,1,0,16896,4,5396312826
6180,6552440,51628774,58181214,15,1,0,16896,19,4240259459
6181,6552739,51623304,58176043,17,1,0,67072,28,1191111222
6182,6553200,51408883,57962083,38,3,0,11264,26,5099680100
6183,6553300,71844002,78397302,2,0,1,512,3,5703407226
6184,6553770,51905654,58459424,18,1,0,70656,13,6478665901
6185,6554360,51589217,58143577,35,3,0,10240,8,9481193263
6186,6555269,51799595,58354864,17,1,0,33792,28,7205765991
6187,6557670,71839647,78397317,14,1,1,43008,8,10159315971
6188,6557970,52080361,58638331,4,0,0,33792,14,7177536434
6189,6559750,51919197,58478947,13,1,0,64000,6,5725624823
6190,6560330,71856967,78417297,17,1,1,16896,28,6255660052
6191,6561040,52168127,58729167,16,1,0,26112,10,853642386
6192,6561410,51957330,58518740,29,2,0,18944,26,5444763339
6193,6561710,51492500,58054210,2,0,0,6656,3,205038625
6194,6561720,51972247,58533967,32,3,0,35840,17,3572121612
6195,6564170,51749136,58313306,37,3,0,36352,15,994015825
6196,6564561,71874230,78438791,30,3,1,512,3,6073650509
6197,6565530,51872343,58437873,26,2,0,15360,29,7707200096
6198,6566100,51818640,58384740,32,3,0,2560,17,4167675600
6199,6567551,52052861,58620412,33,3,0,46080,22,8368166958
6200,6567580,71888789,78456369,17,1,1,31232,28,2544828370
6201,6568130,51936580,58504710,2,0,0,84480,3,7260378041
6202,6568179,71889176,78457355,23,2,1,1536,4,10376198576
6203,6569100,71890201,78459301,2,0,1,3072,3,9238229288
6204,6569723,51863447,58433170,0,0,0,52736,8,1194534923
6205,6570760,71936434,78507194,14,1,1,97792,8,7504465654
6206,6571030,51843714,58414744,8,0,0,30720,1,10676179113
6207,6573970,52248814,58822784,36,3,0,18944,3,9405357056
6208,6574980,51804760,58379740,6,0,0,32256,24,4050951384
6209,6576560,52521881,59098441,20,2,0,19456,24,347517462
6210,6577690,52159456,58737146,27,2,0,26112,9,8991031312
6211,6578430,52533819,59112249,10,1,0,14336,4,5898491985
6212,6578680,51993615,58572295,20,2,0,11776,24,2825407886
6213,6580370,71928371,78508741,33,3,1,512,22,10361210163
6214,6581170,52590177,59171347,14,1,0,512,8,5275201574
6215,6582280,52040651,58622931,16,1,0,8192,10,8631340189
6216,6582601,51937722,58520323,9,0,0,5120,12,9198849642
6217,6582800,51662336,58245136,5,0,0,512,4,1605860014
6218,6585670,52013447,58599117,28,2,0,16896,24,2407987467
6219,6586380,52134808,58721188,0,0,0,65536,8,7183922750
6220,6588310,51999645,58587955,21,2,0,34816,25,9264922290
6221,6591640,71919687,78511327,20,2,1,4096,24,7708223497
6222,6592940,71970078,78563018,38,3,1,99840,26,4914577935
6223,6594011,52079791,58673802,25,2,0,1536,4,9292827830
6224,6594281,71971963,78566244,22,2,1,5120,10,8850448300
6225,6595621,51917293,58512914,9,0,0,25600,12,9766399288
6226,6597650,51794144,58391794,8,0,0,7680,1,2757708909
6227,6601050,71973699,78574749,6,0,1,3072,24,1802286161
6228,6601070,52731372,59332442,26,2,0,26112,29,1119349251
6229,6602390,52387635,58990025,26,2,0,40448,29,7818141415
6230,6605320,71969775,78575095,0,0,1,512,8,1073831425
6231,6606060,52088650,58694710,36,3,0,61952,3,3799476747
6232,6606330,53443500,60049830,16,1,0,15872,10,1176062477
6233,6608930,52904070,59513000,3,0,0,68096,5,6969904409
6234,6610930,52218917,58829847,10,1,0,18432,4,2195154530
6235,6611050,52202532,58813582,36,3,0,9728,3,8814569417
6236,6611130,71964951,78576081,0,0,1,1536,8,3908632137
6237,6614400,51890691,58505091,14,1,0,1024,8,7437108607
6238,6615280,52084289,58699569,14,1,0,15872,8,3091913395
6239,6615541,52215889,58831430,33,3,0,5120,22,6900780991
6240,6616370,71963181,78579551,17,1,1,15360,28,6058799336
6241,6616431,53062784,59679215,34,3,0,48128,2,4269409306
6242,6616990,53292036,59909026,16,1,0,14336,10,10264118023
6243,6617120,52184390,58801510,3,0,0,12288,5,703759649
6244,6619120,52800532,59419652,31,3,0,35328,27,8908325839
6245,6622771,52639499,59262270,9,0,0,7680,12,8209980996
6246,6624609,71957528,78582137,18,1,1,4096,13,417143294
6247,6625041,71957442,78582483,21,2,1,512,25,8754417691
6248,6628530,51972170,58600700,7,0,0,5120,29,1163998982
6249,6628830,52158696,58787526,20,2,0,8192,24,5195811148
6250,6630220,52308728,58938948,32,3,0,80384,17,7633458675
6251,6631160,52666398,59297558,5,0,0,79360,4,8036621704
6252,6632180,52965179,59597359,4,0,0,62976,14,754034689
6253,6632800,52568933,59201733,19,1,0,5120,5,1844786198
6254,6633240,52408490,59041730,26,2,0,43008,29,10500844531
6255,6633311,71950798,78584109,31,3,1,2560,27,9233331951
6256,6634010,52103369,58737379,22,2,0,512,10,6655254930
6257,6634790,52523291,59158081,0,0,0,28672,8,10629857565
6258,6635849,52218078,58853927,17,1,0,11264,28,3302141609
6259,6637380,71948009,78585389,17,1,1,14336,28,2893804112
6260,6638330,52225558,58863888,31,3,0,5632,27,9017525582
6261,6639169,71946566,78585735,15,1,1,512,19,5038368217
6262,6640890,52406947,59047837,16,1,0,19968,10,7989929349
6263,6642060,52732772,59374832,37,3,0,9216,15,8489145858
6264,6642760,71954439,78597199,17,1,1,22016,28,9525388110
6265,6644201,71957824,78602025,31,3,1,7680,27,9177915297
6266,6644370,52384233,59028603,35,3,0,68608,8,9105702205
6267,6644529,53313446,59957975,17,1,0,77312,28,6647206180
6268,6645240,71965738,78610978,17,1,1,6144,28,5347883345
6269,6645560,52730855,59376415,7,0,0,5120,29,2067645779
6270,6646080,71966204,78612284,9,0,1,2048,12,6249122244
6271,6646540,52676134,59322674,2,0,0,33792,3,7031626296
6272,6646941,52515842,59162783,25,2,0,2560,4,9728302050
6273,6647640,52330038,58977678,20,2,0,25088,24,8229555490
6274,6648600,52538139,59186739,27,2,0,5632,9,9149351253
6275,6648910,52265523,58914433,31,3,0,15872,27,3887189727
6276,6649171,52291071,58940242,9,0,0,4096,12,7383392979
6277,6650741,71962414,78613155,19,1,1,12288,5,4501491300
6278,6651740,52880003,59531743,36,3,0,61440,3,1328835412
6279,6652060,52433295,59085355,21,2,0,18944,25,6514909166
6280,6653050,52468426,59121476,12,1,0,30208,3,8445908916
6281,6653539,71970554,78624093,23,2,1,1024,4,7963685459
6282,6657130,71972250,78629380,1,0,1,16896,26,5500085433
6283,6657270,52430916,59088186,20,2,0,9216,24,3031838075
6284,6657680,53489708,60147388,35,3,0,31744,8,8006427181
6285,6658230,53058889,59717119,20,2,0,4096,24,6874136909
6286,6659380,53210123,59869503,4,0,0,14336,14,8070782559
6287,6659521,71971805,78631326,31,3,1,3072,27,5195348933
6288,6660290,53001563,59661853,13,1,0,50688,6,8004769507
6289,6661460,53095319,59756779,21,2,0,43520,25,9713666890
6290,6662300,52915848,59578148,16,1,0,110592,10,7531840029
6291,6662689,71969303,78631992,18,1,1,1024,13,5458941950
6292,6663870,52648485,59312355,35,3,0,17408,8,976781682
6293,6665510,53302339,59967849,8,0,0,27136,1,6999248200
6294,6665690,52460645,59126335,6,0,0,15872,24,7103314131
6295,6666260,71967901,78634161,2,0,1,10752,3,8485081179
6296,6667799,52508233,59176032,17,1,0,13824,28,5099865249
6297,6668780,71995825,78664605,32,3,1,27648,17,4239619100
6298,6668820,52591087,59259907,30,3,0,18944,3,2366659083
6299,6669341,72007968,78677309,31,3,1,7168,27,88759100
6300,6671780,52872649,59544429,29,2,0,24576,26,9053255517
6301,6671810,52528340,59200150,2,0,0,13312,3,2165553861
6302,6672010,52759053,59431063,12,1,0,37376,3,10247214692
6303,6672940,72006315,78679255,36,3,1,3072,3,8767967610
6304,6675030,53462663,60137693,5,0,0,5632,4,10542035796
6305,6676270,52772631,59448901,4,0,0,4608,14,9205712806
6306,6676700,52624625,59301325,13,1,0,12288,6,5993747892
6307,6677841,53345214,60023055,33,3,0,22016,22,1966695254
6308,6680020,53004366,59684386,27,2,0,16896,9,6786449929
6309,6680120,52500912,59181032,19,1,0,512,5,6137585154
6310,6680430,52922911,59603341,39,3,0,9728,2,3921691562
6311,6680891,52657502,59338393,34,3,0,19456,2,2652566221
6312,6681411,71998510,78679921,19,1,1,1024,5,9210566843
6313,6683280,53150709,59833989,37,3,0,53760,15,7760733945
6314,6685760,52761714,59447474,12,1,0,53760,3,7111596421
6315,6686720,52536594,59223314,27,2,0,2048,9,2671062554
6316,6687650,53040050,59727700,30,3,0,25600,3,7356975327
6317,6687720,52793619,59481339,38,3,0,40448,26,9093736813
6318,6687830,52912524,59600354,22,2,0,9728,10,5788360308
6319,6688160,53296867,59985027,8,0,0,24064,1,9030982644
6320,6691260,52773568,59464828,7,0,0,12288,29,9413900426
6321,6694560,52994380,59688940,0,0,0,7168,8,10357745557
6322,6694920,53427081,60122001,18,1,0,74240,13,10383406273
6323,6695500,71994636,78690136,28,2,1,25088,24,4992592988
6324,6696040,52925154,59621194,7,0,0,16896,29,4397170449
6325,6697270,53528618,60225888,18,1,0,47104,13,5660170188
6326,6699650,52768202,59467852,23,2,0,2048,4,10683877011
6327,6701980,71992662,78694642,20,2,1,7168,24,1200725353
6328,6702860,52927881,59630741,37,3,0,31232,15,423851734
6329,6703180,53086491,59789671,23,2,0,15360,4,466825285
6330,6704160,52910592,59614752,6,0,0,37376,24,6857534587
6331,6704970,52959558,59664528,29,2,0,8704,26,8015805803
6332,6705700,52910323,59616023,20,2,0,4096,24,2388208797
6333,6705870,53107869,59813739,21,2,0,12800,25,9193817191
6334,6706030,53473121,60179151,35,3,0,10240,8,5442650185
6335,6710649,53059013,59769662,17,1,0,27136,28,1547539717
6336,6710940,53473477,60184417,19,1,0,12800,5,2149791861
6337,6711010,71987294,78698304,25,2,1,17408,4,4607885366
6338,6713020,53628390,60341410,4,0,0,24576,14,2401925938
6339,6713710,53458467,60172177,13,1,0,23040,6,7630286193
6340,6714880,52921352,59636232,13,1,0,17920,6,10302996686
6341,6715470,53664251,60379721,23,2,0,34816,4,7453242725
6342,6717680,53020059,59737739,36,3,0,10752,3,9108449652
6343,6717930,71980630,78698560,39,3,1,9216,2,307651845
6344,6718620,52982507,59701127,4,0,0,1536,14,6799954675
6345,6718890,53185745,59904635,14,1,0,68608,8,5817425632
6346,6718960,71980906,78699866,36,3,1,2048,3,6756945875
6347,6719150,53413505,60132655,5,0,0,34816,4,8214557726
6348,6719759,71987101,78706860,18,1,1,18432,13,4298876063
6349,6720430,53014010,59734440,37,3,0,9216,15,991274894
6350,6720720,53348031,60068751,23,2,0,5632,4,2890228350
6351,6722301,71985942,78708243,26,2,1,14848,29,4800075701
6352,6723241,53661339,60384580,34,3,0,15872,2,10402848258
6353,6723550,53412404,60135954,19,1,0,10752,5,2945370013
6354,6723770,53036308,59760078,5,0,0,10752,4,5054261728
6355,6724050,71986779,78710829,1,0,1,4096,26,8622344169
6356,6724060,53317261,60041321,29,2,0,2048,26,4336396429
6357,6725550,53200242,59925792,39,3,0,23552,2,7173545916
6358,6725670,53208021,59933691,28,2,0,16896,24,1542079226
6359,6726150,53485355,60211505,12,1,0,32256,3,1422793955
6360,6727109,71986702,78713811,18,1,1,8704,13,7936911638
6361,6727139,72003358,78730497,4,0,1,24576,14,8587954085
6362,6730530,53556244,60286774,39,3,0,25088,2,497175775
6363,6734499,53253479,59987978,17,1,0,512,28,7423081086
6364,6735689,72004709,78740398,5,0,1,4608,4,1963990834
6365,6736460,53278854,60015314,2,0,0,20480,3,6829402791
6366,6738860,53462786,60201646,18,1,0,22016,13,2498693087
6367,6739950,53593926,60333876,2,0,0,67584,3,8426047521
6368,6741670,53815852,60557522,19,1,0,6656,5,7418283357
6369,6741950,53217608,59959558,15,1,0,5120,19,9093136292
6370,6742170,53452745,60194915,31,3,0,8192,27,1845571621
6371,6742850,72007608,78750458,1,0,1,16384,26,386317525
6372,6743170,53619189,60362359,0,0,0,12800,8,4189996805
6373,6743230,72016104,78759334,17,1,1,9216,28,7501547285
6374,6744260,72017340,78761600,6,0,1,3584,24,4871078699
6375,6744451,72021655,78766106,34,3,1,7168,2,1770794825
6376,6745170,53848434,60593604,10,1,0,3072,4,3981706558
6377,6746010,53446386,60192396,30,3,0,26112,3,6279697582
6378,6747809,72048807,78796616,4,0,1,39424,14,3747910820
6379,6747840,54200340,60948180,12,1,0,13312,3,4444838677
6380,6748010,54152866,60900876,12,1,0,82944,3,1062894306
6381,6750690,53409094,60159784,19,1,0,18944,5,3556885915
6382,6751361,53680171,60431532,25,2,0,12800,4,35749161
6383,6751439,53896243,60647682,17,1,0,58368,28,2007497582
6384,6754190,53732831,60487021,16,1,0,10240,10,6483099638
6385,6756630,53822780,60579410,5,0,0,23040,4,9535827825
6386,6758170,53653155,60411325,30,3,0,31232,3,2143105488
6387,6759720,53905268,60664988,19,1,0,20480,5,6151955048
6388,6760160,53996463,60756623,35,3,0,20992,8,480388673
6389,6760520,72043244,78803764,3,0,1,1024,5,6111861238
6390,6760880,53494196,60255076,2,0,0,12800,3,3314983653
6391,6762350,53588466,60350816,5,0,0,30720,4,8932016277
6392,6763420,54356109,61119529,31,3,0,4096,27,8987857193
6393,6765120,53884613,60649733,3,0,0,6656,5,2124811248
6394,6765970,72046299,78812269,0,0,1,26112,8,82206318
6395,6766750,54444610,61211360,5,0,0,46080,4,3505582630
6396,6767051,54581460,61348511,25,2,0,60928,4,9610416427
6397,6767511,53858753,60626264,25,2,0,16896,4,2074655116
6398,6768440,53818169,60586609,0,0,0,23552,8,1608392088
6399,6768530,54403636,61172166,10,1,0,15360,4,10055716236
6400,6768871,54145958,60914829,34,3,0,37888,2,4976516126
6401,6771440,53946313,60717753,29,2,0,32768,26,8607009564
6402,6773850,53826781,60600631,22,2,0,17408,10,532125600
6403,6773890,53855985,60629875,35,3,0,11776,8,7509242137
6404,6775180,53593910,60369090,21,2,0,22016,25,3755894700
6405,6775360,54457206,61232566,30,3,0,1024,3,3764030903
6406,6775470,53484107,60259577,20,2,0,3072,24,2988779927
6407,6775950,54293376,61069326,35,3,0,90624,8,7847448112
6408,6777590,53828096,60605686,6,0,0,12288,24,1784471947
6409,6779000,72037135,78816135,20,2,1,6144,24,8596950285
6410,6779520,72040029,78819549,2,0,1,3584,3,8805187568
6411,6780419,72039489,78819908,37,3,1,9728,15,707826276
6412,6780560,53965409,60745969,18,1,0,49664,13,1294543002
6413,6783090,54091220,60874310,0,0,0,63488,8,7664623047
6414,6783750,53837343,60621093,11,1,0,7680,6,10572774858
6415,6784510,53834220,60618730,38,3,0,9728,26,8765902483
6416,6785130,54626912,61412042,27,2,0,40960,9,3599831597
6417,6785700,54156506,60942206,30,3,0,50688,3,10292039351
6418,6785900,53821402,60607302,31,3,0,1536,27,8493270247
6419,6786460,53743887,60530347,8,0,0,5120,1,8078021638
6420,6786510,53940292,60726802,13,1,0,14336,6,5673210732
6421,6787760,54817561,61605321,11,1,0,9216,6,1218512158
6422,6787860,55049008,61836868,21,2,0,44544,25,6460084234
6423,6787880,53868914,60656794,7,0,0,3584,29,3715238290
6424,6787910,54115329,60903239,22,2,0,7680,10,6661503814
6425,6791421,72030753,78822174,26,2,1,3584,29,4362040959
6426,6792711,54052537,60845248,34,3,0,44032,2,8965057934
6427,6793790,53758082,60551872,37,3,0,8192,15,6946844541
6428,6794690,53857874,60652564,5,0,0,9216,4,1660524197
6429,6794711,72028129,78822840,7,0,1,11264,29,276285288
6430,6797399,72036620,78834019,8,0,1,12288,1,6441645266
6431,6798810,54278362,61077172,6,0,0,7168,24,8752496536
6432,6800030,53950174,60750204,39,3,0,13824,2,3417134373
6433,6801080,54053863,60854943,27,2,0,31744,9,4176881151
6434,6801969,55219626,62021595,17,1,0,49664,28,4518102748
6435,6804540,54122199,60926739,14,1,0,38912,8,212463665
6436,6804740,54383705,61188445,36,3,0,8192,3,365892444
6437,6805180,54143647,60948827,28,2,0,2048,24,7046992069
6438,6806260,54321603,61127863,18,1,0,2048,13,850922079
6439,6806280,53960635,60766915,30,3,0,28160,3,8540286942
6440,6806620,54170532,60977152,16,1,0,54272,10,5848421530
6441,6808760,54210521,61019281,37,3,0,30208,15,9651812341
6442,6810749,54227517,61038266,17,1,0,22528,28,2474797712
6443,6810809,72024836,78835645,4,0,1,2560,14,146488213
6444,6811220,53854103,60665323,39,3,0,1024,2,5599183342
6445,6811860,54303114,61114974,23,2,0,51200,4,564997781
6446,6813640,54130461,60944101,30,3,0,6144,3,3855218132
6447,6813740,72025131,78838871,17,1,1,5120,28,5267496317
6448,6814520,72025427,78839947,39,3,1,13312,2,8526317857
6449,6815781,72033224,78849005,31,3,1,3584,27,869262452
6450,6817110,55297498,62114608,22,2,0,23040,10,7398980641
6451,6819660,54255305,61074965,30,3,0,18432,3,631973554
6452,6821060,54645667,61466727,16,1,0,56320,10,1723256890
6453,6821935,54293842,61115777,39,3,0,2560,2,2631069920
6454,6823092,72026259,78849351,36,3,1,512,3,6203454153
6455,6823750,54571428,61395178,14,1,0,8192,8,1340898485
6456,6825440,54332929,61158369,36,3,0,3072,3,7114107461
6457,6826950,54272401,61099351,39,3,0,65024,2,8623851497
6458,6829760,54045821,60875581,3,0,0,4096,5,1692142142
6459,6830400,54286024,61116424,19,1,0,2048,5,5410488001
6460,6832790,54333246,61166036,19,1,0,25088,5,6632642184
6461,6834420,72043947,78878367,9,0,1,28672,12,9586318522
6462,6834740,54767750,61602490,7,0,0,15872,29,3190831521
6463,6835290,72099887,78935177,35,3,1,108544,8,10452229111
6464,6835400,54150881,60986281,14,1,0,5632,8,7696992461
6465,6836980,54316975,61153955,2,0,0,46080,3,9026261634
6466,6837530,72130016,78967546,16,1,1,41984,10,755313696
6467,6838780,54491144,61329924,12,1,0,5632,3,9221472446
6468,6839160,54182776,61021936,13,1,0,6656,6,6348965255
6469,6839681,54451458,61291139,25,2,0,33280,4,4595872464
6470,6840360,54327103,61167463,37,3,0,4608,15,8691599082
6471,6840390,54534020,61374410,21,2,0,8192,25,10558667034
6472,6840420,54332705,61173125,36,3,0,3072,3,4032060891
6473,6841641,72128142,78969783,19,1,1,512,5,2852705840
6474,6841860,55164580,62006440,31,3,0,40448,27,8968249450
6475,6847610,54230122,61077732,12,1,0,1536,3,1449759850
6476,6847631,72122511,78970142,21,2,1,9728,25,4248524326
6477,6847990,54959216,61807206,28,2,0,4096,24,2450546081
6478,6850190,54541072,61391262,8,0,0,9216,1,528880342
6479,6851280,54149440,61000720,11,1,0,2560,6,2069920401
6480,6851501,54663112,61514613,25,2,0,29184,4,8593061541
6481,6852101,54407909,61260010,34,3,0,16384,2,7249702640
6482,6853330,55222140,62075470,36,3,0,13824,3,9077663901
6483,6854031,54629058,61483089,34,3,0,6656,2,5990413792
6484,6854690,72122251,78976941,3,0,1,14848,5,6009963276
6485,6857030,54322358,61179388,37,3,0,20480,15,3813073781
6486,6860220,54460948,61321168,29,2,0,14336,26,9703288536
6487,6862659,72115268,78977927,15,1,1,1536,19,6487473132
6488,6865190,54428156,61293346,27,2,0,7168,9,3270498149
6489,6865471,54291939,61157410,33,3,0,11264,22,9246822896
6490,6866950,54373404,61240354,10,1,0,17408,4,3718639329
6491,6867560,54611248,61478808,39,3,0,13824,2,4837963099
6492,6867871,72115202,78983073,34,3,1,8192,2,10002955238
6493,6868050,54353281,61221331,13,1,0,4096,6,539244397
6494,6869020,54605553,61474573,14,1,0,25600,8,3091245785
6495,6869550,54771545,61641095,2,0,0,112128,3,6762872385
6496,6871450,54897579,61769029,2,0,0,10752,3,1276426648
6497,6871780,54725098,61596878,18,1,0,17920,13,2231750557
6498,6872380,55013402,61885782,28,2,0,8192,24,1086793713
6499,6874549,55115363,61989912,17,1,0,31232,28,1688930297
6500,6875490,54664244,61539734,23,2,0,1024,4,700551519
6501,6875540,54604695,61480235,23,2,0,4608,4,10092979824
6502,6877750,54872935,61750685,35,3,0,147968,8,1585472359
6503,6879700,54569844,61449544,20,2,0,5120,24,3375154336
6504,6880650,54957021,61837671,5,0,0,2560,4,10314903196
6505,6882420,55428226,62310646,28,2,0,2048,24,7942036399
6506,6882940,55049478,61932418,18,1,0,47104,13,2106658789
6507,6883120,54873360,61756480,36,3,0,18944,3,10716156977
6508,6883960,54998250,61882210,20,2,0,22016,24,8191425171
6509,6884270,54621428,61505698,37,3,0,10752,15,1343381161
6510,6884430,54535174,61419604,0,0,0,1536,8,1165526709
6511,6886410,55536357,62422767,28,2,0,28672,24,3476470151
6512,6887040,54593998,61481038,18,1,0,2560,13,4966865852
6513,6887629,54878101,61765730,17,1,0,17920,28,6172506971
6514,6887659,54893037,61780696,17,1,0,21504,28,3101442337
6515,6887960,54872287,61760247,15,1,0,12288,19,3799374880
6516,6888060,54898275,61786335,36,3,0,18432,3,7496574352
6517,6889300,54558661,61447961,7,0,0,57856,29,3721664280
6518,6891840,54810814,61702654,37,3,0,4608,15,9657529250
6519,6892710,55004151,61896861,30,3,0,34304,3,10624343639
6520,6894510,54906246,61800756,36,3,0,28672,3,9885759320
6521,6895460,55882671,62778131,29,2,0,26112,26,235679877
6522,6896750,55021293,61918043,16,1,0,50688,10,2264669270
6523,6897130,72087569,78984699,29,2,1,2560,26,3523754882
6524,6898251,72087754,78986005,19,1,1,2048,5,2984012864
6525,6898810,55354910,62253720,32,3,0,32768,17,6103636703
6526,6899000,72087671,78986671,24,2,1,11264,10,5428160202
6527,6900580,54905355,61805935,8,0,0,16896,1,10447351572
6528,6902150,55200221,62102371,21,2,0,33280,25,7012539976
6529,6903230,55188978,62092208,35,3,0,45568,8,9297626062
6530,6903280,54884170,61787450,37,3,0,3584,15,1491330184
6531,6904960,55391081,62296041,10,1,0,26624,4,10205623447
6532,6905720,54961078,61866798,11,1,0,21504,6,4675832026
6533,6905840,54744950,61650790,26,2,0,31744,29,6460005319
6534,6907140,55361290,62268430,6,0,0,45056,24,4804123979
6535,6910530,55949874,62860404,23,2,0,5120,4,2484277675
6536,6912340,55437924,62350264,38,3,0,25088,26,2052790201
6537,6912469,55366797,62279266,17,1,0,25088,28,290345629
6538,6913130,72075807,78988937,6,0,1,3584,24,2322989488
6539,6913530,56014048,62927578,14,1,0,38912,8,3194130796
6540,6914001,72109071,79023072,26,2,1,24576,29,563483640
6541,6914790,54877207,61791997,21,2,0,14848,25,4487351036
6542,6915800,55498208,62414008,10,1,0,90112,4,1081135828
6543,6916929,72110969,79027898,23,2,1,7680,4,1470627581
6544,6917980,55249151,62167131,0,0,0,30720,8,1330126935
6545,6918440,55369466,62287906,13,1,0,22016,6,5848869397
6546,6918920,54850912,61769832,30,3,0,2560,3,8837267914
6547,6920190,55316655,62236845,28,2,0,4608,24,7750622828
6548,6920700,55131533,62052233,32,3,0,48128,17,1062339025
6549,6920840,55442730,62363570,16,1,0,31744,10,2257536349
6550,6921091,55250431,62171522,9,0,0,14336,12,4890203921
6551,6921251,55023202,61944453,25,2,0,39424,4,2811594515
6552,6922520,55192815,62115335,35,3,0,2048,8,3986270742
6553,6922950,55184615,62107565,28,2,0,2048,24,3508909447
6554,6923561,55255678,62179239,9,0,0,25088,12,5467055989
6555,6924730,55459780,62384510,8,0,0,25600,1,8109144877
6556,6924799,55901921,62826720,17,1,0,4608,28,944729225
6557,6924920,72103324,79028244,17,1,1,512,28,9280995403
6558,6925440,55329239,62254679,36,3,0,3072,3,1093724526
6559,6927100,55449587,62376687,21,2,0,25600,25,1714098548
6560,6927870,55150431,62078301,37,3,0,9216,15,8622862977
6561,6927970,55497784,62425754,21,2,0,9728,25,10489488586
6562,6929140,55266793,62195933,39,3,0,18432,2,1268080890
6563,6929560,55685244,62614804,20,2,0,84480,24,215758461
6564,6929660,56074013,63003673,32,3,0,30720,17,2570281323
6565,6931350,55369550,62300900,16,1,0,15872,10,8005013816
6566,6931950,55495699,62427649,13,1,0,6144,6,6767400035
6567,6932560,55578749,62511309,23,2,0,35840,4,3437262067
6568,6933279,72106602,79039881,4,0,1,26624,14,2831198137
6569,6935821,55196667,62132488,9,0,0,2048,12,3767555888
6570,6937169,72103480,79040649,37,3,1,11776,15,6021175881
6571,6940600,56157483,63098083,21,2,0,11776,25,742620302
6572,6941660,72103495,79045155,28,2,1,7168,24,9452943705
6573,6942850,55391088,62333938,8,0,0,1024,1,1839602099
6574,6943180,72102231,79045411,1,0,1,9216,26,2156940332
6575,6946800,55675983,62622783,18,1,0,26112,13,5454052736
6576,6947670,54954906,61902576,16,1,0,8704,10,9471692104
6577,6949360,55286058,62235418,39,3,0,42496,2,6514712720
6578,6951300,55831220,62782520,27,2,0,7680,9,4960380383
6579,6952420,55401455,62353875,35,3,0,11776,8,6438619835
6580,6952920,72093464,79046384,12,1,1,12800,3,3404131580
6581,6955449,55773523,62728972,17,1,0,97280,28,4727342405
6582,6957410,56002958,62960368,3,0,0,71168,5,9658171358
6583,6957820,55599048,62556868,24,2,0,34304,10,9872806147
6584,6958520,55148398,62106918,16,1,0,14848,10,2150115649
6585,6959911,55794738,62754649,33,3,0,36352,22,9053526679
6586,6960140,55408601,62368741,21,2,0,16896,25,6209995272
6587,6963211,72088819,79052030,30,3,1,26624,3,812342796
6588,6963570,55219480,62183050,8,0,0,512,1,9523684901
6589,6965429,72087267,79052696,11,1,1,1024,6,6708115919
6590,6965900,55801009,62766909,18,1,0,9728,13,9153397861
6591,6968120,55694485,62662605,20,2,0,83456,24,151556806
6592,6968780,55487954,62456734,21,2,0,22528,25,4143030380
6593,6969419,55889378,62858797,17,1,0,52736,28,7919721867
6594,6971300,55701857,62673157,14,1,0,4096,8,5742677333
6595,6974080,55841831,62815911,10,1,0,38912,4,9926413561
6596,6974881,56590116,63564997,34,3,0,80384,2,7307119440
6597,6974890,55457774,62432664,10,1,0,16384,4,10375638512
6598,6977811,55781720,62759531,33,3,0,13824,22,2043960465
6599,6979550,55710509,62690059,32,3,0,55296,17,9550218446
6600,6984541,55356951,62341492,33,3,0,10240,22,5981783079
6601,6984700,55602221,62586921,28,2,0,24064,24,8943800674
6602,6984930,72073463,79058393,2,0,1,18944,3,7858927637
6603,6985210,72103854,79089064,35,3,1,31744,8,1472485196
6604,6985680,55686175,62671855,22,2,0,7680,10,3535366013
6605,6985910,55318297,62304207,6,0,0,10752,24,1548034660
6606,6986160,57025877,64012037,20,2,0,29184,24,6887102378
6607,6987190,55637964,62625154,29,2,0,7680,26,472538725
6608,6988370,55775552,62763922,15,1,0,14336,19,2611104861
6609,6989610,55448007,62437617,27,2,0,7680,9,3255747184
6610,6991770,55763526,62755296,8,0,0,2048,1,24833970
6611,6992550,56015670,63008220,8,0,0,14848,1,295907396
6612,6993090,55785228,62778318,7,0,0,512,29,9721718500
6613,6996749,56371910,63368659,17,1,0,15360,28,2696353144
6614,6997340,55336263,62333603,0,0,0,3584,8,6863954445
6615,6999630,72092980,79092610,20,2,1,5632,24,3978351730
6616,7005670,55737872,62743542,13,1,0,46080,6,3501650631
6617,7005760,56131638,63137398,13,1,0,15872,6,9658410973
6618,7006409,72091314,79097723,5,0,1,1024,4,654796623
6619,7007990,55531058,62539048,11,1,0,13824,6,5881669526
6620,7008470,55503954,62512424,31,3,0,3584,27,1338096388
6621,7008721,57360351,64369072,34,3,0,17408,2,4889756346
6622,7010529,72090420,79100949,37,3,1,5120,15,7351566302
6623,7010720,55524093,62534813,36,3,0,12288,3,10403786448
6624,7012440,55657052,62669492,8,0,0,22528,1,701724064
6625,7012830,56108392,63121222,24,2,0,5632,10,8190216043
6626,7012940,57408164,64421104,21,2,0,18432,25,10471243151
6627,7013670,72097342,79111012,27,2,1,13824,9,4136672839
6628,7015090,55684219,62699309,12,1,0,27648,3,9311527303
6629,7015920,56238550,63254470,7,0,0,47104,29,4674316779
6630,7016080,55713383,62729463,23,2,0,1536,4,4632483568
6631,7016379,55563187,62579566,17,1,0,11776,28,10650913213
6632,7016400,72099705,79116105,32,3,1,14848,17,6100978669
6633,7017889,55891610,62909499,17,1,0,1024,28,3748952065
6634,7019190,55823493,62842683,10,1,0,26112,4,6690181338
6635,7019200,55749916,62769116,8,0,0,7168,1,4704581358
6636,7019371,72105555,79124926,7,0,1,1536,29,10485980143
6637,7021150,55767078,62788228,16,1,0,6144,10,296951198
6638,7021680,57478030,64499710,20,2,0,3072,24,5546582695
6639,7021740,55509306,62531046,37,3,0,7168,15,1862558288
6640,7022710,72102575,79125285,0,0,1,9728,8,9731237381
6641,7022920,55757137,62780057,7,0,0,5632,29,2686805011
6642,7024490,55666372,62690862,16,1,0,2560,10,7346300751
6643,7025680,55858457,62884137,6,0,0,4608,24,4338808569
6644,7026470,55743605,62770075,6,0,0,3072,24,2031263176
6645,7029220,72116877,79146097,39,3,1,2560,2,939822531
6646,7031030,72115528,79146558,17,1,1,10240,28,3915851242
6647,7032520,56016282,63048802,5,0,0,37376,4,715833584
6648,7032811,56207276,63240087,25,2,0,9728,4,3383639987
6649,7032930,56199623,63232553,38,3,0,53760,26,2440333976
6650,7034290,55978799,63013089,36,3,0,7168,3,1056816910
6651,7036810,55989874,63026684,32,3,0,44544,17,5960982467
6652,7036949,57721554,64758503,17,1,0,55808,28,5147985553
6653,7037300,56296981,63334281,21,2,0,31744,25,2560192015
6654,7037571,56674520,63712091,9,0,0,32768,12,10445808090
6655,7037700,56301752,63339452,18,1,0,16896,13,9428727028
6656,7038180,72109044,79147224,0,0,1,1024,8,4732700945
6657,7039929,56046379,63086308,17,1,0,3072,28,6340689963
6658,7040700,56390148,63430848,12,1,0,34304,3,4608818463
6659,7044000,56429057,63473057,19,1,0,64512,5,2118267471
6660,7045330,72108154,79153484,33,3,1,19456,22,4213190938
6661,7046000,72117201,79163201,14,1,1,23552,8,2096167762
6662,7048920,56255785,63304705,38,3,0,9728,26,3321117327
6663,7049490,56310917,63360407,10,1,0,58880,4,8864865678
6664,7049750,72124243,79173993,6,0,1,14848,24,890539536
6665,7049859,56274727,63324586,17,1,0,29184,28,2024102141
6666,7050230,72127309,79177539,16,1,1,5632,10,10509600482
6667,7053030,55911766,62964796,2,0,0,8704,3,7736596153
6668,7053900,56331126,63385026,32,3,0,31232,17,2607394860
6669,7055260,56634758,63690018,36,3,0,25088,3,10168133255
6670,7055460,72123385,79178845,38,3,1,2048,26,1581928050
6671,7056160,72123671,79179831,16,1,1,1536,10,5903077734
6672,7056181,72124956,79181137,26,2,1,2048,29,8188887773
6673,7056211,56461862,63518073,33,3,0,23552,22,7718491760
6674,7056300,56615210,63671510,38,3,0,29696,26,162987295
6675,7056760,72124723,79181483,14,1,1,512,8,10334540714
6676,7057540,72221204,79278744,27,2,1,183296,9,3656033106
6677,7057619,57870409,64928028,17,1,0,47616,28,774594715
6678,7058280,56205908,63264188,12,1,0,14848,3,10369539826
6679,7059270,56256401,63315671,38,3,0,10752,26,8397735673
6680,7060980,56348299,63409279,3,0,0,64512,5,4914489730
6681,7061700,72242335,79304035,2,0,1,22016,3,1061174188
6682,7062060,57059421,64121481,0,0,0,16896,8,9617982683
6683,7062240,58311095,65373335,2,0,0,5120,3,3128412584
6684,7063800,58227397,65291197,24,2,0,46592,10,10644918667
6685,7065540,56098054,63163594,5,0,0,33792,4,7408100145
6686,7065890,56460037,63525927,7,0,0,6144,29,9900967919
6687,7070360,56166740,63237100,24,2,0,14848,10,5488754967
6688,7070710,56703495,63774205,29,2,0,19968,26,4157170287
6689,7070979,72239176,79310155,11,1,1,7680,6,6043763750
6690,7071549,72241425,79312974,18,1,1,4096,13,7246199851
6691,7072660,56688761,63761421,16,1,0,9728,10,5276948830
6692,7077120,56182521,63259641,30,3,0,16896,3,4267557430
6693,7077329,72253027,79330356,4,0,1,18432,14,3737772864
6694,7077360,72253982,79331342,0,0,1,1536,8,10636039422
6695,7078200,56604151,63682351,31,3,0,35328,27,3358356559
6696,7078830,56498404,63577234,23,2,0,11264,4,7046850577
6697,7078840,56102037,63180877,37,3,0,9728,15,10564871989
6698,7079180,55929375,63008555,28,2,0,1024,24,2499235442
6699,7081380,56492399,63573779,28,2,0,20992,24,817642317
6700,7082660,72251908,79334568,9,0,1,5120,12,3826408661
6701,7086310,56055192,63141502,39,3,0,6656,2,2314734891
6702,7086520,56821664,63908184,0,0,0,33280,8,2929268082
6703,7087750,56494811,63582561,8,0,0,17408,1,177965981
6704,7088161,56562509,63650670,34,3,0,92672,2,4870603866
6705,7088319,72308262,79396581,4,0,1,125952,14,9921977145
6706,7088350,57033934,64122284,29,2,0,2560,26,6164942844
6707,7088730,56176885,63265615,2,0,0,4608,3,186429770
6708,7090841,72306201,79397042,34,3,1,10240,2,1487434555
6709,7091050,56765816,63856866,13,1,0,7168,6,5267834228
6710,7092050,58402317,65494367,4,0,0,22016,14,6736481199
6711,7092650,72313363,79406013,29,2,1,1536,26,3154012491
6712,7095711,56428313,63524024,25,2,0,19456,4,8159027225
6713,7097961,72308398,79406359,34,3,1,512,2,9896352756
6714,7099390,72327248,79426638,32,3,1,12288,17,5027066792
6715,7103350,72326514,79429864,12,1,1,5120,3,9491925513
6716,7103510,58493799,65597309,32,3,0,20992,17,5171014306
6717,7105299,72339588,79444887,15,1,1,512,19,1882468904
6718,7106080,56556359,63662439,5,0,0,23040,4,4796894654
6719,7106850,58627823,65734673,13,1,0,15872,6,1943039124
6720,7108790,56280810,63389600,16,1,0,4608,10,6608836179
6721,7110100,56202272,63312372,14,1,0,25088,8,5697010201
6722,7110611,56323692,63434303,33,3,0,11264,22,8866483229
6723,7111079,72420865,79531944,4,0,1,164864,14,1530701730
6724,7111540,56891582,64003122,11,1,0,31232,6,5174453595
6725,7111920,56581873,63693793,5,0,0,12288,4,7884890788
6726,7113150,56261460,63374610,28,2,0,19456,24,1355137544
6727,7113190,56273575,63386765,8,0,0,5632,1,1124426498
6728,7113800,56361620,63475420,38,3,0,7680,26,6628921920
6729,7114210,56382601,63496811,0,0,0,23552,8,7252703465
6730,7114601,56298975,63413576,33,3,0,7680,22,7235715907
6731,7115620,56171747,63287367,24,2,0,6656,10,7456550657
6732,7116560,56658604,63775164,37,3,0,3072,15,5952667515
6733,7117820,56974199,64092019,12,1,0,1024,3,4998420093
6734,7118280,72416570,79534850,32,3,1,4608,17,8753468765
6735,7121730,57152471,64274201,5,0,0,10752,4,4795146977
6736,7124270,58703102,65827372,6,0,0,7680,24,4686733985
6737,7127060,56822771,63949831,39,3,0,25600,2,9350390129
6738,7127230,72410846,79538076,36,3,1,5120,3,7648069873
6739,7127610,56770411,63898021,8,0,0,54784,1,842853943
6740,7127830,56383044,63510874,37,3,0,46080,15,4983991420
6741,7128960,56526436,63655396,16,1,0,15360,10,6599107986
6742,7131130,56669181,63800311,6,0,0,40960,24,2872295322
6743,7134420,56432940,63567360,2,0,0,7680,3,8087335229
6744,7135100,56848759,63983859,32,3,0,25088,17,3119982578
6745,7135840,57267454,64403294,14,1,0,50176,8,1278745962
6746,7136211,57045574,64181785,25,2,0,7168,4,2354273659
6747,7136301,72407141,79543442,22,2,1,13824,10,7271807650
6748,7138630,56724153,63862783,26,2,0,15872,29,1042920355
6749,7139520,57535856,64675376,2,0,0,7168,3,3290188154
6750,7139731,72407880,79547611,21,2,1,15872,25,4968207007
6751,7140310,56833197,63973507,22,2,0,29184,10,8740211638
6752,7140360,56835666,63976026,32,3,0,8192,17,5888380438
6753,7141109,72428515,79569624,23,2,1,32256,4,1196376160
6754,7142030,57510188,64652218,32,3,0,7680,17,5824335590
6755,7143270,56911768,64055038,26,2,0,53248,29,5685425617
6756,7143820,58789956,65933776,3,0,0,45056,5,5726819960
6757,7143860,72431881,79575741,20,2,1,9216,24,7779191462
6758,7144950,57299803,64444753,27,2,0,73216,9,6460364274
6759,7145180,57399802,64544982,37,3,0,11776,15,8214116718
6760,7145800,57079100,64224900,30,3,0,4096,3,3234856507
6761,7146350,72431017,79577367,24,2,1,2560,10,2242275449
6762,7146980,57064066,64211046,23,2,0,5632,4,8386154351
6763,7147220,72433194,79580414,25,2,1,14336,4,5657225910
6764,7147470,57655621,64803091,26,2,0,15872,29,10082408922
6765,7149260,57121584,64270844,31,3,0,14848,27,4003483800
6766,7149291,56552793,63702084,34,3,0,27136,2,962731524
6767,7149550,56864546,64014096,20,2,0,5120,24,9963046715
6768,7150430,57050763,64201193,35,3,0,3584,8,9875560873
6769,7152049,56772605,63924654,17,1,0,35328,28,1774075397
6770,7152600,72442284,79594884,27,2,1,12288,9,3200177039
6771,7153460,72443675,79597135,39,3,1,1536,2,6421489390
6772,7154720,57386651,64541371,14,1,0,66560,8,8747056743
6773,7155990,57297990,64453980,14,1,0,30208,8,8052746067
6774,7157749,72440052,79597801,12,1,1,1024,3,10440757881
6775,7157940,57455677,64613617,6,0,0,136192,24,4896592107
6776,7160030,57061924,64221954,32,3,0,6144,17,954019163
6777,7160390,57039688,64200078,23,2,0,25088,4,10134876995
6778,7162930,72436177,79599107,14,1,1,2048,8,9051567271
6779,7163540,58884385,66047925,21,2,0,12800,25,8511745173
6780,7165470,56760143,63925613,37,3,0,3072,15,1284061904
6781,7166910,57539150,64706060,21,2,0,32256,25,8930145612
6782,7167441,57011098,64178539,34,3,0,9216,2,7044238778
6783,7168310,57079252,64247562,10,1,0,30208,4,7645678814
6784,7170300,57087990,64258290,8,0,0,25088,1,6914568725
6785,7171321,57185803,64357124,9,0,0,136704,12,4159281097
6786,7173180,56844588,64017768,15,1,0,2048,19,8036614203
6787,7174540,57195202,64369742,16,1,0,1536,10,2430890582
6788,7177420,57657257,64834677,11,1,0,17408,6,10122318433
6789,7179350,56859441,64038791,3,0,0,24576,5,588649963
6790,7179710,72420063,79599773,38,3,1,1024,26,3465714055
6791,7180760,72419999,79600759,28,2,1,1536,24,10689427490
6792,7181489,72422496,79603985,23,2,1,5120,4,2199477490
6793,7183630,57273025,64456655,30,3,0,8704,3,7228689570
6794,7183830,57786111,64969941,11,1,0,53248,6,2555416187
6795,7184050,57632043,64816093,5,0,0,5120,4,8127503568
6796,7184990,58946004,66130994,19,1,0,7168,5,3846573496
6797,7185010,57178735,64363745,28,2,0,18432,24,10315200192
6798,7185430,57172653,64358083,36,3,0,3072,3,3272879801
6799,7187790,57181461,64369251,6,0,0,512,24,10312818356
6800,7189210,57295647,64484857,35,3,0,43520,8,9836383158
6801,7190770,57871285,65062055,26,2,0,16384,29,4286230459
6802,7192900,57534867,64727767,38,3,0,35840,26,7635884226
6803,7195000,57703787,64898787,2,0,0,99840,3,6407834782
6804,7195270,57515673,64710943,6,0,0,10752,24,10007619836
6805,7195949,72410302,79606251,18,1,1,3584,13,4283632671
6806,7200200,59042354,66242554,16,1,0,97280,10,8389768286
6807,7200309,72406301,79606610,18,1,1,9728,13,1554841420
6808,7201990,72406246,79608236,16,1,1,2560,10,3708864972
6809,7202601,72411405,79614006,30,3,1,3584,3,1727256316
6810,7204110,57910517,65114627,13,1,0,112128,6,1509642495
6811,7204840,72421763,79626603,25,2,1,28160,4,10152970414
6812,7205950,57481461,64687411,8,0,0,39424,1,1818587943
6813,7207459,57077859,64285318,17,1,0,5632,28,864698162
6814,7208160,57426696,64634856,22,2,0,69632,10,9128915389
6815,7208900,57280348,64489248,22,2,0,14336,10,10267848433
6816,7209320,57605182,64814502,29,2,0,37376,26,6264528455
6817,7209870,72460067,79669937,27,2,1,91648,9,3014144291
6818,7209990,57439865,64649855,38,3,0,49152,26,9071382126
6819,7210090,57575848,64785938,30,3,0,21504,3,6911593516
6820,7211510,72462200,79673710,16,1,1,4608,10,1334280819
6821,7214429,72461547,79675976,8,0,1,3584,1,4732714765
6822,7215169,72463073,79678242,5,0,1,3584,4,5884558588
6823,7215290,57732609,64947899,27,2,0,31744,9,1407354835
6824,7215980,57298284,64514264,4,0,0,25088,14,9476684668
6825,7215990,57864404,65080394,37,3,0,28672,15,5236240924
6826,7217800,72462388,79680188,14,1,1,3072,8,9778319245
6827,7218020,57695477,64913497,30,3,0,48128,3,5232179193
6828,7219400,72473501,79692901,27,2,1,6144,9,5759862656
6829,7220220,57543454,64763674,19,1,0,16896,5,818392836
6830,7222100,59298920,66521020,29,2,0,39936,26,5699159715
6831,7224040,57747492,64971532,32,3,0,5120,17,7414725346
6832,7224099,72469058,79693157,8,0,1,9216,1,3191252338
6833,7224150,57547347,64771497,11,1,0,25600,6,4459897266
6834,7224170,57601774,64825944,6,0,0,32256,24,9570170476
6835,7226950,57795306,65022256,20,2,0,2560,24,7649914606
6836,7227619,72472382,79700001,11,1,1,23552,6,8649687549
6837,7227880,57503884,64731764,28,2,0,10752,24,8483178115
6838,7228040,59173413,66401453,20,2,0,18944,24,6980667273
6839,7228880,57782516,65011396,2,0,0,10752,3,4743725889
6840,7229489,57797315,65026804,17,1,0,5632,28,10087882336
6841,7229590,59338068,66567658,30,3,0,20480,3,9282635951
6842,7230090,57764807,64994897,0,0,0,49152,8,9827499661
6843,7230980,58090494,65321474,2,0,0,31232,3,8217126408
6844,7231030,59464578,66695608,4,0,0,111616,14,8535963627
6845,7231050,58067502,65298552,0,0,0,24064,8,3385748117
6846,7232560,57721134,64953694,19,1,0,18944,5,523592434
6847,7232930,59604876,66837806,39,3,0,7168,2,4872380
6848,7235950,57916726,65152676,35,3,0,7680,8,6568238864
6849,7237050,57609591,64846641,3,0,0,17920,5,10140508209
6850,7237420,57695966,64933386,23,2,0,8192,4,3827166250
6851,7237990,72481014,79719004,32,3,1,512,17,7589815209
6852,7238130,72486366,79724496,29,2,1,17920,26,9236393937
6853,7238590,57800022,65038612,5,0,0,4096,4,5621724895
6854,7239530,57451336,64690866,30,3,0,11264,3,1265079577
6855,7244210,57532660,64776870,36,3,0,17408,3,4237780732
6856,7247329,58223540,65470869,17,1,0,67072,28,604298584
6857,7248001,58028977,65276978,33,3,0,49152,22,5039709745
6858,7248440,57318538,64566978,6,0,0,2048,24,7115930963
6859,7249410,58121181,65370591,0,0,0,13824,8,4192152429
6860,7250601,72479182,79729783,38,3,1,16896,26,369860314
6861,7252380,58058432,65310812,2,0,0,15360,3,1282449378
6862,7254190,59796210,67050400,16,1,0,76800,10,3331024158
6863,7254880,72485501,79740381,33,3,1,1536,22,9288020454
6864,7256200,57674659,64930859,15,1,0,9216,19,1794429815
6865,7256620,58330415,65587035,28,2,0,24576,24,5335868927
6866,7256880,57866396,65123276,15,1,0,26112,19,5888870569
6867,7257760,57857537,65115297,3,0,0,2048,5,2936670097
6868,7258800,72484487,79743287,29,2,1,4608,26,8960804448
6869,7259080,58216960,65476040,11,1,0,16896,6,3167416063
6870,7259900,72499813,79759713,16,1,1,35328,10,9065829984
6871,7262580,72508489,79771069,38,3,1,3584,26,409549875
6872,7263140,57891672,65154812,22,2,0,4608,10,5726613239
6873,7263540,72511715,79775255,0,0,1,6656,8,8433032973
6874,7265190,57772151,65037341,13,1,0,27136,6,2062466187
6875,7270120,58265385,65535505,23,2,0,24064,4,9851602820
6876,7270260,57945866,65216126,22,2,0,512,10,4470442434
6877,7271500,59923998,67195498,37,3,0,57856,15,10666720684
6878,7271510,72505051,79776561,28,2,1,2048,24,7417720681
6879,7275820,72502047,79777867,16,1,1,2048,10,6374264597
6880,7281321,58337318,65618639,33,3,0,42496,22,2589629890
6881,7281919,72496512,79778431,8,0,1,10752,1,259745122
6882,7284191,72499676,79783867,19,1,1,11776,5,1109024299
6883,7284530,57977449,65261979,5,0,0,5632,4,8470354488
6884,7285230,57975010,65260240,21,2,0,65536,25,2949899181
6885,7286740,57929207,65215947,24,2,0,35328,10,6139349567
6886,7289631,72499088,79788719,7,0,1,7680,29,3858052979
6887,7289960,58381314,65671274,26,2,0,14336,29,5957078022
6888,7292560,58009626,65302186,24,2,0,3072,10,324881293
6889,7293200,58073156,65366356,15,1,0,11776,19,368201301
6890,7294790,58589801,65884591,18,1,0,17920,13,8926456041
6891,7295590,58520325,65815915,20,2,0,2560,24,7727769681
6892,7295650,58360267,65655917,7,0,0,6656,29,4484038070
6893,7296540,57877078,65173618,23,2,0,9216,4,1568568803
6894,7296881,72496344,79793225,22,2,1,7168,10,8310522562
6895,7300510,58652211,65952721,32,3,0,13824,17,4219915108
6896,7300690,58501397,65802087,28,2,0,67072,24,1142145383
6897,7302430,58269485,65571915,11,1,0,29184,6,2246722153
6898,7307271,72489820,79797091,7,0,1,6144,29,4988870891
6899,7307420,58047506,65354926,1,0,0,7168,26,4379648491
6900,7307801,58473827,65781628,33,3,0,29184,22,7758573282
6901,7307860,72491177,79799037,6,0,1,3072,24,855904847
6902,7308410,57875990,65184400,38,3,0,6656,26,7101926463
6903,7309450,58218700,65528150,39,3,0,1536,2,5421658474
6904,7310470,58630817,65941287,5,0,0,24576,4,5005065972
6905,7311600,58279283,65590883,16,1,0,3072,10,4092066886
6906,7312300,58087818,65400118,14,1,0,14336,8,4562167774
6907,7312320,58096713,65409033,12,1,0,29184,3,3339407695
6908,7312740,58368383,65681123,39,3,0,2560,2,313395135
6909,7313451,57918571,65232022,9,0,0,512,12,238657869
6910,7314169,58458544,65772713,17,1,0,29696,28,9492522184
6911,7314220,58388957,65703177,3,0,0,21504,5,9528298776
6912,7315250,58804565,66119815,10,1,0,30720,4,670754151
6913,7317930,72484973,79802903,9,0,1,6144,12,4677567447
6914,7317960,57988149,65306109,35,3,0,12800,8,5350175053
6915,7318750,72484614,79803364,24,2,1,10240,10,7626264126
6916,7318910,57982317,65301227,5,0,0,8704,4,6743391009
6917,7320330,58242647,65562977,18,1,0,4608,13,10150106312
6918,7320970,58487723,65808693,23,2,0,21504,4,3551366942
6919,7321940,58178361,65500301,15,1,0,13312,19,5896273193
6920,7323130,58720872,66044002,21,2,0,89088,25,1447441148
6921,7323160,58253279,65576439,12,1,0,4096,3,7884486293
6922,7323860,58734072,66057932,18,1,0,32768,13,9258347832
6923,7324740,58490372,65815112,16,1,0,20992,10,10025345166
6924,7325000,58810853,66135853,20,2,0,15872,24,9698309310
6925,7326040,58866329,66192369,15,1,0,27648,19,1945887936
6926,7326840,58387985,65714825,37,3,0,1024,15,8864125916
6927,7327221,72494634,79821855,26,2,1,4608,29,7664856439
6928,7327610,58222479,65550089,14,1,0,7680,8,2568340434
6929,7328849,58198810,65527659,17,1,0,50688,28,9282968615
6930,7329740,59973856,67303596,14,1,0,9728,8,4807419565
6931,7330901,58332995,65663896,33,3,0,26112,22,226281263
6932,7336360,58542725,65879085,35,3,0,47104,8,5949327337
6933,7336990,58950966,66287956,24,2,0,43520,10,1288346465
6934,7337520,59029726,66367246,27,2,0,10240,9,7443225265
6935,7339240,58651235,65990475,14,1,0,13312,8,5450506261
6936,7340400,58295747,65636147,20,2,0,9216,24,6856639715
6937,7343060,58481926,65824986,22,2,0,29696,10,8789007378
6938,7343670,72483779,79827449,39,3,1,18432,2,1109651159
6939,7345320,58360748,65706068,19,1,0,1024,5,1933409493
6940,7345690,58632343,65978033,10,1,0,17920,4,5218950250
6941,7345809,72484866,79830675,23,2,1,5120,4,7205355413
6942,7347010,58625540,65972550,18,1,0,61440,13,9666212420
6943,7347900,60047880,67395780,2,0,0,59904,3,9937773625
6944,7350850,58316033,65666883,16,1,0,9728,10,7371555271
6945,7353721,72477210,79830931,7,0,1,9216,29,9393601512
6946,7355531,58661304,66016835,34,3,0,60416,2,2939983145
6947,7358230,59130499,66488729,28,2,0,30720,24,3170180649
6948,7358290,58216776,65575066,1,0,0,10240,26,281370725
6949,7360100,58996197,66356297,29,2,0,6656,26,2104817143
6950,7360360,59168015,66528375,20,2,0,24064,24,10369375880
6951,7360700,60264512,67625212,20,2,0,45568,24,8658524317
6952,7361580,58586906,65948486,15,1,0,23552,19,3833765876
6953,7362970,72475216,79838186,6,0,1,2048,24,3407975060
6954,7363840,59295859,66659699,35,3,0,26112,8,10024486490
6955,7364961,72477411,79842372,7,0,1,3072,29,1748312246
6956,7365581,59103095,66468676,33,3,0,14336,22,2466451645
6957,7366590,60436464,67803054,21,2,0,19968,25,4379014798
6958,7368580,58690475,66059055,32,3,0,3584,17,302897016
6959,7368680,72482704,79851384,35,3,1,16896,8,5306814817
6960,7368850,58759937,66128787,4,0,0,7680,14,9313910651
6961,7369030,60562110,67931140,1,0,0,23040,26,10621274491
6962,7371311,72484986,79856297,26,2,1,17408,29,10136415018
6963,7373070,72495301,79868371,6,0,1,1536,24,7182087384
6964,7373210,60346588,67719798,18,1,0,74752,13,1537433713
6965,7373400,58514703,65888103,4,0,0,4096,14,159775441
6966,7373920,60699651,68073571,7,0,0,35328,29,10723135880
6967,7375869,58606921,65982790,17,1,0,15360,28,4465218310
6968,7376350,58514024,65890374,26,2,0,4096,29,9656803807
6969,7376750,72491775,79868525,2,0,1,8704,3,3881200704
6970,7378810,59264021,66642831,15,1,0,49664,19,6840412290
6971,7380310,58973928,66354238,12,1,0,17408,3,10260659576
6972,7380341,59165903,66546244,9,0,0,6656,12,10315908277
6973,7381020,72487851,79868871,32,3,1,512,17,1676960395
6974,7383920,58791990,66175910,7,0,0,20480,29,310840354
6975,7384290,58964552,66348842,3,0,0,5632,5,9605025981
6976,7386480,59157705,66544185,39,3,0,49664,2,1576901176
6977,7388040,58680903,66068943,3,0,0,512,5,8555266266
6978,7388100,58958957,66347057,12,1,0,67072,3,9709437448
6979,7388450,59599999,66988449,20,2,0,31232,24,8600744018
6980,7389759,72480418,79870177,12,1,1,2048,3,1069720631
6981,7390570,58719862,66110432,27,2,0,14336,9,8259237328
6982,7390629,59357799,66748428,17,1,0,47616,28,7524610327
6983,7390691,58778956,66169647,25,2,0,79872,4,2116275158
6984,7391200,58909674,66300874,32,3,0,17408,17,9112755205
6985,7391561,59137461,66529022,25,2,0,2048,4,6967391637
6986,7392700,59750675,67143375,26,2,0,44544,29,8880046147
6987,7392880,58731998,66124878,35,3,0,4608,8,5282381130
6988,7393270,58712771,66106041,27,2,0,10240,9,1696582325
6989,7394660,72475671,79870331,24,2,1,8704,10,6188364789
6990,7395480,58816252,66211732,20,2,0,13312,24,5342696226
6991,7397940,72489733,79887673,33,3,1,9216,22,2936396914
6992,7399299,72489809,79889108,8,0,1,23040,1,8596136169
6993,7399510,58845742,66245252,26,2,0,6144,29,543264586
6994,7401959,60810836,68212795,17,1,0,55808,28,1840828594
6995,7403590,58839767,66243357,6,0,0,2560,24,642513315
6996,7403960,60891665,68295625,31,3,0,89600,27,8505791564
6997,7405570,59542526,66948096,18,1,0,67072,13,2358370352
6998,7406220,58989438,66395658,0,0,0,18944,8,410256218
6999,7406700,72488730,79895430,28,2,1,5120,24,1812098234
7000,7410290,59401926,66812216,30,3,0,54272,3,7965763194
7001,7413850,58895495,66309345,23,2,0,14848,4,9841356467
7002,7414150,59283977,66698127,28,2,0,8192,24,2514501964
7003,7415270,59032850,66448120,35,3,0,30720,8,8273961995
7004,7416800,72514806,79931606,0,0,1,26112,8,5538718644
7005,7417240,58904373,66321613,27,2,0,4608,9,4883295701
7006,7418710,59416889,66835599,22,2,0,27136,10,5610820971
7007,7418720,72517712,79936432,9,0,1,7680,12,1372290477
7008,7419210,59168200,66587410,4,0,0,41472,14,8022108680
7009,7419840,59306390,66726230,31,3,0,92160,27,4495539102
7010,7420800,59858165,67278965,8,0,0,11264,1,1354536566
7011,7423810,59399684,66823494,14,1,0,22528,8,6913380628
7012,7424010,59684182,67108192,29,2,0,1536,26,8241026115
7013,7426269,72514741,79941010,15,1,1,1024,19,7988750054
7014,7426530,59390077,66816607,11,1,0,14336,6,232158534
7015,7428020,58892166,66320186,16,1,0,5120,10,7127473673
7016,7428240,59587721,67015961,15,1,0,17408,19,3056914238
7017,7428580,59023488,66452068,18,1,0,8704,13,7981496038
7018,7429190,60995609,68424799,12,1,0,179712,3,235705389
7019,7433750,72508886,79942636,17,1,1,2560,28,4010094597
7020,7437060,72513889,79950949,25,2,1,12288,4,9540000754
7021,7438530,59357127,66795657,16,1,0,40960,10,3943274119
7022,7440691,59108540,66549231,34,3,0,9728,2,7836691463
7023,7441830,59150476,66592306,15,1,0,13824,19,6865244958
7024,7441901,61037119,68479020,33,3,0,11776,22,4764734123
7025,7443960,59468131,66912091,1,0,0,14336,26,5310157879
7026,7444921,72513007,79957928,22,2,1,19456,10,7398412099
7027,7446230,59507037,66953267,2,0,0,16896,3,8300544899
7028,7446460,60404058,67850518,11,1,0,23552,6,294665407
7029,7446950,60289343,67736293,15,1,0,1536,19,3953217940
7030,7451250,59304689,66755939,0,0,0,24576,8,4307846648
7031,7451469,72509365,79960834,4,0,1,4608,14,6627078855
7032,7451510,59636356,67087866,5,0,0,25600,4,6025658936
7033,7452420,59281477,66733897,26,2,0,25088,29,7932756427
7034,7453070,60092419,67545489,38,3,0,19968,26,5723659874
7035,7453249,72511138,79964387,5,0,1,12288,4,7330076723
7036,7454150,60050218,67504368,15,1,0,77312,19,6711897340
7037,7454820,61184508,68639328,1,0,0,51712,26,2706692526
7038,7457090,59764639,67221729,24,2,0,86016,10,8879546712
7039,7457350,59614487,67071837,1,0,0,27648,26,5328239966
7040,7457380,59828261,67285641,38,3,0,11264,26,1672068498
7041,7457889,72515788,79973677,37,3,1,4608,15,2618975083
7042,7458530,59436721,66895251,21,2,0,13824,25,10270351237
7043,7458599,72527296,79985895,8,0,1,3072,1,833162919
7044,7459380,59365385,66824765,37,3,0,4096,15,8150421148
7045,7460060,59686458,67146518,26,2,0,10240,29,4561961554
7046,7460930,59538026,66998956,37,3,0,13824,15,4402510245
7047,7461760,59411655,66873415,22,2,0,53760,10,5808567749
7048,7464001,72527162,79991163,34,3,1,2048,2,4344728907
7049,7464860,59994223,67459083,27,2,0,75264,9,10100761105
7050,7465350,61094772,68560122,8,0,0,4608,1,3089548722
7051,7467120,60356162,67823282,32,3,0,29696,17,4633564919
7052,7476390,59857215,67333605,8,0,0,52736,1,4205186329
7053,7476400,59408426,66884826,15,1,0,37376,19,1842178754
7054,7476601,59761375,67237976,9,0,0,53248,12,1539375001
7055,7476871,72516238,79993109,21,2,1,3072,25,448989334
7056,7477621,60210775,67688396,33,3,0,31744,22,3737685499
7057,7477940,72515425,79993365,3,0,1,9216,5,8511619909
7058,7479390,59628311,67107701,14,1,0,65024,8,1668406948
7059,7481200,59919283,67400483,7,0,0,15360,29,1194536028
7060,7482110,59824588,67306698,20,2,0,512,24,7324214102
7061,7483280,60041460,67524740,11,1,0,8704,6,10442727550
7062,7485380,59638088,67123468,4,0,0,26112,14,130011072
7063,7490230,59777792,67268022,12,1,0,39936,3,5120982032
7064,7492030,59335278,66827308,12,1,0,4096,3,2189721299
7065,7492380,60161948,67654328,12,1,0,36864,3,2001847963
7066,7494340,60027725,67522065,35,3,0,30720,8,9769979927
7067,7496450,60057821,67554271,38,3,0,28672,26,2976015946
7068,7496920,61224722,68721642,15,1,0,8192,19,5120937640
7069,7498610,59665757,67164367,35,3,0,13312,8,4108848939
7070,7500890,61333884,68834774,2,0,0,28160,3,2437298604
7071,7505080,59850663,67355743,26,2,0,29184,29,4018391287
7072,7505580,72488131,79993711,25,2,1,512,4,3089723171
7073,7506160,59956378,67462538,6,0,0,11264,24,8909170439
7074,7506191,60131680,67637871,33,3,0,41472,22,390360838
7075,7507260,61379086,68886346,5,0,0,119296,4,9340234939
7076,7507481,72487715,79995196,31,3,1,15360,27,10341457820
7077,7509390,60381355,67890745,30,3,0,44544,3,7278072638
7078,7509990,72491735,80001725,3,0,1,23040,5,4528765262
7079,7511390,59969399,67480789,32,3,0,48640,17,6496446653
7080,7513590,72489121,80002711,28,2,1,1536,24,838277247
7081,7514210,60235678,67749888,23,2,0,44544,4,2016778516
7082,7515520,60095785,67611305,7,0,0,51200,29,1627756097
7083,7516030,60379262,67895292,20,2,0,14848,24,726595192
7084,7517020,60179979,67696999,22,2,0,28160,10,405561150
7085,7519070,59781539,67300609,7,0,0,5632,29,1351755298
7086,7521090,60411633,67932723,32,3,0,5120,17,3776396601
7087,7522040,60051317,67573357,3,0,0,62464,5,5149076417
7088,7522790,72482507,80005297,12,1,1,4096,3,2190836232
7089,7522920,59716639,67239559,38,3,0,5120,26,5096623568
7090,7523819,72493387,80017206,23,2,1,6144,4,8639245430
7091,7524270,59984489,67508759,15,1,0,14336,19,9930272386
7092,7526740,72498577,80025317,3,0,1,12288,5,2181289201
7093,7526860,60196393,67723253,13,1,0,11264,6,6856686431
7094,7529040,59808066,67337106,27,2,0,11264,9,2553384188
7095,7530140,60205662,67735802,8,0,0,14336,1,9442702903
7096,7530171,60266776,67796947,9,0,0,69632,12,9074544277
7097,7531281,59998318,67529599,25,2,0,15872,4,8986942930
7098,7531641,72518950,80050591,7,0,1,25600,29,3615311201
7099,7532620,60239186,67771806,14,1,0,8192,8,6343925842
7100,7534260,60528524,68062784,1,0,0,15872,26,9443058917
7101,7535681,60107384,67643065,25,2,0,14848,4,5811057615
7102,7536539,72525650,80062189,4,0,1,12800,14,9958738059
7103,7536769,72527046,80063815,18,1,1,2560,13,10249791728
7104,7538230,60548675,68086905,32,3,0,5120,17,10172361572
7105,7539440,59973242,67512682,31,3,0,12800,27,5061779936
7106,7540350,60187918,67728268,2,0,0,16384,3,625452010
7107,7540489,60299375,67839864,17,1,0,30720,28,4802798887
7108,7543140,72528729,80071869,2,0,1,4096,3,950163131
7109,7543600,60116496,67660096,28,2,0,14336,24,1100632360
7110,7545800,61347282,68893082,4,0,0,6656,14,8485317817
7111,7548380,60397940,67946320,8,0,0,14848,1,9903397260
7112,7549050,61449663,68998713,11,1,0,39424,6,5064121966
7113,7549329,72524806,80074135,4,0,1,3584,14,5488607249
7114,7549710,60618113,68167823,2,0,0,15872,3,10165219797
7115,7549720,60352582,67902302,4,0,0,14848,14,9056520953
7116,7550921,60087597,67638518,9,0,0,2048,12,4521204568
7117,7551070,72526611,80077681,14,1,1,5632,8,3651130388
7118,7553100,60488870,68041970,23,2,0,129024,4,3189916819
7119,7556220,60274261,67830481,21,2,0,23552,25,4187840504
7120,7556630,60252890,67809520,12,1,0,15360,3,2377347264
7121,7557610,72521697,80079307,3,0,1,2560,5,3772234659
7122,7557730,60096941,67654671,30,3,0,1024,3,9891902187
7123,7559250,60485152,68044402,38,3,0,4096,26,2158791471
7124,7559680,60902378,68462058,20,2,0,11776,24,5539266283
7125,7560430,60601419,68161849,26,2,0,13824,29,4154870649
7126,7561640,60595928,68157568,27,2,0,83456,9,2344763606
7127,7563780,60672253,68236033,28,2,0,22528,24,9494230427
7128,7563950,60346799,67910749,5,0,0,27648,4,8563831494
7129,7564250,72516683,80080933,20,2,1,2560,24,7089282413
7130,7566340,60165071,67731411,1,0,0,10240,26,8258333984
7131,7567469,72513720,80081189,11,1,1,9216,6,843877474
7132,7567880,60431916,67999796,14,1,0,31232,8,10041080797
7133,7569360,60273959,67843319,12,1,0,11264,3,10361120495
7134,7569520,60511384,68080904,39,3,0,17920,2,7959900700
7135,7569850,72512210,80082060,16,1,1,12288,10,6113511714
7136,7569880,60483749,68053629,18,1,0,30208,13,3828243542
7137,7570520,72516686,80087206,32,3,1,8192,17,4829691383
7138,7571481,72709727,80281208,31,3,1,331264,27,1389580348
7139,7573810,72709024,80282834,17,1,1,2560,28,3390758992
7140,7574960,60588004,68162964,28,2,0,3584,24,8067081292
7141,7575000,60648449,68223449,23,2,0,32256,4,4819213853
7142,7576631,72711375,80288006,34,3,1,18432,2,902307754
7143,7576841,61075656,68652497,9,0,0,29184,12,1121280214
7144,7578450,72710017,80288467,38,3,1,10240,26,4891222963
7145,7579310,60591664,68170974,31,3,0,10240,27,4153486589
7146,7580090,61201311,68781401,35,3,0,21504,8,348140737
7147,7581880,60550237,68132117,20,2,0,53760,24,5003411580
7148,7581970,61484151,69066121,3,0,0,41984,5,2029074832
7149,7584320,60629278,68213598,32,3,0,2560,17,2226459326
7150,7585159,60489215,68074374,17,1,0,2560,28,299925474
7151,7585230,60873201,68458431,12,1,0,47616,3,6068266315
7152,7587690,60765961,68353651,12,1,0,39424,3,1090423173
7153,7591200,61090952,68682152,4,0,0,18944,14,3392901481
7154,7591820,60410807,68002627,20,2,0,9216,24,5351984040
7155,7592040,60843569,68435609,37,3,0,7680,15,5547506216
7156,7593110,60449998,68043108,1,0,0,3584,26,3946554104
7157,7594720,72696013,80290733,9,0,1,3584,12,906430900
7158,7594740,60760250,68354990,14,1,0,2560,8,4519042648
7159,7598120,60517594,68115714,37,3,0,41472,15,8770620931
7160,7599700,60730417,68330117,31,3,0,5120,27,10361288773
7161,7601220,60722276,68323496,28,2,0,41472,24,4027862047
7162,7601640,60575947,68177587,8,0,0,15872,1,1655318428
7163,7602600,72689439,80292039,27,2,1,2048,9,3705848798
7164,7603501,72689204,80292705,21,2,1,1024,25,7013904963
7165,7604980,60720411,68325391,30,3,0,6144,3,5727965984
7166,7606370,61606527,69212897,32,3,0,178688,17,7454798616
7167,7607641,72688930,80296571,22,2,1,6144,10,5651919329
7168,7607780,60909628,68517408,26,2,0,25600,29,6508071430
7169,7608990,60923944,68532934,29,2,0,10752,26,1964363978
7170,7612220,72685337,80297557,0,0,1,1536,8,10643211595
7171,7612660,61368067,68980727,13,1,0,22016,6,7825747948
7172,7614010,72684213,80298223,38,3,1,1024,26,5953521722
7173,7614440,60849365,68463805,3,0,0,5632,5,5694827960
7174,7615430,61647306,69262736,24,2,0,31232,10,3089428898
7175,7616290,60712244,68328534,39,3,0,10240,2,9016542116
7176,7616570,61001819,68618389,18,1,0,102912,13,9667978843
7177,7617190,60826710,68443900,12,1,0,27136,3,7036400892
7178,7618390,61231585,68849975,4,0,0,28672,14,7006277600
7179,7618530,60814716,68433246,1,0,0,27648,26,560751303
7180,7618550,60851770,68470320,23,2,0,7168,4,507794978
7181,7620050,61056307,68676357,28,2,0,10752,24,9447341636
7182,7622279,72676610,80298889,4,0,1,1024,14,10319814074
7183,7624590,60928175,68552765,29,2,0,1536,26,416270842
7184,7624860,61300757,68925617,39,3,0,3584,2,7987130353
7185,7624980,61422922,69047902,32,3,0,75776,17,7539423218
7186,7625820,60903815,68529635,23,2,0,22528,4,4304540614
7187,7626830,72673045,80299875,17,1,1,1536,28,6251759676
7188,7626900,72673641,80300541,38,3,1,1024,26,1263976083
7189,7627090,60993240,68620330,6,0,0,6144,24,2297564065
7190,7627210,61424638,69051848,6,0,0,6144,24,6985069437
7191,7627630,61511226,69138856,14,1,0,11264,8,5696525945
7192,7631250,61176819,68808069,39,3,0,4096,2,10500905816
7193,7633840,61311191,68945031,2,0,0,18944,3,5932361817
7194,7636121,60897530,68533651,34,3,0,1536,2,5858474002
7195,7638879,61836248,69475127,17,1,0,72704,28,7271045010
7196,7638910,61377633,69016543,24,2,0,31232,10,7561608234
7197,7639430,61807563,69446993,13,1,0,49152,6,6393023833
7198,7639920,61453371,69093291,22,2,0,12288,10,8475415847
7199,7640831,61181202,68822033,33,3,0,8704,22,6070964996
7200,7642340,72658969,80301309,39,3,1,11776,2,4047687968
7201,7642710,60920623,68563333,23,2,0,2048,4,933892618
7202,7643880,61064687,68708567,13,1,0,25600,6,3605151999
7203,7644510,60937788,68582298,12,1,0,512,3,10195234618
7204,7646910,61945769,69592679,1,0,0,57344,26,560604717
7205,7647001,72656135,80303136,7,0,1,9216,29,5682948616
7206,7649071,72657508,80306579,7,0,1,13824,29,474648449
7207,7650839,72668031,80318870,15,1,1,27648,19,7583888672
7208,7651140,61035896,68687036,32,3,0,5632,17,10310000277
7209,7651500,61047015,68698515,10,1,0,3584,4,2301790576
7210,7653500,61185041,68838541,28,2,0,12288,24,5216839203
7211,7653890,61103893,68757783,28,2,0,31744,24,9168849753
7212,7654020,72670290,80324310,0,0,1,4096,8,3984731949
7213,7655110,61480291,69135401,3,0,0,31744,5,10634444343
7214,7656150,61234743,68890893,39,3,0,14848,2,6742548060
7215,7657540,61748927,69406467,31,3,0,15360,27,10024075623
7216,7658030,61328648,68986678,14,1,0,19456,8,5770283248
7217,7659720,72665051,80324771,32,3,1,10240,17,4094795048
7218,7664860,61231864,68896724,24,2,0,6144,10,2448981351
7219,7665050,61424474,69089524,1,0,0,45568,26,579467999
7220,7666011,61578224,69244235,25,2,0,29184,4,4341627859
7221,7666850,61340154,69007004,24,2,0,27136,10,6824638616
7222,7667380,72666844,80334224,6,0,1,12288,24,5972708839
7223,7668430,61708796,69377226,24,2,0,58880,10,7876923901
7224,7668860,72667310,80336170,38,3,1,3072,26,8192112822
7225,7670150,61451900,69122050,23,2,0,512,4,5019030377
7226,7670800,61427531,69098331,1,0,0,5632,26,3445769308
7227,7671880,61380147,69052027,18,1,0,512,13,5624824552
7228,7672170,72668103,80340273,6,0,1,5632,24,3383811100
7229,7673010,61590849,69263859,10,1,0,3584,4,3113273904
7230,7674390,61576264,69250654,35,3,0,20992,8,6738684519
7231,7675050,72883790,80558840,25,2,1,329728,4,5927407599
7232,7677010,61775934,69452944,1,0,0,19456,26,4599686366
7233,7677270,61372683,69049953,14,1,0,6656,8,6656593164
7234,7677790,61540769,69218559,5,0,0,16384,4,9702792116
7235,7678790,61617426,69296216,1,0,0,24576,26,154121698
7236,7679120,61574077,69253197,21,2,0,8192,25,1439063287
7237,7682230,61623369,69305599,11,1,0,30720,6,3579149971
7238,7682860,61463351,69146211,21,2,0,24064,25,10256163894
7239,7683120,61463738,69146858,27,2,0,2048,9,9539058709
7240,7683690,61529854,69213544,23,2,0,2048,4,1852832178
7241,7686061,61208768,68894829,34,3,0,5632,2,6376680135
7242,7686841,61330349,69017190,25,2,0,2048,4,9586441332
7243,7687180,61544217,69231397,23,2,0,39424,4,6105562216
7244,7688100,61365198,69053298,32,3,0,4096,17,9302488032
7245,7688260,61800797,69489057,2,0,0,6144,3,1308462742
7246,7688650,62035435,69724085,27,2,0,26112,9,8168771768
7247,7689120,61942043,69631163,13,1,0,13312,6,6654116753
7248,7690090,61669173,69359263,2,0,0,59392,3,5652291334
7249,7690439,72870027,80560466,37,3,1,2560,15,6474225684
7250,7690720,61711044,69401764,11,1,0,71168,6,8766641992
7251,7690771,61643044,69333815,34,3,0,14848,2,8932265623
7252,7691680,72871372,80563052,29,2,1,4096,26,4769342696
7253,7693570,61614392,69307962,38,3,0,7680,26,868401358
7254,7694880,61540440,69235320,18,1,0,12800,13,3214354777
7255,7696450,61959560,69656010,1,0,0,1024,26,185504920
7256,7696570,61959105,69655675,29,2,0,30208,26,3652733038
7257,7696760,72876714,80573474,16,1,1,5632,10,9612670832
7258,7697320,61575454,69272774,1,0,0,29184,26,4220931576
7259,7698400,62139535,69837935,23,2,0,4096,4,1421640876
7260,7698600,61590105,69288705,27,2,0,18432,9,10478418405
7261,7699860,62266961,69966821,1,0,0,32768,26,2957970840
7262,7701480,72874493,80575973,24,2,1,13312,10,261753667
7263,7702520,61789532,69492052,6,0,0,9728,24,10014179057
7264,7702570,61800942,69503512,15,1,0,33280,19,5104748010
7265,7702810,61836120,69538930,30,3,0,12288,3,2645900520
7266,7703570,61934792,69638362,35,3,0,23552,8,9198759355
7267,7703670,61990594,69694264,27,2,0,47104,9,7094066945
7268,7708850,61671207,69380057,15,1,0,9216,19,3906958380
7269,7711150,61700176,69411326,21,2,0,15872,25,2417855443
7270,7711931,61507431,69219362,34,3,0,2560,2,10181770006
7271,7714541,72875569,80590110,21,2,1,12288,25,2909987433
7272,7716349,72877832,80594181,8,0,1,4608,1,8327812659
7273,7716710,61770452,69487162,11,1,0,39424,6,640293665
7274,7716730,62370181,70086911,31,3,0,52736,27,1489822885
7275,7717980,72878467,80596447,28,2,1,3584,24,3188887787
7276,7719719,62517342,70237061,17,1,0,95744,28,4379363842
7277,7719801,61925144,69644945,9,0,0,21504,12,9450910465
7278,7719850,72888862,80608712,0,0,1,10240,8,5337558987
7279,7720411,72888455,80608866,34,3,1,8704,2,5145264632
7280,7721940,61994166,69716106,27,2,0,32256,9,8556384836
7281,7725980,72999710,80725690,1,0,1,272896,26,10151715330
7282,7728560,73001325,80729885,29,2,1,3072,26,4895590352
7283,7730910,72999641,80730551,38,3,1,1024,26,5195893615
7284,7731780,61870867,69602647,7,0,0,22528,29,2542347146
7285,7732500,62011598,69744098,18,1,0,512,13,3534900878
7286,7732760,61678901,69411661,20,2,0,1024,24,8759994936
7287,7736410,62505666,70242076,35,3,0,16384,8,9208055408
7288,7736530,62081202,69817732,32,3,0,29184,17,2378781323
7289,7736910,61958625,69695535,12,1,0,4096,3,855658990
7290,7737520,61996474,69733994,26,2,0,7680,29,2264473751
7291,7738541,72995236,80733777,26,2,1,5120,29,5651877618
7292,7738590,72996813,80735403,24,2,1,2560,10,7639438619
7293,7739820,61811197,69551017,1,0,0,25600,26,8467448171
7294,7740440,62658404,70398844,32,3,0,2560,17,4967701146
7295,7742180,62598156,70340336,32,3,0,20992,17,5982253925
7296,7742439,61775098,69517537,17,1,0,21504,28,3309341735
7297,7742620,73000195,80742815,12,1,1,11776,3,9698606032
7298,7743731,62603748,70347479,34,3,0,18432,2,8249711786
7299,7746040,62441640,70187680,38,3,0,131584,26,3690512906
7300,7747551,72998170,80745721,38,3,1,4608,26,5515774941
7301,7747920,62244662,69992582,31,3,0,42496,27,7761602658
7302,7749470,62175280,69924750,20,2,0,6144,24,2653354744
7303,7750910,61843040,69593950,11,1,0,4096,6,7453250397
7304,7751149,62611999,70363148,17,1,0,5120,28,3291876355
7305,7751230,62610335,70361565,6,0,0,9728,24,1445293662
7306,7752690,62134724,69887414,21,2,0,19968,25,3077551198
7307,7753710,62055107,69808817,0,0,0,25600,8,5255933338
7308,7755700,61948617,69704317,12,1,0,28672,3,5856363689
7309,7759100,62184289,69943389,13,1,0,31232,6,6547783150
7310,7759970,72996890,80756860,13,1,1,17920,6,1498938804
7311,7761770,62340348,70102118,18,1,0,31744,13,109842501
7312,7763209,73011700,80774909,18,1,1,1536,13,5345488290
7313,7764630,62970821,70735451,26,2,0,512,29,2491794443
7314,7766080,62381485,70147565,39,3,0,27648,2,6338409521
7315,7766850,62835480,70602330,2,0,0,25600,3,7383792942
7316,7766991,73008264,80775255,30,3,1,512,3,1868631616
7317,7767230,62502654,70269884,1,0,0,31744,26,882273134
7318,7768760,73007481,80776241,33,3,1,1536,22,2214018709
7319,7769310,63093312,70862622,26,2,0,76288,29,3990409085
7320,7769629,73007278,80776907,5,0,1,1024,4,10353942805
7321,7772480,62172492,69944972,23,2,0,5120,4,10067461212
7322,7774630,62044849,69819479,11,1,0,5632,6,1565926656
7323,7774890,73002478,80777368,32,3,1,10240,17,7773853181
7324,7775630,62955332,70730962,38,3,0,45568,26,4874292838
7325,7775770,73002904,80778674,27,2,1,2048,9,3494117326
7326,7779170,62148750,69927920,21,2,0,3072,25,9079939270
7327,7780450,62800206,70580656,23,2,0,2048,4,8656923833
7328,7780531,63126994,70907525,34,3,0,26112,2,7994271487
7329,7780960,62994827,70775787,0,0,0,25600,8,162742971
7330,7782261,72998596,80780857,38,3,1,2048,26,3031680735
7331,7783131,62673092,70456223,9,0,0,99328,12,4155239314
7332,7783170,62213670,69996840,18,1,0,13824,13,3003329344
7333,7784940,62405313,70190253,12,1,0,8192,3,8693934177
7334,7785170,72996776,80781946,35,3,1,1024,8,6799339170
7335,7785850,72997082,80782932,33,3,1,1536,22,9309545723
7336,7790290,72995868,80786158,20,2,1,5120,24,9894770700
7337,7792470,63028699,70821169,24,2,0,105984,10,8201166227
7338,7792991,62710422,70503413,25,2,0,50176,4,7871458712
7339,7793310,62522201,70315511,24,2,0,14336,10,6335263399
7340,7793469,72995595,80789064,11,1,1,4608,6,3990542306
7341,7796280,62890222,70686502,15,1,0,56832,19,9376388719
7342,7796950,62611366,70408316,39,3,0,10240,2,10090012122
7343,7797280,63087380,70884660,30,3,0,36864,3,819014827
7344,7798280,63066549,70864829,16,1,0,7168,10,10500396905
7345,7800930,62448865,70249795,31,3,0,6656,27,2012233781
7346,7801059,62814255,70615314,17,1,0,41984,28,7083836520
7347,7802280,63261358,71063638,24,2,0,45568,10,1582864118
7348,7802531,63411537,71214068,25,2,0,12288,4,8541596406
7349,7804540,62700612,70505152,39,3,0,5632,2,8706069020
7350,7807010,63258858,71065868,11,1,0,5632,6,6558981047
7351,7808360,62589681,70398041,26,2,0,16896,29,5031525777
7352,7812709,63179435,70992144,17,1,0,14336,28,8175035571
7353,7816550,63307096,71123646,30,3,0,20992,3,2902668215
7354,7817220,62541358,70358578,31,3,0,36352,27,8174673886
7355,7817520,63090340,70907860,24,2,0,1024,10,9780021417
7356,7818270,62720874,70539144,13,1,0,19968,6,1771132776
7357,7820200,62558606,70378806,18,1,0,6656,13,2869199886
7358,7820410,62640302,70460712,32,3,0,7168,17,7192685809
7359,7820880,62869545,70690425,39,3,0,12800,2,428486580
7360,7821320,63224488,71045808,6,0,0,143360,24,3849901775
7361,7822091,62481642,70303733,34,3,0,3584,2,1256267887
7362,7823010,63267258,71090268,35,3,0,18432,8,3428399544
7363,7826020,62499818,70325838,35,3,0,17408,8,7765833972
7364,7826060,72978069,80804129,35,3,1,2048,8,1318437961
7365,7827490,62931495,70758985,24,2,0,20480,10,2263139955
7366,7830310,72978325,80808635,38,3,1,7168,26,6886054690
7367,7831239,72979982,80811221,37,3,1,16384,15,7098951777
7368,7831600,62626674,70458274,16,1,0,6656,10,4327887617
7369,7831850,62754750,70586600,4,0,0,3072,14,7460356404
7370,7832060,63369664,71201724,30,3,0,24064,3,7420557736
7371,7832910,62593026,70425936,30,3,0,32256,3,114686937
7372,7833010,62731160,70564170,35,3,0,73216,8,8077296634
7373,7833889,72981838,80815727,4,0,1,7168,14,3254814884
7374,7835391,72981104,80816495,22,2,1,11776,10,10396064643
7375,7838961,62730380,70569341,33,3,0,16896,22,4975238052
7376,7839620,63580040,71419660,26,2,0,82432,29,4633112532
7377,7841850,62636868,70478718,1,0,0,12800,26,4345615333
7378,7842590,72977451,80820041,6,0,1,5632,24,8570179204
7379,7845250,62823913,70669163,3,0,0,45056,5,2295366920
7380,7845431,63298491,71143922,9,0,0,7168,12,9612546212
7381,7846260,63531555,71377815,18,1,0,30208,13,10684527508
7382,7848479,62785099,70633578,17,1,0,6144,28,1431848848
7383,7848709,63255154,71103863,17,1,0,44544,28,3338943248
7384,7849090,72988594,80837684,2,0,1,44544,3,8655646370
7385,7849640,63136440,70986080,1,0,0,512,26,6031073596
7386,7850630,72995691,80846321,27,2,1,10752,9,1516522122
7387,7852720,62725912,70578632,30,3,0,7168,3,3043240484
7388,7853570,63334951,71188521,18,1,0,25600,13,733308503
7389,7854230,63465456,71319686,35,3,0,25088,8,7070996980
7390,7854610,62835994,70690604,1,0,0,512,26,9130104787
7391,7856840,63716039,71572879,2,0,0,16384,3,10520381833
7392,7858979,72999911,80858890,37,3,1,22528,15,8272571798
7393,7861330,63838000,71699330,3,0,0,34304,5,2143817593
7394,7862150,73001246,80863396,35,3,1,7168,8,6762820396
7395,7862900,64245134,72108034,28,2,0,3584,24,737072298
7396,7863140,63698906,71562046,0,0,0,35328,8,10481925957
7397,7865200,63328336,71193536,13,1,0,16384,6,5896090676
7398,7865280,63066130,70931410,32,3,0,23552,17,2651973997
7399,7865890,63498298,71364188,27,2,0,8704,9,8540666624
7400,7867220,73000042,80867262,32,3,1,6144,17,2972684596
7401,7868031,62971324,70839355,9,0,0,20992,12,1912121732
7402,7869450,63096942,70966392,39,3,0,44032,2,1139829030
7403,7870100,63697764,71567864,6,0,0,17920,24,3432004561
7404,7870590,63680669,71551259,13,1,0,50176,6,6640666044
7405,7873630,63703952,71577582,0,0,0,15360,8,3034657785
7406,7873981,72998453,80872434,22,2,1,8192,10,661655377
7407,7874760,73003576,80878336,38,3,1,20992,26,3441341445
7408,7874771,63838622,71713393,9,0,0,46080,12,9110020783
7409,7877270,73001425,80878695,0,0,1,9728,8,5125418440
7410,7879330,73000031,80879361,13,1,1,11264,6,3369652573
7411,7879720,63170011,71049731,20,2,0,12800,24,9875146875
7412,7880260,63067957,70948217,1,0,0,23552,26,2936959237
7413,7880380,63115063,70995443,30,3,0,10752,3,3065216723
7414,7881799,63255191,71136990,17,1,0,7168,28,7568321231
7415,7883791,63095309,70979100,33,3,0,16896,22,7516024507
7416,7886660,63802195,71688855,6,0,0,30720,24,930008802
7417,7887120,64130965,72018085,26,2,0,30720,29,209455692
7418,7890530,63875868,71766398,32,3,0,4608,17,4133197050
7419,7891081,73004343,80895424,38,3,1,15360,26,7316399440
7420,7892830,63171299,71064129,30,3,0,1536,3,8456401101
7421,7893810,73003560,80897370,6,0,1,3072,24,4792004026
7422,7895650,64390438,72286088,28,2,0,58880,24,9348674708
7423,7898129,73001827,80899956,5,0,1,4096,4,8226234792
7424,7898630,63341096,71239726,15,1,0,2560,19,4437415313
7425,7898830,63256516,71155346,12,1,0,13824,3,8451475274
7426,7900271,63211735,71112006,9,0,0,26624,12,1760033063
7427,7900500,63614186,71514686,26,2,0,27648,29,8216337675
7428,7903080,63709958,71613038,31,3,0,42496,27,6713976992
7429,7904050,73001984,80906034,25,2,1,3072,4,2941071880
7430,7904590,63580729,71485319,23,2,0,17408,4,10208143832
7431,7905181,63379455,71284636,25,2,0,7680,4,6580111237
7432,7905231,63933536,71838767,9,0,0,57344,12,1182378498
7433,7905610,63435054,71340664,30,3,0,39936,3,3283655266
7434,7906600,63318739,71225339,12,1,0,13312,3,7329337292
7435,7906750,63612327,71519077,28,2,0,14336,24,5820428118
7436,7906901,63234814,71141715,34,3,0,14336,2,10430814938
7437,7908060,63627888,71535948,37,3,0,55296,15,8018811240
7438,7908210,63913062,71821272,31,3,0,35840,27,2621655944
7439,7908500,73000440,80908940,39,3,1,4608,2,527504171
7440,7908540,63451660,71360200,28,2,0,38912,24,492736406
7441,7910310,63473612,71383922,0,0,0,19968,8,5023549452
7442,7911130,63559474,71470604,28,2,0,35328,24,8771456991
7443,7914630,72997216,80911846,24,2,1,4608,10,7923274960
7444,7916249,72997569,80913818,11,1,1,3072,6,168491451
7445,7917310,63986197,71903507,18,1,0,35328,13,8770353691
7446,7917480,63761992,71679472,32,3,0,51712,17,5527173026
7447,7917520,72997604,80915124,35,3,1,2048,8,10297892077
7448,7918820,73002414,80921234,3,0,1,26624,5,4435648608
7449,7919140,63373622,71292762,39,3,0,12288,2,4435095859
7450,7919630,64145388,72065018,4,0,0,5120,14,8746773254
7451,7919830,64268938,72188768,20,2,0,57856,24,1718579772
7452,7923600,63837614,71761214,37,3,0,12800,15,1818266096
7453,7924710,63989896,71914606,37,3,0,36352,15,6633997529
7454,7924940,63637441,71562381,23,2,0,1024,4,3891799329
7455,7925640,73029710,80955350,30,3,1,1024,3,4449542787
7456,7930790,63664574,71595364,11,1,0,31744,6,10038801715
7457,7931140,73024876,80956016,24,2,1,11264,10,2268410780
7458,7932071,63521567,71453638,9,0,0,16384,12,2768294250
7459,7932080,63815648,71747728,21,2,0,15360,25,5465190751
7460,7932490,63984978,71917468,2,0,0,9216,3,1275740642
7461,7933750,63793737,71727487,3,0,0,46080,5,2582744618
7462,7934131,63665936,71600067,33,3,0,15360,22,1058941931
7463,7935600,64321256,72256856,16,1,0,17920,10,2772363125
7464,7937480,64118725,72056205,21,2,0,88576,25,8291957127
7465,7939870,64089324,72029194,35,3,0,9216,8,3927235494
7466,7940041,63688858,71628899,33,3,0,6144,22,8237919118
7467,7940240,63479599,71419839,32,3,0,512,17,255238279
7468,7941080,73025910,80966990,3,0,1,1024,5,6230485757
7469,7941571,64501142,72442713,25,2,0,10240,4,924234910
7470,7945520,63792153,71737673,37,3,0,33280,15,5537509824
7471,7947770,63832708,71780478,15,1,0,35840,19,160938272
7472,7947801,64254066,72201867,33,3,0,31744,22,3112804355
7473,7948140,73023587,80971727,24,2,1,18432,10,10239576783
7474,7948429,73027084,80975513,11,1,1,2560,6,5559394034
7475,7949151,63905539,71854690,9,0,0,15872,12,8146549028
7476,7950370,64070294,72020664,27,2,0,512,9,7815472340
7477,7952330,63907970,71860300,12,1,0,12800,3,5273189269
7478,7952760,63665917,71618677,22,2,0,18432,10,1003364545
7479,7958459,63846075,71804534,17,1,0,13824,28,2168008974
7480,7959150,64137588,72096738,37,3,0,2048,15,8493375190
7481,7959400,64136186,72095586,3,0,0,18432,5,4588222393
7482,7959500,64110065,72069565,21,2,0,14848,25,7429091635
7483,7960170,64120105,72080275,3,0,0,20992,5,7636931807
7484,7960300,64038395,71998695,21,2,0,22528,25,9115021328
7485,7960761,63849568,71810329,9,0,0,18944,12,1932604129
7486,7961650,73015809,80977459,33,3,1,3072,22,9697304329
7487,7964460,64748635,72713095,6,0,0,4096,24,3987686827
7488,7966289,73064505,81030794,18,1,1,114176,13,8544183043
7489,7966550,63924950,71891500,15,1,0,44544,19,1758644421
7490,7967060,64629697,72596757,18,1,0,6144,13,2972072346
7491,7967400,63992044,71959444,15,1,0,13312,19,7065393797
7492,7968340,64246342,72214682,4,0,0,41984,14,3532553392
7493,7973429,73058351,81031780,11,1,1,1536,6,10020400753
7494,7973649,64111173,72084822,17,1,0,14848,28,6985375467
7495,7975550,63869686,71845236,5,0,0,15360,4,8246186072
7496,7975940,73058746,81034686,12,1,1,4608,3,7962046088
7497,7976240,63951612,71927852,16,1,0,2048,10,7757663882
7498,7976511,64121186,72097697,25,2,0,3072,4,5072530857
7499,7977291,63954371,71931662,34,3,0,4608,2,2021715306
7500,7977771,73064674,81042445,34,3,1,12288,2,9455453486
7501,7980320,64470403,72450723,32,3,0,18432,17,4608148723
7502,7982110,64158505,72140615,22,2,0,23552,10,188081696
7503,7984190,64100967,72085157,24,2,0,1024,10,2312104579
7504,7986000,73058711,81044711,24,2,1,3584,10,7341333526
7505,7990119,73058778,81048897,5,0,1,6656,4,10557541507
7506,7990139,64454945,72445084,17,1,0,7680,28,2524900180
7507,7990880,64017822,72008702,28,2,0,32768,24,8413982040
7508,7991150,63930429,71921579,27,2,0,4608,9,3964486210
7509,7991570,64613813,72605383,12,1,0,22016,3,1654166776
7510,7992000,64071404,72063404,24,2,0,23552,10,1348790126
7511,7992850,64081006,72073856,10,1,0,5120,4,9842997364
7512,7993050,64446520,72439570,31,3,0,12800,27,413040849
7513,7993670,64128474,72122144,13,1,0,512,6,9218507110
7514,7997470,64538309,72535779,22,2,0,64512,10,1593181886
7515,8000190,64496748,72496938,0,0,0,3584,8,10615437864
7516,8003320,64264805,72268125,11,1,0,36352,6,9050942409
7517,8004500,64533330,72537830,22,2,0,6656,10,1037433083
7518,8004960,64244830,72249790,37,3,0,42496,15,3396783792
7519,8005871,73044652,81050523,21,2,1,2560,25,1983808330
7520,8007511,64123079,72130590,9,0,0,5120,12,10401379142
7521,8008550,73045199,81053749,35,3,1,5120,8,10711181075
7522,8010010,64212838,72222848,26,2,0,5632,29,9543999011
7523,8010040,64211061,72221101,0,0,0,20992,8,8019147655
7524,8010170,73046165,81056335,28,2,1,4096,24,60479857
7525,8011221,73047060,81058281,26,2,1,3072,29,9846936560
7526,8012290,64142272,72154562,3,0,0,3584,5,9060976026
7527,8012430,73163727,81176157,13,1,1,138240,6,9384900561
7528,8013571,64580644,72594215,25,2,0,65536,4,9685228143
7529,8013840,73164583,81178423,32,3,1,3584,17,2589602685
7530,8015310,64236063,72251373,18,1,0,5120,13,1505564485
7531,8015870,64750905,72766775,12,1,0,15360,3,6337253623
7532,8015930,64367831,72383761,16,1,0,45056,10,336303938
7533,8016130,64290270,72306400,20,2,0,1536,24,9812268426
7534,8016290,64628462,72644752,37,3,0,20480,15,126735844
7535,8022120,73159875,81181995,25,2,1,15872,4,2361437097
7536,8022850,64368266,72391116,30,3,0,24064,3,3969910931
7537,8023440,64575212,72598652,24,2,0,6144,10,2581430030
7538,8025260,64394733,72419993,30,3,0,34816,3,4185375160
7539,8025420,65043124,73068544,15,1,0,3072,19,8053275864
7540,8026360,64469463,72495823,18,1,0,23552,13,9718033205
7541,8027779,73155522,81183301,37,3,1,2048,15,10449618727
7542,8028380,64374060,72402440,16,1,0,36864,10,2472635950
7543,8028530,64375501,72404031,26,2,0,5120,29,8279061906
7544,8028860,64566002,72594862,32,3,0,2048,17,927553391
7545,8031460,73213357,81244817,13,1,1,137728,6,1572371213
7546,8033170,64630128,72663298,26,2,0,30208,29,5572266837
7547,8033530,73229734,81263264,27,2,1,3584,9,6652467817
7548,8036070,65016950,73053020,23,2,0,157696,4,7394904153
7549,8039039,73234077,81273116,4,0,1,29184,14,5789936570
7550,8041050,64572319,72613369,28,2,0,25088,24,4144459028
7551,8042420,64815308,72857728,35,3,0,34304,8,10002936496
7552,8042560,64740540,72783100,27,2,0,6144,9,9312753908
7553,8044750,73233538,81278288,33,3,1,8192,22,7829271352
7554,8045150,65678133,73723283,3,0,0,130560,5,5329183440
7555,8047400,64661412,72708812,0,0,0,3584,8,544753508
7556,8049530,64316842,72366372,22,2,0,12288,10,640267283
7557,8049820,73230760,81280580,16,1,1,3584,10,8723396150
7558,8050070,64371800,72421870,2,0,0,5120,3,2312811746
7559,8053760,64783626,72837386,31,3,0,31232,27,2203200328
7560,8054951,64999184,73054135,33,3,0,3584,22,1493394968
7561,8055760,73229006,81284766,20,2,1,6656,24,2694197421
7562,8058300,64942703,73001003,15,1,0,64512,19,5231797835
7563,8059411,73230181,81289592,34,3,1,7680,2,10401355423
7564,8059520,64757288,72816808,37,3,0,20992,15,6444196842
7565,8059980,65084416,73144396,30,3,0,26112,3,6852942051
7566,8060420,64454283,72514703,24,2,0,5120,10,726774470
7567,8060680,64615233,72675913,10,1,0,12800,4,5533842650
7568,8061600,64501018,72562618,23,2,0,1024,4,772843252
7569,8062211,64743146,72805357,34,3,0,18432,2,6655450007
7570,8062970,73256727,81319697,27,2,1,5120,9,5207127581
7571,8063430,64510794,72574224,28,2,0,19456,24,4444565935
7572,8066430,73263061,81329491,35,3,1,36352,8,335988451
7573,8068661,73266437,81335098,31,3,1,18432,27,4407676974
7574,8071960,64802327,72874287,20,2,0,54272,24,9780242287
7575,8072560,64932389,73004949,16,1,0,12800,10,6982595793
7576,8074980,65147008,73221988,21,2,0,69120,25,10098736767
7577,8076630,64680431,72757061,30,3,0,10752,3,7399202518
7578,8076720,65124177,73200897,24,2,0,14336,10,9469438100
7579,8078440,73263566,81342006,33,3,1,3584,22,4751555894
7580,8079100,64983973,73063073,5,0,0,29184,4,7097002897
7581,8082230,64832850,72915080,20,2,0,17920,24,6292474492
7582,8082611,64635293,72717904,3,0,0,6656,5,7136395650
7583,8083040,65148510,73231550,28,2,0,14336,24,2443856540
7584,8083181,73260771,81343952,21,2,1,3072,25,7736192629
7585,8084140,65112366,73196506,13,1,0,48128,6,8730491592
7586,8087600,65266655,73354255,23,2,0,75264,4,999555854
7587,8087770,73262247,81350017,25,2,1,16896,4,7315654791
7588,8087800,73262371,81350171,35,3,1,8704,8,7724866534
7589,8088360,64857719,72946079,31,3,0,45568,27,2840981642
7590,8089820,65793040,73882860,16,1,0,35840,10,8145038572
7591,8090520,65056551,73147071,28,2,0,8704,24,1828501430
7592,8090530,73277469,81367999,27,2,1,7680,9,2869364486
7593,8095291,65321081,73416372,34,3,0,80896,2,10500383189
7594,8095720,65076396,73172116,10,1,0,40448,4,892845134
7595,8096410,64796854,72893264,12,1,0,23552,3,395946021
7596,8100590,73272235,81372825,16,1,1,7680,10,3535739662
7597,8101419,65353399,73454818,17,1,0,8704,28,1203135272
7598,8102360,64814147,72916507,23,2,0,4608,4,3405790752
7599,8106440,65345703,73452143,16,1,0,16896,10,807887556
7600,8108510,65973946,74082456,30,3,0,68608,3,1985896646
7601,8109491,65047431,73156922,3,0,0,32256,5,1582221881
7602,8109669,73263617,81373286,23,2,1,10240,4,2609662323
7603,8114770,65197007,73311777,21,2,0,29184,25,139238987
7604,8116990,65019427,73136417,28,2,0,6144,24,6515173570
7605,8117871,65213429,73331300,9,0,0,64000,12,8241108899
7606,8118720,65175006,73293726,13,1,0,7168,6,9564514565
7607,8119630,73254322,81373952,12,1,1,1024,3,2463262809
7608,8120220,65243285,73363505,5,0,0,18432,4,9759778284
7609,8122700,65422929,73545629,4,0,0,23552,14,8856223233
7610,8123340,65036413,73159753,23,2,0,9216,4,1089306514
7611,8125070,73249868,81374938,3,0,1,1536,5,7339560308
7612,8125200,64791486,72916686,23,2,0,512,4,10454711079
7613,8126440,64823623,72950063,28,2,0,6144,24,5043067271
7614,8127500,66271846,74399346,13,1,0,16384,6,6251905992
7615,8127851,64937437,73065288,9,0,0,7168,12,1991089478
7616,8129330,65317642,73446972,12,1,0,55296,3,9210838441
7617,8130100,66639662,74769762,2,0,0,87040,3,2516895056
7618,8133120,66519134,74652254,22,2,0,48128,10,8223980761
7619,8134880,65092279,73227159,2,0,0,16896,3,7665658343
7620,8135380,65046431,73181811,18,1,0,31744,13,6820288262
7621,8137131,65408989,73546120,9,0,0,1536,12,6901496084
7622,8137660,65236834,73374494,21,2,0,1024,25,10230559120
7623,8140200,65350392,73490592,5,0,0,16896,4,10495509224
7624,8140780,65116111,73256891,27,2,0,46592,9,4741676498
7625,8141430,65424887,73566317,35,3,0,9728,8,6422713572
7626,8141880,65221960,73363840,16,1,0,1024,10,2795719048
7627,8141921,65232238,73374159,34,3,0,33792,2,1188597290
7628,8142701,66959205,75101906,25,2,0,38912,4,3521352178
7629,8142820,65342601,73485421,38,3,0,17408,26,10005104930
7630,8143450,65214416,73357866,28,2,0,11776,24,2626856252
7631,8144291,66750661,74894952,25,2,0,57856,4,5929783967
7632,8145060,67073666,75218726,4,0,0,5632,14,7222976473
7633,8146341,65374634,73520975,9,0,0,14336,12,3312630746
7634,8148100,73399450,81547550,9,0,1,274944,12,3860182296
7635,8155380,66300192,74455572,2,0,0,19968,3,5565148898
7636,8155631,73405059,81560690,21,2,1,11264,25,7855359812
7637,8156191,65306192,73462383,34,3,0,24576,2,5800321090
7638,8165340,65403579,73568919,28,2,0,2048,24,3225572692
7639,8167950,73402128,81570078,2,0,1,5120,3,1297181956
7640,8169390,65756944,73926334,22,2,0,31232,10,2763098695
7641,8170960,65558586,73729546,18,1,0,20480,13,10335396620
7642,8172179,73398770,81570949,15,1,1,12288,19,1196195956
7643,8177191,65863157,74040348,34,3,0,37888,2,10685750808
7644,8178430,73420323,81598753,34,3,1,21504,2,6234734105
7645,8181200,65671085,73852285,38,3,0,38912,26,3026254590
7646,8183410,65786022,73969432,10,1,0,10240,4,3891831102
7647,8183540,65709989,73893529,24,2,0,23040,10,9424482046
7648,8184490,65560055,73744545,35,3,0,49152,8,6539238941
7649,8189669,65634919,73824588,17,1,0,27136,28,2206275517
7650,8190350,65804225,73994575,2,0,0,10752,3,5114367999
7651,8190830,65347600,73538430,10,1,0,16896,4,6380637308
7652,8192680,65579077,73771757,35,3,0,11264,8,2084017396
7653,8193830,66908879,75102709,38,3,0,2560,26,250879231
7654,8196230,65755399,73951629,38,3,0,82944,26,3581104930
7655,8198390,66027318,74225708,22,2,0,84992,10,2228121758
7656,8200050,65843457,74043507,37,3,0,10240,15,4229693556
7657,8200211,66040496,74240707,3,0,0,49152,5,3319068190
7658,8203130,65902835,74105965,18,1,0,5632,13,8347540516
7659,8204021,65824760,74028781,34,3,0,6144,2,5765902888
7660,8205400,65929172,74134572,28,2,0,78336,24,3672367819
7661,8206831,73399297,81606128,10,1,1,29696,4,8520101863
7662,8207540,65772234,73979774,16,1,0,2048,10,6977680462
7663,8208850,65988888,74197738,21,2,0,178688,25,6580963621
7664,8217310,67050004,75267314,12,1,0,19968,3,10175407590
7665,8220569,73386545,81607114,4,0,1,1536,14,10353873179
7666,8221180,65757947,73979127,35,3,0,31744,8,4055105931
7667,8222519,73394388,81616907,5,0,1,24064,4,4390643485
7668,8223190,65827311,74050501,5,0,0,512,4,5759627649
7669,8223581,73393672,81617253,10,1,1,512,4,4594428
7670,8224390,65885030,74109420,10,1,0,11264,4,7565780622
7671,8224990,67094284,75319274,24,2,0,29184,10,843398363
7672,8225709,73397036,81622745,4,0,1,17920,14,845012491
7673,8226350,65914664,74141014,21,2,0,20992,25,1547801198
7674,8227003,65656660,73883663,36,3,0,2560,3,3384314248
7675,8228480,65629600,73858080,38,3,0,18944,26,4301595000
7676,8229531,66014186,74243717,34,3,0,5632,2,1682117110
7677,8233650,66110111,74343761,18,1,0,7168,13,3331875860
7678,8234599,66041166,74275765,17,1,0,43008,28,357377764
7679,8236600,73386491,81623091,12,1,1,512,3,10041532623
7680,8239009,66167692,74406701,17,1,0,24064,28,10454899922
7681,8239460,66012392,74251852,12,1,0,26624,3,1181730372
7682,8239900,66421113,74661013,37,3,0,28672,15,9231138510
7683,8240521,65959268,74199789,9,0,0,6656,12,5536767146
7684,8240650,73385232,81625882,25,2,1,17408,4,8388600056
7685,8242410,66099136,74341546,35,3,0,18432,8,7297398324
7686,8243180,66289735,74532915,15,1,0,53248,19,4340482257
7687,8245850,65781036,74026886,16,1,0,27648,10,9721353156
7688,8249010,65848593,74097603,5,0,0,4096,4,9728067262
7689,8249131,73397490,81646621,21,2,1,1024,25,8148018817
7690,8252229,73395058,81647287,15,1,1,1024,19,4913587524
7691,8253939,73394334,81648273,5,0,1,1536,4,8222822672
7692,8254430,73447235,81701665,24,2,1,119296,10,2499691366
7693,8260470,66075437,74335907,37,3,0,1536,15,2455547895
7694,8262821,65755572,74018393,34,3,0,31232,2,5371721577
7695,8266800,73435531,81702331,20,2,1,1024,24,8696526698
7696,8266871,66899379,75166250,25,2,0,19456,4,1017154850
7697,8267201,66016855,74284056,3,0,0,27136,5,2146211161
7698,8267209,66068207,74335416,17,1,0,49664,28,4654450589
7699,8267280,66228906,74496186,3,0,0,31744,5,6917888205
7700,8267770,67057611,75325381,12,1,0,19968,3,635000107
7701,8269160,66017571,74286731,35,3,0,8704,8,2056339302
7702,8269830,66122115,74391945,10,1,0,24064,4,6861828526
7703,8271550,66245118,74516668,4,0,0,52224,14,1720606758
7704,8275390,66398157,74673547,12,1,0,22528,3,10468759863
7705,8277460,65975397,74252857,4,0,0,3072,14,2458872730
7706,8278000,66740181,75018181,12,1,0,39936,3,3879692963
7707,8278560,65963418,74241978,10,1,0,4096,4,10425248465
7708,8279760,67310681,75590441,5,0,0,37376,4,3039465952
7709,8281130,66308692,74589822,10,1,0,40960,4,1390321728
7710,8282690,66166775,74449465,10,1,0,61440,4,5024296971
7711,8284270,67101401,75385671,37,3,0,10240,15,3045391922
7712,8288970,66503793,74792763,24,2,0,35840,10,10170511006
7713,8289110,66377542,74666652,37,3,0,18432,15,5948354482
7714,8289821,73413176,81702997,21,2,1,1024,25,9302152761
7715,8291840,73417929,81709769,20,2,1,10752,24,3361113555
7716,8292300,66251448,74543748,37,3,0,25600,15,9295381898
7717,8293040,66544810,74837850,35,3,0,51200,8,8076773373
7718,8293940,66206793,74500733,38,3,0,14848,26,1249875744
7719,8297130,67473072,75770202,35,3,0,4096,8,5020480221
7720,8300490,66829362,75129852,38,3,0,55296,26,5517443597
7721,8300960,66551434,74852394,37,3,0,8192,15,4512930877
7722,8310500,67235026,75545526,12,1,0,60416,3,3222373751
7723,8316770,67430491,75747261,12,1,0,45568,3,1409487086
7724,8321970,66213776,74535746,20,2,0,9216,24,1295760277
7725,8322540,66459280,74781820,20,2,0,2048,24,954857301
7726,8331199,73385573,81716772,15,1,1,20992,19,2843812442
7727,8333909,73398952,81732861,15,1,1,11264,19,10304909708
7728,8333930,67718074,76052004,35,3,0,5632,8,9130093876
7729,8335010,66572069,74907079,20,2,0,14336,24,5083026712
7730,8338280,66578049,74916329,5,0,0,14848,4,9527817264
7731,8338660,66123822,74462482,21,2,0,19456,25,1425235918
7732,8339340,66068164,74407504,24,2,0,2560,10,1422614148
7733,8340330,66116201,74456531,35,3,0,3072,8,2276039473
7734,8340751,66711059,75051810,34,3,0,27136,2,10468994386
7735,8345710,66248971,74594681,12,1,0,15872,3,7375251166
7736,8345900,67662802,76008702,4,0,0,15872,14,1368191263
7737,8346560,66126135,74472695,22,2,0,10752,10,4466518164
7738,8349280,66431893,74781173,3,0,0,37376,5,6986710343
7739,8354230,66360661,74714891,22,2,0,6656,10,9651465665
7740,8354510,66557272,74911782,35,3,0,15360,8,3384290209
7741,8359530,66435627,74795157,24,2,0,7680,10,9724547428
7742,8362470,66233638,74596108,12,1,0,4608,3,798847308
7743,8362670,66773688,75136358,24,2,0,15872,10,5020018660
7744,8365309,66170616,74535925,17,1,0,512,28,3572872616
7745,8369080,67477827,75846907,21,2,0,48640,25,8462869779
7746,8370409,73367637,81738046,15,1,1,16384,19,1010719705
7747,8371530,73366862,81738392,35,3,1,512,8,9661374022
7748,8371801,73374068,81745869,34,3,1,19968,2,4107491258
7749,8371990,66258379,74630369,18,1,0,37888,13,1100150664
7750,8372530,66104088,74476618,10,1,0,12800,4,4147670404
7751,8372569,66962819,75335388,17,1,0,32768,28,3688231588
7752,8372850,66264717,74637567,12,1,0,9216,3,8596156961
7753,8372951,66866935,75239886,3,0,0,9728,5,9428651081
7754,8373860,66835749,75209609,15,1,0,60416,19,1133367300
7755,8373869,73460866,81834735,18,1,1,202240,13,367100493
7756,8375960,66732124,75108084,22,2,0,11264,10,5241017096
7757,8380301,66856598,75236899,34,3,0,38912,2,1667975273
7758,8381320,67197710,75579030,28,2,0,24576,24,6347156717
7759,8383160,66302516,74685676,15,1,0,512,19,1396789875
7760,8384470,66536718,74921188,2,0,0,15872,3,10453177579
7761,8385250,67519501,75904751,18,1,0,142848,13,6559107794
7762,8389451,66513214,74902665,25,2,0,25088,4,3441192362
7763,8392350,67288434,75680784,18,1,0,39424,13,7644845232
7764,8395381,66466433,74861814,34,3,0,18944,2,9150110552
7765,8395770,73445071,81840841,25,2,1,20992,4,4918908768
7766,8400910,73450628,81851538,25,2,1,12288,4,1008895793
7767,8409580,66631407,75040987,24,2,0,9728,10,3732117141
7768,8412800,67405052,75817852,21,2,0,11264,25,9130076637
7769,8413640,67526646,75940286,21,2,0,13824,25,5044731895
7770,8413880,66449985,74863865,38,3,0,6656,26,2080582766
7771,8414260,66591730,75005990,38,3,0,45568,26,5540215914
7772,8418470,66529788,74948258,15,1,0,17408,19,4545169042
7773,8418581,66654558,75073139,34,3,0,35840,2,7098079660
7774,8419980,67733601,76153581,18,1,0,33280,13,7766070327
7775,8420090,73432012,81852102,20,2,1,10752,24,5015283350
7776,8421290,73441576,81862866,35,3,1,5120,8,7460696550
7777,8421311,73441901,81863212,34,3,1,512,2,979109357
7778,8421649,73441922,81863571,4,0,1,9728,14,10185681171
7779,8424620,66613380,75038000,5,0,0,11776,4,3822674658
7780,8425599,66510609,74936208,17,1,0,5120,28,1702071689
7781,8429330,67600767,76030097,24,2,0,70144,10,8745578972
7782,8429870,73546752,81976622,2,0,1,152576,3,6593844354
7783,8430140,66724258,75154398,10,1,0,20992,4,4303431186
7784,8432240,67787395,76219635,3,0,0,27136,5,7196489734
7785,8436370,67039903,75476273,10,1,0,16896,4,5036080722
7786,8440110,66776877,75216987,10,1,0,10752,4,9146903730
7787,8443790,66781199,75224989,35,3,0,20480,8,3169951874
7788,8448740,66742438,75191178,4,0,0,30208,14,7123952783
7789,8450439,73528129,81978568,4,0,1,3072,14,2486820343
7790,8451570,73576973,82028543,12,1,1,120832,3,9230514928
7791,8452050,66913497,75365547,22,2,0,9728,10,1219212322
7792,8457519,66756169,75213688,17,1,0,13312,28,7876650701
7793,8461290,67197773,75659063,35,3,0,2560,8,4327508333
7794,8465500,67576113,76041613,28,2,0,1024,24,4253030759
7795,8465930,67479215,75945145,12,1,0,15872,3,3145504861
7796,8466920,67668282,76135202,24,2,0,16896,10,7551623375
7797,8468700,73594399,82063099,2,0,1,32768,3,1722119253
7798,8471080,67487068,75958148,18,1,0,1536,13,10614532590
7799,8472790,67098729,75571519,21,2,0,7680,25,1142135742
7800,8480740,73584945,82065685,28,2,1,4096,24,4648632692
7801,8481060,67237295,75718355,35,3,0,35840,8,2158541137
7802,8485700,67083456,75569156,21,2,0,72192,25,370160621
7803,8486819,66853512,75340331,17,1,0,2560,28,4092618115
7804,8486920,67327477,75814397,5,0,0,15360,4,5028540004
7805,8487980,66924006,75411986,12,1,0,32256,3,1514389411
7806,8494320,66761670,75255990,2,0,0,8192,3,5447402704
7807,8497590,67615916,76113506,5,0,0,41472,4,7037758399
7808,8499490,67687533,76187023,4,0,0,48640,14,542158658
7809,8499830,66862080,75361910,38,3,0,20480,26,1862138202
7810,8500540,66879454,75379994,5,0,0,4608,4,9947116908
7811,8501070,66670626,75171696,10,1,0,1024,4,7305083147
7812,8501680,67461795,75963475,28,2,0,17408,24,7060550498
7813,8502230,66968872,75471102,22,2,0,41472,10,1032175253
7814,8505549,73594767,82100316,18,1,1,69632,13,1005936326
7815,8509590,67351614,75861204,20,2,0,42496,24,7504540442
7816,8509730,73606492,82116222,28,2,1,5120,24,7952324865
7817,8511420,73694482,82205902,2,0,1,164864,3,4495855190
7818,8512041,67291546,75803587,25,2,0,30720,4,4090169178
7819,8512111,67192421,75704532,25,2,0,26624,4,9352800954
7820,8513200,67118522,75631722,21,2,0,16896,25,3935251675
7821,8515670,73694857,82210527,3,0,1,1024,5,3766345042
7822,8518690,67028419,75547109,20,2,0,5120,24,10226690995
7823,8520200,66972046,75492246,10,1,0,24576,4,3953499150
7824,8522220,67537453,76059673,18,1,0,19968,13,3311251831
7825,8522870,67645581,76168451,21,2,0,16896,25,5250407159
7826,8527510,66965539,75493049,24,2,0,2560,10,6906028377
7827,8531740,67149453,75681193,38,3,0,512,26,10021096651
7828,8533940,67058716,75592656,3,0,0,7168,5,8275866351
7829,8544269,67189085,75733354,17,1,0,49152,28,675124585
7830,8545339,67089637,75634976,17,1,0,8704,28,7920538702
7831,8547489,66966582,75514071,17,1,0,26112,28,2292083571
7832,8549720,66944288,75494008,12,1,0,3072,3,9505511843
7833,8549770,73661103,82210873,20,2,1,512,24,8053799707
7834,8550430,67398178,75948608,38,3,0,11264,26,869766909
7835,8555400,67858816,76414216,22,2,0,43520,10,3973351854
7836,8557711,67261568,75819279,25,2,0,4608,4,6787926509
7837,8559880,67972066,76531946,12,1,0,16896,3,8588285149
7838,8559890,67249804,75809694,2,0,0,19968,3,9254011948
7839,8566520,67960255,76526775,24,2,0,6656,10,4052775269
7840,8567280,67671079,76238359,18,1,0,55808,13,8039037981
7841,8567779,73643965,82211744,18,1,1,12288,13,724033209
7842,8570380,68033096,76603476,35,3,0,47616,8,8024682696
7843,8574401,73656287,82230688,38,3,1,25600,26,9532506503
7844,8578980,67340926,75919906,3,0,0,49664,5,233137528
7845,8579800,68140575,76720375,5,0,0,30720,4,8303287457
7846,8581440,67781209,76362649,38,3,0,119808,26,1581826833
7847,8583979,67347213,75931192,17,1,0,27136,28,4950652627
7848,8588419,67882262,76470681,17,1,0,16384,28,4410171713
7849,8591391,67331502,75922893,25,2,0,9728,4,7466730882
7850,8594810,73650967,82245777,35,3,1,512,8,6416082403
7851,8595300,67442628,76037928,22,2,0,25600,10,6303184266
7852,8601170,68069746,76670916,24,2,0,26112,10,188986203
7853,8606020,67330031,75936051,4,0,0,15872,14,8455816111
7854,8607570,73643915,82251485,20,2,1,17920,24,3438620939
7855,8610869,73651986,82262855,4,0,1,22016,14,10705237137
7856,8614450,73819228,82433678,24,2,1,358912,10,455528854
7857,8622041,67597929,76219970,25,2,0,1024,4,1378518833
7858,8623240,67576334,76199574,35,3,0,11776,8,780767131
7859,8626470,73808514,82434984,28,2,1,2048,24,8109233727
7860,8630100,68511841,77141941,2,0,0,12288,3,5263180525
7861,8633821,73805349,82439170,38,3,1,6656,26,1222475941
7862,8633980,67483917,76117897,24,2,0,14336,10,7738065674
7863,8636860,73877113,82513973,12,1,1,108544,3,1920359214
7864,8637380,67556074,76193454,18,1,0,16896,13,2156387210
7865,8639530,73897444,82536974,3,0,1,36352,5,9705840377
7866,8641550,68321808,76963358,22,2,0,151552,10,1404765407
7867,8645330,67512894,76158224,12,1,0,12800,3,5037816302
7868,8647550,68441741,77089291,24,2,0,27136,10,4033691352
7869,8655850,67649479,76305329,28,2,0,46592,24,3826316935
7870,8664621,68228566,76893187,3,0,0,54272,5,6584374907
7871,8664920,67728732,76393652,5,0,0,36352,4,6118192662
7872,8669820,67784591,76454411,38,3,0,91136,26,5640596428
7873,8670060,73867887,82537947,20,2,1,12800,24,2745190786
7874,8674181,67705986,76380167,25,2,0,42496,4,10445198197
7875,8675159,73864414,82539573,4,0,1,2560,14,1903486756
7876,8680661,73861178,82541839,22,2,1,3584,10,10385767898
7877,8684290,67378850,76063140,22,2,0,1536,10,3986425155
7878,8684669,73865222,82549891,4,0,1,12800,14,7693947955
7879,8687180,68044606,76731786,22,2,0,37376,10,9807244905
7880,8689330,67569717,76259047,38,3,0,12800,26,5259681627
7881,8690060,67692470,76382530,4,0,0,7680,14,2793398619
7882,8692130,73901764,82593894,12,1,1,135680,3,5332157419
7883,8701950,68618036,77319986,3,0,0,23552,5,7212156900
7884,8709720,67684927,76394647,38,3,0,2560,26,1492646288
7885,8717149,73892365,82609514,5,0,1,2048,4,4658563586
7886,8722730,67827491,76550221,24,2,0,59904,10,235981511
7887,8723260,67785506,76508766,12,1,0,44544,3,4466616432
7888,8725510,67673528,76399038,18,1,0,14336,13,6232061014
7889,8732720,67792004,76524724,24,2,0,1536,10,10612496666
7890,8734089,67633107,76367196,17,1,0,14848,28,7830249602
7891,8736540,68245147,76981687,10,1,0,54272,4,8889403789
7892,8741780,67825937,76567717,10,1,0,10752,4,5107501223
7893,8742890,73867188,82610078,35,3,1,10752,8,3245528986
7894,8746391,67862568,76608959,3,0,0,17920,5,7106540799
7895,8747590,67879292,76626882,24,2,0,5120,10,9461022104
7896,8751230,67773003,76524233,28,2,0,50688,24,7051486325
7897,8751740,67713926,76465666,38,3,0,36864,26,3815297186
7898,8768280,68217285,76985565,12,1,0,2048,3,1632510835
7899,8772310,67648733,76421043,24,2,0,20480,10,8404018976
7900,8776269,68413608,77189877,17,1,0,25088,28,7918257744
7901,8780640,67620293,76400933,5,0,0,6144,4,1717523727
7902,8786780,68316390,77103170,12,1,0,31744,3,5061783388
7903,8788340,67763004,76551344,12,1,0,3584,3,7151468102
7904,8788940,73824878,82613818,35,3,1,15360,8,1870640141
7905,8790490,68324807,77115297,38,3,0,19968,26,4920694080
7906,8790560,67842278,76632838,28,2,0,512,24,2349408405
7907,8802330,73857944,82660274,12,1,1,78336,3,6782433532
7908,8805960,73861480,82667440,38,3,1,18432,26,9264962898
7909,8821199,67935497,76756696,17,1,0,3072,28,6587803824
7910,8823179,67809480,76632659,17,1,0,12288,28,7597084369
7911,8826710,73992160,82818870,3,0,1,240128,5,10625384792
7912,8827010,67906515,76733525,38,3,0,5632,26,3270001527
7913,8835420,68625009,77460429,38,3,0,11264,26,6052393584
7914,8845931,68383263,77229194,3,0,0,119808,5,3716305551
7915,8846600,67892071,76738671,28,2,0,13312,24,472958503
7916,8852591,67925889,76778480,3,0,0,8704,5,6748895689
7917,8857770,73961766,82819536,38,3,1,1024,26,6043038978
7918,8862529,67782119,76644648,17,1,0,16384,28,10052310977
7919,8863420,68466573,77329993,3,0,0,32768,5,3830275140
7920,8867250,67704277,76571527,12,1,0,7168,3,7857247308
7921,8877670,67869308,76746978,3,0,0,18944,5,7737820824
7922,8887490,73936872,82824362,28,2,1,7680,24,5682753741
7923,8905430,73923118,82828548,17,1,1,6656,28,8470913923
7924,8908859,67967769,76876628,17,1,0,65536,28,1365308494
7925,8912090,67983616,76895706,28,2,0,8192,24,8555563709
7926,8918600,67837137,76755737,3,0,0,28672,5,6128144615
7927,8920310,68309843,77230153,38,3,0,3072,26,1541741468
7928,8922941,73907553,82830494,38,3,1,3072,26,2813779326
7929,8934580,68953006,77887586,12,1,0,56320,3,10402230257
7930,8935110,67982049,76917159,28,2,0,30720,24,6446572377
7931,8938570,68345177,77283747,12,1,0,36864,3,224569713
7932,8947830,73916677,82864507,3,0,1,99840,5,7954830067
7933,8956340,73913067,82869407,38,3,1,3072,26,9803244500
7934,8964850,68144294,77109144,38,3,0,3584,26,10504939669
7935,8969100,68826675,77795775,38,3,0,15360,26,339240809
7936,8982449,68663027,77645476,17,1,0,36864,28,3058932782
7937,8986460,73886493,82872953,28,2,1,5632,24,6570632100
7938,8992830,68408428,77401258,38,3,0,53248,26,1765478568
7939,9002040,68091435,77093475,38,3,0,12288,26,8251585127
7940,9019870,67945258,76965128,28,2,0,2048,24,4192269119
7941,9025410,68916614,77942024,3,0,0,62464,5,10298502134
7942,9044799,68026066,77070865,17,1,0,25600,28,132157527
7943,9080400,67982642,77063042,3,0,0,111616,5,5207924694
7944,9081081,73799392,82880473,38,3,1,10240,26,1596289978
7945,9083840,68188652,77272492,28,2,0,19968,24,314631759
7946,9086350,68045098,77131448,38,3,0,17408,26,6338914721
7947,9091169,67873312,76964481,17,1,0,3584,28,7267334622
7948,9091880,68883344,77975224,28,2,0,36864,24,374970138
7949,9117610,67865192,76982802,38,3,0,3584,26,9306019260
7950,9118119,68358750,77476869,17,1,0,46592,28,2293915259
7951,9129790,67883019,77012809,3,0,0,4096,5,7338630898
7952,9169390,68123472,77292862,38,3,0,9216,26,813033757
7953,9181540,68271059,77452599,38,3,0,72704,26,10595596113
7954,9188840,67919189,77108029,3,0,0,15872,5,3047379705
7955,9291059,68171569,77462628,17,1,0,7168,28,2709936604
7956,9292660,68092359,77385019,3,0,0,12800,5,5429253018
7957,9327369,67744923,77072292,17,1,0,4608,28,3493446976
7958,9328059,67908981,77237040,17,1,0,22528,28,7421854156
7959,9368150,73517024,82885174,17,1,1,13824,28,9042778505
7960,9416564,68624003,78040567,27,2,0,42496,9,9716439923
7961,9587549,67869433,77456982,17,1,0,14336,28,7551766435
7962,9675880,73211560,82887440,17,1,1,3584,28,1097146722
7963,9716459,67821191,77537650,17,1,0,11776,28,1547576914
7964,9785269,67833776,77619045,17,1,0,15360,28,10024329688
7965,9787180,73102526,82889706,17,1,1,3584,28,1188576289
7966,9798410,73104591,82903001,17,1,1,15872,28,5777427576
7967,9849599,67650559,77500158,17,1,0,31232,28,3500238994
7968,9900759,67713516,77614275,17,1,0,31744,28,7864469808
7969,9910909,67766406,77677315,17,1,0,104448,28,9598632298
7970,9911419,67621037,77532456,17,1,0,14848,28,8669821489
7971,9956980,72946892,82903872,17,1,1,12288,28,7599638466
7972,9966039,67516149,77482188,17,1,0,17408,28,377726471
7973,9980819,67421234,77402053,17,1,0,2560,28,3127900308
7974,9986929,68144281,78131210,17,1,0,17408,28,7063764572
7975,10027560,72879218,82906778,17,1,1,4608,28,4485169559
7976,10072929,67432629,77505558,17,1,0,16896,28,10328502151
7977,10105090,72804654,82909744,17,1,1,11264,28,5548381097
7978,10143359,67225431,77368790,17,1,0,39424,28,10297927179
7979,10232631,67716282,77948913,26,2,0,8192,29,9656996732
7980,10303969,67496706,77800675,17,1,0,10240,28,9886424974
7981,10308269,67406566,77714835,17,1,0,2560,28,7512406712
7982,10357969,67882333,78240302,17,1,0,40960,28,4751735089
7983,10361059,67793617,78154676,17,1,0,2560,28,9444758375
7984,10380137,72532833,82912970,33,3,1,5120,22,6566565426
7985,10455749,67444956,77900705,17,1,0,43008,28,988295041
7986,10484590,72438911,82923501,17,1,1,16896,28,6258957282
7987,10506230,72417630,82923860,17,1,1,9728,28,230583270
7988,10555739,66934888,77490627,17,1,0,27648,28,1346751810
7989,10565099,66991465,77556564,17,1,0,11776,28,7815124910
7990,10591347,66952461,77543808,24,2,0,11776,10,164592433
7991,10599955,66815192,77415147,32,3,0,5632,17,2982893782
7992,10613059,67784183,78397242,17,1,0,227840,28,2434687898
7993,10685140,72247086,82932226,17,1,1,8192,28,2054366828
7994,10717960,67063381,77781341,12,1,0,33280,3,2426391975
7995,10752893,66851695,77604588,21,2,0,34816,25,541141255
7996,10768179,66934276,77702455,17,1,0,20992,28,3521354804
7997,10798099,67111981,77910080,17,1,0,30720,28,9294183537
7998,10956963,71979449,82936412,17,1,1,6656,28,2355265823
7999,10965070,71972008,82937078,17,1,1,1024,28,8189827850
