RequestID,ArrivalTime,DelayTime,FinishTime,InitiatorID,TargetID,IOType,Size,VolumeID,Offset
0,0,51355,51355,0,0,0,2048,11,6286014793
1,1,61313,61314,4,0,0,4608,16,1769279731
2,2,4177,4179,6,0,1,4096,12,2603517492
3,3,59892,59895,3,0,0,7168,2,3503945237
4,4,6121,6125,7,0,1,3072,8,8926865505
5,5,56400,56405,2,0,0,5632,4,5924388534
6,6,101976,101982,8,0,0,24064,12,7916265759
7,7,104330,104337,1,0,0,7680,6,3878200645
8,8,158837,158845,9,0,0,11776,18,6400596267
9,9,9982,9991,5,0,1,6144,19,5145667823
10,3520,235708,239228,9,0,0,36352,18,8588640738
11,28310,4937,33247,4,0,1,12800,16,730356508
12,126590,3904,130494,9,0,1,10752,18,3812662151
13,191060,1042,192102,0,0,1,1024,11,5079835281
14,348430,108212,456642,5,0,0,55296,19,7972561633
15,401730,202187,603917,4,0,0,29184,16,7904144909
16,411410,77926,489336,4,0,0,10240,16,10694343160
17,434199,127509,561708,7,0,0,81408,8,8454118045
18,501350,7706,509056,7,0,1,8192,8,1606848390
19,502320,64091,566411,5,0,0,6144,19,9088833665
20,522691,101332,624023,6,0,0,18432,12,4740767036
21,534320,191566,725886,8,0,0,22016,12,8968305390
22,567841,146596,714437,6,0,0,97280,12,8478879996
23,570680,1042,571722,9,0,1,1024,18,7757317855
24,663090,75221,738311,0,0,0,5632,11,10707589334
25,748570,67304,815874,4,0,0,11776,16,7938764527
26,778990,3898,782888,1,0,1,4096,6,4371669229
27,813210,53328,866538,9,0,0,2560,18,10283476468
28,824090,55748,879838,0,0,0,4096,11,4890481194
29,893169,2870,896039,3,0,1,8704,2,3662283079
30,914860,1042,915902,7,0,1,1024,8,7660209826
31,915450,159492,1074942,0,0,0,29184,11,9739799556
32,921750,47033,968783,3,0,0,512,2,8556417490
33,940930,100294,1041224,8,0,0,26112,12,4546607319
34,968900,4420,973320,0,0,1,11776,11,10059849900
35,980349,119922,1100271,7,0,0,20992,8,3703274472
36,995660,4850,1000510,4,0,1,5120,16,4304900118
37,1002550,140656,1143206,2,0,0,32256,4,2121352585
38,1057000,216788,1273788,1,0,0,60928,6,1866279103
39,1313130,66368,1379498,9,0,0,8704,18,9150693785
40,1411889,55148,1467037,7,0,0,7168,8,4393084983
41,1480260,74360,1554620,2,0,0,9728,4,7778905349
42,1632310,63608,1695918,2,0,0,9728,4,7563900374
43,1633271,95312,1728583,6,0,0,23040,12,10350393149
44,1704660,1042,1705702,0,0,1,1024,11,3090815503
45,1727260,45219,1772479,2,0,0,512,4,10289559520
46,1777540,72068,1849608,1,0,0,12288,6,5412713069
47,1872890,102908,1975798,2,0,0,37888,4,3095120476
48,1895160,3387,1898547,7,0,1,9728,8,3128799149
49,1944110,43904,1988014,2,0,0,512,4,10193338876
50,2164101,82688,2246789,6,0,0,16896,12,10558650564
51,2179130,74355,2253485,5,0,0,3584,19,1254268118
52,2239680,1518,2241198,4,0,1,1536,16,10324450929
53,2258250,79436,2337686,1,0,0,11264,6,2582267265
54,2312260,76052,2388312,0,0,0,10240,11,8424025123
55,2339410,121261,2460671,0,0,0,18944,11,3855484957
56,2361570,5326,2366896,2,0,1,5632,4,9483272651
57,2386670,106258,2492928,9,0,0,43520,18,7632025149
58,2402520,52364,2454884,2,0,0,3072,4,10691549151
59,2415810,144216,2560026,3,0,0,30720,2,1663770864
60,2505939,60824,2566763,7,0,0,5632,8,1520085611
61,2507060,102075,2609135,4,0,0,33792,16,5551123745
62,2547420,147713,2695133,0,0,0,88064,11,9504121082
63,2653480,106184,2759664,4,0,0,48640,16,7604754075
64,2675200,65521,2740721,4,0,0,1024,16,93078140
65,2892540,43904,2936444,9,0,0,512,18,6871443555
66,2954850,74002,3028852,8,0,0,14336,12,4051115213
67,2976470,127772,3104242,1,0,0,33792,6,9465996725
68,3084630,100256,3184886,3,0,0,29184,2,9803906328
69,3138660,1994,3140654,6,0,1,2048,12,10229314891
70,3185500,121193,3306693,1,0,0,20992,6,5911989846
71,3188660,146702,3335362,3,0,0,34304,2,637759600
72,3260520,81908,3342428,5,0,0,14336,19,8313611493
73,3487550,84380,3571930,1,0,0,17408,6,8458044036
74,3540890,566,3541456,0,0,1,512,11,8930090371
75,3614030,11274,3625304,0,0,1,18432,11,5301293612
76,3623520,111800,3735320,4,0,0,67072,16,4234912656
77,3659380,1042,3660422,9,0,1,1024,18,7861569304
78,3701710,5326,3707036,7,0,1,5632,8,3857185145
79,3704890,109148,3814038,5,0,0,58368,19,2838701570
80,4076970,45596,4122566,4,0,0,1024,16,9737031523
81,4128010,60824,4188834,1,0,0,5632,6,9550051114
82,4136250,6754,4143004,1,0,1,7168,6,8204441183
83,4344270,69284,4413554,0,0,0,8192,11,3503291181
84,4405360,60824,4466184,4,0,0,5632,16,4049009395
85,4481080,108368,4589448,3,0,0,55808,2,2313353644
86,4600010,94664,4694674,2,0,0,15872,4,3142647616
87,4604900,62516,4667416,9,0,0,6144,18,8590277889
88,4782400,45596,4827996,0,0,0,1024,11,2841195263
89,4807510,103376,4910886,2,0,0,39424,4,7980378501
90,4819370,7230,4826600,7,0,1,7680,8,10197425431
91,4844780,5326,4850106,4,0,1,5632,16,6194569167
92,4861580,146529,5008109,1,0,0,1536,6,2074838851
93,4924730,80708,5005438,9,0,0,20480,18,4362720489
94,5017191,104936,5122127,6,0,0,44544,12,2578283815
95,5042740,103825,5146565,0,0,0,7680,11,157217116
96,5084420,3898,5088318,5,0,1,4096,19,7459647883
97,5169000,135886,5304886,9,0,0,4096,18,5314799264
98,5179660,119288,5298948,8,0,0,91648,12,1687578543
99,5246560,68312,5314872,5,0,0,512,19,2597550618
100,5360670,86204,5446874,5,0,0,13312,19,10051123617
101,5364911,47288,5412199,6,0,0,1536,12,9021999628
102,5493500,67592,5561092,1,0,0,7680,6,3991908878
103,5601470,54056,5655526,2,0,0,3584,4,2433882763
104,5655621,57440,5713061,6,0,0,4608,12,2339046292
105,5682190,25187,5707377,7,0,1,45568,8,3840120987
106,5744650,208491,5953141,0,0,0,36864,11,1514085044
107,5780250,209131,5989381,4,0,0,34816,16,5071481314
108,5815170,162013,5977183,0,0,0,13824,11,10338706335
109,5851390,62672,5914062,3,0,0,6656,2,10390175247
110,5891400,2470,5893870,2,0,1,2560,4,1010391932
111,6009000,94220,6103220,5,0,0,19456,19,1591168034
112,6011280,166052,6177332,4,0,0,101376,16,3826081304
113,6112920,75008,6187928,4,0,0,16896,16,5983169612
114,6117070,92962,6210032,5,0,0,13824,19,5418992213
115,6147571,33915,6181486,4,0,1,11264,16,728879729
116,6189430,84156,6273586,4,0,0,8704,16,9109683164
117,6214070,74360,6288430,9,0,0,9728,18,8946957855
118,6247080,103078,6350158,8,0,0,10752,12,4933828870
119,6247551,141055,6388606,6,0,0,86528,12,2066832964
120,6281740,1994,6283734,2,0,1,2048,4,2085603127
121,6286940,104489,6391429,2,0,0,9216,4,7590934322
122,6314260,4162,6318422,9,0,1,11264,18,452730866
123,6429751,48980,6478731,6,0,0,2048,12,2674717250
124,6505151,84536,6589687,6,0,0,17920,12,2879805447
125,6533050,86895,6619945,4,0,0,10240,16,4346763459
126,6610229,3422,6613651,3,0,1,3584,2,10697211271
127,6610840,98446,6709286,0,0,0,21504,11,4837950396
128,6662920,3387,6666307,1,0,1,9728,6,2803546210
129,6686729,1042,6687771,3,0,1,1024,2,8709442998
130,6718100,99320,6817420,1,0,0,26112,6,4653050712
131,6728930,96305,6825235,0,0,0,25600,11,1355447530
132,6739880,123578,6863458,4,0,0,9728,16,9048958333
133,6824620,85884,6910504,3,0,0,11776,2,9556103286
134,6835621,102284,6937905,6,0,0,35840,12,9141690363
135,6841510,566,6842076,2,0,1,512,4,4379575672
136,6902040,45596,6947636,2,0,0,1024,4,8494968504
137,6908810,110834,7019644,3,0,0,58368,2,7232238514
138,6920340,116626,7036966,8,0,0,43520,12,6315789654
139,6990050,169610,7159660,8,0,0,14336,12,2094400966
140,6991090,110796,7101886,3,0,0,17408,2,3542623683
141,7171450,78212,7249662,4,0,0,12288,16,6321300904
142,7239570,3128,7242698,2,0,1,9216,4,3071752657
143,7411570,62516,7474086,9,0,0,6144,18,3701969741
144,7423301,101036,7524337,6,0,0,31744,12,1197596271
145,7522101,58132,7580233,6,0,0,4608,12,3253235038
146,7700580,98540,7799120,3,0,0,23552,2,3350794105
147,7709620,98872,7808492,0,0,0,24064,11,700872098
148,7730630,107120,7837750,5,0,0,51712,19,273627912
149,7768660,134316,7902976,9,0,0,32768,18,6978293917
150,7836190,50532,7886722,0,0,0,2048,11,7305619461
151,7845040,73518,7918558,1,0,0,7168,6,2653576851
152,7942030,58688,8000718,5,0,0,8704,19,5242030421
153,7983430,104780,8088210,8,0,0,44032,12,1381412690
154,8044460,48980,8093440,3,0,0,2048,2,6955027120
155,8072489,23208,8095697,3,0,1,38400,2,9562661963
156,8120839,5712,8126551,3,0,1,14336,2,8190471993
157,8174370,165266,8339636,3,0,0,51712,2,4510353799
158,8303060,71312,8374372,5,0,0,14848,19,5046084398
159,8327070,61538,8388608,5,0,0,2048,19,997138657
160,8384380,69908,8454288,0,0,0,10240,11,6855106649
161,8392100,7230,8399330,4,0,1,7680,16,8156240869
162,8400370,89138,8489508,2,0,0,19968,4,4464950860
163,8410230,109902,8520132,5,0,0,21504,19,6021734036
164,8441681,4374,8446055,4,0,1,4608,16,2829137282
165,8501250,55748,8556998,8,0,0,4096,12,1195977966
166,8505980,193267,8699247,2,0,0,36352,4,637811655
167,8580880,107276,8688156,0,0,0,52224,11,3871320682
168,8625570,566,8626136,6,0,1,512,12,6080848314
169,8729020,76052,8805072,5,0,0,10240,19,9607648738
170,8766390,113947,8880337,8,0,0,48128,12,5272534534
171,8766470,99188,8865658,1,0,0,30720,6,2174554496
172,8907110,67592,8974702,9,0,0,7680,18,8104721226
173,9004750,123032,9127782,5,0,0,103936,19,4546063525
174,9063020,139534,9202554,1,0,0,49664,6,3747268566
175,9076240,92798,9169038,1,0,0,10240,6,9999316809
176,9100620,72750,9173370,3,0,0,1024,2,4171326894
177,9107810,98278,9206088,0,0,0,9728,11,8819548100
178,9124870,146834,9271704,9,0,0,48640,18,3252961534
179,9239610,109772,9349382,9,0,0,60416,18,6749787641
180,9269760,105992,9375752,4,0,0,9728,16,7522166106
181,9286790,64495,9351285,2,0,0,6144,4,4158296940
182,9335790,114932,9450722,1,0,0,32768,6,9620498276
183,9339500,158034,9497534,4,0,0,25088,16,9411648107
184,9361330,95132,9456462,8,0,0,17408,12,581489405
185,9490180,7912,9498092,4,0,1,512,16,7291487476
186,9638780,51296,9690076,8,0,0,4608,12,6149369368
187,9646620,60824,9707444,8,0,0,5632,12,4439978790
188,9686650,91952,9778602,8,0,0,27136,12,2683151268
189,9727000,105944,9832944,3,0,0,12800,2,4305694115
190,9752780,55748,9808528,5,0,0,4096,19,8624536813
191,9757260,98696,9855956,9,0,0,24064,18,8540355769
192,9859430,6754,9866184,9,0,1,7168,18,1430395342
193,9939090,100568,10039658,2,0,0,30208,4,4683300685
194,9993150,566,9993716,7,0,1,512,8,9404341170
195,9997940,103302,10101242,2,0,0,13312,4,10660778795
196,10003840,66680,10070520,5,0,0,9728,19,5711426480
197,10062700,62828,10125528,3,0,0,7168,2,2275838163
198,10131680,92060,10223740,8,0,0,17408,12,3739712922
199,10288280,11533,10299813,0,0,1,18944,11,5307676625
200,10389100,4850,10393950,0,0,1,5120,11,2938324856
201,10435090,1042,10436132,7,0,1,1024,8,8039969028
202,10475950,5712,10481662,9,0,1,14336,18,8061762683
203,10537510,1042,10538552,1,0,1,1024,6,1944901004
204,10566660,14029,10580689,2,0,1,27136,4,2760494830
205,10588841,94788,10683629,6,0,0,15360,12,3504767960
206,10647830,54813,10702643,1,0,0,1024,6,10605016029
207,10729680,71156,10800836,9,0,0,14336,18,6920262637
208,10785759,4850,10790609,3,0,1,5120,2,3419260432
209,10947520,109928,11057448,9,0,0,60928,18,7744452581
210,10952410,137546,11089956,3,0,0,16384,2,482729726
211,10989150,179136,11168286,2,0,0,40448,4,7159946471
212,11044270,93002,11137272,2,0,0,3072,4,3757248639
213,11158720,112611,11271331,9,0,0,33280,18,6394708162
214,11196500,64676,11261176,3,0,0,8192,2,10582128920
215,11251410,47288,11298698,4,0,0,1536,16,6428363992
216,11287100,82820,11369920,1,0,0,12288,6,4917422339
217,11367560,103544,11471104,3,0,0,32256,2,8183913674
218,11398300,6278,11404578,5,0,1,6656,19,36250356
219,11399360,106109,11505469,2,0,0,45056,4,8158712641
220,11459190,11929,11471119,7,0,1,5120,8,6274038173
221,11482670,3898,11486568,0,0,1,4096,11,3112813986
222,11496370,91911,11588281,0,0,0,12288,11,9264252547
223,11510960,118007,11628967,9,0,0,33792,18,7539726003
224,11516220,158293,11674513,4,0,0,10752,16,8744190404
225,11589720,4374,11594094,1,0,1,4608,6,9789271856
226,11683660,107276,11790936,8,0,0,52224,12,10587886011
227,11698530,112986,11811516,9,0,0,18944,18,9434756072
228,11956530,90392,12046922,8,0,0,22016,12,9308543137
229,11980070,84930,12065000,3,0,0,4608,2,2503886488
230,12025580,72668,12098248,8,0,0,9216,12,4686972905
231,12026390,44630,12071020,1,0,0,512,6,10245442657
232,12091629,3128,12094757,3,0,1,9216,2,1202566671
233,12102170,82400,12184570,3,0,0,20992,2,108494669
234,12326350,52364,12378714,4,0,0,3072,16,9015567409
235,12477930,99788,12577718,5,0,0,27648,19,7724788396
236,12500720,165854,12666574,1,0,0,42496,6,9770582496
237,12543830,108318,12652148,1,0,0,38912,6,1257886628
238,12585130,5454,12590584,1,0,1,13824,6,1905528324
239,12699720,98384,12798104,5,0,0,23040,19,2990989399
240,12798850,60824,12859674,8,0,0,5632,12,6098837805
241,12801980,114802,12916782,5,0,0,31744,19,4398429705
242,12914749,100097,13014846,7,0,0,22016,8,4449964570
243,12985890,60824,13046714,5,0,0,5632,19,7112242786
244,13011810,119489,13131299,1,0,0,10752,6,7420935225
245,13015250,112758,13128008,3,0,0,39424,2,10708038221
246,13049410,111090,13160500,8,0,0,19456,12,9875688329
247,13058840,81596,13140436,5,0,0,13312,19,10059304996
248,13060240,136850,13197090,4,0,0,62464,16,7291559596
249,13173900,115700,13289600,4,0,0,79872,16,2827040213
250,13174180,130414,13304594,1,0,0,27136,6,3774928803
251,13220990,96582,13317572,9,0,0,3072,18,9504405484
252,13262870,26745,13289615,2,0,1,3584,4,106158119
253,13322540,55748,13378288,1,0,0,4096,6,1825419370
254,13381980,110552,13492532,3,0,0,62976,2,6692595632
255,13532170,65900,13598070,9,0,0,7168,18,6163867466
256,13621450,10757,13632207,7,0,1,17408,8,3866709984
257,13667200,63287,13730487,8,0,0,4096,12,10008579291
258,13684940,4374,13689314,6,0,1,4608,12,2079688677
259,13775250,99164,13874414,5,0,0,25600,19,4604614644
260,13798450,100724,13899174,9,0,0,30720,18,3548922974
261,13813650,106226,13919876,5,0,0,17408,19,10517764843
262,13841969,111355,13953324,7,0,0,40960,8,8763981600
263,14029610,55748,14085358,9,0,0,4096,18,2799970159
264,14039500,60380,14099880,8,0,0,9216,12,6107215859
265,14098230,4112,14102342,1,0,1,2560,6,2020013958
266,14103620,5802,14109422,0,0,1,6144,11,2383139703
267,14107190,109772,14216962,4,0,0,60416,16,9964067038
268,14155280,95732,14251012,4,0,0,4608,16,3560544701
269,14164470,133972,14298442,4,0,0,28160,16,5526310387
270,14199900,154492,14354392,3,0,0,29184,2,9760110553
271,14211390,115378,14326768,9,0,0,34304,18,4502991398
272,14237260,142309,14379569,1,0,0,15872,6,8229276219
273,14268400,3645,14272045,9,0,1,10240,18,9691028329
274,14296350,86224,14382574,9,0,0,4608,18,9106995874
275,14308920,57596,14366516,4,0,0,5120,16,7165700828
276,14311081,566,14311647,4,0,1,512,16,6901146625
277,14338650,117764,14456414,4,0,0,72192,16,9746660740
278,14372050,143938,14515988,1,0,0,49152,6,9968762614
279,14394960,273806,14668766,3,0,0,161280,2,4453607439
280,14453469,9425,14462894,3,0,1,15872,2,909485012
281,14616180,68084,14684264,3,0,0,14336,2,8640904558
282,14648570,86088,14734658,1,0,0,7168,6,4732860430
283,14764730,100256,14864986,2,0,0,29184,4,9182711728
284,14883449,566,14884015,3,0,1,512,2,6900442283
285,14897130,2470,14899600,0,0,1,2560,11,7193710625
286,15151921,566,15152487,4,0,1,512,16,2659380141
287,15176610,83000,15259610,8,0,0,17920,12,3813987176
288,15225990,52364,15278354,2,0,0,3072,4,7604657214
289,15257830,104056,15361886,9,0,0,35840,18,86074487
290,15261400,5802,15267202,9,0,1,6144,18,7598494132
291,15267820,77900,15345720,8,0,0,11264,12,712119339
292,15307850,69976,15377826,4,0,0,4608,16,4095170339
293,15444220,1518,15445738,1,0,1,1536,6,4030273826
294,15464250,113799,15578049,9,0,0,39424,18,637006465
295,15477370,116918,15594288,3,0,0,53248,2,8186011126
296,15482770,3422,15486192,1,0,1,3584,6,6927683229
297,15504200,137920,15642120,1,0,0,17920,6,2813615834
298,15518270,1518,15519788,6,0,1,1536,12,6437284593
299,15596760,81284,15678044,2,0,0,12288,4,2472179304
300,15608540,104468,15713008,9,0,0,43008,18,4490432154
301,15633480,101806,15735286,1,0,0,4096,6,3230219119
302,15651420,89932,15741352,3,0,0,12800,2,10164323391
303,15701410,12632,15714042,7,0,1,1024,8,3722281833
304,15746960,3898,15750858,2,0,1,4096,4,7524876062
305,15776490,71132,15847622,8,0,0,9216,12,4661413469
306,15781200,136946,15918146,1,0,0,79360,6,4612461842
307,15865140,109184,15974324,2,0,0,34304,4,8106245026
308,15919261,6278,15925539,4,0,1,6656,16,834787282
309,15996590,177947,16174537,9,0,0,22016,18,4665330595
310,16048040,45596,16093636,1,0,0,1024,6,7793188383
311,16082270,57440,16139710,3,0,0,4608,2,2394368017
312,16233980,106652,16340632,1,0,0,50176,6,2986801282
313,16306420,45596,16352016,1,0,0,1024,6,2112443733
314,16346350,82820,16429170,4,0,0,12288,16,7601781982
315,16420990,100607,16521597,5,0,0,10752,19,4307699783
316,16421219,2470,16423689,3,0,1,2560,2,3640446648
317,16428660,216932,16645592,9,0,0,79360,18,3663501964
318,16501190,1994,16503184,5,0,1,2048,19,9640319095
319,16571550,76397,16647947,5,0,0,7680,19,603759348
320,16603790,120708,16724498,2,0,0,48640,4,6387368999
321,16615670,84512,16700182,1,0,0,12800,6,2608282566
322,16660520,178950,16839470,8,0,0,50688,12,8714491418
323,16668580,89104,16757684,8,0,0,10240,12,9274653752
324,16699040,180918,16879958,5,0,0,37376,19,5775535681
325,16759890,178214,16938104,8,0,0,15360,12,7703802176
326,16790460,60824,16851284,4,0,0,5632,16,6403891147
327,16899150,93500,16992650,3,0,0,11776,2,1146898759
328,16985700,43904,17029604,9,0,0,512,18,3385922343
329,17162170,87296,17249466,2,0,0,16896,4,7043621539
330,17276190,5802,17281992,1,0,1,6144,6,238898679
331,17295310,102440,17397750,8,0,0,36352,12,4207443688
332,17431320,107120,17538440,2,0,0,51712,4,7116864366
333,17485120,106816,17591936,2,0,0,13312,4,4788368815
334,17574480,4374,17578854,9,0,1,4608,18,5451298727
335,17601110,104780,17705890,4,0,0,44032,16,2856888369
336,17814120,45596,17859716,3,0,0,1024,2,333658729
337,17886020,99944,17985964,2,0,0,28160,4,315167662
338,17906780,91280,17998060,9,0,0,14848,18,4503596031
339,17950640,147308,18097948,5,0,0,43008,19,5299849780
340,17963950,85604,18049554,4,0,0,16384,16,4944313527
341,18084980,104642,18189622,9,0,0,22016,18,9114630444
342,18099230,95243,18194473,9,0,0,15872,18,4216753310
343,18169110,56060,18225170,9,0,0,5120,18,9501320858
344,18173779,4374,18178153,3,0,1,4608,2,6078495753
345,18233309,7706,18241015,3,0,1,8192,2,1506124922
346,18367380,63440,18430820,2,0,0,4608,4,3612248579
347,18382690,95600,18478290,2,0,0,18944,4,8984186653
348,18388760,107056,18495816,2,0,0,14848,4,7588865626
349,18407220,146376,18553596,3,0,0,53248,2,4345404489
350,18420050,144793,18564843,9,0,0,36864,18,6189760473
351,18424429,11533,18435962,8,0,1,18944,12,10120266307
352,18446060,158783,18604843,5,0,0,22528,19,2543963250
353,18561190,72797,18633987,5,0,0,12800,19,10106576108
354,18603280,79299,18682579,3,0,0,10752,2,7912095010
355,18663400,50672,18714072,8,0,0,2560,12,3554187913
356,18715280,49292,18764572,4,0,0,3072,16,3392435805
357,18756649,2946,18759595,8,0,1,3072,12,2590739206
358,18814240,3904,18818144,2,0,1,10752,4,6422755312
359,18820490,69776,18890266,3,0,0,14848,2,7766617135
360,18854950,566,18855516,0,0,1,512,11,10379894658
361,18858920,22950,18881870,2,0,1,37888,4,8505799197
362,18867390,147151,19014541,9,0,0,25600,18,236800835
363,18884010,202933,19086943,2,0,0,30208,4,2108209211
364,18920510,118229,19038739,3,0,0,3072,2,2266261989
365,19046870,91787,19138657,2,0,0,12288,4,4456994883
366,19098620,116303,19214923,9,0,0,54784,18,1456887876
367,19120780,6754,19127534,7,0,1,7168,8,577887362
368,19144520,109460,19253980,3,0,0,6144,2,8302957469
369,19153070,221408,19374478,9,0,0,60928,18,225723684
370,19157600,138017,19295617,8,0,0,91648,12,7383272142
371,19182000,148810,19330810,5,0,0,5120,19,7128921398
372,19204490,246395,19450885,4,0,0,104960,16,6866664610
373,19212530,143369,19355899,8,0,0,15872,12,3696632960
374,19249560,50672,19300232,5,0,0,2560,19,5968680549
375,19318210,60627,19378837,2,0,0,4608,4,3330041249
376,19388150,5326,19393476,5,0,1,5632,19,8306892733
377,19398310,4374,19402684,0,0,1,4608,11,1586818021
378,19489660,47288,19536948,2,0,0,1536,4,10307676128
379,19495100,101972,19597072,4,0,0,34816,16,9519802932
380,19508730,3645,19512375,7,0,1,10240,8,9649380271
381,19572390,98384,19670774,1,0,0,23040,6,8463630548
382,19579800,137513,19717313,2,0,0,39424,4,7408777576
383,19580640,4679,19585319,0,0,1,12288,11,7940308023
384,19586171,10916,19597087,4,0,1,512,16,6140969412
385,19625690,120447,19746137,3,0,0,28160,2,2995835987
386,19749030,60824,19809854,3,0,0,5632,2,6337803108
387,19792460,101660,19894120,9,0,0,33792,18,8632890508
388,19799230,69284,19868514,9,0,0,8192,18,10104164315
389,19980000,91439,20071439,4,0,0,24576,16,8201731846
390,20001420,62516,20063936,2,0,0,6144,4,786332006
391,20072940,49292,20122232,2,0,0,3072,4,7317746907
392,20131950,100724,20232674,4,0,0,30720,16,2434131924
393,20247549,3898,20251447,3,0,1,4096,2,5478868744
394,20253180,59132,20312312,9,0,0,5120,18,8126678748
395,20257090,6229,20263319,2,0,1,15360,4,2640568087
396,20367720,136419,20504139,8,0,0,12288,12,8056920738
397,20429380,71000,20500380,5,0,0,13824,19,9635644684
398,20438820,101348,20540168,2,0,0,32768,4,1553839036
399,20445580,141496,20587076,9,0,0,45568,18,7096959448
400,20506170,110864,20617034,4,0,0,64000,16,5358838848
401,20562100,104000,20666100,3,0,0,41472,2,4697975776
402,20646121,1994,20648115,4,0,1,2048,16,5606767143
403,20773269,5971,20779240,3,0,1,14848,2,3561575528
404,20901030,106808,21007838,4,0,0,50688,16,365692884
405,20904009,1042,20905051,3,0,1,1024,2,3441738367
406,21006990,3710,21010700,2,0,1,8704,4,6240467532
407,21120840,60824,21181664,9,0,0,5632,18,546008041
408,21158940,111974,21270914,4,0,0,65536,16,1112767948
409,21175270,1518,21176788,2,0,1,1536,4,1937240473
410,21234180,2946,21237126,5,0,1,3072,19,5223927283
411,21259150,66436,21325586,4,0,0,5632,16,8315998837
412,21317660,75608,21393268,5,0,0,13824,19,5398304470
413,21389640,125560,21515200,5,0,0,100352,19,7343770948
414,21416799,2870,21419669,3,0,1,8704,2,10698340059
415,21425800,156366,21582166,9,0,0,92160,18,7324251898
416,21475130,109886,21585016,3,0,0,4608,2,3573454619
417,21510750,10154,21520904,9,0,1,14336,18,4098373762
418,21517750,84840,21602590,4,0,0,10752,16,6816190149
419,21565170,64276,21629446,2,0,0,1536,4,6120091348
420,21734900,50672,21785572,4,0,0,2560,16,5898962629
421,21910710,12737,21923447,6,0,1,24576,12,8522595744
422,21912300,76323,21988623,3,0,0,11776,2,471464569
423,21928380,129911,22058291,3,0,0,27648,2,4768181408
424,21944150,165351,22109501,2,0,0,33280,4,4545765081
425,22002820,75363,22078183,3,0,0,13312,2,9813483630
426,22007120,5802,22012922,5,0,1,6144,19,662324753
427,22012940,4420,22017360,5,0,1,11776,19,3759541908
428,22026400,153313,22179713,9,0,0,6656,18,5904761846
429,22104380,11867,22116247,2,0,1,7168,4,6518765734
430,22206380,1518,22207898,5,0,1,1536,19,5984669887
431,22249500,43904,22293404,4,0,0,512,16,4105326730
432,22293820,96824,22390644,8,0,0,17920,12,5313187899
433,22346950,86672,22433622,9,0,0,14848,18,3955720956
434,22394260,65900,22460160,9,0,0,7168,18,764136109
435,22427530,109724,22537254,9,0,0,55296,18,4385483009
436,22440530,101263,22541793,8,0,0,14848,12,9738147451
437,22448070,145254,22593324,8,0,0,16384,12,4619995421
438,22665940,3898,22669838,9,0,1,4096,18,7621869699
439,22708410,60980,22769390,3,0,0,6144,2,2660364190
440,22739240,4850,22744090,9,0,1,5120,18,7451358426
441,22815680,59600,22875280,9,0,0,6656,18,919305942
442,22883220,67304,22950524,8,0,0,11776,12,1226297367
443,22886630,100880,22987510,1,0,0,31232,6,23862333
444,23036070,114452,23150522,2,0,0,75776,4,2676608308
445,23158641,33075,23191716,4,0,1,54272,16,3298535891
446,23290350,81620,23371970,8,0,0,18432,12,8018718758
447,23301550,87896,23389446,2,0,0,13824,4,4453307489
448,23329370,119394,23448764,5,0,0,42496,19,9096843782
449,23360500,1042,23361542,6,0,1,1024,12,10164494498
450,23454530,55748,23510278,8,0,0,4096,12,7512754209
451,23458330,65334,23523664,2,0,0,1536,4,1886933380
452,23460550,70476,23531026,1,0,0,6656,6,5673605150
453,23471010,153346,23624356,5,0,0,84992,19,8239032757
454,23485970,103598,23589568,3,0,0,36352,2,9141042297
455,23508890,121724,23630614,8,0,0,3584,12,3440813355
456,23531020,126408,23657428,2,0,0,14848,4,9871220359
457,23608100,135950,23744050,3,0,0,71168,2,8167591979
458,23807680,101816,23909496,3,0,0,34304,2,7297762389
459,23899650,111790,24011440,9,0,0,22528,18,3437487248
460,23917500,1042,23918542,6,0,1,1024,12,10088377801
461,24078880,6754,24085634,5,0,1,7168,19,5714190798
462,24129670,13083,24142753,0,0,1,22016,11,4068885287
463,24140380,75311,24215691,1,0,0,4608,6,9197243958
464,24387260,84980,24472240,1,0,0,14336,6,5421268421
465,24396180,100880,24497060,3,0,0,31232,2,7727593547
466,24420060,53131,24473191,2,0,0,3072,4,3832173333
467,24457760,58376,24516136,3,0,0,7680,2,5533148213
468,24506800,70976,24577776,5,0,0,8704,19,9576102409
469,24515469,1225,24516694,3,0,1,512,2,2681419607
470,24519701,3645,24523346,4,0,1,10240,16,8967057372
471,24529610,139251,24668861,2,0,0,2560,4,4477792323
472,24578040,207395,24785435,1,0,0,157184,6,2796337791
473,24666230,120624,24786854,2,0,0,4608,4,690899008
474,24781130,56388,24837518,9,0,0,2560,18,6278105213
475,24991681,4850,24996531,4,0,1,5120,16,1522594219
476,25231931,57231,25289162,6,0,0,6144,12,10127660595
477,25252000,3422,25255422,9,0,1,3584,18,10630793271
478,25320369,1994,25322363,3,0,1,2048,2,8762342538
479,25370250,76052,25446302,2,0,0,10240,4,123657090
480,25479460,54056,25533516,4,0,0,3584,16,3483248645
481,25496280,68840,25565120,5,0,0,11776,19,7688235189
482,25507090,1994,25509084,9,0,1,2048,18,1595125006
483,25636200,105872,25742072,4,0,0,47616,16,10388653985
484,25670160,137774,25807934,5,0,0,66048,19,9818623821
485,25907910,97916,26005826,3,0,0,21504,2,9680004183
486,26092010,74852,26166862,2,0,0,16384,4,8559786730
487,26145480,52364,26197844,9,0,0,3072,18,2995661122
488,26166960,72590,26239550,4,0,0,12800,16,555295572
489,26272110,105716,26377826,1,0,0,47104,6,8428992760
490,26291620,98638,26390258,8,0,0,12288,12,7369788660
491,26465110,88676,26553786,8,0,0,16384,12,5330197049
492,26466580,5326,26471906,2,0,1,5632,4,10194356519
493,26531160,68562,26599722,8,0,0,3584,12,3443805245
494,26579990,50672,26630662,5,0,0,2560,19,10583450461
495,26620219,5802,26626021,3,0,1,6144,2,9327612409
496,26624150,5196,26629346,9,0,1,13312,18,6004745818
497,26643480,55904,26699384,9,0,0,4608,18,4965305014
498,26652820,77494,26730314,5,0,0,9216,19,4155861585
499,26718809,100880,26819689,7,0,0,31232,8,2361571703
500,26738480,105521,26844001,3,0,0,40448,2,8678716730
501,26757660,7706,26765366,9,0,1,8192,18,8073879901
502,26761680,144649,26906329,3,0,0,15872,2,3286599920
503,26860820,16613,26877433,9,0,1,32256,18,4438260999
504,26924040,22950,26946990,2,0,1,37888,4,2806337522
505,26934340,113359,27047699,5,0,0,19456,19,4777290337
506,27136690,3422,27140112,9,0,1,3584,18,3197969434
507,27155580,96668,27252248,5,0,0,17408,19,4976522014
508,27370080,130670,27500750,3,0,0,86528,2,4572923628
509,27384351,5326,27389677,4,0,1,5632,16,770029323
510,27408220,246375,27654595,4,0,0,37888,16,6562429990
511,27439200,4420,27443620,6,0,1,11776,12,1448222789
512,27449310,140661,27589971,4,0,0,71680,16,3160470019
513,27464720,43904,27508624,9,0,0,512,18,1971686652
514,27486990,156038,27643028,8,0,0,40960,12,10407338951
515,27506540,3898,27510438,6,0,1,4096,12,9011621586
516,27595220,107538,27702758,1,0,0,29184,6,2435681276
517,27600540,182912,27783452,1,0,0,66048,6,4984853167
518,27631809,26167,27657976,3,0,1,3584,2,7103898548
519,27667460,79016,27746476,1,0,0,19968,6,10141224296
520,27698300,198480,27896780,8,0,0,44032,12,1835197598
521,27753970,102284,27856254,3,0,0,35840,2,10086577654
522,27773260,126507,27899767,9,0,0,9728,18,10541121476
523,27852990,4298,27857288,5,0,1,1024,19,2181907871
524,27884680,170499,28055179,4,0,0,31744,16,396647591
525,27929020,48980,27978000,4,0,0,2048,16,9576012600
526,27947210,115074,28062284,1,0,0,9216,6,6553911329
527,27963030,76208,28039238,1,0,0,10752,6,573424767
528,27981750,96542,28078292,4,0,0,16384,16,7526478657
529,28021200,128777,28149977,8,0,0,47616,12,8807502823
530,28037020,98434,28135454,1,0,0,20992,6,176174433
531,28102700,56700,28159400,5,0,0,3072,19,1483608612
532,28306750,60824,28367574,2,0,0,5632,4,10343230220
533,28374120,1518,28375638,2,0,1,1536,4,9168210864
534,28487390,83156,28570546,8,0,0,18432,12,3303660242
535,28514560,102908,28617468,5,0,0,37888,19,7716454145
536,28519889,3422,28523311,3,0,1,3584,2,2488653829
537,28562590,137234,28699824,1,0,0,28672,6,10670549235
538,28649410,100568,28749978,9,0,0,30208,18,10032756278
539,28696910,53239,28750149,8,0,0,512,12,4628797112
540,28712710,2470,28715180,9,0,1,2560,18,1537132715
541,28821900,107744,28929644,5,0,0,53760,19,2225189146
542,28954360,65612,29019972,2,0,0,11264,4,10283777518
543,28993370,1518,28994888,0,0,1,1536,11,7685041891
544,29003270,99788,29103058,3,0,0,27648,2,8624343182
545,29098060,54619,29152679,1,0,0,4096,6,5514757786
546,29100670,106249,29206919,9,0,0,40960,18,7079755011
547,29104890,54056,29158946,5,0,0,3584,19,2422139252
548,29254260,103220,29357480,8,0,0,38912,12,211171912
549,29324010,136478,29460488,3,0,0,77312,2,3166540375
550,29382680,125952,29508632,2,0,0,11264,4,5112971213
551,29440930,23237,29464167,9,0,1,10240,18,3249562598
552,29454480,127958,29582438,2,0,0,20480,4,7340476598
553,29457419,114131,29571550,7,0,0,64512,8,5113496580
554,29504870,149072,29653942,9,0,0,30208,18,2101115084
555,29507720,86636,29594356,1,0,0,7168,6,1713155423
556,29513980,72546,29586526,1,0,0,512,6,9627082159
557,29649550,66900,29716450,3,0,0,6144,2,3532681633
558,29676750,86014,29762764,9,0,0,15872,18,8189087661
559,29681080,119854,29800934,8,0,0,22016,12,3423456701
560,29709160,157234,29866394,4,0,0,12800,16,6886869836
561,29718470,86067,29804537,2,0,0,11776,4,3673735713
562,29766360,163364,29929724,9,0,0,48128,18,2951241974
563,29794110,75263,29869373,1,0,0,9728,6,6729207520
564,29886300,116474,30002774,3,0,0,59904,2,2432066058
565,29962160,112164,30074324,1,0,0,27648,6,8236306302
566,29971610,3128,29974738,0,0,1,9216,11,9554730555
567,30006220,6278,30012498,1,0,1,6656,6,6686474676
568,30018990,94316,30113306,2,0,0,13312,4,3471436689
569,30027330,5326,30032656,2,0,1,5632,4,4609166762
570,30056670,75320,30131990,3,0,0,17920,2,2362810957
571,30094580,137831,30232411,2,0,0,14336,4,2138545097
572,30195140,61448,30256588,3,0,0,7680,2,6443253266
573,30205150,74228,30279378,2,0,0,14336,4,4134088844
574,30254580,64516,30319096,5,0,0,6144,19,3016381287
575,30284890,59132,30344022,4,0,0,5120,16,3244724981
576,30557840,98072,30655912,1,0,0,22016,6,8558134996
577,30595270,62529,30657799,3,0,0,6144,2,2211187844
578,30698680,94688,30793368,1,0,0,20992,6,7642201791
579,30723660,106340,30830000,9,0,0,49152,18,6529589301
580,30866340,71468,30937808,9,0,0,15360,18,7904778285
581,30957890,97604,31055494,1,0,0,20480,6,7127825750
582,31031700,97448,31129148,4,0,0,19968,16,8660121818
583,31120570,101972,31222542,4,0,0,34816,16,4174242457
584,31161760,103688,31265448,2,0,0,40448,4,3832790293
585,31203420,63915,31267335,2,0,0,6144,4,3154030491
586,31260920,90007,31350927,2,0,0,14848,4,5306233734
587,31582290,99320,31681610,2,0,0,26112,4,1135497879
588,31661010,3422,31664432,2,0,1,3584,4,9536296573
589,31785920,566,31786486,1,0,1,512,6,5210297990
590,31862160,93752,31955912,4,0,0,17920,16,6254847199
591,32048220,52364,32100584,1,0,0,3072,6,3227343286
592,32053010,11533,32064543,5,0,1,18944,19,5894225529
593,32140680,84512,32225192,5,0,0,12800,19,1539336642
594,32170421,11274,32181695,4,0,1,18432,16,439834814
595,32285070,74360,32359430,5,0,0,9728,19,6928008425
596,32336620,83000,32419620,5,0,0,17920,19,3029077651
597,32336880,135714,32472594,4,0,0,104960,16,6626551993
598,32387150,108630,32495780,3,0,0,7680,2,7215773929
599,32538040,104780,32642820,1,0,0,44032,6,8701599032
600,32581930,104000,32685930,5,0,0,41472,19,3596096219
601,32623810,113609,32737419,1,0,0,9728,6,5707352289
602,32628090,106350,32734440,3,0,0,45056,2,2162133046
603,32633210,138700,32771910,4,0,0,18944,16,3599445193
604,32814700,78766,32893466,8,0,0,6144,12,536992771
605,32830950,93644,32924594,1,0,0,27648,6,7230914881
606,32918450,103272,33021722,2,0,0,18944,4,2894526813
607,32924430,44085,32968515,3,0,0,512,2,7890292201
608,32938230,101972,33040202,4,0,0,34816,16,1532139239
609,32939620,72668,33012288,8,0,0,9216,12,8460458888
610,33034850,10670,33045520,7,0,1,5632,8,5000212024
611,33068370,566,33068936,1,0,1,512,6,9454867491
612,33147880,93596,33241476,1,0,0,17408,6,7709795897
613,33212150,84824,33296974,1,0,0,13824,6,6616790212
614,33245981,4374,33250355,4,0,1,4608,16,7329599194
615,33286050,3422,33289472,2,0,1,3584,4,2215248393
616,33390690,104301,33494991,4,0,0,24576,16,10556148714
617,33418460,105685,33524145,1,0,0,43520,6,1835931195
618,33447920,124519,33572439,5,0,0,49664,19,3092858544
619,33486350,104803,33591153,5,0,0,4096,19,1044241380
620,33578730,55748,33634478,9,0,0,4096,18,955947822
621,33700220,73916,33774136,3,0,0,13312,2,4953484822
622,33801940,43904,33845844,3,0,0,512,2,9907114480
623,33821350,6278,33827628,9,0,1,6656,18,6745798289
624,33940420,10499,33950919,0,0,1,16896,11,8253444371
625,33978780,101816,34080596,2,0,0,34304,4,8982495283
626,33987370,98002,34085372,0,0,0,4608,11,9162460997
627,34005760,56372,34062132,0,0,0,6144,11,5036582842
628,34055090,566,34055656,0,0,1,512,11,2418077376
629,34155520,124714,34280234,9,0,0,48640,18,3961155621
630,34174050,82688,34256738,3,0,0,16896,2,4220437460
631,34353250,82244,34435494,9,0,0,20480,18,7047644715
632,34355600,81001,34436601,5,0,0,3584,19,1572240734
633,34398730,100770,34499500,3,0,0,18944,2,2807932705
634,34486840,47288,34534128,3,0,0,1536,2,578078316
635,34498620,1438,34500058,1,0,1,512,6,1652729357
636,34511640,90992,34602632,3,0,0,18944,2,3217183190
637,34551170,144792,34695962,2,0,0,97280,4,831138748
638,34614210,82243,34696453,0,0,0,1536,11,6292859196
639,34660300,1042,34661342,5,0,1,1024,19,10249815997
640,34669410,33305,34702715,7,0,1,6656,8,6400735067
641,34690020,13361,34703381,7,0,1,1024,8,5155730853
642,34842200,14545,34856745,0,0,1,28160,11,762771410
643,34861690,3387,34865077,9,0,1,9728,18,877768760
644,34877990,103199,34981189,2,0,0,26112,4,1367988673
645,35023790,67928,35091718,1,0,0,13824,6,379198291
646,35063380,69528,35132908,2,0,0,11776,4,3140627030
647,35084711,1994,35086705,4,0,1,2048,16,331198370
648,35106390,46624,35153014,9,0,0,1024,18,2739917673
649,35185990,107120,35293110,3,0,0,51712,2,9290246630
650,35202080,47288,35249368,9,0,0,1536,18,6306951115
651,35228600,10499,35239099,1,0,1,16896,6,9558684238
652,35304020,176236,35480256,8,0,0,26624,12,2088542874
653,35345900,4850,35350750,7,0,1,5120,8,10471548890
654,35353970,94976,35448946,9,0,0,16896,18,4478444511
655,35367031,3422,35370453,4,0,1,3584,16,4372307268
656,35424470,126028,35550498,5,0,0,29184,19,9057270677
657,35528600,50672,35579272,9,0,0,2560,18,2468405046
658,35531580,96512,35628092,2,0,0,16896,4,2788347326
659,35551120,110562,35661682,8,0,0,45056,12,7996719130
660,35623740,101636,35725376,8,0,0,19456,12,4060825308
661,35655480,118150,35773630,5,0,0,67584,19,9579249156
662,35728760,120134,35848894,8,0,0,19968,12,5086054463
663,35732090,105248,35837338,0,0,0,45568,11,6450154375
664,35884019,5802,35889821,3,0,1,6144,2,9592129003
665,35898410,82088,35980498,3,0,0,19968,2,9025409259
666,35919340,153159,36072499,2,0,0,39936,4,2367085055
667,35926170,85480,36011650,0,0,0,9728,11,849606615
668,35928230,132078,36060308,5,0,0,8704,19,823026169
669,35979650,1882,35981532,0,0,1,1024,11,7516988976
670,36011300,108566,36119866,2,0,0,16384,4,8361929715
671,36038640,100568,36139208,5,0,0,30208,19,6768141688
672,36054820,122844,36177664,0,0,0,18432,11,6052833775
673,36058060,140424,36198484,1,0,0,36352,6,10708851856
674,36098230,81990,36180220,0,0,0,6656,11,4518317796
675,36116870,132392,36249262,8,0,0,15360,12,5628229820
676,36182850,115834,36298684,4,0,0,65536,16,2832172296
677,36193231,9636,36202867,4,0,1,4608,16,5902333159
678,36193670,115637,36309307,8,0,0,34816,12,8036075390
679,36205630,120907,36326537,5,0,0,24576,19,8924785321
680,36240650,142946,36383596,5,0,0,44544,19,1690543916
681,36254450,108278,36362728,5,0,0,16384,19,3984291063
682,36255830,164804,36420634,3,0,0,8704,2,1342416224
683,36257270,174632,36431902,2,0,0,20480,4,9429735723
684,36331960,179040,36511000,9,0,0,77312,18,2403578444
685,36469670,73160,36542830,8,0,0,15872,12,9475414190
686,36728310,102752,36831062,5,0,0,37376,19,4082540281
687,36747540,88217,36835757,4,0,0,15360,16,9144498101
688,36798320,49448,36847768,9,0,0,3584,18,6253779258
689,36840480,47288,36887768,5,0,0,1536,19,6717544546
690,36849900,62516,36912416,4,0,0,6144,16,9521841608
691,36890010,105884,36995894,3,0,0,47104,2,6830757080
692,36971870,98072,37069942,3,0,0,22016,2,400376096
693,37139440,112268,37251708,4,0,0,68608,16,9096584489
694,37166360,168241,37334601,8,0,0,28672,12,707336946
695,37175780,150070,37325850,2,0,0,83968,4,8428052310
696,37186440,22950,37209390,5,0,1,37888,19,5456746917
697,37231680,176046,37407726,1,0,0,37888,6,2262788679
698,37274490,63140,37337630,8,0,0,8192,12,2923745363
699,37427630,76364,37503994,4,0,0,11264,16,7671688457
700,37447070,59132,37506202,5,0,0,5120,19,10169277894
701,37458190,1994,37460184,1,0,1,2048,6,1321447984
702,37469440,54368,37523808,9,0,0,4608,18,7502660246
703,37500440,47288,37547728,1,0,0,1536,6,1610710452
704,37601020,3422,37604442,0,0,1,3584,11,2862863168
705,37615291,3422,37618713,4,0,1,3584,16,6347661028
706,37632470,48980,37681450,1,0,0,2048,6,10688598282
707,37664860,120380,37785240,2,0,0,95232,4,9826017008
708,37686890,98856,37785746,3,0,0,1536,2,2976854233
709,37755800,29463,37785263,5,0,1,2560,19,5484599619
710,37757050,200472,37957522,3,0,0,8704,2,7805136060
711,37796130,105092,37901222,4,0,0,45056,16,3690792376
712,37798310,112131,37910441,4,0,0,30208,16,9901789501
713,37937350,5971,37943321,7,0,1,14848,8,8569855802
714,37989220,97136,38086356,0,0,0,18944,11,2100157722
715,38052070,98696,38150766,2,0,0,24064,4,3352916404
716,38113460,86828,38200288,0,0,0,15360,11,9034404408
717,38117130,47444,38164574,2,0,0,2048,4,1279944351
718,38256860,103064,38359924,5,0,0,38400,19,4997180758
719,38306380,4162,38310542,5,0,1,11264,19,6576227895
720,38361870,7706,38369576,7,0,1,8192,8,1141491313
721,38483520,67113,38550633,2,0,0,6144,4,6359850570
722,38489770,98852,38588622,9,0,0,24576,18,2755726012
723,38531020,111929,38642949,1,0,0,24576,6,5089721153
724,38542120,159854,38701974,0,0,0,32256,11,4306139856
725,38562540,139917,38702457,9,0,0,1536,18,8319449448
726,38574670,152405,38727075,8,0,0,72704,12,2035276787
727,38617920,133326,38751246,2,0,0,10240,4,4745582192
728,38632150,152264,38784414,4,0,0,8192,16,7826195705
729,38653770,127776,38781546,8,0,0,18944,12,8116651225
730,38686950,67500,38754450,5,0,0,5632,19,4060981009
731,38745800,5461,38751261,1,0,1,5120,6,2730386258
732,38750810,5769,38756579,0,0,1,5632,11,4855644415
733,38839750,138534,38978284,9,0,0,13312,18,2911044549
734,39032950,3898,39036848,0,0,1,4096,11,8696155593
735,39107930,110105,39218035,3,0,0,19456,2,9531923917
736,39116570,47288,39163858,8,0,0,1536,12,1961550912
737,39243400,1042,39244442,2,0,1,1024,4,9999848293
738,39254310,55748,39310058,0,0,0,4096,11,8744371344
739,39283550,153371,39436921,9,0,0,19968,18,4311741522
740,39297050,103784,39400834,9,0,0,24576,18,170219575
741,39396870,63088,39459958,3,0,0,5120,2,5853563984
742,39402990,3422,39406412,2,0,1,3584,4,10607138191
743,39403640,99499,39503139,1,0,0,25088,6,7307018684
744,39436010,6705,39442715,6,0,1,6144,12,8306247314
745,39487930,120380,39608310,9,0,0,95232,18,9482798467
746,39530710,152528,39683238,8,0,0,41472,12,1287568222
747,39613120,105807,39718927,9,0,0,4608,18,1677551746
748,39649280,3387,39652667,7,0,1,9728,8,6918397571
749,39678880,75038,39753918,1,0,0,12800,6,1329966039
750,39712440,55748,39768188,4,0,0,4096,16,7718639627
751,39873430,54524,39927954,8,0,0,5120,12,8987121945
752,39947270,77012,40024282,5,0,0,18432,19,4069570797
753,40023650,4046,40027696,0,0,1,3584,11,4469630949
754,40068680,5971,40074651,9,0,1,14848,18,8985034982
755,40113310,6278,40119588,5,0,1,6656,19,6029480558
756,40125510,111800,40237310,9,0,0,67072,18,6179861123
757,40155120,135716,40290836,5,0,0,9728,19,3007296711
758,40164210,110540,40274750,3,0,0,11264,2,2117304017
759,40200170,1994,40202164,1,0,1,2048,6,3138997349
760,40241810,71004,40312814,3,0,0,5120,2,2824534749
761,40256840,69642,40326482,3,0,0,4608,2,6799676110
762,40270559,48980,40319539,7,0,0,2048,8,9984936355
763,40328790,76052,40404842,8,0,0,10240,12,8823839080
764,40397840,101504,40499344,9,0,0,33280,18,6362622020
765,40398010,6847,40404857,2,0,1,11264,4,4051070373
766,40459900,77744,40537644,8,0,0,10752,12,4265383751
767,40468100,566,40468666,5,0,1,512,19,8142199419
768,40475731,67460,40543191,6,0,0,12288,12,4814082800
769,40519190,50672,40569862,5,0,0,2560,19,2348227991
770,40552460,4850,40557310,5,0,1,5120,19,5748666263
771,40594730,161091,40755821,2,0,0,17920,4,9028620699
772,40617900,52364,40670264,0,0,0,3072,11,6444566955
773,40627270,130906,40758176,8,0,0,7680,12,7687237769
774,40662050,127125,40789175,1,0,0,15360,6,8675085747
775,40693480,181509,40874989,1,0,0,8704,6,6304395435
776,40742510,99476,40841986,8,0,0,26624,12,10146980019
777,40745840,149354,40895194,8,0,0,39936,12,1144497311
778,40792740,169963,40962703,0,0,0,68608,11,5605981503
779,40902920,82820,40985740,9,0,0,12288,18,9991329343
780,40921880,94820,41016700,8,0,0,16384,12,2865542014
781,40955150,92525,41047675,8,0,0,14336,12,4363935547
782,41063030,55748,41118778,8,0,0,4096,12,6701298471
783,41126050,1042,41127092,6,0,1,1024,12,562915553
784,41140040,7230,41147270,9,0,1,7680,18,7375890414
785,41162750,79696,41242446,0,0,0,12288,11,5442159995
786,41176290,129660,41305950,5,0,0,59392,19,2562171203
787,41212980,93461,41306441,8,0,0,1536,12,7733159790
788,41288260,75902,41364162,1,0,0,7168,6,9077629879
789,41453230,112424,41565654,4,0,0,69120,16,4376092803
790,41475520,10757,41486277,6,0,1,17408,12,8652601092
791,41520951,4374,41525325,4,0,1,4608,16,3499988506
792,41535920,3898,41539818,5,0,1,4096,19,6855498936
793,41609970,144473,41754443,9,0,0,44544,18,1335981415
794,41678950,81616,41760566,9,0,0,5632,18,5182639828
795,41756930,101348,41858278,1,0,0,32768,6,9639367064
796,41763470,52676,41816146,9,0,0,4096,18,806459226
797,41788059,10757,41798816,3,0,1,17408,2,2040132016
798,41795190,152521,41947711,0,0,0,25600,11,4165574058
799,41822180,151043,41973223,8,0,0,28672,12,894879106
800,41885509,131976,42017485,7,0,0,26624,8,6606067131
801,42036690,69752,42106442,5,0,0,9728,19,9457424492
802,42068990,1994,42070984,0,0,1,2048,11,2243000901
803,42097140,58220,42155360,5,0,0,7168,19,9243907063
804,42147050,99476,42246526,0,0,0,26624,11,8915880308
805,42227110,109304,42336414,0,0,0,58880,11,1076713453
806,42272030,66895,42338925,4,0,0,8192,16,10291360944
807,42316020,63296,42379316,0,0,0,8704,11,3831337299
808,42339340,106930,42446270,9,0,0,30720,18,1846929478
809,42372680,1042,42373722,0,0,1,1024,11,2001102882
810,42376980,142160,42519140,3,0,0,36864,2,7900827414
811,42399510,147800,42547310,9,0,0,23552,18,3570707987
812,42414110,1042,42415152,2,0,1,1024,4,2075301929
813,42421750,76052,42497802,9,0,0,10240,18,10530423780
814,42458600,114084,42572684,0,0,0,8704,11,769324954
815,42546450,61388,42607838,4,0,0,9728,16,3541465078
816,42614200,94532,42708732,4,0,0,20480,16,8157261758
817,42667490,139102,42806592,0,0,0,41984,11,5020250394
818,42921699,3422,42925121,3,0,1,3584,2,3421773860
819,42957671,1518,42959189,4,0,1,1536,16,603735518
820,42969861,118154,43088015,6,0,0,47104,12,7707568065
821,42980731,4850,42985581,4,0,1,5120,16,4456157305
822,42997340,122829,43120169,1,0,0,9728,6,1285047226
823,43042070,78270,43120340,2,0,0,512,4,2702679760
824,43043520,128873,43172393,3,0,0,9728,2,7714156847
825,43044770,1994,43046764,6,0,1,2048,12,7872507629
826,43052270,103923,43156193,3,0,0,27136,2,2740649990
827,43089040,68884,43157924,5,0,0,5632,19,10402974436
828,43183450,102440,43285890,0,0,0,36352,11,4700500212
829,43194790,48980,43243770,9,0,0,2048,18,10116538738
830,43231150,124826,43355976,1,0,0,38400,6,10309771730
831,43323390,59132,43382522,9,0,0,5120,18,259692012
832,43347060,78504,43425564,2,0,0,9216,4,9717062490
833,43464090,106652,43570742,0,0,0,50176,11,1254197264
834,43467050,81284,43548334,0,0,0,12288,11,428374665
835,43635710,55748,43691458,9,0,0,4096,18,6468838590
836,43719140,52364,43771504,0,0,0,3072,11,10195948619
837,43841150,57440,43898590,1,0,0,4608,6,5537128553
838,43906890,70532,43977422,1,0,0,12288,6,8137703948
839,43915700,148515,44064215,4,0,0,38912,16,8792559030
840,43936210,116134,44052344,5,0,0,30208,19,49914616
841,43971200,140783,44111983,8,0,0,29696,12,2010690920
842,43988460,94358,44082818,2,0,0,3072,4,3644164099
843,44008990,93930,44102920,0,0,0,19968,11,9804770604
844,44076200,57116,44133316,4,0,0,1536,16,9452018561
845,44182530,99320,44281850,5,0,0,26112,19,1440983229
846,44225270,74360,44299630,8,0,0,9728,12,8511436096
847,44265550,2946,44268496,2,0,1,3072,4,6776898036
848,44427620,82688,44510308,5,0,0,16896,19,9958569682
849,44461170,3904,44465074,9,0,1,10752,18,4920566235
850,44492590,55748,44548338,1,0,0,4096,6,8730438209
851,44505420,55552,44560972,4,0,0,2560,16,931907116
852,44683110,96848,44779958,1,0,0,23040,6,8606154749
853,44808160,6229,44814389,6,0,1,15360,12,3662330792
854,44814160,47288,44861448,2,0,0,1536,4,1068930051
855,44864000,104780,44968780,9,0,0,44032,18,5007882476
856,44868520,1518,44870038,2,0,1,1536,4,31169730
857,45015180,69284,45084464,8,0,0,8192,12,3092124554
858,45050980,94534,45145514,3,0,0,15872,2,3814130616
859,45069060,64208,45133268,0,0,0,6656,11,5609322251
860,45147250,6754,45154004,5,0,1,7168,19,10036569635
861,45178340,100880,45279220,4,0,0,31232,16,2406287306
862,45216400,64395,45280795,9,0,0,5120,18,6057896613
863,45236420,56528,45292948,2,0,0,6656,4,1488251003
864,45344020,54056,45398076,4,0,0,3584,16,10444349989
865,45433410,54056,45487466,8,0,0,3584,12,8008939073
866,45437250,3904,45441154,2,0,1,10752,4,3923398539
867,45461190,109130,45570320,1,0,0,42496,6,10496075330
868,45468550,118789,45587339,9,0,0,55808,18,1398913463
869,45489130,3645,45492775,0,0,1,10240,11,6073865201
870,45495000,121971,45616971,3,0,0,15360,2,478344878
871,45521430,138638,45660068,4,0,0,37376,16,3086880830
872,45598970,2946,45601916,0,0,1,3072,11,2469991809
873,45681300,88364,45769664,3,0,0,15360,2,1333385445
874,45701480,70695,45772175,2,0,0,8192,4,6139062947
875,45730650,99164,45829814,9,0,0,25600,18,7095341558
876,45773121,5802,45778923,4,0,1,6144,16,9755311941
877,45791799,97307,45889106,7,0,0,23040,8,6578550848
878,45800440,100453,45900893,5,0,0,6656,19,10170492518
879,45881540,60714,45942254,3,0,0,8704,2,636155449
880,45955650,128090,46083740,9,0,0,74752,18,4857149732
881,45969600,90950,46060550,1,0,0,4096,6,3399887191
882,46051480,88700,46140180,2,0,0,21504,4,9383132780
883,46091220,4420,46095640,7,0,1,11776,8,10708919476
884,46137010,193421,46330431,5,0,0,16896,19,442397509
885,46264400,107276,46371676,8,0,0,52224,12,929577899
886,46655600,77744,46733344,1,0,0,10752,6,1357540096
887,46718570,63140,46781710,2,0,0,8192,4,2171962907
888,46731820,86676,46818496,8,0,0,19968,12,4978041990
889,46948610,101660,47050270,4,0,0,33792,16,4063677303
890,46984780,110436,47095216,1,0,0,13824,6,9986152035
891,47030370,79436,47109806,4,0,0,11264,16,1751760423
892,47144700,47288,47191988,3,0,0,1536,2,6706405901
893,47216760,14287,47231047,1,0,1,27648,6,6450666563
894,47261360,86037,47347397,8,0,0,14336,12,1103431513
895,47288830,60824,47349654,2,0,0,5632,4,9712290192
896,47325720,50672,47376392,8,0,0,2560,12,1209012184
897,47338150,102908,47441058,3,0,0,37888,2,2125717584
898,47470470,5712,47476182,5,0,1,14336,19,5364478533
899,47538800,106497,47645297,8,0,0,39424,12,5336099908
900,47550450,82820,47633270,2,0,0,12288,4,3980088512
901,47747080,98615,47845695,0,0,0,21504,11,6177981241
902,47766460,72668,47839128,4,0,0,9216,16,3901894374
903,47815760,69284,47885044,2,0,0,8192,4,1319887366
904,47847060,13341,47860401,2,0,1,22528,4,1833600031
905,47853060,9607,47862667,9,0,1,3584,18,4518036562
906,47864460,90995,47955455,9,0,0,5632,18,5142179661
907,47897040,56684,47953724,3,0,0,7168,2,6986569365
908,47933990,5712,47939702,7,0,1,14336,8,6146611181
909,47952550,96829,48049379,8,0,0,23552,12,4225220993
910,47955790,101265,48057055,4,0,0,17920,16,4906069984
911,48020600,1042,48021642,7,0,1,1024,8,9183174083
912,48020630,66040,48086670,0,0,0,512,11,4989629655
913,48125560,50672,48176232,2,0,0,2560,4,9197001418
914,48135250,106808,48242058,3,0,0,50688,2,1869683586
915,48171650,132071,48303721,4,0,0,13824,16,5904120448
916,48172300,4374,48176674,9,0,1,4608,18,5834079361
917,48315151,2870,48318021,4,0,1,8704,16,7474922622
918,48362340,64208,48426548,3,0,0,6656,2,8018916708
919,48395000,74360,48469360,3,0,0,9728,2,3641764140
920,48396550,566,48397116,5,0,1,512,19,3648501772
921,48397300,79528,48476828,8,0,0,3072,12,1472534896
922,48419290,7273,48426563,6,0,1,6656,12,8566130744
923,48503260,86984,48590244,2,0,0,15872,4,6682632760
924,48509820,115752,48625572,3,0,0,15872,2,6747816245
925,48772500,84980,48857480,5,0,0,14336,19,10133760226
926,48821180,47288,48868468,8,0,0,1536,12,992666291
927,48865610,81752,48947362,5,0,0,13824,19,4680288730
928,48875940,5802,48881742,1,0,1,6144,6,7432547839
929,49127050,62516,49189566,1,0,0,6144,6,5303175203
930,49150310,104936,49255246,1,0,0,44544,6,2509632116
931,49214829,6488,49221317,5,0,1,15872,19,2122581577
932,49241890,217184,49459074,3,0,0,45568,2,7367442464
933,49332480,47444,49379924,4,0,0,2048,16,4998482651
934,49351930,1994,49353924,7,0,1,2048,8,4808360432
935,49355780,74442,49430222,3,0,0,9728,2,330729615
936,49361060,164344,49525404,3,0,0,65536,2,6895289303
937,49399180,4850,49404030,0,0,1,5120,11,3671755168
938,49410590,92450,49503040,0,0,0,2560,11,9901872429
939,49512650,84658,49597308,2,0,0,11776,4,6138557132
940,49704370,75764,49780134,9,0,0,14336,18,3176112726
941,49798629,11791,49810420,5,0,1,19456,19,9676893536
942,50033890,5454,50039344,9,0,1,13824,18,7653610975
943,50160310,134397,50294707,2,0,0,76800,4,4372336812
944,50266500,50672,50317172,8,0,0,2560,12,6135485685
945,50270190,112892,50383082,3,0,0,70656,2,3011144500
946,50307150,152444,50459594,0,0,0,27136,11,4050131752
947,50432760,105248,50538008,9,0,0,45568,18,3848234170
948,50477530,4850,50482380,9,0,1,5120,18,6375385841
949,50627530,1042,50628572,5,0,1,1024,19,3962848067
950,50642501,1042,50643543,4,0,1,1024,16,5507514061
951,50689470,69284,50758754,4,0,0,8192,16,8404674474
952,50743880,95468,50839348,4,0,0,23552,16,1567508258
953,50853100,58064,50911164,9,0,0,6656,18,8955993496
954,50951720,47288,50999008,4,0,0,1536,16,5228274243
955,51026610,99788,51126398,3,0,0,27648,2,8813656006
956,51054180,2870,51057050,5,0,1,8704,19,636981100
957,51056810,84295,51141105,2,0,0,16896,4,7780036756
958,51083620,148943,51232563,3,0,0,89088,2,3527081039
959,51134660,118033,51252693,4,0,0,17920,16,7892736896
960,51169780,145835,51315615,8,0,0,31744,12,5115591737
961,51278040,4679,51282719,1,0,1,12288,6,8079086195
962,51463530,2470,51466000,7,0,1,2560,8,2800595495
963,51642061,4374,51646435,4,0,1,4608,16,3043314880
964,51658889,45596,51704485,7,0,0,1024,8,1580394105
965,51692100,111488,51803588,3,0,0,66048,2,7893170632
966,51724321,142933,51867254,6,0,0,41984,12,7999678186
967,51747200,87896,51835096,9,0,0,13824,18,2123870787
968,51825920,4374,51830294,1,0,1,4608,6,457980573
969,51939590,100880,52040470,9,0,0,31232,18,4517252973
970,52103350,54056,52157406,8,0,0,3584,12,8409073277
971,52120970,5326,52126296,7,0,1,5632,8,7411712110
972,52175090,149223,52324313,2,0,0,6144,4,7267319471
973,52221510,72668,52294178,9,0,0,9216,18,807408773
974,52236140,67592,52303732,9,0,0,7680,18,7556960583
975,52307650,72668,52380318,0,0,0,9216,11,1667179846
976,52337680,57440,52395120,9,0,0,4608,18,2247368655
977,52376210,7706,52383916,1,0,1,8192,6,6411260780
978,52387450,88076,52475526,2,0,0,19456,4,3359111749
979,52531190,45596,52576786,5,0,0,1024,19,747017235
980,52561680,54056,52615736,5,0,0,3584,19,7532331966
981,52613100,4937,52618037,2,0,1,12800,4,2092491175
982,52618680,2946,52621626,7,0,1,3072,8,9187499006
983,52824510,5326,52829836,1,0,1,5632,6,844896028
984,53000609,1994,53002603,3,0,1,2048,2,1319199925
985,53030070,54524,53084594,0,0,0,5120,11,9675327381
986,53166250,54056,53220306,5,0,0,3584,19,3606309771
987,53178419,3422,53181841,8,0,1,3584,12,166255305
988,53208600,103510,53312110,8,0,0,27136,12,2869991990
989,53347330,2946,53350276,2,0,1,3072,4,4428321198
990,53398840,68996,53467836,5,0,0,12288,19,5666982063
991,53443490,2470,53445960,5,0,1,2560,19,6781482651
992,53532230,64208,53596438,3,0,0,6656,2,3732813290
993,53570610,81128,53651738,5,0,0,11776,19,7231538557
994,53600270,105248,53705518,2,0,0,45568,4,8427502593
995,53714590,5971,53720561,6,0,1,14848,12,3631004184
996,53743780,3898,53747678,9,0,1,4096,18,8270477510
997,53772050,64921,53836971,2,0,0,4608,4,6950812197
998,53787350,2470,53789820,1,0,1,2560,6,9921255792
999,53794410,52364,53846774,8,0,0,3072,12,2260835234
1000,53856840,101816,53958656,9,0,0,34304,18,5746697479
1001,53953841,106935,54060776,6,0,0,35328,12,6547392225
1002,53975880,59132,54035012,3,0,0,5120,2,8460861902
1003,53984330,2470,53986800,9,0,1,2560,18,3599893426
1004,54045891,56429,54102320,6,0,0,3072,12,4740926257
1005,54054030,76334,54130364,2,0,0,9216,4,3032186909
1006,54056910,122084,54178994,3,0,0,21504,2,5781991684
1007,54084980,62828,54147808,9,0,0,7168,18,1077155252
1008,54109350,102908,54212258,9,0,0,37888,18,4956551248
1009,54191610,125216,54316826,0,0,0,81408,11,1761833069
1010,54243911,77067,54320978,6,0,0,2048,12,6378660589
1011,54295110,138188,54433298,2,0,0,82432,4,9741514813
1012,54336350,143604,54479954,0,0,0,74240,11,5794387210
1013,54357990,129806,54487796,9,0,0,3072,18,1087995498
1014,54391660,143140,54534800,5,0,0,36352,19,3878317847
1015,54395080,238264,54633344,2,0,0,71168,4,5166229969
1016,54468120,196664,54664784,3,0,0,28160,2,2053848545
1017,54483500,206082,54689582,8,0,0,68096,12,9980031524
1018,54726999,10241,54737240,3,0,1,16384,2,994295079
1019,54751080,51140,54802220,8,0,0,4096,12,4833087225
1020,54777320,82722,54860042,4,0,0,11264,16,9615995554
1021,54792320,59132,54851452,5,0,0,5120,19,5625112421
1022,54925839,3898,54929737,5,0,1,4096,19,547431916
1023,54981690,5802,54987492,0,0,1,6144,11,9385084461
1024,55054280,116948,55171228,8,0,0,83968,12,5354473763
1025,55093240,90570,55183810,1,0,0,8192,6,2255967704
1026,55187040,2946,55189986,7,0,1,3072,8,2898050229
1027,55262800,54056,55316856,8,0,0,3584,12,6461138931
1028,55291751,57859,55349610,6,0,0,4096,12,4561154276
1029,55333430,42424,55375854,6,0,1,69120,12,3251291602
1030,55450690,80996,55531686,5,0,0,16384,19,10660894789
1031,55502920,91538,55594458,9,0,0,23552,18,5226125736
1032,55576120,31524,55607644,6,0,1,51200,12,6961658795
1033,55612860,64208,55677068,2,0,0,6656,4,8694079085
1034,55642770,217477,55860247,8,0,0,24064,12,5311101631
1035,55693560,149143,55842703,0,0,0,16896,11,5102013481
1036,55709800,75320,55785120,9,0,0,17920,18,6384986156
1037,55714880,566,55715446,1,0,1,512,6,9365458338
1038,55800990,118171,55919161,4,0,0,34816,16,4151686018
1039,55854400,104637,55959037,4,0,0,7168,16,6998379445
1040,56046840,62516,56109356,4,0,0,6144,16,509176907
1041,56255130,99476,56354606,9,0,0,26624,18,7096911996
1042,56448110,5196,56453306,6,0,1,13312,12,5286950974
1043,56609411,50672,56660083,6,0,0,2560,12,1629658286
1044,56624709,1042,56625751,3,0,1,1024,2,657412777
1045,56627930,4937,56632867,9,0,1,12800,18,3395906982
1046,56752390,101192,56853582,8,0,0,32256,12,10230443753
1047,56789541,88839,56878380,6,0,0,6656,12,123338234
1048,56822740,1994,56824734,2,0,1,2048,4,4220837649
1049,56890671,102596,56993267,6,0,0,36864,12,2487144833
1050,56895120,99098,56994218,0,0,0,3072,11,4512770975
1051,56909390,5454,56914844,0,0,1,13824,11,4223321699
1052,56933380,172891,57106271,8,0,0,77824,12,6375605168
1053,56948229,3422,56951651,3,0,1,3584,2,10490027435
1054,57092459,66629,57159088,3,0,1,86016,2,2578048156
1055,57096440,87772,57184212,3,0,0,16384,2,4474379826
1056,57110590,172299,57282889,8,0,0,31232,12,3869267653
1057,57189420,259588,57449008,5,0,0,58368,19,7765674399
1058,57195610,50672,57246282,8,0,0,2560,12,3973509037
1059,57274309,62325,57336634,3,0,1,91136,2,7511169197
1060,57413410,77046,57490456,8,0,0,5632,12,9951025179
1061,57493429,11791,57505220,3,0,1,19456,2,4457286767
1062,57495819,87803,57583622,3,0,1,137216,2,7716470322
1063,57511400,145259,57656659,8,0,0,12288,12,445212916
1064,57554030,200469,57754499,2,0,0,10240,4,5784263062
1065,57616700,88122,57704822,8,0,0,11776,12,5041389177
1066,57673990,60980,57734970,5,0,0,6144,19,6470055420
1067,57762800,158730,57921530,0,0,0,32768,11,3128151005
1068,57763060,12049,57775109,7,0,1,19968,8,9221201204
1069,57769410,130336,57899746,4,0,0,17408,16,523704813
1070,57789770,114203,57903973,0,0,0,13824,11,1603971739
1071,57797800,5971,57803771,5,0,1,14848,19,7759817955
1072,57930340,102284,58032624,0,0,0,35840,11,8737550162
1073,57985220,86362,58071582,5,0,0,16384,19,5649942386
1074,58005181,2946,58008127,4,0,1,3072,16,8361602756
1075,58024891,71789,58096680,6,0,0,5120,12,9894872030
1076,58092800,107588,58200388,8,0,0,53248,12,210337587
1077,58178440,62516,58240956,0,0,0,6144,11,8344547969
1078,58226560,43904,58270464,4,0,0,512,16,1825549374
1079,58326430,103220,58429650,0,0,0,38912,11,949479800
1080,58478830,3898,58482728,0,0,1,4096,11,8228117374
1081,58504840,48980,58553820,0,0,0,2048,11,3489220490
1082,58534700,91796,58626496,2,0,0,26624,4,793782823
1083,58550790,99320,58650110,3,0,0,26112,2,9474146042
1084,59009260,6278,59015538,7,0,1,6656,8,9870440860
1085,59016550,100724,59117274,4,0,0,30720,16,8860619505
1086,59087490,64272,59151762,0,0,0,512,11,8937107959
1087,59112060,62646,59174706,8,0,0,4608,12,6882371133
1088,59195020,109750,59304770,4,0,0,56832,16,3437715401
1089,59216400,159548,59375948,5,0,0,62464,19,10532131277
1090,59243480,11016,59254496,7,0,1,17920,8,2413473994
1091,59299859,84807,59384666,7,0,0,12800,8,1424346045
1092,59403810,109438,59513248,4,0,0,58368,16,10095976368
1093,59404100,67902,59472002,8,0,0,4608,12,4485594931
1094,59583800,123344,59707144,5,0,0,104960,19,5328058447
1095,59594700,124462,59719162,0,0,0,7168,11,6545643905
1096,59626050,2946,59628996,5,0,1,3072,19,7419371618
1097,59640660,137128,59777788,5,0,0,87552,19,9877266906
1098,59693960,100244,59794204,8,0,0,3072,12,5164607940
1099,59711630,102278,59813908,2,0,0,12288,4,8149721066
1100,59755300,100224,59855524,2,0,0,10752,4,3810070271
1101,59783941,61136,59845077,6,0,0,6656,12,3193129341
1102,59786790,100724,59887514,3,0,0,30720,2,163130775
1103,59837210,125382,59962592,8,0,0,49152,12,6249123175
1104,59864470,45596,59910066,0,0,0,1024,11,10381698566
1105,59881759,8693,59890452,8,0,1,3072,12,9334816148
1106,59946970,83156,60030126,3,0,0,18432,2,3297710610
1107,60011110,6278,60017388,2,0,1,6656,4,10672309471
1108,60018880,236379,60255259,2,0,0,99840,4,5446281612
1109,60103021,5971,60108992,4,0,1,14848,16,1427326568
1110,60116240,195746,60311986,2,0,0,56832,4,112855542
1111,60226120,93363,60319483,5,0,0,11776,19,2210446772
1112,60258870,99632,60358502,5,0,0,27136,19,1702308153
1113,60333570,108368,60441938,4,0,0,55808,16,7290734792
1114,60380531,101049,60481580,6,0,0,18432,12,9249705708
1115,60399510,147338,60546848,2,0,0,81408,4,10532824698
1116,60530880,128072,60658952,1,0,0,68096,6,9116098042
1117,60643291,125581,60768872,6,0,0,60928,12,2993809573
1118,60727150,1518,60728668,7,0,1,1536,8,6686858437
1119,60758370,16982,60775352,0,0,1,15872,11,3872616274
1120,60881750,2946,60884696,7,0,1,3072,8,2455091680
1121,61040620,89768,61130388,0,0,0,19968,11,1901916308
1122,61081100,132478,61213578,5,0,0,65024,19,88765267
1123,61185360,117825,61303185,0,0,0,26112,11,6792437237
1124,61189731,105483,61295214,6,0,0,33280,12,4274097970
1125,61232870,92506,61325376,4,0,0,5120,16,4156336683
1126,61235530,123314,61358844,0,0,0,34304,11,6838587457
1127,61319240,109768,61429008,3,0,0,45568,2,2521011162
1128,61405550,110084,61515634,4,0,0,61440,16,8032817743
1129,61456210,98088,61554298,2,0,0,4608,4,2618276116
1130,61545520,102284,61647804,4,0,0,35840,16,2104440701
1131,61627101,1518,61628619,4,0,1,1536,16,3048399130
1132,61632680,77744,61710424,5,0,0,10752,19,6889283520
1133,61679040,69440,61748480,4,0,0,8704,16,9113866316
1134,61710650,79772,61790422,9,0,0,17408,18,8124503271
1135,61723920,2470,61726390,2,0,1,2560,4,1611589848
1136,61767840,68996,61836836,5,0,0,12288,19,5917573263
1137,61800950,44928,61845878,2,0,0,512,4,9785025455
1138,61952930,76076,62029006,4,0,0,15360,16,1600490357
1139,61986760,47288,62034048,4,0,0,1536,16,2762048602
1140,62128301,3904,62132205,4,0,1,10752,16,4103985033
1141,62255710,102596,62358306,8,0,0,36864,12,4396885788
1142,62305180,153014,62458194,0,0,0,65024,11,2622819690
1143,62526531,63140,62589671,6,0,0,8192,12,390049244
1144,62647811,2946,62650757,4,0,1,3072,16,3935575710
1145,62650660,1518,62652178,1,0,1,1536,6,6435294763
1146,62697250,125807,62823057,4,0,0,7168,16,178221865
1147,62868101,108836,62976937,6,0,0,57344,12,10725050885
1148,62885880,143641,63029521,3,0,0,68608,2,3158437844
1149,62989299,96321,63085620,3,0,1,160768,2,670761323
1150,63069891,225514,63295405,6,0,0,11776,12,7975618905
1151,63237870,3387,63241257,2,0,1,9728,4,7003103059
1152,63276620,211636,63488256,3,0,0,41984,2,148437057
1153,63382050,84848,63466898,8,0,0,18944,12,1596996563
1154,63473301,60692,63533993,6,0,0,10240,12,9325581554
1155,63505310,5971,63511281,9,0,1,14848,18,2580474774
1156,63580530,115279,63695809,6,0,1,190976,12,798671228
1157,63591030,237956,63828986,0,0,0,8704,11,3057637827
1158,63646420,101624,63748044,8,0,0,6144,12,367465562
1159,63646800,221775,63868575,0,0,0,39424,11,1586447059
1160,63698320,1518,63699838,5,0,1,1536,19,2355641380
1161,63707820,4679,63712499,2,0,1,12288,4,2162325206
1162,63774170,75858,63850028,1,0,0,1024,6,471564243
1163,63840630,71000,63911630,3,0,0,13824,2,10239208720
1164,63860400,88436,63948836,1,0,0,13824,6,4805762611
1165,63968390,100568,64068958,2,0,0,30208,4,4134681460
1166,64130520,72224,64202744,2,0,0,12800,4,962147055
1167,64193720,87624,64281344,1,0,0,21504,6,10736015109
1168,64222360,1042,64223402,2,0,1,1024,4,3022066829
1169,64316761,114296,64431057,6,0,0,75264,12,703713180
1170,64378060,73472,64451532,2,0,0,16896,4,10005474602
1171,64478580,98072,64576652,2,0,0,22016,4,3837476885
1172,64540700,90480,64631180,1,0,0,7168,6,9305757905
1173,64584471,76547,64661018,6,0,0,8192,12,2910237149
1174,64627900,50672,64678572,0,0,0,2560,11,3869170065
1175,64648630,101036,64749666,1,0,0,31744,6,837528221
1176,64749841,52364,64802205,6,0,0,3072,12,7972474390
1177,64927630,104468,65032098,2,0,0,43008,4,7619613076
1178,64993961,78236,65072197,6,0,0,17408,12,5810681200
1179,65073170,84668,65157838,1,0,0,13312,6,6265378940
1180,65079520,566,65080086,0,0,1,512,11,8079593371
1181,65161150,91148,65252298,0,0,0,19456,11,2105287427
1182,65182390,566,65182956,5,0,1,512,19,1234494644
1183,65284290,105716,65390006,3,0,0,47104,2,4320889209
1184,65363760,4937,65368697,7,0,1,12800,8,4184797401
1185,65392580,98540,65491120,0,0,0,23552,11,1470653013
1186,65447900,2946,65450846,9,0,1,3072,18,9361286634
1187,65519199,54056,65573255,7,0,0,3584,8,1075019339
1188,65638660,85916,65724576,9,0,0,17408,18,3976038422
1189,65679510,94820,65774330,2,0,0,16384,4,6188532988
1190,65692520,5196,65697716,7,0,1,13312,8,1281411927
1191,65706280,5971,65712251,9,0,1,14848,18,7258782890
1192,65744429,405891,66150320,3,0,1,656896,2,96999113
1193,65772580,411112,66183692,8,0,0,5120,12,7126135316
1194,65868660,238912,66107572,2,0,0,5632,4,6596062496
1195,65912740,247855,66160595,6,0,1,20992,12,2438637872
1196,65925540,235040,66160580,4,0,0,22528,16,10050381416
1197,66017770,193132,66210902,5,0,0,2560,19,6422501918
1198,66038500,231106,66269606,3,0,0,14848,2,3389260994
1199,66343560,54056,66397616,2,0,0,3584,4,3125952116
1200,66454220,101660,66555880,2,0,0,33792,4,2855809819
1201,66482640,47288,66529928,4,0,0,1536,16,8977352680
1202,66503710,100100,66603810,2,0,0,28672,4,7102281973
1203,66555340,109164,66664504,1,0,0,25088,6,6113634591
1204,66604001,102440,66706441,6,0,0,36352,12,1657237429
1205,66644000,112907,66756907,3,0,0,14336,2,1822239944
1206,66653500,11019,66664519,7,0,1,10752,8,9384170056
1207,66696740,55289,66752029,0,0,0,1024,11,9734169271
1208,66751620,31007,66782627,9,0,1,50176,18,9147764774
1209,66755950,135175,66891125,1,0,0,15872,6,3344215537
1210,66790930,115555,66906485,1,0,0,15872,6,6648229985
1211,66839600,86391,66925991,8,0,0,8192,12,2715350749
1212,66868250,144675,67012925,4,0,0,65536,16,2887948462
1213,66868840,115464,66984304,5,0,0,26624,19,8117484335
1214,67009900,68917,67078817,8,0,0,7168,12,7475542468
1215,67147090,113335,67260425,2,0,0,30208,4,8227378357
1216,67156230,94976,67251206,3,0,0,16896,2,8968426109
1217,67282870,3898,67286768,5,0,1,4096,19,6953950661
1218,67391950,62516,67454466,8,0,0,6144,12,463644290
1219,67416090,135450,67551540,2,0,0,96768,4,9600927253
1220,67439430,150122,67589552,0,0,0,41472,11,9240108578
1221,67467310,1042,67468352,9,0,1,1024,18,152377035
1222,67475160,100166,67575326,4,0,0,13824,16,3048752071
1223,67532310,123534,67655844,4,0,0,42496,16,3470219635
1224,67606110,147571,67753681,0,0,0,31744,11,7692522925
1225,67651470,107850,67759320,4,0,0,18432,16,7099972988
1226,67712610,82220,67794830,1,0,0,15360,6,2634276200
1227,67731490,53696,67785186,5,0,0,2560,19,9209744024
1228,67745760,90036,67835796,8,0,0,11264,12,5418453132
1229,67792530,68660,67861190,2,0,0,8704,4,8844861454
1230,67842691,4374,67847065,4,0,1,4608,16,1177701295
1231,67873330,43904,67917234,2,0,0,512,4,1189253531
1232,67873800,104936,67978736,8,0,0,44544,12,1752571908
1233,67875350,65900,67941250,5,0,0,7168,19,8638628014
1234,67888360,5326,67893686,9,0,1,5632,18,9282379480
1235,67959270,106652,68065922,0,0,0,50176,11,595944587
1236,68048091,56684,68104775,6,0,0,7168,12,3164863575
1237,68067580,100256,68167836,3,0,0,29184,2,5735245469
1238,68106220,88022,68194242,3,0,0,18944,2,4707822288
1239,68143400,109148,68252548,0,0,0,58368,11,3379393793
1240,68176540,118105,68294645,2,0,0,2048,4,7862709151
1241,68210190,13253,68223443,7,0,1,25600,8,7438349470
1242,68235490,221039,68456529,0,0,0,16384,11,191819974
1243,68335080,89168,68424248,1,0,0,23040,6,4459847915
1244,68346750,1518,68348268,2,0,1,1536,4,6572617949
1245,68492520,566,68493086,2,0,1,512,4,585559736
1246,68500920,102284,68603204,3,0,0,35840,2,2206021800
1247,68518690,107440,68626130,4,0,0,4096,16,2412667092
1248,68532670,93943,68626613,1,0,0,1536,6,987620585
1249,68638990,65900,68704890,2,0,0,7168,4,4260819726
1250,68691260,2870,68694130,7,0,1,8704,8,1003467303
1251,68793420,106340,68899760,4,0,0,49152,16,8385038094
1252,68833340,147738,68981078,5,0,0,88064,19,9081515483
1253,68993041,3645,68996686,4,0,1,10240,16,6771289472
1254,68996760,49925,69046685,0,0,0,2048,11,5534302892
1255,69007340,1042,69008382,9,0,1,1024,18,5040110034
1256,69105810,94220,69200030,2,0,0,19456,4,6705563807
1257,69150350,1518,69151868,7,0,1,1536,8,6673559374
1258,69182350,6754,69189104,2,0,1,7168,4,8487443777
1259,69244990,101816,69346806,3,0,0,34304,2,5967022133
1260,69273490,209864,69483354,5,0,0,4096,19,1001577698
1261,69305560,45596,69351156,8,0,0,1024,12,1476394670
1262,69307540,132446,69439986,0,0,0,40448,11,5591988956
1263,69361320,5326,69366646,2,0,1,5632,4,6976961585
1264,69411880,184669,69596549,0,0,0,14336,11,7748174875
1265,69423550,219815,69643365,0,0,0,49152,11,7308995641
1266,69428731,75323,69504054,6,0,0,11264,12,442438070
1267,69448251,86204,69534455,6,0,0,13312,12,3747033377
1268,69484560,143814,69628374,8,0,0,59392,12,10736172878
1269,69487160,1042,69488202,6,0,1,1024,12,7653710833
1270,69578880,68207,69647087,1,0,0,7680,6,1562426544
1271,69590321,113496,69703817,6,0,0,11264,12,5199477664
1272,69593800,64969,69658769,5,0,0,10240,19,4597309267
1273,69627380,200271,69827651,8,0,0,43520,12,918261150
1274,69629930,135491,69765421,5,0,0,54272,19,2314363042
1275,69637740,85883,69723623,3,0,0,13824,2,8538180710
1276,69650390,8394,69658784,7,0,1,8192,8,4329308864
1277,69727959,37477,69765436,3,0,1,34304,2,565950925
1278,69730080,192080,69922160,0,0,0,82432,11,8031931221
1279,69759890,284658,70044548,0,0,0,28160,11,8365983935
1280,69776291,205986,69982277,6,0,0,24576,12,3167312899
1281,69792181,136398,69928579,6,0,0,20992,12,7508343948
1282,69802330,172444,69974774,5,0,0,27136,19,2491264959
1283,69816840,166544,69983384,2,0,0,3584,4,2751183068
1284,69912860,17196,69930056,7,0,1,1536,8,1698648812
1285,69943710,2946,69946656,5,0,1,3072,19,2244467227
1286,69945970,147469,70093439,2,0,0,59392,4,5716592929
1287,69999590,72837,70072427,3,0,0,512,2,3134151469
1288,70044670,134684,70179354,2,0,0,34304,4,451442753
1289,70230830,89144,70319974,5,0,0,17920,19,207221093
1290,70254920,100526,70355446,3,0,0,15872,2,7484282826
1291,70265390,98384,70363774,8,0,0,23040,12,6092556441
1292,70502930,3128,70506058,6,0,1,9216,12,4246475382
1293,70515120,1042,70516162,2,0,1,1024,4,1459977378
1294,70558720,3422,70562142,2,0,1,3584,4,2948703346
1295,70575411,97292,70672703,6,0,0,19456,12,9229283734
1296,70628470,82153,70710623,5,0,0,512,19,1561665408
1297,70690540,71912,70762452,1,0,0,11776,6,4229802221
1298,70727780,81094,70808874,1,0,0,11776,6,6772642381
1299,70760320,102848,70863168,4,0,0,30720,16,9468102812
1300,70889250,6488,70895738,0,0,1,15872,11,5734282539
1301,70897519,98228,70995747,7,0,0,22528,8,5713617501
1302,70963410,72723,71036133,0,0,0,12800,11,5154960495
1303,70974001,177807,71151808,6,0,0,72192,12,3895637977
1304,71004910,155337,71160247,0,0,0,27648,11,3041175529
1305,71191550,103064,71294614,2,0,0,38400,4,3497795401
1306,71195391,109534,71304925,6,0,0,33792,12,2920010190
1307,71257290,125668,71382958,1,0,0,28672,6,8703964998
1308,71368260,107566,71475826,8,0,0,33792,12,8517892400
1309,71419130,109862,71528992,8,0,0,30720,12,880301664
1310,71433190,166356,71599546,1,0,0,34304,6,8266970712
1311,71508150,158674,71666824,8,0,0,27136,12,2370644825
1312,71536910,1042,71537952,2,0,1,1024,4,8287321012
1313,71635440,87008,71722448,2,0,0,20992,4,2058383567
1314,71777080,2946,71780026,2,0,1,3072,4,6306543698
1315,71920270,97916,72018186,2,0,0,21504,4,4281956796
1316,71941870,5802,71947672,7,0,1,6144,8,2922555960
1317,71989470,4162,71993632,1,0,1,11264,6,10058922220
1318,72013970,146363,72160333,1,0,0,19968,6,8826040908
1319,72084650,3422,72088072,9,0,1,3584,18,5024760079
1320,72097060,4162,72101222,5,0,1,11264,19,4362503404
1321,72133660,73384,72207044,0,0,0,4608,11,10052271322
1322,72172329,196795,72369124,3,0,1,323072,2,4043032239
1323,72205810,266117,72471927,0,0,0,35328,11,5819092191
1324,72264920,293134,72558054,0,0,0,18432,11,91433427
1325,72286841,83461,72370302,4,0,1,13824,16,7369491879
1326,72325700,195154,72520854,8,0,0,12288,12,10203451592
1327,72355830,19298,72375128,0,0,1,7680,11,1020029429
1328,72583800,100724,72684524,5,0,0,30720,19,5282648785
1329,72686360,43904,72730264,1,0,0,512,6,508064126
1330,72844530,45596,72890126,5,0,0,1024,19,6089310098
1331,72845520,67592,72913112,3,0,0,7680,2,10173067842
1332,72875980,49292,72925272,1,0,0,3072,6,8707191770
1333,72951550,54056,73005606,8,0,0,3584,12,3034059621
1334,73000120,5501,73005621,1,0,1,5632,6,6076607939
1335,73066711,5326,73072037,4,0,1,5632,16,1042691656
1336,73069980,77744,73147724,5,0,0,10752,19,2767992294
1337,73096960,3898,73100858,2,0,1,4096,4,7421000820
1338,73101620,213089,73314709,1,0,0,40960,6,1336694091
1339,73116310,93624,73209934,3,0,0,4096,2,10607156797
1340,73153410,95938,73249348,3,0,0,16384,2,8025450066
1341,73268500,94497,73362997,1,0,0,5632,6,4906788036
1342,73300330,45596,73345926,3,0,0,1024,2,9407002402
1343,73392110,10757,73402867,6,0,1,17408,12,6178596396
1344,73475120,82820,73557940,4,0,0,12288,16,6047086597
1345,73518260,130804,73649064,0,0,0,80896,11,10451731371
1346,73522300,82220,73604520,1,0,0,15360,6,8138957717
1347,73529950,152102,73682052,8,0,0,73216,12,4956897830
1348,73621300,2870,73624170,2,0,1,8704,4,1081986002
1349,73641570,17727,73659297,9,0,1,16384,18,10174954121
1350,73699970,78992,73778962,3,0,0,14848,2,4820791894
1351,73706750,2870,73709620,6,0,1,8704,12,1590703349
1352,73859080,101348,73960428,2,0,0,32768,4,2309880985
1353,73881379,101882,73983261,3,0,1,164864,2,4590949177
1354,73882950,105496,73988446,6,0,1,16384,12,5746101809
1355,73967530,21070,73988600,2,0,1,8704,4,2332490993
1356,74048000,4374,74052374,6,0,1,4608,12,7577291093
1357,74051450,174484,74225934,2,0,0,6656,4,9363228998
1358,74100150,101660,74201810,8,0,0,33792,12,9085015251
1359,74138090,2470,74140560,5,0,1,2560,19,5496253723
1360,74270750,77900,74348650,4,0,0,11264,16,5806721065
1361,74283210,45596,74328806,1,0,0,1024,6,2846864025
1362,74354840,106340,74461180,8,0,0,49152,12,6036088613
1363,74403370,116118,74519488,3,0,0,21504,2,8400285348
1364,74424000,110635,74534635,8,0,0,49664,12,44323387
1365,74441590,101328,74542918,1,0,0,27136,6,8572821974
1366,74506420,90548,74596968,1,0,0,17408,6,4939113941
1367,74540870,62864,74603734,5,0,0,5632,19,9476689604
1368,74555230,85472,74640702,3,0,0,20992,2,2094883623
1369,74559380,114970,74674350,4,0,0,68608,16,5246845811
1370,74641260,7230,74648490,1,0,1,7680,6,513355058
1371,74740970,3904,74744874,6,0,1,10752,12,5703996943
1372,74772550,63608,74836158,4,0,0,9728,16,8381516405
1373,74777460,6278,74783738,0,0,1,6656,11,4863648514
1374,74813951,57440,74871391,6,0,0,4608,12,10330669229
1375,74940721,77744,75018465,6,0,0,10752,12,5434919911
1376,74977180,56216,75033396,8,0,0,5632,12,2310827703
1377,75012820,115232,75128052,2,0,0,78336,4,6980850262
1378,75013891,158471,75172362,6,0,0,20992,12,6173895279
1379,75053210,136294,75189504,5,0,0,512,19,4984824213
1380,75100790,27285,75128075,1,0,1,16896,6,5484654130
1381,75102630,102901,75205531,4,0,0,7680,16,4168190234
1382,75175940,203001,75378941,1,0,0,30720,6,3651512611
1383,75211600,47288,75258888,3,0,0,1536,2,8381434283
1384,75253210,72668,75325878,0,0,0,9216,11,10188390945
1385,75328761,98696,75427457,6,0,0,24064,12,2618829493
1386,75357090,158837,75515927,3,0,0,81408,2,235325216
1387,75397300,69284,75466584,4,0,0,8192,16,9073560073
1388,75464840,51266,75516106,2,0,0,512,4,1405570824
1389,75486890,68528,75555418,3,0,0,10752,2,4027927023
1390,75508270,54937,75563207,3,0,0,1536,2,4441329732
1391,75524500,87048,75611548,2,0,0,17408,4,7312098320
1392,75557019,1042,75558061,8,0,1,1024,12,1586103903
1393,75566450,101192,75667642,5,0,0,32256,19,6349304227
1394,75599931,108385,75708316,6,0,0,35328,12,1662120044
1395,75631680,92794,75724474,8,0,0,1536,12,1857837554
1396,75778370,59132,75837502,3,0,0,5120,2,1954570376
1397,75856810,3422,75860232,6,0,1,3584,12,6080523796
1398,75871030,99788,75970818,2,0,0,27648,4,6625298426
1399,75899020,101972,76000992,0,0,0,34816,11,3382098028
1400,75935860,82298,76018158,0,0,0,19456,11,9909083308
1401,75957930,12903,75970833,6,0,1,8192,12,9030013966
1402,76056250,70976,76127226,4,0,0,8704,16,3872202635
1403,76059480,110784,76170264,1,0,0,7680,6,3600323456
1404,76093880,73136,76167016,5,0,0,10752,19,9968180153
1405,76094670,566,76095236,2,0,1,512,4,2583980832
1406,76182181,65900,76248081,6,0,0,7168,12,8416945059
1407,76265170,57440,76322610,0,0,0,4608,11,10584123719
1408,76329310,4374,76333684,2,0,1,4608,4,6519766598
1409,76335250,91148,76426398,8,0,0,19456,12,2003404451
1410,76496290,106808,76603098,2,0,0,50688,4,9919301462
1411,76513939,2870,76516809,5,0,1,8704,19,2578879502
1412,76587670,16462,76604132,9,0,1,1024,18,4205943835
1413,76630690,141395,76772085,4,0,0,41984,16,8659267624
1414,76647961,108368,76756329,6,0,0,55808,12,7330325614
1415,76712350,84173,76796523,8,0,0,5120,12,3167830895
1416,76727531,58220,76785751,6,0,0,7168,12,6938339796
1417,76764900,10616,76775516,6,0,1,3584,12,7876816262
1418,76770580,56381,76826961,3,0,0,3072,2,277593030
1419,76913180,127400,77040580,8,0,0,118272,12,6232364431
1420,76954629,7230,76961859,5,0,1,7680,19,2883089261
1421,77070040,3422,77073462,7,0,1,3584,8,818827001
1422,77195980,101660,77297640,3,0,0,33792,2,185344666
1423,77199180,116160,77315340,3,0,0,41472,2,8507870158
1424,77254810,216777,77471587,2,0,0,67072,4,2872246267
1425,77258330,4162,77262492,6,0,1,11264,12,9947061982
1426,77288240,191474,77479714,2,0,0,26624,4,1920277311
1427,77481241,107276,77588517,6,0,0,52224,12,2234936174
1428,77513880,1518,77515398,1,0,1,1536,6,9155586429
1429,77529050,91747,77620797,4,0,0,9728,16,1795407294
1430,77648641,50672,77699313,6,0,0,2560,12,9723721321
1431,77668330,118820,77787150,8,0,0,90112,12,5972098516
1432,77742090,69912,77812002,0,0,0,3072,11,9464032737
1433,77764540,127850,77892390,8,0,0,45568,12,5432649953
1434,77805990,90315,77896305,1,0,0,12800,6,5307687874
1435,77812080,202406,78014486,1,0,0,116736,6,4818585560
1436,77822700,95804,77918504,4,0,0,29696,16,5441797473
1437,77829620,566,77830186,9,0,1,512,18,8615329772
1438,77975510,100100,78075610,0,0,0,28672,11,2537061048
1439,77998570,22186,78020756,0,0,1,6656,11,9312470812
1440,78068440,139379,78207819,2,0,0,8704,4,4040623393
1441,78170330,65900,78236230,2,0,0,7168,4,3484976752
1442,78199610,91280,78290890,5,0,0,14848,19,2604327490
1443,78244170,7706,78251876,2,0,1,8192,4,10308552560
1444,78248510,107276,78355786,1,0,0,52224,6,5553459590
1445,78310260,60076,78370336,0,0,0,3072,11,6547906495
1446,78323580,106028,78429608,5,0,0,48128,19,7693511703
1447,78357230,103248,78460478,4,0,0,7168,16,7658789376
1448,78366920,124194,78491114,3,0,0,22016,2,7655862834
1449,78391070,79122,78470192,3,0,0,7680,2,10208317927
1450,78413590,92422,78506012,5,0,0,14336,19,3492249621
1451,78457240,3253,78460493,7,0,1,3072,8,8081347264
1452,78596940,78056,78674996,0,0,0,11776,11,8409443930
1453,78648070,101348,78749418,8,0,0,32768,12,5575222029
1454,78676750,106496,78783246,1,0,0,49664,6,4605969827
1455,78693370,147842,78841212,2,0,0,22016,4,7031450288
1456,78721520,132655,78854175,4,0,0,42496,16,3943335486
1457,78864470,100880,78965350,4,0,0,31232,16,3530619167
1458,78957380,10432,78967812,1,0,1,2560,6,8556100816
1459,78974910,86072,79060982,4,0,0,17920,16,7933378020
1460,78997680,148364,79146044,0,0,0,69120,11,7923918298
1461,79093419,66721,79160140,3,0,1,113152,2,1854059509
1462,79140980,209050,79350030,3,0,0,23040,2,8551157701
1463,79174140,4162,79178302,1,0,1,11264,6,7270695590
1464,79185060,178878,79363938,5,0,0,8192,19,8622040943
1465,79194840,103076,79297916,0,0,0,7680,11,8972119898
1466,79286880,65970,79352850,0,0,0,2048,11,5635195796
1467,79383400,106496,79489896,2,0,0,49664,4,73779490
1468,79385479,42424,79427903,3,0,1,69120,2,9730024993
1469,79395590,32659,79428249,1,0,1,512,6,6918534409
1470,79451730,112776,79564506,8,0,0,66560,12,7646428951
1471,79498030,273087,79771117,4,0,0,182784,16,2459572518
1472,79513310,282158,79795468,5,0,0,79872,19,1210760337
1473,79718610,129526,79848136,2,0,0,4096,4,8649322682
1474,79812780,55748,79868528,4,0,0,4096,16,7983113510
1475,79838290,5712,79844002,6,0,1,14336,12,5642725206
1476,79973920,96692,80070612,3,0,0,22528,2,2419275762
1477,80014300,2946,80017246,9,0,1,3072,18,7633563945
1478,80121920,13512,80135432,1,0,1,26112,6,9904932630
1479,80141820,117937,80259757,5,0,0,44544,19,10411413291
1480,80199890,118529,80318419,2,0,0,34304,4,8666840308
1481,80254680,10395,80265075,7,0,1,5632,8,581962450
1482,80296961,21473,80318434,4,0,1,34304,16,9719707336
1483,80326400,64569,80390969,2,0,0,5120,4,9587631388
1484,80334020,3387,80337407,0,0,1,9728,11,6176104590
1485,80373880,188605,80562485,0,0,0,60416,11,1781501317
1486,80625340,104156,80729496,4,0,0,41984,16,655842027
1487,80646440,3128,80649568,0,0,1,9216,11,636067312
1488,80683720,5326,80689046,5,0,1,5632,19,7573805921
1489,80822110,120475,80942585,9,0,0,56832,18,9440319575
1490,80861190,96282,80957472,4,0,0,7168,16,5760025486
1491,80935489,23184,80958673,8,0,1,31232,12,9393105471
1492,81005780,117228,81123008,2,0,0,41984,4,821724292
1493,81015430,161092,81176522,3,0,0,14848,2,5072914076
1494,81135439,10499,81145938,3,0,1,16896,2,4040792329
1495,81211660,104336,81315996,4,0,0,21504,16,1076650104
1496,81218080,79166,81297246,4,0,0,5120,16,5630399065
1497,81219670,48182,81267852,9,0,0,512,18,5302044534
1498,81226191,4937,81231128,4,0,1,12800,16,7970946493
1499,81250530,110982,81361512,8,0,0,43520,12,8135814157
1500,81291010,6251,81297261,6,0,1,6144,12,1933671656
1501,81321600,48654,81370254,3,0,0,512,2,3541187643
1502,81335860,144332,81480192,0,0,0,65536,11,4374855830
1503,81390840,127416,81518256,4,0,0,39424,16,5464446026
1504,81399270,121608,81520878,5,0,0,1536,19,96392087
1505,81470260,101239,81571499,2,0,0,11776,4,2714886436
1506,81554030,100724,81654754,8,0,0,30720,12,8556936496
1507,81617080,57440,81674520,4,0,0,4608,16,1891073455
1508,81792920,48980,81841900,0,0,0,2048,11,3378974272
1509,81848960,82820,81931780,4,0,0,12288,16,8924413149
1510,81887620,5454,81893074,5,0,1,13824,19,6602951694
1511,81971780,4850,81976630,0,0,1,5120,11,822334054
1512,81981550,148845,82130395,9,0,0,21504,18,7015435792
1513,82004130,74101,82078231,0,0,0,1536,11,1189740286
1514,82018130,104156,82122286,0,0,0,41984,11,4569843531
1515,82035460,266378,82301838,1,0,1,435200,6,3375007195
1516,82061920,320427,82382347,9,0,0,16896,18,291334247
1517,82113940,349101,82463041,3,0,0,53760,2,7830115152
1518,82400850,147727,82548577,8,0,0,34816,12,370370719
1519,82415440,120305,82535745,4,0,0,19456,16,7165422394
1520,82516160,86360,82602520,2,0,0,13824,4,7301700060
1521,82561660,50672,82612332,0,0,0,2560,11,5153822642
1522,82585600,49490,82635090,5,0,0,512,19,2535451868
1523,82604580,10499,82615079,2,0,1,16896,4,3049460992
1524,82703090,101348,82804438,0,0,0,32768,11,10083494001
1525,82863510,5326,82868836,5,0,1,5632,19,3487901142
1526,82904220,108316,83012536,4,0,0,52224,16,5880580912
1527,82925570,91513,83017083,1,0,0,14848,6,6098570434
1528,82953790,129702,83083492,8,0,0,2048,12,5483912714
1529,82965050,109928,83074978,3,0,0,60928,2,4177357272
1530,83008630,106182,83114812,2,0,0,35840,4,2708374899
1531,83021660,146534,83168194,2,0,0,13312,4,6614268288
1532,83039240,87806,83127046,2,0,0,12800,4,4726339822
1533,83125610,100280,83225890,2,0,0,24576,4,2543280079
1534,83173660,93932,83267592,2,0,0,23552,4,6149870476
1535,83214131,11774,83225905,4,0,1,5632,16,6083621151
1536,83253360,1518,83254878,6,0,1,1536,12,9661307772
1537,83293340,154497,83447837,0,0,0,11264,11,8564686380
1538,83341880,89012,83430892,3,0,0,22528,2,7494392291
1539,83612420,52364,83664784,1,0,0,3072,6,109195577
1540,83619210,55748,83674958,5,0,0,4096,19,7488037899
1541,83630620,6754,83637374,9,0,1,7168,18,3359213610
1542,83762650,1994,83764644,2,0,1,2048,4,5370672230
1543,83782720,100100,83882820,1,0,0,28672,6,2130723260
1544,83913561,81908,83995469,6,0,0,14336,12,5434320455
1545,83943090,61604,84004694,5,0,0,8192,19,6502228344
1546,83953540,566,83954106,9,0,1,512,18,7949584514
1547,83972840,67592,84040432,4,0,0,7680,16,4168767554
1548,83989310,84512,84073822,4,0,0,12800,16,8221924542
1549,84023710,94341,84118051,1,0,1,153600,6,8312871508
1550,84040710,295250,84335960,9,0,0,84480,18,5551672707
1551,84121759,66204,84187963,3,0,1,112128,2,9029569227
1552,84208560,157409,84365969,2,0,0,3072,4,2742930805
1553,84260000,249577,84509577,4,0,0,35840,16,4901764983
1554,84283070,167497,84450567,0,0,0,70144,11,2043493158
1555,84309270,55748,84365018,4,0,0,4096,16,489512939
1556,84400270,180485,84580755,0,0,0,41472,11,8148544369
1557,84417410,54056,84471466,8,0,0,3584,12,2990126639
1558,84421350,72366,84493716,3,0,0,4608,2,7099693477
1559,84610930,79460,84690390,5,0,0,16384,19,4684766899
1560,84626920,12995,84639915,0,0,1,25088,11,2857635638
1561,84758910,2946,84761856,2,0,1,3072,4,3892172247
1562,84799540,1518,84801058,2,0,1,1536,4,1397393396
1563,84825440,64232,84889672,1,0,0,11776,6,3873674835
1564,84876880,107220,84984100,0,0,0,22016,11,5920220795
1565,84975100,103688,85078788,5,0,0,40448,19,272086956
1566,85000030,2946,85002976,7,0,1,3072,8,4386159331
1567,85016030,64021,85080051,8,0,0,4096,12,7264557398
1568,85145410,102908,85248318,0,0,0,37888,11,1265205114
1569,85195630,85142,85280772,4,0,0,7168,16,31099826
1570,85279190,56254,85335444,0,0,0,5632,11,113461945
1571,85318650,112787,85431437,1,0,0,32256,6,4493732470
1572,85332930,4162,85337092,9,0,1,11264,18,6759475568
1573,85426269,20222,85446491,3,0,1,29184,2,490162582
1574,85473479,1518,85474997,5,0,1,1536,19,3333382361
1575,85487880,67712,85555592,1,0,0,512,6,2259123743
1576,85510060,129410,85639470,9,0,0,9216,18,6585584782
1577,85691940,76052,85767992,0,0,0,10240,11,5844568681
1578,85770480,10241,85780721,7,0,1,16384,8,7948348174
1579,85827449,1994,85829443,5,0,1,2048,19,3077368838
1580,85829150,125479,85954629,2,0,0,4096,4,5681662480
1581,85942710,1042,85943752,0,0,1,1024,11,2251520528
1582,86188840,85316,86274156,8,0,0,20480,12,10197467683
1583,86232210,110034,86342244,3,0,0,14848,2,965927645
1584,86252260,118052,86370312,8,0,0,71680,12,2634323459
1585,86381689,61382,86443071,3,0,1,99328,2,8934803067
1586,86442520,234544,86677064,1,0,0,90112,6,6030242588
1587,86442989,3645,86446634,5,0,1,10240,19,4609375156
1588,86444220,272060,86716280,2,0,0,67584,4,5057381560
1589,86454020,10241,86464261,1,0,1,16384,6,10494911076
1590,86461650,133784,86595434,8,0,0,50176,12,8372722973
1591,86478030,98072,86576102,2,0,0,22016,4,4498341371
1592,86570690,145761,86716451,9,0,0,512,18,6317970953
1593,86678540,105404,86783944,5,0,0,46080,19,7385453351
1594,86703040,136542,86839582,3,0,0,46080,2,5644360853
1595,86708940,135337,86844277,3,0,0,15360,2,3837645943
1596,86731370,6754,86738124,5,0,1,7168,19,7888504312
1597,86766480,135046,86901526,2,0,0,88064,4,443048440
1598,86920670,104468,87025138,2,0,0,43008,4,10074007045
1599,86929530,138904,87068434,4,0,0,38912,16,3489474880
1600,87075130,5326,87080456,9,0,1,5632,18,9125052350
1601,87125520,94376,87219896,5,0,0,19968,19,2797676961
1602,87145670,11791,87157461,6,0,1,19456,12,487121278
1603,87265290,94844,87360134,1,0,0,21504,6,922428500
1604,87269740,2946,87272686,2,0,1,3072,4,7058095982
1605,87300460,102868,87403328,9,0,0,20992,18,8955041077
1606,87544620,97760,87642380,2,0,0,20992,4,9203864983
1607,87584140,15837,87599977,2,0,1,30720,4,9674269324
1608,87590581,11022,87601603,4,0,1,2560,16,2833724102
1609,87601830,13341,87615171,5,0,1,22528,19,7414509154
1610,87624930,198353,87823283,9,0,0,4096,18,1336803999
1611,87721140,100880,87822020,3,0,0,31232,2,9885195043
1612,87726440,11791,87738231,7,0,1,19456,8,1098683909
1613,87953929,1518,87955447,3,0,1,1536,2,8996453943
1614,87958750,1994,87960744,2,0,1,2048,4,10347648160
1615,88004710,12995,88017705,9,0,1,25088,18,1380482880
1616,88058470,54077,88112547,9,0,0,2560,18,9525147711
1617,88067530,11791,88079321,9,0,1,19456,18,925726129
1618,88167260,64208,88231468,8,0,0,6656,12,4376188080
1619,88202400,129169,88331569,2,0,0,30208,4,3997365116
1620,88206370,106964,88313334,5,0,0,51200,19,2691979516
1621,88254000,155010,88409010,1,0,0,65536,6,8345826541
1622,88352860,109904,88462764,2,0,0,24064,4,7795762220
1623,88420180,106340,88526520,3,0,0,49152,2,6424897410
1624,88533690,108368,88642058,5,0,0,55808,19,2662370366
1625,88541140,3422,88544562,9,0,1,3584,18,3177737859
1626,88634640,90722,88725362,1,0,0,18944,6,5100776039
1627,88667600,129696,88797296,5,0,0,22016,19,3785212539
1628,88675780,99320,88775100,3,0,0,26112,2,10601170348
1629,88754610,6229,88760839,6,0,1,15360,12,1587894221
1630,88802910,87296,88890206,4,0,0,16896,16,9450582869
1631,88830870,3128,88833998,9,0,1,9216,18,5697171880
1632,88924480,1042,88925522,6,0,1,1024,12,8261497071
1633,89048940,76052,89124992,4,0,0,10240,16,8221974397
1634,89067640,64208,89131848,8,0,0,6656,12,6614059080
1635,89129540,6278,89135818,2,0,1,6656,4,3211793532
1636,89134980,1184,89136164,9,0,1,512,18,1514557340
1637,89180700,56840,89237540,5,0,0,7680,19,8648076885
1638,89301730,64208,89365938,9,0,0,6656,18,6406587485
1639,89458850,68840,89527690,1,0,0,11776,6,3448839863
1640,89505060,2946,89508006,1,0,1,3072,6,1752132965
1641,89539630,85940,89625570,1,0,0,22528,6,9134896964
1642,89602040,84826,89686866,9,0,0,9728,18,7610185417
1643,89624870,5066,89629936,1,0,1,4608,6,8850611213
1644,89626030,123692,89749722,9,0,0,49664,18,9646974596
1645,89652390,109218,89761608,9,0,0,22016,18,6803481083
1646,89654520,169026,89823546,5,0,0,22528,19,6489970979
1647,89696700,4937,89701637,6,0,1,12800,12,9541623927
1648,89769590,70786,89840376,8,0,0,1024,12,8004937771
1649,89811250,3422,89814672,6,0,1,3584,12,8052160245
1650,89846450,48980,89895430,8,0,0,2048,12,5826942080
1651,89862380,93879,89956259,9,0,0,25088,18,519916773
1652,89877870,63898,89941768,3,0,0,1024,2,2247520016
1653,89879670,68930,89948600,9,0,0,9216,18,5524186489
1654,89888560,14117,89902677,2,0,1,24064,4,4207902716
1655,89985619,64395,90050014,3,0,1,108544,2,7014473399
1656,90032900,20340,90053240,0,0,1,5120,11,2064309979
1657,90157410,119778,90277188,2,0,0,57344,4,7768198766
1658,90157600,133643,90291243,4,0,0,46080,16,8464014037
1659,90174230,142762,90316992,4,0,0,61952,16,8910820843
1660,90184760,107434,90292194,5,0,0,3072,19,2245000329
1661,90380870,80084,90460954,3,0,0,18432,2,6305689102
1662,90422160,99164,90521324,9,0,0,25600,18,8894238587
1663,90425310,142592,90567902,4,0,0,26112,16,8091759515
1664,90470490,59132,90529622,5,0,0,5120,19,2922575936
1665,90534760,62516,90597276,2,0,0,6144,4,3947738473
1666,90549250,65456,90614706,2,0,0,10752,4,7327942096
1667,90590340,101192,90691532,4,0,0,32256,16,5708529308
1668,90608830,88021,90696851,5,0,0,17408,19,3455788903
1669,90650310,116082,90766392,3,0,0,24576,2,4155480405
1670,90698110,70793,90768903,2,0,0,8192,4,7498837894
1671,90801439,4850,90806289,3,0,1,5120,2,8704749122
1672,90802540,49800,90852340,9,0,0,3072,18,4063900956
1673,91023010,48980,91071990,9,0,0,2048,18,10275893009
1674,91028510,97006,91125516,2,0,0,10240,4,9079188991
1675,91085069,91748,91176817,7,0,0,16384,8,9751942841
1676,91107640,33762,91141402,1,0,1,58880,6,8380153458
1677,91223880,2470,91226350,9,0,1,2560,18,3968821160
1678,91295129,76700,91371829,7,0,0,17408,8,2536388364
1679,91321029,117154,91438183,7,0,0,42496,8,2153600803
1680,91326260,76271,91402531,1,0,0,6144,6,3225667790
1681,91452400,4850,91457250,0,0,1,5120,11,7896615902
1682,91479520,102440,91581960,4,0,0,36352,16,3753148056
1683,91503930,4374,91508304,6,0,1,4608,12,9042118623
1684,91548610,16354,91564964,5,0,1,31744,19,5692887866
1685,91598370,67592,91665962,8,0,0,7680,12,3765629933
1686,91625690,98852,91724542,3,0,0,24576,2,8266947514
1687,91639710,104492,91744202,2,0,0,5120,4,6787867312
1688,91743870,36153,91780023,5,0,1,62976,19,3444428838
1689,91816410,206661,92023071,3,0,0,72192,2,5710099647
1690,91847929,112852,91960781,7,0,0,23040,8,3000789517
1691,91910439,74867,91985306,3,0,1,122368,2,10676773172
1692,91938640,185814,92124454,0,0,0,94720,11,243568175
1693,91981649,198227,92179876,7,0,0,48640,8,1236173349
1694,92146240,5326,92151566,7,0,1,5632,8,8956340615
1695,92172620,242564,92415184,5,0,1,381440,19,7250286760
1696,92193780,308703,92502483,9,0,0,26112,18,2197395994
1697,92240851,282613,92523464,6,0,0,49664,12,5795613844
1698,92275640,264489,92540129,3,0,0,19456,2,9656999453
1699,92316500,264661,92581161,1,0,0,15872,6,10137087792
1700,92320740,96390,92417130,0,0,1,3072,11,5987124331
1701,92321770,338116,92659886,4,0,0,26112,16,3789414957
1702,92348460,69336,92417796,7,0,1,1024,8,10048369282
1703,92349660,263711,92613371,1,0,0,19968,6,7880361657
1704,92351930,274257,92626187,8,0,0,1536,12,213320526
1705,92472990,6754,92479744,5,0,1,7168,19,9061934234
1706,92478560,97750,92576310,1,0,0,9728,6,7198701197
1707,92513770,137515,92651285,3,0,0,7168,2,9773965757
1708,92538590,6381,92544971,7,0,1,5120,8,3087211591
1709,92621490,102440,92723930,5,0,0,36352,19,10118937791
1710,92626649,135279,92761928,7,0,0,8704,8,2931159263
1711,92647050,117077,92764127,4,0,0,7168,16,3286084191
1712,92722400,97794,92820194,1,0,0,12288,6,6719823326
1713,92825810,159391,92985201,4,0,0,37376,16,8376801800
1714,92830920,142870,92973790,1,0,0,84992,6,10523786641
1715,92952450,79552,93032002,5,0,0,7168,19,4452499705
1716,93099740,6278,93106018,6,0,1,6656,12,6389653032
1717,93150560,93308,93243868,1,0,1,151552,6,6863268401
1718,93173450,152243,93325693,9,0,0,11264,18,5482487487
1719,93273680,209728,93483408,9,0,0,16896,18,3989020115
1720,93299939,20624,93320563,3,0,1,33280,2,853023675
1721,93359780,7230,93367010,0,0,1,7680,11,10260437405
1722,93401440,103844,93505284,8,0,0,40960,12,1497436506
1723,93458910,118350,93577260,1,0,0,12800,6,10736327711
1724,93470930,160504,93631434,5,0,0,28160,19,1526716156
1725,93516101,11274,93527375,4,0,1,18432,16,669469519
1726,93556550,60470,93617020,1,0,0,512,6,5779736482
1727,93585650,1042,93586692,1,0,1,1024,6,805604567
1728,93603979,100100,93704079,7,0,0,28672,8,5573680104
1729,93612590,91660,93704250,3,0,0,512,2,9093139478
1730,93616930,76901,93693831,3,0,0,5120,2,5936158172
1731,93619990,165947,93785937,8,0,0,69120,12,1186710351
1732,93642120,6278,93648398,0,0,1,6656,11,4106845752
1733,93682320,150873,93833193,9,0,0,16384,18,1449369676
1734,93692809,216911,93909720,7,0,0,16384,8,229430327
1735,93780090,68355,93848445,2,0,0,6144,4,2377684966
1736,93783360,85611,93868971,8,0,0,6656,12,6472420946
1737,93805160,106135,93911295,3,0,0,5120,2,1376398432
1738,93809390,95323,93904713,3,0,0,22016,2,7710685439
1739,93891140,121289,94012429,1,0,0,2560,6,3222626764
1740,93896090,115544,94011634,0,0,0,79360,11,1712142729
1741,93919120,12049,93931169,6,0,1,19968,12,8742147636
1742,93946940,99590,94046530,8,0,0,5120,12,8347259277
1743,93962150,90992,94053142,3,0,0,6656,2,8719558375
1744,94038160,14997,94053157,7,0,1,22016,8,1498799425
1745,94097980,50672,94148652,9,0,0,2560,18,710925487
1746,94183640,6229,94189869,7,0,1,15360,8,6009724045
1747,94198171,1994,94200165,4,0,1,2048,16,1735271642
1748,94209970,96428,94306398,8,0,0,20992,12,1698066913
1749,94252410,153989,94406399,0,0,0,9728,11,5853257502
1750,94366820,133797,94500617,0,0,0,53248,11,9282044959
1751,94379730,5196,94384926,6,0,1,13312,12,9527320088
1752,94474040,132774,94606814,5,0,1,215040,19,7070159460
1753,94491880,251650,94743530,3,0,0,44544,2,9228671351
1754,94530410,279018,94809428,1,0,0,37888,6,2671381588
1755,94551670,221923,94773593,2,0,0,12800,4,2477117762
1756,94636400,175718,94812118,9,0,0,8704,18,9992182248
1757,94684460,3422,94687882,9,0,1,3584,18,9728456932
1758,94688509,120942,94809451,3,0,1,186368,2,3701409940
1759,94689760,122373,94812133,1,0,1,32256,6,7501153522
1760,94800729,176851,94977580,7,0,0,31744,8,1160343998
1761,94822200,157423,94979623,8,0,0,6656,12,2523237287
1762,94840690,140508,94981198,0,0,0,5120,11,8062616248
1763,95010600,102596,95113196,3,0,0,36864,2,7680008562
1764,95053760,85506,95139266,5,0,0,18432,19,1681943369
1765,95056110,105872,95161982,9,0,0,47616,18,6228077762
1766,95066221,2946,95069167,4,0,1,3072,16,9056915233
1767,95084999,12737,95097736,3,0,1,24576,2,7786665459
1768,95216760,76052,95292812,5,0,0,10240,19,5994348099
1769,95342980,62516,95405496,0,0,0,6144,11,5669618720
1770,95444199,90056,95534255,7,0,0,15872,8,8192582240
1771,95596650,81128,95677778,1,0,0,11776,6,2757196580
1772,95622939,15321,95638260,3,0,1,29696,2,6562872756
1773,95673150,184201,95857351,2,0,0,10240,4,9361738324
1774,95686450,1994,95688444,0,0,1,2048,11,3820378998
1775,95780320,103220,95883540,2,0,0,38912,4,9346874243
1776,95780730,155724,95936454,5,0,0,14848,19,7737067162
1777,95890250,98770,95989020,2,0,0,14848,4,9457002920
1778,95996260,71600,96067860,2,0,0,10752,4,4456052397
1779,96141970,48980,96190950,3,0,0,2048,2,40375208
1780,96146140,118844,96264984,0,0,0,27136,11,754322313
1781,96191440,119948,96311388,8,0,0,18432,12,557093462
1782,96232630,100412,96333042,1,0,0,29696,6,8230020860
1783,96283740,109548,96393288,3,0,0,29696,2,1224480776
1784,96353780,2470,96356250,9,0,1,2560,18,18596463
1785,96407030,80060,96487090,1,0,0,13312,6,10227207415
1786,96424040,106808,96530848,0,0,0,50688,11,471466901
1787,96482890,85940,96568830,2,0,0,22528,4,1927005516
1788,96515590,143762,96659352,9,0,0,91648,18,9820773629
1789,96516650,14781,96531431,7,0,1,512,8,1523998796
1790,96591670,128262,96719932,2,0,0,26112,4,4860483384
1791,96598380,13083,96611463,5,0,1,22016,19,6030217641
1792,96645079,110957,96756036,7,0,0,22528,8,9232709647
1793,96653280,7131,96660411,0,0,1,1024,11,644717485
1794,96782710,84512,96867222,3,0,0,12800,2,1121924193
1795,96856590,120001,96976591,9,0,0,30720,18,10410725617
1796,96860360,13253,96873613,2,0,1,25600,4,8647492887
1797,96925920,117731,97043651,5,0,0,1024,19,7306948327
1798,96932009,94712,97026721,7,0,0,26112,8,8140855910
1799,96949040,79100,97028140,2,0,0,4608,4,3968609993
1800,97069420,87896,97157316,9,0,0,13824,18,256085765
1801,97114820,111514,97226334,2,0,0,17408,4,8238378749
1802,97142060,52364,97194424,5,0,0,3072,19,7290846632
1803,97360519,6488,97367007,3,0,1,15872,2,6462204364
1804,97403530,134370,97537900,5,0,0,2560,19,7719543267
1805,97534960,69284,97604244,9,0,0,8192,18,3099948256
1806,97721480,5802,97727282,9,0,1,6144,18,5590500724
1807,97834330,59756,97894086,9,0,0,7168,18,803834172
1808,97839749,48980,97888729,7,0,0,2048,8,8320772119
1809,97853900,566,97854466,6,0,1,512,12,4312006750
1810,97876949,188793,98065742,7,0,0,2560,8,8593895405
1811,97877340,102596,97979936,4,0,0,36864,16,5158754855
1812,97914980,109818,98024798,4,0,0,31744,16,4229119832
1813,97918680,80330,97999010,2,0,0,2560,4,4952359168
1814,97930570,172558,98103128,0,0,0,55808,11,6513723457
1815,97939400,138120,98077520,2,0,0,32256,4,1556181755
1816,97989860,121551,98111411,5,0,0,27136,19,6666187425
1817,98075941,6421,98082362,4,0,1,5120,16,2367129035
1818,98163010,56060,98219070,0,0,0,5120,11,5804300790
1819,98183510,71288,98254798,3,0,0,9728,2,2040562606
1820,98212370,3904,98216274,2,0,1,10752,4,3235950915
1821,98214530,106419,98320949,2,0,0,12800,4,9954404921
1822,98228429,119909,98348338,7,0,0,27136,8,1484070313
1823,98272600,95221,98367821,1,0,0,3072,6,183144315
1824,98333300,98262,98431562,0,0,0,20480,11,7274041595
1825,98352639,72668,98425307,7,0,0,9216,8,5102182114
1826,98358070,89768,98447838,5,0,0,19968,19,5101928018
1827,98421350,99445,98520795,3,0,0,24576,2,9550113528
1828,98521440,104312,98625752,1,0,0,42496,6,4502886372
1829,98546240,163016,98709256,0,0,0,41984,11,7161252026
1830,98554070,92708,98646778,5,0,0,24576,19,5637650850
1831,98592380,210950,98803330,4,0,0,16896,16,4061298097
1832,98621340,172033,98793373,4,0,0,2048,16,3640247699
1833,98652210,140524,98792734,2,0,0,82944,4,6775679043
1834,98678080,182160,98860240,9,0,0,26112,18,10253572765
1835,98681580,121921,98803501,9,0,0,512,18,9946429636
1836,98802821,4576,98807397,4,0,1,10752,16,9455440498
1837,98865661,7706,98873367,4,0,1,8192,16,5514180097
1838,98990380,57440,99047820,3,0,0,4608,2,4849817763
1839,98995590,45596,99041186,1,0,0,1024,6,9499742761
1840,99078149,59600,99137749,7,0,0,6656,8,4838142932
1841,99085449,458066,99543515,3,0,1,741888,2,8829931387
1842,99231560,409182,99640742,8,0,0,26624,12,10288693450
1843,99283650,260224,99543874,0,0,1,9728,11,4746625059
1844,99353659,454615,99808274,7,0,0,26624,8,1635091617
1845,99436440,287591,99724031,1,0,0,19456,6,5449777604
1846,99446310,102070,99548380,0,0,1,7168,11,9919821830
1847,99447170,241156,99688326,0,0,0,3584,11,7659542134
1848,99570010,4850,99574860,0,0,1,5120,11,4174302356
1849,99803580,8090,99811670,9,0,1,9728,18,2651292462
1850,99807710,10291,99818001,1,0,1,7168,6,46129247
1851,99865400,7230,99872630,2,0,1,7680,4,2162965649
1852,99872420,4850,99877270,6,0,1,5120,12,3310657990
1853,99891300,405021,100296321,1,0,0,5632,6,8766450265
1854,99894730,157587,100052317,5,0,1,260096,19,433109225
1855,99940560,113703,100054263,9,0,1,3072,18,2945242048
1856,99966070,206316,100172386,5,0,0,30208,19,10658799884
1857,99968279,262853,100231132,7,0,0,52736,8,6337520485
1858,99979040,75569,100054609,1,0,1,512,6,4386527483
1859,99984190,91617,100075807,5,0,1,68608,19,4188442578
1860,100014140,159041,100173181,5,0,0,2560,19,9485033278
1861,100064400,187666,100252066,0,0,0,54784,11,2007281749
1862,100077460,175089,100252549,9,0,0,1536,18,2472698268
1863,100114830,145460,100260290,1,0,0,5632,6,1905313617
1864,100115260,137772,100253032,2,0,0,1536,4,10660485695
1865,100156159,116293,100272452,7,0,0,4096,8,3686825251
1866,100216300,18246,100234546,1,0,1,3584,6,4525767486
1867,100277210,199535,100476745,0,0,0,57856,11,4385451170
1868,100280960,117643,100398603,8,0,0,27648,12,4758042138
1869,100417589,123272,100540861,7,0,0,24064,8,1178632608
1870,100556800,60536,100617336,5,0,0,9728,19,4355834420
1871,100648260,88232,100736492,0,0,0,19968,11,5385729745
1872,100649140,72068,100721208,5,0,0,12288,19,6677515638
1873,100702880,74908,100777788,2,0,0,9216,4,1891390294
1874,100727610,2470,100730080,7,0,1,2560,8,8895300475
1875,100834970,44194,100879164,9,0,0,512,18,3826218027
1876,100855570,69284,100924854,9,0,0,8192,18,6780092034
1877,100905810,63296,100969106,5,0,0,8704,19,4895554994
1878,100929080,111176,101040256,2,0,0,65024,4,8429781462
1879,100979999,84668,101064667,7,0,0,13312,8,6646674844
1880,100981890,64106,101045996,9,0,0,5632,18,4012538497
1881,101006570,48662,101055232,3,0,0,1024,2,6597166054
1882,101013330,43904,101057234,8,0,0,512,12,7580466768
1883,101050690,79436,101130126,9,0,0,11264,18,6455538877
1884,101080790,99632,101180422,9,0,0,27136,18,5868291563
1885,101093730,56216,101149946,5,0,0,5632,19,2639225719
1886,101184130,65900,101250030,8,0,0,7168,12,10048200443
1887,101226470,95468,101321938,2,0,0,23552,4,2325495023
1888,101255320,109656,101364976,1,0,0,22528,6,3261554895
1889,101262250,82554,101344804,8,0,0,11776,12,6723889996
1890,101279890,52364,101332254,3,0,0,3072,2,6103926449
1891,101280200,566,101280766,7,0,1,512,8,63381245
1892,101300110,122353,101422463,9,0,0,12288,18,7682416355
1893,101383030,147377,101530407,0,0,0,31744,11,6354882998
1894,101386950,133770,101520720,2,0,0,45056,4,9531317098
1895,101405080,79988,101485068,2,0,0,8704,4,6310113532
1896,101407300,153892,101561192,5,0,0,44032,19,8662330458
1897,101419460,197904,101617364,0,0,0,67072,11,4763006067
1898,101569820,104214,101674034,4,0,0,25088,16,1298670205
1899,101617020,58121,101675141,0,0,0,3584,11,2454454847
1900,101617930,43904,101661834,3,0,0,512,2,9660748289
1901,101629419,22174,101651593,3,0,1,36352,2,6768084579
1902,101672480,6551,101679031,0,0,1,4096,11,10086896535
1903,101677260,151123,101828383,8,0,0,49664,12,2605644225
1904,101711299,48980,101760279,7,0,0,2048,8,4851938839
1905,101741240,166300,101907540,3,0,0,15360,2,9796532871
1906,101749780,81582,101831362,2,0,0,9728,4,2573473133
1907,101851770,85740,101937510,0,0,0,11776,11,8412994668
1908,101853350,114696,101968046,2,0,0,71680,4,8505437410
1909,101897890,1042,101898932,2,0,1,1024,4,2282054026
1910,102009711,1042,102010753,4,0,1,1024,16,476932879
1911,102035760,153606,102189366,8,0,0,3584,12,941151080
1912,102301550,101624,102403174,5,0,1,164352,19,8477311661
1913,102414020,154569,102568589,4,0,0,1024,16,8546074827
1914,102415460,190353,102605813,8,0,0,12288,12,2298522724
1915,102537340,76700,102614040,9,0,0,17408,18,9007166889
1916,102557420,60224,102617644,5,0,0,8704,19,727208758
1917,102613060,46568,102659628,5,0,0,1024,19,3026178866
1918,102656080,62312,102718392,2,0,0,5120,4,6061853263
1919,102702549,98876,102801425,7,0,0,29696,8,8043771517
1920,102732870,3645,102736515,2,0,1,10240,4,5410654489
1921,102739240,4374,102743614,5,0,1,4608,19,7497674173
1922,102763320,103688,102867008,0,0,0,40448,11,9276991749
1923,102853680,13343,102867023,9,0,1,3584,18,9482372242
1924,102909890,190579,103100469,2,0,0,141824,4,9365639197
1925,102959360,143308,103102668,8,0,0,7168,12,742646471
1926,103001330,101821,103103151,1,0,0,1536,6,3071747238
1927,103013850,95709,103109559,2,0,0,9216,4,8709092997
1928,103089000,91155,103180155,5,0,0,18432,19,7200200012
1929,103158520,73604,103232124,3,0,0,12288,2,1024923534
1930,103209330,104156,103313486,0,0,0,41984,11,7848635804
1931,103211400,4374,103215774,2,0,1,4608,4,9821587331
1932,103303980,12385,103316365,0,0,1,8704,11,5217695068
1933,103312420,112278,103424698,8,0,0,56320,12,2848285537
1934,103319200,162461,103481661,2,0,0,24064,4,2847114142
1935,103451559,59712,103511271,7,0,0,9216,8,1649640087
1936,103481440,115133,103596573,3,0,0,77312,2,5357863411
1937,103496789,143164,103639953,7,0,0,58368,8,818950397
1938,103552290,100568,103652858,9,0,0,30208,18,3939624373
1939,103591890,6193,103598083,9,0,1,1536,18,1472456972
1940,103665390,58064,103723454,2,0,0,6656,4,7929579097
1941,103680330,59114,103739444,0,0,0,2560,11,2540663101
1942,103687070,10757,103697827,9,0,1,17408,18,5554057947
1943,103708350,1518,103709868,0,0,1,1536,11,6434670642
1944,103881210,108368,103989578,2,0,0,55808,4,3057810495
1945,103937809,23637,103961446,3,0,1,42496,2,2821843171
1946,103960550,4937,103965487,2,0,1,12800,4,4825173482
1947,103961370,79764,104041134,2,0,0,5632,4,3317934682
1948,103983690,153632,104137322,0,0,0,23552,11,6453067854
1949,104001230,256544,104257774,8,0,0,3072,12,2200550780
1950,104016369,184615,104200984,7,0,0,19456,8,6499012201
1951,104016771,22433,104039204,4,0,1,36864,16,1448114283
1952,104053120,54368,104107488,1,0,0,4608,6,7023177174
1953,104091130,91369,104182499,3,0,0,4096,2,6322905064
1954,104144960,64076,104209036,8,0,0,11264,12,5338256946
1955,104158230,177555,104335785,2,0,0,26624,4,420100071
1956,104160470,94520,104254990,3,0,0,9728,2,8650564669
1957,104163720,115078,104278798,1,0,0,31744,6,7081496920
1958,104210240,44921,104255161,9,0,0,512,18,4858943204
1959,104212800,6754,104219554,1,0,1,7168,6,1784467092
1960,104409600,70976,104480576,5,0,0,8704,19,7149536652
1961,104534050,59288,104593338,3,0,0,5632,2,1086039103
1962,104546010,43904,104589914,3,0,0,512,2,377481001
1963,104546729,224674,104771403,3,0,1,364032,2,2218755863
1964,104555170,230469,104785639,3,0,0,2048,2,5638824259
1965,104702490,330526,105033016,8,0,0,78848,12,7622889233
1966,104733540,245320,104978860,3,0,0,9216,2,1395694375
1967,104776980,6278,104783258,6,0,1,6656,12,8319846372
1968,104877440,113834,104991274,8,0,0,28672,12,186711242
1969,104900060,156668,105056728,8,0,0,25600,12,1325425379
1970,104977680,55671,105033351,0,0,0,1024,11,357541196
1971,105011160,86056,105097216,3,0,0,6656,2,8701190886
1972,105036840,65302,105102142,5,0,0,1536,19,9745573437
1973,105144060,116636,105260696,2,0,0,82944,4,603770039
1974,105166100,2470,105168570,0,0,1,2560,11,10310294906
1975,105168930,107888,105276818,9,0,0,8704,18,325288187
1976,105200910,175177,105376087,3,0,0,5120,2,8263823459
1977,105238790,24844,105263634,1,0,1,3072,6,6137393166
1978,105303800,48980,105352780,4,0,0,2048,16,5019298118
1979,105423290,1518,105424808,2,0,1,1536,4,6792582742
1980,105442610,54056,105496666,1,0,0,3584,6,4367077286
1981,105539310,79148,105618458,4,0,0,15360,16,9900353363
1982,105745000,1042,105746042,1,0,1,1024,6,8000764462
1983,105766170,98072,105864242,2,0,0,22016,4,7942132477
1984,105879669,62516,105942185,7,0,0,6144,8,6037550210
1985,105895850,147753,106043603,4,0,0,105984,16,2990959686
1986,105902240,156189,106058429,2,0,0,17408,4,2798033003
1987,105949279,101331,106050610,7,0,0,9216,8,2013792697
1988,106024690,116977,106141667,8,0,0,22016,12,5652360474
1989,106051350,11016,106062366,7,0,1,17920,8,1137811882
1990,106056670,85324,106141994,2,0,0,1024,4,9376818913
1991,106191540,106340,106297880,8,0,0,49152,12,3017225490
1992,106282200,106184,106388384,4,0,0,48640,16,9196859476
1993,106362000,55748,106417748,5,0,0,4096,19,7863176386
1994,106393660,101194,106494854,2,0,0,29184,4,5135300782
1995,106429640,110396,106540036,1,0,0,62464,6,3891436038
1996,106485240,73486,106558726,5,0,0,11776,19,3035526136
1997,106515600,100480,106616080,8,0,0,17408,12,662350781
1998,106556780,102974,106659754,9,0,0,31744,18,5343001323
1999,106567150,566,106567716,5,0,1,512,19,3678805927
2000,106614140,2974,106617114,6,0,1,1024,12,2365973331
2001,106669710,57440,106727150,1,0,0,4608,6,4531794766
2002,106717050,89456,106806506,5,0,0,18944,19,535766725
2003,106759240,59132,106818372,3,0,0,5120,2,5520086932
2004,106760920,96368,106857288,8,0,0,16896,12,4571300231
2005,106765050,5802,106770852,0,0,1,6144,11,4153536745
2006,106804920,82862,106887782,5,0,0,12288,19,2295067976
2007,106850399,6904,106857303,8,0,1,3584,12,4812648066
2008,106875690,169874,107045564,5,0,0,73216,19,2103978236
2009,106919750,82842,107002592,8,0,0,4608,12,3441318914
2010,106929920,3898,106933818,7,0,1,4096,8,8119662575
2011,107278299,63452,107341751,7,0,0,9216,8,1953067828
2012,107319550,45596,107365146,1,0,0,1024,6,9934085078
2013,107360060,113048,107473108,8,0,0,71168,12,5032945575
2014,107386030,103844,107489874,4,0,0,40960,16,5850014278
2015,107402960,2470,107405430,5,0,1,2560,19,9599672453
2016,107415680,107468,107523148,0,0,0,16384,11,7539007652
2017,107429760,97660,107527420,1,0,0,10240,6,10715074055
2018,107501839,107835,107609674,7,0,0,52224,8,1360318718
2019,107626100,95756,107721856,1,0,0,19456,6,2748802144
2020,107681560,72139,107753699,4,0,0,2048,16,5027168993
2021,107689359,99008,107788367,7,0,0,25088,8,5118864823
2022,107795100,48980,107844080,3,0,0,2048,2,1006053755
2023,107813870,72668,107886538,0,0,0,9216,11,2425993547
2024,107830049,50672,107880721,7,0,0,2560,8,4743113443
2025,107976860,102284,108079144,1,0,0,35840,6,413141618
2026,108161970,4374,108166344,1,0,1,4608,6,9289479224
2027,108274410,3387,108277797,0,0,1,9728,11,9331146815
2028,108300090,74279,108374369,8,0,0,1024,12,9109718664
2029,108331459,44492,108375951,3,0,1,73216,2,7007326193
2030,108350469,81091,108431560,7,0,0,10752,8,463027371
2031,108363110,123800,108486910,0,0,0,14848,11,7690274727
2032,108557520,99632,108657152,0,0,0,27136,11,9948439532
2033,108641650,105250,108746900,2,0,0,22016,4,6991840219
2034,108644940,120191,108765131,2,0,0,15360,4,2041153568
2035,108651261,17416,108668677,4,0,1,18944,16,3474614828
2036,108792250,108680,108900930,3,0,0,56832,2,2921126029
2037,108841930,4162,108846092,5,0,1,11264,19,2308869672
2038,108859909,156210,109016119,7,0,0,93696,8,2480462747
2039,109089800,70532,109160332,5,0,0,12288,19,3946619599
2040,109144450,83780,109228230,3,0,0,20480,2,5370872589
2041,109173870,2946,109176816,1,0,1,3072,6,1126158518
2042,109256400,55748,109312148,2,0,0,4096,4,5121913107
2043,109316980,83936,109400916,4,0,0,20992,16,3344327917
2044,109317540,91191,109408731,0,0,0,25600,11,8921550148
2045,109360540,169648,109530188,3,0,0,37888,2,299560508
2046,109368920,101816,109470736,5,0,0,34304,19,10073719563
2047,109393100,94574,109487674,4,0,0,3072,16,2324514589
2048,109409340,157154,109566494,5,0,0,9728,19,9668594253
2049,109413490,101036,109514526,5,0,0,31744,19,7448755118
2050,109502430,136476,109638906,5,0,0,30720,19,2860809129
2051,109504390,100724,109605114,1,0,0,30720,6,2137982085
2052,109576950,77982,109654932,3,0,0,1536,2,4142940589
2053,109683000,74360,109757360,2,0,0,9728,4,4142048902
2054,109770600,3898,109774498,7,0,1,4096,8,4284863048
2055,109786530,78836,109865366,3,0,0,14336,2,507255833
2056,110001140,108368,110109508,5,0,0,55808,19,4243648801
2057,110148390,86204,110234594,1,0,0,13312,6,8484998721
2058,110172120,1518,110173638,2,0,1,1536,4,20666466
2059,110193940,101036,110294976,2,0,0,31744,4,2909311863
2060,110372570,5712,110378282,7,0,1,14336,8,3517463805
2061,110376960,124843,110501803,9,0,0,23040,18,3587543560
2062,110454230,76052,110530282,1,0,0,10240,6,5391846337
2063,110518290,102752,110621042,8,0,0,37376,12,5605688134
2064,110539310,566,110539876,7,0,1,512,8,7540508047
2065,110619890,102804,110722694,4,0,0,33792,16,9946057204
2066,110673230,131244,110804474,2,0,0,32768,4,4303747145
2067,110734410,143696,110878106,5,0,0,30208,19,4091982378
2068,110956330,105248,111061578,2,0,0,45568,4,4021071226
2069,111097930,76052,111173982,8,0,0,10240,12,2421257192
2070,111122330,2470,111124800,5,0,1,2560,19,9778954594
2071,111162930,84824,111247754,2,0,0,13824,4,1162080071
2072,111168299,5698,111173997,8,0,1,5632,12,3793372041
2073,111186800,100400,111287200,3,0,0,23040,2,4710240953
2074,111188520,118862,111307382,9,0,0,5632,18,1549437216
2075,111191060,64100,111255160,0,0,0,3584,11,825725428
2076,111199170,145016,111344186,5,0,0,25600,19,7789977147
2077,111298680,96668,111395348,3,0,0,17408,2,4851555198
2078,111383159,105092,111488251,7,0,0,45056,8,8437480983
2079,111403559,6278,111409837,8,0,1,6656,12,8583334473
2080,111474190,60824,111535014,9,0,0,5632,18,9717028648
2081,111539920,74516,111614436,9,0,0,10240,18,5992236284
2082,111552190,98072,111650262,4,0,0,22016,16,6855759382
2083,111578419,74666,111653085,7,0,0,9216,8,7787339098
2084,111637530,97184,111734714,5,0,0,29184,19,7909109471
2085,111669320,103488,111772808,4,0,0,22016,16,8515414206
2086,111687250,142050,111829300,3,0,0,89088,2,9806434859
2087,111717580,2946,111720526,7,0,1,3072,8,7484402178
2088,111750549,3898,111754447,8,0,1,4096,12,2634060414
2089,111835750,72668,111908418,5,0,0,9216,19,494619813
2090,111841600,62516,111904116,3,0,0,6144,2,6096935180
2091,111888640,85604,111974244,5,0,0,16384,19,9791319061
2092,111945340,84560,112029900,2,0,0,23040,4,2064331945
2093,112050150,100412,112150562,9,0,0,29696,18,3788450749
2094,112051460,116012,112167472,5,0,0,15360,19,9296200679
2095,112099170,129622,112228792,8,0,0,7680,12,1125640031
2096,112323310,103844,112427154,9,0,0,40960,18,10287035375
2097,112335870,91767,112427637,1,0,0,1536,6,114026552
2098,112344599,3898,112348497,5,0,1,4096,19,10075596672
2099,112360590,129762,112490352,0,0,0,15360,11,10442594844
2100,112395460,64598,112460058,9,0,0,512,18,6773248694
2101,112400960,73882,112474842,9,0,0,8704,18,86544118
2102,112564890,87896,112652786,9,0,0,13824,18,6525157184
2103,112608259,184866,112793125,7,0,0,45056,8,5922288807
2104,112623179,91904,112715083,7,0,0,16896,8,2161645250
2105,112628810,213935,112842745,2,0,0,46592,4,4734136224
2106,112631419,4679,112636098,3,0,1,12288,2,9185477929
2107,112672600,566,112673166,5,0,1,512,19,9482713083
2108,112735599,114952,112850551,7,0,0,512,8,10016581063
2109,112773540,88412,112861952,2,0,0,25600,4,2612369446
2110,112790590,72640,112863230,8,0,0,3072,12,7945850136
2111,112809960,52319,112862279,3,0,0,1024,2,10087046031
2112,112861839,17754,112879593,3,0,1,31744,2,5617474409
2113,112861930,100637,112962567,1,0,0,26112,6,2127942012
2114,112873360,174129,113047489,2,0,0,31744,4,8033025183
2115,112874030,282138,113156168,0,0,0,36864,11,5934844540
2116,112908719,1994,112910713,8,0,1,2048,12,329594666
2117,112935170,277223,113212393,9,0,0,36352,18,3297216882
2118,112937140,207773,113144913,4,0,0,6144,16,6131811154
2119,112961820,238552,113200372,1,0,0,6656,6,4764415861
2120,112992850,150168,113143018,9,0,0,66560,18,5142087986
2121,113001890,250037,113251927,0,0,0,8704,11,3838719402
2122,113016220,209976,113226196,0,0,0,10752,11,6165786232
2123,113128770,30303,113159073,7,0,1,3072,8,982297311
2124,113131430,111235,113242665,3,0,0,20992,2,8198456635
2125,113148010,106740,113254750,0,0,0,9216,11,9584416030
2126,113244630,103441,113348071,1,0,0,24576,6,3921114643
2127,113343559,130008,113473567,7,0,0,107008,8,9286566744
2128,113361170,121475,113482645,0,0,0,4608,11,8931894247
2129,113368950,159433,113528383,0,0,0,22528,11,1171038365
2130,113399010,91651,113490661,2,0,0,10752,4,5323981005
2131,113415170,6754,113421924,1,0,1,7168,6,5519429038
2132,113426790,76945,113503735,9,0,0,7168,18,3685792050
2133,113610959,15837,113626796,3,0,1,30720,2,9957041019
2134,113712140,127614,113839754,9,0,0,4096,18,8428882900
2135,113713660,47600,113761260,0,0,0,2560,11,9037621050
2136,113789060,87320,113876380,9,0,0,22016,18,3516292070
2137,113791360,69152,113860512,3,0,0,12800,2,6481111155
2138,113807010,53673,113860683,2,0,0,512,4,362902985
2139,113929390,87476,114016866,9,0,0,22528,18,2460718636
2140,114014419,116891,114131310,7,0,0,75776,8,638875561
2141,114036070,166100,114202170,9,0,0,38912,18,9933276099
2142,114048170,85963,114134133,0,0,0,9216,11,2513194084
2143,114062870,107812,114170682,0,0,0,6144,11,5963972771
2144,114073310,135427,114208737,8,0,0,21504,12,8481372753
2145,114143010,88254,114231264,4,0,0,12288,16,7921015941
2146,114175340,3128,114178468,5,0,1,9216,19,8466036573
2147,114363220,88076,114451296,8,0,0,19456,12,1256660756
2148,114472330,76832,114549162,9,0,0,12800,18,4743469290
2149,114473050,59132,114532182,0,0,0,5120,11,5758328527
2150,114511140,65900,114577040,2,0,0,7168,4,9560242178
2151,114512800,65503,114578303,4,0,0,4096,16,5399346264
2152,114585310,54056,114639366,4,0,0,3584,16,4620476758
2153,114724280,66080,114790360,5,0,0,12800,19,9053003343
2154,114770430,50984,114821414,1,0,0,3584,6,9026216727
2155,114830360,3645,114834005,5,0,1,10240,19,7652821108
2156,114932170,100256,115032426,2,0,0,29184,4,2788928146
2157,114978640,64208,115042848,8,0,0,6656,12,6296865886
2158,115078610,7706,115086316,0,0,1,8192,11,1752183833
2159,115123120,43904,115167024,5,0,0,512,19,10448474651
2160,115134290,74672,115208962,8,0,0,10752,12,7931663306
2161,115154090,2946,115157036,2,0,1,3072,4,1406834813
2162,115247030,47288,115294318,3,0,0,1536,2,5306260485
2163,115262550,4937,115267487,6,0,1,12800,12,9685300176
2164,115320200,74696,115394896,4,0,0,15872,16,6219127280
2165,115343830,84068,115427898,4,0,0,16384,16,1927036008
2166,115428810,99632,115528442,8,0,0,27136,12,1940878139
2167,115443510,47288,115490798,1,0,0,1536,6,5466959111
2168,115463649,566,115464215,8,0,1,512,12,9500850510
2169,115484500,107588,115592088,3,0,0,53248,2,5555614062
2170,115552720,54056,115606776,2,0,0,3584,4,1799026763
2171,115573120,101192,115674312,3,0,0,32256,2,6006405077
2172,115633199,104936,115738135,7,0,0,44544,8,3318634807
2173,115728470,76493,115804963,1,0,0,10240,6,5913930456
2174,115729370,126845,115856215,9,0,0,32256,18,7012292027
2175,115729480,250767,115980247,5,0,0,33792,19,10721561518
2176,115787270,170329,115957599,4,0,0,18944,16,5480250549
2177,115792630,16613,115809243,1,0,1,32256,6,9444153445
2178,115805520,189537,115995057,4,0,0,39936,16,6225802454
2179,115951589,6025,115957614,8,0,1,4608,12,5673162750
2180,115986730,116219,116102949,8,0,0,54272,12,3654690217
2181,116053290,90213,116143503,4,0,0,14848,16,5518176745
2182,116136000,125182,116261182,3,0,0,80896,2,3684410446
2183,116145170,79436,116224606,2,0,0,11264,4,2139475497
2184,116278849,3645,116282494,5,0,1,10240,19,5734087762
2185,116290210,56840,116347050,1,0,0,7680,6,6852953334
2186,116354020,50828,116404848,3,0,0,3072,2,7682269656
2187,116573391,7230,116580621,4,0,1,7680,16,9392302321
2188,116603099,109460,116712559,7,0,0,59392,8,1788761778
2189,116609380,166754,116776134,4,0,0,7168,16,4739305651
2190,116623260,50672,116673932,9,0,0,2560,18,9511174518
2191,116666509,98790,116765299,7,0,0,23552,8,2957522226
2192,116745890,103376,116849266,2,0,0,39424,4,5380209938
2193,116834150,98072,116932222,3,0,0,22016,2,6036471386
2194,116862399,60824,116923223,7,0,0,5632,8,8944491235
2195,116864960,20882,116885842,2,0,1,33792,4,536141430
2196,116878630,89607,116968237,1,0,0,4096,6,10238320116
2197,116888560,90141,116978701,8,0,0,8192,12,1949423002
2198,117009080,101504,117110584,5,0,0,33280,19,9161949367
2199,117090980,101972,117192952,9,0,0,34816,18,8160467435
2200,117128180,161816,117289996,4,0,0,13312,16,10155661862
2201,117159319,105129,117264448,7,0,0,35328,8,1059714574
2202,117182019,110644,117292663,7,0,0,8704,8,5169423334
2203,117382390,105560,117487950,1,0,0,46592,6,3941199442
2204,117505299,3387,117508686,8,0,1,9728,12,3026159768
2205,117513769,3422,117517191,8,0,1,3584,12,3869996445
2206,117549500,77744,117627244,3,0,0,10752,2,7298170023
2207,117559160,170393,117729553,8,0,0,35328,12,548449445
2208,117597860,88358,117686218,5,0,0,5120,19,2926094653
2209,117651880,5802,117657682,0,0,1,6144,11,8630335578
2210,117752010,97448,117849458,3,0,0,19968,2,377927897
2211,117761800,103397,117865197,4,0,0,25088,16,248803385
2212,117766720,109084,117875804,9,0,0,29696,18,2976813472
2213,117769010,169081,117938091,8,0,0,36352,12,6943900703
2214,117895449,2470,117897919,8,0,1,2560,12,9145741701
2215,117914470,109092,118023562,3,0,0,33280,2,3859156488
2216,117923669,14437,117938106,8,0,1,3584,12,5221715466
2217,118027410,88676,118116086,1,0,0,16384,6,4977479993
2218,118028190,78368,118106558,2,0,0,12800,4,8393810663
2219,118045430,73011,118118441,0,0,0,7680,11,473267742
2220,118061500,153226,118214726,4,0,0,40448,16,2988723465
2221,118067080,76676,118143756,5,0,0,12288,19,6143572089
2222,118154630,74874,118229504,5,0,0,7168,19,8271977233
2223,118266800,121472,118388272,2,0,0,98816,4,2625283422
2224,118317290,4850,118322140,0,0,1,5120,11,10648146043
2225,118443590,122408,118565998,1,0,0,101888,6,10443598044
2226,118551700,110514,118662214,5,0,0,20992,19,7235901971
2227,118634960,65300,118700260,1,0,0,10240,6,8933048975
2228,118640700,4850,118645550,2,0,1,5120,4,5130128685
2229,118664610,145510,118810120,9,0,0,101376,18,2985581787
2230,118667480,91878,118759358,9,0,0,1024,18,9181926621
2231,118685340,160688,118846028,9,0,0,67584,18,5907267384
2232,118764080,154370,118918450,3,0,0,37376,2,4113131143
2233,118855430,141872,118997302,3,0,0,67072,2,6599305639
2234,118857280,2946,118860226,2,0,1,3072,4,4807386709
2235,118877700,6754,118884454,2,0,1,7168,4,5288959989
2236,118959899,11533,118971432,8,0,1,18944,12,1301464380
2237,118981800,103126,119084926,0,0,0,23040,11,1538054572
2238,119016090,76696,119092786,5,0,0,4096,19,1185078053
2239,119088190,101972,119190162,8,0,0,34816,12,9352168069
2240,119102530,52364,119154894,9,0,0,3072,18,9692508639
2241,119105320,104312,119209632,1,0,0,42496,6,2118002667
2242,119143780,13512,119157292,0,0,1,26112,11,5447943242
2243,119225810,92216,119318026,0,0,0,17920,11,2135880121
2244,119240279,144936,119385215,7,0,0,35840,8,499241489
2245,119297810,104181,119401991,0,0,0,10240,11,3404634683
2246,119314990,183139,119498129,4,0,0,97792,16,3119064606
2247,119446869,10241,119457110,3,0,1,16384,2,4745456267
2248,119461130,47288,119508418,5,0,0,1536,19,4916102377
2249,119552250,77725,119629975,0,0,0,4608,11,1023423803
2250,119562440,11016,119573456,0,0,1,17920,11,4929829930
2251,119564960,8650,119573610,7,0,1,8704,8,7918582164
2252,119591090,3128,119594218,0,0,1,9216,11,9223235469
2253,119695510,63452,119758962,4,0,0,9216,16,10233144725
2254,119726339,69361,119795700,7,0,0,7680,8,3858820276
2255,119749839,1518,119751357,8,0,1,1536,12,3646476573
2256,119780901,5971,119786872,4,0,1,14848,16,8455314224
2257,119786760,129657,119916417,5,0,0,64000,19,5725066969
2258,119838570,106652,119945222,0,0,0,50176,11,8233210731
2259,119960690,72012,120032702,3,0,0,5120,2,10344476165
2260,119973570,134990,120108560,9,0,0,26112,18,7927714809
2261,120012130,145006,120157136,4,0,0,34304,16,994351067
2262,120023759,2470,120026229,8,0,1,2560,12,1728888296
2263,120052890,82820,120135710,5,0,0,12288,19,3891091398
2264,120092600,74904,120167504,0,0,0,4608,11,10303277772
2265,120156120,129368,120285488,2,0,0,92160,4,10705525836
2266,120181740,566,120182306,2,0,1,512,4,5776327754
2267,120318560,6278,120324838,7,0,1,6656,8,6640619325
2268,120355640,94712,120450352,8,0,0,26112,12,9969120127
2269,120441180,9187,120450367,6,0,1,5632,12,9298766354
2270,120484520,221964,120706484,2,0,0,98304,4,3717409404
2271,120529530,83624,120613154,8,0,0,19968,12,1518975753
2272,120533570,220189,120753759,8,0,0,39424,12,8009335297
2273,120549910,125238,120675148,8,0,0,26112,12,5327919026
2274,120626080,566,120626646,6,0,1,512,12,1946473219
2275,120632459,75132,120707591,7,0,0,3584,8,172242067
2276,120638860,211973,120850833,5,0,0,130048,19,7038490164
2277,120733760,120208,120853968,9,0,0,10240,18,1885779578
2278,120787990,76052,120864042,3,0,0,10240,2,1680103111
2279,120810800,57440,120868240,3,0,0,4608,2,6727292270
2280,120833590,22381,120855971,7,0,1,2048,8,2343244287
2281,120840219,87394,120927613,7,0,0,17408,8,2851080814
2282,120896650,74889,120971539,2,0,0,9216,4,1446895471
2283,121000520,101036,121101556,4,0,0,31744,16,10436226567
2284,121027059,74512,121101571,3,0,1,111104,2,4762645364
2285,121139110,272106,121411216,2,0,0,110080,4,1273935876
2286,121153690,2470,121156160,7,0,1,2560,8,6553788514
2287,121158510,106028,121264538,8,0,0,48128,12,9806924444
2288,121197819,221992,121419811,7,0,0,28160,8,10358497206
2289,121213520,73136,121286656,0,0,0,10752,11,4986559852
2290,121216850,99788,121316638,2,0,0,27648,4,4883747596
2291,121253450,111572,121365022,5,0,0,9728,19,9256829519
2292,121256180,172858,121429038,2,0,0,30208,4,452947258
2293,121322520,144106,121466626,4,0,0,28672,16,4861611027
2294,121393180,98247,121491427,0,0,0,15872,11,8058098669
2295,121423380,85594,121508974,0,0,0,4096,11,9200911735
2296,121480829,126696,121607525,3,0,1,209920,2,2251946967
2297,121541110,219100,121760210,2,0,0,7168,4,4069793038
2298,121544110,258245,121802355,8,0,0,8192,12,4951634485
2299,121552300,81857,121634157,5,0,0,3072,19,10686088612
2300,121581120,159193,121740313,4,0,0,15872,16,5304372189
2301,121605660,5091,121610751,2,0,1,5120,4,9293282730
2302,121616530,77707,121694237,8,0,0,5632,12,7489209287
2303,121633230,244693,121877923,2,0,0,12288,4,3234348501
2304,121703590,4162,121707752,2,0,1,11264,4,4643520174
2305,121751410,4162,121755572,6,0,1,11264,12,5476715506
2306,121757100,75225,121832325,9,0,0,4608,18,1476592964
2307,121888999,99164,121988163,7,0,0,25600,8,533896753
2308,121941150,47340,121988490,1,0,0,1024,6,5425930718
2309,121956370,95350,122051720,9,0,0,26624,18,7099108033
2310,122051110,107344,122158454,3,0,0,33280,2,7027445319
2311,122063110,64208,122127318,0,0,0,6656,11,10711238914
2312,122072310,70532,122142842,1,0,0,8192,6,5034144920
2313,122099720,129666,122229386,8,0,0,11776,12,10469875933
2314,122262720,88700,122351420,3,0,0,21504,2,1147592464
2315,122378640,55748,122434388,5,0,0,4096,19,9514346858
2316,122397180,109616,122506796,2,0,0,59904,4,6303003149
2317,122404740,109121,122513861,2,0,0,23040,4,10468026256
2318,122414199,6229,122420428,3,0,1,15360,2,9115159108
2319,122439719,5802,122445521,3,0,1,6144,2,6450727544
2320,122463470,12737,122476207,7,0,1,24576,8,8183630908
2321,122464010,208100,122672110,0,0,0,56832,11,928137916
2322,122466090,134218,122600308,3,0,0,49152,2,1059366378
2323,122480519,26292,122506811,8,0,1,20992,12,6345438028
2324,122487281,19545,122506826,4,0,1,11776,16,4378164982
2325,122496429,22274,122518703,8,0,1,5120,12,10666582240
2326,122596550,120461,122717011,3,0,0,40448,2,6600575358
2327,122607330,153139,122760469,1,0,0,30720,6,3797485999
2328,122607420,2946,122610366,7,0,1,3072,8,3793375886
2329,122679979,101348,122781327,7,0,0,32768,8,6024767011
2330,122738680,94367,122833047,5,0,0,8704,19,2221640545
2331,122950880,56372,123007252,5,0,0,6144,19,8404817016
2332,123054090,47288,123101378,3,0,0,1536,2,770608839
2333,123185640,97448,123283088,3,0,0,19968,2,2452367677
2334,123215379,77924,123293303,7,0,0,16384,8,8051258992
2335,123228350,13512,123241862,5,0,1,26112,19,3719033877
2336,123326779,101454,123428233,7,0,0,22016,8,4515903937
2337,123327710,93800,123421510,2,0,0,28160,4,3375867524
2338,123331480,144666,123476146,1,0,0,51200,6,10157852751
2339,123519559,102128,123621687,7,0,0,35328,8,3089589722
2340,123605760,55748,123661508,5,0,0,4096,19,3647271113
2341,123618750,103341,123722091,0,0,0,29696,11,6996897328
2342,123638040,96254,123734294,5,0,0,25088,19,2253434018
2343,123793640,2946,123796586,2,0,1,3072,4,2279061818
2344,123830560,105092,123935652,1,0,0,45056,6,926398812
2345,123847709,4162,123851871,8,0,1,11264,12,6963132000
2346,123900230,77744,123977974,4,0,0,10752,16,3354453825
2347,123907700,54992,123962692,3,0,0,6656,2,9038273046
2348,123976690,86100,124062790,9,0,0,13824,18,1342239527
2349,124062900,110708,124173608,4,0,0,63488,16,10264704702
2350,124160820,96872,124257692,3,0,0,21504,2,7934517546
2351,124195709,134853,124330562,7,0,0,27648,8,5625561114
2352,124245000,76052,124321052,0,0,0,10240,11,4351584680
2353,124267290,115796,124383086,4,0,0,31232,16,2804061352
2354,124281270,4937,124286207,1,0,1,12800,6,5259176057
2355,124437100,566,124437666,0,0,1,512,11,5489337299
2356,124586260,110552,124696812,4,0,0,62976,16,9507020250
2357,124663740,103176,124766916,1,0,0,28672,6,4096739741
2358,124867329,60824,124928153,7,0,0,5632,8,8225682756
2359,124910349,13083,124923432,3,0,1,22016,2,5365601909
2360,124974910,119043,125093953,3,0,0,38912,2,9957288460
2361,124978340,3128,124981468,1,0,1,9216,6,6760256565
2362,125049330,78680,125128010,3,0,0,13824,2,4814021560
2363,125185600,108212,125293812,2,0,0,55296,4,4665586669
2364,125242239,566,125242805,3,0,1,512,2,1710275373
2365,125268080,54056,125322136,0,0,0,3584,11,3870147050
2366,125371770,103376,125475146,4,0,0,39424,16,6027113595
2367,125405170,48980,125454150,3,0,0,2048,2,5387462170
2368,125419440,92618,125512058,1,0,0,2048,6,4495914528
2369,125481760,68840,125550600,4,0,0,11776,16,3738287671
2370,125508710,110092,125618802,5,0,0,37888,19,6288316914
2371,125525110,122523,125647633,2,0,0,9216,4,1204292413
2372,125526810,3898,125530708,2,0,1,4096,4,7021116098
2373,125528780,2274,125531054,1,0,1,512,6,3575236590
2374,125534800,43904,125578704,9,0,0,512,18,6002741906
2375,125535000,72156,125607156,4,0,0,3584,16,4903765238
2376,125562489,4679,125567168,8,0,1,12288,12,8934700339
2377,125647230,1913,125649143,7,0,1,1536,8,1031281891
2378,125735750,103532,125839282,0,0,0,39936,11,4931309391
2379,125782591,3645,125786236,4,0,1,10240,16,6127854953
2380,125881740,97160,125978900,4,0,0,24064,16,2686150895
2381,125943030,133814,126076844,9,0,0,43520,18,6059153995
2382,125951910,67460,126019370,2,0,0,12288,4,7711738419
2383,126036309,6229,126042538,5,0,1,15360,19,9098439358
2384,126080410,231932,126312342,2,0,0,110080,4,312891045
2385,126108870,52364,126161234,3,0,0,3072,2,9452749297
2386,126156330,165855,126322185,5,0,0,32256,19,10332562428
2387,126167070,76670,126243740,1,0,0,3072,6,472238204
2388,126228740,105948,126334688,4,0,0,40960,16,1259843657
2389,126248540,105006,126353546,1,0,0,24576,6,1380647685
2390,126290759,123346,126414105,7,0,0,22016,8,1953191953
2391,126324630,120950,126445580,4,0,0,23040,16,7880732663
2392,126427711,566,126428277,4,0,1,512,16,1204242589
2393,126560050,102752,126662802,2,0,0,37376,4,7974892956
2394,126653970,57804,126711774,5,0,0,2048,19,1882784036
2395,126724340,57440,126781780,4,0,0,4608,16,10277096799
2396,126751460,119906,126871366,5,0,0,70656,19,3428772639
2397,126862840,90894,126953734,5,0,0,15872,19,6816769653
2398,126900570,58978,126959548,9,0,0,3584,18,616809941
2399,126934760,1994,126936754,6,0,1,2048,12,3301900554
2400,127041109,3645,127044754,3,0,1,10240,2,10489175215
2401,127057490,130732,127188222,0,0,0,15360,11,2473263477
2402,127100429,566,127100995,3,0,1,512,2,3275512077
2403,127110610,60824,127171434,9,0,0,5632,18,6218286087
2404,127395720,110084,127505804,4,0,0,61440,16,9289612046
2405,127419690,3422,127423112,7,0,1,3584,8,7997038877
2406,127668220,109616,127777836,3,0,0,59904,2,1061601782
2407,127768649,14981,127783630,5,0,1,6144,19,4954552315
2408,127787000,1994,127788994,6,0,1,2048,12,4645412164
2409,127816000,5971,127821971,0,0,1,14848,11,8997308139
2410,127960360,104780,128065140,0,0,0,44032,11,6865691243
2411,127999160,118462,128117622,2,0,0,58880,4,3828943891
2412,128052510,100830,128153340,5,0,0,14848,19,3931793309
2413,128068950,100724,128169674,1,0,0,30720,6,2133537736
2414,128083590,121284,128204874,1,0,0,56832,6,967432253
2415,128109591,10017,128119608,4,0,1,2048,16,714396994
2416,128147231,91691,128238922,6,0,0,14848,12,5006591305
2417,128190930,91680,128282610,9,0,0,10752,18,10259383526
2418,128208100,90236,128298336,0,0,0,21504,11,7459899502
2419,128338149,6229,128344378,8,0,1,15360,12,9702306870
2420,128347250,91788,128439038,4,0,0,4608,16,7254632545
2421,128368141,1042,128369183,4,0,1,1024,16,1339634480
2422,128397299,2870,128400169,5,0,1,8704,19,9574037224
2423,128416020,12308,128428328,0,0,1,20480,11,9836697573
2424,128432720,154563,128587283,2,0,0,59392,4,633105544
2425,128444970,86986,128531956,9,0,0,11264,18,6058857534
2426,128451420,3422,128454842,2,0,1,3584,4,2492752312
2427,128510359,154292,128664651,7,0,0,15360,8,8686068710
2428,128645150,3128,128648278,2,0,1,9216,4,3950041541
2429,128653510,22174,128675684,7,0,1,36352,8,1601143146
2430,128660250,84093,128744343,9,0,0,1024,18,1429596014
2431,128719229,6229,128725458,8,0,1,15360,12,5208895776
2432,128746680,1518,128748198,2,0,1,1536,4,9953854571
2433,128799861,1042,128800903,4,0,1,1024,16,1983733867
2434,128804160,4374,128808534,2,0,1,4608,4,1246747008
2435,128814710,55748,128870458,9,0,0,4096,18,8629578700
2436,128849069,76052,128925121,7,0,0,10240,8,1244693127
2437,128850850,70688,128921538,4,0,0,12800,16,2448996175
2438,128870070,197756,129067826,9,0,0,68608,18,8035277843
2439,128885390,153298,129038688,4,0,0,28160,16,8476051776
2440,128982841,132017,129114858,6,0,0,50176,12,955378693
2441,128995880,93908,129089788,0,0,0,18432,11,5458738360
2442,129006989,3898,129010887,5,0,1,4096,19,5144086324
2443,129066540,8984,129075524,7,0,1,8192,8,9335330710
2444,129090970,58376,129149346,1,0,0,7680,6,3794490649
2445,129178640,98540,129277180,2,0,0,23552,4,3821687796
2446,129389661,91484,129481145,6,0,0,25600,12,4392708231
2447,129393610,72668,129466278,0,0,0,9216,11,3096120045
2448,129438530,76373,129514903,1,0,0,1024,6,4330851693
2449,129439389,182609,129621998,7,0,0,20992,8,8803173437
2450,129444800,69776,129514576,3,0,0,14848,2,2614334832
2451,129479170,73411,129552581,4,0,0,10240,16,4186642907
2452,129481230,103064,129584294,1,0,0,38400,6,9886399758
2453,129497380,65485,129562865,3,0,0,8704,2,8935474642
2454,129557121,117233,129674354,6,0,0,34304,12,10598266253
2455,129581980,6726,129588706,6,0,1,11776,12,1913805063
2456,129609730,137050,129746780,2,0,0,44032,4,2109641347
2457,129620800,136603,129757403,2,0,0,34816,4,1101785417
2458,129649090,118258,129767348,8,0,0,9728,12,5776572864
2459,129851910,83936,129935846,0,0,0,20992,11,8772711562
2460,129943990,82820,130026810,1,0,0,12288,6,7603982877
2461,129993660,99320,130092980,4,0,0,26112,16,531971662
2462,130151120,177305,130328425,9,0,0,58368,18,4274759699
2463,130157860,104376,130262236,1,0,0,19456,6,6261865588
2464,130159959,150667,130310626,7,0,0,46080,8,5377518346
2465,130172651,159533,130332184,6,0,0,12288,12,2751246211
2466,130198320,184432,130382752,4,0,0,24576,16,8577604213
2467,130241689,94566,130336255,7,0,0,13312,8,9146221045
2468,130263730,109357,130373087,4,0,0,9216,16,231303916
2469,130270049,4850,130274899,3,0,1,5120,2,2822346099
2470,130431380,109616,130540996,5,0,0,59904,19,2747231430
2471,130447311,116401,130563712,6,0,0,23552,12,1761383948
2472,130495460,83726,130579186,9,0,0,7680,18,1205511667
2473,130706850,110396,130817246,4,0,0,62464,16,8209152640
2474,130714849,50672,130765521,7,0,0,2560,8,5990316365
2475,130737771,86664,130824435,6,0,0,13312,12,9627738118
2476,130923360,88100,131011460,3,0,0,24576,2,2102157608
2477,130978930,91748,131070678,3,0,0,16384,2,4638618881
2478,131014420,65900,131080320,1,0,0,7168,6,9858022692
2479,131022169,144491,131166660,7,0,0,103424,8,3539767212
2480,131027010,160733,131187743,0,0,0,69120,11,3289093693
2481,131159320,105092,131264412,1,0,0,20992,6,4225251834
2482,131194039,52364,131246403,7,0,0,3072,8,9190199185
2483,131204150,67304,131271454,0,0,0,11776,11,7778545364
2484,131215800,2470,131218270,2,0,1,2560,4,6690313344
2485,131259130,88718,131347848,3,0,0,14336,2,5141870298
2486,131262320,56165,131318485,1,0,0,3584,6,6801532785
2487,131311719,3422,131315141,3,0,1,3584,2,1777541685
2488,131430430,5802,131436232,2,0,1,6144,4,1958028336
2489,131445070,5802,131450872,0,0,1,6144,11,4785820345
2490,131488049,6278,131494327,5,0,1,6656,19,6264104053
2491,131532729,60824,131593553,7,0,0,5632,8,4780247279
2492,131532770,4937,131537707,2,0,1,12800,4,6795439173
2493,131662360,90992,131753352,5,0,0,18944,19,7094912193
2494,131672680,163539,131836219,4,0,0,13824,16,8838771264
2495,131699659,2470,131702129,3,0,1,2560,2,5832030103
2496,131702970,566,131703536,7,0,1,512,8,1286213461
2497,131734080,24670,131758750,7,0,1,44544,8,2213696735
2498,131880870,47288,131928158,9,0,0,1536,18,9551800005
2499,131948650,103844,132052494,5,0,0,40960,19,9987047630
2500,131953061,72871,132025932,6,0,0,3072,12,10222338347
2501,132049910,3142,132053052,0,0,1,512,11,4715728238
2502,132093160,47288,132140448,1,0,0,1536,6,4673064834
2503,132115140,79748,132194888,3,0,0,12288,2,5327039772
2504,132180670,14233,132194903,6,0,1,23040,12,8210921044
2505,132180980,15236,132196216,0,0,1,3072,11,5931320584
2506,132236670,156752,132393422,9,0,0,16384,18,4419259532
2507,132306670,54056,132360726,4,0,0,3584,16,492156881
2508,132392600,67806,132460406,0,0,0,10752,11,2778838424
2509,132457531,51847,132509378,6,0,0,2048,12,7660656975
2510,132492080,62516,132554596,1,0,0,6144,6,1763216227
2511,132516320,85916,132602236,1,0,0,17408,6,9789238435
2512,132714000,97316,132811316,0,0,0,24576,11,5201797823
2513,132724801,69284,132794085,6,0,0,8192,12,1549099693
2514,132747160,131146,132878306,5,0,0,87040,19,6946733266
2515,132806550,174510,132981060,3,0,0,16896,2,2533986625
2516,132830160,125724,132955884,0,0,0,85504,11,5415769874
2517,133021500,100880,133122380,2,0,0,31232,4,8694403908
2518,133108930,20624,133129554,7,0,1,33280,8,6925614711
2519,133127081,117625,133244706,6,0,0,3072,12,8190228129
2520,133129580,114175,133243755,0,0,0,17408,11,7234983820
2521,133131690,55748,133187438,1,0,0,4096,6,7979036941
2522,133253730,167902,133421632,9,0,0,54784,18,2754035578
2523,133273640,111488,133385128,3,0,0,66048,2,9693781442
2524,133359800,117017,133476817,4,0,0,37376,16,6393378298
2525,133391159,108110,133499269,7,0,0,10240,8,414023946
2526,133484271,56840,133541111,6,0,0,7680,12,5800640183
2527,133526170,59132,133585302,0,0,0,5120,11,2049685269
2528,133596200,48980,133645180,5,0,0,2048,19,5514324000
2529,133618020,1518,133619538,7,0,1,1536,8,2062533321
2530,133661349,4374,133665723,8,0,1,4608,12,3504912305
2531,133713579,87764,133801343,7,0,0,18432,8,6088184451
2532,133783221,45596,133828817,6,0,0,1024,12,10498013356
2533,133828070,109928,133937998,1,0,0,60928,6,10588460308
2534,133912790,61112,133973902,2,0,0,5120,4,4887384215
2535,133912900,111956,134024856,3,0,0,67584,2,8655532528
2536,133988329,123311,134111640,7,0,0,52736,8,10384368344
2537,134051980,64208,134116188,1,0,0,6656,6,452727873
2538,134057310,100722,134158032,2,0,0,6144,4,5502652751
2539,134084910,97434,134182344,0,0,0,15360,11,5084949924
2540,134148170,566,134148736,6,0,1,512,12,6129900315
2541,134148540,99500,134248040,8,0,0,31744,12,5548094783
2542,134299381,84980,134384361,6,0,0,14336,12,3282504444
2543,134321590,84512,134406102,3,0,0,12800,2,9901561916
2544,134348490,58875,134407365,2,0,0,4096,4,2052100090
2545,134414890,103532,134518422,9,0,0,39936,18,146062123
2546,134436470,69752,134506222,4,0,0,9728,16,83191024
2547,134446741,5326,134452067,4,0,1,5632,16,1855757930
2548,134653969,31007,134684976,5,0,1,50176,19,4727575526
2549,134814490,76856,134891346,0,0,0,17920,11,6727317418
2550,134836119,81128,134917247,7,0,0,11776,8,5991986401
2551,134891390,112635,135004025,4,0,0,68608,16,3488466655
2552,135001550,15979,135017529,2,0,1,26112,4,396468302
2553,135026790,58640,135085430,1,0,0,512,6,4674482616
2554,135051220,186320,135237540,2,0,0,34304,4,10040610686
2555,135079330,4850,135084180,2,0,1,5120,4,9788679930
2556,135150180,10757,135160937,1,0,1,17408,6,237977038
2557,135163410,1518,135164928,6,0,1,1536,12,1955648286
2558,135182770,239598,135422368,3,0,0,105984,2,3849399256
2559,135264980,125073,135390053,1,0,0,48128,6,769686690
2560,135296360,173511,135469871,3,0,0,17408,2,10200332604
2561,135312790,13341,135326131,9,0,1,22528,18,8851426881
2562,135312910,121122,135434032,3,0,0,10752,2,4499651498
2563,135332530,245875,135578405,9,0,0,29696,18,2792906267
2564,135343589,267276,135610865,7,0,0,10752,8,8389067374
2565,135387860,38112,135425972,7,0,1,10240,8,9093975771
2566,135400220,33827,135434047,5,0,1,7680,19,5216701949
2567,135403919,139158,135543077,7,0,0,29696,8,996426559
2568,135418459,40160,135458619,3,0,1,49664,2,5068359491
2569,135423230,212950,135636180,1,0,0,15360,6,6457084637
2570,135437349,25456,135462805,8,0,1,6656,12,2822228999
2571,135445579,106017,135551596,7,0,0,19968,8,4166831887
2572,135480190,203359,135683549,2,0,0,35328,4,2985946921
2573,135585340,110830,135696170,9,0,0,4608,18,175351627
2574,135669800,118786,135788586,0,0,0,25088,11,4499102514
2575,135726751,43904,135770655,6,0,0,512,12,3676484115
2576,135783670,80960,135864630,4,0,0,10240,16,9006272520
2577,135900340,84512,135984852,9,0,0,12800,18,4018440353
2578,135964840,69776,136034616,4,0,0,14848,16,3226583888
2579,136107250,68372,136175622,1,0,0,10240,6,2030347472
2580,136134551,127849,136262400,6,0,0,67072,12,4623981923
2581,136207380,4420,136211800,7,0,1,11776,8,4458631083
2582,136220840,82540,136303380,3,0,0,12800,2,5908234252
2583,136250170,74738,136324908,2,0,0,6144,4,8294021926
2584,136313570,80463,136394033,2,0,0,6144,4,9557999058
2585,136362369,64208,136426577,7,0,0,6656,8,3997832496
2586,136368061,111970,136480031,6,0,0,60416,12,9093632879
2587,136411650,74853,136486503,1,0,0,2048,6,4462113919
2588,136496750,2946,136499696,9,0,1,3072,18,665567396
2589,136658870,60980,136719850,2,0,0,6144,4,3623051422
2590,136670680,110760,136781440,3,0,0,30720,2,5655865012
2591,136750420,6278,136756698,1,0,1,6656,6,6219499408
2592,136808500,61760,136870260,2,0,0,8704,4,4511873971
2593,136853279,182901,137036180,7,0,0,60928,8,2045279643
2594,136856790,101504,136958294,1,0,0,33280,6,4275569350
2595,136955211,61139,137016350,6,0,0,6656,12,9541218611
2596,137008950,109490,137118440,9,0,0,31232,18,1989112727
2597,137015691,59027,137074718,6,0,0,7680,12,728786743
2598,137037130,129994,137167124,1,0,0,29696,6,7673646986
2599,137053719,5712,137059431,3,0,1,14336,2,9993559558
2600,137072130,46637,137118767,3,0,0,1024,2,8698025975
2601,137168570,11533,137180103,9,0,1,18944,18,8191126460
2602,137199460,96824,137296284,3,0,0,17920,2,3134552990
2603,137270760,99164,137369924,9,0,0,25600,18,2425605465
2604,137344640,3422,137348062,7,0,1,3584,8,2393014675
2605,137388150,77300,137465450,2,0,0,14336,4,6077153865
2606,137403270,55748,137459018,9,0,0,4096,18,4957142817
2607,137436330,2470,137438800,7,0,1,2560,8,1655471149
2608,137495269,3904,137499173,5,0,1,10752,19,10520076230
2609,137521270,65900,137587170,2,0,0,7168,4,9188884841
2610,137537941,117926,137655867,6,0,0,63488,12,4938893811
2611,137574739,156182,137730921,7,0,0,76800,8,1014980105
2612,137589991,153121,137743112,6,0,0,39936,12,3574836633
2613,137610650,1994,137612644,7,0,1,2048,8,7790477764
2614,137615050,128857,137743907,1,0,0,2560,6,501247281
2615,137663410,143759,137807169,4,0,0,42496,16,9086472484
2616,137690900,119872,137810772,3,0,0,11776,2,7382886231
2617,137704331,131827,137836158,6,0,0,30208,12,6814842590
2618,137715880,111059,137826939,1,0,0,25600,6,10551046788
2619,137772890,77959,137850849,9,0,0,7168,18,7645163575
2620,137786461,69932,137856393,6,0,0,10240,12,2542613396
2621,137916360,65900,137982260,1,0,0,7168,6,4238389322
2622,137966580,71972,138038552,3,0,0,8192,2,1670029049
2623,138003990,97028,138101018,4,0,0,28672,16,2715065733
2624,138087751,113048,138200799,6,0,0,71168,12,7022813263
2625,138114109,7706,138121815,8,0,1,8192,12,2902179404
2626,138139060,112604,138251664,5,0,0,28160,19,6405835683
2627,138159680,65599,138225279,0,0,0,3072,11,6318044504
2628,138217270,156666,138373936,4,0,0,41984,16,1251991863
2629,138230740,104624,138335364,3,0,0,43520,2,653338561
2630,138242339,9340,138251679,3,0,1,8192,2,7837409598
2631,138302989,7230,138310219,8,0,1,7680,12,4549260762
2632,138350450,74946,138425396,2,0,0,8704,4,986935897
2633,138361340,205082,138566422,2,0,0,30720,4,4237539211
2634,138384599,53189,138437788,7,0,0,5120,8,2168661787
2635,138405110,47600,138452710,9,0,0,2560,18,1507927486
2636,138444499,156958,138601457,7,0,0,43520,8,6453773967
2637,138477680,1042,138478722,0,0,1,1024,11,8737093815
2638,138500380,175491,138675871,9,0,0,20992,18,10010790631
2639,138541860,1994,138543854,1,0,1,2048,6,10665878425
2640,138622120,81726,138703846,2,0,0,12800,4,3986069836
2641,138628550,109415,138737965,1,0,0,22016,6,3591142916
2642,138691560,3898,138695458,2,0,1,4096,4,442456945
2643,138755040,73004,138828044,9,0,0,15360,18,8866419183
2644,138766640,2470,138769110,9,0,1,2560,18,3093428321
2645,138782770,108056,138890826,5,0,0,54784,19,9813763351
2646,138839521,118271,138957792,6,0,0,46592,12,2128542761
2647,139010260,167317,139177577,5,0,0,113664,19,1599857809
2648,139041010,62516,139103526,0,0,0,6144,11,10223617915
2649,139113300,119537,139232837,0,0,0,25600,11,1898033160
2650,139142470,35122,139177592,2,0,1,6656,4,9360090379
2651,139191781,1042,139192823,4,0,1,1024,16,8055330862
2652,139404970,54992,139459962,4,0,0,6656,16,1859655705
2653,139451380,103844,139555224,1,0,0,40960,6,4918007289
2654,139453930,84746,139538676,1,0,0,16896,6,2698439760
2655,139469960,133504,139603464,4,0,0,43008,16,201639371
2656,139525921,169007,139694928,6,0,0,43520,12,6952014279
2657,139533580,54696,139588276,2,0,0,512,4,10727549829
2658,139614450,143076,139757526,3,0,0,20992,2,5128084699
2659,139703820,74934,139778754,4,0,0,12800,16,1870136369
2660,139739260,1994,139741254,7,0,1,2048,8,6088512571
2661,139789580,160095,139949675,0,0,0,10240,11,3105072782
2662,139828330,47288,139875618,0,0,0,1536,11,9348672532
2663,139911290,65144,139976434,9,0,0,9728,18,6841335351
2664,139928651,55127,139983778,6,0,0,3584,12,6866681687
2665,139937269,40874,139978143,8,0,1,66048,12,10264536737
2666,139965280,103532,140068812,1,0,0,39936,6,7005504582
2667,140032611,100989,140133600,6,0,0,18432,12,9452105396
2668,140051280,143172,140194452,0,0,0,56832,11,8020527229
2669,140062030,166184,140228214,4,0,0,10240,16,6803721147
2670,140173849,79928,140253777,7,0,0,17920,8,7208215976
2671,140228430,84068,140312498,9,0,0,16384,18,1439681048
2672,140460680,6754,140467434,7,0,1,7168,8,6880687523
2673,140487450,103532,140590982,9,0,0,39936,18,9961302153
2674,140488739,45596,140534335,7,0,0,1024,8,4329300990
2675,140539720,139102,140678822,0,0,0,53760,11,9178693763
2676,140573001,87149,140660150,6,0,0,2560,12,1047568778
2677,140577020,102753,140679773,3,0,0,3072,2,8124979930
2678,140606520,153074,140759594,3,0,0,34304,2,8286471805
2679,140622780,3128,140625908,2,0,1,9216,4,4627391563
2680,140647470,138206,140785676,4,0,0,35328,16,9101469856
2681,140717030,102211,140819241,3,0,0,16384,2,5430351914
2682,140730540,566,140731106,7,0,1,512,8,7314901827
2683,140868630,100568,140969198,3,0,0,30208,2,4201193898
2684,140927159,47288,140974447,7,0,0,1536,8,2090688919
2685,140951690,102752,141054442,1,0,0,37376,6,9843174065
2686,140955520,79304,141034824,4,0,0,15872,16,7093382216
2687,141073310,69752,141143062,3,0,0,9728,2,2310974991
2688,141108870,5971,141114841,2,0,1,14848,4,4230591019
2689,141257961,3387,141261348,4,0,1,9728,16,5371080378
2690,141285170,98982,141384152,2,0,0,26624,4,8245879391
2691,141308130,165072,141473202,4,0,0,57344,16,7740172234
2692,141329290,3898,141333188,1,0,1,4096,6,2591282296
2693,141400170,112344,141512514,0,0,0,55296,11,6759020227
2694,141430629,169894,141600523,7,0,0,30720,8,8152193888
2695,141470400,91650,141562050,2,0,0,22016,4,3943984389
2696,141499900,146096,141645996,0,0,0,64512,11,7831695029
2697,141502930,160736,141663666,9,0,0,25600,18,6604483369
2698,141533230,154808,141688038,0,0,0,14848,11,10157291267
2699,141709850,82976,141792826,1,0,0,12800,6,97926344
2700,141822610,105092,141927702,2,0,0,45056,4,6505481307
2701,141846180,140232,141986412,9,0,0,45056,18,5996303646
2702,141885960,129494,142015454,5,0,0,32768,19,3158372635
2703,141980271,66131,142046402,6,0,0,1024,12,1123686887
2704,142042570,80240,142122810,0,0,0,18944,11,8314942727
2705,142046520,137149,142183669,9,0,0,39936,18,10460537276
2706,142064480,4850,142069330,1,0,1,5120,6,5470187003
2707,142149460,113569,142263029,4,0,0,27648,16,1550766108
2708,142276930,105872,142382802,3,0,0,47616,2,9922625212
2709,142290060,66524,142356584,4,0,0,9216,16,3009111377
2710,142400690,92972,142493662,3,0,0,15360,2,5936658432
2711,142423790,141590,142565380,3,0,0,37888,2,10006487550
2712,142460849,74852,142535701,7,0,0,16384,8,2734577357
2713,142540390,77612,142618002,2,0,0,15360,4,4000337066
2714,142556611,66201,142622812,6,0,0,4608,12,2117924388
2715,142590140,111158,142701298,0,0,0,29184,11,9890305521
2716,142645000,72534,142717534,1,0,0,4608,6,8925013643
2717,142669020,55748,142724768,9,0,0,4096,18,3385220436
2718,142745200,59132,142804332,0,0,0,5120,11,8961923747
2719,142756610,101192,142857802,9,0,0,32256,18,1385302609
2720,142780259,87605,142867864,7,0,0,8704,8,5927676977
2721,142801180,82332,142883512,3,0,0,4608,2,4733481076
2722,142834571,104831,142939402,6,0,0,25600,12,4976436905
2723,142925180,119570,143044750,9,0,0,71680,18,8278988876
2724,142948210,61968,143010178,2,0,0,3584,4,5836389699
2725,143039870,78476,143118346,0,0,0,12288,11,7389889911
2726,143098930,71000,143169930,1,0,0,13824,6,4869928403
2727,143131100,53860,143184960,2,0,0,1536,4,3389076661
2728,143247750,105404,143353154,4,0,0,46080,16,604383695
2729,143317080,1042,143318122,5,0,1,1024,19,1520360916
2730,143328560,6278,143334838,7,0,1,6656,8,8130624385
2731,143342100,75254,143417354,2,0,0,6656,4,10042557069
2732,143349699,24096,143373795,3,0,1,33280,2,10358388668
2733,143396930,134548,143531478,1,0,0,12800,6,817878229
2734,143397060,105872,143502932,2,0,0,47616,4,10658324200
2735,143434259,70092,143504351,7,0,0,4608,8,3908416920
2736,143453500,98256,143551756,1,0,0,19456,6,6641934853
2737,143589229,90704,143679933,7,0,0,23040,8,1840213262
2738,143652901,109976,143762877,6,0,0,40960,12,5170825921
2739,143682600,120219,143802819,5,0,0,34816,19,6238617858
2740,143702359,120050,143822409,7,0,0,12288,8,7672343958
2741,143749700,13192,143762892,6,0,1,1024,12,8416300779
2742,143836940,566,143837506,7,0,1,512,8,9578409157
2743,143927820,195272,144123092,0,0,0,179712,11,3554098565
2744,143982150,3422,143985572,6,0,1,3584,12,4684182931
2745,144003350,161579,144164929,0,0,0,512,11,3305488912
2746,144010520,114147,144124667,4,0,0,5120,16,8184926776
2747,144011330,566,144011896,7,0,1,512,8,222862600
2748,144062410,92528,144154938,3,0,0,18944,2,5139627990
2749,144098410,157802,144256212,0,0,0,22528,11,3522700011
2750,144101090,179785,144280875,1,0,0,80896,6,7484977881
2751,144130410,99174,144229584,2,0,0,4096,4,8740599124
2752,144162410,123940,144286350,4,0,0,17920,16,4427455089
2753,144219390,137753,144357143,3,0,0,42496,2,5887574625
2754,144234129,96668,144330797,7,0,0,17408,8,10308901689
2755,144339120,104000,144443120,5,0,0,41472,19,6891142180
2756,144395271,96356,144491627,6,0,0,16384,12,6639926653
2757,144419430,57440,144476870,2,0,0,4608,4,2238010966
2758,144475070,105417,144580487,9,0,0,18432,18,3338074337
2759,144589350,4162,144593512,2,0,1,11264,4,203197120
2760,144599699,85916,144685615,7,0,0,17408,8,8366611795
2761,144616910,55748,144672658,5,0,0,4096,19,8714483474
2762,144694780,99335,144794115,3,0,0,16384,2,2974902188
2763,144715580,117877,144833457,4,0,0,13312,16,837702323
2764,144736370,7230,144743600,7,0,1,7680,8,7293851973
2765,144790110,8159,144798269,9,0,1,11264,18,5311846892
2766,144882820,55748,144938568,5,0,0,4096,19,1430638161
2767,144939920,109460,145049380,4,0,0,59392,16,6819268932
2768,144975860,96242,145072102,2,0,0,16896,4,8897881773
2769,145042510,106182,145148692,1,0,0,26112,6,4413323197
2770,145110940,63452,145174392,2,0,0,9216,4,5896150616
2771,145154580,65900,145220480,9,0,0,7168,18,8532961069
2772,145256440,64076,145320516,5,0,0,11264,19,6030192915
2773,145261700,117442,145379142,1,0,0,26112,6,1378764005
2774,145351020,74322,145425342,0,0,0,4096,11,3938094302
2775,145536871,52364,145589235,6,0,0,3072,12,7587673766
2776,145772310,83780,145856090,2,0,0,20480,4,5678156999
2777,145798871,45596,145844467,6,0,0,1024,12,7788251002
2778,145802450,82782,145885232,4,0,0,4096,16,7166305861
2779,145862340,82868,145945208,4,0,0,22528,16,5302844008
2780,145967130,70976,146038106,3,0,0,8704,2,2551657061
2781,145977331,62506,146039837,6,0,0,5632,12,6063473865
2782,146000190,88707,146088897,0,0,0,9728,11,4590376388
2783,146125920,95936,146221856,2,0,0,25088,4,5925504331
2784,146262529,22174,146284703,8,0,1,36352,12,8013420430
2785,146270500,257202,146527702,5,0,0,5632,19,8910621593
2786,146379370,1518,146380888,6,0,1,1536,12,8365381637
2787,146386719,77363,146464082,8,0,1,130560,12,2712036243
2788,146540450,140022,146680472,2,0,0,16384,4,5299545315
2789,146588760,47756,146636516,2,0,0,3072,4,7911167066
2790,146631650,61314,146692964,5,0,0,4608,19,4752666795
2791,146715000,4374,146719374,5,0,1,4608,19,9442480738
2792,146784580,49448,146834028,4,0,0,3584,16,1417257181
2793,146788260,5326,146793586,9,0,1,5632,18,9880863253
2794,146806050,57972,146864022,1,0,0,5120,6,7250940796
2795,146814530,124564,146939094,2,0,0,95232,4,3408277476
2796,146924970,125564,147050534,9,0,0,9728,18,7710811632
2797,146946990,134447,147081437,9,0,0,101376,18,7307978394
2798,146975860,129118,147104978,4,0,0,9728,16,6111259
2799,147015380,116202,147131582,5,0,0,16384,19,673303170
2800,147019830,170420,147190250,9,0,0,47616,18,6806282838
2801,147055150,165802,147220952,4,0,0,36352,16,10533928668
2802,147093260,3128,147096388,0,0,1,9216,11,2583497797
2803,147096640,8353,147104993,7,0,1,6144,8,5149336431
2804,147209350,80130,147289480,9,0,0,7680,18,9434974855
2805,147211690,12200,147223890,0,0,1,3072,11,9019700291
2806,147232600,76700,147309300,2,0,0,17408,4,10334548428
2807,147279190,95726,147374916,3,0,0,8704,2,2577502955
2808,147331360,100880,147432240,4,0,0,31232,16,860621320
2809,147345020,134914,147479934,0,0,0,40448,11,5864617006
2810,147401340,107892,147509232,4,0,0,24576,16,7646179790
2811,147407469,112639,147520108,7,0,0,20480,8,5761424966
2812,147503720,72652,147576372,2,0,0,11264,4,595697714
2813,147558150,83624,147641774,1,0,0,19968,6,7478573421
2814,147704520,6754,147711274,5,0,1,7168,19,6856508176
2815,147788320,72668,147860988,1,0,0,9216,6,8011047718
2816,147839359,2470,147841829,3,0,1,2560,2,4102760036
2817,147851620,1994,147853614,5,0,1,2048,19,2247957058
2818,147862169,101972,147964141,7,0,0,34816,8,10108080245
2819,147903180,106669,148009849,5,0,0,6144,19,4558273620
2820,148005820,73292,148079112,1,0,0,11264,6,10667366167
2821,148024170,96288,148120458,9,0,0,9728,18,8105673262
2822,148065230,7230,148072460,1,0,1,7680,6,3389615179
2823,148095730,101208,148196938,1,0,0,14336,6,10443740118
2824,148115030,75320,148190350,9,0,0,17920,18,6645212075
2825,148125540,133498,148259038,5,0,0,56832,19,156825805
2826,148173300,150118,148323418,0,0,0,13824,11,9544698040
2827,148251379,92793,148344172,7,0,0,10240,8,8084869279
2828,148254480,97351,148351831,8,0,0,25088,12,4720963367
2829,148359720,52364,148412084,3,0,0,3072,2,9924717058
2830,148426199,1994,148428193,3,0,1,2048,2,4298158032
2831,148432721,11533,148444254,4,0,1,18944,16,6934217903
2832,148434350,67627,148501977,3,0,0,6144,2,3802594041
2833,148517879,76832,148594711,7,0,0,12800,8,10696789831
2834,148556450,89900,148646350,9,0,0,15360,18,9776745472
2835,148696080,107744,148803824,3,0,0,53760,2,10515460015
2836,148722690,113678,148836368,3,0,0,2048,2,9170825084
2837,148762991,127773,148890764,6,0,0,39424,12,6917881277
2838,148811230,136012,148947242,9,0,0,22016,18,6252096717
2839,148929010,47288,148976298,2,0,0,1536,4,4617000688
2840,148988070,5712,148993782,7,0,1,14336,8,2037727900
2841,149104230,104156,149208386,0,0,0,41984,11,10081306363
2842,149118560,102912,149221472,4,0,0,8192,16,1251688000
2843,149147780,125502,149273282,3,0,0,10752,2,1509013003
2844,149217039,109001,149326040,7,0,0,51712,8,5733576723
2845,149242531,104936,149347467,6,0,0,44544,12,1016878216
2846,149391609,69284,149460893,7,0,0,8192,8,9038584167
2847,149397139,81142,149478281,7,0,0,14848,8,9742833737
2848,149636580,50984,149687564,1,0,0,3584,6,8800277367
2849,149645420,1042,149646462,7,0,1,1024,8,6557276313
2850,149689560,78680,149768240,1,0,0,13824,6,499208762
2851,149713091,98529,149811620,6,0,0,12800,12,2866559087
2852,149722669,101504,149824173,7,0,0,33280,8,3933738664
2853,149877980,93308,149971288,1,0,0,21504,6,7717554176
2854,149899650,566,149900216,0,0,1,512,11,5669673776
2855,149953561,92396,150045957,6,0,0,23552,12,10151692927
2856,149979460,2870,149982330,1,0,1,8704,6,1935124010
2857,150061841,133292,150195133,6,0,0,19456,12,6000072996
2858,150181901,88052,150269953,6,0,0,14336,12,7592565340
2859,150281890,88832,150370722,8,0,0,16896,12,2459071844
2860,150321270,95850,150417120,3,0,0,11776,2,1364555354
2861,150326590,103060,150429650,0,0,0,25600,11,262059311
2862,150387760,61778,150449538,2,0,0,6144,4,7636567898
2863,150513830,129421,150643251,5,0,0,34304,19,10099754418
2864,150529930,10241,150540171,9,0,1,16384,18,460746
2865,150544410,201909,150746319,2,0,0,30720,4,1244188894
2866,150576100,242399,150818499,2,0,0,13312,4,6016627450
2867,150586690,89900,150676590,0,0,0,15360,11,5286466850
2868,150588881,142321,150731202,6,0,0,33280,12,7788374269
2869,150594220,64137,150658357,0,0,1,108032,11,1656583655
2870,150659070,7706,150666776,5,0,1,8192,19,1019116833
2871,150683430,101660,150785090,5,0,0,33792,19,7512889497
2872,150750930,240187,150991117,1,0,0,9216,6,2732471841
2873,150780480,92743,150873223,9,0,0,20992,18,5179194438
2874,150804200,232130,151036330,4,0,0,31232,16,7135036761
2875,150876740,107432,150984172,9,0,0,52736,18,9646331516
2876,150904530,169078,151073608,4,0,0,46592,16,10425559221
2877,150955740,129151,151084891,9,0,0,18432,18,9017304668
2878,150973490,18380,150991870,0,0,1,8192,11,2883136142
2879,151016980,106134,151123114,0,0,0,16384,11,8206561237
2880,151184530,72224,151256754,5,0,0,12800,19,8872389908
2881,151190160,45596,151235756,4,0,0,1024,16,9069539270
2882,151310471,4679,151315150,4,0,1,12288,16,7534960724
2883,151374800,104780,151479580,1,0,0,44032,6,9652038828
2884,151435230,111292,151546522,5,0,0,44544,19,1647163114
2885,151481260,6754,151488014,0,0,1,7168,11,8157568060
2886,151527710,18835,151546545,6,0,1,7680,12,9629234909
2887,151534759,73588,151608347,7,0,0,2048,8,4261704130
2888,151574100,113009,151687109,3,0,0,52736,2,8013058929
2889,151617190,100756,151717946,2,0,0,14848,4,10059308944
2890,151670530,72848,151743378,1,0,0,14848,6,8752197392
2891,151701260,53718,151754978,1,0,0,3072,6,9116688238
2892,151860409,6278,151866687,3,0,1,6656,2,6853245030
2893,151867730,4420,151872150,9,0,1,11776,18,8994418508
2894,151877720,55856,151933576,0,0,0,3072,11,3197053307
2895,151879249,83094,151962343,7,0,0,12800,8,8660470520
2896,151930430,124463,152054893,2,0,0,88576,4,4099157994
2897,151966890,133987,152100877,1,0,0,20480,6,3809318463
2898,151973860,7230,151981090,7,0,1,7680,8,2925049131
2899,151983751,104395,152088146,6,0,0,12800,12,2891355921
2900,152089370,52520,152141890,1,0,0,3584,6,2959952510
2901,152259459,56996,152316455,7,0,0,8192,8,7403423605
2902,152343770,103532,152447302,4,0,0,39936,16,9627558561
2903,152386850,4850,152391700,5,0,1,5120,19,8424096748
2904,152509170,69908,152579078,1,0,0,10240,6,5390298106
2905,152552400,72662,152625062,4,0,0,7680,16,9305627709
2906,152628689,94688,152723377,7,0,0,20992,8,6580390162
2907,152646520,51453,152697973,4,0,0,512,16,3231018592
2908,152665550,2470,152668020,9,0,1,2560,18,7534971252
2909,152681780,146602,152828382,1,0,0,22528,6,5527991004
2910,152696020,57440,152753460,0,0,0,4608,11,9531970026
2911,152697570,64200,152761770,2,0,0,512,4,9907378972
2912,152739380,95413,152834793,0,0,0,20992,11,2088789650
2913,152745111,105872,152850983,6,0,0,47616,12,6392369420
2914,152783930,133000,152916930,1,0,0,23552,6,2821852993
2915,152794230,130203,152924433,3,0,0,24576,2,4264240882
2916,152800481,1518,152801999,4,0,1,1536,16,801677555
2917,152813280,5802,152819082,0,0,1,6144,11,6403130868
2918,152864000,67592,152931592,0,0,0,7680,11,3431984426
2919,152937350,52520,152989870,9,0,0,3584,18,2059335865
2920,153101991,63920,153165911,6,0,0,10752,12,4535150133
2921,153152810,70976,153223786,2,0,0,8704,4,6482248352
2922,153169531,2470,153172001,4,0,1,2560,16,2663659001
2923,153180720,141544,153322264,9,0,0,512,18,589152502
2924,153256890,70976,153327866,0,0,0,8704,11,8804061768
2925,153310350,3898,153314248,6,0,1,4096,12,4204932180
2926,153364820,1042,153365862,0,0,1,1024,11,3175736880
2927,153442550,125679,153568229,0,0,0,32256,11,3469785632
2928,153518921,100568,153619489,6,0,0,30208,12,7081187381
2929,153544320,101447,153645767,4,0,0,18432,16,9354776601
2930,153618910,14083,153632993,7,0,1,26112,8,2325993169
2931,153669420,101910,153771330,5,0,0,32768,19,10446665034
2932,153693880,120128,153814008,4,0,0,20480,16,3797945913
2933,153706201,3898,153710099,4,0,1,4096,16,2875680333
2934,153756220,102908,153859128,2,0,0,37888,4,154487161
2935,153811280,107518,153918798,0,0,0,38400,11,8810440190
2936,153819480,203347,154022827,0,0,0,3584,11,6951745554
2937,153829130,183447,154012577,3,0,0,17920,2,7382107191
2938,153843521,137923,153981444,6,0,0,26112,12,3554617327
2939,153849320,211900,154061220,3,0,0,23552,2,6413566997
2940,153861729,85833,153947562,7,0,0,7168,8,9540698069
2941,153899990,121714,154021704,5,0,0,22528,19,5992192219
2942,153962251,110996,154073247,6,0,0,39424,12,368342367
2943,154018810,141143,154159953,3,0,0,35328,2,8716253258
2944,154021260,105921,154127181,2,0,0,23552,4,2061107311
2945,154047511,95444,154142955,6,0,0,18432,12,9581240605
2946,154120641,101220,154221861,6,0,0,20992,12,6157163359
2947,154133320,2870,154136190,9,0,1,8704,18,8186606423
2948,154161620,106496,154268116,5,0,0,49664,19,6839759568
2949,154173270,51346,154224616,5,0,0,1024,19,6878730110
2950,154252610,15521,154268131,0,0,1,13312,11,10706027588
2951,154327560,55748,154383308,0,0,0,4096,11,2596547180
2952,154355480,81620,154437100,9,0,0,18432,18,5324424176
2953,154484600,566,154485166,2,0,1,512,4,210325948
2954,154569549,7230,154576779,3,0,1,7680,2,3617929283
2955,154591010,103925,154694935,1,0,0,32256,6,8091049158
2956,154607300,110453,154717753,2,0,0,25088,4,8325010480
2957,154614070,67707,154681777,0,0,0,3072,11,1268882455
2958,154619150,123527,154742677,9,0,0,51712,18,8346507119
2959,154625459,84635,154710094,7,0,0,8704,8,10133693801
2960,154652420,156912,154809332,0,0,0,31232,11,3394025553
2961,154761200,105092,154866292,3,0,0,45056,2,10530501283
2962,154920760,82820,155003580,3,0,0,12288,2,7293723364
2963,154959170,93020,155052190,4,0,0,25600,16,8266172198
2964,154969740,100396,155070136,5,0,0,12800,19,4300611933
2965,155029330,122494,155151824,4,0,0,38400,16,4683982948
2966,155101730,68568,155170298,1,0,0,7168,6,9057245553
2967,155125100,64208,155189308,1,0,0,6656,6,2714387142
2968,155214540,47288,155261828,5,0,0,1536,19,9865856916
2969,155233340,69908,155303248,4,0,0,10240,16,7928626713
2970,155248980,60824,155309804,5,0,0,5632,19,7179245548
2971,155349290,105404,155454694,5,0,0,46080,19,8590034914
2972,155365890,111856,155477746,9,0,0,15872,18,888883499
2973,155387381,177354,155564735,6,0,0,512,12,1216466450
2974,155391070,254345,155645415,1,0,0,46080,6,8058448747
2975,155402790,253499,155656289,0,0,0,27648,11,9630808249
2976,155424090,30619,155454709,6,0,1,40960,12,1548173089
2977,155437600,192395,155629995,2,0,0,512,4,4240538944
2978,155484700,1518,155486218,0,0,1,1536,11,10665659780
2979,155615030,65900,155680930,1,0,0,7168,6,4349555344
2980,155638821,111678,155750499,6,0,0,45056,12,6294178810
2981,155704960,59756,155764716,0,0,0,7168,11,6226865491
2982,155790041,97604,155887645,6,0,0,20480,12,3934332440
2983,155808230,83814,155892044,9,0,0,14336,18,1814506857
2984,155815949,141437,155957386,7,0,0,73728,8,5151712324
2985,155817400,93165,155910565,0,0,0,5632,11,1296205249
2986,155876500,90045,155966545,3,0,0,5632,2,7277839996
2987,155884770,73879,155958649,1,0,0,4096,6,10664775369
2988,155885289,75091,155960380,7,0,0,5632,8,7227350525
2989,155915650,64137,155979787,6,0,1,108032,12,7272781231
2990,155996850,197533,156194383,2,0,0,36352,4,7831534177
2991,156012520,2946,156015466,9,0,1,3072,18,5223460971
2992,156068600,6754,156075354,5,0,1,7168,19,2241541756
2993,156235030,104936,156339966,1,0,0,44544,6,6872160564
2994,156429961,89168,156519129,6,0,0,23040,12,2953505964
2995,156456409,106808,156563217,7,0,0,50688,8,7252972609
2996,156481540,101771,156583311,4,0,0,4608,16,1463830418
2997,156491609,129220,156620829,7,0,0,5632,8,2035292296
2998,156533330,1518,156534848,9,0,1,1536,18,2920101685
2999,156571200,52364,156623564,1,0,0,3072,6,8309421484
3000,156594740,69932,156664672,3,0,0,15360,2,7084756974
3001,156628380,79618,156707998,5,0,0,10240,19,10035819531
3002,156678239,104624,156782863,7,0,0,43520,8,5567175609
3003,156711740,5802,156717542,0,0,1,6144,11,5632498806
3004,156718810,119283,156838093,0,0,0,22016,11,7765602540
3005,156786920,129593,156916513,4,0,0,25088,16,4360244764
3006,156805080,80528,156885608,0,0,0,14848,11,9934639797
3007,156831680,13635,156845315,0,0,1,7680,11,7107592179
3008,156884910,69974,156954884,1,0,0,8192,6,6439552070
3009,156941450,65900,157007350,1,0,0,7168,6,8878465503
3010,156993430,96668,157090098,1,0,0,17408,6,1167508798
3011,157041610,87362,157128972,2,0,0,12800,4,6251371569
3012,157151169,52549,157203718,8,0,1,85504,12,1935566449
3013,157196550,116396,157312946,1,0,0,13312,6,3571701440
3014,157248180,3898,157252078,1,0,1,4096,6,9702118239
3015,157312490,191684,157504174,3,0,0,94720,2,8639391436
3016,157320870,45596,157366466,2,0,0,1024,4,2582579429
3017,157325240,143502,157468742,9,0,0,50176,18,8015571219
3018,157369240,566,157369806,5,0,1,512,19,8357810633
3019,157416640,153528,157570168,8,0,0,43008,12,3070006472
3020,157436601,152449,157589050,6,0,0,33280,12,5358664478
3021,157478370,184042,157662412,5,0,0,46080,19,1214207340
3022,157688040,101816,157789856,4,0,0,34304,16,10369065666
3023,157698520,93067,157791587,9,0,0,5632,18,4414181392
3024,157711930,139888,157851818,2,0,0,39936,4,3745438635
3025,157717520,78054,157795574,9,0,0,1536,18,790001462
3026,157744270,70570,157814840,4,0,0,8192,16,6398905449
3027,157787361,124763,157912124,6,0,0,19968,12,384413623
3028,157794270,174728,157968998,9,0,0,54272,18,2859607246
3029,157860550,136852,157997402,1,0,0,51712,6,7239794182
3030,157873371,48527,157921898,6,0,0,512,12,4178096691
3031,157874691,1994,157876685,4,0,1,2048,16,10613958330
3032,158002691,99320,158102011,6,0,0,26112,12,156736749
3033,158021610,144550,158166160,5,0,0,50688,19,8900466391
3034,158037500,113201,158150701,5,0,0,18432,19,7259725628
3035,158050590,196873,158247463,3,0,0,42496,2,3710033245
3036,158149300,62448,158211748,4,0,0,1024,16,1151223534
3037,158172470,6229,158178699,9,0,1,15360,18,1008548366
3038,158177540,97433,158274973,9,0,0,5632,18,6762469566
3039,158192069,77828,158269897,7,0,0,4096,8,9271978372
3040,158233380,91904,158325284,5,0,0,16896,19,8147676447
3041,158278760,6278,158285038,5,0,1,6656,19,6813197092
3042,158336980,105560,158442540,1,0,0,46592,6,9102609600
3043,158382710,123322,158506032,4,0,0,10752,16,1682388642
3044,158465100,13512,158478612,0,0,1,26112,11,1529387006
3045,158469140,83401,158552541,9,0,0,11264,18,5266678885
3046,158481370,157013,158638383,4,0,0,65024,16,1887515229
3047,158569560,69618,158639178,4,0,0,2560,16,9307408064
3048,158647800,40616,158688416,7,0,1,65536,8,316562594
3049,158772720,112011,158884731,0,0,0,1024,11,6354769995
3050,158812480,43904,158856384,3,0,0,512,2,788577164
3051,158958070,93284,159051354,0,0,0,16384,11,642356702
3052,158991370,43904,159035274,1,0,0,512,6,3376067860
3053,159095620,121628,159217248,0,0,0,99328,11,7747161345
3054,159103360,115619,159218979,9,0,0,5632,18,9778012013
3055,159148200,114114,159262314,3,0,0,39424,2,4629738731
3056,159185900,196207,159382107,5,0,0,74240,19,637618363
3057,159205630,150626,159356256,9,0,0,84480,18,8988258910
3058,159241689,566,159242255,3,0,1,512,2,3559636502
3059,159308940,91471,159400411,4,0,0,15360,16,5674422274
3060,159367649,40671,159408320,8,0,1,47616,12,10699199463
3061,159438500,153224,159591724,2,0,0,1024,4,4279743801
3062,159632290,566,159632856,2,0,1,512,4,1834230342
3063,159637980,14029,159652009,7,0,1,27136,8,6066136210
3064,159785099,87896,159872995,7,0,0,13824,8,6268561442
3065,159798249,3128,159801377,3,0,1,9216,2,658262340
3066,160006730,99944,160106674,9,0,0,28160,18,4301811336
3067,160009921,141849,160151770,6,0,0,80384,12,5589729534
3068,160228680,50672,160279352,5,0,0,2560,19,2000123176
3069,160249160,54056,160303216,3,0,0,3584,2,1497655289
3070,160300840,54056,160354896,1,0,0,3584,6,1716221734
3071,160403770,10241,160414011,1,0,1,16384,6,5557559675
3072,160451920,185793,160637713,2,0,0,35328,4,5510269062
3073,160460239,85160,160545399,7,0,0,19968,8,171553137
3074,160481540,68137,160549677,1,0,0,7680,6,5702022884
3075,160493310,60824,160554134,1,0,0,5632,6,2919358035
3076,160509820,142065,160651885,5,0,0,11264,19,1267179914
3077,160553239,125610,160678849,7,0,0,29184,8,6440994721
3078,160696400,54056,160750456,3,0,0,3584,2,9775904142
3079,160757290,68528,160825818,1,0,0,10752,6,4640590383
3080,160762169,54056,160816225,7,0,0,3584,8,3863892883
3081,160780010,1042,160781052,2,0,1,1024,4,10442043562
3082,160865710,72668,160938378,0,0,0,9216,11,4586705164
3083,160879699,84824,160964523,7,0,0,13824,8,1137595367
3084,160897089,162324,161059413,7,0,0,97280,8,634999633
3085,161092940,108224,161201164,3,0,0,46080,2,3923561201
3086,161095760,62072,161157832,9,0,0,9728,18,8272870772
3087,161350519,276503,161627022,8,0,1,451584,12,4325521675
3088,161384759,326837,161711596,7,0,0,23552,8,8345355468
3089,161554100,237550,161791650,9,0,0,6656,18,5122583991
3090,161555080,72928,161628008,0,0,1,1536,11,9383744222
3091,161580549,48125,161628674,3,0,1,1024,2,7909886930
3092,161631430,207265,161838695,5,0,0,39936,19,5564182855
3093,161694620,199773,161894393,0,0,0,19968,11,2994648165
3094,161724539,154296,161878835,7,0,0,3072,8,1619198961
3095,161766360,88412,161854772,9,0,0,25600,18,2565587686
3096,161970320,50672,162020992,9,0,0,2560,18,6530548863
3097,162024450,4850,162029300,0,0,1,5120,11,10099064817
3098,162081560,2470,162084030,1,0,1,2560,6,213891254
3099,162126700,93908,162220608,2,0,0,18432,4,2331033977
3100,162150780,127563,162278343,9,0,0,37888,18,7496123019
3101,162177040,89744,162266784,9,0,0,14848,18,1740074308
3102,162223150,93659,162316809,0,0,0,8704,11,3205502957
3103,162239689,48980,162288669,7,0,0,2048,8,1387805172
3104,162330219,4850,162335069,3,0,1,5120,2,5070342514
3105,162476321,57787,162534108,6,0,0,1536,12,304844576
3106,162486820,102752,162589572,1,0,0,37376,6,9774992588
3107,162506510,97060,162603570,5,0,0,1536,19,7893064682
3108,162573271,74672,162647943,6,0,0,10752,12,4650966443
3109,162631670,87008,162718678,1,0,0,20992,6,3636354950
3110,162684389,49292,162733681,7,0,0,3072,8,533756348
3111,162721490,45596,162767086,0,0,0,1024,11,1683939837
3112,162733520,50825,162784345,9,0,0,2560,18,917573752
3113,162856400,106652,162963052,1,0,0,50176,6,10326352260
3114,162890609,54056,162944665,7,0,0,3584,8,9470419466
3115,162899890,2946,162902836,1,0,1,3072,6,1413079963
3116,162927521,77144,163004665,6,0,0,13824,12,1540931673
3117,162962760,45880,163008640,5,0,0,1024,19,7004397069
3118,163041459,3904,163045363,8,0,1,10752,12,9436873550
3119,163046820,82820,163129640,2,0,0,12288,4,1864678438
3120,163151009,2470,163153479,3,0,1,2560,2,6357145590
3121,163318570,4850,163323420,1,0,1,5120,6,9341305183
3122,163321919,13083,163335002,3,0,1,22016,2,10500743853
3123,163323710,105074,163428784,0,0,0,28672,11,457591808
3124,163485510,92108,163577618,2,0,0,27648,4,7056121666
3125,163517520,153541,163671061,7,0,1,248832,8,5666607700
3126,163576000,140328,163716328,0,0,0,512,11,8154616595
3127,163582210,190396,163772606,5,0,0,29184,19,7801893211
3128,163686671,230921,163917592,6,0,0,39424,12,10550841761
3129,163706800,133007,163839807,5,0,0,20480,19,3458647908
3130,163771340,8012,163779352,5,0,1,7168,19,4378563970
3131,163922231,96248,164018479,6,0,0,26112,12,935574027
3132,164057369,74516,164131885,7,0,0,10240,8,2644485036
3133,164061680,47288,164108968,5,0,0,1536,19,1572841018
3134,164073440,125693,164199133,5,0,0,69632,19,6338816114
3135,164115920,12825,164128745,1,0,1,21504,6,6358857671
3136,164117320,16571,164133891,7,0,1,8192,8,2340251268
3137,164120840,79712,164200552,9,0,0,4608,18,8635134815
3138,164216490,112424,164328914,1,0,0,69120,6,2423200019
3139,164246720,100992,164347712,1,0,0,8704,6,3753834073
3140,164358100,1042,164359142,2,0,1,1024,4,3983324505
3141,164439309,5802,164445111,8,0,1,6144,12,5770801226
3142,164451300,99344,164550644,5,0,0,31232,19,2175910144
3143,164455490,151950,164607440,4,0,0,56320,16,7293074405
3144,164510370,3898,164514268,9,0,1,4096,18,4451505659
3145,164541491,14082,164555573,4,0,1,12800,16,7299568161
3146,164707009,65900,164772909,7,0,0,7168,8,8499451238
3147,164786500,4162,164790662,5,0,1,11264,19,9158279972
3148,164930700,91592,165022292,2,0,0,15872,4,7706098683
3149,165026930,101036,165127966,1,0,0,31744,6,2893679664
3150,165031580,82088,165113668,9,0,0,19968,18,5695441133
3151,165070430,153992,165224422,0,0,0,48640,11,7383596991
3152,165128350,102179,165230529,5,0,0,19968,19,1903895064
3153,165205110,132196,165337306,0,0,0,70656,11,7029917896
3154,165212560,126633,165339193,5,0,0,6144,19,4976847135
3155,165242730,200914,165443644,9,0,0,40448,18,2436114894
3156,165282820,142444,165425264,5,0,0,73728,19,8488084197
3157,165288360,100458,165388818,1,0,0,1536,6,1379854184
3158,165302679,7706,165310385,3,0,1,8192,2,4590866935
3159,165396900,3898,165400798,9,0,1,4096,18,4209544911
3160,165407310,183223,165590533,0,0,0,12288,11,4889783642
3161,165449210,108104,165557314,4,0,0,53760,16,10719467128
3162,165469880,132908,165602788,0,0,0,15360,11,6848600247
3163,165624500,54529,165679029,6,0,1,92672,12,6628724809
3164,165742200,99320,165841520,1,0,0,26112,6,1160241359
3165,165750280,74072,165824352,0,0,0,13824,11,164182903
3166,165754729,4937,165759666,8,0,1,12800,12,7082816135
3167,165778680,224158,166002838,6,0,1,363008,12,1570472846
3168,166062570,104156,166166726,9,0,0,41984,18,6122984650
3169,166128489,108637,166237126,7,0,0,3072,8,1484315044
3170,166135610,97916,166233526,2,0,0,21504,4,9047989910
3171,166248700,47387,166296087,2,0,0,1536,4,1584284182
3172,166257830,52364,166310194,4,0,0,3072,16,10115704197
3173,166266159,2870,166269029,8,0,1,8704,12,7802770313
3174,166280199,62590,166342789,7,0,0,2048,8,7483066499
3175,166317170,276762,166593932,6,0,1,452096,12,1886633516
3176,166330951,451844,166782795,6,0,0,80896,12,813402332
3177,166350960,207926,166558886,4,0,0,9728,16,7641015718
3178,166436949,256104,166693053,7,0,0,14336,8,2897191489
3179,166467750,187718,166655468,0,0,0,3072,11,3544933144
3180,166513699,240173,166753872,7,0,0,5120,8,1957293174
3181,166705220,212485,166917705,9,0,0,10752,18,2249296375
3182,166769210,112897,166882107,9,0,0,26112,18,1520246003
3183,166882469,109629,166992098,7,0,0,49152,8,8578095386
3184,166958751,50672,167009423,6,0,0,2560,12,3898101348
3185,167209320,101816,167311136,5,0,0,34304,19,8415862697
3186,167234980,43904,167278884,1,0,0,512,6,5076486289
3187,167321720,106496,167428216,1,0,0,49664,6,7723271405
3188,167340790,90249,167431039,9,0,0,9216,18,6798902619
3189,167397939,106369,167504308,7,0,0,14848,8,8278572415
3190,167452310,45596,167497906,1,0,0,1024,6,3075758582
3191,167478740,94088,167572828,9,0,0,24064,18,9116289023
3192,167513500,171962,167685462,4,0,0,61952,16,4935169021
3193,167551459,10757,167562216,3,0,1,17408,2,254118151
3194,167658070,100241,167758311,5,0,0,22528,19,8339088215
3195,167690740,60692,167751432,0,0,0,10240,11,10255593905
3196,167700170,59248,167759418,5,0,0,3584,19,10417149407
3197,167736180,5326,167741506,1,0,1,5632,6,1846946575
3198,167747740,11693,167759433,5,0,1,7680,19,7721377694
3199,167761180,4850,167766030,9,0,1,5120,18,9521616745
3200,167785749,102908,167888657,7,0,0,37888,8,4313706633
3201,167814241,78799,167893040,6,0,0,14336,12,4231859761
3202,167833650,1994,167835644,5,0,1,2048,19,2637922741
3203,167853490,3898,167857388,5,0,1,4096,19,10257562088
3204,167973890,55748,168029638,9,0,0,4096,18,8135732316
3205,168034920,102908,168137828,8,0,0,37888,12,5363317022
3206,168065079,93359,168158438,7,0,0,3584,8,7232264230
3207,168075830,93440,168169270,2,0,0,16896,4,2045349857
3208,168098350,88102,168186452,2,0,0,8704,4,5294197687
3209,168122630,158976,168281606,2,0,0,17408,4,484416977
3210,168148449,194515,168342964,7,0,0,119808,8,10022079569
3211,168153070,16215,168169285,9,0,1,24576,18,331349849
3212,168188479,1518,168189997,3,0,1,1536,2,2576324432
3213,168197270,3422,168200692,7,0,1,3584,8,8678367474
3214,168342051,102721,168444772,6,0,0,34304,12,9622363732
3215,168365880,94450,168460330,9,0,0,3584,18,2181984399
3216,168378310,100880,168479190,1,0,0,31232,6,4841225699
3217,168413750,121394,168535144,8,0,0,31232,12,6178363467
3218,168430050,116661,168546711,5,0,0,37888,19,1305645240
3219,168454840,148518,168603358,4,0,0,27136,16,3345813581
3220,168459590,154859,168614449,4,0,0,36352,16,4656990332
3221,168496200,3904,168500104,5,0,1,10752,19,10610133055
3222,168512730,102202,168614932,1,0,0,1536,6,5509288812
3223,168530050,95942,168625992,8,0,0,512,12,6303742934
3224,168571590,4374,168575964,7,0,1,4608,8,5335064580
3225,168888900,105092,168993992,4,0,0,45056,16,4963627900
3226,168952040,106380,169058420,2,0,0,12288,4,8726055943
3227,168972580,566,168973146,1,0,1,512,6,5642878116
3228,168973910,1994,168975904,1,0,1,2048,6,3329337048
3229,168975351,75833,169051184,6,0,0,8704,12,3733654406
3230,169050660,54572,169105232,4,0,0,3584,16,5767774057
3231,169055950,94414,169150364,9,0,0,27136,18,7740387330
3232,169115080,103532,169218612,3,0,0,39936,2,5257707716
3233,169211490,107058,169318548,3,0,0,28160,2,6820914439
3234,169232491,74360,169306851,6,0,0,9728,12,4148453600
3235,169250101,117800,169367901,6,0,0,82944,12,4432793672
3236,169260560,107980,169368540,9,0,0,2048,18,1038318467
3237,169264390,122495,169386885,1,0,0,23040,6,9486661027
3238,169297010,72325,169369335,9,0,0,2560,18,3890477077
3239,169309660,111449,169421109,0,0,0,2048,11,9109992372
3240,169329870,59991,169389861,8,0,0,1536,12,8326772096
3241,169478930,4374,169483304,0,0,1,4608,11,2908621378
3242,169610970,56840,169667810,9,0,0,7680,18,5224441078
3243,169631790,125138,169756928,2,0,0,72192,4,4658170742
3244,169703610,129572,169833182,2,0,0,61440,4,1003288039
3245,169812490,45820,169858310,0,0,0,512,11,1885432359
3246,169852840,65900,169918740,8,0,0,7168,12,8849801093
3247,169857520,71890,169929410,3,0,0,14848,2,4811764305
3248,169884570,3128,169887698,7,0,1,9216,8,3517116847
3249,169931620,89900,170021520,9,0,0,15360,18,551009956
3250,169963560,87008,170050568,3,0,0,20992,2,5306694222
3251,170007029,79011,170086040,7,0,0,4096,8,5349226986
3252,170186920,1518,170188438,9,0,1,1536,18,382020433
3253,170198450,74360,170272810,8,0,0,9728,12,3063947147
3254,170266981,52364,170319345,6,0,0,3072,12,1248283111
3255,170289849,566,170290415,3,0,1,512,2,8670983626
3256,170323500,99632,170423132,5,0,0,27136,19,6711822932
3257,170329490,96465,170425955,8,0,0,9216,12,4539865788
3258,170335400,67356,170402756,0,0,0,5632,11,10256951165
3259,170350020,106184,170456204,8,0,0,48640,12,726018284
3260,170411251,79675,170490926,6,0,0,10240,12,10563204618
3261,170483441,7500,170490941,4,0,1,15872,16,76017231
3262,170504960,74006,170578966,2,0,0,6656,4,3851933768
3263,170572790,97316,170670106,2,0,0,24576,4,4410914189
3264,170597560,1042,170598602,9,0,1,1024,18,7854800376
3265,170611390,64208,170675598,0,0,0,6656,11,7269139453
3266,170638360,73674,170712034,0,0,0,8704,11,4335905484
3267,170669510,83144,170752654,3,0,0,21504,2,10243876935
3268,170720460,95176,170815636,0,0,0,15360,11,389127779
3269,170835890,55748,170891638,4,0,0,4096,16,4325588010
3270,170853270,106126,170959396,4,0,0,33792,16,5988640316
3271,170861570,153842,171015412,8,0,0,56320,12,4278799673
3272,170891550,185524,171077074,2,0,0,30720,4,10248300863
3273,170942129,1518,170943647,3,0,1,1536,2,9021643018
3274,170960931,133483,171094414,6,0,0,27136,12,4222818418
3275,171021200,1994,171023194,7,0,1,2048,8,5624689595
3276,171029070,123826,171152896,5,0,0,76800,19,9914249837
3277,171081961,129121,171211082,6,0,0,23040,12,9239575466
3278,171242269,3422,171245691,3,0,1,3584,2,5003774894
3279,171254140,124974,171379114,4,0,0,14848,16,1200280389
3280,171266330,104780,171371110,5,0,0,44032,19,792391162
3281,171313240,6754,171319994,6,0,1,7168,12,9588229445
3282,171345670,47288,171392958,0,0,0,1536,11,2120860260
3283,171422580,54056,171476636,3,0,0,3584,2,2535325816
3284,171460641,91592,171552233,6,0,0,15872,12,3335732002
3285,171492690,103688,171596378,2,0,0,40448,4,61633095
3286,171559630,1994,171561624,7,0,1,2048,8,667782271
3287,171580970,1994,171582964,0,0,1,2048,11,8351508909
3288,171592610,6230,171598840,2,0,1,2560,4,7066835064
3289,171605950,82244,171688194,8,0,0,20480,12,2213192969
3290,171609890,145879,171755769,0,0,0,14848,11,4704099250
3291,171622950,128280,171751230,4,0,0,66048,16,4542180583
3292,171666400,147578,171813978,2,0,0,28160,4,635290029
3293,171671219,131341,171802560,7,0,0,20992,8,4105726405
3294,171714680,90703,171805383,3,0,0,9216,2,2007064850
3295,171722460,67590,171790050,2,0,0,9728,4,7658298391
3296,171770460,97031,171867491,9,0,0,19456,18,9257886368
3297,171776550,69284,171845834,2,0,0,8192,4,5003011917
3298,171825990,68684,171894674,3,0,0,11264,2,4470156791
3299,171836650,1518,171838168,5,0,1,1536,19,4510024406
3300,171980500,56684,172037184,4,0,0,7168,16,9428081270
3301,172052610,112580,172165190,1,0,0,69632,6,4083928856
3302,172172640,74384,172247024,4,0,0,14848,16,8396769361
3303,172269060,50672,172319732,8,0,0,2560,12,6875236297
3304,172287860,50672,172338532,5,0,0,2560,19,968791538
3305,172298521,104780,172403301,6,0,0,44032,12,923383096
3306,172348070,93259,172441329,4,0,0,15360,16,7661939362
3307,172376560,119363,172495923,3,0,0,22016,2,2093664649
3308,172401490,123257,172524747,9,0,0,10752,18,8418717086
3309,172415820,127119,172542939,3,0,0,25088,2,1905708727
3310,172418630,85940,172504570,3,0,0,22528,2,5730307850
3311,172429460,5712,172435172,1,0,1,14336,6,7337300694
3312,172532180,78236,172610416,1,0,0,17408,6,7903834153
3313,172775519,71912,172847431,7,0,0,11776,8,10130163061
3314,172884510,73472,172957982,4,0,0,16896,16,6561371980
3315,172899081,84224,172983305,6,0,0,16896,12,1510633367
3316,172919620,99823,173019443,1,0,0,18432,6,1466431670
3317,172981980,67373,173049353,2,0,0,7680,4,6506408559
3318,173015699,6606,173022305,8,0,1,8704,12,9930342132
3319,173040041,81610,173121651,6,0,0,5120,12,7043161263
3320,173062519,100100,173162619,7,0,0,28672,8,3587661628
3321,173086450,106355,173192805,0,0,0,5632,11,2441011018
3322,173233450,97916,173331366,4,0,0,21504,16,21313919
3323,173279930,102386,173382316,9,0,0,5120,18,477412378
3324,173308020,12308,173320328,1,0,1,20480,6,389654619
3325,173332400,82053,173414453,8,0,0,2560,12,5221246821
3326,173394560,177121,173571681,5,0,0,54272,19,5554165298
3327,173459399,83044,173542443,7,0,0,2560,8,5237246548
3328,173475040,153623,173628663,5,0,0,78848,19,1242419309
3329,173516150,115024,173631174,9,0,0,8192,18,7875724352
3330,173564190,108519,173672709,4,0,0,31744,16,10735619700
3331,173584600,88592,173673192,3,0,0,1536,2,3986892178
3332,173799470,81152,173880622,2,0,0,16896,4,7834827303
3333,173799941,82256,173882197,6,0,0,5120,12,9772616250
3334,173918119,2946,173921065,8,0,1,3072,12,4324288819
3335,174001560,137632,174139192,2,0,0,62976,4,4485695749
3336,174077799,118219,174196018,7,0,0,21504,8,507555097
3337,174099291,170845,174270136,6,0,0,31744,12,148456422
3338,174111130,100880,174212010,5,0,0,31232,19,4263114105
3339,174116750,85055,174201805,0,0,0,18944,11,6482526920
3340,174146931,88135,174235066,6,0,0,512,12,1652480664
3341,174170050,144339,174314389,3,0,0,39424,2,9284972634
3342,174196450,104823,174301273,1,0,0,26624,6,3899434033
3343,174234530,201419,174435949,1,0,0,103424,6,1421628945
3344,174242580,144103,174386683,9,0,0,53760,18,9087466198
3345,174245019,5326,174250345,3,0,1,5632,2,9506864532
3346,174383590,116289,174499879,5,0,0,71680,19,4744385745
3347,174468601,6754,174475355,4,0,1,7168,16,9864223623
3348,174503800,118604,174622404,9,0,0,54272,18,6373479753
3349,174549890,3904,174553794,6,0,1,10752,12,2314229768
3350,174578701,115175,174693876,6,0,0,49664,12,2456043166
3351,174722910,65768,174788678,0,0,0,11776,11,8107940559
3352,174737100,52217,174789317,0,0,0,2048,11,5210293313
3353,174748220,72668,174820888,0,0,0,9216,11,3302650111
3354,174751280,176510,174927790,2,0,0,132096,4,2095258849
3355,174774620,155868,174930488,8,0,0,6656,12,4008343751
3356,174789420,139025,174928445,0,0,0,2048,11,7193841808
3357,174832190,12049,174844239,5,0,1,19968,19,3258350841
3358,174851000,1994,174852994,7,0,1,2048,8,5782786087
3359,174866829,3904,174870733,3,0,1,10752,2,6996411310
3360,174888910,109475,174998385,5,0,0,3072,19,323909596
3361,174889140,201492,175090632,0,0,0,5120,11,2341478640
3362,174960070,101192,175061262,2,0,0,32256,4,5254123102
3363,174966350,173608,175139958,8,0,0,34816,12,5871286164
3364,175000780,78704,175079484,9,0,0,18944,18,10443146698
3365,175176830,66080,175242910,4,0,0,12800,16,10722973359
3366,175284290,1042,175285332,7,0,1,1024,8,7080568763
3367,175320341,111800,175432141,6,0,0,67072,12,10528321768
3368,175361400,106399,175467799,4,0,0,31744,16,4563424093
3369,175389340,87896,175477236,3,0,0,13824,2,367884192
3370,175396970,1518,175398488,1,0,1,1536,6,1757486871
3371,175432410,14029,175446439,7,0,1,27136,8,3889427952
3372,175437640,16170,175453810,6,0,1,22016,12,7931794532
3373,175499810,1042,175500852,7,0,1,1024,8,4217385495
3374,175511500,117104,175628604,8,0,0,84480,12,2456069279
3375,175675700,108212,175783912,4,0,0,55296,16,1542487749
3376,175767059,91205,175858264,7,0,0,9728,8,1180459526
3377,175886650,5802,175892452,1,0,1,6144,6,9233353229
3378,175889291,221826,176111117,6,0,0,24576,12,5285826555
3379,175927590,99788,176027378,2,0,0,27648,4,5739124008
3380,175965240,64208,176029448,9,0,0,6656,18,8681731264
3381,175979180,124434,176103614,5,0,0,27136,19,7547691198
3382,176018170,99826,176117996,4,0,0,22528,16,1423096639
3383,176257341,84692,176342033,6,0,0,18432,12,2400428019
3384,176301390,1518,176302908,0,0,1,1536,11,1918909583
3385,176316750,104370,176421120,0,0,0,28672,11,2838822507
3386,176349850,2870,176352720,9,0,1,8704,18,8457074663
3387,176463730,102596,176566326,1,0,0,36864,6,7735725065
3388,176472570,105471,176578041,9,0,0,38400,18,5017563004
3389,176492349,117761,176610110,7,0,0,20480,8,6651509615
3390,176503281,76023,176579304,6,0,0,4096,12,2485222606
3391,176514580,190885,176705465,0,0,0,104960,11,1619891877
3392,176548229,80004,176628233,7,0,0,12800,8,10364063187
3393,176573890,9304,176583194,7,0,1,4096,8,1134322243
3394,176648070,58823,176706893,8,0,0,1536,12,9265200037
3395,176712770,81152,176793922,9,0,0,16896,18,1354487477
3396,176794390,105404,176899794,5,0,0,46080,19,4345593755
3397,176903320,78992,176982312,1,0,0,14848,6,3516992810
3398,176993200,47288,177040488,5,0,0,1536,19,8610932095
3399,177008379,76388,177084767,7,0,0,16384,8,9096515375
3400,177015109,21658,177036767,8,0,1,35328,12,3612281692
3401,177021189,101455,177122644,7,0,0,15872,8,1735670208
3402,177027980,72099,177100079,2,0,0,6144,4,3980947006
3403,177047560,100214,177147774,8,0,0,13312,12,8090518668
3404,177168350,102908,177271258,5,0,0,37888,19,7270752042
3405,177172790,109559,177282349,3,0,0,36352,2,7908864637
3406,177185190,61324,177246514,2,0,0,2048,4,9155531565
3407,177194600,112844,177307444,5,0,0,19968,19,1435473845
3408,177378150,106652,177484802,4,0,0,50176,16,2279818887
3409,177401459,110985,177512444,7,0,0,8704,8,39151131
3410,177444400,112246,177556646,4,0,0,26624,16,4017701358
3411,177552370,91276,177643646,8,0,0,20992,12,9028007651
3412,177601810,7706,177609516,0,0,1,8192,11,9483982444
3413,177603270,243865,177847135,8,0,0,87040,12,3668489015
3414,177756130,5712,177761842,9,0,1,14336,18,7641600224
3415,177847210,179697,178026907,2,0,0,103936,4,5920431006
3416,177866820,80214,177947034,3,0,0,2560,2,8826676477
3417,177946670,121337,178068007,9,0,0,9728,18,8834780554
3418,178026400,102783,178129183,8,0,0,35840,12,4681304275
3419,178051530,65900,178117430,8,0,0,7168,12,4536631871
3420,178156639,2870,178159509,3,0,1,8704,2,8511629903
3421,178244119,566,178244685,3,0,1,512,2,3923834948
3422,178322560,48980,178371540,1,0,0,2048,6,9202652454
3423,178332361,107120,178439481,6,0,0,51712,12,4798935487
3424,178409750,78080,178487830,5,0,0,16896,19,2428800178
3425,178464370,125426,178589796,9,0,0,34304,18,1362864762
3426,178464940,108278,178573218,5,0,0,27136,19,6609903447
3427,178500320,12566,178512886,5,0,1,20992,19,4718252980
3428,178546040,254788,178800828,1,0,0,67072,6,1928091688
3429,178564310,566,178564876,5,0,1,512,19,3728329054
3430,178576490,82088,178658578,1,0,0,19968,6,6210061772
3431,178580940,93886,178674826,1,0,0,12800,6,10598032111
3432,178583879,9832,178593711,3,0,1,4096,2,4973748222
3433,178590780,226230,178817010,2,0,0,38400,4,7311193845
3434,178594300,156725,178751025,9,0,0,18432,18,9407017716
3435,178650310,110402,178760712,1,0,0,31744,6,1619593036
3436,178682220,7230,178689450,7,0,1,7680,8,2878824468
3437,178682560,120319,178802879,0,0,0,6656,11,8743995387
3438,178766191,90704,178856895,6,0,0,23040,12,2540015277
3439,178791010,26015,178817025,6,0,1,5632,12,3364609870
3440,178816690,81065,178897755,4,0,0,8704,16,9166518705
3441,178843810,70976,178914786,9,0,0,8704,18,7267019403
3442,178860800,45424,178906224,5,0,0,512,19,1276747023
3443,178877080,115412,178992492,5,0,0,30720,19,5713209579
3444,178882630,43904,178926534,4,0,0,512,16,10194520356
3445,178914100,157220,179071320,9,0,0,55296,18,234322546
3446,178939039,76247,179015286,7,0,0,3584,8,2200373014
3447,178962240,5712,178967952,5,0,1,14336,19,4209054239
3448,178996841,96553,179093394,6,0,0,5632,12,4631481511
3449,179002030,123386,179125416,9,0,0,13824,18,392898187
3450,179002140,142758,179144898,0,0,0,1024,11,570827453
3451,179007440,127819,179135259,5,0,0,32256,19,10373374429
3452,179194541,52364,179246905,6,0,0,3072,12,10134260396
3453,179236250,114741,179350991,5,0,0,44544,19,6051056775
3454,179287921,102136,179390057,6,0,0,15360,12,3005757038
3455,179312270,3904,179316174,5,0,1,10752,19,1540645942
3456,179322180,3898,179326078,0,0,1,4096,11,1487309862
3457,179526700,55748,179582448,8,0,0,4096,12,8845680486
3458,179542070,1518,179543588,0,0,1,1536,11,3082615227
3459,179556830,69464,179626294,3,0,0,13824,2,4635907887
3460,179611520,55748,179667268,2,0,0,4096,4,4463509505
3461,179616470,43904,179660374,0,0,0,512,11,7039854225
3462,179621550,57562,179679112,9,0,0,7680,18,10308449267
3463,179650590,81170,179731760,9,0,0,15360,18,6259075049
3464,179699980,59132,179759112,8,0,0,5120,12,6786968935
3465,179742550,105883,179848433,2,0,0,15360,4,9428561796
3466,179749080,4374,179753454,0,0,1,4608,11,8078070408
3467,179806040,48424,179854464,3,0,0,1024,2,8724040644
3468,179817369,111800,179929169,7,0,0,67072,8,8821885716
3469,179855310,119471,179974781,5,0,0,19456,19,1290780292
3470,179947620,10757,179958377,6,0,1,17408,12,6465125608
3471,179996070,45596,180041666,2,0,0,1024,4,8969136325
3472,180032620,4374,180036994,1,0,1,4608,6,3667500158
3473,180060280,110879,180171159,8,0,0,10240,12,6980347904
3474,180095319,83132,180178451,7,0,0,13312,8,517216478
3475,180110069,69489,180179558,7,0,0,3584,8,10564904510
3476,180361429,5802,180367231,8,0,1,6144,12,2533858342
3477,180366800,105664,180472464,0,0,0,40960,11,5437899223
3478,180387449,4374,180391823,8,0,1,4608,12,7077911676
3479,180493401,99632,180593033,6,0,0,27136,12,484509788
3480,180660910,110084,180770994,0,0,0,61440,11,3268873071
3481,180704840,119305,180824145,2,0,0,56320,4,3099706142
3482,180735641,92575,180828216,6,0,0,13312,12,10265182723
3483,180854841,77744,180932585,6,0,0,10752,12,4992917087
3484,180930120,74369,181004489,9,0,0,11776,18,5976568152
3485,180948580,99944,181048524,0,0,0,28160,11,4789155229
3486,180952510,136394,181088904,5,0,0,24576,19,5507911305
3487,180969460,4850,180974310,0,0,1,5120,11,7157573239
3488,180969610,146252,181115862,5,0,0,66560,19,10316008961
3489,181086471,113170,181199641,6,0,0,33280,12,1330848779
3490,181087471,72582,181160053,6,0,0,9216,12,7376678140
3491,181114900,106046,181220946,3,0,0,45056,2,438279565
3492,181148290,2946,181151236,0,0,1,3072,11,10569233998
3493,181272170,70976,181343146,2,0,0,8704,4,9163505255
3494,181317330,11016,181328346,6,0,1,17920,12,5097065044
3495,181364520,248030,181612550,2,0,0,32768,4,7545668977
3496,181378710,90899,181469609,0,0,0,13312,11,7489598207
3497,181380130,566,181380696,1,0,1,512,6,348552131
3498,181421430,115250,181536680,5,0,0,38912,19,10368480348
3499,181430200,5326,181435526,0,0,1,5632,11,3378936771
3500,181453301,566,181453867,4,0,1,512,16,1575275981
3501,181673339,90368,181763707,7,0,0,16896,8,2173900218
3502,181704970,92996,181797966,1,0,0,20480,6,10301710334
3503,181767700,102440,181870140,0,0,0,36352,11,1389627431
3504,181820070,140001,181960071,3,0,0,9216,2,6402633331
3505,181827030,130218,181957248,1,0,0,57856,6,3061045861
3506,181887690,135900,182023590,0,0,0,47616,11,9813590810
3507,181931730,1518,181933248,6,0,1,1536,12,4248274876
3508,181952029,117059,182069088,7,0,0,14336,8,8078008454
3509,182035710,10499,182046209,2,0,1,16896,4,2283020674
3510,182107410,60824,182168234,3,0,0,5632,2,1396618600
3511,182267550,98072,182365622,3,0,0,22016,2,4620057940
3512,182291810,55314,182347124,0,0,0,512,11,9663173450
3513,182306250,102128,182408378,0,0,0,35328,11,7212905892
3514,182330609,106964,182437573,7,0,0,51200,8,727222543
3515,182358370,88168,182446538,5,0,0,2048,19,1893114548
3516,182511680,97760,182609440,3,0,0,20992,2,175839167
3517,182697560,5802,182703362,7,0,1,6144,8,1007211822
3518,182702230,96692,182798922,9,0,0,22528,18,6136855664
3519,182738420,11016,182749436,0,0,1,17920,11,4442843788
3520,182799130,72668,182871798,8,0,0,9216,12,8816719647
3521,182808830,1518,182810348,2,0,1,1536,4,9982931216
3522,182849759,100724,182950483,7,0,0,30720,8,1740440137
3523,182886101,7706,182893807,4,0,1,8192,16,1799158254
3524,182916440,174054,183090494,9,0,0,38400,18,3140539043
3525,182922400,68372,182990772,9,0,0,10240,18,9181512727
3526,182939910,74814,183014724,3,0,0,8192,2,3725812515
3527,183059699,14117,183073816,3,0,1,24064,2,9693475157
3528,183195060,74696,183269756,8,0,0,15872,12,739652467
3529,183212660,78080,183290740,8,0,0,16896,12,3288260338
3530,183239550,167878,183407428,8,0,0,24576,12,4760798425
3531,183250829,84485,183335314,7,0,0,15872,8,2332132309
3532,183318150,52364,183370514,4,0,0,3072,16,172124556
3533,183336161,74870,183411031,6,0,0,11776,12,10014855722
3534,183398000,69101,183467101,1,0,0,6656,6,5331897405
3535,183420100,68667,183488767,1,0,0,1024,6,8164461146
3536,183516530,56528,183573058,8,0,0,6656,12,1722161784
3537,183547820,120596,183668416,0,0,0,91648,11,530919241
3538,183583050,5802,183588852,0,0,1,6144,11,10108241732
3539,183594031,92847,183686878,6,0,0,9216,12,9714108813
3540,183640990,126450,183767440,0,0,0,30208,11,9804721181
3541,183729360,99796,183829156,2,0,0,8704,4,9041477215
3542,183752150,63296,183815446,2,0,0,8704,4,2212108986
3543,183778660,100100,183878760,8,0,0,28672,12,3282212135
3544,183788220,566,183788786,0,0,1,512,11,212932059
3545,183799600,113762,183913362,8,0,0,30208,12,7484544084
3546,183821909,7262,183829171,8,0,1,12288,12,9177393525
3547,183822500,142714,183965214,5,0,0,1536,19,9082179513
3548,183834180,163794,183997974,3,0,0,33792,2,418549976
3549,183862180,68528,183930708,0,0,0,10752,11,6141414158
3550,183966420,83270,184049690,2,0,0,18432,4,6295117574
3551,184008400,74440,184082840,5,0,0,5120,19,9389035459
3552,184040270,116997,184157267,0,0,0,34816,11,1213918817
3553,184054310,2946,184057256,7,0,1,3072,8,9854921448
3554,184054930,63580,184118510,4,0,0,5120,16,2770232530
3555,184181500,65900,184247400,2,0,0,7168,4,980445361
3556,184234010,58532,184292542,3,0,0,8192,2,1101811319
3557,184274990,5971,184280961,7,0,1,14848,8,1255392207
3558,184298830,2946,184301776,6,0,1,3072,12,8869391594
3559,184433101,50672,184483773,6,0,0,2560,12,2421174753
3560,184468749,93620,184562369,7,0,0,22528,8,990405347
3561,184567670,113828,184681498,0,0,0,73728,11,4263027155
3562,184592911,3898,184596809,4,0,1,4096,16,9987541141
3563,184639940,108249,184748189,3,0,0,28160,2,9230397040
3564,184676601,77557,184754158,6,0,0,9216,12,377829036
3565,184700050,75097,184775147,3,0,0,4608,2,8418657926
3566,184708970,90783,184799753,4,0,0,3584,16,7110010522
3567,184771150,99944,184871094,2,0,0,28160,4,3268965618
3568,184780670,112795,184893465,8,0,0,38400,12,3362264889
3569,184844500,145022,184989522,5,0,0,50176,19,1541612550
3570,184847620,84605,184932225,9,0,0,2048,18,7032971927
3571,184848649,233045,185081694,7,0,0,37888,8,500372515
3572,184885830,75399,184961229,5,0,0,13312,19,1064060082
3573,184903180,139031,185042211,8,0,0,29184,12,7075302123
3574,184903440,103743,185007183,4,0,0,11776,16,9201531030
3575,184926189,165036,185091225,7,0,0,31232,8,4508894174
3576,185115780,57596,185173376,9,0,0,5120,18,9440747539
3577,185178599,4850,185183449,3,0,1,5120,2,4999511831
3578,185202170,72557,185274727,8,0,0,9728,12,10341347149
3579,185216000,55748,185271748,9,0,0,4096,18,3648518085
3580,185222610,132370,185354980,9,0,0,48640,18,1579097662
3581,185422510,79436,185501946,0,0,0,11264,11,10416608130
3582,185439490,47288,185486778,3,0,0,1536,2,1701617753
3583,185448730,43904,185492634,0,0,0,512,11,8764572217
3584,185480310,62516,185542826,0,0,0,6144,11,2302345107
3585,185506320,75092,185581412,8,0,0,5632,12,2491852180
3586,185534250,79748,185613998,8,0,0,12288,12,3477798633
3587,185554710,101192,185655902,3,0,0,32256,2,3466843797
3588,185657451,129896,185787347,6,0,0,126464,12,8163035382
3589,185681260,173839,185855099,2,0,0,49152,4,2411126153
3590,185771280,32430,185803710,7,0,1,31744,8,2332222076
3591,185781020,81105,185862125,2,0,0,512,4,6740383430
3592,185857430,80396,185937826,0,0,0,19456,11,3273200106
3593,185941500,99008,186040508,5,0,0,25088,19,9903778901
3594,185985410,60824,186046234,0,0,0,5632,11,5562494193
3595,185994730,77056,186071786,9,0,0,5632,18,1694466403
3596,186070250,105528,186175778,5,0,0,41472,19,2624032184
3597,186150869,2470,186153339,3,0,1,2560,2,4138910835
3598,186157760,50766,186208526,1,0,0,512,6,3035660880
3599,186185810,86599,186272409,8,0,0,11264,12,5500798566
3600,186222970,2470,186225440,0,0,1,2560,11,7744959521
3601,186228400,35312,186263712,9,0,1,61952,18,305695469
3602,186236360,70097,186306457,4,0,0,5120,16,8827282557
3603,186294690,76935,186371625,3,0,0,11264,2,6584337162
3604,186308740,137373,186446113,8,0,0,8192,12,1418627810
3605,186368570,5041,186373611,1,0,1,2048,6,8655779376
3606,186472861,50672,186523533,6,0,0,2560,12,791031200
3607,186546440,1042,186547482,1,0,1,1024,6,10102719134
3608,186547640,74360,186622000,1,0,0,9728,6,2736101610
3609,186633860,99476,186733336,2,0,0,26624,4,7643885101
3610,186669600,175792,186845392,5,0,0,94720,19,5153197355
3611,186674160,189967,186864127,4,0,0,61440,16,8942474100
3612,186676941,87407,186764348,6,0,0,1024,12,7630849141
3613,186695470,4937,186700407,7,0,1,12800,8,4863718730
3614,186707930,193542,186901472,2,0,0,10240,4,8211670915
3615,186755940,113408,186869348,1,0,0,5632,6,3063808646
3616,186907570,45596,186953166,9,0,0,1024,18,2722851992
3617,186913700,88876,187002576,5,0,0,15872,19,4613098253
3618,187059820,66836,187126656,9,0,0,10240,18,2381213433
3619,187071160,99632,187170792,0,0,0,27136,11,3310042393
3620,187104520,4374,187108894,0,0,1,4608,11,773586276
3621,187106349,5971,187112320,8,0,1,14848,12,369682125
3622,187192350,123955,187316305,9,0,0,46080,18,10227018337
3623,187242339,1994,187244333,3,0,1,2048,2,1400442348
3624,187269880,109959,187379839,4,0,0,26624,16,1971456352
3625,187345781,78212,187423993,6,0,0,12288,12,1739370141
3626,187353040,123842,187476882,0,0,0,46592,11,10655835167
3627,187421750,67379,187489129,8,0,0,9728,12,1818261178
3628,187487630,45420,187533050,2,0,0,512,4,5091269758
3629,187488690,59588,187548278,8,0,0,5120,12,7052929022
3630,187564350,73448,187637798,4,0,0,11776,16,83693294
3631,187581640,11791,187593431,7,0,1,19456,8,1581713268
3632,187630859,11274,187642133,3,0,1,18432,2,10381561499
3633,187643350,114948,187758298,0,0,0,22016,11,5002448449
3634,187663610,146771,187810381,2,0,0,10752,4,8380984158
3635,187712310,66856,187779166,3,0,0,2560,2,7143541425
3636,187872439,5712,187878151,8,0,1,14336,12,600471262
3637,187889790,119226,188009016,5,0,0,16896,19,9785885120
3638,187936530,2870,187939400,7,0,1,8704,8,7753065863
3639,187968340,125140,188093480,2,0,0,40448,4,10692322847
3640,187987600,6754,187994354,7,0,1,7168,8,7591775372
3641,188000769,8262,188009031,8,0,1,5632,12,493401770
3642,188109141,47288,188156429,6,0,0,1536,12,8764100682
3643,188159351,3898,188163249,4,0,1,4096,16,1447305730
3644,188188680,102596,188291276,0,0,0,36864,11,10320669467
3645,188237270,67592,188304862,8,0,0,7680,12,7046635748
3646,188323470,96824,188420294,2,0,0,17920,4,2576800028
3647,188335300,97760,188433060,8,0,0,20992,12,2040904310
3648,188348370,5326,188353696,7,0,1,5632,8,4185634050
3649,188387219,54056,188441275,7,0,0,3584,8,235351723
3650,188433020,82852,188515872,8,0,0,12288,12,7003315266
3651,188441180,59219,188500399,5,0,0,5120,19,6545292776
3652,188494580,120712,188615292,8,0,0,38912,12,8709193487
3653,188566190,72668,188638858,5,0,0,9216,19,5619447909
3654,188574020,85718,188659738,5,0,0,7168,19,8115429742
3655,188606270,68146,188674416,1,0,0,5120,6,399656942
3656,188631070,87140,188718210,5,0,0,16384,19,3090282533
3657,188709670,85160,188794830,8,0,0,19968,12,770378065
3658,188718511,60824,188779335,6,0,0,5632,12,10448455974
3659,188864720,100880,188965600,5,0,0,31232,19,5414615526
3660,188941550,69284,189010834,5,0,0,8192,19,10476661919
3661,189049290,48980,189098270,0,0,0,2048,11,7682490216
3662,189056630,2470,189059100,1,0,1,2560,6,9859917933
3663,189092240,59132,189151372,4,0,0,5120,16,9333562245
3664,189190030,89300,189279330,1,0,0,18432,6,1151917399
3665,189190970,106340,189297310,0,0,0,49152,11,6031613584
3666,189234990,117040,189352030,9,0,0,9728,18,4817800763
3667,189292970,51620,189344590,2,0,0,1536,4,2349081548
3668,189296050,130122,189426172,9,0,0,25088,18,3014293822
3669,189325560,4850,189330410,0,0,1,5120,11,8351942507
3670,189330010,75164,189405174,9,0,0,17408,18,2394594255
3671,189358540,97448,189455988,8,0,0,19968,12,5538974457
3672,189386670,127312,189513982,5,0,0,35328,19,6617686651
3673,189503650,89160,189592810,1,0,0,14336,6,8302054645
3674,189624549,4374,189628923,3,0,1,4608,2,2380285175
3675,189665910,113828,189779738,3,0,0,73728,2,7172065229
3676,189687791,152517,189840308,6,0,0,44544,12,380913678
3677,189737871,111719,189849590,6,0,0,18432,12,5666824353
3678,189793770,113036,189906806,5,0,0,34816,19,3915244027
3679,189814810,161695,189976505,2,0,0,59392,4,730610348
3680,189815040,143354,189958394,5,0,0,15360,19,2254683530
3681,189852730,170362,190023092,9,0,0,63488,18,10490989739
3682,189913649,154026,190067675,7,0,0,66048,8,466501463
3683,189961180,106666,190067846,0,0,0,512,11,1214997958
3684,189968421,10095,189978516,4,0,1,2048,16,3604668490
3685,190032511,4420,190036931,4,0,1,11776,16,4891754558
3686,190148330,89646,190237976,2,0,0,11264,4,2828628956
3687,190158909,5454,190164363,3,0,1,13824,2,10457001710
3688,190201690,66700,190268390,0,0,0,4096,11,4073350622
3689,190266960,50798,190317758,8,0,0,2560,12,4652249777
3690,190428621,62228,190490849,6,0,0,10240,12,8247374321
3691,190435500,64208,190499708,8,0,0,6656,12,6372490188
3692,190505890,12566,190518456,6,0,1,20992,12,7563069322
3693,190515120,70955,190586075,0,0,0,9728,11,5889790171
3694,190520580,62516,190583096,8,0,0,6144,12,9434706975
3695,190582900,104827,190687727,0,0,0,33792,11,3342685248
3696,190628139,93290,190721429,7,0,0,7168,8,1318694761
3697,190630710,5802,190636512,1,0,1,6144,6,3937383334
3698,190775490,99360,190874850,2,0,0,18432,4,684880534
3699,190815920,115504,190931424,4,0,0,21504,16,10675580389
3700,190841049,83146,190924195,7,0,0,512,8,4608630370
3701,190845200,2946,190848146,6,0,1,3072,12,8230264245
3702,190849379,48980,190898359,7,0,0,2048,8,4246684504
3703,190890070,114463,191004533,8,0,0,7680,12,9530663355
3704,190930919,3919,190934838,8,0,1,3584,12,10474496335
3705,191007630,102440,191110070,1,0,0,36352,6,1858102067
3706,191023261,94468,191117729,6,0,0,25088,12,1785956771
3707,191231810,62516,191294326,9,0,0,6144,18,988796100
3708,191277941,100412,191378353,6,0,0,29696,12,8772500015
3709,191372260,58449,191430709,4,0,0,3072,16,5384913715
3710,191454860,94820,191549680,0,0,0,16384,11,837635201
3711,191472250,99788,191572038,0,0,0,27648,11,508092151
3712,191506920,85464,191592384,2,0,0,2560,4,6588568339
3713,191515900,105738,191621638,1,0,0,24576,6,946262653
3714,191524470,79304,191603774,9,0,0,15872,18,8706650183
3715,191538240,3387,191541627,7,0,1,9728,8,1508125979
3716,191592590,120009,191712599,4,0,0,84992,16,10250496193
3717,191733280,108056,191841336,4,0,0,54784,16,9058351499
3718,191834970,108798,191943768,0,0,0,36352,11,984453175
3719,191845021,116858,191961879,6,0,0,59392,12,10688944268
3720,191861581,132848,191994429,6,0,0,29184,12,4022545582
3721,191887929,114315,192002244,7,0,0,25600,8,2503942213
3722,191949520,72188,192021708,0,0,0,2560,11,2391539524
3723,192047829,91772,192139601,7,0,0,21504,8,8792104576
3724,192050649,5326,192055975,3,0,1,5632,2,9810832651
3725,192117680,47600,192165280,4,0,0,2560,16,7010373530
3726,192170930,81128,192252058,9,0,0,11776,18,42753122
3727,192204110,44060,192248170,9,0,0,1024,18,7629496892
3728,192270990,52364,192323354,5,0,0,3072,19,8026075114
3729,192282910,57908,192340818,3,0,0,6144,2,1499312957
3730,192296051,5454,192301505,4,0,1,13824,16,2583394720
3731,192356490,125996,192482486,5,0,0,113664,19,10436095033
3732,192495910,92708,192588618,3,0,0,24576,2,6959103457
3733,192531100,106964,192638064,4,0,0,51200,16,927618381
3734,192535469,2946,192538415,3,0,1,3072,2,3287109754
3735,192561650,119200,192680850,9,0,0,29184,18,4870070756
3736,192661640,117694,192779334,1,0,0,52736,6,3537528888
3737,192709730,120490,192830220,2,0,0,22016,4,2857682214
3738,192732650,3898,192736548,6,0,1,4096,12,3664733088
3739,192797070,75008,192872078,4,0,0,16896,16,10434977993
3740,192805620,160220,192965840,5,0,0,121856,19,7769562602
3741,192819391,20624,192840015,4,0,1,33280,16,4075413094
3742,192829020,12301,192841321,0,0,1,2048,11,7323732331
3743,192911479,78368,192989847,7,0,0,12800,8,1731736299
3744,192915580,79898,192995478,0,0,0,18432,11,352378126
3745,192997560,143551,193141111,2,0,0,9728,4,6379764363
3746,193047380,107807,193155187,4,0,0,30720,16,9867378757
3747,193106760,79681,193186441,4,0,0,6144,16,3995849600
3748,193164341,119960,193284301,6,0,0,27648,12,7699376810
3749,193248930,100963,193349893,0,0,0,13824,11,7385957140
3750,193280849,93368,193374217,7,0,0,20480,8,6872464816
3751,193317360,97292,193414652,9,0,0,19456,18,4626744920
3752,193382150,1042,193383192,0,0,1,1024,11,1800027653
3753,193400020,566,193400586,0,0,1,512,11,97199134
3754,193463069,1518,193464587,8,0,1,1536,12,1401220845
3755,193489151,1518,193490669,4,0,1,1536,16,1430304303
3756,193500490,186694,193687184,5,0,0,17920,19,10465514554
3757,193686740,102252,193788992,4,0,0,34304,16,5753908555
3758,193689970,112921,193802891,4,0,0,45568,16,3470277860
3759,193718910,92276,193811186,5,0,0,10240,19,3387954553
3760,193741849,138713,193880562,7,0,0,51200,8,2229358387
3761,193790870,20331,193811201,5,0,1,7168,19,8129504631
3762,193806920,243095,194050015,0,0,0,44032,11,10672926312
3763,193858889,4420,193863309,3,0,1,11776,2,4059552823
3764,193867930,115851,193983781,3,0,0,17408,2,6331142989
3765,193904670,84118,193988788,4,0,0,16384,16,3029130192
3766,193929680,4162,193933842,0,0,1,11264,11,9607673242
3767,194065420,76052,194141472,8,0,0,10240,12,891530083
3768,194066360,80060,194146420,2,0,0,13312,4,4019364520
3769,194083550,566,194084116,9,0,1,512,18,4927095190
3770,194102229,65521,194167750,7,0,0,1536,8,4007102629
3771,194156500,64208,194220708,4,0,0,6656,16,7965077952
3772,194207710,65900,194273610,5,0,0,7168,19,6300974220
3773,194360680,81284,194441964,2,0,0,12288,4,8719004059
3774,194409140,104780,194513920,8,0,0,44032,12,7206648146
3775,194513609,44207,194557816,7,0,0,512,8,2518849595
3776,194600680,106184,194706864,0,0,0,48640,11,7584091956
3777,194604701,62516,194667217,6,0,0,6144,12,9592025040
3778,194629530,87768,194717298,5,0,0,6144,19,6992792962
3779,194679040,113888,194792928,1,0,0,11264,6,5779852416
3780,194686110,103064,194789174,9,0,0,38400,18,6016554128
3781,194689050,86384,194775434,9,0,0,18944,18,5766427474
3782,194710420,7706,194718126,0,0,1,8192,11,1128628666
3783,194798940,127033,194925973,0,0,0,5632,11,6109729971
3784,194933680,4850,194938530,7,0,1,5120,8,53092623
3785,194980560,104156,195084716,3,0,0,41984,2,1846168336
3786,194999790,3645,195003435,9,0,1,10240,18,9246086075
3787,195017530,68761,195086291,4,0,0,5120,16,10355210881
3788,195192120,1518,195193638,0,0,1,1536,11,2477633475
3789,195206500,102440,195308940,4,0,0,36352,16,7442777901
3790,195221660,43904,195265564,3,0,0,512,2,5088482715
3791,195226941,1042,195227983,4,0,1,1024,16,8372301694
3792,195257610,6278,195263888,1,0,1,6656,6,3698446218
3793,195259921,93058,195352979,6,0,0,15360,12,1742643315
3794,195288270,59742,195348012,4,0,0,1024,16,5719279472
3795,195349480,61399,195410879,0,0,0,6144,11,7547717466
3796,195386261,112926,195499187,6,0,0,21504,12,4816649379
3797,195389390,1042,195390432,2,0,1,1024,4,6194820414
3798,195441540,95912,195537452,2,0,0,19968,4,7083046709
3799,195481450,57440,195538890,9,0,0,4608,18,1540331789
3800,195533480,102972,195636452,9,0,0,25088,18,5878639636
3801,195580400,57159,195637559,1,0,0,3584,6,8427767908
3802,195605851,100412,195706263,6,0,0,29696,12,4822556389
3803,195661191,57440,195718631,6,0,0,4608,12,9179580489
3804,195673400,114199,195787599,8,0,0,32256,12,10181327800
3805,195712870,99673,195812543,8,0,0,20992,12,9402708348
3806,195732840,73292,195806132,4,0,0,11264,16,8767274570
3807,195843420,106652,195950072,2,0,0,50176,4,4077676736
3808,195867520,161350,196028870,1,0,0,75776,6,3484589998
3809,195939230,176586,196115816,2,0,0,37376,4,3623397129
3810,195972700,98656,196071356,4,0,0,22528,16,6828090372
3811,196136970,73916,196210886,4,0,0,13312,16,10178450483
3812,196140770,86360,196227130,5,0,0,13824,19,745058950
3813,196188060,91928,196279988,5,0,0,22016,19,6931590721
3814,196242080,78704,196320784,1,0,0,18944,6,10609132426
3815,196269110,10893,196280003,1,0,1,4608,6,5209741218
3816,196272160,12995,196285155,0,0,1,25088,11,9549661311
3817,196297970,226477,196524447,0,0,0,29184,11,461410460
3818,196337590,144282,196481872,3,0,0,15872,2,2094036433
3819,196359560,112424,196471984,4,0,0,69120,16,543661994
3820,196437449,3128,196440577,3,0,1,9216,2,2778565151
3821,196448670,140110,196588780,1,0,0,67072,6,1324332050
3822,196558530,59132,196617662,0,0,0,5120,11,8536888715
3823,196562540,52364,196614904,2,0,0,3072,4,1410335724
3824,196592380,106444,196698824,1,0,0,43520,6,5723360844
3825,196621990,128094,196750084,8,0,0,56320,12,7198254332
3826,196707170,2470,196709640,7,0,1,2560,8,5364886779
3827,196727330,57440,196784770,0,0,0,4608,11,6338822034
3828,196769470,65612,196835082,5,0,0,11264,19,3736077782
3829,196772850,120076,196892926,2,0,0,59904,4,6482520869
3830,196819940,5802,196825742,2,0,1,6144,4,10538764087
3831,196858340,77907,196936247,2,0,0,2048,4,6127962252
3832,196981260,1994,196983254,0,0,1,2048,11,5998371358
3833,197067830,101348,197169178,8,0,0,32768,12,8367953346
3834,197106960,116275,197223235,8,0,0,49152,12,6993170706
3835,197112250,221379,197333629,2,0,0,32256,4,5026058027
3836,197116419,1518,197117937,3,0,1,1536,2,8784645218
3837,197151630,129103,197280733,8,0,0,19968,12,7568379700
3838,197172750,89144,197261894,9,0,0,17920,18,1312567045
3839,197298230,103220,197401450,4,0,0,38912,16,8051104452
3840,197312100,73160,197385260,2,0,0,15872,4,1733532274
3841,197335550,118776,197454326,3,0,0,29696,2,4588913996
3842,197386520,119223,197505743,4,0,0,45056,16,3505181360
3843,197387971,13494,197401465,4,0,1,3584,16,4342412492
3844,197488540,110240,197598780,0,0,0,61952,11,8084802902
3845,197494760,146570,197641330,9,0,0,16896,18,10035456915
3846,197525459,110708,197636167,7,0,0,63488,8,5879704536
3847,197561860,85425,197647285,0,0,0,3072,11,3759069969
3848,197630920,64458,197695378,4,0,0,3584,16,3453569069
3849,197701660,115076,197816736,4,0,0,77824,16,1273316327
3850,197830780,59132,197889912,8,0,0,5120,12,5731709041
3851,197837630,3422,197841052,0,0,1,3584,11,1196382857
3852,198010190,108524,198118714,1,0,0,56320,6,10447548819
3853,198028091,62984,198091075,6,0,0,7680,12,2724469875
3854,198076670,123680,198200350,3,0,0,24576,2,9275138199
3855,198217931,74384,198292315,6,0,0,14848,12,345973973
3856,198248280,152563,198400843,8,0,0,131584,12,4671961001
3857,198262100,2870,198264970,9,0,1,8704,18,3784989022
3858,198331819,3128,198334947,3,0,1,9216,2,2083725243
3859,198332520,79296,198411816,1,0,0,4096,6,4075631428
3860,198412410,122675,198535085,3,0,0,8704,2,1170189995
3861,198434641,43904,198478545,6,0,0,512,12,765029601
3862,198444620,79436,198524056,8,0,0,11264,12,6054637095
3863,198471010,53997,198525007,1,0,0,3072,6,3767117705
3864,198588640,4374,198593014,6,0,1,4608,12,9428443415
3865,198671820,117104,198788924,9,0,0,84480,18,3468051691
3866,198743960,5196,198749156,0,0,1,13312,11,4446536653
3867,198783789,7121,198790910,3,0,1,2048,2,9334102616
3868,198806330,184375,198990705,8,0,0,46080,12,8390071803
3869,198815800,93030,198908830,8,0,0,16384,12,7994977336
3870,198821371,138015,198959386,6,0,0,20992,12,8829902615
3871,198854320,194994,199049314,4,0,0,21504,16,8630986673
3872,198855050,147385,199002435,8,0,0,512,12,9192000517
3873,198898050,104214,199002264,3,0,0,22528,2,9119159422
3874,198943630,75512,199019142,4,0,0,11264,16,6813369174
3875,199058280,101660,199159940,9,0,0,33792,18,1407551326
3876,199060330,145330,199205660,4,0,0,22528,16,8936511602
3877,199081481,2946,199084427,4,0,1,3072,16,1006071905
3878,199097389,21399,199118788,3,0,1,34816,2,7566345080
3879,199099000,20556,199119556,7,0,1,11776,8,3790951291
3880,199124540,180855,199305395,5,0,0,90624,19,4304253769
3881,199136610,55748,199192358,4,0,0,4096,16,7445380132
3882,199258390,144545,199402935,4,0,0,9728,16,2824787426
3883,199421800,79616,199501416,2,0,0,16896,4,6156823432
3884,199453450,137240,199590690,9,0,0,81920,18,1164916348
3885,199569621,26404,199596025,4,0,1,5632,16,3583412807
3886,199581340,66807,199648147,5,0,0,4608,19,2570851250
3887,199639950,189954,199829904,4,0,0,94720,16,10683189753
3888,199784080,99476,199883556,3,0,0,26624,2,9333193816
3889,199785311,89768,199875079,6,0,0,19968,12,2442748339
3890,199791539,4850,199796389,3,0,1,5120,2,7258672906
3891,199901341,45596,199946937,6,0,0,1024,12,4636701128
3892,199958970,85628,200044598,8,0,0,21504,12,2309832487
3893,200012260,63328,200075588,5,0,0,6144,19,6259312411
3894,200047871,93596,200141467,6,0,0,17408,12,928652514
3895,200056690,150363,200207053,9,0,0,75264,18,1727773791
3896,200144350,566,200144916,0,0,1,512,11,7126436800
3897,200249581,5802,200255383,4,0,1,6144,16,7713263213
3898,200302130,3645,200305775,6,0,1,10240,12,2506464490
3899,200307760,47288,200355048,2,0,0,1536,4,6354476477
3900,200380160,56216,200436376,9,0,0,5632,18,6036250389
3901,200409020,93284,200502304,5,0,0,16384,19,10153557917
3902,200472330,2946,200475276,0,0,1,3072,11,8274974798
3903,200510680,160091,200670771,8,0,0,22016,12,10304903375
3904,200521591,156683,200678274,6,0,0,24576,12,4719720001
3905,200534061,219024,200753085,6,0,0,40960,12,590281765
3906,200559391,103436,200662827,6,0,0,31232,12,8296868007
3907,200623530,71307,200694837,0,0,0,1024,11,7110982304
3908,200630590,122830,200753420,9,0,0,1024,18,6814903614
3909,200663660,104156,200767816,1,0,0,41984,6,9793150808
3910,200676349,117927,200794276,7,0,0,17920,8,7980683376
3911,200723490,108885,200832375,5,0,0,25600,19,6864236201
3912,200723950,6754,200730704,2,0,1,7168,4,5571948301
3913,200743211,104386,200847597,6,0,0,10752,12,769174883
3914,200784740,154843,200939583,1,0,0,42496,6,6052228158
3915,200788270,90305,200878575,2,0,0,3584,4,10261482594
3916,200953880,4162,200958042,0,0,1,11264,11,3113054651
3917,200998450,45596,201044046,3,0,0,1024,2,5849185861
3918,201000550,124519,201125069,9,0,0,27136,18,1573855124
3919,201003100,1042,201004142,9,0,1,1024,18,5777710191
3920,201009970,106808,201116778,8,0,0,50688,12,6086936285
3921,201107349,18245,201125594,8,0,1,512,12,8180338290
3922,201166550,50672,201217222,2,0,0,2560,4,7405452675
3923,201171050,103688,201274738,1,0,0,40448,6,9378468259
3924,201173230,158681,201331911,2,0,0,12800,4,8889623323
3925,201249990,107432,201357422,2,0,0,52736,4,508505175
3926,201271590,120171,201391761,9,0,0,26624,18,1282946563
3927,201290960,113166,201404126,0,0,0,7168,11,8733507748
3928,201315819,132792,201448611,7,0,0,8192,8,154198792
3929,201472740,57908,201530648,5,0,0,6144,19,6565710068
3930,201496670,1042,201497712,9,0,1,1024,18,4647184417
3931,201528790,111622,201640412,4,0,0,60416,16,1094496065
3932,201643329,66080,201709409,7,0,0,12800,8,2117304946
3933,201736510,2946,201739456,6,0,1,3072,12,4281652539
3934,201830129,103220,201933349,7,0,0,38912,8,5721672543
3935,201861540,153829,202015369,5,0,0,23552,19,5620451149
3936,201875720,97604,201973324,2,0,0,20480,4,7773647094
3937,201885510,60799,201946309,5,0,0,3584,19,3764890099
3938,201890660,92225,201982885,3,0,0,7680,2,1504409140
3939,201922290,96838,202019128,0,0,0,12288,11,6301458364
3940,201930600,106231,202036831,3,0,0,7168,2,2585652810
3941,202074320,4850,202079170,0,0,1,5120,11,8439925302
3942,202083880,11016,202094896,0,0,1,17920,11,6805076308
3943,202090620,60536,202151156,0,0,0,9728,11,6599156371
3944,202144600,79768,202224368,3,0,0,15872,2,8457707153
3945,202191540,65768,202257308,3,0,0,11776,2,2881134866
3946,202202050,137014,202339064,8,0,0,118784,12,7119673259
3947,202363520,102596,202466116,4,0,0,36864,16,4374127781
3948,202374640,47288,202421928,9,0,0,1536,18,3785656109
3949,202375231,99617,202474848,6,0,0,18944,12,6975235607
3950,202379220,164124,202543344,0,0,0,82432,11,4067784441
3951,202397090,6278,202403368,7,0,1,6656,8,4322809746
3952,202436911,80481,202517392,6,0,0,16384,12,10392512458
3953,202480120,5454,202485574,6,0,1,13824,12,1608494304
3954,202516671,58153,202574824,6,0,0,4608,12,4768895652
3955,202559510,566,202560076,9,0,1,512,18,3049558328
3956,202573660,88140,202661800,3,0,0,15872,2,3384359002
3957,202613340,6229,202619569,9,0,1,15360,18,9814314562
3958,202642180,221279,202863459,5,0,0,13824,19,3839696188
3959,202741350,45596,202786946,9,0,0,1024,18,7194673699
3960,202790170,2870,202793040,4,0,1,8704,16,6660509553
3961,202840349,104156,202944505,7,0,0,41984,8,4374016212
3962,202892840,108125,203000965,8,0,0,13312,12,2524550672
3963,202939630,89379,203029009,1,0,0,12800,6,5526434944
3964,202954289,131222,203085511,7,0,0,66048,8,5083990161
3965,202994420,100100,203094520,4,0,0,28672,16,2449861903
3966,203000541,118645,203119186,6,0,0,7680,12,1090982936
3967,203103820,97160,203200980,3,0,0,24064,2,2975890415
3968,203142550,58757,203201307,4,0,0,1024,16,5903097824
3969,203186880,1042,203187922,6,0,1,1024,12,8061594488
3970,203208150,51880,203260030,1,0,0,3584,6,10259599865
3971,203320190,4162,203324352,9,0,1,11264,18,4478854218
3972,203460991,106652,203567643,6,0,0,50176,12,4165823169
3973,203466971,106927,203573898,6,0,0,20480,12,1166694021
3974,203469760,5196,203474956,6,0,1,13312,12,2004793388
3975,203601259,75721,203676980,7,0,0,15360,8,1673459828
3976,203618799,61448,203680247,7,0,0,7680,8,4112326195
3977,203622750,116165,203738915,8,0,0,38912,12,8159299329
3978,203687190,104624,203791814,4,0,0,43520,16,6532830004
3979,203725469,119508,203844977,7,0,0,2048,8,2968900933
3980,203742051,102287,203844338,6,0,0,27136,12,4667809056
3981,203764279,45596,203809875,7,0,0,1024,8,9991406491
3982,203780669,89817,203870486,7,0,0,13824,8,5966587000
3983,203907900,81308,203989208,4,0,0,17408,16,1008435978
3984,203991320,83849,204075169,5,0,0,14848,19,3057311930
3985,203991569,47600,204039169,7,0,0,2560,8,1769358462
3986,203992730,3422,203996152,6,0,1,3584,12,2635436404
3987,204060740,98696,204159436,3,0,0,24064,2,8347549882
3988,204139850,77168,204217018,3,0,0,18944,2,6320579178
3989,204155170,113588,204268758,2,0,0,58880,4,6894647200
3990,204158450,117811,204276261,4,0,0,24576,16,6155076713
3991,204172419,1994,204174413,3,0,1,2048,2,4430315522
3992,204201320,147536,204348856,1,0,0,87552,6,4898191399
3993,204282360,124404,204406764,0,0,0,19456,11,2351273127
3994,204314939,116956,204431895,7,0,0,82432,8,3453174226
3995,204450130,99788,204549918,9,0,0,27648,18,10076510541
3996,204484850,110453,204595303,1,0,0,13824,6,5247119416
3997,204497830,93246,204591076,5,0,0,17408,19,7586513166
3998,204498890,72668,204571558,8,0,0,9216,12,9772268957
3999,204631121,101816,204732937,6,0,0,34304,12,5740045297
4000,204693700,566,204694266,6,0,1,512,12,6797493363
4001,204717440,55661,204773101,2,0,0,2560,4,2075331119
4002,204909530,50828,204960358,8,0,0,3072,12,4772811389
4003,204924090,87320,205011410,2,0,0,22016,4,7742016004
4004,204949989,2470,204952459,8,0,1,2560,12,2743852724
4005,204963660,5326,204968986,1,0,1,5632,6,3680600010
4006,205051780,101816,205153596,4,0,0,34304,16,9490250726
4007,205109390,82688,205192078,3,0,0,16896,2,4095240231
4008,205134930,162340,205297270,9,0,0,62464,18,10028916035
4009,205281860,68266,205350126,4,0,0,1024,16,3998507689
4010,205287961,119098,205407059,6,0,0,60416,12,8056385464
4011,205304530,54836,205359366,3,0,0,6144,2,870652763
4012,205355190,87611,205442801,0,0,0,10240,11,298455755
4013,205410420,101504,205511924,4,0,0,33280,16,1518853234
4014,205503690,65666,205569356,3,0,0,4608,2,8648880956
4015,205561400,91172,205652572,8,0,0,24576,12,4313593033
4016,205577090,141872,205718962,2,0,0,24576,4,7175455179
4017,205683830,5802,205689632,9,0,1,6144,18,5154259029
4018,205689360,100256,205789616,1,0,0,29184,6,6299115690
4019,205693100,152688,205845788,2,0,0,52224,4,8858564508
4020,205778079,101807,205879886,7,0,0,11776,8,6908400076
4021,205798920,161504,205960424,9,0,0,48128,18,780645053
4022,205935310,99164,206034474,8,0,0,25600,12,4804632573
4023,205994009,119131,206113140,7,0,0,55808,8,3023506897
4024,206004990,120645,206125635,2,0,0,40960,4,2310866754
4025,206009510,124112,206133622,4,0,0,26112,16,7203856293
4026,206042600,117457,206160057,3,0,0,9216,2,300045782
4027,206045680,111554,206157234,9,0,0,17920,18,1593852019
4028,206095240,104156,206199396,9,0,0,41984,18,5289111566
4029,206110810,144128,206254938,8,0,0,21504,12,899430725
4030,206119009,18992,206138001,3,0,1,11776,2,5806793449
4031,206268570,80145,206348715,2,0,0,8704,4,10252465460
4032,206272970,148015,206420985,2,0,0,17920,4,405252585
4033,206276140,24242,206300382,6,0,1,40448,12,9880130269
4034,206395899,70376,206466275,7,0,0,11776,8,3898114671
4035,206397871,47444,206445315,6,0,0,2048,12,7646780700
4036,206418160,132553,206550713,9,0,0,60928,18,5565410874
4037,206421510,3904,206425414,1,0,1,10752,6,4762564636
4038,206517360,95597,206612957,4,0,0,20992,16,4649379785
4039,206549260,74893,206624153,3,0,0,11776,2,6813795115
4040,206620500,99788,206720288,1,0,0,27648,6,8237444172
4041,206636319,126437,206762756,8,0,1,209408,12,4699762197
4042,206662010,166731,206828741,3,0,0,4096,2,5166964058
4043,206665350,262067,206927417,5,0,0,3072,19,2251093602
4044,206697289,221712,206919001,7,0,0,67072,8,1290426173
4045,206727920,259582,206987502,4,0,0,15360,16,5692863122
4046,206829940,130070,206960010,0,0,0,15872,11,3132204955
4047,206842140,146001,206988141,1,0,0,2048,6,8714500622
4048,206871630,79005,206950635,2,0,0,4608,4,1301367683
4049,206910700,13143,206923843,9,0,1,5120,18,2025404510
4050,206968690,134712,207103402,5,0,0,90112,19,2302358013
4051,207039540,98866,207138406,0,0,0,6144,11,1398065638
4052,207041180,63536,207104716,9,0,0,2560,18,9557169673
4053,207073820,92306,207166126,4,0,0,21504,16,9734878849
4054,207080959,126747,207207706,7,0,0,42496,8,374517252
4055,207183250,45752,207229002,9,0,0,1536,18,4746300509
4056,207203450,57082,207260532,8,0,0,3072,12,2604021487
4057,207311150,72668,207383818,3,0,0,9216,2,3874991850
4058,207339499,101192,207440691,7,0,0,32256,8,6560858951
4059,207434510,83917,207518427,9,0,0,10752,18,9103456412
4060,207469250,49675,207518925,3,0,0,1536,2,8964612467
4061,207472730,71288,207544018,4,0,0,9728,16,6155156492
4062,207512710,5732,207518442,0,0,1,2560,11,9025508236
4063,207549821,84068,207633889,6,0,0,16384,12,1883456120
4064,207808930,1994,207810924,2,0,1,2048,4,8956644242
4065,207857570,185117,208042687,4,0,0,115712,16,9775651544
4066,207880300,119250,207999550,4,0,0,2560,16,4883102693
4067,207893919,157371,208051290,1,0,0,28160,6,309536410
4068,207936079,162666,208098745,1,0,0,41472,6,6719673676
4069,208016669,88900,208105569,8,0,1,92160,12,1370543300
4070,208029180,180841,208210021,8,0,0,107008,12,10037190123
4071,208031880,180964,208212844,8,0,0,9216,12,2797211315
4072,208045410,270330,208315740,5,0,0,40448,19,1010373489
4073,208062560,191497,208254057,3,0,0,35840,2,337090580
4074,208066140,147975,208214115,9,0,0,4096,18,6516571656
4075,208115330,157275,208272605,2,0,0,24064,4,4753296348
4076,208117000,100250,208217250,0,0,0,10240,11,7870972316
4077,208157180,105689,208262869,5,0,0,4096,19,734835803
4078,208163789,1042,208164831,3,0,1,1024,2,1191037848
4079,208185980,245649,208431629,0,0,0,76288,11,7017727672
4080,208219961,150660,208370621,6,0,0,37376,12,3038389674
4081,208282150,72980,208355130,8,0,0,10240,12,9573432938
4082,208303411,148822,208452233,6,0,0,512,12,5454894982
4083,208330729,75864,208406593,7,0,0,7168,8,4658223253
4084,208526560,107744,208634304,8,0,0,53760,12,2887613996
4085,208541199,34367,208575566,8,0,1,56832,12,1578923510
4086,208543939,186444,208730383,1,0,0,18944,6,10149828910
4087,208548760,134187,208682947,3,0,0,24576,2,4661718635
4088,208672939,142794,208815733,7,0,0,66048,8,3970248880
4089,208689900,74696,208764596,8,0,0,15872,12,2951947154
4090,208735650,87661,208823311,9,0,0,4096,18,7968799193
4091,208862509,2470,208864979,3,0,1,2560,2,247263330
4092,208877380,78080,208955460,0,0,0,16896,11,3508554027
4093,208965001,139524,209104525,6,0,0,29696,12,7977730490
4094,208992710,102752,209095462,0,0,0,37376,11,5098934536
4095,209002750,3898,209006648,1,0,1,4096,6,1589078398
4096,209038879,67065,209105944,7,0,0,4608,8,7940592273
4097,209049770,73412,209123182,9,0,0,5120,18,10473429336
4098,209141121,58376,209199497,6,0,0,7680,12,9078927571
4099,209381799,52364,209434163,7,0,0,3072,8,5235989483
4100,209396250,109304,209505554,8,0,0,58880,12,8253127752
4101,209424290,190656,209614946,2,0,0,17408,4,197288479
4102,209437399,111829,209549228,1,0,0,29696,6,6440979460
4103,209542820,51996,209594816,3,0,0,1024,2,5337953185
4104,209557180,85604,209642784,3,0,0,16384,2,1487858759
4105,209650480,13770,209664250,9,0,1,26624,18,6103355989
4106,209718130,1994,209720124,0,0,1,2048,11,4992867417
4107,209718700,79539,209798239,9,0,0,11264,18,8325325568
4108,209804290,74360,209878650,3,0,0,9728,2,3202774977
4109,209827530,127446,209954976,9,0,0,32256,18,2872283304
4110,209904950,131422,210036372,8,0,0,14848,12,3364923424
4111,209920350,566,209920916,2,0,1,512,4,2946853320
4112,209926510,3422,209929932,4,0,1,3584,16,2546009569
4113,209967680,77744,210045424,3,0,0,10752,2,8544052358
4114,210007760,72874,210080634,2,0,0,12800,4,7005917741
4115,210025180,82056,210107236,4,0,0,9728,16,3771095378
4116,210092451,55748,210148199,6,0,0,4096,12,8222533233
4117,210103719,108524,210212243,7,0,0,56320,8,8015742716
4118,210254169,102128,210356297,1,0,0,35328,6,5379129464
4119,210267601,120412,210388013,6,0,0,18432,12,8528700561
4120,210370460,71444,210441904,8,0,0,10240,12,10631173848
4121,210428150,1994,210430144,4,0,1,2048,16,5501040050
4122,210579140,116012,210695152,8,0,0,80896,12,6408011592
4123,210619220,149456,210768676,2,0,0,22528,4,419796152
4124,210703680,68755,210772435,0,0,0,12288,11,4787619188
4125,210773249,72668,210845917,1,0,0,9216,6,8787314269
4126,210871739,97340,210969079,1,0,0,29696,6,4476517056
4127,210919220,96677,211015897,3,0,0,15872,2,10730135239
4128,210954981,81020,211036001,6,0,0,21504,12,9626167303
4129,210961490,81495,211042985,5,0,0,4096,19,8326913801
4130,211030149,116708,211146857,7,0,0,64000,8,5652295997
4131,211122630,2946,211125576,0,0,1,3072,11,4621179863
4132,211134320,110757,211245077,8,0,0,22528,12,10690209558
4133,211217680,70976,211288656,2,0,0,8704,4,5547609517
4134,211228350,16742,211245092,6,0,1,32256,12,1713719073
4135,211272440,98696,211371136,1,0,0,24064,6,9797367131
4136,211314620,120785,211435405,2,0,0,28160,4,10436758739
4137,211427150,13184,211440334,5,0,1,12800,19,1475665792
4138,211461169,24242,211485411,8,0,1,40448,12,1224127937
4139,211508359,189177,211697536,1,0,0,4096,6,378405177
4140,211525690,113200,211638890,8,0,0,5632,12,1494080392
4141,211570499,3387,211573886,3,0,1,9728,2,4550429021
4142,211743300,116324,211859624,3,0,0,81920,2,5549322431
4143,211776430,151852,211928282,1,0,0,74240,6,6757249200
4144,211797059,151737,211948796,7,0,0,19456,8,813695284
4145,211866551,125181,211991732,6,0,0,69632,12,845990743
4146,212079050,47288,212126338,0,0,0,1536,11,7684276128
4147,212129579,74852,212204431,7,0,0,16384,8,10466599117
4148,212132271,1994,212134265,4,0,1,2048,16,3581975245
4149,212147090,77300,212224390,3,0,0,14336,2,10438507635
4150,212179570,4374,212183944,7,0,1,4608,8,5621235221
4151,212223961,6699,212230660,4,0,1,6656,16,9294111418
4152,212268450,55748,212324198,0,0,0,4096,11,877049707
4153,212315200,108262,212423462,1,0,0,30208,6,4542436619
4154,212324599,139903,212464502,1,0,0,69120,6,10631392411
4155,212363329,120751,212484080,7,0,0,11264,8,1241196053
4156,212413730,122364,212536094,5,0,0,24576,19,5017278881
4157,212437030,127366,212564396,0,0,0,25600,11,1871789934
4158,212441790,65936,212507726,3,0,0,2048,2,6092783106
4159,212468590,140530,212609120,4,0,0,31232,16,5692335612
4160,212491740,23208,212514948,6,0,1,38400,12,6796562357
4161,212520649,33245,212553894,8,0,1,57856,12,9850071541
4162,212526540,27700,212554240,5,0,1,512,19,7470255226
4163,212629170,6278,212635448,4,0,1,6656,16,4674730235
4164,212694070,62516,212756586,3,0,0,6144,2,8260189200
4165,212745910,43904,212789814,2,0,0,512,4,8630304817
4166,212832420,43904,212876324,0,0,0,512,11,3994144798
4167,212885880,107588,212993468,9,0,0,53248,18,1753269800
4168,212900930,99608,213000538,9,0,0,22016,18,5531394963
4169,212902089,119975,213022064,1,0,0,26112,6,3837750298
4170,212915850,4850,212920700,9,0,1,5120,18,9922235283
4171,212934340,3422,212937762,9,0,1,3584,18,5197048413
4172,212948300,3128,212951428,0,0,1,9216,11,4984988542
4173,212977760,113928,213091688,3,0,0,22528,2,8382388700
4174,213022580,164612,213187192,2,0,1,270336,4,2387988245
4175,213030550,327607,213358157,8,0,0,40448,12,6620251478
4176,213031310,202931,213234241,3,0,0,17408,2,6551024296
4177,213073929,119159,213193088,7,0,0,2048,8,6811431980
4178,213131880,186735,213318615,3,0,0,23552,2,4681007896
4179,213271300,100771,213372071,8,0,0,19456,12,7714878390
4180,213298540,34367,213332907,6,0,1,56832,12,3164156943
4181,213309380,119019,213428399,5,0,0,43008,19,9725735007
4182,213329210,115054,213444264,9,0,0,8192,18,2089582911
4183,213429481,75764,213505245,6,0,0,14336,12,112096813
4184,213477670,194795,213672465,8,0,0,152576,12,8503137557
4185,213557930,151459,213709389,2,0,0,19456,4,1057081929
4186,213683580,102752,213786332,0,0,0,37376,11,7691729942
4187,213685779,104312,213790091,7,0,0,12288,8,2783016698
4188,213687061,45596,213732657,6,0,0,1024,12,6666627976
4189,213722619,76052,213798671,7,0,0,10240,8,8743987075
4190,213737330,111054,213848384,5,0,0,22016,19,10197097253
4191,213745761,13512,213759273,4,0,1,26112,16,10556811951
4192,213940020,98696,214038716,8,0,0,24064,12,6996670259
4193,213998859,102908,214101767,1,0,0,37888,6,4615385958
4194,214032840,132822,214165662,2,0,1,210432,4,171927617
4195,214040270,130679,214170949,7,0,1,16896,8,6024005680
4196,214063130,108485,214171615,9,0,1,1024,18,7300376530
4197,214115390,119619,214235009,0,0,0,11776,11,7808297221
4198,214219611,99788,214319399,6,0,0,27648,12,3466331387
4199,214303220,98696,214401916,5,0,0,24064,19,1042439125
4200,214352670,71000,214423670,5,0,0,13824,19,2809087668
4201,214364770,106202,214470972,9,0,0,1024,18,10737055920
4202,214393120,100412,214493532,0,0,0,29696,11,651948667
4203,214398880,116218,214515098,1,0,0,39424,6,5433823926
4204,214413971,130995,214544966,6,0,0,21504,12,4370343339
4205,214556040,68084,214624124,5,0,0,14336,19,2875065777
4206,214637919,3898,214641817,3,0,1,4096,2,8148740808
4207,214638080,4723,214642803,5,0,1,1536,19,8522107284
4208,214683280,71600,214754880,9,0,0,10752,18,7407692633
4209,214723759,145414,214869173,1,0,0,25088,6,4530946160
4210,214730190,24705,214754895,6,0,1,35328,12,10581759075
4211,214842160,7706,214849866,4,0,1,8192,16,2329980232
4212,215010250,88052,215098302,3,0,0,14336,2,611757605
4213,215053900,105404,215159304,3,0,0,46080,2,2436480945
4214,215195660,102128,215297788,8,0,0,35328,12,3067237952
4215,215227099,107432,215334531,7,0,0,52736,8,1874152376
4216,215332830,106785,215439615,4,0,0,45056,16,6839515586
4217,215414589,102102,215516691,1,0,0,23552,6,1711724733
4218,215433430,105497,215538927,3,0,0,26112,2,7511715895
4219,215438600,101590,215540190,4,0,0,4096,16,2202909310
4220,215454480,63162,215517642,4,0,0,3072,16,6406679915
4221,215556870,83756,215640626,3,0,0,15360,2,8830299574
4222,215642901,84512,215727413,6,0,0,12800,12,6876746051
4223,215661370,43904,215705274,2,0,0,512,4,6713243912
4224,215696811,88136,215784947,6,0,0,24064,12,1201649994
4225,215883220,76052,215959272,4,0,0,10240,16,4373789731
4226,215897610,65900,215963510,3,0,0,7168,2,8290795421
4227,216004240,75296,216079536,9,0,0,12800,18,8830206966
4228,216035440,67592,216103032,0,0,0,7680,11,3367090528
4229,216040550,3422,216043972,1,0,1,3584,6,6010826533
4230,216109320,2946,216112266,1,0,1,3072,6,6554622413
4231,216215340,98228,216313568,3,0,0,22528,2,8675483959
4232,216252940,2470,216255410,1,0,1,2560,6,5680216648
4233,216259060,64936,216323996,8,0,0,4096,12,1413705064
4234,216274080,10757,216284837,0,0,1,17408,11,6473284765
4235,216275960,267676,216543636,2,0,0,72192,4,9622427975
4236,216365140,71444,216436584,0,0,0,10240,11,8093910841
4237,216371920,74290,216446210,2,0,0,3584,4,3442320550
4238,216391999,68543,216460542,7,0,0,2048,8,4029432139
4239,216428240,8359,216436599,7,0,1,6656,8,2752491302
4240,216430520,121095,216551615,5,0,0,26112,19,9698594605
4241,216486420,155550,216641970,3,0,0,6656,2,6038792649
4242,216498990,60980,216559970,4,0,0,6144,16,7234242396
4243,216521659,80501,216602160,7,0,0,8192,8,7786694838
4244,216607800,7230,216615030,1,0,1,7680,6,3505185276
4245,216625770,53144,216678914,5,0,0,5632,19,10422747254
4246,216658960,94688,216753648,2,0,0,20992,4,4497625088
4247,216721759,71119,216792878,1,0,0,4096,6,3870414146
4248,216757440,65900,216823340,5,0,0,7168,19,10444210308
4249,216801620,90104,216891724,4,0,0,26112,16,8367328194
4250,216929720,114452,217044172,2,0,0,75776,4,8896268378
4251,216936519,140737,217077256,1,0,0,23040,6,1616946036
4252,217012400,5802,217018202,4,0,1,6144,16,3327970198
4253,217036250,63662,217099912,8,0,0,4096,12,1189737921
4254,217082440,50905,217133345,9,0,0,2048,18,2219765432
4255,217112490,67592,217180082,9,0,0,7680,18,9188086058
4256,217125810,103281,217229091,3,0,0,19456,2,9256388194
4257,217136080,59132,217195212,2,0,0,5120,4,241489330
4258,217173869,130383,217304252,7,0,0,88064,8,2499994081
4259,217192990,116908,217309898,3,0,0,18432,2,7522735752
4260,217216599,87668,217304267,8,0,1,121344,12,6993928718
4261,217316590,242605,217559195,5,0,0,52736,19,5524438445
4262,217402611,101972,217504583,6,0,0,34816,12,10525145763
4263,217523600,2470,217526070,5,0,1,2560,19,4684299942
4264,217527190,52676,217579866,9,0,0,4096,18,4595393880
4265,217578760,82382,217661142,0,0,0,12288,11,2681230056
4266,217635159,7230,217642389,3,0,1,7680,2,9232045138
4267,217666049,101972,217768021,1,0,0,34816,6,9298877976
4268,217698190,50672,217748862,4,0,0,2560,16,5983432726
4269,217712190,179296,217891486,4,0,0,40960,16,5053977743
4270,217718180,98384,217816564,5,0,0,23040,19,9933232023
4271,217738030,98384,217836414,2,0,0,23040,4,3384714071
4272,217749630,42683,217792313,2,0,1,69632,4,10499906019
4273,217860739,159616,218020355,7,0,0,12800,8,8159384912
4274,217880600,163887,218044487,2,0,0,16384,4,1020000188
4275,217936450,47288,217983738,5,0,0,1536,19,3765044399
4276,217952540,21916,217974456,1,0,1,35840,6,8764867479
4277,218001430,5326,218006756,2,0,1,5632,4,6324197870
4278,218044851,86414,218131265,6,0,0,7168,12,1522682856
4279,218129679,75182,218204861,1,0,0,12288,6,2220427065
4280,218147200,113987,218261187,2,0,1,188416,4,9735775182
4281,218265510,6488,218271998,9,0,1,15872,18,6708677693
4282,218327800,143307,218471107,9,0,0,17408,18,7436886366
4283,218340970,72291,218413261,0,0,0,5120,11,6564792069
4284,218520670,86828,218607498,4,0,0,15360,16,1261169468
4285,218535719,78109,218613828,1,0,0,14848,6,2796919503
4286,218546900,168124,218715024,9,0,0,140288,18,721108781
4287,218628950,128218,218757168,5,0,0,39424,19,4820585551
4288,218657060,116860,218773920,4,0,0,8704,16,2558501474
4289,218721480,53391,218774871,3,0,0,3072,2,7669328704
4290,218785249,90056,218875305,7,0,0,15872,8,2719296067
4291,218801390,79231,218880621,5,0,0,3072,19,8737363779
4292,218803420,99164,218902584,0,0,0,25600,11,3408825976
4293,218849970,123424,218973394,2,0,1,200192,4,2300042113
4294,218918859,193785,219112644,1,0,0,47104,6,5597577067
4295,218928510,47150,218975660,5,0,1,3584,19,10547167009
4296,218956910,115450,219072360,2,0,0,5632,4,255060463
4297,218995481,204137,219199618,6,0,0,13312,12,4690534801
4298,219170620,99008,219269628,8,0,0,25088,12,1282872
4299,219227439,141765,219369204,7,0,0,52224,8,1453653519
4300,219250780,5802,219256582,7,0,1,6144,8,8730140975
4301,219330269,50828,219381097,7,0,0,3072,8,1429136635
4302,219364860,89808,219454668,0,0,0,20992,11,3568900110
4303,219406159,123875,219530034,7,0,0,35328,8,2442898603
4304,219421620,45596,219467216,0,0,0,1024,11,2838425670
4305,219451000,218985,219669985,0,0,1,349184,11,10615188839
4306,219574130,243203,219817333,0,0,0,22528,11,72373647
4307,219576790,161040,219737830,3,0,0,10752,2,8231080070
4308,219595829,113237,219709066,7,0,0,2048,8,6699430350
4309,219607110,63951,219671061,4,0,1,13312,16,10649531698
4310,219651470,314806,219966276,3,0,0,93184,2,4004741592
4311,219654020,212751,219866771,2,0,0,38400,4,5556750100
4312,219673041,264828,219937869,6,0,0,34304,12,7045867960
4313,219673970,177113,219851083,0,0,0,6144,11,6991858830
4314,219696240,1994,219698234,1,0,1,2048,6,10328567462
4315,219726119,246271,219972390,7,0,0,4096,8,6825483828
4316,219728379,149795,219878174,1,0,0,37376,6,7553407504
4317,219741750,229377,219971127,5,0,0,15872,19,404600230
4318,219782410,6278,219788688,9,0,1,6656,18,7451561205
4319,219941870,87952,220029822,0,0,0,4608,11,2611238412
4320,219999431,84668,220084099,6,0,0,13312,12,4809394789
4321,220095751,97916,220193667,6,0,0,21504,12,7740722840
4322,220107090,56684,220163774,4,0,0,7168,16,3123602743
4323,220148670,57440,220206110,5,0,0,4608,19,8960381009
4324,220152369,78168,220230537,7,0,0,15360,8,6884779185
4325,220311360,98696,220410056,2,0,0,24064,4,4445354587
4326,220373261,47288,220420549,6,0,0,1536,12,2988739717
4327,220407620,95400,220503020,3,0,0,15360,2,6654969566
4328,220452301,55748,220508049,6,0,0,4096,12,1055218806
4329,220568560,107588,220676148,2,0,0,53248,4,8117583464
4330,220628650,566,220629216,5,0,1,512,19,2213390217
4331,220631040,79650,220710690,8,0,0,9216,12,4851171459
4332,220654050,106964,220761014,8,0,0,51200,12,6439952086
4333,220654209,175067,220829276,7,0,0,57344,8,3094198751
4334,220664690,18680,220683370,2,0,1,7680,4,6516421100
4335,220734330,164024,220898354,5,0,0,40960,19,185127783
4336,220848240,98114,220946354,5,0,0,9728,19,5650932712
4337,220902280,82660,220984940,0,0,0,9216,11,3941704056
4338,220905380,85448,220990828,0,0,0,15872,11,2521352857
4339,220915280,110718,221025998,9,0,0,11776,18,6554508733
4340,220920710,43904,220964614,0,0,0,512,11,4014400458
4341,221102579,83288,221185867,1,0,0,13824,6,5665146246
4342,221108781,113828,221222609,6,0,0,73728,12,4677194396
4343,221221080,72497,221293577,4,0,0,8704,16,4186825119
4344,221252390,98852,221351242,5,0,0,24576,19,8884837933
4345,221282410,5196,221287606,4,0,1,13312,16,4159063596
4346,221304211,136954,221441165,6,0,0,85504,12,1404803399
4347,221325870,7706,221333576,1,0,1,8192,6,441392054
4348,221431000,112039,221543039,2,0,1,164864,4,629512765
4349,221448990,194673,221643663,9,0,0,26112,18,727477516
4350,221452080,180602,221632682,2,0,0,21504,4,421670245
4351,221549370,104683,221654053,4,0,0,9728,16,6993651853
4352,221602950,122388,221725338,5,0,0,6144,19,1314055207
4353,221717470,87068,221804538,0,0,0,11776,11,5100675111
4354,221727660,11274,221738934,1,0,1,18432,6,4907150792
4355,221778790,60380,221839170,3,0,0,9216,2,3487212375
4356,221825939,181583,222007522,1,0,0,7168,6,7058825341
4357,221851850,92996,221944846,9,0,0,20480,18,10467982942
4358,221870921,79529,221950450,6,0,0,3584,12,2700354672
4359,221902249,85953,221988202,7,0,0,14336,8,2769704823
4360,221984580,102466,222087046,2,0,0,24576,4,785749497
4361,221996880,47288,222044168,8,0,0,1536,12,3327094903
4362,222023370,81308,222104678,4,0,0,17408,16,10461039525
4363,222035430,138524,222173954,4,0,0,83456,16,6646524988
4364,222093550,140947,222234497,0,0,0,3072,11,7941562147
4365,222095680,137866,222233546,9,0,0,50688,18,7766855160
4366,222128680,1042,222129722,4,0,1,1024,16,3732948934
4367,222310789,69908,222380697,1,0,0,10240,6,5503633582
4368,222316621,87608,222404229,6,0,0,17920,12,4988337220
4369,222381750,64208,222445958,0,0,0,6656,11,9735639498
4370,222416670,113882,222530552,0,0,0,56320,11,101675890
4371,222463020,45596,222508616,2,0,0,1024,4,9013068097
4372,222498030,114314,222612344,9,0,0,25088,18,6201074388
4373,222522930,80282,222603212,8,0,0,9216,12,730922534
4374,222586250,47288,222633538,5,0,0,1536,19,4020921375
4375,222628090,98228,222726318,5,0,0,22528,19,5606953277
4376,222651800,50672,222702472,5,0,0,2560,19,297778202
4377,222695740,110864,222806604,9,0,0,64000,18,6796545656
4378,222703159,122417,222825576,7,0,0,15360,8,5629374174
4379,222812800,89636,222902436,0,0,0,24576,11,718509962
4380,222819850,7230,222827080,4,0,1,7680,16,4889681610
4381,222827239,57596,222884835,1,0,0,5120,6,4588687133
4382,222914090,113672,223027762,0,0,0,73216,11,3220927461
4383,222946520,130634,223077154,3,0,0,11264,2,2940483450
4384,223038440,121724,223160164,4,0,0,50688,16,1377601568
4385,223089731,166410,223256141,6,0,0,39424,12,1562065291
4386,223095600,12995,223108595,9,0,1,25088,18,5380483220
4387,223268169,1518,223269687,3,0,1,1536,2,502056162
4388,223275489,33075,223308564,8,0,1,54272,12,6600348916
4389,223391900,100880,223492780,2,0,0,31232,4,4528518394
4390,223441560,64483,223506043,6,0,1,105472,12,6903044258
4391,223519700,171882,223691582,0,0,0,512,11,9081989562
4392,223547710,60824,223608534,4,0,0,5632,16,4057911936
4393,223612350,108524,223720874,4,0,0,56320,16,4772170919
4394,223661989,114229,223776218,7,0,0,18944,8,10102736290
4395,223665730,1042,223666772,4,0,1,1024,16,6480916468
4396,223691450,4286,223695736,4,0,1,11264,16,2715123228
4397,223716820,110179,223826999,4,0,0,36352,16,7981336067
4398,223750430,12566,223762996,2,0,1,20992,4,9396067143
4399,223814930,95683,223910613,8,0,0,6656,12,4672316496
4400,223848649,136106,223984755,7,0,0,22016,8,7894657330
4401,223878560,59132,223937692,5,0,0,5120,19,6772643940
4402,224185320,100378,224285698,2,0,0,23552,4,2582929682
4403,224190230,166650,224356880,5,0,0,101888,19,10055052298
4404,224215060,144331,224359391,2,0,0,8192,4,7769917855
4405,224309511,91429,224400940,6,0,0,10240,12,1397560522
4406,224361780,61270,224423050,3,0,0,1024,2,9588652950
4407,224391640,121004,224512644,3,0,0,97280,2,203688912
4408,224421101,109129,224530230,6,0,0,7680,12,1097560110
4409,224429539,83900,224513439,7,0,0,2560,8,674677571
4410,224441610,5802,224447412,6,0,1,6144,12,9425830730
4411,224511090,101349,224612439,2,0,0,25088,4,3308837422
4412,224712250,65924,224778174,4,0,0,12288,16,2445702324
4413,224722470,566,224723036,7,0,1,512,8,6100779044
4414,224751390,89400,224840790,4,0,0,18944,16,4021384869
4415,224760420,57858,224818278,3,0,0,512,2,3861921534
4416,224795130,111693,224906823,2,0,0,3584,4,4344076077
4417,224819470,4679,224824149,7,0,1,12288,8,6982977834
4418,224819680,5135,224824815,5,0,1,1024,19,5920339629
4419,224853769,207678,225061447,1,0,0,56832,6,5401167848
4420,224897900,43904,224941804,3,0,0,512,2,5986911032
4421,224952780,2870,224955650,6,0,1,8704,12,9723936759
4422,224953230,189127,225142357,3,0,0,8704,2,6126106921
4423,224958000,164953,225122953,3,0,0,30720,2,8419628288
4424,224968169,230762,225198931,1,0,0,11776,6,10213755681
4425,225005620,3422,225009042,4,0,1,3584,16,3359241826
4426,225071290,60824,225132114,3,0,0,5632,2,3294498320
4427,225091529,134237,225225766,8,0,1,221184,12,5866348279
4428,225107829,313817,225421646,1,0,0,71680,6,4511119232
4429,225173389,83877,225257266,1,0,0,1536,6,616208590
4430,225398859,236729,225635588,8,0,1,386560,12,7608919428
4431,225419100,302151,225721251,0,0,0,10240,11,2279691830
4432,225479600,297062,225776662,0,0,0,30720,11,10489659293
4433,225481139,154434,225635573,1,0,0,2560,6,8589525900
4434,225491800,173524,225665324,9,0,0,25600,18,8361412632
4435,225569100,153570,225722670,2,0,0,4608,4,4070524865
4436,225592170,329624,225921794,3,0,0,10240,2,1894240577
4437,225660299,8404,225668703,3,0,1,9728,2,240618464
4438,225675330,76884,225752214,3,0,0,6656,2,136052361
4439,225691209,1994,225693203,3,0,1,2048,2,9094613165
4440,225855840,50828,225906668,3,0,0,3072,2,2176616990
4441,225905980,105928,226011908,0,0,0,45568,11,9960929057
4442,225914061,179442,226093503,6,0,0,56832,12,9160029020
4443,225974680,226833,226201513,5,0,0,21504,19,4232065111
4444,225987040,4937,225991977,1,0,1,12800,6,2642657102
4445,226058729,54836,226113565,7,0,0,6144,8,4522390425
4446,226061930,73451,226135381,9,0,0,7168,18,2045307816
4447,226133221,98262,226231483,6,0,0,17920,12,10072981749
4448,226211900,1994,226213894,4,0,1,2048,16,6518338027
4449,226257340,95468,226352808,9,0,0,23552,18,3664137231
4450,226279361,128581,226407942,6,0,0,47104,12,7705153226
4451,226312451,200150,226512601,6,0,0,40448,12,7500133062
4452,226313329,31007,226344336,8,0,1,50176,12,2184284121
4453,226369930,166996,226536926,8,0,0,7680,12,9251213277
4454,226547720,6229,226553949,4,0,1,15360,16,6418756870
4455,226585221,117994,226703215,6,0,0,47616,12,7893654275
4456,226614010,105807,226719817,0,0,0,10240,11,6925226478
4457,226618780,31524,226650304,9,0,1,51200,18,350775572
4458,226736560,58844,226795404,0,0,0,9216,11,2165794262
4459,226757250,180186,226937436,4,0,0,15872,16,10026693177
4460,226774141,185539,226959680,6,0,0,60416,12,2511173051
4461,226807730,47288,226855018,4,0,0,1536,16,7835733588
4462,226819420,4679,226824099,9,0,1,12288,18,3430991256
4463,226825910,2946,226828856,2,0,1,3072,4,940134691
4464,226841260,566,226841826,9,0,1,512,18,3301485567
4465,226855130,76505,226931635,2,0,0,4608,4,7266151157
4466,226944570,17096,226961666,9,0,1,2048,18,4733575718
4467,226973010,190408,227163418,5,0,0,19968,19,3573577249
4468,227015320,2870,227018190,4,0,1,8704,16,557124897
4469,227019890,97136,227117026,9,0,0,18944,18,99828512
4470,227073650,66236,227139886,8,0,0,13312,12,9945674351
4471,227074260,99788,227174048,3,0,0,27648,2,9536311732
4472,227131611,132053,227263664,6,0,0,27136,12,2824913833
4473,227233200,2946,227236146,5,0,1,3072,19,3772984216
4474,227242290,6229,227248519,2,0,1,15360,4,6934866455
4475,227298880,216005,227514885,9,0,0,57344,18,5174584628
4476,227316400,244607,227561007,5,0,0,26112,19,5436736135
4477,227321820,67592,227389412,8,0,0,7680,12,6981219329
4478,227397070,54056,227451126,4,0,0,3584,16,9338443792
4479,227521450,95312,227616762,4,0,0,23040,16,3714592097
4480,227681500,121628,227803128,0,0,0,99328,11,8298652715
4481,227707420,110984,227818404,2,0,0,1024,4,4642501605
4482,227726309,5326,227731635,3,0,1,5632,2,4485380876
4483,227754109,153799,227907908,8,0,1,249344,12,336470169
4484,227769890,138582,227908472,1,0,1,10752,6,2003458220
4485,227802470,165028,227967498,0,0,0,13824,11,1624683649
4486,227848709,92149,227940858,8,0,1,114176,12,1693257724
4487,227890889,51595,227942484,3,0,1,2560,2,162525252
4488,227925750,264584,228190334,3,0,0,7680,2,5062828122
4489,227960180,152253,228112433,9,0,0,12800,18,4197466036
4490,227989861,186269,228176130,6,0,0,24064,12,3321725024
4491,228082120,105859,228187979,2,0,0,32768,4,5098407331
4492,228093560,101157,228194717,2,0,0,14336,4,1035292201
4493,228210129,105560,228315689,7,0,0,46592,8,3420459172
4494,228215260,171577,228386837,4,0,0,118784,16,8358627675
4495,228428100,48980,228477080,9,0,0,2048,18,1382920642
4496,228432970,80240,228513210,4,0,0,18944,16,5557159017
4497,228460540,101660,228562200,2,0,0,33792,4,7156079113
4498,228512420,125638,228638058,0,0,0,54784,11,1520791794
4499,228602379,50984,228653363,1,0,0,3584,6,6609388184
4500,228673120,91280,228764400,9,0,0,14848,18,9373589020
4501,228728260,47288,228775548,4,0,0,1536,16,9385916110
4502,228745150,94376,228839526,9,0,0,19968,18,10077910642
4503,228762960,84720,228847680,8,0,0,13824,12,9076216740
4504,228919590,12825,228932415,2,0,1,21504,4,7972187798
4505,228942689,86852,229029541,7,0,0,20480,8,3432838224
4506,228974200,93723,229067923,4,0,0,9216,16,1747656307
4507,228996999,6229,229003228,8,0,1,15360,12,7366883073
4508,229003590,99476,229103066,8,0,0,26624,12,10392583067
4509,229006440,106001,229112441,2,0,0,30720,4,2881196786
4510,229029650,4850,229034500,9,0,1,5120,18,251777866
4511,229083450,106647,229190097,0,0,0,2048,11,304638248
4512,229121880,76520,229198400,2,0,0,11776,4,9294493145
4513,229153650,107120,229260770,0,0,0,51712,11,2741147388
4514,229188050,10365,229198415,5,0,1,8192,19,4636599598
4515,229212300,2870,229215170,7,0,1,8704,8,4562006516
4516,229253830,55912,229309742,2,0,0,2048,4,992715048
4517,229282580,174815,229457395,0,0,0,35328,11,5537987082
4518,229335299,103023,229438322,1,0,0,23552,6,1717265159
4519,229416410,62072,229478482,3,0,0,9728,2,5711764275
4520,229417810,2470,229420280,2,0,1,2560,4,9242656846
4521,229478871,59156,229538027,6,0,0,5120,12,10236065744
4522,229528820,123759,229652579,5,0,0,81408,19,3619279295
4523,229531370,96189,229627559,9,0,0,19456,18,2121287285
4524,229580519,111852,229692371,1,0,0,3072,6,431011718
4525,229593410,130347,229723757,0,0,0,87040,11,881568403
4526,229757170,114764,229871934,2,0,0,76800,4,9450681614
4527,229785790,159356,229945146,2,0,0,17408,4,9822239004
4528,229862229,56985,229919214,7,0,0,1536,8,5580299285
4529,229903280,1994,229905274,6,0,1,2048,12,4205530467
4530,229975039,5712,229980751,3,0,1,14336,2,271367881
4531,230061560,2946,230064506,9,0,1,3072,18,2755741257
4532,230109609,103064,230212673,1,0,0,38400,6,2447276370
4533,230114880,99056,230213936,9,0,0,4096,18,5722243961
4534,230157770,566,230158336,6,0,1,512,12,5814523360
4535,230175260,15837,230191097,2,0,1,30720,4,1639560023
4536,230184659,177594,230362253,7,0,0,39424,8,4153747703
4537,230276289,163729,230440018,1,0,0,14336,6,6429508102
4538,230351761,94041,230445802,6,0,0,3072,12,9538497046
4539,230434400,56596,230490996,0,0,1,96768,11,7019703090
4540,230478220,16962,230495182,4,0,1,6656,16,8587443151
4541,230480240,307239,230787479,8,0,0,73728,12,108917833
4542,230596740,137675,230734415,3,0,0,25600,2,9322835643
4543,230637390,108491,230745881,0,0,0,6656,11,6341313260
4544,230816299,107588,230923887,7,0,0,53248,8,1066298011
4545,230858220,81128,230939348,8,0,0,11776,12,8756362787
4546,230863711,123332,230987043,6,0,0,9728,12,10329604919
4547,230906810,17092,230923902,1,0,1,7168,6,9697076509
4548,230970900,106028,231076928,0,0,0,48128,11,704868479
4549,230999420,48980,231048400,3,0,0,2048,2,1928337743
4550,231024951,137663,231162614,6,0,0,101376,12,262129936
4551,231052439,24504,231076943,8,0,1,28160,12,5572420070
4552,231090320,127382,231217702,4,0,0,20480,16,6514138941
4553,231176690,100724,231277414,9,0,0,30720,18,53373168
4554,231177570,135028,231312598,4,0,0,32256,16,8883206256
4555,231213300,113980,231327280,0,0,0,11776,11,4438685446
4556,231264190,1518,231265708,6,0,1,1536,12,8621758846
4557,231265220,65900,231331120,0,0,0,7168,11,5071814570
4558,231352349,1994,231354343,3,0,1,2048,2,3537802407
4559,231356430,3422,231359852,4,0,1,3584,16,9290590283
4560,231387630,60824,231448454,5,0,0,5632,19,5535509535
4561,231420440,7230,231427670,4,0,1,7680,16,4436761648
4562,231493070,88988,231582058,2,0,0,17408,4,2986475448
4563,231533490,1518,231535008,1,0,1,1536,6,3671214475
4564,231615330,6278,231621608,9,0,1,6656,18,3661183725
4565,231637950,72262,231710212,0,0,0,13824,11,10157139440
4566,231665050,5326,231670376,1,0,1,5632,6,446682126
4567,231724120,96245,231820365,0,0,0,5632,11,5587090892
4568,231736990,99008,231835998,0,0,0,25088,11,3602918482
4569,231744030,47288,231791318,4,0,0,1536,16,2876989451
4570,231775731,172947,231948678,6,0,0,29696,12,8481097653
4571,231779480,139858,231919338,8,0,0,94720,12,3428656519
4572,231805649,6754,231812403,3,0,1,7168,2,10540242089
4573,231967420,146041,232113461,3,0,0,68608,2,10615799913
4574,232017980,7230,232025210,1,0,1,7680,6,2684333671
4575,232033120,2870,232035990,6,0,1,8704,12,2101657366
4576,232038550,156673,232195223,8,0,0,103936,12,1355103064
4577,232080780,121271,232202051,0,0,0,20480,11,3201171850
4578,232107320,134193,232241513,2,0,0,43008,4,3809202472
4579,232256679,5802,232262481,3,0,1,6144,2,3489225387
4580,232333880,43904,232377784,5,0,0,512,19,8045455907
4581,232337170,101006,232438176,5,0,0,5632,19,3608544947
4582,232371710,68821,232440531,2,0,0,7680,4,10512274305
4583,232414699,60824,232475523,7,0,0,5632,8,8140206429
4584,232429839,67748,232497587,7,0,0,8192,8,8647044027
4585,232437990,66741,232504731,3,0,0,6656,2,3420549006
4586,232483190,65946,232549136,0,0,1,111616,11,9054039212
4587,232664009,3898,232667907,8,0,1,4096,12,8355076127
4588,232698329,101999,232800328,1,0,0,30208,6,9587818102
4589,232701700,61899,232763599,0,0,1,100352,11,8206963146
4590,232744320,147421,232891741,4,0,0,19456,16,8453944447
4591,232759609,104102,232863711,7,0,0,8192,8,4676671800
4592,232761300,173875,232935175,8,0,0,4608,12,8040630653
4593,232771979,132806,232904785,7,0,0,16896,8,1491943784
4594,232945310,62540,233007850,4,0,0,11264,16,5073181075
4595,232961310,4850,232966160,5,0,1,5120,19,848789222
4596,232980630,102752,233083382,5,0,0,37376,19,4402400267
4597,233012650,3422,233016072,6,0,1,3584,12,9342094305
4598,233124770,54056,233178826,2,0,0,3584,4,6847564977
4599,233126730,11533,233138263,6,0,1,18944,12,5067022834
4600,233211801,265637,233477438,6,0,0,19456,12,8928184651
4601,233268870,108524,233377394,9,0,0,56320,18,1810780473
4602,233284481,169227,233453708,6,0,0,61440,12,886230238
4603,233294549,111758,233406307,7,0,0,3072,8,5808994292
4604,233309820,240080,233549900,3,0,0,22016,2,7260760089
4605,233313530,100026,233413556,5,0,0,15360,19,9671190157
4606,233377170,77645,233454815,5,0,0,3584,19,7498319426
4607,233377660,131443,233509103,2,0,0,74752,4,2192216473
4608,233384050,3128,233387178,4,0,1,9216,16,3558385573
4609,233477080,89938,233567018,5,0,0,14336,19,403409924
4610,233600310,4850,233605160,2,0,1,5120,4,7369193006
4611,233654730,52364,233707094,2,0,0,3072,4,1252955086
4612,233729530,3422,233732952,9,0,1,3584,18,7741684676
4613,233761450,74360,233835810,0,0,0,9728,11,8402402334
4614,233866740,56216,233922956,3,0,0,5632,2,9670167097
4615,233868270,104468,233972738,3,0,0,43008,2,2914752173
4616,233900900,2946,233903846,9,0,1,3072,18,2674191814
4617,233958510,199663,234158173,8,0,0,64000,12,7434107750
4618,234033120,1518,234034638,4,0,1,1536,16,5207852233
4619,234055820,74540,234130360,3,0,0,15360,2,2190480179
4620,234059820,4937,234064757,9,0,1,12800,18,9066214813
4621,234109350,127294,234236644,5,0,0,64512,19,6643317009
4622,234119420,57440,234176860,8,0,0,4608,12,6123289844
4623,234183940,4374,234188314,9,0,1,4608,18,7222094928
4624,234314379,110708,234425087,1,0,0,63488,6,6604977031
4625,234365691,74678,234440369,6,0,0,6656,12,2654129114
4626,234389870,71565,234461435,2,0,0,4096,4,8940562566
4627,234422770,69901,234492671,8,0,0,7680,12,2450307013
4628,234491529,76946,234568475,8,0,1,127488,12,7033959024
4629,234505931,169341,234675272,6,0,0,24576,12,3702228610
4630,234516700,131920,234648620,5,0,0,7680,19,5281335107
4631,234611529,103061,234714590,7,0,0,16384,8,7679263909
4632,234664230,144944,234809174,5,0,0,27136,19,7865124955
4633,234688400,91172,234779572,4,0,0,24576,16,10594483686
4634,234735599,144753,234880352,7,0,0,32768,8,1928704070
4635,234761980,76440,234838420,3,0,0,13824,2,5174482070
4636,234788970,129445,234918415,3,0,0,30720,2,7694005546
4637,234921670,101036,235022706,8,0,0,31744,12,5294338544
4638,234933060,6488,234939548,6,0,1,15872,12,6986347360
4639,234977120,136738,235113858,0,0,0,31232,11,6945687313
4640,235018950,105876,235124826,8,0,0,35328,12,8342164137
4641,235049650,3128,235052778,4,0,1,9216,16,710807763
4642,235155960,45179,235201139,0,0,1,77824,11,6050231873
4643,235207400,3387,235210787,2,0,1,9728,4,2494571859
4644,235208990,5321,235214311,9,0,1,4096,18,1152421170
4645,235243050,105689,235348739,5,0,0,40960,19,5129052774
4646,235337080,16025,235353105,2,0,1,4608,4,1459748244
4647,235350400,13253,235363653,6,0,1,25600,12,704133711
4648,235496850,74516,235571366,0,0,0,10240,11,1199600205
4649,235509219,102752,235611971,7,0,0,37376,8,8214017969
4650,235520630,103641,235624271,0,0,0,7168,11,7294904259
4651,235535829,131948,235667777,7,0,0,7680,8,1778211792
4652,235567579,54056,235621635,7,0,0,3584,8,10189794913
4653,235633620,69827,235703447,5,0,0,7680,19,3425727190
4654,235669930,55748,235725678,3,0,0,4096,2,10042178067
4655,235684470,100100,235784570,0,0,0,28672,11,984007198
4656,235800510,92552,235893062,5,0,0,24064,19,5317007115
4657,235829610,85773,235915383,0,0,0,2048,11,7830727813
4658,235839949,69908,235909857,7,0,0,10240,8,8041962904
4659,235876450,104312,235980762,3,0,0,42496,2,10220944618
4660,235912619,2779,235915398,3,0,1,2560,2,7724189410
4661,235950580,70976,236021556,3,0,0,8704,2,8022917379
4662,235986120,44334,236030454,5,0,0,512,19,4754487353
4663,236006860,107905,236114765,2,0,0,35840,4,7016588010
4664,236066470,67304,236133774,2,0,0,11776,4,545190263
4665,236084289,98072,236182361,1,0,0,22016,6,9750892373
4666,236108910,75575,236184485,2,0,0,1536,4,8177043974
4667,236112970,122245,236235215,2,0,0,17920,4,3394609482
4668,236184410,116121,236300531,0,0,1,192512,11,4847587737
4669,236185410,202688,236388098,4,0,0,18432,16,7991077655
4670,236379830,106288,236486118,0,0,0,22016,11,4859234913
4671,236465760,108212,236573972,4,0,0,55296,16,3668000106
4672,236495900,6278,236502178,1,0,1,6656,6,442064469
4673,236643900,1518,236645418,9,0,1,1536,18,9404043859
4674,236651210,5802,236657012,5,0,1,6144,19,414721958
4675,236662230,3422,236665652,0,0,1,3584,11,2360136644
4676,236813780,1994,236815774,5,0,1,2048,19,959769790
4677,236864780,112424,236977204,4,0,0,69120,16,8661327526
4678,236874610,145236,237019846,4,0,0,16384,16,2480497670
4679,236911540,113313,237024853,8,0,0,16384,12,10156054483
4680,236921011,104013,237025024,6,0,0,512,12,3226511080
4681,236988159,52364,237040523,7,0,0,3072,8,7486302611
4682,237025800,1994,237027794,5,0,1,2048,19,9316690709
4683,237040690,97448,237138138,4,0,0,19968,16,4381035965
4684,237066680,109372,237176052,0,0,0,7168,11,8193621446
4685,237132060,111162,237243222,0,0,0,45056,11,4242020876
4686,237159030,59298,237218328,5,0,0,2560,19,4928552820
4687,237288379,70976,237359355,7,0,0,8704,8,7865619520
4688,237306219,53841,237360060,8,0,1,88064,12,9187803313
4689,237347820,119030,237466850,5,0,0,17920,19,68111754
4690,237398110,3422,237401532,6,0,1,3584,12,2035814977
4691,237409170,233155,237642325,3,0,0,61952,2,4829811927
4692,237413789,56079,237469868,8,0,1,95744,12,4248277623
4693,237457590,90532,237548122,9,0,0,13824,18,10065625701
4694,237476040,232355,237708395,3,0,0,25088,2,774836392
4695,237523549,280438,237803987,7,0,0,36352,8,9750955180
4696,237531359,51774,237583133,8,0,1,83968,12,1108906055
4697,237567270,174722,237741992,4,0,0,38912,16,9540870926
4698,237707500,58327,237765827,9,0,0,4608,18,10582179600
4699,237710680,169980,237880660,8,0,0,29184,12,8734051564
4700,237813370,113690,237927060,2,0,0,18432,4,9143575216
4701,237826020,55591,237881611,8,0,0,3072,12,5412041493
4702,237886780,4679,237891459,5,0,1,12288,19,194484036
4703,237900100,69380,237969480,0,0,0,9216,11,1171639282
4704,237910750,111869,238022619,2,0,0,16384,4,5189805562
4705,237913670,103942,238017612,9,0,0,20992,18,7319899507
4706,238036940,99632,238136572,5,0,0,27136,19,5964804571
4707,238060280,154178,238214458,9,0,0,54784,18,6635154397
4708,238068089,71314,238139403,7,0,0,9216,8,10714709076
4709,238108830,110947,238219777,8,0,0,17408,12,1093972262
4710,238129380,13905,238143285,0,0,1,4096,11,1120989823
4711,238136000,148559,238284559,4,0,0,5632,16,8241197272
4712,238158619,124209,238282828,7,0,0,51200,8,1193648082
4713,238254800,56732,238311532,5,0,0,1024,19,6137315658
4714,238330209,49136,238379345,7,0,0,2560,8,6348494652
4715,238349019,3422,238352441,3,0,1,3584,2,8310164986
4716,238359831,45596,238405427,6,0,0,1024,12,10339543766
4717,238500410,14287,238514697,4,0,1,27648,16,8064659687
4718,238538130,52364,238590494,2,0,0,3072,4,8900194626
4719,238554910,174445,238729355,3,0,0,13824,2,9470514400
4720,238556880,85837,238642717,5,0,0,6144,19,741911750
4721,238630711,151391,238782102,6,0,0,8192,12,3059337694
4722,238634519,2470,238636989,3,0,1,2560,2,8419949810
4723,238666790,69284,238736074,0,0,0,8192,11,6889412938
4724,238696650,3422,238700072,9,0,1,3584,18,10477309937
4725,238712499,2946,238715445,3,0,1,3072,2,2438840393
4726,238751510,4850,238756360,4,0,1,5120,16,1223743361
4727,238772990,71912,238844902,4,0,0,11776,16,3587566169
4728,238823860,566,238824426,2,0,1,512,4,1199277868
4729,238832890,14804,238847694,4,0,1,28672,16,5942637972
4730,238867800,566,238868366,4,0,1,512,16,5482594027
4731,238985291,161756,239147047,6,0,0,140288,12,7058391647
4732,239113320,148483,239261803,0,0,0,76800,11,10354792532
4733,239169420,129019,239298439,4,0,0,13312,16,333387586
4734,239189290,1994,239191284,0,0,1,2048,11,9882095354
4735,239303170,11274,239314444,2,0,1,18432,4,1452406516
4736,239312640,2470,239315110,0,0,1,1024,11,594104678
4737,239370261,136894,239507155,6,0,0,74240,12,2682311940
4738,239377210,131832,239509042,5,0,0,6144,19,2649386882
4739,239397700,2470,239400170,9,0,1,2560,18,9103609260
4740,239486650,86616,239573266,0,0,0,11776,11,5592726963
4741,239486910,122249,239609159,8,0,0,28672,12,4308628786
4742,239495270,24830,239520100,9,0,1,17920,18,10117892836
4743,239548880,75595,239624475,2,0,0,8192,4,5218583842
4744,239618450,103220,239721670,0,0,0,38912,11,2188798468
4745,239663141,128147,239791288,6,0,0,39424,12,10644219376
4746,239738290,104819,239843109,8,0,0,33792,12,5140405203
4747,239746390,86408,239832798,9,0,0,24064,18,6366195589
4748,239760079,198017,239958096,1,0,0,32256,6,792530388
4749,239770260,145236,239915496,8,0,0,53760,12,6172247990
4750,239882180,157858,240040038,4,0,0,73216,16,242937745
4751,239917220,12566,239929786,6,0,1,20992,12,7298612774
4752,240089351,97292,240186643,6,0,0,19456,12,8854328538
4753,240099150,1994,240101144,2,0,1,2048,4,215404149
4754,240103590,133609,240237199,9,0,0,24064,18,9407737307
4755,240131200,195941,240327141,9,0,0,25088,18,5788645270
4756,240201170,1994,240203164,9,0,1,2048,18,6312380926
4757,240213400,5712,240219112,7,0,1,14336,8,3553794296
4758,240239071,89801,240328872,6,0,0,5632,12,9238606009
4759,240260600,127449,240388049,0,0,0,36352,11,8036028185
4760,240270229,32041,240302270,8,0,1,52224,12,8461118613
4761,240284370,18246,240302616,5,0,1,512,19,1640942941
4762,240287270,16652,240303922,4,0,1,2048,16,3541709373
4763,240293170,73139,240366309,5,0,0,10240,19,9521014967
4764,240293891,139704,240433595,6,0,0,28672,12,7169581872
4765,240553899,64676,240618575,7,0,0,8192,8,1904505267
4766,240557260,94220,240651480,0,0,0,19456,11,3865167169
4767,240672610,54056,240726666,4,0,0,3584,16,10666982570
4768,240760520,4374,240764894,7,0,1,4608,8,702410308
4769,240805791,84980,240890771,6,0,0,14336,12,8829642617
4770,240828810,141251,240970061,8,0,0,46592,12,8771646318
4771,240845540,47288,240892828,8,0,0,1536,12,522692435
4772,240863550,54056,240917606,9,0,0,3584,18,9955905311
4773,240969050,14603,240983653,0,0,1,23040,11,3760510249
4774,240978669,5970,240984639,3,0,1,1536,2,4781639981
4775,241009730,132442,241142172,3,0,0,30208,2,10494553739
4776,241013989,52549,241066538,8,0,1,85504,12,6810641071
4777,241044359,251231,241295590,1,0,0,48128,6,5600288145
4778,241056960,119430,241176390,0,0,0,15360,11,5079821196
4779,241072470,3904,241076374,6,0,1,10752,12,573786748
4780,241089579,218210,241307789,7,0,0,39936,8,1717414675
4781,241145000,5326,241150326,7,0,1,5632,8,1716060260
4782,241197009,136591,241333600,1,0,0,55808,6,7978919234
4783,241211790,1994,241213784,2,0,1,2048,4,2351128667
4784,241212540,5802,241218342,9,0,1,6144,18,2184817090
4785,241281600,92423,241374023,0,0,0,9728,11,7717325031
4786,241285880,72003,241357883,0,0,0,7168,11,2481172666
4787,241388891,113516,241502407,6,0,0,72704,12,1762442859
4788,241405510,97068,241502578,4,0,0,512,16,2779296464
4789,241448160,3898,241452058,9,0,1,4096,18,5941073710
4790,241449870,4679,241454549,1,0,1,12288,6,9458618374
4791,241514650,100724,241615374,8,0,0,30720,12,9030548337
4792,241555490,3898,241559388,9,0,1,4096,18,7340997685
4793,241562080,153806,241715886,3,0,0,60928,2,1962155911
4794,241640961,81128,241722089,6,0,0,11776,12,561648992
4795,241666860,79536,241746396,3,0,0,3072,2,3971582106
4796,241669329,91539,241760868,7,0,0,15872,8,6500650436
4797,241710069,54951,241765020,7,0,0,2048,8,1118090145
4798,241832180,55748,241887928,0,0,0,4096,11,6430200765
4799,241878100,77300,241955400,9,0,0,14336,18,10373233863
4800,241906910,56837,241963747,2,0,0,2560,4,3288787478
4801,241908101,54056,241962157,6,0,0,3584,12,10521456741
4802,241919480,3898,241923378,2,0,1,4096,4,1741309952
4803,241921869,60824,241982693,7,0,0,5632,8,6537336992
4804,241923611,90918,242014529,6,0,0,14336,12,6236613524
4805,241970310,3128,241973438,0,0,1,9216,11,5751836259
4806,242010739,68302,242079041,7,0,0,7680,8,8936742799
4807,242083930,99944,242183874,2,0,0,28160,4,1538979583
4808,242093710,71468,242165178,0,0,0,15360,11,8268278734
4809,242110559,73486,242184045,1,0,0,512,6,7510595638
4810,242205150,112007,242317157,2,0,1,181248,4,2602994722
4811,242215001,286954,242501955,6,0,0,17408,12,5235591577
4812,242236890,82213,242319103,0,0,1,3072,11,2596563381
4813,242274300,45469,242319769,5,0,1,1024,19,9337573427
4814,242294200,242972,242537172,4,0,0,10752,16,1097802854
4815,242420700,186766,242607466,3,0,0,28672,2,1375170629
4816,242440910,92971,242533881,9,0,0,5120,18,4119681183
4817,242492620,130461,242623081,9,0,0,51200,18,6071145874
4818,242499530,53089,242552619,0,0,0,2560,11,9607176740
4819,242525580,4374,242529954,0,0,1,4608,11,7884829226
4820,242583590,177822,242761412,3,0,0,18432,2,3888374624
4821,242625100,65900,242691000,9,0,0,7168,18,246024137
4822,242681980,109304,242791284,3,0,0,58880,2,1422472906
4823,242739599,3422,242743021,3,0,1,3584,2,10550274248
4824,242886869,96536,242983405,1,0,0,22016,6,10600979823
4825,242955100,45596,243000696,5,0,0,1024,19,9752919870
4826,242964060,5802,242969862,9,0,1,6144,18,8372863816
4827,242990189,103064,243093253,7,0,0,38400,8,1592075528
4828,243003090,106652,243109742,4,0,0,50176,16,4016990321
4829,243025630,67794,243093424,5,0,0,512,19,4402203719
4830,243068330,71156,243139486,3,0,0,14336,2,5636332910
4831,243162900,108992,243271892,5,0,0,57856,19,6219055453
4832,243174659,566,243175225,3,0,1,512,2,8771570202
4833,243222840,49691,243272531,2,0,0,2048,4,10706316016
4834,243328600,115388,243443988,0,0,0,78848,11,2986634380
4835,243422549,118567,243541116,1,0,0,18944,6,9350016570
4836,243499610,112822,243612432,4,0,0,13824,16,10316789927
4837,243618060,104624,243722684,9,0,0,43520,18,4662134035
4838,243635959,93768,243729727,7,0,0,23040,8,621022701
4839,243682810,130343,243813153,9,0,0,83968,18,690266110
4840,243710989,155786,243866775,7,0,0,47104,8,355967491
4841,243757949,70532,243828481,1,0,0,12288,6,8132682956
4842,243812751,94290,243907041,6,0,0,11776,12,2694768907
4843,243913740,107276,244021016,8,0,0,52224,12,5527818764
4844,243989050,100005,244089055,9,0,0,24064,18,1746786528
4845,243990359,111347,244101706,7,0,0,41472,8,2292828938
4846,244079671,72668,244152339,6,0,0,9216,12,2557933165
4847,244202380,87896,244290276,5,0,0,13824,19,5830366786
4848,244274600,112892,244387492,8,0,0,70656,12,10501611883
4849,244284870,155518,244440388,9,0,0,82944,18,7039870313
4850,244342581,45596,244388177,6,0,0,1024,12,10401227071
4851,244498480,106652,244605132,0,0,0,50176,11,4810703003
4852,244506010,104909,244610919,2,0,0,18944,4,7583509274
4853,244597750,87521,244685271,3,0,0,9728,2,3660326442
4854,244605910,15267,244621177,9,0,1,16384,18,5115530407
4855,244634940,168226,244803166,5,0,0,5632,19,6831595966
4856,244640061,55148,244695209,6,0,0,7168,12,9854622165
4857,244664220,1042,244665262,5,0,1,1024,19,6550156002
4858,244672880,164264,244837144,9,0,0,21504,18,1705016255
4859,244805540,5326,244810866,6,0,1,5632,12,4290224277
4860,244863730,83624,244947354,8,0,0,19968,12,5331946254
4861,244892780,1042,244893822,6,0,1,1024,12,8706825047
4862,244902360,97760,245000120,4,0,0,20992,16,2197403838
4863,244954451,130806,245085257,6,0,0,26624,12,1950866213
4864,245025419,80708,245106127,7,0,0,20480,8,10447537576
4865,245030740,55624,245086364,0,0,0,3584,11,10518193041
4866,245032949,5802,245038751,8,0,1,6144,12,2604543894
4867,245113560,50213,245163773,2,0,0,512,4,1188145187
4868,245115810,7706,245123516,2,0,1,8192,4,1980458546
4869,245134100,110240,245244340,3,0,0,61952,2,2629957219
4870,245263229,113828,245377057,7,0,0,73728,8,1762038004
4871,245405360,60824,245466184,5,0,0,5632,19,1033514848
4872,245420570,60824,245481394,4,0,0,5632,16,127739335
4873,245446190,97604,245543794,3,0,0,20480,2,5585044378
4874,245504190,47288,245551478,0,0,0,1536,11,6744138209
4875,245554519,77168,245631687,1,0,0,18944,6,2521643372
4876,245575830,77744,245653574,0,0,0,10752,11,1483818475
4877,245614560,1042,245615602,7,0,1,1024,8,7701014454
4878,245696290,566,245696856,6,0,1,512,12,238859385
4879,245719319,74896,245794215,7,0,0,3584,8,4091122083
4880,245856039,97340,245953379,1,0,0,29696,6,5368816864
4881,245903891,98136,246002027,6,0,0,5632,12,7061579239
4882,245968530,65900,246034430,4,0,0,7168,16,1776121167
4883,245977600,72526,246050126,9,0,0,13312,18,6845438508
4884,246147320,62984,246210304,2,0,0,7680,4,1897490036
4885,246250490,59132,246309622,8,0,0,5120,12,5567198158
4886,246411020,106652,246517672,8,0,0,50176,12,1206779224
4887,246419360,107234,246526594,8,0,0,5120,12,5086585185
4888,246421770,103249,246525019,8,0,0,24064,12,2446227455
4889,246448600,158418,246607018,3,0,0,65024,2,1895122507
4890,246489369,148939,246638308,7,0,0,15360,8,6140209488
4891,246657880,52542,246710422,8,0,0,2560,12,227471544
4892,246659750,60824,246720574,2,0,0,5632,4,2192572258
4893,246777530,4374,246781904,2,0,1,4608,4,1409956035
4894,246840090,74384,246914474,3,0,0,14848,2,1925021333
4895,247009210,86204,247095414,0,0,0,13312,11,2776636835
4896,247012429,1042,247013471,3,0,1,1024,2,6729900699
4897,247055190,48980,247104170,8,0,0,2048,12,2408447859
4898,247080570,1042,247081612,1,0,1,1024,6,10575195424
4899,247107119,76853,247183972,1,0,0,7680,6,7088329263
4900,247117440,1518,247118958,0,0,1,1536,11,3896742387
4901,247127440,98072,247225512,5,0,0,22016,19,9249375121
4902,247172390,118352,247290742,0,0,0,88576,11,5548972225
4903,247232520,6278,247238798,4,0,1,6656,16,5669534586
4904,247245650,98696,247344346,8,0,0,24064,12,1349279538
4905,247260910,87359,247348269,4,0,0,12800,16,5167806396
4906,247273360,148236,247421596,2,0,0,30720,4,4037834685
4907,247306880,105266,247412146,2,0,0,38912,4,829808392
4908,247308460,257790,247566250,9,0,0,146432,18,6819986883
4909,247328969,94727,247423696,1,0,0,5120,6,10484316434
4910,247338480,135382,247473862,5,0,0,1024,19,5479933072
4911,247427149,156585,247583734,7,0,0,42496,8,7548240054
4912,247529089,139905,247668994,7,0,0,37376,8,10643750065
4913,247549720,72295,247622015,0,0,0,4096,11,1627074708
4914,247588771,104624,247693395,6,0,0,43520,12,1860216600
4915,247654550,83905,247738455,0,0,0,7680,11,2638461526
4916,247721850,72668,247794518,9,0,0,9216,18,3827814987
4917,247765310,52364,247817674,4,0,0,3072,16,9139234438
4918,247770750,70976,247841726,5,0,0,8704,19,4167576164
4919,247791369,87608,247878977,1,0,0,17920,6,7635989556
4920,247803440,11533,247814973,0,0,1,18944,11,9342880175
4921,247818370,116115,247934485,8,0,0,44544,12,9164155753
4922,247829320,108456,247937776,0,0,0,10752,11,4213069543
4923,247886840,191249,248078089,9,0,0,91648,18,5076140983
4924,247909650,322769,248232419,9,0,0,41984,18,9520442251
4925,247911620,173660,248085280,2,0,0,23552,4,821476933
4926,247936660,11865,247948525,9,0,1,17408,18,1180602280
4927,247939801,98231,248038032,6,0,0,19456,12,9437023335
4928,247968870,198299,248167169,5,0,0,55808,19,4303781296
4929,247993850,324855,248318705,0,0,0,92160,11,490710896
4930,248025330,307788,248333118,3,0,0,6656,2,1717289878
4931,248153720,254536,248408256,0,0,0,33280,11,9764276082
4932,248201620,125836,248327456,5,0,0,28672,19,9620686586
4933,248202950,128117,248331067,5,0,0,11776,19,3980123864
4934,248232990,4374,248237364,2,0,1,4608,4,9421417416
4935,248239179,257421,248496600,7,0,0,71168,8,1360973853
4936,248269910,99898,248369808,9,0,0,23040,18,5079545490
4937,248270740,65900,248336640,8,0,0,7168,12,10384950844
4938,248279360,179434,248458794,2,0,0,26624,4,1568581238
4939,248300010,207057,248507067,2,0,0,34304,4,3094108963
4940,248304360,268343,248572703,9,0,0,43008,18,7696550310
4941,248327500,314006,248641506,2,0,0,29184,4,10509965740
4942,248338760,275494,248614254,9,0,0,15360,18,10621164437
4943,248377810,160742,248538552,9,0,0,60416,18,10548956786
4944,248416229,172111,248588340,7,0,0,32256,8,9467127645
4945,248431320,2470,248433790,6,0,1,2560,12,10082623792
4946,248455550,6623,248462173,1,0,1,9728,6,7690614031
4947,248465320,3422,248468742,9,0,1,3584,18,1522133389
4948,248523880,186409,248710289,2,0,0,12288,4,6981261256
4949,248568240,114785,248683025,0,0,0,28672,11,8710481594
4950,248583900,104892,248688792,3,0,0,1024,2,8465433649
4951,248618620,139327,248757947,8,0,0,46592,12,4631060691
4952,248651760,88676,248740436,3,0,0,16384,2,9195774273
4953,248657029,130061,248787090,1,0,0,25088,6,9599118063
4954,248824499,93308,248917807,7,0,0,21504,8,10042060718
4955,249069520,57440,249126960,0,0,0,4608,11,7591591086
4956,249082519,109772,249192291,7,0,0,60416,8,9071912895
4957,249118120,81128,249199248,5,0,0,11776,19,3176953927
4958,249188670,105786,249294456,3,0,0,24576,2,4282834963
4959,249279050,45596,249324646,0,0,0,1024,11,10372241463
4960,249287080,86048,249373128,5,0,0,13824,19,3628357962
4961,249289850,58679,249348529,8,0,0,3584,12,3673902390
4962,249355991,125449,249481440,6,0,0,69632,12,2147812717
4963,249378539,3422,249381961,3,0,1,3584,2,7603732754
4964,249397869,142869,249540738,1,0,0,31232,6,2563258261
4965,249427601,192199,249619800,6,0,0,47616,12,5335365582
4966,249439599,78212,249517811,1,0,0,12288,6,5588682011
4967,249457820,114130,249571950,9,0,0,37888,18,3334302911
4968,249571360,128112,249699472,9,0,0,32256,18,2766267255
4969,249573320,111266,249684586,4,0,0,27648,16,3368719058
4970,249619550,82901,249702451,2,0,0,9728,4,1878756290
4971,249669061,88923,249757984,6,0,0,15360,12,8407935109
4972,249670880,103688,249774568,9,0,0,40448,18,63439860
4973,249768000,112588,249880588,9,0,0,48128,18,1444428388
4974,249771860,91304,249863164,4,0,0,1024,16,1194771815
4975,249777150,115474,249892624,2,0,0,27136,4,10136580271
4976,249849759,47288,249897047,7,0,0,1536,8,960496579
4977,249852539,83444,249935983,1,0,0,14336,6,5789647110
4978,249856141,131847,249987988,6,0,0,40448,12,7015788837
4979,249863009,97751,249960760,1,0,0,20480,6,8102913242
4980,249933290,3251,249936541,4,0,1,512,16,1294281160
4981,249972239,98852,250071091,1,0,0,24576,6,8045779854
4982,250017330,4374,250021704,9,0,1,4608,18,2021230764
4983,250037530,5326,250042856,4,0,1,5632,16,7411560863
4984,250046890,11016,250057906,9,0,1,17920,18,10240478977
4985,250148130,79436,250227566,5,0,0,11264,19,8378098397
4986,250153241,100238,250253479,6,0,0,6144,12,7314063639
4987,250163320,4162,250167482,5,0,1,11264,19,9361978180
4988,250320150,79436,250399586,3,0,0,11264,2,3153372737
4989,250399299,79583,250478882,1,0,0,15872,6,746276054
4990,250410990,1518,250412508,5,0,1,1536,19,3911627514
4991,250488980,70976,250559956,8,0,0,8704,12,8880314399
4992,250564720,112736,250677456,4,0,0,70144,16,6806477879
4993,250577350,6278,250583628,0,0,1,6656,11,10557160416
4994,250589080,45596,250634676,9,0,0,1024,18,582358790
4995,250655100,49908,250705008,9,0,0,2048,18,214581702
4996,250688950,111020,250799970,8,0,0,64512,12,9557122837
4997,250693800,149706,250843506,0,0,0,46080,11,5866251289
4998,250719230,206831,250926061,5,0,0,42496,19,7422843952
4999,250765540,7706,250773246,7,0,1,8192,8,4525703765
5000,250796730,90996,250887726,0,0,0,18432,11,10589805569
5001,250834980,176851,251011831,3,0,0,15360,2,5391299919
5002,250846020,151195,250997215,9,0,0,43008,18,1555697179
5003,250856950,5326,250862276,2,0,1,5632,4,6385316486
5004,250860110,6754,250866864,4,0,1,7168,16,10134251649
5005,250952089,60396,251012485,1,0,0,1024,6,6063142182
5006,250953200,58958,251012158,2,0,0,1024,4,2405506099
5007,250961489,149063,251110552,1,0,0,48640,6,5311981688
5008,250967260,166239,251133499,5,0,0,75264,19,10505771499
5009,250976299,119418,251095717,7,0,0,12288,8,7273282094
5010,251001280,217434,251218714,2,0,0,55808,4,3073172521
5011,251203000,91758,251294758,0,0,0,10240,11,1944205603
5012,251236900,89900,251326800,0,0,0,15360,11,10470595289
5013,251278440,119010,251397450,9,0,0,39424,18,4773516258
5014,251368770,106652,251475422,9,0,0,50176,18,191104551
5015,251417790,99770,251517560,0,0,0,20992,11,2222038058
5016,251433630,3904,251437534,7,0,1,10752,8,6568709939
5017,251464459,23780,251488239,8,0,1,21504,12,1857545688
5018,251500790,186220,251687010,3,0,0,25088,2,5613958704
5019,251501960,163489,251665449,5,0,0,2048,19,2392979146
5020,251549260,60824,251610084,0,0,0,5632,11,4917083454
5021,251571119,1518,251572637,3,0,1,1536,2,4736860960
5022,251595439,113090,251708529,1,0,0,17408,6,10395686134
5023,251681090,74128,251755218,5,0,0,9728,19,286173745
5024,251727801,118719,251846520,6,0,0,81408,12,7571650053
5025,251753390,141238,251894628,2,0,0,23552,4,27886857
5026,251800820,3422,251804242,5,0,1,3584,19,6218164770
5027,251812201,85874,251898075,6,0,0,11264,12,8753931909
5028,251815590,4420,251820010,1,0,1,11776,6,7109305287
5029,251899420,1518,251900938,1,0,1,1536,6,3948643811
5030,252032761,103688,252136449,6,0,0,40448,12,3303868357
5031,252070290,78392,252148682,2,0,0,17920,4,10117657703
5032,252090180,2470,252092650,1,0,1,2560,6,4171501135
5033,252112070,7706,252119776,7,0,1,8192,8,5824758047
5034,252128270,78235,252206505,3,0,0,10752,2,6805150797
5035,252143659,238809,252382468,1,0,0,9216,6,1780070235
5036,252209951,182360,252392311,6,0,0,32256,12,4538817811
5037,252241279,138366,252379645,1,0,0,89600,6,10479937265
5038,252251049,225301,252476350,1,0,0,27136,6,803031586
5039,252284060,125783,252409843,4,0,0,36352,16,3565676242
5040,252285940,156495,252442435,5,0,0,42496,19,8692738359
5041,252298300,150753,252449053,8,0,0,1536,12,6118613120
5042,252381910,86157,252468067,8,0,0,14336,12,2137408684
5043,252390050,2844,252392894,7,0,1,512,8,5717571807
5044,252402140,105143,252507283,8,0,0,19968,12,8350250997
5045,252430709,89798,252520507,7,0,0,4096,8,4234596048
5046,252531130,5802,252536932,6,0,1,6144,12,4390755598
5047,252545730,87140,252632870,9,0,0,16384,18,8395422166
5048,252636379,117552,252753931,7,0,0,35328,8,5473379572
5049,252806790,79436,252886226,5,0,0,11264,19,5206123397
5050,252809420,1994,252811414,5,0,1,2048,19,4969311341
5051,252810520,142900,252953420,9,0,0,18944,18,1295736183
5052,252848210,65900,252914110,2,0,0,7168,4,6336924771
5053,252873910,102820,252976730,5,0,0,3584,19,4864335996
5054,252878660,63210,252941870,2,0,0,5120,4,7769139187
5055,252935479,43904,252979383,7,0,0,512,8,6094404159
5056,252943260,10757,252954017,0,0,1,17408,11,3099576426
5057,253015100,115076,253130176,3,0,0,77824,2,8416547485
5058,253022009,4937,253026946,3,0,1,12800,2,9343369576
5059,253089810,73438,253163248,4,0,0,7680,16,7775182214
5060,253094220,87958,253182178,5,0,0,8192,19,6923763984
5061,253135170,117820,253252990,2,0,0,74240,4,8799447592
5062,253170869,87908,253258777,1,0,0,18944,6,7910795985
5063,253178799,6754,253185553,3,0,1,7168,2,5156528945
5064,253201270,79167,253280437,9,0,0,2048,18,9494327678
5065,253289480,55748,253345228,5,0,0,4096,19,5260285362
5066,253298441,109928,253408369,6,0,0,60928,12,1308835499
5067,253432559,100096,253532655,1,0,0,26624,6,1260000955
5068,253447910,1518,253449428,0,0,1,1536,11,634246360
5069,253452750,206877,253659627,5,0,0,32768,19,2954270154
5070,253468540,100568,253569108,3,0,0,30208,2,2875721053
5071,253477330,157310,253634640,3,0,0,83968,2,7683638867
5072,253485640,216936,253702576,5,0,0,46592,19,756209630
5073,253497910,5326,253503236,0,0,1,5632,11,5851362229
5074,253532689,111155,253643844,1,0,0,1024,6,256668555
5075,253572109,136218,253708327,1,0,0,4096,6,2812637764
5076,253579751,108614,253688365,6,0,0,45568,12,3565428481
5077,253595510,4374,253599884,5,0,1,4608,19,7989354568
5078,253596850,109797,253706647,2,0,0,13312,4,3008087542
5079,253637310,155017,253792327,2,0,0,22528,4,838925047
5080,253731670,67592,253799262,5,0,0,7680,19,5823478884
5081,253747610,116404,253864014,3,0,0,58880,2,6045934671
5082,253750680,3128,253753808,9,0,1,9216,18,4593872202
5083,253771350,121930,253893280,5,0,0,10752,19,2595172684
5084,253774720,187830,253962550,0,0,0,35328,11,6900395074
5085,253847810,147086,253994896,0,0,0,14336,11,4673491558
5086,253878650,14645,253893295,7,0,1,25088,8,5186122762
5087,253898490,7230,253905720,1,0,1,7680,6,2931808464
5088,253961690,3722,253965412,2,0,1,8704,4,6256278974
5089,254013209,159750,254172959,7,0,0,12288,8,7224595900
5090,254118371,47288,254165659,6,0,0,1536,12,7031239076
5091,254141420,566,254141986,2,0,1,512,4,3948544919
5092,254174030,43904,254217934,5,0,0,512,19,3742783964
5093,254244400,102752,254347152,5,0,0,37376,19,2845456040
5094,254293851,106647,254400498,6,0,0,39936,12,1487554251
5095,254364509,108103,254472612,1,0,0,48640,6,7943217282
5096,254421799,66680,254488479,1,0,0,9728,6,2241456954
5097,254499369,88076,254587445,1,0,0,19456,6,7367664337
5098,254540560,59132,254599692,2,0,0,5120,4,3938113457
5099,254625510,68216,254693726,2,0,0,9728,4,4542702746
5100,254640090,86204,254726294,4,0,0,13312,16,5951761408
5101,254641420,5326,254646746,0,0,1,5632,11,7210630635
5102,254647650,99368,254747018,4,0,0,10240,16,763753568
5103,254655651,88232,254743883,6,0,0,19968,12,2342896677
5104,254806160,7230,254813390,0,0,1,7680,11,8140854512
5105,254819869,76544,254896413,7,0,0,16896,8,1433485709
5106,255005250,60824,255066074,2,0,0,5632,4,123345237
5107,255009810,91622,255101432,3,0,0,4608,2,9552768102
5108,255020990,1994,255022984,2,0,1,2048,4,3690355398
5109,255063430,106876,255170306,4,0,0,43008,16,5675321739
5110,255081830,110240,255192070,2,0,0,61952,4,3434277872
5111,255159760,32333,255192093,0,0,1,16896,11,4051272126
5112,255179430,181836,255361266,9,0,0,67072,18,6992204778
5113,255192000,148815,255340815,9,0,0,44544,18,6660091640
5114,255197260,95001,255292261,2,0,0,2560,4,8875396820
5115,255211340,198269,255409609,9,0,0,34816,18,1539545122
5116,255215300,204776,255420076,0,0,0,34304,11,5589120404
5117,255341180,148681,255489861,2,0,0,48640,4,2624868275
5118,255353380,119783,255473163,4,0,0,10240,16,708978718
5119,255387040,4937,255391977,5,0,1,12800,19,6512470295
5120,255536719,3898,255540617,3,0,1,4096,2,605437254
5121,255547640,94532,255642172,9,0,0,20480,18,10471041745
5122,255727110,77168,255804278,0,0,0,18944,11,10726046952
5123,255765560,74360,255839920,2,0,0,9728,4,8739200190
5124,255808950,84824,255893774,5,0,0,13824,19,3147950205
5125,255819390,142045,255961435,3,0,0,45568,2,10105236893
5126,255823931,80996,255904927,6,0,0,16384,12,8766282150
5127,255837350,101670,255939020,5,0,0,25088,19,1820913245
5128,255845580,3387,255848967,1,0,1,9728,6,2669827975
5129,255849260,47444,255896704,8,0,0,2048,12,3174159902
5130,255853319,185066,256038385,1,0,0,70144,6,4230614101
5131,255924200,115604,256039804,3,0,0,4608,2,3016376738
5132,255987441,126133,256113574,6,0,0,70656,12,7629598395
5133,255999900,180922,256180822,4,0,0,130048,16,8699882683
5134,256034830,161935,256196765,9,0,0,52224,18,10221975108
5135,256062710,135942,256198652,0,0,0,6144,11,9923977204
5136,256081439,6229,256087668,3,0,1,15360,2,7476913231
5137,256097390,146578,256243968,2,0,0,19968,4,841623754
5138,256097780,22316,256120096,2,0,1,15872,4,9322797190
5139,256099720,149902,256249622,8,0,0,10752,12,6515605550
5140,256115870,5852,256121722,6,0,1,2560,12,7832510039
5141,256141539,104784,256246323,1,0,0,7680,6,7850252631
5142,256155390,102828,256258218,0,0,0,5120,11,6372871171
5143,256203769,156657,256360426,1,0,0,17408,6,7624815631
5144,256241700,103780,256345480,9,0,0,14848,18,5110998677
5145,256292650,169879,256462529,9,0,0,88064,18,9093150941
5146,256342620,17821,256360441,1,0,1,18432,6,6171446366
5147,256351600,189290,256540890,9,0,0,108032,18,6048459185
5148,256393590,281742,256675332,8,0,0,35840,12,52820287
5149,256410610,4937,256415547,2,0,1,12800,4,2928465347
5150,256422310,203905,256626215,9,0,0,69632,18,8063397686
5151,256463970,110410,256574380,5,0,0,25600,19,9055123669
5152,256538450,5302,256543752,2,0,1,8704,4,3801669475
5153,256568380,89077,256657457,4,0,0,9728,16,7731533121
5154,256584000,116177,256700177,9,0,0,13824,18,7372368705
5155,256584690,205073,256789763,4,0,0,79872,16,483308592
5156,256700880,141317,256842197,2,0,0,18944,4,621462591
5157,256736830,81440,256818270,3,0,0,12800,2,3504742397
5158,256752890,49690,256802580,8,0,0,512,12,4308602325
5159,256756250,172257,256928507,4,0,0,74240,16,991674091
5160,256811390,250603,257061993,5,0,0,98304,19,1475032086
5161,256843640,5802,256849442,6,0,1,6144,12,6113476848
5162,256857180,264768,257121948,5,0,0,10752,19,5307297087
5163,256870540,161486,257032026,5,0,0,69632,19,8205583044
5164,256873881,230007,257103888,6,0,0,57344,12,4313527099
5165,256941870,2946,256944816,0,0,1,3072,11,925384786
5166,257003469,58539,257062008,3,0,1,23552,2,3998004351
5167,257135011,74360,257209371,6,0,0,9728,12,4083482431
5168,257146819,1042,257147861,3,0,1,1024,2,7862780089
5169,257172400,105266,257277666,0,0,0,45568,11,3081235548
5170,257220660,104077,257324737,0,0,0,10240,11,7807577459
5171,257238740,4162,257242902,6,0,1,11264,12,5958236501
5172,257240099,126206,257366305,1,0,0,29696,6,9814444571
5173,257262140,1042,257263182,5,0,1,1024,19,9735542564
5174,257308740,241713,257550453,8,0,0,36864,12,103377261
5175,257340720,1994,257342714,2,0,1,2048,4,8515539340
5176,257360330,53255,257413585,9,0,0,1536,18,3619359031
5177,257362980,70381,257433361,2,0,0,512,4,1403410365
5178,257417820,195333,257613153,9,0,0,28672,18,9307495821
5179,257418140,113352,257531492,3,0,0,7680,2,4856446641
5180,257532620,83988,257616608,0,0,0,11264,11,4638934860
5181,257599259,65482,257664741,1,0,0,9216,6,9642566418
5182,257604870,13215,257618085,4,0,1,1536,16,5443449626
5183,257654940,76052,257730992,4,0,0,10240,16,2396462407
5184,257779400,2946,257782346,6,0,1,3072,12,9376269259
5185,257835610,86540,257922150,3,0,0,19456,2,9550720591
5186,257961340,77768,258039108,4,0,0,15872,16,4579167955
5187,258012710,64676,258077386,3,0,0,8192,2,10317185166
5188,258064440,566,258065006,0,0,1,512,11,501483966
5189,258340470,47288,258387758,0,0,0,1536,11,963101203
5190,258341629,90704,258432333,1,0,0,23040,6,7754409570
5191,258363780,1994,258365774,5,0,1,2048,19,4524975329
5192,258510551,64832,258575383,6,0,0,8704,12,609771955
5193,258540490,86204,258626694,5,0,0,13312,19,2569711295
5194,258624910,13825,258638735,2,0,1,19968,4,2831158330
5195,258748259,45596,258793855,7,0,0,1024,8,5650119084
5196,258777720,6278,258783998,7,0,1,6656,8,8535465741
5197,258988120,55748,259043868,9,0,0,4096,18,128062307
5198,259012579,99632,259112211,1,0,0,27136,6,4921719665
5199,259073920,60824,259134744,9,0,0,5632,18,8852220488
5200,259096000,4374,259100374,9,0,1,4608,18,8671432922
5201,259113070,101816,259214886,3,0,0,34304,2,7484534929
5202,259118570,136853,259255423,4,0,0,41472,16,7529505446
5203,259134910,7230,259142140,5,0,1,7680,19,3175750395
5204,259179271,161783,259341054,6,0,0,32768,12,7385909095
5205,259292660,4850,259297510,9,0,1,5120,18,8775039673
5206,259320049,166262,259486311,7,0,0,84480,8,8997387187
5207,259326199,242205,259568404,1,0,0,114688,6,1541542402
5208,259343840,227075,259570915,8,0,0,8192,12,7924025382
5209,259360420,26738,259387158,6,0,1,48640,12,9623419749
5210,259413830,217860,259631690,5,0,0,8192,19,8207343516
5211,259425519,168656,259594175,1,0,0,55808,6,7867618031
5212,259443570,11791,259455361,4,0,1,19456,16,7403171855
5213,259507520,4420,259511940,1,0,1,11776,6,8076047977
5214,259677850,69440,259747290,2,0,0,8704,4,3420605310
5215,259685450,75685,259761135,2,0,0,6144,4,3159577622
5216,259797910,103376,259901286,9,0,0,39424,18,2330219050
5217,259948731,65900,260014631,6,0,0,7168,12,7534201414
5218,260044120,47288,260091408,8,0,0,1536,12,5576861285
5219,260054429,71449,260125878,7,0,0,7680,8,9398763636
5220,260056190,7230,260063420,9,0,1,7680,18,2753713449
5221,260179500,59912,260239412,3,0,0,7680,2,2937837621
5222,260218070,4937,260223007,6,0,1,12800,12,4165775613
5223,260249670,166602,260416272,3,0,0,10752,2,8784993719
5224,260259970,10757,260270727,7,0,1,17408,8,1861424491
5225,260268410,5223,260273633,1,0,1,4608,6,4083238619
5226,260301160,1042,260302202,0,0,1,1024,11,8108698070
5227,260305930,131869,260437799,8,0,0,12800,12,2093533854
5228,260332529,76208,260408737,1,0,0,10752,6,7567776636
5229,260363150,98384,260461534,8,0,0,23040,12,3461633234
5230,260381720,70198,260451918,4,0,0,5632,16,4475829170
5231,260428869,70976,260499845,1,0,0,8704,6,5742832774
5232,260458440,153875,260612315,4,0,0,37376,16,1466191459
5233,260470821,101504,260572325,6,0,0,33280,12,6054860185
5234,260661050,99320,260760370,4,0,0,26112,16,689546644
5235,260676799,100256,260777055,1,0,0,29184,6,2429425971
5236,260778610,109304,260887914,0,0,0,58880,11,5777310803
5237,260786030,123820,260909850,9,0,0,19968,18,5680945032
5238,260848090,1518,260849608,1,0,1,1536,6,6005780283
5239,260947720,100256,261047976,9,0,0,29184,18,5971924650
5240,261059990,13600,261073590,9,0,1,23040,18,3749435253
5241,261096671,204906,261301577,6,0,0,53760,12,1414885584
5242,261098650,175555,261274205,9,0,0,14336,18,8519213718
5243,261116910,195671,261312581,5,0,0,9216,19,7673690489
5244,261300910,99355,261400265,8,0,0,24064,12,5479648944
5245,261330670,59845,261390515,9,0,0,1024,18,6256628919
5246,261388250,98696,261486946,3,0,0,24064,2,10435296945
5247,261418760,133154,261551914,2,0,0,8192,4,9413138836
5248,261419611,158370,261577981,6,0,0,85504,12,8522222701
5249,261446420,179816,261626236,0,0,0,29184,11,83247009
5250,261466969,222063,261689032,7,0,0,23552,8,1435942069
5251,261584420,50672,261635092,4,0,0,2560,16,7656744265
5252,261616279,106340,261722619,7,0,0,49152,8,5314246426
5253,261621020,106526,261727546,2,0,0,7680,4,384652486
5254,261659630,3904,261663534,2,0,1,10752,4,8168504287
5255,261678479,177045,261855524,1,0,0,47616,6,5610833986
5256,261700500,100724,261801224,9,0,0,30720,18,9638588483
5257,261732361,144193,261876554,6,0,0,4608,12,10340704862
5258,261801589,102440,261904029,7,0,0,36352,8,2841324786
5259,261885070,98072,261983142,0,0,0,22016,11,588031480
5260,261916119,48980,261965099,1,0,0,2048,6,4496410741
5261,262135290,2946,262138236,7,0,1,3072,8,4471606861
5262,262177350,92840,262270190,9,0,0,19968,18,4361002420
5263,262289240,114296,262403536,0,0,0,75264,11,6380737582
5264,262300440,106707,262407147,5,0,0,11776,19,8616120243
5265,262310650,120720,262431370,8,0,0,9216,12,952605320
5266,262314369,1994,262316363,3,0,1,2048,2,6415977375
5267,262343790,1994,262345784,0,0,1,2048,11,7374620875
5268,262385239,68961,262454200,1,0,0,2560,6,10700962830
5269,262404820,102887,262507707,0,0,0,30208,11,792600607
5270,262470070,92609,262562679,2,0,0,11776,4,5718817202
5271,262473390,73593,262546983,3,0,0,5632,2,4921978236
5272,262583930,48980,262632910,2,0,0,2048,4,21932241
5273,262604560,3128,262607688,4,0,1,9216,16,1466645710
5274,262607400,77629,262685029,3,0,0,15360,2,4940807754
5275,262624541,71916,262696457,6,0,0,6656,12,10397774867
5276,262626610,83912,262710522,0,0,0,15872,11,6961419126
5277,262629829,137867,262767696,1,0,0,15872,6,793422457
5278,262667550,195016,262862566,5,0,0,33280,19,7724142637
5279,262699700,88564,262788264,3,0,0,12800,2,10206752397
5280,262779719,72692,262852411,1,0,0,14336,6,2233205006
5281,262864760,102752,262967512,5,0,0,37376,19,7209809289
5282,262906430,5712,262912142,4,0,1,14336,16,6033603368
5283,262916170,56840,262973010,3,0,0,7680,2,8003024501
5284,262919150,67748,262986898,0,0,0,8192,11,187756497
5285,262928529,81752,263010281,7,0,0,13824,8,8001290053
5286,263023740,128021,263151761,9,0,0,67072,18,10450820177
5287,263039961,212174,263252135,6,0,0,108032,12,1843195705
5288,263099620,103738,263203358,9,0,0,11264,18,359237780
5289,263135620,17651,263153271,9,0,1,1536,18,3664141305
5290,263182000,5326,263187326,6,0,1,5632,12,3547540518
5291,263454450,57440,263511890,4,0,0,4608,16,5845104835
5292,263481180,566,263481746,4,0,1,512,16,6573307616
5293,263602410,4374,263606784,7,0,1,4608,8,8099407211
5294,263684320,111176,263795496,9,0,0,65024,18,2290667558
5295,263692840,154260,263847100,0,0,0,9728,11,3092628502
5296,263719910,228506,263948416,5,0,0,29696,19,5492450468
5297,263724449,100049,263824498,1,0,0,12288,6,3200408253
5298,263744750,158570,263903320,4,0,0,43008,16,3589860026
5299,263782020,15462,263797482,7,0,1,2048,8,3526242644
5300,263862349,49136,263911485,7,0,0,2560,8,3762494366
5301,263896739,82306,263979045,7,0,0,15360,8,9197930287
5302,264008800,103844,264112644,3,0,0,40960,2,3305068693
5303,264147039,13600,264160639,3,0,1,23040,2,5461903131
5304,264213180,3904,264217084,0,0,1,10752,11,5328210530
5305,264380170,68060,264448230,0,0,0,9216,11,7255356634
5306,264388800,73916,264462716,8,0,0,13312,12,3754320013
5307,264413039,74391,264487430,1,0,0,2560,6,7274873233
5308,264512920,107432,264620352,3,0,0,52736,2,9791255762
5309,264782480,4162,264786642,4,0,1,11264,16,9170824400
5310,264801350,69776,264871126,3,0,0,14848,2,7922694286
5311,264816250,104936,264921186,0,0,0,44544,11,4019518456
5312,264907270,100724,265007994,3,0,0,30720,2,1781308640
5313,264948609,87896,265036505,1,0,0,13824,6,7328649794
5314,264959800,96980,265056780,3,0,0,18432,2,817251872
5315,264991330,117686,265109016,2,0,0,6144,4,2591824187
5316,265012980,4850,265017830,0,0,1,5120,11,2100547227
5317,265050490,6305,265056795,0,0,1,1024,11,1072513465
5318,265109811,59132,265168943,6,0,0,5120,12,2999965828
5319,265207509,88700,265296209,7,0,0,21504,8,7042748813
5320,265275089,118196,265393285,7,0,0,88064,8,4338511848
5321,265406100,1994,265408094,6,0,1,2048,12,2004112391
5322,265440519,2470,265442989,8,0,1,2560,12,10011328620
5323,265506270,84404,265590674,8,0,0,22528,12,8286442279
5324,265509190,99944,265609134,3,0,0,28160,2,1189236122
5325,265542040,128752,265670792,3,0,0,67584,2,2711480267
5326,265576410,14279,265590689,6,0,1,20480,12,2943642524
5327,265583220,43904,265627124,8,0,0,512,12,7416257629
5328,265732561,64208,265796769,6,0,0,6656,12,831114897
5329,265763950,74969,265838919,2,0,0,12800,4,1019326068
5330,265835989,48518,265884507,7,0,0,1024,8,1284325307
5331,265902940,100724,266003664,5,0,0,30720,19,6467192545
5332,265974780,4679,265979459,6,0,1,12288,12,10707906115
5333,266062391,104468,266166859,6,0,0,43008,12,8276015625
5334,266134190,13341,266147531,6,0,1,22528,12,6415259476
5335,266140830,9927,266150757,0,0,1,5120,11,8403634365
5336,266197460,103220,266300680,8,0,0,38912,12,6380893315
5337,266298910,64278,266363188,0,0,0,6144,11,8131766217
5338,266301809,12566,266314375,3,0,1,20992,2,8578397721
5339,266326060,104347,266430407,3,0,0,7680,2,6065001909
5340,266334800,173997,266508797,4,0,0,14848,16,8121698328
5341,266353090,138517,266491607,8,0,0,87552,12,5057000690
5342,266354800,149458,266504258,9,0,0,41472,18,1440178586
5343,266543100,76052,266619152,9,0,0,10240,18,2086382858
5344,266561720,1042,266562762,6,0,1,1024,12,5150628502
5345,266613070,6097,266619167,7,0,1,3584,8,350592842
5346,266645870,4850,266650720,5,0,1,5120,19,8689160028
5347,266728070,6278,266734348,6,0,1,6656,12,9718635831
5348,266816729,7230,266823959,8,0,1,7680,12,9434251632
5349,266915059,130635,267045694,7,0,0,81920,8,1209067384
5350,266929370,127103,267056473,0,0,0,35328,11,8256905026
5351,266975550,147747,267123297,8,0,0,7168,12,9581837307
5352,266996231,111952,267108183,6,0,0,34304,12,7909603003
5353,267012170,69284,267081454,8,0,0,8192,12,7718494726
5354,267059980,13083,267073063,5,0,1,22016,19,2006218576
5355,267092790,174139,267266929,8,0,0,12800,12,7085661496
5356,267094149,59288,267153437,1,0,0,5632,6,4052786173
5357,267097980,72071,267170051,5,0,0,3584,19,5054093302
5358,267208150,45596,267253746,4,0,0,1024,16,726623907
5359,267225649,4850,267230499,3,0,1,5120,2,8501269326
5360,267290920,134480,267425400,4,0,0,15872,16,3184605265
5361,267294821,79904,267374725,6,0,0,12800,12,9867694361
5362,267324830,50378,267375208,3,0,0,1536,2,10114931377
5363,267357740,99832,267457572,5,0,0,23040,19,10691212820
5364,267364990,65768,267430758,4,0,0,11776,16,7876749520
5365,267454490,124234,267578724,3,0,0,97792,2,9874539565
5366,267460200,136110,267596310,2,0,0,8192,4,2098398572
5367,267494459,84600,267579059,1,0,0,1024,6,10463918483
5368,267534109,162239,267696348,7,0,0,108544,8,7005770485
5369,267552950,143725,267696675,0,0,0,1024,11,5739832660
5370,267613920,99264,267713184,4,0,0,15360,16,6526857168
5371,267630090,110142,267740232,0,0,0,18432,11,10562258746
5372,267736150,9028,267745178,5,0,1,12800,19,5940007660
5373,267736870,85599,267822469,2,0,0,15360,4,7719859446
5374,267755090,97916,267853006,4,0,0,21504,16,6966012442
5375,267824180,103124,267927304,9,0,0,37376,18,7732885761
5376,267855669,75558,267931227,1,0,0,12800,6,2054004921
5377,267864979,131620,267996599,1,0,0,15360,6,744521407
5378,267924410,64270,267988680,8,0,0,512,12,3134159223
5379,267937400,62672,268000072,3,0,0,6656,2,4886936445
5380,267942740,6278,267949018,4,0,1,6656,16,10627740063
5381,267963890,2946,267966836,7,0,1,3072,8,97223407
5382,267975130,163145,268138275,2,0,0,1024,4,8754457871
5383,268021339,74360,268095699,7,0,0,9728,8,5620789668
5384,268044430,123059,268167489,2,0,0,47616,4,8678180184
5385,268063890,116718,268180608,2,0,0,43008,4,5533723929
5386,268077760,3645,268081405,9,0,1,10240,18,1777588508
5387,268142750,99900,268242650,8,0,0,17408,12,2403661829
5388,268145200,115121,268260321,4,0,0,14848,16,2390160675
5389,268261540,101504,268363044,4,0,0,33280,16,4847956500
5390,268274370,11533,268285903,6,0,1,18944,12,7110194612
5391,268413460,141094,268554554,5,0,0,41984,19,2929799542
5392,268422051,89900,268511951,6,0,0,15360,12,4873636348
5393,268426920,128608,268555528,0,0,0,2560,11,7977780363
5394,268445790,118177,268563967,0,0,0,27648,11,6623523402
5395,268455980,120763,268576743,4,0,0,9216,16,10650472779
5396,268477199,77526,268554725,1,0,0,512,6,3805315832
5397,268512460,128717,268641177,2,0,0,17920,4,5384477014
5398,268545760,76549,268622309,4,0,0,7680,16,1258262570
5399,268570679,104709,268675388,7,0,0,41984,8,2636016099
5400,268580120,197856,268777976,8,0,0,23552,12,9773396156
5401,268605300,128834,268734134,2,0,0,16896,4,3414495
5402,268607070,3387,268610457,1,0,1,9728,6,7731548786
5403,268627460,125448,268752908,9,0,0,16896,18,6845527550
5404,268643021,110682,268753703,6,0,0,2560,12,10307279049
5405,268739920,1518,268741438,6,0,1,1536,12,936528172
5406,268759249,114608,268873857,7,0,0,76288,8,8160229472
5407,268984170,62516,269046686,0,0,0,6144,11,8301549856
5408,268998049,45596,269043645,1,0,0,1024,6,3747058663
5409,269048680,97760,269146440,2,0,0,20992,4,7193460502
5410,269174470,59132,269233602,3,0,0,5120,2,4699326564
5411,269192240,69596,269261836,0,0,0,9216,11,6150082029
5412,269216830,52520,269269350,0,0,0,3584,11,7136605047
5413,269287070,48980,269336050,3,0,0,2048,2,1054446132
5414,269327670,56372,269384042,4,0,0,6144,16,3469317367
5415,269348770,4937,269353707,1,0,1,12800,6,3304427344
5416,269405760,2470,269408230,5,0,1,2560,19,10409005509
5417,269434440,2870,269437310,4,0,1,8704,16,4397952710
5418,269529650,1518,269531168,1,0,1,1536,6,7611369776
5419,269677311,98540,269775851,6,0,0,23552,12,4595088945
5420,269692129,118846,269810975,7,0,0,12800,8,3835316033
5421,269719430,47288,269766718,2,0,0,1536,4,4517682592
5422,269726159,121956,269848115,7,0,0,16896,8,458354589
5423,269737080,105872,269842952,2,0,0,47616,4,4182546121
5424,269756010,118946,269874956,3,0,0,26624,2,5752526787
5425,269812850,159586,269972436,0,0,0,11776,11,3371757222
5426,269852041,116792,269968833,6,0,0,83456,12,1464616717
5427,269856480,119073,269975553,4,0,0,9728,16,718647680
5428,269856639,2870,269859509,8,0,1,8704,12,5050651379
5429,270039570,2470,270042040,9,0,1,2560,18,4676849734
5430,270045730,101192,270146922,0,0,0,32256,11,3955399088
5431,270054760,1042,270055802,9,0,1,1024,18,6395513496
5432,270073990,111020,270185010,9,0,0,64512,18,6868413431
5433,270174509,12011,270186520,8,0,1,1536,12,9068923380
5434,270185980,116012,270301992,5,0,0,80896,19,8437398762
5435,270198390,148848,270347238,5,0,0,26624,19,10524808706
5436,270280510,79694,270360204,0,0,0,7168,11,3444118874
5437,270371710,6278,270377988,1,0,1,6656,6,1877490247
5438,270499951,98696,270598647,6,0,0,24064,12,3941362224
5439,270530530,101579,270632109,0,0,0,11776,11,1006027060
5440,270574220,93752,270667972,9,0,0,17920,18,8714990238
5441,270650140,78056,270728196,0,0,0,11776,11,2213074461
5442,270787610,103220,270890830,0,0,0,38912,11,9677179082
5443,270857159,61079,270918238,1,0,0,5632,6,10177577826
5444,270912440,79148,270991588,3,0,0,15360,2,3008490102
5445,271012380,108212,271120592,8,0,0,55296,12,2306969751
5446,271042090,168010,271210100,5,0,0,64512,19,4505008321
5447,271101969,112982,271214951,7,0,0,15872,8,2720055072
5448,271111720,106678,271218398,5,0,0,11264,19,2760040000
5449,271211929,9407,271221336,3,0,1,3072,2,948660775
5450,271226840,4374,271231214,5,0,1,4608,19,8610780693
5451,271263681,86408,271350089,6,0,0,24064,12,9113076772
5452,271290610,92605,271383215,2,0,0,5632,4,4911418157
5453,271357740,107417,271465157,8,0,0,46592,12,5948393981
5454,271373750,140631,271514381,3,0,0,61952,2,7288280097
5455,271386420,217865,271604285,8,0,0,57344,12,6220161144
5456,271397460,181211,271578671,3,0,0,39936,2,7064825872
5457,271425920,6278,271432198,4,0,1,6656,16,10585755749
5458,271532710,96253,271628963,4,0,0,6144,16,2852084194
5459,271595550,108515,271704065,5,0,0,27648,19,8602971404
5460,271645230,6754,271651984,7,0,1,7168,8,4932640769
5461,271723060,74828,271797888,8,0,0,11264,12,5877796427
5462,271768270,94844,271863114,8,0,0,21504,12,10667911677
5463,271866860,2470,271869330,5,0,1,2560,19,6393329748
5464,271878030,107688,271985718,8,0,0,20992,12,10077269212
5465,272177379,54056,272231435,1,0,0,3584,6,4166318786
5466,272247400,82820,272330220,2,0,0,12288,4,594417638
5467,272297900,1518,272299418,6,0,1,1536,12,269913552
5468,272302419,90704,272393123,1,0,0,23040,6,7324363787
5469,272356759,127822,272484581,7,0,0,95232,8,1285273612
5470,272360560,125908,272486468,9,0,0,6144,18,7118387404
5471,272421331,91732,272513063,6,0,0,8704,12,6250419397
5472,272648799,50672,272699471,7,0,0,2560,8,7528492216
5473,272656400,1042,272657442,4,0,1,1024,16,10438963140
5474,272868709,124436,272993145,1,0,0,108544,6,1895053871
5475,272905479,4850,272910329,3,0,1,5120,2,9658015752
5476,272945020,145622,273090642,9,0,0,32256,18,8583002908
5477,272951050,88700,273039750,8,0,0,21504,12,8914021932
5478,273030010,76052,273106062,3,0,0,10240,2,5445757578
5479,273067920,47288,273115208,0,0,0,1536,11,3605769126
5480,273166929,56840,273223769,1,0,0,7680,6,10501950004
5481,273171690,92528,273264218,0,0,0,18944,11,4476513793
5482,273251990,101972,273353962,0,0,0,34816,11,6992546931
5483,273256899,7334,273264233,8,0,1,2560,12,6322755388
5484,273275410,7230,273282640,4,0,1,7680,16,10537808453
5485,273312451,105092,273417543,6,0,0,45056,12,8324176801
5486,273387360,124748,273512108,0,0,0,109568,11,892079189
5487,273407661,141875,273549536,6,0,0,18432,12,3095689322
5488,273450820,112984,273563804,8,0,0,14848,12,6209382649
5489,273492420,147182,273639602,2,0,0,55808,4,28769967
5490,273574380,78836,273653216,4,0,0,14336,16,3717132074
5491,273624780,81026,273705806,9,0,0,8192,18,5935067408
5492,273676110,50672,273726782,2,0,0,2560,4,6151198699
5493,273708640,67592,273776232,5,0,0,7680,19,103424993
5494,273749639,131443,273881082,1,0,0,118784,6,10204911163
5495,273768311,136963,273905274,6,0,0,36864,12,136897772
5496,273930760,84512,274015272,0,0,0,12800,11,75388965
5497,273976120,72536,274048656,4,0,0,13824,16,9510884715
5498,273978200,106852,274085052,9,0,0,12288,18,4483339613
5499,274002091,105299,274107390,6,0,0,18944,12,2403169064
5500,274010190,75501,274085691,0,0,0,2048,11,1156342477
5501,274072510,54338,274126848,4,0,0,1024,16,2148412260
5502,274083879,95607,274179486,1,0,0,16384,6,2360184272
5503,274113150,45596,274158746,2,0,0,1024,4,2502485949
5504,274180820,104780,274285600,4,0,0,44032,16,3954059322
5505,274205190,82876,274288066,0,0,0,5632,11,8859223803
5506,274228810,57117,274285927,2,0,0,1024,4,9455201696
5507,274241200,129744,274370944,4,0,0,49664,16,7525823958
5508,274387220,104780,274492000,4,0,0,44032,16,1361838229
5509,274391181,129307,274520488,6,0,0,26624,12,8605324742
5510,274394510,165380,274559890,3,0,0,3584,2,6185924806
5511,274401270,1042,274402312,9,0,1,1024,18,8021453348
5512,274451140,98466,274549606,8,0,0,5120,12,5898678463
5513,274494959,140789,274635748,7,0,0,24576,8,4458934449
5514,274528950,84824,274613774,2,0,0,13824,4,5268613436
5515,274574401,102271,274676672,6,0,0,22528,12,7043942443
5516,274656159,1518,274657677,3,0,1,1536,2,4989298286
5517,274721469,2470,274723939,3,0,1,2560,2,665601825
5518,274765840,104156,274869996,9,0,0,41984,18,8130140425
5519,274830379,22950,274853329,8,0,1,37888,12,4302873587
5520,274844361,146091,274990452,6,0,0,25088,12,9992730513
5521,275016060,45596,275061656,2,0,0,1024,4,3676578848
5522,275100410,104936,275205346,5,0,0,44544,19,2806744609
5523,275134180,120960,275255140,4,0,0,75776,16,9933066856
5524,275147450,144874,275292324,9,0,0,57856,18,1777267926
5525,275173360,13600,275186960,9,0,1,23040,18,723719599
5526,275186280,4374,275190654,4,0,1,4608,16,500617102
5527,275193801,148612,275342413,6,0,0,2048,12,7033898965
5528,275211100,1994,275213094,6,0,1,2048,12,2028809757
5529,275226270,109918,275336188,8,0,0,16896,12,2416150610
5530,275243850,166960,275410810,5,0,0,69120,19,8377016023
5531,275318729,100850,275419579,1,0,0,7168,6,6346929553
5532,275333050,128169,275461219,3,0,0,43008,2,6687432649
5533,275409760,121750,275531510,2,0,0,39424,4,9236032636
5534,275410750,10318,275421068,1,0,1,16384,6,5540629395
5535,275605489,86204,275691693,7,0,0,13312,8,9812191713
5536,275607219,199763,275806982,1,0,0,7168,6,8765716107
5537,275620229,4420,275624649,8,0,1,11776,12,2795671411
5538,275668190,5326,275673516,2,0,1,5632,4,7146835884
5539,275685500,91756,275777256,4,0,0,18432,16,10240558083
5540,275686420,102509,275788929,2,0,0,32768,4,5469359810
5541,275711530,104420,275815950,4,0,0,8192,16,6774387387
5542,275720760,175520,275896280,8,0,0,77312,12,2331233031
5543,275790960,53649,275844609,2,0,0,1536,4,5191125580
5544,275863940,82820,275946760,8,0,0,12288,12,1352254304
5545,275876060,109380,275985440,9,0,0,23040,18,9846793922
5546,275938880,99032,276037912,0,0,0,30208,11,5039392514
5547,275959380,15837,275975217,2,0,1,30720,4,10679158943
5548,275990370,92165,276082535,5,0,0,6656,19,2440627806
5549,276040390,91304,276131694,8,0,0,19968,12,8346908817
5550,276051389,108852,276160241,1,0,0,28672,6,4016547015
5551,276061280,112228,276173508,2,0,0,19968,4,99016321
5552,276109091,110880,276219971,6,0,0,16896,12,9828517079
5553,276148030,117878,276265908,4,0,0,23552,16,5151200190
5554,276159650,88479,276248129,2,0,0,13824,4,8467323774
5555,276178050,89277,276267327,5,0,0,4608,19,6326107831
5556,276253269,81927,276335196,1,0,0,11776,6,1114507343
5557,276309631,106259,276415890,6,0,0,48640,12,5403391544
5558,276330550,4661,276335211,2,0,1,4608,4,1712463051
5559,276415780,164251,276580031,2,0,0,8704,4,4890252633
5560,276580730,94556,276675286,9,0,0,25600,18,3048917930
5561,276641220,70976,276712196,5,0,0,8704,19,2484874050
5562,276644120,10757,276654877,7,0,1,17408,8,10086496930
5563,276934170,84224,277018394,5,0,0,16896,19,7089173812
5564,276975290,13341,276988631,1,0,1,22528,6,4404004685
5565,277012020,97471,277109491,8,0,0,26112,12,715573865
5566,277021901,132447,277154348,6,0,0,26112,12,3199347067
5567,277116589,137023,277253612,7,0,0,52224,8,1692157969
5568,277118080,4374,277122454,7,0,1,4608,8,5341042049
5569,277155530,70062,277225592,5,0,0,5632,19,9851364857
5570,277308049,95936,277403985,1,0,0,25088,6,3586929217
5571,277313810,109603,277423413,5,0,0,8192,19,4890301508
5572,277570250,6754,277577004,2,0,1,7168,4,6968983453
5573,277638889,1042,277639931,8,0,1,1024,12,6983788034
5574,277660000,122720,277782720,8,0,0,102912,12,87543313
5575,277719101,131065,277850166,6,0,0,18432,12,7900219242
5576,277753160,30118,277783278,6,0,1,512,12,3487839695
5577,277803601,85727,277889328,6,0,0,9728,12,7102895757
5578,277867060,78056,277945116,9,0,0,11776,18,10678907801
5579,277893070,73916,277966986,3,0,0,13312,2,9223348052
5580,277955179,3898,277959077,3,0,1,4096,2,1093747768
5581,277963030,9402,277972432,2,0,1,13824,4,6180286666
5582,278031200,7706,278038906,1,0,1,8192,6,10522596247
5583,278075191,50672,278125863,6,0,0,2560,12,2620548215
5584,278082239,13341,278095580,8,0,1,22528,12,8431710550
5585,278185760,53300,278239060,5,0,0,6144,19,1657059482
5586,278192960,137328,278330288,8,0,0,4096,12,10567483075
5587,278230310,129978,278360288,3,0,0,47104,2,3806194198
5588,278230950,4374,278235324,4,0,1,4608,16,8154822484
5589,278305149,7230,278312379,8,0,1,7680,12,689294354
5590,278444630,77744,278522374,9,0,0,10752,18,6921351142
5591,278470409,75011,278545420,1,0,0,4608,6,6901214714
5592,278508670,99632,278608302,2,0,0,27136,4,9215873368
5593,278652170,104624,278756794,9,0,0,43520,18,5156135761
5594,278713740,101902,278815642,9,0,0,32768,18,2106362848
5595,278881480,47288,278928768,9,0,0,1536,18,2933909742
5596,278942000,55748,278997748,3,0,0,4096,2,2653755473
5597,278974860,93737,279068597,9,0,1,155648,18,3412423955
5598,279081250,255456,279336706,8,0,0,78848,12,5743284913
5599,279150420,79436,279229856,0,0,0,11264,11,5281229794
5600,279242950,6754,279249704,2,0,1,7168,4,4030798156
5601,279260469,4937,279265406,3,0,1,12800,2,6674232175
5602,279264410,136488,279400898,5,0,0,39936,19,8900695498
5603,279266430,7706,279274136,5,0,1,8192,19,2711189105
5604,279296170,238941,279535111,5,0,0,85504,19,7631430674
5605,279314920,86617,279401537,0,0,0,2048,11,10310594679
5606,279342160,83450,279425610,3,0,0,5120,2,6244240129
5607,279376270,103376,279479646,2,0,0,39424,4,10695052293
5608,279396119,108457,279504576,1,0,0,9216,6,7777500999
5609,279406300,84872,279491172,8,0,0,512,12,6726655407
5610,279430380,164365,279594745,3,0,0,53248,2,9542637366
5611,279464110,82820,279546930,5,0,0,12288,19,10224845275
5612,279516430,25427,279541857,5,0,1,7168,19,9369818196
5613,279546420,12035,279558455,5,0,1,18944,19,1112407899
5614,279555249,3904,279559153,8,0,1,10752,12,5090842185
5615,279605520,1518,279607038,2,0,1,1536,4,7198899546
5616,279634979,51400,279686379,1,0,0,1536,6,4876262496
5617,279674820,48980,279723800,0,0,0,2048,11,8258078213
5618,279701790,79225,279781015,0,0,0,4096,11,10566364808
5619,279791709,111956,279903665,1,0,0,67584,6,5022334616
5620,279835500,137159,279972659,4,0,0,66048,16,3863805567
5621,279866420,52364,279918784,2,0,0,3072,4,5703265630
5622,279872160,4679,279876839,1,0,1,12288,6,2751596214
5623,279921120,98951,280020071,8,0,0,7680,12,498579167
5624,280077510,57908,280135418,3,0,0,6144,2,8888444371
5625,280079080,64464,280143544,0,0,0,6656,11,9785249807
5626,280121690,1042,280122732,5,0,1,1024,19,5830227364
5627,280135329,3979,280139308,3,0,1,4096,2,7578749135
5628,280236490,103064,280339554,3,0,0,38400,2,3815873697
5629,280289210,97496,280386706,5,0,0,30208,19,1595624483
5630,280321030,25187,280346217,9,0,1,45568,18,5393476090
5631,280393950,113679,280507629,8,0,0,32768,12,8815976622
5632,280407410,147967,280555377,9,0,0,28160,18,4014871725
5633,280482001,99788,280581789,6,0,0,27648,12,6595230805
5634,280515560,141151,280656711,5,0,0,45568,19,683497255
5635,280537720,167987,280705707,2,0,0,45056,4,4200773459
5636,280565780,43904,280609684,0,0,0,512,11,4332803225
5637,280719259,110864,280830123,1,0,0,64000,6,5100777643
5638,280833330,64208,280897538,9,0,0,6656,18,8974872489
5639,280936630,59600,280996230,2,0,0,6656,4,533823069
5640,280951139,3422,280954561,3,0,1,3584,2,5170643498
5641,280963670,47288,281010958,8,0,0,1536,12,7257159438
5642,281048390,57440,281105830,3,0,0,4608,2,8645609924
5643,281089420,69284,281158704,5,0,0,8192,19,8802958433
5644,281154690,33762,281188452,9,0,1,58880,18,3085204351
5645,281162370,54221,281216591,9,0,0,512,18,8408394067
5646,281241800,45596,281287396,2,0,0,1024,4,2503353577
5647,281259430,4374,281263804,7,0,1,4608,8,4520837961
5648,281292130,100724,281392854,9,0,0,30720,18,4281903427
5649,281319490,144050,281463540,8,0,0,29696,12,4087885750
5650,281324040,3422,281327462,6,0,1,3584,12,3795713238
5651,281495169,3128,281498297,3,0,1,9216,2,1837611767
5652,281544010,134060,281678070,4,0,0,7168,16,6042338786
5653,281611410,154374,281765784,3,0,0,67072,2,4884633805
5654,281628550,112264,281740814,2,0,0,54272,4,8204242799
5655,281629391,159404,281788795,6,0,0,9216,12,854229720
5656,281683520,1518,281685038,1,0,1,1536,6,818494707
5657,281731520,82422,281813942,8,0,0,10752,12,9450410602
5658,281879720,48980,281928700,4,0,0,2048,16,594327124
5659,281911480,2470,281913950,2,0,1,2560,4,9656349978
5660,281926580,168737,282095317,8,0,0,16896,12,2352028147
5661,282001930,51452,282053382,8,0,0,5120,12,7464767640
5662,282043189,111806,282154995,7,0,0,49152,8,6864033918
5663,282043530,125556,282169086,8,0,0,3584,12,4456861631
5664,282047820,120159,282167979,0,0,0,12800,11,2346355821
5665,282055060,3898,282058958,6,0,1,4096,12,9515053745
5666,282112501,110820,282223321,6,0,0,46592,12,1945303106
5667,282187591,105488,282293079,6,0,0,12800,12,5091404929
5668,282219709,88740,282308449,7,0,0,14848,8,3666053467
5669,282282500,101192,282383692,5,0,0,32256,19,9902649879
5670,282306980,87713,282394693,3,0,0,23552,2,7597747429
5671,282308380,77979,282386359,2,0,0,8704,4,4955130765
5672,282335240,145676,282480916,4,0,0,81920,16,8353392379
5673,282404220,142090,282546310,0,0,0,33280,11,10598790182
5674,282412190,93596,282505786,2,0,0,6144,4,885109216
5675,282468780,101752,282570532,4,0,0,15872,16,9104808407
5676,282520421,43904,282564325,6,0,0,512,12,10195361671
5677,282541710,104692,282646402,4,0,0,28672,16,5699949606
5678,282624020,109148,282733168,8,0,0,58368,12,5873188409
5679,282690170,79076,282769246,4,0,0,14336,16,2014465164
5680,282799390,43904,282843294,2,0,0,512,4,6682751526
5681,282807920,74984,282882904,0,0,0,11776,11,8003813944
5682,282861440,13253,282874693,1,0,1,25600,6,4808162459
5683,282889679,93932,282983611,1,0,0,23552,6,7425440716
5684,282908270,113817,283022087,4,0,0,15360,16,8437772110
5685,282935529,102410,283037939,7,0,0,22016,8,4393913004
5686,282962960,108381,283071341,4,0,0,29696,16,7966903269
5687,282995690,26412,283022102,6,0,1,41984,12,1250219365
5688,283006770,96829,283103599,4,0,0,1024,16,2158183323
5689,283121330,121365,283242695,5,0,0,18432,19,7163852896
5690,283190129,3904,283194033,3,0,1,10752,2,7659040604
5691,283194930,102284,283297214,8,0,0,8704,12,145270638
5692,283223450,240328,283463778,4,0,0,38400,16,3392175460
5693,283291801,177452,283469253,6,0,0,17920,12,9333124862
5694,283337620,48980,283386600,3,0,0,2048,2,3699365553
5695,283378520,108212,283486732,9,0,0,55296,18,4182670727
5696,283458361,73400,283531761,6,0,0,6144,12,7991810755
5697,283649729,102284,283752013,1,0,0,35840,6,7226300806
5698,283658600,101384,283759984,4,0,0,26112,16,8502752247
5699,283704979,135066,283840045,7,0,0,25088,8,8141029007
5700,283718530,96594,283815124,8,0,0,25088,12,185141547
5701,283801690,89937,283891627,5,0,0,11776,19,4480126370
5702,283806440,93284,283899724,3,0,0,16384,2,8153471230
5703,283834690,83091,283917781,5,0,0,10752,19,3284186561
5704,283838050,85944,283923994,2,0,0,9216,4,1022871026
5705,283854799,7706,283862505,3,0,1,8192,2,9287413784
5706,283923050,103844,284026894,9,0,0,37888,18,9407916344
5707,283930870,99895,284030765,0,0,0,4096,11,2954712316
5708,283959969,107263,284067232,7,0,0,17920,8,7217061419
5709,284024400,8764,284033164,7,0,1,6656,8,8438676645
5710,284164530,54836,284219366,8,0,0,6144,12,2866456314
5711,284196180,99320,284295500,8,0,0,26112,12,9376496374
5712,284201130,85604,284286734,3,0,0,16384,2,4088439941
5713,284257290,2870,284260160,4,0,1,8704,16,8782313946
5714,284279020,108226,284387246,0,0,0,46592,11,3214838907
5715,284319690,3898,284323588,7,0,1,4096,8,9598779348
5716,284351630,566,284352196,7,0,1,512,8,496553870
5717,284380830,98180,284479010,3,0,0,21504,2,2975784721
5718,284406061,159406,284565467,6,0,0,1536,12,8058287411
5719,284420480,144504,284564984,8,0,0,70656,12,1294566907
5720,284520861,86747,284607608,6,0,0,6656,12,1329324048
5721,284556170,155070,284711240,4,0,0,47104,16,4120149985
5722,284563509,7777,284571286,8,0,1,6144,12,4819335633
5723,284570070,60824,284630894,8,0,0,5632,12,5934848105
5724,284579489,2946,284582435,3,0,1,3072,2,8333806624
5725,284601690,93128,284694818,4,0,0,15872,16,9672448699
5726,284689620,78935,284768555,4,0,0,5120,16,8439632404
5727,284700000,66980,284766980,2,0,0,4096,4,4970845838
5728,284710139,102778,284812917,1,0,0,33792,6,4030689970
5729,284733320,30749,284764069,9,0,1,49664,18,4387327943
5730,284819460,61183,284880643,3,0,0,5632,2,3909256619
5731,284940389,1518,284941907,8,0,1,1536,12,9187050753
5732,284988190,21916,285010106,9,0,1,35840,18,7836429521
5733,284996141,48614,285044755,6,0,0,1024,12,2579280535
5734,285352250,50828,285403078,9,0,0,3072,18,1747333887
5735,285383550,69908,285453458,0,0,0,10240,11,2477125787
5736,285394709,97916,285492625,7,0,0,21504,8,5676937307
5737,285458800,54368,285513168,9,0,0,4608,18,4400953788
5738,285511690,108230,285619920,3,0,0,55296,2,615420532
5739,285524380,102739,285627119,4,0,0,23552,16,10490754314
5740,285548719,152939,285701658,1,0,0,69120,6,868994807
5741,285604309,133739,285738048,7,0,0,26112,8,10219053353
5742,285624270,185580,285809850,0,0,0,33792,11,4840072730
5743,285767230,96512,285863742,4,0,0,16896,16,9655871388
5744,285821111,132841,285953952,6,0,0,84992,12,3407561771
5745,285860450,114988,285975438,4,0,0,8192,16,7347282083
5746,285862380,107479,285969859,3,0,0,4608,2,5464661805
5747,285901610,53293,285954903,4,0,0,3072,16,430491456
5748,285984010,4374,285988384,2,0,1,4608,4,1219693752
5749,286029810,102596,286132406,4,0,0,36864,16,7473450825
5750,286043850,147536,286191386,0,0,0,69120,11,4500616184
5751,286104360,3898,286108258,7,0,1,4096,8,7268022746
5752,286168670,22731,286191401,1,0,1,11776,6,10493227404
5753,286267189,129836,286397025,1,0,0,13312,6,3301966835
5754,286281230,77744,286358974,2,0,0,10752,4,909901894
5755,286283360,65300,286348660,2,0,0,10240,4,9461364757
5756,286286720,74360,286361080,4,0,0,5632,16,6271120692
5757,286295461,82820,286378281,6,0,0,12288,12,7792061405
5758,286374951,88794,286463745,6,0,0,20992,12,8780866251
5759,286433741,60824,286494565,6,0,0,5632,12,10569129001
5760,286457690,88867,286546557,3,0,0,12288,2,4440334565
5761,286464870,196020,286660890,9,0,1,321536,18,2555621771
5762,286525379,295430,286820809,1,0,0,84480,6,3086451765
5763,286633730,393199,287026929,3,0,0,79360,2,6793028980
5764,286703680,51257,286754937,9,0,1,82944,18,4765806631
5765,286720440,400077,287120517,4,0,0,90112,16,7701936534
5766,286747360,135001,286882361,4,0,0,8704,16,2250495979
5767,286765950,7706,286773656,2,0,1,8192,4,2273163394
5768,286811140,155403,286966543,3,0,0,55296,2,5397277157
5769,286848411,126670,286975081,6,0,0,1536,12,7965340968
5770,286954250,176193,287130443,0,0,0,23040,11,5579108334
5771,286978580,144136,287122716,4,0,0,7168,16,3828369891
5772,287014590,150526,287165116,2,0,0,17408,4,4253057790
5773,287060550,6278,287066828,2,0,1,6656,4,8913573915
5774,287135410,86540,287221950,8,0,0,19456,12,1395646183
5775,287143130,135710,287278840,0,0,0,15360,11,10639168741
5776,287154480,102128,287256608,2,0,0,35328,4,10157909504
5777,287272919,58688,287331607,1,0,0,8704,6,3342931286
5778,287297649,105604,287403253,1,0,0,15872,6,6359699005
5779,287411910,81128,287493038,4,0,0,11776,16,316283779
5780,287428790,14804,287443594,6,0,1,28672,12,8506917991
5781,287533729,97628,287631357,1,0,0,25600,6,4211971403
5782,287581649,54056,287635705,1,0,0,3584,6,8764543971
5783,287590439,3898,287594337,8,0,1,4096,12,1520511656
5784,287638049,3128,287641177,3,0,1,9216,2,2761487345
5785,287695600,102496,287798096,9,0,0,17920,18,10454554518
5786,287712609,2946,287715555,3,0,1,3072,2,1241125817
5787,287802779,1042,287803821,8,0,1,1024,12,739972387
5788,287836629,103376,287940005,1,0,0,39424,6,6648824493
5789,287843390,64947,287908337,3,0,0,1024,2,3569625522
5790,287855740,90988,287946728,0,0,0,22016,11,5362387303
5791,287861430,129720,287991150,0,0,0,17408,11,9124088911
5792,287936900,150856,288087756,4,0,0,106496,16,7608245949
5793,287937661,252107,288189768,6,0,0,30720,12,532705334
5794,287996730,152552,288149282,0,0,0,10752,11,570078100
5795,288002820,233708,288236528,0,0,0,69120,11,9349907248
5796,288015900,101348,288117248,9,0,0,32768,18,8842047352
5797,288080699,170992,288251691,7,0,0,49664,8,8051109613
5798,288172280,79894,288252174,4,0,0,1536,16,3400629652
5799,288175921,82967,288258888,6,0,0,1024,12,4372943781
5800,288191110,4679,288195789,6,0,1,12288,12,10550291279
5801,288211040,98696,288309736,9,0,0,24064,18,10458955508
5802,288216651,95596,288312247,6,0,0,8192,12,2880405645
5803,288219201,95565,288314766,6,0,0,8192,12,3355758791
5804,288247190,85856,288333046,4,0,0,8704,16,6660793841
5805,288284850,61650,288346500,2,0,0,3584,4,7981743596
5806,288308769,96045,288404814,7,0,0,17408,8,2540784290
5807,288396430,60824,288457254,0,0,0,5632,11,9762074221
5808,288397749,62516,288460265,7,0,0,6144,8,4785116030
5809,288438530,5326,288443856,6,0,1,5632,12,2631605346
5810,288467970,95756,288563726,4,0,0,19456,16,280881761
5811,288480970,566,288481536,5,0,1,512,19,5802610576
5812,288562690,5448,288568138,5,0,1,11776,19,9750379234
5813,288568880,51296,288620176,4,0,0,4608,16,4534179417
5814,288605520,85864,288691384,4,0,0,9216,16,1510122667
5815,288656241,69409,288725650,6,0,0,4608,12,7664520875
5816,288658540,566,288659106,2,0,1,512,4,9901078849
5817,288671049,1518,288672567,8,0,1,1536,12,8683221801
5818,288682520,55748,288738268,3,0,0,4096,2,1852626511
5819,288691489,63687,288755176,1,0,0,4608,6,6747849945
5820,288696470,93506,288789976,0,0,0,23040,11,2965314442
5821,288771460,3898,288775358,1,0,1,4096,6,1902917442
5822,288809461,101192,288910653,6,0,0,32256,12,365994273
5823,288812700,1994,288814694,6,0,1,2048,12,5524010671
5824,288830350,1518,288831868,2,0,1,1536,4,4080332990
5825,288867429,198899,289066328,1,0,0,126976,6,7655767415
5826,288954720,14804,288969524,9,0,1,28672,18,3262455279
5827,288971060,1518,288972578,4,0,1,1536,16,9845174778
5828,288980359,87100,289067459,7,0,0,3584,8,2633219272
5829,289038600,40351,289078951,7,0,1,18944,8,5370135586
5830,289054811,74370,289129181,6,0,0,4096,12,9024017918
5831,289055930,118496,289174426,0,0,0,54784,11,3196999037
5832,289079640,5802,289085442,5,0,1,6144,19,8912404281
5833,289097460,109510,289206970,3,0,0,3072,2,6983826169
5834,289111950,131532,289243482,9,0,0,28672,18,4883641196
5835,289122870,3904,289126774,2,0,1,10752,4,6248627741
5836,289174520,151216,289325736,4,0,0,70656,16,1739217468
5837,289234290,111527,289345817,4,0,0,31232,16,8244441333
5838,289286399,1518,289287917,8,0,1,1536,12,6733200719
5839,289323940,97076,289421016,9,0,0,17920,18,308525788
5840,289326239,143199,289469438,7,0,0,4096,8,8579118991
5841,289600410,87788,289688198,3,0,0,23552,2,1470548779
5842,289738919,13083,289752002,3,0,1,22016,2,1047539607
5843,289778160,4420,289782580,1,0,1,11776,6,3883276071
5844,289804260,2946,289807206,7,0,1,3072,8,707022556
5845,289850210,1994,289852204,2,0,1,2048,4,10454135712
5846,289914611,99788,290014399,6,0,0,27648,12,2476951565
5847,289937880,4420,289942300,6,0,1,11776,12,2184290711
5848,290014859,161194,290176053,7,0,0,65024,8,6579587903
5849,290041510,111939,290153449,4,0,0,7680,16,8155075688
5850,290159120,69757,290228877,9,0,0,4608,18,3149399900
5851,290271100,79436,290350536,3,0,0,11264,2,9427750748
5852,290454209,90104,290544313,7,0,0,26112,8,1706977030
5853,290507390,93932,290601322,0,0,0,23552,11,799249283
5854,290511750,2470,290514220,5,0,1,2560,19,8330478115
5855,290524720,566,290525286,1,0,1,512,6,2394687015
5856,290530101,85792,290615893,6,0,0,11776,12,7641538759
5857,290559649,2946,290562595,3,0,1,3072,2,9153686486
5858,290615830,99999,290715829,0,0,0,28160,11,9016697817
5859,290639471,138716,290778187,6,0,0,19968,12,10259804113
5860,290750360,93911,290844271,3,0,0,12800,2,7230349036
5861,290886459,97916,290984375,7,0,0,21504,8,9762381852
5862,290914100,94077,291008177,3,0,0,12800,2,4647744929
5863,290929430,202641,291132071,0,0,0,90624,11,2366963279
5864,290935510,136735,291072245,9,0,0,81920,18,560831764
5865,291050960,119193,291170153,2,0,0,21504,4,7563223541
5866,291058760,130251,291189011,2,0,0,6656,4,3521434653
5867,291112960,81331,291194291,0,0,0,10240,11,4143533493
5868,291153800,49089,291202889,9,0,0,2048,18,8771193935
5869,291169789,126898,291296687,7,0,0,81920,8,2568753458
5870,291200310,98429,291298739,4,0,0,5120,16,4880290691
5871,291271321,88648,291359969,6,0,0,18432,12,4390959431
5872,291344760,77744,291422504,4,0,0,10752,16,10006070178
5873,291366510,62516,291429026,9,0,0,6144,18,1278481480
5874,291558970,2946,291561916,4,0,1,3072,16,7671943780
5875,291612590,100256,291712846,9,0,0,29184,18,9814872967
5876,291730420,20624,291751044,5,0,1,33280,19,10321719064
5877,291758150,137335,291895485,3,0,0,46080,2,4294699801
5878,291823810,182907,292006717,3,0,0,82944,2,2060405483
5879,291882981,130636,292013617,6,0,0,14848,12,8831875882
5880,292111590,83288,292194878,0,0,0,13824,11,5878587995
5881,292120280,139752,292260032,4,0,0,110592,16,2014901382
5882,292134620,127767,292262387,0,0,0,7680,11,228136702
5883,292137009,132577,292269586,1,0,0,23552,6,238045794
5884,292233639,89564,292323203,7,0,0,5632,8,1152822531
5885,292291770,121160,292412930,4,0,0,97792,16,5448844836
5886,292331431,156142,292487573,6,0,0,57344,12,10474508768
5887,292352660,117426,292470086,0,0,0,20992,11,6124446605
5888,292431580,118822,292550402,9,0,0,35328,18,223523154
5889,292494399,6754,292501153,8,0,1,7168,12,2072698916
5890,292628969,62516,292691485,1,0,0,6144,6,6567895232
5891,292632480,45596,292678076,3,0,0,1024,2,7276295029
5892,292656260,76988,292733248,9,0,0,13312,18,2773765643
5893,292673829,128383,292802212,1,0,0,78336,6,4888479152
5894,292755139,12308,292767447,8,0,1,20480,12,666776533
5895,292758869,49847,292808716,1,0,0,1536,6,5193158134
5896,292769840,127970,292897810,9,0,0,60928,18,9959845315
5897,292778291,43904,292822195,6,0,0,512,12,10452647395
5898,292788330,160565,292948895,0,0,0,75264,11,543300616
5899,292793950,114259,292908209,0,0,0,6144,11,381632723
5900,292796570,162016,292958586,3,0,0,3584,2,8610072532
5901,292811581,142789,292954370,6,0,0,17920,12,10073476772
5902,293025390,48980,293074370,3,0,0,2048,2,461713096
5903,293060210,67592,293127802,2,0,0,7680,4,4993130607
5904,293081810,12566,293094376,5,0,1,20992,19,857112340
5905,293089599,103064,293192663,1,0,0,38400,6,6629640315
5906,293109560,102604,293212164,4,0,0,25600,16,8898761002
5907,293137480,2470,293139950,2,0,1,2560,4,1792131522
5908,293183290,120229,293303519,9,0,0,64000,18,6220375629
5909,293320030,64520,293384550,0,0,0,7680,11,5341335036
5910,293385560,3128,293388688,0,0,1,9216,11,2926633938
5911,293390220,181049,293571269,2,0,0,16384,4,9139671786
5912,293443120,67592,293510712,3,0,0,7680,2,8584629766
5913,293445660,76052,293521712,4,0,0,10240,16,9713408575
5914,293587520,78056,293665576,4,0,0,11776,16,4073556297
5915,293619041,126269,293745310,6,0,0,40448,12,8589092600
5916,293664480,123484,293787964,2,0,0,23040,4,3645938148
5917,293708910,3898,293712808,0,0,1,4096,11,6575461512
5918,293768189,12566,293780755,8,0,1,20992,12,7191838114
5919,293779360,166649,293946009,9,0,0,32768,18,3272370804
5920,293794240,105872,293900112,3,0,0,47616,2,4887379962
5921,293798190,43904,293842094,9,0,0,512,18,1273900231
5922,293828660,159806,293988466,3,0,0,34816,2,1783170195
5923,293978019,87763,294065782,7,0,0,19456,8,8353915017
5924,293989620,3904,293993524,2,0,1,10752,4,6705874706
5925,294094970,56840,294151810,0,0,0,7680,11,3811700344
5926,294106890,107020,294213910,9,0,0,50176,18,1094336086
5927,294176360,47288,294223648,3,0,0,1536,2,2754256163
5928,294200750,14194,294214944,2,0,1,1024,4,3015255073
5929,294317030,167712,294484742,9,0,1,276480,18,5120864213
5930,294376320,278159,294654479,4,0,0,40448,16,2042492666
5931,294392060,176640,294568700,0,0,0,15360,11,6389985327
5932,294437991,186347,294624338,6,0,0,15360,12,6176967762
5933,294559999,205924,294765923,7,0,0,10752,8,3504967979
5934,294579319,140410,294719729,1,0,0,26624,6,10514639379
5935,294606190,76784,294682974,5,0,0,5632,19,2917027220
5936,294732161,59256,294791417,6,0,0,2560,12,8161706797
5937,294847909,101660,294949569,7,0,0,33792,8,4206133185
5938,294851820,74516,294926336,4,0,0,10240,16,4100253579
5939,294881920,69856,294951776,3,0,0,7168,2,9985709735
5940,294936310,109616,295045926,2,0,0,59904,4,7111048213
5941,294942010,11719,294953729,7,0,1,2048,8,6417399447
5942,294983821,204074,295187895,6,0,0,28672,12,8158712696
5943,295002190,147833,295150023,3,0,0,10240,2,7248400799
5944,295004509,102596,295107105,1,0,0,36864,6,1704992150
5945,295082630,53325,295135955,9,0,1,87040,18,4076472212
5946,295108260,58387,295166647,0,0,0,4608,11,5234359876
5947,295159970,237714,295397684,0,0,0,27648,11,7638762008
5948,295162100,164682,295326782,0,0,0,28160,11,8529673057
5949,295163520,153490,295317010,9,0,0,61952,18,6914461038
5950,295287890,99594,295387484,3,0,0,14336,2,6535720640
5951,295452400,105404,295557804,0,0,0,46080,11,3177346558
5952,295498849,118477,295617326,7,0,0,10752,8,7017009298
5953,295510490,4420,295514910,0,0,1,11776,11,3700764660
5954,295531560,71288,295602848,3,0,0,9728,2,9557658219
5955,295561200,122594,295683794,9,0,0,67584,18,10039996526
5956,295600781,108561,295709342,6,0,0,13824,12,8736281287
5957,295601550,170117,295771667,0,0,0,22016,11,3697437332
5958,295611929,138135,295750064,7,0,0,10240,8,10599993269
5959,295623780,7230,295631010,6,0,1,7680,12,1257490575
5960,295690319,52364,295742683,7,0,0,3072,8,401196657
5961,295945960,45908,295991868,4,0,0,2048,16,9768120730
5962,295946540,2470,295949010,4,0,1,2560,16,9073959791
5963,295962010,113672,296075682,2,0,0,73216,4,7189875477
5964,295982870,13083,295995953,2,0,1,22016,4,10608925436
5965,296017191,134979,296152170,6,0,0,24576,12,820631008
5966,296085050,151571,296236621,0,0,0,32256,11,4170438360
5967,296107330,2470,296109800,6,0,1,2560,12,10307700278
5968,296136470,81790,296218260,4,0,0,2048,16,1152083145
5969,296139590,566,296140156,6,0,1,512,12,1025916640
5970,296186410,58532,296244942,0,0,0,8192,11,715385177
5971,296242569,166034,296408603,1,0,0,45568,6,6854282240
5972,296266590,109064,296375654,0,0,0,7680,11,4556417020
5973,296290840,154636,296445476,0,0,0,18944,11,10130008542
5974,296294150,217722,296511872,4,0,0,78336,16,15269116
5975,296332830,88967,296421797,9,0,0,2048,18,7064318242
5976,296405580,3581,296409161,4,0,1,512,16,3423716103
5977,296464189,117502,296581691,7,0,0,50688,8,7803571156
5978,296484099,206793,296690892,1,0,0,50176,6,2752742845
5979,296498660,142729,296641389,0,0,0,12288,11,6297573580
5980,296507619,167970,296675589,1,0,0,33792,6,7478975117
5981,296507691,76667,296584358,6,0,0,8704,12,10541248063
5982,296525109,289902,296815011,1,0,0,81920,6,4467270337
5983,296547720,566,296548286,1,0,1,512,6,10202388105
5984,296555679,167658,296723337,1,0,0,29184,6,2459058598
5985,296605859,128361,296734220,1,0,0,2048,6,4604712936
5986,296669911,90157,296760068,6,0,0,11264,12,3045365720
5987,296744841,71745,296816586,6,0,0,5120,12,4118412833
5988,296755270,6278,296761548,1,0,1,6656,6,10233281485
5989,296824760,64208,296888968,2,0,0,6656,4,4510614217
5990,296847849,124041,296971890,1,0,0,37376,6,7501967284
5991,296867570,4850,296872420,4,0,1,5120,16,8555391630
5992,296918480,116432,297034912,4,0,0,29696,16,1428160951
5993,296953780,1518,296955298,6,0,1,1536,12,10134620942
5994,297039420,55748,297095168,2,0,0,4096,4,8652357419
5995,297122660,57752,297180412,4,0,0,5632,16,4630951612
5996,297147060,71288,297218348,3,0,0,9728,2,7507355692
5997,297193919,65900,297259819,7,0,0,7168,8,9019347613
5998,297230310,4679,297234989,5,0,1,12288,19,8584216198
5999,297238210,2946,297241156,5,0,1,3072,19,234568122
6000,297264060,3422,297267482,7,0,1,3584,8,5112748670
6001,297284820,67592,297352412,2,0,0,7680,4,10415589097
6002,297347121,110302,297457423,6,0,0,56832,12,8041784666
6003,297351970,3856,297355826,2,0,1,3584,4,3670114856
6004,297367630,57440,297425070,2,0,0,4608,4,1585549072
6005,297399920,117543,297517463,0,0,0,31232,11,2443848806
6006,297427439,5326,297432765,8,0,1,5632,12,7665561142
6007,297454339,130846,297585185,7,0,0,20480,8,9901505175
6008,297566390,1994,297568384,0,0,1,2048,11,1067404337
6009,297646880,4679,297651559,5,0,1,12288,19,724815652
6010,297657340,1042,297658382,1,0,1,1024,6,838886656
6011,297821729,4937,297826666,3,0,1,12800,2,8866821808
6012,297844990,113672,297958662,0,0,0,73216,11,7343256132
6013,297849200,70688,297919888,9,0,0,12800,18,3757989391
6014,298065660,99632,298165292,4,0,0,27136,16,930787890
6015,298071960,64208,298136168,9,0,0,6656,18,5766577318
6016,298090920,121730,298212650,9,0,0,29696,18,2754766745
6017,298188019,3422,298191441,8,0,1,3584,12,9361677998
6018,298220959,59132,298280091,7,0,0,5120,8,6360879305
6019,298270740,5454,298276194,1,0,1,13824,6,4373408138
6020,298416250,110708,298526958,0,0,0,63488,11,1446683265
6021,298420570,116855,298537425,9,0,0,34304,18,128207142
6022,298531159,70934,298602093,1,0,0,8192,6,10075613688
6023,298543270,97354,298640624,9,0,1,162816,18,6546226320
6024,298551909,89061,298640970,8,0,1,512,12,7083029715
6025,298687320,58220,298745540,0,0,0,7168,11,2534193462
6026,298687800,2870,298690670,7,0,1,8704,8,1324003261
6027,298718260,254130,298972390,2,0,0,62976,4,5059027847
6028,298887411,92170,298979581,6,0,0,23552,12,9029356037
6029,298903110,84773,298987883,2,0,0,9728,4,5227590392
6030,298935260,94593,299029853,0,0,0,10240,11,9247152398
6031,298974570,112123,299086693,4,0,0,51712,16,10423383431
6032,298991520,99565,299091085,9,0,0,5632,18,2994833104
6033,298997260,72715,299069975,3,0,0,9728,2,4476264209
6034,299005780,4850,299010630,0,0,1,5120,11,3022038181
6035,299089030,54368,299143398,3,0,0,4608,2,281372761
6036,299189600,100412,299290012,3,0,0,29696,2,10685903497
6037,299360380,566,299360946,4,0,1,512,16,9246468872
6038,299442750,20624,299463374,5,0,1,33280,19,881581926
6039,299456799,95264,299552063,1,0,0,14336,6,9449148578
6040,299458101,253446,299711547,6,0,0,88576,12,4143644902
6041,299485629,144190,299629819,1,0,0,21504,6,9815543289
6042,299558860,47288,299606148,3,0,0,1536,2,2875478495
6043,299648210,150901,299799111,9,0,0,76288,18,5750802166
6044,299658190,82061,299740251,3,0,0,4096,2,9988651712
6045,299692540,20993,299713533,4,0,1,2048,16,1283692086
6046,299737510,63318,299800828,5,0,0,5120,19,10708446254
6047,299841460,83936,299925396,2,0,0,20992,4,1358211529
6048,299993619,45596,300039215,1,0,0,1024,6,1858109026
6049,299995520,85604,300081124,0,0,0,16384,11,8946813429
6050,300061339,98384,300159723,1,0,0,23040,6,6293213116
6051,300097999,76544,300174543,7,0,0,16896,8,4623252784
6052,300118240,1518,300119758,4,0,1,1536,16,10731326867
6053,300136220,110905,300247125,3,0,0,27136,2,676102202
6054,300157591,60188,300217779,6,0,0,6656,12,8460961299
6055,300351279,120378,300471657,7,0,0,91648,8,9848910218
6056,300372679,151124,300523803,7,0,0,34816,8,5910601441
6057,300491039,114764,300605803,7,0,0,76800,8,4439034236
6058,300582850,26885,300609735,5,0,1,4096,19,675367995
6059,300583030,85306,300668336,4,0,0,6144,16,6847709703
6060,300596859,15782,300612641,8,0,1,4608,12,4811076443
6061,300631869,121529,300753398,1,0,0,57344,6,2430008062
6062,300644990,188960,300833950,0,0,0,512,11,300628108
6063,300650430,171307,300821737,2,0,0,49152,4,484299776
6064,300700180,133599,300833779,4,0,0,17408,16,7203295865
6065,300702390,126070,300828460,8,0,0,22016,12,2206422450
6066,300758980,111973,300870953,0,0,0,26624,11,7157217237
6067,300794820,2470,300797290,5,0,1,2560,19,6762017617
6068,300818401,70294,300888695,6,0,0,3072,12,1761987293
6069,300890050,15579,300905629,1,0,1,30208,6,7425703974
6070,300893439,16376,300909815,3,0,1,6656,2,8499334890
6071,300956040,52364,301008404,3,0,0,3072,2,2769762726
6072,301016460,68372,301084832,9,0,0,10240,18,7705665070
6073,301108010,76052,301184062,2,0,0,10240,4,3173486817
6074,301130970,103990,301234960,3,0,0,14848,2,5943060819
6075,301142641,55748,301198389,6,0,0,4096,12,10196243109
6076,301164200,2470,301166670,0,0,1,2560,11,4559665514
6077,301424261,101816,301526077,6,0,0,34304,12,9825829727
6078,301453860,45596,301499456,0,0,0,1024,11,7315492918
6079,301515810,84775,301600585,3,0,0,10240,2,1105842815
6080,301557770,12737,301570507,5,0,1,24576,19,7002742134
6081,301577550,104989,301682539,3,0,0,43520,2,8116534685
6082,301581379,47881,301629260,1,0,0,2560,6,8438584633
6083,301623050,1518,301624568,2,0,1,1536,4,4211479594
6084,301684380,5802,301690182,0,0,1,6144,11,9903986666
6085,301691369,100568,301791937,1,0,0,30208,6,4542732559
6086,301850669,84512,301935181,7,0,0,12800,8,4831957219
6087,301923670,56372,301980042,2,0,0,6144,4,8517146516
6088,301940969,72668,302013637,1,0,0,9216,6,248536897
6089,302013149,109940,302123089,7,0,0,59392,8,10319685692
6090,302016020,160766,302176786,0,0,0,49152,11,1843941264
6091,302046039,115756,302161795,7,0,0,18944,8,7976275016
6092,302074460,159041,302233501,4,0,0,6144,16,7119441264
6093,302074970,142439,302217409,9,0,0,13824,18,7930817634
6094,302095620,3645,302099265,6,0,1,10240,12,1785754574
6095,302106980,29459,302136439,6,0,1,22528,12,9607526721
6096,302118900,85324,302204224,9,0,1,124416,18,3523841345
6097,302177690,105716,302283406,8,0,0,47104,12,627185838
6098,302211110,7706,302218816,2,0,1,8192,4,4638847152
6099,302297070,112727,302409797,8,0,0,8704,12,5184478638
6100,302320130,270001,302590131,3,0,0,34304,2,4373607196
6101,302345130,198039,302543169,4,0,0,17408,16,9379323948
6102,302460310,55748,302516058,5,0,0,4096,19,7104448012
6103,302482670,169093,302651763,9,0,0,75264,18,4321442361
6104,302492820,6278,302499098,2,0,1,6656,4,872110806
6105,302497890,177912,302675802,8,0,0,78848,12,3881222228
6106,302522990,1518,302524508,6,0,1,1536,12,517849521
6107,302530830,171881,302702711,2,0,0,27136,4,9417754833
6108,302568960,167547,302736507,9,0,0,18432,18,2344905079
6109,302619560,134066,302753626,9,0,1,217600,18,5627610357
6110,302640160,254665,302894825,2,0,0,6144,4,8171583546
6111,302660470,109426,302769896,9,0,1,53248,18,9996066301
6112,302719680,55362,302775042,6,0,1,8192,12,2096448403
6113,302853890,217756,303071646,9,0,0,9728,18,9231958831
6114,302874949,187283,303062232,7,0,0,49152,8,6407644959
6115,302882430,3904,302886334,4,0,1,10752,16,7387836193
6116,302882929,147389,303030318,1,0,0,38912,6,6914604368
6117,302887020,13083,302900103,6,0,1,22016,12,501548604
6118,302902900,216482,303119382,9,0,0,35328,18,3911531650
6119,302904220,67769,302971989,3,0,0,12288,2,2534277299
6120,302950280,10241,302960521,6,0,1,16384,12,3083042258
6121,303086690,82088,303168778,2,0,0,19968,4,7457569836
6122,303168760,5837,303174597,2,0,1,6144,4,4199992406
6123,303168779,69020,303237799,1,0,0,12288,6,9163269261
6124,303191640,91045,303282685,0,0,0,12288,11,343316368
6125,303237920,117971,303355891,3,0,0,24576,2,9893065844
6126,303261319,55748,303317067,7,0,0,4096,8,6785713182
6127,303270090,105340,303375430,0,0,0,39424,11,8210229470
6128,303289160,68462,303357622,0,0,0,5632,11,5361885011
6129,303331070,64565,303395635,2,0,0,1536,4,3212225106
6130,303377190,78992,303456182,4,0,0,14848,16,3811102903
6131,303406600,166340,303572940,9,0,0,60928,18,756480779
6132,303413860,101231,303515091,4,0,0,27136,16,48807445
6133,303420750,2946,303423696,1,0,1,3072,6,10295737084
6134,303423370,83438,303506808,4,0,0,10240,16,2564677124
6135,303585950,3387,303589337,0,0,1,9728,11,8401764809
6136,303650970,91016,303741986,4,0,0,24064,16,6751196034
6137,303672150,149282,303821432,0,0,0,56832,11,5723133765
6138,303789740,43904,303833644,8,0,0,512,12,9824639845
6139,303818900,7203,303826103,1,0,1,12288,6,4066229973
6140,303843181,209864,304053045,6,0,0,43008,12,280392887
6141,303913640,5971,303919611,5,0,1,14848,19,4471352453
6142,303922470,6754,303929224,7,0,1,7168,8,7934728162
6143,303923440,96198,304019638,9,0,0,16896,18,611052573
6144,303958050,106242,304064292,4,0,0,36864,16,8767056256
6145,303972519,145152,304117671,7,0,0,27136,8,10291070401
6146,304039030,52364,304091394,9,0,0,3072,18,2096350823
6147,304053459,12861,304066320,8,0,1,2048,12,4810869984
6148,304059440,16784,304076224,4,0,1,18432,16,3747656929
6149,304063160,15650,304078810,5,0,1,4096,19,6719570855
6150,304079109,22174,304101283,3,0,1,36352,2,3617781161
6151,304100120,3128,304103248,0,0,1,9216,11,6670379675
6152,304154010,145442,304299452,0,0,0,14848,11,9624879145
6153,304214681,98228,304312909,6,0,0,22528,12,1271077205
6154,304228370,114899,304343269,5,0,0,11264,19,3145887077
6155,304233790,81630,304315420,8,0,0,8192,12,3724537984
6156,304250079,112144,304362223,7,0,0,16896,8,5050644028
6157,304280350,65430,304345780,0,0,0,8192,11,10024599479
6158,304363340,5802,304369142,5,0,1,6144,19,4148836502
6159,304435619,45596,304481215,7,0,0,1024,8,5403689641
6160,304500970,43904,304544874,0,0,0,512,11,1112009349
6161,304622879,120173,304743052,1,0,0,91136,6,10262889564
6162,304644230,99305,304743535,4,0,0,1536,16,276125309
6163,304667229,160333,304827562,1,0,0,46592,6,10388784070
6164,304691650,121701,304813351,4,0,0,25600,16,1190607732
6165,304700670,103862,304804532,9,0,1,172032,18,4975524321
6166,304719740,109085,304828825,4,0,0,4096,16,8406613165
6167,304992340,81440,305073780,8,0,0,12800,12,3154784541
6168,305044120,132038,305176158,0,0,0,120832,11,9329425787
6169,305112270,72138,305184408,9,0,0,2048,18,2735179872
6170,305163870,14274,305178144,2,0,1,2048,4,3655902981
6171,305206230,47600,305253830,3,0,0,2560,2,3509927356
6172,305311459,76208,305387667,7,0,0,10752,8,1820344364
6173,305359480,111956,305471436,5,0,0,67584,19,3034367157
6174,305413550,121018,305534568,3,0,0,20480,2,586062889
6175,305495440,101036,305596476,9,0,0,31744,18,3290993019
6176,305502629,2470,305505099,3,0,1,2560,2,5027118000
6177,305517920,101080,305619000,9,0,0,28160,18,5123250235
6178,305594200,9498,305603698,4,0,1,7680,16,2928842808
6179,305644480,67592,305712072,8,0,0,7680,12,7367124806
6180,305721930,103909,305825839,2,0,0,18944,4,9131171966
6181,305800150,67592,305867742,2,0,0,7680,4,5513950146
6182,305867300,102718,305970018,9,0,0,35840,18,10225562182
6183,305902190,148678,306050868,2,0,0,73216,4,8043104257
6184,305944660,163502,306108162,5,0,0,33280,19,6082099004
6185,306151070,1042,306152112,9,0,1,1024,18,5232907692
6186,306184790,131870,306316660,4,0,0,102912,16,5929439186
6187,306193940,125707,306319647,0,0,0,9728,11,10274316546
6188,306246779,145331,306392110,7,0,0,80896,8,5779592752
6189,306298850,27034,306325884,1,0,1,6656,6,6355675799
6190,306333509,3128,306336637,3,0,1,9216,2,2982055381
6191,306365850,60692,306426542,3,0,0,10240,2,10232645041
6192,306381441,92125,306473566,6,0,0,17920,12,3629461321
6193,306402729,103457,306506186,1,0,0,12288,6,1629870471
6194,306428650,69284,306497934,5,0,0,8192,19,8176891848
6195,306475930,100109,306576039,8,0,0,7680,12,8479236542
6196,306497110,3762,306500872,5,0,1,3072,19,6473750222
6197,306531050,32816,306563866,1,0,1,53760,6,6101922609
6198,306566210,71573,306637783,3,0,0,512,2,6489832948
6199,306643070,156336,306799406,0,0,0,10240,11,4889943839
6200,306643879,2470,306646349,3,0,1,2560,2,10717100106
6201,306681519,114752,306796271,7,0,0,26112,8,3686551898
6202,306851250,121409,306972659,2,0,0,26112,4,5400229146
6203,306853980,14545,306868525,5,0,1,28160,19,2031090475
6204,306995860,173492,307169352,4,0,0,153600,16,4018378729
6205,307109969,72439,307182408,7,0,0,7680,8,1696611062
6206,307137160,87932,307225092,3,0,0,4096,2,2884956434
6207,307162900,108909,307271809,4,0,0,36352,16,9736419359
6208,307191470,1518,307192988,9,0,1,1536,18,7496793457
6209,307200550,145113,307345663,0,0,0,55808,11,4749549040
6210,307211401,62984,307274385,6,0,0,7680,12,2857385084
6211,307261230,103379,307364609,1,0,1,150528,6,7465085934
6212,307264729,100866,307365595,8,0,1,1536,12,5807992690
6213,307321789,102698,307424487,7,0,0,4096,8,5562389854
6214,307422579,170620,307593199,7,0,0,113664,8,752653378
6215,307510040,112660,307622700,2,0,0,40960,4,4577557831
6216,307556660,1042,307557702,1,0,1,1024,6,3628005676
6217,307576729,17980,307594709,3,0,1,1536,2,2567019807
6218,307641070,45596,307686666,9,0,0,1024,18,30973382
6219,307651910,99164,307751074,0,0,0,25600,11,6871955611
6220,307675340,160902,307836242,5,0,0,22016,19,45446221
6221,307710180,71156,307781336,0,0,0,14336,11,4199339634
6222,307738070,130272,307868342,5,0,0,21504,19,5587853385
6223,307791910,12825,307804735,4,0,1,21504,16,3662326777
6224,307793090,99162,307892252,2,0,0,3072,4,5038871144
6225,307853259,76052,307929311,1,0,0,10240,6,9842181507
6226,307861910,76632,307938542,9,0,0,7680,18,2977314021
6227,307899390,117727,308017117,0,0,0,1536,11,4899787716
6228,307928929,7128,307936057,3,0,1,7168,2,7482802705
6229,307934451,55748,307990199,6,0,0,4096,12,6839599889
6230,307997300,105248,308102548,0,0,0,45568,11,9414794094
6231,308043860,134702,308178562,8,0,0,67072,12,1268857164
6232,308083551,131251,308214802,6,0,0,28160,12,10702188025
6233,308090720,94952,308185672,8,0,0,1536,12,96285374
6234,308132240,134522,308266762,5,0,0,37376,19,9037253590
6235,308179550,116018,308295568,3,0,0,69632,2,4622776160
6236,308222680,2470,308225150,6,0,1,2560,12,8805505088
6237,308224671,130747,308355418,6,0,0,28672,12,9733866492
6238,308272969,107355,308380324,7,0,0,48128,8,10108818484
6239,308305930,87896,308393826,8,0,0,13824,12,4674672032
6240,308349320,81220,308430540,8,0,0,7168,12,9326141616
6241,308350510,97722,308448232,9,0,0,8704,18,4132259914
6242,308375410,95742,308471152,4,0,0,18432,16,3415540183
6243,308405270,1042,308406312,7,0,1,1024,8,6850759591
6244,308634149,87452,308721601,7,0,0,17408,8,1156710854
6245,308704460,100157,308804617,9,0,0,23040,18,9378561478
6246,308711450,1042,308712492,7,0,1,1024,8,837601200
6247,308717110,110199,308827309,2,0,0,47104,4,4754464516
6248,308751220,150231,308901451,2,0,0,62464,4,10410975447
6249,308805620,146666,308952286,2,0,0,31232,4,10562885606
6250,308817710,12461,308830171,2,0,1,8704,4,7010246765
6251,308926100,91254,309017354,9,0,0,14848,18,1596134605
6252,308980980,62516,309043496,9,0,0,6144,18,5506324017
6253,309054760,1518,309056278,7,0,1,1536,8,6287276824
6254,309054779,125230,309180009,7,0,0,109568,8,8997415248
6255,309208400,63764,309272164,9,0,0,10240,18,7163429429
6256,309267019,60824,309327843,1,0,0,5632,6,10209633968
6257,309363640,60692,309424332,5,0,0,10240,19,3625125653
6258,309381051,115287,309496338,6,0,0,28672,12,2403778277
6259,309426770,13770,309440540,0,0,1,26624,11,9836725854
6260,309449570,6229,309455799,5,0,1,15360,19,10212107032
6261,309558260,60824,309619084,2,0,0,5632,4,6289631397
6262,309577750,57440,309635190,4,0,0,4608,16,8869609135
6263,309605140,101660,309706800,3,0,0,33792,2,7904732887
6264,309677770,566,309678336,6,0,1,512,12,8652953040
6265,309695669,92996,309788665,7,0,0,20480,8,7647907840
6266,309696730,96786,309793516,9,0,0,15872,18,4286625077
6267,309730500,168541,309899041,3,0,0,63488,2,10348199003
6268,309746770,222081,309968851,9,0,0,33792,18,2151353503
6269,309750160,151860,309902020,4,0,0,9728,16,10394790820
6270,309775790,6488,309782278,7,0,1,15872,8,10146571630
6271,309813800,205991,310019791,0,0,0,54784,11,3123923793
6272,309967800,101455,310069255,4,0,0,29696,16,1527648363
6273,309982260,138361,310120621,9,0,0,35840,18,433771576
6274,310035100,65721,310100821,2,0,0,6144,4,7683481986
6275,310035890,68690,310104580,5,0,0,12288,19,4140478900
6276,310038530,141713,310180243,3,0,0,33792,2,6461555741
6277,310081860,119761,310201621,9,0,0,32256,18,10032764089
6278,310176740,127025,310303765,8,0,0,82944,12,9682599545
6279,310211839,143736,310355575,7,0,0,19968,8,4269313849
6280,310216140,104815,310320955,9,0,0,7168,18,2562481811
6281,310246729,3128,310249857,8,0,1,9216,12,7555573886
6282,310248480,8336,310256816,5,0,1,7680,19,5208997682
6283,310269190,75639,310344829,8,0,0,13824,12,3411857932
6284,310300700,228958,310529658,4,0,0,44032,16,4978126718
6285,310306720,89708,310396428,9,0,0,10752,18,9110962180
6286,310340200,133490,310473690,2,0,0,36352,4,5620266231
6287,310412020,566,310412586,4,0,1,512,16,10150283934
6288,310457670,89424,310547094,5,0,0,17920,19,5840391443
6289,310468939,145787,310614726,7,0,0,23552,8,863828314
6290,310573350,14117,310587467,9,0,1,24064,18,4806613201
6291,310660710,55748,310716458,3,0,0,4096,2,1454482721
6292,310688890,109583,310798473,0,0,0,36864,11,6233430609
6293,310691890,95336,310787226,2,0,0,28160,4,4247867809
6294,310726730,113893,310840623,5,0,0,13312,19,3368189334
6295,310727170,109382,310836552,3,0,0,42496,2,4621368602
6296,310853639,5712,310859351,8,0,1,14336,12,10534998867
6297,310861760,130220,310991980,5,0,0,98304,19,5101523119
6298,310901850,13253,310915103,6,0,1,25600,12,7041337028
6299,310943450,3898,310947348,6,0,1,4096,12,2218840203
6300,310955999,35996,310991995,3,0,1,35328,2,10417090198
6301,311057650,566,311058216,7,0,1,512,8,5408558835
6302,311070940,4162,311075102,7,0,1,11264,8,4782941782
6303,311126251,73591,311199842,6,0,0,11264,12,10614720942
6304,311134230,113233,311247463,2,0,0,20992,4,7482912472
6305,311228260,3898,311232158,2,0,1,4096,4,5303869255
6306,311288351,78524,311366875,6,0,0,13312,12,10246276374
6307,311336220,2946,311339166,5,0,1,3072,19,7357660719
6308,311337840,118621,311456461,9,0,0,79360,18,336999891
6309,311445050,13397,311458447,9,0,1,2048,18,1232247030
6310,311500030,69152,311569182,8,0,0,12800,12,8792036717
6311,311503610,54056,311557666,0,0,0,3584,11,7550118610
6312,311531249,91417,311622666,7,0,0,4608,8,7923695507
6313,311581520,91241,311672761,0,0,0,6144,11,3045957402
6314,311596421,105716,311702137,6,0,0,47104,12,6483307185
6315,311709950,105404,311815354,9,0,0,46080,18,10524947635
6316,311762629,83250,311845879,1,0,0,7168,6,2078239439
6317,311784311,59369,311843680,6,0,0,4608,12,2143269733
6318,311938130,10241,311948371,7,0,1,16384,8,4548610224
6319,311938270,114201,312052471,9,0,0,22528,18,8764709027
6320,312003920,117272,312121192,5,0,0,6144,19,9064294611
6321,312021180,94429,312115609,5,0,0,16896,19,2526641562
6322,312022990,64380,312087370,5,0,0,7168,19,5551736529
6323,312042520,99632,312142152,4,0,0,27136,16,6072753684
6324,312111860,9347,312121207,7,0,1,5632,8,10603768896
6325,312210690,85136,312295826,5,0,0,14848,19,1836086620
6326,312259930,80684,312340614,4,0,0,15360,16,3944334025
6327,312304560,95936,312400496,3,0,0,25088,2,6027712874
6328,312325981,102284,312428265,6,0,0,35840,12,2316942761
6329,312438019,57440,312495459,1,0,0,4608,6,8653986769
6330,312460600,64208,312524808,4,0,0,6656,16,3936583240
6331,312513290,58414,312571704,4,0,0,2048,16,6755035198
6332,312593100,131664,312724764,4,0,0,99840,16,5443536070
6333,312602980,124615,312727595,4,0,0,9216,16,5254151935
6334,312686530,43904,312730434,0,0,0,512,11,815537067
6335,312702809,32476,312735285,8,0,1,8192,12,5766066762
6336,312713229,119294,312832523,7,0,0,44544,8,9136250736
6337,312735579,66212,312801791,7,0,0,8192,8,3071145489
6338,312735780,2946,312738726,5,0,1,3072,19,8644931249
6339,312781580,128845,312910425,2,0,0,21504,4,9694831282
6340,312792290,98544,312890834,4,0,0,25088,16,6077345058
6341,312796530,86645,312883175,8,0,0,20992,12,8025367653
6342,312808280,5326,312813606,9,0,1,5632,18,433304679
6343,312813220,168383,312981603,4,0,0,27136,16,7267172757
6344,312832320,2665,312834985,7,0,1,2560,8,1217859474
6345,312920680,1994,312922674,5,0,1,2048,19,4607293433
6346,313009910,86204,313096114,3,0,0,13312,2,5011580992
6347,313029509,74393,313103902,7,0,0,3584,8,8179883838
6348,313067470,89012,313156482,0,0,0,22528,11,6738000995
6349,313132300,110552,313242852,5,0,0,62976,19,7616805273
6350,313152970,149828,313302798,9,0,0,31744,18,1738662058
6351,313236490,135746,313372236,0,0,0,26624,11,7247126211
6352,313238599,116255,313354854,7,0,0,13824,8,4342995882
6353,313245120,133215,313378335,0,0,0,19968,11,9579152406
6354,313359520,80840,313440360,9,0,0,15872,18,541942039
6355,313404440,118486,313522926,2,0,0,58880,4,309693156
6356,313411711,181141,313592852,6,0,0,3072,12,9419568941
6357,313412379,125977,313538356,1,0,0,33792,6,1346278466
6358,313420351,54056,313474407,6,0,0,3584,12,4758509735
6359,313428290,71835,313500125,4,0,0,7168,16,9618018449
6360,313428421,134829,313563250,6,0,0,28672,12,237878279
6361,313438030,153871,313591901,0,0,0,56320,11,6898730634
6362,313449080,117458,313566538,4,0,0,9216,16,4400005972
6363,313500379,118948,313619327,1,0,0,34304,6,6846806605
6364,313520620,124261,313644881,5,0,0,6144,19,1714858381
6365,313547590,88207,313635797,4,0,0,1536,16,10707450989
6366,313853920,52364,313906284,0,0,0,3072,11,6057060965
6367,313915640,59756,313975396,2,0,0,7168,4,9830884402
6368,313944970,64208,314009178,9,0,0,6656,18,9174530213
6369,313969910,65900,314035810,3,0,0,7168,2,8199630209
6370,314086219,6754,314092973,8,0,1,7168,12,4280439552
6371,314162250,2946,314165196,5,0,1,3072,19,2423532220
6372,314168330,103688,314272018,1,0,0,40448,6,5184736491
6373,314191660,6754,314198414,0,0,1,7168,11,7773171913
6374,314202630,110014,314312644,3,0,0,16384,2,2238427882
6375,314280409,54368,314334777,1,0,0,4608,6,8926177274
6376,314336280,98228,314434508,5,0,0,22528,19,9919246354
6377,314373430,77908,314451338,8,0,0,1024,12,5502494765
6378,314401220,100256,314501476,0,0,0,29184,11,9089920560
6379,314573810,566,314574376,1,0,1,512,6,9259180826
6380,314603390,108212,314711602,2,0,0,55296,4,8209400696
6381,314677519,79436,314756955,7,0,0,11264,8,9926539356
6382,314714290,82400,314796690,2,0,0,20992,4,7331491303
6383,314724270,81752,314806022,5,0,0,13824,19,4981196423
6384,314739349,73250,314812599,7,0,0,5120,8,8474385094
6385,314814950,104000,314918950,5,0,0,41472,19,623973054
6386,314818290,69148,314887438,9,0,0,3584,18,9161981208
6387,314827910,23120,314851030,7,0,1,41472,8,7287447016
6388,314840640,151246,314991886,0,0,0,21504,11,8350817125
6389,314901080,566,314901646,4,0,1,512,16,9245515169
6390,314995329,177805,315173134,7,0,0,43520,8,5346578565
6391,315009800,104156,315113956,0,0,0,41984,11,2388959068
6392,315029890,57076,315086966,2,0,0,3584,4,5721392043
6393,315034050,1042,315035092,7,0,1,1024,8,5949044597
6394,315050410,100412,315150822,3,0,0,29696,2,6606662190
6395,315064279,138749,315203028,7,0,0,18432,8,8971382853
6396,315076620,97621,315174241,2,0,0,3584,4,10693486331
6397,315112479,14035,315126514,3,0,1,20992,2,7175315851
6398,315129651,109665,315239316,6,0,0,31232,12,10404584201
6399,315169631,154603,315324234,6,0,0,51712,12,6306715184
6400,315188830,87932,315276762,2,0,0,16896,4,2220044938
6401,315271120,137504,315408624,3,0,0,38400,2,7284525883
6402,315286180,170060,315456240,9,0,0,38400,18,10613694479
6403,315300989,81596,315382585,1,0,0,13312,6,9904756613
6404,315333971,83768,315417739,6,0,0,1536,12,2213064594
6405,315375640,6960,315382600,7,0,1,4608,8,358284432
6406,315409920,111020,315520940,8,0,0,64512,12,422056817
6407,315433170,120644,315553814,3,0,0,25088,2,6218970392
6408,315445540,137860,315583400,0,0,0,5120,11,1904452912
6409,315507870,114878,315622748,5,0,0,34304,19,8092083867
6410,315530059,2470,315532529,8,0,1,2560,12,1354747455
6411,315679949,92972,315772921,7,0,0,15360,8,5758787934
6412,315801230,71468,315872698,3,0,0,15360,2,8840878606
6413,315817970,101348,315919318,0,0,0,32768,11,9530043339
6414,315951730,78860,316030590,2,0,0,19456,4,9298802120
6415,315954750,111644,316066394,4,0,0,66560,16,9677173561
6416,315958919,2870,315961789,8,0,1,8704,12,436272401
6417,316114710,13600,316128310,5,0,1,23040,19,2145338949
6418,316135299,178968,316314267,7,0,0,7680,8,3137448501
6419,316135330,134137,316269467,1,0,0,52736,6,2489020691
6420,316180980,188207,316369187,0,0,0,52736,11,3890216918
6421,316184680,116770,316301450,2,0,0,8704,4,3207076818
6422,316226230,114318,316340548,4,0,0,23552,16,4929232541
6423,316238230,114874,316353104,0,0,0,10752,11,10474029757
6424,316269411,144145,316413556,6,0,0,18944,12,300281611
6425,316282750,118254,316401004,8,0,0,28160,12,5602946674
6426,316320960,137836,316458796,4,0,0,36352,16,10495639068
6427,316331070,10757,316341827,5,0,1,17408,19,9595553964
6428,316398620,77384,316476004,3,0,0,16896,2,8386498154
6429,316456410,107314,316563724,3,0,0,44544,2,698990209
6430,316482370,178317,316660687,8,0,0,44544,12,1792922723
6431,316540370,106730,316647100,5,0,0,23552,19,1854186965
6432,316542370,88364,316630734,0,0,0,15360,11,5448247555
6433,316740239,6754,316746993,8,0,1,7168,12,8590414996
6434,316756150,1994,316758144,5,0,1,2048,19,9535045483
6435,316772381,61985,316834366,6,0,0,4608,12,4903710001
6436,316809700,77481,316887181,5,0,0,14336,19,840239373
6437,316821350,61448,316882798,9,0,0,7680,18,2482284859
6438,316874970,5326,316880296,9,0,1,5632,18,10442139012
6439,316943489,6278,316949767,3,0,1,6656,2,6627697760
6440,316946140,181524,317127664,5,0,0,138240,19,10062097675
6441,316979941,79565,317059506,6,0,0,512,12,113492396
6442,317014490,128956,317143446,3,0,0,49152,2,2631304899
6443,317058780,122202,317180982,4,0,0,13824,16,3709940329
6444,317172640,81932,317254572,4,0,0,19456,16,10361324683
6445,317217839,101192,317319031,7,0,0,32256,8,5808995899
6446,317323650,50828,317374478,0,0,0,3072,11,4344135641
6447,317360930,99008,317459938,2,0,0,25088,4,162919229
6448,317385700,158364,317544064,4,0,0,73216,16,1845257217
6449,317483560,83184,317566744,4,0,0,14336,16,6836885996
6450,317592150,113498,317705648,8,0,0,33792,12,2509946722
6451,317600680,110599,317711279,2,0,0,18432,4,8103461011
6452,317608120,1518,317609638,9,0,1,1536,18,8480623901
6453,317608670,183112,317791782,4,0,0,69120,16,104489030
6454,317632400,91198,317723598,4,0,0,6656,16,2798236852
6455,317676780,48980,317725760,9,0,0,2048,18,1059017549
6456,317682060,175722,317857782,4,0,0,124416,16,1343761661
6457,317718260,6488,317724748,4,0,1,15872,16,5218208645
6458,317722610,6782,317729392,0,0,1,6144,11,2201736577
6459,317743500,115701,317859201,3,0,0,4608,2,1672642036
6460,317764450,110332,317874782,8,0,0,18944,12,7194377289
6461,317857570,85324,317942894,3,0,0,18432,2,3653589775
6462,317914220,110772,318024992,4,0,0,59904,16,10152475648
6463,317918490,116126,318034616,3,0,0,15872,2,4009213966
6464,317920390,148312,318068702,9,0,0,5632,18,7824292135
6465,318041480,120224,318161704,2,0,0,94720,4,3258908538
6466,318044120,147392,318191512,8,0,0,31232,12,6269595499
6467,318064500,141730,318206230,8,0,0,17920,12,7000777279
6468,318078850,135042,318213892,3,0,0,6656,2,8443034606
6469,318093310,3898,318097208,5,0,1,4096,19,5355405650
6470,318132670,29049,318161719,6,0,1,4096,12,1599127628
6471,318219350,45596,318264946,8,0,0,1024,12,970955001
6472,318385499,64208,318449707,7,0,0,6656,8,2874550981
6473,318409639,79436,318489075,7,0,0,11264,8,4629582593
6474,318456740,96980,318553720,8,0,0,18432,12,9107860824
6475,318491060,99944,318591004,5,0,0,28160,19,1466710512
6476,318493990,144173,318638163,0,0,0,19968,11,3512989180
6477,318544900,87164,318632064,8,0,0,21504,12,2030589510
6478,318569140,197787,318766927,9,0,0,92672,18,3515653738
6479,318604429,260644,318865073,1,0,0,50176,6,8324338836
6480,318610160,13512,318623672,9,0,1,26112,18,1054957792
6481,318616160,101980,318718140,5,0,0,19456,19,743639362
6482,318802030,114987,318917017,2,0,0,11776,4,6644334555
6483,318813070,52174,318865244,2,0,0,512,4,4229432993
6484,318815560,50167,318865727,8,0,0,1536,12,7484512668
6485,318823269,3128,318826397,3,0,1,9216,2,7035726065
6486,318911820,1042,318912862,7,0,1,1024,8,5474725324
6487,318940340,67772,319008112,9,0,0,13312,18,5026325392
6488,318955540,7706,318963246,5,0,1,8192,19,9224245732
6489,318973450,54456,319027906,9,0,0,1536,18,3179763035
6490,319088380,52364,319140744,8,0,0,3072,12,1758654513
6491,319141759,109928,319251687,7,0,0,60928,8,8990767941
6492,319256419,104000,319360419,7,0,0,41472,8,4900649116
6493,319299581,198046,319497627,6,0,0,35840,12,5704480138
6494,319315010,142921,319457931,9,0,0,87040,18,2728603166
6495,319370500,55748,319426248,3,0,0,4096,2,3346666754
6496,319384031,89879,319473910,6,0,0,7680,12,3199494191
6497,319395249,63017,319458266,1,0,0,1024,6,111111949
6498,319444060,62843,319506903,4,0,0,2048,16,9934517997
6499,319449919,92851,319542770,1,0,0,12800,6,5509812773
6500,319581480,98540,319680020,0,0,0,23552,11,5041189818
6501,319641430,141543,319782973,4,0,0,101376,16,2500462377
6502,319660220,142938,319803158,2,0,0,38400,4,5087487925
6503,319660721,191817,319852538,6,0,0,6656,12,7978847675
6504,319683250,126782,319810032,2,0,0,20480,4,6709051160
6505,319729380,7230,319736610,4,0,1,7680,16,8671716381
6506,319797720,51026,319848746,0,0,0,1024,11,7695166623
6507,319864300,105872,319970172,1,0,0,47616,6,9772671580
6508,319936150,85850,320022000,1,0,0,13824,6,3301974543
6509,319936440,125994,320062434,4,0,0,14336,16,7807967326
6510,319950600,52364,320002964,2,0,0,3072,4,1469489745
6511,320031570,53574,320085144,8,0,0,2048,12,4416415861
6512,320033850,79616,320113466,8,0,0,16896,12,8852124688
6513,320157000,61604,320218604,3,0,0,8192,2,6449416562
6514,320227241,91016,320318257,6,0,0,24064,12,6956566594
6515,320243700,6754,320250454,0,0,1,7168,11,3463259591
6516,320244670,98583,320343253,5,0,0,15360,19,937180723
6517,320264410,3422,320267832,6,0,1,3584,12,2930536867
6518,320371270,2470,320373740,5,0,1,2560,19,9458978723
6519,320371750,3616,320375366,9,0,1,2560,18,3830940624
6520,320515100,81596,320596696,5,0,0,13312,19,1470160957
6521,320586960,566,320587526,1,0,1,512,6,126981989
6522,320592200,77744,320669944,4,0,0,10752,16,5713757865
6523,320647330,159575,320806905,0,0,0,87040,11,10183139302
6524,320647470,212517,320859987,9,0,0,33280,18,10420597831
6525,320655300,160668,320815968,1,0,0,29696,6,2891750918
6526,320759530,79436,320838966,2,0,0,11264,4,1357836965
6527,320839780,64208,320903988,0,0,0,6656,11,529007855
6528,320846349,48980,320895329,7,0,0,2048,8,10510892669
6529,320857069,101606,320958675,7,0,0,24064,8,1875130527
6530,320905161,189083,321094244,6,0,0,42496,12,4286749787
6531,320920470,102596,321023066,3,0,0,36864,2,2469542724
6532,321033830,75324,321109154,5,0,0,4608,19,5578581337
6533,321052400,69284,321121684,3,0,0,8192,2,4797794892
6534,321101190,124570,321225760,9,0,0,45056,18,8463255815
6535,321108500,13471,321121971,5,0,1,21504,19,4172197580
6536,321135930,146962,321282892,5,0,0,76288,19,3105558201
6537,321183250,136657,321319907,2,0,0,24064,4,320284677
6538,321280930,80364,321361294,3,0,0,2560,2,8825514475
6539,321284790,43904,321328694,4,0,0,512,16,6336847988
6540,321323819,4162,321327981,3,0,1,11264,2,1703357047
6541,321445239,71000,321516239,7,0,0,13824,8,1289322581
6542,321450410,100100,321550510,0,0,0,28672,11,158523055
6543,321515041,144069,321659110,6,0,0,80384,12,4316118125
6544,321522550,66680,321589230,3,0,0,9728,2,2977306449
6545,321531640,79182,321610822,2,0,0,2560,4,8856254483
6546,321559830,48980,321608810,8,0,0,2048,12,7525394488
6547,321569050,194158,321763208,3,0,0,24064,2,6699687490
6548,321574499,140837,321715336,1,0,0,41984,6,8908381562
6549,321592780,97448,321690228,3,0,0,19968,2,3280249625
6550,321597100,118563,321715663,5,0,0,1024,19,6401629404
6551,321633450,62516,321695966,4,0,0,6144,16,5935493954
6552,321711350,71453,321782803,9,0,0,11264,18,1965482770
6553,321924350,47288,321971638,0,0,0,1536,11,2572168074
6554,322000970,55748,322056718,3,0,0,4096,2,8297554909
6555,322011370,79460,322090830,0,0,0,16384,11,1932575893
6556,322133470,69284,322202754,2,0,0,8192,4,3235859526
6557,322147129,3422,322150551,8,0,1,3584,12,3070233345
6558,322163680,90524,322254204,3,0,0,17408,2,2975954211
6559,322174630,10757,322185387,4,0,1,17408,16,3745139100
6560,322181789,77018,322258807,1,0,0,12288,6,3517135255
6561,322313510,95132,322408642,0,0,0,17408,11,7782841950
6562,322410340,6278,322416618,5,0,1,6656,19,6328518823
6563,322500521,109772,322610293,6,0,0,60416,12,4696142106
6564,322508019,2946,322510965,3,0,1,3072,2,2851292106
6565,322554961,111332,322666293,6,0,0,65536,12,8479247756
6566,322557380,116023,322673403,8,0,0,2048,12,6297438675
6567,322789040,83624,322872664,2,0,0,19968,4,9496376869
6568,322840920,93508,322934428,9,0,0,8704,18,6974642331
6569,322892880,76774,322969654,8,0,0,12288,12,434029239
6570,322907700,94064,323001764,9,0,0,18944,18,479334754
6571,322923970,124678,323048648,4,0,0,26624,16,2708341832
6572,322996640,55788,323052428,4,0,0,2560,16,850197063
6573,323133630,88052,323221682,9,0,0,14336,18,6555416642
6574,323189360,50672,323240032,4,0,0,2560,16,2867956514
6575,323201830,566,323202396,9,0,1,512,18,6679188422
6576,323216820,69284,323286104,5,0,0,8192,19,407228911
6577,323323080,59132,323382212,4,0,0,5120,16,6389823235
6578,323388240,103642,323491882,9,0,0,39936,18,5041134648
6579,323408660,85889,323494549,8,0,0,8704,12,545999135
6580,323413260,48980,323462240,8,0,0,2048,12,10217469110
6581,323497550,153930,323651480,2,0,0,26624,4,7340927238
6582,323515140,101878,323617018,2,0,0,31744,4,7695452142
6583,323516550,87530,323604080,4,0,0,7168,16,9885874655
6584,323545670,87756,323633426,9,0,0,1536,18,10522155574
6585,323599901,73136,323673037,6,0,0,10752,12,953920349
6586,323932200,90704,324022904,0,0,0,23040,11,9318159274
6587,324075669,65900,324141569,1,0,0,7168,6,7669495524
6588,324165199,4162,324169361,3,0,1,11264,2,8028633845
6589,324177760,1042,324178802,5,0,1,1024,19,7564828112
6590,324181160,76052,324257212,0,0,0,10240,11,1690997412
6591,324181629,91592,324273221,1,0,0,15872,6,1076071267
6592,324196759,2946,324199705,8,0,1,3072,12,8070666440
6593,324251230,119827,324371057,2,0,0,32256,4,2764952630
6594,324349000,1042,324350042,1,0,1,1024,6,4633370382
6595,324485130,3645,324488775,5,0,1,10240,19,5602110168
6596,324485580,68619,324554199,2,0,0,7168,4,2661673060
6597,324499270,566,324499836,7,0,1,512,8,9536292314
6598,324579420,110451,324689871,8,0,0,12288,12,6516307943
6599,324760940,69776,324830716,0,0,0,14848,11,6451454575
6600,324822170,52946,324875116,0,0,0,2048,11,1254385985
6601,324842490,57440,324899930,2,0,0,4608,4,2807967638
6602,324931550,66836,324998386,5,0,0,10240,19,1959144978
6603,324968469,3422,324971891,8,0,1,3584,12,9966952024
6604,324993970,47288,325041258,2,0,0,1536,4,240086285
6605,325023080,6278,325029358,5,0,1,6656,19,10710474992
6606,325024080,123666,325147746,2,0,0,26112,4,175990385
6607,325047840,120691,325168531,2,0,0,42496,4,7001760259
6608,325075549,132786,325208335,7,0,0,47104,8,10013516333
6609,325244540,3387,325247927,0,0,1,9728,11,6089674874
6610,325261780,48980,325310760,5,0,0,2048,19,5869861365
6611,325320409,106184,325426593,1,0,0,48640,6,937626664
6612,325338710,157969,325496679,8,0,0,50688,12,2816303670
6613,325352010,157804,325509814,0,0,0,15872,11,562665752
6614,325359630,14117,325373747,4,0,1,24064,16,7369086516
6615,325388970,196046,325585016,4,0,0,41472,16,4166520037
6616,325457829,105872,325563701,7,0,0,47616,8,7788129382
6617,325482400,119867,325602267,0,0,0,16896,11,3667786582
6618,325512100,12308,325524408,1,0,1,20480,6,5962988127
6619,325522310,97508,325619818,2,0,0,6656,4,7979371953
6620,325562639,100242,325662881,1,0,0,30720,6,1118359073
6621,325658739,8554,325667293,3,0,1,11776,2,9879769458
6622,325717630,114920,325832550,8,0,0,77312,12,9108984746
6623,325720330,198260,325918590,8,0,0,34816,12,481540467
6624,325766509,108107,325874616,7,0,0,32768,8,637161070
6625,325768270,171266,325939536,2,0,0,6656,4,5614454168
6626,325854330,48504,325902834,2,0,0,1024,4,5308388944
6627,325873511,68224,325941735,6,0,0,7168,12,1534751794
6628,325933950,56840,325990790,5,0,0,7680,19,3738804504
6629,325992340,6754,325999094,4,0,1,7168,16,2046303887
6630,326025130,75920,326101050,8,0,0,14848,12,5255089451
6631,326076720,72380,326149100,3,0,0,13312,2,2174756086
6632,326326530,50672,326377202,2,0,0,2560,4,5021706487
6633,326418430,73004,326491434,5,0,0,15360,19,8948885131
6634,326534780,47288,326582068,8,0,0,1536,12,6637523522
6635,326571220,119600,326690820,5,0,0,92672,19,6984690293
6636,326624980,122060,326747040,2,0,0,12800,4,4844605568
6637,326630180,6229,326636409,7,0,1,15360,8,2434329174
6638,326814320,54056,326868376,4,0,0,3584,16,4846721935
6639,326815899,47288,326863187,7,0,0,1536,8,6165149425
6640,326853909,67592,326921501,1,0,0,7680,6,4569719593
6641,326925220,100724,327025944,8,0,0,30720,12,1289157478
6642,326949099,128163,327077262,1,0,0,26624,6,1094690700
6643,326961430,102284,327063714,8,0,0,35840,12,9674896840
6644,327009239,3422,327012661,8,0,1,3584,12,5929335126
6645,327012950,55942,327068892,8,0,0,3072,12,8899601407
6646,327028040,94400,327122440,3,0,0,25088,2,4988482881
6647,327045690,168994,327214684,3,0,0,28160,2,6565360445
6648,327071240,8501,327079741,9,0,1,2560,18,3458140200
6649,327074510,84022,327158532,0,0,0,7680,11,10703591298
6650,327098260,158341,327256601,4,0,0,10240,16,3895276563
6651,327131110,48980,327180090,5,0,0,2048,19,3274870175
6652,327210940,69636,327280576,5,0,0,7168,19,4655164400
6653,327291830,69596,327361426,4,0,0,9216,16,9629126604
6654,327301790,51140,327352930,4,0,0,4096,16,5991136313
6655,327358080,116792,327474872,5,0,0,83456,19,2227287144
6656,327392450,108192,327500642,3,0,0,35840,2,5419373042
6657,327451039,69421,327520460,7,0,0,1024,8,4610794122
6658,327451680,117626,327569306,0,0,0,22016,11,919191334
6659,327468770,105699,327574469,3,0,0,16896,2,6512543386
6660,327504450,74090,327578540,0,0,0,13312,11,4807926477
6661,327581080,5802,327586882,7,0,1,6144,8,5085903552
6662,327672051,62516,327734567,6,0,0,6144,12,5729479115
6663,327715880,47288,327763168,5,0,0,1536,19,7878028682
6664,327848270,1994,327850264,7,0,1,2048,8,1967165041
6665,327877690,86540,327964230,0,0,0,19456,11,10510618830
6666,327926981,99943,328026924,6,0,0,17408,12,6832066775
6667,328035440,109928,328145368,3,0,0,60928,2,7726661684
6668,328116590,84848,328201438,5,0,0,18944,19,743446835
6669,328211040,64208,328275248,3,0,0,6656,2,2955449329
6670,328232850,59132,328291982,0,0,0,5120,11,5333481933
6671,328265509,566,328266075,8,0,1,512,12,1377133655
6672,328355430,7230,328362660,5,0,1,7680,19,6613771714
6673,328433330,5802,328439132,7,0,1,6144,8,4204587579
6674,328441739,3422,328445161,3,0,1,3584,2,2557803056
6675,328490059,52366,328542425,7,0,0,3072,8,9684396361
6676,328490069,6246,328496315,8,0,1,15360,12,2138445164
6677,328531270,80864,328612134,8,0,0,20992,12,5276650154
6678,328605090,106620,328711710,0,0,0,48128,11,7283198107
6679,328608040,106550,328714590,4,0,0,7168,16,4054815971
6680,328745241,91616,328836857,6,0,0,20992,12,3899933074
6681,328767289,105478,328872767,1,0,0,6656,6,505886127
6682,328858001,65612,328923613,6,0,0,11264,12,1247598519
6683,329056969,98384,329155353,1,0,0,23040,6,3325487261
6684,329191030,2870,329193900,7,0,1,8704,8,9194854720
6685,329218540,104531,329323071,5,0,0,37888,19,7402388760
6686,329219869,57803,329277672,1,0,0,5120,6,7310665208
6687,329444990,1042,329446032,5,0,1,1024,19,10349778766
6688,329453820,71288,329525108,5,0,0,9728,19,8821105387
6689,329543629,66680,329610309,1,0,0,9728,6,3347268273
6690,329631550,3422,329634972,1,0,1,3584,6,4873969993
6691,329675559,55748,329731307,1,0,0,4096,6,6600503027
6692,329716131,116730,329832861,6,0,0,52736,12,9155701279
6693,329721790,10499,329732289,5,0,1,16896,19,55147380
6694,329772880,164433,329937313,2,0,0,4608,4,5143324605
6695,329785600,4679,329790279,9,0,1,12288,18,386534562
6696,329790120,100412,329890532,8,0,0,29696,12,5498395193
6697,329879449,81620,329961069,1,0,0,18432,6,10696181989
6698,329894550,114920,330009470,0,0,0,77312,11,2356256804
6699,329936070,127886,330063956,4,0,0,28160,16,2332050014
6700,329991189,115253,330106442,1,0,0,18432,6,8808145721
6701,330009300,69783,330079083,0,0,0,9216,11,1047885022
6702,330038480,13253,330051733,9,0,1,25600,18,4319055558
6703,330056710,155118,330211828,2,0,0,8704,4,4700959015
6704,330091700,116948,330208648,1,0,0,83968,6,4070168326
6705,330129700,126930,330256630,2,0,0,23552,4,8269980139
6706,330136380,5802,330142182,1,0,1,6144,6,5578175204
6707,330275081,49292,330324373,6,0,0,3072,12,6176715801
6708,330402150,107276,330509426,0,0,0,52224,11,318006988
6709,330425400,101504,330526904,4,0,0,33280,16,2084473951
6710,330451560,131102,330582662,5,0,0,63488,19,2948302502
6711,330459130,5196,330464326,4,0,1,13312,16,2765601639
6712,330595780,56216,330651996,8,0,0,5632,12,7638112085
6713,330613131,52832,330665963,6,0,0,4608,12,4506996920
6714,330625780,52364,330678144,8,0,0,3072,12,146785141
6715,330806080,82820,330888900,5,0,0,12288,19,7412708061
6716,330850830,130932,330981762,3,0,0,89088,2,6547363802
6717,330890459,1994,330892453,8,0,1,2048,12,4876745880
6718,330931210,80212,331011422,2,0,0,8192,4,8483824009
6719,330991210,4374,330995584,5,0,1,4608,19,141911163
6720,331061211,55748,331116959,6,0,0,4096,12,9074135592
6721,331067300,89744,331157044,4,0,0,14848,16,6324487649
6722,331280090,1518,331281608,1,0,1,1536,6,2478975403
6723,331293080,148526,331441606,8,0,0,28672,12,5442430651
6724,331323810,47288,331371098,8,0,0,1536,12,2064425286
6725,331386050,79436,331465486,2,0,0,11264,4,8436744037
6726,331417150,7706,331424856,9,0,1,8192,18,6237324315
6727,331434280,95310,331529590,4,0,0,7680,16,7384244365
6728,331485640,13600,331499240,5,0,1,23040,19,6284178734
6729,331534469,79436,331613905,1,0,0,11264,6,6772681824
6730,331560640,78603,331639243,0,0,0,2560,11,8985085549
6731,331594150,69464,331663614,8,0,0,13824,12,9545622765
6732,331606171,129401,331735572,6,0,0,22016,12,658751706
6733,331689410,100007,331789417,8,0,0,27648,12,2734577657
6734,331709480,141539,331851019,5,0,0,22016,19,1201383409
6735,331709939,96877,331806816,1,0,0,1536,6,10514805739
6736,331937010,98072,332035082,9,0,0,22016,18,9045382772
6737,332039639,77744,332117383,7,0,0,10752,8,7831476808
6738,332128470,113828,332242298,0,0,0,73728,11,2295430610
6739,332160560,150864,332311424,2,0,0,67584,4,7688144615
6740,332170660,74149,332244809,3,0,0,8192,2,10310146941
6741,332187900,7706,332195606,0,0,1,8192,11,3864343961
6742,332200460,5712,332206172,2,0,1,14336,4,3015245258
6743,332246620,79468,332326088,8,0,0,2560,12,5281434873
6744,332295970,166623,332462593,8,0,0,45568,12,8783833070
6745,332302200,63297,332365497,8,0,0,3584,12,1603354258
6746,332476240,43904,332520144,8,0,0,512,12,3133135164
6747,332532170,47288,332579458,0,0,0,1536,11,7982517161
6748,332637640,4374,332642014,2,0,1,4608,4,6245059230
6749,332690850,60980,332751830,5,0,0,6144,19,2116237214
6750,332795440,115388,332910828,8,0,0,78848,12,5489575688
6751,332818761,144057,332962818,6,0,0,21504,12,5708213788
6752,333021840,2470,333024310,7,0,1,2560,8,5204390722
6753,333140090,74360,333214450,4,0,0,9728,16,2680898185
6754,333177950,11016,333188966,0,0,1,17920,11,6686082875
6755,333296949,90524,333387473,7,0,0,17408,8,5245381474
6756,333358140,111869,333470009,2,0,0,13824,4,2345008192
6757,333503250,97604,333600854,3,0,0,20480,2,10373774359
6758,333531619,59132,333590751,1,0,0,5120,6,900254723
6759,333542330,65456,333607786,2,0,0,10752,4,8006605236
6760,333565270,136210,333701480,2,0,0,82432,4,6080974616
6761,333572180,56280,333628460,2,0,0,4096,4,2696853047
6762,333579860,148352,333728212,2,0,0,36864,4,567220786
6763,333680329,124519,333804848,7,0,0,39424,8,8224027178
6764,333696880,129376,333826256,2,0,0,18944,4,1599615007
6765,333745720,84526,333830246,8,0,0,10752,12,6905795439
6766,333785641,118999,333904640,6,0,0,47104,12,3434899342
6767,333881859,99164,333981023,7,0,0,25600,8,1348984671
6768,333882449,79748,333962197,7,0,0,12288,8,3752020169
6769,333909889,113184,334023073,7,0,0,8192,8,6561830992
6770,333956120,93411,334049531,4,0,0,11264,16,6008473755
6771,334052910,97448,334150358,4,0,0,19968,16,505031770
6772,334123800,69398,334193198,3,0,0,2048,2,2257927871
6773,334148240,101142,334249382,5,0,0,30208,19,6294048350
6774,334186449,138299,334324748,7,0,0,44544,8,1040399079
6775,334251340,1042,334252382,7,0,1,1024,8,9839424105
6776,334335451,47288,334382739,6,0,0,1536,12,6807252012
6777,334379060,67592,334446652,2,0,0,7680,4,1414135881
6778,334388810,61604,334450414,2,0,0,8192,4,3285329850
6779,334543649,6229,334549878,3,0,1,15360,2,8910493659
6780,334547290,104464,334651754,3,0,0,39424,2,7561043284
6781,334622800,120262,334743062,5,0,0,39424,19,2875647466
6782,334639420,206492,334845912,1,0,1,335360,6,2453385904
6783,334684800,286537,334971337,2,0,0,13824,4,3694706778
6784,334714540,227811,334942351,4,0,0,12800,16,10079503914
6785,334777880,71258,334849138,9,0,1,5120,18,5845543783
6786,334845891,261841,335107732,6,0,0,16384,12,7928778106
6787,334908239,159056,335067295,7,0,0,95744,8,10254767151
6788,334929749,3387,334933136,3,0,1,9728,2,6886315943
6789,334936940,224654,335161594,3,0,0,3072,2,2466977777
6790,334944830,5802,334950632,5,0,1,6144,19,9509294811
6791,335014940,5802,335020742,9,0,1,6144,18,5222856266
6792,335014960,10288,335025248,7,0,1,7168,8,1911587197
6793,335045170,66177,335111347,4,0,0,1024,16,4550461725
6794,335119400,72668,335192068,2,0,0,9216,4,1739585420
6795,335151450,45596,335197046,4,0,0,1024,16,1015479040
6796,335210061,59132,335269193,6,0,0,5120,12,7446113452
6797,335249270,76052,335325322,5,0,0,10240,19,2887469194
6798,335277360,99788,335377148,2,0,0,27648,4,4429973321
6799,335303010,98096,335401106,2,0,0,27136,4,1102429066
6800,335321880,103376,335425256,5,0,0,39424,19,6598493377
6801,335324779,143629,335468408,1,0,0,25088,6,2435002784
6802,335457640,121316,335578956,4,0,0,98304,16,2881933009
6803,335486320,3422,335489742,2,0,1,3584,4,5332858008
6804,335623069,1994,335625063,8,0,1,2048,12,3324113486
6805,335739389,71312,335810701,7,0,0,14848,8,2294781647
6806,335775969,101192,335877161,1,0,0,32256,6,6804879739
6807,335885920,48980,335934900,3,0,0,2048,2,6594960323
6808,336009340,78368,336087708,4,0,0,12800,16,8117080615
6809,336123140,101660,336224800,3,0,0,33792,2,2216470504
6810,336159130,95156,336254286,4,0,0,22528,16,3211195329
6811,336289000,94712,336383712,8,0,0,26112,12,1583737859
6812,336319890,97628,336417518,5,0,0,25600,19,4769084255
6813,336345889,52364,336398253,1,0,0,3072,6,9336975025
6814,336361900,111416,336473316,8,0,0,55808,12,9068240284
6815,336383430,166392,336549822,4,0,0,83968,16,3096816666
6816,336417190,3742,336420932,4,0,1,3584,16,4057237550
6817,336525970,123476,336649446,4,0,0,27136,16,6966251571
6818,336532110,20199,336552309,2,0,1,2560,4,10321781673
6819,336577239,74094,336651333,7,0,0,6144,8,6081456499
6820,336577339,5326,336582665,8,0,1,5632,12,3422774587
6821,336603270,103220,336706490,8,0,0,38912,12,5327456844
6822,336606921,238259,336845180,6,0,0,8704,12,7045117751
6823,336624099,2870,336626969,3,0,1,8704,2,440176773
6824,336631539,300146,336931685,7,0,0,38400,8,8902686712
6825,336635070,5326,336640396,9,0,1,5632,18,9534332957
6826,336666000,85136,336751136,4,0,0,14848,16,3583182630
6827,336691760,124410,336816170,3,0,0,20480,2,2619360291
6828,336765930,3898,336769828,9,0,1,4096,18,2881744354
6829,336819870,100100,336919970,5,0,0,28672,19,3624279670
6830,336826940,110860,336937800,2,0,0,19968,4,538869249
6831,336835150,3128,336838278,9,0,1,9216,18,3552696930
6832,336912021,185979,337098000,6,0,0,53248,12,8547629775
6833,336918960,99906,337018866,8,0,0,21504,12,1425816303
6834,336971800,132775,337104575,3,0,0,21504,2,10682836314
6835,336976060,61916,337037976,5,0,0,9216,19,10402936724
6836,337050929,131359,337182288,1,0,0,30208,6,4264868476
6837,337082900,178786,337261686,4,0,0,52736,16,3062341971
6838,337104450,163530,337267980,8,0,0,11776,12,3298289511
6839,337107911,102403,337210314,6,0,0,5120,12,4898933622
6840,337148769,7706,337156475,8,0,1,8192,12,1342887238
6841,337196079,110476,337306555,1,0,0,32256,6,9697472715
6842,337267331,218394,337485725,6,0,0,15360,12,2164875608
6843,337279941,105092,337385033,6,0,0,45056,12,6652352331
6844,337361760,90041,337451801,5,0,0,19968,19,8240526666
6845,337366671,68786,337435457,6,0,0,6656,12,2114913026
6846,337457899,76052,337533951,7,0,0,10240,8,2897266567
6847,337460210,99632,337559842,4,0,0,27136,16,1067389613
6848,337523680,20366,337544046,5,0,1,32768,19,5465197166
6849,337623380,150203,337773583,5,0,0,15872,19,8011957659
6850,337662960,71132,337734092,4,0,0,9216,16,3393334830
6851,337734241,60824,337795065,6,0,0,5632,12,5564362794
6852,337762730,72949,337835679,2,0,0,11776,4,174933525
6853,337866000,89588,337955588,5,0,0,14336,19,5079537887
6854,337911491,232666,338144157,6,0,0,19456,12,1597973978
6855,337923410,5326,337928736,5,0,1,5632,19,960327143
6856,337958990,104766,338063756,3,0,0,39424,2,697063581
6857,338035870,5326,338041196,7,0,1,5632,8,4584378584
6858,338117960,70885,338188845,2,0,0,2560,4,4554724642
6859,338146949,88988,338235937,1,0,0,17408,6,3673092760
6860,338214351,105404,338319755,6,0,0,46080,12,6986136733
6861,338218431,171566,338389997,6,0,0,48640,12,6366982320
6862,338277479,1994,338279473,8,0,1,2048,12,907400851
6863,338388630,84803,338473433,4,0,0,14336,16,2702466043
6864,338493360,107744,338601104,2,0,0,53760,4,9617308222
6865,338568230,96848,338665078,4,0,0,23040,16,3881920849
6866,338769050,93308,338862358,2,0,0,21504,4,2217761554
6867,338790609,163987,338954596,1,0,0,96256,6,910652146
6868,338794200,99617,338893817,8,0,0,3584,12,167096947
6869,338806469,152510,338958979,1,0,0,14336,6,10284445280
6870,338849340,111214,338960554,8,0,0,5120,12,4117156279
6871,338905229,95538,339000767,7,0,0,23552,8,9372296875
6872,338979590,69249,339048839,8,0,0,7680,12,3785374320
6873,339034939,52364,339087303,1,0,0,3072,6,3242474730
6874,339078700,84512,339163212,5,0,0,12800,19,3619877988
6875,339143580,307395,339450975,1,0,1,501760,6,6363999340
6876,339152690,348065,339500755,3,0,0,4096,2,7681150497
6877,339164510,288411,339452921,7,0,1,3072,8,4366999631
6878,339174169,298106,339472275,7,0,0,1536,8,1892170052
6879,339179680,274547,339454227,9,0,1,2048,18,812593832
6880,339370720,202707,339573427,4,0,0,8192,16,359187416
6881,339397899,211808,339609707,7,0,0,13312,8,6226564046
6882,339436570,20563,339457133,5,0,1,4608,19,10134878056
6883,339496000,142471,339638471,4,0,0,22016,16,10004271757
6884,339672600,114245,339786845,1,0,1,188928,6,2211323536
6885,339678570,275688,339954258,3,0,0,110592,2,7228968549
6886,339689620,176310,339865930,3,0,0,13312,2,1524313922
6887,339879350,107056,339986406,8,0,0,7168,12,2815560912
6888,339929479,88979,340018458,7,0,0,6656,8,1639395666
6889,339967090,4374,339971464,5,0,1,4608,19,7561805202
6890,339988140,50672,340038812,2,0,0,2560,4,1173921691
6891,339997010,100724,340097734,4,0,0,30720,16,3885629201
6892,340076610,86564,340163174,4,0,0,24576,16,7962314981
6893,340151959,566,340152525,2,0,1,512,4,8010370236
6894,340381311,72668,340453979,6,0,0,9216,12,8929505930
6895,340390200,66758,340456958,8,0,0,9728,12,5050457048
6896,340426100,64483,340490583,1,0,1,105472,6,2799119027
6897,340533791,62516,340596307,6,0,0,6144,12,553445776
6898,340626260,87608,340713868,0,0,0,17920,11,8823768883
6899,340777871,90163,340868034,6,0,0,26112,12,4195078276
6900,340797950,57440,340855390,8,0,0,4608,12,678415332
6901,340856980,62540,340919520,4,0,0,11264,16,5936783475
6902,340945410,101972,341047382,8,0,0,34816,12,4329836670
6903,341036430,47288,341083718,8,0,0,1536,12,5854713620
6904,341039130,57224,341096354,3,0,0,2048,2,3623788425
6905,341054270,65900,341120170,2,0,0,7168,4,8029155243
6906,341089240,74360,341163600,2,0,0,9728,4,5385000330
6907,341221710,10499,341232209,4,0,1,16896,16,9521350668
6908,341224760,56162,341280922,8,0,0,3584,12,367733690
6909,341241280,5326,341246606,5,0,1,5632,19,5288284987
6910,341276520,61074,341337594,2,0,0,4608,4,6997130260
6911,341313809,26221,341340030,8,0,1,47616,12,3116238943
6912,341346090,145669,341491759,2,0,0,34816,4,10149402863
6913,341386030,143847,341529877,5,0,0,32768,19,1514908612
6914,341411120,91484,341502604,5,0,0,7680,19,3511939513
6915,341431981,99939,341531920,6,0,0,6656,12,4432028481
6916,341505361,127680,341633041,6,0,0,71680,12,8789161603
6917,341541820,1042,341542862,0,0,1,1024,11,3425833038
6918,341643471,60824,341704295,6,0,0,5632,12,9217772
6919,341787120,106652,341893772,8,0,0,50176,12,3209229937
6920,341808540,32987,341841527,1,0,1,57344,6,7733917067
6921,341900230,108617,342008847,3,0,0,37376,2,3852282496
6922,341979169,130970,342110139,1,0,0,70144,6,7783306012
6923,342037579,136562,342174141,7,0,0,52224,8,5011489095
6924,342330150,58844,342388994,2,0,0,9216,4,9672422739
6925,342373959,1042,342375001,8,0,1,1024,12,4522306844
6926,342480229,102596,342582825,1,0,0,36864,6,6682061725
6927,342488881,105355,342594236,6,0,0,37376,12,5670780225
6928,342559120,85457,342644577,3,0,0,12288,2,5303655509
6929,342580130,46591,342626721,4,0,0,512,16,10302461651
6930,342601070,50672,342651742,3,0,0,2560,2,5926355107
6931,342705400,67592,342772992,4,0,0,7680,16,3829225824
6932,342789850,2470,342792320,5,0,1,2560,19,113473898
6933,342846380,81152,342927532,5,0,0,16896,19,3827775785
6934,342920520,89792,343010312,5,0,0,25088,19,1275010441
6935,343050130,47288,343097418,3,0,0,1536,2,4786707806
6936,343141200,1042,343142242,7,0,1,1024,8,1954914697
6937,343199190,104936,343304126,5,0,0,44544,19,3947986095
6938,343260049,6754,343266803,3,0,1,7168,2,2681995622
6939,343333359,104000,343437359,1,0,0,41472,6,6751719360
6940,343466450,13083,343479533,0,0,1,22016,11,873343134
6941,343540140,6754,343546894,9,0,1,7168,18,7993319414
6942,343543399,62516,343605915,7,0,0,6144,8,10127916717
6943,343602130,48980,343651110,5,0,0,2048,19,10513535011
6944,343691501,59912,343751413,6,0,0,7680,12,10589318097
6945,343776909,4420,343781329,8,0,1,11776,12,4886990398
6946,343820730,10499,343831229,4,0,1,16896,16,3780178808
6947,343878440,4374,343882814,0,0,1,4608,11,382770887
6948,343898951,169672,344068623,6,0,0,36352,12,10436838229
6949,343981110,128832,344109942,8,0,0,36352,12,469823038
6950,344041710,4850,344046560,0,0,1,5120,11,6878040653
6951,344065040,8425,344073465,2,0,1,5120,4,7804127316
6952,344095590,72504,344168094,2,0,0,8192,4,2789602948
6953,344112770,147618,344260388,2,0,0,6656,4,4797379386
6954,344133259,87141,344220400,1,0,0,22016,6,2627318537
6955,344180190,65414,344245604,3,0,0,3584,2,6536980923
6956,344194620,43904,344238524,2,0,0,512,4,8384359511
6957,344207769,70532,344278301,7,0,0,12288,8,8082970132
6958,344262470,102429,344364899,3,0,0,31232,2,5214048935
6959,344269140,86228,344355368,5,0,0,18432,19,883420501
6960,344317539,109460,344426999,1,0,0,59392,6,3852661984
6961,344479829,2946,344482775,3,0,1,3072,2,4016520046
6962,344557699,66992,344624691,7,0,0,10752,8,9880090766
6963,344561290,78056,344639346,5,0,0,11776,19,5080356617
6964,344609220,6229,344615449,1,0,1,15360,6,10260771528
6965,344636699,92719,344729418,1,0,0,20992,6,4806790435
6966,344649740,67479,344717219,2,0,0,6656,4,5661526513
6967,344661150,13600,344674750,5,0,1,23040,19,2140955293
6968,344825571,50828,344876399,6,0,0,3072,12,5814832925
6969,344902889,1042,344903931,3,0,1,1024,2,6161909608
6970,344919650,89744,345009394,4,0,0,14848,16,7100685244
6971,344941170,4374,344945544,2,0,1,4608,4,734892948
6972,344965940,86162,345052102,2,0,0,1536,4,5627367301
6973,344991610,1042,344992652,7,0,1,1024,8,9213985237
6974,345252360,1994,345254354,9,0,1,2048,18,9978179441
6975,345312379,52676,345365055,1,0,0,4096,6,9840368954
6976,345426360,1042,345427402,6,0,1,1024,12,900047385
6977,345455049,101972,345557021,1,0,0,34816,6,2803920141
6978,345536940,101660,345638600,2,0,0,33792,4,394031635
6979,345571490,140004,345711494,4,0,0,45056,16,9058935035
6980,345583189,238927,345822116,1,0,0,44032,6,6513719325
6981,345653919,109841,345763760,1,0,0,13824,6,8188573216
6982,345684810,47288,345732098,2,0,0,1536,4,9004546439
6983,345716960,5712,345722672,2,0,1,14336,4,4718821290
6984,345796390,62516,345858906,5,0,0,6144,19,10531719688
6985,345833080,14117,345847197,5,0,1,24064,19,10044135766
6986,345952119,4850,345956969,3,0,1,5120,2,6218617257
6987,346012160,7706,346019866,7,0,1,8192,8,9428125978
6988,346086349,98228,346184577,1,0,0,22528,6,10438509329
6989,346121470,100091,346221561,4,0,0,512,16,2134076294
6990,346245051,45596,346290647,6,0,0,1024,12,1328877370
6991,346306781,72668,346379449,6,0,0,9216,12,4885161438
6992,346384610,566,346385176,4,0,1,512,16,4710483884
6993,346461540,4162,346465702,9,0,1,11264,18,2495265293
6994,346507359,86096,346593455,1,0,0,23040,6,3753206858
6995,346537810,99241,346637051,8,0,0,2560,12,3536155505
6996,346575489,7706,346583195,2,0,1,8192,4,1902407970
6997,346688329,48980,346737309,7,0,0,2048,8,9105492464
6998,346866309,110708,346977017,7,0,0,63488,8,5235027515
6999,346895000,14117,346909117,1,0,1,24064,6,9233044873
7000,346966689,136395,347103084,1,0,0,101888,6,2715935804
7001,347113749,62516,347176265,7,0,0,6144,8,9140423046
7002,347143569,137102,347280671,1,0,0,120832,6,9705109592
7003,347145540,143273,347288813,8,0,0,25600,12,8185616169
7004,347171800,109198,347280998,8,0,0,1024,12,10419350687
7005,347189230,100386,347289616,5,0,0,2560,19,153505532
7006,347211370,122671,347334041,3,0,0,25600,2,5816765053
7007,347279569,132982,347412551,7,0,0,55296,8,4105462646
7008,347326630,88440,347415070,8,0,0,8192,12,3248840295
7009,347379909,89588,347469497,7,0,0,14336,8,4790138430
7010,347402880,84023,347486903,4,0,0,9728,16,9350299109
7011,347416969,13858,347430827,3,0,1,23552,2,10373893274
7012,347483150,91280,347574430,3,0,0,14848,2,10479324446
7013,347520360,93644,347614004,8,0,0,27648,12,3005104867
7014,347575209,127655,347702864,7,0,0,29696,8,1090055859
7015,347649350,2470,347651820,0,0,1,2560,11,1668172203
7016,347730190,48980,347779170,8,0,0,2048,12,9864031703
7017,347800199,99476,347899675,1,0,0,26624,6,538435023
7018,347817290,103688,347920978,8,0,0,40448,12,7805248502
7019,347839990,93147,347933137,3,0,0,14336,2,7337226692
7020,347909039,68615,347977654,1,0,0,7168,6,10593182293
7021,347914360,110947,348025307,5,0,0,42496,19,7834950547
7022,347917770,156965,348074735,3,0,0,68608,2,1732201157
7023,347971139,178674,348149813,1,0,0,87040,6,8983724690
7024,348091619,118135,348209754,7,0,0,74752,8,6145322492
7025,348168530,101972,348270502,5,0,0,34816,19,4159764796
7026,348376459,57440,348433899,1,0,0,4608,6,1587849126
7027,348379780,1518,348381298,0,0,1,1536,11,6092806076
7028,348402979,138712,348541691,7,0,0,31744,8,6095560280
7029,348406620,25446,348432066,9,0,1,46080,18,6607008631
7030,348436359,155930,348592289,7,0,0,70656,8,7569350649
7031,348498829,191753,348690582,1,0,0,24576,6,6761768908
7032,348502399,119128,348621527,1,0,0,9216,6,8576767592
7033,348600940,57596,348658536,4,0,0,5120,16,10066325658
7034,348642191,82820,348725011,6,0,0,12288,12,4690647653
7035,348807859,3422,348811281,3,0,1,3584,2,7963315721
7036,348846510,7706,348854216,7,0,1,8192,8,3444290
7037,349126581,55748,349182329,6,0,0,4096,12,10312397632
7038,349127450,112268,349239718,4,0,0,68608,16,4263647392
7039,349204551,47288,349251839,6,0,0,1536,12,640918088
7040,349303471,58220,349361691,6,0,0,7168,12,6171874708
7041,349308360,86685,349395045,5,0,0,4608,19,4688020610
7042,349341640,2946,349344586,0,0,1,3072,11,1078103867
7043,349347730,107339,349455069,4,0,0,37888,16,5981480626
7044,349354869,132366,349487235,1,0,0,11264,6,9121977557
7045,349420700,5802,349426502,5,0,1,6144,19,3954633535
7046,349491179,5802,349496981,3,0,1,6144,2,7112910942
7047,349550299,103376,349653675,7,0,0,39424,8,716142692
7048,349628461,72668,349701129,6,0,0,9216,12,9921038205
7049,349689989,1042,349691031,3,0,1,1024,2,1967917285
7050,349741320,68684,349810004,3,0,0,11264,2,10417824116
7051,349777910,99320,349877230,4,0,0,26112,16,9459873234
7052,349888520,98072,349986592,3,0,0,22016,2,2344900500
7053,349989450,89300,350078750,3,0,0,18432,2,6285480564
7054,350070629,1518,350072147,3,0,1,1536,2,5586321570
7055,350073130,82624,350155754,4,0,0,18432,16,6035055626
7056,350115609,566,350116175,3,0,1,512,2,3724250982
7057,350267511,107588,350375099,6,0,0,53248,12,2599070398
7058,350270170,44920,350315090,1,0,1,77312,6,10475295765
7059,350374249,3970,350378219,2,0,1,9216,4,3069817992
7060,350407389,48980,350456369,7,0,0,2048,8,9591261774
7061,350434549,3128,350437677,8,0,1,9216,12,7436040565
7062,350471790,69284,350541074,3,0,0,8192,2,6558473695
7063,350535849,179305,350715154,1,0,0,63488,6,932635238
7064,350649760,100880,350750640,3,0,0,31232,2,8281616543
7065,350807509,106184,350913693,7,0,0,48640,8,10692685400
7066,350830060,54056,350884116,5,0,0,3584,19,8583705640
7067,350863850,101647,350965497,3,0,0,9728,2,9689162350
7068,350908680,6523,350915203,7,0,1,1536,8,1829838506
7069,350945490,112268,351057758,4,0,0,68608,16,6928027127
7070,350958611,136599,351095210,6,0,0,30208,12,3156858350
7071,351064830,83312,351148142,8,0,0,18944,12,2400636168
7072,351148260,110353,351258613,0,0,0,51200,11,1501983596
7073,351149270,150350,351299620,3,0,0,26112,2,738981716
7074,351151649,111191,351262840,7,0,0,13824,8,10681883860
7075,351325520,107900,351433420,2,0,0,54272,4,3497838419
7076,351325770,110941,351436711,5,0,0,10752,19,906997071
7077,351352800,182626,351535426,9,0,0,2560,18,8745027240
7078,351368310,122452,351490762,3,0,0,24576,2,99060117
7079,351388930,130338,351519268,4,0,0,36352,16,5670759900
7080,351402800,172970,351575770,9,0,0,24064,18,7207142915
7081,351514319,15957,351530276,8,0,1,17920,12,4247619513
7082,351523209,68635,351591844,1,0,0,5120,6,5676361050
7083,351605191,65900,351671091,6,0,0,7168,12,8011503655
7084,351699090,76052,351775142,9,0,0,10240,18,8899202910
7085,351704371,65900,351770271,6,0,0,7168,12,4552182918
7086,351715700,98072,351813772,5,0,0,22016,19,6919858616
7087,351741550,6488,351748038,5,0,1,15872,19,7483122138
7088,351751690,566,351752256,4,0,1,512,16,6606379543
7089,351757280,101816,351859096,3,0,0,34304,2,6475520099
7090,351775220,43904,351819124,3,0,0,512,2,1328165964
7091,351793580,67247,351860827,8,0,0,5632,12,3632026921
7092,351840239,112268,351952507,1,0,0,68608,6,9994321454
7093,351841360,137841,351979201,9,0,0,7680,18,3496044160
7094,351866181,186850,352053031,6,0,0,22016,12,6640411767
7095,351917009,99944,352016953,1,0,0,28160,6,10607717595
7096,352157189,3128,352160317,3,0,1,9216,2,962514303
7097,352159580,96378,352255958,5,0,0,19968,19,7273920190
7098,352287939,117260,352405199,7,0,0,84992,8,873822939
7099,352344719,162618,352507337,7,0,0,28672,8,271055310
7100,352352490,98825,352451315,3,0,0,12288,2,8701710965
7101,352356021,74366,352430387,6,0,0,4096,12,5276979163
7102,352393040,17001,352410041,7,0,1,5120,8,4984473767
7103,352439840,69723,352509563,3,0,0,4608,2,1790119117
7104,352468560,7706,352476266,7,0,1,8192,8,3773488649
7105,352569410,78392,352647802,3,0,0,17920,2,7154323081
7106,352769720,55748,352825468,9,0,0,4096,18,9832160924
7107,352805320,120224,352925544,2,0,0,94720,4,4405113663
7108,352808160,3645,352811805,0,0,1,10240,11,1029101015
7109,352866880,60422,352927302,2,0,0,3584,4,8617902397
7110,353027190,3645,353030835,9,0,1,10240,18,1595183793
7111,353088471,97472,353185943,6,0,0,25088,12,7208172350
7112,353119891,100568,353220459,6,0,0,30208,12,7959927546
7113,353135270,87391,353222661,2,0,0,1024,4,5512901662
7114,353152469,13770,353166239,8,0,1,26624,12,5181149107
7115,353191870,60824,353252694,3,0,0,5632,2,10359845736
7116,353194789,110045,353304834,7,0,0,20480,8,5391231317
7117,353205650,1994,353207644,5,0,1,2048,19,2339946308
7118,353222270,64826,353287096,0,0,0,7168,11,6264516278
7119,353244939,159221,353404160,1,0,0,43008,6,8838851721
7120,353245410,3387,353248797,7,0,1,9728,8,1982517080
7121,353310879,99692,353410571,7,0,0,20992,8,10048710873
7122,353372540,125253,353497793,3,0,0,40960,2,2421897268
7123,353408031,132638,353540669,6,0,0,45568,12,2466130276
7124,353419830,103064,353522894,5,0,0,38400,19,5942481373
7125,353436259,144622,353580881,7,0,0,26112,8,6561676317
7126,353439060,45596,353484656,3,0,0,1024,2,4285345993
7127,353570769,10135,353580904,2,0,1,14336,4,6986928317
7128,353573469,117704,353691173,7,0,0,51200,8,4248809496
7129,353577950,97608,353675558,3,0,0,18432,2,5062389920
7130,353593429,137089,353730518,7,0,0,39936,8,8411253
7131,353659870,151780,353811650,3,0,0,82432,2,2059215386
7132,353664450,76364,353740814,8,0,0,11264,12,3920291901
7133,353681920,145720,353827640,9,0,0,12800,18,9755526737
7134,353736709,129658,353866367,7,0,0,38912,8,10410404436
7135,353917810,97136,354014946,5,0,0,18944,19,7471917018
7136,353948120,98128,354046248,8,0,0,4608,12,4274795149
7137,354005069,102908,354107977,1,0,0,37888,6,899261879
7138,354030960,111956,354142916,5,0,0,67584,19,2160299542
7139,354055489,4374,354059863,8,0,1,4608,12,566788095
7140,354230300,156554,354386854,1,0,1,258048,6,537085216
7141,354249599,140481,354390080,8,0,1,5120,12,6802927768
7142,354377050,17536,354394586,6,0,1,7168,12,5908484442
7143,354487540,3898,354491438,0,0,1,4096,11,7510282125
7144,354493681,149286,354642967,6,0,0,7168,12,8178008400
7145,354501361,275314,354776675,6,0,0,22016,12,5096712531
7146,354508490,41649,354550139,0,0,1,67584,11,9942701869
7147,354590301,166747,354757048,6,0,0,13824,12,10034174248
7148,354602129,150692,354752821,1,0,0,104448,6,7537122469
7149,354905050,101972,355007022,3,0,0,34816,2,10650324038
7150,354990559,73916,355064475,7,0,0,13312,8,2381783863
7151,355030859,111020,355141879,7,0,0,64512,8,68135027
7152,355084819,103758,355188577,1,0,0,25088,6,7923042149
7153,355127089,135162,355262251,1,0,0,38912,6,9807327090
7154,355207610,7706,355215316,9,0,1,8192,18,8251856113
7155,355295749,79436,355375185,1,0,0,11264,6,3656731592
7156,355367840,73141,355440981,2,0,0,8192,4,3097534015
7157,355374370,80243,355454613,9,0,0,11264,18,3000083749
7158,355379700,52364,355432064,8,0,0,3072,12,7806498022
7159,355436890,97136,355534026,9,0,0,18944,18,9810856315
7160,355463690,152902,355616592,2,0,0,61952,4,7981557114
7161,355529729,105013,355634742,1,0,0,30720,6,8266658033
7162,355585930,3645,355589575,6,0,1,10240,12,9184356794
7163,355691190,50672,355741862,2,0,0,2560,4,8231060679
7164,355722070,104312,355826382,9,0,0,42496,18,2051168168
7165,355824501,98697,355923198,6,0,0,17920,12,498966430
7166,355900559,5802,355906361,8,0,1,6144,12,4638505590
7167,356099360,105670,356205030,0,0,1,175616,11,1465789002
7168,356166050,99791,356265841,3,0,0,9216,2,10350179092
7169,356212510,7230,356219740,9,0,1,7680,18,5753925828
7170,356240920,93652,356334572,2,0,0,5632,4,5016406033
7171,356418739,69284,356488023,7,0,0,8192,8,482971978
7172,356454331,111176,356565507,6,0,0,65024,12,8238440833
7173,356483490,133971,356617461,9,0,0,32768,18,8809788022
7174,356497271,129964,356627235,6,0,0,13312,12,7497663782
7175,356550279,81828,356632107,7,0,0,4096,8,5220678843
7176,356649080,97292,356746372,8,0,0,19456,12,8589908982
7177,356703310,101972,356805282,8,0,0,34816,12,2789681288
7178,356731090,52364,356783454,5,0,0,3072,19,3762131022
7179,356749700,1994,356751694,4,0,1,2048,16,10563772266
7180,356764770,116154,356880924,8,0,0,75264,12,9994333732
7181,356844279,100256,356944535,7,0,0,29184,8,1324227214
7182,357036511,50672,357087183,6,0,0,2560,12,9866337738
7183,357095870,2946,357098816,5,0,1,3072,19,3319238981
7184,357098180,982,357099162,0,0,1,512,11,8266708697
7185,357101740,106184,357207924,8,0,0,48640,12,7402263185
7186,357127780,2946,357130726,7,0,1,3072,8,5100636271
7187,357155630,75334,357230964,2,0,0,1024,4,4132731216
7188,357165160,195393,357360553,2,0,0,101376,4,5645263958
7189,357229001,143267,357372268,6,0,0,38400,12,5514036350
7190,357399010,54056,357453066,8,0,0,3584,12,4940747344
7191,357405620,5731,357411351,1,0,1,14336,6,1383200525
7192,357405630,114038,357519668,5,0,0,23552,19,3383657231
7193,357454070,99164,357553234,2,0,0,25600,4,7786946709
7194,357591750,71600,357663350,8,0,0,10752,12,3696141947
7195,357600630,64607,357665237,9,0,0,6144,18,1262584546
7196,357676440,4374,357680814,6,0,1,4608,12,9652732781
7197,357776990,89948,357866938,3,0,0,25600,2,3084899109
7198,357786130,87375,357873505,2,0,0,21504,4,4780906184
7199,357884020,101972,357985992,5,0,0,34816,19,2334808183
7200,357898800,145742,358044542,1,0,1,237056,6,6819453168
7201,357939839,109990,358049829,8,0,1,16896,12,9435812452
7202,357951170,104151,358055321,1,0,1,17920,6,5029313267
7203,358047969,96303,358144272,1,0,0,3072,6,9930929329
7204,358145050,105252,358250302,2,0,0,18944,4,5337366921
7205,358148910,57440,358206350,2,0,0,4608,4,8533771819
7206,358172979,64232,358237211,1,0,0,11776,6,9367370192
7207,358245359,103787,358349146,7,0,0,24576,8,10524365681
7208,358263760,1042,358264802,4,0,1,1024,16,10470940505
7209,358309401,72536,358381937,6,0,0,13824,12,5811928397
7210,358452320,99320,358551640,8,0,0,26112,12,1070700849
7211,358517130,105790,358622920,5,0,0,46080,19,5386385556
7212,358600419,123013,358723432,1,0,0,76288,6,4270023705
7213,358622661,158221,358780882,6,0,0,36864,12,6718027046
7214,358708210,49064,358757274,1,0,1,55808,6,304035960
7215,358723729,173808,358897537,7,0,0,53248,8,4671799699
7216,358753850,164745,358918595,8,0,0,14848,12,2015590910
7217,358762289,7230,358769519,2,0,1,7680,4,7676600900
7218,358766919,191324,358958243,7,0,0,18944,8,1474785382
7219,358895279,154087,359049366,1,0,0,8192,6,9335926633
7220,358899290,51257,358950547,6,0,1,82944,12,211966261
7221,358985540,107276,359092816,8,0,0,52224,12,5260579512
7222,359123250,45596,359168846,3,0,0,1024,2,5430528250
7223,359158820,101660,359260480,8,0,0,33792,12,298359181
7224,359222190,101348,359323538,2,0,0,32768,4,5600943177
7225,359353271,49136,359402407,6,0,0,2560,12,5498373690
7226,359365620,50672,359416292,8,0,0,2560,12,2621977828
7227,359433839,90548,359524387,7,0,0,22528,8,4510309197
7228,359438239,3387,359441626,8,0,1,9728,12,9039130377
7229,359524489,91748,359616237,7,0,0,16384,8,5778147617
7230,359540790,566,359541356,4,0,1,512,16,3518007138
7231,359567121,134436,359701557,6,0,0,16896,12,10511224255
7232,359678890,3422,359682312,4,0,1,3584,16,691321013
7233,359726540,60224,359786764,9,0,0,8704,18,8294067541
7234,359780260,6519,359786779,9,0,1,11264,18,4517234736
7235,359895530,78992,359974522,9,0,0,14848,18,3225349834
7236,360414761,81596,360496357,6,0,0,13312,12,4239743687
7237,360445530,74360,360519890,8,0,0,9728,12,3477313567
7238,360503649,1518,360505167,2,0,1,1536,4,7759949933
7239,360619790,76052,360695842,5,0,0,10240,19,8353385726
7240,360669899,98408,360768307,7,0,0,28160,8,10372718460
7241,360681619,52676,360734295,7,0,0,4096,8,9200945974
7242,360721030,133665,360854695,9,0,0,27136,18,7846176096
7243,360867179,52364,360919543,7,0,0,3072,8,6128596494
7244,361074370,74360,361148730,9,0,0,9728,18,1050816136
7245,361110171,98696,361208867,6,0,0,24064,12,5004554392
7246,361143169,97916,361241085,1,0,0,21504,6,9048837883
7247,361217820,52364,361270184,9,0,0,3072,18,1516521848
7248,361321920,45596,361367516,3,0,0,1024,2,4520599311
7249,361340299,99320,361439619,7,0,0,26112,8,10006500136
7250,361429900,60824,361490724,5,0,0,5632,19,6625218733
7251,361466519,566,361467085,8,0,1,512,12,4370504861
7252,361552550,48980,361601530,5,0,0,2048,19,2125578423
7253,361669430,1518,361670948,4,0,1,1536,16,932115376
7254,361681910,92372,361774282,8,0,0,18432,12,9113297365
7255,361744970,51728,361796698,2,0,0,3072,4,8677999383
7256,361755840,2870,361758710,6,0,1,8704,12,5682534974
7257,361766180,112772,361878952,8,0,0,45056,12,1536201445
7258,361815200,82370,361897570,0,0,0,7168,11,9477506596
7259,361839920,2470,361842390,7,0,1,2560,8,1624489528
7260,361949250,60224,362009474,0,0,0,8704,11,5091863380
7261,361956430,1994,361958424,4,0,1,2048,16,9484031285
7262,361977230,7706,361984936,4,0,1,8192,16,3077953142
7263,361986530,96380,362082910,9,0,0,21504,18,8877417649
7264,362058100,3128,362061228,7,0,1,9216,8,6186741008
7265,362137810,139527,362277337,3,0,0,25600,2,2638953195
7266,362177689,113844,362291533,1,0,0,6656,6,7039520512
7267,362298740,100880,362399620,0,0,0,31232,11,6185086315
7268,362323430,156080,362479510,0,0,0,60416,11,5965410578
7269,362402280,2946,362405226,0,0,1,3072,11,7407073442
7270,362440700,84554,362525254,3,0,0,6656,2,6831023112
7271,362486290,87396,362573686,2,0,0,2048,4,6323359188
7272,362518230,1994,362520224,0,0,1,2048,11,1694545500
7273,362522939,90860,362613799,1,0,0,23552,6,4379607843
7274,362528610,117629,362646239,8,0,0,16384,12,2716260417
7275,362536920,104312,362641232,3,0,0,42496,2,7338890898
7276,362577020,176244,362753264,0,0,0,39936,11,651152512
7277,362590030,144466,362734496,2,0,0,33792,4,6707005881
7278,362658830,94605,362753435,5,0,0,512,19,1997735858
7279,362708520,4850,362713370,1,0,1,5120,6,1812823064
7280,362799059,108702,362907761,7,0,0,50688,8,604171408
7281,362817510,1042,362818552,0,0,1,1024,11,6323663529
7282,362895470,93747,362989217,2,0,0,17920,4,6910563207
7283,362897479,12293,362909772,8,0,1,2048,12,580113333
7284,363007240,114844,363122084,9,0,0,39936,18,9572544418
7285,363026389,131041,363157430,7,0,0,3584,8,2184663217
7286,363030500,96336,363126836,3,0,0,5120,2,539722415
7287,363115700,105072,363220772,8,0,0,24064,12,5198822864
7288,363130330,2946,363133276,7,0,1,3072,8,7685042968
7289,363133870,43904,363177774,0,0,0,512,11,408154518
7290,363148731,74084,363222815,6,0,0,6656,12,9994517080
7291,363204421,95180,363299601,6,0,0,27648,12,1815791527
7292,363207229,54056,363261285,7,0,0,3584,8,3499321841
7293,363234460,74516,363308976,3,0,0,10240,2,8657404425
7294,363290130,48980,363339110,3,0,0,2048,2,7099815953
7295,363299640,1042,363300682,9,0,1,1024,18,10690822660
7296,363337601,103196,363440797,6,0,0,32256,12,9724178554
7297,363340430,90524,363430954,5,0,0,17408,19,5075902914
7298,363377010,86269,363463279,5,0,0,5632,19,1169913469
7299,363475330,86384,363561714,8,0,0,18944,12,10084310991
7300,363496259,79772,363576031,1,0,0,17408,6,1113614707
7301,363555770,163408,363719178,6,0,1,264704,12,5828104591
7302,363598110,133429,363731539,8,0,0,1024,12,6500462577
7303,363706709,55136,363761845,7,0,0,3584,8,8311987358
7304,363822190,107336,363929526,9,0,0,12800,18,4286515350
7305,363858870,10757,363869627,7,0,1,17408,8,3732115314
7306,363979439,136230,364115669,1,0,0,20992,6,9466815088
7307,363993020,58688,364051708,2,0,0,8704,4,4400235318
7308,364034769,52364,364087133,7,0,0,3072,8,5602696108
7309,364065070,79447,364144517,0,0,0,7680,11,5555452984
7310,364223151,72668,364295819,6,0,0,9216,12,4977731816
7311,364234460,14545,364249005,7,0,1,28160,8,8432291878
7312,364278530,250641,364529171,5,0,0,76800,19,4306974644
7313,364297050,73916,364370966,0,0,0,13312,11,7294261813
7314,364392130,147820,364539950,2,0,0,35328,4,7452925759
7315,364471680,118547,364590227,5,0,0,12800,19,9845658812
7316,364545460,137079,364682539,1,0,1,226816,6,7730197081
7317,364572430,157791,364730221,6,0,1,162816,12,7265932407
7318,364595960,140041,364736001,0,0,0,11776,11,1855762650
7319,364614090,121926,364736016,0,0,1,5120,11,2082656666
7320,364637209,249256,364886465,1,0,0,33280,6,6542462356
7321,364678019,60254,364738273,2,0,1,7680,4,9384656381
7322,364763640,178180,364941820,8,0,0,16896,12,5417887100
7323,364766900,177246,364944146,5,0,0,2560,19,10657255030
7324,364769780,14287,364784067,4,0,1,27648,16,4810234597
7325,364859810,12049,364871859,9,0,1,19968,18,1981302462
7326,365092060,104780,365196840,9,0,0,44032,18,10528071224
7327,365093109,3128,365096237,2,0,1,9216,4,5916272642
7328,365174630,22225,365196855,7,0,1,23040,8,6952908143
7329,365215630,117381,365333011,8,0,0,39424,12,10598609246
7330,365256070,98775,365354845,2,0,0,4096,4,8241507466
7331,365316780,99008,365415788,8,0,0,25088,12,3521133655
7332,365327010,140738,365467748,3,0,0,34304,2,606877003
7333,365435950,48980,365484930,0,0,0,2048,11,1468685884
7334,365495530,104000,365599530,5,0,0,41472,19,8587741123
7335,365504929,566,365505495,8,0,1,512,12,7583496807
7336,365539290,60411,365599701,5,0,0,512,19,2816789715
7337,365556149,64208,365620357,7,0,0,6656,8,323971
7338,365687680,5326,365693006,0,0,1,5632,11,2677953486
7339,365712629,102752,365815381,1,0,0,37376,6,2638066714
7340,365776610,83600,365860210,3,0,0,14848,2,6393920229
7341,366025419,118820,366144239,7,0,0,90112,8,2801112052
7342,366026560,147019,366173579,9,0,0,25088,18,2509868277
7343,366060319,199414,366259733,7,0,0,79872,8,1326324197
7344,366123130,162877,366286007,3,0,0,8704,2,9349572098
7345,366184289,153480,366337769,7,0,0,66560,8,789511191
7346,366233410,123882,366357292,0,0,0,64000,11,2424994689
7347,366255240,102847,366358087,5,0,0,2560,19,6080646048
7348,366298230,64208,366362438,3,0,0,6656,2,157530915
7349,366318510,123875,366442385,3,0,0,43520,2,6939330590
7350,366370160,140118,366510278,8,0,0,40960,12,10474788355
7351,366500720,117606,366618326,9,0,0,54784,18,8761780774
7352,366505240,68663,366573903,0,0,0,9728,11,8062691536
7353,366587630,112956,366700586,8,0,0,25088,12,2307684753
7354,366677070,65900,366742970,0,0,0,7168,11,8195271325
7355,366758329,109304,366867633,1,0,0,58880,6,2309960383
7356,366800010,110541,366910551,0,0,0,32256,11,7556076392
7357,366964690,24929,366989619,4,0,1,45056,16,8863257716
7358,367292930,87632,367380562,8,0,0,23040,12,2355405990
7359,367445209,115388,367560597,1,0,0,78848,6,6000184687
7360,367529500,97253,367626753,0,0,0,21504,11,3313080868
7361,367531820,28792,367560612,0,0,1,18944,11,4651172786
7362,367574150,164955,367739105,5,0,0,22016,19,7267097736
7363,367614560,3387,367617947,4,0,1,9728,16,7283333929
7364,367741140,99944,367841084,2,0,0,28160,4,5203480990
7365,367765800,117087,367882887,6,0,1,194560,12,1767943097
7366,367774189,200980,367975169,7,0,0,30208,8,1352654834
7367,367846910,92260,367939170,8,0,0,6656,12,4679808919
7368,367927320,200164,368127484,8,0,0,63488,12,8730338352
7369,367932510,1994,367934504,0,0,1,2048,11,1566605641
7370,368050320,141448,368191768,5,0,0,113152,19,1398039255
7371,368217790,58688,368276478,0,0,0,8704,11,4115194645
7372,368222170,98228,368320398,3,0,0,22528,2,7502250365
7373,368231650,81620,368313270,5,0,0,9216,19,1735044270
7374,368248900,139304,368388204,0,0,0,62464,11,549082023
7375,368272179,1042,368273221,8,0,1,1024,12,2018161199
7376,368286830,152086,368438916,2,0,0,67584,4,2687292786
7377,368363410,146672,368510082,0,0,0,29696,11,8774445099
7378,368511650,74672,368586322,8,0,0,10752,12,8311716026
7379,368694730,94400,368789130,0,0,0,25088,11,1668311244
7380,368731400,81952,368813352,2,0,0,7680,4,8388344513
7381,368756580,74852,368831432,3,0,0,16384,2,9536962442
7382,368874019,80372,368954391,7,0,0,14336,8,5856610376
7383,368942330,1518,368943848,9,0,1,1536,18,4058993367
7384,368971540,137920,369109460,5,0,0,5120,19,8745995449
7385,369012810,6754,369019564,9,0,1,7168,18,1707325639
7386,369078970,80840,369159810,2,0,0,15872,4,5166136149
7387,369119870,101816,369221686,8,0,0,34304,12,1834487750
7388,369172310,83441,369255751,1,0,1,135680,6,8801711919
7389,369187940,180767,369368707,9,0,0,41472,18,9633448270
7390,369223530,111817,369335347,3,0,0,2560,2,1539532373
7391,369330169,69330,369399499,1,0,0,9216,6,4204178649
7392,369349850,1994,369351844,4,0,1,2048,16,4430340475
7393,369443420,111800,369555220,8,0,0,67072,12,8231542472
7394,369464070,97257,369561327,2,0,0,19968,4,5796610657
7395,369489819,90505,369580324,1,0,0,1024,6,3942847727
7396,369536580,103144,369639724,3,0,0,12800,2,7383752291
7397,369598060,81752,369679812,5,0,0,13824,19,6422306745
7398,369674961,105248,369780209,6,0,0,45568,12,3453091406
7399,369727310,87296,369814606,8,0,0,16896,12,8816430850
7400,369838000,7706,369845706,1,0,1,8192,6,8761723111
7401,369850580,48980,369899560,8,0,0,2048,12,3731735905
7402,369937500,95024,370032524,5,0,0,27136,19,6045974245
7403,369989571,80711,370070282,6,0,0,13824,12,9007108820
7404,369991990,117628,370109618,8,0,0,16896,12,9904455651
7405,370037331,133133,370170464,6,0,0,13824,12,9633511393
7406,370127040,2946,370129986,4,0,1,3072,16,1251948749
7407,370219580,103376,370322956,0,0,0,39424,11,2118598940
7408,370267530,14029,370281559,1,0,1,27136,6,10458548911
7409,370314090,93850,370407940,6,0,1,138752,12,5641050228
7410,370388620,24146,370412766,0,0,1,7680,11,7309989950
7411,370406071,208133,370614204,6,0,0,4096,12,6687236694
7412,370499330,1042,370500372,7,0,1,1024,8,104734464
7413,370499929,5326,370505255,2,0,1,5632,4,9523793413
7414,370538911,95624,370634535,6,0,0,24064,12,4179900621
7415,370571390,130189,370701579,3,0,0,25088,2,10645750983
7416,370589180,82094,370671274,9,0,0,3072,18,10563077888
7417,370746299,99944,370846243,1,0,0,28160,6,4079507885
7418,370777090,101036,370878126,8,0,0,31744,12,7332676412
7419,370835610,82064,370917674,0,0,0,14848,11,5934216583
7420,370896499,89012,370985511,1,0,0,22528,6,2635478245
7421,370929000,144723,371073723,8,0,0,17408,12,5946714971
7422,371066250,99164,371165414,2,0,0,25600,4,128367606
7423,371081430,1042,371082472,9,0,1,1024,18,8035999548
7424,371127719,59288,371187007,7,0,0,5632,8,57424991
7425,371221260,111644,371332904,2,0,0,66560,4,9562769209
7426,371332690,108172,371440862,5,0,0,52736,19,5512564265
7427,371333430,152372,371485802,3,0,0,38912,2,8474277413
7428,371388460,129850,371518310,9,0,0,35328,18,2387515639
7429,371418590,105972,371524562,2,0,0,2560,4,8548220518
7430,371453410,81268,371534678,9,0,0,6144,18,6696645900
7431,371502600,111368,371613968,5,0,0,38400,19,8903712212
7432,371587810,93994,371681804,5,0,0,13824,19,4814245378
7433,371597130,16853,371613983,0,0,1,5632,11,1601069271
7434,371648310,89624,371737934,9,0,0,20480,18,10578574341
7435,371700060,62096,371762156,9,0,0,3072,18,6442688516
7436,371744130,92396,371836526,5,0,0,23552,19,704252196
7437,371766430,1042,371767472,4,0,1,1024,16,10313401385
7438,371811040,65900,371876940,9,0,0,7168,18,8539604903
7439,371824119,2870,371826989,8,0,1,8704,12,7244981062
7440,371878279,55748,371934027,1,0,0,4096,6,4418372008
7441,371889120,98540,371987660,9,0,0,23552,18,165621970
7442,371990769,11791,372002560,2,0,1,19456,4,1350461992
7443,372027470,4374,372031844,1,0,1,4608,6,4358419431
7444,372043700,107880,372151580,8,0,0,29696,12,8615244479
7445,372052860,181170,372234030,3,0,0,28672,2,2351985436
7446,372105110,82668,372187778,0,0,0,11264,11,79424242
7447,372112729,3422,372116151,3,0,1,3584,2,1964885302
7448,372126419,117769,372244188,1,0,0,25600,6,7874103630
7449,372241490,80590,372322080,0,0,0,11264,11,6355369020
7450,372249531,123656,372373187,6,0,0,105984,12,380056163
7451,372306109,137014,372443123,1,0,0,35840,6,7307492201
7452,372336919,122716,372459635,7,0,0,19456,8,4368591972
7453,372386650,4162,372390812,5,0,1,11264,19,3541181697
7454,372391570,73292,372464862,8,0,0,11264,12,8202436824
7455,372451230,171065,372622295,8,0,0,72704,12,8433180010
7456,372453751,103636,372557387,6,0,0,20992,12,6406562711
7457,372490650,98250,372588900,0,0,0,6656,11,10516008671
7458,372525370,5971,372531341,1,0,1,14848,6,6749111981
7459,372596620,76154,372672774,3,0,0,9216,2,4794905518
7460,372624590,102910,372727500,2,0,0,11264,4,8770607523
7461,372671329,99977,372771306,7,0,0,23552,8,6015548399
7462,372806390,70376,372876766,5,0,0,11776,19,1220638096
7463,372822100,55773,372877873,0,0,0,3584,11,6546376783
7464,372879650,97340,372976990,8,0,0,29696,12,3146499617
7465,372886630,51296,372937926,5,0,0,4608,19,1465875131
7466,372943720,11533,372955253,6,0,1,18944,12,7824953420
7467,372961290,2470,372963760,1,0,1,2560,6,5293373667
7468,373079480,4162,373083642,7,0,1,11264,8,77838261
7469,373098200,175725,373273925,8,0,0,43008,12,420950872
7470,373112420,164640,373277060,9,0,0,10240,18,1017829323
7471,373249210,103688,373352898,9,0,0,40448,18,5294702022
7472,373287329,91411,373378740,7,0,0,8192,8,4168867255
7473,373331310,21611,373352921,4,0,1,28672,16,1264908074
7474,373341379,57465,373398844,8,0,1,79360,12,1739367331
7475,373406810,3387,373410197,5,0,1,9728,19,7454136695
7476,373425330,132411,373557741,9,0,0,58880,18,826813634
7477,373659161,82556,373741717,6,0,0,21504,12,10195132007
7478,373668219,3898,373672117,5,0,1,4096,19,9120817638
7479,373675310,111750,373787060,5,0,0,44544,19,3073377457
7480,373710090,7706,373717796,6,0,1,8192,12,6770488603
7481,373737260,26107,373763367,4,0,1,35328,16,4531803338
7482,373921090,45596,373966686,3,0,0,1024,2,3157269817
7483,373962690,74672,374037362,3,0,0,10752,2,4178104619
7484,373983480,47288,374030768,0,0,0,1536,11,9982567774
7485,373992920,1518,373994438,4,0,1,1536,16,3961369945
7486,374117101,86360,374203461,6,0,0,13824,12,7709937699
7487,374126230,59132,374185362,2,0,0,5120,4,5404284814
7488,374136320,99320,374235640,8,0,0,26112,12,4263172537
7489,374168920,67047,374235967,8,0,0,1024,12,5975892515
7490,374192220,83624,374275844,2,0,0,19968,4,4071041518
7491,374231780,140520,374372300,2,0,0,36864,4,6436600695
7492,374268630,65900,374334530,0,0,0,7168,11,1593616108
7493,374341389,95156,374436545,7,0,0,22528,8,1380934578
7494,374346421,106690,374453111,6,0,0,10240,12,6735121049
7495,374380220,150441,374530661,0,0,0,31744,11,5151877957
7496,374452579,172465,374625044,1,0,0,29696,6,6703133631
7497,374470530,82820,374553350,9,0,0,12288,18,552980164
7498,374542959,566,374543525,2,0,1,512,4,6976396211
7499,374651720,107276,374758996,0,0,0,52224,11,6143471822
7500,374778210,67592,374845802,3,0,0,7680,2,705242215
7501,374898300,99008,374997308,2,0,0,25088,4,10643753296
7502,374937300,5196,374942496,0,0,1,13312,11,3596666803
7503,374955750,93683,375049433,8,0,0,13312,12,9072956861
7504,374982409,57440,375039849,1,0,0,4608,6,8823334739
7505,375007761,66680,375074441,6,0,0,9728,12,9623128686
7506,375129300,85316,375214616,9,0,0,20480,18,5869011462
7507,375174080,72068,375246148,0,0,0,12288,11,4658326135
7508,375263900,109616,375373516,2,0,0,59904,4,6968773516
7509,375421309,92164,375513473,7,0,0,10752,8,1480978020
7510,375435729,101972,375537701,7,0,0,34816,8,5165775624
7511,375471590,52364,375523954,2,0,0,3072,4,10228309437
7512,375498939,77473,375576412,7,0,0,12800,8,3305390265
7513,375552069,2470,375554539,3,0,1,2560,2,5741536632
7514,375573590,9568,375583158,9,0,1,7168,18,1836219274
7515,375588891,76383,375665274,6,0,0,8704,12,2010934450
7516,375617570,196832,375814402,5,0,0,184832,19,8627586275
7517,375638660,180749,375819409,3,0,0,16384,2,8024686985
7518,375770050,137451,375907501,3,0,0,24576,2,2018032326
7519,375794730,80444,375875174,9,0,0,4096,18,4367104256
7520,375814910,121801,375936711,5,0,0,84992,19,9149674760
7521,375869660,96847,375966507,2,0,0,4096,4,7518853312
7522,375878331,99108,375977439,6,0,0,9728,12,400839730
7523,376016900,48980,376065880,3,0,0,2048,2,6656546278
7524,376084580,1042,376085622,7,0,1,1024,8,10326032288
7525,376200230,101816,376302046,9,0,0,34304,18,727932199
7526,376216251,98743,376314994,6,0,0,11264,12,4572928309
7527,376243020,21658,376264678,6,0,1,35328,12,4066347779
7528,376300230,4278,376304508,4,0,1,2560,16,1236608292
7529,376308760,170825,376479585,3,0,0,9216,2,10226916881
7530,376397810,4850,376402660,0,0,1,5120,11,9697422225
7531,376435940,71756,376507696,3,0,0,11264,2,8281531787
7532,376465580,84092,376549672,5,0,0,21504,19,5794983883
7533,376507259,51170,376558429,8,0,1,81920,12,6198627322
7534,376530120,28975,376559095,4,0,1,11264,16,8983081396
7535,376576060,124445,376700505,0,0,0,19456,11,8503557103
7536,376631940,177323,376809263,8,0,0,45568,12,7523185077
7537,376634309,73990,376708299,7,0,0,3584,8,936979187
7538,376665850,152181,376818031,3,0,0,15360,2,2297386521
7539,376698240,126982,376825222,9,0,0,23552,18,4406002533
7540,376731289,385382,377116671,8,0,1,623616,12,6513515993
7541,376773900,453045,377226945,9,0,0,53248,18,4185603708
7542,376795650,268975,377064625,2,0,0,6656,4,6540035920
7543,376842430,279067,377121497,9,0,1,7680,18,7807544073
7544,376862650,306529,377169179,6,0,1,162816,12,740398926
7545,376924490,440017,377364507,2,0,0,56832,4,2660919854
7546,376984151,243433,377227584,6,0,0,2048,12,5701682105
7547,376996010,472902,377468912,0,0,0,43520,11,10338267494
7548,377005239,288003,377293242,8,0,1,405504,12,9985601417
7549,377025880,271228,377297108,1,0,1,6144,6,10661854731
7550,377066780,385981,377452761,9,0,0,41472,18,802956723
7551,377251360,46619,377297979,5,0,1,12288,19,1549708798
7552,377291390,306611,377598001,0,0,0,3072,11,2626125111
7553,377320860,274193,377595053,2,0,0,8704,4,2013585819
7554,377419000,259238,377678238,9,0,0,10752,18,1997834987
7555,377463180,172276,377635456,8,0,0,13312,12,912609910
7556,377468430,251062,377719492,5,0,0,22016,19,6957040200
7557,377571930,165468,377737398,2,0,0,48640,4,1385188256
7558,377589320,232901,377822221,5,0,0,55808,19,7914189433
7559,377682651,115775,377798426,6,0,0,37376,12,3773680614
7560,377759580,193268,377952848,9,0,0,26624,18,6381398815
7561,377765130,139892,377905022,9,0,0,87552,18,4185224624
7562,377883600,117782,378001382,3,0,0,18432,2,222032941
7563,377917379,74613,377991992,1,0,0,6656,6,3739026564
7564,377925380,109800,378035180,5,0,0,12288,19,9468881734
7565,377934420,68381,378002801,8,0,0,4608,12,5559396473
7566,377973099,73833,378046932,8,0,1,120320,12,189148368
7567,378000200,156996,378157196,9,0,0,21504,18,2676153055
7568,378031870,181234,378213104,2,0,0,6144,4,4245984490
7569,378104380,139006,378243386,2,0,0,3584,4,10496275946
7570,378113560,150614,378264174,8,0,0,28160,12,7278553216
7571,378211920,56118,378268038,8,0,0,512,12,8601686666
7572,378230430,93272,378323702,5,0,0,17920,19,5395712593
7573,378361550,80684,378442234,8,0,0,15360,12,6313108743
7574,378407220,72694,378479914,9,0,0,10752,18,7626813076
7575,378441839,14674,378456513,8,0,1,27648,12,527501628
7576,378534330,5326,378539656,4,0,1,5632,16,6611982353
7577,378546069,1518,378547587,2,0,1,1536,4,8267470733
7578,378617480,103220,378720700,3,0,0,38912,2,5738216989
7579,378650041,161535,378811576,6,0,0,12288,12,9167373011
7580,378661270,60857,378722127,3,0,0,4608,2,4337734338
7581,378666740,99794,378766534,8,0,0,11776,12,8493022022
7582,378712010,154232,378866242,3,0,0,34304,2,3213642620
7583,378826280,105872,378932152,9,0,0,47616,18,1290910655
7584,378832250,124310,378956560,0,0,0,11776,11,1631267272
7585,378902390,5454,378907844,7,0,1,13824,8,10476471138
7586,378921200,108236,379029436,0,0,0,19456,11,7287309273
7587,378963250,55748,379018998,3,0,0,4096,2,2826689671
7588,379022410,12049,379034459,6,0,1,19968,12,1050860105
7589,379031610,3835,379035445,9,0,1,1536,18,3162551620
7590,379199760,66992,379266752,0,0,0,10752,11,621211737
7591,379258880,1042,379259922,9,0,1,1024,18,3896061539
7592,379413281,71288,379484569,6,0,0,9728,12,2633622958
7593,379418770,3422,379422192,6,0,1,3584,12,1074347463
7594,379421541,91280,379512821,6,0,0,14848,12,5043949121
7595,379509510,65819,379575329,2,0,0,6144,4,1452972770
7596,379564280,105404,379669684,8,0,0,46080,12,376730643
7597,379565820,111688,379677508,2,0,0,11264,4,7781549107
7598,379601421,120061,379721482,6,0,0,13312,12,10367073534
7599,379623650,82736,379706386,3,0,0,4096,2,5416667709
7600,379641890,103082,379744972,5,0,0,26624,19,4229685454
7601,379672650,4873,379677523,7,0,1,11776,8,2749026194
7602,379702380,5326,379707706,9,0,1,5632,18,7235395976
7603,379807589,106588,379914177,1,0,0,43008,6,10664006466
7604,379886050,2870,379888920,9,0,1,8704,18,4602420419
7605,379936161,50672,379986833,6,0,0,2560,12,2615588341
7606,380077609,566,380078175,2,0,1,512,4,2777929777
7607,380126340,70976,380197316,3,0,0,8704,2,5872356257
7608,380188280,1994,380190274,0,0,1,2048,11,4141039230
7609,380202739,106028,380308767,1,0,0,48128,6,5254897392
7610,380240200,69362,380309562,8,0,0,2560,12,4164128345
7611,380367910,62516,380430426,9,0,0,6144,18,8198450973
7612,380380810,4850,380385660,1,0,1,5120,6,392405217
7613,380561929,47288,380609217,1,0,0,1536,6,3412659472
7614,380637019,101036,380738055,1,0,0,31744,6,217450926
7615,380655670,101945,380757615,2,0,0,10240,4,132626639
7616,380701170,114735,380815905,3,0,0,18944,2,6098411462
7617,380747400,5712,380753112,4,0,1,14336,16,1935437306
7618,380815730,52531,380868261,2,0,0,3072,4,6313322702
7619,380848920,48980,380897900,8,0,0,2048,12,10429527955
7620,380852560,103844,380956404,2,0,0,40960,4,2193735921
7621,380917220,3898,380921118,7,0,1,4096,8,10374797258
7622,380965740,95336,381061076,4,0,0,28160,16,1256969987
7623,380976320,62516,381038836,5,0,0,6144,19,3649055562
7624,381003079,154111,381157190,7,0,0,110592,8,6227526909
7625,381023500,5802,381029302,0,0,1,6144,11,7556524868
7626,381054939,11583,381066522,2,0,1,13824,4,10330433393
7627,381101539,165066,381266605,7,0,0,3072,8,6003996001
7628,381134830,25222,381160052,6,0,1,8704,12,9732913768
7629,381175830,2470,381178300,0,0,1,2560,11,1941232587
7630,381189060,58376,381247436,4,0,0,7680,16,2776653497
7631,381209910,113029,381322939,0,0,0,20480,11,10328649543
7632,381294350,2470,381296820,1,0,1,2560,6,1499151441
7633,381375040,48980,381424020,2,0,0,2048,4,6628881065
7634,381403709,70976,381474685,1,0,0,8704,6,4646184010
7635,381429820,56216,381486036,0,0,0,5632,11,1100400829
7636,381506270,5712,381511982,1,0,1,14336,6,8141483941
7637,381523670,73030,381596700,4,0,0,6656,16,7796874501
7638,381618670,11016,381629686,0,0,1,17920,11,9052668467
7639,381638719,99524,381738243,7,0,0,23040,8,5936391385
7640,381686850,3387,381690237,1,0,1,9728,6,3865490774
7641,381716209,4937,381721146,2,0,1,12800,4,1697787229
7642,381794570,7706,381802276,0,0,1,8192,11,4000739819
7643,381824550,119407,381943957,8,0,0,28672,12,2281810059
7644,381896449,57440,381953889,1,0,0,4608,6,4342867957
7645,381906490,104840,382011330,5,0,0,12288,19,8188297661
7646,381928510,55748,381984258,3,0,0,4096,2,7303125034
7647,381986450,99632,382086082,0,0,0,27136,11,3718356715
7648,382015410,4374,382019784,4,0,1,4608,16,7871192507
7649,382015830,48329,382064159,9,0,0,512,18,539151776
7650,382086051,52387,382138438,6,0,0,3072,12,8375246763
7651,382087870,86096,382173966,8,0,0,23040,12,10016079587
7652,382095240,3898,382099138,4,0,1,4096,16,9233440290
7653,382181970,13341,382195311,0,0,1,22528,11,6963636315
7654,382294760,101816,382396576,3,0,0,34304,2,5171201620
7655,382295121,43904,382339025,6,0,0,512,12,7705785038
7656,382483589,70064,382553653,1,0,0,10752,6,2852297050
7657,382490400,99320,382589720,8,0,0,26112,12,2308857616
7658,382617100,67460,382684560,9,0,0,12288,18,7073153459
7659,382646320,85262,382731582,0,0,0,9216,11,7855049149
7660,382797220,76988,382874208,4,0,0,13312,16,7682630551
7661,382814360,104936,382919296,9,0,0,44544,18,5449417719
7662,382839610,89652,382929262,0,0,0,512,11,6253165537
7663,382968900,7230,382976130,4,0,1,7680,16,4722490073
7664,383054840,54056,383108896,8,0,0,3584,12,2268639946
7665,383062829,1994,383064823,3,0,1,2048,2,4981092404
7666,383144610,45596,383190206,4,0,0,1024,16,6494510721
7667,383157470,103064,383260534,5,0,0,38400,19,9870792604
7668,383226140,99320,383325460,0,0,0,26112,11,9528134515
7669,383359449,99788,383459237,7,0,0,27648,8,3050264504
7670,383374640,70220,383444860,5,0,0,11264,19,2566853465
7671,383404210,152383,383556593,9,0,0,7168,18,5297923062
7672,383412829,69213,383482042,7,0,0,6144,8,7071298661
7673,383419950,130907,383550857,0,0,0,28672,11,10281896918
7674,383512640,78368,383591008,5,0,0,12800,19,2966925467
7675,383528500,100724,383629224,8,0,0,30720,12,2406953840
7676,383551089,1042,383552131,5,0,1,1024,19,7393169909
7677,383592549,21916,383614465,8,0,1,35840,12,8121378522
7678,383647580,1042,383648622,1,0,1,1024,6,6271096158
7679,383861019,1518,383862537,2,0,1,1536,4,1152501188
7680,383862180,2946,383865126,4,0,1,3072,16,10063469188
7681,383887240,91484,383978724,5,0,0,25600,19,5266717159
7682,383965999,104189,384070188,1,0,0,26112,6,6464959118
7683,384041870,63965,384105835,4,0,0,9728,16,1152283672
7684,384053270,2946,384056216,1,0,1,3072,6,9933608442
7685,384062550,98022,384160572,0,0,0,22016,11,7332858829
7686,384093490,84068,384177558,8,0,0,1024,12,6722866930
7687,384161730,67592,384229322,9,0,0,7680,18,1141168003
7688,384250780,57440,384308220,9,0,0,4608,18,5852610484
7689,384300529,94664,384395193,7,0,0,15872,8,9280928252
7690,384535860,4850,384540710,4,0,1,5120,16,4180603602
7691,384537810,100568,384638378,9,0,0,30208,18,7106075175
7692,384589370,5454,384594824,7,0,1,13824,8,8488444702
7693,384639080,67592,384706672,3,0,0,7680,2,6444631788
7694,384640181,106463,384746644,6,0,0,48128,12,6233859473
7695,384644400,107095,384751495,4,0,0,15872,16,7998072196
7696,384650770,52364,384703134,5,0,0,3072,19,1172041485
7697,384749470,101805,384851275,3,0,0,27648,2,2572883409
7698,384761749,78056,384839805,7,0,0,11776,8,949916299
7699,384904730,62516,384967246,5,0,0,6144,19,10059057191
7700,384934060,68372,385002432,3,0,0,10240,2,9833059479
7701,384934391,62516,384996907,6,0,0,6144,12,7440495375
7702,384937200,125410,385062610,5,0,0,19456,19,10671168955
7703,384952170,63169,385015339,8,0,0,6144,12,8948760835
7704,384963700,4374,384968074,4,0,1,4608,16,6231376629
7705,384964440,109052,385073492,4,0,0,26624,16,6427356246
7706,385054050,106280,385160330,8,0,0,44032,12,4118192244
7707,385055550,122864,385178414,5,0,0,27648,19,473205680
7708,385062129,11378,385073507,2,0,1,4096,4,8842044363
7709,385084420,145600,385230020,5,0,0,19456,19,10156452746
7710,385091280,100100,385191380,4,0,0,28672,16,1045968105
7711,385110841,213445,385324286,6,0,0,100864,12,5970177553
7712,385193610,566,385194176,4,0,1,512,16,6690303396
7713,385196030,1042,385197072,7,0,1,1024,8,548235521
7714,385250580,100289,385350869,5,0,0,3584,19,606347967
7715,385303960,20884,385324844,4,0,1,512,16,2632136360
7716,385402640,47600,385450240,9,0,0,2560,18,5645416091
7717,385458079,1994,385460073,2,0,1,2048,4,3557581204
7718,385480799,103532,385584331,1,0,0,39936,6,5033443140
7719,385597659,97316,385694975,7,0,0,24576,8,10216618730
7720,385621029,148400,385769429,1,0,0,40960,6,892240089
7721,385722290,101660,385823950,0,0,0,33792,11,10151049346
7722,385831799,81440,385913239,7,0,0,12800,8,2141625800
7723,385857290,75476,385932766,3,0,0,18432,2,3437164557
7724,385913740,103844,386017584,0,0,0,40960,11,2134201118
7725,386023430,78992,386102422,4,0,0,14848,16,9717352532
7726,386150900,48980,386199880,5,0,0,2048,19,1629558904
7727,386180450,6754,386187204,0,0,1,7168,11,5602819975
7728,386200609,99788,386300397,1,0,0,27648,6,2464008765
7729,386264170,25187,386289357,9,0,1,45568,18,4563861689
7730,386309080,60824,386369904,8,0,0,5632,12,7840571423
7731,386354850,115556,386470406,3,0,0,27136,2,3596884855
7732,386387950,157388,386545338,0,0,0,53760,11,2238624585
7733,386461159,566,386461725,2,0,1,512,4,3925520851
7734,386467259,99483,386566742,7,0,0,18432,8,8800420521
7735,386480720,97162,386577882,3,0,0,2048,2,797225007
7736,386529240,118374,386647614,4,0,0,35840,16,1899126194
7737,386582580,104468,386687048,9,0,0,43008,18,6081746751
7738,386668210,111800,386780010,9,0,0,67072,18,8570404589
7739,386748800,4162,386752962,6,0,1,11264,12,4393223800
7740,386773209,18584,386791793,8,0,1,19456,12,6779604315
7741,386879041,45596,386924637,6,0,0,1024,12,1762161188
7742,386922830,106184,387029014,5,0,0,48640,19,5845581360
7743,386985960,69284,387055244,2,0,0,8192,4,2811413897
7744,387013550,15479,387029029,6,0,1,4608,12,8853180386
7745,387042650,98711,387141361,0,0,0,16896,11,9024098657
7746,387046810,160555,387207365,3,0,0,8192,2,242163688
7747,387068619,106652,387175271,1,0,0,50176,6,9573404321
7748,387106910,131403,387238313,3,0,0,24064,2,7759836411
7749,387138910,100198,387239108,3,0,0,2560,2,180766696
7750,387191549,98072,387289621,7,0,0,22016,8,1732620956
7751,387211920,57440,387269360,0,0,0,4608,11,7233787980
7752,387237219,12139,387249358,8,0,1,16384,12,2807208816
7753,387237309,67339,387304648,7,0,0,4608,8,6867094375
7754,387273149,69959,387343108,1,0,0,2560,6,7682079685
7755,387307270,81128,387388398,8,0,0,11776,12,5476889797
7756,387377910,106320,387484230,5,0,0,26624,19,185002750
7757,387396609,6278,387402887,8,0,1,6656,12,1608644660
7758,387445620,47288,387492908,8,0,0,1536,12,7577716906
7759,387494439,104936,387599375,1,0,0,44544,6,8579149304
7760,387642310,105092,387747402,0,0,0,45056,11,6023097542
7761,387724640,100880,387825520,2,0,0,31232,4,5545032162
7762,387776721,79928,387856649,6,0,0,17920,12,4787728944
7763,387888921,98384,387987305,6,0,0,23040,12,10224140213
7764,387891111,60824,387951935,6,0,0,5632,12,1494886246
7765,387953419,66056,388019475,7,0,0,7680,8,3648119774
7766,387968060,67243,388035303,2,0,0,9216,4,9639421396
7767,387973170,110396,388083566,5,0,0,62464,19,1000908835
7768,388043680,125996,388169676,3,0,0,113664,2,6508293115
7769,388153811,66529,388220340,6,0,0,2560,12,6234587198
7770,388194310,125569,388319879,0,0,0,77312,11,3476589685
7771,388204959,178389,388383348,1,0,0,87552,6,7285290761
7772,388218540,121134,388339674,3,0,0,3584,2,6178445332
7773,388311631,109120,388420751,6,0,0,31232,12,10033910250
7774,388357650,123606,388481256,2,0,0,21504,4,874258618
7775,388511231,60824,388572055,6,0,0,5632,12,4266511879
7776,388567990,47288,388615278,2,0,0,1536,4,6827263538
7777,388603020,87608,388690628,4,0,0,17920,16,1910616215
7778,388667419,65900,388733319,7,0,0,7168,8,9599475435
7779,388717350,1042,388718392,4,0,1,1024,16,7328830506
7780,388776240,45596,388821836,3,0,0,1024,2,1022466637
7781,388799329,99320,388898649,7,0,0,26112,8,503854014
7782,388858870,7230,388866100,0,0,1,7680,11,3417726807
7783,388872479,104608,388977087,7,0,0,38912,8,3536208447
7784,388976029,95582,389071611,1,0,0,20480,6,4932385044
7785,389124610,50672,389175282,5,0,0,2560,19,10263926325
7786,389203870,167632,389371502,8,0,0,56832,12,10151121041
7787,389206789,120029,389326818,1,0,0,53248,6,10242088433
7788,389213670,96668,389310338,0,0,0,17408,11,9315989915
7789,389334340,43904,389378244,8,0,0,512,12,1667831084
7790,389353960,86852,389440812,4,0,0,20480,16,5870423173
7791,389487210,102596,389589806,3,0,0,36864,2,6704187343
7792,389679330,89300,389768630,8,0,0,18432,12,5468462613
7793,389734600,11791,389746391,4,0,1,19456,16,5520528237
7794,389782480,3898,389786378,6,0,1,4096,12,4557831820
7795,389789671,77456,389867127,6,0,0,14848,12,2373602390
7796,389796380,95624,389892004,5,0,0,24064,19,6891634911
7797,389802739,93933,389896672,1,0,0,4096,6,276634873
7798,389849820,65091,389914911,4,0,0,3072,16,1101222093
7799,389864460,101979,389966439,2,0,0,26112,4,10416923126
7800,389939580,55904,389995484,8,0,0,4608,12,2887227671
7801,389960719,104564,390065283,7,0,0,24576,8,3450124692
7802,389994450,46778,390041228,8,0,0,1536,12,10539638073
7803,390014590,92441,390107031,8,0,0,3072,12,5158105148
7804,390072459,81152,390153611,7,0,0,16896,8,2797919945
7805,390079329,64208,390143537,1,0,0,6656,6,1022330379
7806,390113699,136338,390250037,7,0,0,100352,8,3006291878
7807,390179990,151215,390331205,8,0,0,67072,12,5515538431
7808,390196210,54162,390250372,4,0,0,1024,16,6810682133
7809,390202121,103848,390305969,6,0,0,24576,12,5715130790
7810,390221729,34880,390256609,8,0,1,6656,12,4906369375
7811,390280551,71930,390352481,6,0,0,3584,12,803041797
7812,390289380,203770,390493150,3,0,0,50176,2,8287458148
7813,390306880,81128,390388008,9,0,0,11776,18,241114692
7814,390316510,18849,390335359,1,0,1,11264,6,8141546282
7815,390344340,4374,390348714,0,0,1,4608,11,4836410309
7816,390346140,124343,390470483,9,0,0,36864,18,528701084
7817,390380700,152147,390532847,9,0,0,54784,18,5055163585
7818,390476229,103381,390579610,7,0,0,4096,8,5768697630
7819,390483949,122709,390606658,1,0,0,72704,6,97087532
7820,390527720,117284,390645004,2,0,0,20992,4,4601245002
7821,390596009,103367,390699376,7,0,0,5632,8,9966450271
7822,390649850,180866,390830716,8,0,0,56320,12,2370685086
7823,390652730,129116,390781846,3,0,0,123904,2,7488257632
7824,390724660,177390,390902050,0,0,0,62464,11,8251950297
7825,390768240,149884,390918124,9,0,0,43520,18,3605532947
7826,390848109,135241,390983350,1,0,0,24576,6,10066678414
7827,390855740,5454,390861194,4,0,1,13824,16,4613138784
7828,390869000,101594,390970594,4,0,0,23040,16,2531183176
7829,390956559,105343,391061902,7,0,0,23040,8,5070325245
7830,390978589,7881,390986470,2,0,1,9216,4,2743516159
7831,391026441,52364,391078805,6,0,0,3072,12,9398750372
7832,391075860,108479,391184339,0,0,0,33280,11,1293987149
7833,391207360,110864,391318224,5,0,0,64000,19,8788707219
7834,391238930,144058,391382988,8,0,0,37376,12,5489595187
7835,391397980,52364,391450344,5,0,0,3072,19,10144525581
7836,391405050,52364,391457414,5,0,0,3072,19,2569342639
7837,391445470,104138,391549608,5,0,0,29184,19,3102896560
7838,391535560,100568,391636128,5,0,0,30208,19,4085208382
7839,391606169,99115,391705284,1,0,0,23040,6,1176192104
7840,391748660,45596,391794256,5,0,0,1024,19,3119760469
7841,391800540,116840,391917380,8,0,0,79360,12,5283347643
7842,391801360,1518,391802878,5,0,1,1536,19,5867119508
7843,391804400,166632,391971032,4,0,0,89088,16,6901835492
7844,391813021,207973,392020994,6,0,0,25088,12,8382159865
7845,391840090,253150,392093240,2,0,0,29184,4,505956351
7846,391843879,1042,391844921,3,0,1,1024,2,618348662
7847,391878560,100824,391979384,0,0,0,2560,11,2290415015
7848,391962620,13083,391975703,1,0,1,12288,6,7535509936
7849,392073259,101192,392174451,1,0,0,30208,6,2973131802
7850,392084369,11826,392096195,3,0,1,3072,2,8142846291
7851,392090100,124449,392214549,8,0,0,24576,12,8958369274
7852,392130419,100568,392230987,7,0,0,30208,8,395021233
7853,392165690,139751,392305441,9,0,0,46592,18,8091724420
7854,392205219,193012,392398231,7,0,0,42496,8,7272758735
7855,392207500,301127,392508627,9,0,0,31232,18,3632856040
7856,392211291,173728,392385019,6,0,0,74752,12,6057898074
7857,392298741,174100,392472841,6,0,0,59392,12,235195013
7858,392336690,139273,392475963,2,0,0,9728,4,4082915739
7859,392367539,124748,392492287,7,0,0,6144,8,10462985681
7860,392435790,15062,392450852,1,0,1,29184,6,2038388308
7861,392513460,89612,392603072,5,0,0,19456,19,3691813796
7862,392516470,14287,392530757,5,0,1,27648,19,8668725501
7863,392543469,136397,392679866,7,0,0,43520,8,5665892746
7864,392588910,166658,392755568,0,0,0,64000,11,6978119564
7865,392589590,3422,392593012,9,0,1,3584,18,6721762410
7866,392616990,43904,392660894,8,0,0,512,12,1062414991
7867,392619780,183379,392803159,5,0,0,15360,19,10423869017
7868,392652940,120826,392773766,5,0,0,6656,19,10502572786
7869,392735389,20194,392755583,3,0,1,15360,2,743818977
7870,392825259,105601,392930860,1,0,0,7680,6,10521120504
7871,392843300,70688,392913988,4,0,0,12800,16,456177936
7872,392844490,109923,392954413,5,0,0,22016,19,2497177530
7873,392856959,105079,392962038,7,0,0,15360,8,7077492909
7874,392967950,45596,393013546,4,0,0,1024,16,8218483627
7875,392976350,87632,393063982,2,0,0,23040,4,8310508387
7876,393072920,10241,393083161,9,0,1,16384,18,7562022826
7877,393121020,106652,393227672,5,0,0,50176,19,9425413824
7878,393137990,48980,393186970,0,0,0,2048,11,8196772173
7879,393144270,150032,393294302,0,0,0,35840,11,4332471581
7880,393232750,97292,393330042,5,0,0,19456,19,3266805246
7881,393258690,150798,393409488,4,0,0,52224,16,4264199377
7882,393269250,4374,393273624,5,0,1,4608,19,392654327
7883,393382589,71155,393453744,7,0,0,8704,8,499122905
7884,393399330,57438,393456768,2,0,0,1536,4,9563345790
7885,393583660,50672,393634332,8,0,0,2560,12,3740556868
7886,393647820,105092,393752912,3,0,0,45056,2,5760886886
7887,393707150,111684,393818834,8,0,0,43520,12,8562704197
7888,393821580,98540,393920120,0,0,0,23552,11,2788806296
7889,393852310,2946,393855256,4,0,1,3072,16,8071763599
7890,393866330,128778,393995108,5,0,0,15360,19,1774550569
7891,393929830,6229,393936059,6,0,1,15360,12,7781846620
7892,393933459,67000,394000459,7,0,0,7168,8,9884187644
7893,394007191,65900,394073091,6,0,0,7168,12,8761367053
7894,394068139,43904,394112043,1,0,0,512,6,1708525714
7895,394091541,101660,394193201,6,0,0,33792,12,4819716494
7896,394105870,89689,394195559,5,0,0,5120,19,5211864702
7897,394179830,52364,394232194,8,0,0,3072,12,3547957005
7898,394209100,50672,394259772,8,0,0,2560,12,720596559
7899,394243640,78368,394322008,5,0,0,12800,19,2170792859
7900,394287740,4679,394292419,0,0,1,12288,11,59764352
7901,394396130,1518,394397648,7,0,1,1536,8,8325311485
7902,394424580,4374,394428954,5,0,1,4608,19,3324797022
7903,394433970,1518,394435488,5,0,1,1536,19,7303518877
7904,394502639,57479,394560118,1,0,0,6656,6,10691588854
7905,394517581,99008,394616589,6,0,0,25088,12,10401246158
7906,394523900,108460,394632360,0,0,0,51712,11,4942287698
7907,394525209,113617,394638826,7,0,0,5632,8,4497403732
7908,394604981,114809,394719790,6,0,0,27136,12,1918519598
7909,394678780,83132,394761912,9,0,0,13312,18,5419779836
7910,394692210,2470,394694680,4,0,1,2560,16,8955206818
7911,394845959,94973,394940932,1,0,0,10240,6,6412743015
7912,394864880,79343,394944223,0,0,0,10752,11,2757639176
7913,394874450,85202,394959652,3,0,0,6144,2,6782270728
7914,394919400,95914,395015314,3,0,0,11264,2,4157788930
7915,395031540,1042,395032582,7,0,1,1024,8,115603617
7916,395127760,22862,395150622,1,0,1,40960,6,171417855
7917,395162261,216112,395378373,6,0,0,7168,12,3455743511
7918,395171690,196975,395368665,0,0,0,512,11,8161246114
7919,395218950,121779,395340729,8,0,0,52224,12,7756284385
7920,395242360,47288,395289648,9,0,0,1536,18,3530295750
7921,395378200,2635,395380835,4,0,1,2560,16,10236252154
7922,395379310,206988,395586298,5,0,0,45568,19,6757575080
7923,395448889,164505,395613394,7,0,0,11264,8,840897289
7924,395498031,122170,395620201,6,0,0,13312,12,5296181707
7925,395517280,5326,395522606,9,0,1,5632,18,7085143542
7926,395542531,73599,395616130,6,0,0,5120,12,9409314493
7927,395664899,104254,395769153,7,0,0,25600,8,6988014043
7928,395685060,4374,395689434,6,0,1,4608,12,465232771
7929,395709100,50163,395759263,9,0,0,2560,18,9320247224
7930,395718540,51408,395769948,3,0,0,2560,2,7039337266
7931,395841790,99027,395940817,8,0,0,24064,12,8064068828
7932,395850769,156371,396007140,7,0,0,14848,8,1167059188
7933,395867570,65900,395933470,5,0,0,7168,19,9062096070
7934,395872380,3422,395875802,1,0,1,3584,6,1990904732
7935,395880040,208262,396088302,3,0,0,53248,2,3234493568
7936,395909660,129310,396038970,0,0,0,47616,11,10289226472
7937,395915709,132495,396048204,7,0,0,16896,8,4303916332
7938,395922480,120561,396043041,3,0,0,13312,2,8781308015
7939,395974309,123591,396097900,1,0,0,8192,6,7893185472
7940,396033679,64548,396098227,1,0,0,1024,6,9210373756
7941,396052470,47288,396099758,2,0,0,1536,4,5455576490
7942,396097249,2964,396100213,2,0,1,2048,4,4945724931
7943,396198930,122252,396321182,3,0,0,101376,2,6925361072
7944,396266760,102113,396368873,9,0,0,9728,18,10650612479
7945,396278890,87004,396365894,5,0,0,24064,19,8712905316
7946,396309789,94019,396403808,1,0,0,11264,6,8735361108
7947,396343809,117245,396461054,1,0,0,26624,6,10545798896
7948,396399020,46896,396445916,3,0,0,1024,2,1141094979
7949,396419100,45596,396464696,5,0,0,1024,19,5123255129
7950,396436610,104780,396541390,5,0,0,44032,19,1021583449
7951,396472910,78602,396551512,3,0,0,512,2,416005500
7952,396492239,49322,396541561,7,0,0,512,8,8345860900
7953,396514281,63085,396577366,6,0,0,3584,12,3297180444
7954,396619980,100880,396720860,2,0,0,31232,4,3991474970
7955,396690770,52364,396743134,0,0,0,3072,11,4541683375
7956,396700330,20545,396720875,4,0,1,17920,16,9559984889
7957,396713090,107906,396820996,9,0,0,25600,18,573404120
7958,396736160,566,396736726,1,0,1,512,6,10037673575
7959,396776610,86828,396863438,4,0,0,15360,16,7324939961
7960,396795430,91280,396886710,0,0,0,14848,11,9979191774
7961,396824399,79436,396903835,7,0,0,11264,8,5873133474
7962,396839420,84380,396923800,3,0,0,17408,2,6358785925
7963,396863990,6754,396870744,1,0,1,7168,6,443233354
7964,396937860,566,396938426,1,0,1,512,6,117573869
7965,396942040,84512,397026552,3,0,0,12800,2,2038063137
7966,397004269,5196,397009465,2,0,1,13312,4,277502388
7967,397026811,99632,397126443,6,0,0,27136,12,5058382161
7968,397028100,2946,397031046,9,0,1,3072,18,2486149705
7969,397063790,4850,397068640,5,0,1,5120,19,5611174156
7970,397090681,93573,397184254,6,0,0,3584,12,2886303447
7971,397184160,60910,397245070,2,0,0,5632,4,9006356936
7972,397230099,5454,397235553,8,0,1,13824,12,4468817844
7973,397321640,93020,397414660,3,0,0,25600,2,3190589379
7974,397372900,176518,397549418,4,0,0,13824,16,8309391115
7975,397376700,97604,397474304,9,0,0,20480,18,9111887127
7976,397435410,172790,397608200,2,0,0,29184,4,10477151412
7977,397436279,100299,397536578,7,0,0,27136,8,5540900900
7978,397466299,161473,397627772,1,0,0,43008,6,8067334661
7979,397491410,323109,397814519,3,0,0,4096,2,2513139483
7980,397495489,10241,397505730,2,0,1,16384,4,6826170730
7981,397544920,176027,397720947,2,0,0,10240,4,1230519953
7982,397553480,232297,397785777,5,0,0,70656,19,7063328000
7983,397574350,161920,397736270,9,0,0,14848,18,7408301598
7984,397617220,196036,397813256,2,0,0,79872,4,9282690200
7985,397620310,18495,397638805,1,0,1,17920,6,7973287979
7986,397740700,148208,397888908,9,0,0,55296,18,4566992641
7987,397748260,143315,397891575,4,0,0,8704,16,9388221997
7988,397784740,121451,397906191,9,0,0,13824,18,707488770
7989,397930380,109772,398040152,0,0,0,60416,11,6110086527
7990,397949130,15062,397964192,4,0,1,29184,16,4670186334
7991,398043220,70688,398113908,3,0,0,12800,2,6025955789
7992,398106359,2470,398108829,3,0,1,2560,2,5024862237
7993,398143840,54056,398197896,5,0,0,3584,19,7832127942
7994,398207370,59132,398266502,5,0,0,5120,19,4271316529
7995,398212869,7230,398220099,2,0,1,7680,4,5392061535
7996,398223250,45596,398268846,5,0,0,1024,19,3983605243
7997,398316549,7706,398324255,3,0,1,8192,2,5559181903
7998,398338559,57440,398395999,1,0,0,4608,6,525822669
7999,398349780,97916,398447696,2,0,0,21504,4,5468356316
8000,398480239,75452,398555691,7,0,0,13312,8,5468354347
8001,398485970,202837,398688807,4,0,0,150528,16,3725412677
8002,398538859,3645,398542504,2,0,1,10240,4,5387809784
8003,398547480,152753,398700233,3,0,0,20480,2,7040030898
8004,398547849,94411,398642260,7,0,0,15360,8,7185363331
8005,398564910,129068,398693978,8,0,0,16896,12,154000098
8006,398567410,152251,398719661,8,0,0,18944,12,6931975665
8007,398625719,4850,398630569,5,0,1,5120,19,10061889718
8008,398662610,42432,398705042,9,0,1,5120,18,5330656537
8009,398711100,59132,398770232,3,0,0,5120,2,2575101715
8010,398788650,62516,398851166,4,0,0,6144,16,9348238147
8011,398845911,59132,398905043,6,0,0,5120,12,3102319778
8012,398902819,64832,398967651,7,0,0,8704,8,2430867730
8013,398904399,109472,399013871,1,0,0,57344,6,5215104617
8014,398921241,69170,398990411,6,0,0,512,12,8418037447
8015,398923111,98518,399021629,6,0,0,1024,12,5084354967
8016,398935440,105026,399040466,0,0,0,4608,11,1140648974
8017,398945820,123905,399069725,8,0,0,37888,12,6749774526
8018,399083050,101036,399184086,8,0,0,31744,12,2180215134
8019,399126640,92090,399218730,9,0,0,2048,18,8063404202
8020,399215490,88076,399303566,2,0,0,19456,4,7111972067
8021,399321049,100256,399421305,1,0,0,29184,6,6463708562
8022,399513500,67928,399581428,0,0,0,13824,11,696337490
8023,399518641,65922,399584563,6,0,0,10240,12,9495067887
8024,399638450,101504,399739954,9,0,0,33280,18,10430190031
8025,399645799,101502,399747301,1,0,0,24064,6,5684818717
8026,399678890,128030,399806920,0,0,0,25088,11,8642566092
8027,399694590,83752,399778342,5,0,0,15872,19,6945557619
8028,399725530,141900,399867430,8,0,0,33792,12,4789050986
8029,399754020,148732,399902752,3,0,0,39936,2,8309496814
8030,399801120,17066,399818186,7,0,1,18432,8,9252111383
8031,399814580,216479,400031059,2,0,0,141312,4,2719915670
8032,399832700,6278,399838978,5,0,1,6656,19,9824692126
8033,399871000,3898,399874898,9,0,1,4096,18,9414578875
8034,400030150,99753,400129903,3,0,0,24576,2,2782766679
8035,400060540,112821,400173361,4,0,0,14848,16,9754670031
8036,400099639,105630,400205269,1,0,0,38912,6,561044021
8037,400110879,125050,400235929,1,0,0,58880,6,2602590173
8038,400125159,121600,400246759,7,0,0,2560,8,9096993519
8039,400180870,56181,400237051,8,0,0,2560,12,8119615250
8040,400182490,53766,400236256,0,0,0,1024,11,5128234387
8041,400204569,50127,400254696,7,0,0,1536,8,6728376135
8042,400278690,108212,400386902,9,0,0,55296,18,2838853103
8043,400295940,142112,400438052,0,0,0,15360,11,8627207456
8044,400309020,2470,400311490,9,0,1,2560,18,4220296747
8045,400332050,87552,400419602,5,0,0,4096,19,5153674507
8046,400410510,104468,400514978,2,0,0,43008,4,3992321484
8047,400410570,112067,400522637,4,0,0,25088,16,515213943
8048,400438959,124343,400563302,7,0,0,2560,8,1609198467
8049,400456129,76393,400532522,1,0,0,2560,6,4698839353
8050,400497591,102203,400599794,6,0,0,21504,12,570227097
8051,400530630,71207,400601837,4,0,0,6656,16,8385610948
8052,400546879,118664,400665543,1,0,0,89600,6,5515932381
8053,400678800,3422,400682222,0,0,1,3584,11,7847411787
8054,400692110,566,400692676,6,0,1,512,12,6473805422
8055,400704230,63465,400767695,8,0,0,6144,12,1318757563
8056,400731730,43904,400775634,5,0,0,512,19,7060117327
8057,400809390,92708,400902098,9,0,0,24576,18,2423287819
8058,400820920,566,400821486,9,0,1,512,18,10239658646
8059,400829959,86696,400916655,7,0,0,19968,8,8632415107
8060,400830099,107309,400937408,1,0,0,13312,6,5075754290
8061,400843709,4420,400848129,2,0,1,11776,4,8149070208
8062,400924890,3904,400928794,5,0,1,10752,19,7804764180
8063,400967019,100880,401067899,7,0,0,31232,8,5893735718
8064,400972670,76388,401049058,5,0,0,16384,19,9704071145
8065,401094600,99320,401193920,0,0,0,26112,11,6253041520
8066,401123979,110903,401234882,7,0,0,8192,8,8673119452
8067,401164860,1042,401165902,0,0,1,1024,11,2736269727
8068,401263590,57440,401321030,8,0,0,4608,12,5537988644
8069,401303920,116792,401420712,3,0,0,83456,2,2456060792
8070,401326109,111481,401437590,7,0,0,6656,8,9262541744
8071,401383400,111124,401494524,8,0,0,20992,12,3073326264
8072,401393480,85316,401478796,2,0,0,20480,4,6579253357
8073,401416929,102621,401519550,1,0,0,11264,6,645232302
8074,401482460,101660,401584120,5,0,0,33792,19,8964511146
8075,401607830,101348,401709178,5,0,0,32768,19,546318667
8076,401683571,100100,401783671,6,0,0,28672,12,10619926955
8077,401697660,93046,401790706,5,0,0,23040,19,861582408
8078,401729060,159420,401888480,8,0,0,67072,12,846136364
8079,401736740,5802,401742542,5,0,1,6144,19,10396983761
8080,401803389,139493,401942882,1,0,0,32768,6,858521303
8081,401856290,179772,402036062,3,0,0,38912,2,474434811
8082,401952060,132686,402084746,5,0,0,37376,19,8890423258
8083,402008639,5326,402013965,2,0,1,5632,4,1191030971
8084,402023500,143728,402167228,5,0,0,1536,19,8814798027
8085,402185960,14287,402200247,0,0,1,27648,11,7123066400
8086,402187009,13392,402200401,8,0,1,8704,12,9800947012
8087,402210440,78146,402288586,9,0,0,2048,18,393943108
8088,402251789,109247,402361036,1,0,0,16896,6,2328498493
8089,402348280,110896,402459176,5,0,0,46080,19,1363943748
8090,402387390,132924,402520314,8,0,0,31744,12,166963920
8091,402411030,94920,402505950,8,0,0,14848,12,4216560731
8092,402417820,62386,402480206,9,0,0,3072,18,3497479762
8093,402514450,107048,402621498,9,0,0,32256,18,6060200453
8094,402656040,45596,402701636,9,0,0,1024,18,5898437167
8095,402670040,76388,402746428,9,0,0,16384,18,3318593362
8096,402745150,87474,402832624,9,0,0,13312,18,2019830177
8097,402798460,47288,402845748,3,0,0,1536,2,9895242959
8098,402926300,75140,403001440,8,0,0,12288,12,7333096170
8099,402969700,89900,403059600,5,0,0,15360,19,3818651043
8100,402979109,43904,403023013,1,0,0,512,6,5227031749
8101,403000440,157674,403158114,4,0,0,19968,16,7296587178
8102,403026350,114124,403140474,0,0,0,57856,11,1849880910
8103,403342660,120536,403463196,2,0,0,95744,4,6076378547
8104,403389280,144002,403533282,5,0,0,97792,19,3353210667
8105,403427920,131330,403559250,2,0,0,19456,4,919190412
8106,403560901,93332,403654233,6,0,0,26624,12,5797580194
8107,403633190,45596,403678786,8,0,0,1024,12,4913457589
8108,403661350,47288,403708638,4,0,0,1536,16,9739027878
8109,403733190,107120,403840310,8,0,0,51712,12,9758498545
8110,403736210,142788,403878998,4,0,0,47616,16,6802771250
8111,403796820,201280,403998100,5,0,0,26624,19,1731855373
8112,403819319,109378,403928697,7,0,0,56832,8,924727383
8113,403827009,162964,403989973,7,0,0,32256,8,3279013453
8114,403831421,112438,403943859,6,0,0,39936,12,4555572185
8115,403901741,98402,404000143,6,0,0,6656,12,7856504908
8116,403950610,63381,404013991,9,0,0,4096,18,8009437298
8117,404008510,104156,404112666,9,0,0,41984,18,2925337575
8118,404090411,102440,404192851,6,0,0,36352,12,6245159113
8119,404151439,95000,404246439,1,0,0,22016,6,96612098
8120,404230580,103688,404334268,9,0,0,40448,18,2010028257
8121,404253850,54836,404308686,4,0,0,6144,16,2514257498
8122,404446970,50672,404497642,4,0,0,2560,16,10615510575
8123,404449900,43904,404493804,3,0,0,512,2,10137825703
8124,404480861,101192,404582053,6,0,0,32256,12,6939716452
8125,404625271,118664,404743935,6,0,0,89600,12,8392407894
8126,404673349,3898,404677247,8,0,1,4096,12,9268899161
8127,404677990,6754,404684744,6,0,1,7168,12,4124272137
8128,404678510,68587,404747097,5,0,0,3072,19,6957769399
8129,404752550,75920,404828470,4,0,0,14848,16,7903003178
8130,404795709,69284,404864993,1,0,0,8192,6,8515491564
8131,404882219,5326,404887545,2,0,1,5632,4,9167663308
8132,405002481,73604,405076085,6,0,0,12288,12,1088371450
8133,405054920,81440,405136360,4,0,0,12800,16,3644288029
8134,405157850,111176,405269026,8,0,0,65024,12,9187036914
8135,405209089,135639,405344728,7,0,0,85504,8,9949265619
8136,405301940,109460,405411400,8,0,0,59392,12,3085965971
8137,405322460,28129,405350589,5,0,1,6144,19,4923309347
8138,405329440,26295,405355735,6,0,1,8192,12,7644210829
8139,405340300,16421,405356721,9,0,1,1536,18,4846785441
8140,405343330,192686,405536016,8,0,0,9216,12,161292153
8141,405498740,1042,405499782,0,0,1,1024,11,7366612290
8142,405503540,84668,405588208,3,0,0,13312,2,5620014437
8143,405580940,102596,405683536,9,0,0,36864,18,8069797623
8144,405587790,129442,405717232,5,0,0,16384,19,2810659609
8145,405679609,7341,405686950,8,0,1,3584,12,4539280279
8146,405704330,6754,405711084,5,0,1,7168,19,9916502996
8147,405783500,80996,405864496,8,0,0,16384,12,1968041258
8148,405825070,1518,405826588,5,0,1,1536,19,4552078278
8149,405826299,80587,405906886,7,0,0,8192,8,4650769452
8150,405847420,64832,405912252,8,0,0,8704,12,3441877115
8151,405888130,108992,405997122,4,0,0,57856,16,4554768647
8152,405996920,103882,406100802,5,0,0,40448,19,7497599732
8153,406055579,97987,406153566,1,0,0,9728,6,3303704338
8154,406088470,16503,406104973,5,0,1,11264,19,3361699472
8155,406094230,117609,406211839,4,0,0,64512,16,9004468516
8156,406133461,176389,406309850,6,0,0,81408,12,235062345
8157,406199990,147137,406347127,4,0,0,42496,16,6314280495
8158,406304690,111989,406416679,5,0,0,21504,19,4007142378
8159,406469511,90212,406559723,6,0,0,16384,12,10625855519
8160,406560749,104000,406664749,7,0,0,41472,8,642858835
8161,406829660,3645,406833305,4,0,1,10240,16,1451425845
8162,406916410,2946,406919356,6,0,1,3072,12,1201917175
8163,406947679,92246,407039925,7,0,0,19456,8,4249074900
8164,406960900,119351,407080251,2,0,0,29696,4,4942448883
8165,407079500,61723,407141223,2,0,0,6144,4,3809406814
8166,407101929,118740,407220669,7,0,0,38912,8,9416059446
8167,407110489,125540,407236029,1,0,0,38912,6,8731456260
8168,407190209,68684,407258893,7,0,0,11264,8,5121509303
8169,407243170,1518,407244688,4,0,1,1536,16,8111364485
8170,407247240,67592,407314832,5,0,0,7680,19,2203440355
8171,407250610,78548,407329158,3,0,0,18432,2,7400405645
8172,407329231,81596,407410827,6,0,0,13312,12,1028849769
8173,407426511,60824,407487335,6,0,0,5632,12,4428537736
8174,407440430,99788,407540218,5,0,0,27648,19,2170013342
8175,407477210,73094,407550304,2,0,0,9216,4,9281553876
8176,407582100,12049,407594149,7,0,1,19968,8,1166531592
8177,407592920,3898,407596818,1,0,1,4096,6,4038931737
8178,407640030,172850,407812880,9,0,0,8704,18,5892648223
8179,407641380,101036,407742416,3,0,0,31744,2,7615283263
8180,407643839,87476,407731315,1,0,0,22528,6,98239757
8181,407663159,90992,407754151,7,0,0,18944,8,6102912692
8182,407686260,99260,407785520,4,0,0,4608,16,5964765238
8183,407842360,120068,407962428,5,0,0,94208,19,5281729725
8184,407847460,144776,407992236,4,0,0,30720,16,4373010448
8185,407933320,29123,407962443,9,0,1,4608,18,3400688084
8186,408119390,76052,408195442,3,0,0,10240,2,3803042592
8187,408192200,98228,408290428,0,0,0,22528,11,8474921875
8188,408216070,2470,408218540,4,0,1,2560,16,5685262864
8189,408254380,131256,408385636,3,0,0,35328,2,3868174523
8190,408360549,106351,408466900,7,0,0,22528,8,5262562786
8191,408379780,165600,408545380,4,0,0,118784,16,1450491086
8192,408424630,132564,408557194,9,0,0,30208,18,6008048239
8193,408429430,177030,408606460,2,0,0,14336,4,4392414601
8194,408519659,137615,408657274,1,0,0,33792,6,7407851083
8195,408586370,141242,408727612,0,0,0,56832,11,2970466727
8196,408622820,138668,408761488,8,0,0,41984,12,8219855235
8197,408645410,100640,408746050,9,0,0,7680,18,8995398156
8198,408812029,2870,408814899,2,0,1,8704,4,6164935101
8199,408824299,93776,408918075,1,0,0,23040,6,3761080066
8200,408872910,104139,408977049,4,0,0,13824,16,2182678783
8201,408942100,2870,408944970,5,0,1,8704,19,5588378657
8202,408977159,5802,408982961,2,0,1,6144,4,6040630239
8203,409009500,5196,409014696,6,0,1,13312,12,4334539131
8204,409105980,91904,409197884,9,0,0,16896,18,3089227490
8205,409129299,11274,409140573,2,0,1,18432,4,5270156507
8206,409155041,82414,409237455,6,0,0,19968,12,9600340331
8207,409180830,121645,409302475,4,0,0,26624,16,21225816
8208,409189619,98852,409288471,7,0,0,24576,8,252325424
8209,409272550,2870,409275420,9,0,1,8704,18,949260098
8210,409308510,4162,409312672,7,0,1,11264,8,242850814
8211,409460110,12995,409473105,9,0,1,25088,18,6866426880
8212,409474130,202457,409676587,3,0,0,10752,2,10053788198
8213,409618470,97604,409716074,9,0,0,20480,18,2749790588
8214,409620810,140230,409761040,2,0,0,18432,4,1852327248
8215,409627570,127839,409755409,2,0,0,41472,4,10467957010
8216,409681499,114692,409796191,1,0,0,17920,6,5815088428
8217,409735190,82666,409817856,6,0,1,134144,12,5695801700
8218,409840400,212967,410053367,2,0,0,32768,4,5805991350
8219,409863160,4162,409867322,9,0,1,11264,18,7063234283
8220,409911511,43904,409955415,6,0,0,512,12,4018645729
8221,410077240,64208,410141448,2,0,0,6656,4,4829377703
8222,410130750,3422,410134172,9,0,1,3584,18,8667250170
8223,410168819,100568,410269387,1,0,0,30208,6,8387946529
8224,410182721,64676,410247397,6,0,0,8192,12,395193085
8225,410335520,48980,410384500,2,0,0,2048,4,6912704342
8226,410365099,103844,410468943,7,0,0,40960,8,7968974860
8227,410423430,75495,410498925,3,0,0,7168,2,531064652
8228,410498401,75056,410573457,6,0,0,15360,12,8487068208
8229,410504390,103532,410607922,5,0,0,39936,19,963063742
8230,410564400,105981,410670381,2,0,0,33792,4,3906243716
8231,410579001,115578,410694579,6,0,0,11264,12,3138510197
8232,410644330,51044,410695374,5,0,0,2560,19,3711033393
8233,410863480,67592,410931072,4,0,0,7680,16,10243955807
8234,410922529,70844,410993373,7,0,0,13312,8,10360559979
8235,410937529,64832,411002361,7,0,0,8704,8,2972266139
8236,411030251,52364,411082615,6,0,0,3072,12,7492460082
8237,411066470,52364,411118834,9,0,0,3072,18,9528436317
8238,411071501,114425,411185926,6,0,0,61952,12,1416804174
8239,411074259,165601,411239860,1,0,0,26112,6,10122047301
8240,411085421,134420,411219841,6,0,0,30720,12,2434835074
8241,411187240,96184,411283424,9,0,0,9216,18,9668484962
8242,411189009,91592,411280601,1,0,0,15872,6,8674056639
8243,411286151,58220,411344371,6,0,0,7168,12,10147005490
8244,411305130,62516,411367646,3,0,0,6144,2,2720087232
8245,411336980,68996,411405976,2,0,0,12288,4,6510830830
8246,411357920,99758,411457678,2,0,0,24576,4,9712235611
8247,411368970,97292,411466262,9,0,0,19456,18,703908415
8248,411375550,134950,411510500,4,0,0,12288,16,523246415
8249,411440740,108680,411549420,9,0,0,56832,18,1140744556
8250,411604849,117289,411722138,1,0,0,83968,6,1437886711
8251,411605190,120723,411725913,9,0,0,12288,18,1764957072
8252,411636350,102354,411738704,2,0,0,6144,4,2161768545
8253,411672089,3422,411675511,8,0,1,3584,12,9260764816
8254,411682440,113817,411796257,4,0,0,28672,16,6708888778
8255,411697589,79156,411776745,7,0,0,1536,8,3033976423
8256,411707969,163186,411871155,7,0,0,41472,8,6033383470
8257,411785131,129542,411914673,6,0,0,11776,12,5141099324
8258,411829009,3422,411832431,8,0,1,3584,12,8231157094
8259,411844250,91171,411935421,5,0,0,14336,19,2498467632
8260,411941750,113360,412055110,2,0,0,72192,4,7534196349
8261,411960441,131965,412092406,6,0,0,33280,12,674287722
8262,411997020,5326,412002346,1,0,1,5632,6,4862683079
8263,412045349,102773,412148122,7,0,0,25600,8,9820541088
8264,412107721,127833,412235554,6,0,0,17920,12,5625770111
8265,412169330,102128,412271458,9,0,0,35328,18,6949863915
8266,412258089,97861,412355950,1,0,0,23040,6,5401007840
8267,412310901,98228,412409129,6,0,0,22528,12,2690643771
8268,412358170,132247,412490417,4,0,0,14848,16,1919566085
8269,412415981,77744,412493725,6,0,0,10752,12,6475322658
8270,412468071,47764,412515835,6,0,0,1536,12,4944812576
8271,412649760,101660,412751420,2,0,0,33792,4,1831971631
8272,412685730,93296,412779026,3,0,0,17408,2,7603398929
8273,412700639,3128,412703767,3,0,1,9216,2,3690470185
8274,412781550,79881,412861431,4,0,0,7168,16,5913295284
8275,412787089,89480,412876569,1,0,0,24064,6,13364294
8276,412940200,10241,412950441,5,0,1,16384,19,5026468239
8277,412969420,156554,413125974,6,0,1,258048,12,1082868922
8278,413005010,214580,413219590,5,0,0,8704,19,7479412417
8279,413010840,118680,413129520,0,0,1,5632,11,3507111916
8280,413075750,55716,413131466,1,0,1,3072,6,3286944434
8281,413096180,210210,413306390,5,0,0,10752,19,5802960629
8282,413101889,235125,413337014,1,0,0,8192,6,10208503805
8283,413132869,238898,413371767,1,0,0,52736,6,5950544045
8284,413156920,6754,413163674,7,0,1,7168,8,8053022142
8285,413184659,57908,413242567,7,0,0,6144,8,6348272218
8286,413398710,4162,413402872,4,0,1,11264,16,3864146256
8287,413443790,104624,413548414,3,0,0,43520,2,9191168626
8288,413572730,101036,413673766,5,0,0,31744,19,10389368551
8289,413598150,1518,413599668,4,0,1,1536,16,4510144445
8290,413688570,100412,413788982,8,0,0,29696,12,7717146973
8291,413803299,104780,413908079,7,0,0,44032,8,5568265838
8292,413829539,3422,413832961,2,0,1,3584,4,10684414797
8293,413857280,114801,413972081,2,0,0,26112,4,6339836051
8294,414010000,84380,414094380,3,0,0,17408,2,10405916995
8295,414059780,65900,414125680,3,0,0,7168,2,1887407591
8296,414137260,90704,414227964,2,0,0,23040,4,5291722755
8297,414426850,80708,414507558,4,0,0,20480,16,692605485
8298,414451500,76052,414527552,3,0,0,10240,2,9893783997
8299,414452250,70626,414522876,2,0,0,4096,4,7603517463
8300,414470500,4850,414475350,5,0,1,5120,19,7743779131
8301,414595060,45596,414640656,2,0,0,1024,4,2114197450
8302,414616849,6278,414623127,8,0,1,6656,12,73184362
8303,414638090,14117,414652207,4,0,1,24064,16,10530182826
8304,414670879,109548,414780427,7,0,0,56320,8,5743016651
8305,414738639,59772,414798411,7,0,0,512,8,5081260212
8306,414760210,107781,414867991,9,0,0,44032,18,1181115628
8307,414845910,6278,414852188,7,0,1,6656,8,7374523062
8308,414874730,57003,414931733,5,0,0,3072,19,953060947
8309,414910600,63452,414974052,3,0,0,9216,2,9413450768
8310,414974470,4679,414979149,4,0,1,12288,16,861724565
8311,415046461,110552,415157013,6,0,0,62976,12,7855361500
8312,415060871,120484,415181355,6,0,0,5632,12,5478973701
8313,415115109,115266,415230375,1,0,0,75776,6,8293985387
8314,415176029,130644,415306673,7,0,0,29184,8,7988359409
8315,415248419,62516,415310935,1,0,0,6144,6,3162326664
8316,415253411,128652,415382063,6,0,0,48640,12,2518426103
8317,415359229,2470,415361699,3,0,1,2560,2,5150859067
8318,415418970,91616,415510586,9,0,0,20992,18,6149045840
8319,415471910,10499,415482409,7,0,1,16896,8,3753093238
8320,415475409,7973,415483382,2,0,1,12800,4,7976765448
8321,415514090,2946,415517036,9,0,1,3072,18,10612413300
8322,415553849,4850,415558699,5,0,1,5120,19,6054338511
8323,415637650,2870,415640520,1,0,1,8704,6,6896498981
8324,415671219,99476,415770695,7,0,0,26624,8,9762613832
8325,415708720,47288,415756008,9,0,0,1536,18,6641645249
8326,415740320,90484,415830804,9,0,0,17920,18,1646134606
8327,415836130,104624,415940754,2,0,0,43520,4,2432139336
8328,415878460,69284,415947744,2,0,0,8192,4,5078022559
8329,415906980,100698,416007678,3,0,0,18944,2,3004051791
8330,415952320,77468,416029788,9,0,0,9728,18,8414110257
8331,416102821,116052,416218873,6,0,0,30208,12,5427966244
8332,416109710,99944,416209654,5,0,0,28160,19,9699555250
8333,416143910,2946,416146856,0,0,1,3072,11,8763071345
8334,416176460,2470,416178930,5,0,1,2560,19,7534794889
8335,416321321,111176,416432497,6,0,0,65024,12,3405431306
8336,416382319,5454,416387773,3,0,1,13824,2,2899577923
8337,416402730,4374,416407104,0,0,1,4608,11,2865139362
8338,416446640,74360,416521000,3,0,0,9728,2,3362288585
8339,416478610,6754,416485364,5,0,1,7168,19,10376597805
8340,416547110,77744,416624854,3,0,0,10752,2,74983298
8341,416582931,59132,416642063,6,0,0,5120,12,1409991680
8342,416677040,124592,416801632,9,0,0,109056,18,4448655451
8343,416709999,114715,416824714,1,0,0,12288,6,367066652
8344,416877279,106652,416983931,1,0,0,50176,6,3406168858
8345,416885720,163461,417049181,5,0,0,36352,19,3719399177
8346,417016150,113672,417129822,9,0,0,73216,18,9527838540
8347,417047470,138710,417186180,4,0,0,30208,16,1668922236
8348,417049070,228100,417277170,9,0,0,100864,18,5492298987
8349,417067020,105108,417172128,4,0,0,14336,16,7465371475
8350,417162430,566,417162996,5,0,1,512,19,8439456017
8351,417168029,115396,417283425,7,0,0,20480,8,3424212519
8352,417204329,93908,417298237,7,0,0,18432,8,4651830976
8353,417210479,13083,417223562,8,0,1,22016,12,5280216321
8354,417237860,88217,417326077,2,0,0,11776,4,5882241134
8355,417400270,108212,417508482,2,0,0,55296,4,6747553783
8356,417447530,71182,417518712,3,0,0,2048,2,3941056772
8357,417491239,17258,417508497,2,0,1,9728,4,6308227241
8358,417551240,105560,417656800,4,0,0,46592,16,6912330771
8359,417627729,101972,417729701,1,0,0,34816,6,5447164408
8360,417785930,112424,417898354,3,0,0,69120,2,6651094611
8361,417827360,2470,417829830,9,0,1,2560,18,9188800361
8362,417869729,80957,417950686,1,0,0,11776,6,8739710199
8363,417922540,92216,418014756,9,0,0,17920,18,1599201498
8364,417956651,49292,418005943,6,0,0,3072,12,8923973658
8365,418008329,64208,418072537,1,0,0,6656,6,10563074439
8366,418052399,4679,418057078,2,0,1,12288,4,9341052559
8367,418119310,103064,418222374,3,0,0,38400,2,1677207968
8368,418231000,99632,418330632,3,0,0,27136,2,7224973268
8369,418248770,127708,418376478,8,0,0,49152,12,9846449781
8370,418262910,156513,418419423,9,0,0,61440,18,6565818271
8371,418263259,98228,418361487,7,0,0,22528,8,4996065043
8372,418310020,248454,418558474,6,0,1,407040,12,4725732615
8373,418318610,244050,418562660,1,0,1,6656,6,7434411650
8374,418368220,197026,418565246,9,0,1,4096,18,3539237663
8375,418411189,156963,418568152,8,0,1,4608,12,6487911813
8376,418500480,185006,418685486,9,0,0,13312,18,5428226792
8377,418502760,304896,418807656,5,0,0,22016,19,10725731092
8378,418520829,363494,418884323,7,0,0,178688,8,4023739951
8379,418608820,312870,418921690,2,0,0,41472,4,4181333697
8380,418664489,233273,418897762,7,0,0,44032,8,4482433618
8381,418723349,185690,418909039,1,0,0,9216,6,4769457815
8382,418738570,7230,418745800,4,0,1,7680,16,5875080613
8383,418758700,147516,418906216,5,0,0,22016,19,6264882751
8384,418768231,131262,418899493,6,0,0,5632,12,9578100674
8385,418783699,168587,418952286,1,0,0,19456,6,9690018337
8386,418843990,97316,418941306,5,0,0,3584,19,8732241683
8387,418908230,16415,418924645,9,0,1,3072,18,9027301072
8388,418909210,125330,419034540,2,0,0,61440,4,4537238760
8389,418965540,138299,419103839,5,0,0,48640,19,4234915166
8390,418987840,82483,419070323,9,0,0,9216,18,4622304485
8391,419090620,113155,419203775,4,0,0,28160,16,3510264074
8392,419248229,98228,419346457,1,0,0,22528,6,5071902966
8393,419320170,111176,419431346,9,0,0,65024,18,5905558052
8394,419421990,78032,419500022,3,0,0,11264,2,10533573716
8395,419535079,103376,419638455,7,0,0,39424,8,3939491190
8396,419584990,1994,419586984,1,0,1,2048,6,3342757808
8397,419602609,128084,419730693,7,0,0,114176,8,7680121859
8398,419662870,3898,419666768,1,0,1,4096,6,8729795639
8399,419665260,65448,419730708,6,0,1,75776,12,8851087851
8400,419757019,78172,419835191,7,0,0,18432,8,7543929579
8401,419794490,103076,419897566,9,0,0,15872,18,9487816791
8402,419899960,4374,419904334,9,0,1,4608,18,9197369934
8403,419994800,45596,420040396,5,0,0,1024,19,6379785110
8404,420010171,57440,420067611,6,0,0,4608,12,7743253701
8405,420056720,81908,420138628,3,0,0,14336,2,9429444773
8406,420156700,1042,420157742,1,0,1,1024,6,9353311959
8407,420179169,84824,420263993,7,0,0,13824,8,7637406628
8408,420309460,108290,420417750,2,0,0,14336,4,1691383357
8409,420325090,50672,420375762,3,0,0,2560,2,3678215256
8410,420353359,51845,420405204,7,0,0,2048,8,6467131252
8411,420564980,114608,420679588,5,0,0,76288,19,4443098286
8412,420636520,14117,420650637,5,0,1,24064,19,5635269473
8413,420638629,83758,420722387,1,0,0,12800,6,3924578199
8414,420687390,180015,420867405,9,0,0,8192,18,10571493997
8415,420731469,566,420732035,3,0,1,512,2,1521120532
8416,420837749,62854,420900603,1,0,0,5120,6,3138252381
8417,420861210,248454,421109664,6,0,1,407040,12,2582140156
8418,421120970,171639,421292609,9,0,0,39424,18,1545337269
8419,421279000,1042,421280042,5,0,1,1024,19,1890224251
8420,421285060,11439,421296499,1,0,1,4096,6,799274458
8421,421300210,6278,421306488,1,0,1,6656,6,9841688907
8422,421309210,96677,421405887,3,0,0,18944,2,10047809445
8423,421465770,82820,421548590,9,0,0,12288,18,8498496288
8424,421477200,10499,421487699,0,0,1,16896,11,4095073611
8425,421564150,42683,421606833,6,0,1,69632,12,145415514
8426,421735551,84560,421820111,6,0,0,23040,12,2910963657
8427,421743130,90733,421833863,4,0,0,7680,16,268466388
8428,421755539,6754,421762293,3,0,1,7168,2,4855092261
8429,422006791,65900,422072691,6,0,0,7168,12,1265889676
8430,422038650,100412,422139062,9,0,0,29696,18,4901442604
8431,422069150,5196,422074346,7,0,1,13312,8,6637997424
8432,422072421,107174,422179595,6,0,0,49152,12,4381651355
8433,422252469,5802,422258271,3,0,1,6144,2,4240672075
8434,422319971,89588,422409559,6,0,0,14336,12,7755349536
8435,422412589,96536,422509125,7,0,0,22016,8,9840122288
8436,422437110,147381,422584491,9,0,0,36352,18,7741968184
8437,422475879,83766,422559645,7,0,0,4096,8,8470868193
8438,422613880,98540,422712420,5,0,0,23552,19,3702294132
8439,422885410,4374,422889784,4,0,1,4608,16,2541706614
8440,422933730,66680,423000410,3,0,0,9728,2,8720940887
8441,423030760,4162,423034922,4,0,1,11264,16,5967777811
8442,423054939,95648,423150587,7,0,0,29184,8,6747086785
8443,423070859,1042,423071901,8,0,1,1024,12,8187461170
8444,423078610,71992,423150602,6,0,1,109568,12,3107689826
8445,423249819,164127,423413946,1,0,0,8192,6,9610001897
8446,423356410,3422,423359832,0,0,1,3584,11,9152313454
8447,423504450,100724,423605174,2,0,0,30720,4,9438020910
8448,423620360,1518,423621878,9,0,1,1536,18,4835132543
8449,423712539,99632,423812171,1,0,0,27136,6,2315053399
8450,423725430,94949,423820379,5,0,0,8704,19,1222782296
8451,423729570,67592,423797162,9,0,0,7680,18,2686555336
8452,423888831,95804,423984635,6,0,0,29696,12,8016329567
8453,423911399,11533,423922932,2,0,1,18944,4,9911843141
8454,423932780,229860,424162640,9,0,0,60416,18,1223258358
8455,424187220,3422,424190642,0,0,1,3584,11,10277069223
8456,424187680,3551,424191231,5,0,1,8704,19,99058284
8457,424269780,69620,424339400,3,0,0,14336,2,3043747376
8458,424297429,121971,424419400,7,0,0,13312,8,7504776839
8459,424330500,50384,424380884,5,0,0,2048,19,1595535710
8460,424369070,117968,424487038,5,0,0,17408,19,9138708735
8461,424398300,176709,424575009,2,0,0,31744,4,3462846130
8462,424405740,90832,424496572,5,0,0,12288,19,3268737161
8463,424412191,89232,424501423,6,0,0,15872,12,977895867
8464,424481019,173592,424654611,1,0,0,65024,6,10417205608
8465,424617489,566,424618055,2,0,1,512,4,1048648738
8466,424756319,101816,424858135,7,0,0,34304,8,10502226757
8467,424826320,5326,424831646,9,0,1,5632,18,9914288742
8468,424955021,105965,425060986,6,0,0,44544,12,6091831602
8469,424968330,79069,425047399,5,0,0,12288,19,6442547467
8470,424983599,93716,425077315,1,0,0,4608,6,419290234
8471,425110720,75608,425186328,5,0,0,13824,19,9337080585
8472,425156730,55248,425211978,2,0,0,6144,4,9672259829
8473,425293220,48980,425342200,4,0,0,2048,16,4380461713
8474,425443470,108992,425552462,3,0,0,57856,2,3145765109
8475,425457190,60824,425518014,5,0,0,5632,19,5374885035
8476,425477249,143715,425620964,7,0,0,49664,8,8306547604
8477,425505791,117996,425623787,6,0,0,9216,12,2046551931
8478,425553960,82202,425636162,3,0,0,7680,2,8408274317
8479,425587149,3904,425591053,3,0,1,10752,2,5659078966
8480,425684270,4679,425688949,5,0,1,12288,19,7451297881
8481,425789151,105092,425894243,6,0,0,45056,12,1908908622
8482,426012320,114140,426126460,9,0,0,74752,18,9041475472
8483,426177239,72668,426249907,1,0,0,9216,6,6674475718
8484,426269840,75452,426345292,9,0,0,13312,18,7053177750
8485,426431209,2470,426433679,2,0,1,2560,4,4712756151
8486,426440630,566,426441196,1,0,1,512,6,470221215
8487,426451241,74360,426525601,6,0,0,9728,12,7056150149
8488,426543840,4374,426548214,7,0,1,4608,8,6286145262
8489,426577970,65900,426643870,3,0,0,7168,2,5339706054
8490,426593040,566,426593606,4,0,1,512,16,8840596457
8491,426686520,99944,426786464,3,0,0,28160,2,986544541
8492,426761700,81128,426842828,3,0,0,11776,2,5575663653
8493,426811880,57440,426869320,9,0,0,4608,18,7212041677
8494,426913940,73160,426987100,5,0,0,15872,19,3570670993
8495,426915619,148713,427064332,7,0,0,108032,8,5009368346
8496,426918939,4162,426923101,8,0,1,11264,12,1310882576
8497,426926670,169030,427095700,3,0,0,49664,2,3808530283
8498,426945370,220548,427165918,3,0,0,47104,2,8032227723
8499,426970029,159481,427129510,7,0,0,13312,8,2374751352
8500,427120259,76997,427197256,7,0,0,7680,8,1098445194
8501,427192161,98564,427290725,6,0,0,28672,12,2576739808
8502,427207169,132420,427339589,7,0,0,32768,8,2096627902
8503,427396280,64208,427460488,3,0,0,6656,2,4562755119
8504,427523710,76388,427600098,2,0,0,16384,4,6723349034
8505,427596650,81496,427678146,3,0,0,11776,2,1466710347
8506,427700840,3904,427704744,1,0,1,10752,6,2265461032
8507,427829170,48980,427878150,2,0,0,2048,4,3638988635
8508,427843499,94525,427938024,1,0,0,20992,6,10443430725
8509,427911620,1518,427913138,9,0,1,1536,18,4630930086
8510,427952770,106487,428059257,4,0,0,27136,16,10351299295
8511,427965769,72668,428038437,7,0,0,9216,8,2858029129
8512,427967969,3645,427971614,2,0,1,10240,4,3621183326
8513,427997909,117166,428115075,1,0,0,32768,6,9616924727
8514,428044729,566,428045295,8,0,1,512,12,1712590141
8515,428214041,88856,428302897,6,0,0,22016,12,2220422446
8516,428257850,77744,428335594,9,0,0,10752,18,7773935208
8517,428296180,10131,428306311,1,0,1,3584,6,7560509983
8518,428360259,87140,428447399,1,0,0,16384,6,3730125701
8519,428519509,6229,428525738,2,0,1,15360,4,9001689293
8520,428534609,120085,428654694,1,0,0,46592,6,2745765998
8521,428717730,116168,428833898,9,0,0,81408,18,9337675403
8522,428730820,105589,428836409,2,0,0,8192,4,4629470927
8523,428748759,566,428749325,8,0,1,512,12,10229808302
8524,428837590,1994,428839584,9,0,1,2048,18,348869522
8525,428988410,101660,429090070,5,0,0,33792,19,687560957
8526,429009810,105502,429115312,4,0,0,4608,16,10413059595
8527,429111280,60012,429171292,3,0,0,4608,2,8981704620
8528,429146360,77990,429224350,4,0,0,11264,16,2587751595
8529,429155330,45596,429200926,3,0,0,1024,2,4198508251
8530,429183599,92528,429276127,7,0,0,18944,8,494594360
8531,429209710,104156,429313866,2,0,0,41984,4,10536878987
8532,429250680,147942,429398622,3,0,0,20480,2,8164180661
8533,429369230,74360,429443590,5,0,0,9728,19,9815398149
8534,429405130,3422,429408552,5,0,1,3584,19,3194565414
8535,429432341,45596,429477937,6,0,0,1024,12,1284131062
8536,429526229,10499,429536728,8,0,1,16896,12,10157595953
8537,429606799,97916,429704715,7,0,0,21504,8,5796148317
8538,429674349,98852,429773201,1,0,0,24576,6,4000733820
8539,429697859,6879,429704738,8,0,1,1536,12,4677287251
8540,429698050,162553,429860603,3,0,0,83456,2,8776525319
8541,429721830,5326,429727156,5,0,1,5632,19,225948918
8542,429747120,167813,429914933,5,0,0,33792,19,760386663
8543,429751290,249953,430001243,4,0,0,89088,16,7650811475
8544,429785809,4850,429790659,2,0,1,5120,4,1732290999
8545,429880640,12737,429893377,7,0,1,24576,8,2832130203
8546,429882751,144812,430027563,6,0,0,18432,12,5765793753
8547,429884409,10248,429894657,3,0,1,14336,2,3163446062
8548,429937390,31266,429968656,6,0,1,50688,12,9628339479
8549,429966860,124795,430091655,5,0,0,18432,19,3589059413
8550,430050220,109185,430159405,5,0,0,12288,19,4827447466
8551,430137501,102128,430239629,6,0,0,35328,12,3906931038
8552,430166260,84824,430251084,3,0,0,13824,2,411725374
8553,430180820,59604,430240424,2,0,0,2560,4,1881544464
8554,430382230,91304,430473534,5,0,0,19968,19,7843443329
8555,430445610,77744,430523354,2,0,0,10752,4,1261076744
8556,430596440,1518,430597958,9,0,1,1536,18,7020065194
8557,430689570,13253,430702823,0,0,1,25600,11,9484475464
8558,430744451,75140,430819591,6,0,0,12288,12,5525044473
8559,430813020,7706,430820726,5,0,1,8192,19,4094281596
8560,430840770,52364,430893134,9,0,0,3072,18,9124086716
8561,430861510,102610,430964120,3,0,0,33280,2,3892809220
8562,430882070,86121,430968191,2,0,0,13312,4,6017619848
8563,430887980,566,430888546,7,0,1,512,8,9078411061
8564,430940081,61131,431001212,6,0,0,1536,12,3603150841
8565,431026929,105716,431132645,7,0,0,47104,8,9698323072
8566,431029530,124016,431153546,4,0,0,36352,16,6928996827
8567,431054279,88176,431142455,7,0,0,2560,8,4492144454
8568,431191420,1042,431192462,1,0,1,1024,6,1493208940
8569,431257340,90548,431347888,5,0,0,22528,19,9870307339
8570,431263530,167392,431430922,9,0,0,67072,18,10623129812
8571,431317690,4850,431322540,9,0,1,5120,18,7965170162
8572,431320900,60472,431381372,2,0,0,5120,4,9783510614
8573,431326699,106578,431433277,1,0,0,7680,6,6090733744
8574,431340070,154854,431494924,5,0,0,49152,19,3391466989
8575,431343061,173511,431516572,6,0,0,14336,12,6015855382
8576,431371240,6278,431377518,5,0,1,6656,19,2223006568
8577,431420770,18777,431439547,0,0,1,6656,11,4115959303
8578,431514800,132937,431647737,9,0,0,17408,18,5840767515
8579,431520180,77456,431597636,4,0,0,14848,16,3174733942
8580,431536190,3898,431540088,9,0,1,4096,18,3296497712
8581,431552980,72286,431625266,2,0,0,3584,4,7468541574
8582,431640891,135684,431776575,6,0,0,11264,12,7404269089
8583,431720309,115700,431836009,1,0,0,79872,6,2856467025
8584,431745590,146465,431892055,3,0,0,35840,2,6699363444
8585,431829290,19277,431848567,1,0,1,20992,6,8773925694
8586,431883140,110879,431994019,5,0,0,34816,19,2345039664
8587,432047330,43298,432090628,4,0,0,9728,16,312891187
8588,432140959,63452,432204411,7,0,0,9216,8,4652435320
8589,432177560,5196,432182756,5,0,1,13312,19,9189717598
8590,432240059,13770,432253829,3,0,1,26624,2,2490786524
8591,432305120,120857,432425977,5,0,0,37888,19,981308990
8592,432332079,128627,432460706,1,0,0,6656,6,7106131361
8593,432332631,81787,432414418,6,0,0,17408,12,6051787658
8594,432408050,17942,432425992,0,0,1,5632,11,6230820691
8595,432439180,119230,432558410,2,0,0,27648,4,4762791134
8596,432473600,3898,432477498,9,0,1,4096,18,7573160122
8597,432512420,117486,432629906,5,0,0,28160,19,6356973248
8598,432585960,115280,432701240,5,0,0,34304,19,6588678068
8599,432690140,96216,432786356,4,0,0,24064,16,4689920960
8600,432692180,69876,432762056,9,0,0,5632,18,9873208592
8601,432738820,103000,432841820,0,0,0,12288,11,9768052414
8602,432744019,47288,432791307,7,0,0,1536,8,7552525793
8603,432764100,118694,432882794,9,0,0,29696,18,1751852687
8604,432766599,145320,432911919,1,0,0,27136,6,1115609717
8605,432768459,182927,432951386,7,0,0,48128,8,7096561443
8606,432788500,204329,432992829,0,0,0,44544,11,4976034923
8607,432875310,146565,433021875,0,0,0,7680,11,153366868
8608,432971779,72668,433044447,1,0,0,9216,6,3352702379
8609,432989380,87089,433076469,5,0,0,14336,19,1728699211
8610,433036680,98072,433134752,9,0,0,22016,18,7976667606
8611,433242580,130162,433372742,5,0,0,98816,19,5956863339
8612,433251270,123983,433375253,4,0,0,8192,16,3549088383
8613,433296991,84185,433381176,6,0,0,1536,12,10016638388
8614,433302609,11533,433314142,3,0,1,18944,2,1624183247
8615,433323170,125333,433448503,4,0,0,40960,16,786072539
8616,433334220,82064,433416284,9,0,0,14848,18,3144435545
8617,433590400,3128,433593528,7,0,1,9216,8,3947498448
8618,433778130,71600,433849730,4,0,0,10752,16,2284982843
8619,433951660,13858,433965518,6,0,1,23552,12,674960518
8620,433982120,134190,434116310,3,0,0,14848,2,8791652272
8621,433994310,230558,434224868,9,0,0,77824,18,1106222159
8622,434017239,82469,434099708,7,0,0,4608,8,5239637023
8623,434040330,100724,434141054,9,0,0,30720,18,7335768432
8624,434052830,107880,434160710,4,0,0,2048,16,10274561315
8625,434077710,148577,434226287,9,0,0,4608,18,1434665631
8626,434110130,6195,434116325,6,0,1,9216,12,10039651516
8627,434116919,64569,434181488,7,0,0,3584,8,5551704643
8628,434128319,104847,434233166,7,0,0,22528,8,5316453460
8629,434147960,6229,434154189,5,0,1,15360,19,4776431115
8630,434190560,10241,434200801,1,0,1,16384,6,8996945745
8631,434227250,10328,434237578,1,0,1,11776,6,4774532649
8632,434263450,78663,434342113,4,0,0,6144,16,3034623952
8633,434272310,2870,434275180,7,0,1,8704,8,1547836607
8634,434277850,89612,434367462,2,0,0,19456,4,7045876802
8635,434294760,43904,434338664,2,0,0,512,4,10330061959
8636,434326139,2946,434329085,8,0,1,3072,12,504845782
8637,434365520,83720,434449240,5,0,0,3584,19,6458446663
8638,434418679,97329,434516008,1,0,0,26112,6,6538345250
8639,434460919,11533,434472452,2,0,1,18944,4,3003655403
8640,434598000,101192,434699192,5,0,0,32256,19,8928932239
8641,434599650,44080,434643730,4,0,0,512,16,10518343995
8642,434624929,124225,434749154,1,0,0,33792,6,2028530777
8643,434658490,141490,434799980,9,0,0,23040,18,9838663493
8644,434724000,82088,434806088,5,0,0,19968,19,10310347498
8645,434922950,45596,434968546,0,0,0,1024,11,9761103365
8646,434958261,101348,435059609,6,0,0,32768,12,4572510536
8647,434996711,104000,435100711,6,0,0,41472,12,4209552116
8648,435002791,109780,435112571,6,0,0,18944,12,3641762642
8649,435008860,72224,435081084,5,0,0,12800,19,3737363406
8650,435124650,1518,435126168,4,0,1,1536,16,2666630561
8651,435128440,181430,435309870,2,0,0,3584,4,10693661097
8652,435216450,3422,435219872,4,0,1,3584,16,7315664267
8653,435226630,96277,435322907,4,0,0,24576,16,10125470334
8654,435268320,4420,435272740,0,0,1,11776,11,689295133
8655,435276480,96980,435373460,9,0,0,18432,18,1042220797
8656,435309170,97204,435406374,0,0,0,16896,11,1921933408
8657,435310890,192246,435503136,3,0,0,106496,2,2327840546
8658,435375960,130311,435506271,3,0,0,10240,2,291285522
8659,435396360,115308,435511668,9,0,0,11264,18,5163062049
8660,435456680,96824,435553504,3,0,0,17920,2,10611561946
8661,435530761,102752,435633513,6,0,0,37376,12,2921803289
8662,435551260,193504,435744764,0,0,0,41984,11,5719323227
8663,435569610,106340,435675950,9,0,0,49152,18,3834731893
8664,435572090,11016,435583106,5,0,1,17920,19,3045726252
8665,435583761,50079,435633840,6,0,0,1024,12,8607324438
8666,435634769,219567,435854336,1,0,0,103936,6,3999505581
8667,435660900,151538,435812438,5,0,0,20992,19,5319504470
8668,435671941,99576,435771517,6,0,0,512,12,2969734601
8669,435672330,11343,435683673,1,0,1,8192,6,3480395632
8670,435788791,134233,435923024,6,0,0,29696,12,2635320528
8671,435818200,74360,435892560,5,0,0,9728,19,3252043168
8672,435843660,106166,435949826,2,0,0,5632,4,1005388024
8673,435851620,197566,436049186,4,0,0,34304,16,202858213
8674,435864360,141170,436005530,2,0,0,27136,4,8223532487
8675,435915870,227816,436143686,2,0,0,59904,4,1213073127
8676,435939140,45596,435984736,3,0,0,1024,2,7830983605
8677,435944930,125226,436070156,5,0,0,11264,19,2095967182
8678,435955620,140510,436096130,4,0,0,15872,16,1557947159
8679,435978840,74258,436053098,9,0,0,10752,18,3238214033
8680,435978999,122447,436101446,1,0,0,3072,6,4283352083
8681,436094679,4389,436099068,8,0,1,3072,12,10572850923
8682,436115041,72668,436187709,6,0,0,9216,12,3782910467
8683,436131530,71280,436202810,4,0,0,5120,16,9855813185
8684,436238340,5196,436243536,7,0,1,13312,8,7488159497
8685,436259609,105365,436364974,7,0,0,30720,8,2969563695
8686,436294280,118052,436412332,2,0,0,33792,4,981028349
8687,436359850,57324,436417174,9,0,0,2560,18,5179198711
8688,436364280,93058,436457338,5,0,0,18432,19,6264595009
8689,436416000,2470,436418470,7,0,1,2560,8,3094636444
8690,436589420,67331,436656751,2,0,0,7168,4,5393886243
8691,436591820,108836,436700656,4,0,0,57344,16,5803086680
8692,436611161,109247,436720408,6,0,0,11264,12,5481801118
8693,436615190,106793,436721983,5,0,0,5120,19,9948917894
8694,436659199,74601,436733800,1,0,0,2560,6,4333783560
8695,436675370,118502,436793872,4,0,0,38400,16,62676189
8696,436793659,4103,436797762,8,0,1,4096,12,1303976287
8697,436795040,60945,436855985,9,0,0,5632,18,1116253413
8698,436864990,80864,436945854,9,0,0,20992,18,3805516010
8699,436892450,100412,436992862,9,0,0,29696,18,1453080178
8700,437058840,80684,437139524,3,0,0,15360,2,10546182419
8701,437095000,47288,437142288,3,0,0,1536,2,8148576932
8702,437149400,52364,437201764,3,0,0,3072,2,3037023761
8703,437216680,3898,437220578,5,0,1,4096,19,7632465596
8704,437218670,2574,437221244,9,0,1,1024,18,8343199663
8705,437231980,5326,437237306,5,0,1,5632,19,5466635220
8706,437318150,88715,437406865,8,0,0,4608,12,1774972368
8707,437420250,61916,437482166,0,0,0,9216,11,5904196883
8708,437523350,50672,437574022,9,0,0,2560,18,5231287399
8709,437662769,4374,437667143,8,0,1,4608,12,8178643798
8710,437680139,88100,437768239,1,0,0,24576,6,936725543
8711,437719471,107588,437827059,6,0,0,53248,12,2539137192
8712,437765549,91600,437857149,1,0,0,9728,6,9017855213
8713,437873070,98072,437971142,2,0,0,22016,4,3109500949
8714,437999690,55748,438055438,2,0,0,4096,4,9821202883
8715,438013000,47288,438060288,0,0,0,1536,11,5772491074
8716,438081129,105404,438186533,1,0,0,46080,6,5541047784
8717,438099889,112354,438212243,7,0,0,18432,8,1183705143
8718,438138360,124913,438263273,3,0,0,18432,2,9619414056
8719,438261021,63068,438324089,6,0,0,5632,12,8378038816
8720,438301850,92528,438394378,2,0,0,18944,4,9393707263
8721,438304700,101660,438406360,3,0,0,33792,2,4345934899
8722,438388270,6123,438394393,1,0,1,2048,6,7291274297
8723,438391739,95330,438487069,1,0,0,19456,6,6796259808
8724,438462480,69620,438532100,5,0,0,14336,19,2866288944
8725,438500849,54897,438555746,1,0,0,5120,6,4131973946
8726,438664140,76364,438740504,4,0,0,11264,16,7561970875
8727,438691150,106840,438797990,5,0,0,12288,19,7510161603
8728,438797110,14213,438811323,4,0,1,22528,16,1237334899
8729,438844270,75583,438919853,3,0,0,9728,2,1982034591
8730,438870129,6774,438876903,8,0,1,7168,12,292574283
8731,438870140,51512,438921652,2,0,0,3072,4,10120759896
8732,438923030,72848,438995878,2,0,0,14848,4,3024169811
8733,438939870,125312,439065182,3,0,0,8704,2,9375438920
8734,438958760,5196,438963956,5,0,1,13312,19,342830764
8735,439120500,80060,439200560,4,0,0,13312,16,4518326650
8736,439129569,73133,439202702,7,0,0,4096,8,8784870241
8737,439148800,70976,439219776,4,0,0,8704,16,4544191818
8738,439182110,3904,439186014,4,0,1,10752,16,3605830625
8739,439255949,67986,439323935,1,0,0,12800,6,474461621
8740,439256319,116938,439373257,1,0,0,29696,6,4121614493
8741,439289529,159242,439448771,1,0,0,22016,6,8056712428
8742,439356619,168298,439524917,1,0,0,38912,6,2876231601
8743,439364130,86840,439450970,0,0,0,7168,11,1628016357
8744,439364570,236532,439601102,9,0,0,7680,18,3281488889
8745,439446801,151946,439598747,6,0,0,53248,12,4544165322
8746,439512010,566,439512576,6,0,1,512,12,721567039
8747,439697450,54056,439751506,4,0,0,3584,16,3191962990
8748,439699050,3422,439702472,9,0,1,3584,18,7577025025
8749,439699219,163700,439862919,7,0,0,15872,8,8928234265
8750,439830210,107900,439938110,4,0,0,54272,16,1112492593
8751,439834930,108031,439942961,0,0,0,15872,11,4927121941
8752,439852100,4679,439856779,9,0,1,12288,18,8857877848
8753,439858729,147247,440005976,7,0,0,74240,8,1640858478
8754,439898930,131364,440030294,0,0,0,11776,11,1915436385
8755,439975610,83936,440059546,9,0,0,20992,18,2949262029
8756,440035659,62516,440098175,1,0,0,6144,6,9434457159
8757,440053569,9867,440063436,3,0,1,4096,2,5682707481
8758,440063431,98252,440161683,6,0,0,27648,12,6295162334
8759,440195580,57415,440252995,2,0,0,6144,4,2277094202
8760,440221251,70976,440292227,6,0,0,8704,12,2385357354
8761,440237660,88544,440326204,9,0,0,20992,18,2736333392
8762,440260730,65645,440326375,4,0,0,512,16,9171700301
8763,440290080,5561,440295641,0,0,1,3584,11,3886044439
8764,440299450,13341,440312791,4,0,1,22528,16,9870097729
8765,440422929,22174,440445103,8,0,1,36352,12,897124306
8766,440512850,103844,440616694,5,0,0,40960,19,6351263586
8767,440526299,97147,440623446,7,0,0,2560,8,3218322703
8768,440544200,125900,440670100,5,0,0,23552,19,6812458317
8769,440556381,133777,440690158,6,0,0,2560,12,7056539322
8770,440719000,100256,440819256,4,0,0,29184,16,6300221353
8771,440719799,111016,440830815,7,0,0,37888,8,3520811771
8772,440733419,43904,440777323,7,0,0,512,8,10127774810
8773,440815620,98007,440913627,0,0,0,12288,11,3951173890
8774,440960921,83444,441044365,6,0,0,14336,12,4031808454
8775,441031529,60824,441092353,1,0,0,5632,6,2811973007
8776,441100451,65612,441166063,6,0,0,11264,12,3452769490
8777,441111460,67616,441179076,2,0,0,12800,4,2745045777
8778,441125020,129171,441254191,5,0,0,20992,19,5776820322
8779,441163071,109816,441272887,6,0,0,11776,12,6363340628
8780,441164090,93392,441257482,9,0,0,10752,18,10296957495
8781,441164200,3423,441167623,5,0,1,1536,19,4290925356
8782,441347319,2946,441350265,3,0,1,3072,2,7051697989
8783,441398980,108680,441507660,4,0,0,56832,16,4579627011
8784,441417891,90096,441507987,6,0,0,1024,12,1882787616
8785,441478680,1994,441480674,9,0,1,2048,18,3980082273
8786,441484330,164861,441649191,3,0,0,49664,2,336232459
8787,441489710,109879,441599589,4,0,0,59392,16,9125069246
8788,441510439,218354,441728793,7,0,0,82944,8,6620669649
8789,441604430,148808,441753238,2,0,0,13312,4,3411977525
8790,441614490,127444,441741934,4,0,0,26624,16,84167213
8791,441660291,72105,441732396,6,0,0,11776,12,10103053456
8792,441769259,53144,441822403,7,0,0,5632,8,9094091127
8793,441779650,122199,441901849,0,0,0,38400,11,1350789308
8794,441860919,109300,441970219,1,0,0,34816,6,1908037315
8795,441892010,80416,441972426,3,0,0,7168,2,1013225802
8796,441965240,90599,442055839,9,0,0,21504,18,7370912203
8797,442017830,3904,442021734,1,0,1,10752,6,3378240320
8798,442062710,70376,442133086,2,0,0,11776,4,3980411087
8799,442071199,109065,442180264,1,0,0,9216,6,9779385285
8800,442173319,86457,442259776,1,0,0,15872,6,6650939093
8801,442420960,103688,442524648,3,0,0,40448,2,5827973296
8802,442543270,50672,442593942,0,0,0,2560,11,5160275308
8803,442606410,101972,442708382,4,0,0,34816,16,9342782181
8804,442659450,90944,442750394,5,0,0,4096,19,16279710
8805,442688380,5326,442693706,9,0,1,5632,18,6700784759
8806,442714689,5971,442720660,2,0,1,14848,4,8764323826
8807,442721770,67842,442789612,5,0,0,3072,19,5723375734
8808,442813249,150025,442963274,7,0,0,47104,8,10298215438
8809,442824630,1518,442826148,7,0,1,1536,8,6418247897
8810,442830140,5326,442835466,6,0,1,5632,12,4755470448
8811,442936060,45596,442981656,0,0,0,1024,11,4877665687
8812,442954250,115824,443070074,0,0,0,50688,11,2047017239
8813,442965540,1042,442966582,5,0,1,1024,19,6051936886
8814,443104010,70976,443174986,5,0,0,8704,19,3616039
8815,443142170,59600,443201770,2,0,0,6656,4,8069705657
8816,443220280,113828,443334108,3,0,0,73728,2,7968645870
8817,443243799,145167,443388966,7,0,0,71168,8,387345001
8818,443247471,165765,443413236,6,0,0,64000,12,1231687400
8819,443258230,195692,443453922,3,0,0,67584,2,9476736022
8820,443274779,184561,443459340,7,0,0,3584,8,9504183577
8821,443318130,17012,443335142,1,0,1,1024,6,9263588925
8822,443408160,8014,443416174,1,0,1,3072,6,6687873928
8823,443416040,3387,443419427,6,0,1,9728,12,7747253841
8824,443470081,87296,443557377,6,0,0,16896,12,2275284101
8825,443504430,96717,443601147,3,0,0,8192,2,8308229417
8826,443505571,55748,443561319,6,0,0,4096,12,3159447055
8827,443539440,57908,443597348,9,0,0,6144,18,2580426460
8828,443571930,57440,443629370,9,0,0,4608,18,3158696585
8829,443615089,101192,443716281,7,0,0,32256,8,5976665995
8830,443637720,3387,443641107,5,0,1,9728,19,1969004297
8831,443646180,22433,443668613,5,0,1,36864,19,6423314146
8832,443649980,165047,443815027,9,0,0,48640,18,3494215788
8833,443690620,109572,443800192,5,0,0,23040,19,9980238368
8834,443723550,5802,443729352,1,0,1,6144,6,5997472153
8835,443765651,49547,443815198,6,0,0,512,12,1417912949
8836,443831250,3422,443834672,5,0,1,3584,19,1771259392
8837,443896231,100568,443996799,6,0,0,30208,12,7094258508
8838,443924791,130616,444055407,6,0,0,33792,12,8727145478
8839,443938240,84893,444023133,8,0,0,4608,12,7577486955
8840,443990889,101316,444092205,1,0,0,12288,6,4114753301
8841,444032011,60521,444092532,6,0,0,1024,12,8638787256
8842,444054691,110774,444165465,6,0,0,28672,12,4046798037
8843,444071951,120358,444192309,6,0,0,20992,12,208119789
8844,444130610,131473,444262083,0,0,0,22016,11,3339070424
8845,444189100,109607,444298707,9,0,0,5632,18,6750610834
8846,444229201,97094,444326295,6,0,0,8704,12,6734887053
8847,444230590,2470,444233060,9,0,1,2560,18,7899632281
8848,444281249,12308,444293557,8,0,1,20480,12,4682022985
8849,444289771,45908,444335679,6,0,0,2048,12,4976541756
8850,444409290,60824,444470114,3,0,0,5632,2,6223302665
8851,444433909,5326,444439235,2,0,1,5632,4,1222858647
8852,444534570,101972,444636542,2,0,0,34816,4,10658204443
8853,444581260,87476,444668736,0,0,0,22528,11,49566573
8854,444618500,3422,444621922,0,0,1,3584,11,10160518213
8855,444644201,72607,444716808,6,0,0,6656,12,788781702
8856,444666949,76601,444743550,7,0,0,2560,8,1111052955
8857,444667230,140778,444808008,5,0,0,16384,19,6404962691
8858,444681220,167336,444848556,2,0,0,1024,4,2104864669
8859,444691180,55748,444746928,9,0,0,4096,18,1295496240
8860,444717490,11274,444728764,5,0,1,18432,19,3155221391
8861,444758239,202980,444961219,7,0,0,96768,8,9135015589
8862,444832290,188573,445020863,4,0,0,39424,16,8952395321
8863,444838410,135360,444973770,2,0,0,32768,4,8483303899
8864,444841700,211158,445052858,9,0,0,104960,18,7368144867
8865,444870409,108992,444979401,7,0,0,18432,8,5169587877
8866,444940470,114743,445055213,0,0,0,7680,11,174156713
8867,444990760,1994,444992754,4,0,1,2048,16,1485466388
8868,445099529,2470,445101999,3,0,1,2560,2,8992112067
8869,445113330,7706,445121036,5,0,1,8192,19,3620230917
8870,445210290,2946,445213236,9,0,1,3072,18,5082307367
8871,445320440,6754,445327194,7,0,1,7168,8,4919692227
8872,445337579,13512,445351091,2,0,1,26112,4,5991271523
8873,445381350,102922,445484272,2,0,0,33280,4,65046391
8874,445476961,66435,445543396,6,0,0,5120,12,1965930193
8875,445536931,96697,445633628,6,0,0,15872,12,4901213825
8876,445537670,86360,445624030,9,0,0,13824,18,6770399587
8877,445540500,50260,445590760,3,0,0,2048,2,10618388435
8878,445579590,70690,445650280,2,0,0,3072,4,7178631269
8879,445583490,71912,445655402,9,0,0,11776,18,7071004364
8880,445688050,5326,445693376,5,0,1,5632,19,3794834462
8881,445707929,11016,445718945,2,0,1,17920,4,6543683953
8882,445716520,216045,445932565,9,0,0,40448,18,8397300503
8883,445731620,98332,445829952,3,0,0,22016,2,6072644636
8884,445732830,170719,445903549,5,0,0,10752,19,4358819594
8885,445769730,87314,445857044,8,0,0,13312,12,2892675427
8886,445785950,89616,445875566,3,0,0,7168,2,4299357549
8887,445788741,64232,445852973,6,0,0,11776,12,5141942738
8888,445872629,99968,445972597,1,0,0,13312,6,5277826901
8889,445877660,105872,445983532,8,0,0,35840,12,3045526448
8890,445922240,117398,446039638,9,0,0,49152,18,3539731659
8891,445935990,1518,445937508,6,0,1,1536,12,3489332124
8892,445949800,111195,446060995,2,0,0,4608,4,1326508401
8893,446037180,105514,446142694,0,0,0,38400,11,10352929998
8894,446091781,133557,446225338,6,0,0,25088,12,7437965033
8895,446166040,122286,446288326,9,0,0,12800,18,973020161
8896,446199520,64208,446263728,3,0,0,6656,2,233942161
8897,446225800,121908,446347708,9,0,0,25088,18,6156198662
8898,446230320,98628,446328948,2,0,0,23552,4,5066314805
8899,446310980,4162,446315142,6,0,1,11264,12,5452472457
8900,446315820,76052,446391872,9,0,0,10240,18,3308651812
8901,446415460,69464,446484924,3,0,0,13824,2,2419210675
8902,446469910,84692,446554602,3,0,0,18432,2,3268221875
8903,446507490,10757,446518247,4,0,1,17408,16,4343266577
8904,446583010,149441,446732451,9,0,0,26112,18,6289414658
8905,446596020,113633,446709653,3,0,0,40448,2,4705706157
8906,446597631,157586,446755217,6,0,0,28672,12,5893120912
8907,446597850,12825,446610675,6,0,1,21504,12,6031556496
8908,446652289,119006,446771295,7,0,0,22528,8,10072017134
8909,446669370,1518,446670888,0,0,1,1536,11,8735060995
8910,446676160,102286,446778446,4,0,0,20480,16,4611659964
8911,446678560,254491,446933051,8,0,0,64512,12,3461952582
8912,446711581,239206,446950787,6,0,0,25600,12,3114758401
8913,446754849,157007,446911856,7,0,0,64000,8,3808416603
8914,446822720,114417,446937137,9,0,0,13312,18,6147591380
8915,446828090,114882,446942972,0,0,0,2560,11,6292666404
8916,446836300,146653,446982953,3,0,0,20480,2,6180186257
8917,446870939,40932,446911871,8,0,1,35840,12,10237392247
8918,446901210,31856,446933066,0,0,1,8704,11,6765659325
8919,446928310,91871,447020181,0,0,0,12800,11,1513349745
8920,446929240,129898,447059138,5,0,0,5120,19,5745284089
8921,446956260,2946,446959206,6,0,1,3072,12,7797642205
8922,447027570,3387,447030957,9,0,1,9728,18,7686495295
8923,447053710,59600,447113310,9,0,0,6656,18,2219388572
8924,447074330,123418,447197748,2,0,0,55808,4,8347845010
8925,447134610,113590,447248200,9,0,0,13824,18,6489424843
8926,447139610,64208,447203818,0,0,0,6656,11,9873549858
8927,447174310,76869,447251179,4,0,0,9728,16,7352208230
8928,447192800,142906,447335706,2,0,0,15872,4,7226943258
8929,447239450,86072,447325522,8,0,0,17920,12,1318241991
8930,447268450,104534,447372984,9,0,0,31232,18,6208032621
8931,447276150,105984,447382134,5,0,0,9728,19,10485846955
8932,447308600,177274,447485874,5,0,0,40448,19,4927886766
8933,447332630,99310,447431940,5,0,0,10752,19,9733027754
8934,447561150,4374,447565524,1,0,1,4608,6,7594964878
8935,447565939,90392,447656331,1,0,0,22016,6,8237838796
8936,447567429,10499,447577928,2,0,1,16896,4,5471896481
8937,447591749,156196,447747945,7,0,0,94720,8,1745662152
8938,447675819,309265,447985084,7,0,0,76288,8,3678220610
8939,447686150,3128,447689278,9,0,1,9216,18,10511165813
8940,447725969,200945,447926914,1,0,0,27648,6,4967614804
8941,447801611,99476,447901087,6,0,0,26624,12,5272871418
8942,447801940,1518,447803458,1,0,1,1536,6,10156365589
8943,447846700,566,447847266,0,0,1,512,11,202969372
8944,447912509,77122,447989631,1,0,0,14848,6,1598714548
8945,447967310,128878,448096188,8,0,0,35328,12,8348520446
8946,447994060,77820,448071880,5,0,0,10240,19,2332799049
8947,448041900,80996,448122896,5,0,0,16384,19,4841432680
8948,448111250,99788,448211038,5,0,0,27648,19,3647606551
8949,448161650,125090,448286740,5,0,0,48128,19,8789278228
8950,448220309,4420,448224729,2,0,1,11776,4,3760875111
8951,448294350,566,448294916,6,0,1,512,12,7873054496
8952,448312180,84404,448396584,2,0,0,22528,4,1715808203
8953,448341010,106652,448447662,4,0,0,50176,16,1290350133
8954,448362620,116188,448478808,4,0,0,17920,16,7303657120
8955,448365800,167620,448533420,0,0,0,35840,11,8615591297
8956,448376910,205308,448582218,3,0,0,18432,2,6911812785
8957,448408551,77691,448486242,6,0,0,8192,12,5890470653
8958,448423730,5802,448429532,9,0,1,6144,18,1194757194
8959,448462830,99552,448562382,4,0,0,13824,16,9669236875
8960,448672050,107744,448779794,9,0,0,53760,18,6669591949
8961,448705579,86449,448792028,1,0,0,2048,6,10299227701
8962,448718499,2870,448721369,8,0,1,8704,12,1971918256
8963,448764390,60992,448825382,9,0,0,1024,18,9921652017
8964,448841680,123621,448965301,0,0,0,24576,11,6860697741
8965,448868379,5326,448873705,8,0,1,5632,12,6781328635
8966,448885480,62846,448948326,3,0,0,8704,2,6937485686
8967,449007640,106340,449113980,3,0,0,49152,2,6807233041
8968,449024570,103688,449128258,4,0,0,40448,16,3496665491
8969,449058249,1518,449059767,3,0,1,1536,2,10171256252
8970,449122510,8686,449131196,7,0,1,3072,8,5734377294
8971,449149000,101660,449250660,1,0,0,33792,6,5751668026
8972,449415679,43904,449459583,1,0,0,512,6,47373190
8973,449444229,74360,449518589,7,0,0,9728,8,10126464454
8974,449451510,113747,449565257,1,0,0,38400,6,3855163736
8975,449457079,7230,449464309,3,0,1,7680,2,10055211595
8976,449457520,13329,449470849,4,0,1,18432,16,8983727894
8977,449465800,87742,449553542,4,0,0,14848,16,5286920090
8978,449494770,115524,449610294,0,0,0,22016,11,3323546535
8979,449519169,4679,449523848,8,0,1,12288,12,257712976
8980,449598191,98696,449696887,6,0,0,24064,12,9851232977
8981,449636280,6278,449642558,9,0,1,6656,18,5528111888
8982,449656530,101660,449758190,4,0,0,33792,16,9988692545
8983,449695440,134828,449830268,3,0,0,67584,2,1559423467
8984,449780130,120014,449900144,4,0,0,17408,16,1932167812
8985,449842080,88388,449930468,4,0,0,20480,16,8802353570
8986,449940750,88700,450029450,0,0,0,21504,11,3688087077
8987,449972330,81596,450053926,1,0,0,13312,6,61898601
8988,450063629,105092,450168721,7,0,0,45056,8,2255322878
8989,450165350,60803,450226153,3,0,0,4608,2,8407259374
8990,450172190,52364,450224554,0,0,0,3072,11,8245991022
8991,450204250,87476,450291726,5,0,0,22528,19,6432798340
8992,450282590,106028,450388618,9,0,0,48128,18,459447471
8993,450338031,91165,450429196,6,0,0,13824,12,8960876981
8994,450339530,50709,450390239,3,0,0,2560,2,7073288703
8995,450360300,117449,450477749,9,0,0,51712,18,2066232100
8996,450428369,7573,450435942,3,0,1,7168,2,2503657328
8997,450590000,116324,450706324,3,0,0,81920,2,3236147976
8998,450616170,5802,450621972,7,0,1,6144,8,7939144175
8999,450657620,7706,450665326,9,0,1,8192,18,314949269
9000,450811840,61760,450873600,0,0,0,8704,11,5487159699
9001,450827081,99788,450926869,6,0,0,27648,12,8439653062
9002,450929229,119385,451048614,7,0,0,87040,8,1410737657
9003,450930730,162824,451093554,0,0,0,73216,11,48389110
9004,451009520,189988,451199508,0,0,0,12800,11,2966141672
9005,451033010,136749,451169759,4,0,0,95232,16,2545952671
9006,451056860,36709,451093569,7,0,1,57344,8,1979538867
9007,451149899,23274,451173173,2,0,1,3584,4,6582797226
9008,451258480,89168,451347648,8,0,0,23040,12,8800196994
9009,451264260,73292,451337552,1,0,0,11264,6,599024334
9010,451311200,14029,451325229,1,0,1,27136,6,3549292113
9011,451499970,566,451500536,1,0,1,512,6,725400017
9012,451502180,6278,451508458,9,0,1,6656,18,1050074960
9013,451502580,65885,451568465,1,0,0,6656,6,10674941149
9014,451510649,95000,451605649,7,0,0,22016,8,1059946690
9015,451584529,102284,451686813,7,0,0,35840,8,1070412403
9016,451641641,86716,451728357,6,0,0,3584,12,9450139638
9017,451647860,68983,451716843,9,0,0,12288,18,1787929238
9018,451713279,87780,451801059,7,0,0,20992,8,581068622
9019,451738000,110633,451848633,1,0,0,4608,6,7227027812
9020,451754569,82424,451836993,7,0,0,11776,8,1945901396
9021,451758989,65980,451824969,7,0,0,2560,8,10720040082
9022,451773830,155653,451929483,9,0,0,41984,18,3843062317
9023,451890960,102752,451993712,3,0,0,37376,2,7627084753
9024,451902359,138747,452041106,7,0,0,15360,8,1998906839
9025,451959520,101660,452061180,1,0,0,33792,6,8799453514
9026,452026240,62498,452088738,0,0,0,1536,11,1769391752
9027,452041450,54056,452095506,2,0,0,3584,4,6858918982
9028,452104960,90236,452195196,3,0,0,21504,2,3737314256
9029,452138040,4850,452142890,1,0,1,5120,6,9636673456
9030,452163209,52364,452215573,7,0,0,3072,8,3075371408
9031,452199030,60824,452259854,9,0,0,5632,18,590132945
9032,452215260,82993,452298253,9,0,0,16896,18,1008792118
9033,452264410,128895,452393305,9,0,0,29184,18,6124840275
9034,452348649,120202,452468851,7,0,0,49152,8,10527996972
9035,452413420,118497,452531917,3,0,0,28160,2,2919396189
9036,452490980,59279,452550259,3,0,0,1536,2,8247307616
9037,452495979,70976,452566955,1,0,0,8704,6,10443804838
9038,452496640,116409,452613049,3,0,0,19968,2,7880733474
9039,452499930,81752,452581682,9,0,0,13824,18,8397608568
9040,452626900,59132,452686032,1,0,0,5120,6,10651491007
9041,452704910,108212,452813122,3,0,0,55296,2,7976268522
9042,452756260,83862,452840122,1,0,0,512,6,6333377889
9043,452786950,2470,452789420,0,0,1,2560,11,1102894537
9044,452847290,109616,452956906,4,0,0,59904,16,1360835407
9045,452857900,59132,452917032,3,0,0,5120,2,5063178257
9046,452876970,120912,452997882,4,0,0,42496,16,8171043303
9047,452882910,209877,453092787,1,0,0,27648,6,4395479915
9048,452890611,203439,453094050,6,0,0,4096,12,10597925682
9049,452904090,180258,453084348,5,0,0,98304,19,9089274868
9050,452949399,159931,453109330,7,0,0,23552,8,9830964043
9051,452994431,100258,453094689,6,0,0,2048,12,4299057350
9052,453005370,2470,453007840,1,0,1,2560,6,2613913075
9053,453029829,3128,453032957,3,0,1,9216,2,7740033762
9054,453113680,97760,453211440,0,0,0,20992,11,5426295834
9055,453220800,106808,453327608,5,0,0,50688,19,5062220875
9056,453344850,43904,453388754,1,0,0,512,6,594663510
9057,453382129,6754,453388883,2,0,1,7168,4,8341798744
9058,453476690,55748,453532438,4,0,0,4096,16,8569844622
9059,453525810,5326,453531136,5,0,1,5632,19,10494244888
9060,453617420,59132,453676552,0,0,0,5120,11,3962626602
9061,453701680,98696,453800376,0,0,0,24064,11,9680827342
9062,453717960,136716,453854676,1,0,0,40960,6,6933566407
9063,453852109,66767,453918876,7,0,0,6656,8,4140169614
9064,453885540,103844,453989384,4,0,0,40960,16,4111067460
9065,453888330,87818,453976148,3,0,0,2560,2,2783176014
9066,453905550,111054,454016604,4,0,0,32768,16,6359196307
9067,453937510,148666,454086176,5,0,0,64000,19,7471176455
9068,453984210,16957,454001167,1,0,1,19456,6,10679806804
9069,454056780,74350,454131130,7,0,1,121344,8,6067752600
9070,454147170,186074,454333244,4,0,0,1536,16,5816567369
9071,454169500,47288,454216788,1,0,0,1536,6,9941904029
9072,454192990,85940,454278930,9,0,0,12800,18,8228535969
9073,454233710,73401,454307111,9,0,0,3072,18,2461266930
9074,454251619,3645,454255264,2,0,1,10240,4,3020012698
9075,454297870,83444,454381314,4,0,0,14336,16,2462787975
9076,454306170,79527,454385697,1,0,0,14336,6,9790337832
9077,454306809,108842,454415651,7,0,0,43008,8,2864142781
9078,454318741,178228,454496969,6,0,0,16384,12,1240484026
9079,454347950,108615,454456565,0,0,0,14848,11,9562306994
9080,454363740,205967,454569707,3,0,0,27136,2,4759196342
9081,454372210,136936,454509146,5,0,0,22528,19,1964775979
9082,454375590,101504,454477094,5,0,0,33280,19,5512319535
9083,454448540,79148,454527688,9,0,0,15360,18,4062511209
9084,454523740,57523,454581263,7,0,1,87552,8,3255332353
9085,454578090,91782,454669872,5,0,0,4608,19,8924047176
9086,454584290,261983,454846273,1,0,0,39936,6,6210075725
9087,454669349,164741,454834090,7,0,0,32768,8,856367873
9088,454736029,566,454736595,8,0,1,512,12,1021610003
9089,454758860,120200,454879060,5,0,0,17920,19,998375214
9090,454896490,109304,455005794,3,0,0,58880,2,10558428214
9091,454987121,74516,455061637,6,0,0,10240,12,9947272091
9092,455062020,65900,455127920,5,0,0,7168,19,1925001380
9093,455063510,120504,455184014,9,0,0,38912,18,1820005477
9094,455150640,4162,455154802,5,0,1,11264,19,1440469119
9095,455168199,64208,455232407,7,0,0,6656,8,9736724004
9096,455197960,191714,455389674,0,0,0,26624,11,759208046
9097,455212810,69284,455282094,1,0,0,8192,6,2377669803
9098,455218770,75646,455294416,2,0,0,4608,4,5870277423
9099,455223300,122292,455345592,0,0,0,13824,11,8632523678
9100,455233229,6754,455239983,3,0,1,7168,2,5726049826
9101,455250090,155667,455405757,9,0,0,52736,18,2457742516
9102,455256660,124887,455381547,1,0,0,15360,6,8181317714
9103,455314830,113847,455428677,5,0,0,2560,19,268597145
9104,455361810,4850,455366660,7,0,1,5120,8,6855270408
9105,455496570,14287,455510857,6,0,1,27648,12,9903253361
9106,455497170,269793,455766963,0,0,0,74240,11,2989195277
9107,455540570,5454,455546024,6,0,1,13824,12,378235696
9108,455668320,1994,455670314,6,0,1,2048,12,1889540995
9109,455699190,101348,455800538,1,0,0,32768,6,4790120895
9110,455730050,124626,455854676,5,0,0,7680,19,1615893192
9111,455746351,84973,455831324,6,0,0,6656,12,3534178002
9112,455756430,89542,455845972,0,0,0,14848,11,5984151670
9113,455789250,47600,455836850,4,0,0,2560,16,9578881337
9114,455815159,102285,455917444,7,0,0,10240,8,10622044001
9115,455819199,5326,455824525,8,0,1,5632,12,3460921275
9116,455848291,85940,455934231,6,0,0,22528,12,4415337482
9117,455858310,99164,455957474,9,0,0,25600,18,8220861807
9118,455894640,136640,456031280,2,0,0,34816,4,2059327309
9119,455905980,66927,455972907,1,0,0,1024,6,2815117102
9120,455978170,93118,456071288,3,0,0,2560,2,6869915200
9121,456039250,65900,456105150,9,0,0,7168,18,4877703181
9122,456044909,1042,456045951,3,0,1,1024,2,6529266110
9123,456054619,3898,456058517,2,0,1,4096,4,7330687521
9124,456069820,162611,456232431,1,0,0,16384,6,4637107017
9125,456100910,101632,456202542,0,0,0,27136,11,1134560815
9126,456113749,2946,456116695,3,0,1,3072,2,2817866760
9127,456131270,1042,456132312,9,0,1,1024,18,9248704758
9128,456166600,60824,456227424,2,0,0,5632,4,1665700487
9129,456172710,223162,456395872,2,0,0,9728,4,9826229426
9130,456198300,58290,456256590,1,0,0,3584,6,2960324535
9131,456234590,109928,456344518,0,0,0,60928,11,10389498580
9132,456260010,87946,456347956,1,0,0,512,6,7242700044
9133,456267410,102926,456370336,9,0,0,23552,18,9570774456
9134,456335520,73180,456408700,3,0,0,1024,2,7654894948
9135,456359550,105436,456464986,1,0,0,33792,6,7315398594
9136,456389230,52210,456441440,9,0,0,3072,18,5977756698
9137,456453170,11831,456465001,6,0,1,7680,12,8704392101
9138,456480670,54056,456534726,5,0,0,3584,19,1259930579
9139,456560579,69308,456629887,7,0,0,13312,8,6231027982
9140,456576390,45596,456621986,3,0,0,1024,2,6518132461
9141,456625260,64208,456689468,4,0,0,6656,16,8831267367
9142,456632310,45596,456677906,5,0,0,1024,19,2659092614
9143,456776401,48980,456825381,6,0,0,2048,12,10589126001
9144,456827610,110084,456937694,1,0,0,61440,6,4261715093
9145,456854080,2870,456856950,6,0,1,8704,12,9438568606
9146,456931790,87961,457019751,4,0,0,9728,16,6349920963
9147,456953310,49136,457002446,1,0,0,2560,6,4869959930
9148,456970500,106964,457077464,9,0,0,51200,18,3289609996
9149,457019680,2533,457022213,6,0,1,2560,12,6514162667
9150,457022790,82103,457104893,4,0,0,6144,16,9937382601
9151,457068160,116491,457184651,4,0,0,39936,16,5429040315
9152,457075710,6191,457081901,0,0,1,11776,11,314198765
9153,457080150,6422,457086572,5,0,1,13824,19,1513832862
9154,457138290,4850,457143140,1,0,1,5120,6,4943092425
9155,457169481,106496,457275977,6,0,0,49664,12,5403439734
9156,457235880,162997,457398877,8,0,0,30208,12,2286015659
9157,457307580,168868,457476448,1,0,0,54272,6,1419976659
9158,457351020,108877,457459897,9,0,0,56832,18,2699655727
9159,457444180,35749,457479929,9,0,1,3584,18,2160039670
9160,457445780,35455,457481235,4,0,1,2048,16,990257685
9161,457447640,33941,457481581,1,0,1,512,6,6439629527
9162,457470470,12737,457483207,1,0,1,2560,6,7260983754
9163,457507250,4420,457511670,5,0,1,11776,19,10198113050
9164,457536140,183230,457719370,3,0,0,39936,2,6646793770
9165,457600371,106808,457707179,6,0,0,50688,12,876742315
9166,457627800,92053,457719853,4,0,0,1536,16,2329029366
9167,457665111,60314,457725425,6,0,0,3584,12,2491885513
9168,457671660,119339,457790999,8,0,0,26112,12,7009574340
9169,457685230,139129,457824359,3,0,0,65024,2,9279531499
9170,457693499,168883,457862382,7,0,0,67584,8,272394577
9171,457724600,2811,457727411,0,0,1,2048,11,9034423389
9172,457760589,115113,457875702,7,0,0,25600,8,7525153785
9173,457848769,79505,457928274,7,0,0,7168,8,9275337767
9174,457863450,147210,458010660,8,0,0,44544,12,5618635962
9175,457877000,95272,457972272,5,0,0,14336,19,3256185138
9176,457927400,134974,458062374,0,0,0,26624,11,10217656370
9177,457938889,179771,458118660,7,0,0,99328,8,194577535
9178,457967239,566,457967805,2,0,1,512,4,1759978737
9179,458021689,2870,458024559,2,0,1,8704,4,381279071
9180,458054700,64607,458119307,9,0,0,2048,18,5496764445
9181,458102469,21993,458124462,3,0,1,13312,2,3251842870
9182,458205650,56372,458262022,2,0,0,6144,4,294547128
9183,458224790,109705,458334495,9,0,0,18432,18,1875018270
9184,458229501,52651,458282152,6,0,0,512,12,4964738223
9185,458263599,3387,458266986,2,0,1,9728,4,8668019873
9186,458280870,3645,458284515,1,0,1,10240,6,1778050377
9187,458331560,55291,458386851,1,0,0,3072,6,2399142787
9188,458592860,11791,458604651,0,0,1,19456,11,7458159994
9189,458632140,1994,458634134,0,0,1,2048,11,9554209706
9190,458681780,2870,458684650,5,0,1,8704,19,7124434615
9191,458703870,73487,458777357,7,0,1,122880,8,4194677352
9192,458716950,168857,458885807,3,0,0,16896,2,1405462558
9193,458758450,20213,458778663,1,0,1,2048,6,8633396051
9194,458788480,134539,458923019,3,0,0,26624,2,7480344282
9195,458809379,5802,458815181,8,0,1,6144,12,380776087
9196,458849170,1994,458851164,5,0,1,2048,19,1167443753
9197,458858580,3898,458862478,6,0,1,4096,12,5360309351
9198,458894149,2470,458896619,2,0,1,2560,4,7959981843
9199,458910690,106028,459016718,1,0,0,48128,6,9942932376
9200,458924630,107874,459032504,1,0,0,51712,6,10044250386
9201,458961290,10757,458972047,9,0,1,17408,18,5915004098
9202,459001140,15593,459016733,5,0,1,2048,19,3124940590
9203,459021060,15357,459036417,0,0,1,10752,11,4178766492
9204,459026150,20396,459046546,5,0,1,17408,19,211584103
9205,459039749,151810,459191559,7,0,0,37888,8,1818269043
9206,459113250,125859,459239109,5,0,0,16384,19,4935210217
9207,459123390,188834,459312224,2,0,0,48128,4,9356310287
9208,459129100,130188,459259288,8,0,0,9728,12,1205087688
9209,459153450,50783,459204233,0,0,0,2560,11,7220440686
9210,459156150,47288,459203438,2,0,0,1536,4,2861185702
9211,459210290,6278,459216568,9,0,1,6656,18,3124086235
9212,459253101,160698,459413799,6,0,0,19968,12,4933671591
9213,459256249,3054,459259303,8,0,1,2048,12,4096575317
9214,459262579,127609,459390188,7,0,0,19456,8,4832250081
9215,459330311,136893,459467204,6,0,0,17920,12,8982099760
9216,459374860,108209,459483069,1,0,0,44544,6,10302041536
9217,459460999,6220,459467219,2,0,1,1024,4,1571716461
9218,459484739,76832,459561571,7,0,0,12800,8,2767888875
9219,459514620,77768,459592388,9,0,0,15872,18,3223005012
9220,459585410,115230,459700640,3,0,0,66048,2,1362810800
9221,459597249,3422,459600671,2,0,1,3584,4,7808837871
9222,459665140,3422,459668562,5,0,1,3584,19,10221284961
9223,459738220,90524,459828744,1,0,0,17408,6,7848059169
9224,459741250,100724,459841974,3,0,0,30720,2,10483488150
9225,459755550,87531,459843081,3,0,0,3584,2,8976206124
9226,459830870,103220,459934090,3,0,0,38912,2,2615690039
9227,459837190,102063,459939253,8,0,0,16896,12,427401703
9228,459906721,110637,460017358,6,0,0,27648,12,128710822
9229,459911099,4850,459915949,8,0,1,5120,12,4266751226
9230,459920440,112065,460032505,1,0,0,49664,6,4381996033
9231,459961410,137482,460098892,5,0,0,47104,19,6492315832
9232,459962579,1518,459964097,2,0,1,1536,4,8036634328
9233,459968850,191296,460160146,2,0,0,65536,4,3509900272
9234,460054690,109839,460164529,2,0,0,14336,4,4721832379
9235,460118680,88722,460207402,9,0,0,6656,18,6622114786
9236,460130240,73004,460203244,3,0,0,15360,2,3051721618
9237,460162610,7365,460169975,9,0,1,13824,18,8262620002
9238,460197860,69284,460267144,3,0,0,8192,2,1027529123
9239,460296600,90236,460386836,2,0,0,21504,4,8905066977
9240,460328501,127779,460456280,6,0,0,10240,12,6407700289
9241,460381890,77606,460459496,9,0,0,9216,18,5033649887
9242,460417140,127478,460544618,1,0,0,72192,6,8675713002
9243,460424790,136154,460560944,1,0,0,8704,6,9762552885
9244,460461129,1518,460462647,2,0,1,1536,4,10303732482
9245,460619981,54056,460674037,6,0,0,3584,12,2389240487
9246,460667940,45596,460713536,1,0,0,1024,6,4958935955
9247,460703360,76700,460780060,5,0,0,17408,19,8886450729
9248,460756900,82944,460839844,8,0,0,9728,12,9292631414
9249,460803040,100350,460903390,3,0,0,25600,2,8961848655
9250,460820560,101504,460922064,4,0,0,33280,16,8724077078
9251,460878640,54056,460932696,2,0,0,3584,4,114760711
9252,461017430,90236,461107666,3,0,0,21504,2,9246855553
9253,461047070,47288,461094358,3,0,0,1536,2,9014338606
9254,461069560,106872,461176432,8,0,0,37888,12,4964376848
9255,461201570,81128,461282698,8,0,0,11776,12,4212866430
9256,461255129,43904,461299033,7,0,0,512,8,1590099111
9257,461271749,47288,461319037,7,0,0,1536,8,9963543364
9258,461370110,5326,461375436,0,0,1,5632,11,5334829702
9259,461385391,80244,461465635,6,0,0,16896,12,6054175214
9260,461410879,100938,461511817,7,0,0,31232,8,7752346271
9261,461556400,47288,461603688,9,0,0,1536,18,3999790030
9262,461748670,1042,461749712,6,0,1,1024,12,829980093
9263,461753740,3422,461757162,4,0,1,3584,16,1739825796
9264,461783870,14029,461797899,4,0,1,27136,16,503880205
9265,461812570,77900,461890470,1,0,0,11264,6,2122796606
9266,461882790,77744,461960534,8,0,0,10752,12,5084518
9267,461886949,64208,461951157,7,0,0,6656,8,533645600
9268,461912689,3645,461916334,8,0,1,10240,12,5266647560
9269,461992949,1994,461994943,3,0,1,2048,2,7880766944
9270,462021490,94244,462115734,8,0,0,24576,12,8700001919
9271,462037020,200733,462237753,5,0,0,12800,19,6853710236
9272,462038840,130726,462169566,9,0,0,39936,18,8679143249
9273,462065500,181892,462247392,5,0,0,512,19,9709626196
9274,462132490,101348,462233838,3,0,0,32768,2,6421513256
9275,462137030,67594,462204624,3,0,0,7680,2,574336138
9276,462157300,151904,462309204,4,0,0,47104,16,7590730934
9277,462180570,153600,462334170,5,0,0,57344,19,5453784345
9278,462247050,148470,462395520,8,0,0,30720,12,3668025585
9279,462331580,7432,462339012,6,0,1,5120,12,4698233107
9280,462383890,11645,462395535,6,0,1,4608,12,5558026270
9281,462420770,77768,462498538,1,0,0,15872,6,4740083818
9282,462543030,13512,462556542,5,0,1,26112,19,1459794002
9283,462560841,62516,462623357,6,0,0,6144,12,2257426700
9284,462575150,54056,462629206,5,0,0,3584,19,2890090193
9285,462588319,104312,462692631,7,0,0,42496,8,6844781997
9286,462594720,162039,462756759,5,0,0,91648,19,3449264264
9287,462650160,1518,462651678,9,0,1,1536,18,2924063556
9288,462691781,115018,462806799,6,0,0,36864,12,4908546091
9289,462704980,566,462705546,0,0,1,512,11,8459237164
9290,462925439,11533,462936972,2,0,1,18944,4,7724621735
9291,462935420,48980,462984400,1,0,0,2048,6,4444322650
9292,462946089,2946,462949035,8,0,1,3072,12,1727557977
9293,462955199,5326,462960525,3,0,1,5632,2,3462622723
9294,462994430,61916,463056346,2,0,0,9216,4,5460824019
9295,463057189,117728,463174917,7,0,0,86528,8,9600358128
9296,463127279,66814,463194093,7,0,0,1024,8,3214629381
9297,463133480,71389,463204869,3,0,0,6144,2,3547112247
9298,463157899,72800,463230699,7,0,0,4096,8,10008762689
9299,463250220,124764,463374984,2,0,0,47104,4,9209665840
9300,463259900,15837,463275737,1,0,1,30720,6,684343503
9301,463314581,124424,463439005,6,0,0,94720,12,8080512644
9302,463315360,6278,463321638,5,0,1,6656,19,6511237802
9303,463399610,56951,463456561,4,0,0,2560,16,9554174845
9304,463420510,130287,463550797,2,0,0,67072,4,3992437270
9305,463432230,185377,463617607,0,0,0,58368,11,3350756910
9306,463654319,2470,463656789,8,0,1,2560,12,3630270527
9307,463683590,233438,463917028,2,0,0,47104,4,3687077229
9308,463694880,76364,463771244,1,0,0,11264,6,9217944104
9309,463741850,107120,463848970,3,0,0,51712,2,2319496800
9310,463748560,119145,463867705,2,0,0,61440,4,3986684374
9311,463897280,47288,463944568,2,0,0,1536,4,3449523534
9312,463977470,43904,464021374,1,0,0,512,6,1318986484
9313,464113661,69284,464182945,6,0,0,8192,12,4823868909
9314,464126890,127737,464254627,4,0,0,55808,16,572570859
9315,464133650,187031,464320681,0,0,0,49664,11,7445221342
9316,464136540,127946,464264486,0,0,0,32256,11,4001122465
9317,464237840,84884,464322724,9,0,0,6656,18,9177997908
9318,464250860,84238,464335098,3,0,0,8192,2,10186496295
9319,464295810,47288,464343098,0,0,0,1536,11,6293150017
9320,464321700,69856,464391556,8,0,0,11776,12,1424303857
9321,464384540,103688,464488228,3,0,0,40448,2,1568281061
9322,464413920,3645,464417565,4,0,1,10240,16,3261880335
9323,464485710,6408,464492118,4,0,1,4096,16,8285135417
9324,464518889,5454,464524343,8,0,1,13824,12,4703787053
9325,464524530,131757,464656287,3,0,0,65536,2,2543054462
9326,464531080,126782,464657862,2,0,0,5120,4,1408840840
9327,464577920,123301,464701221,9,0,0,10240,18,4761429645
9328,464585250,95112,464680362,3,0,0,6144,2,10691634737
9329,464739240,60068,464799308,5,0,0,8192,19,1469491962
9330,464749270,3904,464753174,1,0,1,10752,6,1046263886
9331,464782879,97448,464880327,7,0,0,19968,8,9988350619
9332,464851910,52676,464904586,5,0,0,4096,19,4743473368
9333,464886060,96980,464983040,2,0,0,18432,4,3967053372
9334,464917250,101504,465018754,1,0,0,33280,6,5950007544
9335,465002930,72668,465075598,3,0,0,9216,2,4074673700
9336,465008110,101036,465109146,9,0,0,31744,18,4641236042
9337,465045350,77300,465122650,0,0,0,14336,11,9109566408
9338,465061250,74728,465135978,4,0,0,6656,16,1266293146
9339,465093369,84261,465177630,7,0,0,12288,8,2234351338
9340,465124410,107736,465232146,5,0,0,27648,19,1295271310
9341,465155050,62684,465217734,2,0,0,512,4,860821262
9342,465162300,74541,465236841,0,0,0,15360,11,6218096076
9343,465241540,82820,465324360,4,0,0,12288,16,504520646
9344,465244090,47444,465291534,0,0,0,2048,11,5082320731
9345,465334259,3422,465337681,3,0,1,3584,2,7405396644
9346,465340060,167683,465507743,3,0,0,39424,2,6646548683
9347,465358541,137167,465495708,6,0,0,49664,12,8044225744
9348,465384579,128956,465513535,7,0,0,1024,8,2514317822
9349,465481450,98474,465579924,0,0,0,16896,11,7531606548
9350,465542660,66992,465609652,5,0,0,10752,19,9290657710
9351,465605979,101192,465707171,7,0,0,32256,8,9325583169
9352,465705680,102519,465808199,1,0,0,31744,6,5814541764
9353,465716920,98863,465815783,0,0,0,11264,11,5742610129
9354,465734010,6754,465740764,9,0,1,7168,18,1475491546
9355,465803540,74559,465878099,5,0,0,10240,19,4103621466
9356,465819680,194618,466014298,3,0,0,27648,2,3618698209
9357,465831790,99679,465931469,5,0,0,17920,19,1564554092
9358,465848120,112874,465960994,0,0,0,31744,11,2384439510
9359,465958630,58884,466017514,8,0,0,6656,12,334015352
9360,465978689,88577,466067266,7,0,0,7680,8,6025541497
9361,466033940,57440,466091380,3,0,0,4608,2,7914924517
9362,466040990,114542,466155532,8,0,0,58880,12,3190167691
9363,466058580,57440,466116020,4,0,0,4608,16,5029521480
9364,466066170,94798,466160968,0,0,0,2048,11,7304420047
9365,466091720,96848,466188568,9,0,0,23040,18,1381750290
9366,466126880,566,466127446,0,0,1,512,11,2427511472
9367,466129510,101192,466230702,9,0,0,32256,18,9722709375
9368,466135270,104347,466239617,4,0,0,29184,16,9699038690
9369,466159150,1994,466161144,7,0,1,2048,8,6390612335
9370,466181350,83372,466264722,0,0,0,512,11,8556265817
9371,466221800,107590,466329390,5,0,0,24064,19,8573434132
9372,466244090,2946,466247036,0,0,1,3072,11,5622134218
9373,466258340,97604,466355944,1,0,0,20480,6,316309211
9374,466333801,70976,466404777,6,0,0,8704,12,656665962
9375,466359490,36087,466395577,7,0,1,63488,8,2063503467
9376,466436940,1518,466438458,5,0,1,1536,19,2565954428
9377,466439619,120055,466559674,7,0,0,29696,8,176621343
9378,466462240,134643,466596883,9,0,0,10752,18,5943300559
9379,466472119,216158,466688277,7,0,0,50688,8,4317034585
9380,466494829,1518,466496347,8,0,1,1536,12,3662349135
9381,466637760,61969,466699729,9,0,0,7168,18,7956802580
9382,466669431,65900,466735331,6,0,0,7168,12,2926407584
9383,466758880,64076,466822956,8,0,0,11264,12,6887915571
9384,466844850,100100,466944950,8,0,0,28672,12,1719783658
9385,466856310,76700,466933010,9,0,0,4608,18,7186545115
9386,466881800,95808,466977608,4,0,0,8704,16,3502668272
9387,466951490,1518,466953008,0,0,1,1536,11,6682574029
9388,466981430,75008,467056438,0,0,0,16896,11,8200341642
9389,466999330,62334,467061664,2,0,0,5632,4,9330387473
9390,467021150,145869,467167019,9,0,0,61440,18,5454476198
9391,467053381,70197,467123578,6,0,0,11264,12,8035597902
9392,467058940,113740,467172680,8,0,0,4608,12,1723122197
9393,467067330,101108,467168438,2,0,0,4608,4,568505309
9394,467084089,87172,467171261,7,0,0,9216,8,5200813450
9395,467142240,113987,467256227,0,0,0,39424,11,7772927104
9396,467170100,10278,467180378,6,0,1,8192,12,4812661748
9397,467198220,101837,467300057,8,0,0,10752,12,6770198434
9398,467221650,52988,467274638,8,0,0,5120,12,1492770650
9399,467231240,11791,467243031,7,0,1,19456,8,9399375357
9400,467232100,138534,467370634,9,0,0,13824,18,7901958344
9401,467321051,71312,467392363,6,0,0,14848,12,854414992
9402,467322940,3422,467326362,0,0,1,3584,11,2620176417
9403,467351831,121826,467473657,6,0,0,48640,12,9028526440
9404,467364440,120290,467484730,0,0,0,12288,11,6786838878
9405,467365090,173445,467538535,4,0,0,53760,16,7773825175
9406,467371190,52364,467423554,0,0,0,3072,11,9367231687
9407,467418510,148329,467566839,9,0,0,46080,18,7671612410
9408,467486669,128918,467615587,7,0,0,27136,8,3726409549
9409,467669969,4162,467674131,8,0,1,11264,12,8003658396
9410,467732600,84512,467817112,0,0,0,12800,11,3775757444
9411,467769210,102596,467871806,5,0,0,36864,19,10638650359
9412,467770210,3898,467774108,0,0,1,4096,11,9272690214
9413,467861189,12144,467873333,3,0,1,1536,2,7772823665
9414,467864500,11428,467875928,1,0,1,10240,6,4881975845
9415,467919640,102284,468021924,4,0,0,35840,16,3972150991
9416,467968600,36346,468004946,7,0,1,64000,8,94502654
9417,468034130,4374,468038504,0,0,1,4608,11,7095176770
9418,468034880,148063,468182943,2,0,0,45056,4,2846896344
9419,468036990,191655,468228645,9,0,0,22528,18,8660250580
9420,468122730,95559,468218289,4,0,0,8704,16,4811106304
9421,468139829,105987,468245816,7,0,0,1024,8,8050445342
9422,468152909,566,468153475,8,0,1,512,12,10226628596
9423,468200220,85105,468285325,9,0,0,21504,18,3636728648
9424,468207870,120481,468328351,5,0,0,50688,19,9714237872
9425,468247400,108635,468356035,5,0,0,25600,19,5668640045
9426,468276560,137231,468413791,2,0,0,11264,4,8708991665
9427,468281760,95473,468377233,0,0,0,18432,11,3111638982
9428,468356440,120213,468476653,2,0,0,45056,4,1241417996
9429,468412649,113708,468526357,7,0,0,49664,8,2221784489
9430,468543130,64208,468607338,3,0,0,6656,2,2165847979
9431,468585840,73004,468658844,3,0,0,15360,2,8661925515
9432,468603859,3494,468607353,8,0,1,3072,12,7929759054
9433,468862900,97448,468960348,0,0,0,19968,11,5160072151
9434,468881811,135801,469017612,6,0,0,46592,12,7864151493
9435,468958581,95451,469054032,6,0,0,2560,12,2367254272
9436,469005620,106204,469111824,9,0,0,19456,18,5705061024
9437,469116169,132774,469248943,8,0,1,215040,12,5362507996
9438,469223000,32664,469255664,4,0,1,32256,16,5880676935
9439,469229100,90948,469320048,1,0,0,10752,6,4308493232
9440,469252870,214482,469467352,0,0,0,9728,11,4734235673
9441,469256301,235609,469491910,6,0,0,64000,12,3070236924
9442,469319200,3968,469323168,5,0,1,9216,19,6283275684
9443,469333469,89480,469422949,1,0,0,24064,6,5327169956
9444,469345720,155820,469501540,5,0,0,13824,19,4620783590
9445,469439680,3422,469443102,5,0,1,3584,19,4845391102
9446,469446210,91592,469537802,2,0,0,15872,4,7488698656
9447,469449630,170582,469620212,3,0,0,58368,2,3308254997
9448,469456460,207138,469663598,0,0,0,98816,11,1680248166
9449,469510880,74409,469585289,9,0,0,2048,18,7328468454
9450,469511850,108533,469620383,3,0,0,512,2,1455178563
9451,469579570,123992,469703562,8,0,0,45056,12,6347229565
9452,469598470,67015,469665485,2,0,0,6144,4,968202990
9453,469632580,106976,469739556,8,0,0,17408,12,2864534137
9454,469726900,86204,469813104,3,0,0,13312,2,5910970400
9455,469760630,1042,469761672,6,0,1,1024,12,5960459511
9456,469775540,44060,469819600,3,0,0,1024,2,10650414202
9457,469809890,58954,469868844,2,0,0,4096,4,8226206836
9458,469812200,228809,470041009,2,0,0,109568,4,9191224245
9459,469832201,175393,470007594,6,0,0,105472,12,3587444228
9460,469846550,1042,469847592,5,0,1,1024,19,8703070112
9461,469884980,160747,470045727,3,0,0,9728,2,9611512070
9462,469912899,4850,469917749,3,0,1,5120,2,4712097401
9463,469915780,126968,470042748,4,0,0,5632,16,10064077012
9464,469969730,133325,470103055,2,0,0,20992,4,5455310313
9465,469976020,202746,470178766,4,0,0,31232,16,834168938
9466,469983960,138277,470122237,4,0,0,24576,16,3861512844
9467,470006130,42502,470048632,6,0,1,3072,12,3813784215
9468,470062620,106615,470169235,3,0,0,16384,2,7999842730
9469,470079830,197842,470277672,0,0,0,68096,11,6630422394
9470,470097310,112154,470209464,8,0,0,512,12,2804882524
9471,470244160,95756,470339916,8,0,0,19456,12,10625826108
9472,470318260,48980,470367240,9,0,0,2048,18,5440268547
9473,470360880,102752,470463632,9,0,0,37376,18,1902889590
9474,470376740,119256,470495996,8,0,0,27648,12,3342948448
9475,470379660,104624,470484284,8,0,0,43520,12,4074583292
9476,470390400,55748,470446148,8,0,0,4096,12,711384772
9477,470454840,52688,470507528,2,0,0,512,4,4660119313
9478,470456210,116694,470572904,2,0,0,53760,4,4452350925
9479,470498590,89488,470588078,2,0,0,6656,4,8234891286
9480,470656190,98228,470754418,4,0,0,22528,16,2181003640
9481,470699921,66461,470766382,6,0,0,4096,12,7705070786
9482,470700800,98690,470799490,4,0,0,22016,16,7737043725
9483,470792970,57184,470850154,8,0,0,2560,12,4612013632
9484,470805589,5802,470811391,3,0,1,6144,2,4031119427
9485,470810170,74360,470884530,4,0,0,9728,16,6574084195
9486,470893429,1042,470894471,2,0,1,1024,4,6855704258
9487,470910060,42424,470952484,7,0,1,69120,8,6097214228
9488,470972369,192720,471165089,1,0,0,164352,6,6581176312
9489,471011759,10499,471022258,8,0,1,16896,12,9188375597
9490,471026430,294590,471321020,2,0,0,17408,4,1426142276
9491,471032309,133263,471165572,7,0,0,1536,8,6879563691
9492,471057609,151256,471208865,7,0,0,18432,8,2258096409
9493,471147729,22772,471170501,3,0,1,12800,2,9344945059
9494,471173260,2470,471175730,6,0,1,2560,12,8536725365
9495,471298620,100724,471399344,8,0,0,30720,12,10461868019
9496,471394209,104447,471498656,1,0,0,26112,6,10382763992
9497,471438620,114690,471553310,9,0,0,12800,18,3658973924
9498,471450410,1994,471452404,4,0,1,2048,16,9766551141
9499,471465729,65900,471531629,7,0,0,7168,8,6099124175
9500,471646530,95000,471741530,8,0,0,22016,12,1352821506
9501,471711449,3422,471714871,3,0,1,3584,2,4982645720
9502,471719181,89300,471808481,6,0,0,18432,12,5529613795
9503,471723420,54524,471777944,3,0,0,5120,2,3993439324
9504,471795170,55748,471850918,2,0,0,4096,4,6270630037
9505,471834119,13253,471847372,8,0,1,25600,12,7677673084
9506,471838459,9681,471848140,2,0,1,11776,4,2046487745
9507,471885679,201744,472087423,7,0,0,17408,8,2481319632
9508,471976931,86672,472063603,6,0,0,14848,12,10032918456
9509,472054750,3898,472058648,1,0,1,4096,6,9986016494
9510,472061200,15648,472076848,4,0,1,25600,16,9536159839
9511,472109949,76052,472186001,1,0,0,10240,6,9397977408
9512,472125980,121341,472247321,2,0,0,50176,4,9990521850
9513,472288860,64676,472353536,2,0,0,8192,4,9690191577
9514,472328729,2870,472331599,3,0,1,8704,2,7151945423
9515,472360649,121883,472482532,7,0,0,52736,8,1211533672
9516,472372110,3645,472375755,5,0,1,10240,19,5510650242
9517,472373790,139522,472513312,3,0,0,32768,2,387115843
9518,472639640,50672,472690312,0,0,0,2560,11,6109407638
9519,472715729,79172,472794901,7,0,0,20480,8,7026370089
9520,472765120,47235,472812355,0,0,0,1024,11,3960542282
9521,472784570,99008,472883578,2,0,0,25088,4,6770101629
9522,472858779,62695,472921474,1,0,0,1024,6,7514285531
9523,472898229,22433,472920662,8,0,1,36864,12,6924554142
9524,473009291,52364,473061655,6,0,0,3072,12,4242720167
9525,473011120,73293,473084413,4,0,0,1024,16,9461746605
9526,473023560,115232,473138792,2,0,0,78336,4,1595034863
9527,473045600,161694,473207294,9,0,0,70144,18,6735178249
9528,473165410,102412,473267822,0,0,0,24576,11,4529890005
9529,473174590,2470,473177060,5,0,1,2560,19,3923213899
9530,473193850,65800,473259650,2,0,0,3072,4,4365205025
9531,473229280,62672,473291952,3,0,0,6656,2,5046792285
9532,473247180,20657,473267837,1,0,1,27136,6,1592767275
9533,473352920,52364,473405284,8,0,0,3072,12,8307560291
9534,473357671,45596,473403267,6,0,0,1024,12,4181736879
9535,473388550,65300,473453850,4,0,0,10240,16,1592979417
9536,473391281,98707,473489988,6,0,0,11776,12,6773147344
9537,473391570,1994,473393564,6,0,1,2048,12,8546503150
9538,473409300,170913,473580213,2,0,0,77824,4,10161592537
9539,473464060,92396,473556456,0,0,0,23552,11,4847199106
9540,473489639,66832,473556471,8,0,1,101376,12,9748568505
9541,473508390,48096,473556486,1,0,1,5120,6,827600604
9542,473613961,57440,473671401,6,0,0,4608,12,7952094796
9543,473643370,98228,473741598,3,0,0,22528,2,9972127100
9544,473712710,1518,473714228,6,0,1,1536,12,62105941
9545,473718830,82088,473800918,8,0,0,19968,12,6632751020
9546,473728100,102752,473830852,1,0,0,37376,6,1980333077
9547,473805869,2470,473808339,3,0,1,2560,2,1517694906
9548,473826499,68577,473895076,7,0,0,8192,8,4220094389
9549,473837740,82688,473920428,3,0,0,16896,2,5228598087
9550,473843229,82820,473926049,1,0,0,12288,6,8516506752
9551,473888290,89729,473978019,8,0,0,4096,12,7024064802
9552,473915459,99977,474015436,1,0,0,512,6,9758802310
9553,473915640,99625,474015265,1,0,0,16384,6,5395847293
9554,473928690,95000,474023690,3,0,0,22016,2,9888933295
9555,473978010,48981,474026991,4,0,0,2048,16,394375989
9556,474039499,5712,474045211,8,0,1,14336,12,3331223612
9557,474062080,69440,474131520,0,0,0,8704,11,5153619566
9558,474090200,43904,474134104,0,0,0,512,11,6531813573
9559,474140820,3645,474144465,4,0,1,10240,16,468528578
9560,474165510,184326,474349836,3,0,0,3072,2,892015063
9561,474237919,23895,474261814,8,0,1,43008,12,9423173766
9562,474289390,82136,474371526,3,0,0,2560,2,8081798904
9563,474366661,81773,474448434,6,0,0,10752,12,6831858056
9564,474372940,117326,474490266,1,0,0,22016,6,3591244909
9565,474477250,55748,474532998,2,0,0,4096,4,1210689734
9566,474491599,89948,474581547,1,0,0,25600,6,6556365317
9567,474527530,74384,474601914,0,0,0,14848,11,7366389394
9568,474598939,72251,474671190,7,0,0,8192,8,9879202281
9569,474692570,82976,474775546,8,0,0,12800,12,5117704582
9570,474708460,76052,474784512,0,0,0,10240,11,7030827235
9571,474715170,129394,474844564,8,0,0,16384,12,6927223932
9572,474751310,2946,474754256,6,0,1,3072,12,2883076220
9573,474819210,95453,474914663,8,0,0,4608,12,8021447563
9574,474892400,83444,474975844,1,0,0,14336,6,9579710424
9575,474942890,85420,475028310,1,0,1,142848,6,6724271861
9576,475002360,106267,475108627,9,0,0,14336,18,9891153553
9577,475070950,10241,475081191,9,0,1,16384,18,3709145964
9578,475093220,3898,475097118,9,0,1,4096,18,6648788909
9579,475188660,49448,475238108,0,0,0,3584,11,9417908920
9580,475192009,7706,475199715,3,0,1,8192,2,7152297913
9581,475203260,102128,475305388,8,0,0,35328,12,6143627907
9582,475337500,60824,475398324,1,0,0,5632,6,2102858339
9583,475419640,83780,475503420,8,0,0,20480,12,9291764235
9584,475429920,82820,475512740,8,0,0,12288,12,3683181187
9585,475479020,54056,475533076,0,0,0,3584,11,9865971438
9586,475500240,79692,475579932,2,0,0,11776,4,2663397276
9587,475535839,62072,475597911,7,0,0,9728,8,8175559441
9588,475555690,98408,475654098,8,0,0,28160,12,3064653255
9589,475627130,100568,475727698,8,0,0,30208,12,3475799208
9590,475640090,123404,475763494,2,0,0,31744,4,4070692994
9591,475713909,125131,475839040,7,0,0,51712,8,5577815664
9592,475722190,126318,475848508,3,0,0,7168,2,2975704741
9593,475729250,172676,475901926,0,0,0,25088,11,401957038
9594,475850020,127896,475977916,2,0,0,41472,4,8759199212
9595,475876940,103502,475980442,8,0,0,2048,12,2950613731
9596,475883379,43133,475926512,8,0,1,73728,12,261719552
9597,475883391,50689,475934080,6,0,0,2560,12,8005936787
9598,475906170,73633,475979803,8,0,0,6144,12,3669840553
9599,475950160,96631,476046791,9,0,0,3072,18,56125887
9600,475962689,182722,476145411,7,0,0,3584,8,8524896791
9601,476077510,77741,476155251,8,0,0,5632,12,4528515144
9602,476104180,67904,476172084,1,0,0,8704,6,8689328506
9603,476123080,53237,476176317,2,0,0,3072,4,2526647810
9604,476126470,89636,476216106,2,0,0,24576,4,9305771974
9605,476139260,113674,476252934,2,0,0,46080,4,8473081460
9606,476262400,108992,476371392,1,0,0,57856,6,9601925328
9607,476345799,85160,476430959,7,0,0,19968,8,2392180135
9608,476374370,81279,476455649,1,0,0,4096,6,6463080119
9609,476445620,121672,476567292,8,0,0,98816,12,10442917911
9610,476466130,101653,476567783,8,0,0,1536,12,5580377008
9611,476479601,109223,476588824,6,0,0,1536,12,2470968097
9612,476491291,146049,476637340,6,0,0,29696,12,1524239187
9613,476501390,207128,476708518,8,0,0,35328,12,8886040632
9614,476557310,101458,476658768,2,0,0,25600,4,8309460673
9615,476626609,13600,476640209,8,0,1,23040,12,3119199505
9616,476664969,140005,476804974,1,0,0,8704,6,5212947952
9617,476724409,70376,476794785,1,0,0,11776,6,4206817646
9618,476787771,60824,476848595,6,0,0,5632,12,4845356961
9619,476873880,101348,476975228,8,0,0,32768,12,1758843423
9620,476886550,166384,477052934,9,0,0,54784,18,1144498404
9621,476902760,116478,477019238,2,0,0,9728,4,1149870426
9622,476914860,99216,477014076,4,0,0,6656,16,4207932154
9623,476980410,50186,477030596,4,0,0,512,16,10150636960
9624,477011080,75778,477086858,2,0,0,2560,4,3202088163
9625,477060359,214549,477274908,2,0,1,347648,4,4569660500
9626,477103929,213932,477317861,7,0,0,8704,8,6553162577
9627,477191899,270688,477462587,7,0,0,18432,8,3106602941
9628,477198999,76255,477275254,2,0,1,512,4,3648209940
9629,477200590,313375,477513965,4,0,0,34816,16,6392465788
9630,477281960,10499,477292459,6,0,1,16896,12,8297085980
9631,477312030,78764,477390794,2,0,0,5632,4,6900973592
9632,477366080,233214,477599294,2,0,0,19968,4,8989032027
9633,477387381,247830,477635211,6,0,0,83456,12,7584763091
9634,477391609,60824,477452433,1,0,0,5632,6,10278394625
9635,477398250,105092,477503342,2,0,0,45056,4,10206558995
9636,477398760,316770,477715530,9,0,0,90624,18,9345245807
9637,477435720,126315,477562035,3,0,0,4608,2,7140041777
9638,477458850,118579,477577429,1,0,1,186880,6,3563391547
9639,477487330,91072,477578402,1,0,1,12800,6,1334249328
9640,477496860,86688,477583548,9,0,1,8192,18,256765361
9641,477499320,288823,477788143,9,0,0,23040,18,7554650481
9642,477500900,147679,477648579,0,0,0,4096,11,2926563566
9643,477525761,195556,477721317,6,0,0,18944,12,9330069488
9644,477529560,60197,477589757,5,0,1,29696,19,5774846521
9645,477634119,14942,477649061,3,0,1,23552,2,1030245208
9646,477643029,149574,477792603,7,0,0,11264,8,5102903726
9647,477723499,170937,477894436,1,0,0,14336,6,4956954930
9648,477753290,96697,477849987,0,0,0,7168,11,8245644205
9649,477806620,188628,477995248,0,0,0,10240,11,443188046
9650,477807160,60618,477867778,4,0,0,3584,16,6973359237
9651,477854520,113392,477967912,4,0,0,11264,16,5046701629
9652,477935009,155447,478090456,1,0,0,23040,6,8998589362
9653,477941930,87272,478029202,0,0,0,4608,11,5834605897
9654,478027039,65304,478092343,1,0,0,6144,6,3409360701
9655,478029770,69284,478099054,8,0,0,8192,12,8776383393
9656,478047009,146455,478193464,1,0,0,61440,6,6708615506
9657,478114370,134564,478248934,8,0,0,25600,12,7438203816
9658,478158960,90457,478249417,4,0,0,1536,16,8113382362
9659,478233760,67616,478301376,4,0,0,12800,16,3279028177
9660,478291009,74315,478365324,1,0,0,8704,6,7540632763
9661,478561630,66368,478627998,4,0,0,8704,16,3776692476
9662,478576740,89144,478665884,3,0,0,17920,2,5911628694
9663,478597899,48980,478646879,1,0,0,2048,6,9801551179
9664,478623100,4913,478628013,9,0,1,2560,18,3653619905
9665,478630920,52364,478683284,0,0,0,3072,11,2646180712
9666,478651480,117923,478769403,4,0,0,62976,16,9536869367
9667,478653371,69620,478722991,6,0,0,14336,12,7471500206
9668,478657740,8159,478665899,0,0,1,6144,11,4134144260
9669,478712311,125587,478837898,6,0,0,33280,12,3064319471
9670,478773020,165234,478938254,3,0,0,62976,2,5936843468
9671,478857339,136805,478994144,1,0,0,18432,6,2510830591
9672,478895779,124267,479020046,1,0,0,31744,6,7950165034
9673,478929230,121974,479051204,3,0,0,52224,2,1321155944
9674,479015960,153527,479169487,2,0,0,29184,4,6488307432
9675,479020060,106047,479126107,2,0,0,48128,4,639206621
9676,479213429,43904,479257333,1,0,0,512,6,4177702923
9677,479248301,100724,479349025,6,0,0,30720,12,779440101
9678,479248950,115378,479364328,8,0,0,50176,12,8427307847
9679,479299800,127981,479427781,4,0,0,39936,16,6586176696
9680,479372590,1518,479374108,4,0,1,1536,16,2632716368
9681,479374490,74350,479448840,1,0,1,121344,6,6535039305
9682,479511310,151232,479662542,8,0,0,25088,12,2836482976
9683,479515440,73760,479589200,2,0,0,12800,4,7079792523
9684,479535899,4850,479540749,3,0,1,5120,2,9069545941
9685,479675500,48980,479724480,9,0,0,2048,18,2110399026
9686,479732969,66212,479799181,1,0,0,8192,6,3379742173
9687,479806890,62384,479869274,9,0,0,10752,18,7344975090
9688,479894480,144708,480039188,1,0,1,235008,6,9317939479
9689,479958459,84595,480043054,3,0,1,6144,2,9132926243
9690,480039560,55562,480095122,1,0,1,94720,6,1815405170
9691,480125270,184963,480310233,2,0,0,23040,4,9185392512
9692,480168690,70638,480239328,3,0,0,3072,2,4280172821
9693,480205490,96575,480302065,2,0,0,6144,4,8427306951
9694,480208660,208024,480416684,8,0,0,7680,12,6850135060
9695,480231030,64208,480295238,0,0,0,6656,11,5957974351
9696,480250609,5454,480256063,8,0,1,13824,12,9295944749
9697,480258440,155889,480414329,9,0,0,66560,18,10412604148
9698,480271389,208888,480480277,1,0,0,16896,6,2818763717
9699,480363601,135066,480498667,6,0,0,512,12,10618867647
9700,480365680,93045,480458725,4,0,0,6656,16,3332012400
9701,480410820,9754,480420574,9,0,1,4096,18,6851240883
9702,480444180,135805,480579985,9,0,0,39424,18,10728868792
9703,480530860,106187,480637047,7,0,1,176640,8,8196240118
9704,480559959,278554,480838513,1,0,0,25088,6,9793979197
9705,480730289,54056,480784345,1,0,0,3584,6,3657285441
9706,480779790,100100,480879890,2,0,0,28672,4,3356415880
9707,480812110,108680,480920790,0,0,0,56832,11,10000910875
9708,480867550,56824,480924374,9,0,0,1024,18,9938376067
9709,480908510,124540,481033050,3,0,0,68608,2,3358852049
9710,480994320,125826,481120146,3,0,0,54784,2,4559595479
9711,481055160,117990,481173150,8,0,0,9728,12,8199946425
9712,481075230,2946,481078176,6,0,1,3072,12,9419288873
9713,481149460,81464,481230924,8,0,0,17920,12,5354890609
9714,481161800,109138,481270938,4,0,0,27136,16,7347343419
9715,481173390,77016,481250406,2,0,0,5120,4,72069344
9716,481188130,163206,481351336,8,0,0,22528,12,7015557075
9717,481308949,1518,481310467,3,0,1,1536,2,7784633631
9718,481425450,83288,481508738,9,0,0,13824,18,7175242213
9719,481436020,64232,481500252,8,0,0,11776,12,4028504082
9720,481466810,131727,481598537,8,0,0,21504,12,951555300
9721,481472230,149548,481621778,9,0,0,29696,18,1498047157
9722,481488750,103220,481591970,3,0,0,38912,2,8143672838
9723,481533149,145449,481678598,1,0,0,23552,6,2502173880
9724,481614630,126062,481740692,3,0,0,24576,2,6135564227
9725,481697540,24670,481722210,7,0,1,44544,8,9364574562
9726,481822089,4850,481826939,2,0,1,5120,4,2002236990
9727,481857700,5196,481862896,6,0,1,13312,12,10162255541
9728,481931290,47288,481978578,9,0,0,1536,18,9399693477
9729,481941100,118952,482060052,3,0,0,40960,2,7100207000
9730,481968130,45596,482013726,9,0,0,1024,18,3420149586
9731,482048230,68030,482116260,4,0,0,5632,16,3724661207
9732,482103940,14287,482118227,1,0,1,27648,6,1568082807
9733,482158210,129171,482287381,4,0,0,5632,16,10653206635
9734,482205710,45596,482251306,9,0,0,1024,18,2260136029
9735,482392340,110708,482503048,0,0,0,63488,11,1933028555
9736,482399171,104984,482504155,6,0,0,3584,12,987721184
9737,482432720,139658,482572378,8,0,0,68096,12,10495166492
9738,482504760,68872,482573632,0,0,0,512,11,6621409072
9739,482578160,73472,482651632,9,0,0,16896,18,8130333068
9740,482604420,95648,482700068,3,0,0,29184,2,9219676127
9741,482703370,82820,482786190,9,0,0,12288,18,10415658334
9742,483066490,84824,483151314,3,0,0,13824,2,4635872389
9743,483067310,566,483067876,0,0,1,512,11,2858561658
9744,483075590,76900,483152490,0,0,0,2560,11,10536544664
9745,483077820,107730,483185550,0,0,0,10240,11,2516863619
9746,483120340,45596,483165936,2,0,0,1024,4,6386217725
9747,483201480,52364,483253844,2,0,0,3072,4,3955244112
9748,483210970,61448,483272418,4,0,0,7680,16,7970026521
9749,483297499,48980,483346479,1,0,0,2048,6,7429532587
9750,483304349,566,483304915,2,0,1,512,4,7897673965
9751,483379670,12995,483392665,7,0,1,25088,8,333143540
9752,483458730,1042,483459772,5,0,1,1024,19,5741725888
9753,483536850,58688,483595538,3,0,0,8704,2,6886276853
9754,483568830,21141,483589971,1,0,1,34304,6,7463015387
9755,483590649,149174,483739823,1,0,0,64512,6,3159724982
9756,483728969,101214,483830183,1,0,0,16896,6,8991175008
9757,483964080,105404,484069484,5,0,0,46080,19,5726493838
9758,484009820,101972,484111792,4,0,0,34816,16,10336580607
9759,484012720,78730,484091450,9,0,0,6144,18,7839330202
9760,484063970,93894,484157864,4,0,0,20480,16,636410566
9761,484158240,52988,484211228,9,0,0,5120,18,64137660
9762,484372130,70064,484442194,4,0,0,10752,16,7971952088
9763,484456960,120068,484577028,9,0,0,94208,18,8640842824
9764,484625501,80372,484705873,6,0,0,14336,12,6706206871
9765,484668900,60380,484729280,9,0,0,9216,18,5188787670
9766,484672920,65900,484738820,2,0,0,7168,4,2284723568
9767,484703970,74816,484778786,8,0,0,6144,12,5627674706
9768,484747130,65166,484812296,0,0,0,4096,11,5925467278
9769,484821540,96980,484918520,3,0,0,18432,2,1728101788
9770,484890470,52364,484942834,3,0,0,3072,2,950985824
9771,484969180,6229,484975409,0,0,1,15360,11,9844827713
9772,484973999,3036,484977035,3,0,1,2560,2,2238025543
9773,484976410,47867,485024277,2,0,0,512,4,7618775654
9774,485029890,3904,485033794,0,0,1,10752,11,175742605
9775,485038500,119687,485158187,3,0,0,23552,2,7651138496
9776,485188980,61916,485250896,2,0,0,9216,4,10637882256
9777,485213460,71132,485284592,3,0,0,9216,2,8365545675
9778,485226610,43904,485270514,0,0,0,512,11,3681661624
9779,485278210,54056,485332266,8,0,0,3584,12,435016494
9780,485315740,43904,485359644,0,0,0,512,11,2446014424
9781,485374610,96980,485471590,3,0,0,18432,2,2196774429
9782,485489590,5802,485495392,4,0,1,6144,16,2712556629
9783,485509570,3422,485512992,5,0,1,3584,19,10308680698
9784,485522420,123662,485646082,2,0,0,34304,4,9096029198
9785,485537160,119011,485656171,3,0,0,2048,2,1835086665
9786,485733561,106496,485840057,6,0,0,49664,12,7389312477
9787,485833790,66015,485899805,8,0,0,7168,12,10474628465
9788,485897650,101935,485999585,5,0,0,27648,19,4680974248
9789,485913059,1994,485915053,3,0,1,2048,2,4699511157
9790,485935109,134562,486069671,1,0,0,29696,6,3932465334
9791,485978680,78949,486057629,4,0,0,9216,16,3656400016
9792,485990929,11791,486002720,3,0,1,19456,2,8756350796
9793,486006981,65201,486072182,6,0,0,8192,12,5784513306
9794,486031849,48388,486080237,1,0,0,512,6,2885694852
9795,486053220,136023,486189243,8,0,0,71168,12,2341800272
9796,486055790,156756,486212546,0,0,0,40448,11,6167894722
9797,486086099,566,486086665,3,0,1,512,2,2229426581
9798,486251160,111176,486362336,5,0,0,65024,19,8396383714
9799,486285760,35312,486321072,7,0,1,61952,8,6859519352
9800,486401960,30749,486432709,7,0,1,49664,8,8191960928
9801,486414860,148157,486563017,0,0,0,26624,11,4251827336
9802,486424381,52364,486476745,6,0,0,3072,12,8432939251
9803,486555669,15063,486570732,2,0,1,8192,4,9920191581
9804,486559850,119923,486679773,4,0,0,59904,16,1587719708
9805,486591270,566,486591836,9,0,1,512,18,9611429099
9806,486712001,80684,486792685,6,0,0,15360,12,118471352
9807,486723631,100256,486823887,6,0,0,29184,12,4949129784
9808,486905320,94664,486999984,5,0,0,15872,19,8756293981
9809,486959069,59132,487018201,1,0,0,5120,6,5227924036
9810,487100849,86984,487187833,1,0,0,15872,6,4374076068
9811,487108719,150574,487259293,1,0,0,89088,6,5091684735
9812,487114620,180763,487295383,4,0,0,14848,16,5203279280
9813,487120130,149170,487269300,0,0,0,32768,11,1701047915
9814,487168720,185643,487354363,9,0,0,47104,18,9901862255
9815,487240610,120632,487361242,5,0,0,22528,19,1406088390
9816,487301150,139343,487440493,4,0,0,96768,16,6135296104
9817,487320451,89013,487409464,6,0,0,4096,12,1664441717
9818,487348950,138484,487487434,5,0,0,16896,19,197658145
9819,487357210,17044,487374254,4,0,1,25088,16,6950871369
9820,487406540,162288,487568828,4,0,0,111616,16,7288145607
9821,487434110,180172,487614282,5,0,0,2048,19,3901490023
9822,487453010,186944,487639954,9,0,0,1024,18,2993164591
9823,487464129,140215,487604344,1,0,0,49664,6,5864727493
9824,487483020,187264,487670284,9,0,0,8704,18,6703667000
9825,487489141,82050,487571191,6,0,0,7680,12,1661276230
9826,487516040,147098,487663138,3,0,0,34816,2,1579757316
9827,487531220,1042,487532262,9,0,1,1024,18,7513360087
9828,487535720,91474,487627194,5,0,0,4096,19,2646516322
9829,487628879,4162,487633041,2,0,1,11264,4,4263318914
9830,487640350,83574,487723924,3,0,0,4096,2,2664628667
9831,487714550,115106,487829656,5,0,0,35328,19,4729369591
9832,487730600,108275,487838875,2,0,0,30208,4,6089097558
9833,487775881,77744,487853625,6,0,0,10752,12,9628495582
9834,487785189,6278,487791467,8,0,1,6656,12,1582179847
9835,487862531,114307,487976838,6,0,0,8192,12,9760240135
9836,487937399,7230,487944629,2,0,1,7680,4,7651430936
9837,487959370,101348,488060718,2,0,0,32768,4,1793064832
9838,487959499,124013,488083512,1,0,0,5632,6,6682613369
9839,487999250,73760,488073010,8,0,0,12800,12,7066238411
9840,488044919,108431,488153350,7,0,0,32256,8,9477570845
9841,488106609,123553,488230162,7,0,0,19968,8,8059069550
9842,488129579,59132,488188711,1,0,0,5120,6,2908748483
9843,488130460,153846,488284306,2,0,0,36352,4,8368887417
9844,488144360,127898,488272258,8,0,0,19968,12,4121557498
9845,488174810,139466,488314276,4,0,0,30720,16,3991586067
9846,488238960,108730,488347690,5,0,0,8192,19,9910999311
9847,488269220,99746,488368966,2,0,0,27648,4,9319128158
9848,488430110,3422,488433532,6,0,1,3584,12,5351889494
9849,488541249,58220,488599469,1,0,0,7168,6,8088498103
9850,488575900,45596,488621496,0,0,0,1024,11,8651073061
9851,488660100,3387,488663487,5,0,1,9728,19,5682220367
9852,488725641,98228,488823869,6,0,0,22528,12,10712315311
9853,488758660,101036,488859696,8,0,0,31744,12,6020597208
9854,488771481,77168,488848649,6,0,0,18944,12,2521707372
9855,488820241,122752,488942993,6,0,0,91136,12,368648455
9856,488880270,6488,488886758,4,0,1,15872,16,9801713022
9857,488888861,124536,489013397,6,0,0,22528,12,4795134046
9858,489045001,111644,489156645,6,0,0,66560,12,10212063251
9859,489167970,109148,489277118,9,0,0,58368,18,7324047692
9860,489227300,128802,489356102,3,0,0,17920,2,4182262684
9861,489254799,47288,489302087,1,0,0,1536,6,4218678823
9862,489301170,115340,489416510,5,0,0,12288,19,88988629
9863,489340651,103688,489444339,6,0,0,40448,12,5713865019
9864,489429219,139712,489568931,1,0,0,105472,6,4143891218
9865,489443320,4433,489447753,9,0,1,3584,18,510511866
9866,489457640,2470,489460110,0,0,1,2560,11,339593668
9867,489547859,76812,489624671,1,0,0,4096,6,2137001270
9868,489554119,15395,489569514,2,0,1,512,4,8204060225
9869,489617860,47288,489665148,5,0,0,1536,19,4919213361
9870,489661330,103532,489764862,2,0,0,39936,4,1773436413
9871,489924060,4679,489928739,9,0,1,12288,18,2751483704
9872,490023659,105248,490128907,7,0,0,45568,8,1418251089
9873,490034750,47288,490082038,4,0,0,1536,16,8061004025
9874,490115409,143821,490259230,1,0,0,34304,6,2253974539
9875,490132289,12995,490145284,8,0,1,25088,12,7780903675
9876,490138139,8451,490146590,8,0,1,2048,12,4917098778
9877,490145790,102973,490248763,9,0,0,17920,18,4086974270
9878,490180329,10241,490190570,8,0,1,16384,12,6371337952
9879,490276459,1518,490277977,2,0,1,1536,4,7804215710
9880,490369171,99008,490468179,6,0,0,25088,12,5239729590
9881,490402559,85054,490487613,7,0,0,2048,8,6722719178
9882,490575260,16613,490591873,4,0,1,32256,16,8138815855
9883,490608970,218743,490827713,5,0,0,76288,19,2234067600
9884,490650790,4374,490655164,6,0,1,4608,12,1143700415
9885,490663269,65300,490728569,7,0,0,10240,8,5988477553
9886,490675990,3898,490679888,5,0,1,4096,19,10360630807
9887,490981110,99788,491080898,2,0,0,27648,4,5267157004
9888,491027800,54205,491082005,5,0,0,3584,19,1348279714
9889,491028050,93348,491121398,8,0,0,2048,12,6667920524
9890,491154530,69308,491223838,8,0,0,13312,12,6615714190
9891,491165810,566,491166376,0,0,1,512,11,5575070005
9892,491170030,142837,491312867,2,0,0,4096,4,4271873303
9893,491285709,1518,491287227,3,0,1,1536,2,6094816503
9894,491298070,106340,491404410,3,0,0,49152,2,7582385458
9895,491298660,48980,491347640,3,0,0,2048,2,3468744116
9896,491384309,20116,491404425,8,0,1,14848,12,6076931692
9897,491554180,78368,491632548,0,0,0,12800,11,10586544262
9898,491581170,143928,491725098,8,0,0,88576,12,8124378228
9899,491592880,88582,491681462,4,0,0,4096,16,5663350747
9900,491609880,208004,491817884,2,0,0,67584,4,8130409932
9901,491620140,136736,491756876,2,0,0,28672,4,10018479298
9902,491645680,180495,491826175,3,0,0,27136,2,6573549392
9903,491694421,96809,491791230,6,0,0,26112,12,1223956105
9904,491695781,62826,491758607,6,0,0,5632,12,9871007541
9905,491702110,158884,491860994,8,0,0,16384,12,6571194852
9906,491725720,1518,491727238,1,0,1,1536,6,8636976686
9907,491807200,64732,491871932,5,0,0,3584,19,1286336673
9908,491918770,59132,491977902,0,0,0,5120,11,3935630804
9909,491932450,147962,492080412,8,0,0,108544,12,4407934586
9910,491964100,118511,492082611,9,0,0,7168,18,934202028
9911,492184510,106808,492291318,4,0,0,50688,16,7665481871
9912,492264080,85604,492349684,4,0,0,16384,16,4415292229
9913,492286540,125994,492412534,8,0,0,14848,12,10612111935
9914,492372990,55748,492428738,0,0,0,4096,11,4236022702
9915,492393820,5196,492399016,4,0,1,13312,16,10571207563
9916,492484590,71132,492555722,0,0,0,9216,11,4242674685
9917,492496640,130961,492627601,0,0,0,44032,11,6117384529
9918,492567539,3387,492570926,8,0,1,9728,12,8315598159
9919,492620860,8727,492629587,1,0,1,2048,6,9317857705
9920,492663550,80996,492744546,5,0,0,16384,19,6960822259
9921,492775849,104468,492880317,7,0,0,43008,8,7729575465
9922,492818450,98696,492917146,5,0,0,24064,19,9645291160
9923,492870920,68521,492939441,0,0,0,5120,11,5873058944
9924,492879230,93295,492972525,0,0,0,17920,11,1688155277
9925,493073390,98072,493171462,9,0,0,22016,18,830791676
9926,493114320,59132,493173452,9,0,0,5120,18,8678406736
9927,493147220,102908,493250128,0,0,0,37888,11,470502385
9928,493169040,149734,493318774,5,0,0,60416,19,3719651347
9929,493273429,3422,493276851,2,0,1,3584,4,2138677481
9930,493303260,103918,493407178,8,0,0,25600,12,8005905123
9931,493325480,117452,493442932,5,0,0,10752,19,4188327185
9932,493351860,87347,493439207,5,0,0,512,19,2087856087
9933,493361079,4420,493365499,3,0,1,11776,2,8183236547
9934,493399020,107254,493506274,0,0,0,15872,11,6668005113
9935,493420520,11533,493432053,5,0,1,18944,19,3799820148
9936,493452870,3898,493456768,1,0,1,4096,6,684808041
9937,493481129,166624,493647753,7,0,0,5120,8,2353376200
9938,493502660,105422,493608082,9,0,0,34304,18,6465068013
9939,493611139,102440,493713579,7,0,0,36352,8,3565609076
9940,493674040,99632,493773672,2,0,0,27136,4,8439252026
9941,493697730,89832,493787562,3,0,0,1024,2,3308289342
9942,493737370,84062,493821432,2,0,0,10240,4,8472813766
9943,493761480,111966,493873446,4,0,0,23552,16,5564861090
9944,493787230,43007,493830237,7,0,1,69632,8,2569375485
9945,493835030,38431,493873461,7,0,1,62976,8,612459927
9946,494016959,1994,494018953,8,0,1,2048,12,8658199738
9947,494144149,98696,494242845,1,0,0,24064,6,1226713886
9948,494254589,125528,494380117,7,0,0,112128,8,2289985294
9949,494305950,118783,494424733,8,0,0,14336,12,8069200181
9950,494347160,33557,494380717,0,0,1,512,11,5171963056
9951,494351030,100080,494451110,9,0,0,8704,18,536027296
9952,494359290,172819,494532109,9,0,0,67072,18,3837063120
9953,494437500,10499,494447999,1,0,1,16896,6,7520775453
9954,494446990,85803,494532793,9,0,0,1536,18,1849094496
9955,494470359,76745,494547104,7,0,0,3072,8,4542350257
9956,494480539,79592,494560131,1,0,0,11776,6,4042244797
9957,494626169,1042,494627211,2,0,1,1024,4,3099550095
9958,494700310,2946,494703256,4,0,1,3072,16,6775003506
9959,494796811,49292,494846103,6,0,0,3072,12,8018628026
9960,494895739,104312,495000051,7,0,0,42496,8,9966754554
9961,494910730,109301,495020031,2,0,0,12288,4,99187995
9962,494942180,69284,495011464,5,0,0,8192,19,10307593675
9963,495013090,65924,495079014,8,0,0,12288,12,10090935662
9964,495066339,47288,495113627,1,0,0,1536,6,8348160687
9965,495097460,96824,495194284,5,0,0,17920,19,2428594591
9966,495115150,5712,495120862,1,0,1,14336,6,2598216081
9967,495123369,64208,495187577,7,0,0,6656,8,3932402446
9968,495176150,108351,495284501,8,0,0,25088,12,8835900939
9969,495210020,127959,495337979,0,0,0,23040,11,1898164266
9970,495212621,161433,495374054,6,0,0,13824,12,7919039015
9971,495248950,72168,495321118,2,0,0,8192,4,3249699416
9972,495270900,98927,495369827,0,0,0,19456,11,6401013351
9973,495341960,90189,495432149,5,0,0,18432,19,4920728085
9974,495407820,97448,495505268,8,0,0,19968,12,5699063038
9975,495435570,84992,495520562,7,0,1,138752,8,4007514958
9976,495448200,133823,495582023,2,0,0,512,4,7193937642
9977,495457640,177956,495635596,5,0,0,8704,19,3883671509
9978,495468459,134587,495603046,1,0,0,18944,6,6340526014
9979,495494020,238259,495732279,8,0,0,39424,12,2024720122
9980,495611160,3422,495614582,5,0,1,3584,19,8077726576
9981,495622209,3387,495625596,3,0,1,9728,2,7435986077
9982,495636941,167289,495804230,6,0,0,512,12,9344327519
9983,495799920,45596,495845516,9,0,0,1024,18,6587286613
9984,495808839,130936,495939775,7,0,0,2048,8,8008241373
9985,495812660,153489,495966149,0,0,0,11776,11,5314434797
9986,495818631,120505,495939136,6,0,0,84992,12,9765390287
9987,495834091,127324,495961415,6,0,0,57856,12,3669432930
9988,495878940,7230,495886170,0,0,1,7680,11,10353185106
9989,495949040,63039,496012079,5,0,0,2560,19,10455571478
9990,495987780,59132,496046912,5,0,0,5120,19,9795054180
9991,496082020,106964,496188984,8,0,0,51200,12,3635027201
9992,496121770,33850,496155620,9,0,1,55808,18,5006062175
9993,496130310,109125,496239435,4,0,0,4096,16,7659203224
9994,496226550,5802,496232352,0,0,1,6144,11,9093432145
9995,496336120,90080,496426200,4,0,0,20992,16,7464943215
9996,496345480,2870,496348350,1,0,1,8704,6,2019014176
9997,496528649,106227,496634876,1,0,0,39936,6,3972614794
9998,496540239,208901,496749140,7,0,0,54784,8,10568788011
9999,496548240,96356,496644596,5,0,0,16384,19,8553600860
10000,496571180,191555,496762735,0,0,0,16384,11,3570226655
10001,496583360,227118,496810478,2,0,0,10752,4,9204713291
10002,496596070,120633,496716703,4,0,0,26624,16,5114317004
10003,496601040,180800,496781840,0,0,0,3584,11,8487877497
10004,496612669,232476,496845145,7,0,0,58880,8,28976330
10005,496678289,3422,496681711,2,0,1,3584,4,9350959344
10006,496712450,6239,496718689,6,0,1,2048,12,4130334136
10007,496718080,97093,496815173,9,0,0,15360,18,6889163908
10008,496764090,3387,496767477,0,0,1,9728,11,2410758424
10009,496892010,106788,496998798,0,0,0,9728,11,9613306098
10010,496919270,93464,497012734,2,0,0,22016,4,3884148258
10011,496959670,566,496960236,1,0,1,512,6,8495368373
10012,497038630,81752,497120382,0,0,0,13824,11,1546294921
10013,497044199,2470,497046669,3,0,1,2560,2,707709537
10014,497046980,120091,497167071,9,0,0,52224,18,3714202322
10015,497053840,11791,497065631,0,0,1,19456,11,5456564412
10016,497070110,141967,497212077,9,0,0,12288,18,2102294721
10017,497073820,166577,497240397,4,0,0,24576,16,5696225998
10018,497141290,75014,497216304,9,0,0,13824,18,1351346222
10019,497156560,131696,497288256,8,0,0,25088,12,1893411866
10020,497168831,159358,497328189,6,0,0,28160,12,6312265827
10021,497244679,48980,497293659,1,0,0,2048,6,1005725619
10022,497278599,20366,497298965,3,0,1,32768,2,2261359080
10023,497279020,21328,497300348,9,0,1,14848,18,5337430432
10024,497294609,10565,497305174,8,0,1,7680,12,315489529
10025,497486109,66368,497552477,7,0,0,8704,8,9518374713
10026,497494191,108992,497603183,6,0,0,57856,12,3272080537
10027,497624770,6754,497631524,9,0,1,7168,18,4472431032
10028,497631410,62725,497694135,2,0,0,5120,4,9348216243
10029,497751140,106496,497857636,4,0,0,49664,16,3330489296
10030,497868750,57440,497926190,4,0,0,4608,16,7111323919
10031,497967220,45596,498012816,0,0,0,1024,11,2844291476
10032,498009180,131300,498140480,4,0,0,131072,16,4365668662
10033,498013940,132023,498145963,4,0,0,17920,16,9450846867
10034,498090260,62592,498152852,4,0,0,3072,16,9092858118
10035,498102370,130054,498232424,4,0,0,27136,16,1500544741
10036,498274350,73316,498347666,2,0,0,16384,4,10225924172
10037,498315160,3422,498318582,0,0,1,3584,11,5277077129
10038,498330689,16992,498347681,3,0,1,20480,2,2786115524
10039,498404380,60949,498465329,4,0,0,4608,16,9444972450
10040,498407889,168681,498576570,1,0,0,17408,6,5812382947
10041,498418120,101192,498519312,5,0,0,32256,19,609019088
10042,498478260,137202,498615462,2,0,0,24064,4,6079481798
10043,498550079,80473,498630552,7,0,0,9728,8,5476879375
10044,498676560,10499,498687059,4,0,1,16896,16,7557122105
10045,498745040,158593,498903633,0,0,0,18432,11,442394957
10046,498760560,70976,498831536,3,0,0,8704,2,9435523585
10047,498767080,88583,498855663,4,0,0,1024,16,65643016
10048,498846870,77012,498923882,9,0,0,18432,18,5903620075
10049,498945230,104780,499050010,8,0,0,44032,12,8694725509
10050,498990540,94996,499085536,4,0,0,13312,16,9211324364
10051,498993199,117855,499111054,7,0,0,10240,8,9478072860
10052,499014460,6754,499021214,6,0,1,7168,12,5780863067
10053,499041929,81435,499123364,1,0,0,4608,6,6576057749
10054,499057399,160925,499218324,1,0,0,58880,6,9738271456
10055,499067460,122452,499189912,3,0,0,15872,2,8510053377
10056,499070190,165053,499235243,8,0,0,1024,12,9627721684
10057,499112240,206734,499318974,3,0,0,37888,2,9648556404
10058,499149320,12737,499162057,4,0,1,24576,16,7552406989
10059,499171180,69440,499240620,3,0,0,8704,2,1963753119
10060,499321240,63920,499385160,3,0,0,10752,2,8226927984
10061,499340080,93374,499433454,8,0,0,16896,12,9417206152
10062,499389780,106212,499495992,8,0,0,14336,12,8351152000
10063,499440550,83096,499523646,9,0,0,8192,18,7541677207
10064,499459380,72068,499531448,5,0,0,12288,19,10436232532
10065,499523450,59320,499582770,8,0,0,5120,12,2479488689
10066,499527600,4374,499531974,5,0,1,4608,19,3775301996
10067,499645990,97292,499743282,2,0,0,19456,4,5711828472
10068,499671060,54056,499725116,8,0,0,3584,12,4470158697
10069,499698729,89241,499787970,7,0,0,2560,8,6367932004
10070,499760370,76856,499837226,0,0,0,17920,11,3280716556
10071,499763470,99944,499863414,4,0,0,28160,16,9271393236
10072,499820889,68084,499888973,1,0,0,14336,6,10151136077
10073,499880520,59132,499939652,9,0,0,5120,18,6264414498
10074,499896630,124112,500020742,7,0,1,204800,8,3579795096
10075,499967900,140836,500108736,0,0,0,2560,11,7391241229
10076,500041649,122638,500164287,7,0,0,34304,8,4084298582
10077,500054510,1042,500055552,0,0,1,1024,11,8104235559
10078,500146721,65399,500212120,6,0,0,3584,12,8713463474
10079,500150520,108836,500259356,9,0,0,57344,18,4602583828
10080,500153141,128331,500281472,6,0,0,24064,12,8423163650
10081,500173550,144504,500318054,0,0,0,22016,11,3937335129
10082,500217279,135995,500353274,1,0,0,31744,6,3158264078
10083,500218279,566,500218845,3,0,1,512,2,3428306651
10084,500464310,99008,500563318,4,0,0,25088,16,6665931837
10085,500518950,93308,500612258,5,0,0,21504,19,5530367425
10086,500564200,81128,500645328,5,0,0,11776,19,8355872543
10087,500566801,100793,500667594,6,0,0,3072,12,3931668764
10088,500585701,106340,500692041,6,0,0,49152,12,5730623310
10089,500622010,88901,500710911,5,0,0,4096,19,4856414357
10090,500637589,2946,500640535,2,0,1,3072,4,3326941803
10091,500713860,114296,500828156,2,0,0,75264,4,1123372820
10092,500736829,122545,500859374,7,0,0,10240,8,9330919881
10093,500737359,95303,500832662,7,0,0,13312,8,9595922335
10094,500765199,11533,500776732,3,0,1,18944,2,2556089581
10095,500822379,10619,500832998,2,0,1,5120,4,3784356963
10096,500871340,59132,500930472,5,0,0,5120,19,6314063749
10097,500872890,116832,500989722,0,0,0,22016,11,9357691024
10098,500899190,142013,501041203,4,0,0,8192,16,3435653228
10099,500981010,86252,501067262,5,0,0,23552,19,1872996746
10100,501011060,132552,501143612,4,0,0,51200,16,8195527658
10101,501086900,61760,501148660,5,0,0,8704,19,5298527064
10102,501131320,73108,501204428,9,0,0,5632,18,1864847572
10103,501132000,74471,501206471,3,0,0,6656,2,2865608092
10104,501142470,149204,501291674,5,0,0,64000,19,753395090
10105,501150489,99164,501249653,7,0,0,25600,8,10347518225
10106,501197410,136361,501333771,7,0,1,223232,8,5644186323
10107,501238110,141400,501379510,3,0,0,10240,2,8589625352
10108,501243980,89776,501333756,8,0,0,9728,12,5177980847
10109,501261110,72876,501333986,4,0,1,2048,16,5966649798
10110,501264250,232615,501496865,5,0,0,25088,19,5946142185
10111,501333110,7883,501340993,5,0,1,7680,19,5687483085
10112,501439550,142011,501581561,3,0,0,23552,2,7937640481
10113,501492209,92643,501584852,7,0,0,10752,8,9471044174
10114,501522840,104936,501627776,4,0,0,44544,16,6534966693
10115,501552800,98394,501651194,5,0,0,19456,19,7105365382
10116,501584580,203138,501787718,7,0,1,328192,8,10491210807
10117,501590610,197467,501788077,0,0,1,9728,11,3931019976
10118,501617801,277154,501894955,6,0,0,33280,12,1598909851
10119,501683460,108483,501791943,9,0,1,6144,18,8323462950
10120,501693630,106565,501800195,8,0,0,6656,12,8161631393
10121,501736429,60903,501797332,3,0,1,25600,2,4908597322
10122,501839660,274067,502113727,2,0,0,17408,4,8023756972
10123,501884370,10600,501894970,5,0,1,5632,19,7590281780
10124,501909870,198538,502108408,8,0,0,188928,12,3970048973
10125,501974230,180412,502154642,5,0,0,42496,19,10514222567
10126,501983730,265174,502248904,7,0,1,429568,8,5414914930
10127,502013790,473673,502487463,4,0,0,91136,16,5357541748
10128,502055680,231002,502286682,4,0,0,15360,16,1338135360
10129,502168801,361481,502530282,6,0,0,13312,12,6189798517
10130,502253790,239468,502493258,4,0,0,18944,16,2299962440
10131,502296030,115333,502411363,5,0,0,12800,19,7497923098
10132,502350340,4420,502354760,5,0,1,11776,19,10393225300
10133,502365410,212421,502577831,0,0,0,69632,11,8467597537
10134,502390190,566,502390756,6,0,1,512,12,7371363803
10135,502463620,187261,502650881,5,0,0,81408,19,9103333849
10136,502583279,95132,502678411,7,0,0,17408,8,3644749212
10137,502622480,45596,502668076,0,0,0,1024,11,5353508664
10138,502642140,14076,502656216,5,0,1,5632,19,8003231811
10139,502646710,11452,502658162,5,0,1,3072,19,7090186050
10140,502657591,64208,502721799,6,0,0,6656,12,7495983407
10141,502696849,59132,502755981,7,0,0,5120,8,3125164910
10142,502707839,63296,502771135,7,0,0,8704,8,9490242096
10143,502718500,131743,502850243,3,0,0,14336,2,8839403590
10144,502764980,106281,502871261,2,0,0,1536,4,7396052816
10145,502861570,62384,502923954,9,0,0,10752,18,148837109
10146,503020831,99320,503120151,6,0,0,26112,12,4989249037
10147,503021241,99237,503120478,6,0,0,1024,12,6520138806
10148,503044070,77515,503121585,3,0,0,3584,2,5173802767
10149,503066660,92635,503159295,5,0,0,6144,19,3830128509
10150,503171780,6754,503178534,6,0,1,7168,12,2866367530
10151,503215160,3904,503219064,9,0,1,10752,18,4553241495
10152,503244069,181712,503425781,1,0,0,20992,6,1100436865
10153,503255540,64208,503319748,5,0,0,6656,19,4917632489
10154,503290610,104372,503394982,9,0,0,25600,18,3096101846
10155,503348590,84512,503433102,8,0,0,12800,12,7879273502
10156,503378959,90992,503469951,7,0,0,18944,8,3945786806
10157,503389330,98348,503487678,2,0,0,8192,4,3123407094
10158,503409430,62096,503471526,4,0,0,5120,16,5890169996
10159,503425510,70823,503496333,2,0,0,3584,4,6637125072
10160,503592700,108368,503701068,4,0,0,55808,16,6786476625
10161,503683920,17171,503701091,9,0,1,14336,18,2836073870
10162,503688150,83886,503772036,3,0,0,8704,2,5360546922
10163,503775680,103376,503879056,4,0,0,39424,16,7322162571
10164,503782250,7706,503789956,5,0,1,8192,19,649932953
10165,503817000,5802,503822802,6,0,1,6144,12,778133705
10166,503872260,118120,503990380,9,0,0,65536,18,4067678458
10167,503904830,158341,504063171,8,0,0,40960,12,8258553965
10168,504014340,52364,504066704,0,0,0,3072,11,1269226955
10169,504028130,98696,504126826,9,0,0,24064,18,998865716
10170,504034520,45596,504080116,9,0,0,1024,18,9138392287
10171,504037610,53388,504090998,5,0,0,1024,19,1194767782
10172,504047780,2470,504050250,1,0,1,2560,6,4115833820
10173,504062111,125117,504187228,6,0,0,24576,12,2408456005
10174,504078970,87896,504166866,9,0,0,13824,18,8802060508
10175,504157460,97916,504255376,2,0,0,21504,4,5481927258
10176,504170010,117260,504287270,5,0,0,84992,19,7768672388
10177,504201540,122386,504323926,8,0,0,23552,12,10361259612
10178,504237531,105515,504343046,6,0,0,8704,12,5427020670
10179,504239610,5326,504244936,5,0,1,5632,19,9040219454
10180,504240240,103289,504343529,4,0,0,1536,16,7955960937
10181,504252830,75206,504328036,2,0,0,9216,4,2802629855
10182,504324370,5971,504330341,9,0,1,14848,18,7614301544
10183,504326140,87471,504413611,8,0,0,13312,12,5009439005
10184,504363060,116167,504479227,3,0,0,4608,2,10376477436
10185,504372109,128256,504500365,7,0,0,65024,8,4272246981
10186,504407229,214364,504621593,7,0,0,27136,8,10490381432
10187,504438650,1994,504440644,0,0,1,2048,11,2145677317
10188,504455571,91280,504546851,6,0,0,14848,12,9524709727
10189,504461910,90836,504552746,3,0,0,18432,2,6627751201
10190,504526570,110170,504636740,2,0,0,49664,4,707810544
10191,504544870,63969,504608839,3,0,0,4608,2,9155328485
10192,504560760,76931,504637691,8,0,0,3072,12,507936425
10193,504577930,74439,504652369,9,0,0,10240,18,653166810
10194,504629840,22544,504652384,6,0,1,25600,12,3394846671
10195,504700810,43904,504744714,3,0,0,512,2,8759997890
10196,504707259,6278,504713537,3,0,1,6656,2,7428944132
10197,504711790,98072,504809862,3,0,0,22016,2,2806590812
10198,504734410,43904,504778314,5,0,0,512,19,2012739250
10199,504761689,5712,504767401,3,0,1,14336,2,1005621735
10200,504765091,102215,504867306,6,0,0,6656,12,9881575166
10201,504771429,92528,504863957,1,0,0,18944,6,2663193463
10202,504840160,65420,504905580,5,0,0,5120,19,7337884176
10203,504886040,76364,504962404,3,0,0,11264,2,4777987676
10204,504907681,57440,504965121,6,0,0,4608,12,9998478879
10205,504921190,139536,505060726,9,0,0,105984,18,4019781870
10206,505025591,53459,505079050,6,0,0,2560,12,2951070607
10207,505042621,76005,505118626,6,0,0,6144,12,9002727795
10208,505054949,70026,505124975,7,0,0,11776,8,3372543475
10209,505095990,92533,505188523,7,0,1,150016,8,5188570997
10210,505247650,246476,505494126,2,0,0,3072,4,5935135998
10211,505268179,111020,505379199,1,0,0,64512,6,3742146573
10212,505298690,104431,505403121,0,0,0,15872,11,1586334477
10213,505346769,146406,505493175,7,0,0,83456,8,4752575421
10214,505404790,5802,505410592,5,0,1,6144,19,4254379362
10215,505412089,116960,505529049,7,0,0,28672,8,1770897724
10216,505600781,100412,505701193,6,0,0,29696,12,577226203
10217,505622290,95444,505717734,2,0,0,18432,4,790386075
10218,505647720,109717,505757437,8,0,0,20480,12,4440494796
10219,505827720,79772,505907492,8,0,0,17408,12,5307709489
10220,505839370,74696,505914066,4,0,0,15872,16,3590953586
10221,505875591,133053,506008644,6,0,0,98304,12,3818747168
10222,505938800,86992,506025792,4,0,0,6144,16,10259123157
10223,505955280,1042,505956322,5,0,1,1024,19,776488816
10224,506011830,135417,506147247,8,0,0,8704,12,792409234
10225,506039881,85171,506125052,6,0,0,14848,12,1619672824
10226,506044960,3422,506048382,9,0,1,3584,18,3133346780
10227,506124960,4458,506129418,4,0,1,4608,16,127339889
10228,506200429,87140,506287569,1,0,0,16384,6,619928614
10229,506229320,79609,506308929,9,0,0,12288,18,5124362125
10230,506267709,189126,506456835,7,0,0,59392,8,407672485
10231,506269960,105869,506375829,9,0,0,21504,18,3940259010
10232,506293519,98126,506391645,7,0,0,14336,8,4841871493
10233,506356050,206856,506562906,0,0,0,17408,11,8586130939
10234,506362390,149399,506511789,4,0,0,38400,16,4468040137
10235,506362430,163495,506525925,8,0,0,12800,12,1850249696
10236,506373630,105062,506478692,3,0,0,28672,2,6106892293
10237,506381529,88412,506469941,1,0,0,25600,6,7483810116
10238,506410250,128997,506539247,5,0,0,25088,19,8794234193
10239,506417970,139617,506557587,2,0,0,9728,4,1364350677
10240,506421789,160770,506582559,1,0,0,22528,6,6693824281
10241,506460580,106561,506567141,3,0,0,4608,2,4864527199
10242,506603800,109765,506713565,9,0,0,45056,18,4107253161
10243,506620200,6754,506626954,1,0,1,7168,6,10171785568
10244,506625369,105333,506730702,1,0,0,4608,6,3911702214
10245,506627211,185721,506812932,6,0,0,41472,12,1510184356
10246,506662210,96350,506758560,4,0,0,9216,16,2878423833
10247,506668239,182637,506850876,1,0,0,26624,6,3266837759
10248,506719480,62126,506781606,9,0,0,3072,18,303461744
10249,506740309,102440,506842749,7,0,0,36352,8,2098489139
10250,506777129,6754,506783883,2,0,1,7168,4,7832131852
10251,506810649,15012,506825661,2,0,1,24576,4,4432745055
10252,506834870,169175,507004045,9,0,1,198656,18,9698279216
10253,506835530,168500,507004030,9,0,0,108544,18,1742807231
10254,506852820,257631,507110451,0,0,0,92672,11,2370855024
10255,506868560,171523,507040083,9,0,0,23040,18,2403105520
10256,506892920,111140,507004060,0,0,1,13312,11,8752161539
10257,506895250,234653,507129903,2,0,0,15360,4,3518722557
10258,506907939,98632,507006571,1,0,0,8192,6,10672965504
10259,506912139,233388,507145527,7,0,0,6144,8,4778297608
10260,507090740,75020,507165760,8,0,0,3584,12,10351700803
10261,507096479,100049,507196528,7,0,0,13824,8,9646923172
10262,507152499,5326,507157825,3,0,1,5632,2,1006004124
10263,507291510,71468,507362978,2,0,0,15360,4,888119346
10264,507325759,64208,507389967,1,0,0,6656,6,2003990504
10265,507355271,87296,507442567,6,0,0,16896,12,10692350708
10266,507388990,53748,507442738,4,0,0,512,16,9868475619
10267,507399079,78056,507477135,1,0,0,11776,6,8081543815
10268,507442680,48915,507491595,3,0,0,1536,2,5471569217
10269,507462260,148680,507610940,0,0,0,17408,11,1011643225
10270,507467850,77744,507545594,8,0,0,10752,12,8224061287
10271,507509239,107689,507616928,1,0,0,16896,6,8197042330
10272,507531149,43904,507575053,1,0,0,512,6,8747144665
10273,507645050,104000,507749050,3,0,0,41472,2,6692390483
10274,507699250,77646,507776896,9,0,0,10752,18,10459710545
10275,507751000,105006,507856006,5,0,0,37376,19,10477298788
10276,507877560,115076,507992636,2,0,0,77824,4,15825715
10277,507885170,81152,507966322,2,0,0,16896,4,2846611444
10278,507919311,140423,508059734,6,0,0,65024,12,6157617451
10279,507936969,142031,508079000,1,0,0,6144,6,8513532487
10280,507942321,176339,508118660,6,0,0,45568,12,10481528958
10281,508089300,4420,508093720,0,0,1,11776,11,9684632993
10282,508203420,1042,508204462,0,0,1,1024,11,721319149
10283,508232080,86204,508318284,4,0,0,13312,16,9433716156
10284,508251940,97448,508349388,9,0,0,19968,18,4098470170
10285,508276119,3898,508280017,3,0,1,4096,2,2884303115
10286,508388030,109290,508497320,2,0,0,54272,4,918441467
10287,508389420,147166,508536586,0,0,0,76800,11,7764149319
10288,508415680,183330,508599010,8,0,0,42496,12,4369744892
10289,508425200,114908,508540108,5,0,0,1536,19,5424691035
10290,508475559,77837,508553396,1,0,0,9216,6,6392848068
10291,508494589,118545,508613134,1,0,0,8192,6,5150107470
10292,508498740,133900,508632640,0,0,0,512,11,9815644736
10293,508511189,25412,508536601,8,0,1,4096,12,1448251109
10294,508515610,24513,508540123,1,0,1,3584,6,3964238469
10295,508546300,7111,508553411,4,0,1,5632,16,10449245400
10296,508573120,3128,508576248,9,0,1,9216,18,4813006542
10297,508608909,69284,508678193,1,0,0,8192,6,3848483241
10298,508626150,279699,508905849,8,0,0,110080,12,2647194872
10299,508711779,93410,508805189,7,0,0,2048,8,9478294031
10300,508768290,144906,508913196,0,0,0,24064,11,6462060865
10301,508822470,92457,508914927,2,0,0,5632,4,819260356
10302,508835040,86204,508921244,2,0,0,13312,4,670377444
10303,508848170,122041,508970211,2,0,0,37888,4,8822905237
10304,508912110,71337,508983447,5,0,0,10752,19,4822881519
10305,508982239,2242,508984481,3,0,1,1024,2,1788273143
10306,509020141,144819,509164960,6,0,0,15872,12,7628101865
10307,509111940,53971,509165911,0,0,0,3072,11,1714135195
10308,509142070,99008,509241078,5,0,0,25088,19,7191493388
10309,509169470,151486,509320956,3,0,0,18944,2,2740438257
10310,509174550,111546,509286096,2,0,0,20480,4,2076613367
10311,509547430,5196,509552626,9,0,1,13312,18,10111187219
10312,509560220,1518,509561738,6,0,1,1536,12,2431313508
10313,509560639,2085,509562724,3,0,1,1536,2,214732009
10314,509560690,103604,509664294,9,0,0,39936,18,4117734209
10315,509819229,54056,509873285,7,0,0,3584,8,6483033359
10316,510009630,107432,510117062,2,0,0,52736,4,7305901857
10317,510049470,108770,510158240,5,0,0,15360,19,2480924246
10318,510074999,5802,510080801,8,0,1,6144,12,3610426662
10319,510105370,112716,510218086,0,0,0,30208,11,6129444057
10320,510148530,111970,510260500,5,0,0,27136,19,5362971910
10321,510211429,64497,510275926,1,0,0,1024,6,6690056218
10322,510268210,7731,510275941,0,0,1,8192,11,9440920463
10323,510270479,10263,510280742,2,0,1,7680,4,10479848581
10324,510286210,22691,510308901,6,0,1,37376,12,6507958234
10325,510302569,133367,510435936,1,0,0,17408,6,5004270215
10326,510303940,110708,510414648,9,0,0,63488,18,7495467316
10327,510309150,106917,510416067,0,0,0,4608,11,2312020224
10328,510356250,151669,510507919,4,0,0,19456,16,2697062797
10329,510418109,321244,510739353,7,0,0,107520,8,530049872
10330,510434610,15435,510450045,0,0,1,24064,11,5671042841
10331,510460670,369187,510829857,4,0,0,9216,16,5669715738
10332,510485130,100495,510585625,5,0,0,10752,19,9662708666
10333,510525930,63811,510589741,9,0,0,4096,18,4652524218
10334,510526480,180098,510706578,5,0,0,78336,19,5058803315
10335,510533620,241640,510775260,3,0,0,75776,2,7926979490
10336,510554680,3422,510558102,1,0,1,3584,6,3436835960
10337,510596231,73604,510669835,6,0,0,12288,12,7352082999
10338,510666111,160923,510827034,6,0,0,37888,12,1826073348
10339,510704780,192382,510897162,4,0,0,20480,16,1013051154
10340,510732329,12860,510745189,8,0,1,6144,12,6483006512
10341,510734949,279933,511014882,7,0,0,38400,8,1468094503
10342,510821710,270122,511091832,2,0,0,76288,4,1923590690
10343,510835190,167977,511003167,9,0,0,76288,18,45605531
10344,510836040,95043,510931083,4,0,0,1024,16,3980103335
10345,510859319,2470,510861789,3,0,1,2560,2,8973369516
10346,510903930,3898,510907828,4,0,1,4096,16,7217482337
10347,510924051,231626,511155677,6,0,0,19968,12,7817116232
10348,510963849,73004,511036853,1,0,0,15360,6,8950145643
10349,510967379,214227,511181606,1,0,0,79360,6,1102439500
10350,510975320,566,510975886,5,0,1,512,19,7640478690
10351,511098990,15837,511114827,4,0,1,30720,16,8669267511
10352,511134040,48109,511182149,2,0,0,512,4,8452738808
10353,511183761,100100,511283861,6,0,0,28672,12,873244977
10354,511206109,168513,511374622,1,0,0,3584,6,4020794393
10355,511252640,118467,511371107,5,0,0,87040,19,8734538991
10356,511301431,112809,511414240,6,0,0,26624,12,4205555645
10357,511350099,28723,511378822,8,0,1,8192,12,4660031955
10358,511350330,90512,511440842,2,0,0,13824,4,70900755
10359,511376379,2870,511379249,2,0,1,8704,4,4113672212
10360,511449729,150003,511599732,1,0,0,84992,6,5712760867
10361,511521759,2946,511524705,2,0,1,3072,4,922980523
10362,511544140,123578,511667718,0,0,0,84480,11,3982098280
10363,511553911,137147,511691058,6,0,0,14848,12,2419702636
10364,511651600,94010,511745610,9,0,0,11264,18,8017499783
10365,511662890,95837,511758727,9,0,0,18944,18,1718059351
10366,511682460,55748,511738208,8,0,0,4096,12,10244342022
10367,511686380,187682,511874062,8,0,0,72704,12,1827078400
10368,511723830,12737,511736567,7,0,1,24576,8,107319136
10369,511755830,68177,511824007,9,0,0,4096,18,6101398843
10370,511762529,136092,511898621,1,0,0,25088,6,4420874391
10371,511931160,43904,511975064,4,0,0,512,16,4370602415
10372,511968990,65900,512034890,4,0,0,7168,16,8050581995
10373,512006799,3904,512010703,8,0,1,10752,12,10668705635
10374,512058780,104936,512163716,9,0,0,44544,18,7303574773
10375,512106519,6488,512113007,3,0,1,15872,2,4733064045
10376,512107760,75348,512183108,3,0,0,5120,2,9416438692
10377,512201080,77612,512278692,9,0,0,15360,18,9812333362
10378,512252100,104946,512357046,9,0,0,44544,18,2507051812
10379,512339729,566,512340295,8,0,1,512,12,9099395773
10380,512408340,101036,512509376,0,0,0,31744,11,3199812330
10381,512429860,89744,512519604,8,0,0,14848,12,2953603902
10382,512445749,147217,512592966,7,0,0,27648,8,1858775597
10383,512451559,3898,512455457,2,0,1,4096,4,5349856266
10384,512523099,110552,512633651,7,0,0,62976,8,3814145636
10385,512551269,11791,512563060,3,0,1,19456,2,8748074010
10386,512682199,99632,512781831,7,0,0,27136,8,9974279955
10387,512682229,2005,512684234,8,0,1,2048,12,6501256299
10388,512710279,254336,512964615,7,0,0,45056,8,3493549827
10389,512752940,99265,512852205,3,0,0,25088,2,3013487379
10390,512793380,220747,513014127,5,0,0,8704,19,10500325167
10391,512793690,112725,512906415,9,0,0,15360,18,1230791977
10392,512818880,93217,512912097,9,0,0,7680,18,7182735524
10393,512845380,201675,513047055,2,0,0,20992,4,8742659453
10394,512902480,10205,512912685,5,0,1,6656,19,482849294
10395,513054170,7706,513061876,1,0,1,8192,6,1238254821
10396,513082660,79976,513162636,2,0,0,28160,4,8707148649
10397,513091430,81779,513173209,5,0,0,9728,19,6852299706
10398,513221290,72668,513293958,2,0,0,9216,4,8621365895
10399,513265910,94088,513359998,8,0,0,24064,12,2958297858
10400,513297369,95336,513392705,7,0,0,28160,8,5113060292
10401,513385460,192705,513578165,9,0,0,152576,18,10592091088
10402,513402750,194474,513597224,8,0,0,16384,12,8896948422
10403,513412040,16096,513428136,0,0,1,31232,11,9439868860
10404,513458649,1994,513460643,2,0,1,2048,4,5919398065
10405,513507320,4162,513511482,1,0,1,11264,6,477757239
10406,513517680,126121,513643801,5,0,0,65024,19,4905185345
10407,513665509,64208,513729717,7,0,0,6656,8,8056970895
10408,513742320,113672,513855992,8,0,0,73216,12,3113026078
10409,513777579,2946,513780525,2,0,1,3072,4,10070803147
10410,513855520,72220,513927740,5,0,0,11264,19,9405508651
10411,513881510,1518,513883028,1,0,1,1536,6,9888996055
10412,513891500,2946,513894446,4,0,1,3072,16,10237493821
10413,513910910,167133,514078043,5,0,0,39424,19,304417419
10414,513928470,104468,514032938,8,0,0,43008,12,3961483321
10415,513985730,5802,513991532,6,0,1,6144,12,9261340338
10416,514005460,82666,514088126,7,0,1,134144,8,7581189228
10417,514006710,239815,514246525,5,0,0,2560,19,4630710184
10418,514009779,138438,514148217,7,0,0,3072,8,1582063364
10419,514025140,151709,514176849,9,0,0,16384,18,77170922
10420,514034120,114736,514148856,2,0,0,2048,4,7737762862
10421,514052010,144144,514196154,9,0,0,4096,18,8149386184
10422,514057730,30742,514088472,6,0,1,512,12,1135503218
10423,514063640,119620,514183260,0,0,0,20992,11,7425996681
10424,514095559,7706,514103265,2,0,1,8192,4,4694660763
10425,514305299,7230,514312529,8,0,1,7680,12,528167213
10426,514350209,1518,514351727,2,0,1,1536,4,7804592993
10427,514366739,70844,514437583,1,0,0,13312,6,5216894324
10428,514464419,6229,514470648,3,0,1,15360,2,1861117317
10429,514577950,92067,514670017,3,0,0,19456,2,9536665074
10430,514587230,4937,514592167,5,0,1,12800,19,2035308008
10431,514602440,144832,514747272,8,0,0,43008,12,6373705313
10432,514622990,93176,514716166,0,0,0,26112,11,7411697702
10433,514701960,157265,514859225,0,0,0,62976,11,4254851181
10434,514775600,3422,514779022,5,0,1,3584,19,3345438369
10435,514778199,177495,514955694,7,0,0,38400,8,5140801064
10436,514945319,85115,515030434,7,0,0,5632,8,4992837540
10437,514948370,10986,514959356,4,0,1,10240,16,6843159206
10438,514998330,57908,515056238,4,0,0,6144,16,7708526484
10439,515030149,122556,515152705,7,0,0,6144,8,5681370200
10440,515036670,114148,515150818,8,0,0,65024,12,601054501
10441,515080109,101816,515181925,7,0,0,34304,8,2397648070
10442,515116300,5326,515121626,5,0,1,5632,19,10275971946
10443,515172320,201419,515373739,4,0,0,91648,16,10619481867
10444,515305420,79016,515384436,9,0,0,19968,18,6587691210
10445,515363490,89389,515452879,4,0,0,15360,16,10245121426
10446,515367020,72036,515439056,0,0,0,10240,11,5537371697
10447,515411130,138043,515549173,2,0,0,103424,4,3093370995
10448,515445299,141789,515587088,7,0,0,49664,8,2014142697
10449,515518190,96875,515615065,4,0,0,7168,16,3375956423
10450,515606620,97940,515704560,8,0,0,26624,12,7736416606
10451,515643950,14545,515658495,0,0,1,28160,11,7644481413
10452,515680880,124229,515805109,3,0,0,20480,2,6663404580
10453,515718040,1042,515719082,5,0,1,1024,19,671519998
10454,515822801,102128,515924929,6,0,0,35328,12,5007167797
10455,515882159,100724,515982883,1,0,0,30720,6,6901661625
10456,515890631,99110,515989741,6,0,0,11776,12,8543059360
10457,515895210,131545,516026755,4,0,0,18432,16,6483214526
10458,515899050,204811,516103861,9,0,0,43520,18,6655362472
10459,515920080,183952,516104032,0,0,0,512,11,467798990
10460,516001019,136028,516137047,1,0,0,5120,6,4368026046
10461,516004489,116262,516120751,7,0,0,2048,8,4036651217
10462,516023410,169605,516193015,2,0,0,35328,4,3428028285
10463,516023791,65856,516089647,6,0,0,3584,12,3748611900
10464,516030029,77138,516107167,7,0,0,10240,8,450040033
10465,516106980,10678,516117658,4,0,1,16896,16,7395967541
10466,516288750,77612,516366362,8,0,0,15360,12,378971660
10467,516375640,104156,516479796,2,0,0,41984,4,1339336373
10468,516430380,130476,516560856,5,0,0,18432,19,1677654298
10469,516505390,67304,516572694,0,0,0,11776,11,1022716850
10470,516613920,99008,516712928,5,0,0,25088,19,2308845847
10471,516776950,92216,516869166,5,0,0,17920,19,10478637822
10472,516912790,79592,516992382,8,0,0,11776,12,6303555047
10473,516917240,95560,517012800,3,0,0,2048,2,7157745115
10474,516940640,171424,517112064,8,0,0,28160,12,6201572828
10475,516966030,82820,517048850,5,0,0,12288,19,4784811071
10476,516991161,82608,517073769,6,0,0,1024,12,8543825982
10477,517002969,4850,517007819,8,0,1,5120,12,10571802676
10478,517010330,3898,517014228,9,0,1,4096,18,10311214889
10479,517121350,57495,517178845,0,0,0,2560,11,9362648918
10480,517148260,107445,517255705,4,0,0,46592,16,8652517787
10481,517303370,101660,517405030,5,0,0,33792,19,5599230134
10482,517347150,86981,517434131,5,0,0,17920,19,5031534068
10483,517349041,187468,517536509,6,0,0,125952,12,8865168234
10484,517356000,3898,517359898,6,0,1,4096,12,4812842749
10485,517376689,69284,517445973,7,0,0,8192,8,3842337702
10486,517454690,5326,517460016,1,0,1,5632,6,3846784947
10487,517567800,90860,517658660,8,0,0,23552,12,3185804516
10488,517621120,4374,517625494,9,0,1,4608,18,343363597
10489,517710489,47600,517758089,7,0,0,2560,8,723741118
10490,517839350,101972,517941322,5,0,0,34816,19,7284631645
10491,517905710,47288,517952998,9,0,0,1536,18,5625275136
10492,517977360,70844,518048204,2,0,0,13312,4,7516320691
10493,518028209,43904,518072113,7,0,0,512,8,10447271618
10494,518047680,100460,518148140,5,0,0,28160,19,6863816138
10495,518078190,177794,518255984,5,0,0,82432,19,8564816078
10496,518093940,73658,518167598,8,0,0,10240,12,7993048504
10497,518149160,156786,518305946,5,0,0,18432,19,50248670
10498,518181530,78294,518259824,9,0,0,2048,18,969655242
10499,518340749,10499,518351248,2,0,1,16896,4,7242470667
10500,518372090,105716,518477806,9,0,0,47104,18,8540673949
10501,518386610,103940,518490550,9,0,0,13312,18,7860819373
10502,518400839,99689,518500528,1,0,0,4608,6,6044849293
10503,518430890,72305,518503195,3,0,0,8704,2,9885140550
10504,518481230,91904,518573134,0,0,0,16896,11,8407464863
10505,518591540,3387,518594927,0,0,1,9728,11,5349871087
10506,518605440,98228,518703668,2,0,0,22528,4,10120661752
10507,518662490,4374,518666864,4,0,1,4608,16,5036177018
10508,518667560,67523,518735083,9,0,0,8192,18,3137290875
10509,518695840,76832,518772672,0,0,0,12800,11,10600934870
10510,518716920,3422,518720342,1,0,1,3584,6,9747229711
10511,518758549,93440,518851989,7,0,0,16896,8,491948509
10512,518867139,59132,518926271,1,0,0,5120,6,8389312802
10513,518873670,42424,518916094,4,0,1,69120,16,3627978326
10514,518929170,58985,518988155,8,0,0,512,12,1464802487
10515,519006240,149859,519156099,2,0,0,77312,4,3557799592
10516,519019529,11533,519031062,2,0,1,18944,4,8951286502
10517,519159999,98852,519258851,1,0,0,24576,6,8453945371
10518,519178090,90061,519268151,9,0,0,9728,18,6915099956
10519,519179709,4374,519184083,2,0,1,4608,4,6156062039
10520,519225620,47600,519273220,3,0,0,2560,2,2509374365
10521,519257470,57121,519314591,0,0,0,4096,11,5391569568
10522,519287570,54056,519341626,3,0,0,3584,2,5223195023
10523,519382140,103220,519485360,2,0,0,38912,4,8145950093
10524,519400460,59444,519459904,3,0,0,6144,2,7623594739
10525,519516220,12825,519529045,9,0,1,21504,18,6460249422
10526,519586560,83312,519669872,5,0,0,18944,19,106857737
10527,519684570,6278,519690848,1,0,1,6656,6,2481212804
10528,519705550,82976,519788526,8,0,0,12800,12,5349691110
10529,519801670,44920,519846590,7,0,1,77312,8,6170678718
10530,519861150,65456,519926606,8,0,0,10752,12,10421833363
10531,519898780,109304,520008084,4,0,0,58880,16,847546534
10532,519912540,566,519913106,1,0,1,512,6,3078277301
10533,519972739,133308,520106047,7,0,0,131072,8,884267604
10534,520021761,137262,520159023,6,0,0,16896,12,9662865434
10535,520024850,88177,520113027,2,0,0,2048,4,8882337742
10536,520044780,78715,520123495,3,0,0,4608,2,8802294236
10537,520052570,110539,520163109,8,0,0,10752,12,4646852732
10538,520070390,89428,520159818,4,0,0,2560,16,814759586
10539,520085499,92945,520178444,1,0,0,13312,6,5093620045
10540,520118600,130615,520249215,4,0,0,73728,16,8077308432
10541,520179279,566,520179845,8,0,1,512,12,120584427
10542,520191830,5326,520197156,5,0,1,5632,19,2780861818
10543,520217599,5196,520222795,8,0,1,13312,12,1025820930
10544,520221510,217860,520439370,3,0,0,25600,2,9692036984
10545,520289549,5802,520295351,8,0,1,6144,12,9493736751
10546,520300920,130635,520431555,8,0,0,84480,12,1471633042
10547,520314451,128678,520443129,6,0,0,12288,12,5493273296
10548,520403650,77386,520481036,8,0,0,11776,12,6714947595
10549,520494110,3422,520497532,0,0,1,3584,11,3392947812
10550,520500980,105242,520606222,7,0,1,171520,8,555732685
10551,520561070,177456,520738526,8,0,0,23552,12,3322878439
10552,520562510,44071,520606581,7,0,1,9728,8,10177181161
10553,520675721,103688,520779409,6,0,0,40448,12,9857553482
10554,520708060,106858,520814918,0,0,0,19968,11,1497832489
10555,520787910,113360,520901270,9,0,0,72192,18,2537111736
10556,520801430,23378,520824808,6,0,1,41984,12,3661585632
10557,520814949,88855,520903804,1,0,0,4608,6,6091464852
10558,520828990,73387,520902377,3,0,0,3584,2,371434597
10559,520863540,49136,520912676,4,0,0,2560,16,5064038330
10560,520885150,107789,520992939,8,0,0,6656,12,9039869725
10561,520944700,48980,520993680,8,0,0,2048,12,5136558449
10562,520957199,47288,521004487,7,0,0,1536,8,10408601666
10563,521088961,43904,521132865,6,0,0,512,12,7045205768
10564,521121189,99320,521220509,7,0,0,26112,8,3404950135
10565,521176861,135580,521312441,6,0,0,28160,12,9264500597
10566,521327999,95600,521423599,7,0,0,18944,8,5612720280
10567,521338800,54056,521392856,5,0,0,3584,19,2268980214
10568,521388989,3882,521392871,2,0,1,10240,4,6738018200
10569,521396231,97589,521493820,6,0,0,9216,12,2426927360
10570,521398779,82844,521481623,1,0,0,17408,6,9225495365
10571,521410630,43904,521454534,5,0,0,512,19,8880595172
10572,521537110,67592,521604702,3,0,0,7680,2,8692786437
10573,521630480,116480,521746960,4,0,0,82432,16,6326883779
10574,521630880,147916,521778796,2,0,0,25600,4,6993224945
10575,521672240,197511,521869751,4,0,0,34304,16,2531656931
10576,521757420,3128,521760548,9,0,1,9216,18,8879250943
10577,521758200,55936,521814136,5,0,0,3072,19,5378306452
10578,521767840,1518,521769358,5,0,1,1536,19,7491865420
10579,521785069,175844,521960913,7,0,0,9216,8,3589458687
10580,521849650,65900,521915550,3,0,0,7168,2,6438147392
10581,521907600,111651,522019251,8,0,0,28160,12,8382005511
10582,521933159,2470,521935629,8,0,1,2560,12,10164983215
10583,522016000,7141,522023141,0,0,1,4096,11,4668198841
10584,522021109,69284,522090393,1,0,0,8192,6,6148749031
10585,522038420,105154,522143574,4,0,1,174592,16,8189958564
10586,522098000,155970,522253970,3,0,0,13824,2,978624467
10587,522137410,8110,522145520,5,0,1,3072,19,8467780660
10588,522151750,187009,522338759,4,0,0,8192,16,1122461080
10589,522175819,12566,522188385,2,0,1,20992,4,2911045553
10590,522227810,221387,522449197,8,0,0,34304,12,162620718
10591,522251320,84928,522336248,3,0,0,13312,2,10206783077
10592,522271770,2470,522274240,6,0,1,2560,12,7862989422
10593,522293519,55748,522349267,1,0,0,4096,6,8865017999
10594,522304700,26479,522331179,7,0,1,48128,8,2472046375
10595,522316020,55693,522371713,2,0,0,1024,4,3511153294
10596,522317240,187128,522504368,0,0,0,10240,11,335113873
10597,522327180,11594,522338774,1,0,1,3072,6,4414521321
10598,522363990,102908,522466898,8,0,0,37888,12,2901300933
10599,522383140,101660,522484800,5,0,0,33792,19,8698334248
10600,522411420,144176,522555596,4,0,0,27136,16,2120979073
10601,522434159,97110,522531269,7,0,0,10752,8,8990330394
10602,522539480,113360,522652840,9,0,0,72192,18,9838498736
10603,522542530,55748,522598278,2,0,0,4096,4,4944867692
10604,522614680,125412,522740092,3,0,0,58880,2,4755644617
10605,522659680,98634,522758314,2,0,0,6656,4,7082415577
10606,522728540,128414,522856954,8,0,0,30720,12,7809168476
10607,522945139,58555,523003694,1,0,0,4608,6,8634013182
10608,522946090,566,522946656,0,0,1,512,11,4119639425
10609,522992930,61124,523054054,7,0,1,98816,8,7353317631
10610,523041530,133773,523175303,3,0,0,1536,2,8040485564
10611,523108460,128325,523236785,5,0,0,35840,19,10185718727
10612,523173561,87710,523261271,6,0,0,9216,12,5697192628
10613,523189730,74246,523263976,3,0,0,6656,2,5438042600
10614,523226609,12638,523239247,3,0,1,2560,2,1643334994
10615,523330901,45596,523376497,6,0,0,1024,12,4711980939
10616,523490750,112599,523603349,8,0,0,29184,12,963562886
10617,523512309,97451,523609760,1,0,0,20992,6,3851846080
10618,523528089,86678,523614767,1,0,0,16384,6,2028133192
10619,523714900,566,523715466,6,0,1,512,12,8135842715
10620,523731980,69308,523801288,4,0,0,13312,16,3797718356
10621,523764800,14287,523779087,4,0,1,27648,16,6675082832
10622,523769629,11404,523781033,8,0,1,3072,12,7662932488
10623,523862450,199264,524061714,9,0,0,29696,18,8296569501
10624,523891840,118352,524010192,4,0,0,88576,16,309510176
10625,523932480,79338,524011818,9,0,0,2048,18,8526305473
10626,524066240,73448,524139688,4,0,0,11776,16,2575972397
10627,524126680,43904,524170584,2,0,0,512,4,3174564588
10628,524159850,20882,524180732,7,0,1,33792,8,3895268738
10629,524161931,86032,524247963,6,0,0,15872,12,6549129289
10630,524265140,81128,524346268,8,0,0,11776,12,7035571042
10631,524279299,45596,524324895,7,0,0,1024,8,10158623237
10632,524284540,101348,524385888,5,0,0,32768,19,3859031179
10633,524390970,107432,524498402,3,0,0,52736,2,6114671824
10634,524401290,69620,524470910,8,0,0,14336,12,1146899537
10635,524412630,102440,524515070,2,0,0,36352,4,5516116093
10636,524491809,50489,524542298,7,0,0,512,8,1049082427
10637,524495791,109651,524605442,6,0,0,33280,12,10230979711
10638,524534449,6278,524540727,8,0,1,6656,12,8379122810
10639,524536059,86251,524622310,7,0,0,22016,8,3154799655
10640,524543770,111664,524655434,3,0,0,33792,2,6524061625
10641,524546460,80840,524627300,3,0,0,3072,2,1392022206
10642,524571961,83956,524655917,6,0,0,1536,12,9539306928
10643,524577790,88481,524666271,5,0,0,7680,19,7595549715
10644,524582540,6754,524589294,1,0,1,7168,6,485908609
10645,524613580,120424,524734004,9,0,0,43520,18,7925759088
10646,524686450,65900,524752350,8,0,0,7168,12,4282699489
10647,524704821,54056,524758877,6,0,0,3584,12,1271816902
10648,524752760,57908,524810668,9,0,0,6144,18,9269560377
10649,524879879,95288,524975167,1,0,0,17920,6,3056216800
10650,524884450,145017,525029467,3,0,0,34816,2,502417340
10651,524890200,90130,524980330,3,0,0,16896,2,5301427717
10652,524982719,135560,525118279,1,0,0,26624,6,7210430543
10653,525072631,90960,525163591,6,0,0,11776,12,7564014563
10654,525237530,3898,525241428,4,0,1,4096,16,9888697922
10655,525270150,72380,525342530,4,0,0,13312,16,7009986764
10656,525327779,103688,525431467,7,0,0,40448,8,10455930724
10657,525387400,132255,525519655,5,0,0,30208,19,10285474659
10658,525445219,1042,525446261,2,0,1,1024,4,6184208236
10659,525452300,70490,525522790,8,0,0,10240,12,3343549204
10660,525462460,95067,525557527,4,0,0,1024,16,417597509
10661,525691269,65900,525757169,7,0,0,7168,8,6038192383
10662,525704770,5454,525710224,5,0,1,13824,19,8317452411
10663,525770080,71000,525841080,2,0,0,13824,4,1155090197
10664,525794839,115643,525910482,1,0,0,33792,6,6698241090
10665,525811049,172639,525983688,7,0,0,46080,8,5754125606
10666,525893310,3422,525896732,4,0,1,3584,16,10620662891
10667,525904030,81545,525985575,4,0,0,6144,16,10042719485
10668,525947179,117078,526064257,1,0,0,34304,6,4778815270
10669,526028050,59132,526087182,3,0,0,5120,2,277319722
10670,526081190,65900,526147090,3,0,0,7168,2,4049379265
10671,526090580,158420,526249000,4,0,0,113664,16,761005323
10672,526127940,168754,526296694,4,0,0,57344,16,5773339755
10673,526224449,204263,526428712,7,0,0,54272,8,6635693635
10674,526233540,17488,526251028,6,0,1,2048,12,1133505281
10675,526237761,142555,526380316,6,0,0,51712,12,2326490953
10676,526268110,3898,526272008,9,0,1,4096,18,3284141146
10677,526270230,236484,526506714,8,0,0,74752,12,645270502
10678,526293580,147150,526440730,9,0,0,22016,18,5190231195
10679,526294799,230518,526525317,1,0,0,60928,6,1570974195
10680,526337200,15321,526352521,5,0,1,29696,19,8309934874
10681,526371180,101452,526472632,5,0,0,4608,19,7827294613
10682,526497590,42490,526540080,1,0,1,28672,6,7435879979
10683,526502710,101494,526604204,8,0,0,19968,12,63780283
10684,526503850,141838,526645688,4,0,0,54272,16,5149749031
10685,526571040,75755,526646795,3,0,0,3584,2,8766253832
10686,526692570,132576,526825146,8,0,0,14336,12,8501021057
10687,526702960,57440,526760400,4,0,0,4608,16,5681852309
10688,526775049,114452,526889501,7,0,0,75776,8,1573775020
10689,526829140,5802,526834942,6,0,1,6144,12,7460014490
10690,526918540,77744,526996284,5,0,0,10752,19,9285383361
10691,526985130,51726,527036856,8,0,0,512,12,791050239
10692,527159020,3645,527162665,9,0,1,10240,18,2082417824
10693,527161600,95769,527257369,4,0,0,27648,16,3544315650
10694,527340740,100100,527440840,5,0,0,28672,19,3103359101
10695,527384000,104877,527488877,2,0,0,24064,4,7712932305
10696,527384230,97292,527481522,4,0,0,19456,16,1139290685
10697,527412630,5326,527417956,0,0,1,5632,11,9380023234
10698,527431789,9066,527440855,3,0,1,1024,2,2117116123
10699,527458861,118181,527577042,6,0,0,33280,12,6058200269
10700,527476580,122830,527599410,5,0,0,20992,19,6435168709
10701,527520991,105716,527626707,6,0,0,47104,12,8063851802
10702,527578990,50746,527629736,9,0,0,1024,18,4541422216
10703,527584140,107373,527691513,2,0,0,36864,4,10172725746
10704,527611400,64158,527675558,2,0,0,4096,4,261601906
10705,527716750,5802,527722552,9,0,1,6144,18,4643498863
10706,527807850,70976,527878826,5,0,0,8704,19,8226015743
10707,528075780,3898,528079678,6,0,1,4096,12,5098481914
10708,528125691,169312,528295003,6,0,0,35328,12,8980147963
10709,528127109,566,528127675,2,0,1,512,4,5314081163
10710,528139629,95000,528234629,7,0,0,22016,8,2927000498
10711,528146490,137399,528283889,2,0,0,61952,4,2961885997
10712,528168611,115605,528284216,6,0,0,1024,12,6722735695
10713,528169110,4162,528173272,0,0,1,11264,11,10314367985
10714,528274610,78594,528353204,2,0,0,12288,4,9934343763
10715,528281860,17555,528299415,9,0,1,11776,18,9597925360
10716,528298620,12320,528310940,1,0,1,20480,6,665806856
10717,528391130,145416,528536546,2,0,0,24576,4,3033209948
10718,528453290,221573,528674863,2,0,0,28160,4,3124876535
10719,528485291,129453,528614744,6,0,0,53248,12,8455608602
10720,528553799,112229,528666028,7,0,0,16896,8,5059226321
10721,528585570,59132,528644702,3,0,0,5120,2,6548591010
10722,528692611,99320,528791931,6,0,0,26112,12,2373491313
10723,528733519,78860,528812379,1,0,0,15360,6,1546456401
10724,528794980,17414,528812394,7,0,1,28160,8,4933451126
10725,528807350,5059,528812409,1,0,1,9728,6,4533940074
10726,528827509,4374,528831883,2,0,1,4608,4,2796682642
10727,528863639,103220,528966859,7,0,0,38912,8,2788768971
10728,528908129,2470,528910599,8,0,1,2560,12,5932621218
10729,528916890,77744,528994634,9,0,0,10752,18,4995907749
10730,529012049,64208,529076257,7,0,0,6656,8,10033029352
10731,529071630,97760,529169390,4,0,0,20992,16,10302059285
10732,529105560,134653,529240213,5,0,0,12288,19,1643719078
10733,529130939,98072,529229011,1,0,0,22016,6,4325550967
10734,529165839,55907,529221746,1,0,0,3072,6,7293480916
10735,529248260,81440,529329700,5,0,0,12800,19,923376873
10736,529257320,82328,529339648,8,0,0,5120,12,8936619482
10737,529275500,116414,529391914,3,0,0,39424,2,5450044400
10738,529290469,3645,529294114,3,0,1,10240,2,2560815888
10739,529353561,87008,529440569,6,0,0,20992,12,9462788204
10740,529456640,12995,529469635,0,0,1,25088,11,5750003804
10741,529512290,74360,529586650,8,0,0,9728,12,10645128701
10742,529549991,97020,529647011,6,0,0,4608,12,2828855669
10743,529593890,66992,529660882,2,0,0,10752,4,599583129
10744,529805130,73136,529878266,4,0,0,10752,16,6154728523
10745,529819380,99476,529918856,2,0,0,26624,4,6109110417
10746,529856720,81776,529938496,4,0,0,18944,16,10690354885
10747,529860200,133406,529993606,4,0,0,37376,16,618246630
10748,530076640,4937,530081577,7,0,1,12800,8,4017696674
10749,530170059,51296,530221355,1,0,0,4608,6,6098339065
10750,530186029,114460,530300489,7,0,0,36352,8,7761314018
10751,530263660,95443,530359103,4,0,0,15872,16,6295350784
10752,530302771,140302,530443073,6,0,0,63488,12,3653811429
10753,530324880,121016,530445896,8,0,0,9216,12,5594784059
10754,530465399,12566,530477965,3,0,1,20992,2,8959601420
10755,530525770,210640,530736410,3,0,0,41472,2,3181599228
10756,530611499,60824,530672323,7,0,0,5632,8,388402666
10757,530660860,135100,530795960,3,0,0,24064,2,8539648522
10758,530797120,45596,530842716,3,0,0,1024,2,8952874024
10759,530854930,5196,530860126,0,0,1,13312,11,2970571349
10760,530860550,3422,530863972,1,0,1,3584,6,3629652927
10761,530865780,184211,531049991,3,0,0,64512,2,1311732300
10762,530931159,1518,530932677,8,0,1,1536,12,467381357
10763,530949590,191442,531141032,5,0,0,5632,19,5026864739
10764,530953700,104730,531058430,3,0,0,27648,2,7335812596
10765,531186630,5196,531191826,7,0,1,13312,8,3043339992
10766,531191661,99734,531291395,6,0,0,14336,12,1751764976
10767,531323980,6488,531330468,4,0,1,15872,16,2624404763
10768,531366179,69620,531435799,1,0,0,14336,6,5767802703
10769,531407340,127507,531534847,8,0,0,82432,12,10365041474
10770,531408501,165874,531574375,6,0,0,38400,12,3100228631
10771,531408799,2946,531411745,2,0,1,3072,4,6121170091
10772,531425240,2470,531427710,1,0,1,2560,6,4950983544
10773,531458430,130681,531589111,5,0,0,11264,19,3016100581
10774,531535810,3898,531539708,5,0,1,4096,19,2544653265
10775,531564900,125269,531690169,2,0,0,64512,4,10219828015
10776,531579149,47288,531626437,1,0,0,1536,6,4157010423
10777,531632140,5454,531637594,1,0,1,13824,6,10353265566
10778,531724139,6754,531730893,3,0,1,7168,2,852812769
10779,531727140,102752,531829892,5,0,0,37376,19,6066477343
10780,531744510,154430,531898940,9,0,0,17920,18,5072274877
10781,531764830,86320,531851150,3,0,0,10240,2,2005752665
10782,531772149,203117,531975266,1,0,0,40448,6,2475374774
10783,531794881,71002,531865883,6,0,0,6656,12,1431106829
10784,531807280,2870,531810150,7,0,1,8704,8,2383647538
10785,531890630,8325,531898955,9,0,1,4608,18,6051614275
10786,531898591,51028,531949619,6,0,0,2560,12,9528515518
10787,531919510,188533,532108043,9,0,0,34304,18,5454486834
10788,531986189,86384,532072573,7,0,0,18944,8,6786702737
10789,532018541,99362,532117903,6,0,0,15360,12,528503699
10790,532086189,4374,532090563,3,0,1,4608,2,9427518087
10791,532139309,4679,532143988,2,0,1,12288,4,10665848905
10792,532207500,55748,532263248,2,0,0,4096,4,9554284801
10793,532257569,2946,532260515,3,0,1,3072,2,1090080768
10794,532271300,52164,532323464,3,0,0,2048,2,1878725600
10795,532273870,85916,532359786,8,0,0,17408,12,7759880580
10796,532334040,5326,532339366,6,0,1,5632,12,1931680342
10797,532391200,99008,532490208,5,0,0,25088,19,9117171029
10798,532478530,101816,532580346,5,0,0,34304,19,4902692015
10799,532502420,125032,532627452,8,0,0,16384,12,5326965778
10800,532616980,117380,532734360,5,0,0,67584,19,5493879331
10801,532637631,101596,532739227,6,0,0,15872,12,9344272559
10802,532652980,102182,532755162,4,0,0,8704,16,1509487135
10803,532653769,1042,532654811,8,0,1,1024,12,4207774032
10804,532709170,30072,532739242,4,0,1,20992,16,9614780454
10805,532715959,95987,532811946,7,0,0,4096,8,4538522612
10806,532716219,24024,532740243,8,0,1,1024,12,4542715689
10807,532774730,155931,532930661,3,0,0,7168,2,5923083821
10808,532948020,102596,533050616,9,0,0,36864,18,5119162967
10809,532950049,114934,533064983,7,0,0,47104,8,5283424489
10810,532974600,128930,533103530,5,0,0,3584,19,10024632968
10811,532986380,180516,533166896,3,0,0,13824,2,1784194694
10812,533009930,206358,533216288,3,0,0,65024,2,8391901970
10813,533020290,74360,533094650,3,0,0,9728,2,2920073354
10814,533069329,156817,533226146,1,0,0,20992,6,8776520792
10815,533074949,7706,533082655,3,0,1,8192,2,3520487548
10816,533087050,132685,533219735,3,0,0,11264,2,8128216750
10817,533143980,3422,533147402,4,0,1,3584,16,7993724085
10818,533262260,110084,533372344,8,0,0,61440,12,1240009930
10819,533294840,136958,533431798,2,0,0,23552,4,4985686801
10820,533330520,85472,533415992,3,0,0,20992,2,9023890372
10821,533432820,91280,533524100,3,0,0,14848,2,4989052768
10822,533520090,73598,533593688,5,0,0,9216,19,5711908028
10823,533525930,5712,533531642,6,0,1,14336,12,9852187957
10824,533533260,62159,533595419,2,0,0,5632,4,10128698734
10825,533576640,43904,533620544,5,0,0,512,19,10018325699
10826,533583270,68335,533651605,9,0,0,10240,18,1118997522
10827,533599310,6278,533605588,0,0,1,6656,11,55211593
10828,533619400,104468,533723868,4,0,0,43008,16,7051008582
10829,533620230,161904,533782134,9,0,0,46592,18,9257229058
10830,533620850,261995,533882845,3,0,0,82432,2,1440057039
10831,533797091,45596,533842687,6,0,0,1024,12,10338478537
10832,533803180,176935,533980115,4,0,0,16896,16,8436527160
10833,533933280,78992,534012272,2,0,0,14848,4,2094623242
10834,534102110,48980,534151090,2,0,0,2048,4,1355824759
10835,534160299,3645,534163944,2,0,1,10240,4,8447958908
10836,534164119,159637,534323756,7,0,0,119296,8,8679262488
10837,534175009,3128,534178137,8,0,1,9216,12,8420969121
10838,534366350,103220,534469570,9,0,0,38912,18,147152486
10839,534378540,6278,534384818,9,0,1,6656,18,3116689676
10840,534412690,103844,534516534,4,0,0,40960,16,5069286680
10841,534419100,169236,534588336,9,0,0,48640,18,6423794738
10842,534517260,87136,534604396,8,0,0,9216,12,3101316194
10843,534692219,43904,534736123,7,0,0,512,8,9156588372
10844,534886479,64208,534950687,7,0,0,6656,8,9861061673
10845,534896200,73760,534969960,8,0,0,12800,12,1169468558
10846,534943900,110223,535054123,8,0,0,24576,12,9464873078
10847,534945390,5312,534950702,9,0,1,13312,18,563924332
10848,535081560,117983,535199543,2,0,0,50688,4,5380353535
10849,535099140,3898,535103038,9,0,1,4096,18,9927980319
10850,535240270,43904,535284174,3,0,0,512,2,1057512278
10851,535245440,105872,535351312,5,0,0,47616,19,341825148
10852,535450690,96092,535546782,4,0,0,25600,16,4169791040
10853,535475070,59132,535534202,3,0,0,5120,2,3070641359
10854,535683020,54056,535737076,4,0,0,3584,16,9868581860
10855,535765170,125996,535891166,8,0,0,113664,12,8501111953
10856,535768420,123393,535891813,9,0,0,2048,18,6739500629
10857,535804720,87732,535892452,8,0,0,2048,12,1104427373
10858,535807530,146684,535954214,2,0,0,15872,4,4191604092
10859,535856850,126836,535983686,9,0,0,18944,18,61685304
10860,535879620,89836,535969456,4,0,0,18432,16,1414542253
10861,535909399,74458,535983857,7,0,0,512,8,9901639744
10862,536049439,112892,536162331,7,0,0,70656,8,9470917699
10863,536145189,20521,536165710,3,0,1,9728,2,7357305974
10864,536225490,99032,536324522,8,0,0,30208,12,7363335582
10865,536235230,69284,536304514,2,0,0,8192,4,5437181740
10866,536257429,11016,536268445,2,0,1,17920,4,1234613028
10867,536258620,10811,536269431,5,0,1,1536,19,4291351809
10868,536269479,133085,536402564,7,0,0,58368,8,9202846817
10869,536272529,144405,536416934,7,0,0,3584,8,2582769066
10870,536304661,149794,536454455,6,0,0,32768,12,6516008258
10871,536340481,226162,536566643,6,0,0,30720,12,7370939718
10872,536349500,116967,536466467,8,0,0,6656,12,3451462252
10873,536414570,246501,536661071,3,0,0,34304,2,1614493508
10874,536433960,3387,536437347,0,0,1,9728,11,1200855265
10875,536444650,194863,536639513,3,0,0,36864,2,2240142243
10876,536529301,121303,536650604,6,0,0,36352,12,7535324184
10877,536590120,95563,536685683,4,0,0,15872,16,4337505899
10878,536650890,15975,536666865,9,0,1,6144,18,9169248147
10879,536699409,2946,536702355,3,0,1,3072,2,9122979496
10880,536755010,47288,536802298,8,0,0,1536,12,10025276660
10881,536777590,123186,536900776,4,0,0,96768,16,6296907124
10882,536823880,86000,536909880,3,0,0,7168,2,10432223225
10883,536909710,102134,537011844,4,0,0,34816,16,8861267468
10884,536909790,3053,536912843,9,0,1,3072,18,1952681128
10885,537020620,84751,537105371,3,0,0,11264,2,6726264723
10886,537042660,137189,537179849,2,0,0,32768,4,5445077663
10887,537105550,108781,537214331,2,0,0,8704,4,7374879920
10888,537135650,55748,537191398,9,0,0,4096,18,7700385168
10889,537169009,10855,537179864,8,0,1,7680,12,2372160750
10890,537258181,63296,537321477,6,0,0,8704,12,1980070427
10891,537274199,114838,537389037,7,0,0,69120,8,8436538077
10892,537317930,3562,537321492,0,0,1,3584,11,3923993899
10893,537325181,109610,537434791,6,0,0,8192,12,2335347181
10894,537362999,26053,537389052,3,0,1,7680,2,3106717812
10895,537451499,54056,537505555,7,0,0,3584,8,10293148754
10896,537530330,102440,537632770,2,0,0,36352,4,9971279976
10897,537740099,566,537740665,2,0,1,512,4,2207021973
10898,537795070,77900,537872970,5,0,0,11264,19,5322425341
10899,537830491,101504,537931995,6,0,0,33280,12,6566322038
10900,537997440,12308,538009748,6,0,1,20480,12,7942585103
10901,538027860,90938,538118798,2,0,0,3584,4,6464486648
10902,538053990,197888,538251878,3,0,0,9728,2,3104422134
10903,538116449,132442,538248891,7,0,0,2048,8,4212176899
10904,538122510,125742,538248252,4,0,0,111616,16,1800433231
10905,538122880,151066,538273946,2,0,0,35840,4,8245746092
10906,538220060,124471,538344531,5,0,0,29184,19,9060994432
10907,538264350,156507,538420857,2,0,0,51712,4,1822999664
10908,538363380,107744,538471124,2,0,0,53760,4,504434108
10909,538398559,22313,538420872,3,0,1,24064,2,7611227777
10910,538426800,10757,538437557,1,0,1,17408,6,10240931640
10911,538475011,56840,538531851,6,0,0,7680,12,8905627669
10912,538675540,100256,538775796,9,0,0,29184,18,1608717398
10913,538758380,106852,538865232,9,0,0,23040,18,8096322479
10914,538809980,135682,538945662,8,0,0,14336,12,6027038566
10915,538821940,99164,538921104,5,0,0,25600,19,1743579770
10916,538830430,1042,538831472,0,0,1,1024,11,4150978219
10917,538853080,111902,538964982,5,0,0,7168,19,2279636867
10918,539038851,65900,539104751,6,0,0,7168,12,1261045477
10919,539041300,7706,539049006,5,0,1,8192,19,10482916459
10920,539094830,1994,539096824,5,0,1,2048,19,7450843932
10921,539170960,110708,539281668,9,0,0,63488,18,7190643818
10922,539198359,11016,539209375,2,0,1,17920,4,115695481
10923,539200679,11602,539212281,8,0,1,4608,12,1573893984
10924,539287059,90104,539377163,7,0,0,26112,8,3754570118
10925,539402670,109307,539511977,5,0,0,31744,19,3135952609
10926,539405790,4420,539410210,9,0,1,11776,18,165015570
10927,539449121,100880,539550001,6,0,0,31232,12,606672455
10928,539464530,94532,539559062,9,0,0,20480,18,4389274260
10929,539496460,2946,539499406,1,0,1,3072,6,7188685867
10930,539593360,14545,539607905,5,0,1,28160,19,4447303186
10931,539596190,90311,539686501,5,0,0,12800,19,5934247778
10932,539636280,213259,539849539,2,0,0,15872,4,5357566379
10933,539655350,3904,539659254,7,0,1,10752,8,9384564766
10934,539683799,6116,539689915,8,0,1,3584,12,10404088029
10935,539743930,3645,539747575,9,0,1,10240,18,8667459709
10936,539783150,180539,539963689,2,0,0,14336,4,7871580019
10937,539855150,104156,539959306,2,0,0,41984,4,6945367447
10938,539999280,110552,540109832,3,0,0,62976,2,9390151592
10939,540043089,1994,540045083,3,0,1,2048,2,6027734062
10940,540085251,64208,540149459,6,0,0,6656,12,2964693168
10941,540095050,18419,540113469,7,0,1,10240,8,5217226360
10942,540123370,105475,540228845,4,0,0,44032,16,4940866502
10943,540183610,106184,540289794,2,0,0,48640,4,2030426916
10944,540304250,76676,540380926,8,0,0,12288,12,6940653689
10945,540356560,5454,540362014,5,0,1,13824,19,6282631381
10946,540370270,66056,540436326,8,0,0,7680,12,754050578
10947,540374280,93596,540467876,9,0,0,17408,18,6011863641
10948,540379720,213153,540592873,2,0,0,92160,4,6009255980
10949,540596309,99788,540696097,1,0,0,27648,6,2113805406
10950,540601330,110757,540712087,2,0,0,23552,4,165843863
10951,540630401,135003,540765404,6,0,0,15872,12,1343053095
10952,540674810,7706,540682516,9,0,1,8192,18,3139366937
10953,540688071,140723,540828794,6,0,0,31232,12,5923309562
10954,540692970,74945,540767915,2,0,0,8192,4,1994450054
10955,540784200,104972,540889172,2,0,0,26624,4,4219069219
10956,540789711,125039,540914750,6,0,0,3584,12,9231310826
10957,540822870,95769,540918639,2,0,0,2048,4,6504889651
10958,540843910,7230,540851140,4,0,1,7680,16,8417231950
10959,540873470,62516,540935986,5,0,0,6144,19,2741021793
10960,540875820,97522,540973342,4,0,0,12800,16,7924541787
10961,540944580,90850,541035430,2,0,0,11776,4,4947566663
10962,540962399,3422,540965821,2,0,1,3584,4,10442984507
10963,540985310,4850,540990160,0,0,1,5120,11,4018716694
10964,541025080,50672,541075752,4,0,0,2560,16,2773197422
10965,541039529,138913,541178442,7,0,0,111616,8,1864842459
10966,541063131,185593,541248724,6,0,0,29184,12,9186661915
10967,541069850,111735,541181585,9,0,0,10240,18,7846345232
10968,541095059,2470,541097529,3,0,1,2560,2,6145103396
10969,541113789,70151,541183940,7,0,0,7680,8,5095684497
10970,541141070,98747,541239817,8,0,0,22528,12,9423238122
10971,541148790,41597,541190387,7,0,1,15872,8,280400757
10972,541194740,125328,541320068,5,0,0,11776,19,200523376
10973,541212000,43904,541255904,3,0,0,512,2,4536275405
10974,541214770,249674,541464444,4,0,0,33792,16,2816395264
10975,541216850,7230,541224080,4,0,1,7680,16,9393332876
10976,541219450,204698,541424148,2,0,0,58880,4,7943147235
10977,541279370,126823,541406193,3,0,0,56320,2,1340573021
10978,541322301,145746,541468047,6,0,0,11776,12,419707227
10979,541339690,2946,541342636,1,0,1,3072,6,3024329846
10980,541362430,107972,541470402,8,0,0,7680,12,6322364675
10981,541370670,180860,541551530,4,0,0,52224,16,7886548942
10982,541372970,1994,541374964,6,0,1,2048,12,8580877283
10983,541548750,16630,541565380,0,0,1,23552,11,5499926106
10984,541580240,4850,541585090,0,0,1,5120,11,5693939478
10985,541606979,12995,541619974,2,0,1,25088,4,835918043
10986,541662810,150360,541813170,4,0,0,23040,16,6289561079
10987,541712920,148134,541861054,8,0,0,13312,12,7619961884
10988,541714610,90992,541805602,3,0,0,18944,2,9714292320
10989,541759050,178954,541938004,8,0,0,37888,12,8698592505
10990,541931220,60832,541992052,4,0,0,3584,16,8646883076
10991,541960410,67592,542028002,8,0,0,7680,12,6196102222
10992,541963690,103284,542066974,4,0,0,21504,16,615520257
10993,542013461,133739,542147200,6,0,0,56832,12,2416694709
10994,542027010,145102,542172112,9,0,0,15360,18,5881843409
10995,542082429,5802,542088231,8,0,1,6144,12,7325311804
10996,542127671,144791,542272462,6,0,0,116736,12,9102577260
10997,542167870,155321,542323191,8,0,0,14336,12,2047580306
10998,542184320,95660,542279980,4,0,0,9216,16,10549619642
10999,542312270,4850,542317120,7,0,1,5120,8,7732065507
11000,542402519,99476,542501995,7,0,0,26624,8,7718046748
11001,542431829,1042,542432871,8,0,1,1024,12,3978666125
11002,542486540,3387,542489927,1,0,1,9728,6,8897550358
11003,542515790,4374,542520164,7,0,1,4608,8,8356180823
11004,542538350,3645,542541995,6,0,1,10240,12,4545225485
11005,542549979,3387,542553366,8,0,1,9728,12,2052137081
11006,542564389,120199,542684588,7,0,0,60416,8,1897886025
11007,542585170,1994,542587164,4,0,1,2048,16,6106879939
11008,542585701,71497,542657198,6,0,0,9728,12,4107846614
11009,542597030,172495,542769525,2,0,0,8192,4,4804600668
11010,542626260,127221,542753481,8,0,0,26112,12,3657433422
11011,542763780,6278,542770058,7,0,1,6656,8,1131690110
11012,542776480,123385,542899865,2,0,0,83456,4,4910329876
11013,542945419,108056,543053475,7,0,0,54784,8,6906286275
11014,542947759,2470,542950229,8,0,1,2560,12,4157953034
11015,543062359,70976,543133335,7,0,0,8704,8,5750053056
11016,543075201,121020,543196221,6,0,0,47616,12,5687250037
11017,543340660,2946,543343606,4,0,1,3072,16,7565648164
11018,543349509,91748,543441257,1,0,0,16384,6,3822073596
11019,543438699,113102,543551801,7,0,0,62976,8,9903117236
11020,543446239,5196,543451435,8,0,1,13312,12,3184765166
11021,543507630,111311,543618941,5,0,0,18944,19,8001284720
11022,543694790,71000,543765790,9,0,0,13824,18,8921233132
11023,543721030,126054,543847084,4,0,0,47616,16,9125265776
11024,543772360,2470,543774830,7,0,1,2560,8,6546600086
11025,543871701,117884,543989585,6,0,0,87040,12,6080340310
11026,543999100,54524,544053624,4,0,0,5120,16,10107013944
11027,544045270,1518,544046788,7,0,1,1536,8,7629711555
11028,544061069,3128,544064197,8,0,1,9216,12,9948963133
11029,544099470,68372,544167842,5,0,0,10240,19,5767513359
11030,544107340,65900,544173240,8,0,0,7168,12,9435391005
11031,544154510,52364,544206874,3,0,0,3072,2,4424028654
11032,544230280,88520,544318800,3,0,0,15872,2,4654237626
11033,544351080,60824,544411904,4,0,0,5632,16,10038500896
11034,544387340,87462,544474802,5,0,0,14336,19,1363666718
11035,544454080,6754,544460834,0,0,1,7168,11,2319740819
11036,544469880,4937,544474817,7,0,1,8704,8,2204518296
11037,544598500,106652,544705152,2,0,0,50176,4,1908557259
11038,544644679,121199,544765878,7,0,0,21504,8,4258268405
11039,544712520,90654,544803174,3,0,0,512,2,10351278396
11040,544793170,2870,544796040,7,0,1,8704,8,2796170947
11041,544809660,59326,544868986,2,0,0,5120,4,858992162
11042,544814970,97760,544912730,5,0,0,20992,19,905697847
11043,544851720,124639,544976359,5,0,0,3584,19,2469612236
11044,544930110,79436,545009546,9,0,0,11264,18,6760021056
11045,544935890,69284,545005174,4,0,0,8192,16,5244261739
11046,545052250,81464,545133714,2,0,0,17920,4,6149001936
11047,545061389,4850,545066239,8,0,1,5120,12,1787736992
11048,545063810,75920,545139730,9,0,0,14848,18,1054472013
11049,545109570,4679,545114249,7,0,1,12288,8,10629795631
11050,545229300,105327,545334627,2,0,0,15360,4,7905645877
11051,545235410,10499,545245909,0,0,1,16896,11,7807976566
11052,545261560,111635,545373195,4,0,0,51200,16,950746335
11053,545340789,181414,545522203,7,0,0,67072,8,3149229670
11054,545371949,1804,545373753,8,0,1,512,12,5174775550
11055,545378990,2946,545381936,7,0,1,3072,8,9671191789
11056,545395320,128941,545524261,8,0,0,6656,12,4007092859
11057,545395880,105872,545501752,4,0,0,47616,16,8020391425
11058,545441130,101806,545542936,4,0,0,4096,16,1746558447
11059,545482370,39848,545522218,0,0,1,15872,11,3856514830
11060,545520040,102909,545622949,8,0,0,24064,12,4802012731
11061,545612970,80552,545693522,2,0,0,19968,4,3385913898
11062,545645550,130694,545776244,3,0,0,63488,2,2413942545
11063,545663790,5802,545669592,7,0,1,6144,8,4467768607
11064,545723640,5712,545729352,5,0,1,14336,19,3282037492
11065,545768960,12126,545781086,0,0,1,5120,11,4418963753
11066,545784600,89457,545874057,2,0,0,7680,4,10178309564
11067,545838680,77300,545915980,5,0,0,14336,19,513904460
11068,545847099,70456,545917555,7,0,0,5120,8,1327336973
11069,545913669,75710,545989379,7,0,0,9728,8,2994268559
11070,545916810,7040,545923850,7,0,1,6656,8,6395924867
11071,545954890,118297,546073187,2,0,0,15360,4,2903399931
11072,546027290,121784,546149074,5,0,0,99840,19,2173700642
11073,546052090,107022,546159112,5,0,0,5632,19,3923731073
11074,546079869,118657,546198526,7,0,0,17920,8,1712457458
11075,546111311,127445,546238756,6,0,0,7680,12,7733070339
11076,546179469,82820,546262289,7,0,0,12288,8,9895564964
11077,546264950,45596,546310546,3,0,0,1024,2,7719389816
11078,546362570,5196,546367766,0,0,1,13312,11,4172320556
11079,546437719,1042,546438761,8,0,1,1024,12,7663392839
11080,546482839,1994,546484833,8,0,1,2048,12,6864362704
11081,546498110,75608,546573718,9,0,0,13824,18,7337577301
11082,546514490,140318,546654808,9,0,0,17408,18,3215662671
11083,546564260,69464,546633724,8,0,0,13824,12,10673248239
11084,546817140,13858,546830998,9,0,1,23552,18,4974832594
11085,546890849,45596,546936445,7,0,0,1024,8,4709274090
11086,546949190,101660,547050850,4,0,0,33792,16,3008248576
11087,546958530,179434,547137964,3,0,0,96768,2,2184295036
11088,547106160,31819,547137979,7,0,1,13824,8,2581382445
11089,547130600,10317,547140917,0,0,1,3072,11,1061712322
11090,547194020,125497,547319517,4,0,0,11776,16,1866245158
11091,547311860,10241,547322101,1,0,1,16384,6,832049385
11092,547395541,62516,547458057,6,0,0,6144,12,10371096196
11093,547511620,65900,547577520,3,0,0,7168,2,484054656
11094,547605540,94064,547699604,9,0,0,18944,18,1012647266
11095,547609290,57440,547666730,8,0,0,4608,12,2728383826
11096,547738930,50672,547789602,2,0,0,2560,4,7091245006
11097,547756890,60380,547817270,8,0,0,9216,12,8753191762
11098,547800050,88076,547888126,2,0,0,19456,4,9665801442
11099,548044820,47288,548092108,8,0,0,1536,12,5754114919
11100,548049320,47288,548096608,3,0,0,1536,2,711926952
11101,548115800,566,548116366,0,0,1,512,11,9792812258
11102,548246391,72980,548319371,6,0,0,10240,12,487047054
11103,548339810,83444,548423254,8,0,0,14336,12,4874057210
11104,548341359,6229,548347588,2,0,1,15360,4,5749075304
11105,548353970,70134,548424104,2,0,0,512,4,4364458851
11106,548521789,45752,548567541,7,0,0,1536,8,4826606685
11107,548555400,64988,548620388,2,0,0,9216,4,1661109427
11108,548624421,59600,548684021,6,0,0,6656,12,1179048189
11109,548649080,55748,548704828,5,0,0,4096,19,9524621631
11110,548667610,91748,548759358,8,0,0,16384,12,2118416220
11111,548767991,108902,548876893,6,0,0,31232,12,4875288088
11112,548770749,113959,548884708,7,0,0,25600,8,10577388126
11113,548771449,67928,548839377,7,0,0,13824,8,3979314129
11114,548814420,107269,548921689,5,0,0,4608,19,3440146941
11115,548836479,8692,548845171,3,0,1,6144,2,3331495299
11116,548905149,4374,548909523,3,0,1,4608,2,4961691923
11117,548967260,70976,549038236,4,0,0,8704,16,3439024166
11118,549001120,98010,549099130,3,0,0,15872,2,1801309735
11119,549012380,55748,549068128,9,0,0,4096,18,5084085232
11120,549017240,127970,549145210,4,0,0,15872,16,382475554
11121,549018641,185081,549203722,6,0,0,46592,12,3033820171
11122,549069890,1518,549071408,6,0,1,1536,12,2657993836
11123,549113919,65900,549179819,7,0,0,7168,8,363681290
11124,549183600,52364,549235964,5,0,0,3072,19,7428423661
11125,549214380,566,549214946,1,0,1,512,6,9402467234
11126,549231670,100256,549331926,9,0,0,29184,18,8993440366
11127,549254379,119721,549374100,7,0,0,40448,8,6720104410
11128,549334930,5326,549340256,1,0,1,5632,6,1468459751
11129,549363241,116723,549479964,6,0,0,47616,12,6456147019
11130,549368479,10834,549379313,2,0,1,13312,4,8871087925
11131,549385010,13512,549398522,6,0,1,26112,12,7144438240
11132,549389270,52725,549441995,5,0,0,2048,19,8935729821
11133,549477959,82525,549560484,7,0,0,14848,8,8445170229
11134,549554720,5779,549560499,7,0,1,12288,8,10106874378
11135,549667480,62161,549729641,9,0,0,4608,18,6852919887
11136,549709161,98072,549807233,6,0,0,22016,12,5687936981
11137,549763930,63608,549827538,8,0,0,9728,12,6820996918
11138,549791000,100412,549891412,5,0,0,29696,19,5601287060
11139,549797581,110381,549907962,6,0,0,14336,12,461535240
11140,549898679,102596,550001275,7,0,0,36864,8,10724286978
11141,549986240,2470,549988710,6,0,1,2560,12,6658178825
11142,549999930,99565,550099495,2,0,0,22528,4,5755118422
11143,550014699,207302,550222001,7,0,0,116736,8,670705535
11144,550035760,4162,550039922,7,0,1,11264,8,5837684089
11145,550050610,92527,550143137,2,0,0,4608,4,7602390310
11146,550098360,129584,550227944,9,0,0,19456,18,5138361658
11147,550315470,100256,550415726,8,0,0,29184,12,8024004106
11148,550334420,91796,550426216,8,0,0,26624,12,7945299138
11149,550414610,125845,550540455,8,0,0,40448,12,1898345575
11150,550416799,76052,550492851,7,0,0,10240,8,8329045861
11151,550462131,114685,550576816,6,0,0,12288,12,1633424338
11152,550503651,77392,550581043,6,0,0,13824,12,5467168054
11153,550537760,110930,550648690,5,0,0,35328,19,7957018751
11154,550579100,219672,550798772,4,0,0,69632,16,183330144
11155,550580880,218851,550799731,4,0,0,3072,16,9914721890
11156,550616730,98072,550714802,2,0,0,22016,4,3827404628
11157,550785021,79643,550864664,6,0,0,7168,12,783532712
11158,550797420,100375,550897795,2,0,0,22016,4,9773955194
11159,550832460,2470,550834930,0,0,1,2560,11,9962319622
11160,550887120,1042,550888162,5,0,1,1024,19,9466482933
11161,550929219,566,550929785,3,0,1,512,2,2923348003
11162,551025220,79748,551104968,4,0,0,12288,16,8264479558
11163,551149770,90104,551239874,9,0,0,26112,18,3704361861
11164,551222730,58220,551280950,8,0,0,7168,12,5863911321
11165,551339231,114296,551453527,6,0,0,75264,12,5053152430
11166,551492030,11274,551503304,0,0,1,18432,11,1636580431
11167,551648350,92708,551741058,4,0,0,24576,16,3166184907
11168,551754630,79436,551834066,8,0,0,11264,12,9410814975
11169,551807550,64208,551871758,5,0,0,6656,19,5994205867
11170,551819900,61916,551881816,4,0,0,9216,16,9581757301
11171,551821320,111604,551932924,2,0,0,66048,4,2618799331
11172,551838441,118975,551957416,6,0,0,15360,12,8300690723
11173,551841340,2470,551843810,7,0,1,2560,8,4588299126
11174,551841491,98231,551939722,6,0,0,1536,12,1207545616
11175,551924489,12325,551936814,8,0,1,4096,12,5885578064
11176,551996690,1042,551997732,5,0,1,1024,19,10428890175
11177,552124810,22174,552146984,9,0,1,36352,18,5449145609
11178,552137570,189785,552327355,8,0,0,9216,12,8774845171
11179,552164750,102440,552267190,9,0,0,36352,18,5897859422
11180,552174510,70029,552244539,2,0,0,5120,4,7992671537
11181,552215871,82376,552298247,6,0,0,15872,12,3052982743
11182,552357950,45596,552403546,0,0,0,1024,11,9341002947
11183,552401449,108378,552509827,7,0,0,43520,8,9641808144
11184,552403580,90836,552494416,8,0,0,18432,12,3795322243
11185,552405440,3128,552408568,6,0,1,9216,12,5868877367
11186,552509120,47987,552557107,3,0,0,1536,2,525241198
11187,552581900,4374,552586274,1,0,1,4608,6,10524030995
11188,552674420,137118,552811538,8,0,0,5632,12,6578172316
11189,552681059,89612,552770671,7,0,0,19456,8,10658007184
11190,552697279,1994,552699273,2,0,1,2048,4,7258432100
11191,552733731,76076,552809807,6,0,0,15360,12,272221685
11192,552737870,83600,552821470,2,0,0,14848,4,2450735802
11193,552741210,154909,552896119,0,0,0,60928,11,286254418
11194,552837770,59612,552897382,3,0,0,4096,2,8757190179
11195,552865399,7706,552873105,8,0,1,8192,12,6279109391
11196,553029449,10499,553039948,3,0,1,16896,2,6320797378
11197,553146560,69908,553216468,3,0,0,10240,2,1067000284
11198,553200230,21658,553221888,5,0,1,35328,19,4755744678
11199,553215680,148367,553364047,3,0,0,39936,2,1279569583
11200,553216409,7105,553223514,8,0,1,2560,12,8267801857
11201,553318380,2870,553321250,6,0,1,8704,12,8775031141
11202,553394980,48980,553443960,8,0,0,2048,12,10706457403
11203,553418840,52364,553471204,2,0,0,3072,4,9188126990
11204,553526611,105872,553632483,6,0,0,47616,12,5368289634
11205,553610889,104624,553715513,7,0,0,43520,8,9429264104
11206,553650529,5326,553655855,8,0,1,5632,12,8656743125
11207,553658019,111794,553769813,7,0,0,12800,8,5764429939
11208,553835859,98072,553933931,1,0,0,22016,6,9192762710
11209,553867300,145627,554012927,4,0,0,16896,16,9872639108
11210,553912919,4850,553917769,2,0,1,5120,4,9521882852
11211,554006021,57752,554063773,6,0,0,5632,12,7439947963
11212,554166599,69776,554236375,7,0,0,14848,8,2906377489
11213,554427980,55748,554483728,2,0,0,4096,4,5201539712
11214,554494439,4374,554498813,8,0,1,4608,12,7208407340
11215,554506240,72848,554579088,0,0,0,14848,11,10641042831
11216,554687560,109772,554797332,0,0,0,60416,11,3460466205
11217,554730290,5802,554736092,0,0,1,6144,11,4803243784
11218,554734839,103689,554838528,7,0,0,12800,8,3586243455
11219,554782610,127762,554910372,8,0,0,71168,12,8660324804
11220,554851180,99788,554950968,3,0,0,27648,2,1098717760
11221,554852690,141736,554994426,0,0,0,17920,11,6550425173
11222,554874141,178485,555052626,6,0,0,47616,12,10546700885
11223,554953620,133416,555087036,8,0,0,8192,12,4676292447
11224,554994870,138036,555132906,4,0,0,21504,16,10350395631
11225,555049100,7416,555056516,5,0,1,4096,19,7163411550
11226,555137829,108056,555245885,7,0,0,54784,8,4593144727
11227,555159529,566,555160095,2,0,1,512,4,8700042088
11228,555213151,100810,555313961,6,0,0,13824,12,4423665670
11229,555254479,5454,555259933,3,0,1,13824,2,9230700310
11230,555263480,134390,555397870,5,0,0,10240,19,10352494356
11231,555321760,70844,555392604,3,0,0,13312,2,2414668175
11232,555329000,88208,555417208,0,0,0,14848,11,9504910433
11233,555451680,69908,555521588,8,0,0,10240,12,8290955180
11234,555466060,57103,555523163,8,0,0,5120,12,3216723928
11235,555525150,45596,555570746,4,0,0,1024,16,6618804344
11236,555535250,50672,555585922,0,0,0,2560,11,2292651715
11237,555557969,67748,555625717,1,0,0,8192,6,4999867887
11238,555568179,67592,555635771,1,0,0,7680,6,1467547601
11239,555600969,2870,555603839,8,0,1,8704,12,8032061848
11240,555683870,5971,555689841,7,0,1,14848,8,1532973432
11241,555765611,181952,555947563,6,0,0,17920,12,10227006066
11242,555787779,66992,555854771,7,0,0,10752,8,9282895413
11243,555841520,100568,555942088,5,0,0,30208,19,5955205173
11244,555884390,119918,556004308,8,0,0,50688,12,4356203187
11245,555951280,86400,556037680,9,0,0,11776,18,4412022142
11246,555988359,78680,556067039,1,0,0,13824,6,7093716424
11247,556153520,6278,556159798,7,0,1,6656,8,2865846657
11248,556263849,5802,556269651,2,0,1,6144,4,180463365
11249,556284389,71965,556356354,1,0,0,3072,6,240192692
11250,556303990,54056,556358046,8,0,0,3584,12,2085620199
11251,556353091,100412,556453503,6,0,0,29696,12,4473289226
11252,556422781,64634,556487415,6,0,0,7680,12,8314276497
11253,556524959,4850,556529809,3,0,1,5120,2,2251658400
11254,556531040,65900,556596940,4,0,0,7168,16,9510906824
11255,556598200,236252,556834452,4,0,0,22016,16,2051528866
11256,556634320,61292,556695612,4,0,0,7168,16,7207310770
11257,556640710,134660,556775370,8,0,0,40960,12,1881318305
11258,556671610,73292,556744902,5,0,0,11264,19,5587939916
11259,556769360,7520,556776880,6,0,1,1536,12,5453870507
11260,556848660,1042,556849702,6,0,1,1024,12,9057750086
11261,556982480,47288,557029768,4,0,0,1536,16,2732128072
11262,557015720,4374,557020094,5,0,1,4608,19,227913226
11263,557023070,3422,557026492,9,0,1,3584,18,7945477665
11264,557044340,206265,557250605,5,0,0,91648,19,1945190793
11265,557126740,145753,557272493,0,0,0,42496,11,10215913731
11266,557128500,84136,557212636,4,0,0,13312,16,3143061209
11267,557212289,116483,557328772,1,0,0,34304,6,299997628
11268,557265530,69471,557335001,8,0,0,6144,12,5240052270
11269,557293970,118514,557412484,9,0,0,19456,18,9024083581
11270,557319800,66404,557386204,5,0,0,4608,19,1275984386
11271,557343660,72668,557416328,5,0,0,9216,19,3444948514
11272,557353290,63989,557417279,8,0,0,3072,12,7004009228
11273,557473450,11533,557484983,7,0,1,18944,8,3047330996
11274,557548230,87320,557635550,9,0,0,22016,18,2396890118
11275,557569710,77768,557647478,5,0,0,15872,19,6985905545
11276,557589031,47288,557636319,6,0,0,1536,12,10572115388
11277,557743550,67592,557811142,8,0,0,7680,12,198634757
11278,557918610,58220,557976830,3,0,0,7168,2,2561662998
11279,557936830,104000,558040830,8,0,0,41472,12,6978624364
11280,557974280,105248,558079528,3,0,0,45568,2,10248348394
11281,557977210,137132,558114342,4,0,0,13312,16,9161263585
11282,558082950,89456,558172406,8,0,0,18944,12,3197045237
11283,558148470,4374,558152844,5,0,1,4608,19,7000369731
11284,558475020,52520,558527540,9,0,0,3584,18,405361823
11285,558632060,79436,558711496,5,0,0,11264,19,949056006
11286,558635050,43904,558678954,4,0,0,512,16,898762185
11287,558662480,80366,558742846,2,0,0,7168,4,4944384567
11288,558706870,100100,558806970,0,0,0,28672,11,979361004
11289,558749420,114336,558863756,3,0,0,4608,2,4746713999
11290,558762081,100256,558862337,6,0,0,29184,12,4750654286
11291,558891580,116792,559008372,5,0,0,83456,19,821279847
11292,558898850,123946,559022796,8,0,0,14848,12,4714975367
11293,559019009,89563,559108572,1,0,0,22016,6,3224301863
11294,559110749,100724,559211473,1,0,0,30720,6,5631322952
11295,559315390,108836,559424226,0,0,0,57344,11,10036907147
11296,559324100,202393,559526493,8,0,0,86016,12,2191051871
11297,559359120,105330,559464450,2,0,0,5632,4,9198569043
11298,559418000,82270,559500270,0,0,0,10240,11,7150578439
11299,559463130,94632,559557762,4,0,0,7168,16,1837023254
11300,559515019,94286,559609305,7,0,0,12288,8,3195644388
11301,559576920,147816,559724736,3,0,0,75264,2,7654471770
11302,559602760,50672,559653432,0,0,0,2560,11,8224868202
11303,559631380,136115,559767495,3,0,0,18944,2,6115070228
11304,559731120,55748,559786868,9,0,0,4096,18,9333375726
11305,559844590,78680,559923270,3,0,0,13824,2,2584387545
11306,559873200,50553,559923753,0,0,0,1536,11,1823636948
11307,559882349,94712,559977061,1,0,0,26112,6,7360200832
11308,559962901,104156,560067057,6,0,0,41984,12,3711670810
11309,560029230,59756,560088986,9,0,0,7168,18,7855871961
11310,560066609,1499,560068108,8,0,1,1024,12,4111449734
11311,560066749,109473,560176222,1,0,0,58368,6,2326772924
11312,560117330,63920,560181250,5,0,0,2048,19,5599777977
11313,560150419,25818,560176237,3,0,1,18432,2,528061847
11314,560165629,31741,560197370,8,0,1,34304,12,5174255303
11315,560242269,75476,560317745,1,0,0,18432,6,9528242026
11316,560270070,106211,560376281,4,0,0,6656,16,6565825444
11317,560313570,105011,560418581,2,0,0,19456,4,3155955878
11318,560483720,125840,560609560,9,0,0,113152,18,10176765592
11319,560593041,132991,560726032,6,0,0,82432,12,7398507790
11320,560633680,3422,560637102,5,0,1,3584,19,10404859169
11321,560664870,3898,560668768,4,0,1,4096,16,4750036227
11322,560717520,87940,560805460,3,0,0,11264,2,6516994685
11323,560805190,100362,560905552,2,0,0,28672,4,6095439892
11324,560901789,4321,560906110,8,0,1,512,12,2464397707
11325,560911140,112580,561023720,3,0,0,69632,2,6524168840
11326,560912700,2870,560915570,1,0,1,8704,6,6445360227
11327,561129360,81464,561210824,9,0,0,17920,18,2958222130
11328,561183900,1042,561184942,1,0,1,1024,6,8644216642
11329,561259631,81128,561340759,6,0,0,11776,12,10030916868
11330,561291850,566,561292416,9,0,1,512,18,8670562457
11331,561303080,86204,561389284,3,0,0,13312,2,10361294782
11332,561408680,102128,561510808,9,0,0,35328,18,8061812377
11333,561494531,109184,561603715,6,0,0,50176,12,10030646712
11334,561506090,82322,561588412,8,0,0,15360,12,7658380595
11335,561547000,68133,561615133,5,0,0,4096,19,3050239962
11336,561561270,136431,561697701,9,0,0,36352,18,6759556653
11337,561571890,63764,561635654,9,0,0,10240,18,3227909399
11338,561606370,80240,561686610,2,0,0,18944,4,2138031306
11339,561654411,68733,561723144,6,0,0,6656,12,9184588742
11340,561705551,75577,561781128,6,0,0,8192,12,8498673110
11341,561710251,132425,561842676,6,0,0,64000,12,4189284464
11342,561713400,89900,561803300,4,0,0,15360,16,829122846
11343,561724420,179474,561903894,0,0,0,107520,11,6857305557
11344,561946390,78368,562024758,4,0,0,12800,16,1238543228
11345,561972579,3422,561976001,3,0,1,3584,2,761523422
11346,562015910,123188,562139098,2,0,0,104448,4,5787992106
11347,562025361,137305,562162666,6,0,0,20480,12,10711651994
11348,562076809,4374,562081183,8,0,1,4608,12,4560045782
11349,562111601,103541,562215142,6,0,0,10240,12,4792522532
11350,562144250,98234,562242484,8,0,0,3072,12,4777803551
11351,562175840,60824,562236664,3,0,0,5632,2,8964361824
11352,562213830,135616,562349446,3,0,0,39424,2,2575559111
11353,562215350,107960,562323310,9,0,0,35328,18,1348308737
11354,562233320,119729,562353049,4,0,0,11776,16,9625504568
11355,562244240,190089,562434329,2,0,0,27136,4,4812350645
11356,562273019,11016,562284035,2,0,1,17920,4,8947143891
11357,562280250,4144,562284394,1,0,1,9728,6,8232904933
11358,562286660,126590,562413250,3,0,0,25600,2,802622327
11359,562291080,122653,562413733,5,0,0,1536,19,8241866814
11360,562315331,150401,562465732,6,0,0,20480,12,6228279915
11361,562428540,16022,562444562,5,0,1,16384,19,266791756
11362,562558290,60824,562619114,3,0,0,5632,2,7643816236
11363,562572130,86828,562658958,3,0,0,15360,2,9323768760
11364,562582720,67426,562650146,2,0,0,4096,4,1434680318
11365,562594810,2870,562597680,0,0,1,8704,11,5139390567
11366,562624279,59245,562683524,1,0,0,6656,6,7160681334
11367,562658740,49190,562707930,9,0,0,2048,18,10717182088
11368,562695750,91436,562787186,9,0,0,15360,18,3442320478
11369,562705850,2095,562707945,7,0,1,1536,8,5295828437
11370,562710750,83600,562794350,4,0,0,3584,16,9725518191
11371,562717660,89324,562806984,4,0,0,23552,16,1477288748
11372,562748870,3128,562751998,7,0,1,9216,8,7237540125
11373,562760490,193610,562954100,5,0,0,50176,19,5743527081
11374,562799490,99164,562898654,9,0,0,25600,18,5819724926
11375,562807740,113856,562921596,4,0,0,14336,16,2364558772
11376,562808660,223302,563031962,5,0,0,72704,19,7499123052
11377,562834120,2946,562837066,6,0,1,3072,12,6768623341
11378,562845070,109201,562954271,2,0,0,512,4,3084193969
11379,562966859,4374,562971233,2,0,1,4608,4,4672988677
11380,563034660,106340,563141000,4,0,0,49152,16,9800228419
11381,563087420,110772,563198192,4,0,0,12800,16,10557059402
11382,563154800,63764,563218564,9,0,0,10240,18,8841563028
11383,563236620,69284,563305904,0,0,0,8192,11,478903885
11384,563267960,59132,563327092,2,0,0,5120,4,5693231712
11385,563323759,100412,563424171,1,0,0,29696,6,2891452141
11386,563379790,113360,563493150,8,0,0,72192,12,8721167900
11387,563408441,94867,563503308,6,0,0,3584,12,2541775396
11388,563470849,117053,563587902,1,0,0,53248,6,10429924341
11389,563511910,192494,563704404,0,0,0,17920,11,2022875516
11390,563520880,129359,563650239,5,0,0,60928,19,2641710907
11391,563562820,182546,563745366,4,0,0,47616,16,3020391013
11392,563572070,20778,563592848,7,0,1,12800,8,7663155999
11393,563584719,173211,563757930,1,0,0,8192,6,2613727108
11394,563656359,54429,563710788,1,0,0,3584,6,9959316833
11395,563699720,70576,563770296,4,0,0,7168,16,2874915812
11396,563720250,7706,563727956,7,0,1,8192,8,5668657496
11397,563790470,68372,563858842,4,0,0,10240,16,5059826932
11398,563791930,143857,563935787,0,0,0,43520,11,10250097648
11399,563798150,64988,563863138,8,0,0,9216,12,471334811
11400,563863360,74158,563937518,2,0,0,5632,4,5391638105
11401,563994960,4679,563999639,5,0,1,12288,19,4224881892
11402,564091949,100568,564192517,1,0,0,30208,6,8668232953
11403,564137740,142913,564280653,5,0,0,91648,19,10241071188
11404,564144609,3422,564148031,2,0,1,3584,4,5352827331
11405,564164230,5326,564169556,0,0,1,5632,11,7931866259
11406,564238450,1994,564240444,4,0,1,2048,16,794092114
11407,564338789,3898,564342687,3,0,1,4096,2,8398582407
11408,564434469,1042,564435511,8,0,1,1024,12,10154829894
11409,564455050,1994,564457044,5,0,1,2048,19,930790570
11410,564464501,65900,564530401,6,0,0,7168,12,7530944926
11411,564601059,87608,564688667,1,0,0,17920,6,3380395702
11412,564610410,108212,564718622,8,0,0,55296,12,8087078687
11413,564642250,134458,564776708,5,0,0,5120,19,2102106320
11414,564642340,132793,564775133,3,0,0,73728,2,9485468311
11415,564694570,93134,564787704,0,0,0,3584,11,8321571156
11416,564702370,98308,564800678,8,0,0,14848,12,1789997801
11417,564822770,56840,564879610,8,0,0,7680,12,1453760760
11418,564842650,4374,564847024,7,0,1,4608,8,3800920027
11419,564919280,49136,564968416,0,0,0,2560,11,732298716
11420,564932550,60824,564993374,2,0,0,5632,4,4239963464
11421,564954891,109460,565064351,6,0,0,59392,12,8890711433
11422,565023149,50672,565073821,7,0,0,2560,8,220861081
11423,565046920,24670,565071590,9,0,1,7680,18,1107337219
11424,565059280,64220,565123500,9,0,0,5120,18,1216531235
11425,565091030,214047,565305077,0,0,0,87552,11,2923261042
11426,565105660,80118,565185778,8,0,0,1024,12,3560507053
11427,565109010,101860,565210870,0,0,0,12800,11,2654027638
11428,565120281,101660,565221941,6,0,0,33792,12,4015828749
11429,565151900,81704,565233604,3,0,0,5632,2,8289592473
11430,565158870,1042,565159912,4,0,1,1024,16,2926087614
11431,565214119,10777,565224896,8,0,1,3072,12,2168567645
11432,565221290,149514,565370804,0,0,0,10240,11,549634254
11433,565256010,111041,565367051,0,0,0,62976,11,1801746386
11434,565271160,1042,565272202,0,0,1,1024,11,14932717
11435,565289540,154935,565444475,3,0,0,77824,2,2201339692
11436,565332899,5326,565338225,3,0,1,5632,2,9833762134
11437,565333400,149187,565482587,9,0,0,54784,18,10234233220
11438,565347090,154634,565501724,5,0,0,39424,19,4043068629
11439,565423080,36966,565460046,7,0,1,30208,8,2536291192
11440,565482910,77566,565560476,4,0,0,4096,16,1967373449
11441,565492480,102280,565594760,5,0,0,10752,19,4730261384
11442,565498010,17243,565515253,9,0,1,26112,18,9787760688
11443,565509290,122443,565631733,4,0,0,55296,16,7177580503
11444,565565550,141383,565706933,2,0,0,51712,4,1887230824
11445,565602180,111647,565713827,0,0,0,22528,11,7081399507
11446,565612101,134753,565746854,6,0,0,27648,12,2152029625
11447,565675940,87876,565763816,4,0,0,1536,16,985818310
11448,565688340,18608,565706948,4,0,1,5120,16,3387414496
11449,565740119,67551,565807670,1,0,0,5632,6,9256083825
11450,565767210,128579,565895789,5,0,0,20480,19,8952894044
11451,565769219,4162,565773381,8,0,1,11264,12,4960061795
11452,565784100,208607,565992707,8,0,0,110592,12,1458099684
11453,565796679,566,565797245,2,0,1,512,4,689508433
11454,565867650,76286,565943936,8,0,0,10752,12,5990929711
11455,565903250,150714,566053964,5,0,0,72192,19,830073247
11456,566001309,1994,566003303,3,0,1,2048,2,9117872089
11457,566096620,101192,566197812,3,0,0,32256,2,1109616448
11458,566169060,93228,566262288,4,0,0,9728,16,5663295909
11459,566253380,83788,566337168,0,0,0,11264,11,7508626780
11460,566315540,97136,566412676,5,0,0,18944,19,2023472410
11461,566333399,82724,566416123,1,0,0,11264,6,9985479141
11462,566481470,99476,566580946,0,0,0,26624,11,1066572695
11463,566508091,122355,566630446,6,0,0,20480,12,2798153554
11464,566583180,98228,566681408,0,0,0,22528,11,6621642006
11465,566628180,5204,566633384,1,0,1,3072,6,4048483534
11466,566684550,66212,566750762,9,0,0,8192,18,2973619645
11467,566793700,5802,566799502,0,0,1,6144,11,2596711929
11468,566859249,6229,566865478,2,0,1,15360,4,8031464350
11469,566935930,7706,566943636,1,0,1,8192,6,3337859135
11470,566970090,59132,567029222,2,0,0,5120,4,10592751975
11471,567014899,1042,567015941,8,0,1,1024,12,10295172369
11472,567089451,75476,567164927,6,0,0,18432,12,8657603402
11473,567156779,81128,567237907,1,0,0,11776,6,5396059394
11474,567175040,5326,567180366,5,0,1,5632,19,7649030612
11475,567267171,81464,567348635,6,0,0,17920,12,10697575662
11476,567286820,100412,567387232,5,0,0,29696,19,10328275336
11477,567321060,93754,567414814,5,0,0,8192,19,5103715765
11478,567322250,47288,567369538,2,0,0,1536,4,2537874804
11479,567334569,67675,567402244,1,0,0,6144,6,2425409539
11480,567439550,2470,567442020,7,0,1,2560,8,1853654806
11481,567471230,161661,567632891,9,0,0,12800,18,7523676676
11482,567511849,1042,567512891,2,0,1,1024,4,916628470
11483,567631690,73729,567705419,0,0,0,13824,11,7648350284
11484,567679309,566,567679875,8,0,1,512,12,1743340571
11485,567692170,49292,567741462,2,0,0,3072,4,5363989978
11486,567725080,97292,567822372,3,0,0,19456,2,6826910842
11487,567736380,5097,567741477,1,0,1,5120,6,5157727243
11488,567764710,4374,567769084,4,0,1,4608,16,1181525105
11489,567773050,190232,567963282,3,0,0,9728,2,1166859816
11490,567780950,143032,567923982,8,0,0,6656,12,1188348433
11491,567804840,114432,567919272,5,0,0,32768,19,5605823584
11492,567844650,77289,567921939,0,0,0,8704,11,2935611839
11493,568048950,50672,568099622,2,0,0,2560,4,1190283627
11494,568058550,103731,568162281,5,0,0,26112,19,9780909613
11495,568078390,75920,568154310,9,0,0,14848,18,10382512872
11496,568172281,68684,568240965,6,0,0,11264,12,2675717848
11497,568181839,115934,568297773,1,0,0,71680,6,4329408601
11498,568202430,61581,568264011,2,0,0,5120,4,7264848393
11499,568308770,7706,568316476,4,0,1,8192,16,9934889901
11500,568337370,169979,568507349,2,0,0,3072,4,1964208059
11501,568343550,56840,568400390,4,0,0,7680,16,7737917173
11502,568364510,5326,568369836,6,0,1,5632,12,476161317
11503,568372399,201558,568573957,1,0,0,38400,6,7353328695
11504,568407040,129147,568536187,9,0,0,16384,18,5149710857
11505,568435571,278192,568713763,6,0,0,6656,12,4995255610
11506,568451210,10499,568461709,4,0,1,16896,16,7271880243
11507,568472820,83156,568555976,0,0,0,18432,11,4839436455
11508,568524759,61760,568586519,1,0,0,8704,6,7203589234
11509,568538820,55748,568594568,9,0,0,4096,18,7803680174
11510,568564420,114847,568679267,5,0,0,31744,19,1407324175
11511,568607030,95561,568702591,0,0,0,15360,11,247130438
11512,568607470,6229,568613699,4,0,1,15360,16,6509984478
11513,568806500,69284,568875784,4,0,0,8192,16,4292157036
11514,568912760,74984,568987744,9,0,0,11776,18,6998990329
11515,568975730,99944,569075674,4,0,0,28160,16,4128939111
11516,569013920,134468,569148388,4,0,0,33792,16,6564801452
11517,569027879,155825,569183704,1,0,0,64000,6,9500908095
11518,569086650,1518,569088168,6,0,1,1536,12,829713056
11519,569140230,122621,569262851,4,0,0,72192,16,7483362138
11520,569158650,116362,569275012,2,0,0,19968,4,4909815114
11521,569273870,55190,569329060,2,0,0,3584,4,4624071495
11522,569335919,108524,569444443,1,0,0,56320,6,9837082504
11523,569410320,103532,569513852,2,0,0,39936,4,3761646670
11524,569431290,89972,569521262,5,0,0,7680,19,3168076220
11525,569445790,88459,569534249,0,0,0,2560,11,4899944617
11526,569463940,74555,569538495,4,0,0,2560,16,6660394611
11527,569470740,5326,569476066,0,0,1,5632,11,5121546328
11528,569481980,120132,569602112,9,0,0,45056,18,9180901785
11529,569540500,63031,569603531,0,0,0,4608,11,1971392134
11530,569557170,110023,569667193,0,0,0,10240,11,5773098307
11531,569580590,83468,569664058,2,0,0,19456,4,4145363367
11532,569679141,118040,569797181,6,0,0,87552,12,8376478627
11533,569712920,138435,569851355,0,0,0,37376,11,7640571893
11534,569738990,161730,569900720,0,0,0,21504,11,8778421751
11535,569794670,99483,569894153,0,0,0,18432,11,10177418905
11536,569863340,5326,569868666,6,0,1,5632,12,4925813955
11537,569985720,72352,570058072,4,0,0,3072,16,8610445555
11538,569993420,116324,570109744,0,0,0,81920,11,594007032
11539,570060829,4374,570065203,3,0,1,4608,2,138406388
11540,570079370,91748,570171118,5,0,0,16384,19,8792640921
11541,570087961,157305,570245266,6,0,0,11776,12,4011301846
11542,570167709,99313,570267022,1,0,0,19968,6,8069800733
11543,570299209,13341,570312550,3,0,1,22528,2,7613183628
11544,570299300,14428,570313728,5,0,1,13824,19,8609490126
11545,570367200,54056,570421256,4,0,0,3584,16,6804041631
11546,570371390,66636,570438026,5,0,0,2048,19,7103940853
11547,570404700,6488,570411188,1,0,1,15872,6,4585553940
11548,570425430,2946,570428376,6,0,1,3072,12,3119896789
11549,570497550,105224,570602774,5,0,0,10240,19,975765951
11550,570503340,47288,570550628,2,0,0,1536,4,9404523720
11551,570576450,110864,570687314,4,0,0,64000,16,8459920599
11552,570584530,4937,570589467,6,0,1,12800,12,9706312860
11553,570623480,111648,570735128,2,0,0,33280,4,8055630259
11554,570672510,17924,570690434,5,0,1,9216,19,7505481367
11555,570712610,71156,570783766,4,0,0,14336,16,2809308403
11556,570722059,13084,570735143,8,0,1,4096,12,6994763403
11557,570726290,13007,570739297,4,0,1,11264,16,4522685321
11558,570748419,11016,570759435,2,0,1,17920,4,10087661590
11559,570749130,10766,570759896,5,0,1,10240,19,8276781090
11560,570785869,2946,570788815,2,0,1,3072,4,769353515
11561,570867409,1518,570868927,2,0,1,1536,4,10549477800
11562,570925530,85292,571010822,8,0,0,15360,12,4285213017
11563,570938360,100412,571038772,5,0,0,29696,19,6080120882
11564,571027629,70358,571097987,1,0,0,13312,6,90832691
11565,571040419,111958,571152377,1,0,0,44032,6,8317724718
11566,571054631,81128,571135759,6,0,0,11776,12,5644546558
11567,571153270,102596,571255866,3,0,0,36864,2,4129735627
11568,571185521,119947,571305468,6,0,0,27136,12,4456065775
11569,571238900,22433,571261333,6,0,1,36864,12,4973219674
11570,571270549,5196,571275745,3,0,1,13312,2,5693376898
11571,571306719,153662,571460381,1,0,0,17408,6,3342966457
11572,571318050,52364,571370414,4,0,0,3072,16,671524135
11573,571330081,253948,571584029,6,0,0,20992,12,3263018615
11574,571430340,7706,571438046,6,0,1,8192,12,4473483856
11575,571453180,7216,571460396,6,0,1,6144,12,6190586145
11576,571480130,72819,571552949,9,0,0,9728,18,497830875
11577,571651180,48980,571700160,0,0,0,2048,11,8689508822
11578,571686111,45596,571731707,6,0,0,1024,12,10073589030
11579,571789540,102128,571891668,0,0,0,35328,11,650012817
11580,572019320,72668,572091988,0,0,0,9216,11,2004485068
11581,572021319,147901,572169220,1,0,0,101376,6,7010690851
11582,572172110,4937,572177047,5,0,1,12800,19,9863199183
11583,572320260,100880,572421140,4,0,0,31232,16,8244457295
11584,572414020,89932,572503952,2,0,0,12288,4,337481317
11585,572434890,2870,572437760,6,0,1,8704,12,692926897
11586,572463699,4162,572467861,3,0,1,11264,2,3673069230
11587,572633840,108680,572742520,4,0,0,56832,16,7521066200
11588,572645871,140965,572786836,6,0,0,40960,12,5756133863
11589,572697170,230468,572927638,0,0,0,154112,11,317887467
11590,572716060,566,572716626,7,0,1,512,8,9916564176
11591,572740880,187249,572928129,8,0,0,1536,12,2406287584
11592,572783820,159208,572943028,4,0,0,22016,16,6876321001
11593,572895800,90962,572986762,8,0,0,5120,12,8887249130
11594,572930040,77744,573007784,9,0,0,10752,18,68621154
11595,572938870,94338,573033208,9,0,0,10240,18,9612856973
11596,573004721,85875,573090596,6,0,0,12288,12,4730943749
11597,573017890,103532,573121422,8,0,0,39936,12,2595532473
11598,573017951,48980,573066931,6,0,0,2048,12,4377167655
11599,573107591,115746,573223337,6,0,0,65536,12,1817810620
11600,573121890,81464,573203354,8,0,0,17920,12,4967373649
11601,573148790,132707,573281497,9,0,0,37888,18,1485868970
11602,573173820,13600,573187420,4,0,1,23040,16,1041804690
11603,573291300,5802,573297102,0,0,1,6144,11,7808619879
11604,573309930,89456,573399386,8,0,0,18944,12,2206878756
11605,573391510,52988,573444498,5,0,0,5120,19,2017219513
11606,573535120,47288,573582408,2,0,0,1536,4,6956009061
11607,573638220,104156,573742376,5,0,0,41984,19,55164257
11608,573665640,6278,573671918,7,0,1,6656,8,6214220732
11609,573792159,87896,573880055,1,0,0,13824,6,20570852
11610,573856090,2470,573858560,7,0,1,2560,8,4522252122
11611,573880080,103068,573983148,5,0,0,26112,19,4330013425
11612,573971200,107312,574078512,2,0,0,39424,4,1137705976
11613,574031181,74360,574105541,6,0,0,9728,12,874271105
11614,574240420,2946,574243366,9,0,1,3072,18,3770886882
11615,574478730,48980,574527710,4,0,0,2048,16,5112057876
11616,574481530,118727,574600257,9,0,0,46080,18,6137744435
11617,574488420,148473,574636893,9,0,0,30208,18,8149906463
11618,574498630,7230,574505860,6,0,1,7680,12,9320744790
11619,574560290,566,574560856,6,0,1,512,12,6075462766
11620,574700671,55748,574756419,6,0,0,4096,12,1695372817
11621,574705909,1042,574706951,2,0,1,1024,4,10602688989
11622,574720451,52364,574772815,6,0,0,3072,12,3535315144
11623,574766940,56528,574823468,8,0,0,6656,12,3911064794
11624,574855111,50672,574905783,6,0,0,2560,12,4423216265
11625,574916830,13600,574930430,9,0,1,23040,18,765758868
11626,574977990,101192,575079182,0,0,0,32256,11,70489587
11627,575037820,109732,575147552,0,0,0,28672,11,10730043628
11628,575055760,99326,575155086,5,0,0,13312,19,239255512
11629,575144650,50182,575194832,2,0,0,1536,4,8432204012
11630,575194909,1518,575196427,2,0,1,1536,4,1745780858
11631,575238870,6278,575245148,0,0,1,6656,11,5257134582
11632,575354189,12825,575367014,3,0,1,21504,2,8877114859
11633,575466829,141091,575607920,1,0,0,24576,6,9208117905
11634,575557890,99008,575656898,2,0,0,25088,4,4512366166
11635,575562140,61986,575624126,2,0,0,1024,4,3181975209
11636,575632039,74228,575706267,1,0,0,14336,6,2267442541
11637,575820440,62516,575882956,8,0,0,6144,12,5347966820
11638,575873520,100256,575973776,9,0,0,29184,18,6736484806
11639,575884900,125482,576010382,8,0,0,32256,12,3406012405
11640,575934621,90143,576024764,6,0,0,12800,12,7657038390
11641,575987680,85160,576072840,4,0,0,19968,16,6430421861
11642,576041590,76052,576117642,0,0,0,10240,11,3874623687
11643,576087830,84076,576171906,8,0,0,4608,12,422504940
11644,576097249,101348,576198597,1,0,0,32768,6,2370804618
11645,576107600,138097,576245697,4,0,0,20992,16,1425708953
11646,576110079,112224,576222303,1,0,0,3584,6,1514489911
11647,576131540,125404,576256944,0,0,0,36864,11,311117274
11648,576184250,108328,576292578,2,0,0,10240,4,9531346153
11649,576192310,65429,576257739,0,0,0,2560,11,3347477138
11650,576218350,4162,576222512,6,0,1,11264,12,4540324925
11651,576311540,69308,576380848,2,0,0,13312,4,3259555380
11652,576320649,92797,576413446,1,0,0,13312,6,5422733072
11653,576349600,129846,576479446,5,0,0,68608,19,1722757864
11654,576392620,270079,576662699,4,0,0,5632,16,753483956
11655,576392841,262184,576655025,6,0,0,57856,12,6836759421
11656,576458280,179086,576637366,5,0,0,156160,19,4062408229
11657,576548270,112698,576660968,0,0,0,19456,11,8772223519
11658,576576320,145950,576722270,0,0,0,38912,11,8610854060
11659,576593800,179770,576773570,4,0,0,71168,16,8215296989
11660,576595169,153857,576749026,7,0,0,6144,8,99546695
11661,576675910,4374,576680284,1,0,1,4608,6,4176771850
11662,576712080,69388,576781468,0,0,0,5632,11,4074303830
11663,576851049,103532,576954581,1,0,0,39936,6,2726518580
11664,576853639,566,576854205,3,0,1,512,2,4585450026
11665,576968760,4162,576972922,5,0,1,11264,19,4325683685
11666,577020690,5802,577026492,5,0,1,6144,19,996064082
11667,577063640,110305,577173945,0,0,0,7680,11,2491187439
11668,577087710,54056,577141766,8,0,0,3584,12,6794440843
11669,577104350,81932,577186282,8,0,0,19456,12,2527629103
11670,577132950,5326,577138276,0,0,1,5632,11,4068947098
11671,577152940,121517,577274457,8,0,0,37888,12,6567636715
11672,577170970,15327,577186297,7,0,1,22016,8,1214665542
11673,577220369,123124,577343493,7,0,0,35328,8,8337425825
11674,577251019,132230,577383249,7,0,0,29696,8,7533034388
11675,577258810,103376,577362186,4,0,0,39424,16,9924666410
11676,577336639,112955,577449594,7,0,0,26624,8,8045949520
11677,577348049,112480,577460529,7,0,0,35840,8,9643426186
11678,577411950,78972,577490922,2,0,0,13824,4,10542207285
11679,577419771,60824,577480595,6,0,0,5632,12,10277874789
11680,577449449,74803,577524252,7,0,0,6144,8,1082238782
11681,577455350,7683,577463033,0,0,1,2560,11,9205109908
11682,577456030,10509,577466539,9,0,1,13312,18,6395125647
11683,577535950,89636,577625586,0,0,0,24576,11,4222736612
11684,577615339,43904,577659243,1,0,0,512,6,2278712216
11685,577644470,54836,577699306,4,0,0,6144,16,8595836759
11686,577730989,11016,577742005,2,0,1,17920,4,6631828374
11687,577759570,122060,577881630,5,0,0,64512,19,4591493434
11688,577857040,91436,577948476,2,0,0,15360,4,5374891457
11689,577937900,72668,578010568,0,0,0,9216,11,4227616771
11690,577988660,99320,578087980,5,0,0,26112,19,4612254332
11691,578063621,77900,578141521,6,0,0,11264,12,1343924875
11692,578177590,97604,578275194,8,0,0,20480,12,7951748598
11693,578191089,121221,578312310,1,0,0,41472,6,4677288641
11694,578282839,1994,578284833,8,0,1,2048,12,10224691346
11695,578326401,96092,578422493,6,0,0,25600,12,2538397057
11696,578344210,106847,578451057,2,0,0,4096,4,10628509843
11697,578356330,93464,578449794,4,0,0,22016,16,7333793231
11698,578391970,15062,578407032,1,0,1,29184,6,6067748886
11699,578421100,124751,578545851,9,0,0,23552,18,5250492686
11700,578469829,83312,578553141,1,0,0,18944,6,837046921
11701,578484580,103433,578588013,4,0,1,167936,16,1435645267
11702,578500020,238102,578738122,9,0,0,64512,18,7468898935
11703,578529759,141426,578671185,1,0,0,17408,6,1266588695
11704,578573210,168983,578742193,8,0,0,13312,12,9917831913
11705,578602340,99878,578702218,8,0,0,6144,12,6527763188
11706,578621141,196868,578818009,6,0,0,46592,12,4575787223
11707,578639290,11533,578650823,7,0,1,18944,8,1972597423
11708,578644449,8640,578653089,3,0,1,3584,2,8739779098
11709,578672739,202993,578875732,1,0,0,85504,6,5196496472
11710,578679759,124039,578803798,1,0,0,35840,6,8296794909
11711,578694730,7503,578702233,7,0,1,7168,8,1703462919
11712,578774390,69566,578843956,9,0,0,9216,18,5016815704
11713,578900050,65300,578965350,0,0,0,10240,11,8554045743
11714,578926261,110735,579036996,6,0,0,17408,12,1847600416
11715,579010290,47444,579057734,5,0,0,2048,19,7856343738
11716,579086750,94976,579181726,0,0,0,16896,11,5121656604
11717,579089000,52364,579141364,0,0,0,3072,11,566277251
11718,579137610,54056,579191666,2,0,0,3584,4,1922084790
11719,579205130,48980,579254110,0,0,0,2048,11,10050933873
11720,579215710,89792,579305502,5,0,0,25088,19,6948672230
11721,579232870,52364,579285234,4,0,0,3072,16,2121195448
11722,579236581,57440,579294021,6,0,0,4608,12,3325803981
11723,579277490,4374,579281864,9,0,1,4608,18,8883562506
11724,579283609,5712,579289321,8,0,1,14336,12,9749645397
11725,579284990,115190,579400180,8,0,0,23040,12,4337814880
11726,579290429,15088,579305517,2,0,1,8192,4,2074506034
11727,579300829,135086,579435915,7,0,0,27136,8,3082881912
11728,579346110,55036,579401146,9,0,0,3072,18,6113593424
11729,579391970,8225,579400195,0,0,1,9216,11,7079296831
11730,579423460,90160,579513620,8,0,0,24576,12,4980149797
11731,579466350,107588,579573938,5,0,0,39936,19,8889776101
11732,579506911,104803,579611714,6,0,0,3584,12,10353910430
11733,579571790,47736,579619526,0,0,0,1024,11,4533980586
11734,579581980,6278,579588258,5,0,1,6656,19,543234064
11735,579626329,54056,579680385,1,0,0,3584,6,4538684290
11736,579692639,48980,579741619,7,0,0,2048,8,8434579757
11737,579719770,115467,579835237,2,0,0,76288,4,7491035387
11738,579785700,91063,579876763,3,0,0,14848,2,2545552220
11739,579896309,99008,579995317,1,0,0,25088,6,10622122095
11740,579904380,73292,579977672,8,0,0,11264,12,3084995515
11741,579938119,62516,580000635,7,0,0,6144,8,352862537
11742,579951811,83132,580034943,6,0,0,13312,12,4072028518
11743,580033520,48703,580082223,9,0,0,1536,18,1506058994
11744,580229400,43904,580273304,8,0,0,512,12,5074891159
11745,580230420,566,580230986,6,0,1,512,12,1791973243
11746,580254729,3128,580257857,3,0,1,9216,2,10624587314
11747,580342180,101348,580443528,4,0,0,32768,16,7948580154
11748,580353640,94427,580448067,9,0,0,14848,18,4209077725
11749,580377920,74788,580452708,8,0,0,5120,12,9457287815
11750,580411150,1994,580413144,6,0,1,2048,12,26277553
11751,580417450,82484,580499934,5,0,0,12800,19,8110701452
11752,580425400,150050,580575450,2,0,0,99328,4,6170147951
11753,580468969,169907,580638876,1,0,0,35328,6,2121062639
11754,580509700,96956,580606656,9,0,0,10240,18,4252249054
11755,580542250,150614,580692864,4,0,0,51200,16,7491613617
11756,580563889,206549,580770438,7,0,0,77824,8,2686372314
11757,580632040,107294,580739334,0,0,0,27136,11,5699221640
11758,580745930,52364,580798294,5,0,0,3072,19,8868576039
11759,580805999,90104,580896103,7,0,0,26112,8,8661549858
11760,580814430,24412,580838842,0,0,1,44032,11,591229582
11761,580819020,116435,580935455,5,0,0,11776,19,8119145428
11762,581078630,54056,581132686,0,0,0,3584,11,3794514021
11763,581257869,97448,581355317,1,0,0,19968,6,8584917337
11764,581265680,160043,581425723,8,0,0,11776,12,5011465085
11765,581269049,152892,581421941,7,0,0,77312,8,7438388561
11766,581370650,51470,581422120,5,0,0,512,19,2438695176
11767,581407600,113341,581520941,5,0,0,25088,19,1654077950
11768,581430580,99788,581530368,2,0,0,27648,4,5059743824
11769,581485450,77755,581563205,9,0,0,15360,18,3390300876
11770,581604160,92996,581697156,9,0,0,20480,18,9421225265
11771,581655710,103376,581759086,2,0,0,39424,4,9068933111
11772,581797821,101348,581899169,6,0,0,32768,12,6309141331
11773,581812790,170217,581983007,8,0,0,19456,12,499984485
11774,581814850,115771,581930621,0,0,0,25088,11,3775908718
11775,581838370,64208,581902578,2,0,0,6656,4,6548867022
11776,581969309,95132,582064441,1,0,0,17408,6,421520193
11777,581980210,8115,581988325,5,0,1,5632,19,3085720591
11778,582017080,78531,582095611,0,0,0,7680,11,9531074102
11779,582139999,111020,582251019,7,0,0,64512,8,8642735720
11780,582246410,50197,582296607,8,0,0,1024,12,6231666083
11781,582256600,106964,582363564,8,0,0,51200,12,4921049347
11782,582270141,101067,582371208,6,0,0,10752,12,2880102669
11783,582314370,128202,582442572,2,0,0,19968,4,5971529706
11784,582359749,71399,582431148,1,0,0,7680,6,6692936616
11785,582418710,58376,582477086,9,0,0,7680,18,2776049302
11786,582451700,89924,582541624,2,0,0,20480,4,7006195632
11787,582485059,3898,582488957,3,0,1,4096,2,1513419824
11788,582538369,5241,582543610,2,0,1,2048,4,9371827180
11789,582664040,2946,582666986,5,0,1,3072,19,1276662976
11790,582665450,64208,582729658,0,0,0,6656,11,7260672738
11791,582722060,3898,582725958,0,0,1,4096,11,7207913798
11792,582736140,70976,582807116,0,0,0,8704,11,892043904
11793,582740770,100724,582841494,4,0,0,30720,16,3420161046
11794,582786790,70784,582857574,8,0,0,5632,12,7297516264
11795,582887820,55748,582943568,0,0,0,4096,11,4810014128
11796,583059080,94688,583153768,0,0,0,20992,11,244532834
11797,583072040,99962,583172002,4,0,0,4096,16,4795492476
11798,583226470,10499,583236969,1,0,1,16896,6,5284383400
11799,583230401,55322,583285723,6,0,0,3584,12,1147138284
11800,583297910,43904,583341814,2,0,0,512,4,4274370749
11801,583351609,1994,583353603,3,0,1,2048,2,5869344208
11802,583356079,48980,583405059,7,0,0,2048,8,2268295913
11803,583363849,1518,583365367,3,0,1,1536,2,7759486863
11804,583555130,90836,583645966,5,0,0,18432,19,1529366884
11805,583623849,89581,583713430,1,0,0,10752,6,9225118041
11806,583624351,54056,583678407,6,0,0,3584,12,8640759444
11807,583659739,5454,583665193,8,0,1,13824,12,7838314065
11808,583878970,54056,583933026,0,0,0,3584,11,10670126564
11809,583880020,65900,583945920,2,0,0,7168,4,5488031084
11810,583918019,4679,583922698,8,0,1,12288,12,5325951862
11811,583993040,76052,584069092,2,0,0,10240,4,10271713604
11812,584004620,4420,584009040,7,0,1,11776,8,6362135071
11813,584018310,11274,584029584,6,0,1,18432,12,5140997863
11814,584048329,115503,584163832,1,0,0,21504,6,7523086612
11815,584066621,67368,584133989,6,0,0,3584,12,1452758874
11816,584174169,4420,584178589,2,0,1,11776,4,5473133173
11817,584212121,98540,584310661,6,0,0,23552,12,615895992
11818,584300150,65900,584366050,4,0,0,7168,16,6730237966
11819,584373480,81128,584454608,2,0,0,11776,4,3908405480
11820,584387301,92951,584480252,6,0,0,10240,12,6523031514
11821,584673459,98384,584771843,1,0,0,23040,6,9540075739
11822,584766991,59680,584826671,6,0,0,6144,12,10362722454
11823,584788160,97916,584886076,4,0,0,21504,16,4993440535
11824,584808159,5802,584813961,2,0,1,6144,4,5787291535
11825,584817999,127255,584945254,1,0,0,23040,6,1889642632
11826,584850879,5326,584856205,8,0,1,5632,12,1059888183
11827,584890660,93440,584984100,0,0,0,16896,11,10175703293
11828,584898789,3422,584902211,3,0,1,3584,2,800738696
11829,584900950,48980,584949930,0,0,0,2048,11,3099743808
11830,585069859,102284,585172143,1,0,0,35840,6,10455816853
11831,585083730,11533,585095263,6,0,1,18944,12,1486198534
11832,585155419,151064,585306483,1,0,0,12288,6,4932237562
11833,585190140,101504,585291644,4,0,0,33280,16,3037095069
11834,585198820,4850,585203670,6,0,1,5120,12,9042641417
11835,585209810,3422,585213232,0,0,1,3584,11,2606997717
11836,585281100,117981,585399081,0,0,0,54784,11,1143881739
11837,585541010,5454,585546464,0,0,1,13824,11,4198375522
11838,585581580,1518,585583098,7,0,1,1536,8,3422704024
11839,585653190,50672,585703862,8,0,0,2560,12,4009154467
11840,585661329,6754,585668083,8,0,1,7168,12,10121753990
11841,585699100,89660,585788760,2,0,0,19968,4,1572807181
11842,585711280,45596,585756876,0,0,0,1024,11,8721620082
11843,585712290,3128,585715418,0,0,1,9216,11,742574487
11844,585737930,2946,585740876,0,0,1,3072,11,10368809651
11845,585876720,102440,585979160,2,0,0,36352,4,10705385415
11846,585949631,63993,586013624,6,0,0,1024,12,8040018722
11847,585973149,79475,586052624,7,0,0,16896,8,4175782637
11848,585982710,60824,586043534,5,0,0,5632,19,1539361858
11849,585994710,73232,586067942,0,0,0,512,11,8148829453
11850,586065039,55748,586120787,1,0,0,4096,6,5336365006
11851,586205280,87920,586293200,2,0,0,18944,4,6550605795
11852,586249159,117747,586366906,7,0,0,31744,8,3789958783
11853,586250510,154969,586405479,2,0,0,61952,4,4372601492
11854,586265560,167952,586433512,8,0,0,77824,12,10607589623
11855,586317751,130083,586447834,6,0,0,12800,12,4773690117
11856,586345130,112393,586457523,8,0,0,8704,12,1318968396
11857,586436119,64208,586500327,1,0,0,6656,6,871761826
11858,586632730,6754,586639484,9,0,1,7168,18,4371338885
11859,586671761,101816,586773577,6,0,0,34304,12,5351017323
11860,586712661,105466,586818127,6,0,0,28160,12,5235687977
11861,586716450,124459,586840909,2,0,0,31232,4,4494352819
11862,586866599,1042,586867641,2,0,1,1024,4,10466154141
11863,586876090,81128,586957218,2,0,0,11776,4,9936323109
11864,586943260,31266,586974526,4,0,1,50688,16,6042922342
11865,587026210,4374,587030584,1,0,1,4608,6,7937405336
11866,587057100,100103,587157203,5,0,0,24064,19,541481721
11867,587080080,69776,587149856,9,0,0,14848,18,713796945
11868,587129300,133260,587262560,2,0,0,90112,4,3856507525
11869,587191640,74672,587266312,4,0,0,10752,16,3535680093
11870,587283661,64520,587348181,6,0,0,7680,12,9709378511
11871,587360470,74360,587434830,8,0,0,9728,12,10257827331
11872,587502310,55748,587558058,2,0,0,4096,4,6450611945
11873,587615969,65900,587681869,1,0,0,7168,6,10109295917
11874,587620620,127873,587748493,0,0,0,64512,11,7068986877
11875,587627380,131923,587759303,8,0,0,6656,12,2744279584
11876,587641511,115741,587757252,6,0,0,28672,12,1044718968
11877,587646739,142915,587789654,1,0,0,2560,6,1481299661
11878,587662240,4679,587666919,7,0,1,12288,8,8806574632
11879,587675650,12737,587688387,1,0,1,24576,6,7767634876
11880,587687239,13770,587701009,3,0,1,26624,2,1447587730
11881,587713790,216725,587930515,4,0,0,3584,16,1035416510
11882,587729180,140398,587869578,8,0,0,38912,12,4743980921
11883,587742040,24452,587766492,0,0,1,7680,11,9248236193
11884,587766890,265676,588032566,2,0,0,8192,4,188502808
11885,587795839,77467,587873306,7,0,0,7680,8,5247877310
11886,587807000,4679,587811679,1,0,1,12288,6,2912378286
11887,587821989,208066,588030055,7,0,0,168960,8,5945382953
11888,587909809,7706,587917515,2,0,1,8192,4,473505754
11889,587920410,113731,588034141,0,0,0,5120,11,3552918651
11890,588184340,47288,588231628,2,0,0,1536,4,5918910846
11891,588369870,108680,588478550,0,0,0,56832,11,5250510332
11892,588403840,5454,588409294,1,0,1,13824,6,7155334842
11893,588433169,79461,588512630,1,0,0,5120,6,6195580984
11894,588439400,183399,588622799,4,0,1,296960,16,2263551348
11895,588463259,160206,588623465,3,0,1,1024,2,328666651
11896,588481671,201635,588683306,6,0,0,9728,12,4706070001
11897,588499319,230466,588729785,1,0,0,6656,6,6486888409
11898,588580940,42679,588623619,1,0,1,8704,6,2196989521
11899,588620640,233580,588854220,2,0,0,24576,4,782845263
11900,588741689,81895,588823584,7,0,0,9728,8,6287833419
11901,588782369,2470,588784839,3,0,1,2560,2,3961071399
11902,588876459,101192,588977651,1,0,0,32256,6,6057093344
11903,588970629,57998,589028627,1,0,0,3584,6,7422964600
11904,588993910,105679,589099589,2,0,0,36352,4,8252457814
11905,588997149,50672,589047821,7,0,0,2560,8,5185226672
11906,589069359,1994,589071353,2,0,1,2048,4,7278310871
11907,589077760,111020,589188780,8,0,0,64512,12,411683961
11908,589084510,15094,589099604,5,0,1,4608,19,2604467189
11909,589363150,2470,589365620,1,0,1,2560,6,8767144641
11910,589487780,77744,589565524,5,0,0,10752,19,5973878627
11911,589628660,57440,589686100,5,0,0,4608,19,1944458401
11912,589823910,88832,589912742,2,0,0,16896,4,610434970
11913,589913640,109304,590022944,4,0,0,58880,16,6965634604
11914,589954599,146699,590101298,7,0,0,88064,8,185516848
11915,590036980,66065,590103045,4,0,0,5632,16,5759073999
11916,590038690,88969,590127659,0,0,0,13824,11,8088153855
11917,590075680,146095,590221775,4,0,0,23040,16,1685928443
11918,590080630,91897,590172527,0,0,0,2560,11,259051455
11919,590167160,12566,590179726,9,0,1,20992,18,2470945980
11920,590227060,50672,590277732,5,0,0,2560,19,918624345
11921,590300220,98852,590399072,8,0,0,24576,12,5686329625
11922,590348110,154750,590502860,2,0,0,65536,4,7662511581
11923,590470960,7706,590478666,0,0,1,8192,11,8792411876
11924,590493960,79868,590573828,5,0,0,8704,19,3246482564
11925,590561900,50672,590612572,4,0,0,2560,16,9173153828
11926,590568550,196537,590765087,4,0,1,322560,16,1954502744
11927,590641060,170400,590811460,8,0,0,1024,12,10647618437
11928,590677460,88395,590765855,7,0,1,11776,8,3114139892
11929,590695579,245790,590941369,7,0,0,5632,8,14372268
11930,590863649,122283,590985932,7,0,0,94208,8,5407227571
11931,590881061,105354,590986415,6,0,0,1536,12,2865565548
11932,590910510,146961,591057471,4,0,0,34304,16,2900131437
11933,590913569,10757,590924326,2,0,1,17408,4,6266734439
11934,590921000,5912,590926912,1,0,1,4096,6,985913446
11935,590991410,98072,591089482,5,0,0,22016,19,10172591572
11936,590993760,124502,591118262,2,0,0,16896,4,1950767298
11937,591078690,2946,591081636,1,0,1,3072,6,6508242384
11938,591230839,45752,591276591,1,0,0,1536,6,9795691323
11939,591240890,76076,591316966,0,0,0,15360,11,3421347148
11940,591296290,59132,591355422,5,0,0,5120,19,1444408160
11941,591319309,77900,591397209,1,0,0,11264,6,2331724158
11942,591439660,97916,591537576,4,0,0,21504,16,9199395511
11943,591486750,2870,591489620,1,0,1,8704,6,8161144
11944,591502900,49604,591552504,0,0,0,4096,11,544185372
11945,591505120,101348,591606468,8,0,0,32768,12,2511114814
11946,591670330,79172,591749502,8,0,0,20480,12,5148158762
11947,591681960,144960,591826920,4,0,0,46592,16,8559947013
11948,591713030,84512,591797542,2,0,0,12800,4,2820104321
11949,591843360,3422,591846782,7,0,1,3584,8,1489241646
11950,591882040,2870,591884910,5,0,1,8704,19,4004763395
11951,591884279,5312,591889591,8,0,1,5120,12,7278283152
11952,591925260,6488,591931748,7,0,1,15872,8,1350812299
11953,591996120,3904,592000024,0,0,1,10752,11,944124567
11954,592096939,108680,592205619,1,0,0,56832,6,8557243127
11955,592127129,111964,592239093,7,0,0,14336,8,10489263467
11956,592129450,2470,592131920,5,0,1,2560,19,8276210461
11957,592196340,108591,592304931,9,0,0,26112,18,2122342800
11958,592212090,78548,592290638,5,0,0,18432,19,6454878473
11959,592231090,113158,592344248,4,0,0,11776,16,6926515456
11960,592243041,91280,592334321,6,0,0,14848,12,1857436129
11961,592295620,70295,592365915,0,0,0,12288,11,1256580529
11962,592308870,101307,592410177,0,0,0,10240,11,6649616537
11963,592317410,77514,592394924,5,0,0,6656,19,348002685
11964,592411699,111488,592523187,7,0,0,66048,8,8491551735
11965,592446880,123269,592570149,2,0,0,17408,4,1213064773
11966,592454420,148531,592602951,8,0,0,28160,12,9777570486
11967,592466080,236753,592702833,5,0,0,128000,19,2030883413
11968,592583450,122050,592705500,0,0,0,8704,11,7470333006
11969,592610690,96549,592707239,2,0,0,5632,4,3902649991
11970,592655890,7230,592663120,1,0,1,7680,6,4269502563
11971,592660600,94688,592755288,8,0,0,20992,12,4725133312
11972,592694129,122593,592816722,1,0,0,45056,6,4110057992
11973,592746900,8403,592755303,1,0,1,3584,6,7732895969
11974,592842580,85409,592927989,5,0,0,6656,19,9029330413
11975,592854190,71756,592925946,0,0,0,11264,11,3789199182
11976,592888690,62245,592950935,2,0,0,1536,4,5207935726
11977,592891020,6754,592897774,0,0,1,7168,11,1076390527
11978,592898130,56189,592954319,4,0,0,2560,16,10711374430
11979,592921179,45183,592966362,1,0,0,512,6,7370020335
11980,592940260,11274,592951534,7,0,1,18432,8,3252375028
11981,592982990,99476,593082466,4,0,0,26624,16,5296442742
11982,593029120,4850,593033970,1,0,1,5120,6,10102632689
11983,593087750,95129,593182879,4,0,0,16384,16,3891431154
11984,593130510,96301,593226811,0,0,0,2048,11,9759685944
11985,593352151,96980,593449131,6,0,0,18432,12,2364368700
11986,593403270,125452,593528722,5,0,0,5120,19,1027267549
11987,593409190,66979,593476169,4,0,1,113664,16,10682189249
11988,593439700,253486,593693186,4,0,0,12800,16,4297035530
11989,593469960,85372,593555332,0,0,0,5632,11,5788124226
11990,593517569,20624,593538193,8,0,1,33280,12,5074593603
11991,593537400,14287,593551687,4,0,1,27648,16,8481994685
11992,593565890,109236,593675126,5,0,0,13824,19,3271439300
11993,593587230,57440,593644670,2,0,0,4608,4,2457933990
11994,593607910,566,593608476,1,0,1,512,6,740428564
11995,593724100,137613,593861713,4,0,0,18432,16,6674447058
11996,593752520,4679,593757199,9,0,1,12288,18,2222064477
11997,593865499,6754,593872253,3,0,1,7168,2,9560810831
11998,593877730,82334,593960064,5,0,0,11264,19,7680290629
11999,593880609,48980,593929589,7,0,0,2048,8,912933742
12000,593917060,98384,594015444,0,0,0,23040,11,8463668666
12001,593951289,139461,594090750,1,0,0,57344,6,10350136424
12002,594007370,60824,594068194,5,0,0,5632,19,4279084106
12003,594018450,81174,594099624,0,0,0,9728,11,6798392198
12004,594028421,109633,594138054,6,0,0,8704,12,4567644211
12005,594158230,64208,594222438,0,0,0,6656,11,464631041
12006,594185980,101816,594287796,8,0,0,34304,12,5439129933
12007,594202070,156532,594358602,8,0,0,58880,12,4613503967
12008,594227340,147657,594374997,8,0,0,53760,12,2857626184
12009,594286030,2800,594288830,7,0,1,1024,8,5778301674
12010,594300710,114874,594415584,0,0,0,17920,11,5817834812
12011,594306540,192109,594498649,0,0,0,22016,11,8056018134
12012,594310460,137926,594448386,2,0,0,28672,4,98819482
12013,594327610,122351,594449961,5,0,0,5120,19,5500166850
12014,594339950,180761,594520711,4,0,0,2560,16,5759318756
12015,594355960,129806,594485766,3,0,0,40448,2,9111787072
12016,594447419,7860,594455279,8,0,1,5632,12,6820606921
12017,594615450,100880,594716330,2,0,0,31232,4,8834786150
12018,594712801,67441,594780242,6,0,0,10752,12,1056286999
12019,594735650,45596,594781246,4,0,0,1024,16,2517397479
12020,594801959,60824,594862783,7,0,0,5632,8,6098752773
12021,594875260,99164,594974424,5,0,0,25600,19,10003738923
12022,594890460,5326,594895786,0,0,1,5632,11,9268583300
12023,594908049,6229,594914278,8,0,1,15360,12,3345121468
12024,594972880,60668,595033548,0,0,0,5120,11,3218505325
12025,595093600,5196,595098796,7,0,1,13312,8,4542246335
12026,595109019,2470,595111489,2,0,1,2560,4,2417871562
12027,595133169,66524,595199693,1,0,0,9216,6,9564311768
12028,595161150,169504,595330654,4,0,0,6144,16,4645405906
12029,595211520,2870,595214390,7,0,1,8704,8,349268560
12030,595326970,6754,595333724,6,0,1,7168,12,5604643194
12031,595335599,2946,595338545,8,0,1,3072,12,10702809890
12032,595430841,99476,595530317,6,0,0,26624,12,406104692
12033,595605530,81908,595687438,0,0,0,14336,11,5648121927
12034,595615910,2946,595618856,0,0,1,3072,11,1961520061
12035,595646969,6488,595653457,3,0,1,15872,2,9445607172
12036,595725490,74828,595800318,0,0,0,11264,11,4322408091
12037,595729730,4374,595734104,1,0,1,4608,6,7308782219
12038,595768039,566,595768605,3,0,1,512,2,9517161268
12039,595789600,99008,595888608,8,0,0,25088,12,1582379708
12040,595918180,64988,595983168,5,0,0,9216,19,8323985463
12041,595964610,4374,595968984,5,0,1,4608,19,268811191
12042,595991980,203615,596195595,0,0,0,78848,11,96039727
12043,596069090,65026,596134116,8,0,0,3072,12,7164635864
12044,596094430,134249,596228679,4,0,0,26112,16,9726494094
12045,596113830,82248,596196078,8,0,0,1536,12,3448160912
12046,596115919,101660,596217579,7,0,0,33792,8,6307625273
12047,596118219,80994,596199213,7,0,0,10240,8,5710805218
12048,596289330,105404,596394734,9,0,0,46080,18,1744420791
12049,596294550,153524,596448074,5,0,0,54784,19,5232916409
12050,596316500,191856,596508356,0,0,0,29696,11,5822466744
12051,596490610,67772,596558382,2,0,0,13312,4,2784351923
12052,596573839,12566,596586405,2,0,1,20992,4,8851438702
12053,596628340,4937,596633277,9,0,1,12800,18,2813570804
12054,596631329,72192,596703521,1,0,0,11776,6,6030482230
12055,596646969,69932,596716901,1,0,0,15360,6,1671503473
12056,596883569,3422,596886991,8,0,1,3584,12,5836090884
12057,596899971,111488,597011459,6,0,0,66048,12,4936554296
12058,596983040,28434,597011474,6,0,1,30208,12,10060848444
12059,597054440,67259,597121699,4,0,0,11776,16,2617644596
12060,597090171,96122,597186293,6,0,0,2560,12,814310505
12061,597100619,2946,597103565,2,0,1,3072,4,2181450750
12062,597127041,130475,597257516,6,0,0,3584,12,7959636466
12063,597166080,111920,597278000,2,0,0,15360,4,7428619791
12064,597246920,105378,597352298,5,0,0,31232,19,5909102306
12065,597353800,81620,597435420,0,0,0,18432,11,1087919210
12066,597432500,125164,597557664,4,0,0,101376,16,3509867577
12067,597452499,120273,597572772,1,0,0,14848,6,9390809146
12068,597515819,1518,597517337,2,0,1,1536,4,9840861369
12069,597542721,92679,597635400,6,0,0,10752,12,9319121284
12070,597560100,228171,597788271,4,0,0,6656,16,5051669517
12071,597592790,102596,597695386,5,0,0,36864,19,2700102803
12072,597608710,104780,597713490,0,0,0,44032,11,3722480644
12073,597609450,156622,597766072,4,0,0,35840,16,3092310163
12074,597652060,134168,597786228,5,0,0,54784,19,4534070493
12075,597704089,133563,597837652,1,0,0,21504,6,987163541
12076,597710959,8019,597718978,2,0,1,13824,4,3024567256
12077,597711970,10703,597722673,7,0,1,12800,8,9650300519
12078,597729240,1994,597731234,0,0,1,2048,11,6702573820
12079,597855120,80893,597936013,4,0,0,9728,16,10651507562
12080,597871130,3898,597875028,5,0,1,4096,19,8704982896
12081,597894781,104624,597999405,6,0,0,43520,12,2783036150
12082,597976271,118508,598094779,6,0,0,89088,12,478988861
12083,598018600,151887,598170487,2,0,0,37888,4,7808865235
12084,598242661,43904,598286565,6,0,0,512,12,3373879780
12085,598301570,93464,598395034,0,0,0,22016,11,9574475278
12086,598309250,133580,598442830,5,0,0,27648,19,1278548770
12087,598341410,1518,598342928,9,0,1,1536,18,766822939
12088,598465120,102275,598567395,8,0,0,29184,12,2069081263
12089,598475800,82688,598558488,0,0,0,16896,11,9277778034
12090,598487290,94580,598581870,4,0,0,1536,16,7781996754
12091,598557260,85891,598643151,5,0,0,14336,19,476159437
12092,598565519,110488,598676007,7,0,0,11264,8,9956973509
12093,598598270,87607,598685877,5,0,0,12288,19,9526358686
12094,598695509,47288,598742797,1,0,0,1536,6,9426023464
12095,598813349,85595,598898944,7,0,0,23040,8,3550794920
12096,598829850,6488,598836338,5,0,1,15872,19,8483906556
12097,598837200,108836,598946036,8,0,0,57344,12,7027415327
12098,598852720,5326,598858046,9,0,1,5632,18,10292009980
12099,598896050,7306,598903356,1,0,1,11776,6,4034079241
12100,598968699,66236,599034935,1,0,0,13312,6,7480286096
12101,598973470,95780,599069250,8,0,0,24576,12,9794049578
12102,599036330,91426,599127756,0,0,0,13824,11,52417857
12103,599061999,9713,599071712,2,0,1,2560,4,7903206319
12104,599265350,57752,599323102,2,0,0,5632,4,9059308499
12105,599272709,102284,599374993,7,0,0,35840,8,5196474693
12106,599342810,119288,599462098,0,0,0,91648,11,1319147322
12107,599365480,173418,599538898,4,0,0,44032,16,10501603776
12108,599500890,4937,599505827,1,0,1,12800,6,402273036
12109,599612050,14287,599626337,1,0,1,27648,6,8085848950
12110,599662830,11274,599674104,4,0,1,18432,16,4524650375
12111,599685571,92972,599778543,6,0,0,15360,12,10273971675
12112,599731709,107276,599838985,7,0,0,52224,8,532810750
12113,599738159,133564,599871723,7,0,0,21504,8,6578671444
12114,599814540,1994,599816534,5,0,1,2048,19,7322168695
12115,599821069,78823,599899892,7,0,0,2048,8,2053019352
12116,599847241,55748,599902989,6,0,0,4096,12,8846384816
12117,599893800,144422,600038222,5,0,0,66048,19,7369464045
12118,600074991,101192,600176183,6,0,0,32256,12,7190986732
12119,600089430,101267,600190697,2,0,0,8192,4,3016608228
12120,600109730,52364,600162094,4,0,0,3072,16,9214076103
12121,600131110,566,600131676,5,0,1,512,19,9181966467
12122,600139399,64208,600203607,1,0,0,6656,6,6620933293
12123,600149689,98876,600248565,1,0,0,22016,6,10622067325
12124,600273521,102128,600375649,6,0,0,35328,12,5582869326
12125,600328840,70545,600399385,0,0,0,5120,11,9743057982
12126,600335471,49292,600384763,6,0,0,3072,12,5125172890
12127,600459520,71132,600530652,2,0,0,9216,4,2573674398
12128,600689839,45596,600735435,1,0,0,1024,6,1807149400
12129,600731179,91172,600822351,7,0,0,24576,8,7504896898
12130,600755790,1994,600757784,7,0,1,2048,8,322091095
12131,600784139,67048,600851187,1,0,0,1024,6,3438248703
12132,600798470,1042,600799512,0,0,1,1024,11,7426933585
12133,600812220,147375,600959595,4,0,0,17408,16,568635454
12134,600817520,7786,600825306,6,0,1,3072,12,2190593895
12135,600817579,13423,600831002,2,0,1,8192,4,9054590599
12136,600843029,104156,600947185,7,0,0,41984,8,1342505664
12137,600973510,5802,600979312,0,0,1,6144,11,5046220468
12138,601028540,119087,601147627,0,0,0,36864,11,635540694
12139,601126861,68610,601195471,6,0,0,5120,12,4212818228
12140,601200740,76364,601277104,8,0,0,11264,12,8768137864
12141,601299879,47288,601347167,7,0,0,1536,8,6209221999
12142,601383869,65900,601449769,7,0,0,7168,8,1152265549
12143,601393471,81128,601474599,6,0,0,11776,12,7469150849
12144,601409099,82820,601491919,1,0,0,12288,6,2319097957
12145,601420310,1994,601422304,6,0,1,2048,12,2965674243
12146,601441760,50806,601492566,4,0,0,2048,16,2305964968
12147,601488170,5873,601494043,6,0,1,1536,12,624597235
12148,601519370,3387,601522757,9,0,1,9728,18,9024853912
12149,601625439,68684,601694123,1,0,0,11264,6,3774863888
12150,601713411,47600,601761011,6,0,0,2560,12,6305059003
12151,601727179,110396,601837575,7,0,0,62464,8,3914754979
12152,601805870,122437,601928307,0,0,0,70656,11,5739195210
12153,601876959,130956,602007915,7,0,0,32256,8,2826308584
12154,601896190,45596,601941786,0,0,0,1024,11,2634838166
12155,601941760,166313,602108073,8,0,0,26112,12,5196951562
12156,601944689,155413,602100102,1,0,0,63488,6,849521659
12157,602032550,78034,602110584,8,0,0,8192,12,5528699277
12158,602058099,6488,602064587,2,0,1,15872,4,6176982917
12159,602066199,90992,602157191,1,0,0,18944,6,4050382293
12160,602145849,4162,602150011,8,0,1,11264,12,2543094633
12161,602163309,59132,602222441,1,0,0,5120,6,10515432905
12162,602163611,62516,602226127,6,0,0,6144,12,8688249415
12163,602177820,2946,602180766,5,0,1,3072,19,6811624176
12164,602230200,566,602230766,5,0,1,512,19,1062025759
12165,602244511,55748,602300259,6,0,0,4096,12,559427732
12166,602301450,3422,602304872,7,0,1,3584,8,3457193230
12167,602338410,566,602338976,4,0,1,512,16,10249191433
12168,602349301,52676,602401977,6,0,0,4096,12,4429322552
12169,602350709,76052,602426761,1,0,0,10240,6,9696723074
12170,602396751,101348,602498099,6,0,0,32768,12,8193981082
12171,602480960,1042,602482002,9,0,1,1024,18,10545005864
12172,602532400,14117,602546517,7,0,1,24064,8,1475733247
12173,602534419,207038,602741457,7,0,0,68608,8,10401529487
12174,602572990,86769,602659759,5,0,0,2048,19,10568681864
12175,602586910,110399,602697309,4,0,0,54784,16,2990908923
12176,602633130,117234,602750364,8,0,0,29184,12,7382679139
12177,602889251,102128,602991379,6,0,0,35328,12,5036429073
12178,602940580,86403,603026983,5,0,0,13824,19,1258308365
12179,602982570,12223,602994793,1,0,1,3584,6,3879848701
12180,603040970,6278,603047248,6,0,1,6656,12,3549365728
12181,603127420,43904,603171324,5,0,0,512,19,2479044464
12182,603215599,70976,603286575,7,0,0,8704,8,5999370632
12183,603435979,62516,603498495,7,0,0,6144,8,6052389322
12184,603597410,55748,603653158,4,0,0,4096,16,6627880228
12185,603624460,115788,603740248,2,0,0,61952,4,4931139574
12186,603653999,150007,603804006,1,0,0,61440,6,3332383028
12187,603668970,4162,603673132,5,0,1,11264,19,10408761185
12188,603854859,7230,603862089,8,0,1,7680,12,9744423354
12189,603868410,92528,603960938,4,0,0,18944,16,5307138710
12190,603892790,115026,604007816,9,0,0,50688,18,7425852989
12191,604025680,11016,604036696,1,0,1,17920,6,10582603319
12192,604104780,101816,604206596,8,0,0,34304,12,4300990957
12193,604133040,81128,604214168,2,0,0,11776,4,357788839
12194,604203080,115932,604319012,3,0,0,69120,2,8932360040
12195,604260930,118196,604379126,0,0,0,88064,11,10581942732
12196,604279061,101492,604380553,6,0,0,4608,12,9620572103
12197,604284750,566,604285316,1,0,1,512,6,7758847965
12198,604293519,126431,604419950,7,0,0,18944,8,9151906769
12199,604321060,130246,604451306,9,0,0,5120,18,1756025658
12200,604330709,157149,604487858,7,0,0,69632,8,4939849193
12201,604363530,22784,604386314,5,0,1,6144,19,598178607
12202,604383990,164834,604548824,5,0,0,26624,19,839490590
12203,604406440,102424,604508864,2,0,0,21504,4,8083980032
12204,604413140,6825,604419965,5,0,1,8704,19,5312056947
12205,604440870,111268,604552138,5,0,0,512,19,387145310
12206,604445710,106249,604551959,2,0,0,10240,4,4520040261
12207,604487600,99282,604586882,4,0,0,30208,16,8322424029
12208,604500760,138232,604638992,9,0,0,64000,18,6117443694
12209,604527270,7706,604534976,0,0,1,8192,11,5633278870
12210,604544309,98286,604642595,1,0,0,11776,6,1997412120
12211,604559780,83298,604643078,5,0,0,1536,19,393535845
12212,604702770,3422,604706192,4,0,1,3584,16,1984527371
12213,604762839,70976,604833815,1,0,0,8704,6,8963430917
12214,604797089,101362,604898451,1,0,0,19456,6,9693449197
12215,604805551,74360,604879911,6,0,0,9728,12,2036655712
12216,604809909,52364,604862273,1,0,0,3072,6,7334368677
12217,605085970,60002,605145972,8,0,0,2560,12,6090270783
12218,605087379,4679,605092058,8,0,1,12288,12,3288830815
12219,605095300,110396,605205696,2,0,0,62464,4,6302559152
12220,605102500,2470,605104970,9,0,1,2560,18,7040143228
12221,605175170,1994,605177164,1,0,1,2048,6,5330126792
12222,605324309,63920,605388229,7,0,0,10752,8,7381582673
12223,605343090,103256,605446346,2,0,0,24064,4,5858309406
12224,605359659,131065,605490724,1,0,0,41472,6,3958596327
12225,605360019,3387,605363406,8,0,1,9728,12,6142739469
12226,605369700,108373,605478073,4,0,0,26112,16,1663250796
12227,605393800,109345,605503145,9,0,0,3584,18,5231844347
12228,605401520,131808,605533328,9,0,0,26112,18,1118226151
12229,605435371,98752,605534123,6,0,0,2560,12,4403353573
12230,605499880,5454,605505334,9,0,1,13824,18,6618707851
12231,605552590,73316,605625906,0,0,0,16384,11,3818369966
12232,605594890,114332,605709222,4,0,0,15360,16,10175957536
12233,605685010,88544,605773554,5,0,0,20992,19,2600601253
12234,605738610,86228,605824838,9,0,0,18432,18,3154486502
12235,605821249,73177,605894426,1,0,0,9216,6,2723505117
12236,605891080,13770,605904850,9,0,1,26624,18,7105351585
12237,606026630,97496,606124126,2,0,0,30208,4,7100514751
12238,606064380,47600,606111980,2,0,0,2560,4,5107031196
12239,606120179,10427,606130606,8,0,1,15872,12,4344022244
12240,606166739,5971,606172710,8,0,1,14848,12,520432760
12241,606186850,141565,606328415,2,0,0,10240,4,8569361105
12242,606231300,190445,606421745,4,0,0,88576,16,9146777175
12243,606267090,265463,606532553,2,0,0,21504,4,8046727403
12244,606287060,173817,606460877,9,0,0,15360,18,5972790991
12245,606315720,125705,606441425,5,0,0,27136,19,4587085250
12246,606402769,158908,606561677,1,0,0,41472,6,9429856903
12247,606408161,103501,606511662,6,0,0,15360,12,4541157410
12248,606434730,110555,606545285,4,0,0,17920,16,10344363520
12249,606481240,140527,606621767,2,0,0,40960,4,5510216681
12250,606517379,68671,606586050,1,0,0,10240,6,708938098
12251,606521649,105445,606627094,1,0,0,17408,6,9445416524
12252,606554561,138204,606692765,6,0,0,40960,12,1695336429
12253,606565030,2470,606567500,7,0,1,2560,8,8520865935
12254,606568389,146498,606714887,1,0,0,15872,6,9521135806
12255,606609330,138066,606747396,0,0,0,67584,11,10168673041
12256,606630920,150034,606780954,0,0,0,10240,11,7167534076
12257,606686020,126523,606812543,0,0,0,26624,11,5479810351
12258,606798850,47288,606846138,4,0,0,1536,16,9431749290
12259,606802910,9648,606812558,7,0,1,2048,8,9911167313
12260,606886300,107120,606993420,0,0,0,51712,11,7048377575
12261,607048060,102596,607150656,9,0,0,36864,18,7536529148
12262,607098950,130216,607229166,2,0,0,66560,4,10118889117
12263,607108250,7706,607115956,6,0,1,8192,12,6223313572
12264,607157430,145456,607302886,9,0,0,79872,18,7894218282
12265,607161050,73066,607234116,5,0,0,1024,19,2672292617
12266,607177380,207685,607385065,2,0,0,105472,4,4906630659
12267,607237339,3645,607240984,3,0,1,10240,2,3921350246
12268,607280630,147217,607427847,9,0,0,29696,18,9591153243
12269,607289280,96268,607385548,4,0,0,1536,16,2055155162
12270,607349050,91912,607440962,5,0,0,6144,19,4987986573
12271,607389540,6278,607395818,6,0,1,6656,12,10063739689
12272,607409560,6488,607416048,1,0,1,15872,6,5271955022
12273,607438010,222053,607660063,5,0,0,29696,19,1128500939
12274,607481881,89480,607571361,6,0,0,24064,12,7979952648
12275,607487631,249964,607737595,6,0,0,39936,12,8473291665
12276,607553149,119592,607672741,1,0,0,39936,6,2769099049
12277,607628260,226077,607854337,8,0,0,99328,12,6008148595
12278,607692290,110219,607802509,9,0,0,19968,18,3045895884
12279,607722550,194289,607916839,4,0,0,56320,16,8115210161
12280,607770320,6754,607777074,4,0,1,7168,16,10272908053
12281,607791340,104000,607895340,0,0,0,41472,11,2869886578
12282,607857680,151807,608009487,4,0,0,512,16,6240108216
12283,607885910,123406,608009316,2,0,0,74240,4,3557002133
12284,607905860,169825,608075685,0,0,0,29696,11,4533591011
12285,607923270,143352,608066622,9,0,0,69632,18,3091974959
12286,607955801,211190,608166991,6,0,0,6656,12,7084300546
12287,607967780,3645,607971425,7,0,1,10240,8,8353228602
12288,607974580,190352,608164932,4,0,0,129024,16,4259254345
12289,607979450,566,607980016,6,0,1,512,12,3083518506
12290,607990320,22105,608012425,6,0,1,3072,12,9081687147
12291,608140150,32126,608172276,1,0,1,5632,6,8042476336
12292,608140480,150933,608291413,4,0,0,115200,16,2960364075
12293,608241890,75708,608317598,5,0,0,6144,19,6874477117
12294,608275290,22869,608298159,0,0,1,7168,11,4937415901
12295,608292370,9975,608302345,1,0,1,6656,6,2405210033
12296,608329170,4374,608333544,6,0,1,4608,12,3424979287
12297,608404550,120757,608525307,2,0,0,58880,4,3731293058
12298,608413851,89454,608503305,6,0,0,2048,12,6209839646
12299,608440890,3422,608444312,6,0,1,3584,12,4751184824
12300,608530831,48980,608579811,6,0,0,2048,12,5247353904
12301,608546790,114140,608660930,4,0,0,74752,16,3731725577
12302,608587940,3128,608591068,9,0,1,9216,18,7687124296
12303,608647609,94753,608742362,7,0,0,12800,8,978374601
12304,608680890,85766,608766656,2,0,0,10752,4,1984688093
12305,608709419,566,608709985,8,0,1,512,12,5291747300
12306,608744799,566,608745365,8,0,1,512,12,1625830008
12307,608760330,107203,608867533,0,0,0,30720,11,9002121430
12308,608776420,162759,608939179,5,0,0,37888,19,1386477781
12309,608791340,6278,608797618,4,0,1,6656,16,8936562621
12310,608792500,150282,608942782,9,0,0,11776,18,3357301012
12311,608885699,3128,608888827,2,0,1,9216,4,10682434465
12312,608938710,81808,609020518,4,0,0,10752,16,1256737670
12313,608973899,116105,609090004,1,0,0,15872,6,8101556348
12314,609068050,119190,609187240,9,0,0,35328,18,1213002515
12315,609110649,136525,609247174,7,0,0,99840,8,897793635
12316,609169290,149536,609318826,2,0,0,35328,4,3480935654
12317,609274570,114654,609389224,5,0,0,38400,19,3451879400
12318,609343790,137054,609480844,5,0,0,39424,19,8369328542
12319,609420520,99164,609519684,5,0,0,25600,19,7177172050
12320,609455030,141760,609596790,2,0,0,50688,4,7390869322
12321,609518090,92578,609610668,8,0,0,18944,12,3756749603
12322,609541760,104624,609646384,9,0,0,43520,18,3763462780
12323,609598079,60824,609658903,7,0,0,5632,8,5602830029
12324,609637300,68988,609706288,8,0,0,7680,12,9673926642
12325,609647941,92552,609740493,6,0,0,24064,12,5276276258
12326,609789150,59600,609848750,0,0,0,6656,11,1462876445
12327,609803999,113204,609917203,1,0,0,71680,6,3099835458
12328,609895430,90562,609985992,5,0,0,7680,19,6053636094
12329,609918400,109928,610028328,0,0,0,60928,11,7711200816
12330,610018350,74178,610092528,5,0,0,6656,19,4897173457
12331,610064220,64208,610128428,2,0,0,6656,4,8996851621
12332,610164850,1994,610166844,0,0,1,2048,11,433042711
12333,610233400,47288,610280688,9,0,0,1536,18,7317877014
12334,610274349,4374,610278723,2,0,1,4608,4,2892659982
12335,610320709,64208,610384917,1,0,0,6656,6,8071178756
12336,610332121,118072,610450193,6,0,0,24576,12,10411024591
12337,610481899,101816,610583715,7,0,0,34304,8,3659655138
12338,610514479,2946,610517425,2,0,1,3072,4,3150448876
12339,610525270,370938,610896208,9,0,0,237568,18,7014353386
12340,610566870,191236,610758106,5,0,0,12288,19,8895229925
12341,610594959,194257,610789216,7,0,0,70144,8,10465863386
12342,610699930,204093,610904023,2,0,0,25600,4,5080656121
12343,610817819,87155,610904974,7,0,0,3072,8,7550668019
12344,610928831,48980,610977811,6,0,0,2048,12,3564270214
12345,610933211,69440,611002651,6,0,0,8704,12,1738588880
12346,611030609,61489,611092098,1,0,0,2560,6,665161555
12347,611039390,6278,611045668,4,0,1,6656,16,8317532890
12348,611073740,3422,611077162,1,0,1,3584,6,8398828585
12349,611301800,99632,611401432,4,0,0,27136,16,1659554520
12350,611413320,100568,611513888,9,0,0,30208,18,8304691050
12351,611487049,104468,611591517,1,0,0,43008,6,1334005454
12352,611501520,97188,611598708,4,0,0,23552,16,5527919203
12353,611514270,20882,611535152,9,0,1,33792,18,3523678915
12354,611606130,195950,611802080,2,0,0,3072,4,10594448095
12355,611644080,1994,611646074,1,0,1,2048,6,1863765859
12356,611660510,123108,611783618,8,0,0,4096,12,1831816277
12357,611688349,2470,611690819,2,0,1,2560,4,3187249731
12358,611781490,203187,611984677,5,0,0,81408,19,5229542122
12359,611788139,86407,611874546,7,0,0,512,8,8438282356
12360,611850159,1042,611851201,2,0,1,1024,4,2720357559
12361,611906970,12049,611919019,6,0,1,19968,12,1291001431
12362,612082990,45596,612128586,5,0,0,1024,19,5648490499
12363,612109840,2470,612112310,5,0,1,2560,19,10466262473
12364,612147040,62516,612209556,4,0,0,6144,16,5211994622
12365,612237890,54056,612291946,4,0,0,3584,16,9216303273
12366,612343440,103511,612446951,2,0,0,34816,4,7638218473
12367,612361350,566,612361916,1,0,1,512,6,7300056031
12368,612361750,57752,612419502,2,0,0,5632,4,8583087027
12369,612458541,101036,612559577,6,0,0,31744,12,6284125391
12370,612491780,149115,612640895,2,0,0,70656,4,7880098707
12371,612534710,142491,612677201,5,0,0,42496,19,2118450929
12372,612724110,76208,612800318,4,0,0,10752,16,8446066152
12373,612727990,1994,612729984,4,0,1,2048,16,5459985335
12374,612774739,95288,612870027,7,0,0,17920,8,8364121784
12375,612884570,65900,612950470,2,0,0,7168,4,72792545
12376,613044890,50828,613095718,2,0,0,3072,4,3845282554
12377,613063220,2470,613065690,1,0,1,2560,6,5729618755
12378,613098480,2470,613100950,1,0,1,2560,6,8911802172
12379,613133940,97916,613231856,0,0,0,21504,11,9807972754
12380,613185360,129374,613314734,2,0,0,65536,4,1309710165
12381,613188180,5454,613193634,0,0,1,13824,11,9743979739
12382,613200910,4850,613205760,4,0,1,5120,16,5374295565
12383,613247461,179462,613426923,6,0,0,13312,12,9138382931
12384,613256011,83288,613339299,6,0,0,13824,12,4719901830
12385,613331539,62624,613394163,7,0,0,5120,8,4520490111
12386,613336491,69324,613405815,6,0,0,9216,12,8775173368
12387,613397190,4374,613401564,9,0,1,4608,18,4402234202
12388,613409659,48980,613458639,7,0,0,2048,8,1881024059
12389,613492019,101816,613593835,1,0,0,34304,6,6423597977
12390,613579590,101660,613681250,5,0,0,33792,19,449438016
12391,613625220,151082,613776302,4,0,0,46080,16,1333861166
12392,613625360,99594,613724954,3,0,0,3584,2,5076071806
12393,613631620,62516,613694136,5,0,0,6144,19,8041958819
12394,613647900,1518,613649418,0,0,1,1536,11,3742284757
12395,613756350,62516,613818866,2,0,0,6144,4,8711061758
12396,613806640,69308,613875948,9,0,0,13312,18,3548617012
12397,613937220,22950,613960170,5,0,1,37888,19,1543516734
12398,613947799,74758,614022557,1,0,0,6656,6,8024173970
12399,613953539,110982,614064521,1,0,0,13312,6,2844708402
12400,614030870,60224,614091094,0,0,0,8704,11,8540441874
12401,614077669,65902,614143571,7,0,0,7168,8,9660384448
12402,614077679,83460,614161139,1,0,0,19456,6,7537876199
12403,614144990,52520,614197510,8,0,0,3584,12,7120485399
12404,614181049,56996,614238045,1,0,0,8192,6,8311688436
12405,614213341,149987,614363328,6,0,0,39424,12,5022451945
12406,614221520,6754,614228274,9,0,1,7168,18,8207032715
12407,614236710,11568,614248278,7,0,1,16384,8,9816269044
12408,614481280,57440,614538720,0,0,0,4608,11,7234360265
12409,614486140,10241,614496381,6,0,1,16384,12,2726998747
12410,614511140,96356,614607496,0,0,0,16384,11,5005376414
12411,614573889,47288,614621177,1,0,0,1536,6,2160209752
12412,614767560,54056,614821616,5,0,0,3584,19,5908047311
12413,614812100,99164,614911264,4,0,0,25600,16,8928133173
12414,614858590,115656,614974246,9,0,0,19456,18,7186015028
12415,614910990,832,614911822,9,0,1,512,18,1555559923
12416,614924300,7230,614931530,7,0,1,7680,8,4780180435
12417,614940620,5326,614945946,5,0,1,5632,19,3892341961
12418,614968649,212419,615181068,1,0,0,122368,6,7482656945
12419,615109671,183672,615293343,6,0,0,8192,12,6516240620
12420,615139719,1518,615141237,2,0,1,1536,4,9243019159
12421,615164100,126732,615290832,9,0,0,60416,18,148007915
12422,615210330,2946,615213276,6,0,1,3072,12,3139196957
12423,615234540,141984,615376524,8,0,0,41984,12,8899892889
12424,615288479,136146,615424625,1,0,0,1536,6,8445309044
12425,615371870,9972,615381842,0,0,1,5632,11,5638607381
12426,615427240,48980,615476220,0,0,0,2048,11,2278358026
12427,615485050,57440,615542490,8,0,0,4608,12,6588192773
12428,615561570,112892,615674462,8,0,0,70656,12,2910389818
12429,615619830,159044,615778874,2,0,0,113664,4,2083094198
12430,615638359,141326,615779685,1,0,0,2560,6,4232546184
12431,615638490,201554,615840044,8,0,0,81408,12,5980074485
12432,615672020,9664,615681684,6,0,1,7680,12,5380735224
12433,615675460,172867,615848327,8,0,0,27136,12,9005914054
12434,615717480,4162,615721642,7,0,1,11264,8,6763754953
12435,615751270,98491,615849761,0,0,0,3072,11,5461092819
12436,615763121,85689,615848810,6,0,0,1536,12,8930103890
12437,616050121,96824,616146945,6,0,0,17920,12,4440565725
12438,616120970,114452,616235422,8,0,0,75776,12,8653283774
12439,616140709,96288,616236997,7,0,0,5120,8,7283497798
12440,616160099,130877,616290976,7,0,0,25088,8,2950785501
12441,616237499,65300,616302799,7,0,0,10240,8,1772427129
12442,616331129,106028,616437157,1,0,0,48128,6,3634473772
12443,616369881,104920,616474801,6,0,0,3072,12,341020687
12444,616373120,110789,616483909,5,0,0,12800,19,7936716731
12445,616407609,95956,616503565,1,0,0,11776,6,506600992
12446,616434590,61691,616496281,5,0,0,5120,19,6580024754
12447,616453791,89588,616543379,6,0,0,14336,12,7462568033
12448,616466830,66111,616532941,9,0,0,5120,18,1614859922
12449,616476559,92382,616568941,1,0,0,17408,6,2118714104
12450,616488270,97369,616585639,5,0,0,512,19,249960982
12451,616506831,102346,616609177,6,0,0,1024,12,8888090118
12452,616530990,102284,616633274,2,0,0,35840,4,6871380624
12453,616613100,108056,616721156,0,0,0,54784,11,1703506207
12454,616645440,142658,616788098,8,0,0,41472,12,9519101616
12455,616732300,4374,616736674,7,0,1,4608,8,3628407280
12456,616931160,4374,616935534,5,0,1,4608,19,2548015643
12457,617037940,121079,617159019,9,0,0,27136,18,3029587112
12458,617074290,94820,617169110,0,0,0,16384,11,4370037597
12459,617206110,13253,617219363,5,0,1,25600,19,7654703464
12460,617214161,73517,617287678,6,0,0,12800,12,7943047468
12461,617223350,174789,617398139,2,0,0,137216,4,7531700833
12462,617353300,65612,617418912,5,0,0,11264,19,4693716725
12463,617357500,158648,617516148,4,0,0,30720,16,2170716607
12464,617541050,3387,617544437,4,0,1,9728,16,4858168327
12465,617566700,106184,617672884,8,0,0,48640,12,5918837379
12466,617753639,3422,617757061,8,0,1,3584,12,5107536056
12467,617760999,109657,617870656,7,0,0,49152,8,6472700765
12468,617814329,146463,617960792,7,0,0,41984,8,4015513774
12469,617873069,97184,617970253,1,0,0,29184,6,1699823650
12470,617887840,182225,618070065,4,0,0,24064,16,4807915435
12471,617900960,173956,618074916,8,0,0,15872,12,3199039527
12472,617906670,156048,618062718,2,0,0,80896,4,7117372622
12473,617918429,3645,617922074,8,0,1,10240,12,7281249005
12474,618094260,1518,618095778,4,0,1,1536,16,4007712636
12475,618139870,80396,618220266,0,0,0,19456,11,7676393388
12476,618220390,67592,618287982,2,0,0,7680,4,6309967645
12477,618255940,65300,618321240,5,0,0,10240,19,3675901874
12478,618374490,101036,618475526,9,0,0,31744,18,10055924126
12479,618443760,58376,618502136,5,0,0,7680,19,9663497334
12480,618503630,79592,618583222,9,0,0,11776,18,78209407
12481,618514720,129265,618643985,8,0,0,28160,12,2867846792
12482,618583439,62121,618645560,1,0,0,5120,6,878948620
12483,618599731,120322,618720053,6,0,0,37888,12,4143520393
12484,618610890,97604,618708494,0,0,0,20480,11,4659873594
12485,618683519,121368,618804887,1,0,0,23552,6,494254424
12486,618695430,65900,618761330,8,0,0,7168,12,10713586875
12487,618772860,103844,618876704,0,0,0,40960,11,1334433653
12488,618787570,102752,618890322,9,0,0,37376,18,6001632241
12489,618873739,48553,618922292,1,0,0,1024,6,3764795414
12490,618911550,70220,618981770,5,0,0,11264,19,3985584377
12491,618985540,72668,619058208,4,0,0,9216,16,5406794051
12492,618992259,3898,618996157,8,0,1,4096,12,3684700698
12493,619052920,90962,619143882,5,0,0,15360,19,1585102390
12494,619066270,95312,619161582,0,0,0,23040,11,4693874063
12495,619101920,142072,619243992,3,0,0,65536,2,7128260735
12496,619129290,130005,619259295,5,0,0,50176,19,5702643197
12497,619202389,1518,619203907,8,0,1,1536,12,2425220770
12498,619210230,117411,619327641,5,0,0,31744,19,6173916435
12499,619215350,102596,619317946,5,0,0,36864,19,6139634551
12500,619315310,93308,619408618,5,0,0,17920,19,7195357366
12501,619327719,7230,619334949,2,0,1,7680,4,10156229005
12502,619347580,92240,619439820,2,0,0,23040,4,2935356995
12503,619403230,11351,619414581,9,0,1,14848,18,1089434981
12504,619460840,81128,619541968,4,0,0,11776,16,10084909147
12505,619485441,160456,619645897,6,0,0,23552,12,3207455397
12506,619501330,137376,619638706,9,0,0,96256,18,1186873148
12507,619509639,204309,619713948,1,0,0,38912,6,9797752716
12508,619565539,177708,619743247,1,0,0,11776,6,4974425526
12509,619596430,151064,619747494,5,0,0,11776,19,6772043078
12510,619637410,10949,619648359,4,0,1,2560,16,5925886165
12511,619660210,94163,619754373,9,0,0,22528,18,7259420257
12512,619711399,46445,619757844,7,0,0,512,8,9810534581
12513,619750120,10216,619760336,7,0,1,14848,8,10395174330
12514,619761820,4679,619766499,6,0,1,12288,12,1227992907
12515,619776020,69284,619845304,4,0,0,8192,16,4347172878
12516,619805259,43904,619849163,7,0,0,512,8,7611334522
12517,619925900,80528,620006428,4,0,0,14848,16,6073334951
12518,620012210,111644,620123854,4,0,0,66560,16,6201848113
12519,620066130,3898,620070028,7,0,1,4096,8,6086347765
12520,620276330,6278,620282608,0,0,1,6656,11,2309572812
12521,620293560,48980,620342540,8,0,0,2048,12,9440094805
12522,620305189,101504,620406693,1,0,0,33280,6,10318836405
12523,620418829,54056,620472885,7,0,0,3584,8,9234650991
12524,620427759,91460,620519219,1,0,0,20480,6,5948252178
12525,620430509,1994,620432503,8,0,1,2048,12,3863386786
12526,620456180,141585,620597765,9,0,0,90624,18,5644933414
12527,620560460,5712,620566172,6,0,1,14336,12,5759809318
12528,620576030,209111,620785141,2,0,0,21504,4,8972336448
12529,620591090,129953,620721043,2,0,0,18944,4,2384169791
12530,620600979,98072,620699051,1,0,0,22016,6,4545253564
12531,620650120,86408,620736528,0,0,0,24064,11,3107468008
12532,620717500,187754,620905254,0,0,0,50176,11,3199531101
12533,620722110,119766,620841876,8,0,0,70144,12,2080028521
12534,620804970,161874,620966844,0,0,0,74752,11,539559262
12535,620805550,274940,621080490,8,0,0,129024,12,5778683320
12536,620828340,255285,621083625,8,0,0,10240,12,3613257806
12537,620915061,180807,621095868,6,0,0,27136,12,4931450798
12538,620951919,18045,620969964,8,0,1,9216,12,6635470336
12539,621020750,153136,621173886,5,0,0,50176,19,3071326749
12540,621028270,3898,621032168,5,0,1,4096,19,2949228791
12541,621065130,119991,621185121,2,0,0,33280,4,5678081690
12542,621098680,143420,621242100,3,0,0,46080,2,4833003349
12543,621125180,99550,621224730,8,0,0,3072,12,575955786
12544,621159721,107621,621267342,6,0,0,22016,12,4562793153
12545,621182090,85423,621267513,8,0,0,512,12,7734930124
12546,621192870,109902,621302772,9,0,0,31232,18,7767288117
12547,621283970,3422,621287392,0,0,1,3584,11,698997030
12548,621482319,74516,621556835,7,0,0,10240,8,2905469726
12549,621518280,107120,621625400,9,0,0,51712,18,8935897476
12550,621563420,7706,621571126,5,0,1,8192,19,5319042082
12551,621585360,7230,621592590,9,0,1,7680,18,53691032
12552,621637650,108212,621745862,5,0,0,55296,19,3566833706
12553,621753130,108212,621861342,0,0,0,55296,11,2433112013
12554,621770600,6278,621776878,0,0,1,6656,11,4053879180
12555,621779830,88358,621868188,8,0,0,1024,12,148219147
12556,621813270,135924,621949194,2,0,0,38912,4,9416882392
12557,621830870,57440,621888310,9,0,0,4608,18,1723222544
12558,622134260,5971,622140231,9,0,1,14848,18,4180673153
12559,622189881,47288,622237169,6,0,0,1536,12,6857642617
12560,622293690,66992,622360682,3,0,0,10752,2,8164134453
12561,622338490,87100,622425590,3,0,0,14848,2,2573458967
12562,622425970,65900,622491870,8,0,0,7168,12,3511044192
12563,622443780,4374,622448154,5,0,1,4608,19,4786116511
12564,622491900,100568,622592468,8,0,0,30208,12,6927989688
12565,622495440,5802,622501242,0,0,1,6144,11,4325575392
12566,622677140,5454,622682594,9,0,1,13824,18,8532803295
12567,622754670,7706,622762376,9,0,1,8192,18,2196248154
12568,622755680,77587,622833267,5,0,0,10240,19,9063973155
12569,622869770,56060,622925830,5,0,0,5120,19,2616843255
12570,622870851,114143,622984994,6,0,0,7168,12,2086913048
12571,622889910,87140,622977050,0,0,0,16384,11,9444318466
12572,622974410,103980,623078390,0,0,0,32768,11,8075347370
12573,622981550,5196,622986746,1,0,1,13312,6,2800524263
12574,622981770,7013,622988783,1,0,1,9216,6,3288632562
12575,623019329,154425,623173754,1,0,0,46080,6,2356746964
12576,623043890,7706,623051596,9,0,1,8192,18,1575934524
12577,623159240,89588,623248828,3,0,0,14336,2,6255447617
12578,623198540,100724,623299264,5,0,0,30720,19,2131807133
12579,623237530,3898,623241428,0,0,1,4096,11,6811099369
12580,623279090,82826,623361916,0,0,0,12288,11,3577753870
12581,623283179,24670,623307849,3,0,1,44544,2,1779215519
12582,623345550,66080,623411630,8,0,0,12800,12,264026419
12583,623367060,120716,623487776,4,0,0,12800,16,515433721
12584,623431119,133367,623564486,7,0,0,51712,8,2172144098
12585,623431810,95845,623527655,3,0,0,22016,2,3509075794
12586,623507071,117640,623624711,6,0,0,35840,12,853021092
12587,623530061,144648,623674709,6,0,0,12288,12,730282437
12588,623598880,114583,623713463,2,0,0,47616,4,5666653224
12589,623621059,140308,623761367,1,0,0,43520,6,3074736690
12590,623645300,181785,623827085,4,0,0,31232,16,8928449372
12591,623688081,125822,623813903,6,0,0,62464,12,5514827920
12592,623724750,3128,623727878,1,0,1,9216,6,4729969325
12593,623782800,88520,623871320,5,0,0,15872,19,447229468
12594,623829990,4679,623834669,9,0,1,12288,18,1514086543
12595,624074651,63140,624137791,6,0,0,8192,12,2266339707
12596,624117400,167566,624284966,2,0,0,61952,4,7839850504
12597,624122160,111488,624233648,2,0,0,66048,4,2908380587
12598,624281151,119195,624400346,6,0,0,78848,12,9794225000
12599,624320810,89202,624410012,2,0,0,3584,4,7137441762
12600,624332470,156220,624488690,5,0,0,69120,19,5405442137
12601,624446770,54056,624500826,2,0,0,3584,4,1981432112
12602,624483769,64201,624547970,1,0,0,5632,6,3898938261
12603,624572280,72380,624644660,4,0,0,13312,16,3969332470
12604,624611780,60068,624671848,0,0,0,8192,11,4721206968
12605,624632660,79436,624712096,4,0,0,11264,16,4803381794
12606,624754689,24242,624778931,2,0,1,40448,4,2428978115
12607,624804390,131185,624935575,4,0,0,29184,16,7799094659
12608,624827870,2946,624830816,4,0,1,3072,16,9092946106
12609,624865070,102227,624967297,3,0,0,6144,2,3590115244
12610,624870780,566,624871346,7,0,1,512,8,7989681008
12611,624891969,264373,625156342,1,0,0,87552,6,9437225796
12612,624923920,11670,624935590,7,0,1,9216,8,459346868
12613,625031250,98401,625129651,0,0,0,16384,11,8931668637
12614,625069721,127904,625197625,6,0,0,26624,12,3204053666
12615,625071460,87869,625159329,9,0,0,9728,18,4611571328
12616,625133230,142749,625275979,3,0,0,55808,2,9656905071
12617,625180580,167333,625347913,9,0,0,45056,18,8878615611
12618,625192210,109482,625301692,0,0,0,9728,11,837028742
12619,625231429,64208,625295637,7,0,0,6656,8,4848968208
12620,625270710,63460,625334170,8,0,0,4608,12,3903550134
12621,625276730,148316,625425046,2,0,0,70656,4,4428783992
12622,625277590,163266,625440856,9,0,0,15872,18,3030180319
12623,625381310,47840,625429150,8,0,0,1536,12,6329500441
12624,625395940,4374,625400314,0,0,1,4608,11,9463750402
12625,625435270,65900,625501170,5,0,0,7168,19,489026082
12626,625480530,89012,625569542,3,0,0,22528,2,4184537572
12627,625560720,83030,625643750,5,0,0,11776,19,1442816293
12628,625602559,108332,625710891,7,0,0,13312,8,8689162187
12629,625615471,67592,625683063,6,0,0,7680,12,566614735
12630,625656960,76388,625733348,0,0,0,16384,11,3185929074
12631,625746130,1042,625747172,1,0,1,1024,6,6559410587
12632,625760670,190993,625951663,9,0,0,124928,18,2297728665
12633,625763389,105565,625868954,7,0,0,5120,8,7230781391
12634,625827150,1518,625828668,0,0,1,1536,11,4587655623
12635,625858149,123657,625981806,1,0,0,5632,6,8842084460
12636,625858151,121916,625980067,6,0,0,56832,12,4492076651
12637,625869690,195601,626065291,9,0,0,36864,18,10309710201
12638,625881590,4850,625886440,1,0,1,5120,6,9752636913
12639,625917220,35001,625952221,1,0,1,512,6,3430517484
12640,625964769,22450,625987219,8,0,1,13824,12,10575179345
12641,625980660,247150,626227810,4,0,0,103936,16,7768330157
12642,626059570,59769,626119339,5,0,0,3584,19,3933103782
12643,626108389,45596,626153985,1,0,0,1024,6,572620509
12644,626124310,1042,626125352,1,0,1,1024,6,8325301068
12645,626194230,33603,626227833,6,0,1,10752,12,6010994811
12646,626197169,107645,626304814,7,0,0,18432,8,868056047
12647,626273920,100568,626374488,3,0,0,30208,2,7102070164
12648,626378799,80528,626459327,7,0,0,14848,8,2635744233
12649,626383390,55141,626438531,5,0,0,2048,19,146604047
12650,626435560,79436,626514996,8,0,0,11264,12,26925409
12651,626450559,110084,626560643,1,0,0,61440,6,976370327
12652,626495230,144758,626639988,4,0,0,19456,16,1889907916
12653,626520850,112892,626633742,9,0,0,70656,18,6098571758
12654,626546160,22198,626568358,5,0,1,8192,19,2053847661
12655,626558980,128588,626687568,9,0,0,44544,18,2631876169
12656,626602590,4679,626607269,1,0,1,12288,6,4059972970
12657,626669720,98696,626768416,3,0,0,24064,2,5669850268
12658,626686710,95250,626781960,2,0,0,25088,4,262810348
12659,626718869,132733,626851602,1,0,0,30720,6,5184405503
12660,626821120,98072,626919192,8,0,0,22016,12,9387813076
12661,626844981,154125,626999106,6,0,0,56320,12,1244752532
12662,626871819,90680,626962499,7,0,0,17920,8,3396042563
12663,626951001,50672,627001673,6,0,0,2560,12,9184236992
12664,627017690,62516,627080206,8,0,0,6144,12,1769537601
12665,627093630,76388,627170018,8,0,0,16384,12,793901747
12666,627097449,80240,627177689,7,0,0,18944,8,3976632810
12667,627176771,65586,627242357,6,0,0,8192,12,10059104024
12668,627203230,103532,627306762,2,0,0,39936,4,556052446
12669,627205610,162574,627368184,8,0,0,28672,12,4706402273
12670,627321710,114580,627436290,2,0,0,34304,4,5497261031
12671,627443190,83312,627526502,9,0,0,18944,18,7246691535
12672,627447980,101504,627549484,4,0,0,33280,16,439486307
12673,627531710,54680,627586390,3,0,0,5632,2,6194992406
12674,627562149,65900,627628049,1,0,0,7168,6,5794067021
12675,627569570,54056,627623626,8,0,0,3584,12,4349551744
12676,627615330,3387,627618717,4,0,1,9728,16,9160495824
12677,627677551,100256,627777807,6,0,0,29184,12,87237129
12678,627691460,22174,627713634,9,0,1,36352,18,1954097367
12679,627708280,135713,627843993,9,0,0,18432,18,8441797661
12680,627806290,76052,627882342,2,0,0,10240,4,420233313
12681,627903839,3387,627907226,2,0,1,9728,4,5873785641
12682,628011520,5802,628017322,1,0,1,6144,6,7397306709
12683,628193400,5326,628198726,7,0,1,5632,8,3498739277
12684,628238510,72668,628311178,4,0,0,9216,16,1265145548
12685,628249929,84512,628334441,7,0,0,12800,8,1800552836
12686,628250930,47288,628298218,5,0,0,1536,19,1527698411
12687,628275620,88208,628363828,3,0,0,14848,2,9206908161
12688,628430220,5196,628435416,7,0,1,13312,8,3943655379
12689,628467139,154784,628621923,1,0,0,5632,6,9099936474
12690,628499960,3128,628503088,5,0,1,9216,19,8728309649
12691,628609740,222691,628832431,5,0,0,24064,19,9716505273
12692,628660859,76520,628737379,1,0,0,11776,6,653562284
12693,628802640,69284,628871924,0,0,0,8192,11,8308254975
12694,628830090,113041,628943131,3,0,0,63488,2,10550155628
12695,628837310,112997,628950307,9,0,0,21504,18,6617433812
12696,628876190,6754,628882944,4,0,1,7168,16,5919416332
12697,628930191,186297,629116488,6,0,0,23552,12,6956416212
12698,629028530,4850,629033380,6,0,1,5120,12,3813358148
12699,629135050,3904,629138954,7,0,1,10752,8,7657890439
12700,629136530,115549,629252079,0,0,0,11776,11,80656006
12701,629138640,660,629139300,5,0,1,512,19,9377146498
12702,629227240,6278,629233518,9,0,1,6656,18,6076737106
12703,629254119,126961,629381080,1,0,0,78848,6,1638978581
12704,629321120,2870,629323990,7,0,1,8704,8,5932387723
12705,629330700,129988,629460688,9,0,0,40448,18,8959757504
12706,629374419,152299,629526718,1,0,0,29184,6,628605441
12707,629434080,54056,629488136,8,0,0,3584,12,8917274536
12708,629476110,12041,629488151,0,0,1,19456,11,5930384393
12709,629570960,2470,629573430,9,0,1,2560,18,1116924652
12710,629654340,4850,629659190,0,0,1,5120,11,3753178256
12711,629673520,13341,629686861,5,0,1,22528,19,6607912737
12712,629700410,120379,629820789,9,0,0,28672,18,921623842
12713,629713839,147090,629860929,1,0,0,18432,6,8771692403
12714,629722660,110000,629832660,0,0,0,38912,11,4066497967
12715,629845799,85160,629930959,1,0,0,19968,6,8811105517
12716,629859430,64007,629923437,8,0,0,6144,12,10629874082
12717,629903680,5326,629909006,6,0,1,5632,12,7253339436
12718,629982030,52364,630034394,4,0,0,3072,16,7954526272
12719,629990020,44545,630034565,0,0,0,512,11,10300907380
12720,630214680,2470,630217150,5,0,1,2560,19,8849742413
12721,630237759,57440,630295199,1,0,0,4608,6,4419808084
12722,630238710,111800,630350510,0,0,0,67072,11,7412140422
12723,630354660,111644,630466304,5,0,0,66560,19,841090869
12724,630376600,100564,630477164,2,0,0,9216,4,8848859926
12725,630378160,159706,630537866,9,0,0,23040,18,10643865237
12726,630401920,83986,630485906,2,0,0,13824,4,4740926101
12727,630453800,113544,630567344,0,0,0,30720,11,2053151446
12728,630565540,126388,630691928,9,0,0,109056,18,5189854743
12729,630605270,87157,630692427,2,0,0,1536,4,3893945121
12730,630629230,64460,630693690,2,0,0,4096,4,8421142400
12731,630629590,127594,630757184,3,0,0,23552,2,9006973144
12732,630666110,131214,630797324,0,0,0,46080,11,7019871805
12733,630683320,119635,630802955,9,0,0,18432,18,3540039421
12734,630787540,87163,630874703,3,0,0,11264,2,5511703309
12735,630804660,55748,630860408,0,0,0,4096,11,3721871711
12736,630860949,78170,630939119,7,0,0,8704,8,2552421085
12737,630911859,76052,630987911,7,0,0,10240,8,5454138495
12738,630931421,91952,631023373,6,0,0,27136,12,5553361924
12739,630969400,69284,631038684,4,0,0,8192,16,5077650153
12740,630987240,67560,631054800,3,0,0,5632,2,597113588
12741,631020699,55030,631075729,1,0,0,3072,6,9028663106
12742,631088290,3128,631091418,4,0,1,9216,16,8805044752
12743,631111889,111332,631223221,7,0,0,65536,8,7426304116
12744,631139460,140119,631279579,0,0,0,22528,11,5478307699
12745,631140899,2946,631143845,8,0,1,3072,12,5678342583
12746,631166559,232425,631398984,1,0,0,54784,6,7352512103
12747,631207650,129235,631336885,8,0,0,73216,12,1254450146
12748,631356139,95492,631451631,7,0,0,28672,8,216322659
12749,631367170,3387,631370557,1,0,1,9728,6,424035801
12750,631410840,54056,631464896,4,0,0,3584,16,7471955453
12751,631437060,106503,631543563,2,0,0,30720,4,3303365374
12752,631490380,77415,631567795,0,0,0,19456,11,5611891915
12753,631491869,68840,631560709,1,0,0,11776,6,6376050037
12754,631597910,92791,631690701,7,0,1,150528,8,1223132495
12755,631666920,205661,631872581,0,0,0,4608,11,1422620712
12756,631692650,122435,631815085,4,0,0,28160,16,123654933
12757,631751489,143466,631894955,1,0,0,33792,6,7957842060
12758,631826509,54012,631880521,2,0,1,91648,4,3988861367
12759,631861361,139423,632000784,6,0,0,39936,12,6370744710
12760,631896890,163911,632060801,3,0,0,35328,2,8791817586
12761,631915299,94514,632009813,1,0,0,4096,6,10567603355
12762,632013680,102782,632116462,8,0,0,34816,12,1941965404
12763,632049450,122242,632171692,2,0,0,13312,4,10414389694
12764,632220740,4850,632225590,0,0,1,5120,11,2289351970
12765,632404220,10499,632414719,9,0,1,16896,18,9714372412
12766,632474200,197581,632671781,4,0,0,70656,16,5796477246
12767,632496000,98228,632594228,9,0,0,22528,18,8747002390
12768,632584300,106567,632690867,2,0,0,6144,4,2189993027
12769,632653649,151673,632805322,2,0,1,216576,4,3066602367
12770,632676990,267876,632944866,0,0,0,1024,11,9988685923
12771,632734920,209619,632944539,2,0,0,53760,4,1522170354
12772,632851559,190726,633042285,7,0,0,25600,8,6924807395
12773,632905400,104857,633010257,8,0,0,41472,12,134359280
12774,632959721,160294,633120015,6,0,0,52736,12,8279561709
12775,632988391,70976,633059367,6,0,0,8704,12,5007484553
12776,633047250,3387,633050637,1,0,1,9728,6,2685975662
12777,633111920,10081,633122001,9,0,1,2048,18,23110943
12778,633122280,566,633122846,6,0,1,512,12,1433408074
12779,633153590,54368,633207958,5,0,0,4608,19,6661205750
12780,633271700,107588,633379288,9,0,0,53248,18,8350257890
12781,633294140,168914,633463054,3,0,0,90112,2,6035549681
12782,633357100,112500,633469600,9,0,0,4608,18,4240738388
12783,633447571,93219,633540790,6,0,0,10752,12,10014188987
12784,633457079,20537,633477616,8,0,1,28160,12,5370727943
12785,633631300,64208,633695508,4,0,0,6656,16,10525804547
12786,633701390,60824,633762214,3,0,0,5632,2,1955911781
12787,633762520,16613,633779133,9,0,1,32256,18,9991875698
12788,633772549,91748,633864297,7,0,0,16384,8,508747549
12789,633778630,1169,633779799,1,0,1,1024,6,6287482177
12790,633837690,5802,633843492,4,0,1,6144,16,9420675900
12791,633896441,82088,633978529,6,0,0,19968,12,8535483819
12792,633916990,142124,634059114,7,0,1,229888,8,4688843273
12793,633928940,294563,634223503,0,0,0,40960,11,799511506
12794,633930420,244486,634174906,0,0,0,10752,11,6955834863
12795,634046909,14791,634061700,8,0,1,4096,12,8393528400
12796,634176550,93261,634269811,5,0,0,9216,19,7114549236
12797,634224870,83312,634308182,0,0,0,18944,11,4013868359
12798,634246930,6229,634253159,7,0,1,15360,8,6886617548
12799,634255950,63673,634319623,9,0,0,4096,18,5004107256
12800,634342250,4420,634346670,4,0,1,11776,16,7987002340
12801,634349381,109148,634458529,6,0,0,58368,12,10430707042
12802,634364440,169351,634533791,9,0,0,12800,18,76769532
12803,634366671,176398,634543069,6,0,0,23552,12,7882562416
12804,634380981,119014,634499995,6,0,0,16896,12,509589692
12805,634410659,102908,634513567,7,0,0,37888,8,4492986893
12806,634425690,47288,634472978,9,0,0,1536,18,5369097826
12807,634480860,113066,634593926,2,0,0,33280,4,298516798
12808,634594950,6754,634601704,0,0,1,7168,11,3707336324
12809,634653810,107900,634761710,9,0,0,54272,18,2237234895
12810,634748120,86874,634834994,3,0,0,11264,2,6173988171
12811,634879580,100568,634980148,2,0,0,30208,4,1085082770
12812,634894680,47288,634941968,3,0,0,1536,2,4836989155
12813,634899440,6754,634906194,1,0,1,7168,6,2317032840
12814,634911980,71774,634983754,5,0,0,5632,19,6431637514
12815,634915011,79904,634994915,6,0,0,12800,12,4578582875
12816,634938440,106401,635044841,8,0,0,39424,12,5413203135
12817,634968430,15339,634983769,4,0,1,28672,16,2263891605
12818,634972280,11504,634983784,9,0,1,9728,18,4009509427
12819,634972500,101729,635074229,8,0,0,18944,12,10455748669
12820,634976110,9030,634985140,0,0,1,2048,11,7446965021
12821,635006861,108822,635115683,6,0,0,7680,12,10726255488
12822,635016839,197957,635214796,7,0,0,3584,8,2326850885
12823,635174580,7230,635181810,1,0,1,7680,6,1080126580
12824,635348610,52676,635401286,3,0,0,4096,2,10725414361
12825,635414270,10499,635424769,4,0,1,16896,16,9592123380
12826,635470790,103844,635574634,5,0,0,40960,19,8719702510
12827,635563800,110926,635674726,3,0,0,28672,2,6233554358
12828,635572370,5244,635577614,4,0,1,3072,16,8468093858
12829,635572659,72105,635644764,1,0,0,12800,6,2359402581
12830,635609171,100724,635709895,6,0,0,30720,12,10558586213
12831,635664899,12737,635677636,8,0,1,24576,12,4663428333
12832,635694189,68969,635763158,7,0,0,6144,8,6841319400
12833,635771400,123912,635895312,0,0,0,9728,11,1547158084
12834,635796020,1518,635797538,6,0,1,1536,12,319454246
12835,635846870,137692,635984562,0,0,0,69632,11,3148113330
12836,635967470,117808,636085278,9,0,0,30720,18,6412647979
12837,636009600,3904,636013504,9,0,1,10752,18,7318478002
12838,636043590,4850,636048440,6,0,1,5120,12,1291093429
12839,636084920,98578,636183498,2,0,0,22528,4,7986186609
12840,636111429,327216,636438645,2,0,1,530432,4,1889305926
12841,636128680,363728,636492408,9,0,0,18432,18,9433228928
12842,636199440,356297,636555737,9,0,0,38400,18,2541103052
12843,636284470,160793,636445263,0,0,1,31744,11,6606920117
12844,636335690,275483,636611173,5,0,0,31744,19,17678325
12845,636445330,1518,636446848,0,0,1,1536,11,3144616811
12846,636456520,2946,636459466,9,0,1,3072,18,5774339562
12847,636461911,215378,636677289,6,0,0,48640,12,4388668680
12848,636483150,136855,636620005,5,0,0,15360,19,2523517301
12849,636617661,61651,636679312,6,0,0,3584,12,6665405274
12850,636717530,1518,636719048,6,0,1,1536,12,6404657436
12851,636796880,2470,636799350,4,0,1,2560,16,7043891583
12852,636814320,91748,636906068,3,0,0,16384,2,5464301243
12853,636895300,78392,636973692,2,0,0,17920,4,1493916748
12854,636947870,101036,637048906,5,0,0,31744,19,865926135
12855,636988180,126981,637115161,9,0,0,6144,18,590926828
12856,637036309,54368,637090677,1,0,0,4608,6,1746882905
12857,637048060,7592,637055652,0,0,1,7168,11,8416223967
12858,637073481,95936,637169417,6,0,0,25088,12,8979771806
12859,637177649,79436,637257085,7,0,0,11264,8,2462829705
12860,637215750,128893,637344643,9,0,0,70656,18,3287463967
12861,637236720,1518,637238238,9,0,1,1536,18,9704439419
12862,637256499,149723,637406222,7,0,0,25600,8,4738459639
12863,637418310,3645,637421955,5,0,1,10240,19,156418590
12864,637441470,72533,637514003,3,0,0,12800,2,7301420850
12865,637443181,86811,637529992,6,0,0,19968,12,3839581617
12866,637506011,97661,637603672,6,0,0,27648,12,7283152671
12867,637510809,55550,637566359,1,0,0,3072,6,6396615361
12868,637550739,196827,637747566,7,0,0,92160,8,2408342740
12869,637558660,109148,637667808,8,0,0,58368,12,2249620415
12870,637752330,103064,637855394,9,0,0,38400,18,6058992577
12871,637805700,142874,637948574,3,0,0,44544,2,929010273
12872,637855460,102006,637957466,2,0,0,8192,4,6590770267
12873,637914249,82769,637997018,1,0,0,9728,6,4470210537
12874,638025790,79304,638105094,8,0,0,15872,12,2061657386
12875,638029360,173907,638203267,0,0,0,19968,11,1100509749
12876,638042501,140605,638183106,6,0,0,110592,12,749184465
12877,638042940,141273,638184213,8,0,0,3584,12,8121222898
12878,638167000,22531,638189531,7,0,1,5632,8,121694104
12879,638235141,59132,638294273,6,0,0,5120,12,9064164576
12880,638240500,128695,638369195,3,0,0,23040,2,9699651291
12881,638296030,5326,638301356,9,0,1,5632,18,4405216536
12882,638452300,61760,638514060,5,0,0,8704,19,8292801910
12883,638766980,100100,638867080,0,0,0,28672,11,1382142797
12884,638785100,7230,638792330,6,0,1,7680,12,3987852699
12885,638795990,6754,638802744,1,0,1,7168,6,5815036255
12886,638852609,47288,638899897,7,0,0,1536,8,5774293960
12887,638921660,92972,639014632,5,0,0,15360,19,7611321245
12888,638943390,59132,639002522,5,0,0,5120,19,876252906
12889,639026969,357075,639384044,2,0,1,578560,4,7800123874
12890,639037160,348510,639385670,4,0,1,2560,16,6502297734
12891,639041610,423333,639464943,0,0,0,71168,11,10307853595
12892,639095030,418233,639513263,8,0,0,16384,12,8387344005
12893,639421450,160724,639582174,8,0,0,18432,12,10567161729
12894,639478159,98101,639576260,7,0,0,19968,8,5436561209
12895,639483930,4420,639488350,9,0,1,11776,18,4237068792
12896,639512261,147019,639659280,6,0,0,43520,12,8145283705
12897,639552419,131690,639684109,7,0,0,44544,8,9518138552
12898,639704820,89744,639794564,2,0,0,14848,4,3767098110
12899,639724150,88544,639812694,2,0,0,20992,4,3795100592
12900,639818479,59132,639877611,1,0,0,5120,6,3442608449
12901,639884930,104468,639989398,8,0,0,43008,12,3545591029
12902,639925630,130398,640056028,9,0,0,28672,18,9922780108
12903,640184550,86204,640270754,0,0,0,13312,11,7625903007
12904,640268979,101867,640370846,1,0,0,28672,6,3165809065
12905,640317440,3422,640320862,9,0,1,3584,18,707243816
12906,640447200,104278,640551478,3,0,0,23552,2,9497968537
12907,640448330,152802,640601132,0,0,0,44032,11,5470485371
12908,640515110,2470,640517580,7,0,1,2560,8,2919381027
12909,640545080,112620,640657700,2,0,0,5632,4,8087582988
12910,640550129,94215,640644344,7,0,0,7168,8,7400045813
12911,640624100,66680,640690780,2,0,0,9728,4,3866393946
12912,640657740,113734,640771474,3,0,0,46592,2,8358550842
12913,640666049,69284,640735333,1,0,0,8192,6,5682329036
12914,640704750,135766,640840516,0,0,0,55296,11,9128440846
12915,640814081,100989,640915070,6,0,0,27136,12,6478717855
12916,640834340,173283,641007623,4,0,0,91136,16,1570051842
12917,640839379,78990,640918369,1,0,0,10752,6,3614346556
12918,640853310,163436,641016746,8,0,0,10752,12,4012501414
12919,640908720,109826,641018546,5,0,0,1536,19,3534341811
12920,640920910,130639,641051549,0,0,0,17408,11,8511601720
12921,640996731,130654,641127385,6,0,0,5120,12,7083209884
12922,641021831,75008,641096839,6,0,0,16896,12,4481618319
12923,641040250,76988,641117238,5,0,0,13312,19,9784421384
12924,641108490,60824,641169314,0,0,0,5632,11,3459271305
12925,641215150,6278,641221428,4,0,1,6656,16,2257663901
12926,641396751,108836,641505587,6,0,0,57344,12,4634118037
12927,641414900,101348,641516248,0,0,0,32768,11,7875428678
12928,641507270,57950,641565220,5,0,0,2048,19,3356940908
12929,641569019,43904,641612923,1,0,0,512,6,6853966140
12930,641620990,87896,641708886,8,0,0,13824,12,6572016959
12931,641664800,98852,641763652,0,0,0,24576,11,805674589
12932,641733560,566,641734126,9,0,1,512,18,3068091665
12933,641736410,5802,641742212,9,0,1,6144,18,4827178385
12934,641795849,90992,641886841,1,0,0,18944,6,5960493602
12935,641815369,25446,641840815,2,0,1,46080,4,5349514627
12936,641888859,2946,641891805,2,0,1,3072,4,5812603410
12937,641919900,1042,641920942,5,0,1,1024,19,3424974782
12938,641937130,138819,642075949,0,0,0,24064,11,6755603104
12939,641962880,5326,641968206,7,0,1,5632,8,5932989105
12940,641966020,54056,642020076,3,0,0,3584,2,304564854
12941,642148321,43904,642192225,6,0,0,512,12,1022072358
12942,642153369,115020,642268389,2,0,1,190464,4,5449393481
12943,642158421,306189,642464610,6,0,0,40448,12,2352145753
12944,642243290,25765,642269055,0,0,1,1024,11,7227783899
12945,642289400,84668,642374068,3,0,0,13312,2,2795070214
12946,642320600,5326,642325926,9,0,1,5632,18,10305480455
12947,642329210,271780,642600990,9,0,0,22016,18,2822184315
12948,642343650,243748,642587398,8,0,0,77824,12,7176903263
12949,642349550,1042,642350592,0,0,1,1024,11,7038777192
12950,642390270,198859,642589129,9,0,0,5632,18,38048264
12951,642411980,151691,642563671,2,0,0,26624,4,8876078495
12952,642427131,101510,642528641,6,0,0,7680,12,5174267922
12953,642544400,142331,642686731,3,0,0,14336,2,5830468168
12954,642546049,5802,642551851,8,0,1,6144,12,3530696243
12955,642575389,81036,642656425,7,0,0,11776,8,4405844336
12956,642650951,74360,642725311,6,0,0,9728,12,7001047935
12957,643120040,47444,643167484,9,0,0,2048,18,1871567071
12958,643162630,97604,643260234,3,0,0,20480,2,9906537236
12959,643250759,103532,643354291,7,0,0,39936,8,5097594899
12960,643253210,62516,643315726,8,0,0,6144,12,6963005089
12961,643326120,4162,643330282,7,0,1,11264,8,4989439464
12962,643375130,6278,643381408,0,0,1,6656,11,9218088649
12963,643413310,65900,643479210,9,0,0,7168,18,1675630245
12964,643414940,7706,643422646,4,0,1,8192,16,10717259443
12965,643465950,146336,643612286,9,0,0,2048,18,7814249668
12966,643493139,118508,643611647,7,0,0,89088,8,9041296416
12967,643547140,70376,643617516,8,0,0,11776,12,2487364367
12968,643548709,6278,643554987,8,0,1,6656,12,3470393923
12969,643617610,6488,643624098,9,0,1,15872,18,647740829
12970,643767431,98408,643865839,6,0,0,28160,12,6924236606
12971,643778730,45596,643824326,9,0,0,1024,18,4968714671
12972,643809540,4850,643814390,6,0,1,5120,12,971522955
12973,643827470,98835,643926305,9,0,0,26624,18,3382080960
12974,643943950,107165,644051115,0,0,0,36352,11,6976931008
12975,644001709,49585,644051294,1,0,0,512,6,2855428001
12976,644010699,102774,644113473,7,0,0,28160,8,7894824884
12977,644035420,121919,644157339,9,0,0,39936,18,7249807227
12978,644048240,92035,644140275,5,0,0,4096,19,1924036836
12979,644086420,125773,644212193,9,0,0,10240,18,9004041888
12980,644104590,53076,644157666,8,0,0,1024,12,3250774578
12981,644114410,54299,644168709,2,0,0,512,4,3450391026
12982,644158590,81620,644240210,9,0,0,18432,18,5072158512
12983,644236000,7624,644243624,0,0,1,3584,11,5609231989
12984,644261859,203391,644465250,2,0,1,329216,4,2348848243
12985,644350310,117206,644467516,1,0,1,3584,6,3252201155
12986,644355470,142443,644497913,5,0,0,17408,19,1269500877
12987,644444930,238530,644683460,9,0,0,44544,18,1281981736
12988,644450751,161799,644612550,6,0,0,2048,12,5886398164
12989,644467200,3645,644470845,9,0,1,10240,18,1077181869
12990,644502689,97459,644600148,1,0,0,17920,6,10028952294
12991,644509009,200307,644709316,7,0,0,7680,8,457196497
12992,644571320,4420,644575740,4,0,1,11776,16,6082582754
12993,644641960,4374,644646334,1,0,1,4608,6,5438099534
12994,644705680,103220,644808900,8,0,0,38912,12,3949975652
12995,644750599,24670,644775269,2,0,1,44544,4,4746647116
12996,644815531,62516,644878047,6,0,0,6144,12,2949328819
12997,644887400,92372,644979772,9,0,0,18432,18,1462816633
12998,644953760,76052,645029812,0,0,0,10240,11,1580915814
12999,644962149,128161,645090310,7,0,0,96768,8,9920290728
13000,645038380,71293,645109673,2,0,0,5632,4,392768925
13001,645165590,69284,645234874,3,0,0,8192,2,6200179172
13002,645181780,5712,645187492,9,0,1,14336,18,4820491039
13003,645182950,132462,645315412,5,0,0,44544,19,4192212415
13004,645267820,89769,645357589,2,0,0,18432,4,9613287086
13005,645310679,103421,645414100,7,0,0,24064,8,9123273746
13006,645339091,147549,645486640,6,0,0,17920,12,7979649032
13007,645414250,138720,645552970,2,0,0,37888,4,5412069782
13008,645456271,143163,645599434,6,0,0,54272,12,8960958657
13009,645517891,200341,645718232,6,0,0,28672,12,1775649335
13010,645536600,2946,645539546,4,0,1,3072,16,8474781163
13011,645568980,110084,645679064,9,0,0,61440,18,4646331949
13012,645590930,14774,645605704,9,0,1,6656,18,5742860686
13013,645627320,142218,645769538,8,0,0,54784,12,3294676827
13014,645835730,54212,645889942,2,0,0,4096,4,5576253367
13015,645873240,103220,645976460,5,0,0,38912,19,8040133620
13016,645933460,152404,646085864,5,0,0,98304,19,1275692084
13017,645978880,2470,645981350,9,0,1,2560,18,6538570491
13018,646028610,75338,646103948,2,0,0,9216,4,7900886873
13019,646044210,146143,646190353,3,0,0,47104,2,3531035887
13020,646067430,22330,646089760,5,0,1,10752,19,4933270737
13021,646111890,142441,646254331,5,0,0,24064,19,3856810398
13022,646182839,114487,646297326,1,0,0,22528,6,947083395
13023,646185069,9692,646194761,3,0,1,4608,2,4024344852
13024,646185850,104597,646290447,9,0,0,5120,18,6483660046
13025,646207211,48884,646256095,6,0,0,512,12,4144497893
13026,646274870,95195,646370065,5,0,0,17408,19,2971145354
13027,646322960,1042,646324002,5,0,1,1024,19,2690804271
13028,646402409,124230,646526639,1,0,0,56832,6,1741731824
13029,646417959,65612,646483571,1,0,0,11264,6,610392691
13030,646455590,176685,646632275,2,0,0,33280,4,7764167151
13031,646471001,107100,646578101,6,0,0,17920,12,6393304610
13032,646475889,93128,646569017,1,0,0,15872,6,4628129664
13033,646485440,3387,646488827,4,0,1,9728,16,10159141978
13034,646561360,99632,646660992,5,0,0,27136,19,8051359724
13035,646649559,1994,646651553,8,0,1,2048,12,480734919
13036,646722570,101660,646824230,2,0,0,33792,4,9812674283
13037,646747810,125218,646873028,3,0,0,16384,2,6312096499
13038,646816260,137774,646954034,0,0,0,54272,11,5954722543
13039,646850159,55748,646905907,7,0,0,4096,8,5261852276
13040,646946229,103265,647049494,1,0,0,23552,6,1884808240
13041,646954060,139036,647093096,2,0,0,44544,4,4948065876
13042,646979680,70453,647050133,0,0,0,2048,11,2476235173
13043,646995549,120005,647115554,1,0,0,11264,6,5148989016
13044,647033880,188162,647222042,3,0,0,50688,2,4421230525
13045,647035020,96068,647131088,2,0,0,20480,4,3595693750
13046,647050000,143698,647193698,3,0,0,35840,2,8367834375
13047,647071791,86903,647158694,6,0,0,4096,12,6561077953
13048,647212180,99646,647311826,5,0,0,25088,19,4406607620
13049,647357079,64208,647421287,7,0,0,6656,8,9590077821
13050,647500309,83839,647584148,7,0,0,9216,8,10505803591
13051,647511480,101816,647613296,8,0,0,34304,12,6609261003
13052,647625789,11274,647637063,8,0,1,18432,12,5912899090
13053,647655970,72536,647728506,0,0,0,13824,11,10581194634
13054,647660510,57440,647717950,3,0,0,4608,2,4369121614
13055,647661060,91666,647752726,2,0,0,17920,4,2830737411
13056,647674950,114992,647789942,3,0,0,62976,2,6383520018
13057,647835350,102284,647937634,8,0,0,35840,12,1349300802
13058,647873900,14117,647888017,1,0,1,24064,6,2983246796
13059,647893180,65688,647958868,0,0,0,3584,11,10588212059
13060,647930440,56166,647986606,0,0,0,2048,11,9699520941
13061,647973250,101192,648074442,8,0,0,32256,12,4319534494
13062,648102990,62516,648165506,9,0,0,6144,18,6199483277
13063,648165770,5802,648171572,1,0,1,6144,6,7440909608
13064,648243020,115232,648358252,3,0,0,78336,2,9738850976
13065,648299950,77988,648377938,3,0,0,10752,2,881501467
13066,648440569,156037,648596606,2,0,1,257024,4,8810964314
13067,648443221,279836,648723057,6,0,0,39936,12,1768318182
13068,648498800,191783,648690583,0,0,0,9216,11,5231649440
13069,648508220,275069,648783289,4,0,0,85504,16,768128077
13070,648654600,195089,648849689,0,0,0,60928,11,7284695203
13071,648699910,198949,648898859,5,0,0,24576,19,6188130458
13072,648720590,76375,648796965,2,0,0,13312,4,8836852074
13073,648768170,255718,649023888,5,0,0,129024,19,322585846
13074,648771090,277380,649048470,3,0,0,57344,2,8512271787
13075,648818910,4162,648823072,7,0,1,11264,8,5444359817
13076,648924020,206720,649130740,9,0,0,50688,18,9616182366
13077,649016100,69072,649085172,9,0,0,7168,18,4541165787
13078,649048980,91546,649140526,9,0,0,1024,18,7179790768
13079,649089410,52808,649142218,5,0,0,1536,19,10132051087
13080,649107620,23135,649130755,0,0,1,8192,11,7254530342
13081,649108160,59000,649167160,0,0,0,4608,11,1477378232
13082,649187359,91757,649279116,2,0,1,148480,4,7771505730
13083,649213510,162830,649376340,2,0,0,19456,4,1855294040
13084,649221210,118350,649339560,3,0,0,4608,2,4729363077
13085,649229640,53342,649282982,5,0,1,6144,19,9345300958
13086,649258530,209794,649468324,3,0,0,13312,2,5365477249
13087,649478989,110084,649589073,1,0,0,61440,6,1085742875
13088,649507230,162225,649669455,8,0,0,97280,12,5159605010
13089,649655450,126182,649781632,0,0,0,12800,11,4849611952
13090,649666670,130309,649796979,5,0,0,48128,19,9854488959
13091,649730840,152230,649883070,0,0,0,18944,11,5016564797
13092,649739680,137603,649877283,8,0,0,27136,12,8648009343
13093,649762910,71624,649834534,0,0,0,15872,11,1190392785
13094,649770960,52364,649823324,0,0,0,3072,11,481355572
13095,649884270,566,649884836,1,0,1,512,6,7020408456
13096,649885109,55590,649940699,1,0,0,4608,6,2579493245
13097,649890700,2470,649893170,1,0,1,2560,6,3675596444
13098,650093640,101036,650194676,9,0,0,31744,18,9705758765
13099,650096399,108645,650205044,7,0,0,15360,8,1804882205
13100,650204760,1318,650206078,5,0,1,1024,19,1674761391
13101,650241580,104624,650346204,5,0,0,43520,19,5040838908
13102,650285109,148347,650433456,7,0,0,30208,8,8267573032
13103,650299500,1518,650301018,1,0,1,1536,6,7005798394
13104,650320329,52364,650372693,7,0,0,3072,8,6251446317
13105,650409480,69284,650478764,5,0,0,8192,19,6240551209
13106,650419249,566,650419815,8,0,1,512,12,4861218700
13107,650519010,65300,650584310,2,0,0,10240,4,3131390936
13108,650555869,13083,650568952,8,0,1,22016,12,2942659564
13109,650556670,246948,650803618,2,0,0,66048,4,5620253836
13110,650643490,2470,650645960,5,0,1,2560,19,9236675279
13111,650689770,90212,650779982,5,0,0,16384,19,5408003874
13112,650810770,52364,650863134,3,0,0,3072,2,2751433785
13113,650829060,43904,650872964,5,0,0,512,19,3764706186
13114,650874250,108524,650982774,0,0,0,56320,11,8217259418
13115,651068310,98072,651166382,2,0,0,22016,4,3902532980
13116,651126679,104600,651231279,1,0,0,38400,6,9063918264
13117,651145400,3387,651148787,1,0,1,9728,6,1383029392
13118,651156470,75292,651231762,8,0,0,1536,12,5525509788
13119,651165110,1830,651166940,0,0,1,512,11,7169213533
13120,651221429,117445,651338874,1,0,0,51712,6,6509602649
13121,651234350,50672,651285022,0,0,0,2560,11,1667650346
13122,651239630,152272,651391902,0,0,0,11776,11,8117953587
13123,651265850,80806,651346656,0,0,0,512,11,3880253312
13124,651280780,5712,651286492,5,0,1,14336,19,7317349637
13125,651283780,5315,651289095,7,0,1,4096,8,8457367888
13126,651379480,12437,651391917,6,0,1,18432,12,920260718
13127,651420440,1994,651422434,4,0,1,2048,16,1403511121
13128,651447841,84512,651532353,6,0,0,12800,12,8677571068
13129,651490409,96070,651586479,7,0,0,17920,8,8189608967
13130,651504251,67616,651571867,6,0,0,12800,12,3396091729
13131,651686660,5454,651692114,6,0,1,13824,12,5950712287
13132,651720450,3645,651724095,0,0,1,10240,11,2308667243
13133,651793920,168483,651962403,2,0,0,53760,4,871204443
13134,651812270,67548,651879818,8,0,0,6144,12,9497680594
13135,651841080,67328,651908408,0,0,0,3072,11,10641864644
13136,651926330,81308,652007638,0,0,0,17408,11,10293123087
13137,651994780,1518,651996298,1,0,1,1536,6,4756156882
13138,652019920,1042,652020962,1,0,1,1024,6,6562398217
13139,652029960,68666,652098626,9,0,0,12800,18,3570384180
13140,652051320,119732,652171052,0,0,0,22528,11,6597189938
13141,652097611,98455,652196066,6,0,0,19968,12,1042747293
13142,652113651,111869,652225520,6,0,0,4608,12,3131293359
13143,652159471,54056,652213527,6,0,0,3584,12,1597828818
13144,652179369,2870,652182239,8,0,1,8704,12,1243203958
13145,652223369,180031,652403400,1,0,0,25600,6,3083444803
13146,652236430,99320,652335750,9,0,0,26112,18,2420820373
13147,652244440,125828,652370268,9,0,0,2560,18,2488647375
13148,652443630,73292,652516922,2,0,0,11264,4,6275207769
13149,652465160,13083,652478243,6,0,1,22016,12,10425579044
13150,652522199,192060,652714259,1,0,0,18944,6,7600691987
13151,652683260,108483,652791743,0,0,0,18944,11,8681876869
13152,652706310,7964,652714274,4,0,1,7680,16,8145785913
13153,652714720,67592,652782312,9,0,0,7680,18,4750075744
13154,652738160,6229,652744389,5,0,1,15360,19,9043093747
13155,652765879,200494,652966373,7,0,0,33792,8,3296769542
13156,652780919,149872,652930791,7,0,0,12288,8,8573856150
13157,652794120,74360,652868480,0,0,0,9728,11,4654370015
13158,652799790,47288,652847078,8,0,0,1536,12,781745553
13159,652861579,6916,652868495,3,0,1,4608,2,3615421119
13160,652915850,51318,652967168,5,0,0,2560,19,5645226535
13161,652979139,90705,653069844,7,0,0,4096,8,9213182777
13162,652996939,3387,653000326,8,0,1,9728,12,9011592727
13163,653004449,89324,653093773,7,0,0,23552,8,9029296264
13164,653054660,23983,653078643,6,0,1,39936,12,7931584828
13165,653172960,3898,653176858,1,0,1,4096,6,8336353924
13166,653217230,1042,653218272,9,0,1,1024,18,8233034095
13167,653239250,67592,653306842,0,0,0,7680,11,5282546245
13168,653263819,12308,653276127,2,0,1,20480,4,7538679686
13169,653312190,1042,653313232,5,0,1,1024,19,417822771
13170,653344179,215011,653559190,1,0,0,3584,6,2257543338
13171,653412290,113516,653525806,2,0,0,72704,4,10203778113
13172,653435750,204344,653640094,5,0,0,27136,19,1490897655
13173,653503290,83596,653586886,4,0,0,13824,16,1659719176
13174,653583370,100956,653684326,2,0,0,19968,4,4563305017
13175,653644779,96068,653740847,7,0,0,20480,8,5039823989
13176,653654900,566,653655466,4,0,1,512,16,9669047215
13177,653759390,1042,653760432,5,0,1,1024,19,4346456508
13178,653780559,104936,653885495,7,0,0,44544,8,4983742508
13179,653830049,132810,653962859,1,0,0,18944,6,1176652182
13180,653837089,132961,653970050,1,0,0,23552,6,3116710735
13181,653940320,5454,653945774,4,0,1,13824,16,1710368183
13182,654050400,4374,654054774,9,0,1,4608,18,1527214968
13183,654091810,1994,654093804,6,0,1,2048,12,3147471277
13184,654163600,100568,654264168,2,0,0,30208,4,8589141298
13185,654267850,59132,654326982,4,0,0,5120,16,9310448080
13186,654315709,50672,654366381,1,0,0,2560,6,4299560007
13187,654387299,3645,654390944,2,0,1,10240,4,493989883
13188,654502229,99164,654601393,1,0,0,25600,6,9795756442
13189,654554849,117566,654672415,7,0,0,30720,8,4346664094
13190,654608100,1042,654609142,4,0,1,1024,16,129039370
13191,654742100,67592,654809692,8,0,0,7680,12,10212643498
13192,654743430,72382,654815812,5,0,0,2560,19,3511468965
13193,654898209,102284,655000493,1,0,0,35840,6,5869084869
13194,655022569,69284,655091853,1,0,0,8192,6,908145351
13195,655043900,60824,655104724,2,0,0,5632,4,8813501803
13196,655082440,88520,655170960,8,0,0,15872,12,8320481185
13197,655126540,11791,655138331,1,0,1,19456,6,4343422380
13198,655194699,1042,655195741,2,0,1,1024,4,10402628306
13199,655202530,62516,655265046,8,0,0,6144,12,10114173831
13200,655262489,60824,655323313,1,0,0,5632,6,2304901928
13201,655299340,62516,655361856,3,0,0,6144,2,9250762082
13202,655337580,108680,655446260,0,0,0,56832,11,6755539407
13203,655431360,79100,655510460,0,0,0,6656,11,7519444870
13204,655483210,127294,655610504,3,0,0,35328,2,9620508206
13205,655592059,67904,655659963,1,0,0,8704,6,6538848878
13206,655692980,110240,655803220,3,0,0,61952,2,1438222368
13207,655750400,4374,655754774,1,0,1,4608,6,4396936371
13208,655785321,121891,655907212,6,0,0,41472,12,2216538831
13209,655875000,32227,655907227,7,0,1,32768,8,1860391717
13210,655933519,3387,655936906,2,0,1,9728,4,9326131468
13211,655950569,3645,655954214,8,0,1,10240,12,4644172475
13212,655962969,149629,656112598,7,0,0,3072,8,6992414331
13213,656092699,52364,656145063,7,0,0,3072,8,4643018605
13214,656178710,97760,656276470,3,0,0,20992,2,4054407067
13215,656261840,64208,656326048,5,0,0,6656,19,5512982571
13216,656280920,64028,656344948,3,0,0,8192,2,7928891417
13217,656298940,126858,656425798,3,0,0,45568,2,10157210898
13218,656351331,104293,656455624,6,0,0,11264,12,5245373044
13219,656620429,115544,656735973,1,0,0,79360,6,8960158010
13220,656710800,97136,656807936,3,0,0,18944,2,9170777371
13221,656749460,13253,656762713,0,0,1,25600,11,1045558394
13222,656751990,13309,656765299,5,0,1,4096,19,5395344747
13223,656772010,75140,656847150,3,0,0,12288,2,9267931017
13224,656850720,1994,656852714,6,0,1,2048,12,5652070959
13225,656938450,78539,657016989,2,0,0,5120,4,5011301924
13226,657020000,62072,657082072,0,0,0,9728,11,10459981331
13227,657039920,5326,657045246,5,0,1,5632,19,4944516576
13228,657102439,7706,657110145,2,0,1,8192,4,9056753253
13229,657211949,1518,657213467,2,0,1,1536,4,4188662441
13230,657345100,45596,657390696,2,0,0,1024,4,512143495
13231,657380859,101816,657482675,1,0,0,34304,6,111301159
13232,657488721,79016,657567737,6,0,0,19968,12,9325979944
13233,657579620,101660,657681280,9,0,0,33792,18,2597328334
13234,657615120,55748,657670868,8,0,0,4096,12,4737614129
13235,657660780,84668,657745448,0,0,0,13312,11,3188022246
13236,657686370,102752,657789122,9,0,0,37376,18,7273812373
13237,657689879,109874,657799753,1,0,0,34816,6,2702049571
13238,657772750,2870,657775620,1,0,1,8704,6,2868795487
13239,657779399,27067,657806466,3,0,1,7168,2,7489811365
13240,657809970,138173,657948143,9,0,0,35328,18,4382604423
13241,657822480,104312,657926792,2,0,0,42496,4,4078690251
13242,657835310,102054,657937364,8,0,0,11264,12,1731529851
13243,657836881,149959,657986840,6,0,0,47616,12,3158496446
13244,657886549,1042,657887591,2,0,1,1024,4,9802933160
13245,657906510,99929,658006439,2,0,0,5632,4,7428363587
13246,657918249,9101,657927350,8,0,1,512,12,5230900179
13247,657945720,123755,658069475,8,0,0,51200,12,1883782439
13248,658001909,566,658002475,8,0,1,512,12,7798123928
13249,658103070,65900,658168970,0,0,0,7168,11,137938889
13250,658107130,119260,658226390,2,0,0,34304,4,7204467640
13251,658167421,232421,658399842,6,0,0,39424,12,7872048632
13252,658189329,1994,658191323,8,0,1,2048,12,10488090639
13253,658271479,4374,658275853,8,0,1,4608,12,10369246681
13254,658330179,23895,658354074,3,0,1,43008,2,2375077253
13255,658356010,126222,658482232,8,0,0,22528,12,7924902868
13256,658506769,5326,658512095,2,0,1,5632,4,4209424607
13257,658543620,94976,658638596,3,0,0,16896,2,7519335611
13258,658647960,1994,658649954,0,0,1,2048,11,9968461292
13259,658677890,50672,658728562,3,0,0,2560,2,8060213706
13260,658705200,73448,658778648,8,0,0,11776,12,8226962410
13261,658803239,5802,658809041,8,0,1,6144,12,5677319145
13262,658834741,98337,658933078,6,0,0,22016,12,1329033390
13263,658870430,6754,658877184,7,0,1,7168,8,5299264741
13264,658878970,176341,659055311,2,0,0,5632,4,2471590884
13265,658891279,113445,659004724,7,0,0,29184,8,10268493236
13266,658913520,566,658914086,4,0,1,512,16,7369273841
13267,658957220,14545,658971765,6,0,1,28160,12,7405207896
13268,659000650,221097,659221747,8,0,0,46592,12,969626217
13269,659002409,4326,659006735,3,0,1,2048,2,9410202149
13270,659036139,126694,659162833,1,0,0,35840,6,7823025720
13271,659069250,12308,659081558,4,0,1,20480,16,6268909255
13272,659163520,89924,659253444,3,0,0,20480,2,1009197317
13273,659207330,50672,659258002,8,0,0,2560,12,634697170
13274,659279150,84512,659363662,2,0,0,12800,4,5882614629
13275,659294911,101816,659396727,6,0,0,34304,12,5523748298
13276,659370810,50672,659421482,2,0,0,2560,4,2690954224
13277,659371039,84512,659455551,7,0,0,12800,8,8958300030
13278,659389670,7615,659397285,1,0,1,512,6,8357916899
13279,659508570,72668,659581238,2,0,0,9216,4,5606026822
13280,659525770,1042,659526812,7,0,1,1024,8,10173029611
13281,659530049,1518,659531567,2,0,1,1536,4,9867193120
13282,659726391,59132,659785523,6,0,0,5120,12,10616961995
13283,659740439,101504,659841943,7,0,0,33280,8,7763672097
13284,659744230,105996,659850226,3,0,0,27136,2,6883036786
13285,659790120,108552,659898672,9,0,0,14336,18,4760688261
13286,659960291,84512,660044803,6,0,0,12800,12,568929408
13287,660059940,67592,660127532,3,0,0,7680,2,10362488836
13288,660127380,710,660128090,0,0,1,512,11,9363938220
13289,660227120,1994,660229114,6,0,1,2048,12,3635902363
13290,660233890,55748,660289638,3,0,0,4096,2,10251650893
13291,660241210,1518,660242728,7,0,1,1536,8,2615486648
13292,660254410,113672,660368082,0,0,0,73216,11,2422221472
13293,660257070,59132,660316202,3,0,0,5120,2,8842781803
13294,660445250,5712,660450962,1,0,1,14336,6,3230994624
13295,660532070,127088,660659158,8,0,0,117248,12,4466938697
13296,660570500,129392,660699892,3,0,0,17920,2,9292509852
13297,660607881,81397,660689278,6,0,0,7168,12,3432589929
13298,660686030,1042,660687072,4,0,1,1024,16,4166077236
13299,660763060,64520,660827580,0,0,0,7680,11,10311872985
13300,660781720,88303,660870023,0,0,0,18944,11,143588624
13301,660877560,75920,660953480,8,0,0,14848,12,6470713971
13302,660913050,43904,660956954,2,0,0,512,4,4375624429
13303,660916700,45596,660962296,2,0,0,1024,4,9110097508
13304,660918720,58064,660976784,2,0,0,6656,4,6653464308
13305,661013650,65900,661079550,2,0,0,7168,4,1169290770
13306,661054109,101089,661155198,7,0,0,31744,8,9179930805
13307,661060970,4374,661065344,6,0,1,4608,12,4201917943
13308,661095240,2470,661097710,5,0,1,2560,19,6070055236
13309,661116259,6754,661123013,8,0,1,7168,12,9919897234
13310,661225220,4937,661230157,5,0,1,12800,19,4379250480
13311,661288379,79436,661367815,7,0,0,11264,8,6820903325
13312,661305040,10757,661315797,9,0,1,17408,18,10435453627
13313,661323849,67456,661391305,7,0,0,1536,8,5070906019
13314,661454219,109304,661563523,7,0,0,58880,8,2450999828
13315,661506860,83057,661589917,8,0,0,13312,12,2159046674
13316,661560830,52058,661612888,3,0,0,512,2,4228699071
13317,661708750,47288,661756038,0,0,0,1536,11,2155211572
13318,661736790,100412,661837202,0,0,0,29696,11,8234413143
13319,661830890,116896,661947786,0,0,0,45568,11,446782252
13320,661831679,102208,661933887,7,0,0,17408,8,8360523675
13321,661846960,105209,661952169,0,0,0,14336,11,10282913652
13322,661899841,111488,662011329,6,0,0,66048,12,5190749389
13323,661946410,142967,662089377,3,0,0,22528,2,5730708051
13324,661962110,7230,661969340,9,0,1,7680,18,9585787181
13325,661966099,3497,661969596,3,0,1,9216,2,8002826615
13326,661988089,23255,662011344,8,0,1,18432,12,7804850888
13327,662002420,89312,662091732,5,0,0,7680,19,5552610732
13328,662016989,181655,662198644,1,0,0,25600,6,1719869775
13329,662130890,79436,662210326,2,0,0,11264,4,1907355208
13330,662271190,98228,662369418,3,0,0,22528,2,3830169271
13331,662295430,126398,662421828,0,0,0,22016,11,782980778
13332,662347440,62516,662409956,2,0,0,6144,4,6800593963
13333,662400130,106906,662507036,9,0,0,25088,18,4162683058
13334,662415080,70976,662486056,9,0,0,8704,18,3501624387
13335,662459919,5971,662465890,2,0,1,14848,4,6599348496
13336,662479791,99632,662579423,6,0,0,27136,12,4512129598
13337,662502390,85922,662588312,2,0,0,12288,4,7260670886
13338,662586200,47700,662633900,9,0,0,1024,18,2998275864
13339,662646970,118508,662765478,0,0,0,89088,11,7524751869
13340,662677201,133297,662810498,6,0,0,6144,12,812695227
13341,662686200,157853,662844053,9,0,0,110080,18,5677231288
13342,662869729,7230,662876959,3,0,1,7680,2,7327064016
13343,662883620,82064,662965684,2,0,0,14848,4,1880119817
13344,662887639,14545,662902184,2,0,1,28160,4,9726007049
13345,663039791,102908,663142699,6,0,0,37888,12,9653549069
13346,663076599,102752,663179351,7,0,0,37376,8,8995596877
13347,663122320,72721,663195041,3,0,0,2048,2,9610083177
13348,663246149,69284,663315433,7,0,0,8192,8,4535830527
13349,663433409,99320,663532729,7,0,0,26112,8,5915650867
13350,663496739,55748,663552487,1,0,0,4096,6,8303105811
13351,663527769,57940,663585709,7,0,0,5120,8,5085746074
13352,663591929,2946,663594875,8,0,1,3072,12,4024477208
13353,663725141,55748,663780889,6,0,0,4096,12,3114040450
13354,663777640,114993,663892633,9,0,0,71168,18,5343593077
13355,663813560,145259,663958819,9,0,0,60416,18,8522377048
13356,663874540,109869,663984409,9,0,0,7168,18,5404698026
13357,663874870,24285,663899155,5,0,1,15872,19,5480853186
13358,663886190,73736,663959926,8,0,0,3584,12,339430762
13359,664204131,96224,664300355,6,0,0,20992,12,7036247603
13360,664279319,70844,664350163,1,0,0,13312,6,2228432367
13361,664374460,76052,664450512,3,0,0,10240,2,1994129996
13362,664409280,45596,664454876,8,0,0,1024,12,7393711041
13363,664481840,52364,664534204,2,0,0,3072,4,395559596
13364,664503980,105248,664609228,2,0,0,45568,4,8481873368
13365,664546220,5802,664552022,9,0,1,6144,18,6852572885
13366,664562510,76988,664639498,9,0,0,13312,18,5032311832
13367,664613729,101504,664715233,1,0,0,33280,6,7332570167
13368,664626820,92952,664719772,2,0,0,14848,4,4295700665
13369,664746620,45596,664792216,0,0,0,1024,11,3262773975
13370,664782689,566,664783255,3,0,1,512,2,5282330371
13371,664801650,3904,664805554,1,0,1,10752,6,4717537495
13372,664852241,60824,664913065,6,0,0,5632,12,9874814248
13373,664894660,86696,664981356,8,0,0,19968,12,4609064229
13374,665048560,566,665049126,4,0,1,512,16,9444888495
13375,665052000,103844,665155844,0,0,0,40960,11,831670739
13376,665158669,43904,665202573,7,0,0,512,8,6828785032
13377,665203680,16096,665219776,4,0,1,31232,16,10142919885
13378,665233519,6754,665240273,3,0,1,7168,2,7756572859
13379,665246829,62516,665309345,7,0,0,6144,8,10426282886
13380,665269400,117963,665387363,8,0,0,29184,12,7696203731
13381,665383160,8569,665391729,0,0,1,4608,11,248014954
13382,665421109,86204,665507313,1,0,0,13312,6,6593868957
13383,665449750,4420,665454170,5,0,1,11776,19,2905332804
13384,665456989,131366,665588355,1,0,0,26112,6,10421945652
13385,665536049,104809,665640858,1,0,0,25600,6,8132360282
13386,665598879,129435,665728314,1,0,0,23040,6,3020281264
13387,665651410,106898,665758308,0,0,0,24576,11,2330293636
13388,665703900,154848,665858748,3,0,0,39424,2,8708922487
13389,665708350,89702,665798052,3,0,0,1536,2,9238888112
13390,665803609,67592,665871201,7,0,0,7680,8,5608495874
13391,665823680,128560,665952240,0,0,0,46592,11,8555734194
13392,665909090,72802,665981892,9,0,0,512,18,2210994076
13393,666119040,99691,666218731,8,0,0,27136,12,3511322957
13394,666119099,117743,666236842,1,0,0,59392,6,5642901131
13395,666155689,88009,666243698,7,0,0,17408,8,5868310830
13396,666182230,101854,666284084,2,0,0,7680,4,946954051
13397,666229729,90705,666320434,7,0,0,14848,8,6257070021
13398,666268529,566,666269095,8,0,1,512,12,2368171745
13399,666292060,100724,666392784,2,0,0,30720,4,2885850501
13400,666310519,100880,666411399,7,0,0,31232,8,10190091195
13401,666484490,99320,666583810,3,0,0,26112,2,9320034293
13402,666540619,3904,666544523,8,0,1,10752,12,9286906002
13403,666557491,62284,666619775,6,0,0,4608,12,605855564
13404,666587920,66145,666654065,2,0,0,5120,4,95076670
13405,666622761,89750,666712511,6,0,0,14336,12,6137782086
13406,666737900,72668,666810568,9,0,0,9216,18,4571900258
13407,666870720,87140,666957860,4,0,0,16384,16,3764440345
13408,666884990,95598,666980588,8,0,0,15360,12,2062594096
13409,666972099,100724,667072823,1,0,0,30720,6,8354426581
13410,666995420,103581,667099001,2,0,0,4608,4,26840563
13411,667109369,50672,667160041,1,0,0,2560,6,3430491608
13412,667113360,20882,667134242,7,0,1,33792,8,4212343798
13413,667129570,5338,667134908,4,0,1,11264,16,4114300276
13414,667159209,70502,667229711,1,0,0,512,6,10044062289
13415,667201741,75976,667277717,6,0,0,10752,12,10478222667
13416,667254830,101151,667355981,9,0,0,13312,18,10034185688
13417,667321150,55748,667376898,9,0,0,4096,18,953749445
13418,667360189,102752,667462941,1,0,0,37376,6,4312094579
13419,667373619,126408,667500027,7,0,0,11776,8,10025669236
13420,667404820,65093,667469913,0,0,0,2560,11,905680160
13421,667433570,2946,667436516,0,0,1,3072,11,3671642584
13422,667452520,54317,667506837,9,0,0,512,18,7965450870
13423,667491399,80240,667571639,1,0,0,18944,6,3376493930
13424,667571300,15135,667586435,6,0,1,28672,12,4255723001
13425,667582640,8301,667590941,1,0,1,7168,6,6256283874
13426,667659330,3645,667662975,0,0,1,10240,11,9529966821
13427,667718650,201392,667920042,9,0,0,89088,18,6183360551
13428,667731730,101972,667833702,3,0,0,34816,2,9187549834
13429,667779670,142883,667922553,0,0,0,8192,11,6897021362
13430,667796491,59099,667855590,6,0,0,3584,12,3883289572
13431,667885659,3387,667889046,8,0,1,9728,12,7371251761
13432,668094479,59132,668153611,7,0,0,5120,8,3855996810
13433,668137660,5802,668143462,5,0,1,6144,19,5661931447
13434,668148790,2870,668151660,5,0,1,8704,19,8592807161
13435,668169980,4374,668174354,0,0,1,4608,11,9603080467
13436,668257899,43904,668301803,7,0,0,512,8,10231957851
13437,668279740,5196,668284936,0,0,1,13312,11,6758136749
13438,668310310,70688,668380998,9,0,0,12800,18,8243431347
13439,668357300,102128,668459428,9,0,0,35328,18,2221511503
13440,668396770,153960,668550730,3,0,0,107008,2,8559770866
13441,668470419,5454,668475873,8,0,1,13824,12,8864511262
13442,668517220,71383,668588603,3,0,0,1024,2,9335550009
13443,668555059,206924,668761983,7,0,0,90624,8,7783678979
13444,668576800,102596,668679396,0,0,0,36864,11,3814067641
13445,668578241,147217,668725458,6,0,0,25600,12,5766281323
13446,668614459,163295,668777754,7,0,0,51712,8,4685905297
13447,668632050,4679,668636729,6,0,1,12288,12,7578399277
13448,668669860,158555,668828415,9,0,0,7680,18,10008644729
13449,668703481,82184,668785665,6,0,0,4608,12,1995766684
13450,668741110,40298,668781408,0,0,1,10240,11,9921457450
13451,668776620,84619,668861239,8,0,0,19456,12,3821999048
13452,668814150,111956,668926106,0,0,0,67584,11,4096388103
13453,668996970,6278,669003248,6,0,1,6656,12,7792028703
13454,669005019,2946,669007965,3,0,1,3072,2,5846379970
13455,669064120,7230,669071350,5,0,1,7680,19,1300900989
13456,669085080,143377,669228457,8,0,0,13312,12,6567665482
13457,669133010,52364,669185374,8,0,0,3072,12,8491985532
13458,669133580,185015,669318595,3,0,0,66048,2,2370725720
13459,669234540,143041,669377581,8,0,0,26624,12,2322569838
13460,669254140,164715,669418855,9,0,0,75264,18,9374144441
13461,669324429,147664,669472093,7,0,0,22016,8,5711653818
13462,669386010,164413,669550423,8,0,0,46080,12,7952201705
13463,669422040,50692,669472732,3,0,0,2048,2,8383439712
13464,669456150,118438,669574588,3,0,0,8704,2,10332347890
13465,669508250,63671,669571921,8,0,0,4608,12,7171525933
13466,669522819,80032,669602851,7,0,0,9216,8,6985591161
13467,669526610,121325,669647935,0,0,0,26112,11,9901308189
13468,669536481,185899,669722380,6,0,0,6656,12,8573909541
13469,669548900,108254,669657154,9,0,0,30208,18,6352509569
13470,669555220,165117,669720337,8,0,0,30720,12,10332966392
13471,669617730,64208,669681938,8,0,0,6656,12,10099976908
13472,669633130,141777,669774907,8,0,0,32256,12,2937591599
13473,669732479,47288,669779767,1,0,0,1536,6,1975031003
13474,669736760,102908,669839668,9,0,0,37888,18,1745909130
13475,669742210,117306,669859516,8,0,0,12288,12,10529516437
13476,669754780,99944,669854724,9,0,0,28160,18,2766278683
13477,669870520,2470,669872990,9,0,1,2560,18,2147746105
13478,669945620,67592,670013212,0,0,0,7680,11,4526990276
13479,670020910,3645,670024555,7,0,1,10240,8,8400706283
13480,670060290,6754,670067044,9,0,1,7168,18,2793948792
13481,670125410,74360,670199770,8,0,0,9728,12,8269283013
13482,670225150,4162,670229312,4,0,1,11264,16,8734499021
13483,670237850,94873,670332723,3,0,0,25600,2,1694497157
13484,670335890,82976,670418866,3,0,0,12800,2,5698167133
13485,670396000,2470,670398470,0,0,1,2560,11,1805061199
13486,670443189,4374,670447563,3,0,1,4608,2,1210092426
13487,670475309,99008,670574317,1,0,0,25088,6,3014639006
13488,670498450,102069,670600519,2,0,0,4096,4,2523785903
13489,670590940,6754,670597694,7,0,1,7168,8,9307583197
13490,670668550,165734,670834284,2,0,0,71680,4,3054579661
13491,670733960,125752,670859712,8,0,0,24064,12,5684477668
13492,670752220,89441,670841661,8,0,0,13824,12,38467394
13493,670758150,79284,670837434,8,0,0,10240,12,5953104031
13494,670807549,26750,670834299,3,0,1,23040,2,726585262
13495,670921950,59132,670981082,0,0,0,5120,11,9019689644
13496,670974049,78680,671052729,1,0,0,13824,6,6165584104
13497,671138850,74516,671213366,3,0,0,10240,2,1150940447
13498,671161619,100568,671262187,7,0,0,30208,8,3491358932
13499,671167060,124473,671291533,0,0,0,24576,11,9676395525
13500,671173470,153259,671326729,8,0,0,29184,12,3602686147
13501,671190270,107311,671297581,8,0,0,4096,12,4958915595
13502,671218800,55748,671274548,3,0,0,4096,2,218253219
13503,671245670,16532,671262202,0,0,1,25600,11,3148376347
13504,671393310,107588,671500898,8,0,0,53248,12,6973244393
13505,671423280,101348,671524628,9,0,0,32768,18,7645876617
13506,671461830,94388,671556218,8,0,0,10752,12,110704847
13507,671463221,79953,671543174,6,0,0,13312,12,5425772024
13508,671531339,104391,671635730,1,0,0,17408,6,2065196244
13509,671540740,81886,671622626,3,0,0,16384,2,7790289480
13510,671574319,1994,671576313,3,0,1,2048,2,3589215346
13511,671677251,43904,671721155,6,0,0,512,12,2579951951
13512,671796530,103376,671899906,0,0,0,39424,11,9539100461
13513,671833730,108476,671942206,9,0,0,4608,18,9942868572
13514,671854740,108490,671963230,2,0,0,33280,4,7116195073
13515,671920420,65916,671986336,9,0,0,7168,18,3819319107
13516,671939720,108716,672048436,8,0,0,49664,12,10475386932
13517,671994299,178383,672172682,1,0,0,14336,6,5188258773
13518,672008420,114891,672123311,2,0,0,6144,4,4116740829
13519,672010560,110864,672121424,2,0,0,64000,4,8992695736
13520,672061720,114721,672176441,2,0,0,12288,4,7977553918
13521,672210770,3898,672214668,6,0,1,4096,12,4665087085
13522,672266860,5454,672272314,9,0,1,13824,18,2908322992
13523,672282680,205458,672488138,5,0,1,333312,19,9943460200
13524,672337990,150732,672488722,2,0,0,512,4,8164271205
13525,672371650,117461,672489111,7,0,1,12800,8,5109258784
13526,672431131,210340,672641471,6,0,0,7168,12,2729036592
13527,672439450,50941,672490391,4,0,1,14336,16,9815676788
13528,672466291,253886,672720177,6,0,0,41472,12,9272624686
13529,672597939,1042,672598981,3,0,1,1024,2,3948042232
13530,672623649,74714,672698363,1,0,0,5120,6,8096757535
13531,672667770,52890,672720660,9,0,0,1536,18,6942974745
13532,672670720,169315,672840035,3,0,0,19456,2,4077649375
13533,672780340,134701,672915041,3,0,0,29184,2,5063302816
13534,672808641,75788,672884429,6,0,0,12800,12,8897677779
13535,672973920,106496,673080416,8,0,0,49664,12,8522208749
13536,673123049,50672,673173721,1,0,0,2560,6,1442479888
13537,673233940,2946,673236886,4,0,1,3072,16,7405175522
13538,673374660,45596,673420256,9,0,0,1024,18,7675971038
13539,673438040,85292,673523332,3,0,0,15360,2,8550606039
13540,673464170,116654,673580824,0,0,0,10240,11,864090613
13541,673480480,47288,673527768,9,0,0,1536,18,10125414520
13542,673515420,52156,673567576,3,0,0,2048,2,4746115110
13543,673577180,88364,673665544,0,0,0,15360,11,8079951457
13544,673604080,5326,673609406,0,0,1,5632,11,2390435393
13545,673747131,47288,673794419,6,0,0,1536,12,4780953635
13546,673771159,52988,673824147,7,0,0,5120,8,3612857083
13547,673789811,52520,673842331,6,0,0,3584,12,9018858262
13548,673792449,100344,673892793,1,0,0,27648,6,5171710397
13549,673902900,106652,674009552,0,0,0,50176,11,387392493
13550,673930920,2870,673933790,7,0,1,8704,8,4164540391
13551,673966811,66112,674032923,6,0,0,3584,12,3179315183
13552,673989770,54617,674044387,5,0,1,89600,19,8806220728
13553,674041280,88919,674130199,3,0,0,9728,2,7479264246
13554,674115500,165402,674280902,8,0,0,16896,12,8623969646
13555,674124900,150839,674275739,8,0,0,58368,12,8862642146
13556,674218009,97330,674315339,7,0,0,4608,8,5676760895
13557,674225760,103673,674329433,8,0,0,36864,12,3528497861
13558,674372830,116201,674489031,9,0,0,512,18,3728301335
13559,674376421,100256,674476677,6,0,0,29184,12,8258043623
13560,674377359,111501,674488860,1,0,0,39936,6,6484833144
13561,674393980,100994,674494974,0,0,0,19456,11,3647674703
13562,674416020,84413,674500433,3,0,0,7168,2,7609501623
13563,674416250,2946,674419196,9,0,1,3072,18,7204254475
13564,674419600,125923,674545523,8,0,0,17920,12,9276699235
13565,674452190,178215,674630405,3,0,0,63488,2,5250725210
13566,674609989,102440,674712429,1,0,0,36352,6,3770911375
13567,674691119,1518,674692637,3,0,1,1536,2,8968844376
13568,674762209,68372,674830581,7,0,0,10240,8,4141757849
13569,674768000,100412,674868412,8,0,0,29696,12,5879555790
13570,674794620,102908,674897528,9,0,0,37888,18,9532818773
13571,674796770,1994,674798764,9,0,1,2048,18,3034972428
13572,674932749,116411,675049160,7,0,0,28160,8,1408040478
13573,674945469,6754,674952223,3,0,1,7168,2,3980819504
13574,675002310,52139,675054449,0,0,0,1536,11,9726791136
13575,675087589,566,675088155,8,0,1,512,12,2670955468
13576,675174590,5802,675180392,1,0,1,6144,6,1882665680
13577,675194909,54056,675248965,7,0,0,3584,8,9277440435
13578,675310970,81752,675392722,0,0,0,13824,11,4290935290
13579,675393630,59132,675452762,3,0,0,5120,2,8737535084
13580,675409419,48980,675458399,7,0,0,2048,8,5159011911
13581,675441001,45596,675486597,6,0,0,1024,12,4717649792
13582,675521919,79772,675601691,1,0,0,17408,6,627727179
13583,675563340,54056,675617396,9,0,0,3584,18,4254350892
13584,675604349,1994,675606343,3,0,1,2048,2,4923643938
13585,675612509,90548,675703057,1,0,0,22528,6,8566386433
13586,675783800,125379,675909179,2,0,0,28672,4,1681998401
13587,675784869,107120,675891989,1,0,0,51712,6,5772650129
13588,675786110,114318,675900428,8,0,0,27648,12,4657815804
13589,675797387,63347,675860734,2,0,0,512,4,5081952042
13590,675820920,119326,675940246,2,0,0,15872,4,2903090244
13591,675962970,7230,675970200,6,0,1,7680,12,5738125399
13592,676022169,61136,676083305,1,0,0,6656,6,3113289140
13593,676072540,83912,676156452,8,0,0,15872,12,9887262084
13594,676089130,6278,676095408,9,0,1,6656,18,7614717723
13595,676167500,103376,676270876,3,0,0,39424,2,8377709237
13596,676252290,78368,676330658,0,0,0,12800,11,9346122183
13597,676265220,6214,676271434,9,0,1,512,18,4496618599
13598,676278109,108679,676386788,1,0,0,19456,6,9612707270
13599,676399270,4162,676403432,1,0,1,11264,6,7700557440
13600,676473030,34279,676507309,5,0,1,59904,19,5131155486
13601,676642071,120990,676763061,6,0,0,29696,12,9793354289
13602,676649290,32816,676682106,5,0,1,53760,19,4110224417
13603,676769230,66680,676835910,3,0,0,9728,2,1935426738
13604,676848520,99320,676947840,0,0,0,26112,11,9127716794
13605,676874100,80060,676954160,9,0,0,13312,18,6626491431
13606,676889460,123084,677012544,8,0,0,19456,12,4350811039
13607,676969101,69284,677038385,6,0,0,8192,12,2490175525
13608,677012021,47562,677059583,6,0,0,1024,12,5433849638
13609,677023171,64208,677087379,6,0,0,6656,12,2024805675
13610,677149840,1994,677151834,0,0,1,2048,11,774678826
13611,677185110,99320,677284430,4,0,0,26112,16,9806475027
13612,677296750,1518,677298268,4,0,1,1536,16,1084143387
13613,677297980,52364,677350344,8,0,0,3072,12,7980654316
13614,677337691,52364,677390055,6,0,0,3072,12,1571735192
13615,677440069,2470,677442539,3,0,1,2560,2,4310378687
13616,677473010,45596,677518606,3,0,0,1024,2,7485284883
13617,677529100,5326,677534426,5,0,1,5632,19,9566715741
13618,677621170,4374,677625544,7,0,1,4608,8,777084157
13619,677623949,10499,677634448,3,0,1,16896,2,2460589986
13620,677753990,115388,677869378,0,0,0,78848,11,1501211391
13621,677783840,6278,677790118,9,0,1,6656,18,5543282288
13622,677789389,13858,677803247,8,0,1,23552,12,8800286983
13623,677808439,221726,678030165,7,0,0,18944,8,4617805414
13624,677981010,2946,677983956,4,0,1,3072,16,3037807668
13625,677996300,147204,678143504,5,0,1,243200,19,4037894497
13626,678067079,211974,678279053,7,0,0,5120,8,9168156652
13627,678080879,293719,678374598,7,0,0,60416,8,217159699
13628,678345119,107744,678452863,1,0,0,53760,6,6909003392
13629,678411500,6229,678417729,9,0,1,15360,18,1876352385
13630,678556130,7706,678563836,7,0,1,8192,8,2814329622
13631,678595669,43904,678639573,1,0,0,512,6,7509064796
13632,678677869,63296,678741165,1,0,0,8704,6,4249431538
13633,678707250,106808,678814058,8,0,0,50688,12,4836573972
13634,678741650,138594,678880244,3,0,0,39936,2,3371735084
13635,678762730,176056,678938786,8,0,0,30720,12,8194227370
13636,678783960,77744,678861704,9,0,0,10752,18,8415152071
13637,678818170,87196,678905366,0,0,0,11776,11,1533475095
13638,678858319,70976,678929295,1,0,0,8704,6,7932473951
13639,678917139,5326,678922465,8,0,1,5632,12,9104908659
13640,679052631,101036,679153667,6,0,0,31744,12,5921525651
13641,679078729,91853,679170582,1,0,0,19456,6,10125232484
13642,679086950,566,679087516,6,0,1,512,12,3259858112
13643,679198110,71444,679269554,9,0,0,10240,18,619492399
13644,679224200,79772,679303972,0,0,0,17408,11,10490369390
13645,679335601,132445,679468046,6,0,0,57856,12,8309201666
13646,679347220,2870,679350090,4,0,1,8704,16,8244614697
13647,679352891,94556,679447447,6,0,0,25600,12,7762648520
13648,679401210,4937,679406147,0,0,1,12800,11,4179435024
13649,679420419,3904,679424323,3,0,1,10752,2,8130369555
13650,679462760,90102,679552862,0,0,0,13824,11,1022913735
13651,679544600,132791,679677391,0,0,0,60416,11,6371131546
13652,679695169,119273,679814442,1,0,0,48640,6,7532971887
13653,679706340,4937,679711277,7,0,1,12800,8,7616712007
13654,679730880,109616,679840496,8,0,0,59904,12,4455282144
13655,679905280,99008,680004288,0,0,0,25088,11,3749379647
13656,679936910,121120,680058030,3,0,0,13824,2,8072657432
13657,679972660,67592,680040252,9,0,0,7680,18,2119937505
13658,680052231,101504,680153735,6,0,0,33280,12,2561206554
13659,680271019,54992,680326011,1,0,0,6656,6,3147106105
13660,680300919,14029,680314948,3,0,1,27136,2,5767424232
13661,680487929,1994,680489923,8,0,1,2048,12,6987194259
13662,680501200,65900,680567100,0,0,0,7168,11,6759264237
13663,680512459,100053,680612512,7,0,0,18944,8,3749618816
13664,680517440,16354,680533794,4,0,1,31744,16,2447703534
13665,680522630,154596,680677226,9,0,0,35328,18,4834667084
13666,680581560,80813,680662373,5,0,0,512,19,6326194907
13667,680605749,81953,680687702,1,0,0,9216,6,3051778195
13668,680642139,5326,680647465,3,0,1,5632,2,1924359298
13669,680800580,1042,680801622,9,0,1,1024,18,9770469786
13670,680815880,566,680816446,0,0,1,512,11,1312442506
13671,680821210,102908,680924118,0,0,0,37888,11,9410080293
13672,680901689,106496,681008185,7,0,0,49664,8,1009495276
13673,680940049,130734,681070783,1,0,0,27136,6,6284763126
13674,680990590,1518,680992108,1,0,1,1536,6,5319801637
13675,681019170,125443,681144613,3,0,0,41472,2,5386294742
13676,681029610,3422,681033032,1,0,1,3584,6,36807608
13677,681060420,193516,681253936,5,0,0,34816,19,9910439800
13678,681096319,23895,681120214,3,0,1,43008,2,911202062
13679,681122210,90524,681212734,9,0,0,17408,18,5978956984
13680,681129680,235403,681365083,3,0,0,45056,2,6733482493
13681,681155419,70322,681225741,1,0,0,512,6,6579858403
13682,681166451,99944,681266395,6,0,0,28160,12,3473527548
13683,681193830,264814,681458644,9,0,0,61952,18,4753852757
13684,681273020,158822,681431842,9,0,0,86016,18,9225169463
13685,681274860,201688,681476548,3,0,0,14848,2,2320968545
13686,681340880,124316,681465196,9,0,0,17920,18,5418009865
13687,681391441,87999,681479440,6,0,0,9216,12,8936636446
13688,681412649,140315,681552964,1,0,0,16384,6,7673073075
13689,681546930,66680,681613610,8,0,0,9728,12,9340205239
13690,681548670,121610,681670280,9,0,0,33280,18,5809401294
13691,681632639,97760,681730399,1,0,0,20992,6,6520277238
13692,681673379,70844,681744223,1,0,0,13312,6,6975684301
13693,681838100,89792,681927892,9,0,0,25088,18,3312493608
13694,681853120,182631,682035751,9,0,0,55296,18,4550157575
13695,681913930,104958,682018888,9,0,0,24064,18,8346878833
13696,681916380,167722,682084102,5,0,0,35328,19,7530882067
13697,682031390,10155,682041545,6,0,1,6144,12,5417723072
13698,682088360,77744,682166104,3,0,0,10752,2,4143635169
13699,682104411,152839,682257250,6,0,0,81920,12,10354786715
13700,682111811,154510,682266321,6,0,0,29696,12,7544268052
13701,682146320,151808,682298128,0,0,0,78848,11,1020845396
13702,682235599,138593,682374192,1,0,0,52736,6,7246410548
13703,682267391,50561,682317952,6,0,0,512,12,10144631797
13704,682302099,1518,682303617,3,0,1,1536,2,2619459283
13705,682401630,66524,682468154,2,0,0,9216,4,7668158905
13706,682449940,6754,682456694,4,0,1,7168,16,3818405888
13707,682455460,82820,682538280,5,0,0,12288,19,963138274
13708,682462829,5340,682468169,8,0,1,3584,12,3434388398
13709,682508329,4850,682513179,8,0,1,5120,12,4784227167
13710,682600750,65900,682666650,5,0,0,7168,19,3284645937
13711,682643380,1042,682644422,0,0,1,1024,11,1952433524
13712,682705379,87140,682792519,7,0,0,16384,8,4608758040
13713,682728159,90392,682818551,7,0,0,22016,8,10093580491
13714,682751551,77554,682829105,6,0,0,5120,12,3627623224
13715,682782650,132357,682915007,2,0,0,38912,4,8671769621
13716,682784219,157038,682941257,7,0,0,28160,8,6755609203
13717,682884990,5196,682890186,6,0,1,13312,12,1962401921
13718,682892680,84733,682977413,5,0,1,138240,19,2102161956
13719,682923180,234169,683157349,0,0,0,20480,11,4263773134
13720,682954320,310784,683265104,3,0,0,18944,2,4630979525
13721,682965199,15440,682980639,8,0,1,5120,12,8698755488
13722,682991479,126776,683118255,7,0,0,62976,8,2198213715
13723,683067510,94600,683162110,5,0,1,154112,19,1960089125
13724,683086989,155437,683242426,7,0,0,4096,8,2948344557
13725,683111789,165211,683277000,1,0,0,19456,6,7775907589
13726,683259770,49230,683309000,3,0,0,512,2,5498130273
13727,683337229,54368,683391597,1,0,0,4608,6,7994768309
13728,683346120,74997,683421117,9,0,0,10752,18,10578950552
13729,683346139,3920,683350059,3,0,1,4096,2,2523953915
13730,683421050,53900,683474950,5,0,1,88064,19,8887240210
13731,683503040,118315,683621355,2,0,0,14336,4,3301371253
13732,683631440,4374,683635814,6,0,1,4608,12,2348251308
13733,683651490,99632,683751122,9,0,0,27136,18,8872355219
13734,683658680,65900,683724580,0,0,0,7168,11,1207956488
13735,683733229,104312,683837541,1,0,0,42496,6,1467597927
13736,683773700,1042,683774742,6,0,1,1024,12,8171644505
13737,683780849,86362,683867211,1,0,0,7680,6,8595775887
13738,683825929,131924,683957853,7,0,0,5120,8,8181023301
13739,683853510,78080,683931590,9,0,0,16896,18,10311501678
13740,683856030,12566,683868596,6,0,1,20992,12,7664915126
13741,683875681,71729,683947410,6,0,0,12800,12,6898435635
13742,683881330,150353,684031683,9,0,0,19456,18,2158219068
13743,683922301,62516,683984817,6,0,0,6144,12,555943187
13744,683998020,2470,684000490,9,0,1,2560,18,6671371663
13745,684016200,113360,684129560,0,0,0,72192,11,7838340356
13746,684126030,103622,684229652,9,0,0,28672,18,3766894291
13747,684247749,45596,684293345,7,0,0,1024,8,761770055
13748,684391669,95444,684487113,1,0,0,18432,6,4153248377
13749,684451860,1994,684453854,1,0,1,2048,6,113480890
13750,684466650,82976,684549626,8,0,0,12800,12,9721285307
13751,684501001,97784,684598785,6,0,0,26112,12,3605877632
13752,684547150,12709,684559859,0,0,1,16384,11,7123542412
13753,684603180,1518,684604698,5,0,1,1536,19,9717861036
13754,684826850,55748,684882598,3,0,0,4096,2,3429887521
13755,684836970,1042,684838012,4,0,1,1024,16,7503930641
13756,684878730,5326,684884056,9,0,1,5632,18,548798931
13757,684884310,90080,684974390,3,0,0,20992,2,603074597
13758,684899530,122452,685021982,9,0,0,81408,18,1009854264
13759,684927850,171244,685099094,8,0,0,34816,12,4766785015
13760,684981859,3387,684985246,3,0,1,9728,2,2273889226
13761,685026230,116430,685142660,8,0,0,15360,12,10417667859
13762,685075610,69873,685145483,0,0,0,9216,11,10578632844
13763,685147160,94712,685241872,5,0,0,26112,19,1953050819
13764,685159800,137932,685297732,9,0,0,48128,18,5778477981
13765,685202539,48980,685251519,7,0,0,2048,8,1495965203
13766,685313260,74360,685387620,9,0,0,9728,18,2397741801
13767,685357500,166523,685524023,2,0,0,57856,4,2482062116
13768,685373559,102752,685476311,7,0,0,37376,8,9524598527
13769,685503149,59132,685562281,7,0,0,5120,8,7572348337
13770,685524049,83034,685607083,7,0,0,19968,8,7618513415
13771,685657400,20624,685678024,9,0,1,33280,18,408277590
13772,685697850,53583,685751433,9,0,1,87552,18,1360746917
13773,685727350,25466,685752816,6,0,1,14848,12,4740839442
13774,685794810,164436,685959246,8,0,0,2048,12,170905512
13775,685889439,93464,685982903,7,0,0,22016,8,7807274799
13776,685919530,126055,686045585,3,0,0,59904,2,4105744489
13777,685935649,1042,685936691,3,0,1,1024,2,5348457951
13778,685953410,11274,685964684,1,0,1,18432,6,9097781333
13779,685962679,103259,686065938,7,0,0,512,8,7414460363
13780,686019790,132606,686152396,5,0,0,19456,19,3307834069
13781,686060949,62672,686123621,1,0,0,6656,6,3843762974
13782,686148419,76661,686225080,7,0,0,14336,8,7222534834
13783,686387829,101972,686489801,1,0,0,34816,6,10694593603
13784,686399349,126068,686525417,7,0,0,30720,8,5846947633
13785,686425230,107549,686532779,3,0,0,20992,2,9252158736
13786,686430120,43904,686474024,3,0,0,512,2,4647448024
13787,686451050,106788,686557838,5,0,0,47616,19,1569001879
13788,686452340,105981,686558321,3,0,0,1536,2,9084939577
13789,686564940,109148,686674088,2,0,0,58368,4,8760725456
13790,686606900,129942,686736842,0,0,0,36352,11,5746827471
13791,686665339,82657,686747996,7,0,0,13312,8,4441851500
13792,686893110,4374,686897484,5,0,1,4608,19,1693353473
13793,686936250,90524,687026774,0,0,0,17408,11,2259211363
13794,686944729,4850,686949579,8,0,1,5120,12,10660427018
13795,686968260,7706,686975966,7,0,1,8192,8,9099935668
13796,686979890,102531,687082421,2,0,0,25088,4,2014080699
13797,687060580,31007,687091587,9,0,1,50176,18,317757703
13798,687109960,50672,687160632,3,0,0,2560,2,5290765508
13799,687205619,125084,687330703,7,0,0,19456,8,916990626
13800,687246850,93488,687340338,5,0,0,27136,19,760393319
13801,687265320,6754,687272074,0,0,1,7168,11,10114214236
13802,687365190,59132,687424322,0,0,0,5120,11,3331629618
13803,687437320,82088,687519408,9,0,0,19968,18,2152299470
13804,687535169,80216,687615385,7,0,0,13824,8,3216747418
13805,687595670,85628,687681298,8,0,0,21504,12,5217961318
13806,687650919,105404,687756323,7,0,0,46080,8,3430744510
13807,687688159,120766,687808925,1,0,0,20992,6,1718405297
13808,687943520,4679,687948199,6,0,1,12288,12,10510600251
13809,688013629,184384,688198013,7,0,0,72704,8,8676377361
13810,688043369,113242,688156611,7,0,0,27136,8,9698872310
13811,688078699,137330,688216029,1,0,0,14336,6,2544283680
13812,688127261,156613,688283874,6,0,0,38912,12,8661485748
13813,688146520,57440,688203960,2,0,0,4608,4,1061200870
13814,688186999,13000,688199999,2,0,1,2048,4,5771509439
13815,688262940,104741,688367681,0,0,0,30208,11,2650843239
13816,688292069,89168,688381237,7,0,0,23040,8,5166692292
13817,688303850,104936,688408786,2,0,0,44544,4,9240084716
13818,688326830,163551,688490381,8,0,0,28672,12,4209866872
13819,688326870,567,688327437,6,0,1,512,12,4288862192
13820,688351539,127246,688478785,7,0,0,43520,8,5140801444
13821,688423609,94695,688518304,7,0,0,22528,8,2151518735
13822,688451950,3898,688455848,1,0,1,4096,6,1015874261
13823,688525199,143891,688669090,7,0,0,16384,8,4421522605
13824,688580699,43904,688624603,7,0,0,512,8,1753598342
13825,688587700,48980,688636680,2,0,0,2048,4,4380162086
13826,688602480,53144,688655624,8,0,0,5632,12,5016826872
13827,688620640,89012,688709652,0,0,0,22528,11,7970400331
13828,688704650,62434,688767084,3,0,0,4608,2,1483006735
13829,688725689,74360,688800049,7,0,0,9728,8,643796203
13830,688774390,103857,688878247,3,0,0,38400,2,6546323899
13831,688776540,108630,688885170,3,0,0,13312,2,5853053870
13832,688807600,14029,688821629,5,0,1,27136,19,5697993506
13833,688829011,155423,688984434,6,0,0,39424,12,9270439089
13834,688864851,92216,688957067,6,0,0,17920,12,10369423166
13835,688947340,106964,689054304,9,0,0,51200,18,8429815901
13836,689016510,7230,689023740,0,0,1,7680,11,4507268287
13837,689042430,176289,689218719,9,0,0,31744,18,6737856973
13838,689059460,103480,689162940,5,0,0,16384,19,2711625221
13839,689126820,115320,689242140,3,0,0,22016,2,3653861203
13840,689155331,98206,689253537,6,0,0,13824,12,2253145042
13841,689205420,98072,689303492,4,0,0,22016,16,10414480915
13842,689250130,6345,689256475,9,0,1,3072,18,386423125
13843,689272430,136030,689408460,9,0,0,2048,18,7320971379
13844,689290980,12527,689303507,7,0,1,7168,8,2348879325
13845,689291340,116481,689407821,9,0,0,76288,18,2406858007
13846,689299700,140797,689440497,8,0,0,67584,12,3353817736
13847,689330560,122689,689453249,9,0,0,4608,18,7775025062
13848,689372901,85632,689458533,6,0,0,5632,12,8420673727
13849,689416119,65900,689482019,7,0,0,7168,8,9963445824
13850,689441150,98540,689539690,2,0,0,23552,4,5486166522
13851,689443300,189096,689632396,5,0,0,99840,19,6446155493
13852,689488490,104895,689593385,9,0,1,174080,18,4599030989
13853,689492150,101581,689593731,4,0,1,512,16,4986680800
13854,689529360,238141,689767501,9,0,1,366080,18,2210908696
13855,689539419,137680,689677099,1,0,0,12800,6,8572147072
13856,689579661,311854,689891515,6,0,0,11776,12,4339855784
13857,689623220,145267,689768487,0,0,1,1536,11,2449694395
13858,689669779,56508,689726287,1,0,0,5632,6,5041085528
13859,689687450,226421,689913871,8,0,0,29696,12,3107712022
13860,689778180,163873,689942053,3,0,0,5120,2,1172051744
13861,689783040,297012,690080052,5,0,1,484864,19,987577463
13862,689783830,371265,690155095,5,0,0,46080,19,5105465173
13863,689816510,255440,690071950,9,0,0,40960,18,2030099191
13864,689819260,350007,690169267,0,0,0,22016,11,1760366889
13865,689821179,597775,690418954,7,0,0,89600,8,2785543221
13866,690059439,25900,690085339,8,0,1,16896,12,6396546081
13867,690096579,327229,690423808,7,0,0,3584,8,10619960197
13868,690170679,196555,690367234,7,0,0,512,8,2168404189
13869,690370860,65522,690436382,3,0,0,5120,2,445203953
13870,690471090,123739,690594829,0,0,0,3072,11,1242147470
13871,690481481,52364,690533845,6,0,0,3072,12,802821995
13872,690607870,6278,690614148,1,0,1,6656,6,10477468627
13873,690628949,93596,690722545,1,0,0,17408,6,9610182686
13874,690704009,4374,690708383,8,0,1,4608,12,7140339870
13875,690736150,54282,690790432,0,0,0,2048,11,5122948525
13876,690799450,120568,690920018,2,0,0,29696,4,53619086
13877,690840800,100880,690941680,2,0,0,31232,4,4717453356
13878,690847320,4850,690852170,7,0,1,5120,8,2981856716
13879,690930130,109148,691039278,0,0,0,58368,11,8847254559
13880,690938411,152203,691090614,6,0,0,65536,12,2153299535
13881,691027441,79289,691106730,6,0,0,12288,12,1619976214
13882,691093180,78548,691171728,3,0,0,18432,2,12038800
13883,691268810,5326,691274136,4,0,1,5632,16,8712440110
13884,691291220,107588,691398808,0,0,0,53248,11,3035809182
13885,691369159,49292,691418451,7,0,0,3072,8,7781647227
13886,691378899,3422,691382321,2,0,1,3584,4,31406880
13887,691446160,76052,691522212,3,0,0,10240,2,2365451365
13888,691459119,85448,691544567,7,0,0,15872,8,5866486488
13889,691461029,151668,691612697,7,0,0,26624,8,936868292
13890,691476140,6754,691482894,7,0,1,7168,8,3029405276
13891,691541070,205380,691746450,2,0,0,34816,4,2455078372
13892,691553170,100412,691653582,8,0,0,29696,12,8359435131
13893,691586580,51296,691637876,3,0,0,4608,2,9948674264
13894,691587470,82092,691669562,4,0,0,6656,16,7672483797
13895,691590739,121841,691712580,1,0,0,25600,6,2186256179
13896,691617940,107686,691725626,9,0,0,39424,18,68105873
13897,691659580,109352,691768932,2,0,0,6656,4,8860668549
13898,691682510,83638,691766148,5,0,0,2560,19,9336061718
13899,691696451,95631,691792082,6,0,0,13312,12,7404869784
13900,691716200,61782,691777982,0,0,0,3072,11,1725108563
13901,691882159,104936,691987095,1,0,0,44544,6,6432450180
13902,691914250,1042,691915292,4,0,1,1024,16,7390771614
13903,691985391,98988,692084379,6,0,0,19456,12,10366096472
13904,691999490,43887,692043377,9,0,1,75264,18,4480444257
13905,692110930,120145,692231075,0,0,0,5120,11,7647597764
13906,692209930,72668,692282598,2,0,0,9216,4,3735553736
13907,692308120,60824,692368944,5,0,0,5632,19,4663114066
13908,692318880,92864,692411744,0,0,0,25088,11,8229353095
13909,692384599,140951,692525550,1,0,0,50688,6,2943310730
13910,692384950,79436,692464386,0,0,0,11264,11,4369866150
13911,692435670,102044,692537714,0,0,0,6656,11,4330451647
13912,692449789,5454,692455243,3,0,1,13824,2,208288546
13913,692579420,107744,692687164,3,0,0,53760,2,1079556561
13914,692586769,148923,692735692,7,0,0,51712,8,3697641471
13915,692604219,251914,692856133,7,0,0,36864,8,1252602116
13916,692604310,6278,692610588,4,0,1,6656,16,1470816576
13917,692639141,131200,692770341,6,0,0,9216,12,9318370016
13918,692691320,153566,692844886,0,0,0,40960,11,5856334854
13919,692699300,194648,692893948,3,0,0,14336,2,4099736358
13920,692708950,26757,692735707,4,0,1,20480,16,8609463142
13921,692744270,2870,692747140,7,0,1,8704,8,789993882
13922,692804769,135409,692940178,7,0,0,38912,8,2192706015
13923,692859620,82601,692942221,8,0,0,6656,12,4768396769
13924,692901680,92528,692994208,5,0,0,18944,19,141222659
13925,692975840,79592,693055432,5,0,0,11776,19,4023885512
13926,693042959,47288,693090247,7,0,0,1536,8,9273799202
13927,693142971,43904,693186875,6,0,0,512,12,2339207929
13928,693244769,106340,693351109,7,0,0,49152,8,8199296271
13929,693377699,566,693378265,2,0,1,512,4,7723360039
13930,693385891,62072,693447963,6,0,0,9728,12,4979830614
13931,693654690,2870,693657560,1,0,1,8704,6,2117144053
13932,693682460,47288,693729748,8,0,0,1536,12,8471950748
13933,693693250,55748,693748998,2,0,0,4096,4,9341224646
13934,693713320,62516,693775836,8,0,0,6144,12,8000254053
13935,693809430,106808,693916238,2,0,0,50688,4,9249689239
13936,693885950,94380,693980330,2,0,0,11776,4,1966008650
13937,693956380,3904,693960284,1,0,1,10752,6,4741581639
13938,694179230,103691,694282921,5,0,1,168448,19,10321771614
13939,694282259,330242,694612501,7,0,0,9728,8,4388502760
13940,694290560,1994,694292554,7,0,1,2048,8,743708151
13941,694293000,14545,694307545,9,0,1,28160,18,6656571341
13942,694299649,190850,694490499,7,0,0,9216,8,8836858953
13943,694328110,68764,694396874,5,0,0,512,19,8182526589
13944,694337140,103950,694441090,9,0,1,168960,18,6594329807
13945,694381320,178646,694559966,0,0,0,9728,11,8144889051
13946,694411620,30034,694441654,0,0,1,10752,11,6013060786
13947,694417210,99658,694516868,9,0,0,7680,18,2447037020
13948,694434920,323087,694758007,8,0,0,12288,12,6598156758
13949,694452561,132929,694585490,6,0,0,25088,12,5661189961
13950,694466830,227296,694694126,9,0,0,39424,18,7041175582
13951,694495350,356774,694852124,5,0,0,52736,19,4482851775
13952,694516040,1386,694517426,7,0,1,512,8,623701919
13953,694539720,134569,694674289,8,0,0,51200,12,2459440592
13954,694562410,233680,694796090,8,0,0,66560,12,6182177990
13955,694579910,249006,694828916,0,0,0,16896,11,373949457
13956,694595740,155985,694751725,5,0,0,40960,19,839230243
13957,694622019,233884,694855903,1,0,0,8704,6,5197301714
13958,694625659,5196,694630855,8,0,1,13312,12,9653639777
13959,694702480,2470,694704950,4,0,1,2560,16,9581480282
13960,694768101,110530,694878631,6,0,0,7680,12,1623660522
13961,694816740,6278,694823018,6,0,1,6656,12,7238574217
13962,694824679,70129,694894808,7,0,0,7168,8,6249309807
13963,694905240,71288,694976528,0,0,0,9728,11,1775160367
13964,694929591,43904,694973495,6,0,0,512,12,6963905286
13965,694979820,101972,695081792,5,0,0,34816,19,6206131081
13966,695038130,72630,695110760,8,0,0,6656,12,8313103872
13967,695135000,3422,695138422,6,0,1,3584,12,6027731392
13968,695141031,87920,695228951,6,0,0,18944,12,929525653
13969,695180680,3387,695184067,6,0,1,9728,12,6936075788
13970,695194200,157008,695351208,2,0,0,23552,4,5264489948
13971,695216529,95781,695312310,1,0,0,23040,6,2260222217
13972,695290060,70976,695361036,2,0,0,8704,4,1699416618
13973,695455320,65612,695520932,0,0,0,11264,11,2052479350
13974,695456880,2470,695459350,0,0,1,2560,11,4705652625
13975,695490599,112112,695602711,1,0,0,68096,6,1295345340
13976,695539830,156553,695696383,0,0,0,15360,11,1198938107
13977,695559439,96828,695656267,7,0,0,9728,8,1798227719
13978,695560059,3422,695563481,3,0,1,3584,2,1531698888
13979,695561960,5326,695567286,9,0,1,5632,18,811155795
13980,695663900,84512,695748412,2,0,0,12800,4,5489821634
13981,695680179,3645,695683824,2,0,1,10240,4,2028805506
13982,695737200,4850,695742050,1,0,1,5120,6,9841249148
13983,695844260,59132,695903392,8,0,0,5120,12,6990523428
13984,695863690,64932,695928622,2,0,0,6144,4,3061267264
13985,695890969,80708,695971677,1,0,0,20480,6,7752426250
13986,695904700,106628,696011328,9,0,0,28160,18,8933181119
13987,695920600,72071,695992671,3,0,0,2560,2,7280698632
13988,695928180,1476,695929656,0,0,1,1024,11,4349326690
13989,695988470,109270,696097740,5,0,0,49152,19,8331426719
13990,696169530,69284,696238814,9,0,0,8192,18,1171534788
13991,696342651,91328,696433979,6,0,0,25088,12,5420235080
13992,696487599,90368,696577967,7,0,0,16896,8,26592891
13993,696608210,109772,696717982,5,0,0,60416,19,8880293608
13994,696632840,566,696633406,6,0,1,512,12,9442185166
13995,696663179,566,696663745,2,0,1,512,4,1912349880
13996,696685490,57932,696743422,9,0,0,512,18,3940870545
13997,696694251,100256,696794507,6,0,0,29184,12,5068517586
13998,696723710,61491,696785201,9,0,0,2560,18,10525194600
13999,696796719,66524,696863243,1,0,0,9216,6,6010221465
14000,696827389,120736,696948125,7,0,0,54784,8,7593780827
14001,696828580,94309,696922889,5,0,0,12288,19,6748409920
14002,696908039,105970,697014009,7,0,0,23040,8,10301678572
14003,697111960,74696,697186656,9,0,0,15872,18,4457536497
14004,697126990,94574,697221564,8,0,0,24576,12,5440199434
14005,697153561,121259,697274820,6,0,0,12800,12,1255671839
14006,697159760,2946,697162706,0,0,1,3072,11,6382458815
14007,697160900,83308,697244208,2,0,0,3072,4,10467713677
14008,697232830,76544,697309374,0,0,0,16896,11,3116549521
14009,697305170,112096,697417266,5,0,0,54272,19,4643940235
14010,697312500,104781,697417281,5,0,1,157184,19,5468729995
14011,697470250,125683,697595933,8,0,0,7680,12,7514078119
14012,697571489,50874,697622363,1,0,0,2560,6,4926749869
14013,697618670,53841,697672511,5,0,1,88064,19,4366336313
14014,697631050,104826,697735876,5,0,0,5632,19,7810445672
14015,697637050,36767,697673817,1,0,1,2048,6,4311348948
14016,697645910,34423,697680333,5,0,1,23040,19,3412618237
14017,697713800,87629,697801429,2,0,0,23040,4,9219953093
14018,697810049,182081,697992130,7,0,0,26624,8,3707987356
14019,697811761,98228,697909989,6,0,0,22528,12,595683253
14020,697828620,1994,697830614,4,0,1,2048,16,9239901466
14021,697911010,3898,697914908,1,0,1,4096,6,908333859
14022,697963740,61604,698025344,5,0,0,8192,19,3027677274
14023,698039330,101348,698140678,3,0,0,32768,2,3681588309
14024,698053140,58844,698111984,0,0,0,9216,11,7454254356
14025,698069231,100097,698169328,6,0,0,9728,12,1273635958
14026,698090990,122408,698213398,2,0,0,101888,4,3333061258
14027,698115620,124118,698239738,9,0,0,4608,18,10221753970
14028,698197469,88715,698286184,1,0,0,9728,6,2474240367
14029,698249200,112892,698362092,5,0,0,70656,19,3123514275
14030,698273581,262727,698536308,6,0,0,30208,12,10106202266
14031,698277200,197725,698474925,3,0,0,9216,2,7248714177
14032,698289361,133901,698423262,6,0,0,38400,12,10673918143
14033,698318490,153612,698472102,0,0,0,37376,11,488922313
14034,698374190,54922,698429112,9,0,0,1024,18,6252267443
14035,698380709,208495,698589204,1,0,0,42496,6,10347629968
14036,698411079,107487,698518566,1,0,0,6144,6,8572896161
14037,698544110,62516,698606626,5,0,0,6144,19,8202121096
14038,698723020,12825,698735845,9,0,1,21504,18,3577961774
14039,698752800,62829,698815629,0,0,0,1536,11,4917636178
14040,698819950,11533,698831483,5,0,1,18944,19,4866230223
14041,698892860,181943,699074803,9,0,0,77312,18,837288385
14042,699000890,147005,699147895,9,0,0,57856,18,483846752
14043,699090679,73434,699164113,1,0,0,4096,6,2843906926
14044,699125540,104468,699230008,8,0,0,43008,12,8366686296
14045,699217170,15300,699232470,1,0,1,2560,6,802572934
14046,699336309,95132,699431441,1,0,0,17408,6,6249522042
14047,699497230,5802,699503032,4,0,1,6144,16,6003254990
14048,699504010,97916,699601926,5,0,0,21504,19,9153430674
14049,699598740,7857,699606597,0,0,1,12288,11,310096748
14050,699650630,117206,699767836,8,0,0,64512,12,4618808900
14051,699656340,1518,699657858,4,0,1,1536,16,10300649933
14052,699704949,107120,699812069,1,0,0,51712,6,9152040899
14053,699853910,12308,699866218,1,0,1,20480,6,2639648489
14054,699949650,34367,699984017,5,0,1,56832,19,2554670614
14055,700015210,26221,700041431,9,0,1,47616,18,9406720404
14056,700062830,187745,700250575,2,0,0,19968,4,4038288356
14057,700075130,68863,700143993,2,0,0,1024,4,2065078638
14058,700240050,97604,700337654,8,0,0,20480,12,2739977758
14059,700299230,138306,700437536,5,0,0,54784,19,2802968877
14060,700308920,148922,700457842,0,0,0,59392,11,3563213860
14061,700351710,191200,700542910,3,0,0,38912,2,946501149
14062,700504890,566,700505456,4,0,1,512,16,4092846996
14063,700600030,3422,700603452,0,0,1,3584,11,8880966766
14064,700646481,71132,700717613,6,0,0,9216,12,8713800283
14065,700697879,65850,700763729,1,0,0,2048,6,8903734185
14066,700708230,45596,700753826,0,0,0,1024,11,5247396886
14067,700794590,63452,700858042,2,0,0,9216,4,416933210
14068,700841570,82820,700924390,5,0,0,12288,19,1482755848
14069,700885480,124080,701009560,3,0,0,36352,2,969099296
14070,700902899,2470,700905369,8,0,1,2560,12,2479589148
14071,700992580,81440,701074020,2,0,0,12800,4,33975646
14072,701186310,94688,701280998,3,0,0,20992,2,2700528129
14073,701229379,148231,701377610,7,0,0,38400,8,3600491087
14074,701240519,55748,701296267,1,0,0,4096,6,7994862444
14075,701359560,115856,701475416,9,0,0,80384,18,4981178248
14076,701368340,115827,701484167,5,0,0,28672,19,6732500559
14077,701382970,112786,701495756,3,0,0,6144,2,9815752019
14078,701487350,8421,701495771,5,0,1,8192,19,119750039
14079,701501370,76863,701578233,8,0,0,11264,12,8391239542
14080,701539899,3645,701543544,2,0,1,10240,4,357357638
14081,701557710,134665,701692375,9,0,0,6144,18,7020057735
14082,701587390,54056,701641446,8,0,0,3584,12,5634199302
14083,701588660,234781,701823441,9,0,0,92672,18,8024170865
14084,701636580,110202,701746782,3,0,0,14336,2,6645931407
14085,701648771,146419,701795190,6,0,0,52224,12,3250864324
14086,701676959,80683,701757642,1,0,0,4608,6,8595436704
14087,701720459,1518,701721977,2,0,1,1536,4,6606191422
14088,701894449,2946,701897395,2,0,1,3072,4,10485721445
14089,701914060,104780,702018840,2,0,0,44032,4,3639253149
14090,701985390,94362,702079752,2,0,0,14848,4,529928693
14091,702045470,105352,702150822,3,0,0,30208,2,7791430880
14092,702132060,67592,702199652,8,0,0,7680,12,6279923905
14093,702302960,4374,702307334,0,0,1,4608,11,2193415518
14094,702383171,81152,702464323,6,0,0,16896,12,7418465447
14095,702385599,4937,702390536,2,0,1,12800,4,1343475983
14096,702418029,2946,702420975,2,0,1,3072,4,4622719755
14097,702491750,65300,702557050,8,0,0,10240,12,1517119353
14098,702567790,81399,702649189,9,0,0,11776,18,590650206
14099,702570890,74696,702645586,5,0,0,15872,19,8932469679
14100,702576240,3904,702580144,1,0,1,10752,6,4083677575
14101,702608220,90088,702698308,2,0,0,16384,4,4713985751
14102,702612340,5326,702617666,7,0,1,5632,8,1209269793
14103,702686041,135248,702821289,6,0,0,58368,12,2371726440
14104,702745281,165312,702910593,6,0,0,21504,12,8933702853
14105,702752720,130189,702882909,3,0,0,46592,2,7208178848
14106,702753959,71250,702825209,1,0,0,512,6,3344648246
14107,702780600,57440,702838040,3,0,0,4608,2,6393809259
14108,702810009,15215,702825224,8,0,1,4096,12,10017900637
14109,702842159,4420,702846579,3,0,1,11776,2,5221654038
14110,702863139,113610,702976749,7,0,0,29696,8,9670834153
14111,702865740,134289,703000029,0,0,0,15360,11,3376906733
14112,702867740,15184,702882924,4,0,1,6144,16,1708026325
14113,702893351,71945,702965296,6,0,0,7168,12,5170785070
14114,702940210,113516,703053726,3,0,0,46080,2,3882802697
14115,702976020,153412,703129432,5,0,0,512,19,2888461098
14116,702987490,566,702988056,1,0,1,512,6,2936582937
14117,703116680,73916,703190596,0,0,0,13312,11,6824538805
14118,703116889,99825,703216714,7,0,0,7168,8,916292535
14119,703184990,65900,703250890,9,0,0,7168,18,9606688416
14120,703212860,77552,703290412,2,0,0,9728,4,10015220884
14121,703243080,98314,703341394,5,0,0,25088,19,6819789675
14122,703341139,6049,703347188,2,0,1,6144,4,9157756786
14123,703464910,100724,703565634,0,0,0,30720,11,2386523995
14124,703526620,101816,703628436,2,0,0,34304,4,3186953399
14125,703544421,98852,703643273,6,0,0,24576,12,8408074008
14126,703577880,11533,703589413,1,0,1,18944,6,1164231324
14127,703611460,68173,703679633,0,0,0,512,11,9556854813
14128,703623790,103759,703727549,5,0,0,19968,19,6190727327
14129,703655600,107233,703762833,3,0,0,9216,2,4532490372
14130,703700080,100880,703800960,9,0,0,31232,18,3649431029
14131,703718400,87291,703805691,0,0,0,2560,11,1979029462
14132,703744950,108378,703853328,3,0,0,14336,2,6333441848
14133,703876430,77324,703953754,0,0,0,19456,11,4750511723
14134,703936870,72980,704009850,2,0,0,10240,4,3828099405
14135,703957389,101715,704059104,7,0,0,24576,8,4005728349
14136,703990200,99320,704089520,5,0,0,26112,19,10059046320
14137,704113490,104624,704218114,9,0,0,43520,18,9328979057
14138,704123340,79450,704202790,9,0,0,18432,18,4062240074
14139,704178720,103927,704282647,0,0,0,36864,11,7709605795
14140,704180051,87896,704267947,6,0,0,13824,12,6773616413
14141,704680910,71468,704752378,4,0,0,15360,16,8568796622
14142,704712551,83933,704796484,6,0,0,12800,12,3472973648
14143,704807860,54212,704862072,5,0,0,4096,19,6006994934
14144,704844559,105872,704950431,7,0,0,47616,8,4603434716
14145,704973140,103174,705076314,5,0,1,167424,19,9575266348
14146,705012909,145276,705158185,1,0,0,12800,6,5930369986
14147,705032250,46010,705078260,0,0,1,3072,11,8312221232
14148,705042460,185473,705227933,8,0,0,14336,12,8192454935
14149,705084840,23983,705108823,4,0,1,39936,16,6345280597
14150,705095130,177326,705272456,2,0,0,67584,4,9540561375
14151,705142510,164612,705307122,5,0,1,270336,19,2602158192
14152,705254231,172086,705426317,6,0,0,1024,12,7942579745
14153,705382131,164220,705546351,6,0,0,24064,12,3396768700
14154,705417229,4374,705421603,2,0,1,4608,4,6086454065
14155,705655750,3387,705659137,7,0,1,9728,8,9072163856
14156,705723180,74852,705798032,4,0,0,16384,16,158452334
14157,705875020,137513,706012533,8,0,0,44544,12,7505292915
14158,705887629,164411,706052040,1,0,0,119808,6,7779489884
14159,705888830,566,705889396,1,0,1,512,6,6756082835
14160,705896780,203950,706100730,5,0,0,46592,19,4866636653
14161,705922850,131857,706054707,8,0,0,8704,12,4454661603
14162,705930000,183324,706113324,5,0,0,6144,19,2405964919
14163,706133689,70976,706204665,7,0,0,8704,8,7873991750
14164,706140399,50672,706191071,7,0,0,2560,8,3476050047
14165,706214160,111332,706325492,5,0,0,65536,19,5002899531
14166,706295530,106606,706402136,9,0,0,17408,18,10088302299
14167,706352310,90836,706443146,3,0,0,18432,2,10476287807
14168,706496711,122636,706619347,6,0,0,91136,12,4529427172
14169,706505679,4679,706510358,3,0,1,12288,2,2939274386
14170,706514560,114638,706629198,3,0,0,32256,2,2464298912
14171,706545610,5196,706550806,6,0,1,13312,12,636961103
14172,706598670,33640,706632310,9,0,1,9216,18,9458592123
14173,706619100,16788,706635888,7,0,1,4096,8,4780540983
14174,706703850,45596,706749446,0,0,0,1024,11,7002637893
14175,706773360,4850,706778210,4,0,1,5120,16,8715664045
14176,706800720,97004,706897724,9,0,0,23552,18,5099968415
14177,706805599,45908,706851507,7,0,0,2048,8,2995329117
14178,706851629,114231,706965860,1,0,0,28160,6,1662923132
14179,706859110,111598,706970708,5,0,0,13824,19,9903752039
14180,706923900,3645,706927545,9,0,1,10240,18,7426002076
14181,706980739,52364,707033103,1,0,0,3072,6,3352499560
14182,707008119,566,707008685,8,0,1,512,12,5350735462
14183,707010380,122245,707132625,8,0,0,10240,12,8293652899
14184,707061719,47288,707109007,7,0,0,1536,8,5119722570
14185,707125870,98720,707224590,9,0,0,29184,18,7124871742
14186,707138259,101816,707240075,1,0,0,34304,6,8211979981
14187,707177960,108669,707286629,0,0,0,29696,11,2641532002
14188,707189360,127011,707316371,0,0,0,10240,11,2015502229
14189,707292300,55748,707348048,5,0,0,4096,19,10080329612
14190,707321450,104172,707425622,9,0,0,30720,18,1776343932
14191,707449870,107120,707556990,5,0,0,51712,19,6368138814
14192,707470080,53300,707523380,5,0,0,6144,19,1410870042
14193,707529469,5326,707534795,8,0,1,5632,12,6196488469
14194,707546130,13339,707559469,7,0,1,2560,8,1417670681
14195,707546550,14874,707561424,4,0,1,10240,16,4349556543
14196,707582219,147677,707729896,7,0,0,6656,8,3980078095
14197,707588771,59756,707648527,6,0,0,7168,12,9052695832
14198,707597729,139559,707737288,7,0,0,10752,8,9425103339
14199,707617400,101036,707718436,0,0,0,31744,11,10559207535
14200,707649729,69658,707719387,7,0,0,3072,8,7827767138
14201,707702231,48980,707751211,6,0,0,2048,12,4571992919
14202,707756450,179843,707936293,0,0,0,35840,11,10655899609
14203,707769820,155538,707925358,2,0,0,93184,4,5889615315
14204,707895310,101660,707996970,0,0,0,33792,11,7455381312
14205,707937140,83224,708020364,2,0,0,3584,4,2443033005
14206,707939070,161136,708100206,8,0,0,22528,12,7449131173
14207,707947360,108056,708055416,3,0,0,54784,2,8481821414
14208,708080160,1994,708082154,4,0,1,2048,16,7914149456
14209,708126050,105092,708231142,0,0,0,45056,11,2026388009
14210,708129360,6754,708136114,0,0,1,7168,11,1423115665
14211,708137101,98424,708235525,6,0,0,14336,12,3956474529
14212,708149220,88504,708237724,5,0,0,7168,19,9694417881
14213,708174620,91699,708266319,9,0,0,7168,18,1474142259
14214,708205039,6229,708211268,3,0,1,15360,2,8437734447
14215,708294650,48980,708343630,2,0,0,2048,4,4131994921
14216,708413880,62516,708476396,8,0,0,6144,12,224719924
14217,708486720,2470,708489190,1,0,1,2560,6,1282992920
14218,708504909,99164,708604073,7,0,0,25600,8,1328120856
14219,708530960,74688,708605648,5,0,0,5120,19,950688646
14220,708630560,101192,708731752,0,0,0,32256,11,5092605060
14221,708702110,62516,708764626,9,0,0,6144,18,7946037181
14222,708769830,1042,708770872,6,0,1,1024,12,344778867
14223,708879880,3898,708883778,6,0,1,4096,12,10291950732
14224,708936771,69284,709006055,6,0,0,8192,12,10190586339
14225,708970470,134381,709104851,2,0,0,32768,4,2750531100
14226,708970630,57440,709028070,2,0,0,4608,4,1641717909
14227,709010380,72668,709083048,5,0,0,9216,19,4749650564
14228,709017040,74696,709091736,5,0,0,15872,19,2650625778
14229,709052310,23983,709076293,9,0,1,39936,18,9700894574
14230,709076839,86237,709163076,7,0,0,15872,8,5200209362
14231,709102490,218785,709321275,2,0,0,52224,4,9395496760
14232,709167299,5802,709173101,2,0,1,6144,4,2218242185
14233,709281270,1994,709283264,0,0,1,2048,11,2598013164
14234,709319449,65610,709385059,7,0,0,8192,8,4891736920
14235,709330659,1518,709332177,2,0,1,1536,4,726331661
14236,709342881,136541,709479422,6,0,0,18944,12,1824437102
14237,709362339,79592,709441931,7,0,0,11776,8,2099038505
14238,709472240,67146,709539386,8,0,0,4608,12,2916701749
14239,709474650,66724,709541374,5,0,0,1536,19,8660772745
14240,709481470,1518,709482988,1,0,1,1536,6,694757400
14241,709528559,103220,709631779,7,0,0,38912,8,8284259956
14242,709595929,566,709596495,8,0,1,512,12,7827039066
14243,709721740,87452,709809192,0,0,0,17408,11,8381497506
14244,709747779,96015,709843794,1,0,0,18944,6,6817333954
14245,709797230,3128,709800358,0,0,1,9216,11,245312486
14246,709807330,47450,709854780,8,0,0,1024,12,8623675015
14247,709818990,2470,709821460,4,0,1,2560,16,9467571563
14248,709858319,82844,709941163,7,0,0,17408,8,4613676167
14249,709870290,47288,709917578,2,0,0,1536,4,7478828087
14250,709876240,2470,709878710,5,0,1,2560,19,6261102513
14251,709927271,101660,710028931,6,0,0,33792,12,3042944515
14252,710099890,60824,710160714,2,0,0,5632,4,5370131939
14253,710151570,72668,710224238,5,0,0,9216,19,4509957669
14254,710169929,47444,710217373,1,0,0,2048,6,8103205369
14255,710225520,112736,710338256,3,0,0,70144,2,1281691122
14256,710283139,117247,710400386,1,0,0,46080,6,3791178265
14257,710300791,131407,710432198,6,0,0,49664,12,2544381650
14258,710347550,89031,710436581,0,0,0,14336,11,5509866873
14259,710411440,72668,710484108,3,0,0,9216,2,9611988866
14260,710474060,6754,710480814,4,0,1,7168,16,10318180610
14261,710483079,5871,710488950,8,0,1,5120,12,10382012898
14262,710488910,98072,710586982,4,0,0,22016,16,1426280735
14263,710656700,99320,710756020,0,0,0,26112,11,7058318203
14264,710685621,98228,710783849,6,0,0,22528,12,8756235253
14265,710796420,105716,710902136,0,0,0,47104,11,5320422126
14266,710806510,47288,710853798,4,0,0,1536,16,3610844834
14267,710823290,89328,710912618,5,0,0,14848,19,4021738571
14268,710876789,103688,710980477,7,0,0,40448,8,2284356572
14269,710917820,45596,710963416,0,0,0,1024,11,2002270648
14270,710968450,79611,711048061,2,0,0,7680,4,7485086176
14271,711000400,106964,711107364,8,0,0,51200,12,8009162067
14272,711046650,3397,711050047,9,0,1,2048,18,5612315546
14273,711076791,111453,711188244,6,0,0,22016,12,7557769457
14274,711093810,14112,711107922,9,0,1,512,18,1501120864
14275,711116600,182117,711298717,4,0,0,18432,16,2155348566
14276,711179530,106496,711286026,9,0,0,49664,18,1744615078
14277,711258360,1042,711259402,9,0,1,1024,18,8221181939
14278,711381530,103532,711485062,3,0,0,39936,2,1396146732
14279,711399420,6278,711405698,7,0,1,6656,8,8884529557
14280,711412819,239229,711652048,1,0,0,54784,6,10218314877
14281,711423430,3422,711426852,4,0,1,3584,16,3105853631
14282,711424280,69575,711493855,4,0,0,8192,16,8470873868
14283,711491300,43904,711535204,3,0,0,512,2,8345857591
14284,711549639,5802,711555441,8,0,1,6144,12,8341614057
14285,711585290,69121,711654411,5,0,0,7680,19,871630567
14286,711643779,81865,711725644,7,0,0,12288,8,5568162668
14287,711740950,43904,711784854,8,0,0,512,12,4443891651
14288,711752810,63140,711815950,2,0,0,8192,4,5108696474
14289,711773649,120380,711894029,7,0,0,95232,8,6539356636
14290,711813140,10241,711823381,6,0,1,16384,12,3663896769
14291,711822669,117433,711940102,1,0,0,35328,6,7335599731
14292,711843750,270305,712114055,9,0,0,40448,18,8528265172
14293,711863100,104801,711967901,8,0,0,12800,12,3779717658
14294,711921400,100765,712022165,2,0,0,7168,4,5995632842
14295,711973280,114417,712087697,4,0,0,60928,16,3058050950
14296,712015879,161118,712176997,7,0,0,9216,8,960322560
14297,712035170,102284,712137454,3,0,0,35840,2,3117200900
14298,712056740,5454,712062194,1,0,1,13824,6,10093055389
14299,712077870,75719,712153589,0,0,0,7168,11,1147948271
14300,712080760,100095,712180855,9,0,0,5632,18,190680988
14301,712168000,72668,712240668,2,0,0,9216,4,6852355623
14302,712225070,104936,712330006,4,0,0,44544,16,689095294
14303,712276900,125334,712402234,3,0,0,37376,2,4483354669
14304,712360680,60622,712421302,3,0,0,5120,2,7288603680
14305,712368409,2470,712370879,8,0,1,2560,12,9184958197
14306,712382480,109814,712492294,3,0,0,33280,2,5363854887
14307,712389930,12319,712402249,7,0,1,2560,8,7862276299
14308,712421820,164524,712586344,8,0,0,64512,12,6274480875
14309,712432990,162417,712595407,8,0,0,29696,12,6723508436
14310,712440159,2946,712443105,3,0,1,3072,2,5579713201
14311,712521020,127454,712648474,4,0,0,40448,16,3916816371
14312,712595419,64362,712659781,1,0,0,6144,6,9937665766
14313,712610410,87896,712698306,2,0,0,13824,4,7638420126
14314,712635590,118354,712753944,8,0,0,13824,12,1181080138
14315,712687070,89480,712776550,9,0,0,24064,18,55627787
14316,712776930,69308,712846238,8,0,0,13312,12,5460693811
14317,712833960,76076,712910036,5,0,0,15360,19,6943383466
14318,712836759,9494,712846253,3,0,1,6656,2,197781255
14319,712862840,112362,712975202,5,0,0,16384,19,1697827229
14320,712934200,47288,712981488,8,0,0,1536,12,6083750793
14321,712962200,106808,713069008,4,0,0,50688,16,4794973774
14322,713006170,110658,713116828,9,0,0,13824,18,8631023392
14323,713019279,16613,713035892,8,0,1,32256,12,4028400911
14324,713084260,97292,713181552,3,0,0,19456,2,5694921402
14325,713214229,6754,713220983,2,0,1,7168,4,9297703140
14326,713236680,94314,713330994,4,0,0,24576,16,6500065761
14327,713340430,47288,713387718,0,0,0,1536,11,5246319588
14328,713375589,84668,713460257,1,0,0,13312,6,2619199230
14329,713410510,105248,713515758,2,0,0,45568,4,4334210620
14330,713447090,125122,713572212,8,0,0,23040,12,2874603598
14331,713554270,63230,713617500,4,0,0,3072,16,6739368159
14332,713578150,3422,713581572,1,0,1,3584,6,9467253187
14333,713593450,47288,713640738,0,0,0,1536,11,8434336568
14334,713686880,100724,713787604,8,0,0,30720,12,9924522201
14335,713689849,1042,713690891,8,0,1,1024,12,3168071641
14336,713701330,20366,713721696,5,0,1,32768,19,8213409966
14337,713727350,145037,713872387,5,0,0,54784,19,7866936489
14338,713877569,98540,713976109,1,0,0,23552,6,6097762322
14339,713907660,98551,714006211,4,0,0,15360,16,4089471745
14340,713982980,15062,713998042,0,0,1,29184,11,4882203536
14341,714037430,105560,714142990,2,0,0,46592,4,6245516591
14342,714217549,48980,714266529,7,0,0,2048,8,719309236
14343,714220140,45596,714265736,0,0,0,1024,11,2977710093
14344,714247910,59132,714307042,4,0,0,5120,16,3619066145
14345,714348410,94064,714442474,0,0,0,18944,11,465566946
14346,714371650,95670,714467320,4,0,0,3584,16,6853438455
14347,714378570,57440,714436010,8,0,0,4608,12,7613839402
14348,714411830,98252,714510082,9,0,0,27648,18,6447874174
14349,714499300,81128,714580428,9,0,0,11776,18,3516436739
14350,714586269,566,714586835,3,0,1,512,2,5244045994
14351,714712910,48980,714761890,2,0,0,2048,4,10390106654
14352,714742310,60224,714802534,2,0,0,8704,4,5495726551
14353,714787280,123188,714910468,5,0,0,104448,19,4426961333
14354,714829450,98118,714927568,9,0,0,2048,18,2385036683
14355,714835000,118128,714953128,5,0,0,15360,19,6004220113
14356,714840930,100174,714941104,8,0,0,6144,12,8124416511
14357,714885230,137210,715022440,5,0,0,36864,19,875305295
14358,714890150,143077,715033227,2,0,0,35328,4,10266226659
14359,714917340,7706,714925046,0,0,1,8192,11,462125577
14360,714991000,11533,715002533,5,0,1,18944,19,9721654972
14361,715011280,26280,715037560,4,0,1,4608,16,2784973233
14362,715025320,120043,715145363,2,0,0,12288,4,2238124722
14363,715051680,186715,715238395,0,0,0,19456,11,9329655953
14364,715133050,69337,715202387,0,0,0,5632,11,8540122340
14365,715178470,148917,715327387,8,0,0,16896,12,1751489854
14366,715179409,6754,715186163,3,0,1,7168,2,2876711305
14367,715401371,48980,715450351,6,0,0,2048,12,4086791059
14368,715461280,6278,715467558,0,0,1,6656,11,4093168008
14369,715560860,86540,715647400,0,0,0,19456,11,8990533411
14370,715578400,6278,715584678,7,0,1,6656,8,8059250064
14371,715593330,63400,715656730,8,0,0,3584,12,8935120612
14372,715683960,3128,715687088,7,0,1,9216,8,2057865562
14373,715710871,85672,715796543,6,0,0,7680,12,1327197453
14374,715734701,129558,715864259,6,0,0,68608,12,2611107583
14375,715749870,192378,715942248,8,0,0,53248,12,7239436102
14376,715755640,59132,715814772,2,0,0,5120,4,10446832551
14377,715756200,16613,715772813,7,0,1,32256,8,8404021443
14378,715757280,166825,715924105,0,0,0,27136,11,10215679932
14379,715846860,195296,716042156,3,0,0,59392,2,3664744120
14380,715902490,85994,715988484,8,0,0,6144,12,7986021687
14381,715957840,149254,716107094,3,0,0,44544,2,6275929522
14382,715993010,66992,716060002,5,0,0,10752,19,5523284080
14383,716031869,24396,716056265,8,0,1,24064,12,1748426657
14384,716056069,136447,716192516,7,0,0,107008,8,3696231891
14385,716129810,130633,716260443,2,0,0,30208,4,10251628417
14386,716205700,143801,716349501,9,0,0,114688,18,10480681375
14387,716400719,78524,716479243,7,0,0,13312,8,7119112712
14388,716460109,4850,716464959,8,0,1,5120,12,981717821
14389,716527620,75608,716603228,9,0,0,13824,18,9961513385
14390,716567750,104936,716672686,2,0,0,44544,4,5623081000
14391,716578870,1994,716580864,9,0,1,2048,18,7205488537
14392,716603899,51242,716655141,1,0,0,1536,6,2490820494
14393,716650310,110096,716760406,2,0,0,32768,4,3051761468
14394,716768911,79904,716848815,6,0,0,12800,12,5216090440
14395,716806760,3904,716810664,4,0,1,10752,16,4872089321
14396,716826241,59132,716885373,6,0,0,5120,12,6531248304
14397,716890720,103220,716993940,3,0,0,38912,2,5792565171
14398,716906249,10757,716917006,8,0,1,17408,12,9547456113
14399,716920130,99184,717019314,2,0,0,5120,4,5366628851
14400,716928500,74498,717002998,3,0,0,4096,2,1432537478
14401,716986500,89427,717075927,3,0,0,3072,2,5923311590
14402,717012369,2470,717014839,8,0,1,2560,12,8415389303
14403,717012540,3925,717016465,6,0,1,2560,12,7107427308
14404,717181940,102752,717284692,5,0,0,37376,19,8839109007
14405,717257780,107588,717365368,9,0,0,53248,18,7278087379
14406,717295740,104624,717400364,2,0,0,43520,4,2573772868
14407,717382840,52364,717435204,0,0,0,3072,11,2123396951
14408,717400130,113118,717513248,8,0,0,70656,12,9004922877
14409,717487999,25264,717513263,8,0,1,15360,12,8531362247
14410,717515660,67592,717583252,4,0,0,7680,16,4578059747
14411,717527619,57208,717584827,1,0,0,5120,6,3955743575
14412,717569690,81074,717650764,2,0,0,10240,4,2412353039
14413,717609349,77924,717687273,7,0,0,16384,8,4072746418
14414,717671920,566,717672486,6,0,1,512,12,9900935325
14415,717778230,75608,717853838,2,0,0,13824,4,9424351092
14416,717787240,72538,717859778,0,0,0,3072,11,6262893705
14417,717793770,47288,717841058,9,0,0,1536,18,8868006405
14418,717821849,55748,717877597,7,0,0,4096,8,2982185074
14419,717920670,105872,718026542,8,0,0,47616,12,4882091908
14420,717939510,1042,717940552,7,0,1,1024,8,4180682354
14421,718019519,14721,718034240,8,0,1,8192,12,5749724164
14422,718048320,66524,718114844,3,0,0,9216,2,1195069490
14423,718108460,108680,718217140,3,0,0,56832,2,1410238225
14424,718186210,6754,718192964,1,0,1,7168,6,9751487894
14425,718188140,106799,718294939,5,0,0,49664,19,9799912492
14426,718215230,137747,718352977,0,0,0,37376,11,7702131298
14427,718250570,77612,718328182,4,0,0,15360,16,1285616566
14428,718340780,12212,718352992,5,0,1,4608,19,7569238431
14429,718367260,169381,718536641,0,0,0,24064,11,4678318250
14430,718385559,104780,718490339,7,0,0,44032,8,394471892
14431,718424900,4374,718429274,6,0,1,4608,12,6334454400
14432,718475690,136467,718612157,4,0,0,110592,16,6778026762
14433,718514640,145271,718659911,8,0,0,34304,12,5472218239
14434,718549530,3898,718553428,4,0,1,4096,16,3556992580
14435,718553929,6278,718560207,8,0,1,6656,12,4127354735
14436,718590099,27852,718617951,3,0,1,6144,2,1815866263
14437,718717299,75949,718793248,7,0,0,9216,8,3791004521
14438,718753040,72692,718825732,0,0,0,14336,11,4518800435
14439,718769590,97308,718866898,8,0,0,7168,12,10636066915
14440,718794480,64676,718859156,9,0,0,8192,18,5994394138
14441,718814840,77012,718891852,3,0,0,18432,2,2213749422
14442,718860239,139103,718999342,7,0,0,132096,8,8498494803
14443,718873660,141966,719015626,8,0,0,34304,12,9385690846
14444,718899131,143309,719042440,6,0,0,45568,12,5490033454
14445,718930620,3645,718934265,4,0,1,10240,16,5554841303
14446,718995340,67248,719062588,5,0,0,3584,19,10122758575
14447,719014620,2516,719017136,0,0,1,1536,11,1857076137
14448,719036529,106003,719142532,7,0,0,28672,8,8374048857
14449,719097819,57440,719155259,7,0,0,4608,8,5405335682
14450,719113269,119917,719233186,7,0,0,93184,8,2081483241
14451,719121790,127621,719249411,2,0,0,9728,4,4082118448
14452,719198830,566,719199396,4,0,1,512,16,2191005667
14453,719253121,93674,719346795,6,0,0,20480,12,5241920130
14454,719259700,80840,719340540,3,0,0,15872,2,4935938760
14455,719293290,6754,719300044,1,0,1,7168,6,4913682848
14456,719321251,113048,719434299,6,0,0,71168,12,3190696683
14457,719340380,123829,719464209,5,0,0,22016,19,7782711246
14458,719418361,71678,719490039,6,0,0,4096,12,5108655234
14459,719419090,87894,719506984,4,0,0,9216,16,298959394
14460,719422300,13100,719435400,0,0,1,1024,11,3413518902
14461,719423670,59217,719482887,9,0,0,1536,18,671782646
14462,719554330,10499,719564829,5,0,1,16896,19,1058667150
14463,719555930,10205,719566135,4,0,1,2048,16,9113308682
14464,719689090,104624,719793714,0,0,0,43520,11,6390390395
14465,719705840,50789,719756629,8,0,0,1536,12,8839344224
14466,719718159,76662,719794821,7,0,0,3584,8,8782553276
14467,719833460,102752,719936212,4,0,0,37376,16,6307752780
14468,719907569,103688,720011257,1,0,0,40448,6,9926880789
14469,719908459,2946,719911405,8,0,1,3072,12,6066970840
14470,719913970,169998,720083968,3,0,0,9216,2,4577736656
14471,719938970,50672,719989642,5,0,0,2560,19,10359943587
14472,720166160,113204,720279364,8,0,0,71680,12,772859734
14473,720297710,106184,720403894,2,0,0,48640,4,4595582183
14474,720346360,108858,720455218,8,0,0,38400,12,4304349851
14475,720350669,54956,720405625,1,0,0,5632,6,5027896698
14476,720385210,105090,720490300,9,0,0,11264,18,9917021877
14477,720430050,119132,720549182,3,0,0,91136,2,7420941059
14478,720567610,98876,720666486,4,0,0,29696,16,2227671204
14479,720604790,86806,720691596,9,0,0,5120,18,9350614329
14480,720680210,54056,720734266,3,0,0,3584,2,6693907030
14481,720749660,115076,720864736,9,0,0,77824,18,2675953248
14482,720782660,109442,720892102,0,0,0,10240,11,528987838
14483,720810050,5971,720816021,4,0,1,14848,16,3991264051
14484,720823200,121679,720944879,2,0,0,51200,4,6901794273
14485,720830130,120536,720950666,2,0,0,18944,4,5833284732
14486,720851210,27185,720878395,7,0,1,23040,8,5810099898
14487,720851840,227707,721079547,8,0,0,26624,12,8453326497
14488,720856070,231136,721087206,5,0,0,25088,19,5391744042
14489,720864590,63656,720928246,9,0,0,5632,18,3599721054
14490,720942660,264472,721207132,4,0,0,53760,16,10021886917
14491,720973330,1994,720975324,1,0,1,2048,6,390924432
14492,720974050,53705,721027755,4,0,0,1536,16,377468571
14493,720989760,74380,721064140,3,0,0,5120,2,659316988
14494,721038160,130769,721168929,2,0,0,81920,4,9928470788
14495,721062639,157464,721220103,7,0,0,42496,8,4358820976
14496,721090120,153378,721243498,2,0,0,5632,4,1913384622
14497,721187280,101776,721289056,3,0,0,17920,2,8079661702
14498,721192509,28119,721220628,3,0,1,512,2,8542663464
14499,721236350,4374,721240724,4,0,1,4608,16,2111931512
14500,721245010,126987,721371997,8,0,0,17408,12,9810327984
14501,721255649,3645,721259294,2,0,1,10240,4,1368879052
14502,721264240,114792,721379032,9,0,0,23040,18,1149029872
14503,721269750,52364,721322114,2,0,0,3072,4,1537830482
14504,721334660,182343,721517003,8,0,0,43008,12,7421610719
14505,721348630,47288,721395918,9,0,0,1536,18,5902871657
14506,721369600,63480,721433080,4,0,0,3584,16,293240307
14507,721392951,103064,721496015,6,0,0,38400,12,4979380062
14508,721463490,73973,721537463,4,0,0,2048,16,3117662117
14509,721503890,25154,721529044,9,0,1,19968,18,2410901555
14510,721519870,231980,721751850,2,0,0,29696,4,10020705254
14511,721530090,91358,721621448,9,0,0,6656,18,9203086005
14512,721574360,7230,721581590,6,0,1,7680,12,9300556689
14513,721620391,118163,721738554,6,0,0,11264,12,8885804585
14514,721675670,101348,721777018,3,0,0,32768,2,644547204
14515,721686800,106238,721793038,9,0,0,9728,18,8059458943
14516,721746050,9954,721756004,5,0,1,11264,19,8015982419
14517,721877679,45596,721923275,7,0,0,1024,8,3088833553
14518,721880610,3898,721884508,7,0,1,4096,8,1754435939
14519,721920080,54368,721974448,0,0,0,4608,11,8186961722
14520,721922520,165687,722088207,2,0,0,37888,4,9746318636
14521,722023660,3387,722027047,7,0,1,9728,8,607826802
14522,722057810,54056,722111866,9,0,0,3584,18,3686839021
14523,722181731,91172,722272903,6,0,0,24576,12,6795428066
14524,722185771,59444,722245215,6,0,0,6144,12,9354746202
14525,722285541,100100,722385641,6,0,0,28672,12,7567779317
14526,722317240,110708,722427948,4,0,0,63488,16,7676771896
14527,722392760,45696,722438456,7,0,1,78848,8,2868163298
14528,722469319,3422,722472741,8,0,1,3584,12,82146609
14529,722486659,179974,722666633,1,0,0,44544,6,50888274
14530,722488010,188021,722676031,8,0,0,3072,12,6357982254
14531,722500700,5326,722506026,6,0,1,5632,12,4769096588
14532,722573990,101082,722675072,2,0,0,27648,4,7421106708
14533,722606371,104536,722710907,6,0,0,12288,12,4036683845
14534,722672170,53566,722725736,8,0,0,2560,12,6229474193
14535,722731989,96716,722828705,7,0,0,27648,8,10393261571
14536,722785311,72986,722858297,6,0,0,1536,12,3645047232
14537,722905640,100724,723006364,8,0,0,30720,12,4233337259
14538,723006200,90056,723096256,0,0,0,15360,11,339221252
14539,723032390,12308,723044698,7,0,1,20480,8,7331737258
14540,723070801,86532,723157333,6,0,0,11776,12,2558507766
14541,723073410,90212,723163622,2,0,0,16384,4,6858976281
14542,723111290,194136,723305426,4,0,0,12288,16,6748417430
14543,723120309,138689,723258998,1,0,0,18432,6,5845459
14544,723142050,99164,723241214,5,0,0,25600,19,1814414000
14545,723143970,130955,723274925,0,0,0,52224,11,4120406088
14546,723175710,108294,723284004,9,0,0,29696,18,10495963657
14547,723197230,1994,723199224,7,0,1,2048,8,7765283791
14548,723214910,91779,723306689,0,0,0,4096,11,10330155607
14549,723258949,128179,723387128,1,0,0,67584,6,4423376301
14550,723261830,131880,723393710,0,0,0,12800,11,9072228400
14551,723293279,96516,723389795,7,0,0,8704,8,5658599062
14552,723304310,90039,723394349,8,0,0,2048,12,7990403818
14553,723332329,135316,723467645,1,0,0,48128,6,9585231389
14554,723394540,2946,723397486,9,0,1,3072,18,5841408438
14555,723411580,2470,723414050,6,0,1,2560,12,6696141329
14556,723413520,2946,723416466,6,0,1,3072,12,10519662945
14557,723427570,161494,723589064,3,0,0,17408,2,10098153299
14558,723432150,104468,723536618,5,0,0,43008,19,3505836366
14559,723591500,11791,723603291,0,0,1,19456,11,6037592380
14560,723640170,5802,723645972,0,0,1,6144,11,6378035108
14561,723642869,108524,723751393,7,0,0,56320,8,2392744295
14562,723645490,153067,723798557,9,0,0,5632,18,648619611
14563,723680680,566,723681246,5,0,1,512,19,7724583404
14564,723712640,111639,723824279,2,0,0,13312,4,1418188382
14565,723748570,190481,723939051,4,0,0,4608,16,469445813
14566,723819280,118352,723937632,5,0,0,88576,19,46546333
14567,723842339,172093,724014432,7,0,0,40960,8,3317373612
14568,723984330,101322,724085652,0,0,0,15360,11,1117694888
14569,723997780,69908,724067688,3,0,0,10240,2,7734559481
14570,724046920,45596,724092516,9,0,0,1024,18,1304545420
14571,724128320,5326,724133646,4,0,1,5632,16,3781242009
14572,724183990,99320,724283310,8,0,0,26112,12,2205074961
14573,724234270,101036,724335306,4,0,0,31744,16,3400853159
14574,724237300,3128,724240428,5,0,1,9216,19,540892102
14575,724265340,106188,724371528,2,0,0,18432,4,3222051471
14576,724272150,48980,724321130,4,0,0,2048,16,6741531661
14577,724314370,80840,724395210,2,0,0,15872,4,8584832371
14578,724324739,10582,724335321,2,0,1,6656,4,7670077239
14579,724345001,97604,724442605,6,0,0,20480,12,530545182
14580,724357899,101296,724459195,1,0,0,13312,6,10449253974
14581,724368139,131220,724499359,7,0,0,29184,8,9479962696
14582,724494000,9725,724503725,7,0,1,4608,8,7600436170
14583,724521430,43904,724565334,2,0,0,512,4,7833445246
14584,724554229,66680,724620909,7,0,0,9728,8,8646225367
14585,724586690,60536,724647226,8,0,0,9728,12,4050056852
14586,724593120,110146,724703266,3,0,0,37376,2,5721764761
14587,724710550,64364,724774914,3,0,0,7168,2,8639845039
14588,724756480,109616,724866096,9,0,0,59904,18,50118403
14589,724874640,102596,724977236,3,0,0,36864,2,7918685507
14590,724919620,193578,725113198,5,0,0,57344,19,10354567883
14591,724934900,106770,725041670,0,0,0,45568,11,10109941258
14592,724993500,7230,725000730,7,0,1,7680,8,4543467699
14593,725007850,10241,725018091,0,0,1,16384,11,7529990557
14594,725153590,96824,725250414,2,0,0,17920,4,7199068955
14595,725168010,107432,725275442,8,0,0,52736,12,5736314789
14596,725180690,185041,725365731,3,0,0,35840,2,7029170639
14597,725193609,1994,725195603,2,0,1,2048,4,2579762625
14598,725207011,147785,725354796,6,0,0,61952,12,7132743688
14599,725217610,115222,725332832,3,0,0,33280,2,6914904215
14600,725289021,93347,725382368,6,0,0,2048,12,7124202761
14601,725315220,151859,725467079,4,0,0,74752,16,7897418605
14602,725352611,125532,725478143,6,0,0,10240,12,6634789573
14603,725400770,87714,725488484,5,0,0,14848,19,260688208
14604,725413419,1042,725414461,3,0,1,1024,2,1630183255
14605,725454009,104366,725558375,7,0,0,19968,8,5823524258
14606,725521880,115359,725637239,0,0,0,19456,11,3832535345
14607,725559191,111020,725670211,6,0,0,64512,12,1790445468
14608,725596360,85297,725681657,2,0,0,17920,4,8934709289
14609,725640600,75608,725716208,0,0,0,13824,11,106674040
14610,725818370,78212,725896582,2,0,0,12288,4,7503157320
14611,725851620,58064,725909684,4,0,0,6656,16,3977307803
14612,725955429,90212,726045641,1,0,0,16384,6,5962183810
14613,726026410,105404,726131814,5,0,0,46080,19,8396267647
14614,726029089,3645,726032734,8,0,1,10240,12,5364611662
14615,726057109,146975,726204084,1,0,0,55296,6,7197459578
14616,726099080,154354,726253434,4,0,0,24576,16,1943876648
14617,726118919,152413,726271332,1,0,0,1536,6,4133635628
14618,726125201,241237,726366438,6,0,0,65536,12,5006063025
14619,726180110,87476,726267586,3,0,0,22528,2,731401133
14620,726195940,84188,726280128,0,0,0,10240,11,9762502151
14621,726318660,48980,726367640,4,0,0,2048,16,2193954193
14622,726356110,11545,726367655,0,0,1,1024,11,7110729809
14623,726362800,80019,726442819,5,0,0,10240,19,2852990404
14624,726435290,52676,726487966,2,0,0,4096,4,8430687062
14625,726534320,107588,726641908,0,0,0,53248,11,10209483358
14626,726601480,4679,726606159,1,0,1,12288,6,1568510558
14627,726775400,86852,726862252,2,0,0,20480,4,4717389221
14628,726795480,3898,726799378,0,0,1,4096,11,9049437692
14629,726801541,98696,726900237,6,0,0,24064,12,9099084347
14630,726820650,28826,726849476,4,0,0,2560,16,214164074
14631,726987850,11533,726999383,5,0,1,18944,19,6936118013
14632,727086220,94664,727180884,4,0,0,15872,16,676759905
14633,727116409,107117,727223526,1,0,0,28672,6,7501030513
14634,727215050,85324,727300374,5,0,0,17920,19,5810503467
14635,727246220,43904,727290124,9,0,0,512,18,9373061624
14636,727273071,60068,727333139,6,0,0,8192,12,3941964117
14637,727282029,90524,727372553,7,0,0,17408,8,9405142944
14638,727328460,83567,727412027,2,0,0,12800,4,4298551175
14639,727408460,8496,727416956,5,0,1,12800,19,6589326482
14640,727469960,1994,727471954,6,0,1,2048,12,3927861714
14641,727533689,7706,727541395,2,0,1,8192,4,3107530668
14642,727538669,83600,727622269,1,0,0,14848,6,8702790980
14643,727571530,59132,727630662,0,0,0,5120,11,5114676991
14644,727643550,115856,727759406,0,0,0,80384,11,9622984833
14645,727647859,54056,727701915,7,0,0,3584,8,7390168164
14646,727694420,134262,727828682,3,0,0,33280,2,4403549535
14647,727711930,119548,727831478,3,0,0,7168,2,3881143704
14648,727735950,103376,727839326,4,0,0,17920,16,1964993515
14649,727782330,74978,727857308,9,0,0,5120,18,6065277337
14650,727863290,74384,727937674,2,0,0,14848,4,6057315730
14651,727944520,76520,728021040,5,0,0,11776,19,3675455644
14652,727955190,74672,728029862,4,0,0,10752,16,1858874381
14653,727975530,4374,727979904,7,0,1,4608,8,8754360906
14654,728016549,80396,728096945,1,0,0,19456,6,6260928744
14655,728035549,107120,728142669,7,0,0,51712,8,4368516431
14656,728049570,94206,728143776,5,0,0,3584,19,6163269516
14657,728081410,1518,728082928,4,0,1,1536,16,9472707249
14658,728088640,99981,728188621,5,0,0,2560,19,106635789
14659,728107559,11016,728118575,3,0,1,17920,2,667946193
14660,728125661,117299,728242960,6,0,0,24576,12,2424066007
14661,728197819,60824,728258643,1,0,0,5632,6,1181869678
14662,728226700,99944,728326644,5,0,0,28160,19,3139614714
14663,728232349,100870,728333219,1,0,0,21504,6,756968885
14664,728248690,164258,728412948,2,0,0,66048,4,2813151708
14665,728268010,124799,728392809,5,0,0,12800,19,4614826704
14666,728296580,128404,728424984,9,0,0,20992,18,3603584298
14667,728305260,126864,728432124,5,0,0,4096,19,7045807398
14668,728318091,107844,728425935,6,0,0,3072,12,9370492168
14669,728358320,70963,728429283,9,0,0,6656,18,1154177264
14670,728428209,62670,728490879,7,0,0,8192,8,5916226931
14671,728460090,43904,728503994,8,0,0,512,12,3147471933
14672,728464630,94688,728559318,3,0,0,20992,2,4898383072
14673,728497150,98078,728595228,3,0,0,6656,2,2247087081
14674,728516880,58376,728575256,4,0,0,7680,16,8594469267
14675,728661020,69776,728730796,8,0,0,14848,12,6723703694
14676,728690301,119293,728809594,6,0,0,40448,12,10596910008
14677,728779450,60824,728840274,5,0,0,5632,19,3647634290
14678,728826010,45596,728871606,5,0,0,1024,19,5247504953
14679,728918079,112424,729030503,1,0,0,69120,6,7139319190
14680,728982390,91205,729073595,2,0,0,6656,4,10323487915
14681,729059430,1518,729060948,6,0,1,1536,12,7191050683
14682,729062960,3422,729066382,6,0,1,3584,12,527158462
14683,729086980,2946,729089926,7,0,1,3072,8,4866404618
14684,729090080,68840,729158920,9,0,0,11776,18,2866982992
14685,729120570,154989,729275559,8,0,0,3584,12,4505560903
14686,729184100,62516,729246616,3,0,0,6144,2,5296875745
14687,729239650,95406,729335056,0,0,0,16896,11,8351924343
14688,729267469,80258,729347727,7,0,0,16384,8,2737101614
14689,729290690,108979,729399669,0,0,0,14336,11,3321958168
14690,729308559,59444,729368003,1,0,0,6144,6,6825002739
14691,729355270,105404,729460674,0,0,0,46080,11,6226601089
14692,729383049,59484,729442533,7,0,0,1536,8,3835385212
14693,729557550,80684,729638234,4,0,0,15360,16,4840302248
14694,729676790,59132,729735922,8,0,0,5120,12,7436593298
14695,729702420,69284,729771704,9,0,0,8192,18,5388524780
14696,729716339,111279,729827618,1,0,0,34304,6,7755440619
14697,729768150,116713,729884863,3,0,0,29184,2,5482858250
14698,729771120,83396,729854516,9,0,0,12288,18,9901583780
14699,729829349,11533,729840882,2,0,1,18944,4,6360893088
14700,729833310,208753,730042063,0,0,0,26624,11,1214317830
14701,729863909,101816,729965725,7,0,0,34304,8,7043155994
14702,729871730,154572,730026302,4,0,0,13312,16,4461114825
14703,729874060,131823,730005883,3,0,0,8704,2,4765162593
14704,729909280,90645,729999925,3,0,0,8192,2,8080071192
14705,729943380,167731,730111111,0,0,0,29184,11,8110112096
14706,729976671,68839,730045510,6,0,0,11264,12,4763089524
14707,730010769,54056,730064825,1,0,0,3584,6,331495155
14708,730112880,80396,730193276,9,0,0,19456,18,269251435
14709,730116680,92670,730209350,2,0,0,512,4,1551350648
14710,730226870,69284,730296154,3,0,0,8192,2,9023224327
14711,730244940,5802,730250742,5,0,1,6144,19,5643560304
14712,730478640,98696,730577336,8,0,0,24064,12,2835362836
14713,730530300,103220,730633520,4,0,0,38912,16,5190030139
14714,730579480,93268,730672748,3,0,0,4096,2,2902822396
14715,730778480,93752,730872232,4,0,0,17920,16,300118850
14716,730893730,62516,730956246,4,0,0,6144,16,10727529098
14717,730922269,5802,730928071,2,0,1,6144,4,9261764524
14718,730939480,5802,730945282,4,0,1,6144,16,2125986642
14719,730990789,139467,731130256,1,0,0,512,6,9751762850
14720,731016890,111800,731128690,2,0,0,67072,4,3712228190
14721,731150940,59756,731210696,9,0,0,7168,18,8772002834
14722,731287460,104780,731392240,8,0,0,44032,12,4618502995
14723,731298530,98906,731397436,9,0,0,5632,18,4502240610
14724,731326110,82820,731408930,3,0,0,12288,2,3633441187
14725,731391590,81482,731473072,4,0,0,15872,16,9102816454
14726,731441350,70532,731511882,8,0,0,12288,12,9278004268
14727,731454430,4374,731458804,7,0,1,4608,8,8595174317
14728,731459199,100880,731560079,7,0,0,31232,8,9975292196
14729,731482890,151239,731634129,9,0,0,6144,18,9078737813
14730,731533680,88583,731622263,9,0,0,11264,18,2252987
14731,731558410,94525,731652935,9,0,0,25088,18,4636335938
14732,731616460,50672,731667132,5,0,0,2560,19,7052048905
14733,731625099,86204,731711303,1,0,0,13312,6,8960643453
14734,731678580,117572,731796152,9,0,0,86016,18,2312185755
14735,731715560,99918,731815478,2,0,0,7168,4,3898113134
14736,731772380,126945,731899325,9,0,0,26112,18,3088057806
14737,731782150,27377,731809527,4,0,1,22528,16,8684941226
14738,731786749,24263,731811012,3,0,1,15360,2,3018796311
14739,731815950,100376,731916326,5,0,0,12800,19,28098813
14740,731831521,187052,732018573,6,0,0,6144,12,9777633333
14741,731860919,78558,731939477,7,0,0,9216,8,452000054
14742,731932450,13083,731945533,0,0,1,22016,11,10409569434
14743,732019461,98852,732118313,6,0,0,24576,12,2046480957
14744,732176529,43904,732220433,1,0,0,512,6,6858456733
14745,732258140,4374,732262514,1,0,1,4608,6,3571777000
14746,732408150,65144,732473294,5,0,0,9728,19,5101774808
14747,732475889,2870,732478759,2,0,1,8704,4,319955930
14748,732507770,161154,732668924,5,0,0,135168,19,10425723507
14749,732509229,171901,732681130,7,0,0,6144,8,9043584625
14750,732515180,164063,732679243,9,0,0,33792,18,3142067667
14751,732524319,2946,732527265,8,0,1,3072,12,3881204108
14752,732561370,1518,732562888,9,0,1,1536,18,2749409523
14753,732596400,87809,732684209,8,0,0,9728,12,4330489552
14754,732613510,121644,732735154,0,0,0,35840,11,947400993
14755,732633440,52094,732685534,0,0,1,11776,11,8784040471
14756,732655379,191154,732846533,1,0,0,86528,6,3083877282
14757,732710600,92192,732802792,4,0,0,2560,16,595469526
14758,732762750,131193,732893943,8,0,0,32256,12,2638496487
14759,732790200,88544,732878744,5,0,0,20992,19,7734045859
14760,732850100,4850,732854950,6,0,1,5120,12,3499837506
14761,732902060,106652,733008712,8,0,0,50176,12,4137156539
14762,732919829,47288,732967117,7,0,0,1536,8,183243662
14763,732925511,94835,733020346,6,0,0,1536,12,10135142572
14764,732930520,6754,732937274,7,0,1,7168,8,5654907033
14765,732964551,128317,733092868,6,0,0,31744,12,10432527221
14766,733013600,164954,733178554,4,0,0,84992,16,7192665948
14767,733025470,88032,733113502,2,0,0,2560,4,7031623116
14768,733045610,153110,733198720,3,0,0,54272,2,4975365654
14769,733063989,114736,733178725,1,0,0,512,6,9326467987
14770,733138479,60880,733199359,7,0,0,2048,8,5567238699
14771,733197060,6665,733203725,1,0,1,4608,6,6178364768
14772,733256350,89630,733345980,2,0,0,4096,4,6682954441
14773,733264120,70976,733335096,4,0,0,8704,16,3274219979
14774,733322721,92972,733415693,6,0,0,15360,12,10435802237
14775,733374189,77744,733451933,1,0,0,10752,6,4441572704
14776,733419700,61604,733481304,3,0,0,8192,2,5558869721
14777,733439859,91095,733530954,7,0,0,8704,8,2972594721
14778,733440869,101401,733542270,7,0,0,30720,8,7014968557
14779,733476530,114298,733590828,5,0,0,27648,19,9242909734
14780,733548540,105716,733654256,9,0,0,47104,18,6166854825
14781,733690769,104780,733795549,1,0,0,44032,6,2463460381
14782,733794810,66787,733861597,4,0,0,7680,16,1725519871
14783,733807950,1518,733809468,7,0,1,1536,8,4598617441
14784,734039520,50672,734090192,8,0,0,2560,12,7822816201
14785,734079571,104468,734184039,6,0,0,43008,12,8530432338
14786,734170099,50672,734220771,1,0,0,2560,6,10147825723
14787,734206760,98540,734305300,5,0,0,23552,19,9864720082
14788,734208860,107219,734316079,3,0,0,35328,2,2522515576
14789,734236640,7230,734243870,4,0,1,7680,16,6265211384
14790,734244810,1518,734246328,6,0,1,1536,12,1573554103
14791,734261250,136606,734397856,0,0,0,27648,11,2018584785
14792,734293800,63556,734357356,4,0,0,5632,16,8055713394
14793,734312060,210435,734522495,8,0,0,28672,12,951594773
14794,734334840,115537,734450377,4,0,1,191488,16,5216679657
14795,734375620,210989,734586609,3,0,0,512,2,3964983985
14796,734487470,219235,734706705,8,0,0,14336,12,4366520824
14797,734505880,145475,734651355,5,0,0,10240,19,9204184820
14798,734510459,123244,734633703,7,0,0,12800,8,9633990925
14799,734545940,67591,734613531,4,0,0,2048,16,9950311395
14800,734596079,146560,734742639,7,0,0,5120,8,4047834498
14801,734600900,179479,734780379,3,0,0,28160,2,9849374980
14802,734648330,79069,734727399,4,0,0,10240,16,4059593674
14803,734716090,179453,734895543,9,0,0,34816,18,2110981014
14804,734724109,109304,734833413,7,0,0,58880,8,4727565715
14805,734844370,144353,734988723,4,0,0,40960,16,887961608
14806,734923210,93539,735016749,4,0,0,15872,16,919242098
14807,734936390,83338,735019728,8,0,0,9728,12,668262206
14808,734946360,88017,735034377,0,0,0,8192,11,3964602209
14809,734947099,130814,735077913,7,0,0,55296,8,1255868407
14810,734993840,102763,735096603,2,0,0,4608,4,1180523588
14811,735006520,110747,735117267,2,0,0,19456,4,10575636681
14812,735051639,104412,735156051,7,0,0,38400,8,7713683492
14813,735092030,121849,735213879,2,0,0,36864,4,7941809803
14814,735128120,7230,735135350,9,0,1,7680,18,4675839337
14815,735186410,65909,735252319,4,0,0,2048,16,7844988379
14816,735193580,4420,735198000,9,0,1,11776,18,6973552569
14817,735242930,102128,735345058,4,0,0,35328,16,8200639890
14818,735255439,3645,735259084,3,0,1,10240,2,7369361974
14819,735334080,44218,735378298,0,0,0,1024,11,9148736923
14820,735366410,77612,735444022,2,0,0,15360,4,3182527157
14821,735408420,113800,735522220,5,0,0,44032,19,4404815497
14822,735463340,106808,735570148,3,0,0,50688,2,2535092184
14823,735499090,73413,735572503,2,0,0,7680,4,5094434724
14824,735592230,70376,735662606,8,0,0,11776,12,8649264524
14825,735605720,3898,735609618,6,0,1,4096,12,5764073550
14826,735670980,45596,735716576,3,0,0,1024,2,4267180531
14827,735673279,44677,735717956,7,0,0,512,8,613629428
14828,735769550,111800,735881350,9,0,0,67072,18,7993408933
14829,735773160,2870,735776030,9,0,1,8704,18,4590752056
14830,735789850,96819,735886669,0,0,0,17408,11,1481725843
14831,735808370,154446,735962816,5,0,0,45056,19,1199682412
14832,735923209,59132,735982341,1,0,0,5120,6,7985418544
14833,736002890,107588,736110478,4,0,0,53248,16,2414137909
14834,736032420,11016,736043436,9,0,1,17920,18,9631212455
14835,736098130,123915,736222045,5,0,0,54784,19,74070198
14836,736116170,89168,736205338,9,0,0,23040,18,6783978819
14837,736165701,61387,736227088,6,0,0,2560,12,2271453267
14838,736208620,19129,736227749,6,0,1,14336,12,8990286164
14839,736270920,2470,736273390,6,0,1,2560,12,9636812499
14840,736283290,5802,736289092,0,0,1,6144,11,1450492729
14841,736311660,566,736312226,6,0,1,512,12,9699866202
14842,736340670,107221,736447891,3,0,0,5632,2,4988350777
14843,736354020,175525,736529545,5,0,0,50688,19,2360920106
14844,736463960,83705,736547665,3,0,0,2048,2,5604527556
14845,736510950,18618,736529568,7,0,1,15360,8,10591382792
14846,736516170,18046,736534216,1,0,1,12288,6,4864212743
14847,736699129,101816,736800945,7,0,0,34304,8,9234649133
14848,736703060,122080,736825140,2,0,0,79360,4,4345260689
14849,736717310,149581,736866891,5,0,0,37888,19,5053310727
14850,736802520,147742,736950262,4,0,0,29184,16,7116085495
14851,736907260,105048,737012308,5,0,0,19968,19,4428310274
14852,736913930,161660,737075590,0,0,0,45056,11,7318462134
14853,736943500,93186,737036686,3,0,0,3072,2,9090501395
14854,737050130,52364,737102494,9,0,0,3072,18,2476870497
14855,737183870,12825,737196695,9,0,1,21504,18,8630553700
14856,737234810,72668,737307478,5,0,0,9216,19,3122948582
14857,737269010,60890,737329900,5,0,0,1024,19,9305089456
14858,737295810,100412,737396222,0,0,0,29696,11,10498352182
14859,737376500,107588,737484088,3,0,0,53248,2,8030484053
14860,737389869,141967,737531836,1,0,0,48640,6,8315852582
14861,737404929,222403,737627332,1,0,0,57344,6,7213424466
14862,737438840,250934,737689774,9,0,0,34304,18,709558342
14863,737499510,98428,737597938,9,0,0,5120,18,4715038675
14864,737505329,3422,737508751,3,0,1,3584,2,5827539139
14865,737515110,566,737515676,6,0,1,512,12,6832698150
14866,737527430,77126,737604556,4,0,0,512,16,275089122
14867,737544760,4850,737549610,0,0,1,5120,11,7757790866
14868,737599720,105716,737705436,9,0,0,47104,18,2961848801
14869,737634809,142061,737776870,1,0,0,20480,6,7823595733
14870,737712890,134654,737847544,0,0,0,49664,11,4599695075
14871,737781031,97160,737878191,6,0,0,24064,12,1055832705
14872,737924400,86252,738010652,9,0,0,23552,18,8301928580
14873,738037010,67442,738104452,0,0,0,1024,11,8337737157
14874,738049190,96362,738145552,0,0,0,19968,11,8849396782
14875,738055439,74087,738129526,1,0,0,1536,6,6292965570
14876,738126500,100412,738226912,8,0,0,29696,12,3196464748
14877,738170450,104780,738275230,9,0,0,44032,18,2219022860
14878,738299309,102752,738402061,7,0,0,37376,8,6094640654
14879,738324089,98582,738422671,7,0,0,3072,8,160515213
14880,738341590,78392,738419982,9,0,0,17920,18,4067706602
14881,738396050,10853,738406903,6,0,1,5120,12,6261440697
14882,738414439,48980,738463419,1,0,0,2048,6,6334537854
14883,738428559,1994,738430553,8,0,1,2048,12,7605653512
14884,738525670,76279,738601949,3,0,0,5120,2,5230398762
14885,738528240,121229,738649469,8,0,0,50176,12,302504321
14886,738647019,100662,738747681,7,0,0,12800,8,8834013855
14887,738663169,69284,738732453,1,0,0,8192,6,1628824192
14888,738718390,86495,738804885,5,0,0,11776,19,9808196664
14889,738805670,99476,738905146,8,0,0,26624,12,7294516253
14890,738841070,125966,738967036,5,0,0,16896,19,7498379777
14891,738863349,45596,738908945,7,0,0,1024,8,5311908255
14892,738866470,11016,738877486,1,0,1,17920,6,2393096582
14893,738950990,43904,738994894,9,0,0,512,18,6869610929
14894,739109980,72824,739182804,5,0,0,9728,19,1690619007
14895,739146889,98072,739244961,1,0,0,22016,6,3638708988
14896,739179210,7706,739186916,0,0,1,8192,11,3582084604
14897,739212439,106028,739318467,1,0,0,48128,6,8944785943
14898,739263310,118895,739382205,2,0,0,39424,4,9863770686
14899,739274460,120507,739394967,4,0,0,34816,16,8639006379
14900,739431490,6229,739437719,5,0,1,15360,19,1944009189
14901,739468700,99320,739568020,3,0,0,26112,2,4473651795
14902,739480550,94796,739575346,4,0,0,8704,16,1653785534
14903,739603180,101348,739704528,8,0,0,32768,12,587372911
14904,739605599,162877,739768476,7,0,0,56320,8,4574144091
14905,739646209,105092,739751301,1,0,0,45056,6,5767439809
14906,739665090,161913,739827003,3,0,0,33792,2,1181462794
14907,739686390,130302,739816692,5,0,0,25600,19,462241945
14908,739770640,108374,739879014,9,0,0,42496,18,8350721960
14909,739892720,91436,739984156,0,0,0,15360,11,8796736703
14910,739918290,11533,739929823,5,0,1,18944,19,3836849479
14911,739929480,67751,739997231,8,0,0,512,12,9736312397
14912,739964270,81128,740045398,2,0,0,11776,4,9559692637
14913,740050590,109616,740160206,4,0,0,59904,16,7688075812
14914,740084110,50984,740135094,3,0,0,3584,2,1567071422
14915,740104890,95384,740200274,0,0,0,7680,11,1345564570
14916,740232280,67592,740299872,3,0,0,7680,2,1516898305
14917,740263951,92963,740356914,6,0,0,12288,12,7176363516
14918,740392960,128024,740520984,5,0,0,120320,19,7423009345
14919,740407620,133656,740541276,5,0,0,25600,19,4125989049
14920,740409030,143643,740552673,2,0,0,4096,4,10726535132
14921,740410659,140751,740551410,1,0,0,17408,6,9815489525
14922,740460850,172190,740633040,8,0,0,57344,12,8601380594
14923,740477380,66776,740544156,4,0,0,2560,16,2002252942
14924,740507059,85415,740592474,1,0,0,13824,6,2037779856
14925,740507610,168966,740676576,8,0,0,38912,12,8524672508
14926,740524240,91070,740615310,5,0,0,3072,19,3412835760
14927,740534890,151832,740686722,8,0,0,512,12,3339190302
14928,740585810,62072,740647882,9,0,0,9728,18,5842664147
14929,740652829,4162,740656991,8,0,1,11264,12,8049747291
14930,740760810,119926,740880736,3,0,0,30720,2,5693730541
14931,740871539,84953,740956492,7,0,0,14336,8,9235032403
14932,740879109,7446,740886555,2,0,1,6144,4,4547308512
14933,740962290,108056,741070346,9,0,0,54784,18,605119677
14934,740994919,1042,740995961,2,0,1,1024,4,3774826705
14935,741020890,82688,741103578,8,0,0,16896,12,6469706547
14936,741178840,3645,741182485,4,0,1,10240,16,1254340780
14937,741228649,112112,741340761,7,0,0,68096,8,6003509539
14938,741238719,69284,741308003,7,0,0,8192,8,5874120137
14939,741262529,210258,741472787,7,0,0,35328,8,9136110224
14940,741299661,103376,741403037,6,0,0,39424,12,9002941335
14941,741343390,97292,741440682,9,0,0,19456,18,1254280794
14942,741407080,123637,741530717,3,0,0,32768,2,678599601
14943,741424080,112892,741536972,9,0,0,20480,18,6189109726
14944,741463260,104226,741567486,4,0,0,8704,16,5076471024
14945,741584479,104468,741688947,7,0,0,43008,8,3447347055
14946,741638030,3387,741641417,5,0,1,9728,19,8050105393
14947,741645220,43904,741689124,2,0,0,512,4,6015474652
14948,741654900,105248,741760148,5,0,0,45568,19,8876245683
14949,741705500,67842,741773342,4,0,0,2048,16,8355931631
14950,741718929,3422,741722351,8,0,1,3584,12,5355514970
14951,741723440,566,741724006,7,0,1,512,8,6923292669
14952,741735840,80084,741815924,4,0,0,18432,16,8839596973
14953,741759600,185074,741944674,2,0,0,6656,4,6266128749
14954,741820460,3422,741823882,1,0,1,3584,6,4641651335
14955,741830631,65768,741896399,6,0,0,11776,12,66762134
14956,741999560,7706,742007266,0,0,1,8192,11,4325860541
14957,742010050,71288,742081338,4,0,0,9728,16,9046986219
14958,742079570,100456,742180026,2,0,0,24064,4,6606162620
14959,742096340,102440,742198780,2,0,0,36352,4,2322545636
14960,742100140,82865,742183005,5,0,0,9728,19,4611164247
14961,742248959,149628,742398587,1,0,0,6656,6,3035585107
14962,742267740,128804,742396544,5,0,0,122880,19,5609781819
14963,742326380,14117,742340497,0,0,1,24064,11,5808565743
14964,742354480,91547,742446027,9,0,0,10752,18,1456692722
14965,742397660,82321,742479981,8,0,0,5120,12,6967798791
14966,742460281,103983,742564264,6,0,0,19968,12,4010948674
14967,742472960,71132,742544092,3,0,0,9216,2,8990208235
14968,742539880,57096,742596976,5,0,0,4096,19,4039876148
14969,742602960,113204,742716164,5,0,0,71680,19,5561677195
14970,742654339,3387,742657726,3,0,1,9728,2,10484140388
14971,742830570,74696,742905266,4,0,0,15872,16,10717663305
14972,742832820,4850,742837670,9,0,1,5120,18,4676776719
14973,742857639,110993,742968632,1,0,0,26112,6,6310451679
14974,742985350,79928,743065278,8,0,0,17920,12,8895876199
14975,743086240,65900,743152140,2,0,0,7168,4,2927948977
14976,743103800,95288,743199088,9,0,0,17920,18,10119317884
14977,743143890,98656,743242546,3,0,0,8192,2,1539051824
14978,743299300,103220,743402520,9,0,0,38912,18,6754844668
14979,743337409,98237,743435646,1,0,0,20480,6,1205530234
14980,743342350,43904,743386254,5,0,0,512,19,5975819980
14981,743391300,122029,743513329,4,0,0,48640,16,5687288379
14982,743394879,162993,743557872,7,0,0,53760,8,1994472950
14983,743445820,4374,743450194,1,0,1,4608,6,4481384065
14984,743451460,136538,743587998,8,0,0,50688,12,2354603864
14985,743576270,17046,743593316,5,0,1,5632,19,1500761147
14986,743748799,566,743749365,2,0,1,512,4,545476974
14987,743801030,73604,743874634,4,0,0,12288,16,7232290999
14988,743837040,114388,743951428,8,0,0,30208,12,5348464466
14989,744041001,105092,744146093,6,0,0,45056,12,1972503989
14990,744043110,63767,744106877,9,0,0,2048,18,9795338930
14991,744060160,65768,744125928,3,0,0,11776,2,6388472435
14992,744075181,129649,744204830,6,0,0,24576,12,10734380450
14993,744116730,104957,744221687,8,0,0,9728,12,373643981
14994,744126869,43904,744170773,1,0,0,512,6,2869339923
14995,744129920,98958,744228878,0,0,0,23552,11,1384187969
14996,744166670,134684,744301354,0,0,0,34816,11,10193077559
14997,744207569,101912,744309481,7,0,0,26624,8,829463489
14998,744222740,90188,744312928,8,0,0,11264,12,7316473625
14999,744262300,190204,744452504,2,0,0,47616,4,5049278027
15000,744271790,110472,744382262,9,0,0,45056,18,9281552463
15001,744298980,14506,744313486,1,0,1,512,6,1963453635
15002,744362260,72124,744434384,2,0,0,1024,4,4214127285
15003,744401190,4374,744405564,5,0,1,4608,19,8727285081
15004,744431890,54524,744486414,3,0,0,5120,2,7353701078
15005,744463570,82604,744546174,0,0,0,16384,11,1946399828
15006,744477910,52988,744530898,8,0,0,5120,12,2611193241
15007,744500991,78963,744579954,6,0,0,2560,12,1917119680
15008,744551079,3387,744554466,2,0,1,9728,4,4884947289
15009,744583910,116636,744700546,9,0,0,82944,18,4884615580
15010,744588720,151306,744740026,2,0,0,51200,4,797586059
15011,744659290,161796,744821086,0,0,0,27648,11,6768404159
15012,744760249,4162,744764411,8,0,1,11264,12,9458177899
15013,744788730,3128,744791858,4,0,1,9216,16,882953549
15014,744802651,68175,744870826,6,0,0,7168,12,1541390758
15015,744817870,6154,744824024,1,0,1,3072,6,8564776125
15016,744841149,43904,744885053,1,0,0,512,6,5753910209
15017,744896260,60224,744956484,2,0,0,8704,4,6398924339
15018,744896389,98384,744994773,1,0,0,23040,6,5524091027
15019,744919590,108636,745028226,4,0,0,36352,16,7478597106
15020,744971550,104223,745075773,9,0,0,19456,18,3573559667
15021,744996150,4850,745001000,4,0,1,5120,16,2684136757
15022,745017310,61580,745078890,5,0,0,2560,19,9849502279
15023,745028590,117236,745145826,9,0,0,13312,18,6472395056
15024,745057970,75676,745133646,8,0,0,3584,12,2721886215
15025,745168660,48980,745217640,0,0,0,2048,11,1876704443
15026,745277301,60824,745338125,6,0,0,5632,12,2938599755
15027,745307041,113828,745420869,6,0,0,73728,12,4308486723
15028,745364220,3422,745367642,1,0,1,3584,6,5643633606
15029,745435160,91460,745526620,3,0,0,20480,2,1397007652
15030,745549069,68684,745617753,1,0,0,11264,6,4320751703
15031,745555699,62381,745618080,7,0,0,1024,8,8090175355
15032,745562800,62856,745625656,9,0,0,5120,18,7474442167
15033,745575740,81128,745656868,9,0,0,11776,18,5410290726
15034,745623569,12995,745636564,3,0,1,25088,2,655862437
15035,745718610,69284,745787894,5,0,0,8192,19,294731495
15036,745729930,101504,745831434,8,0,0,33280,12,5263486342
15037,745757990,4374,745762364,9,0,1,4608,18,10567399015
15038,745778951,107588,745886539,6,0,0,53248,12,4407474868
15039,745897550,99632,745997182,3,0,0,27136,2,6782082077
15040,745955159,139103,746094262,1,0,0,46080,6,1504291424
15041,746015690,101762,746117452,4,0,0,5120,16,1405279862
15042,746054890,126312,746181202,2,0,0,31744,4,4451818248
15043,746107599,2470,746110069,8,0,1,2560,12,8727868932
15044,746118480,3904,746122384,4,0,1,10752,16,8242807240
15045,746143960,81686,746225646,3,0,0,39936,2,5464446033
15046,746261760,89612,746351372,2,0,0,19456,4,2797992452
15047,746273250,3387,746276637,9,0,1,9728,18,7271834964
15048,746274520,37830,746312350,0,0,1,63488,11,8643811768
15049,746362530,67592,746430122,2,0,0,7680,4,7887975072
15050,746365500,258558,746624058,0,0,0,57856,11,6816639200
15051,746388380,5196,746393576,7,0,1,13312,8,2983943075
15052,746399969,66579,746466548,1,0,0,5120,6,9384675658
15053,746419150,72848,746491998,3,0,0,14848,2,10304218410
15054,746436839,566,746437405,2,0,1,512,4,8685354828
15055,746455231,85784,746541015,6,0,0,22016,12,8236507337
15056,746462790,108213,746571003,0,0,0,53248,11,6283316523
15057,746486101,210200,746696301,6,0,0,22528,12,347745967
15058,746601719,22354,746624073,2,0,1,6144,4,2637427528
15059,746634550,125281,746759831,2,0,0,43008,4,7326552447
15060,746649459,566,746650025,3,0,1,512,2,14532539
15061,746714340,97292,746811632,3,0,0,19456,2,10514329941
15062,746873730,2470,746876200,4,0,1,2560,16,919715714
15063,746892680,50672,746943352,3,0,0,2560,2,6007067921
15064,746902429,88256,746990685,1,0,0,25088,6,3766453703
15065,746908860,180993,747089853,4,0,0,15872,16,3571261574
15066,746955641,164914,747120555,6,0,0,4608,12,886836105
15067,747178550,85160,747263710,3,0,0,19968,2,17889000
15068,747269930,102440,747372370,5,0,0,36352,19,9140667527
15069,747292950,54056,747347006,0,0,0,3584,11,8386531036
15070,747336850,129897,747466747,8,0,0,26112,12,4951979281
15071,747350720,108056,747458776,4,0,0,54784,16,7580667786
15072,747503170,108524,747611694,4,0,0,56320,16,7387590451
15073,747543480,117540,747661020,5,0,0,20480,19,684601650
15074,747630780,79616,747710396,5,0,0,16896,19,1072676843
15075,747673110,118286,747791396,5,0,0,13312,19,8179457792
15076,747708040,8150,747716190,9,0,1,6144,18,2543325899
15077,747734189,121938,747856127,1,0,0,38912,6,4716192445
15078,747807329,566,747807895,2,0,1,512,4,1058170974
15079,747845699,101568,747947267,1,0,0,19456,6,5978053506
15080,747848320,11722,747860042,0,0,1,4096,11,10198909335
15081,747905930,136835,748042765,4,0,0,19456,16,470390926
15082,747961281,88066,748049347,6,0,0,13824,12,7425038590
15083,747973590,71530,748045120,8,0,0,7680,12,7052160877
15084,748053760,133878,748187638,2,0,0,68608,4,8732619425
15085,748075370,84280,748159650,0,0,0,11264,11,3955340080
15086,748104400,116588,748220988,2,0,0,14848,4,7922540025
15087,748112160,3898,748116058,1,0,1,4096,6,3519032779
15088,748147380,14029,748161409,5,0,1,27136,19,4258720096
15089,748154820,10135,748164955,9,0,1,5632,18,393996776
15090,748227210,48980,748276190,4,0,0,2048,16,6789789141
15091,748243611,86852,748330463,6,0,0,20480,12,8162791853
15092,748264639,6278,748270917,2,0,1,6656,4,5085654322
15093,748365449,99476,748464925,7,0,0,26624,8,10332699568
15094,748376340,62516,748438856,8,0,0,6144,12,322717772
15095,748376869,77035,748453904,7,0,0,5120,8,4407729487
15096,748599160,99944,748699104,3,0,0,28160,2,2720436863
15097,748603000,54056,748657056,4,0,0,3584,16,1418361028
15098,748619890,60824,748680714,4,0,0,5632,16,1131536148
15099,748675400,45596,748720996,2,0,0,1024,4,7615622438
15100,748822900,57440,748880340,9,0,0,4608,18,9234142021
15101,748865570,108680,748974250,5,0,0,56832,19,6292904141
15102,748975920,102596,749078516,2,0,0,36864,4,4749670745
15103,748985620,110539,749096159,8,0,0,57856,12,2117120425
15104,749028010,204842,749232852,2,0,0,75776,4,10484369917
15105,749042650,265336,749307986,0,0,0,111104,11,7581135290
15106,749047580,131944,749179524,0,0,0,36864,11,675606231
15107,749129910,4374,749134284,1,0,1,4608,6,4053298568
15108,749145150,183949,749329099,8,0,0,8192,12,1738750198
15109,749146671,179909,749326580,6,0,0,29184,12,2395616567
15110,749190590,1994,749192584,6,0,1,2048,12,5222219439
15111,749207730,109943,749317673,4,0,0,31744,16,6951140992
15112,749210910,159330,749370240,2,0,0,28160,4,3286825282
15113,749244969,87657,749332626,1,0,0,6656,6,1833407930
15114,749301690,93949,749395639,4,0,0,6656,16,2853147078
15115,749308170,113449,749421619,3,0,0,18944,2,980529283
15116,749324240,137147,749461387,9,0,0,1024,18,9481554497
15117,749484070,92708,749576778,4,0,0,24576,16,4225975466
15118,749524819,88181,749613000,1,0,0,11264,6,1071360695
15119,749538469,1994,749540463,2,0,1,2048,4,235785371
15120,749627410,104624,749732034,3,0,0,43520,2,3200012485
15121,749628190,43904,749672094,0,0,0,512,11,2878615692
15122,749681590,50927,749732517,9,0,0,1536,18,9892529322
15123,749694400,4374,749698774,9,0,1,4608,18,9429952037
15124,749734299,110552,749844851,1,0,0,62976,6,1144290375
15125,749734769,57440,749792209,1,0,0,4608,6,6058529553
15126,749816369,5326,749821695,3,0,1,5632,2,1409951156
15127,749818530,129556,749948086,8,0,0,70144,12,10568237444
15128,749858800,154380,750013180,0,0,0,55808,11,1625203870
15129,749922201,156989,750079190,6,0,0,89600,12,6396152752
15130,749943980,156872,750100852,8,0,0,33792,12,3634900850
15131,750032109,137893,750170002,1,0,0,32768,6,8498354565
15132,750118430,56684,750175114,0,0,0,7168,11,2101888345
15133,750122809,566,750123375,3,0,1,512,2,2844855043
15134,750153990,97760,750251750,9,0,0,20992,18,417235069
15135,750167141,169163,750336304,6,0,0,14336,12,196143682
15136,750442270,110240,750552510,3,0,0,61952,2,2523609315
15137,750484330,135926,750620256,3,0,0,56320,2,8716628430
15138,750496490,97760,750594250,2,0,0,20992,4,10186394523
15139,750600570,1042,750601612,4,0,1,1024,16,6759644677
15140,750649490,61448,750710938,9,0,0,7680,18,4631504186
15141,750728600,1518,750730118,7,0,1,1536,8,2339124811
15142,750845199,47288,750892487,1,0,0,1536,6,929323563
15143,750849230,105248,750954478,0,0,0,45568,11,3734618489
15144,750855820,84380,750940200,5,0,0,17408,19,6110546469
15145,750863350,143450,751006800,4,0,0,69632,16,6247995090
15146,750876530,131221,751007751,8,0,0,3072,12,4398240229
15147,750877451,147113,751024564,6,0,0,47616,12,2003668045
15148,750888110,154250,751042360,2,0,0,10240,4,4135872125
15149,750891970,137133,751029103,4,0,0,14848,16,2916363273
15150,750905299,104659,751009958,7,0,0,7168,8,1650271711
15151,750943150,195954,751139104,3,0,0,23040,2,7568312507
15152,750983150,566,750983716,4,0,1,512,16,873208627
15153,751004850,89920,751094770,2,0,0,9728,4,6905989510
15154,751038800,76052,751114852,3,0,0,10240,2,7651064839
15155,751091389,101349,751192738,1,0,0,21504,6,1906097580
15156,751230590,73316,751303906,8,0,0,16384,12,9621169709
15157,751242999,146905,751389904,1,0,0,70656,6,6844689619
15158,751331590,58797,751390387,3,0,0,1536,2,9801575857
15159,751349349,117932,751467281,7,0,0,54784,8,9453458842
15160,751397299,81128,751478427,1,0,0,11776,6,6677039108
15161,751399400,121083,751520483,8,0,0,26624,12,1483936677
15162,751436730,84704,751521434,3,0,0,3072,2,7194279886
15163,751473641,139554,751613195,6,0,0,31232,12,9631069232
15164,751552650,2470,751555120,6,0,1,2560,12,1924552845
15165,751659300,6278,751665578,4,0,1,6656,16,1517439105
15166,751773389,2870,751776259,8,0,1,8704,12,7070821003
15167,751802700,198518,752001218,8,0,0,24064,12,8639868783
15168,751839241,111800,751951041,6,0,0,67072,12,157351876
15169,751912170,16613,751928783,1,0,1,32256,6,7280615365
15170,751930679,94714,752025393,7,0,0,9728,8,2987347523
15171,751936760,18213,751954973,7,0,1,4096,8,1443976551
15172,751939830,19329,751959159,0,0,1,6656,11,3863999285
15173,752026900,91904,752118804,5,0,0,16896,19,9222868127
15174,752036920,45596,752082516,9,0,0,1024,18,5621392758
15175,752063120,3128,752066248,4,0,1,9216,16,94073956
15176,752070919,99632,752170551,1,0,0,27136,6,5692190998
15177,752078000,161203,752239203,8,0,0,91136,12,6685936339
15178,752088250,22433,752110683,7,0,1,36864,8,7013031116
15179,752132520,12308,752144828,7,0,1,20480,8,8358586220
15180,752244669,106184,752350853,7,0,0,48640,8,956889265
15181,752281011,98540,752379551,6,0,0,23552,12,398119986
15182,752286350,95244,752381594,5,0,0,6656,19,2011807445
15183,752332980,114941,752447921,3,0,0,19968,2,1048315197
15184,752399319,71156,752470475,1,0,0,7168,6,9031453234
15185,752539450,100568,752640018,3,0,0,30208,2,2306765514
15186,752594070,91904,752685974,2,0,0,16896,4,2790938267
15187,752641950,85004,752726954,9,0,0,19456,18,2883358503
15188,752650660,115234,752765894,3,0,0,36352,2,305952571
15189,752670199,58174,752728373,7,0,0,4608,8,7937654540
15190,752682780,65858,752748638,3,0,0,6656,2,6696073105
15191,752689360,79744,752769104,5,0,0,7168,19,9046504625
15192,752695020,101861,752796881,0,0,0,2560,11,3016487862
15193,752705569,90517,752796086,7,0,0,7168,8,3766192996
15194,752908880,72668,752981548,5,0,0,9216,19,7316551685
15195,752930070,109756,753039826,5,0,0,48128,19,156350387
15196,752953140,126632,753079772,8,0,0,18944,12,2387544522
15197,753058529,3904,753062433,3,0,1,10752,2,2795527936
15198,753092329,54056,753146385,7,0,0,3584,8,7378622304
15199,753111049,75662,753186711,7,0,0,13824,8,4733465844
15200,753198139,48980,753247119,1,0,0,2048,6,5848689418
15201,753300260,74360,753374620,4,0,0,9728,16,7391999006
15202,753311160,111644,753422804,4,0,0,66560,16,3064970595
15203,753473180,2470,753475650,1,0,1,2560,6,5751223674
15204,753516140,57440,753573580,0,0,0,4608,11,1508196150
15205,753546960,2470,753549430,0,0,1,2560,11,297220038
15206,753593549,99164,753692713,1,0,0,25600,6,4968161207
15207,753604530,102607,753707137,5,0,0,22528,19,2625612256
15208,753622440,131407,753753847,8,0,0,18432,12,5631596981
15209,753648990,77924,753726914,8,0,0,16384,12,9790211144
15210,753687801,80909,753768710,6,0,0,5120,12,521863809
15211,753742610,4679,753747289,9,0,1,12288,18,1197531445
15212,753768260,1484,753769744,4,0,1,1024,16,8123239270
15213,753811109,82844,753893953,1,0,0,17408,6,10466307780
15214,753868750,4374,753873124,1,0,1,4608,6,878648421
15215,753916200,2946,753919146,7,0,1,3072,8,6433806212
15216,753972560,1042,753973602,7,0,1,1024,8,4444022135
15217,754104970,68840,754173810,5,0,0,11776,19,1742089969
15218,754136199,3898,754140097,2,0,1,4096,4,10720589185
15219,754154190,47288,754201478,8,0,0,1536,12,7532659711
15220,754304410,50672,754355082,5,0,0,2560,19,9883051243
15221,754313229,120037,754433266,1,0,0,47616,6,8371783095
15222,754320419,7230,754327649,3,0,1,7680,2,340959173
15223,754339529,5802,754345331,3,0,1,6144,2,5920958812
15224,754379600,4850,754384450,5,0,1,5120,19,5004732862
15225,754429459,4365,754433824,2,0,1,512,4,5667757421
15226,754433369,103626,754536995,7,0,0,39936,8,10674366003
15227,754497580,66505,754564085,9,0,0,11776,18,7314026800
15228,754535310,8431,754543741,5,0,1,7168,19,7291810133
15229,754595230,91928,754687158,9,0,0,22016,18,1717323748
15230,754635430,102085,754737515,3,0,0,20992,2,76915272
15231,754638000,130008,754768008,3,0,0,59392,2,10103338902
15232,754673039,14134,754687173,2,0,1,17920,4,3464325873
15233,754833070,1518,754834588,0,0,1,1536,11,6077193990
15234,754847920,93596,754941516,9,0,0,17408,18,782701634
15235,754919840,4162,754924002,6,0,1,11264,12,5053392536
15236,754945199,59132,755004331,1,0,0,5120,6,8001776778
15237,754952500,103376,755055876,3,0,0,39424,2,7717371817
15238,755017549,66800,755084349,1,0,0,3584,6,3663196624
15239,755026920,112703,755139623,9,0,0,28672,18,7513438403
15240,755028960,11791,755040751,5,0,1,19456,19,111692014
15241,755093390,101117,755194507,2,0,0,512,4,5674514425
15242,755160290,112112,755272402,8,0,0,68096,12,3457654281
15243,755205921,122863,755328784,6,0,0,30208,12,824244577
15244,755267120,137834,755404954,5,0,0,52224,19,4073646887
15245,755355660,108766,755464426,8,0,0,30720,12,5116428296
15246,755384999,111149,755496148,1,0,0,7680,6,8978670384
15247,755406849,45596,755452445,1,0,0,1024,6,4969284736
15248,755429380,122171,755551551,0,0,0,38400,11,4246015690
15249,755443000,11016,755454016,4,0,1,17920,16,3732562930
15250,755544930,52209,755597139,5,0,0,1024,19,8263264230
15251,755576190,74984,755651174,8,0,0,11776,12,9840804536
15252,755592599,89588,755682187,1,0,0,14336,6,2159436899
15253,755650170,102032,755752202,4,0,0,31744,16,5560361097
15254,755671600,98704,755770304,5,0,0,19456,19,7763043683
15255,755749820,5796,755755616,0,0,1,3584,11,6789436796
15256,755769080,103500,755872580,5,0,0,35840,19,9380638732
15257,755778071,162381,755940452,6,0,0,97280,12,2292595366
15258,755844661,124045,755968706,6,0,0,22528,12,9690468868
15259,755906740,65900,755972640,2,0,0,7168,4,516915147
15260,755919180,75320,755994500,9,0,0,3584,18,6292071540
15261,755938110,49647,755987757,3,0,0,1536,2,9921553890
15262,755986840,106109,756092949,8,0,0,47104,12,7038430526
15263,756025090,71462,756096552,3,0,0,11776,2,8087620300
15264,756045210,134991,756180201,4,0,0,33792,16,6203540951
15265,756056459,3904,756060363,8,0,1,10752,12,2200065461
15266,756143339,2946,756146285,3,0,1,3072,2,5790709166
15267,756205571,82976,756288547,6,0,0,12800,12,9776447332
15268,756206290,121517,756327807,5,0,0,27648,19,3407480555
15269,756245920,73448,756319368,8,0,0,11776,12,3294051994
15270,756283439,98228,756381667,7,0,0,22528,8,10710808527
15271,756341580,114295,756455875,0,0,0,11776,11,7558041409
15272,756363359,72668,756436027,1,0,0,9216,6,10066425087
15273,756412220,105560,756517780,8,0,0,46592,12,3286064328
15274,756464810,2946,756467756,4,0,1,3072,16,3450222644
15275,756602500,102752,756705252,8,0,0,37376,12,3090981343
15276,756614210,91369,756705579,2,0,0,1024,4,3846738685
15277,756640670,105652,756746322,3,0,0,9728,2,7379530971
15278,756755261,117572,756872833,6,0,0,86016,12,8172796542
15279,756795840,88171,756884011,5,0,0,5632,19,9261696699
15280,756836740,86193,756922933,2,0,0,11264,4,1043614688
15281,756903719,104780,757008499,1,0,0,44032,6,8123707035
15282,756916209,104629,757020838,7,0,0,40448,8,1623760906
15283,756929120,5326,756934446,4,0,1,5632,16,3735569628
15284,756990419,73448,757063867,1,0,0,11776,6,6779760600
15285,757015399,91815,757107214,1,0,0,18944,6,10576201999
15286,757053060,97134,757150194,2,0,0,7168,4,1018952692
15287,757106770,96372,757203142,9,0,0,25088,18,7910764639
15288,757121640,1994,757123634,7,0,1,2048,8,2404526719
15289,757161171,104312,757265483,6,0,0,42496,12,7341641957
15290,757231770,1994,757233764,6,0,1,2048,12,5363572101
15291,757235800,66439,757302239,5,0,0,4608,19,2133080594
15292,757279620,158763,757438383,5,0,0,26624,19,7435439735
15293,757288889,1994,757290883,2,0,1,2048,4,10664313206
15294,757298220,10241,757308461,1,0,1,16384,6,948117796
15295,757425090,2946,757428036,6,0,1,3072,12,8256482465
15296,757523511,95156,757618667,6,0,0,22528,12,1421711426
15297,757531589,88497,757620086,7,0,0,4608,8,4506392977
15298,757563280,47485,757610765,4,0,0,512,16,7652131754
15299,757613509,50473,757663982,7,0,0,512,8,4045402845
15300,757626119,7706,757633825,8,0,1,8192,12,2877220219
15301,757657919,1518,757659437,3,0,1,1536,2,3615915539
15302,757676060,94688,757770748,3,0,0,20992,2,4394383507
15303,757677760,62516,757740276,3,0,0,6144,2,6941933636
15304,757685409,71755,757757164,1,0,0,6656,6,3529854609
15305,757686930,99944,757786874,2,0,0,28160,4,8616545244
15306,757731910,107682,757839592,5,0,0,12800,19,10009780693
15307,757771990,127307,757899297,4,0,0,38912,16,10235926924
15308,757812920,133009,757945929,8,0,0,25600,12,2505575313
15309,757830649,8958,757839607,8,0,1,7168,12,7232797091
15310,757958510,72668,758031178,0,0,0,9216,11,956028841
15311,758046680,98852,758145532,2,0,0,24576,4,8861557714
15312,758051239,4679,758055918,2,0,1,12288,4,8112828529
15313,758169529,97292,758266821,7,0,0,19456,8,160986975
15314,758224720,71423,758296143,3,0,0,8704,2,906452600
15315,758241810,128295,758370105,4,0,0,18432,16,6079294141
15316,758252090,45596,758297686,8,0,0,1024,12,5346323762
15317,758278181,112168,758390349,6,0,0,44544,12,6772142550
15318,758282649,64086,758346735,7,0,0,6144,8,3818451834
15319,758291780,4850,758296630,0,0,1,5120,11,5929171261
15320,758298080,175137,758473217,5,0,0,46080,19,1982245492
15321,758332840,116459,758449299,9,0,0,30208,18,10552379599
15322,758344701,135114,758479815,6,0,0,19456,12,9760330659
15323,758348860,134402,758483262,4,0,0,11264,16,1795604468
15324,758453529,115902,758569431,7,0,0,18944,8,3500641600
15325,758488210,168060,758656270,9,0,0,44544,18,3923722494
15326,758494510,7706,758502216,7,0,1,8192,8,2604515904
15327,758500010,47288,758547298,4,0,0,1536,16,8761891999
15328,758553820,1042,758554862,9,0,1,1024,18,645663756
15329,758580640,11274,758591914,7,0,1,18432,8,4153056937
15330,758599059,84248,758683307,1,0,0,22016,6,1163082345
15331,758662060,92227,758754287,3,0,0,10752,2,6331474789
15332,758663040,110796,758773836,8,0,0,20992,12,10089928856
15333,758685961,81464,758767425,6,0,0,17920,12,9461409286
15334,758697931,134222,758832153,6,0,0,64000,12,1131160570
15335,758719630,5802,758725432,1,0,1,6144,6,3253911226
15336,758720669,6078,758726747,3,0,1,13312,2,7721020873
15337,758742800,6754,758749554,0,0,1,7168,11,9388719741
15338,758773790,129396,758903186,0,0,0,14848,11,8374562097
15339,758782380,87683,758870063,5,0,0,20480,19,3791654222
15340,758788420,121021,758909441,5,0,0,20480,19,8127613959
15341,758851410,72536,758923946,4,0,0,13824,16,1398690959
15342,758918419,5542,758923961,8,0,1,3072,12,6765831260
15343,758982870,88232,759071102,2,0,0,19968,4,10001485134
15344,758985620,161310,759146930,8,0,0,107520,12,8308000525
15345,758985830,102842,759088672,5,0,0,3072,19,6546403756
15346,759013410,11533,759024943,1,0,1,18944,6,6566958734
15347,759083669,97314,759180983,1,0,0,16384,6,1792031914
15348,759092470,194791,759287261,2,0,0,137216,4,8363178013
15349,759240550,99188,759339738,4,0,0,30720,16,7984738014
15350,759260650,30032,759290682,1,0,1,9728,6,693895471
15351,759265870,30877,759296747,7,0,1,15872,8,8525267484
15352,759272380,67997,759340377,5,0,0,2048,19,2571115846
15353,759345110,105092,759450202,4,0,0,45056,16,2354609212
15354,759378629,52988,759431617,7,0,0,5120,8,9825609176
15355,759402800,68144,759470944,3,0,0,6144,2,2235597147
15356,759487430,81440,759568870,0,0,0,12800,11,5105843463
15357,759670760,566,759671326,1,0,1,512,6,4956743198
15358,759730400,109304,759839704,9,0,0,58880,18,3873774126
15359,759768200,96980,759865180,4,0,0,18432,16,6564541625
15360,759807640,109304,759916944,0,0,0,58880,11,8898216494
15361,759816520,106902,759923422,8,0,0,16896,12,4473546437
15362,759973980,96872,760070852,5,0,0,28160,19,191893447
15363,760008340,144124,760152464,0,0,0,56832,11,8187188097
15364,760040200,4420,760044620,5,0,1,11776,19,7228765694
15365,760066560,141002,760207562,4,0,0,39936,16,6238208937
15366,760111530,50672,760162202,3,0,0,2560,2,2853132543
15367,760153160,566,760153726,7,0,1,512,8,9500228247
15368,760182650,106692,760289342,0,0,0,44544,11,7943270076
15369,760212500,57440,760269940,9,0,0,4608,18,2060714566
15370,760219131,85589,760304720,6,0,0,8192,12,5216604432
15371,760225779,139241,760365020,7,0,0,59904,8,8873942902
15372,760267649,107964,760375613,7,0,0,14336,8,8769234294
15373,760364380,1198,760365578,0,0,1,512,11,5276065108
15374,760404440,43904,760448344,5,0,0,512,19,3270147716
15375,760457510,1994,760459504,6,0,1,2048,12,8158064411
15376,760472061,52832,760524893,6,0,0,4608,12,2148067481
15377,760488480,101816,760590296,0,0,0,34304,11,8718754089
15378,760516180,126490,760642670,8,0,0,58880,12,3037372763
15379,760523480,196992,760720472,4,0,0,62976,16,2192917231
15380,760604500,92662,760697162,5,0,0,3584,19,9148050120
15381,760609920,120730,760730650,3,0,0,24576,2,441547736
15382,760647160,7706,760654866,4,0,1,8192,16,8294584115
15383,760653750,69397,760723147,5,0,0,8704,19,2435734192
15384,760714129,17522,760731651,2,0,1,1024,4,7630743137
15385,760821329,59132,760880461,7,0,0,5120,8,7059979177
15386,760833520,100568,760934088,3,0,0,30208,2,5725318514
15387,760894220,72970,760967190,9,0,0,6656,18,9143682692
15388,760922650,113672,761036322,9,0,0,73216,18,8454662798
15389,761003679,111159,761114838,1,0,0,31232,6,2772595915
15390,761080601,104312,761184913,6,0,0,42496,12,7738704783
15391,761133000,67592,761200592,0,0,0,7680,11,2719666220
15392,761173219,70818,761244037,1,0,0,5120,6,297137615
15393,761210060,3422,761213482,1,0,1,3584,6,9490800504
15394,761268929,68684,761337613,7,0,0,11264,8,1258699921
15395,761338040,73004,761411044,2,0,0,15360,4,8103732495
15396,761442840,106496,761549336,8,0,0,49664,12,6731989163
15397,761442900,106919,761549819,5,0,0,1536,19,2106299897
15398,761609689,57440,761667129,7,0,0,4608,8,978733353
15399,761623370,49448,761672818,2,0,0,3584,4,8398950009
15400,761664540,54056,761718596,0,0,0,3584,11,5944641871
15401,761691470,69752,761761222,3,0,0,9728,2,1883561949
15402,761701229,65199,761766428,7,0,0,2048,8,3599016313
15403,761715099,125756,761840855,7,0,0,29696,8,3355576726
15404,761726470,105322,761831792,2,0,0,45056,4,8806916666
15405,761744610,145030,761889640,3,0,0,36864,2,1851819416
15406,761747010,151069,761898079,2,0,0,27648,4,1837298206
15407,761753801,103185,761856986,6,0,0,5632,12,8804233029
15408,761950779,2946,761953725,3,0,1,3072,2,4798997121
15409,761965730,47288,762013018,3,0,0,1536,2,5569560706
15410,762013870,65900,762079770,8,0,0,7168,12,1761189897
15411,762055149,45596,762100745,7,0,0,1024,8,1678341927
15412,762094369,99944,762194313,7,0,0,28160,8,149128528
15413,762134769,50082,762184851,7,0,0,1024,8,4111678540
15414,762158970,67990,762226960,3,0,0,2048,2,6939810443
15415,762177980,100256,762278236,8,0,0,29184,12,3722888976
15416,762192390,2481,762194871,7,0,1,512,8,7465978029
15417,762227099,145758,762372857,7,0,0,16896,8,9208780230
15418,762230679,106045,762336724,1,0,0,7168,6,4120795488
15419,762254841,95024,762349865,6,0,0,27136,12,8248848068
15420,762365930,99632,762465562,2,0,0,27136,4,325705419
15421,762402200,6229,762408429,7,0,1,15360,8,7738529129
15422,762427111,120351,762547462,6,0,0,51712,12,9000392927
15423,762570510,80840,762651350,0,0,0,15872,11,3207720374
15424,762614120,115278,762729398,4,0,0,37888,16,2390194414
15425,762664029,1042,762665071,2,0,1,1024,4,7519703202
15426,762675819,107921,762783740,7,0,0,23552,8,1392287979
15427,762735620,238142,762973762,4,0,0,28160,16,1873299971
15428,762750070,4850,762754920,0,0,1,5120,11,7794666315
15429,762760770,107874,762868644,4,0,0,10240,16,5139948144
15430,762770509,4374,762774883,8,0,1,4608,12,8047840759
15431,762782299,91085,762873384,7,0,0,15360,8,7076616261
15432,762936200,101972,763038172,4,0,0,34816,16,1621301719
15433,763008510,108524,763117034,8,0,0,56320,12,6679464215
15434,763061290,12049,763073339,0,0,1,19968,11,7899167845
15435,763167329,5326,763172655,3,0,1,5632,2,1140682165
15436,763256140,13083,763269223,4,0,1,22016,16,5628332161
15437,763261330,107062,763368392,8,0,0,41472,12,1115532232
15438,763359379,20796,763380175,8,0,1,19456,12,5427689301
15439,763391730,73292,763465022,3,0,0,11264,2,3910200781
15440,763399280,6754,763406034,9,0,1,7168,18,4000368425
15441,763411260,62984,763474244,0,0,0,7680,11,7126874010
15442,763429350,110417,763539767,2,0,0,24064,4,5531792595
15443,763457150,193680,763650830,2,0,0,34304,4,1484507437
15444,763499520,99944,763599464,2,0,0,28160,4,9810880522
15445,763592461,145279,763737740,6,0,0,86528,12,9784939655
15446,763655519,155745,763811264,7,0,0,28160,8,2354194266
15447,763739690,4937,763744627,7,0,1,12800,8,579819852
15448,763848810,98540,763947350,8,0,0,23552,12,2564541849
15449,763872550,113638,763986188,5,0,0,1024,19,4881280557
15450,763891260,155811,764047071,8,0,0,27136,12,1788154350
15451,763914480,103064,764017544,4,0,0,38400,16,9303328555
15452,763924530,3422,763927952,1,0,1,3584,6,9968122890
15453,763946581,132235,764078816,6,0,0,20480,12,9641330509
15454,763950961,140983,764091944,6,0,0,3072,12,6712541050
15455,763984640,148273,764132913,9,0,0,80896,18,1992083084
15456,763989171,144693,764133864,6,0,0,3072,12,8795981223
15457,764007450,13214,764020664,5,0,1,9216,19,9243427633
15458,764066550,1042,764067592,0,0,1,1024,11,2201736691
15459,764070160,70883,764141043,4,0,0,5632,16,7294161401
15460,764105120,69284,764174404,4,0,0,8192,16,2929618215
15461,764126251,129315,764255566,6,0,0,46592,12,6799127275
15462,764263570,103064,764366634,0,0,0,38400,11,8298906360
15463,764283490,87379,764370869,3,0,0,13824,2,9747420219
15464,764334969,119313,764454282,7,0,0,21504,8,4155427374
15465,764359730,130060,764489790,2,0,0,27136,4,2905813785
15466,764412510,2946,764415456,0,0,1,3072,11,8160875846
15467,764452499,104839,764557338,1,0,0,38400,6,6409557874
15468,764571310,139760,764711070,4,0,0,133632,16,2000936212
15469,764596050,11016,764607066,0,0,1,17920,11,6058006276
15470,764614359,171816,764786175,7,0,0,18944,8,2564996603
15471,764618079,292638,764910717,7,0,0,56320,8,8986414667
15472,764624199,4937,764629136,3,0,1,12800,2,7097002947
15473,764693640,147147,764840787,8,0,0,54784,12,2723376962
15474,764726910,134163,764861073,4,0,0,31744,16,8210326753
15475,764737130,153422,764890552,5,0,0,10240,19,3597255191
15476,764808540,566,764809106,0,0,1,512,11,3944540940
15477,764819471,119830,764939301,6,0,0,11776,12,4959086668
15478,764822440,97809,764920249,5,0,0,3584,19,6626987020
15479,764848870,70272,764919142,4,0,0,7168,16,1582887346
15480,764850340,193636,765043976,2,0,0,69632,4,9011767778
15481,764948130,5712,764953842,7,0,1,14336,8,7612664041
15482,765025909,92599,765118508,7,0,0,15360,8,6907855857
15483,765038010,83789,765121799,9,0,0,10752,18,7878472574
15484,765121801,110935,765232736,6,0,0,22016,12,5071189792
15485,765189091,122252,765311343,6,0,0,101376,12,7171615330
15486,765240050,156205,765396255,9,0,0,80384,18,7508632967
15487,765296310,134103,765430413,4,0,0,19968,16,2425786401
15488,765345010,110165,765455175,3,0,0,19456,2,6260854350
15489,765360610,114785,765475395,3,0,0,40448,2,7500963751
15490,765404570,87896,765492466,9,0,0,13824,18,4898514819
15491,765428889,5953,765434842,3,0,1,11776,2,8153686935
15492,765430030,98885,765528915,4,0,0,7168,16,3959448143
15493,765569820,94400,765664220,0,0,0,25088,11,6474414528
15494,765589200,102464,765691664,8,0,0,14336,12,5344482785
15495,765595960,219382,765815342,5,0,0,36352,19,10726606146
15496,765611250,3422,765614672,4,0,1,3584,16,3138918695
15497,765618209,1518,765619727,3,0,1,1536,2,9279810623
15498,765641400,1518,765642918,9,0,1,1536,18,2410030569
15499,765642569,125421,765767990,1,0,0,36864,6,220052699
15500,765648719,143229,765791948,7,0,0,28672,8,7511557712
15501,765741799,76054,765817853,7,0,0,8192,8,4603119263
15502,765758581,135127,765893708,6,0,0,62976,12,2758139096
15503,765800220,17648,765817868,9,0,1,17920,18,7019368849
15504,765837380,56655,765894035,9,0,0,1024,18,7053443960
15505,765921130,87764,766008894,4,0,0,18432,16,6782309219
15506,765962029,97448,766059477,1,0,0,19968,6,1834427360
15507,765972129,57440,766029569,7,0,0,4608,8,4299477834
15508,765984219,15837,766000056,2,0,1,30720,4,7754663291
15509,766079080,98696,766177776,2,0,0,24064,4,2497888315
15510,766084009,194055,766278064,7,0,0,47616,8,7901403500
15511,766108601,230984,766339585,6,0,0,1024,12,134069932
15512,766115070,136668,766251738,2,0,0,33792,4,30598427
15513,766123040,103844,766226884,9,0,0,40960,18,4318842266
15514,766174730,164528,766339258,4,0,0,20480,16,8600412570
15515,766447720,83468,766531188,9,0,0,19456,18,764396649
15516,766537120,121004,766658124,2,0,0,97280,4,10556495858
15517,766563600,97038,766660638,2,0,0,3584,4,5492635470
15518,766631830,115922,766747752,2,0,0,24576,4,5951413640
15519,766714310,33457,766747767,4,0,1,52224,16,1530705812
15520,766768150,202417,766970567,0,0,0,9728,11,8439495069
15521,766778539,261304,767039843,1,0,0,28160,6,1886599130
15522,766784050,240199,767024249,3,0,0,18432,2,4782805390
15523,766793489,81856,766875345,1,0,0,6656,6,8056681203
15524,766797570,193189,766990759,8,0,0,2560,12,5384674050
15525,766807910,81128,766889038,3,0,0,11776,2,10041994111
15526,766812580,80877,766893457,3,0,0,3072,2,3460542444
15527,766816010,111764,766927774,2,0,0,17920,4,9504013425
15528,766849001,70006,766919007,6,0,0,7680,12,1545778438
15529,766854910,135054,766989964,3,0,0,39424,2,1263468618
15530,766950659,116645,767067304,7,0,0,8704,8,56367507
15531,766969220,115384,767084604,4,0,0,12800,16,7843738450
15532,766999750,43904,767043654,2,0,0,512,4,7834779459
15533,767057769,3898,767061667,3,0,1,4096,2,6048713192
15534,767127910,7706,767135616,1,0,1,8192,6,4673690256
15535,767154030,145567,767299597,0,0,0,512,11,1508180901
15536,767163860,80840,767244700,2,0,0,15872,4,8717808467
15537,767193870,124183,767318053,8,0,0,5632,12,4333456033
15538,767239969,53703,767293672,1,0,0,2048,6,6129171437
15539,767293380,134092,767427472,4,0,1,217088,16,3896185187
15540,767311609,145317,767456926,7,0,0,1536,8,10698460436
15541,767323300,204070,767527370,5,0,0,10752,19,3734146233
15542,767500560,107135,767607695,8,0,0,11776,12,4702074442
15543,767555300,99801,767655101,5,0,0,25088,19,5402676054
15544,767557570,155575,767713145,5,0,0,54272,19,1971359812
15545,767638241,103688,767741929,6,0,0,40448,12,7142944198
15546,767641361,78608,767719969,6,0,0,8704,12,7787781805
15547,767689389,6754,767696143,2,0,1,7168,4,5157668335
15548,767728100,47288,767775388,3,0,0,1536,2,3106149467
15549,767753700,55748,767809448,2,0,0,4096,4,871240362
15550,767784300,104624,767888924,3,0,0,43520,2,9397147934
15551,767891259,566,767891825,8,0,1,512,12,4354738823
15552,767971299,111488,768082787,1,0,0,66048,6,1662438788
15553,768006950,114129,768121079,5,0,0,28160,19,1584442874
15554,768024889,106969,768131858,7,0,0,35328,8,9081279569
15555,768070650,125829,768196479,2,0,0,35328,4,7407527248
15556,768100530,149135,768249665,9,0,0,25600,18,1560171117
15557,768147480,52364,768199844,3,0,0,3072,2,9852835411
15558,768354060,72668,768426728,0,0,0,9216,11,2831829704
15559,768358240,87035,768445275,2,0,0,12800,4,6200793764
15560,768372520,68840,768441360,0,0,0,11776,11,9615184404
15561,768379469,132913,768512382,1,0,0,48640,6,7474456919
15562,768503130,77172,768580302,3,0,0,13824,2,2356144561
15563,768512999,60824,768573823,7,0,0,5632,8,7427671112
15564,768558270,113569,768671839,8,0,0,27648,12,9770832780
15565,768575019,5298,768580317,8,0,1,4608,12,7732993449
15566,768594480,16354,768610834,7,0,1,31744,8,8339579564
15567,768703139,56767,768759906,1,0,0,2048,6,6049522748
15568,768716261,43904,768760165,6,0,0,512,12,7900611384
15569,768743350,4162,768747512,9,0,1,11264,18,1533878985
15570,768778980,2470,768781450,7,0,1,2560,8,10171927641
15571,768814050,82220,768896270,2,0,0,15360,4,4340108119
15572,768857179,6488,768863667,3,0,1,15872,2,1784023843
15573,768861140,2873,768864013,0,0,1,512,11,2851470360
15574,768861800,117861,768979661,2,0,0,86016,4,2650944935
15575,768899710,566,768900276,6,0,1,512,12,6180651544
15576,768963300,164898,769128198,8,0,0,126464,12,6532781673
15577,769017000,228768,769245768,0,0,0,120320,11,4739749916
15578,769098840,29933,769128773,6,0,1,512,12,4781746047
15579,769120710,11075,769131785,9,0,1,3584,18,7614593283
15580,769256490,121948,769378438,8,0,0,70144,12,6634013185
15581,769285260,100681,769385941,9,0,0,24576,18,6729576839
15582,769293450,92974,769386424,4,0,0,1536,16,5335093853
15583,769407590,91328,769498918,0,0,0,25088,11,4062616515
15584,769421030,157304,769578334,0,0,0,124416,11,3251129168
15585,769424359,158210,769582569,1,0,0,13824,6,9319466152
15586,769497799,4057,769501856,3,0,1,3072,2,511519111
15587,769563760,185747,769749507,0,0,0,93696,11,1939827930
15588,769652420,23120,769675540,4,0,1,41472,16,3100470479
15589,769835070,1994,769837064,6,0,1,2048,12,6095237568
15590,769870341,103532,769973873,6,0,0,39936,12,9415038512
15591,769998480,1042,769999522,7,0,1,1024,8,7093299656
15592,770141570,47288,770188858,5,0,0,1536,19,2291984128
15593,770288669,77900,770366569,7,0,0,11264,8,5489138685
15594,770320650,138625,770459275,2,0,0,87552,4,9935501950
15595,770400630,5196,770405826,9,0,1,13312,18,4238366628
15596,770490039,52364,770542403,7,0,0,3072,8,8104538002
15597,770564690,106184,770670874,5,0,0,48640,19,2842511537
15598,770654750,16139,770670889,0,0,1,5632,11,4894493492
15599,770686610,5802,770692412,9,0,1,6144,18,9238964143
15600,770687830,110294,770798124,4,0,0,23552,16,1525041671
15601,770767720,115412,770883132,8,0,0,23040,12,6471828626
15602,770910011,56060,770966071,6,0,0,5120,12,9303101402
15603,770989490,1518,770991008,0,0,1,1536,11,3159914193
15604,771030390,165387,771195777,4,0,1,271872,16,5874875280
15605,771050480,199136,771249616,5,0,0,15360,19,7089664131
15606,771105121,351037,771456158,6,0,0,122368,12,7862631665
15607,771181780,190683,771372463,5,0,0,33280,19,10037677638
15608,771294950,123909,771418859,3,0,0,22016,2,6191968247
15609,771476800,1994,771478794,7,0,1,2048,8,6104982676
15610,771479759,106618,771586377,7,0,0,36352,8,8575239803
15611,771489390,5802,771495192,6,0,1,6144,12,7563435462
15612,771524869,151424,771676293,7,0,0,1536,8,3812458123
15613,771525181,142670,771667851,6,0,0,75776,12,7763446339
15614,771542610,7230,771549840,9,0,1,7680,18,131589430
15615,771551260,170741,771722001,3,0,0,20480,2,2193570204
15616,771605839,236955,771842794,7,0,0,8192,8,10479248001
15617,771622480,59132,771681612,9,0,0,5120,18,4127592042
15618,771628040,76329,771704369,4,0,1,128512,16,6235423581
15619,771667760,163880,771831640,5,0,0,93696,19,165785340
15620,771693550,143412,771836962,5,0,0,9216,19,3405437752
15621,771716180,185772,771901952,5,0,0,4096,19,8056320786
15622,771743340,176650,771919990,3,0,0,12288,2,5890185876
15623,771758250,118054,771876304,4,0,0,6144,16,5313018288
15624,771841150,9342,771850492,7,0,1,8192,8,10358541533
15625,771990090,47756,772037846,0,0,0,3072,11,2123893628
15626,772019550,98720,772118270,0,0,0,29184,11,4415911140
15627,772020260,108321,772128581,0,0,0,33792,11,1006837142
15628,772033270,127348,772160618,0,0,0,4608,11,1476136683
15629,772067210,315134,772382344,4,0,0,52224,16,8371878710
15630,772079140,173826,772252966,4,0,0,16896,16,964649828
15631,772090980,126987,772217967,4,0,0,55296,16,9959875340
15632,772097260,103844,772201104,9,0,0,40960,18,9849505935
15633,772171420,268734,772440154,2,0,0,24064,4,7885227615
15634,772175380,1994,772177374,6,0,1,2048,12,4015623744
15635,772207181,136363,772343544,6,0,0,37376,12,2635181916
15636,772207999,14359,772222358,3,0,1,4608,2,6712225578
15637,772262679,4374,772267053,8,0,1,4608,12,8402885006
15638,772329870,13697,772343567,7,0,1,19456,8,9505812925
15639,772338390,72581,772410971,2,0,0,6144,4,7854261295
15640,772422671,98696,772521367,6,0,0,24064,12,3234607474
15641,772764229,67148,772831377,7,0,0,11264,8,1240114002
15642,772775290,107744,772883034,3,0,0,53760,2,5177040773
15643,772786400,104983,772891383,9,0,0,25600,18,6632373767
15644,772828150,6641,772834791,9,0,1,3584,18,8472232562
15645,772931260,60824,772992084,2,0,0,5632,4,7634943945
15646,772955599,6754,772962353,2,0,1,7168,4,1867718231
15647,773021720,11274,773032994,9,0,1,18432,18,1379958400
15648,773118130,72668,773190798,3,0,0,9216,2,3268786573
15649,773127740,98072,773225812,2,0,0,22016,4,6185251253
15650,773190439,93995,773284434,7,0,0,27648,8,9550832160
15651,773213750,1042,773214792,7,0,1,1024,8,7255006420
15652,773314179,1042,773315221,2,0,1,1024,4,6497587756
15653,773322680,10241,773332921,1,0,1,16384,6,5684956498
15654,773349879,119116,773468995,1,0,0,20480,6,4779944644
15655,773405850,110708,773516558,9,0,0,63488,18,8428275011
15656,773425930,6754,773432684,6,0,1,7168,12,9253927795
15657,773472219,1042,773473261,3,0,1,1024,2,806683322
15658,773475460,106834,773582294,9,0,0,14848,18,4857484442
15659,773528449,14287,773542736,3,0,1,27648,2,10357710701
15660,773544719,114123,773658842,1,0,0,11776,6,7282614277
15661,773572050,74360,773646410,9,0,0,9728,18,7225652518
15662,773687560,86204,773773764,0,0,0,13312,11,745293697
15663,773782730,5454,773788184,7,0,1,13824,8,8399841858
15664,773790361,140550,773930911,6,0,0,35328,12,23772827
15665,773917571,70984,773988555,6,0,0,7680,12,723369385
15666,773935960,5802,773941762,9,0,1,6144,18,286197950
15667,774048600,70220,774118820,0,0,0,11264,11,2129012975
15668,774173940,7230,774181170,0,0,1,7680,11,5129388524
15669,774200479,111332,774311811,1,0,0,65536,6,10241298179
15670,774254600,3387,774257987,1,0,1,9728,6,4409783500
15671,774297189,66978,774364167,7,0,0,3072,8,9402875791
15672,774344110,14287,774358397,5,0,1,27648,19,6289588578
15673,774346630,216879,774563509,3,0,0,1536,2,3380336524
15674,774377740,62516,774440256,9,0,0,6144,18,8098843942
15675,774483800,13770,774497570,7,0,1,26624,8,5422507281
15676,774493340,124697,774618037,0,0,0,34304,11,7551019705
15677,774502979,11533,774514512,8,0,1,18944,12,3054062854
15678,774523740,214657,774738397,8,0,0,152064,12,10047656394
15679,774580430,165314,774745744,5,0,0,24064,19,428022344
15680,774690680,56335,774747015,5,0,0,4096,19,6136556645
15681,774702960,143656,774846616,8,0,0,31232,12,5584301927
15682,774825240,72068,774897308,3,0,0,12288,2,4352450967
15683,774906970,89792,774996762,4,0,0,25088,16,4786447559
15684,774928610,76052,775004662,9,0,0,10240,18,2537706501
15685,774929290,133370,775062660,8,0,0,18432,12,10586872277
15686,774972759,196846,775169605,7,0,0,36864,8,8636606408
15687,774983380,566,774983946,5,0,1,512,19,4842731023
15688,775107880,16613,775124493,7,0,1,32256,8,8605651397
15689,775212570,124026,775336596,5,0,0,22528,19,10015715074
15690,775237379,52364,775289743,7,0,0,3072,8,2873405586
15691,775255729,101816,775357545,7,0,0,34304,8,8086022073
15692,775265590,102689,775368279,5,0,0,23040,19,7893329545
15693,775296769,71681,775368450,1,0,0,512,6,4415947951
15694,775314770,84781,775399551,8,0,0,9728,12,3927833068
15695,775354750,80603,775435353,8,0,0,5120,12,519573747
15696,775387640,91711,775479351,8,0,0,12288,12,8861002049
15697,775422020,15321,775437341,4,0,1,29696,16,7845497413
15698,775437079,60824,775497903,1,0,0,5632,6,5632591070
15699,775451650,73292,775524942,9,0,0,11264,18,7039572889
15700,775599980,98696,775698676,4,0,0,24064,16,6223834256
15701,775627950,80996,775708946,3,0,0,16384,2,5055530184
15702,775683570,109222,775792792,4,0,0,33280,16,8116371492
15703,775729349,137429,775866778,1,0,0,48128,6,7670353923
15704,775822441,105092,775927533,6,0,0,45056,12,1649285348
15705,775842970,111617,775954587,5,0,0,41984,19,9983319443
15706,775870700,1042,775871742,0,0,1,1024,11,9026128225
15707,776024790,75764,776100554,9,0,0,14336,18,1571248941
15708,776027860,60824,776088684,0,0,0,5632,11,9746435590
15709,776199200,100256,776299456,8,0,0,29184,12,9650405799
15710,776283320,72668,776355988,5,0,0,9216,19,7138376995
15711,776470630,5196,776475826,7,0,1,13312,8,7732940374
15712,776474080,7143,776481223,6,0,1,15872,12,1100505281
15713,776504949,47288,776552237,1,0,0,1536,6,9912199667
15714,776514250,61292,776575542,5,0,0,7168,19,5425801011
15715,776518741,101637,776620378,6,0,0,8704,12,1507233800
15716,776572520,4374,776576894,6,0,1,4608,12,2349802587
15717,776626489,54056,776680545,7,0,0,3584,8,1504712585
15718,776697229,3645,776700874,3,0,1,10240,2,6891904211
15719,776725750,57074,776782824,8,0,0,512,12,5873743677
15720,776738920,73136,776812056,3,0,0,10752,2,533266813
15721,776755830,62088,776817918,0,0,0,8704,11,8072358163
15722,776824150,102440,776926590,4,0,0,36352,16,6694672686
15723,776830431,140943,776971374,6,0,0,22016,12,4004415028
15724,776930030,83936,777013966,0,0,0,20992,11,7224862726
15725,776932600,96404,777029004,9,0,0,26624,18,7871624295
15726,776952700,167294,777119994,3,0,0,97280,2,2495962631
15727,776972830,3387,776976217,5,0,1,9728,19,7449213524
15728,777021979,98654,777120633,7,0,0,2048,8,10664775834
15729,777085120,110864,777195984,8,0,0,64000,12,7458346980
15730,777183550,70490,777254040,5,0,0,6656,19,8073624083
15731,777294760,78236,777372996,9,0,0,17408,18,5415664650
15732,777390530,76052,777466582,0,0,0,10240,11,10486247649
15733,777398489,3645,777402134,3,0,1,10240,2,9008786371
15734,777493510,87764,777581274,3,0,0,18432,2,2934350565
15735,777903500,12308,777915808,5,0,1,20480,19,643493459
15736,777923979,77744,778001723,1,0,0,10752,6,4416306560
15737,778106499,5326,778111825,2,0,1,5632,4,4778151370
15738,778189720,1042,778190762,6,0,1,1024,12,83327377
15739,778269329,1994,778271323,8,0,1,2048,12,1688408751
15740,778396749,97319,778494068,7,0,0,19456,8,4742304375
15741,778576211,105716,778681927,6,0,0,47104,12,5490494013
15742,778612830,78439,778691269,8,0,0,1024,12,1978743104
15743,778640009,81254,778721263,1,0,0,2560,6,8426576525
15744,778684729,43904,778728633,7,0,0,512,8,7550120488
15745,778703220,64208,778767428,3,0,0,6656,2,5341672959
15746,778954980,25446,778980426,4,0,1,46080,16,7461645417
15747,779011840,67111,779078951,4,0,0,8192,16,3730700439
15748,779206050,4850,779210900,6,0,1,5120,12,9468176950
15749,779246730,4850,779251580,6,0,1,5120,12,10442947134
15750,779396049,14117,779410166,3,0,1,24064,2,1272234282
15751,779507999,81308,779589307,1,0,0,17408,6,7612084369
15752,779512640,144196,779656836,8,0,0,18944,12,8402704786
15753,779544709,106340,779651049,1,0,0,49152,6,5039228682
15754,779570341,113234,779683575,6,0,0,33792,12,8333554385
15755,779572791,129102,779701893,6,0,0,2048,12,8115007456
15756,779820920,136586,779957506,5,0,0,22016,19,10088282127
15757,779823950,52832,779876782,4,0,0,4608,16,9009754262
15758,779837930,68996,779906926,5,0,0,12288,19,10018923026
15759,779934941,100880,780035821,6,0,0,31232,12,8368129711
15760,779991090,62293,780053383,8,0,0,2048,12,6702929090
15761,779992260,97292,780089552,3,0,0,19456,2,5527013468
15762,780008680,27164,780035844,9,0,1,35840,18,1614486595
15763,780027580,14721,780042301,9,0,1,15872,18,9651132472
15764,780098841,136787,780235628,6,0,0,95744,12,5184348940
15765,780098910,107531,780206441,3,0,0,23040,2,4473966264
15766,780266550,7706,780274256,1,0,1,8192,6,9064276713
15767,780284690,10499,780295189,0,0,1,16896,11,955765732
15768,780361740,78680,780440420,3,0,0,13824,2,1461277835
15769,780423650,3898,780427548,5,0,1,4096,19,1726764118
15770,780459950,7230,780467180,0,0,1,7680,11,2746179497
15771,780713019,73316,780786335,7,0,0,16384,8,7390212142
15772,780741859,76870,780818729,7,0,0,5632,8,9686958234
15773,780895020,6229,780901249,7,0,1,15360,8,9292832549
15774,781007879,108212,781116091,1,0,0,30208,6,5649418628
15775,781008620,98252,781106872,4,0,0,27648,16,8958674405
15776,781034450,124760,781159210,5,0,0,11776,19,6609624449
15777,781165460,110708,781276168,4,0,0,63488,16,6574790575
15778,781207139,4374,781211513,2,0,1,4608,4,8978458469
15779,781250270,102752,781353022,8,0,0,37376,12,7869066002
15780,781287450,2470,781289920,9,0,1,2560,18,5083616091
15781,781365851,69152,781435003,6,0,0,12800,12,10027071505
15782,781403379,5326,781408705,3,0,1,5632,2,5316047036
15783,781438689,138981,781577670,1,0,0,1536,6,4113190925
15784,781498849,128489,781627338,1,0,0,13312,6,622238405
15785,781573010,2470,781575480,1,0,1,2560,6,4172643701
15786,781610990,50672,781661662,4,0,0,2560,16,6902899143
15787,781633149,61891,781695040,7,0,0,5120,8,9736726484
15788,781637720,110084,781747804,0,0,0,61440,11,8184997885
15789,781639570,115269,781754839,3,0,0,23040,2,6163039678
15790,781662180,150226,781812406,5,0,0,40448,19,3964956435
15791,781711340,152432,781863772,4,0,0,46592,16,3172303575
15792,781746999,86929,781833928,7,0,0,4096,8,5580316500
15793,781856400,13642,781870042,1,0,1,6656,6,4122090166
15794,781985219,7706,781992925,2,0,1,8192,4,10721273046
15795,782026579,15837,782042416,3,0,1,30720,2,2548972410
15796,782061520,2946,782064466,5,0,1,3072,19,6933507546
15797,782143570,86852,782230422,0,0,0,20480,11,15032199
15798,782291300,52832,782344132,5,0,0,4608,19,6073365463
15799,782336820,62984,782399804,0,0,0,7680,11,7166000593
15800,782338110,65900,782404010,3,0,0,7168,2,912117135
15801,782378810,2470,782381280,1,0,1,2560,6,3957167240
15802,782416889,2470,782419359,2,0,1,2560,4,2580753119
15803,782419259,3898,782423157,2,0,1,4096,4,1768379873
15804,782523599,73604,782597203,1,0,0,12288,6,2841750701
15805,782642529,64076,782706605,7,0,0,11264,8,6743072947
15806,782729290,67592,782796882,0,0,0,7680,11,7194633867
15807,782787229,90104,782877333,7,0,0,26112,8,4104150660
15808,783017850,1994,783019844,5,0,1,2048,19,6848649459
15809,783263620,116168,783379788,4,0,0,81408,16,8617745553
15810,783317260,91724,783408984,8,0,0,3584,12,8366714676
15811,783328070,358537,783686607,4,0,1,584704,16,7407877871
15812,783332450,448603,783781053,5,0,0,109056,19,7851139895
15813,783389640,453987,783843627,3,0,0,81920,2,10133661178
15814,783404549,282826,783687375,2,0,1,11776,4,5745844403
15815,783424950,275054,783700004,4,0,0,1024,16,6676626537
15816,783480090,223043,783703133,4,0,1,58880,16,6775147115
15817,783511740,386816,783898556,8,0,0,70656,12,9970009215
15818,783521600,273174,783794774,5,0,0,1024,19,6617437971
15819,783552131,356736,783908867,6,0,0,33792,12,3223991817
15820,783653579,51180,783704759,2,0,1,2560,4,10120970346
15821,783666040,259090,783925130,2,0,0,12800,4,7215268626
15822,783673800,274478,783948278,4,0,0,20992,16,2420581286
15823,783726970,212310,783939280,4,0,0,14848,16,83565442
15824,783751840,50863,783802703,4,0,1,35328,16,8858524666
15825,783797029,122305,783919334,1,0,0,6656,6,4343213768
15826,783844330,253400,784097730,8,0,0,52736,12,116970791
15827,783850470,181961,784032431,3,0,0,10752,2,1954007149
15828,783870770,4850,783875620,5,0,1,5120,19,7432811472
15829,783909659,2946,783912605,2,0,1,3072,4,9414898350
15830,783975309,187731,784163040,7,0,0,18944,8,4368276342
15831,783994569,317773,784312342,1,0,0,97792,6,7953435322
15832,784084330,291311,784375641,4,0,0,80896,16,3974629555
15833,784115539,166992,784282531,1,0,0,77824,6,1973841368
15834,784120270,198682,784318952,3,0,0,10240,2,9320993085
15835,784190430,121927,784312357,4,0,1,149504,16,4192932282
15836,784246629,167754,784414383,7,0,0,15360,8,7209482244
15837,784258180,156530,784414710,3,0,0,1024,2,898368514
15838,784312050,6917,784318967,9,0,1,14336,18,1499109686
15839,784402581,135570,784538151,6,0,0,37888,12,8928682864
15840,784412950,142064,784555014,5,0,0,55296,19,8025561339
15841,784540810,17142,784557952,0,0,1,3072,11,1484013721
15842,784640980,97784,784738764,5,0,0,26112,19,9223068253
15843,784705560,1994,784707554,1,0,1,2048,6,6106478199
15844,784762290,55748,784818038,8,0,0,4096,12,8466926014
15845,784769410,100256,784869666,3,0,0,29184,2,5610389118
15846,784846259,50672,784896931,1,0,0,2560,6,7766629880
15847,784888639,59288,784947927,1,0,0,5632,6,5986361460
15848,784936269,11673,784947942,3,0,1,16896,2,5146520143
15849,784977799,96980,785074779,1,0,0,18432,6,4106083837
15850,785005181,98852,785104033,6,0,0,24576,12,9431338162
15851,785091970,566,785092536,5,0,1,512,19,9799030867
15852,785136930,13083,785150013,5,0,1,22016,19,10395692215
15853,785186040,100412,785286452,3,0,0,29696,2,2657069631
15854,785284570,102910,785387480,0,0,0,31744,11,7191370862
15855,785295550,159802,785455352,0,0,0,93184,11,8471087689
15856,785296910,216277,785513187,0,0,0,11264,11,9761956499
15857,785344370,111309,785455679,0,0,0,1024,11,9820386541
15858,785375909,1518,785377427,3,0,1,1536,2,5740509571
15859,785385321,170682,785556003,6,0,0,35840,12,131341365
15860,785491220,4162,785495382,5,0,1,11264,19,265958289
15861,785551090,58961,785610051,3,0,0,3584,2,4742421495
15862,785591500,80216,785671716,0,0,0,13824,11,2858217370
15863,785637951,112415,785750366,6,0,0,53760,12,4512409660
15864,785639709,11274,785650983,3,0,1,18432,2,7506772501
15865,785700201,103376,785803577,6,0,0,39424,12,2021125551
15866,785855611,112736,785968347,6,0,0,70144,12,6244827995
15867,785868560,103862,785972422,4,0,1,172032,16,1415384666
15868,785922480,152344,786074824,3,0,0,17920,2,9303325581
15869,785963821,139239,786103060,6,0,0,45056,12,5924817861
15870,786151100,85754,786236854,3,0,0,16384,2,1520660711
15871,786171560,78992,786250552,0,0,0,14848,11,10201253299
15872,786236150,63524,786299674,5,0,0,7168,19,8035765008
15873,786263790,13253,786277043,6,0,1,25600,12,3204432555
15874,786274120,60600,786334720,9,0,0,5120,18,9656456283
15875,786274380,11533,786285913,7,0,1,18944,8,496322004
15876,786312359,85932,786398291,7,0,0,10752,8,1413049881
15877,786331299,98852,786430151,7,0,0,24576,8,2516305015
15878,786366219,65983,786432202,1,0,0,6656,6,1097148332
15879,786402100,59132,786461232,3,0,0,5120,2,6020525551
15880,786423690,70685,786494375,4,0,0,11776,16,8569330288
15881,786464060,102596,786566656,4,0,0,36864,16,6077294106
15882,786485269,9121,786494390,3,0,1,7168,2,6858442629
15883,786532210,198534,786730744,4,0,0,148480,16,6942140435
15884,786550790,69308,786620098,8,0,0,13312,12,3509635664
15885,786712090,89622,786801712,0,0,0,8704,11,10403708578
15886,786761680,95912,786857592,9,0,0,19968,18,6108553182
15887,786826799,57440,786884239,1,0,0,4608,6,9616769839
15888,786944240,103064,787047304,8,0,0,38400,12,365637224
15889,787012269,2946,787015215,8,0,1,3072,12,3326397113
15890,787087540,81128,787168668,4,0,0,11776,16,9269746400
15891,787100469,3645,787104114,2,0,1,10240,4,5710241894
15892,787148240,76052,787224292,4,0,0,10240,16,8698068866
15893,787197850,93776,787291626,5,0,0,23040,19,8365097932
15894,787312840,1518,787314358,7,0,1,1536,8,7951129361
15895,787327460,79928,787407388,0,0,0,17920,11,6190738600
15896,787444770,74984,787519754,4,0,0,11776,16,4244458170
15897,787535319,95498,787630817,7,0,0,22528,8,5449021838
15898,787557041,110880,787667921,6,0,0,8192,12,7392179885
15899,787742790,47756,787790546,3,0,0,3072,2,4599904795
15900,787830560,67592,787898152,3,0,0,7680,2,1273304903
15901,787928209,89480,788017689,1,0,0,24064,6,2993613509
15902,787952529,47288,787999817,7,0,0,1536,8,2394424761
15903,788019669,13600,788033269,2,0,1,23040,4,5115149554
15904,788024490,10085,788034575,5,0,1,2048,19,85269413
15905,788156959,1994,788158953,8,0,1,2048,12,2571655258
15906,788210339,124170,788334509,1,0,0,92672,6,10459427483
15907,788214909,57752,788272661,1,0,0,5632,6,5369100405
15908,788259309,75683,788334992,1,0,0,1536,6,678615916
15909,788294970,94465,788389435,3,0,0,23552,2,166138023
15910,788399900,3422,788403322,9,0,1,3584,18,2472271638
15911,788428981,112112,788541093,6,0,0,68096,12,1700626490
15912,788447060,132733,788579793,0,0,0,33792,11,3398853742
15913,788461239,187758,788648997,7,0,0,36864,8,9624615641
15914,788566689,13119,788579808,8,0,1,21504,12,7386429763
15915,788610150,7230,788617380,1,0,1,7680,6,2183989823
15916,788620719,121146,788741865,1,0,0,41984,6,1588546287
15917,788750320,72848,788823168,3,0,0,14848,2,9821327755
15918,788773830,71444,788845274,3,0,0,10240,2,8574322777
15919,788964050,104312,789068362,8,0,0,42496,12,914186432
15920,789102030,103688,789205718,3,0,0,40448,2,1691480305
15921,789119991,64208,789184199,6,0,0,6656,12,9742150272
15922,789272080,3898,789275978,9,0,1,4096,18,2710478875
15923,789297670,178689,789476359,5,0,0,10752,19,7953890442
15924,789312979,188454,789501433,1,0,0,11264,6,1343806027
15925,789338849,68216,789407065,1,0,0,9728,6,8152791341
15926,789364511,48980,789413491,6,0,0,2048,12,9239059875
15927,789388330,103179,789491509,8,0,0,25088,12,5039062193
15928,789445920,116923,789562843,0,0,0,31232,11,706299323
15929,789451270,1994,789453264,9,0,1,2048,18,2577294051
15930,789474340,4481,789478821,7,0,1,2560,8,957478167
15931,789484721,108752,789593473,6,0,0,34816,12,536463345
15932,789514960,92216,789607176,3,0,0,17920,2,1752371779
15933,789543959,5326,789549285,2,0,1,5632,4,7543262558
15934,789640410,6754,789647164,5,0,1,7168,19,9816167611
15935,789715039,107432,789822471,7,0,0,52736,8,5204281490
15936,789875049,101816,789976865,1,0,0,34304,6,5583267720
15937,789914480,107280,790021760,3,0,0,52224,2,10271570134
15938,789932040,73793,790005833,0,0,0,6144,11,2650220218
15939,790137289,79304,790216593,7,0,0,15872,8,8609063271
15940,790185620,105560,790291180,8,0,0,46592,12,5888571237
15941,790310580,48980,790359560,5,0,0,2048,19,10105692558
15942,790393669,77744,790471413,1,0,0,10752,6,8000815460
15943,790422130,1042,790423172,9,0,1,1024,18,3667917001
15944,790493100,84980,790578080,5,0,0,14336,19,4032815909
15945,790501919,566,790502485,3,0,1,512,2,2006459292
15946,790554190,122408,790676598,5,0,0,101888,19,29416506
15947,790602550,4937,790607487,6,0,1,12800,12,7478391878
15948,790650200,26956,790677156,7,0,1,512,8,1479970354
15949,790832409,95912,790928321,1,0,0,19968,6,7080371390
15950,790840369,93271,790933640,1,0,0,17408,6,7839097072
15951,790847880,55748,790903628,3,0,0,4096,2,10124539870
15952,790863200,21141,790884341,9,0,1,34304,18,7591000147
15953,790891170,1518,790892688,0,0,1,1536,11,8893983049
15954,790909780,2870,790912650,4,0,1,8704,16,3232915451
15955,791190610,104156,791294766,8,0,0,41984,12,7210377206
15956,791214729,5712,791220441,2,0,1,14336,4,3581344126
15957,791237310,89052,791326362,0,0,0,17408,11,8888273477
15958,791295951,109827,791405778,6,0,0,13312,12,7952955092
15959,791302231,99476,791401707,6,0,0,26624,12,799011569
15960,791371259,103220,791474479,7,0,0,38912,8,1104251293
15961,791480060,105872,791585932,5,0,0,47616,19,4440708907
15962,791522060,104624,791626684,5,0,0,43520,19,8014209972
15963,791540740,88068,791628808,8,0,0,4608,12,9155963713
15964,791563269,77077,791640346,7,0,0,1536,8,4579836569
15965,791666940,12049,791678989,5,0,1,19968,19,2322949307
15966,791799239,98540,791897779,1,0,0,23552,6,964938528
15967,791838870,107123,791945993,5,0,0,13312,19,10202447215
15968,791859660,5712,791865372,9,0,1,14336,18,7519246484
15969,791913810,13600,791927410,0,0,1,23040,11,574833033
15970,792013231,237326,792250557,6,0,0,40448,12,10584172214
15971,792072850,1042,792073892,6,0,1,1024,12,5314386139
15972,792144550,10241,792154791,5,0,1,16384,19,7015803797
15973,792150550,112502,792263052,4,0,0,40960,16,396223210
15974,792193920,230719,792424639,8,0,0,75776,12,5173276345
15975,792218540,114920,792333460,3,0,0,77312,2,9270760808
15976,792220500,5802,792226302,6,0,1,6144,12,6031432829
15977,792360419,125258,792485677,7,0,0,48128,8,4756346852
15978,792460251,147464,792607715,6,0,0,138752,12,5631944405
15979,792467530,141916,792609446,5,0,0,5632,19,4242412138
15980,792471629,18907,792490536,8,0,1,5120,12,8457719759
15981,792475650,154139,792629789,5,0,0,23552,19,1964518905
15982,792520851,91426,792612277,6,0,0,9216,12,1986714423
15983,792593019,25019,792618038,3,0,1,6144,2,5352326711
15984,792659601,103688,792763289,6,0,0,40448,12,7951785606
15985,792672189,5326,792677515,8,0,1,5632,12,5468037096
15986,792744770,4937,792749707,0,0,1,12800,11,4795347432
15987,792817260,98696,792915956,4,0,0,24064,16,4039076538
15988,792876740,52364,792929104,0,0,0,3072,11,10315941453
15989,792931920,3422,792935342,4,0,1,3584,16,5725537493
15990,793003000,45596,793048596,3,0,0,1024,2,9550854408
15991,793064750,45596,793110346,0,0,0,1024,11,6539022938
15992,793101061,102908,793203969,6,0,0,37888,12,9249001902
15993,793167050,136027,793303077,0,0,0,63488,11,1247171774
15994,793191450,12534,793203984,6,0,1,1024,12,5173183881
15995,793196269,9225,793205494,8,0,1,1536,12,1379783261
15996,793286560,101357,793387917,3,0,0,18944,2,5244336550
15997,793339190,127549,793466739,4,0,0,49664,16,57456263
15998,793346650,75983,793422633,0,0,0,4608,11,7663836701
15999,793430089,103064,793533153,7,0,0,38400,8,6697721152
16000,793566679,103376,793670055,7,0,0,39424,8,3226767444
16001,793613959,6754,793620713,8,0,1,7168,12,292388644
16002,793635820,4374,793640194,1,0,1,4608,6,8447459924
16003,793649780,98953,793748733,3,0,0,24576,2,4506400312
16004,793661580,222925,793884505,4,0,0,14848,16,5388125347
16005,793701309,178486,793879795,1,0,0,90112,6,1428542987
16006,793734710,14038,793748748,5,0,1,22528,19,985026434
16007,793769280,178938,793948218,3,0,0,28160,2,6106787984
16008,793788249,566,793788815,3,0,1,512,2,10049570493
16009,793818219,61747,793879966,1,0,0,512,6,3551239997
16010,793886319,65502,793951821,1,0,0,11776,6,7967806033
16011,793907860,7706,793915566,0,0,1,8192,11,3781805863
16012,794143451,59132,794202583,6,0,0,5120,12,2753219316
16013,794275159,103844,794379003,7,0,0,40960,8,9753966335
16014,794348529,114366,794462895,1,0,0,31744,6,7322159898
16015,794361740,4679,794366419,1,0,1,12288,6,2293527974
16016,794443649,3898,794447547,2,0,1,4096,4,3163856867
16017,794722809,99476,794822285,7,0,0,26624,8,6444336976
16018,794746170,105233,794851403,0,0,0,5120,11,4226241638
16019,794834800,102128,794936928,4,0,0,35328,16,6747693146
16020,794851520,90862,794942382,8,0,0,11776,12,10146412770
16021,794962720,100100,795062820,0,0,0,28672,11,3268068946
16022,794994449,53989,795048438,7,0,0,512,8,5910211597
16023,795061400,96856,795158256,3,0,0,18432,2,4119934879
16024,795110770,52364,795163134,3,0,0,3072,2,2852211792
16025,795234369,6754,795241123,8,0,1,7168,12,3742621849
16026,795266970,3128,795270098,4,0,1,9216,16,3591493164
16027,795288979,182156,795471135,1,0,0,87040,6,9962717497
16028,795321110,3898,795325008,6,0,1,4096,12,8604316895
16029,795324729,7230,795331959,8,0,1,7680,12,8161753881
16030,795344389,139508,795483897,1,0,0,16896,6,5043742517
16031,795356850,4679,795361529,6,0,1,12288,12,490267622
16032,795365430,566,795365996,5,0,1,512,19,1962467303
16033,795430710,54294,795485004,0,0,0,3584,11,2099177431
16034,795543539,118196,795661735,7,0,0,88064,8,5155465499
16035,795581780,13253,795595033,4,0,1,25600,16,1877730154
16036,795749121,53144,795802265,6,0,0,5632,12,7243756056
16037,795752450,83756,795836206,4,0,0,15360,16,295171162
16038,795813519,2946,795816465,3,0,1,3072,2,4749583871
16039,795865329,57752,795923081,7,0,0,5632,8,9598286579
16040,796092869,90212,796183081,1,0,0,16384,6,8437321784
16041,796134300,49732,796184032,3,0,0,3072,2,1186416830
16042,796207950,55748,796263698,3,0,0,4096,2,4506971946
16043,796237530,88622,796326152,5,0,0,16384,19,10734617
16044,796265060,76544,796341604,4,0,0,16896,16,9529976297
16045,796281970,81418,796363388,0,0,0,11264,11,5350365945
16046,796293589,5802,796299391,3,0,1,6144,2,5434586472
16047,796346930,150197,796497127,5,0,0,13824,19,4064712049
16048,796399689,10499,796410188,3,0,1,16896,2,6466713668
16049,796440251,88070,796528321,6,0,0,9216,12,5127626102
16050,796453309,87632,796540941,7,0,0,23040,8,3141051371
16051,796514270,122518,796636788,8,0,0,19968,12,9780392118
16052,796526320,3511,796529831,0,0,1,1536,11,8522119588
16053,796559440,5802,796565242,7,0,1,6144,8,3973466916
16054,796589280,69596,796658876,0,0,0,9216,11,2235907613
16055,796754439,94064,796848503,7,0,0,18944,8,4713638944
16056,796804840,3422,796808262,6,0,1,3584,12,1753629219
16057,796806641,140710,796947351,6,0,0,34816,12,3501258253
16058,796817731,99944,796917675,6,0,0,28160,12,5406472438
16059,796869140,99476,796968616,5,0,0,26624,19,4389385811
16060,796922400,24966,796947366,6,0,1,29184,12,1852740972
16061,796960580,13482,796974062,1,0,1,13824,6,5661251380
16062,796993190,144388,797137578,8,0,0,87552,12,1446158872
16063,797127250,14694,797141944,0,0,1,4608,11,493628052
16064,797180009,90992,797271001,1,0,0,18944,6,10192394578
16065,797407621,77924,797485545,6,0,0,16384,12,7330975977
16066,797428151,98696,797526847,6,0,0,24064,12,3800240914
16067,797541880,6754,797548634,4,0,1,7168,16,6505835069
16068,797682430,82976,797765406,4,0,0,12800,16,2956293566
16069,797709859,76052,797785911,7,0,0,10240,8,10210783911
16070,797748830,92875,797841705,4,0,0,10752,16,10720629401
16071,797752239,102128,797854367,1,0,0,35328,6,7957784249
16072,797846789,11944,797858733,2,0,1,4608,4,8095007171
16073,797946719,5802,797952521,2,0,1,6144,4,3498751133
16074,798005600,136332,798141932,0,0,0,80896,11,664517361
16075,798064800,1994,798066794,0,0,1,2048,11,5173004359
16076,798092630,94244,798186874,0,0,0,24576,11,2453233634
16077,798138580,150499,798289079,4,0,0,122880,16,7233919806
16078,798149760,3128,798152888,6,0,1,9216,12,1328955234
16079,798229730,118382,798348112,3,0,0,26112,2,8589467919
16080,798236010,77012,798313022,8,0,0,18432,12,8464621129
16081,798239120,179702,798418822,3,0,0,30208,2,99603488
16082,798254369,235601,798489970,7,0,0,102400,8,4571074229
16083,798295830,138616,798434446,0,0,0,20992,11,1018435317
16084,798339939,98005,798437944,1,0,0,6144,6,5083130589
16085,798409721,112811,798522532,6,0,0,14336,12,3240034781
16086,798421269,77263,798498532,7,0,0,6144,8,7991240877
16087,798443301,56494,798499795,6,0,0,4096,12,6352846191
16088,798529100,5802,798534902,6,0,1,6144,12,2947908161
16089,798583471,104156,798687627,6,0,0,41984,12,6177779627
16090,798626800,3422,798630222,1,0,1,3584,6,9556034387
16091,798660069,76856,798736925,7,0,0,17920,8,10072014408
16092,798665290,150895,798816185,5,0,0,116736,19,1437737498
16093,798690390,128150,798818540,3,0,0,7680,2,5351800109
16094,798767499,566,798768065,3,0,1,512,2,9260822352
16095,798823850,7706,798831556,4,0,1,8192,16,5703966685
16096,798838950,93049,798931999,0,0,0,20480,11,5868927180
16097,798841080,61604,798902684,0,0,0,8192,11,10044351376
16098,799037730,50672,799088402,4,0,0,2560,16,4190206095
16099,799052200,88064,799140264,0,0,0,4096,11,5094334751
16100,799063309,15062,799078371,2,0,1,29184,4,2924595707
16101,799092200,4937,799097137,7,0,1,12800,8,7213608401
16102,799204099,128578,799332677,1,0,0,31744,6,5752176883
16103,799217869,1042,799218911,3,0,1,1024,2,8434847417
16104,799263800,5196,799268996,7,0,1,13312,8,4072691840
16105,799275130,64208,799339338,2,0,0,6656,4,4138731203
16106,799290900,68423,799359323,9,0,0,7168,18,6606985717
16107,799312709,47814,799360523,1,0,0,1024,6,6344426733
16108,799326670,71899,799398569,5,0,0,7168,19,9319960228
16109,799481011,107900,799588911,6,0,0,54272,12,5392135352
16110,799502690,99476,799602166,3,0,0,26624,2,744585252
16111,799573380,83115,799656495,4,0,0,7680,16,9601271597
16112,799712540,108368,799820908,8,0,0,55808,12,8599879787
16113,799753610,1518,799755128,5,0,1,1536,19,8194940776
16114,799837800,4374,799842174,7,0,1,4608,8,7933041240
16115,799860790,100880,799961670,0,0,0,31232,11,1619683941
16116,800092959,3898,800096857,8,0,1,4096,12,7994671473
16117,800106660,50672,800157332,5,0,0,2560,19,7511996504
16118,800130881,201909,800332790,6,0,0,20992,12,8401944913
16119,800165250,3422,800168672,4,0,1,3584,16,3243392636
16120,800184000,81464,800265464,4,0,0,17920,16,8969348198
16121,800186309,5712,800192021,8,0,1,14336,12,4180339948
16122,800221120,5454,800226574,6,0,1,13824,12,2787657808
16123,800277051,81908,800358959,6,0,0,14336,12,9500719127
16124,800311450,80240,800391690,0,0,0,18944,11,8576770444
16125,800332710,149088,800481798,8,0,0,45056,12,6125346781
16126,800369569,1994,800371563,8,0,1,2048,12,10645348369
16127,800428900,69776,800498676,4,0,0,14848,16,1527097937
16128,800467419,14394,800481813,2,0,1,5120,4,5309103270
16129,800511950,12049,800523999,4,0,1,19968,16,442444050
16130,800614600,100100,800714700,5,0,0,28672,19,781901820
16131,800820139,79436,800899575,7,0,0,11264,8,4799361375
16132,800825769,91616,800917385,7,0,0,20992,8,4696604418
16133,800975340,60824,801036164,5,0,0,5632,19,7237807246
16134,801068060,98696,801166756,5,0,0,24064,19,3624418099
16135,801110240,84722,801194962,8,0,0,4608,12,10425589574
16136,801117190,105138,801222328,3,0,0,2560,2,9128547906
16137,801352750,70976,801423726,5,0,0,8704,19,9273673692
16138,801497160,97916,801595076,0,0,0,21504,11,8724796796
16139,801506820,96695,801603515,3,0,0,27648,2,5104311361
16140,801658220,120380,801778600,4,0,0,95232,16,6342531783
16141,801684140,98851,801782991,8,0,0,14336,12,10474232448
16142,801730230,144070,801874300,4,0,0,114688,16,8548946892
16143,801754960,123418,801878378,8,0,0,7680,12,9804376885
16144,801813840,11791,801825631,4,0,1,19456,16,2498961578
16145,801853170,70102,801923272,4,0,0,2048,16,9908459816
16146,801938261,91436,802029697,6,0,0,15360,12,1040674847
16147,802051920,53144,802105064,8,0,0,5632,12,5624240889
16148,802242090,11533,802253623,9,0,1,18944,18,6612033192
16149,802247299,89428,802336727,1,0,0,10752,6,4577012368
16150,802250980,108524,802359504,3,0,0,56320,2,6453855185
16151,802262930,103765,802366695,5,0,0,23552,19,9693659200
16152,802375340,101192,802476532,8,0,0,32256,12,3359384519
16153,802425410,97604,802523014,9,0,0,12288,18,2868170204
16154,802465930,12049,802477979,7,0,1,19968,8,2011878001
16155,802511130,60824,802571954,5,0,0,5632,19,4556179597
16156,802535719,3128,802538847,8,0,1,9216,12,1679635394
16157,802550860,1042,802551902,4,0,1,1024,16,9095662942
16158,802572660,5971,802578631,0,0,1,14848,11,9862357521
16159,802661830,2946,802664776,6,0,1,3072,12,9340390284
16160,802711111,157800,802868911,6,0,0,27136,12,4426637671
16161,802760590,60824,802821414,3,0,0,5632,2,111188527
16162,802781310,92109,802873419,4,0,0,13824,16,3210099389
16163,802836240,114769,802951009,4,0,0,68608,16,7377236804
16164,802951120,112112,803063232,5,0,0,68096,19,7606875112
16165,802958600,113383,803071983,0,0,0,28672,11,9588284788
16166,803031949,91763,803123712,1,0,0,12288,6,4708549213
16167,803146200,101816,803248016,0,0,0,34304,11,4560448355
16168,803147240,7706,803154946,5,0,1,8192,19,5253937263
16169,803298550,45596,803344146,5,0,0,1024,19,5931095481
16170,803341419,77835,803419254,1,0,0,18432,6,4030357676
16171,803445099,43904,803489003,7,0,0,512,8,9163075163
16172,803459169,1994,803461163,8,0,1,2048,12,203803787
16173,803474040,12737,803486777,0,0,1,24576,11,5787043948
16174,803528170,62353,803590523,4,0,0,5120,16,1416347504
16175,803594970,99788,803694758,5,0,0,27648,19,8529097035
16176,803714179,5971,803720150,3,0,1,14848,2,4857736579
16177,804085830,77144,804162974,5,0,0,13824,19,5865350711
16178,804108589,45596,804154185,1,0,0,1024,6,3344358159
16179,804172049,86360,804258409,7,0,0,13824,8,9077761570
16180,804194900,105404,804300304,8,0,0,46080,12,941347157
16181,804292069,84279,804376348,1,0,0,10240,6,3549006250
16182,804384799,7230,804392029,2,0,1,7680,4,9751386265
16183,804673110,4162,804677272,7,0,1,11264,8,1954439327
16184,804706170,228993,804935163,4,0,0,113664,16,1005782102
16185,804763330,81454,804844784,2,0,0,12800,4,831714742
16186,804830460,106769,804937229,4,0,0,2048,16,9928821939
16187,804843690,92892,804936582,0,0,0,4608,11,5506559850
16188,804894120,86516,804980636,5,0,0,14336,19,4998409148
16189,804920100,117198,805037298,8,0,0,30720,12,9071799121
16190,804928350,12769,804941119,6,0,1,4096,12,9648239235
16191,804971760,119949,805091709,5,0,0,39936,19,6609144476
16192,804984430,6754,804991184,0,0,1,7168,11,3121598149
16193,805033060,156503,805189563,0,0,0,133120,11,6622771766
16194,805483649,104780,805588429,7,0,0,44032,8,9399987535
16195,805679900,97604,805777504,4,0,0,20480,16,4491559037
16196,805686520,3645,805690165,6,0,1,10240,12,3579231778
16197,805862780,1042,805863822,1,0,1,1024,6,10148581157
16198,805890160,47288,805937448,5,0,0,1536,19,6557502316
16199,806065421,103064,806168485,6,0,0,38400,12,5376172374
16200,806119379,104156,806223535,7,0,0,41984,8,4837841855
16201,806122770,566,806123336,7,0,1,512,8,1144138019
16202,806205141,45596,806250737,6,0,0,1024,12,3227265979
16203,806238780,92060,806330840,3,0,0,17408,2,7667570880
16204,806312879,60824,806373703,7,0,0,5632,8,2685731948
16205,806392960,102596,806495556,3,0,0,36864,2,4737408313
16206,806402779,77168,806479947,1,0,0,18944,6,4373372588
16207,806475550,84014,806559564,5,0,0,12800,19,7112056650
16208,806525290,106808,806632098,0,0,0,50688,11,1922489733
16209,806543059,93578,806636637,1,0,0,14848,6,7906536045
16210,806705389,14117,806719506,3,0,1,24064,2,297519575
16211,806857680,113672,806971352,0,0,0,73216,11,7555487074
16212,806888580,87631,806976211,4,0,0,15872,16,7832863555
16213,806935070,6754,806941824,0,0,1,7168,11,3251326283
16214,806963929,16139,806980068,2,0,1,4096,4,3943435542
16215,807122879,103064,807225943,1,0,0,38400,6,6323520335
16216,807123989,3422,807127411,2,0,1,3584,4,10308125692
16217,807161319,2870,807164189,8,0,1,8704,12,39178035
16218,807206180,89924,807296104,0,0,0,20480,11,1772096485
16219,807206509,90078,807296587,1,0,0,1536,6,3529009176
16220,807331810,54056,807385866,3,0,0,3584,2,10129926282
16221,807436600,52520,807489120,3,0,0,3584,2,8207037494
16222,807536069,110864,807646933,1,0,0,64000,6,10073687944
16223,807567410,95180,807662590,5,0,0,27648,19,4906679841
16224,807688530,104468,807792998,0,0,0,43008,11,8378763485
16225,807718470,3422,807721892,4,0,1,3584,16,250003776
16226,807859709,102752,807962461,7,0,0,37376,8,2299170757
16227,807901660,101816,808003476,3,0,0,34304,2,6790610012
16228,807986000,99008,808085008,5,0,0,25088,19,4196284849
16229,808025239,74043,808099282,1,0,0,15360,6,7250648335
16230,808026100,120720,808146820,5,0,0,24064,19,8541044332
16231,808106780,103376,808210156,4,0,0,39424,16,854228663
16232,808148221,119319,808267540,6,0,0,44032,12,5119827732
16233,808252360,103220,808355580,3,0,0,38912,2,1775502314
16234,808340330,99476,808439806,3,0,0,26624,2,8322027593
16235,808364780,176990,808541770,0,0,0,6144,11,277082058
16236,808372270,134370,808506640,3,0,0,23040,2,6655215198
16237,808496340,98072,808594412,4,0,0,22016,16,6228822364
16238,808513620,92876,808606496,3,0,0,11264,2,5424728948
16239,808565890,7230,808573120,7,0,1,7680,8,9520569033
16240,808569170,6856,808576026,0,0,1,4608,11,9358535975
16241,808583050,102072,808685122,0,0,0,22016,11,2904258329
16242,808608000,4374,808612374,0,0,1,4608,11,8151723158
16243,808766929,79616,808846545,1,0,0,16896,6,3864983626
16244,808848970,52364,808901334,3,0,0,3072,2,8196118925
16245,809070060,3128,809073188,6,0,1,9216,12,93682954
16246,809115000,106872,809221872,5,0,0,34816,19,9170498101
16247,809119900,167501,809287401,0,0,0,14336,11,4851160836
16248,809135149,2946,809138095,3,0,1,3072,2,6792115552
16249,809237280,566,809237846,0,0,1,512,11,10576282465
16250,809398579,60224,809458803,7,0,0,8704,8,5390741111
16251,809442521,60862,809503383,6,0,0,1536,12,9194818055
16252,809513690,6754,809520444,9,0,1,7168,18,857386334
16253,809753399,85784,809839183,1,0,0,22016,6,7484785546
16254,809854990,75846,809930836,2,0,0,9728,4,5051126091
16255,809859641,68216,809927857,6,0,0,9728,12,8687842712
16256,809866560,101731,809968291,8,0,0,10240,12,10506264238
16257,809893620,48980,809942600,8,0,0,2048,12,8482493814
16258,810080971,99476,810180447,6,0,0,26624,12,1996467060
16259,810122700,76052,810198752,8,0,0,10240,12,6952992833
16260,810180590,69596,810250186,5,0,0,9216,19,2700740015
16261,810208320,5802,810214122,4,0,1,6144,16,8346439457
16262,810255560,99476,810355036,3,0,0,26624,2,7131192983
16263,810286100,98384,810384484,4,0,0,23040,16,7455245650
16264,810335050,1042,810336092,1,0,1,1024,6,5866179329
16265,810377689,106887,810484576,7,0,0,28672,8,7521167826
16266,810563420,60824,810624244,3,0,0,5632,2,1686147657
16267,810582101,107744,810689845,6,0,0,53760,12,3045066787
16268,810592689,120790,810713479,7,0,0,9216,8,3790275672
16269,810606089,2470,810608559,8,0,1,2560,12,645050419
16270,810636750,80956,810717706,8,0,0,13824,12,963529739
16271,810687121,200801,810887922,6,0,0,44544,12,2850740475
16272,810806370,60824,810867194,0,0,0,5632,11,6805972881
16273,810827660,93464,810921124,3,0,0,22016,2,3176824241
16274,810878219,60211,810938430,7,0,0,2048,8,3157446668
16275,810885610,64664,810950274,4,0,0,5632,16,4325182854
16276,810918800,46220,810965020,0,0,0,512,11,10277995102
16277,810921900,155200,811077100,5,0,0,32768,19,3561126664
16278,810926600,124592,811051192,4,0,0,109056,16,323335064
16279,810927490,4420,810931910,6,0,1,11776,12,435085241
16280,810993189,151903,811145092,7,0,0,72192,8,9140690081
16281,811022990,33923,811056913,9,0,1,14336,18,2660226590
16282,811028240,125312,811153552,3,0,0,9216,2,8482812416
16283,811084950,566,811085516,0,0,1,512,11,2748390777
16284,811157630,4374,811162004,7,0,1,4608,8,9851636483
16285,811206751,68996,811275747,6,0,0,12288,12,3568070608
16286,811223210,1518,811224728,0,0,1,1536,11,7072508402
16287,811275070,68261,811343331,3,0,0,7680,2,200360006
16288,811296210,99603,811395813,2,0,0,22528,4,4546517746
16289,811313640,5712,811319352,7,0,1,14336,8,201480696
16290,811466840,11274,811478114,9,0,1,18432,18,3418208789
16291,811541869,102128,811643997,7,0,0,35328,8,7638480655
16292,811587990,3898,811591888,9,0,1,4096,18,4380683866
16293,811625000,73477,811698477,3,0,0,10240,2,9779162735
16294,811662059,101284,811763343,7,0,0,7680,8,5505961568
16295,811685770,82268,811768038,9,0,0,15360,18,4645205776
16296,811974689,110708,812085397,7,0,0,63488,8,7809883829
16297,812047040,99008,812146048,0,0,0,25088,11,5270697330
16298,812084910,107911,812192821,4,0,0,52736,16,1806743042
16299,812103660,122372,812226032,3,0,0,8192,2,7828159764
16300,812138660,12230,812150890,0,0,1,5120,11,1422660357
16301,812250301,64208,812314509,6,0,0,6656,12,9818830030
16302,812437450,3898,812441348,6,0,1,4096,12,10504074890
16303,812525341,58688,812584029,6,0,0,8704,12,7650987701
16304,812561540,60641,812622181,8,0,0,2048,12,9769969219
16305,812588180,52988,812641168,4,0,0,5120,16,3768418777
16306,812590170,6754,812596924,4,0,1,7168,16,3153673856
16307,812678009,114142,812792151,7,0,0,16384,8,4616522610
16308,812807910,1042,812808952,4,0,1,1024,16,8503298229
16309,812882169,10241,812892410,2,0,1,16384,4,606322382
16310,812889389,182161,813071550,7,0,0,6144,8,10252683247
16311,812921610,55748,812977358,0,0,0,4096,11,9102820839
16312,812928580,133036,813061616,0,0,0,47616,11,413530413
16313,812941190,80010,813021200,3,0,0,10752,2,6845627168
16314,812969750,4374,812974124,1,0,1,4608,6,8013754743
16315,813061349,1301,813062650,8,0,1,1024,12,2796204165
16316,813132480,85245,813217725,2,0,0,3072,4,454815630
16317,813188009,5802,813193811,3,0,1,6144,2,725610472
16318,813321759,3387,813325146,2,0,1,9728,4,2862169850
16319,813579769,99476,813679245,7,0,0,26624,8,10120310518
16320,813682750,57440,813740190,5,0,0,4608,19,4586297670
16321,813719630,50672,813770302,3,0,0,2560,2,5639190307
16322,813725689,4374,813730063,2,0,1,4608,4,9066659763
16323,813768669,105265,813873934,7,0,0,43008,8,2762177530
16324,813798930,121027,813919957,0,0,0,19968,11,7308100681
16325,813808400,5971,813814371,0,0,1,14848,11,966464621
16326,813932770,97448,814030218,4,0,0,19968,16,181793119
16327,813962459,94549,814057008,7,0,0,26112,8,9173291493
16328,814179089,11274,814190363,8,0,1,18432,12,1892679944
16329,814186570,55748,814242318,3,0,0,4096,2,617295570
16330,814210689,5802,814216491,3,0,1,6144,2,10719951729
16331,814222001,214740,814436741,6,0,0,53248,12,3553891671
16332,814298560,121942,814420502,3,0,0,28672,2,6415374308
16333,814349940,137468,814487408,8,0,0,40448,12,6012576970
16334,814407860,114606,814522466,8,0,0,8192,12,3616668430
16335,814441311,85070,814526381,6,0,0,12800,12,9864097473
16336,814481120,65928,814547048,8,0,0,2048,12,2769176593
16337,814492670,57596,814550266,5,0,0,5120,19,9146258715
16338,814545580,16096,814561676,9,0,1,31232,18,6830703442
16339,814557820,61829,814619649,0,0,0,1536,11,666178889
16340,814586650,244224,814830874,4,0,0,37888,16,9895236931
16341,814600931,73760,814674691,6,0,0,12800,12,10621322249
16342,814703390,81284,814784674,5,0,0,12288,19,7750938172
16343,814720020,112897,814832917,2,0,0,6656,4,7525372723
16344,814779961,78680,814858641,6,0,0,13824,12,7491554280
16345,814784490,1694,814786184,4,0,1,1536,16,9179156623
16346,814813980,99008,814912988,3,0,0,25088,2,8237509868
16347,814895810,101816,814997626,0,0,0,34304,11,10695263791
16348,814911090,45794,814956884,5,0,0,512,19,1634197169
16349,814949830,141600,815091430,5,0,0,42496,19,3068993666
16350,814987910,139136,815127046,2,0,0,38400,4,3083780943
16351,815000840,566,815001406,9,0,1,512,18,9887545862
16352,815117610,11439,815129049,6,0,1,2048,12,1793378606
16353,815122190,16763,815138953,4,0,1,18432,16,80215574
16354,815199719,74360,815274079,7,0,0,9728,8,892495653
16355,815253350,89792,815343142,2,0,0,25088,4,4996219588
16356,815262119,1042,815263161,8,0,1,1024,12,8604219838
16357,815294100,99476,815393576,8,0,0,26624,12,5578529595
16358,815300679,108473,815409152,7,0,0,7168,8,9238867013
16359,815319350,116388,815435738,8,0,0,2560,12,2558477137
16360,815326180,194381,815520561,2,0,0,39936,4,8170567072
16361,815345041,159247,815504288,6,0,0,4608,12,2548584258
16362,815350969,100724,815451693,7,0,0,30720,8,803278847
16363,815367190,126908,815494098,5,0,0,38400,19,10367860805
16364,815506579,82154,815588733,7,0,0,19456,8,10250446218
16365,815573950,103847,815677797,8,0,0,32256,12,4006661167
16366,815591400,96692,815688092,3,0,0,22528,2,5459457983
16367,815603840,51296,815655136,3,0,0,4608,2,9203876503
16368,815604690,4374,815609064,7,0,1,4608,8,6127551857
16369,815648941,162637,815811578,6,0,0,3584,12,4664561129
16370,815758770,44192,815802962,4,0,0,512,16,9186844584
16371,815787640,64208,815851848,0,0,0,6656,11,6848579677
16372,815805079,566,815805645,2,0,1,512,4,3293032345
16373,815813810,4850,815818660,4,0,1,5120,16,2455898907
16374,815888720,5802,815894522,4,0,1,6144,16,3314480216
16375,815902160,56060,815958220,4,0,0,5120,16,5299339676
16376,816070900,106340,816177240,2,0,0,49152,4,1713310722
16377,816208759,81128,816289887,7,0,0,11776,8,10614043492
16378,816313550,76052,816389602,5,0,0,10240,19,5662072424
16379,816337760,6488,816344248,6,0,1,15872,12,5774122932
16380,816384570,76705,816461275,8,0,0,6656,12,1225191629
16381,816454630,11274,816465904,6,0,1,18432,12,2318330192
16382,816462190,125309,816587499,2,0,0,40960,4,4460099865
16383,816487180,62132,816549312,4,0,0,5120,16,6962830611
16384,816567300,3387,816570687,9,0,1,9728,18,3036892553
16385,816690820,118196,816809016,3,0,0,88064,2,1720584414
16386,816823869,72668,816896537,1,0,0,9216,6,7295427424
16387,817059000,84404,817143404,2,0,0,22528,4,8454027207
16388,817077990,94820,817172810,3,0,0,16384,2,9182324797
16389,817179580,52364,817231944,4,0,0,3072,16,6304767121
16390,817284460,6754,817291214,5,0,1,7168,19,2675484700
16391,817373890,14117,817388007,7,0,1,24064,8,1050066628
16392,817411400,115547,817526947,3,0,0,32256,2,5222798711
16393,817441980,1042,817443022,6,0,1,1024,12,6641202212
16394,817474231,77744,817551975,6,0,0,10752,12,4498871362
16395,817485730,100617,817586347,5,0,0,8192,19,9319562176
16396,817760420,52364,817812784,3,0,0,3072,2,1195884642
16397,817814780,89168,817903948,3,0,0,23040,2,4746950507
16398,817820080,43904,817863984,4,0,0,512,16,2088039096
16399,817851990,142067,817994057,0,0,0,17920,11,9535087934
16400,817876109,4374,817880483,8,0,1,4608,12,3651014724
16401,818100400,4937,818105337,1,0,1,12800,6,4748352357
16402,818211320,97292,818308612,0,0,0,19456,11,2272937310
16403,818256360,95000,818351360,3,0,0,22016,2,1741074626
16404,818300939,86985,818387924,7,0,0,8704,8,1173317552
16405,818303679,107209,818410888,7,0,0,35840,8,1954937164
16406,818359009,90048,818449057,7,0,0,15872,8,3902427574
16407,818371289,65924,818437213,7,0,0,12288,8,10527898254
16408,818376390,150241,818526631,0,0,0,42496,11,9719180692
16409,818398170,180109,818578279,2,0,0,50688,4,5376999064
16410,818493860,146773,818640633,8,0,0,72704,12,4152681922
16411,818509920,96015,818605935,0,0,0,3072,11,7481911125
16412,818556030,124293,818680323,4,0,0,45568,16,5490350028
16413,818561859,16435,818578294,8,0,1,12288,12,562158239
16414,818798840,52808,818851648,9,0,1,86016,18,9104468050
16415,818804540,143009,818947549,0,0,0,10240,11,6189150941
16416,818864279,3904,818868183,3,0,1,10752,2,949773960
16417,818904719,96980,819001699,1,0,0,18432,6,4072636254
16418,818905050,239912,819144962,5,0,0,15360,19,8129516565
16419,818993280,102596,819095876,0,0,0,36864,11,4899086848
16420,819004820,236844,819241664,3,0,0,59392,2,9463159767
16421,819059871,150701,819210572,6,0,0,12800,12,9935838988
16422,819148830,102308,819251138,3,0,0,8704,2,3149358588
16423,819253919,98384,819352303,7,0,0,23040,8,2667673596
16424,819331199,98408,819429607,7,0,0,28160,8,5188062719
16425,819433741,70976,819504717,6,0,0,8704,12,1957925856
16426,819435650,103532,819539182,8,0,0,39936,12,2636408933
16427,819454449,1994,819456443,8,0,1,2048,12,9688926086
16428,819488310,134680,819622990,0,0,0,45568,11,8111028768
16429,819774130,104000,819878130,0,0,0,41472,11,6127417747
16430,819779080,16613,819795693,5,0,1,32256,19,9383071217
16431,819847660,79616,819927276,8,0,0,16896,12,5962971602
16432,819921050,134584,820055634,8,0,0,20992,12,10688459981
16433,819936370,99320,820035690,8,0,0,26112,12,4944242357
16434,819987291,71478,820058769,6,0,0,10240,12,4678785552
16435,820064440,81128,820145568,0,0,0,11776,11,7353890501
16436,820123489,54056,820177545,7,0,0,3584,8,9673225023
16437,820146050,80281,820226331,5,0,0,16384,19,3125432399
16438,820307910,84824,820392734,3,0,0,13824,2,8863894618
16439,820313221,118093,820431314,6,0,0,19456,12,7217052751
16440,820395800,3898,820399698,4,0,1,4096,16,576761492
16441,820465040,75452,820540492,5,0,0,13312,19,9572507061
16442,820574380,1042,820575422,6,0,1,1024,12,8459435456
16443,820743180,101036,820844216,8,0,0,31744,12,310579580
16444,820768190,56528,820824718,3,0,0,6656,2,5785756473
16445,820838979,8175,820847154,8,0,1,3072,12,10022891566
16446,820845659,62516,820908175,7,0,0,6144,8,5003241351
16447,820863860,113435,820977295,0,0,0,71680,11,236669021
16448,820883150,130430,821013580,8,0,0,30208,12,2328387516
16449,820932259,13083,820945342,2,0,1,22016,4,5582265323
16450,820937370,111517,821048887,2,0,0,27136,4,9205291779
16451,820995650,97787,821093437,0,0,0,20992,11,5406009645
16452,821073340,64364,821137704,8,0,0,7168,12,6849776156
16453,821117840,105716,821223556,0,0,0,47104,11,7609093549
16454,821172870,62516,821235386,2,0,0,6144,4,5494407954
16455,821195491,55748,821251239,6,0,0,4096,12,6423785934
16456,821223129,3365,821226494,8,0,1,3072,12,6290126278
16457,821485600,100412,821586012,2,0,0,29696,4,2826346630
16458,821536101,129999,821666100,6,0,0,28160,12,86789837
16459,821547720,5802,821553522,4,0,1,6144,16,2558577423
16460,821591179,566,821591745,8,0,1,512,12,1675666623
16461,821661150,78102,821739252,5,0,0,15872,19,2815059729
16462,821728780,13083,821741863,0,0,1,22016,11,2820489566
16463,821751310,132083,821883393,5,0,0,23040,19,9315435092
16464,821810250,50672,821860922,4,0,0,2560,16,205332904
16465,821817500,70976,821888476,0,0,0,8704,11,6517784131
16466,821822660,4420,821827080,0,0,1,11776,11,5499335416
16467,821870749,74384,821945133,7,0,0,14848,8,9854142033
16468,821883370,45611,821928981,4,0,0,1024,16,6080992451
16469,821968790,95156,822063946,3,0,0,22528,2,9917474350
16470,821979470,45596,822025066,2,0,0,1024,4,9878957404
16471,822027210,66056,822093266,4,0,0,7680,16,2816842366
16472,822071430,90392,822161822,8,0,0,22016,12,6856986957
16473,822187620,76076,822263696,3,0,0,15360,2,10611548648
16474,822197521,55748,822253269,6,0,0,4096,12,278131368
16475,822345860,5326,822351186,4,0,1,5632,16,1627970725
16476,822463210,90212,822553422,2,0,0,16384,4,2023483139
16477,822482430,96560,822578990,4,0,0,27136,16,6403555462
16478,822595700,114764,822710464,4,0,0,76800,16,1680568639
16479,822623360,126878,822750238,4,0,0,34816,16,2817677246
16480,822668860,87165,822756025,3,0,0,18944,2,9179900235
16481,822806531,50828,822857359,6,0,0,3072,12,3554748538
16482,823005740,60824,823066564,8,0,0,5632,12,1912637330
16483,823165081,47288,823212369,6,0,0,1536,12,4478099009
16484,823244750,54524,823299274,4,0,0,5120,16,4187530199
16485,823309360,76832,823386192,5,0,0,12800,19,4243613689
16486,823315550,100568,823416118,3,0,0,30208,2,2135679790
16487,823328870,59792,823388662,8,0,0,5632,12,3835691638
16488,823352300,176666,823528966,2,0,0,28672,4,4718981316
16489,823385330,81250,823466580,5,0,0,19456,19,1754307115
16490,823388930,153935,823542865,2,0,0,45568,4,1670816954
16491,823407190,9962,823417152,9,0,1,1024,18,6451112091
16492,823451060,148514,823599574,3,0,0,12800,2,7461560104
16493,823459170,153688,823612858,3,0,0,19456,2,3508054946
16494,823496300,2870,823499170,7,0,1,8704,8,8285815146
16495,823503980,89636,823593616,3,0,0,24576,2,1570469354
16496,823543820,229737,823773557,3,0,0,47104,2,1464898955
16497,823544060,160815,823704875,0,0,0,49664,11,6852947556
16498,823558269,5454,823563723,2,0,1,13824,4,6279375254
16499,823565660,98936,823664596,8,0,0,13312,12,674742567
16500,823631199,2470,823633669,2,0,1,2560,4,9039920848
16501,823632100,3195,823635295,6,0,1,2560,12,9227626192
16502,823643950,2870,823646820,9,0,1,8704,18,4123520530
16503,823741851,85786,823827637,6,0,0,4096,12,438421403
16504,823755900,566,823756466,9,0,1,512,18,4301073706
16505,823843540,86696,823930236,8,0,0,19968,12,5599830096
16506,823869639,138774,824008413,7,0,0,16896,8,155105709
16507,823871140,16354,823887494,0,0,1,31744,11,7828416391
16508,823884679,130034,824014713,7,0,0,17408,8,7877730578
16509,823893410,67159,823960569,3,0,0,1024,2,4988961988
16510,824027260,82820,824110080,4,0,0,12288,16,6128836544
16511,824032319,566,824032885,8,0,1,512,12,7353414007
16512,824171080,6754,824177834,9,0,1,7168,18,981780441
16513,824209540,107120,824316660,8,0,0,51712,12,3514384022
16514,824239190,155824,824395014,2,0,0,80896,4,9010540860
16515,824273230,93518,824366748,5,0,0,7168,19,831953698
16516,824280891,43904,824324795,6,0,0,512,12,5924756220
16517,824361030,101192,824462222,3,0,0,32256,2,10256526578
16518,824397040,87220,824484260,5,0,0,7680,19,5312484807
16519,824442640,59132,824501772,0,0,0,5120,11,3837634453
16520,824480730,127014,824607744,3,0,0,53248,2,2308866649
16521,824676300,100100,824776400,0,0,0,28672,11,688198843
16522,824744000,383733,825127733,0,0,1,609792,11,9624015420
16523,824749650,378068,825127718,4,0,0,19968,16,4125404657
16524,824803480,324268,825127748,7,0,1,512,8,9264478094
16525,824852200,269419,825121619,5,0,0,8704,19,10364623030
16526,824858180,388611,825246791,4,0,0,90112,16,3308490819
16527,825083910,238143,825322053,4,0,0,29696,16,6502762540
16528,825198780,3898,825202678,7,0,1,4096,8,3271122921
16529,825208380,254321,825462701,2,0,0,54272,4,5791079829
16530,825326669,5326,825331995,3,0,1,5632,2,9564711632
16531,825368100,71624,825439724,8,0,0,15872,12,10111392108
16532,825393900,88376,825482276,5,0,0,2048,19,4583873878
16533,825451120,157868,825608988,3,0,0,15360,2,5553942495
16534,825469450,13858,825483308,1,0,1,23552,6,3355100119
16535,825502009,102284,825604293,7,0,0,35840,8,3570120313
16536,825605370,77970,825683340,4,0,0,9728,16,8014404508
16537,825719030,105092,825824122,8,0,0,45056,12,9527779146
16538,825761090,128126,825889216,0,0,0,30720,11,4516524613
16539,825848680,5326,825854006,6,0,1,5632,12,3483389368
16540,825914760,104315,826019075,2,0,0,13824,4,5390464732
16541,825929301,110399,826039700,6,0,0,19456,12,10430477006
16542,825945300,2470,825947770,4,0,1,2560,16,5244725222
16543,826012341,87601,826099942,6,0,0,3072,12,8576872113
16544,826019930,104000,826123930,8,0,0,41472,12,9131765597
16545,826030160,3422,826033582,7,0,1,3584,8,8079770310
16546,826066950,122278,826189228,5,0,0,37888,19,2595902004
16547,826070349,7706,826078055,3,0,1,8192,2,7067772712
16548,826142241,84835,826227076,6,0,0,3584,12,3523599612
16549,826218920,75452,826294372,4,0,0,13312,16,3496001272
16550,826339750,10241,826349991,4,0,1,16384,16,660804393
16551,826353180,3422,826356602,9,0,1,3584,18,4253927868
16552,826366120,213464,826579584,2,0,0,70656,4,7411855932
16553,826370080,6488,826376568,7,0,1,15872,8,7273923465
16554,826397230,120913,826518143,2,0,0,69120,4,4013132768
16555,826432860,64208,826497068,4,0,0,6656,16,513136078
16556,826447570,194525,826642095,0,0,0,77312,11,6421419079
16557,826500690,209463,826710153,5,0,0,72704,19,3595643466
16558,826510519,12837,826523356,8,0,1,13312,12,7127107814
16559,826536081,124716,826660797,6,0,0,32768,12,8491936499
16560,826690970,31550,826722520,7,0,1,20480,8,5001586118
16561,826695130,72333,826767463,8,0,0,3584,12,2048469757
16562,826706311,109313,826815624,6,0,0,24064,12,9198399289
16563,826708930,14576,826723506,4,0,1,1536,16,987368461
16564,826884240,3128,826887368,6,0,1,9216,12,1747211616
16565,826912600,89588,827002188,0,0,0,14336,11,10474860028
16566,826967900,6488,826974388,7,0,1,15872,8,8136386345
16567,827063340,111641,827174981,3,0,0,14336,2,5441496390
16568,827082241,45596,827127837,6,0,0,1024,12,719425022
16569,827090890,43904,827134794,2,0,0,512,4,8755440734
16570,827126339,77700,827204039,7,0,0,12800,8,594352173
16571,827248610,3898,827252508,7,0,1,4096,8,1928610601
16572,827261301,103688,827364989,6,0,0,40448,12,4251602589
16573,827274110,93995,827368105,0,0,1,156160,11,8725337710
16574,827323689,55860,827379549,3,0,1,38400,2,636486352
16575,827389019,1518,827390537,2,0,1,1536,4,6091661051
16576,827411440,72448,827483888,0,0,0,13312,11,9792567441
16577,827525960,97136,827623096,0,0,0,18944,11,384582748
16578,827531690,211760,827743450,0,0,0,31232,11,7567998620
16579,827536311,178015,827714326,6,0,0,11264,12,6570460652
16580,827547951,139879,827687830,6,0,0,58880,12,6727202047
16581,827567760,148453,827716213,5,0,0,6144,19,8210019282
16582,827614779,1994,827616773,3,0,1,2048,2,9943179322
16583,827633010,73745,827706755,0,0,1,123392,11,1300945052
16584,827659389,48672,827708061,3,0,1,2048,2,2553396045
16585,827685090,130246,827815336,2,0,0,7168,4,4962406976
16586,827745900,195820,827941720,2,0,0,14336,4,3363014040
16587,827749299,2470,827751769,2,0,1,2560,4,2227433635
16588,827786151,104420,827890571,6,0,0,14848,12,3540548177
16589,827792470,144867,827937337,4,0,0,26112,16,7826096244
16590,827826770,102596,827929366,4,0,0,36864,16,5879341543
16591,827860740,84115,827944855,8,0,0,10240,12,5352701748
16592,828013210,54056,828067266,4,0,0,3584,16,3890809090
16593,828132460,105404,828237864,0,0,0,46080,11,847249399
16594,828194590,50672,828245262,8,0,0,2560,12,3364991884
16595,828199000,78842,828277842,2,0,0,14848,4,2498227980
16596,828348690,58532,828407222,0,0,0,8192,11,5433814135
16597,828363549,84512,828448061,7,0,0,12800,8,5144791941
16598,828369280,566,828369846,1,0,1,512,6,4744476463
16599,828474930,3898,828478828,1,0,1,4096,6,6118592871
16600,828557420,101036,828658456,0,0,0,31744,11,9296309305
16601,828608400,50695,828659095,3,0,0,2048,2,6021305389
16602,828609630,3128,828612758,6,0,1,9216,12,6893009892
16603,828634630,52364,828686994,3,0,0,3072,2,7189284013
16604,828748810,110552,828859362,5,0,0,62976,19,260879203
16605,828823811,61903,828885714,6,0,0,1024,12,395091915
16606,828860370,3898,828864268,1,0,1,4096,6,9433107092
16607,828971989,127040,829099029,7,0,0,37888,8,6938660115
16608,829090470,61788,829152258,0,0,1,90112,11,4864171216
16609,829112390,171632,829284022,4,0,0,13824,16,4732994969
16610,829143519,82395,829225914,1,0,0,5120,6,686710140
16611,829296720,1994,829298714,1,0,1,2048,6,3967305284
16612,829299190,97004,829396194,8,0,0,23552,12,8016706285
16613,829326931,129329,829456260,6,0,0,17920,12,10480740097
16614,829372030,125117,829497147,5,0,0,10240,19,6401099820
16615,829465360,54209,829519569,8,0,0,2048,12,2606811196
16616,829574170,154316,829728486,0,0,1,250368,11,2592897759
16617,829660000,293871,829953871,0,0,0,21504,11,4635834582
16618,829708800,101512,829810312,4,0,0,5632,16,4317065125
16619,829782921,62984,829845905,6,0,0,7680,12,5603518395
16620,829793050,86211,829879261,4,0,0,4608,16,9428918754
16621,829809201,111004,829920205,6,0,0,23040,12,10089792151
16622,829912310,11016,829923326,6,0,1,17920,12,1869780773
16623,829930150,84633,830014783,0,0,0,12288,11,2111074310
16624,829973070,5196,829978266,1,0,1,13312,6,6616090706
16625,830027879,54056,830081935,7,0,0,3584,8,5477485636
16626,830140281,107900,830248181,6,0,0,54272,12,8155455910
16627,830169610,121597,830291207,0,0,0,17920,11,6952070301
16628,830172290,130810,830303100,5,0,0,20480,19,3480917358
16629,830174759,1994,830176753,2,0,1,2048,4,1340001281
16630,830197989,206203,830404192,7,0,0,24064,8,7407469286
16631,830236560,111203,830347763,4,0,0,9728,16,1714794677
16632,830317880,146696,830464576,2,0,0,60928,4,9486079735
16633,830428800,1518,830430318,6,0,1,1536,12,9933551733
16634,830479779,72068,830551847,7,0,0,12288,8,8217877739
16635,830544659,1994,830546653,2,0,1,2048,4,7096703780
16636,830631030,94844,830725874,0,0,0,21504,11,7583105759
16637,830680110,60980,830741090,0,0,0,6144,11,2601528254
16638,830794510,47600,830842110,3,0,0,2560,2,4922658779
16639,830892520,1994,830894514,4,0,1,2048,16,8641991083
16640,830901420,102752,831004172,8,0,0,37376,12,7204131507
16641,830921860,55748,830977608,8,0,0,4096,12,3024006728
16642,831025440,55748,831081188,2,0,0,4096,4,3298075383
16643,831110210,5326,831115536,4,0,1,5632,16,7159689889
16644,831177219,60068,831237287,7,0,0,8192,8,9386653458
16645,831231459,72668,831304127,7,0,0,9216,8,3500252127
16646,831354370,98384,831452754,3,0,0,23040,2,6552531259
16647,831490779,89533,831580312,7,0,0,14336,8,4482148931
16648,831511220,63765,831574985,3,0,0,5632,2,252440551
16649,831511689,1518,831513207,3,0,1,1536,2,8469956424
16650,831512570,92037,831604607,2,0,0,1024,4,8165513303
16651,831513479,1994,831515473,3,0,1,2048,2,290930958
16652,831581169,2470,831583639,2,0,1,2560,4,9946220196
16653,831594630,54056,831648686,8,0,0,3584,12,998095916
16654,831609730,101122,831710852,2,0,0,25088,4,10676631311
16655,831632660,1042,831633702,9,0,1,1024,18,3237291357
16656,831634630,79408,831714038,0,0,0,9216,11,4932698360
16657,831706480,84892,831791372,8,0,0,14848,12,4462902056
16658,831834060,111644,831945704,3,0,0,66560,2,6579668706
16659,831838000,60380,831898380,3,0,0,9216,2,938612664
16660,831842720,110562,831953282,3,0,0,2048,2,4102675014
16661,831917139,7706,831924845,3,0,1,8192,2,266773853
16662,832038511,67592,832106103,6,0,0,7680,12,10607138314
16663,832091421,71418,832162839,6,0,0,5120,12,9168291007
16664,832129739,1042,832130781,8,0,1,1024,12,8578346859
16665,832145220,92810,832238030,3,0,0,512,2,2932916219
16666,832152300,65756,832218056,2,0,0,6656,4,3306340342
16667,832156920,47432,832204352,2,0,0,2048,4,3689014525
16668,832252660,88700,832341360,2,0,0,21504,4,5200532206
16669,832284759,119655,832404414,7,0,0,30720,8,10141608665
16670,832361571,67460,832429031,6,0,0,12288,12,7257794607
16671,832407920,126009,832533929,8,0,0,64000,12,4137508831
16672,832422390,6754,832429144,9,0,1,7168,18,6913075019
16673,832556580,121472,832678052,0,0,0,98816,11,5753760274
16674,832602800,105000,832707800,3,0,0,7680,2,5116930868
16675,832622039,4162,832626201,3,0,1,11264,2,9894450274
16676,832718890,21658,832740548,4,0,1,35328,16,4771770083
16677,832732129,12285,832744414,2,0,1,6144,4,4130872325
16678,832778750,287444,833066194,4,0,0,106496,16,5560336069
16679,832780701,136702,832917403,6,0,0,2048,12,3443912157
16680,832849410,221203,833070613,0,0,0,9728,11,1007907342
16681,832862030,1518,832863548,1,0,1,1536,6,8517880604
16682,832863370,65900,832929270,8,0,0,7168,12,9509132445
16683,832868450,101987,832970437,2,0,0,3584,4,10729357947
16684,832879420,154311,833033731,0,0,0,46080,11,2551464907
16685,832939840,134249,833074089,0,0,0,2048,11,5359004722
16686,833015950,128210,833144160,0,0,0,16384,11,5544484123
16687,833243520,3645,833247165,7,0,1,10240,8,3510618441
16688,833275499,1994,833277493,2,0,1,2048,4,3055012817
16689,833275881,62672,833338553,6,0,0,5632,12,9445599047
16690,833291890,67417,833359307,3,0,0,2048,2,7592778298
16691,833309839,2946,833312785,3,0,1,3072,2,4062956092
16692,833392630,7706,833400336,4,0,1,8192,16,6316928791
16693,833428239,13858,833442097,8,0,1,23552,12,7840195695
16694,833526910,109616,833636526,3,0,0,59904,2,8651884204
16695,833665609,10241,833675850,2,0,1,16384,4,9009151527
16696,833709541,91280,833800821,6,0,0,14848,12,10611136797
16697,833715990,198190,833914180,2,0,0,43008,4,10607797487
16698,833749470,4937,833754407,6,0,1,12800,12,657648533
16699,833805830,566,833806396,4,0,1,512,16,3226159462
16700,833826290,120711,833947001,5,0,0,53760,19,1839777444
16701,833867810,114002,833981812,0,0,0,5632,11,1416668684
16702,833935650,58631,833994281,0,0,0,1536,11,4093858618
16703,833974270,109076,834083346,8,0,0,22016,12,5088161522
16704,833986810,146876,834133686,3,0,0,67072,2,6050694378
16705,834092660,110708,834203368,0,0,0,63488,11,7642143291
16706,834124119,17265,834141384,8,0,1,8192,12,1452928864
16707,834226271,48980,834275251,6,0,0,2048,12,2253464858
16708,834252020,98540,834350560,2,0,0,23552,4,6509363736
16709,834258780,43904,834302684,8,0,0,512,12,2455443829
16710,834358040,53583,834411623,4,0,1,87552,16,8682928705
16711,834464090,60224,834524314,3,0,0,8704,2,6606491478
16712,834551090,96248,834647338,4,0,0,26112,16,3574724746
16713,834594650,6278,834600928,9,0,1,6656,18,7093198549
16714,834605610,176978,834782588,4,0,0,31744,16,2369757210
16715,834612090,101348,834713438,0,0,0,32768,11,2607825684
16716,834723251,105770,834829021,6,0,0,15872,12,4958868754
16717,834744710,79460,834824170,3,0,0,16384,2,689458325
16718,834825950,98711,834924661,4,0,0,29184,16,5392332545
16719,834888240,3898,834892138,9,0,1,4096,18,956446952
16720,835217040,86564,835303604,8,0,0,24576,12,8947672036
16721,835325079,91280,835416359,7,0,0,14848,8,6836993631
16722,835401090,63053,835464143,3,0,0,3072,2,549157458
16723,835437040,101192,835538232,5,0,0,32256,19,4326782967
16724,835644470,109896,835754366,2,0,0,59904,4,6818630019
16725,835664770,93979,835758749,4,0,0,14336,16,10564446310
16726,835720370,107952,835828322,3,0,0,28160,2,4429966192
16727,835833181,43904,835877085,6,0,0,512,12,9248449376
16728,835888031,114608,836002639,6,0,0,76288,12,584202067
16729,835984220,106955,836091175,0,0,0,20992,11,2738214213
16730,836048700,72068,836120768,4,0,0,12288,16,8388571371
16731,836141560,63452,836205012,3,0,0,9216,2,7156068919
16732,836185430,86672,836272102,2,0,0,14848,4,9819427330
16733,836249640,198087,836447727,0,0,1,325632,11,7622212858
16734,836328520,130344,836458864,0,0,1,36864,11,3906535572
16735,836375869,88999,836464868,2,0,1,20480,4,10735696415
16736,836431960,33894,836465854,6,0,1,1536,12,6198242494
16737,836525550,2470,836528020,6,0,1,2560,12,4866479222
16738,836602440,81596,836684036,4,0,0,13312,16,7519227066
16739,836603710,61291,836665001,5,0,0,1536,19,2979508509
16740,836676271,59557,836735828,6,0,0,4608,12,7866767804
16741,836781740,65900,836847640,2,0,0,7168,4,5636992995
16742,836824230,101504,836925734,2,0,0,33280,4,4375841906
16743,836852710,120778,836973488,0,0,0,22528,11,5792356746
16744,836870899,91148,836962047,1,0,0,19456,6,6815631169
16745,836907929,117436,837025365,7,0,0,19456,8,3325613877
16746,837024961,74156,837099117,6,0,0,12800,12,6084409195
16747,837093250,55748,837148998,2,0,0,4096,4,8468639951
16748,837145280,47288,837192568,0,0,0,1536,11,4400203399
16749,837194720,108212,837302932,4,0,0,55296,16,8472543030
16750,837202669,153939,837356608,7,0,0,70144,8,1743968822
16751,837220959,151843,837372802,7,0,0,11264,8,5601323413
16752,837256150,212148,837468298,5,0,0,19968,19,8184423568
16753,837302310,5551,837307861,1,0,1,12800,6,1272663266
16754,837308690,116696,837425386,2,0,0,22528,4,10092714619
16755,837328490,74750,837403240,8,0,0,9216,12,3103399075
16756,837342970,181032,837524002,0,0,0,41472,11,3266357871
16757,837401060,129509,837530569,2,0,0,21504,4,10327786327
16758,837472060,128184,837600244,3,0,0,13312,2,4139821605
16759,837555360,1042,837556402,7,0,1,1024,8,9978840348
16760,837610400,47288,837657688,2,0,0,1536,4,4623652352
16761,837631089,64208,837695297,1,0,0,6656,6,1486813768
16762,837663550,90340,837753890,4,0,0,1536,16,4479946115
16763,837677469,2870,837680339,3,0,1,8704,2,721264768
16764,837717100,101504,837818604,3,0,0,33280,2,1725360855
16765,837757360,69278,837826638,0,0,0,3072,11,10429787399
16766,837900629,72668,837973297,7,0,0,9216,8,2210138283
16767,837915179,104936,838020115,7,0,0,44544,8,2492446951
16768,837943449,566,837944015,8,0,1,512,12,5572705312
16769,838037920,101036,838138956,0,0,0,31744,11,7005366463
16770,838219260,103220,838322480,4,0,0,38912,16,6712534507
16771,838309940,52808,838362748,4,0,1,86016,16,1196373454
16772,838357849,81128,838438977,7,0,0,11776,8,6604816070
16773,838368060,90867,838458927,4,0,0,512,16,7233956032
16774,838688169,65900,838754069,7,0,0,7168,8,4819504521
16775,838717969,2946,838720915,8,0,1,3072,12,3825215526
16776,838727870,55748,838783618,4,0,0,4096,16,8848868167
16777,838733679,94064,838827743,1,0,0,18944,6,3486840664
16778,838796850,98876,838895726,4,0,0,29696,16,4536592579
16779,838896160,61604,838957764,5,0,0,8192,19,8149822199
16780,838902741,72081,838974822,6,0,0,2560,12,3718648309
16781,839053309,5802,839059111,8,0,1,6144,12,10540690006
16782,839132269,57440,839189709,1,0,0,4608,6,3851870611
16783,839148750,110086,839258836,5,0,0,12800,19,6539573325
16784,839233730,77744,839311474,0,0,0,10752,11,5788421221
16785,839320760,5326,839326086,7,0,1,5632,8,1818704235
16786,839321490,94163,839415653,8,0,0,15872,12,5213032093
16787,839405210,90836,839496046,3,0,0,18432,2,2456149975
16788,839479359,16702,839496061,8,0,1,20480,12,2765176959
16789,839494410,62467,839556877,3,0,0,5632,2,8143939176
16790,839574439,123833,839698272,1,0,0,15872,6,4468203763
16791,839583640,131807,839715447,4,0,0,56320,16,5356941013
16792,839619400,4850,839624250,1,0,1,5120,6,395278264
16793,839639879,5196,839645075,3,0,1,13312,2,2854177433
16794,839762790,43904,839806694,5,0,0,512,19,10509511036
16795,839805979,56840,839862819,1,0,0,7680,6,10737199827
16796,839831680,7230,839838910,6,0,1,7680,12,601723144
16797,839891029,7706,839898735,2,0,1,8192,4,1805661402
16798,839913350,2470,839915820,1,0,1,2560,6,10621580829
16799,839930420,4374,839934794,5,0,1,4608,19,10662808911
16800,840024029,108056,840132085,7,0,0,54784,8,9984356674
16801,840097729,78548,840176277,1,0,0,18432,6,8040881992
16802,840137270,51296,840188566,5,0,0,4608,19,8443522231
16803,840149339,110240,840259579,7,0,0,61952,8,10397996049
16804,840329010,96512,840425522,0,0,0,16896,11,1128832032
16805,840344629,59132,840403761,7,0,0,5120,8,9309982596
16806,840374300,61303,840435603,3,0,0,7680,2,6659880309
16807,840416730,107738,840524468,0,0,1,179712,11,912236023
16808,840422920,239672,840662592,0,0,0,52736,11,2144090683
16809,840470710,200633,840671343,0,0,0,28672,11,2263355644
16810,840522299,2870,840525169,2,0,1,8704,4,9154547317
16811,840564329,4679,840569008,3,0,1,12288,2,5301973069
16812,840627760,213280,840841040,2,0,0,42496,4,739116656
16813,840681580,90524,840772104,3,0,0,17408,2,3041493273
16814,840756540,100568,840857108,8,0,0,30208,12,6534573978
16815,840805749,87251,840893000,7,0,0,4608,8,5271402891
16816,840862539,3422,840865961,2,0,1,3584,4,625670165
16817,840901079,70220,840971299,7,0,0,11264,8,9613403948
16818,840967551,99788,841067339,6,0,0,27648,12,9081527260
16819,841000910,69720,841070630,3,0,0,10752,2,5219957687
16820,841070290,69616,841139906,0,0,0,8192,11,6139672139
16821,841162190,106028,841268218,5,0,0,48128,19,2723313968
16822,841189360,92082,841281442,0,0,0,3584,11,643903214
16823,841242330,75920,841318250,4,0,0,14848,16,3001966508
16824,841267490,98948,841366438,8,0,0,22528,12,3679568691
16825,841304969,51296,841356265,1,0,0,4608,6,4919441593
16826,841442129,4374,841446503,3,0,1,4608,2,9847964557
16827,841449140,99944,841549084,5,0,0,28160,19,4998379084
16828,841489959,60403,841550362,7,0,0,4096,8,1192604356
16829,841519959,106207,841626166,1,0,0,48128,6,10479497559
16830,841529809,19290,841549099,8,0,1,24576,12,9206776205
16831,841550850,43904,841594754,3,0,0,512,2,2193379796
16832,841578831,146361,841725192,6,0,0,17408,12,10253463957
16833,841654800,14029,841668829,0,0,1,27136,11,917186394
16834,841972661,101504,842074165,6,0,0,33280,12,7929739399
16835,841992189,117016,842109205,7,0,0,37376,8,1393269861
16836,842016390,1042,842017432,1,0,1,1024,6,2837802965
16837,842131909,98072,842229981,1,0,0,22016,6,3180711324
16838,842158430,74530,842232960,3,0,0,9728,2,3217572664
16839,842256210,64208,842320418,5,0,0,6656,19,7763936130
16840,842295990,5802,842301792,9,0,1,6144,18,2108009799
16841,842325300,52364,842377664,2,0,0,3072,4,3754022886
16842,842392580,246645,842639225,4,0,1,403456,16,9914972140
16843,842394540,245351,842639891,6,0,1,1024,12,6946420045
16844,842417119,256683,842673802,7,0,0,10752,8,10682519580
16845,842467620,288713,842756333,0,0,0,19968,11,7789357170
16846,842520979,120858,842641837,8,0,1,3072,12,2272516660
16847,842614979,216848,842831827,7,0,0,13312,8,4086045904
16848,842647090,5326,842652416,6,0,1,5632,12,2879186099
16849,842706091,194011,842900102,6,0,0,3072,12,5490946859
16850,842738890,203215,842942105,2,0,0,35840,4,4722024474
16851,842774140,70688,842844828,3,0,0,12800,2,5857529422
16852,842791790,107231,842899021,2,0,0,20992,4,5850027954
16853,842811750,2470,842814220,1,0,1,2560,6,2607077204
16854,842815590,155977,842971567,5,0,0,56320,19,9035189185
16855,842911700,117786,843029486,4,0,0,32256,16,241788559
16856,842934260,113430,843047690,8,0,0,16384,12,10419716490
16857,843031071,54056,843085127,6,0,0,3584,12,8371131046
16858,843033099,54056,843087155,1,0,0,3584,6,2031848456
16859,843044179,104851,843149030,7,0,0,32768,8,1410296719
16860,843100779,4374,843105153,3,0,1,4608,2,4126915232
16861,843107960,4420,843112380,1,0,1,11776,6,5403902869
16862,843198310,100011,843298321,2,0,0,10752,4,5426984624
16863,843202111,86204,843288315,6,0,0,13312,12,8631393630
16864,843247929,95000,843342929,1,0,0,22016,6,9611372350
16865,843323780,43904,843367684,0,0,0,512,11,9808217068
16866,843387320,20624,843407944,6,0,1,33280,12,8547124144
16867,843392320,102101,843494421,3,0,0,11264,2,4403689370
16868,843395980,94994,843490974,2,0,0,16896,4,8401247294
16869,843413590,52808,843466398,4,0,1,86016,16,3045711629
16870,843444419,23605,843468024,3,0,1,2560,2,6242631795
16871,843632011,98384,843730395,6,0,0,23040,12,9977313490
16872,843764030,111332,843875362,5,0,0,65536,19,6461314669
16873,843816910,116172,843933082,0,0,0,10752,11,710313096
16874,843904660,57300,843961960,8,0,0,3584,12,4772888197
16875,843919660,60824,843980484,3,0,0,5632,2,2298831879
16876,843934770,92358,844027128,8,0,0,12288,12,9812817861
16877,843940669,10499,843951168,8,0,1,16896,12,5408025770
16878,844029609,1518,844031127,2,0,1,1536,4,3449740641
16879,844030260,2173,844032433,6,0,1,2048,12,2023649180
16880,844089600,98072,844187672,4,0,0,22016,16,3456314876
16881,844093420,104095,844197515,5,0,0,32256,19,9391304044
16882,844101770,99660,844201430,0,0,0,12800,11,7956119112
16883,844110750,136956,844247706,4,0,0,13824,16,3265761158
16884,844124249,6229,844130478,3,0,1,15360,2,1732772674
16885,844146941,55440,844202381,6,0,0,3072,12,2631977323
16886,844207831,65900,844273731,6,0,0,7168,12,6520051654
16887,844254899,79436,844334335,7,0,0,11264,8,5106107174
16888,844295720,115544,844411264,2,0,0,79360,4,10352950139
16889,844347370,139290,844486660,0,0,0,27136,11,6980220969
16890,844354500,57255,844411755,4,0,0,1536,16,10366051077
16891,844396881,92914,844489795,6,0,0,10240,12,8715184638
16892,844510740,72980,844583720,2,0,0,10240,4,28523246
16893,844556990,100880,844657870,5,0,0,31232,19,9938334337
16894,844827290,59756,844887046,5,0,0,7168,19,8829718962
16895,844828100,566,844828666,9,0,1,512,18,4937966046
16896,844841200,3904,844845104,4,0,1,10752,16,1086235806
16897,844856770,258500,845115270,5,0,0,40960,19,2907308291
16898,844869460,5802,844875262,4,0,1,6144,16,6896005805
16899,844921029,2470,844923499,3,0,1,2560,2,1338513499
16900,845078999,98557,845177556,7,0,0,17408,8,6898928701
16901,845091279,100880,845192159,1,0,0,31232,6,7037278052
16902,845092850,145683,845238533,2,0,0,20992,4,2919224656
16903,845134640,60824,845195464,2,0,0,5632,4,5093179402
16904,845231540,64208,845295748,9,0,0,6656,18,9280424229
16905,845275380,10757,845286137,1,0,1,17408,6,4481006466
16906,845387610,124977,845512587,2,0,0,9728,4,6229286063
16907,845462060,51330,845513390,5,0,0,2560,19,7592087245
16908,845479460,119413,845598873,3,0,0,59904,2,10132939462
16909,845511900,4395,845516295,4,0,1,3072,16,428534180
16910,845523810,2870,845526680,4,0,1,8704,16,10577213162
16911,845640399,45596,845685995,1,0,0,1024,6,2274721069
16912,845723989,4850,845728839,8,0,1,5120,12,5702794328
16913,845763480,48980,845812460,5,0,0,2048,19,4841111759
16914,845834069,92552,845926621,1,0,0,24064,6,7771813473
16915,845895180,12825,845908005,7,0,1,21504,8,1353311314
16916,845914690,43904,845958594,8,0,0,512,12,7682200629
16917,845970090,84692,846054782,2,0,0,18432,4,8380155088
16918,846015450,167361,846182811,4,0,0,80384,16,9811325717
16919,846071130,55748,846126878,3,0,0,4096,2,6302197986
16920,846134400,49305,846183705,8,0,0,1536,12,8998316605
16921,846337700,77690,846415390,5,0,0,11776,19,5162421034
16922,846342230,67928,846410158,0,0,0,13824,11,8837854447
16923,846359180,98852,846458032,5,0,0,24576,19,3603682742
16924,846364670,108050,846472720,4,0,0,16384,16,7578334712
16925,846418699,70976,846489675,1,0,0,8704,6,2142152520
16926,846420309,209994,846630303,1,0,0,44544,6,2243467521
16927,846461599,144069,846605668,7,0,0,48128,8,4635852054
16928,846464119,8616,846472735,3,0,1,6144,2,2920051461
16929,846505500,109198,846614698,5,0,0,1024,19,1477421601
16930,846525230,140234,846665464,3,0,0,10240,2,270090333
16931,846541499,105092,846646591,1,0,0,45056,6,5118251135
16932,846580320,69882,846650202,2,0,0,11776,4,9811081491
16933,846592780,120970,846713750,0,0,0,20992,11,3229859473
16934,846633190,117081,846750271,0,0,0,40448,11,8482614981
16935,846677829,126208,846804037,1,0,0,34304,6,7306605216
16936,846825140,50741,846875881,0,0,1,81920,11,3799260809
16937,846830341,145332,846975673,6,0,0,10240,12,6353906406
16938,846893839,5326,846899165,8,0,1,5632,12,7837560658
16939,846906250,4374,846910624,7,0,1,4608,8,1420834891
16940,846911821,215830,847127651,6,0,0,48640,12,9647844831
16941,847043490,118879,847162369,5,0,0,59392,19,4767031327
16942,847057599,566,847058165,3,0,1,512,2,9945623874
16943,847284630,43904,847328534,5,0,0,512,19,8885538164
16944,847375460,16096,847391556,4,0,1,31232,16,1789769708
16945,847377390,195809,847573199,5,0,0,5632,19,8358610979
16946,847398190,195619,847593809,5,0,0,10752,19,2924182757
16947,847399940,6278,847406218,6,0,1,6656,12,5868063139
16948,847458510,7230,847465740,9,0,1,7680,18,1834591964
16949,847583579,49292,847632871,7,0,0,3072,8,172005148
16950,847638171,109460,847747631,6,0,0,59392,12,4445288224
16951,847737820,53707,847791527,3,0,0,512,2,2250156487
16952,847768670,102128,847870798,0,0,0,35328,11,2777954651
16953,847946819,75608,848022427,7,0,0,13824,8,31470360
16954,848002050,1042,848003092,4,0,1,1024,16,10390882150
16955,848009850,103220,848113070,0,0,0,38912,11,9370310490
16956,848049500,135972,848185472,4,0,0,43520,16,405343060
16957,848050270,4374,848054644,1,0,1,4608,6,2039528736
16958,848074811,66107,848140918,6,0,0,4096,12,2373448969
16959,848098149,119705,848217854,7,0,0,62976,8,2293674907
16960,848177480,127116,848304596,8,0,0,91136,12,5029300408
16961,848191310,124533,848315843,4,0,0,36864,16,5260889955
16962,848192960,142848,848335808,0,0,0,32256,11,7254520763
16963,848209650,159494,848369144,4,0,0,18432,16,423274403
16964,848245580,193011,848438591,0,0,0,6144,11,3318326665
16965,848274179,162525,848436704,1,0,0,78848,6,5958602362
16966,848319900,54358,848374258,0,0,1,89088,11,1739996735
16967,848338030,122008,848460038,2,0,0,3072,4,8074533900
16968,848367130,145409,848512539,8,0,0,17920,12,6195559128
16969,848447940,24242,848472182,9,0,1,40448,18,4274206131
16970,848512081,105123,848617204,6,0,0,5120,12,6143477546
16971,848581171,124347,848705518,6,0,0,61952,12,1350123929
16972,848627120,127460,848754580,5,0,0,35328,19,7280907749
16973,848630139,172927,848803066,1,0,0,16896,6,806396282
16974,848639330,137510,848776840,5,0,0,32768,19,1131140108
16975,848672840,185474,848858314,3,0,0,72192,2,6135982013
16976,848761209,125299,848886508,7,0,0,17408,8,9070721176
16977,848911629,3422,848915051,2,0,1,3584,4,6849526666
16978,848939750,113516,849053266,3,0,0,72704,2,2319061685
16979,849021881,106625,849128506,6,0,0,19968,12,3354091102
16980,849038600,116942,849155542,4,0,0,35840,16,10598072574
16981,849109760,1042,849110802,4,0,1,1024,16,9941850082
16982,849169100,14117,849183217,7,0,1,24064,8,9595705658
16983,849241689,1994,849243683,8,0,1,2048,12,5886306370
16984,849253900,115387,849369287,0,0,0,2560,11,6988403542
16985,849264980,76052,849341032,5,0,0,10240,19,7363311908
16986,849284730,108154,849392884,4,0,0,29184,16,3900985604
16987,849304530,48980,849353510,8,0,0,2048,12,247304097
16988,849307009,67592,849374601,7,0,0,7680,8,3750545391
16989,849337419,142391,849479810,7,0,0,14848,8,2426768082
16990,849343200,132071,849475271,4,0,0,87040,16,10136121432
16991,849363110,164731,849527841,4,0,0,14336,16,4305948646
16992,849522200,103844,849626044,2,0,0,40960,4,7459385776
16993,849539419,91065,849630484,7,0,0,5120,8,3144088013
16994,849592110,101972,849694082,4,0,0,34816,16,6042073486
16995,849641650,3422,849645072,6,0,1,3584,12,3798673124
16996,849650370,116804,849767174,4,0,0,15360,16,10135023939
16997,849689970,100820,849790790,4,0,0,27648,16,3753211783
16998,849824510,12566,849837076,1,0,1,20992,6,9343315630
16999,849826280,86583,849912863,0,0,0,14336,11,8668188407
17000,849849220,174618,850023838,4,0,0,44544,16,3769134413
17001,849864480,57433,849921913,0,0,0,1536,11,9343778177
17002,849885110,84560,849969670,8,0,0,23040,12,6320518791
17003,849945549,90368,850035917,1,0,0,16896,6,805375739
17004,849957149,47288,850004437,7,0,0,1536,8,4646983156
17005,850002550,55748,850058298,5,0,0,4096,19,5644635585
17006,850011729,131943,850143672,1,0,0,56320,6,9426328700
17007,850069670,2470,850072140,4,0,1,2560,16,9803019887
17008,850091120,107938,850199058,0,0,0,37888,11,3480317764
17009,850103830,114522,850218352,4,0,0,16896,16,2841418348
17010,850112150,6278,850118428,1,0,1,6656,6,905949857
17011,850114070,155181,850269251,2,0,0,10240,4,3912056923
17012,850198770,54336,850253106,8,0,0,3584,12,732836782
17013,850207860,178268,850386128,5,0,0,76288,19,7478312309
17014,850279149,72383,850351532,7,0,0,3072,8,5419211123
17015,850377030,69626,850446656,5,0,0,9728,19,1101142358
17016,850418300,67542,850485842,0,0,0,6144,11,8047001636
17017,850429390,61378,850490768,3,0,0,1024,2,2888098992
17018,850443190,52364,850495554,3,0,0,3072,2,1277096152
17019,850447960,53144,850501104,0,0,0,5632,11,4163332601
17020,850489430,121194,850610624,2,0,0,94720,4,10142950992
17021,850567349,86672,850654021,7,0,0,14848,8,4151231908
17022,850637151,107900,850745051,6,0,0,54272,12,2689911640
17023,850671560,2946,850674506,9,0,1,3072,18,969302583
17024,850682289,106172,850788461,7,0,0,34304,8,6276723757
17025,850757179,78934,850836113,7,0,0,6144,8,1858781811
17026,850795660,91687,850887347,3,0,0,16896,2,9000367693
17027,850824199,3898,850828097,8,0,1,4096,12,5822682480
17028,850824370,152516,850976886,5,0,0,61440,19,5490244450
17029,850832739,56027,850888766,1,0,0,4608,6,413962783
17030,851101220,74672,851175892,3,0,0,10752,2,3835633228
17031,851150550,48980,851199530,5,0,0,2048,19,4957779474
17032,851166850,3898,851170748,4,0,1,4096,16,3207902859
17033,851273660,54680,851328340,5,0,0,5632,19,3424773624
17034,851328291,99205,851427496,6,0,0,25600,12,3859572820
17035,851351599,45596,851397195,7,0,0,1024,8,4741261805
17036,851382700,93468,851476168,2,0,0,6656,4,94059512
17037,851439850,3128,851442978,9,0,1,9216,18,6078245866
17038,851463509,58688,851522197,1,0,0,8704,6,7378862132
17039,851536080,52364,851588444,3,0,0,3072,2,1251203542
17040,851538480,57488,851595968,4,0,0,2560,16,7533681358
17041,851581890,57146,851639036,2,0,0,512,4,594947627
17042,851607250,104624,851711874,8,0,0,43520,12,929165891
17043,851617710,131868,851749578,8,0,0,26112,12,7684902718
17044,851619370,183572,851802942,5,0,0,39936,19,4266362642
17045,851669360,206320,851875680,3,0,0,50688,2,6376324137
17046,851716250,123244,851839494,8,0,0,27136,12,10014189276
17047,851739650,110584,851850234,8,0,0,21504,12,720759410
17048,851798120,158098,851956218,2,0,0,87040,4,9310214424
17049,851856900,122536,851979436,2,0,0,19968,4,6187844526
17050,851883389,73468,851956857,1,0,0,2048,6,10257403914
17051,852100000,106028,852206028,3,0,0,48128,2,1398238053
17052,852154911,78352,852233263,6,0,0,6144,12,283240330
17053,852173780,57596,852231376,4,0,0,5120,16,7248911860
17054,852182520,78992,852261512,5,0,0,14848,19,4083073449
17055,852207071,139971,852347042,6,0,0,67584,12,7346819434
17056,852293680,2470,852296150,0,0,1,2560,11,1129050120
17057,852377170,81932,852459102,4,0,0,19456,16,614247050
17058,852403899,14804,852418703,3,0,1,28672,2,8924044100
17059,852442241,48980,852491221,6,0,0,2048,12,8904968086
17060,852520350,81128,852601478,8,0,0,11776,12,9344160132
17061,852555110,62516,852617626,3,0,0,6144,2,3827786405
17062,852571300,109206,852680506,3,0,0,51200,2,2766910869
17063,852578080,58864,852636944,8,0,0,1024,12,759164556
17064,852578739,80996,852659735,7,0,0,16384,8,1636333418
17065,852694850,4420,852699270,1,0,1,11776,6,9310151112
17066,852742730,2470,852745200,0,0,1,2560,11,8324565196
17067,852773360,166221,852939581,4,0,0,14848,16,8937505409
17068,852837260,1042,852838302,0,0,1,1024,11,4144111578
17069,852840859,111529,852952388,1,0,0,41984,6,2533204694
17070,852855820,1994,852857814,4,0,1,2048,16,3948448978
17071,852883859,115900,852999759,7,0,0,7680,8,10626468131
17072,852907180,4850,852912030,4,0,1,5120,16,9939237495
17073,852908659,74030,852982689,1,0,0,7168,6,7502885484
17074,852948790,88374,853037164,3,0,0,4608,2,3188692163
17075,852957380,88513,853045893,3,0,0,11776,2,9238939157
17076,853034549,113741,853148290,1,0,0,45568,6,9390873345
17077,853055220,79132,853134352,8,0,0,13824,12,3741246576
17078,853064429,86840,853151269,1,0,0,9728,6,6877714117
17079,853138330,75447,853213777,2,0,0,6144,4,9094876417
17080,853144360,112473,853256833,5,0,0,16384,19,3405891577
17081,853215850,107001,853322851,2,0,0,35328,4,1913087701
17082,853232380,125109,853357489,3,0,0,11776,2,8788886286
17083,853255840,8691,853264531,4,0,1,8192,16,6539698340
17084,853260460,153669,853414129,9,0,0,36352,18,8490377697
17085,853317869,8396,853326265,8,0,1,3584,12,4419588639
17086,853334990,184366,853519356,5,0,0,47616,19,3931003316
17087,853353700,111411,853465111,2,0,0,26112,4,9674567647
17088,853436971,151583,853588554,6,0,0,56832,12,6451458956
17089,853495949,165187,853661136,1,0,0,67072,6,6450548427
17090,853510539,173232,853683771,1,0,0,74240,6,5937175101
17091,853516810,170408,853687218,8,0,0,11264,12,1419340730
17092,853524029,2470,853526499,8,0,1,2560,12,6596368944
17093,853594540,566,853595106,7,0,1,512,8,9818929471
17094,853607891,111796,853719687,6,0,0,28672,12,9393935700
17095,853652111,129811,853781922,6,0,0,26112,12,6055235296
17096,853655060,131111,853786171,5,0,0,9728,19,5507463160
17097,853779499,6687,853786186,2,0,1,1536,4,9434046846
17098,853872520,104743,853977263,8,0,0,23040,12,9671716201
17099,853887869,58220,853946089,1,0,0,7168,6,4167647989
17100,853917840,2946,853920786,9,0,1,3072,18,2181929412
17101,854011841,125028,854136869,6,0,0,44544,12,8480275575
17102,854093049,66992,854160041,1,0,0,10752,6,6345876271
17103,854302710,2470,854305180,6,0,1,2560,12,10307766668
17104,854303950,47288,854351238,2,0,0,1536,4,6640094516
17105,854373450,10241,854383691,6,0,1,16384,12,694839473
17106,854398710,64208,854462918,0,0,0,6656,11,4058344240
17107,854410600,4937,854415537,1,0,1,12800,6,5509932776
17108,854428900,101621,854530521,4,0,0,18944,16,5628298142
17109,854519310,104780,854624090,0,0,0,44032,11,612382636
17110,854520279,53778,854574057,1,0,0,1536,6,2551241848
17111,854520790,239550,854760340,0,0,0,34304,11,4695232738
17112,854570870,132535,854703405,3,0,0,5120,2,4221281167
17113,854590380,69838,854660218,5,0,0,14336,19,4536502511
17114,854597510,104312,854701822,3,0,0,42496,2,361028000
17115,854639709,6278,854645987,3,0,1,6656,2,4461950971
17116,854659009,271346,854930355,1,0,0,115712,6,3365347750
17117,854674600,217278,854891878,2,0,0,71680,4,416727002
17118,854690660,121128,854811788,8,0,0,6144,12,4667166478
17119,854706760,137190,854843950,3,0,0,23040,2,1534500495
17120,854735660,197362,854933022,3,0,0,8704,2,10214068027
17121,854796930,5454,854802384,5,0,1,13824,19,8768996668
17122,854967220,70532,855037752,5,0,0,12288,19,8207307860
17123,855009611,99788,855109399,6,0,0,27648,12,7999548104
17124,855068700,86540,855155240,2,0,0,19456,4,6055992048
17125,855212700,57752,855270452,9,0,0,5632,18,2806100061
17126,855237250,3898,855241148,9,0,1,4096,18,5846716890
17127,855352649,97004,855449653,7,0,0,23552,8,2612180704
17128,855581429,84824,855666253,7,0,0,13824,8,2976353277
17129,855581610,3898,855585508,7,0,1,4096,8,2598695379
17130,855604710,79801,855684511,8,0,0,2048,12,9549843193
17131,855642370,103064,855745434,0,0,0,38400,11,3265219096
17132,855654330,55748,855710078,4,0,0,4096,16,454853365
17133,855672169,7230,855679399,8,0,1,7680,12,2208530065
17134,855820360,47288,855867648,2,0,0,1536,4,2845374761
17135,855835100,4374,855839474,7,0,1,4608,8,3073826146
17136,855865059,106065,855971124,1,0,0,41472,6,965282738
17137,855924760,131120,856055880,0,0,0,19968,11,9865021847
17138,855972240,65900,856038140,0,0,0,7168,11,9707580616
17139,856065370,55748,856121118,8,0,0,4096,12,5788716789
17140,856093380,60380,856153760,4,0,0,9216,16,4836942452
17141,856117980,99944,856217924,9,0,0,28160,18,3014172427
17142,856133790,69284,856203074,3,0,0,8192,2,5557460909
17143,856211600,7358,856218958,9,0,1,1024,18,6058997073
17144,856230269,566,856230835,3,0,1,512,2,9960633700
17145,856273061,72668,856345729,6,0,0,9216,12,4878908608
17146,856281549,115388,856396937,1,0,0,78848,6,5867305201
17147,856295301,181868,856477169,6,0,0,42496,12,4937156161
17148,856374660,25691,856400351,4,0,1,3584,16,9479893706
17149,856439710,69776,856509486,3,0,0,14848,2,3557822993
17150,856474880,111400,856586280,9,0,0,38912,18,9894636039
17151,856619151,83936,856703087,6,0,0,20992,12,5243026348
17152,856624010,85956,856709966,0,0,0,22528,11,1908190955
17153,856845269,69308,856914577,7,0,0,13312,8,9358738669
17154,857016480,48980,857065460,9,0,0,2048,18,2465461444
17155,857021601,70220,857091821,6,0,0,11264,12,7410591959
17156,857042290,91789,857134079,8,0,0,7680,12,4379858403
17157,857050240,153727,857203967,5,0,0,105984,19,3973056997
17158,857088850,168355,857257205,3,0,0,52736,2,2060188343
17159,857144770,243631,857388401,5,0,0,45056,19,3447363426
17160,857150299,154654,857304953,1,0,0,48128,6,4092970443
17161,857237671,117184,857354855,6,0,0,4096,12,7008399867
17162,857246000,82173,857328173,3,0,0,8704,2,4171599236
17163,857267620,103574,857371194,3,0,0,34304,2,3820961253
17164,857318640,112655,857431295,3,0,0,10752,2,2073157695
17165,857339750,76317,857416067,9,0,0,6144,18,8607148265
17166,857352359,69709,857422068,1,0,0,8192,6,4385799266
17167,857412250,14117,857426367,1,0,1,24064,6,6610034208
17168,857463600,214723,857678323,9,0,0,73728,18,1267554052
17169,857540829,89612,857630441,1,0,0,19456,6,2972330212
17170,857711790,60536,857772326,0,0,0,9728,11,3036433269
17171,857746831,98852,857845683,6,0,0,24576,12,8100287897
17172,857779150,214637,857993787,0,0,0,49664,11,1567434282
17173,857791000,170170,857961170,5,0,0,22016,19,5733191514
17174,857808370,146069,857954439,4,0,0,76800,16,2764935807
17175,857944930,115823,858060753,8,0,0,41472,12,6540192083
17176,857970110,48980,858019090,3,0,0,2048,2,4102328065
17177,858172300,86096,858258396,8,0,0,23040,12,9898610628
17178,858308420,4374,858312794,9,0,1,4608,18,9157415075
17179,858319111,99320,858418431,6,0,0,26112,12,98988312
17180,858363610,116899,858480509,4,0,0,64512,16,3926240390
17181,858369489,139113,858508602,7,0,0,70144,8,4981959657
17182,858410599,98338,858508937,1,0,0,1024,6,3715912079
17183,858436840,3422,858440262,0,0,1,3584,11,9636364402
17184,858443900,153358,858597258,9,0,0,61440,18,1704437700
17185,858448930,3898,858452828,1,0,1,4096,6,9072610043
17186,858471570,55479,858527049,5,0,0,512,19,97573062
17187,858504140,183233,858687373,9,0,0,41984,18,10123381669
17188,858657660,60980,858718640,4,0,0,6144,16,9010021531
17189,858771910,54056,858825966,4,0,0,3584,16,9751739647
17190,858813660,123968,858937628,3,0,0,107008,2,10616028714
17191,858872790,117650,858990440,3,0,0,20992,2,1248578959
17192,858881120,88056,858969176,4,0,0,6656,16,10144477450
17193,858936420,105158,859041578,4,0,0,11264,16,47531839
17194,858949539,172495,859122034,7,0,0,96256,8,854615077
17195,858949680,141002,859090682,5,0,0,1024,19,9869270602
17196,858954920,70976,859025896,8,0,0,8704,12,10502737288
17197,858975130,187402,859162532,2,0,0,18944,4,520309561
17198,859098270,128692,859226962,8,0,0,44544,12,8346540486
17199,859154289,1518,859155807,8,0,1,1536,12,7383881350
17200,859162060,78408,859240468,9,0,0,2048,18,9799210740
17201,859190390,195463,859385853,2,0,0,38912,4,4237220181
17202,859210050,98932,859308982,3,0,0,29184,2,6868175294
17203,859219849,97629,859317478,1,0,0,6656,6,4183055323
17204,859284999,54056,859339055,7,0,0,3584,8,7154170316
17205,859335020,566,859335586,7,0,1,512,8,5841562683
17206,859383429,99864,859483293,1,0,0,19968,6,1024714432
17207,859394769,72668,859467437,1,0,0,9216,6,9092021157
17208,859426280,138799,859565079,3,0,0,60416,2,9179006604
17209,859562500,78623,859641123,8,0,0,10240,12,5961807777
17210,859662509,72224,859734733,1,0,0,12800,6,7784776981
17211,859760961,51140,859812101,6,0,0,4096,12,1913012381
17212,859847340,43904,859891244,0,0,0,512,11,2735529762
17213,859905210,66080,859971290,3,0,0,12800,2,5972674706
17214,859951259,5712,859956971,2,0,1,14336,4,1361506209
17215,860000900,57440,860058340,5,0,0,4608,19,4530380897
17216,860087929,72536,860160465,1,0,0,13824,6,1821537871
17217,860132870,51296,860184166,0,0,0,4608,11,2806480027
17218,860135970,171340,860307310,5,0,0,13312,19,5204038570
17219,860154490,115362,860269852,3,0,0,57856,2,7273567331
17220,860193681,77902,860271583,6,0,0,5632,12,9003752397
17221,860350350,87320,860437670,8,0,0,22016,12,7619373259
17222,860378480,136272,860514752,8,0,0,41984,12,5193850676
17223,860466459,3422,860469881,2,0,1,3584,4,2447175481
17224,860500070,111606,860611676,8,0,0,60416,12,6590268721
17225,860528840,112434,860641274,8,0,0,10240,12,827866940
17226,860637150,98072,860735222,3,0,0,22016,2,7828946010
17227,860688290,92550,860780840,3,0,0,14336,2,54372462
17228,860896160,43904,860940064,2,0,0,512,4,5106998759
17229,860911560,78080,860989640,9,0,0,16896,18,3253550411
17230,860952231,101504,861053735,6,0,0,33280,12,6506102997
17231,860992830,68996,861061826,9,0,0,12288,18,7795726740
17232,861092890,79436,861172326,0,0,0,11264,11,9646996896
17233,861156730,103844,861260574,8,0,0,40960,12,2086001391
17234,861166140,138438,861304578,4,0,0,24064,16,7666233077
17235,861290350,94976,861385326,8,0,0,16896,12,5635816348
17236,861347400,61136,861408536,2,0,0,6656,4,4341949075
17237,861359770,4374,861364144,7,0,1,4608,8,2178321625
17238,861429929,43904,861473833,7,0,0,512,8,9891802627
17239,861455021,81596,861536617,6,0,0,13312,12,3778589084
17240,861465499,6278,861471777,2,0,1,6656,4,9013511378
17241,861488019,64232,861552251,7,0,0,11776,8,1720761685
17242,861494420,73679,861568099,9,0,0,4608,18,9871451549
17243,861546360,566,861546926,5,0,1,512,19,988715479
17244,861550479,104672,861655151,1,0,0,37888,6,6139725441
17245,861584830,121591,861706421,8,0,0,23552,12,1890133613
17246,861597881,84092,861681973,6,0,0,21504,12,5231770923
17247,861613940,255468,861869408,9,0,0,40448,18,2490950365
17248,861617220,141055,861758275,5,0,0,38912,19,437798687
17249,861619410,150112,861769522,5,0,0,36864,19,6411471042
17250,861630140,151775,861781915,4,0,0,35840,16,9926098923
17251,861648599,230860,861879459,1,0,0,21504,6,5764480962
17252,861682180,228363,861910543,0,0,0,19968,11,8846838269
17253,861690790,162364,861853154,9,0,0,16384,18,2101302732
17254,861725501,120393,861845894,6,0,0,7680,12,7729367559
17255,861732689,124380,861857069,7,0,0,12800,8,10173590622
17256,861774370,10959,861785329,4,0,1,3584,16,2557736209
17257,861786449,137866,861924315,1,0,0,22528,6,3525063106
17258,861799980,164576,861964556,8,0,0,17920,12,10232654583
17259,861825050,267035,862092085,4,0,0,113152,16,346324277
17260,861843360,214226,862057586,9,0,0,65024,18,857419936
17261,861922989,196278,862119267,1,0,0,34816,6,5688436911
17262,861954209,173185,862127394,1,0,0,26624,6,5249305894
17263,861963640,57280,862020920,5,0,0,6144,19,6144222837
17264,861971019,2470,861973489,2,0,1,2560,4,767497183
17265,861979229,129407,862108636,7,0,0,54272,8,10103519534
17266,862016289,214207,862230496,1,0,0,19456,6,6090185621
17267,862019720,176489,862196209,5,0,0,11776,19,8911010076
17268,862039979,99279,862139258,1,0,0,8192,6,5880977376
17269,862075909,143731,862219640,7,0,0,44032,8,1557373614
17270,862177980,144130,862322110,2,0,0,92160,4,9777044540
17271,862193779,7101,862200880,8,0,1,12288,12,3102920181
17272,862208830,23368,862232198,9,0,1,20992,18,7582622534
17273,862265650,4374,862270024,1,0,1,4608,6,480595479
17274,862332250,1042,862333292,0,0,1,1024,11,10172236280
17275,862338100,121763,862459863,3,0,0,26112,2,2995694366
17276,862345301,65900,862411201,6,0,0,7168,12,3153998731
17277,862421550,10757,862432307,0,0,1,17408,11,4229650549
17278,862431870,81597,862513467,2,0,0,10752,4,2136195654
17279,862435340,177585,862612925,4,0,0,96768,16,7796881072
17280,862435480,74696,862510176,0,0,0,15872,11,5447317265
17281,862456361,80892,862537253,6,0,0,9728,12,3723337447
17282,862588100,114453,862702553,5,0,0,24576,19,1920039594
17283,862597670,18659,862616329,1,0,1,9728,6,6099361924
17284,862614670,101977,862716647,3,0,0,9216,2,8852998797
17285,862741690,65900,862807590,3,0,0,7168,2,4279959599
17286,862771070,102752,862873822,8,0,0,37376,12,7485313475
17287,862797830,93134,862890964,8,0,0,16896,12,4043816869
17288,862831680,138574,862970254,8,0,0,49152,12,10484248231
17289,862889560,2914,862892474,4,0,1,1536,16,7140157666
17290,862891719,85258,862976977,7,0,0,22016,8,8721219943
17291,862900780,53922,862954702,8,0,0,1024,12,6247072675
17292,862918270,141046,863059316,9,0,0,11264,18,7703720436
17293,862919030,134415,863053445,9,0,0,10240,18,10697710058
17294,862928850,87608,863016458,9,0,0,17920,18,8085769971
17295,862974489,141698,863116187,1,0,0,18432,6,4835611860
17296,862976770,60867,863037637,3,0,0,5120,2,9172809605
17297,863019120,1518,863020638,1,0,1,1536,6,5092285801
17298,863169010,67592,863236602,4,0,0,7680,16,7436022495
17299,863245160,107432,863352592,4,0,0,52736,16,5364947491
17300,863356010,109928,863465938,0,0,0,60928,11,3327246101
17301,863380861,145656,863526517,6,0,0,3072,12,222999811
17302,863413640,111926,863525566,8,0,0,52736,12,2411672527
17303,863561730,1042,863562772,7,0,1,1024,8,2342900855
17304,863592289,6278,863598567,2,0,1,6656,4,8000511036
17305,863614079,43904,863657983,1,0,0,512,6,4475024780
17306,863663299,156562,863819861,7,0,0,9728,8,1734482886
17307,863700050,82820,863782870,8,0,0,12288,12,8599629181
17308,863732390,4679,863737069,6,0,1,12288,12,1153780556
17309,863745501,130760,863876261,6,0,0,56832,12,10514182439
17310,863768310,132713,863901023,3,0,0,48128,2,7539556256
17311,863781740,124914,863906654,8,0,0,18432,12,4985812069
17312,863865060,130982,863996042,4,0,0,87040,16,10062106133
17313,863871420,10660,863882080,1,0,1,6144,6,10628391783
17314,864032629,104156,864136785,1,0,0,41984,6,5072372324
17315,864050740,98540,864149280,5,0,0,23552,19,1629301492
17316,864056130,153489,864209619,0,0,0,73216,11,2244724236
17317,864167749,1994,864169743,3,0,1,2048,2,8712289356
17318,864230549,104312,864334861,1,0,0,42496,6,7557637562
17319,864277301,59135,864336436,6,0,0,5120,12,4853731691
17320,864373319,106964,864480283,7,0,0,51200,8,1469725363
17321,864374091,118999,864493090,6,0,0,41984,12,7965029472
17322,864443850,121969,864565819,0,0,0,32256,11,6385122289
17323,864484989,29492,864514481,2,0,1,34816,4,9884802738
17324,864515760,222479,864738239,2,0,0,24576,4,7149101510
17325,864563410,104373,864667783,3,0,0,34816,2,3764134502
17326,864672751,103064,864775815,6,0,0,38400,12,7982388322
17327,864676100,136975,864813075,8,0,0,24576,12,8421808230
17328,864703960,117577,864821537,8,0,0,13824,12,9989263633
17329,864741740,75570,864817310,2,0,0,13824,4,1949745582
17330,864782509,127262,864909771,7,0,0,92672,8,10191271856
17331,864788479,123179,864911658,7,0,0,6144,8,9632843775
17332,864807010,111911,864918921,2,0,0,5632,4,5634932188
17333,864831310,150095,864981405,5,0,0,53248,19,1513282935
17334,864841611,156030,864997641,6,0,0,10752,12,7989635401
17335,864846489,140235,864986724,1,0,0,17408,6,5341205821
17336,865004569,1042,865005611,2,0,1,1024,4,9944520522
17337,865036559,67148,865103707,1,0,0,11264,6,1255189426
17338,865092080,118196,865210276,5,0,0,88064,19,4744196472
17339,865187509,26163,865213672,3,0,1,9728,2,1289975207
17340,865204810,74167,865278977,0,0,0,11264,11,2792764888
17341,865250180,101379,865351559,2,0,0,21504,4,8924001495
17342,865291790,45596,865337386,5,0,0,1024,19,7022780959
17343,865336810,118820,865455630,5,0,0,90112,19,4310692848
17344,865474730,45596,865520326,8,0,0,1024,12,6659306624
17345,865530750,4420,865535170,6,0,1,11776,12,2471691539
17346,865558920,57440,865616360,0,0,0,4608,11,5115055486
17347,865588000,172883,865760883,9,0,0,53760,18,5065128405
17348,865720951,98852,865819803,6,0,0,24576,12,1351862899
17349,865756309,8728,865765037,3,0,1,11264,2,8772934146
17350,865771210,54056,865825266,5,0,0,3584,19,4036394356
17351,865777360,15062,865792422,1,0,1,29184,6,7231572888
17352,865789199,5196,865794395,2,0,1,13312,4,4093244035
17353,865792241,128159,865920400,6,0,0,28672,12,10459019122
17354,865842519,174449,866016968,1,0,0,17408,6,8808941884
17355,865934280,88184,866022464,9,0,0,10240,18,1976623707
17356,865968580,74360,866042940,0,0,0,9728,11,874438122
17357,866025630,63270,866088900,0,0,0,2048,11,7194149016
17358,866159779,102596,866262375,1,0,0,36864,6,141710590
17359,866181790,109151,866290941,5,0,0,28672,19,10040507766
17360,866307870,114452,866422322,8,0,0,75776,12,5119116413
17361,866357780,124800,866482580,5,0,0,45568,19,1947433370
17362,866442440,70532,866512972,9,0,0,12288,18,3593413751
17363,866458410,55669,866514079,0,0,0,3584,11,1779675086
17364,866485830,124222,866610052,5,0,0,31232,19,1578951045
17365,866499340,66212,866565552,0,0,0,8192,11,2607680797
17366,866531800,6278,866538078,7,0,1,6656,8,9868272992
17367,866557531,52692,866610223,6,0,0,512,12,6703453820
17368,866610960,6488,866617448,9,0,1,15872,18,3638355375
17369,866625141,113072,866738213,6,0,0,25088,12,7412261050
17370,866630729,84824,866715553,7,0,0,13824,8,9550045027
17371,866650900,145423,866796323,0,0,0,28160,11,3526862023
17372,866674550,66056,866740606,3,0,0,7680,2,7374722095
17373,866836040,101660,866937700,3,0,0,33792,2,536329792
17374,866851349,102440,866953789,1,0,0,36352,6,5571188939
17375,867041199,98228,867139427,7,0,0,22528,8,202617461
17376,867110930,67592,867178522,3,0,0,7680,2,4080415019
17377,867158301,61729,867220030,6,0,0,512,12,644990325
17378,867261730,4374,867266104,9,0,1,4608,18,1091453958
17379,867375670,103064,867478734,3,0,0,38400,2,5827439917
17380,867376540,52364,867428904,8,0,0,3072,12,6491466175
17381,867426930,201737,867628667,3,0,0,103424,2,3270914972
17382,867456639,106808,867563447,1,0,0,50688,6,8588901528
17383,867502780,145922,867648702,4,0,0,27136,16,2817411839
17384,867511471,120019,867631490,6,0,0,9216,12,9734571333
17385,867746689,4850,867751539,8,0,1,5120,12,9942879261
17386,867823359,1042,867824401,2,0,1,1024,4,3511579797
17387,867880930,13341,867894271,0,0,1,22528,11,7885515300
17388,867951869,5712,867957581,8,0,1,14336,12,9647817315
17389,867964589,54056,868018645,1,0,0,3584,6,5385377192
17390,868070610,122156,868192766,8,0,0,20992,12,8388176474
17391,868276770,10241,868287011,4,0,1,16384,16,8503861353
17392,868300060,109735,868409795,2,0,0,43520,4,7668185380
17393,868543530,109772,868653302,3,0,0,60416,2,10714369231
17394,868639199,103839,868743038,1,0,0,14848,6,8367296704
17395,868707320,85013,868792333,3,0,0,9216,2,5782921448
17396,868719660,136639,868856299,9,0,0,16384,18,3074555889
17397,868761531,107572,868869103,6,0,0,28160,12,7534938097
17398,868776960,64843,868841803,0,0,0,4096,11,3793704741
17399,868817731,68364,868886095,6,0,0,1024,12,4884690827
17400,868840680,3109,868843789,9,0,1,2048,18,10619678514
17401,868962220,5802,868968022,0,0,1,6144,11,290817889
17402,868977369,96824,869074193,1,0,0,17920,6,2830222013
17403,869069499,120698,869190197,7,0,0,80896,8,9263186307
17404,869107749,132734,869240483,7,0,0,53248,8,10495481147
17405,869116919,73605,869190524,1,0,0,1024,6,7435046557
17406,869142650,4162,869146812,0,0,1,11264,11,7385186647
17407,869210500,92996,869303496,9,0,0,20480,18,9490285407
17408,869319360,84716,869404076,0,0,0,15360,11,3402541234
17409,869332840,5712,869338552,0,0,1,14336,11,6588975442
17410,869399700,90572,869490272,9,0,0,13312,18,7424752864
17411,869465650,92372,869558022,8,0,0,18432,12,10090731614
17412,869495080,135818,869630898,8,0,0,18432,12,2177230539
17413,869650529,85160,869735689,1,0,0,19968,6,2575789040
17414,869762789,83132,869845921,1,0,0,13312,6,2885536423
17415,869794660,51900,869846560,3,0,0,2048,2,1843662030
17416,869882349,97628,869979977,7,0,0,25600,8,860355757
17417,869945860,109021,870054881,3,0,0,32256,2,6153298738
17418,870097200,87944,870185144,0,0,0,24064,11,8198595587
17419,870167201,72668,870239869,6,0,0,9216,12,7256283108
17420,870228840,1518,870230358,5,0,1,1536,19,7883707477
17421,870237490,177011,870414501,3,0,0,13824,2,9343424823
17422,870464470,69752,870534222,0,0,0,9728,11,5598167163
17423,870497461,59183,870556644,6,0,0,1536,12,3354847966
17424,870638770,566,870639336,9,0,1,512,18,5154943799
17425,870765130,52364,870817494,0,0,0,3072,11,10345468657
17426,871008170,1994,871010164,5,0,1,2048,19,4001989358
17427,871075669,105092,871180761,7,0,0,45056,8,4917963029
17428,871236790,77612,871314402,5,0,0,15360,19,7262063315
17429,871343640,11274,871354914,9,0,1,18432,18,2614005988
17430,871440299,101660,871541959,7,0,0,33792,8,7944254702
17431,871480240,4374,871484614,6,0,1,4608,12,2283017816
17432,871482410,6070,871488480,4,0,1,6144,16,9485135766
17433,871523149,128158,871651307,7,0,0,4608,8,54972323
17434,871547439,153699,871701138,1,0,0,24064,6,9252306226
17435,871550280,186792,871737072,8,0,0,14848,12,9820873003
17436,871725320,115540,871840860,5,0,0,55808,19,1817325512
17437,871729039,8048,871737087,8,0,1,11776,12,1452895531
17438,871794270,102084,871896354,5,0,0,25088,19,8039312584
17439,871820620,119524,871940144,3,0,0,21504,2,8372082352
17440,871875040,109528,871984568,9,0,0,13824,18,279817128
17441,871925091,111821,872036912,6,0,0,39424,12,10549812269
17442,871991930,80250,872072180,8,0,0,11776,12,945408188
17443,872082780,111956,872194736,8,0,0,67584,12,308023180
17444,872151559,47971,872199530,1,0,0,1536,6,5814794181
17445,872183539,13183,872196722,2,0,1,2048,4,2966074395
17446,872203169,67460,872270629,7,0,0,12288,8,3232847665
17447,872235460,72668,872308128,0,0,0,9216,11,10176469123
17448,872242380,112892,872355272,5,0,0,70656,19,3686337198
17449,872296679,131829,872428508,1,0,0,16384,6,6702297500
17450,872335371,135527,872470898,6,0,0,8192,12,877194148
17451,872350419,60437,872410856,7,0,0,3584,8,5839308651
17452,872383521,97316,872480837,6,0,0,24576,12,2281362126
17453,872429890,66524,872496414,8,0,0,9216,12,5702004560
17454,872548570,61136,872609706,8,0,0,6656,12,8973772506
17455,872601500,47288,872648788,8,0,0,1536,12,10444467075
17456,872635210,98228,872733438,8,0,0,22528,12,6663811804
17457,872798571,64208,872862779,6,0,0,6656,12,2407736306
17458,872811031,131818,872942849,6,0,0,41472,12,877519579
17459,872862420,44255,872906675,0,0,0,512,11,6091007115
17460,873145701,48980,873194681,6,0,0,2048,12,4798353931
17461,873291440,12825,873304265,7,0,1,21504,8,6888202203
17462,873492360,4679,873497039,9,0,1,12288,18,4939717332
17463,873521469,104312,873625781,7,0,0,42496,8,4390723501
17464,873535619,96885,873632504,7,0,0,22016,8,1712914691
17465,873566270,162877,873729147,5,0,0,23552,19,5074872100
17466,873596379,59842,873656221,7,0,0,4096,8,7714580734
17467,873628250,124051,873752301,9,0,0,24576,18,6768891278
17468,873641161,55748,873696909,6,0,0,4096,12,10106774700
17469,873864270,52364,873916634,8,0,0,3072,12,7818667197
17470,873882850,75140,873957990,9,0,0,12288,18,2754642938
17471,873926799,65900,873992699,7,0,0,7168,8,8997755847
17472,873962730,6278,873969008,7,0,1,6656,8,619611657
17473,874127931,76052,874203983,6,0,0,10240,12,10035983781
17474,874137489,126878,874264367,1,0,0,47104,6,1123299215
17475,874146310,143642,874289952,3,0,0,6656,2,3473829067
17476,874147659,124523,874272182,7,0,0,25600,8,5416855411
17477,874158059,4420,874162479,3,0,1,11776,2,7668398258
17478,874183899,54056,874237955,1,0,0,3584,6,3476340705
17479,874190820,171606,874362426,8,0,0,26624,12,7981013951
17480,874198020,243696,874441716,0,0,0,58880,11,6244024466
17481,874349689,145696,874495385,1,0,0,14848,6,10091691756
17482,874374921,142319,874517240,6,0,0,71680,12,4709479043
17483,874403350,143353,874546703,3,0,0,10752,2,9992035293
17484,874404770,5326,874410096,4,0,1,5632,16,751937356
17485,874406160,131111,874537271,8,0,0,30208,12,3144401774
17486,874496681,85698,874582379,6,0,0,4608,12,1696870718
17487,874646640,3422,874650062,6,0,1,3584,12,5033540673
17488,874743520,21141,874764661,0,0,1,34304,11,7796263931
17489,874797740,3422,874801162,1,0,1,3584,6,5656105775
17490,874800170,136826,874936996,8,0,0,45568,12,4729442850
17491,874833050,154676,874987726,9,0,0,14336,18,3542029893
17492,874888640,178352,875066992,5,0,0,41472,19,574772075
17493,874895930,11016,874906946,7,0,1,17920,8,2752368651
17494,874898320,81259,874979579,8,0,0,1536,12,3848812298
17495,874959320,114707,875074027,8,0,0,23040,12,9444202019
17496,875028620,111950,875140570,8,0,0,8704,12,4479784729
17497,875048090,87296,875135386,3,0,0,16896,2,1957211654
17498,875085031,87231,875172262,6,0,0,4608,12,1282493114
17499,875229470,82820,875312290,5,0,0,12288,19,2601000927
17500,875297140,112432,875409572,9,0,0,52224,18,6134413576
17501,875301820,1518,875303338,9,0,1,1536,18,976393525
17502,875432609,1042,875433651,8,0,1,1024,12,2662566976
17503,875620729,4374,875625103,8,0,1,4608,12,5586438834
17504,875634410,55748,875690158,9,0,0,4096,18,4482904805
17505,875642440,55148,875697588,9,0,0,7168,18,2124245784
17506,875652711,66285,875718996,6,0,0,5632,12,1940719656
17507,875701769,81284,875783053,1,0,0,12288,6,3127918600
17508,875757159,2946,875760105,3,0,1,3072,2,2384754243
17509,875761130,108680,875869810,5,0,0,56832,19,4723394731
17510,875821369,566,875821935,2,0,1,512,4,8759376780
17511,875882410,64208,875946618,0,0,0,6656,11,1620004336
17512,875904330,70976,875975306,0,0,0,8704,11,8165779498
17513,875911160,210388,876121548,0,0,0,191488,11,9281842588
17514,875950530,172593,876123123,9,0,0,5120,18,8944484725
17515,875983370,153785,876137155,0,0,0,7680,11,2185054228
17516,876021210,113590,876134800,3,0,0,23552,2,8640405766
17517,876042980,82186,876125166,9,0,0,6656,18,7826716027
17518,876115390,21780,876137170,7,0,1,5120,8,2056877201
17519,876224669,76052,876300721,1,0,0,10240,6,9854535619
17520,876239579,68996,876308575,1,0,0,12288,6,6641152276
17521,876288020,3128,876291148,0,0,1,9216,11,1357523598
17522,876299400,146353,876445753,8,0,0,111616,12,3395757360
17523,876317499,1518,876319017,3,0,1,1536,2,1172186418
17524,876328580,118904,876447484,3,0,0,5632,2,1248733803
17525,876358220,96479,876454699,2,0,0,13824,4,4625049903
17526,876387380,118416,876505796,5,0,0,24064,19,2977977002
17527,876405160,1994,876407154,0,0,1,2048,11,6104910544
17528,876458490,566,876459056,4,0,1,512,16,5999666182
17529,876477470,103631,876581101,0,0,0,22016,11,4295612672
17530,876580200,110821,876691021,9,0,0,60928,18,7083337236
17531,876589779,104221,876694000,7,0,0,9728,8,7185023368
17532,876604560,135943,876740503,9,0,0,25600,18,8513250338
17533,876692379,3131,876695510,2,0,1,1536,4,2828609520
17534,876723439,130858,876854297,7,0,0,11264,8,6646340087
17535,876738080,6789,876744869,6,0,1,4608,12,10034673610
17536,876829271,100704,876929975,6,0,0,26624,12,3104428589
17537,876893829,57146,876950975,1,0,0,2560,6,4468922723
17538,876922500,56447,876978947,8,0,0,2048,12,4939650175
17539,876986289,57440,877043729,7,0,0,4608,8,872531272
17540,877126690,116948,877243638,3,0,0,83968,2,3708750845
17541,877150760,101140,877251900,0,0,0,4096,11,2359936337
17542,877182290,158416,877340706,8,0,0,67584,12,10646397217
17543,877266920,128584,877395504,8,0,0,19456,12,5214616637
17544,877268610,48980,877317590,9,0,0,2048,18,6973820144
17545,877278500,64249,877342749,5,0,0,6656,19,8715233056
17546,877380370,54746,877435116,5,0,0,1024,19,5750848620
17547,877394710,112118,877506828,3,0,0,65536,2,8632524407
17548,877482419,24424,877506843,8,0,1,12800,12,7106260393
17549,877621260,77300,877698560,8,0,0,14336,12,7920023753
17550,877637740,1994,877639734,5,0,1,2048,19,1626319268
17551,877727491,193712,877921203,6,0,0,174592,12,6837391067
17552,877768210,5802,877774012,6,0,1,6144,12,9521901452
17553,877890159,35427,877925586,8,0,1,4608,12,628289868
17554,877917150,105418,878022568,0,0,0,28160,11,7472873512
17555,877927230,12825,877940055,5,0,1,21504,19,4718845686
17556,878069779,102440,878172219,1,0,0,36352,6,1594036899
17557,878175390,76832,878252222,9,0,0,12800,18,1760457356
17558,878284430,48980,878333410,9,0,0,2048,18,10061350069
17559,878336659,2470,878339129,2,0,1,2560,4,4672097006
17560,878424480,76364,878500844,4,0,0,11264,16,2309915531
17561,878548439,566,878549005,3,0,1,512,2,4556537275
17562,878630090,2946,878633036,0,0,1,3072,11,1352868917
17563,878716210,101348,878817558,0,0,0,32768,11,7565053186
17564,878723830,12566,878736396,4,0,1,20992,16,7151328252
17565,878807589,11479,878819068,3,0,1,1536,2,1091071103
17566,878989910,62516,879052426,8,0,0,6144,12,2342018738
17567,879028481,95180,879123661,6,0,0,27648,12,6241240388
17568,879086770,142407,879229177,8,0,0,83456,12,9233605283
17569,879094790,4679,879099469,4,0,1,12288,16,1631324106
17570,879096389,5140,879101529,3,0,1,3072,2,4251969481
17571,879175920,2946,879178866,4,0,1,3072,16,1426205640
17572,879179330,82269,879261599,0,0,0,11776,11,1459183607
17573,879302100,60980,879363080,3,0,0,6144,2,10093234810
17574,879343259,107120,879450379,7,0,0,51712,8,8577632753
17575,879401870,7706,879409576,4,0,1,8192,16,6032213447
17576,879427820,72668,879500488,3,0,0,9216,2,8896868675
17577,879467441,92693,879560134,6,0,0,12288,12,8433425886
17578,879517930,79772,879597702,3,0,0,17408,2,529690635
17579,879654590,78392,879732982,3,0,0,17920,2,4505867599
17580,879708399,45752,879754151,1,0,0,1536,6,8729214266
17581,879718981,67460,879786441,6,0,0,12288,12,2902126929
17582,879723249,122526,879845775,1,0,0,14336,6,849360957
17583,879836229,104312,879940541,7,0,0,42496,8,7684985557
17584,879852840,35571,879888411,4,0,1,62464,16,44112495
17585,879857520,98891,879956411,0,0,0,12800,11,2973479624
17586,879908209,185429,880093638,1,0,0,72704,6,4857358741
17587,879912471,80654,879993125,6,0,0,6144,12,6307611741
17588,879980379,7230,879987609,3,0,1,7680,2,5683877867
17589,880121490,3422,880124912,1,0,1,3584,6,4771652517
17590,880270330,3422,880273752,6,0,1,3584,12,4543747903
17591,880294749,57101,880351850,1,0,0,3584,6,7617847604
17592,880297630,566,880298196,9,0,1,512,18,8650368424
17593,880382459,78080,880460539,7,0,0,16896,8,1984142995
17594,880413609,72668,880486277,7,0,0,9216,8,6424480011
17595,880510580,96824,880607404,5,0,0,17920,19,713433118
17596,880524590,7230,880531820,1,0,1,7680,6,3687937225
17597,880647460,1042,880648502,0,0,1,1024,11,2537777907
17598,880696670,99788,880796458,8,0,0,27648,12,5672254267
17599,880716430,48980,880765410,0,0,0,2048,11,4308122120
17600,880804050,109928,880913978,8,0,0,60928,12,278940060
17601,880857270,3904,880861174,7,0,1,10752,8,10515835491
17602,880879280,2870,880882150,6,0,1,8704,12,7785375565
17603,880959389,128220,881087609,1,0,0,25600,6,7910817567
17604,880983270,1042,880984312,9,0,1,1024,18,6748135149
17605,881002020,97292,881099312,9,0,0,19456,18,193394682
17606,881061569,7230,881068799,2,0,1,7680,4,1940313542
17607,881065530,179038,881244568,8,0,0,4608,12,9060269751
17608,881123810,97136,881220946,9,0,0,18944,18,2461109405
17609,881184349,89480,881273829,7,0,0,24064,8,9618231106
17610,881195399,169411,881364810,7,0,0,64512,8,9126421258
17611,881210090,108827,881318917,5,0,0,3584,19,1165825073
17612,881221910,123229,881345139,0,0,0,25088,11,7611196345
17613,881322040,97292,881419332,5,0,0,19456,19,9205809883
17614,881445349,56216,881501565,1,0,0,5632,6,6380471509
17615,881503921,54056,881557977,6,0,0,3584,12,4901182068
17616,881508570,61916,881570486,9,0,0,9216,18,8460501493
17617,881532210,95468,881627678,3,0,0,23552,2,4472035136
17618,881652150,54368,881706518,0,0,0,4608,11,9111761109
17619,881720160,14029,881734189,4,0,1,27136,16,2920917950
17620,881757199,224439,881981638,1,0,0,40448,6,911557568
17621,881835590,3422,881839012,6,0,1,3584,12,1140172083
17622,881854910,168361,882023271,3,0,0,100352,2,2511023720
17623,881906080,11533,881917613,6,0,1,18944,12,3035767249
17624,881929379,125356,882054735,7,0,0,14848,8,8163421426
17625,881936910,135850,882072760,9,0,0,40960,18,245105669
17626,882156141,100256,882256397,6,0,0,29184,12,9456262294
17627,882309119,45596,882354715,7,0,0,1024,8,2407287267
17628,882322590,52364,882374954,3,0,0,3072,2,5385749374
17629,882336200,6754,882342954,9,0,1,7168,18,8460507621
17630,882364179,103844,882468023,7,0,0,40960,8,4236544719
17631,882455389,78154,882533543,1,0,0,11776,6,5248971196
17632,882458640,93131,882551771,0,0,0,15360,11,9151176100
17633,882482450,98763,882581213,3,0,0,15872,2,6895989202
17634,882540350,122175,882662525,5,0,0,13312,19,7624526017
17635,882864920,99008,882963928,8,0,0,25088,12,4409910450
17636,882904750,98208,883002958,0,0,0,20992,11,1720043741
17637,883013910,5326,883019236,5,0,1,5632,19,7768858644
17638,883175160,70976,883246136,5,0,0,8704,19,8462591463
17639,883175210,99008,883274218,0,0,0,25088,11,1696623540
17640,883177870,96519,883274389,0,0,0,512,11,4777813966
17641,883258890,4850,883263740,5,0,1,5120,19,7312370979
17642,883287640,106496,883394136,9,0,0,49664,18,5380766533
17643,883293830,3898,883297728,5,0,1,4096,19,3133406756
17644,883353400,69452,883422852,9,0,0,512,18,3281942528
17645,883441859,88676,883530535,7,0,0,16384,8,41690277
17646,883470690,6278,883476968,7,0,1,6656,8,3211995121
17647,883493729,122024,883615753,7,0,0,68096,8,10510244184
17648,883536579,149806,883686385,1,0,0,32768,6,3173965037
17649,883610789,87176,883697965,7,0,0,15360,8,8527430277
17650,883709409,109304,883818713,7,0,0,58880,8,2743895496
17651,883735960,59600,883795560,8,0,0,6656,12,6382462106
17652,883863710,86204,883949914,3,0,0,13312,2,9503275902
17653,883900410,55748,883956158,5,0,0,4096,19,2318452768
17654,883903089,4374,883907463,8,0,1,4608,12,196562920
17655,883904940,98852,884003792,3,0,0,24576,2,1101189952
17656,883921330,5326,883926656,4,0,1,5632,16,9888848541
17657,883945030,98564,884043594,9,0,0,28672,18,1496712711
17658,883997560,58588,884056148,5,0,0,3072,19,3386827033
17659,884057261,100412,884157673,6,0,0,29696,12,3080399576
17660,884098680,80684,884179364,9,0,0,15360,18,4927620424
17661,884109850,33075,884142925,5,0,1,54272,19,3312431455
17662,884115670,244173,884359843,5,0,0,20992,19,9070440581
17663,884228140,185649,884413789,0,0,0,20480,11,2608547218
17664,884229580,57440,884287020,8,0,0,4608,12,7968493313
17665,884275730,99944,884375674,2,0,0,28160,4,5024625116
17666,884511550,82820,884594370,5,0,0,12288,19,5017355588
17667,884548920,2470,884551390,0,0,1,2560,11,6123497891
17668,884577150,153843,884730993,3,0,0,66560,2,338599461
17669,884586520,148856,884735376,5,0,0,14336,19,6606112092
17670,884697609,107432,884805041,1,0,0,52736,6,508350641
17671,884868330,103376,884971706,5,0,0,39424,19,124618977
17672,884889360,163331,885052691,3,0,0,58368,2,10569539573
17673,884905529,129363,885034892,1,0,0,21504,6,4981394483
17674,885040050,114761,885154811,8,0,0,35328,12,9305176066
17675,885173820,1518,885175338,4,0,1,1536,16,1942092635
17676,885201259,4850,885206109,3,0,1,5120,2,1229860424
17677,885225400,2470,885227870,7,0,1,2560,8,10040844278
17678,885342220,54368,885396588,3,0,0,4608,2,7995695669
17679,885465259,103532,885568791,7,0,0,39936,8,4307218077
17680,885561270,9507,885570777,0,0,1,2048,11,6320261979
17681,885645470,107744,885753214,9,0,0,53760,18,3556296608
17682,885667950,133036,885800986,5,0,0,6656,19,6890527204
17683,885712649,7706,885720355,8,0,1,8192,12,4374954830
17684,885907860,566,885908426,6,0,1,512,12,3154570228
17685,885956060,107276,886063336,5,0,0,52224,19,3129912478
17686,885987031,78816,886065847,6,0,0,8192,12,3844962338
17687,885996599,4420,886001019,3,0,1,11776,2,3718092104
17688,886008870,58084,886066954,8,0,0,3584,12,9620455438
17689,886096089,103532,886199621,1,0,0,39936,6,3765497571
17690,886104851,103521,886208372,6,0,0,28672,12,1457187118
17691,886148340,106028,886254368,5,0,0,48128,19,9824990607
17692,886347810,43904,886391714,9,0,0,512,18,6243310303
17693,886356880,63362,886420242,5,0,1,106496,19,4583897035
17694,886363991,133871,886497862,6,0,0,14848,12,6473510760
17695,886424009,119014,886543023,7,0,0,5632,8,1716990206
17696,886436599,117872,886554471,7,0,0,23040,8,2598681871
17697,886505690,52364,886558054,5,0,0,3072,19,902187866
17698,886536750,108325,886645075,3,0,0,17408,2,2851764999
17699,886577860,58376,886636236,0,0,0,7680,11,5535967704
17700,886632020,26221,886658241,6,0,1,47616,12,3319036322
17701,886704390,74360,886778750,4,0,0,9728,16,7137128102
17702,886772571,105560,886878131,6,0,0,46592,12,10120200212
17703,886893360,92396,886985756,8,0,0,23552,12,10502326089
17704,886986450,90080,887076530,5,0,0,20992,19,1103957490
17705,886987101,56372,887043473,6,0,0,6144,12,7959368057
17706,887065381,104624,887170005,6,0,0,43520,12,9013377018
17707,887119530,5971,887125501,0,0,1,14848,11,267979036
17708,887264660,55748,887320408,5,0,0,4096,19,5037065543
17709,887306470,1518,887307988,7,0,1,1536,8,3220052473
17710,887332500,173929,887506429,3,0,0,9216,2,3813799432
17711,887335120,102596,887437716,9,0,0,36864,18,8331867964
17712,887381120,62516,887443636,8,0,0,6144,12,7343476938
17713,887461530,129469,887590999,5,0,0,53760,19,3393372264
17714,887559829,89300,887649129,7,0,0,18432,8,565850807
17715,887718739,74516,887793255,1,0,0,10240,6,9201632827
17716,887842360,3645,887846005,7,0,1,10240,8,893451171
17717,887947740,105872,888053612,9,0,0,47616,18,7086274827
17718,887978370,84272,888062642,4,0,0,512,16,4727933951
17719,888062580,4428,888067008,9,0,1,4608,18,4807801747
17720,888072330,168333,888240663,9,0,0,20992,18,5736798046
17721,888176180,64498,888240678,5,0,1,101888,19,7468838251
17722,888209340,231617,888440957,0,0,0,47104,11,3510734641
17723,888258400,149870,888408270,8,0,0,37376,12,2945344121
17724,888292490,176944,888469434,9,0,0,20992,18,4762759381
17725,888357850,57440,888415290,0,0,0,4608,11,5412569822
17726,888484690,2946,888487636,7,0,1,3072,8,2324388387
17727,888550070,76364,888626434,0,0,0,11264,11,6580763163
17728,888589270,81006,888670276,5,0,0,17920,19,9099278599
17729,888632830,98228,888731058,0,0,0,22528,11,6120735833
17730,888644250,4937,888649187,7,0,1,12800,8,9985802130
17731,888678529,54056,888732585,1,0,0,3584,6,9829418702
17732,888707560,65456,888773016,3,0,0,10752,2,4606699990
17733,888814940,84380,888899320,2,0,0,17408,4,6697601349
17734,888819310,97940,888917250,9,0,0,26624,18,10047398150
17735,889117800,107588,889225388,0,0,0,53248,11,6113865630
17736,889124640,1042,889125682,9,0,1,1024,18,5919738531
17737,889227240,99032,889326272,9,0,0,30208,18,9546861501
17738,889276430,73916,889350346,8,0,0,13312,12,309414926
17739,889379029,1042,889380071,8,0,1,1024,12,6304894992
17740,889382419,94532,889476951,7,0,0,20480,8,2138458529
17741,889448421,128533,889576954,6,0,0,9216,12,4012300048
17742,889454250,43904,889498154,8,0,0,512,12,6940456703
17743,889523070,75320,889598390,3,0,0,17920,2,4240194700
17744,889574410,71532,889645942,2,0,0,12288,4,4460846959
17745,889625681,52364,889678045,6,0,0,3072,12,4989393861
17746,889628020,2946,889630966,0,0,1,3072,11,2487102288
17747,889729599,62228,889791827,1,0,0,10240,6,5037916341
17748,889783101,62516,889845617,6,0,0,6144,12,7608168679
17749,889800439,104936,889905375,7,0,0,44544,8,7032338195
17750,889823979,96174,889920153,1,0,0,11264,6,4926895201
17751,889849530,2946,889852476,6,0,1,3072,12,3736708537
17752,889850459,85192,889935651,7,0,0,512,8,2675231461
17753,889934240,112736,890046976,3,0,0,70144,2,1564388099
17754,889940479,11791,889952270,3,0,1,19456,2,1978333577
17755,889972090,137016,890109106,9,0,0,46080,18,9872830999
17756,890091959,106340,890198299,7,0,0,49152,8,6057743061
17757,890173190,50672,890223862,0,0,0,2560,11,626772520
17758,890210040,106964,890317004,3,0,0,51200,2,2256031149
17759,890220471,106384,890326855,6,0,0,32256,12,984189006
17760,890283760,82820,890366580,5,0,0,12288,19,5803730596
17761,890284810,64700,890349510,2,0,0,512,4,2223255260
17762,890309820,94472,890404292,3,0,0,16896,2,9632724245
17763,890363069,120045,890483114,1,0,0,47616,6,8511310604
17764,890394349,566,890394915,8,0,1,512,12,5531157308
17765,890409710,115966,890525676,9,0,0,18432,18,2944786302
17766,890448260,66170,890514430,0,0,0,7168,11,351135048
17767,890454640,62682,890517322,3,0,0,1536,2,1463375427
17768,890625049,2946,890627995,8,0,1,3072,12,5403673950
17769,890644760,81596,890726356,8,0,0,13312,12,1590785149
17770,890719580,101192,890820772,0,0,0,32256,11,4444351155
17771,890768459,87887,890856346,1,0,0,11776,6,554791607
17772,890878690,104936,890983626,8,0,0,44544,12,310297272
17773,890879809,180758,891060567,7,0,0,16896,8,4589830113
17774,890913889,108071,891021960,7,0,0,23040,8,1612773152
17775,890948580,106824,891055404,2,0,0,47104,4,1419281544
17776,891126590,1994,891128584,7,0,1,2048,8,1707341718
17777,891222000,101972,891323972,9,0,0,34816,18,7727604832
17778,891386010,1994,891388004,6,0,1,2048,12,479379655
17779,891387750,134728,891522478,8,0,0,73728,12,7512637412
17780,891408650,115886,891524536,2,0,0,6656,4,6692530286
17781,891497940,1042,891498982,6,0,1,1024,12,420776055
17782,891499779,22714,891522493,3,0,1,4608,2,6216187343
17783,891628990,103376,891732366,3,0,0,39424,2,5812665797
17784,891693919,97691,891791610,7,0,0,14848,8,3175791742
17785,892013449,113672,892127121,7,0,0,73216,8,8995564205
17786,892041680,147391,892189071,9,0,0,43520,18,4848299183
17787,892132289,3904,892136193,3,0,1,10752,2,8889688312
17788,892161080,28006,892189086,1,0,1,29184,6,6402762878
17789,892162939,26162,892189101,8,0,1,16384,12,8712047367
17790,892174050,15066,892189116,4,0,1,9216,16,2134169861
17791,892264679,48980,892313659,7,0,0,2048,8,7124127201
17792,892271210,108368,892379578,0,0,0,55808,11,6945952359
17793,892407690,91796,892499486,9,0,0,26624,18,5491458115
17794,892413680,41908,892455588,5,0,1,68096,19,10139736621
17795,892434790,120387,892555177,0,0,0,29696,11,9580305153
17796,892471640,65927,892537567,3,0,0,1024,2,6781968849
17797,892524090,47288,892571378,2,0,0,1536,4,117814282
17798,892540110,151649,892691759,4,0,0,27648,16,1642932266
17799,892730740,72668,892803408,9,0,0,9216,18,1890560395
17800,892732450,77456,892809906,8,0,0,14848,12,765582103
17801,892777530,69558,892847088,3,0,0,9728,2,7743851030
17802,892787370,118578,892905948,0,0,0,46080,11,1289514803
17803,892865799,4850,892870649,3,0,1,5120,2,3413570392
17804,892881440,1518,892882958,4,0,1,1536,16,2243097929
17805,892940750,15062,892955812,6,0,1,29184,12,5288027815
17806,893125940,103688,893229628,3,0,0,40448,2,7485174514
17807,893221510,108210,893329720,2,0,0,28672,4,2683114858
17808,893247059,169487,893416546,7,0,0,30208,8,1467860118
17809,893276020,7706,893283726,7,0,1,8192,8,3266473147
17810,893277890,165503,893443393,0,0,0,88064,11,10459731807
17811,893308390,158769,893467159,9,0,0,22016,18,8470732483
17812,893347450,110244,893457694,3,0,0,11776,2,8105114800
17813,893377450,182259,893559709,8,0,0,97792,12,7697748821
17814,893648940,80372,893729312,2,0,0,14336,4,8577837430
17815,893799149,82868,893882017,1,0,0,22528,6,6527774151
17816,893811620,101192,893912812,9,0,0,32256,18,4664682486
17817,893871270,65900,893937170,4,0,0,7168,16,1980475564
17818,893914020,47288,893961308,2,0,0,1536,4,8443488309
17819,893924920,102908,894027828,4,0,0,37888,16,6118921636
17820,893927639,56372,893984011,7,0,0,6144,8,2201503607
17821,893933340,4850,893938190,9,0,1,5120,18,3834571293
17822,893949520,120158,894069678,0,0,0,12800,11,5021872587
17823,894040520,130823,894171343,9,0,0,93184,18,3348786585
17824,894128080,106968,894235048,0,0,0,38912,11,9689260790
17825,894197990,88232,894286222,2,0,0,19968,4,8237557295
17826,894290991,103064,894394055,6,0,0,38400,12,3137314127
17827,894295920,52364,894348284,2,0,0,3072,4,460076080
17828,894405230,63452,894468682,8,0,0,9216,12,3467634009
17829,894413770,105248,894519018,4,0,0,45568,16,4555261047
17830,894422299,103442,894525741,7,0,0,22016,8,9166992600
17831,894458770,86978,894545748,8,0,0,6144,12,1923848878
17832,894522870,46767,894569637,0,0,0,512,11,1869214244
17833,894533289,118323,894651612,7,0,0,47616,8,3037385972
17834,894544320,81816,894626136,2,0,0,19456,4,3138086030
17835,894620520,76009,894696529,2,0,0,11776,4,1743958992
17836,894624351,65959,894690310,6,0,0,5120,12,7190942723
17837,894630390,2470,894632860,7,0,1,2560,8,2310224300
17838,894642969,14437,894657406,3,0,1,6144,2,2587437044
17839,894763210,116012,894879222,2,0,0,80896,4,1214607564
17840,894855220,123470,894978690,9,0,0,26624,18,2735474443
17841,894945730,92060,895037790,4,0,0,17408,16,4248215425
17842,894965241,104780,895070021,6,0,0,44032,12,6164695057
17843,894978560,144292,895122852,0,0,0,68608,11,3228301944
17844,895126550,81128,895207678,2,0,0,11776,4,2467834980
17845,895285911,108836,895394747,6,0,0,57344,12,5899577789
17846,895412220,97760,895509980,8,0,0,20992,12,5841826429
17847,895421000,126654,895547654,2,0,0,88064,4,9796477094
17848,895525089,25503,895550592,3,0,1,3072,2,9601921429
17849,895574300,49292,895623592,2,0,0,3072,4,952184508
17850,895579560,195603,895775163,8,0,0,94208,12,1184417154
17851,895626100,2470,895628570,0,0,1,2560,11,8350880123
17852,895681940,99181,895781121,4,0,0,11776,16,1317580996
17853,895686919,90599,895777518,1,0,0,7680,6,4396100946
17854,895696419,118382,895814801,1,0,0,22016,6,9359905614
17855,895729200,6278,895735478,9,0,1,6656,18,8295215257
17856,895771300,203384,895974684,8,0,0,115200,12,6886261564
17857,895793540,146029,895939569,9,0,0,58880,18,6766639571
17858,895830500,55748,895886248,4,0,0,4096,16,6032743075
17859,895839830,153168,895992998,0,0,0,9216,11,3270585047
17860,895841830,133345,895975175,8,0,0,1536,12,4896674649
17861,895884660,137631,896022291,2,0,0,47616,4,6717296756
17862,895956030,90270,896046300,2,0,0,15872,4,4384891599
17863,895984460,97495,896081955,9,0,0,14336,18,7073412122
17864,896034941,93440,896128381,6,0,0,16896,12,3765769697
17865,896056460,148715,896205175,9,0,0,40960,18,4917858495
17866,896100750,169645,896270395,2,0,0,93696,4,6434864724
17867,896123610,216067,896339677,5,0,0,88064,19,4585332855
17868,896143419,1518,896144937,2,0,1,1536,4,9503452039
17869,896193880,149427,896343307,4,0,0,3072,16,7726814685
17870,896208689,64445,896273134,7,0,0,4608,8,3572530286
17871,896369039,3422,896372461,2,0,1,3584,4,6001354042
17872,896376070,97734,896473804,9,0,0,24064,18,4875785133
17873,896378619,173882,896552501,1,0,0,9728,6,4468806698
17874,896395251,54212,896449463,6,0,0,4096,12,9343356981
17875,896449890,99632,896549522,3,0,0,27136,2,13093004
17876,896506669,2946,896509615,2,0,1,3072,4,10578048682
17877,896551500,44897,896596397,3,0,0,512,2,9092864173
17878,896567801,74360,896642161,6,0,0,9728,12,9619084967
17879,896609690,96980,896706670,4,0,0,18432,16,195087548
17880,896659720,3422,896663142,9,0,1,3584,18,3218683250
17881,896736560,43904,896780464,2,0,0,512,4,9535174864
17882,896829760,74228,896903988,0,0,0,14336,11,10457290729
17883,896841490,118982,896960472,5,0,0,38400,19,1386692027
17884,896932400,117976,897050376,8,0,0,33792,12,6359509938
17885,896980110,1994,896982104,7,0,1,2048,8,5977317086
17886,897016830,153833,897170663,3,0,0,17408,2,5412817654
17887,897033650,101816,897135466,0,0,0,34304,11,8202115616
17888,897043039,11233,897054272,8,0,1,10752,12,2106824178
17889,897060889,7706,897068595,8,0,1,8192,12,4168623054
17890,897074679,111877,897186556,1,0,0,14336,6,5803710851
17891,897143890,157140,897301030,0,0,0,48640,11,1798303982
17892,897174710,2870,897177580,0,0,1,8704,11,9198171321
17893,897183269,102911,897286180,1,0,0,27136,6,2831644245
17894,897240940,5326,897246266,0,0,1,5632,11,7233126828
17895,897273250,12945,897286195,1,0,1,7168,6,6386287312
17896,897273290,76405,897349695,2,0,0,14336,4,1437755094
17897,897283530,299901,897583431,3,0,0,196096,2,9728588163
17898,897317481,60824,897378305,6,0,0,5632,12,9271070826
17899,897322129,81070,897403199,7,0,0,512,8,5934897787
17900,897331740,144533,897476273,9,0,0,17408,18,8178022489
17901,897335179,14531,897349710,3,0,1,18944,2,440991788
17902,897341640,60335,897401975,4,0,0,1536,16,7710741598
17903,897385600,206122,897591722,0,0,0,27136,11,1543513288
17904,897393260,89539,897482799,2,0,0,2048,4,9588468024
17905,897439229,4374,897443603,3,0,1,4608,2,7906436943
17906,897493719,117594,897611313,1,0,0,9216,6,8362691567
17907,897548640,110187,897658827,4,0,0,12800,16,8318394771
17908,897574090,219820,897793910,8,0,0,40448,12,1602411764
17909,897628440,87608,897716048,4,0,0,17920,16,5077509188
17910,897697690,53583,897751273,5,0,1,87552,19,7270511843
17911,897698261,293307,897991568,6,0,0,28672,12,10460394478
17912,897714980,42809,897757789,9,0,1,31232,18,6899988915
17913,897788579,132052,897920631,7,0,0,14336,8,2714472579
17914,897870220,137284,898007504,9,0,0,20480,18,2422326086
17915,897914210,83132,897997342,0,0,0,13312,11,2389410301
17916,897931400,108092,898039492,4,0,0,19456,16,2002655718
17917,898007080,98956,898106036,2,0,0,23552,4,17124951
17918,898067360,97940,898165300,0,0,0,26624,11,1098825163
17919,898321840,11274,898333114,7,0,1,18432,8,3648626449
17920,898344970,96311,898441281,9,0,0,27136,18,7152679651
17921,898363429,119510,898482939,1,0,0,26624,6,7841776537
17922,898378040,107722,898485762,4,0,0,9216,16,5571968471
17923,898387310,1042,898388352,4,0,1,1024,16,1846751288
17924,898487310,1994,898489304,9,0,1,2048,18,6627410793
17925,898516760,100100,898616860,8,0,0,28672,12,6657287469
17926,898520061,54212,898574273,6,0,0,4096,12,691543993
17927,898634130,92084,898726214,9,0,0,22528,18,4658218754
17928,898666220,13341,898679561,7,0,1,22528,8,6394774039
17929,898783070,2470,898785540,4,0,1,2560,16,6810762816
17930,898787900,62516,898850416,8,0,0,6144,12,365622772
17931,898809089,99476,898908565,7,0,0,26624,8,2224469938
17932,898871499,77012,898948511,1,0,0,18432,6,4596505323
17933,898883749,74998,898958747,1,0,0,6656,6,1674318613
17934,899080150,57908,899138058,4,0,0,6144,16,10107883314
17935,899181330,11016,899192346,0,0,1,17920,11,751864321
17936,899186460,205335,899391795,9,0,0,13312,18,3432346348
17937,899203240,566,899203806,1,0,1,512,6,10340305966
17938,899237890,566,899238456,6,0,1,512,12,3948479597
17939,899250970,112407,899363377,2,0,0,41984,4,7140113869
17940,899255570,181085,899436655,4,0,0,57856,16,6945987173
17941,899322490,150155,899472645,3,0,0,50688,2,7716343016
17942,899392070,155653,899547723,5,0,0,69120,19,8319011512
17943,899431480,183029,899614509,3,0,0,55296,2,9632862321
17944,899450540,130579,899581119,0,0,0,17408,11,10647372280
17945,899559820,85223,899645043,9,0,0,8192,18,6147437217
17946,899575630,127379,899703009,5,0,0,46080,19,3280521447
17947,899625401,127276,899752677,6,0,0,10240,12,6129859878
17948,899645009,123964,899768973,7,0,0,13312,8,8713807922
17949,899796730,10241,899806971,7,0,1,16384,8,516658206
17950,899798550,67437,899865987,9,0,0,5632,18,5331040510
17951,899860250,65456,899925706,8,0,0,10752,12,7504552181
17952,899864850,105285,899970135,0,0,0,41984,11,6487097252
17953,899910200,107432,900017632,3,0,0,52736,2,7239056373
17954,899962530,142978,900105508,0,0,0,41472,11,3778797122
17955,900037840,124302,900162142,5,0,0,24576,19,3601126540
17956,900061519,54056,900115575,1,0,0,3584,6,2408242406
17957,900093889,156360,900250249,7,0,0,82944,8,5301763152
17958,900134690,121424,900256114,2,0,0,3072,4,8344935592
17959,900158350,66612,900224962,4,0,0,7168,16,2187495763
17960,900178850,117590,900296440,9,0,0,27136,18,8219209139
17961,900187350,566,900187916,4,0,1,512,16,5718035677
17962,900209300,3128,900212428,4,0,1,9216,16,690406111
17963,900211570,128451,900340021,8,0,0,17920,12,7008687846
17964,900225089,208513,900433602,7,0,0,47104,8,10365886793
17965,900283000,99476,900382476,8,0,0,26624,12,7862198282
17966,900290720,205517,900496237,8,0,0,69632,12,3374418047
17967,900295610,102544,900398154,2,0,0,21504,4,5890349889
17968,900335240,15530,900350770,6,0,1,17408,12,755632808
17969,900340920,133025,900473945,9,0,0,8192,18,8948839194
17970,900406880,166805,900573685,2,0,0,19456,4,9156637992
17971,900426681,126686,900553367,6,0,0,35840,12,3956543470
17972,900446860,120874,900567734,2,0,0,47104,4,8273876308
17973,900507839,76814,900584653,1,0,0,9728,6,2378772855
17974,900545819,32199,900578018,8,0,1,4608,12,8461227565
17975,900622520,69440,900691960,2,0,0,8704,4,3447906654
17976,900761520,97628,900859148,5,0,0,25600,19,1505935885
17977,900802509,59177,900861686,1,0,0,2560,6,9916307198
17978,900869030,48980,900918010,3,0,0,2048,2,10283774811
17979,900871120,6278,900877398,1,0,1,6656,6,2172807669
17980,900931280,205612,901136892,8,0,0,67072,12,5047196359
17981,900975940,106470,901082410,2,0,0,28672,4,4557926650
17982,900988160,215206,901203366,2,0,0,52224,4,105305322
17983,901025169,6229,901031398,2,0,1,15360,4,609241846
17984,901044940,54056,901098996,3,0,0,3584,2,2299497410
17985,901055750,100487,901156237,5,0,0,10240,19,1704940386
17986,901083210,226737,901309947,5,0,0,66048,19,8685633951
17987,901150261,84668,901234929,6,0,0,13312,12,6447253156
17988,901161470,62028,901223498,9,0,0,2048,18,3580394608
17989,901178160,70971,901249131,4,0,0,2560,16,187699186
17990,901204220,70501,901274721,8,0,0,512,12,3473394313
17991,901316420,111332,901427752,9,0,0,65536,18,8755062368
17992,901399829,60263,901460092,1,0,0,3072,6,2251865508
17993,901489219,72848,901562067,1,0,0,14848,6,8882897163
17994,901534510,3904,901538414,5,0,1,10752,19,4769816579
17995,901594160,187896,901782056,4,0,0,27136,16,4705909757
17996,901627280,104780,901732060,3,0,0,44032,2,5811646358
17997,901854780,48980,901903760,4,0,0,2048,16,2245757452
17998,901875430,107177,901982607,3,0,0,26624,2,6659496417
17999,901876439,4374,901880813,8,0,1,4608,12,403921425
18000,901921410,1518,901922928,1,0,1,1536,6,1998114724
18001,901928659,138054,902066713,7,0,0,3584,8,8140684857
18002,901992730,43904,902036634,8,0,0,512,12,1044359023
18003,902030189,67592,902097781,7,0,0,7680,8,3241342672
18004,902047159,106496,902153655,1,0,0,49664,6,8673662229
18005,902074930,99131,902174061,4,0,0,4608,16,1376768293
18006,902244640,110084,902354724,8,0,0,61440,12,1815145915
18007,902306429,137419,902443848,1,0,0,54272,6,325092844
18008,902313960,137040,902451000,4,0,0,7168,16,1870106374
18009,902318499,76137,902394636,1,0,0,8704,6,1046900375
18010,902319809,69308,902389117,1,0,0,13312,6,5058930255
18011,902364450,102307,902466757,2,0,0,13824,4,2883953282
18012,902535010,1518,902536528,7,0,1,1536,8,1876029271
18013,902539390,5454,902544844,5,0,1,13824,19,6200461712
18014,902608950,50672,902659622,3,0,0,2560,2,7700085095
18015,902635659,6754,902642413,2,0,1,7168,4,2122461674
18016,902744519,90649,902835168,7,0,0,13312,8,372459737
18017,902807660,51154,902858814,5,0,0,4096,19,8285514712
18018,902836780,101816,902938596,9,0,0,34304,18,6821244088
18019,902837080,122174,902959254,9,0,0,10240,18,6674462710
18020,902896160,104936,903001096,5,0,0,44544,19,10522832949
18021,902951830,72924,903024754,8,0,0,5120,12,1130120803
18022,902996489,103139,903099628,1,0,0,23552,6,7384474420
18023,903039189,70376,903109565,7,0,0,11776,8,4265922935
18024,903084190,100724,903184914,3,0,0,30720,2,6198391937
18025,903104200,148742,903252942,9,0,0,92672,18,1250944796
18026,903168750,104898,903273648,4,0,0,13312,16,8682336658
18027,903212280,63255,903275535,0,0,0,6144,11,6038843104
18028,903220160,174750,903394910,2,0,0,47616,4,481048709
18029,903253710,151511,903405221,3,0,0,33792,2,9851916177
18030,903268969,141259,903410228,1,0,0,16384,6,4237457530
18031,903375241,104581,903479822,6,0,0,26624,12,6181197656
18032,903410430,113654,903524084,8,0,0,24576,12,8977733143
18033,903432210,118478,903550688,8,0,0,31232,12,4512344145
18034,903486061,110552,903596613,6,0,0,62976,12,608115603
18035,903632740,57440,903690180,0,0,0,4608,11,1627362767
18036,903664800,48980,903713780,8,0,0,2048,12,171089571
18037,903818790,74360,903893150,3,0,0,9728,2,8589426782
18038,903822629,54680,903877309,7,0,0,5632,8,8099409205
18039,903838500,1994,903840494,5,0,1,2048,19,6164294075
18040,903841990,90346,903932336,8,0,0,6144,12,9708679005
18041,903845489,126927,903972416,1,0,0,36864,6,2516980390
18042,903879629,110907,903990536,7,0,0,35840,8,2514139714
18043,903889089,153576,904042665,1,0,0,28672,6,7345226141
18044,903899279,59132,903958411,1,0,0,5120,6,5696691464
18045,903968259,78893,904047152,7,0,0,7680,8,9226714599
18046,903998910,183350,904182260,9,0,0,95232,18,225312238
18047,904018530,99008,904117538,8,0,0,25088,12,4156072079
18048,904077911,104520,904182431,6,0,0,512,12,8620257210
18049,904179490,9687,904189177,1,0,1,7168,6,2861639796
18050,904231590,15837,904247427,9,0,1,30720,18,10261510993
18051,904266400,103819,904370219,5,0,0,12288,19,8223340902
18052,904269390,210441,904479831,2,0,0,64000,4,9376335481
18053,904274830,5454,904280284,9,0,1,13824,18,719440618
18054,904279130,131700,904410830,9,0,0,33280,18,5224132471
18055,904402650,143847,904546497,3,0,0,24576,2,3197349785
18056,904423610,135694,904559304,5,0,0,41984,19,8609908835
18057,904500010,123922,904623932,2,0,0,45568,4,4568861556
18058,904635680,48980,904684660,0,0,0,2048,11,3432140993
18059,904653540,105560,904759100,3,0,0,46592,2,1078948502
18060,904746420,100592,904847012,5,0,0,18944,19,957320774
18061,904788810,93692,904882502,4,0,0,13312,16,6424118369
18062,904834410,12617,904847027,4,0,1,17920,16,2265715624
18063,904943690,3422,904947112,7,0,1,3584,8,7795309353
18064,905063619,1994,905065613,8,0,1,2048,12,2126695648
18065,905123790,67592,905191382,0,0,0,7680,11,1827319403
18066,905171781,109460,905281241,6,0,0,59392,12,518812388
18067,905187920,59288,905247208,0,0,0,5632,11,6060518067
18068,905275469,102588,905378057,1,0,0,17920,6,8795536091
18069,905331670,118345,905450015,9,0,0,26112,18,5220258009
18070,905342060,137663,905479723,2,0,0,36864,4,5510603919
18071,905357610,110866,905468476,8,0,0,39424,12,8046673238
18072,905386270,1994,905388264,4,0,1,2048,16,2222330414
18073,905454430,87778,905542208,8,0,0,10240,12,2815784988
18074,905559580,65900,905625480,0,0,0,7168,11,7900086155
18075,905696380,96092,905792472,8,0,0,25600,12,9304360094
18076,905722690,142622,905865312,4,0,0,50688,16,7920942276
18077,905754130,61826,905815956,3,0,0,5120,2,7222062965
18078,905755120,125035,905880155,4,0,0,48640,16,7525430301
18079,905849430,121374,905970804,2,0,0,61952,4,965392625
18080,905860720,87098,905947818,4,0,0,512,16,8138903779
18081,905863969,107474,905971443,7,0,0,2048,8,5103959388
18082,906024140,85940,906110080,9,0,0,22528,18,2853059911
18083,906067140,97468,906164608,8,0,0,7680,12,5426884042
18084,906249949,45596,906295545,7,0,0,1024,8,6034043225
18085,906252371,88832,906341203,6,0,0,16896,12,8993111041
18086,906279020,4162,906283182,4,0,1,11264,16,4475095742
18087,906289110,123871,906412981,9,0,0,19456,18,7800434167
18088,906524740,162891,906687631,9,0,1,263680,18,4963953953
18089,906553540,134245,906687785,4,0,1,8704,16,5196680592
18090,906576330,231316,906807646,4,0,0,39936,16,8270138064
18091,906632790,286509,906919299,3,0,0,11264,2,6701080373
18092,906646640,162425,906809065,0,0,0,4608,11,10603236293
18093,906753209,13858,906767067,2,0,1,23552,4,4008643972
18094,906789400,65170,906854570,9,0,1,110080,18,286414237
18095,906798470,121156,906919626,2,0,0,1024,4,4459040205
18096,906944940,131120,907076060,4,0,0,2560,16,1459474209
18097,907021960,50672,907072632,2,0,0,2560,4,4866898432
18098,907063220,87896,907151116,3,0,0,13824,2,3423149315
18099,907108520,47288,907155808,0,0,0,1536,11,8622759239
18100,907144920,1042,907145962,1,0,1,1024,6,9902704477
18101,907220010,67904,907287914,3,0,0,8704,2,1443721969
18102,907232130,45596,907277726,9,0,0,1024,18,8822232461
18103,907257189,62516,907319705,1,0,0,6144,6,5943540830
18104,907335570,79904,907415474,9,0,0,12800,18,9761697286
18105,907432540,66524,907499064,8,0,0,9216,12,9983061432
18106,907510840,52364,907563204,0,0,0,3072,11,706034212
18107,907554540,102128,907656668,4,0,0,35328,16,2910402738
18108,907579280,153846,907733126,0,0,0,53248,11,2896217177
18109,907624620,88502,907713122,8,0,0,12800,12,6838239168
18110,907704320,55748,907760068,0,0,0,4096,11,2531988746
18111,907720530,58184,907778714,9,0,0,1024,18,105110490
18112,907731480,115186,907846666,2,0,0,55296,4,5180829998
18113,907828500,101816,907930316,9,0,0,34304,18,6014928537
18114,907864550,107616,907972166,8,0,0,9216,12,9745353799
18115,907873970,174741,908048711,2,0,0,16896,4,8812733087
18116,907899329,144219,908043548,1,0,0,91136,6,8318506872
18117,907931970,1042,907933012,7,0,1,1024,8,6650778178
18118,907958030,128610,908086640,8,0,0,10752,12,7464088474
18119,907994580,3898,907998478,7,0,1,4096,8,2404898182
18120,908048779,144547,908193326,1,0,0,22016,6,8763613327
18121,908057759,112336,908170095,1,0,0,32768,6,5223248245
18122,908066560,216820,908283380,0,0,0,89600,11,10485900557
18123,908067480,105672,908173152,4,0,0,4608,16,9514048319
18124,908153099,5802,908158901,2,0,1,6144,4,1829115757
18125,908238850,60824,908299674,4,0,0,5632,16,10461385773
18126,908291929,143467,908435396,1,0,0,77824,6,7228600082
18127,908305399,4162,908309561,2,0,1,11264,4,10572608933
18128,908358940,125818,908484758,8,0,0,16896,12,6435346554
18129,908403630,2946,908406576,4,0,1,3072,16,8307314420
18130,908414940,102404,908517344,3,0,0,3584,2,5299751609
18131,908463970,126096,908590066,0,0,0,4096,11,2122144764
18132,908471000,101036,908572036,8,0,0,31744,12,4354014163
18133,908504360,90002,908594362,3,0,0,3072,2,2278681226
18134,908519200,2470,908521670,0,0,1,2560,11,10426800204
18135,908650329,100256,908750585,7,0,0,29184,8,1416616730
18136,908656829,566,908657395,8,0,1,512,12,5377260247
18137,908708099,50672,908758771,1,0,0,2560,6,1348319832
18138,908715160,102128,908817288,0,0,0,35328,11,5044984235
18139,908718811,103172,908821983,6,0,0,15360,12,2937996385
18140,908723930,174520,908898450,0,0,0,73728,11,9625090935
18141,908792490,122805,908915295,8,0,0,30208,12,827571288
18142,908856081,72978,908929059,6,0,0,2560,12,4665164564
18143,908884880,94690,908979570,2,0,0,11776,4,3513473412
18144,908903560,64520,908968080,4,0,0,7680,16,1031162046
18145,908918119,85319,909003438,7,0,0,6656,8,6039085241
18146,908935859,148873,909084732,7,0,0,40448,8,831934156
18147,908970730,8855,908979585,0,0,1,7680,11,4440890330
18148,908990101,100631,909090732,6,0,0,9728,12,6129153779
18149,909013131,136431,909149562,6,0,0,35328,12,9614352898
18150,909021150,1518,909022668,4,0,1,1536,16,7434634815
18151,909070640,133469,909204109,0,0,0,20480,11,4367324179
18152,909071580,65029,909136609,9,0,0,5632,18,2258112087
18153,909075690,10552,909086242,7,0,1,1536,8,2502743815
18154,909092100,86204,909178304,0,0,0,13312,11,5046489315
18155,909170121,50672,909220793,6,0,0,2560,12,4797774046
18156,909174680,98304,909272984,8,0,0,20992,12,3438943508
18157,909231700,102596,909334296,4,0,0,36864,16,3270374744
18158,909245010,107070,909352080,2,0,0,29696,4,4792587569
18159,909395529,1518,909397047,2,0,1,1536,4,4905346364
18160,909395961,64293,909460254,6,0,0,6656,12,9160412069
18161,909406980,104936,909511916,2,0,0,44544,4,5398123428
18162,909453750,96720,909550470,4,0,0,3072,16,8276339398
18163,909466410,4679,909471089,6,0,1,12288,12,93086313
18164,909503220,214707,909717927,9,0,0,93184,18,480666213
18165,909594310,153971,909748281,3,0,0,40448,2,5554284655
18166,909601940,117250,909719190,0,0,0,4096,11,2163930273
18167,909627950,92823,909720773,0,0,0,5120,11,1292568059
18168,909642481,110183,909752664,6,0,0,14336,12,5128606774
18169,909657381,157566,909814947,6,0,0,66560,12,4700353155
18170,909707949,139680,909847629,7,0,0,51712,8,950730790
18171,909781799,71935,909853734,7,0,0,7680,8,8256947642
18172,909860499,12737,909873236,2,0,1,24576,4,8299517521
18173,909868520,9862,909878382,5,0,1,8192,19,10161350705
18174,909915920,59384,909975304,0,0,0,3072,11,10396378845
18175,909932729,2946,909935675,3,0,1,3072,2,6208628451
18176,909949450,83988,910033438,9,0,0,11264,18,783783877
18177,909987350,66836,910054186,4,0,0,10240,16,8055065078
18178,910039090,7706,910046796,5,0,1,8192,19,4371779084
18179,910077000,51296,910128296,8,0,0,4608,12,3133408122
18180,910119800,167681,910287481,3,0,0,19968,2,10499850487
18181,910147850,103220,910251070,0,0,0,38912,11,10363861911
18182,910308690,115088,910423778,0,0,0,40960,11,2922215461
18183,910319770,566,910320336,1,0,1,512,6,8007141045
18184,910371171,97511,910468682,6,0,0,4608,12,5369683294
18185,910382250,106964,910489214,0,0,0,51200,11,7671677575
18186,910425051,87203,910512254,6,0,0,3584,12,3197034477
18187,910480080,11996,910492076,7,0,1,8704,8,9437931533
18188,910509690,156249,910665939,8,0,0,2560,12,5893200391
18189,910674599,60824,910735423,7,0,0,5632,8,1755203433
18190,910788490,64208,910852698,2,0,0,6656,4,2393201411
18191,910800970,566,910801536,6,0,1,512,12,9127145586
18192,910826470,97760,910924230,4,0,0,20992,16,5728416188
18193,910831680,97926,910929606,2,0,0,14848,4,5241105417
18194,911036949,1042,911037991,8,0,1,1024,12,10129106381
18195,911080970,102440,911183410,4,0,0,36352,16,1259349082
18196,911092390,6278,911098668,7,0,1,6656,8,4577818375
18197,911093631,140491,911234122,6,0,0,41472,12,5677159485
18198,911099560,2870,911102430,0,0,1,8704,11,7932810368
18199,911118780,92437,911211217,9,0,0,1536,18,5128641875
18200,911295069,48980,911344049,1,0,0,2048,6,7056671142
18201,911302350,65456,911367806,9,0,0,10752,18,9467616751
18202,911322170,5326,911327496,7,0,1,5632,8,2131275640
18203,911336910,244449,911581359,8,0,0,158720,12,515893867
18204,911404230,4937,911409167,0,0,1,12800,11,9295257739
18205,911468850,112852,911581702,4,0,0,1024,16,10293324756
18206,911540420,142304,911682724,8,0,0,32768,12,333625095
18207,911555369,107291,911662660,7,0,0,12288,8,307349865
18208,911588120,96803,911684923,8,0,0,7168,12,3810949399
18209,911622259,171626,911793885,1,0,0,97792,6,8346399975
18210,911637580,161624,911799204,4,0,0,17408,16,3296746342
18211,911645290,5712,911651002,4,0,1,14336,16,6083514250
18212,911713550,138380,911851930,9,0,0,30208,18,9856765155
18213,911740009,60302,911800311,1,0,0,3584,6,2306940869
18214,911829370,104624,911933994,3,0,0,43520,2,7648308954
18215,911976460,120848,912097308,9,0,0,96768,18,9256093682
18216,912026870,3898,912030768,7,0,1,4096,8,7362328832
18217,912090030,173483,912263513,3,0,0,38400,2,5748671461
18218,912141139,108383,912249522,7,0,0,32256,8,2045832635
18219,912183910,126479,912310389,9,0,0,27648,18,6028531891
18220,912221399,49448,912270847,1,0,0,3584,6,10485675864
18221,912221489,1042,912222531,8,0,1,1024,12,6898581151
18222,912288819,3898,912292717,2,0,1,4096,4,8352415431
18223,912314591,204123,912518714,6,0,0,41984,12,7578152351
18224,912335949,2470,912338419,8,0,1,2560,12,5189447849
18225,912376420,89278,912465698,0,0,0,12288,11,6302363289
18226,912464139,55378,912519517,7,0,0,2560,8,6333280121
18227,912488340,66632,912554972,3,0,0,7168,2,7907533056
18228,912498940,91928,912590868,8,0,0,22016,12,7321762241
18229,912513669,142917,912656586,1,0,0,75264,6,6055983051
18230,912629050,43904,912672954,0,0,0,512,11,7077861768
18231,912739160,566,912739726,0,0,1,512,11,8887607513
18232,912747619,73160,912820779,7,0,0,15872,8,234742802
18233,912826261,54056,912880317,6,0,0,3584,12,10520610592
18234,912953150,12995,912966145,9,0,1,25088,18,5318914915
18235,913041099,86204,913127303,7,0,0,13312,8,4449810564
18236,913129770,102908,913232678,8,0,0,37888,12,7678625122
18237,913205199,122675,913327874,7,0,0,99840,8,1074428632
18238,913206090,87869,913293959,3,0,0,1536,2,2718176152
18239,913253999,170814,913424813,1,0,0,9216,6,339768826
18240,913285510,104305,913389815,8,0,0,21504,12,2582553344
18241,913358421,96824,913455245,6,0,0,17920,12,8544035004
18242,913411941,68306,913480247,6,0,0,3072,12,1375180484
18243,913540619,2870,913543489,8,0,1,8704,12,7611847173
18244,913615650,96512,913712162,0,0,0,16896,11,6663201436
18245,913664511,132647,913797158,6,0,0,46592,12,3961677966
18246,913908410,57908,913966318,4,0,0,6144,16,9460437241
18247,914114549,1994,914116543,2,0,1,2048,4,202901728
18248,914191600,116948,914308548,3,0,0,83968,2,8459911564
18249,914199210,120741,914319951,9,0,0,37376,18,2777497917
18250,914223190,132746,914355936,0,0,0,20480,11,8641144589
18251,914433401,66836,914500237,6,0,0,10240,12,1949415442
18252,914508860,43904,914552764,0,0,0,512,11,4492119900
18253,914603790,5326,914609116,0,0,1,5632,11,5309385967
18254,914642660,101036,914743696,0,0,0,31744,11,6250365492
18255,914718200,45596,914763796,8,0,0,1024,12,6620164320
18256,914742870,4240,914747110,1,0,1,3584,6,8311015644
18257,914751910,3898,914755808,7,0,1,4096,8,2785147480
18258,914815120,98696,914913816,8,0,0,24064,12,3601617234
18259,914897890,111369,915009259,3,0,0,30720,2,2559993770
18260,914899319,75320,914974639,7,0,0,17920,8,2026333581
18261,914913130,2196,914915326,0,0,1,1536,11,6753331332
18262,914955260,103844,915059104,0,0,0,40960,11,4602165846
18263,914997859,157145,915155004,7,0,0,52224,8,8826618162
18264,915014680,62516,915077196,3,0,0,6144,2,9685861596
18265,915018439,3128,915021567,2,0,1,9216,4,3025442894
18266,915027920,176704,915204624,4,0,0,53760,16,4962691066
18267,915109630,99533,915209163,3,0,0,14848,2,2356722660
18268,915202070,116389,915318459,0,0,0,58880,11,3217126929
18269,915371700,97316,915469016,2,0,0,24576,4,10698690108
18270,915423130,101192,915524322,9,0,0,32256,18,7582549409
18271,915651450,52364,915703814,3,0,0,3072,2,2086194901
18272,915653259,115931,915769190,1,0,0,56320,6,8497924235
18273,915721150,566,915721716,9,0,1,512,18,2472884178
18274,915733510,76208,915809718,4,0,0,10752,16,2322772395
18275,915749641,69284,915818925,6,0,0,8192,12,2501371241
18276,915781500,102284,915883784,0,0,0,35840,11,2357857777
18277,915834780,98696,915933476,2,0,0,24064,4,8759087408
18278,915885409,13600,915899009,8,0,1,23040,12,9247663876
18279,915975840,73292,916049132,0,0,0,11264,11,4686602874
18280,916112040,71600,916183640,9,0,0,10752,18,4786699981
18281,916249101,98852,916347953,6,0,0,24576,12,7842235121
18282,916285491,136892,916422383,6,0,0,35840,12,2156037395
18283,916367449,147334,916514783,1,0,0,39424,6,194114142
18284,916407170,15228,916422398,9,0,1,15360,18,831095260
18285,916457970,77744,916535714,3,0,0,10752,2,1849753858
18286,916500950,13848,916514798,5,0,1,3072,19,3531469620
18287,916536230,89168,916625398,3,0,0,23040,2,256488045
18288,916539830,3422,916543252,9,0,1,3584,18,7109062478
18289,916598470,98072,916696542,0,0,0,22016,11,7673367128
18290,916622610,3822,916626432,1,0,1,1024,6,4236924813
18291,916792730,4374,916797104,6,0,1,4608,12,2085440519
18292,916920340,62516,916982856,8,0,0,6144,12,4596599021
18293,917037100,110552,917147652,5,0,0,62976,19,9395289398
18294,917068590,105588,917174178,9,0,0,12800,18,5347900069
18295,917108270,196630,917304900,9,0,0,138240,18,1258784942
18296,917115001,141547,917256548,6,0,0,25088,12,1650244597
18297,917162789,2470,917165259,2,0,1,2560,4,4231160394
18298,917228840,100724,917329564,2,0,0,30720,4,10538871604
18299,917266209,89355,917355564,7,0,0,2560,8,8423164560
18300,917280620,27719,917308339,1,0,1,3584,6,8844208684
18301,917337010,1518,917338528,6,0,1,1536,12,7742830726
18302,917409450,100724,917510174,4,0,0,30720,16,38371471
18303,917454329,99476,917553805,7,0,0,26624,8,783330749
18304,917500390,116859,917617249,2,0,0,46080,4,7142291821
18305,917544260,9560,917553820,0,0,1,2048,11,4329247128
18306,917547430,152488,917699918,9,0,0,44032,18,8450351293
18307,917580750,65545,917646295,9,0,0,9216,18,950440372
18308,917588860,4937,917593797,7,0,1,12800,8,2142711869
18309,917595919,147010,917742929,7,0,0,19456,8,5696399716
18310,917618950,85195,917704145,2,0,0,13824,4,2364531502
18311,917641940,76278,917718218,3,0,0,1024,2,4572673579
18312,917673960,120764,917794724,5,0,0,29184,19,1058563759
18313,917787630,114674,917902304,0,0,0,53248,11,10019854573
18314,917858610,71318,917929928,4,0,0,512,16,1996086584
18315,917882090,1042,917883132,9,0,1,1024,18,488941267
18316,917952150,1518,917953668,6,0,1,1536,12,5498218129
18317,917958730,48980,918007710,3,0,0,2048,2,7006615511
18318,918020991,112268,918133259,6,0,0,68608,12,614560183
18319,918039891,94163,918134054,6,0,0,2560,12,9767808752
18320,918079790,1042,918080832,4,0,1,1024,16,6458197387
18321,918088160,92049,918180209,0,0,0,2560,11,4855308651
18322,918120209,88509,918208718,7,0,0,10752,8,3261959293
18323,918138800,2470,918141270,1,0,1,2560,6,4180024261
18324,918333140,45596,918378736,0,0,0,1024,11,3310984560
18325,918387110,100100,918487210,9,0,0,28672,18,2152542839
18326,918467890,1994,918469884,1,0,1,2048,6,309812773
18327,918506099,56528,918562627,1,0,0,6656,6,2375855866
18328,918550520,64208,918614728,3,0,0,6656,2,9775703522
18329,918568740,52364,918621104,4,0,0,3072,16,4410770240
18330,918615290,57440,918672730,4,0,0,4608,16,3618044197
18331,918650120,70976,918721096,8,0,0,8704,12,3318044426
18332,918932970,97292,919030262,8,0,0,19456,12,5603072313
18333,918947951,62516,919010467,6,0,0,6144,12,5237605120
18334,918979509,81908,919061417,7,0,0,14336,8,10664074916
18335,919050189,88700,919138889,7,0,0,21504,8,2654635823
18336,919060680,99737,919160417,2,0,0,25088,4,6157049809
18337,919175190,104936,919280126,4,0,0,44544,16,10221278959
18338,919225039,4420,919229459,8,0,1,11776,12,4000473169
18339,919234030,3422,919237452,1,0,1,3584,6,3521027094
18340,919250699,4374,919255073,2,0,1,4608,4,7463091956
18341,919371150,100412,919471562,9,0,0,29696,18,10055137256
18342,919395379,153601,919548980,1,0,0,55808,6,682747607
18343,919427789,3387,919431176,8,0,1,9728,12,7246281227
18344,919548170,102930,919651100,4,0,0,35328,16,3556503237
18345,919601370,78674,919680044,4,0,0,2048,16,2044215769
18346,919723430,47288,919770718,2,0,0,1536,4,5373740114
18347,919761920,79928,919841848,8,0,0,17920,12,5422700745
18348,919864769,98072,919962841,1,0,0,22016,6,8472841746
18349,919961180,80957,920042137,2,0,0,15872,4,4048445737
18350,919980901,62967,920043868,6,0,0,5632,12,679402161
18351,920035980,100880,920136860,8,0,0,31232,12,7252041301
18352,920040200,4702,920044902,5,0,1,1024,19,8556100057
18353,920074120,13512,920087632,7,0,1,26112,8,747697633
18354,920081750,141523,920223273,0,0,0,66560,11,867203052
18355,920111210,113950,920225160,9,0,0,6144,18,1551302449
18356,920113650,197846,920311496,8,0,0,42496,12,3013279995
18357,920116490,112464,920228954,4,0,0,4608,16,4860721958
18358,920202139,93283,920295422,1,0,0,13824,6,8539216462
18359,920231490,47288,920278778,0,0,0,1536,11,6084124910
18360,920385190,84512,920469702,2,0,0,12800,4,9497608769
18361,920469340,67658,920536998,8,0,0,11776,12,44697682
18362,920525319,5802,920531121,2,0,1,6144,4,2534121607
18363,920530710,102440,920633150,0,0,0,36352,11,9378223332
18364,920698060,73628,920771688,9,0,0,17408,18,6795169612
18365,920699460,51296,920750756,4,0,0,4608,16,8765235128
18366,920708369,76364,920784733,1,0,0,11264,6,4702701564
18367,920772490,1042,920773532,9,0,1,1024,18,455718870
18368,920789420,85550,920874970,9,0,0,17920,18,1506978441
18369,920803710,10499,920814209,9,0,1,16896,18,869620318
18370,920860150,4850,920865000,4,0,1,5120,16,7864801122
18371,920882730,1518,920884248,5,0,1,1536,19,8775101100
18372,920886339,16354,920902693,2,0,1,31744,4,369590073
18373,920895539,99061,920994600,1,0,0,23552,6,9455876569
18374,920895550,91750,920987300,4,0,0,3584,16,6172611538
18375,920993410,119066,921112476,0,0,0,87040,11,7218106181
18376,921042700,2870,921045570,9,0,1,8704,18,6796431752
18377,921051520,152697,921204217,9,0,0,36864,18,4867025614
18378,921210290,102128,921312418,9,0,0,35328,18,8753218255
18379,921247921,65448,921313369,6,0,0,3072,12,8832946233
18380,921255590,110156,921365746,9,0,0,16896,18,7839909332
18381,921260951,99632,921360583,6,0,0,27136,12,10604556662
18382,921340360,3904,921344264,4,0,1,10752,16,9976656191
18383,921378889,74516,921453405,7,0,0,10240,8,10079354600
18384,921503380,65612,921568992,2,0,0,11264,4,10481560910
18385,921511150,116606,921627756,3,0,0,62976,2,4263681858
18386,921580860,84536,921665396,2,0,0,17920,4,1233675637
18387,921581679,99788,921681467,1,0,0,27648,6,6027633885
18388,921590509,93937,921684446,1,0,0,9728,6,736186064
18389,921688529,75920,921764449,7,0,0,14848,8,8821941170
18390,921713490,119413,921832903,3,0,0,61952,2,7767493575
18391,921982170,55748,922037918,3,0,0,4096,2,3730911754
18392,921997001,76388,922073389,6,0,0,16384,12,9839835945
18393,921999839,47288,922047127,1,0,0,1536,6,243377778
18394,922050840,1042,922051882,5,0,1,1024,19,8018526232
18395,922221181,104624,922325805,6,0,0,43520,12,3365622461
18396,922527430,100412,922627842,8,0,0,29696,12,2165067205
18397,922604950,112952,922717902,8,0,0,25600,12,9753852630
18398,922653600,79748,922733348,0,0,0,12288,11,3231511209
18399,922836580,4374,922840954,1,0,1,4608,6,5434121548
18400,922900470,59132,922959602,9,0,0,5120,18,3121964932
18401,922951260,78992,923030252,8,0,0,14848,12,4437251446
18402,922996730,3422,923000152,6,0,1,3584,12,9521590650
18403,923101039,48980,923150019,7,0,0,2048,8,5060621060
18404,923154189,126055,923280244,1,0,0,74240,6,2394030948
18405,923156050,3904,923159954,4,0,1,10752,16,5391967435
18406,923159750,122381,923282131,3,0,0,6144,2,8015357831
18407,923166260,135524,923301784,2,0,0,54272,4,6269779435
18408,923195440,87798,923283238,0,0,0,3584,11,5959848305
18409,923195630,127431,923323061,2,0,0,5120,4,9620018722
18410,923243551,96562,923340113,6,0,0,5632,12,7736276766
18411,923298970,70398,923369368,4,0,0,7680,16,8262213053
18412,923343211,69219,923412430,6,0,0,11776,12,784241110
18413,923369450,98852,923468302,0,0,0,24576,11,3289606196
18414,923458310,105560,923563870,0,0,0,46592,11,8716339572
18415,923495520,130324,923625844,3,0,0,22016,2,7929757848
18416,923566570,98256,923664826,3,0,0,7680,2,3561491518
18417,923589170,2470,923591640,9,0,1,2560,18,9415567638
18418,923799970,23208,923823178,1,0,1,38400,6,8650970765
18419,923818700,60824,923879524,9,0,0,5632,18,2265607537
18420,923966850,112424,924079274,8,0,0,69120,12,10651437896
18421,923982430,158818,924141248,3,0,0,44544,2,10510509957
18422,924013320,66896,924080216,8,0,0,512,12,7150624356
18423,924183700,47288,924230988,0,0,0,1536,11,8077719813
18424,924197031,121472,924318503,6,0,0,98816,12,4937307952
18425,924257891,62967,924320858,6,0,0,7680,12,8902535895
18426,924276330,81019,924357349,3,0,0,15360,2,2030221653
18427,924339231,106340,924445571,6,0,0,49152,12,8279950273
18428,924389660,149247,924538907,8,0,0,55808,12,5205963817
18429,924439510,51674,924491184,2,0,0,1024,4,2433177314
18430,924440980,106351,924547331,9,0,0,17920,18,3672764436
18431,924503580,92684,924596264,9,0,0,19456,18,5916287137
18432,924509320,112150,924621470,4,0,0,15360,16,5234663543
18433,924626080,101036,924727116,0,0,0,31744,11,4366852147
18434,924640101,45596,924685697,6,0,0,1024,12,6667649712
18435,924884210,3422,924887632,9,0,1,3584,18,5397936498
18436,925068279,47444,925115723,7,0,0,2048,8,3928338494
18437,925075780,58064,925133844,3,0,0,6656,2,5419143381
18438,925083060,82532,925165592,2,0,0,16384,4,1149091817
18439,925085339,63471,925148810,7,0,0,512,8,9531994455
18440,925087270,138058,925225328,0,0,0,46080,11,10612556469
18441,925102430,129825,925232255,2,0,0,9216,4,9655343047
18442,925118720,177474,925296194,8,0,0,50688,12,4086751926
18443,925228210,5802,925234012,0,0,1,6144,11,8116597665
18444,925231670,3648,925235318,7,0,1,2048,8,5026361446
18445,925265200,59132,925324332,4,0,0,5120,16,4453102470
18446,925397080,65900,925462980,8,0,0,7168,12,5567814727
18447,925561660,7706,925569366,9,0,1,8192,18,1437873384
18448,925755530,1042,925756572,4,0,1,1024,16,2262113306
18449,925851489,52364,925903853,1,0,0,3072,6,351018169
18450,925926929,62828,925989757,1,0,0,7168,6,10006457785
18451,925958040,104468,926062508,0,0,0,43008,11,6286879694
18452,925983650,141612,926125262,3,0,0,20992,2,4346342392
18453,926055330,92150,926147480,4,0,0,14336,16,8227272067
18454,926086709,79941,926166650,1,0,0,512,6,5818584469
18455,926090619,566,926091185,8,0,1,512,12,3702492858
18456,926101920,90212,926192132,9,0,0,16384,18,4434560602
18457,926263830,127471,926391301,0,0,1,211456,11,9115839027
18458,926278080,297039,926575119,4,0,0,95232,16,3891522574
18459,926327670,168551,926496221,0,0,0,2048,11,10242662483
18460,926430530,151468,926581998,3,0,0,22528,2,8672340236
18461,926506199,2946,926509145,3,0,1,3072,2,1029243889
18462,926573601,83709,926657310,6,0,0,17920,12,3951620686
18463,926714699,89588,926804287,7,0,0,14336,8,6853623742
18464,926739171,147742,926886913,6,0,0,37376,12,5446833882
18465,926765700,129496,926895196,9,0,0,27136,18,2374472892
18466,926884690,107790,926992480,4,0,0,19456,16,77494172
18467,926938460,91940,927030400,4,0,0,512,16,537755660
18468,927081220,95312,927176532,5,0,0,23040,19,5446586656
18469,927138229,97292,927235521,1,0,0,19456,6,7360163005
18470,927196200,62672,927258872,3,0,0,6656,2,1521703508
18471,927240650,60068,927300718,4,0,0,8192,16,2714641273
18472,927249080,82982,927332062,9,0,0,10240,18,5246296713
18473,927283930,98384,927382314,2,0,0,23040,4,7257589469
18474,927419470,81440,927500910,8,0,0,12800,12,4921887335
18475,927439410,65900,927505310,4,0,0,7168,16,10675172005
18476,927440950,91514,927532464,5,0,0,19456,19,9122280370
18477,927528339,71109,927599448,1,0,0,10752,6,6782421615
18478,927548030,80528,927628558,4,0,0,14848,16,3769221865
18479,927737989,4850,927742839,3,0,1,5120,2,2712397865
18480,927812270,145654,927957924,0,0,1,240128,11,2542679752
18481,927849190,186442,928035632,2,0,0,9216,4,2975444305
18482,927855921,289087,928145008,6,0,0,8192,12,7127589692
18483,927859220,305918,928165138,0,0,0,2560,11,6912512569
18484,927873010,233352,928106362,3,0,0,28672,2,7822226224
18485,927898340,124800,928023140,0,0,0,3072,11,1602240453
18486,927965061,205611,928170672,6,0,0,13312,12,6118179424
18487,928017290,48980,928066270,2,0,0,2048,4,8156995978
18488,928030280,157380,928187660,5,0,0,20992,19,2701441540
18489,928070880,45596,928116476,4,0,0,1024,16,607414784
18490,928090969,103882,928194851,7,0,0,23552,8,3066520478
18491,928117600,122664,928240264,9,0,0,31232,18,6833466904
18492,928156330,87974,928244304,8,0,0,10752,12,4111978181
18493,928243890,4310,928248200,0,0,1,10752,11,760400128
18494,928270960,91904,928362864,4,0,0,16896,16,5665966369
18495,928342040,14117,928356157,0,0,1,24064,11,8157388693
18496,928369190,96224,928465414,2,0,0,20992,4,10569228092
18497,928391590,1518,928393108,4,0,1,1536,16,2466049749
18498,928394099,3422,928397521,8,0,1,3584,12,5018921631
18499,928555000,113204,928668204,0,0,0,71680,11,1567564576
18500,928571460,156378,928727838,8,0,0,39424,12,3154814996
18501,928600909,142091,928743000,7,0,0,22528,8,2364974272
18502,928648370,124684,928773054,0,0,0,4096,11,2651881667
18503,928686640,2470,928689110,1,0,1,2560,6,10439720855
18504,928706781,73485,928780266,6,0,0,2560,12,2304927184
18505,928770010,110924,928880934,8,0,0,33280,12,6232541488
18506,928828070,95542,928923612,4,0,0,20992,16,4630338086
18507,928846189,83054,928929243,7,0,0,18432,8,2249793193
18508,928866890,110176,928977066,8,0,0,13824,12,1502276106
18509,928932450,109928,929042378,3,0,0,60928,2,1939137059
18510,928978070,119292,929097362,8,0,0,12288,12,10208368578
18511,929116320,4850,929121170,6,0,1,5120,12,1765302267
18512,929135920,47288,929183208,3,0,0,1536,2,9136573364
18513,929278721,101036,929379757,6,0,0,31744,12,125699798
18514,929284310,70064,929354374,2,0,0,10752,4,3962050351
18515,929360590,104156,929464746,5,0,0,41984,19,4709100564
18516,929529779,2946,929532725,3,0,1,3072,2,10037075324
18517,929602540,140116,929742656,0,0,0,51200,11,1896219779
18518,929624150,7706,929631856,1,0,1,8192,6,7400239379
18519,929710580,2870,929713450,9,0,1,8704,18,3578057115
18520,929816179,67592,929883771,1,0,0,7680,6,924656835
18521,929857031,74769,929931800,6,0,0,11264,12,8329005707
18522,929857821,70532,929928353,6,0,0,12288,12,10601663187
18523,929878690,111361,929990051,3,0,0,27136,2,866457832
18524,929929640,102564,930032204,9,0,0,29696,18,10261252940
18525,929931450,123794,930055244,8,0,0,10240,12,3164730037
18526,929940610,161056,930101666,3,0,0,29696,2,5169200977
18527,929945400,100412,930045812,8,0,0,29696,12,9559137421
18528,929981549,156261,930137810,7,0,0,53248,8,1232260756
18529,930022130,244494,930266624,4,0,0,24064,16,9030170028
18530,930068940,73604,930142544,9,0,0,12288,18,9745142218
18531,930088160,120048,930208208,5,0,0,56320,19,72902502
18532,930157940,117123,930275063,9,0,0,27648,18,864984664
18533,930196010,19896,930215906,6,0,1,8192,12,1283033587
18534,930239070,2470,930241540,9,0,1,2560,18,8347175255
18535,930244580,68712,930313292,8,0,0,3584,12,10167629195
18536,930376530,5326,930381856,1,0,1,5632,6,9094155517
18537,930465331,113936,930579267,6,0,0,15360,12,6487553029
18538,930526290,106028,930632318,4,0,0,48128,16,2128823135
18539,930571599,61358,930632957,1,0,0,2048,6,10714111779
18540,930664000,56684,930720684,8,0,0,7168,12,3547147609
18541,930717530,566,930718096,7,0,1,512,8,7151311389
18542,930717549,116494,930834043,1,0,0,75776,6,5755360208
18543,930719880,1838,930721718,4,0,1,1024,16,10085932685
18544,930759220,98967,930858187,5,0,0,1536,19,8495167137
18545,930810690,54056,930864746,9,0,0,3584,18,3989660739
18546,930832549,317953,931150502,1,0,0,40960,6,892088934
18547,930861170,23725,930884895,5,0,1,39424,19,6526272883
18548,930866789,64514,930931303,1,0,0,6656,6,978583607
18549,930886860,116606,931003466,8,0,0,14336,12,8374731156
18550,930933600,86516,931020116,3,0,0,14336,2,9932250586
18551,930953870,124674,931078544,5,0,0,32768,19,3713145459
18552,930984400,5971,930990371,0,0,1,14848,11,9076949414
18553,930993741,87626,931081367,6,0,0,9216,12,2691430139
18554,931008420,4374,931012794,0,0,1,4608,11,6621722095
18555,931075190,13399,931088589,9,0,1,7680,18,7805072533
18556,931115569,102638,931218207,7,0,0,7680,8,2172536672
18557,931150670,2470,931153140,6,0,1,2560,12,86002673
18558,931155420,89456,931244876,9,0,0,18944,18,5675609780
18559,931189310,4374,931193684,6,0,1,4608,12,1062935193
18560,931293030,109304,931402334,4,0,0,58880,16,54942707
18561,931374441,99476,931473917,6,0,0,26624,12,2840115756
18562,931395670,91324,931486994,3,0,0,13312,2,2140317886
18563,931409721,81188,931490909,6,0,0,12800,12,8344933127
18564,931456770,17162,931473932,5,0,1,29184,19,8638357415
18565,931494920,98072,931592992,0,0,0,22016,11,10679476304
18566,931579620,5712,931585332,7,0,1,14336,8,2445778482
18567,931613359,62026,931675385,7,0,0,1024,8,4515586395
18568,931664360,75125,931739485,9,0,0,8192,18,5864544095
18569,931680290,56684,931736974,9,0,0,7168,18,5226553814
18570,931746659,11016,931757675,2,0,1,17920,4,3056548807
18571,931755480,69284,931824764,8,0,0,8192,12,5499132737
18572,931766990,223242,931990232,3,0,0,31232,2,9044720298
18573,931810450,7230,931817680,0,0,1,7680,11,2163162419
18574,931826509,90281,931916790,7,0,0,16896,8,10633937027
18575,931836160,134306,931970466,3,0,0,31744,2,9683777139
18576,931836680,6754,931843434,4,0,1,7168,16,2342325913
18577,931852670,104734,931957404,5,0,0,23040,19,1378161963
18578,931908519,184735,932093254,1,0,0,29184,6,9979326484
18579,931913021,146959,932059980,6,0,0,34816,12,8000353569
18580,931944510,139821,932084331,9,0,0,79872,18,3417523552
18581,931960390,203936,932164326,4,0,0,38400,16,3740042740
18582,932058750,71169,932129919,5,0,0,1024,19,1978938029
18583,932062669,40785,932103454,2,0,1,16384,4,6616342879
18584,932124420,246704,932371124,3,0,0,43520,2,10549133563
18585,932173440,64208,932237648,3,0,0,6656,2,3377456105
18586,932199580,83758,932283338,5,0,0,14336,19,6725475759
18587,932273129,116601,932389730,1,0,0,7680,6,10673003852
18588,932282939,115113,932398052,7,0,0,20992,8,2027197932
18589,932299719,71732,932371451,1,0,0,1024,6,1722259014
18590,932527410,6754,932534164,7,0,1,7168,8,4339470148
18591,932669060,99164,932768224,4,0,0,25600,16,4556160438
18592,932684079,157789,932841868,7,0,0,105984,8,1187324288
18593,932687140,4850,932691990,9,0,1,5120,18,3361836929
18594,932769010,6278,932775288,1,0,1,6656,6,9917655093
18595,932783220,79282,932862502,4,0,0,11264,16,10139608264
18596,932826650,28722,932855372,4,0,1,26112,16,1511014646
18597,932858240,123941,932982181,5,0,0,82944,19,2601983838
18598,932898149,155996,933054145,1,0,0,19456,6,1215777697
18599,932925181,94692,933019873,6,0,0,6144,12,2446981757
18600,932948141,83624,933031765,6,0,0,19968,12,3450535752
18601,932963209,84474,933047683,1,0,0,512,6,1776720975
18602,933005460,3898,933009358,0,0,1,4096,11,1602768111
18603,933064230,61136,933125366,4,0,0,6656,16,9243587729
18604,933270540,91460,933362000,4,0,0,20480,16,4435687538
18605,933285280,566,933285846,5,0,1,512,19,4303164313
18606,933345241,92216,933437457,6,0,0,17920,12,5444175969
18607,933363389,63764,933427153,7,0,0,10240,8,886568984
18608,933522880,50984,933573864,9,0,0,3584,18,7008162744
18609,933534580,47288,933581868,8,0,0,1536,12,5935531279
18610,933755109,43904,933799013,1,0,0,512,6,7797159712
18611,933844300,94844,933939144,9,0,0,21504,18,9102641872
18612,934041029,100412,934141441,1,0,0,29696,6,6402753550
18613,934077320,3422,934080742,5,0,1,3584,19,9018783008
18614,934078160,95027,934173187,8,0,0,11776,12,8906016528
18615,934155450,104312,934259762,8,0,0,42496,12,10554278228
18616,934192800,99164,934291964,9,0,0,25600,18,983054774
18617,934221400,124510,934345910,4,0,0,25088,16,2328037577
18618,934222511,58957,934281468,6,0,0,8192,12,2228931926
18619,934306079,64832,934370911,1,0,0,8704,6,5840126321
18620,934365870,106340,934472210,5,0,0,49152,19,5434944896
18621,934465480,11572,934477052,1,0,1,5120,6,2835694986
18622,934495429,102440,934597869,1,0,0,36352,6,1526848831
18623,934581389,52364,934633753,7,0,0,3072,8,5130460586
18624,934642930,69284,934712214,4,0,0,8192,16,7736812267
18625,934649560,108524,934758084,9,0,0,56320,18,3752249893
18626,934689800,2470,934692270,6,0,1,2560,12,1302419483
18627,934691579,157939,934849518,1,0,0,10240,6,6673754311
18628,934693131,146709,934839840,6,0,0,50176,12,7691833552
18629,934791970,3422,934795392,0,0,1,3584,11,1251068496
18630,934829919,53817,934883736,7,0,0,512,8,8816015186
18631,934858890,92552,934951442,5,0,0,24064,19,3913287107
18632,934871749,110959,934982708,7,0,0,34816,8,7777541694
18633,934882150,5802,934887952,0,0,1,6144,11,7489033884
18634,934928740,206141,935134881,3,0,0,107008,2,4873333083
18635,934996950,139506,935136456,4,0,0,5120,16,10703487380
18636,935059350,79461,935138811,3,0,0,7680,2,6622268383
18637,935074070,11791,935085861,9,0,1,19456,18,5659395346
18638,935178620,91772,935270392,3,0,0,21504,2,2777377219
18639,935189650,66222,935255872,3,0,0,4096,2,7893487861
18640,935204040,155152,935359192,5,0,0,109056,19,10726892787
18641,935246541,160585,935407126,6,0,0,38400,12,6361021368
18642,935388390,104468,935492858,0,0,0,43008,11,2144984683
18643,935409890,139866,935549756,4,0,0,82432,16,824194736
18644,935415640,163468,935579108,5,0,0,52736,19,3630982822
18645,935457550,566,935458116,9,0,1,512,18,10583103510
18646,935516840,135014,935651854,3,0,0,33280,2,5000388902
18647,935575199,47805,935623004,1,0,0,512,6,3560449792
18648,935701740,100724,935802464,0,0,0,30720,11,10199234929
18649,935711119,10241,935721360,2,0,1,16384,4,8042919076
18650,935734219,69835,935804054,7,0,0,5120,8,3151854859
18651,935742360,102188,935844548,3,0,0,15360,2,4868081168
18652,935788120,14359,935802479,4,0,1,6656,16,7881543602
18653,935871720,103010,935974730,0,0,0,23552,11,317386125
18654,935950290,77672,936027962,0,0,0,4608,11,5065789683
18655,935957079,69464,936026543,1,0,0,13824,6,554282801
18656,935976789,4679,935981468,2,0,1,12288,4,8056293729
18657,936073590,5971,936079561,5,0,1,14848,19,1022604489
18658,936147459,64208,936211667,1,0,0,6656,6,10652474282
18659,936276511,74696,936351207,6,0,0,15872,12,235640910
18660,936294080,82976,936377056,4,0,0,12800,16,3181982919
18661,936383220,2870,936386090,5,0,1,8704,19,4617548927
18662,936403640,113157,936516797,0,0,0,37888,11,7144686127
18663,936475630,96692,936572322,9,0,0,22528,18,4683686833
18664,936512300,108021,936620321,5,0,0,39936,19,4305250806
18665,936565510,87979,936653489,3,0,0,21504,2,5285804201
18666,936592489,124036,936716525,7,0,0,67072,8,3219475774
18667,936598650,1994,936600644,4,0,1,2048,16,6659145772
18668,936661730,111967,936773697,0,0,0,15360,11,10635618431
18669,936677749,73664,936751413,7,0,0,12800,8,6615659951
18670,936923920,88052,937011972,2,0,0,14336,4,1482322111
18671,936983030,101192,937084222,3,0,0,32256,2,8007540849
18672,937109820,99476,937209296,0,0,0,26624,11,5147831063
18673,937172210,99944,937272154,0,0,0,28160,11,6404575536
18674,937260390,103844,937364234,2,0,0,40960,4,7377244350
18675,937266320,107946,937374266,3,0,0,18432,2,1010958070
18676,937380609,68840,937449449,1,0,0,11776,6,7225273173
18677,937423320,6278,937429598,9,0,1,6656,18,10200805034
18678,937529050,62516,937591566,0,0,0,6144,11,9644235145
18679,937553770,3387,937557157,4,0,1,9728,16,9238331854
18680,937632830,3904,937636734,0,0,1,10752,11,5572490766
18681,937635171,53348,937688519,6,0,0,3072,12,6424708695
18682,937678000,3422,937681422,4,0,1,3584,16,1442655995
18683,937699531,70064,937769595,6,0,0,10752,12,9771490487
18684,937714261,177036,937891297,6,0,0,41984,12,5949780165
18685,938008549,3645,938012194,2,0,1,10240,4,23594186
18686,938022860,52364,938075224,3,0,0,3072,2,4477423145
18687,938089240,55748,938144988,9,0,0,4096,18,1111097768
18688,938280060,48980,938329040,8,0,0,2048,12,1069108308
18689,938283211,65900,938349111,6,0,0,7168,12,8332904909
18690,938417460,99320,938516780,8,0,0,26112,12,9217071505
18691,938455219,75607,938530826,7,0,0,512,8,5841536176
18692,938465140,108010,938573150,8,0,0,18432,12,7493711505
18693,938529399,112751,938642150,1,0,0,10752,6,7636019643
18694,938579430,136520,938715950,8,0,0,91648,12,6812240558
18695,938587720,128721,938716441,9,0,0,1536,18,9389919703
18696,938623040,135000,938758040,4,0,0,58368,16,10456847352
18697,938661850,142708,938804558,0,0,0,13312,11,10292330496
18698,938696179,125791,938821970,1,0,0,48128,6,5411685218
18699,938879521,78836,938958357,6,0,0,14336,12,9710169397
18700,939012111,62228,939074339,6,0,0,10240,12,2447891030
18701,939085079,64676,939149755,1,0,0,8192,6,9327538585
18702,939101570,79403,939180973,3,0,0,8704,2,9456803198
18703,939122820,79772,939202592,8,0,0,17408,12,1649336755
18704,939180419,55226,939235645,1,0,0,5632,6,6402666745
18705,939257549,98720,939356269,1,0,0,29184,6,5762419935
18706,939296159,95576,939391735,1,0,0,18432,6,1307826959
18707,939357370,79592,939436962,9,0,0,11776,18,4325403933
18708,939387759,99124,939486883,7,0,0,22528,8,9314917246
18709,939390260,47088,939437348,0,0,0,1024,11,7889647606
18710,939398099,122534,939520633,1,0,0,6144,6,5301700745
18711,939618719,106184,939724903,7,0,0,48640,8,406420037
18712,939656991,86782,939743773,6,0,0,3584,12,4388827775
18713,939664649,70664,939735313,1,0,0,1024,6,7513430647
18714,939697410,99476,939796886,4,0,0,26624,16,6906336410
18715,939884010,15321,939899331,1,0,1,29696,6,9486775140
18716,939908919,102818,940011737,7,0,0,6656,8,9765685529
18717,939929829,58220,939988049,1,0,0,7168,6,6094395892
18718,939974379,124292,940098671,7,0,0,64000,8,786746846
18719,940100840,100100,940200940,9,0,0,28672,18,8561884561
18720,940117079,161561,940278640,7,0,0,122368,8,5492842004
18721,940132659,5326,940137985,8,0,1,5632,12,5379639077
18722,940154770,145662,940300432,3,0,0,5120,2,4017752131
18723,940200680,92228,940292908,5,0,0,5632,19,6234975160
18724,940346780,74360,940421140,4,0,0,9728,16,6694283338
18725,940371840,72346,940444186,9,0,0,3584,18,2703634235
18726,940381541,142685,940524226,6,0,0,104960,12,6508367887
18727,940434900,3387,940438287,7,0,1,9728,8,8882610582
18728,940495781,172654,940668435,6,0,0,88576,12,405446440
18729,940500099,169131,940669230,7,0,0,2560,8,4815221121
18730,940518980,20350,940539330,9,0,1,29184,18,8419827992
18731,940676780,1994,940678774,9,0,1,2048,18,2713052374
18732,940694170,89636,940783806,4,0,0,24576,16,9002759778
18733,940713930,45596,940759526,8,0,0,1024,12,9967645485
18734,940945471,102596,941048067,6,0,0,36864,12,1104376967
18735,941046520,117592,941164112,4,0,0,68096,16,7781265207
18736,941061789,2946,941064735,8,0,1,3072,12,1021365873
18737,941082330,129903,941212233,9,0,0,26112,18,6422013735
18738,941127190,98228,941225418,9,0,0,22528,18,10215946995
18739,941194070,110014,941304084,3,0,0,52736,2,6813241028
18740,941217500,91028,941308528,9,0,0,4096,18,5249768131
18741,941266920,62362,941329282,9,0,0,512,18,2627827722
18742,941412570,123812,941536382,0,0,0,106496,11,6178945611
18743,941485819,11274,941497093,8,0,1,18432,12,3557274934
18744,941492260,92746,941585006,8,0,0,11776,12,6064783549
18745,941509170,135728,941644898,8,0,0,56320,12,4038158036
18746,941621970,4850,941626820,7,0,1,5120,8,3275270280
18747,941624799,104699,941729498,1,0,0,34304,6,4069325611
18748,941766511,167183,941933694,6,0,0,52736,12,10080015022
18749,941777110,97916,941875026,9,0,0,21504,18,3966750135
18750,941783879,206767,941990646,1,0,0,78336,6,4712514719
18751,941813510,147268,941960778,0,0,0,6144,11,2758471555
18752,941833759,125132,941958891,7,0,0,6656,8,3744736532
18753,941870189,199735,942069924,7,0,0,4608,8,2311131443
18754,941880719,151321,942032040,1,0,0,21504,6,7517840044
18755,941884820,11791,941896611,4,0,1,19456,16,2003309145
18756,941973481,116165,942089646,6,0,0,25088,12,2570987838
18757,941987980,6587,941994567,7,0,1,10752,8,519473852
18758,942033500,162129,942195629,0,0,0,60416,11,8486634023
18759,942069570,6575,942076145,7,0,1,15360,8,1047193338
18760,942070340,102377,942172717,0,0,0,22016,11,1034123479
18761,942234370,4420,942238790,7,0,1,11776,8,8406516545
18762,942294511,109772,942404283,6,0,0,60416,12,5037597459
18763,942295191,175746,942470937,6,0,0,51200,12,4631704300
18764,942333629,80860,942414489,7,0,0,2048,8,10505594993
18765,942393060,12750,942405810,5,0,1,1536,19,7325953488
18766,942396040,78344,942474384,4,0,0,11264,16,5563926132
18767,942526829,98072,942624901,1,0,0,22016,6,602857591
18768,942538360,4420,942542780,5,0,1,11776,19,3743501562
18769,942604760,1994,942606754,1,0,1,2048,6,9655052995
18770,942676489,64832,942741321,7,0,0,8704,8,6451287961
18771,942679190,6278,942685468,4,0,1,6656,16,456674018
18772,942684670,87896,942772566,8,0,0,13824,12,5084924352
18773,942699300,64755,942764055,0,0,0,1536,11,4686167980
18774,942729539,77456,942806995,1,0,0,14848,6,7461151785
18775,942740190,4768,942744958,4,0,1,10240,16,6681314869
18776,942767090,74072,942841162,5,0,0,13824,19,2249727446
18777,942822851,103711,942926562,6,0,0,35840,12,7445255882
18778,943000449,55748,943056197,1,0,0,4096,6,8330008574
18779,943008350,109928,943118278,0,0,0,60928,11,5732844165
18780,943012200,44324,943056524,5,0,0,1024,19,5175939421
18781,943161909,1518,943163427,8,0,1,1536,12,363002192
18782,943262199,101660,943363859,1,0,0,33792,6,8412347924
18783,943322270,1994,943324264,6,0,1,2048,12,399876715
18784,943324529,63816,943388345,7,0,0,7168,8,4240259864
18785,943393161,55748,943448909,6,0,0,4096,12,1409827144
18786,943403499,132092,943535591,7,0,0,48640,8,2761506633
18787,943428309,153308,943581617,1,0,0,51712,6,3838771874
18788,943483280,12049,943495329,9,0,1,19968,18,10425972412
18789,943510400,139275,943649675,3,0,0,47104,2,6942586839
18790,943526630,170325,943696955,0,0,0,40960,11,5638633425
18791,943551620,56481,943608101,4,0,0,2560,16,5888243114
18792,943613340,124397,943737737,0,0,0,17408,11,8479589098
18793,943659570,1042,943660612,6,0,1,1024,12,9104689872
18794,943674150,136145,943810295,8,0,0,22528,12,8217733073
18795,943862590,2470,943865060,7,0,1,2560,8,89438732
18796,943914200,4937,943919137,1,0,1,12800,6,690051544
18797,943922169,3645,943925814,2,0,1,10240,4,1734614453
18798,943930689,88806,944019495,1,0,0,15872,6,4839608847
18799,943932170,116964,944049134,3,0,0,34816,2,3826886004
18800,943937200,3387,943940587,7,0,1,9728,8,9610901275
18801,943940210,88268,944028478,8,0,0,6144,12,2663783325
18802,944065070,98072,944163142,4,0,0,22016,16,5414084087
18803,944124440,100880,944225320,9,0,0,31232,18,3173212438
18804,944170290,121216,944291506,9,0,0,20480,18,7602859033
18805,944175090,77300,944252390,8,0,0,14336,12,8933202120
18806,944183050,12049,944195099,5,0,1,19968,19,3863333355
18807,944348290,103064,944451354,9,0,0,38400,18,1434752921
18808,944388000,5326,944393326,5,0,1,5632,19,5744239341
18809,944462419,55748,944518167,7,0,0,4096,8,6005614549
18810,944520880,47288,944568168,5,0,0,1536,19,8149553511
18811,944601039,107120,944708159,7,0,0,51712,8,5233992845
18812,944625839,3898,944629737,8,0,1,4096,12,4171913342
18813,944668590,45596,944714186,4,0,0,1024,16,3187973196
18814,944729089,103688,944832777,7,0,0,40448,8,4039550669
18815,944762199,139148,944901347,1,0,0,26112,6,4164247008
18816,944795460,97916,944893376,0,0,0,21504,11,5725349433
18817,944840220,62390,944902610,5,0,0,4096,19,6562692458
18818,944842560,89588,944932148,5,0,0,14336,19,4517822082
18819,944877620,100724,944978344,9,0,0,30720,18,10568626868
18820,944980700,54056,945034756,9,0,0,3584,18,6961718721
18821,945093280,75296,945168576,4,0,0,12800,16,1966000346
18822,945096150,80370,945176520,3,0,0,3584,2,3462458335
18823,945338100,52364,945390464,0,0,0,3072,11,6449715524
18824,945465610,51296,945516906,5,0,0,4608,19,10613619286
18825,945610380,65900,945676280,9,0,0,7168,18,6484631013
18826,945657910,48980,945706890,3,0,0,2048,2,3936763610
18827,945669669,105872,945775541,7,0,0,47616,8,7865134172
18828,945674180,101844,945776024,8,0,0,1536,12,7471527823
18829,945694210,134776,945828986,3,0,0,20992,2,9882980968
18830,945726150,96425,945822575,0,0,0,14336,11,5853866911
18831,945790739,99012,945889751,7,0,0,10752,8,2441474409
18832,945856560,94376,945950936,8,0,0,19968,12,4362563797
18833,945889861,113977,946003838,6,0,0,26112,12,642027713
18834,946016200,102908,946119108,3,0,0,37888,2,4037424679
18835,946020030,81308,946101338,3,0,0,17408,2,2052521961
18836,946054709,103357,946158066,7,0,0,18432,8,2954218743
18837,946069130,60468,946129598,0,0,0,2048,11,7053183411
18838,946092469,99788,946192257,7,0,0,27648,8,4862926265
18839,946102810,165035,946267845,3,0,0,40960,2,3603600282
18840,946157420,97930,946255350,0,0,0,19456,11,6980516698
18841,946231210,60824,946292034,9,0,0,5632,18,4025939826
18842,946235391,93284,946328675,6,0,0,16384,12,1660385538
18843,946371680,83756,946455436,0,0,0,15360,11,2263301991
18844,946423020,117166,946540186,8,0,0,65536,12,514106624
18845,946440170,15281,946455451,1,0,1,22016,6,1862303941
18846,946611640,3898,946615538,1,0,1,4096,6,2155820947
18847,946658860,55748,946714608,9,0,0,4096,18,462780915
18848,946759181,79436,946838617,6,0,0,11264,12,5169045895
18849,946803371,106964,946910335,6,0,0,51200,12,1185348578
18850,946842740,16096,946858836,6,0,1,31232,12,5510535298
18851,946932770,101972,947034742,0,0,0,34816,11,2771053895
18852,946940599,114943,947055542,1,0,0,29184,6,5242442244
18853,947047710,90044,947137754,3,0,0,15360,2,6974238566
18854,947122859,100724,947223583,7,0,0,30720,8,8988327420
18855,947197020,2470,947199490,1,0,1,2560,6,9214944530
18856,947311670,100724,947412394,2,0,0,30720,4,1012504587
18857,947345610,112378,947457988,8,0,0,17920,12,1804095162
18858,947509830,3898,947513728,7,0,1,4096,8,9331917803
18859,947599070,106028,947705098,9,0,0,48128,18,405222181
18860,947616050,43904,947659954,4,0,0,512,16,2540083374
18861,947637950,74360,947712310,3,0,0,9728,2,3102421223
18862,947644230,139534,947783764,8,0,0,78336,12,2132326359
18863,947717100,4937,947722037,6,0,1,12800,12,9887559471
18864,947879020,10499,947889519,1,0,1,16896,6,2123582368
18865,948045210,4679,948049889,4,0,1,12288,16,9310302586
18866,948059330,79616,948138946,3,0,0,16896,2,10622168815
18867,948060330,7706,948068036,5,0,1,8192,19,3054441904
18868,948068271,80432,948148703,6,0,0,6144,12,4815641182
18869,948115540,6488,948122028,7,0,1,15872,8,4988725234
18870,948154390,52364,948206754,8,0,0,3072,12,1288243886
18871,948275451,82400,948357851,6,0,0,20992,12,6643060647
18872,948342800,48980,948391780,4,0,0,2048,16,203529851
18873,948344460,4374,948348834,1,0,1,4608,6,1350387887
18874,948418390,111020,948529410,4,0,0,64512,16,7303118000
18875,948469190,125002,948594192,3,0,0,49152,2,1736154290
18876,948485641,202494,948688135,6,0,0,17408,12,6638366454
18877,948526650,84192,948610842,3,0,0,12800,2,9583661146
18878,948529050,99073,948628123,4,0,0,24064,16,10429951248
18879,948565880,4937,948570817,6,0,1,12800,12,6524562431
18880,948578860,183981,948762841,5,0,0,54784,19,4944921090
18881,948644380,174003,948818383,5,0,0,49152,19,2135413023
18882,948685791,112276,948798067,6,0,0,7680,12,10303453785
18883,948692209,1518,948693727,8,0,1,1536,12,4350953725
18884,948726490,130641,948857131,3,0,0,25088,2,2010028075
18885,948749060,143561,948892621,4,0,0,19456,16,897995819
18886,948937071,105560,949042631,6,0,0,46592,12,2345390254
18887,949079749,64208,949143957,1,0,0,6656,6,5157101037
18888,949228479,566,949229045,3,0,1,512,2,7308120039
18889,949236380,81440,949317820,5,0,0,12800,19,4955985180
18890,949425200,157649,949582849,4,0,0,30720,16,3441574751
18891,949429079,13858,949442937,8,0,1,23552,12,3831730316
18892,949442020,131454,949573474,5,0,0,9216,19,2417924730
18893,949453330,113088,949566418,3,0,0,11264,2,531182683
18894,949593450,54056,949647506,3,0,0,3584,2,7024495622
18895,949659910,1042,949660952,4,0,1,1024,16,5983877447
18896,949682860,13770,949696630,6,0,1,26624,12,6116743178
18897,949698811,99944,949798755,6,0,0,28160,12,5869642867
18898,949744591,196002,949940593,6,0,0,28672,12,2507610648
18899,949774870,99476,949874346,4,0,0,26624,16,8201313210
18900,949880750,86204,949966954,3,0,0,13312,2,9721297470
18901,949901890,98540,950000430,0,0,0,23552,11,8242715092
18902,949925580,76662,950002242,4,0,0,2048,16,1951409263
18903,949939841,150833,950090674,6,0,0,36352,12,4215492340
18904,949943690,100880,950044570,4,0,0,31232,16,2770294802
18905,950006580,1042,950007622,9,0,1,1024,18,157635573
18906,950044179,97429,950141608,7,0,0,15872,8,5597761815
18907,950046740,136160,950182900,0,0,0,52224,11,4601646270
18908,950057010,149254,950206264,3,0,0,9728,2,2219424475
18909,950120810,69116,950189926,3,0,0,3584,2,3904784377
18910,950315080,102128,950417208,5,0,0,35328,19,7619046851
18911,950324651,124453,950449104,6,0,0,24064,12,10545031875
18912,950328460,131708,950460168,8,0,0,25088,12,3651421338
18913,950406980,95608,950502588,3,0,0,12288,2,9916309347
18914,950458379,7583,950465962,8,0,1,6144,12,6528684558
18915,950477510,189311,950666821,3,0,0,32768,2,9091918546
18916,950505079,173760,950678839,1,0,0,512,6,1992018705
18917,950508269,62516,950570785,7,0,0,6144,8,2955220063
18918,950650299,105178,950755477,1,0,0,24064,6,1369624306
18919,950734430,3387,950737817,1,0,1,9728,6,6165380307
18920,950803161,73292,950876453,6,0,0,11264,12,2427545517
18921,950861949,90680,950952629,1,0,0,17920,6,4873034135
18922,950913239,55932,950969171,1,0,0,512,6,854496691
18923,950916479,117756,951034235,7,0,0,52736,8,1582495638
18924,950943110,108321,951051431,8,0,0,18432,12,4466754188
18925,950983760,131359,951115119,5,0,0,9216,19,1183073027
18926,950989740,11016,951000756,4,0,1,17920,16,9308332714
18927,951011731,77605,951089336,6,0,0,10240,12,7811283206
18928,951014680,71521,951086201,2,0,0,7680,4,10234183224
18929,951048230,91438,951139668,9,0,0,7168,18,63287115
18930,951073649,70216,951143865,7,0,0,6656,8,1211592986
18931,951224589,74360,951298949,7,0,0,9728,8,1354688866
18932,951340970,50828,951391798,2,0,0,3072,4,3755806906
18933,951391520,98966,951490486,5,0,0,24064,19,10521578550
18934,951408080,43904,951451984,3,0,0,512,2,1967187382
18935,951450170,116232,951566402,4,0,0,6144,16,2991892820
18936,951451320,156454,951607774,4,0,0,94208,16,4960838470
18937,951490960,5802,951496762,1,0,1,6144,6,5634904982
18938,951539570,3422,951542992,7,0,1,3584,8,5935576612
18939,951567780,6229,951574009,0,0,1,15360,11,2296054618
18940,951587421,134382,951721803,6,0,0,13312,12,10726978258
18941,951679580,45752,951725332,2,0,0,1536,4,7929370171
18942,951781611,57752,951839363,6,0,0,5632,12,1927041406
18943,951803999,566,951804565,8,0,1,512,12,2944075297
18944,951825631,104312,951929943,6,0,0,42496,12,7490542879
18945,951907560,50672,951958232,3,0,0,2560,2,7090238441
18946,951922501,51338,951973839,6,0,0,512,12,6044607132
18947,951934490,5802,951940292,7,0,1,6144,8,3122030028
18948,951942760,65900,952008660,2,0,0,7168,4,3830133797
18949,952179960,93418,952273378,5,0,0,10752,19,7047752009
18950,952197170,70220,952267390,8,0,0,11264,12,7192260557
18951,952260100,81128,952341228,8,0,0,11776,12,10629702173
18952,952278990,83898,952362888,9,0,0,12288,18,4287397396
18953,952299980,104156,952404136,2,0,0,41984,4,4165402450
18954,952307850,110232,952418082,9,0,0,15872,18,7385584404
18955,952394170,113022,952507192,0,0,0,38400,11,8673311576
18956,952457830,49845,952507675,3,0,0,1536,2,6195776516
18957,952486420,3645,952490065,1,0,1,10240,6,6663491017
18958,952526210,130405,952656615,8,0,0,74752,12,4591877807
18959,952533840,62516,952596356,3,0,0,6144,2,6083006109
18960,952544850,112092,952656942,0,0,0,1024,11,8594321166
18961,952755030,62384,952817414,2,0,0,10752,4,8424840178
18962,952793020,71624,952864644,9,0,0,15872,18,4924038735
18963,952816500,75266,952891766,9,0,0,9728,18,3745129219
18964,952839510,56528,952896038,5,0,0,6656,19,8223803
18965,952844039,67748,952911787,1,0,0,8192,6,974419391
18966,952905270,83780,952989050,9,0,0,20480,18,7166201996
18967,952961869,116636,953078505,7,0,0,82944,8,8363004850
18968,952969420,3422,952972842,1,0,1,3584,6,4723793798
18969,953002599,47288,953049887,7,0,0,1536,8,1658138265
18970,953027031,114738,953141769,6,0,0,31232,12,848962222
18971,953066789,12750,953079539,8,0,1,1024,12,4125830052
18972,953184560,117260,953301820,2,0,0,84992,4,446604232
18973,953260151,100229,953360380,6,0,0,12800,12,429979169
18974,953276669,85286,953361955,1,0,0,5120,6,1450069512
18975,953286400,93493,953379893,3,0,0,11776,2,1628961963
18976,953307710,566,953308276,6,0,1,512,12,5595784198
18977,953453501,98228,953551729,6,0,0,22528,12,9991788375
18978,953544559,52676,953597235,1,0,0,4096,6,704787866
18979,953569310,98696,953668006,8,0,0,24064,12,440653726
18980,953642040,48980,953691020,5,0,0,2048,19,3685481678
18981,953684610,112112,953796722,5,0,0,68096,19,5090108390
18982,953780150,30610,953810760,7,0,1,27136,8,2155311183
18983,953796130,99929,953896059,0,0,0,26112,11,9898726908
18984,953827269,138876,953966145,1,0,0,28160,6,1573393025
18985,953852290,3422,953855712,0,0,1,3584,11,100872363
18986,953912670,14545,953927215,6,0,1,28160,12,4462393727
18987,954013200,110552,954123752,0,0,0,62976,11,1200175128
18988,954036670,5802,954042472,0,0,1,6144,11,9591917336
18989,954293130,102596,954395726,9,0,0,36864,18,3855598030
18990,954320590,291979,954612569,2,0,0,36352,4,9912738651
18991,954321910,102754,954424664,2,0,0,9728,4,7167465726
18992,954340090,12737,954352827,5,0,1,24576,19,7196415652
18993,954348310,120593,954468903,9,0,0,21504,18,368894122
18994,954360360,1518,954361878,9,0,1,1536,18,7533147747
18995,954383830,11911,954395741,1,0,1,6656,6,10727356344
18996,954391090,140170,954531260,5,0,0,59904,19,4632925167
18997,954421940,179538,954601478,3,0,0,57344,2,3354623793
18998,954473479,150508,954623987,7,0,0,17920,8,2873821855
18999,954494370,124142,954618512,0,0,0,19456,11,9585270792
19000,954627610,10499,954638109,5,0,1,16896,19,5266970003
19001,954668021,122720,954790741,6,0,0,102912,12,9793969500
19002,954707180,6229,954713409,6,0,1,15360,12,3486304728
19003,954749740,107193,954856933,2,0,0,20480,4,4099517723
19004,954782780,124589,954907369,0,0,0,82944,11,3405147965
19005,954810709,7230,954817939,8,0,1,7680,12,8637671890
19006,954861239,132290,954993529,7,0,0,66048,8,6266564644
19007,954873560,159917,955033477,4,0,0,35840,16,10363077690
19008,954926041,76026,955002067,6,0,0,12288,12,9845692429
19009,954960579,94860,955055439,7,0,0,12800,8,3668106885
19010,954970770,147688,955118458,0,0,0,3584,11,2282458563
19011,954994940,142441,955137381,8,0,0,53760,12,6731731828
19012,955033880,3645,955037525,5,0,1,10240,19,3691175152
19013,955144010,3422,955147432,6,0,1,3584,12,5277633233
19014,955422970,69284,955492254,8,0,0,8192,12,7869893277
19015,955508970,2946,955511916,4,0,1,3072,16,1109896113
19016,955652980,97760,955750740,4,0,0,20992,16,8622191419
19017,955701910,102284,955804194,4,0,0,35840,16,124690399
19018,955752720,90836,955843556,5,0,0,18432,19,10378205247
19019,955791400,102854,955894254,0,0,0,31744,11,4090245219
19020,955828240,88832,955917072,9,0,0,16896,18,4270602723
19021,956010980,16096,956027076,1,0,1,31232,6,4488735420
19022,956024411,135662,956160073,6,0,0,15872,12,1815917501
19023,956099251,48980,956148231,6,0,0,2048,12,7147127479
19024,956114841,97628,956212469,6,0,0,25600,12,9948189021
19025,956214869,106652,956321521,7,0,0,50176,8,1070519324
19026,956223241,146340,956369581,6,0,0,46592,12,7233368578
19027,956254850,85921,956340771,8,0,0,4096,12,2876688144
19028,956350580,1042,956351622,4,0,1,1024,16,9765074817
19029,956510190,5454,956515644,5,0,1,13824,19,3459739885
19030,956534059,145208,956679267,7,0,0,2560,8,6047083287
19031,956617109,98384,956715493,1,0,0,23040,6,1004086163
19032,956635889,80399,956716288,7,0,0,2560,8,7284839612
19033,956728220,117260,956845480,2,0,0,84992,4,6317094783
19034,956750190,119129,956869319,8,0,0,39936,12,865196054
19035,956794850,223831,957018681,4,0,0,44544,16,8159640832
19036,956808109,1042,956809151,2,0,1,1024,4,1797524755
19037,956888370,69616,956957986,8,0,0,12288,12,5496252499
19038,956966510,112903,957079413,3,0,0,9728,2,7951317001
19039,956973230,50672,957023902,0,0,0,2560,11,4847209541
19040,957105280,57440,957162720,8,0,0,4608,12,3819495039
19041,957132860,64988,957197848,5,0,0,9216,19,2683346162
19042,957149269,82679,957231948,7,0,0,12800,8,2360237974
19043,957220550,100880,957321430,0,0,0,31232,11,1962064358
19044,957321031,106585,957427616,6,0,0,44544,12,8576340409
19045,957335650,14117,957349767,7,0,1,24064,8,9191795427
19046,957370959,84536,957455495,7,0,0,17920,8,386574408
19047,957401360,237524,957638884,4,0,0,56320,16,8515556023
19048,957447510,1042,957448552,9,0,1,1024,18,8083251632
19049,957530360,109163,957639523,4,0,0,2048,16,1267153179
19050,957545700,103120,957648820,3,0,0,13312,2,9734833105
19051,957554350,4374,957558724,0,0,1,4608,11,6934966183
19052,957602499,116515,957719014,1,0,0,71168,6,10186794231
19053,957613630,80208,957693838,3,0,0,8704,2,1537868512
19054,957640060,10499,957650559,1,0,1,16896,6,1110913925
19055,957726160,124375,957850535,9,0,0,86016,18,10374888687
19056,957736890,264348,958001238,8,0,0,45056,12,8839332523
19057,957751690,166894,957918584,9,0,0,6144,18,4623160778
19058,957775150,141547,957916697,4,0,0,70144,16,7915040121
19059,957836600,108310,957944910,9,0,0,21504,18,3395073253
19060,957846820,104345,957951165,8,0,0,20480,12,6203007548
19061,957874491,143817,958018308,6,0,0,9216,12,2320029320
19062,957894849,23750,957918599,3,0,1,26624,2,6253108187
19063,958043280,76052,958119332,8,0,0,10240,12,305593379
19064,958097280,4420,958101700,4,0,1,11776,16,4116658641
19065,958274070,59271,958333341,8,0,0,5120,12,4916046728
19066,958274170,1994,958276164,1,0,1,2048,6,9510712938
19067,958294229,45596,958339825,1,0,0,1024,6,1680404725
19068,958305131,64058,958369189,6,0,0,2048,12,4212098029
19069,958319889,1042,958320931,8,0,1,1024,12,5660479815
19070,958355140,70976,958426116,0,0,0,8704,11,3723882372
19071,958368000,110344,958478344,4,0,0,31232,16,985558879
19072,958369150,99663,958468813,3,0,0,27136,2,10246194421
19073,958589880,101036,958690916,8,0,0,31744,12,7374856607
19074,958632150,161198,958793348,8,0,0,78336,12,8850372737
19075,958698090,46396,958744486,9,0,0,1024,18,10505954663
19076,958698890,145092,958843982,0,0,0,26624,11,10188387312
19077,958749991,136932,958886923,6,0,0,19968,12,4699218433
19078,958811540,69284,958880824,9,0,0,8192,18,2182573252
19079,958836440,133112,958969552,0,0,0,14848,11,9737567647
19080,958889649,69284,958958933,7,0,0,8192,8,2750099146
19081,958925780,99632,959025412,8,0,0,27136,12,3852035066
19082,958967239,111471,959078710,1,0,0,19456,6,9411692269
19083,959001930,127384,959129314,3,0,0,34304,2,5595381209
19084,959082369,54368,959136737,7,0,0,4608,8,10530409300
19085,959098950,100724,959199674,2,0,0,30720,4,10544508354
19086,959165630,65172,959230802,4,0,0,4608,16,4786390393
19087,959166821,121347,959288168,6,0,0,93184,12,7989953448
19088,959211240,156848,959368088,4,0,0,55808,16,9154260641
19089,959227199,100137,959327336,7,0,0,12800,8,6173403759
19090,959277930,94760,959372690,2,0,0,14336,4,1708346739
19091,959287410,133238,959420648,8,0,0,14336,12,5672782732
19092,959368950,8106,959377056,0,0,1,4608,11,6413617417
19093,959435379,113984,959549363,1,0,0,74240,6,8011842230
19094,959509369,109148,959618517,1,0,0,58368,6,6750336691
19095,959519340,113232,959632572,0,0,0,46080,11,3791356978
19096,959675040,6278,959681318,0,0,1,6656,11,9940836118
19097,959689391,58511,959747902,6,0,0,2048,12,5541798964
19098,959720180,59876,959780056,8,0,0,5632,12,4472138522
19099,959751240,5326,959756566,6,0,1,5632,12,1316349674
19100,959814140,97004,959911144,2,0,0,23552,4,8061697101
19101,959859450,101972,959961422,3,0,0,34816,2,2683985792
19102,959984799,69284,960054083,7,0,0,8192,8,3253503615
19103,959994770,2946,959997716,5,0,1,3072,19,2839656182
19104,960007739,206544,960214283,7,0,0,57856,8,5129524151
19105,960048560,103181,960151741,5,0,0,15360,19,9723558991
19106,960053720,112493,960166213,5,0,0,22528,19,6580362411
19107,960085980,101893,960187873,0,0,0,23040,11,5426939179
19108,960093660,10757,960104417,5,0,1,17408,19,895774013
19109,960130930,102310,960233240,9,0,0,14848,18,2265672972
19110,960170469,136370,960306839,7,0,0,61952,8,814690895
19111,960221190,119567,960340757,4,0,0,15872,16,4849807632
19112,960255539,89958,960345497,1,0,0,11264,6,3020486021
19113,960414710,67148,960481858,0,0,0,11264,11,517639992
19114,960421410,5712,960427122,0,0,1,14336,11,6710673018
19115,960456930,6278,960463208,5,0,1,6656,19,7461182249
19116,960474529,2946,960477475,2,0,1,3072,4,4530190158
19117,960523439,62516,960585955,1,0,0,6144,6,45704840
19118,960567749,143836,960711585,7,0,0,29184,8,2777413703
19119,960678590,75961,960754551,8,0,0,12800,12,5051859052
19120,960825470,108368,960933838,3,0,0,55808,2,7601150983
19121,960857180,1518,960858698,9,0,1,1536,18,5605773285
19122,960998699,1042,960999741,8,0,1,1024,12,9456639817
19123,961059740,104000,961163740,8,0,0,41472,12,1728599518
19124,961082880,5802,961088682,6,0,1,6144,12,5910966863
19125,961207580,4374,961211954,7,0,1,4608,8,4812496774
19126,961253411,74852,961328263,6,0,0,16384,12,2816481137
19127,961348740,92552,961441292,8,0,0,24064,12,8910676960
19128,961357060,124324,961481384,2,0,0,24576,4,1664677322
19129,961409000,142314,961551314,0,0,0,26112,11,10142866386
19130,961507119,104780,961611899,1,0,0,44032,6,3378795932
19131,961561369,89422,961650791,1,0,0,3072,6,9328569957
19132,961690670,6278,961696948,9,0,1,6656,18,10064466349
19133,961714820,48980,961763800,3,0,0,2048,2,10727286237
19134,961905460,104780,962010240,0,0,0,44032,11,10532551860
19135,962057830,2470,962060300,7,0,1,2560,8,9704715660
19136,962090279,4850,962095129,2,0,1,5120,4,5951299641
19137,962212150,32041,962244191,9,0,1,52224,18,5588981851
19138,962226510,99517,962326027,5,0,0,21504,19,10107268603
19139,962261539,85178,962346717,1,0,0,1536,6,5928684006
19140,962385510,71005,962456515,0,0,0,8704,11,8836963389
19141,962405559,111020,962516579,7,0,0,64512,8,1175266909
19142,962461950,55424,962517374,3,0,0,2560,2,4612490770
19143,962484531,110945,962595476,6,0,0,41472,12,5235359794
19144,962590380,70988,962661368,2,0,0,7168,4,4809209025
19145,962636190,1518,962637708,6,0,1,1536,12,9122031971
19146,962712000,5712,962717712,1,0,1,14336,6,574052988
19147,962726320,91489,962817809,8,0,0,6656,12,1010012553
19148,962781900,69620,962851520,3,0,0,14336,2,7254993614
19149,962817730,4445,962822175,9,0,1,4608,18,3861800514
19150,962873300,50672,962923972,3,0,0,2560,2,10212286384
19151,962910530,112424,963022954,8,0,0,69120,12,4084378591
19152,962919629,174323,963093952,1,0,0,69120,6,8834551313
19153,962947800,164110,963111910,8,0,0,26112,12,9637551189
19154,962955220,112518,963067738,3,0,0,7168,2,10077702027
19155,963131460,50672,963182132,2,0,0,2560,4,3841993729
19156,963318179,50672,963368851,7,0,0,2560,8,9425845030
19157,963343469,79436,963422905,1,0,0,11264,6,1517568134
19158,963386410,47600,963434010,3,0,0,2560,2,3303813949
19159,963389020,97910,963486930,3,0,0,19968,2,1486563360
19160,963427250,64208,963491458,5,0,0,6656,19,3395633676
19161,963432891,62516,963495407,6,0,0,6144,12,3886214634
19162,963480330,106956,963587286,3,0,0,49664,2,1522075242
19163,963502170,137466,963639636,3,0,0,69120,2,3994976685
19164,963520199,79977,963600176,1,0,0,512,6,10136739126
19165,963542801,101499,963644300,6,0,0,9216,12,1536350722
19166,963575400,121778,963697178,8,0,0,10240,12,1620633642
19167,963613019,70623,963683642,7,0,0,6144,8,3251026960
19168,963638209,108851,963747060,1,0,0,52736,6,7482254886
19169,963642280,130420,963772700,3,0,0,25088,2,9587261868
19170,963673740,134670,963808410,8,0,0,26112,12,4592843322
19171,963715000,163628,963878628,2,0,0,23552,4,9798149551
19172,963741301,87907,963829208,6,0,0,6656,12,10512627595
19173,963813300,15923,963829223,1,0,1,24064,6,3101874471
19174,963831769,47186,963878955,7,0,0,1024,8,6802007715
19175,963897730,566,963898296,4,0,1,512,16,775304124
19176,963984290,6278,963990568,6,0,1,6656,12,2123025416
19177,964024040,2470,964026510,0,0,1,2560,11,9058576669
19178,964069809,135578,964205387,7,0,0,2560,8,4693318293
19179,964095079,69752,964164831,7,0,0,9728,8,4411894382
19180,964191279,90548,964281827,1,0,0,22528,6,3836353966
19181,964234209,103844,964338053,1,0,0,40960,6,8296651766
19182,964257950,101660,964359610,0,0,0,33792,11,6030068906
19183,964258170,126185,964384355,0,0,0,15360,11,10552657394
19184,964351610,12154,964363764,6,0,1,11264,12,5185875016
19185,964365910,93128,964459038,2,0,0,15872,4,2462991998
19186,964375730,45596,964421326,5,0,0,1024,19,4444880843
19187,964395090,7230,964402320,9,0,1,7680,18,4713760597
19188,964396621,206602,964603223,6,0,0,48128,12,10431913784
19189,964412520,193526,964606046,5,0,0,9216,19,4183171925
19190,964654040,43904,964697944,2,0,0,512,4,5097922430
19191,964659980,6278,964666258,9,0,1,6656,18,5543329396
19192,964687920,140705,964828625,9,0,0,48640,18,9558042777
19193,964745310,65900,964811210,3,0,0,7168,2,386441577
19194,964747660,98067,964845727,0,0,0,6144,11,8557871575
19195,964827980,54693,964882673,0,0,0,3584,11,5244754537
19196,964832600,92997,964925597,3,0,0,18432,2,5388381029
19197,964991930,55748,965047678,3,0,0,4096,2,7534160843
19198,965022860,70976,965093836,0,0,0,8704,11,6895533918
19199,965045520,86146,965131666,0,0,0,15360,11,8431557879
19200,965083690,97136,965180826,3,0,0,18944,2,1268965598
19201,965164259,78836,965243095,7,0,0,14336,8,7683540374
19202,965198250,124915,965323165,0,0,0,49152,11,621972349
19203,965219570,64364,965283934,8,0,0,7168,12,3766430238
19204,965299940,98852,965398792,3,0,0,24576,2,2592363421
19205,965340620,136502,965477122,2,0,0,48640,4,897950823
19206,965430720,60664,965491384,2,0,0,3584,4,6338057883
19207,965453590,67592,965521182,5,0,0,7680,19,567157381
19208,965539219,4162,965543381,2,0,1,11264,4,3577068870
19209,965540150,75530,965615680,5,0,0,10240,19,10648352185
19210,965570920,6754,965577674,1,0,1,7168,6,9311904389
19211,965577490,65768,965643258,9,0,0,11776,18,208607254
19212,965650890,104936,965755826,5,0,0,44544,19,10575743069
19213,965651429,79148,965730577,7,0,0,15360,8,8906117875
19214,965710490,69407,965779897,4,0,0,3584,16,5556110847
19215,965723199,77002,965800201,1,0,0,9728,6,165728133
19216,965765740,114531,965880271,0,0,0,44544,11,7258704504
19217,965854390,73316,965927706,0,0,0,16384,11,9782954411
19218,966158170,62516,966220686,5,0,0,6144,19,2598637389
19219,966160920,96980,966257900,8,0,0,18432,12,2718792862
19220,966173139,64208,966237347,7,0,0,6656,8,4563137758
19221,966223089,114296,966337385,7,0,0,75264,8,9088787159
19222,966249069,47450,966296519,1,0,0,512,6,5389365907
19223,966253010,103593,966356603,8,0,0,6144,12,3463096166
19224,966370690,1518,966372208,4,0,1,1536,16,6803502129
19225,966429730,85941,966515671,0,0,0,16384,11,8381723722
19226,966440819,57440,966498259,7,0,0,4608,8,178426285
19227,966455590,133593,966589183,2,0,0,71168,4,130441414
19228,966531440,1994,966533434,0,0,1,2048,11,7829436930
19229,966533010,76052,966609062,4,0,0,10240,16,3077930946
19230,966553089,3898,966556987,2,0,1,4096,4,5283924007
19231,966786241,63920,966850161,6,0,0,10752,12,231541943
19232,966884670,2870,966887540,5,0,1,8704,19,3574377838
19233,966888970,100100,966989070,5,0,0,28672,19,7248600582
19234,966960091,68372,967028463,6,0,0,10240,12,10004318028
19235,966970240,102503,967072743,0,0,0,19456,11,10367374912
19236,966999080,76486,967075566,4,0,0,9216,16,1096881380
19237,967037790,114184,967151974,8,0,0,44544,12,4178560731
19238,967080659,108212,967188871,1,0,0,55296,6,8806731113
19239,967122110,138095,967260205,2,0,0,61440,4,9366442573
19240,967255860,107401,967363261,8,0,0,38400,12,10140764344
19241,967353601,112404,967466005,6,0,0,37376,12,10404984159
19242,967389840,4850,967394690,4,0,1,5120,16,5609660803
19243,967464730,51939,967516669,2,0,0,2560,4,9850743314
19244,967494981,69982,967564963,6,0,0,8704,12,2993333918
19245,967532380,98384,967630764,2,0,0,23040,4,4511429110
19246,967573100,79172,967652272,8,0,0,20480,12,456296332
19247,967677950,6488,967684438,6,0,1,15872,12,5959131226
19248,967679269,79618,967758887,1,0,0,10240,6,9269366183
19249,967734490,3422,967737912,0,0,1,3584,11,8815454112
19250,967803141,83300,967886441,6,0,0,12800,12,7456504727
19251,967829970,65429,967895399,0,0,1,110592,11,577873134
19252,967848290,121785,967970075,2,0,0,17920,4,7098405562
19253,967890670,190163,968080833,0,0,0,11776,11,2152839542
19254,967951460,52364,968003824,4,0,0,3072,16,5954784677
19255,968105080,1994,968107074,7,0,1,2048,8,6686229873
19256,968178069,97916,968275985,1,0,0,21504,6,5393753785
19257,968215600,4937,968220537,4,0,1,12800,16,7051267805
19258,968268710,7290,968276000,9,0,1,9728,18,7648652286
19259,968285940,6754,968292694,5,0,1,7168,19,2319890978
19260,968328541,115856,968444397,6,0,0,80384,12,4708332351
19261,968429960,121650,968551610,0,0,1,178688,11,6696996973
19262,968464340,179123,968643463,4,0,0,1024,16,7282118542
19263,968521030,34446,968555476,6,0,1,6144,12,3030025285
19264,968566200,197644,968763844,4,0,0,27648,16,1486068486
19265,968758480,122797,968881277,4,0,0,85504,16,8047044553
19266,968760949,158535,968919484,1,0,0,49664,6,4140246010
19267,968870140,93505,968963645,8,0,0,15872,12,707050424
19268,968891710,139495,969031205,5,0,0,76288,19,9468157354
19269,968978980,110708,969089688,5,0,0,63488,19,6752027652
19270,968991750,4679,968996429,6,0,1,12288,12,10122265986
19271,969108859,54056,969162915,7,0,0,3584,8,4788987177
19272,969117350,73058,969190408,0,0,1,118784,11,10373920459
19273,969208450,195961,969404411,4,0,0,32768,16,2725711673
19274,969260110,81649,969341759,0,0,0,3584,11,7214801336
19275,969410510,5326,969415836,4,0,1,5632,16,7455741259
19276,969531560,101660,969633220,5,0,0,33792,19,10718513055
19277,969651950,2946,969654896,7,0,1,3072,8,4537645606
19278,969722589,140935,969863524,1,0,0,2560,6,10640207130
19279,969742570,70976,969813546,5,0,0,8704,19,1294516896
19280,969743390,113828,969857218,4,0,0,73728,16,5171856335
19281,969779930,4162,969784092,6,0,1,11264,12,10702331230
19282,969814280,76166,969890446,4,0,0,4096,16,2671407432
19283,969875560,130586,970006146,0,0,0,77824,11,882700107
19284,969889860,2572,969892432,9,0,1,2048,18,7004077549
19285,969905130,1042,969906172,6,0,1,1024,12,2904041063
19286,969930700,2946,969933646,9,0,1,3072,18,9027055686
19287,970098590,72824,970171414,4,0,0,9728,16,5067228748
19288,970159500,2470,970161970,4,0,1,2560,16,6529201079
19289,970216031,63296,970279327,6,0,0,8704,12,663798683
19290,970223819,5196,970229015,2,0,1,13312,4,3741457604
19291,970242091,106028,970348119,6,0,0,48128,12,7670203164
19292,970393610,1994,970395604,5,0,1,2048,19,5385052145
19293,970489150,79189,970568339,5,0,0,7680,19,9029265898
19294,970605499,11016,970616515,8,0,1,17920,12,5997504848
19295,970678780,13341,970692121,6,0,1,22528,12,6511483593
19296,971002659,80996,971083655,7,0,0,16384,8,1529756022
19297,971044550,12049,971056599,5,0,1,19968,19,370981508
19298,971177480,113828,971291308,2,0,0,73728,4,1650491129
19299,971279310,17316,971296626,7,0,1,5632,8,4258860314
19300,971417411,101192,971518603,6,0,0,32256,12,5941823239
19301,971435330,69284,971504614,8,0,0,8192,12,10484597121
19302,971465670,4679,971470349,1,0,1,12288,6,7310372694
19303,971495450,73443,971568893,2,0,0,5120,4,3030251363
19304,971609760,113516,971723276,5,0,0,72704,19,3539723105
19305,971640610,146332,971786942,8,0,0,48640,12,1630440600
19306,971831390,100100,971931490,5,0,0,28672,19,4353361980
19307,971846080,11016,971857096,1,0,1,17920,6,8682223096
19308,972054410,73604,972128014,2,0,0,12288,4,7865822327
19309,972145690,54680,972200370,8,0,0,5632,12,2483038075
19310,972181331,86228,972267559,6,0,0,18432,12,1535815591
19311,972209610,81596,972291206,5,0,0,13312,19,3272912168
19312,972210820,134655,972345475,4,0,0,45056,16,8978409534
19313,972317450,188695,972506145,5,0,0,32256,19,7109952686
19314,972317970,143521,972461491,0,0,0,26624,11,1847254991
19315,972324739,89792,972414531,7,0,0,25088,8,6509023462
19316,972372080,81284,972453364,9,0,0,12288,18,3534444894
19317,972386061,167566,972553627,6,0,0,53248,12,6264540504
19318,972442310,19196,972461506,0,0,1,21504,11,10650940324
19319,972554009,126935,972680944,1,0,0,53760,6,9327529930
19320,972561089,50672,972611761,1,0,0,2560,6,2604298969
19321,972573200,120707,972693907,8,0,0,42496,12,5014570554
19322,972645100,127620,972772720,5,0,0,55296,19,4063197437
19323,972662410,31512,972693922,5,0,1,41984,19,9554594986
19324,972689200,10168,972699368,0,0,1,13824,11,854884511
19325,972782910,1994,972784904,1,0,1,2048,6,4037882132
19326,972791830,126963,972918793,8,0,0,12800,12,5791974509
19327,972818060,54056,972872116,2,0,0,3584,4,8974439250
19328,972873620,1518,972875138,1,0,1,1536,6,9948430047
19329,972879340,96824,972976164,0,0,0,17920,11,5157526043
19330,972961820,119061,973080881,2,0,0,34304,4,4207944923
19331,973090850,65768,973156618,2,0,0,11776,4,8496782610
19332,973308550,4162,973312712,1,0,1,11264,6,964302802
19333,973330380,50672,973381052,4,0,0,2560,16,284802934
19334,973394019,101504,973495523,7,0,0,33280,8,3524021300
19335,973506040,94712,973600752,4,0,0,26112,16,6330902144
19336,973608000,81620,973689620,8,0,0,18432,12,3782435977
19337,973709551,85160,973794711,6,0,0,19968,12,9545334861
19338,973717240,95288,973812528,8,0,0,17920,12,6077853566
19339,973918390,84092,974002482,0,0,0,21504,11,9363742213
19340,973939960,6278,973946238,9,0,1,6656,18,2412842617
19341,973954350,2870,973957220,6,0,1,8704,12,8403378824
19342,973977630,57440,974035070,2,0,0,4608,4,8745593033
19343,973993960,156613,974150573,4,0,0,5632,16,6977665397
19344,974003951,55748,974059699,6,0,0,4096,12,4319390485
19345,974048110,72441,974120551,8,0,0,1024,12,2620852816
19346,974117630,90524,974208154,4,0,0,17408,16,6009718903
19347,974133070,54056,974187126,0,0,0,3584,11,7462850934
19348,974196150,3904,974200054,1,0,1,10752,6,6323576233
19349,974277830,51296,974329126,5,0,0,4608,19,3112813722
19350,974314200,14941,974329141,9,0,1,23552,18,10509936910
19351,974366430,4679,974371109,7,0,1,12288,8,3765982619
19352,974422890,223201,974646091,4,0,0,101888,16,7098892044
19353,974499380,21141,974520521,0,0,1,34304,11,4367572922
19354,974553310,4937,974558247,5,0,1,12800,19,7739781759
19355,974570399,6754,974577153,2,0,1,7168,4,6384551056
19356,974602000,48980,974650980,2,0,0,2048,4,3283804448
19357,974605411,82643,974688054,6,0,0,6656,12,6435048194
19358,974758700,4850,974763550,6,0,1,5120,12,1593649020
19359,974834840,123219,974958059,0,0,0,8704,11,578592029
19360,974840589,50672,974891261,1,0,0,2560,6,10036003424
19361,974898290,61344,974959634,2,0,0,5120,4,7100681153
19362,975003549,45596,975049145,7,0,0,1024,8,6572341230
19363,975021990,33762,975055752,4,0,1,58880,16,7092247888
19364,975025800,59775,975085575,2,0,0,1024,4,4756327979
19365,975064519,72118,975136637,7,0,0,5120,8,3459590936
19366,975100629,3645,975104274,8,0,1,10240,12,6244585052
19367,975245491,103220,975348711,6,0,0,38912,12,3299980430
19368,975390450,73760,975464210,5,0,0,12800,19,4325809943
19369,975412880,1042,975413922,5,0,1,1024,19,8106616241
19370,975447111,105716,975552827,6,0,0,47104,12,3772834071
19371,975485270,147180,975632450,5,0,0,78336,19,9718299388
19372,975547509,61058,975608567,1,0,0,4096,6,8943176642
19373,975565151,100463,975665614,6,0,0,27648,12,2000069588
19374,975601351,155097,975756448,6,0,0,97792,12,290836703
19375,975637080,140517,975777597,2,0,0,45568,4,2533070458
19376,975719380,87920,975807300,5,0,0,18944,19,9272746001
19377,975738120,41270,975779390,1,0,1,37888,6,5396470400
19378,975756499,89363,975845862,7,0,0,13312,8,10216522542
19379,975821101,178803,975999904,6,0,0,28160,12,1730802874
19380,975858890,2470,975861360,6,0,1,2560,12,4046376113
19381,975868390,183010,976051400,4,0,0,3072,16,9937242228
19382,975936501,102049,976038550,6,0,0,7680,12,7372678043
19383,975938360,45596,975983956,4,0,0,1024,16,4711395950
19384,975945400,71310,976016710,2,0,0,1536,4,6472318392
19385,975951420,96068,976047488,9,0,0,20480,18,1134132577
19386,976014159,566,976014725,2,0,1,512,4,2901236990
19387,976054371,107120,976161491,6,0,0,51712,12,8199038973
19388,976093680,7230,976100910,5,0,1,7680,19,8910059143
19389,976103130,118309,976221439,9,0,0,1536,18,3140071796
19390,976225940,78212,976304152,9,0,0,12288,18,2999805866
19391,976310490,80240,976390730,2,0,0,18944,4,2072486127
19392,976335890,95756,976431646,2,0,0,19456,4,1859887929
19393,976415420,2946,976418366,7,0,1,3072,8,7712834638
19394,976521429,50672,976572101,1,0,0,2560,6,290554801
19395,976536129,6278,976542407,2,0,1,6656,4,8260115432
19396,976593499,98696,976692195,1,0,0,24064,6,5745845851
19397,976830340,1518,976831858,5,0,1,1536,19,5878543119
19398,976955209,87608,977042817,1,0,0,17920,6,2627951062
19399,977087160,107900,977195060,4,0,0,54272,16,10218555594
19400,977196960,68684,977265644,5,0,0,11264,19,9136402549
19401,977231241,106028,977337269,6,0,0,48128,12,831189940
19402,977423840,100100,977523940,4,0,0,28672,16,1794492396
19403,977464240,61127,977525367,8,0,0,4608,12,2622732397
19404,977501320,107588,977608908,8,0,0,53248,12,5064133273
19405,977516901,59541,977576442,6,0,0,1024,12,2711024153
19406,977643270,83000,977726270,9,0,0,17920,18,618220265
19407,977737089,61916,977799005,7,0,0,9216,8,3967643124
19408,977791939,102440,977894379,1,0,0,36352,6,203826650
19409,977795209,4374,977799583,2,0,1,4608,4,6104231748
19410,977951909,106184,978058093,7,0,0,48640,8,10401459901
19411,978116361,102284,978218645,6,0,0,35840,12,9203955699
19412,978231810,64208,978296018,5,0,0,6656,19,10499906429
19413,978244849,43904,978288753,7,0,0,512,8,6368431710
19414,978391530,95756,978487286,8,0,0,19456,12,3008499224
19415,978407690,85695,978493385,2,0,0,19968,4,4637072620
19416,978434539,112424,978546963,1,0,0,69120,6,5174786876
19417,978435380,138918,978574298,5,0,0,20480,19,3928674835
19418,978511710,2470,978514180,1,0,1,2560,6,2654336315
19419,978518550,56387,978574937,9,0,0,2048,18,2726784377
19420,978544831,102631,978647462,6,0,0,16384,12,8965504839
19421,978623371,103471,978726842,6,0,0,27648,12,10641928842
19422,978707110,79436,978786546,9,0,0,11264,18,8938129950
19423,978841850,106340,978948190,4,0,0,49152,16,867753364
19424,978847531,112935,978960466,6,0,0,13824,12,7600264930
19425,978874840,181236,979056076,9,0,0,54272,18,3342571676
19426,978879010,128586,979007596,8,0,0,1024,12,7700405154
19427,978887960,146714,979034674,5,0,0,3072,19,3076001671
19428,978893799,11016,978904815,8,0,1,17920,12,5830284328
19429,978928309,63483,978991792,7,0,0,4608,8,2291835380
19430,978997369,167379,979164748,7,0,0,56832,8,8524405341
19431,979054980,82108,979137088,2,0,0,21504,4,7131617480
19432,979219860,114140,979334000,5,0,0,74752,19,10453657110
19433,979222500,169550,979392050,5,0,0,32256,19,6354436499
19434,979322970,99230,979422200,5,0,0,14848,19,8347935585
19435,979342290,96668,979438958,5,0,0,17408,19,9344441595
19436,979393820,108204,979502024,8,0,0,22528,12,564858729
19437,979439849,112268,979552117,7,0,0,68608,8,7134338527
19438,979463220,13341,979476561,9,0,1,22528,18,3181708050
19439,979517050,45437,979562487,4,0,1,78336,16,9117818980
19440,979544540,23951,979568491,7,0,1,20480,8,4727169160
19441,979619749,1042,979620791,2,0,1,1024,4,4384964139
19442,979790399,80396,979870795,7,0,0,19456,8,10477389478
19443,979937241,98384,980035625,6,0,0,23040,12,8038389494
19444,979967340,138035,980105375,2,0,0,18944,4,3098727418
19445,980009039,54168,980063207,1,0,0,1536,6,260160509
19446,980150290,70976,980221266,5,0,0,8704,19,8458645066
19447,980196190,104054,980300244,9,0,0,39936,18,2710941745
19448,980281880,139672,980421552,5,0,0,32768,19,9072328489
19449,980288191,77033,980365224,6,0,0,9216,12,4954454097
19450,980370599,115856,980486455,7,0,0,80384,8,7337540180
19451,980434870,95013,980529883,9,0,0,24064,18,10632755587
19452,980499610,30288,980529898,5,0,1,41984,19,1117412887
19453,980630670,148567,980779237,5,0,0,23552,19,4041582062
19454,980704610,3645,980708255,7,0,1,10240,8,1198205427
19455,980725900,89068,980814968,2,0,0,12800,4,7135981796
19456,980765891,105716,980871607,6,0,0,47104,12,9986607192
19457,980908320,91231,980999551,4,0,0,15872,16,2713736924
19458,980958449,135218,981093667,1,0,0,25088,6,2698639070
19459,981290480,88988,981379468,8,0,0,17408,12,10091824564
19460,981376370,99914,981476284,5,0,0,17920,19,4955982494
19461,981449570,11274,981460844,5,0,1,18432,19,6404716169
19462,981459349,82220,981541569,1,0,0,15360,6,9832741957
19463,981565669,90162,981655831,1,0,0,15872,6,1944399940
19464,981579380,71600,981650980,5,0,0,10752,19,8258298296
19465,981652701,79642,981732343,6,0,0,11776,12,3025845483
19466,981731701,69474,981801175,6,0,0,11776,12,5669924335
19467,981798580,6961,981805541,4,0,1,4608,16,3918293122
19468,981842739,91280,981934019,7,0,0,14848,8,9127085726
19469,981937820,73004,982010824,9,0,0,15360,18,1881038579
19470,981969410,10241,981979651,1,0,1,16384,6,5376168157
19471,982006029,47444,982053473,7,0,0,2048,8,10026293018
19472,982053290,102147,982155437,5,0,0,34816,19,7217057599
19473,982088500,84131,982172631,8,0,0,9216,12,5547545853
19474,982123550,56968,982180518,2,0,0,1024,4,214548491
19475,982206560,5326,982211886,4,0,1,5632,16,7289484600
19476,982319750,60692,982380442,8,0,0,10240,12,441270934
19477,982351499,54056,982405555,7,0,0,3584,8,3460419361
19478,982486830,62072,982548902,4,0,0,9728,16,106162197
19479,982619620,54056,982673676,8,0,0,3584,12,5248125776
19480,982623200,1042,982624242,7,0,1,1024,8,1820490004
19481,982638360,106496,982744856,4,0,0,49664,16,7035974852
19482,982689340,4850,982694190,9,0,1,5120,18,5767576435
19483,982693531,131551,982825082,6,0,0,84992,12,537526991
19484,982761350,107515,982868865,8,0,0,47616,12,7193980711
19485,982763311,138428,982901739,6,0,0,8192,12,8705122378
19486,982781070,57596,982838666,9,0,0,5120,18,6249695636
19487,982944110,76388,983020498,5,0,0,16384,19,7451169002
19488,982954710,121960,983076670,9,0,0,39424,18,8891609274
19489,983003021,109923,983112944,6,0,0,36864,12,4420270221
19490,983025391,60224,983085615,6,0,0,8704,12,10532253745
19491,983073620,113911,983187531,9,0,0,43520,18,10331387926
19492,983137910,10757,983148667,1,0,1,17408,6,1755761415
19493,983218019,54836,983272855,7,0,0,6144,8,6227516886
19494,983294290,121950,983416240,9,0,0,90112,18,3800841219
19495,983297420,133918,983431338,9,0,0,13824,18,886838340
19496,983300079,188523,983488602,7,0,0,40448,8,7797171476
19497,983493040,106964,983600004,5,0,0,51200,19,3056923000
19498,983508880,1042,983509922,7,0,1,1024,8,269851737
19499,983510339,67148,983577487,7,0,0,11264,8,6540197903
19500,983602960,54992,983657952,5,0,0,6656,19,4997869911
19501,983677360,113672,983791032,4,0,0,73216,16,5488887738
19502,983730310,72572,983802882,8,0,0,5120,12,4127267574
19503,983961319,99944,984061263,7,0,0,28160,8,2444088370
19504,983994870,78860,984073730,5,0,0,19456,19,9466884522
19505,984012030,4937,984016967,1,0,1,12800,6,6999214374
19506,984175260,3422,984178682,9,0,1,3584,18,1830497887
19507,984224650,101348,984325998,4,0,0,32768,16,761934718
19508,984226660,6229,984232889,9,0,1,15360,18,8987551332
19509,984342520,78704,984421224,5,0,0,18944,19,9717377707
19510,984385080,146484,984531564,4,0,0,81408,16,2234031374
19511,984391010,102130,984493140,4,0,0,10752,16,1606747075
19512,984536780,106184,984642964,5,0,0,48640,19,6014682694
19513,984587300,64208,984651508,5,0,0,6656,19,9071719235
19514,984591720,1042,984592762,7,0,1,1024,8,5753129637
19515,984694960,50828,984745788,9,0,0,3072,18,51923771
19516,984710110,104156,984814266,4,0,0,41984,16,2997958101
19517,984732780,100848,984833628,4,0,0,3584,16,5901841386
19518,984806271,110583,984916854,6,0,0,36864,12,9433258057
19519,984811131,58900,984870031,6,0,0,4096,12,1798603210
19520,984854960,2470,984857430,7,0,1,2560,8,7961947372
19521,984979109,7706,984986815,8,0,1,8192,12,875147159
19522,985097589,83600,985181189,7,0,0,14848,8,1553082555
19523,985207001,50672,985257673,6,0,0,2560,12,2592400904
19524,985277560,58844,985336404,5,0,0,9216,19,4563001781
19525,985315080,71156,985386236,8,0,0,14336,12,7283812173
19526,985369880,103220,985473100,4,0,0,38912,16,5598210661
19527,985528700,113048,985641748,5,0,0,71168,19,1258173934
19528,985590920,89588,985680508,5,0,0,14336,19,3505367648
19529,985611650,110486,985722136,9,0,0,35328,18,3432844545
19530,985659510,84092,985743602,8,0,0,21504,12,10394666696
19531,985677630,82046,985759676,8,0,0,2560,12,8411978446
19532,985702540,5326,985707866,7,0,1,5632,8,234708340
19533,985744590,122083,985866673,4,0,0,4608,16,8335532372
19534,985832550,1042,985833592,4,0,1,1024,16,3107440881
19535,985897641,103376,986001017,6,0,0,39424,12,6041557281
19536,986122940,100724,986223664,8,0,0,30720,12,9155767089
19537,986195650,69284,986264934,4,0,0,8192,16,8344575528
19538,986200380,2946,986203326,5,0,1,3072,19,801264791
19539,986254640,106964,986361604,5,0,0,51200,19,2131245501
19540,986276800,11791,986288591,7,0,1,19456,8,6222632495
19541,986524480,58376,986582856,9,0,0,7680,18,1432713367
19542,986544780,83780,986628560,9,0,0,20480,18,4987913773
19543,986679379,77324,986756703,7,0,0,19456,8,4836632011
19544,986766600,2946,986769546,5,0,1,3072,19,10625736638
19545,986850439,98096,986948535,7,0,0,27136,8,7432997095
19546,986877860,58220,986936080,8,0,0,7168,12,8285231767
19547,987174459,108836,987283295,7,0,0,57344,8,226463368
19548,987273820,11461,987285281,7,0,1,2048,8,9137346157
19549,987318379,47288,987365667,7,0,0,1536,8,1618564490
19550,987403880,1042,987404922,5,0,1,1024,19,2180751806
19551,987521480,100412,987621892,9,0,0,29696,18,5227491543
19552,987629239,43904,987673143,7,0,0,512,8,951836921
19553,987651340,99788,987751128,4,0,0,27648,16,2745708426
19554,987742260,83912,987826172,9,0,0,15872,18,5190261559
19555,987808430,65900,987874330,8,0,0,7168,12,6334175360
19556,987926920,2946,987929866,7,0,1,3072,8,1493913342
19557,987957879,65900,988023779,7,0,0,7168,8,153034702
19558,987967340,89144,988056484,4,0,0,17920,16,9906665281
19559,988016180,59660,988075840,9,0,0,3584,18,10068855855
19560,988044950,86384,988131334,4,0,0,18944,16,4007349125
19561,988099560,52364,988151924,5,0,0,3072,19,3324575145
19562,988134690,1994,988136684,4,0,1,2048,16,8166388573
19563,988190810,4374,988195184,5,0,1,4608,19,8213399972
19564,988416500,116480,988532980,8,0,0,82432,12,6502459488
19565,988475730,79366,988555096,9,0,0,1536,18,9170720063
19566,988505670,46042,988551712,5,0,0,512,19,10166454673
19567,988609259,121004,988730263,7,0,0,97280,8,8112736829
19568,988756860,72668,988829528,5,0,0,9216,19,610064614
19569,988778389,71756,988850145,7,0,0,11264,8,7034532780
19570,988910229,61448,988971677,7,0,0,7680,8,8753603505
19571,988928460,67928,988996388,9,0,0,13824,18,1616182355
19572,988942960,82069,989025029,9,0,0,4096,18,5965477770
19573,989278799,61916,989340715,7,0,0,9216,8,7071992658
19574,989311580,99476,989411056,9,0,0,26624,18,8665458352
19575,989348399,100880,989449279,7,0,0,31232,8,7980227961
19576,989462859,114920,989577779,7,0,0,77312,8,10099469506
19577,989536609,179173,989715782,7,0,0,69632,8,9780001195
19578,989541420,88988,989630408,9,0,0,17408,18,4388376503
19579,989551230,82781,989634011,9,0,0,11776,18,8057438328
19580,989690470,59132,989749602,5,0,0,5120,19,3659799948
19581,989956790,3422,989960212,5,0,1,3584,19,7256809013
19582,989984579,100412,990084991,7,0,0,29696,8,405524457
19583,990014430,177143,990191573,5,0,0,30720,19,2407743254
19584,990162540,102284,990264824,4,0,0,35840,16,8212793035
19585,990162630,121856,990284486,5,0,0,28672,19,9227856718
19586,990267539,92084,990359623,7,0,0,22528,8,5168676974
19587,990328080,108836,990436916,8,0,0,57344,12,8172302050
19588,990494029,3645,990497674,8,0,1,10240,12,1142666070
19589,990502010,115336,990617346,8,0,0,43008,12,38544941
19590,990517520,159586,990677106,9,0,0,77824,18,8693074171
19591,990575460,70654,990646114,9,0,0,5120,18,5082191374
19592,990688990,4850,990693840,7,0,1,5120,8,3332478225
19593,990746330,74672,990821002,9,0,0,10752,18,2426588876
19594,990753830,98072,990851902,4,0,0,22016,16,6355367765
19595,990923499,103844,991027343,7,0,0,40960,8,4578288357
19596,990930130,81061,991011191,5,0,0,3072,19,7894436141
19597,990975330,137855,991113185,8,0,0,94720,12,5052612731
19598,991011220,138172,991149392,9,0,0,38400,18,7537877277
19599,991077829,181016,991258845,7,0,0,31232,8,1524279582
19600,991092750,24325,991117075,9,0,1,4096,18,4670081319
19601,991117660,151816,991269476,8,0,0,16896,12,1074364987
19602,991306319,63296,991369615,7,0,0,8704,8,5666767634
19603,991531890,100100,991631990,5,0,0,28672,19,9948150991
19604,991613960,43904,991657864,8,0,0,512,12,2835685627
19605,991615239,102853,991718092,7,0,0,36864,8,8922584893
19606,991667900,126362,991794262,8,0,0,58880,12,482334994
19607,991723309,132555,991855864,7,0,0,53248,8,1978012917
19608,991767410,2470,991769880,9,0,1,2560,18,10450706051
19609,992016180,7230,992023410,4,0,1,7680,16,1811456735
19610,992144699,4850,992149549,8,0,1,5120,12,9122657444
19611,992425150,126777,992551927,5,0,0,95232,19,6281607999
19612,992444720,1994,992446714,9,0,1,2048,18,4383853744
19613,992461290,119370,992580660,5,0,0,12800,19,6127185119
19614,992549730,6563,992556293,5,0,1,4608,19,2579491354
19615,992859500,115388,992974888,5,0,0,78848,19,7405919322
19616,993018560,4937,993023497,7,0,1,12800,8,8324570759
19617,993086890,97448,993184338,4,0,0,19968,16,6859356986
19618,993126130,5326,993131456,7,0,1,5632,8,6704178592
19619,993206920,140317,993347237,5,0,0,82944,19,7196215738
19620,993221420,129123,993350543,5,0,0,6144,19,2921880566
19621,993247720,100936,993348656,8,0,0,4608,12,9796934353
19622,993284290,2470,993286760,7,0,1,2560,8,10050807361
19623,993541649,54056,993595705,7,0,0,3584,8,4949425028
19624,993748910,87944,993836854,4,0,0,24064,16,266644554
19625,993785760,566,993786326,9,0,1,512,18,10168102721
19626,994209359,6754,994216113,8,0,1,7168,12,3764104288
19627,994226950,66524,994293474,8,0,0,9216,12,152638076
19628,994304610,43904,994348514,8,0,0,512,12,1516036599
19629,994361100,102128,994463228,9,0,0,35328,18,173434203
19630,994428390,71756,994500146,5,0,0,11264,19,3382980090
19631,994541330,88364,994629694,4,0,0,15360,16,2100960100
19632,994697450,62516,994759966,5,0,0,6144,19,1711313378
19633,994828060,104000,994932060,8,0,0,41472,12,6154760745
19634,994937850,74672,995012522,5,0,0,10752,19,8876243849
19635,994994810,77144,995071954,4,0,0,13824,16,60868492
19636,995262480,102752,995365232,4,0,0,37376,16,1042455637
19637,995317940,70976,995388916,4,0,0,8704,16,4379577067
19638,995320390,55748,995376138,5,0,0,4096,19,9188624832
19639,995404489,49136,995453625,7,0,0,2560,8,5451388285
19640,995519030,101036,995620066,9,0,0,31744,18,925283705
19641,995577110,123092,995700202,9,0,0,40448,18,8849854048
19642,995582310,89768,995672078,5,0,0,19968,19,6911104561
19643,995611750,60499,995672249,8,0,0,512,12,1479642938
19644,995613190,103765,995716955,9,0,0,28160,18,5877978053
19645,995616790,138198,995754988,4,0,0,22528,16,790689362
19646,995629700,4374,995634074,9,0,1,4608,18,2603292177
19647,995752059,106921,995858980,7,0,0,41472,8,5026776354
19648,995913370,108056,996021426,9,0,0,54784,18,2865795371
19649,996165630,76052,996241682,9,0,0,10240,18,5855262439
19650,996249690,106496,996356186,8,0,0,49664,12,8972446384
19651,996297160,12049,996309209,9,0,1,19968,18,2442077337
19652,996396530,3422,996399952,7,0,1,3584,8,3111128152
19653,996504520,104624,996609144,9,0,0,43520,18,3487013271
19654,996588670,59522,996648192,9,0,0,3072,18,9306605735
19655,996641290,77300,996718590,4,0,0,14336,16,10651603059
19656,996652790,3422,996656212,4,0,1,3584,16,1200331741
19657,996804760,47288,996852048,4,0,0,1536,16,7168441070
19658,996918900,102284,997021184,4,0,0,35840,16,6205368214
19659,996947600,125825,997073425,4,0,0,15360,16,9114705105
19660,996997349,87788,997085137,7,0,0,23552,8,2402386438
19661,997091330,47288,997138618,8,0,0,1536,12,5921453841
19662,997224670,7706,997232376,9,0,1,8192,18,3376944996
19663,997330780,102596,997433376,8,0,0,36864,12,3304134393
19664,997432990,81662,997514652,8,0,0,12288,12,8342015973
19665,997806620,66836,997873456,4,0,0,10240,16,5105615416
19666,997822920,79904,997902824,9,0,0,12800,18,3728289833
19667,997910380,101660,998012040,9,0,0,33792,18,5532759032
19668,998082490,6229,998088719,9,0,1,15360,18,2049662913
19669,998307010,100100,998407110,4,0,0,28672,16,7889311669
19670,998560920,76364,998637284,9,0,0,11264,18,1384427084
19671,998721360,109304,998830664,4,0,0,58880,16,425481233
19672,998737380,43904,998781284,9,0,0,512,18,3785527442
19673,998770990,64208,998835198,5,0,0,6656,19,4891763440
19674,998897200,10757,998907957,5,0,1,17408,19,3109421412
19675,998954610,60380,999014990,5,0,0,9216,19,5072774134
19676,999019460,103220,999122680,5,0,0,38912,19,6382746325
19677,999036910,102284,999139194,9,0,0,35840,18,5570974574
19678,999383320,43904,999427224,4,0,0,512,16,7647128641
19679,999405040,6278,999411318,9,0,1,6656,18,2879013850
19680,999439490,67904,999507394,5,0,0,8704,19,3048923152
19681,999514550,86384,999600934,4,0,0,18944,16,473128967
19682,999569880,81152,999651032,9,0,0,16896,18,4700526376
19683,999670800,98696,999769496,9,0,0,24064,18,7258104336
19684,999732849,14545,999747394,8,0,1,28160,12,2280982019
19685,999833860,81128,999914988,4,0,0,11776,16,4968352127
19686,999988060,88256,1000076316,8,0,0,25088,12,4382812934
19687,1000097209,98696,1000195905,7,0,0,24064,8,541934495
19688,1000155369,12308,1000167677,8,0,1,20480,12,8553983331
19689,1000318870,74852,1000393722,5,0,0,16384,19,8773923118
19690,1000375580,114286,1000489866,9,0,0,32256,18,7305536324
19691,1000514500,2946,1000517446,7,0,1,3072,8,6189138552
19692,1000766580,5326,1000771906,5,0,1,5632,19,5760204460
19693,1000865630,115495,1000981125,8,0,0,44032,12,3328123235
19694,1000903180,80924,1000984104,8,0,0,9728,12,4264939967
19695,1001035180,100100,1001135280,8,0,0,28672,12,1496477641
19696,1001153410,7706,1001161116,4,0,1,8192,16,9405525621
19697,1001279800,11016,1001290816,5,0,1,17920,19,500559828
19698,1001369290,48980,1001418270,4,0,0,2048,16,4960965830
19699,1001383020,94376,1001477396,9,0,0,19968,18,961547842
19700,1001650480,47288,1001697768,4,0,0,1536,16,11394959
19701,1001674270,78236,1001752506,8,0,0,17408,12,9435080168
19702,1001762240,45596,1001807836,9,0,0,1024,18,8035768081
19703,1001864060,97160,1001961220,4,0,0,24064,16,5323213614
19704,1001939950,117882,1002057832,5,0,0,41472,19,10663866258
19705,1002018519,48679,1002067198,7,0,0,512,8,3416525477
19706,1002031899,2470,1002034369,8,0,1,2560,12,6516366745
19707,1002077529,6278,1002083807,8,0,1,6656,12,2799714268
19708,1002189480,43904,1002233384,5,0,0,512,19,8541132783
19709,1002190570,74360,1002264930,4,0,0,9728,16,4243041631
19710,1002247060,91748,1002338808,5,0,0,16384,19,5991522144
19711,1002386710,54056,1002440766,5,0,0,3584,19,155893001
19712,1002393620,10757,1002404377,9,0,1,17408,18,4357055641
19713,1002448380,6754,1002455134,4,0,1,7168,16,8388653130
19714,1002455609,217506,1002673115,7,0,0,52736,8,1127564221
19715,1002562639,83312,1002645951,7,0,0,18944,8,4802158919
19716,1002676779,60824,1002737603,7,0,0,5632,8,4657847718
19717,1002773980,72380,1002846360,5,0,0,13312,19,10697677170
19718,1002809800,48980,1002858780,8,0,0,2048,12,12258649
19719,1002827609,12566,1002840175,8,0,1,20992,12,5969269686
19720,1002841200,98852,1002940052,9,0,0,24576,18,3931232857
19721,1003008430,100256,1003108686,9,0,0,29184,18,6289155387
19722,1003097209,11492,1003108701,8,0,1,8192,12,3730345324
19723,1003129730,103532,1003233262,4,0,0,39936,16,3315844784
19724,1003326990,100724,1003427714,4,0,0,30720,16,3709640949
19725,1003351070,102440,1003453510,4,0,0,36352,16,8213363315
19726,1003356070,5326,1003361396,7,0,1,5632,8,10492128079
19727,1003385360,76004,1003461364,5,0,0,512,19,4115419579
19728,1003404629,3904,1003408533,8,0,1,10752,12,6210714503
19729,1003427480,104483,1003531963,4,0,0,13312,16,6257562601
19730,1003507950,128648,1003636598,9,0,0,122368,18,4529134864
19731,1003544450,5971,1003550421,4,0,1,14848,16,3316952884
19732,1003608659,130035,1003738694,7,0,0,30208,8,7726100077
19733,1003609830,129191,1003739021,9,0,0,1024,18,8543624592
19734,1003664740,166900,1003831640,5,0,0,92160,19,9686606714
19735,1004183950,74360,1004258310,5,0,0,9728,19,779799404
19736,1004322460,6229,1004328689,9,0,1,15360,18,7198109670
19737,1004405019,4850,1004409869,8,0,1,5120,12,5282441731
19738,1004420520,57440,1004477960,8,0,0,4608,12,1085565572
19739,1004479520,3422,1004482942,7,0,1,3584,8,9586306003
19740,1004480790,47797,1004528587,5,0,0,512,19,5286870772
19741,1004655580,50672,1004706252,4,0,0,2560,16,7993766942
19742,1004686760,75452,1004762212,5,0,0,13312,19,8770034153
19743,1004727429,12825,1004740254,8,0,1,21504,12,9059817028
19744,1005015340,73316,1005088656,4,0,0,16384,16,3288770222
19745,1005033080,4679,1005037759,5,0,1,12288,19,1016322245
19746,1005072060,91449,1005163509,4,0,0,11776,16,7228684400
19747,1005125020,90524,1005215544,8,0,0,17408,12,7651410369
19748,1005219649,86516,1005306165,7,0,0,14336,8,5550087684
19749,1005259090,77177,1005336267,9,0,0,6144,18,4725166074
19750,1005338059,60824,1005398883,7,0,0,5632,8,3603517522
19751,1005390390,103064,1005493454,4,0,0,38400,16,409700657
19752,1005709929,103220,1005813149,7,0,0,38912,8,3462432864
19753,1005768030,108992,1005877022,9,0,0,57856,18,4293735657
19754,1006079680,75452,1006155132,4,0,0,13312,16,2515976588
19755,1006254330,54992,1006309322,8,0,0,6656,12,3898170584
19756,1006480330,68060,1006548390,4,0,0,9216,16,4927223023
19757,1006624060,60824,1006684884,4,0,0,5632,16,2477715361
19758,1006726120,43904,1006770024,9,0,0,512,18,4939641402
19759,1006774180,101816,1006875996,4,0,0,34304,16,5570536524
19760,1006841230,103844,1006945074,9,0,0,40960,18,5547116198
19761,1006843590,113511,1006957101,4,0,0,39424,16,6243458588
19762,1006860290,130972,1006991262,5,0,0,31232,19,5352562858
19763,1006916340,95156,1007011496,9,0,0,22528,18,4907349728
19764,1006955360,71928,1007027288,9,0,0,1536,18,1216919958
19765,1007183819,81128,1007264947,7,0,0,11776,8,8526057853
19766,1007246300,121187,1007367487,5,0,0,48640,19,5575887002
19767,1007350690,82064,1007432754,4,0,0,14848,16,2465901273
19768,1007449600,59132,1007508732,5,0,0,5120,19,8970793345
19769,1007491869,69284,1007561153,7,0,0,8192,8,5084560352
19770,1007518740,99788,1007618528,5,0,0,27648,19,7424064857
19771,1007524900,170630,1007695530,9,0,0,16896,18,1927484145
19772,1007562450,5802,1007568252,5,0,1,6144,19,6135054951
19773,1007571370,108524,1007679894,4,0,0,56320,16,4295097284
19774,1007746809,62516,1007809325,7,0,0,6144,8,7137022056
19775,1007871650,69284,1007940934,8,0,0,8192,12,8316283681
19776,1007994760,4679,1007999439,5,0,1,12288,19,425244162
19777,1008039709,3422,1008043131,8,0,1,3584,12,3590693545
19778,1008349440,69440,1008418880,4,0,0,8704,16,2325711215
19779,1008416369,102135,1008518504,7,0,0,27136,8,1697153920
19780,1008491370,54056,1008545426,9,0,0,3584,18,5901167151
19781,1008521460,87896,1008609356,9,0,0,13824,18,8984665729
19782,1008705940,93440,1008799380,4,0,0,16896,16,4765246816
19783,1008707450,149746,1008857196,9,0,0,95744,18,2980631145
19784,1008914680,122564,1009037244,9,0,0,102400,18,9543998679
19785,1009134650,98852,1009233502,8,0,0,24576,12,1657118135
19786,1009284990,58220,1009343210,9,0,0,7168,18,10182773746
19787,1009619660,102284,1009721944,9,0,0,35840,18,5925467959
19788,1009696870,82820,1009779690,8,0,0,12288,12,1920387398
19789,1009702630,98852,1009801482,5,0,0,24576,19,9158590608
19790,1009836469,101504,1009937973,7,0,0,33280,8,871289206
19791,1010081940,7706,1010089646,7,0,1,8192,8,2486378483
19792,1010370880,100412,1010471292,4,0,0,29696,16,777641465
19793,1010423250,74898,1010498148,5,0,0,9728,19,2292282912
19794,1010436460,121614,1010558074,8,0,0,27648,12,5563982648
19795,1010446079,3387,1010449466,8,0,1,9728,12,1239122505
19796,1010495440,3266,1010498706,5,0,1,512,19,3031982405
19797,1010534660,92372,1010627032,9,0,0,18432,18,3826354840
19798,1010616970,79904,1010696874,9,0,0,12800,18,6359485095
19799,1010668830,67592,1010736422,5,0,0,7680,19,9057847676
19800,1010694939,7253,1010702192,8,0,1,5632,12,7869525015
19801,1010819479,108992,1010928471,7,0,0,57856,8,8212054614
19802,1010917570,87437,1011005007,4,0,0,16896,16,10298815080
19803,1010920590,91623,1011012213,9,0,0,14848,18,2675683081
19804,1010946660,61014,1011007674,8,0,0,8704,12,7880709078
19805,1011014970,101348,1011116318,8,0,0,32768,12,3551052997
19806,1011313239,86204,1011399443,7,0,0,13312,8,979814690
19807,1011455810,5971,1011461781,5,0,1,14848,19,7437237349
19808,1011491970,59132,1011551102,8,0,0,5120,12,6606131491
19809,1011549690,50384,1011600074,9,0,0,2048,18,9432038579
19810,1011637789,101348,1011739137,7,0,0,32768,8,6289053663
19811,1011733620,108261,1011841881,8,0,0,37376,12,4311148555
19812,1011808299,93620,1011901919,7,0,0,22528,8,6727566030
19813,1011889489,12445,1011901934,8,0,1,15360,12,2744937628
19814,1011890010,91216,1011981226,5,0,0,20992,19,1548104967
19815,1011959130,104156,1012063286,9,0,0,41984,18,7624623040
19816,1012049610,72766,1012122376,9,0,0,7680,18,4512167857
19817,1012118289,95288,1012213577,7,0,0,17920,8,9819451032
19818,1012159210,95156,1012254366,9,0,0,22528,18,10502937597
19819,1012237340,7706,1012245046,5,0,1,8192,19,5897501504
19820,1012266420,206531,1012472951,8,0,0,30208,12,574803245
19821,1012416910,144541,1012561451,4,0,0,20992,16,6932202996
19822,1012466119,83812,1012549931,7,0,0,13312,8,504298074
19823,1012514670,123107,1012637777,8,0,0,43520,12,5413000185
19824,1012520560,57307,1012577867,9,0,0,2048,18,992462066
19825,1012621250,91592,1012712842,9,0,0,15872,18,2264177853
19826,1012733710,96848,1012830558,9,0,0,23040,18,8196978542
19827,1012767650,6754,1012774404,9,0,1,7168,18,4767992737
19828,1012779889,103064,1012882953,7,0,0,38400,8,5266198815
19829,1012852010,97784,1012949794,9,0,0,26112,18,6605727689
19830,1012946360,8752,1012955112,9,0,1,5632,18,9532061160
19831,1013018340,1994,1013020334,5,0,1,2048,19,8561869849
19832,1013274310,79172,1013353482,5,0,0,20480,19,7050597801
19833,1013333769,2470,1013336239,8,0,1,2560,12,5621545937
19834,1013756060,89456,1013845516,9,0,0,18944,18,2471712181
19835,1013784010,100404,1013884414,5,0,0,19456,19,6299172561
19836,1013856540,77744,1013934284,5,0,0,10752,19,4471162751
19837,1014008740,84068,1014092808,4,0,0,16384,16,8650095828
19838,1014062050,5802,1014067852,7,0,1,6144,8,9695290363
19839,1014075980,11016,1014086996,9,0,1,17920,18,10360365180
19840,1014164150,103392,1014267542,5,0,0,12800,19,10033993681
19841,1014206070,98408,1014304478,9,0,0,28160,18,475448065
19842,1014247309,7706,1014255015,8,0,1,8192,12,3507483623
19843,1014301260,65726,1014366986,8,0,0,6144,12,24647209
19844,1014410020,100880,1014510900,5,0,0,31232,19,3264933694
19845,1014434409,23208,1014457617,8,0,1,38400,12,637203869
19846,1014853420,103688,1014957108,5,0,0,40448,19,6777617040
19847,1014877870,86072,1014963942,8,0,0,17920,12,5029397061
19848,1014998200,566,1014998766,9,0,1,512,18,5059499893
19849,1015022780,5802,1015028582,5,0,1,6144,19,10547867086
19850,1015065170,70976,1015136146,4,0,0,8704,16,8847782213
19851,1015198220,84848,1015283068,5,0,0,18944,19,9196550223
19852,1015322690,101192,1015423882,9,0,0,32256,18,9157232301
19853,1015404910,566,1015405476,4,0,1,512,16,9629322196
19854,1015786480,57440,1015843920,9,0,0,4608,18,2226939810
19855,1015849770,43904,1015893674,4,0,0,512,16,7307501536
19856,1015871830,43904,1015915734,8,0,0,512,12,2145191685
19857,1015982190,63296,1016045486,9,0,0,8704,18,10528965295
19858,1016226590,62072,1016288662,4,0,0,9728,16,2375108311
19859,1016277940,3422,1016281362,7,0,1,3584,8,3666279414
19860,1016313440,79436,1016392876,8,0,0,11264,12,6320859584
19861,1016427429,85628,1016513057,7,0,0,21504,8,9794395012
19862,1016459230,82813,1016542043,5,0,0,4608,19,2684132502
19863,1016470620,65144,1016535764,4,0,0,9728,16,9665709839
19864,1016528620,85136,1016613756,5,0,0,14848,19,3804895206
19865,1016683860,48980,1016732840,4,0,0,2048,16,1946435402
19866,1017011040,63920,1017074960,8,0,0,10752,12,6819229073
19867,1017013770,75302,1017089072,9,0,0,6656,18,7816258215
19868,1017041770,5326,1017047096,5,0,1,5632,19,5537104962
19869,1017101720,12995,1017114715,5,0,1,25088,19,1909654660
19870,1017121400,101192,1017222592,9,0,0,32256,18,7246301124
19871,1017216679,148348,1017365027,7,0,0,32256,8,5087318834
19872,1017292670,110295,1017402965,4,0,0,24576,16,4042656465
19873,1017408559,64208,1017472767,7,0,0,6656,8,9968851562
19874,1017486750,1518,1017488268,4,0,1,1536,16,3549289732
19875,1017597230,99320,1017696550,9,0,0,26112,18,2949586079
19876,1017652539,10499,1017663038,8,0,1,16896,12,1318299066
19877,1017735529,112335,1017847864,7,0,0,48640,8,5573719111
19878,1017741680,138544,1017880224,4,0,0,50688,16,5501383631
19879,1017776420,139946,1017916366,4,0,0,40448,16,5237348478
19880,1018287220,89948,1018377168,4,0,0,25600,16,5675933860
19881,1018295870,68060,1018363930,4,0,0,9216,16,417221969
19882,1019024150,100412,1019124562,8,0,0,29696,12,8692030713
19883,1019190739,6488,1019197227,8,0,1,15872,12,1966719684
19884,1019746990,77900,1019824890,8,0,0,11264,12,6763558044
19885,1019827240,47288,1019874528,8,0,0,1536,12,8712503440
19886,1019934520,10499,1019945019,5,0,1,16896,19,10311809488
19887,1019984999,94556,1020079555,7,0,0,25600,8,6962131240
19888,1020055599,1518,1020057117,8,0,1,1536,12,516003444
19889,1020195920,4850,1020200770,9,0,1,5120,18,996870305
19890,1020268100,76052,1020344152,8,0,0,10240,12,1265672033
19891,1020442050,101036,1020543086,9,0,0,31744,18,4128276483
19892,1020671239,4374,1020675613,8,0,1,4608,12,3246235521
19893,1020703449,1994,1020705443,8,0,1,2048,12,420643106
19894,1020892259,4850,1020897109,8,0,1,5120,12,4877399693
19895,1020961830,60824,1021022654,8,0,0,5632,12,10066970767
19896,1021009680,1994,1021011674,4,0,1,2048,16,3385782415
19897,1021017870,101816,1021119686,9,0,0,34304,18,4382007635
19898,1021046839,148147,1021194986,7,0,0,27136,8,1981549921
19899,1021119040,3766,1021122806,9,0,1,9216,18,4028220501
19900,1021120970,2607,1021123577,4,0,1,1024,16,6732609861
19901,1021227930,114608,1021342538,8,0,0,76288,12,8362354904
19902,1021235379,5326,1021240705,8,0,1,5632,12,7409464336
19903,1021269159,129089,1021398248,7,0,0,26112,8,10339191988
19904,1021296960,109415,1021406375,8,0,0,26624,12,2290635243
19905,1021311760,116098,1021427858,8,0,0,7168,12,10081391937
19906,1021347770,96834,1021444604,4,0,0,4608,16,9245268442
19907,1021507950,57440,1021565390,9,0,0,4608,18,8438314959
19908,1021526950,77744,1021604694,9,0,0,10752,18,2808014535
19909,1021708310,69284,1021777594,8,0,0,8192,12,2576736067
19910,1021827379,60824,1021888203,7,0,0,5632,8,10150199244
19911,1021844030,566,1021844596,5,0,1,512,19,10702144978
19912,1021954139,64232,1022018371,7,0,0,11776,8,950802900
19913,1022044180,98852,1022143032,9,0,0,24576,18,6741631098
19914,1022192660,2870,1022195530,5,0,1,8704,19,7418797607
19915,1022223110,66368,1022289478,9,0,0,8704,18,9889416174
19916,1022251180,62516,1022313696,8,0,0,6144,12,6932606631
19917,1022319560,103220,1022422780,4,0,0,38912,16,6672963749
19918,1022449459,92864,1022542323,7,0,0,25088,8,8837645408
19919,1022501410,109772,1022611182,4,0,0,60416,16,10045392806
19920,1022540150,6539,1022546689,5,0,1,4608,19,6330230642
19921,1022581439,1518,1022582957,8,0,1,1536,12,9849568704
19922,1023129720,50672,1023180392,4,0,0,2560,16,3728592950
19923,1023201630,62228,1023263858,4,0,0,10240,16,3214751094
19924,1023256439,104312,1023360751,7,0,0,42496,8,3408717364
19925,1023387160,124592,1023511752,4,0,0,109056,16,4724663834
19926,1023580070,49604,1023629674,8,0,0,4096,12,8232390776
19927,1023657820,107900,1023765720,9,0,0,54272,18,9557651710
19928,1023694770,197676,1023892446,8,0,0,80896,12,3806609695
19929,1023725450,200707,1023926157,9,0,0,110592,18,364123530
19930,1023735090,1994,1023737084,4,0,1,2048,16,5654714363
19931,1023925140,100485,1024025625,9,0,0,26624,18,6449944331
19932,1024034850,2946,1024037796,4,0,1,3072,16,4576264104
19933,1024067300,43904,1024111204,9,0,0,512,18,1400920075
19934,1024098440,50672,1024149112,9,0,0,2560,18,7699688359
19935,1024434989,81128,1024516117,7,0,0,11776,8,2795018278
19936,1024454360,47288,1024501648,9,0,0,1536,18,2310179356
19937,1024460520,65900,1024526420,9,0,0,7168,18,4597302220
19938,1024664700,5971,1024670671,7,0,1,14848,8,232038064
19939,1024710319,102904,1024813223,7,0,0,34304,8,2603146828
19940,1024811990,4171,1024816161,9,0,1,3072,18,5791675246
19941,1024894270,118040,1025012310,9,0,0,87552,18,6944634452
19942,1025169229,82376,1025251605,7,0,0,15872,8,9893488421
19943,1025227590,52364,1025279954,8,0,0,3072,12,6496027562
19944,1025229540,70568,1025300108,8,0,0,2560,12,1928488939
19945,1025307740,100724,1025408464,8,0,0,30720,12,4915968870
19946,1025388150,3128,1025391278,5,0,1,9216,19,2120370345
19947,1025403760,239183,1025642943,8,0,0,107008,12,310302548
19948,1025694419,59756,1025754175,7,0,0,7168,8,1967146678
19949,1026125930,10499,1026136429,9,0,1,16896,18,2749112492
19950,1026317150,101660,1026418810,4,0,0,33792,16,3522062327
19951,1026384340,103220,1026487560,8,0,0,38912,12,7929769268
19952,1026696480,106652,1026803132,8,0,0,50176,12,762588356
19953,1026896660,73292,1026969952,9,0,0,11264,18,8011770698
19954,1026939860,1518,1026941378,4,0,1,1536,16,8417092291
19955,1026947600,50672,1026998272,8,0,0,2560,12,1206754865
19956,1026989360,102908,1027092268,9,0,0,37888,18,8971969038
19957,1026991890,150622,1027142512,8,0,0,41472,12,4114267643
19958,1027034610,3387,1027037997,4,0,1,9728,16,8545920745
19959,1027051770,148180,1027199950,9,0,0,32256,18,8677337079
19960,1027270939,1518,1027272457,8,0,1,1536,12,1333404053
19961,1027348280,55748,1027404028,9,0,0,4096,18,2479561586
19962,1027353840,10241,1027364081,4,0,1,16384,16,2083655515
19963,1027427480,60068,1027487548,8,0,0,8192,12,3297138293
19964,1027487000,141649,1027628649,9,0,0,21504,18,7485900777
19965,1027740770,64573,1027805343,9,0,0,6656,18,1967616391
19966,1027754320,48980,1027803300,9,0,0,2048,18,2215547065
19967,1027770440,52364,1027822804,4,0,0,3072,16,8913672547
19968,1027909400,2946,1027912346,9,0,1,3072,18,827555875
19969,1027992950,93596,1028086546,4,0,0,17408,16,1600393890
19970,1028091630,60824,1028152454,4,0,0,5632,16,9345226941
19971,1028200690,3422,1028204112,4,0,1,3584,16,1446939282
19972,1028414280,43904,1028458184,4,0,0,512,16,52164502
19973,1028551140,99320,1028650460,4,0,0,26112,16,9098767664
19974,1029384470,100412,1029484882,4,0,0,29696,16,6153180756
19975,1030059440,92396,1030151836,4,0,0,23552,16,1556160420
19976,1030090410,1042,1030091452,4,0,1,1024,16,4569777951
19977,1030582880,7706,1030590586,4,0,1,8192,16,4473335001
19978,1031052800,43904,1031096704,4,0,0,512,16,10123705571
19979,1031179840,100412,1031280252,4,0,0,29696,16,4890004265
19980,1031255420,47288,1031302708,4,0,0,1536,16,6285001747
19981,1031388350,3898,1031392248,4,0,1,4096,16,1996919342
19982,1031739010,54836,1031793846,4,0,0,6144,16,8882467541
19983,1032183840,95624,1032279464,4,0,0,24064,16,2101110062
19984,1032523270,74360,1032597630,4,0,0,9728,16,41837091
19985,1033812800,72224,1033885024,4,0,0,12800,16,6474459541
19986,1034480590,566,1034481156,4,0,1,512,16,46040371
19987,1034840370,121784,1034962154,4,0,0,99840,16,6783619963
19988,1036984320,2870,1036987190,4,0,1,8704,16,636249211
19989,1037728990,12825,1037741815,4,0,1,21504,16,224428393
19990,1038097910,5326,1038103236,4,0,1,5632,16,10273678635
19991,1038144420,106652,1038251072,4,0,0,50176,16,2536752599
19992,1038338180,71132,1038409312,4,0,0,9216,16,2599563982
19993,1039162960,66368,1039229328,4,0,0,8704,16,5246356987
19994,1039494750,4937,1039499687,4,0,1,12800,16,4688939382
19995,1040088890,82064,1040170954,4,0,0,14848,16,7582966167
19996,1040152450,4850,1040157300,4,0,1,5120,16,2475468564
19997,1040187210,56528,1040243738,4,0,0,6656,16,2126502903
19998,1040790760,71288,1040862048,4,0,0,9728,16,829035038
19999,1041137940,111956,1041249896,4,0,0,67584,16,10061506857
