RequestID,ArrivalTime,DelayTime,FinishTime,InitiatorID,TargetID,IOType,Size,VolumeID,Offset
0,63307921825,1514,63307923339,4,0,1,27648,4,2744568573
1,63307921827,99784,63308021611,4,0,1,12800,4,5397625818
2,63307945696,103693,63308049389,8,0,1,9728,8,1050370300
3,63307957611,97912,63308055523,0,0,1,21504,0,7919505077
4,63307971875,113803,63308085678,1,0,0,1536,1,2523262394
5,63307999000,78811,63308077811,3,0,1,2048,3,6786766718
6,63308026513,54052,63308080565,4,0,1,3584,4,7486970741
7,63308096664,127467,63308224131,9,0,0,211456,9,3304890789
8,63308231001,72279,63308303280,5,0,1,28160,5,3691383208
9,63308301583,73074,63308374657,5,0,0,117248,5,1601976162
10,63308338802,97368,63308436170,3,0,1,9216,3,4318051666
11,63308340029,241943,63308581972,6,0,1,512,6,8390808507
12,63308341664,127043,63308468707,0,0,1,2560,0,6110726420
13,63308381130,155730,63308536860,7,0,1,52224,7,5671104681
14,63308392485,198903,63308591388,0,0,1,22528,0,10492348225
15,63308515151,84265,63308599416,4,0,1,13312,4,4966230681
16,63308607371,33846,63308641217,4,0,0,55808,4,2452496286
17,63308655363,86169,63308741532,3,0,1,17920,3,1145661939
18,63308704109,95225,63308799334,2,0,0,199168,2,423032865
19,63308709214,122904,63308832118,1,0,0,1536,1,6807954325
20,63308716934,118785,63308835719,2,0,1,1536,2,8310364162
21,63308796168,52517,63308848685,2,0,0,74240,2,1920897976
22,63308843815,169977,63309013792,4,0,1,34816,4,5984574394
23,63309020718,82397,63309103115,4,0,1,7680,4,6341994617
24,63309069332,562,63309069894,7,0,1,12800,7,10084231605
25,63309103533,75292,63309178825,1,0,0,512,1,3172383341
26,63309122772,60820,63309183592,3,0,1,5632,3,6129483942
27,63309149184,41387,63309190571,8,0,0,67072,8,631913659
28,63309207363,33329,63309240692,9,0,0,54784,9,1572686583
29,63309212625,141673,63309354298,8,0,1,18944,8,959689518
30,63309248290,238115,63309486405,3,0,1,2048,3,10057619286
31,63309431474,57342,63309488816,0,0,1,512,0,3072134479
32,63309454346,104776,63309559122,6,0,1,44032,6,10434357980
33,63309513414,85402,63309598816,2,0,1,9728,2,8220372328
34,63309516451,239079,63309755530,5,0,1,224256,5,7308738702
35,63309560347,245091,63309805438,8,0,1,21504,8,6641958160
36,63309566477,192726,63309759203,5,0,1,142336,5,8418825802
37,63309573590,237484,63309811074,0,0,1,25600,0,3783695278
38,63309601789,274733,63309876522,8,0,1,11264,8,2731913058
39,63309890336,23721,63309914057,8,0,0,39424,8,7262611748
40,63309909805,12991,63309922796,7,0,1,71168,7,6210163531
41,63309921432,136676,63310058108,2,0,1,36864,2,399893597
42,63309959361,184059,63310143420,2,0,0,25088,2,2793043779
43,63310107964,24925,63310132889,9,0,1,4608,9,4162033072
44,63310109651,102062,63310211713,8,0,0,45056,8,5284349821
45,63310255539,72279,63310327818,7,0,0,117248,7,2065375262
46,63310284252,204128,63310488380,0,0,1,2560,0,5303441787
47,63310487631,16609,63310504240,0,0,1,1024,0,2704188271
48,63310498781,95781,63310594562,8,0,0,32256,8,10686110272
49,63310658350,45904,63310704254,4,0,1,7680,4,5705661709
50,63310671031,67588,63310738619,4,0,1,2048,4,10535168601
51,63310694395,43971,63310738366,5,0,0,72192,5,10398498623
52,63310728648,88580,63310817228,4,0,1,9728,4,3464618442
53,63310851042,34791,63310885833,9,0,1,512,9,4388042610
54,63310851239,58080,63310909319,0,0,0,60928,0,7184336243
55,63311155042,50995,63311206037,9,0,0,82432,9,4906912602
56,63311249950,81628,63311331578,9,0,0,132096,9,6713408979
57,63311331398,128859,63311460257,1,0,1,24064,1,3450548562
58,63311343341,213040,63311556381,5,0,1,16384,5,224093153
59,63311474477,85503,63311559980,2,0,1,11776,2,4704718501
60,63311539040,43900,63311582940,3,0,1,512,3,7349069278
61,63311586432,4846,63311591278,1,0,1,4096,1,4200114872
62,63311601591,52672,63311654263,0,0,1,6144,0,3523745495
63,63311629403,56368,63311685771,4,0,0,5120,4,2551953064
64,63311680648,57592,63311738240,1,0,1,5120,1,340521535
65,63311737143,21709,63311758852,0,0,0,33280,0,5244670382
66,63311746220,120705,63311866925,7,0,1,89088,7,4329132796
67,63311811971,81370,63311893341,8,0,0,131584,8,2037920412
68,63311901968,562,63311902530,0,0,1,7168,0,2213756430
69,63311942077,87756,63312029833,1,0,0,512,1,4010875395
70,63311994398,83866,63312078264,5,0,0,139776,5,5522980493
71,63312037151,54685,63312091836,6,0,1,1024,6,8327206398
72,63312040566,94948,63312135514,5,0,0,56832,5,2010068454
73,63312055510,95825,63312151335,9,0,1,8704,9,5391007992
74,63312204448,562,63312205010,2,0,1,14848,2,400689221
75,63312285004,105952,63312390956,9,0,1,16384,9,6806736761
76,63312300117,90208,63312390325,1,0,1,19456,1,10546517393
77,63312301459,111701,63312413160,1,0,0,512,1,5397453540
78,63312390977,44916,63312435893,8,0,0,77312,8,2315374451
79,63312439612,89740,63312529352,9,0,1,17920,9,9300697353
80,63312475950,1038,63312476988,1,0,1,14848,1,3466982654
81,63312559060,60820,63312619880,2,0,1,1024,2,1505193767
82,63312560762,23116,63312583878,9,0,1,5632,9,5647584139
83,63312561355,72432,63312633787,3,0,1,38400,3,773459113
84,63312567515,107387,63312674902,4,0,0,1024,4,203366930
85,63312602399,236744,63312839143,2,0,0,41472,2,6095713562
86,63312688123,66630,63312754753,1,0,1,3584,1,7662637974
87,63312778253,85158,63312863411,4,0,0,142336,4,10512903339
88,63312792771,44141,63312836912,5,0,1,197632,5,1002011714
89,63312868436,4933,63312873369,9,0,0,75776,9,3273497941
90,63312924648,419719,63313344367,2,0,1,22016,2,3744270642
91,63313011770,245207,63313256977,5,0,1,145920,5,8009805177
92,63313075702,339064,63313414766,7,0,0,12800,7,7069567068
93,63313177314,79804,63313257118,5,0,1,82432,5,5526986876
94,63313183919,20893,63313204812,1,0,0,512,1,9763021881
95,63313214213,35334,63313249547,1,0,1,5120,1,5531769994
96,63313257622,1038,63313258660,2,0,0,28672,2,5646717301
97,63313268428,181517,63313449945,0,0,0,50688,0,10361460494
98,63313308703,189007,63313497710,1,0,0,1024,1,5850979676
99,63313387899,65896,63313453795,9,0,1,10240,9,8338598376
100,63313458305,139433,63313597738,6,0,1,7168,6,6192714561
101,63313485084,91061,63313576145,9,0,1,4096,9,4320650245
102,63313608556,45592,63313654148,2,0,1,1024,2,7919197121
103,63313650040,86192,63313736232,3,0,0,144384,3,10003679361
104,63313749602,13337,63313762939,4,0,1,8192,4,8496461896
105,63313758459,56075,63313814534,4,0,0,22528,4,952320244
106,63313817407,126873,63313944280,4,0,1,13312,4,9376176027
107,63313833482,131004,63313964486,9,0,0,95744,9,6032768726
108,63313839433,24129,63313863562,0,0,0,179712,0,2519190304
109,63313864831,3900,63313868731,7,0,1,152064,7,8457572578
110,63313947934,342813,63314290747,3,0,0,2560,3,5217963256
111,63314069493,334549,63314404042,9,0,0,10752,9,9204637743
112,63314191399,4846,63314196245,9,0,1,3072,9,1141724501
113,63314224533,60333,63314284866,2,0,0,5120,2,6263524613
114,63314456992,47284,63314504276,0,0,1,1536,0,7839513488
115,63314481136,48976,63314530112,1,0,1,2048,1,2104504991
116,63314537554,76516,63314614070,3,0,1,11776,3,1658386252
117,63314700077,101968,63314802045,6,0,1,34816,6,5451889498
118,63314720287,99764,63314820051,1,0,1,2048,1,6470073480
119,63314752565,84988,63314837553,9,0,1,1024,9,4133850781
120,63314786474,26681,63314813155,7,0,1,70656,7,5240296463
121,63314791183,130492,63314921675,7,0,0,138752,7,822155672
122,63314854879,118122,63314973001,2,0,0,25600,2,1069260606
123,63314982047,95961,63315078008,3,0,1,7168,3,9545356744
124,63315058992,55744,63315114736,6,0,1,4096,6,6604200301
125,63315121489,69436,63315190925,3,0,1,8704,3,6377143516
126,63315189657,4678,63315194335,0,0,0,3584,0,9315400902
127,63315243946,3900,63315247846,9,0,0,10752,9,1872716691
128,63315297314,45175,63315342489,3,0,1,1536,3,9823833011
129,63315319114,55481,63315374595,2,0,1,57344,2,2770894103
130,63315323432,108832,63315432264,5,0,0,77824,5,5682812
131,63315324365,23979,63315348344,2,0,0,45568,2,6664585599
132,63315341975,146635,63315488610,9,0,1,8704,9,10618047013
133,63315410157,117573,63315527730,2,0,0,39936,2,3545243447
134,63315552326,87225,63315639551,2,0,0,146432,2,6857725701
135,63315553823,58410,63315612233,4,0,1,17920,4,7757693972
136,63315586326,44649,63315630975,7,0,0,16384,7,6169919521
137,63315619886,105859,63315725745,5,0,1,4608,5,741086707
138,63315620978,240308,63315861286,7,0,0,75264,7,6842648560
139,63315629424,156632,63315786056,9,0,1,3072,9,3280801016
140,63315673916,202816,63315876732,2,0,1,2560,2,603796553
141,63315800565,23204,63315823769,5,0,1,172032,5,9312247914
142,63315832946,66786,63315899732,1,0,1,8192,1,9048261682
143,63315856467,101964,63315958431,3,0,0,38400,3,3325645469
144,63315858005,77231,63315935236,5,0,0,148480,5,114662796
145,63315904038,253353,63316157391,3,0,0,77312,3,8110877083
146,63315919383,134546,63316053929,8,0,0,76800,8,2510351274
147,63315944927,109013,63316053940,1,0,0,4096,1,9872668425
148,63316012556,75134,63316087690,4,0,0,58880,4,8965467324
149,63316095278,3900,63316099178,0,0,0,10752,0,7075179514
150,63316217229,21395,63316238624,5,0,0,34816,5,126617438
151,63316407642,11012,63316418654,7,0,0,17920,7,8395457297
152,63316526507,1990,63316528497,0,0,0,2048,0,7863704292
153,63316556284,3900,63316560184,5,0,0,10752,5,3481586435
154,63316569586,15575,63316585161,5,0,0,30208,5,5181115007
155,63316666117,76842,63316742959,3,0,0,129536,3,7687473773
156,63316718499,87119,63316805618,2,0,1,2048,2,137244243
157,63316740905,100119,63316841024,1,0,1,11264,1,4463159988
158,63316806216,43971,63316850187,2,0,0,72192,2,2516490360
159,63316824307,92529,63316916836,7,0,1,7168,7,3654000255
160,63316833101,81986,63316915087,8,0,0,150016,8,3163651446
161,63316860016,53506,63316913522,2,0,0,61952,2,7716649168
162,63316909592,146208,63317055800,5,0,0,68096,5,3597246665
163,63317002142,16092,63317018234,2,0,0,31232,2,1525323261
164,63317046141,12991,63317059132,7,0,0,25088,7,6517010989
165,63317056886,41645,63317098531,4,0,0,67584,4,5369609549
166,63317189321,10237,63317199558,3,0,1,21504,3,480442864
167,63317213574,5074,63317218648,9,0,0,16384,9,583990465
168,63317219083,174379,63317393462,0,0,0,512,0,9961793726
169,63317355739,64908,63317420647,3,0,0,109568,3,87740908
170,63317357783,56096,63317413879,2,0,1,7680,2,9701707717
171,63317381435,240539,63317621974,3,0,0,64512,3,6902293199
172,63317675938,54052,63317729990,6,0,1,3584,6,5057989012
173,63317734348,81436,63317815784,2,0,1,12800,2,1397952446
174,63317783720,4370,63317788090,8,0,1,7680,8,1312352011
175,63317831801,67588,63317899389,0,0,0,4608,0,5719379907
176,63317993212,93304,63318086516,3,0,0,151552,3,4378287549
177,63318017738,90313,63318108051,3,0,1,1536,3,4755060131
178,63318021028,118455,63318139483,3,0,1,512,3,6865449455
179,63318038606,126305,63318164911,9,0,1,16384,9,6979736671
180,63318040843,162216,63318203059,1,0,1,5632,1,6108111460
181,63318046432,248572,63318295004,5,0,0,495616,5,4944692175
182,63318048751,305929,63318354680,7,0,1,57856,7,8099659001
183,63318089149,237543,63318326692,1,0,1,3584,1,1798785998
184,63318126364,255973,63318382337,8,0,0,38912,8,2295236466
185,63318128927,216908,63318345835,5,0,0,75776,5,10145593740
186,63318133405,283955,63318417360,8,0,1,512,8,6461836173
187,63318184364,169680,63318354044,8,0,0,53760,8,7069720519
188,63318230973,115223,63318346196,5,0,1,34816,5,5593653345
189,63318237116,562,63318237678,8,0,1,10752,8,4899402383
190,63318251868,261176,63318513044,1,0,1,9216,1,6742117532
191,63318307964,469044,63318777008,9,0,0,72192,9,9205785210
192,63318490601,562,63318491163,0,0,0,512,0,862568729
193,63318587945,421073,63319009018,0,0,0,512,0,10582099380
194,63318801539,110860,63318912399,5,0,1,64000,5,7396290318
195,63318867312,20225,63318887537,7,0,1,94208,7,8714185293
196,63318892185,123753,63319015938,9,0,0,8192,9,4959015289
197,63319063542,60820,63319124362,3,0,1,5632,3,9858041022
198,63319119209,74068,63319193277,0,0,1,13824,0,4243043093
199,63319269470,1038,63319270508,1,0,0,1024,1,8754225221
200,63319298284,46467,63319344751,2,0,0,80384,2,1197362598
201,63319334858,15487,63319350345,8,0,0,18432,8,6999105205
202,63319356247,562,63319356809,0,0,0,512,0,2045031571
203,63319357518,113315,63319470833,2,0,1,23552,2,4108293916
204,63319374017,34016,63319408033,3,0,1,45568,3,8369525625
205,63319412275,102495,63319514770,8,0,1,17408,8,3430176606
206,63319471355,56056,63319527411,4,0,0,59392,4,8351435017
207,63319476381,231533,63319707914,8,0,0,70144,8,7389995441
208,63319520417,16736,63319537153,6,0,1,1024,6,5197348680
209,63319592700,164147,63319756847,0,0,0,4096,0,6019395667
210,63319708956,60376,63319769332,8,0,1,9216,8,10352562291
211,63319887205,30487,63319917692,4,0,0,49152,4,5140965326
212,63319892383,256835,63320149218,9,0,0,400896,9,1813625559
213,63319944848,195663,63320140511,3,0,0,107520,3,951460434
214,63319963697,235424,63320199121,3,0,1,3584,3,6991707326
215,63319965354,215584,63320180938,1,0,0,1024,1,5768368123
216,63320016377,171179,63320187556,2,0,0,31744,2,10052902180
217,63320042572,38016,63320080588,8,0,1,17920,8,6556713573
218,63320150526,314885,63320465411,1,0,0,1536,1,2568296226
219,63320281153,78343,63320359496,9,0,1,6656,9,3178392092
220,63320301471,81112,63320382583,3,0,0,131072,3,8597360814
221,63320346842,36727,63320383569,0,0,0,1536,0,4814029503
222,63320375693,8222,63320383915,0,0,0,512,0,2203187620
223,63320415865,64738,63320480603,9,0,0,105984,9,4332462620
224,63320509868,5192,63320515060,8,0,0,13312,8,4401138544
225,63320532429,53310,63320585739,6,0,1,3584,6,7599296380
226,63320556171,85362,63320641533,3,0,1,4096,3,9554722622
227,63320609136,145933,63320755069,2,0,1,8192,2,9039296556
228,63320746062,22858,63320768920,5,0,0,40960,5,3651414258
229,63320797904,44916,63320842820,7,0,0,77312,7,7744185501
230,63321003656,23204,63321026860,5,0,0,38400,5,10368725397
231,63321062120,76048,63321138168,4,0,1,10240,4,5720329700
232,63321086060,111487,63321197547,4,0,0,180224,4,3659229393
233,63321117042,80851,63321197893,0,0,0,512,0,7701859701
234,63321125039,94769,63321219808,3,0,0,72192,3,8562944866
235,63321153253,48290,63321201543,8,0,1,2560,8,10597178997
236,63321177624,153484,63321331108,5,0,0,20992,5,4857545196
237,63321244367,155346,63321399713,2,0,0,252416,2,202234877
238,63321284805,236971,63321521776,8,0,1,3584,8,6711031867
239,63321319960,160764,63321480724,7,0,1,23040,7,9321802187
240,63321342678,258793,63321601471,3,0,1,35328,3,3775379723
241,63321352169,256715,63321608884,2,0,1,23552,2,6786613085
242,63321399466,266725,63321666191,3,0,1,7680,3,7183134215
243,63321476028,148607,63321624635,4,0,1,6144,4,10583272760
244,63321511600,244404,63321756004,5,0,0,395776,5,5397455453
245,63321607685,190969,63321798654,9,0,1,7168,9,1321405483
246,63321640459,104374,63321744833,0,0,1,10752,0,612654237
247,63321710787,93810,63321804597,4,0,1,58368,4,4350413693
248,63321721929,214382,63321936311,4,0,0,173056,4,6302135526
249,63321743835,308295,63322052130,8,0,0,46080,8,9625896049
250,63321794163,93304,63321887467,7,0,1,94720,7,2403420763
251,63321926543,361255,63322287798,9,0,1,4608,9,4745341410
252,63321948806,230290,63322179096,2,0,0,151552,2,5515816695
253,63322003554,162253,63322165807,9,0,1,7168,9,8107226251
254,63322042860,133231,63322176091,9,0,1,5632,9,8952275832
255,63322115194,64391,63322179585,2,0,0,108544,2,4343689378
256,63322216845,562,63322217407,1,0,0,512,1,4418877412
257,63322276528,562,63322277090,0,0,1,9216,0,10046088488
258,63322375564,135834,63322511398,0,0,0,512,0,5889111064
259,63322440042,12821,63322452863,3,0,0,21504,3,1029159392
260,63322467378,43900,63322511278,2,0,1,512,2,9149831970
261,63322544117,103060,63322647177,2,0,1,38400,2,8693324927
262,63322625404,83284,63322708688,2,0,1,13824,2,9376024164
263,63323007143,35567,63323042710,7,0,0,62464,7,5569405634
264,63323154464,65296,63323219760,4,0,1,10240,4,8382567983
265,63323163520,84508,63323248028,3,0,1,12800,3,8364335196
266,63323248568,3894,63323252462,8,0,0,4096,8,8160342214
267,63323305740,61756,63323367496,2,0,1,8704,2,9373881334
268,63323490696,78856,63323569552,2,0,1,19456,2,5374763050
269,63323510918,83620,63323594538,4,0,1,19968,4,4948075246
270,63323706671,562,63323707233,0,0,0,512,0,9067899330
271,63323711641,562,63323712203,8,0,1,42496,8,6603895365
272,63323758406,104308,63323862714,0,0,0,512,0,5689657301
273,63323782910,50737,63323833647,8,0,0,81920,8,6052184182
274,63323783649,54346,63323837995,2,0,1,18944,2,10668601445
275,63323836737,1514,63323838251,2,0,1,6144,2,9007504694
276,63323911455,144762,63324056217,4,0,0,1536,4,841551152
277,63324046411,202288,63324248699,7,0,1,202752,7,2131695149
278,63324223613,97357,63324320970,2,0,0,117248,2,6105562496
279,63324259832,56479,63324316311,0,0,1,4096,0,5320872191
280,63324269676,11529,63324281205,4,0,0,16384,4,4148644771
281,63324419251,1990,63324421241,2,0,0,18944,2,6557880962
282,63324433727,229848,63324663575,1,0,0,2048,1,6679629396
283,63324500444,101188,63324601632,7,0,1,32256,7,3129685380
284,63324584852,31520,63324616372,5,0,1,123392,5,6414693378
285,63324617628,128956,63324746584,2,0,0,51200,2,3427942858
286,63324728783,1514,63324730297,0,0,0,1536,0,6187615247
287,63324810583,1514,63324812097,1,0,0,1536,1,2652548989
288,63324910627,125658,63325036285,4,0,0,207872,4,1911460294
289,63324940315,209395,63325149710,1,0,1,12288,1,6726151231
290,63325111573,52360,63325163933,2,0,1,3072,2,5986985325
291,63325138827,77182,63325216009,0,0,1,7680,0,7098066136
292,63325156282,74258,63325230540,9,0,0,124416,9,5331666217
293,63325164545,102797,63325267342,8,0,0,118784,8,9795558577
294,63325395074,84641,63325479715,4,0,0,141312,4,4728202411
295,63325484954,21137,63325506091,8,0,1,6144,8,62148672
296,63325489087,93199,63325582286,5,0,1,69632,5,1529644636
297,63325512932,211140,63325724072,4,0,0,34304,4,1340783029
298,63325513465,186773,63325700238,7,0,0,287232,7,10382778880
299,63325569456,125730,63325695186,6,0,1,22016,6,941955166
300,63325576880,33071,63325609951,4,0,0,6656,4,9466187988
301,63325665531,33329,63325698860,4,0,1,6656,4,56361102
302,63325703288,238595,63325941883,3,0,0,54272,3,2439449997
303,63325737961,145862,63325883823,5,0,1,63488,5,6903219140
304,63325757052,21137,63325778189,2,0,0,54784,2,107258981
305,63325770247,36342,63325806589,4,0,1,14848,4,938550659
306,63325819045,5967,63325825012,2,0,0,34304,2,7952365145
307,63325837525,36342,63325873867,2,0,0,64000,2,10725108354
308,63325848818,206328,63326055146,8,0,1,1536,8,6986714281
309,63325902284,281627,63326183911,9,0,0,14848,9,1043661575
310,63325912503,205012,63326117515,2,0,0,64000,2,9670762020
311,63325945663,6274,63325951937,5,0,1,173568,5,4961473477
312,63325975153,292143,63326267296,5,0,1,127488,5,6085348102
313,63326067253,22429,63326089682,5,0,1,251392,5,1132967758
314,63326100293,3383,63326103676,8,0,0,6656,8,7607280094
315,63326280513,437846,63326718359,5,0,0,36864,5,9299159200
316,63326306133,392863,63326698996,3,0,0,9728,3,2160426732
317,63326360384,121936,63326482320,3,0,0,36352,3,4175989125
318,63326381230,79535,63326460765,8,0,1,13312,8,9304970997
319,63326413205,154351,63326567556,4,0,0,33280,4,2137804907
320,63326514446,41387,63326555833,7,0,0,67072,7,8456433745
321,63326551408,21395,63326572803,9,0,0,34816,9,9826092766
322,63326612986,15058,63326628044,0,0,1,11264,0,6774172246
323,63326643022,12304,63326655326,4,0,0,29184,4,1914435831
324,63326653645,159007,63326812652,4,0,0,20480,4,5111830440
325,63326765399,33758,63326799157,8,0,0,58880,8,9217654305
326,63326811488,1038,63326812526,5,0,0,1024,5,1483944882
327,63326831991,73383,63326905374,4,0,1,2560,4,3943450952
328,63326837159,205883,63327043042,8,0,0,337408,8,566535626
329,63326856166,199871,63327056037,7,0,0,424960,7,4497283740
330,63326910553,343254,63327253807,9,0,0,9216,9,3990976414
331,63326911790,289123,63327200913,0,0,1,9216,0,5094932422
332,63327291894,113554,63327405448,5,0,0,184320,5,6878797665
333,63327393972,120898,63327514870,0,0,1,1536,0,5357860957
334,63327445706,77818,63327523524,3,0,1,1536,3,9913399051
335,63327457275,91290,63327548565,2,0,1,2048,2,7519704681
336,63327463841,7226,63327471067,7,0,1,94208,7,6645995020
337,63327552419,197678,63327750097,7,0,0,7680,7,2592087299
338,63327619130,42416,63327661546,4,0,0,51712,4,6485777663
339,63327625180,110614,63327735794,7,0,0,124416,7,8777396907
340,63327635824,106076,63327741900,3,0,0,20992,3,5766437028
341,63327672668,126734,63327799402,3,0,1,1536,3,7719147540
342,63327706286,4846,63327711132,2,0,1,1024,2,5837674244
343,63327796746,117878,63327914624,2,0,0,5120,2,8927651423
344,63327798093,94083,63327892176,8,0,0,152576,8,8908747893
345,63327809609,106271,63327915880,0,0,1,8704,0,5496105997
346,63327846840,82752,63327929592,9,0,0,130048,9,161318925
347,63327942536,54783,63327997319,4,0,1,4096,4,9136584111
348,63327955866,88348,63328044214,4,0,0,93184,4,6946385772
349,63327971546,80811,63328052357,3,0,1,7680,3,9156034238
350,63327982087,155733,63328137820,3,0,1,7168,3,7582775041
351,63328012616,204891,63328217507,2,0,1,512,2,2550726574
352,63328014694,139889,63328154583,7,0,1,7680,7,8995680963
353,63328055481,132300,63328187781,6,0,1,4608,6,8919278277
354,63328195114,3418,63328198532,9,0,1,2560,9,5580561330
355,63328196442,96750,63328293192,4,0,0,3584,4,6418430272
356,63328256279,98457,63328354736,1,0,1,15360,1,6099921706
357,63328379432,35050,63328414482,8,0,0,61440,8,8206498207
358,63328424355,4675,63328429030,7,0,1,19456,7,8005631440
359,63328428525,49799,63328478324,2,0,1,2560,2,194285070
360,63328430901,1514,63328432415,7,0,0,12288,7,9596523470
361,63328431620,162136,63328593756,4,0,0,80896,4,3332744866
362,63328510751,6923,63328517674,0,0,0,1536,0,414931632
363,63328584440,211390,63328795830,8,0,1,3584,8,9601973121
364,63328590004,54052,63328644056,1,0,0,6656,1,7597997696
365,63328700215,146425,63328846640,5,0,0,241664,5,91468806
366,63328733271,46549,63328779820,6,0,1,4608,6,6568342070
367,63328775300,166315,63328941615,2,0,1,7680,2,4928413226
368,63328816668,126637,63328943305,7,0,0,62976,7,5302812048
369,63328836497,68308,63328904805,9,0,1,8704,9,4716813583
370,63328904036,138510,63329042546,2,0,1,2048,2,1411095657
371,63328990992,60820,63329051812,6,0,1,5632,6,1860637442
372,63329050954,56925,63329107879,9,0,0,95744,9,3933781501
373,63329070073,139003,63329209076,6,0,1,26112,6,2654712084
374,63329092075,153375,63329245450,0,0,1,25088,0,2360033042
375,63329105248,210469,63329315717,8,0,1,3072,8,5118887398
376,63329115022,165843,63329280865,8,0,1,1024,8,8079840586
377,63329276202,63783,63329339985,9,0,1,5120,9,4635277327
378,63329351977,52029,63329404006,3,0,0,84480,3,3623123530
379,63329432761,126557,63329559318,9,0,1,2048,9,8890068299
380,63329576773,45592,63329622365,2,0,1,1024,2,2836814442
381,63329628876,43900,63329672776,3,0,1,512,3,2702877482
382,63329690212,1514,63329691726,0,0,0,1536,0,8362113507
383,63329724451,94596,63329819047,7,0,0,154112,7,2875622125
384,63329751458,25442,63329776900,1,0,1,9216,1,1193322987
385,63329847154,142134,63329989288,3,0,0,46080,3,9992562006
386,63329967226,81117,63330048343,1,0,1,5120,1,3915309502
387,63330023580,33499,63330057079,2,0,0,58368,2,10066832822
388,63330080209,2466,63330082675,9,0,1,5120,9,7314459608
389,63330103313,70840,63330174153,9,0,1,13312,9,970583958
390,63330160865,23979,63330184844,0,0,0,2560,0,5728318330
391,63330215211,162124,63330377335,3,0,0,39936,3,8103844186
392,63330402669,14025,63330416694,9,0,1,4608,9,10361760275
393,63330416538,55900,63330472438,7,0,0,27136,7,7217850149
394,63330482206,562,63330482768,0,0,0,512,0,6323643791
395,63330494335,48976,63330543311,3,0,1,2048,3,9574840340
396,63330615390,6484,63330621874,2,0,0,15872,2,9144636614
397,63330625211,54052,63330679263,1,0,1,3584,1,1409467028
398,63330651812,43454,63330695266,2,0,0,71168,2,573900851
399,63330707926,1990,63330709916,1,0,1,1024,1,5118026017
400,63330717174,82529,63330799703,1,0,0,2048,1,1863323589
401,63330832379,88758,63330921137,7,0,1,11776,7,10205903863
402,63330851168,266116,63331117284,9,0,0,434688,9,7020472352
403,63330891682,250512,63331142194,3,0,1,23552,3,3914811598
404,63330892796,233672,63331126468,3,0,0,91648,3,8168538428
405,63330911262,285040,63331196302,1,0,0,2560,1,4289744300
406,63330945029,289530,63331234559,5,0,1,61440,5,6168140674
407,63330978007,295750,63331273757,8,0,1,7168,8,8230972919
408,63331166513,88232,63331254745,6,0,1,33280,6,8890105482
409,63331216108,128201,63331344309,4,0,1,4096,4,7212560194
410,63331222601,221899,63331444500,3,0,1,1536,3,5891892323
411,63331449174,43883,63331493057,2,0,1,7168,2,3606643953
412,63331462771,65896,63331528667,9,0,0,75264,9,9965128175
413,63331469776,47810,63331517586,7,0,0,44032,7,5563265410
414,63331573052,5450,63331578502,2,0,1,11776,2,10647644759
415,63331576992,158998,63331735990,4,0,0,13824,4,4254260513
416,63331732131,43900,63331776031,2,0,1,512,2,8314162707
417,63331825785,102137,63331927922,9,0,0,165376,9,3214544901
418,63331829346,14326,63331843672,3,0,1,58368,3,10027213439
419,63331915862,205492,63332121354,0,0,0,3584,0,3607527872
420,63332068541,1514,63332070055,1,0,0,1536,1,7107505523
421,63332156103,101500,63332257603,7,0,1,33280,7,2447844570
422,63332175996,97220,63332273216,5,0,1,179712,5,4205947034
423,63332181980,101850,63332283830,4,0,1,3584,4,3859717473
424,63332183001,237157,63332420158,7,0,1,1536,7,4682020320
425,63332216872,92379,63332309251,0,0,1,6144,0,6562601569
426,63332320793,230650,63332551443,7,0,0,92160,7,5537967556
427,63332361699,35825,63332397524,5,0,1,80896,5,7274260262
428,63332436155,22444,63332458599,5,0,0,62976,5,4069880051
429,63332450842,51937,63332502779,0,0,0,2048,0,2209944046
430,63332486878,64984,63332551862,8,0,1,3072,8,9028457816
431,63332489527,62512,63332552039,0,0,1,9216,0,6742964440
432,63332500996,252703,63332753699,9,0,1,6144,9,6611751584
433,63332549604,64809,63332614413,3,0,0,82944,3,9686460136
434,63332558040,78530,63332636570,7,0,0,99840,7,138979708
435,63332678401,1990,63332680391,1,0,0,2048,1,3410270697
436,63332799021,64204,63332863225,9,0,1,6656,9,8093735909
437,63332970290,67234,63333037524,9,0,0,114176,9,10490181371
438,63332971056,143451,63333114507,1,0,1,7680,1,4715227705
439,63333033006,111183,63333144189,2,0,1,8192,2,5255437849
440,63333051503,104662,63333156165,6,0,1,7168,6,4470623812
441,63333159007,45592,63333204599,0,0,1,1024,0,3677386629
442,63333232189,81304,63333313493,7,0,1,17408,7,1638842964
443,63333316469,62154,63333378623,3,0,0,100864,3,3479248159
444,63333337151,94570,63333431721,3,0,0,137728,3,2602503999
445,63333407769,40119,63333447888,9,0,0,60928,9,5829303674
446,63333554076,2942,63333557018,3,0,0,3072,3,2148830512
447,63333635840,48976,63333684816,2,0,1,2048,2,6054004484
448,63333651557,95800,63333747357,8,0,0,159744,8,380825907
449,63333656602,97646,63333754248,4,0,1,11776,4,7442988213
450,63333671626,86879,63333758505,2,0,0,80384,2,272884525
451,63333694876,75993,63333770869,6,0,1,36352,6,8570023687
452,63333698151,185319,63333883470,8,0,0,50688,8,1095153290
453,63333709383,23891,63333733274,1,0,0,512,1,5038027453
454,63333767219,341585,63334108804,8,0,1,20992,8,8298318682
455,63333786857,1990,63333788847,5,0,1,161792,5,2565173615
456,63333874461,295780,63334170241,1,0,1,29696,1,4041106538
457,63333896863,220390,63334117253,1,0,1,6656,1,5352303751
458,63333911740,57165,63333968905,5,0,0,43008,5,2143970629
459,63333984762,123597,63334108359,3,0,1,38400,3,5729432746
460,63334014006,12640,63334026646,0,0,0,2048,0,7502105751
461,63334030085,347558,63334377643,7,0,1,17408,7,9793073780
462,63334037697,248503,63334286200,7,0,0,11264,7,9260012512
463,63334041237,31003,63334072240,7,0,1,4608,7,8045528826
464,63334095730,16430,63334112160,4,0,0,9216,4,5671039415
465,63334128568,180339,63334308907,7,0,0,50176,7,4864885869
466,63334148428,190730,63334339158,2,0,0,25088,2,2190748116
467,63334156250,114329,63334270579,5,0,0,185856,5,4668041899
468,63334161928,110277,63334272205,0,0,0,2560,0,2422133466
469,63334184024,98895,63334282919,8,0,1,1024,8,4007577354
470,63334208046,186296,63334394342,4,0,1,3072,4,5609437215
471,63334293466,183912,63334477378,5,0,0,297984,5,3648629508
472,63334433600,74935,63334508535,4,0,0,99840,4,3031211339
473,63334481942,42248,63334524190,3,0,0,58368,3,995955306
474,63334493919,10237,63334504156,6,0,1,26624,6,3516148182
475,63334504455,40870,63334545325,2,0,1,9728,2,3558648786
476,63334595013,1514,63334596527,7,0,0,16384,7,8811679648
477,63334613570,86546,63334700116,8,0,0,66048,8,3833341729
478,63334675034,312954,63334987988,7,0,1,1536,7,555219265
479,63334711139,312429,63335023568,2,0,1,13824,2,2100753166
480,63334717640,130784,63334848424,1,0,0,1536,1,5165426435
481,63334730440,165988,63334896428,4,0,0,269824,4,7730279830
482,63334737806,101569,63334839375,9,0,1,512,9,640527248
483,63334790564,98779,63334889343,5,0,1,36864,5,4465796088
484,63334799685,194037,63334993722,4,0,0,7680,4,9541596987
485,63334808684,68225,63334876909,7,0,0,21504,7,1244647116
486,63334815171,11012,63334826183,7,0,1,24576,7,729799764
487,63334865467,226867,63335092334,7,0,0,92672,7,96845969
488,63334915617,296590,63335212207,8,0,1,4096,8,144614229
489,63334986801,226263,63335213064,9,0,0,17920,9,4103846268
490,63335152674,11012,63335163686,3,0,1,17408,3,3367833132
491,63335162771,76696,63335239467,7,0,0,17920,7,4773928159
492,63335211391,60820,63335272211,4,0,1,5632,4,9002138688
493,63335310805,45592,63335356397,1,0,1,1024,1,3095355848
494,63335497066,7702,63335504768,9,0,0,8192,9,10237935692
495,63335517780,2466,63335520246,0,0,0,2560,0,2203687749
496,63335525005,66695,63335591700,4,0,1,10240,4,8285414706
497,63335542080,83179,63335625259,3,0,0,135168,3,6646887696
498,63335560388,70977,63335631365,8,0,0,29184,8,760691893
499,63335622721,10129,63335632850,4,0,0,15360,4,1524051706
500,63335901128,67588,63335968716,5,0,1,13312,5,5596947744
501,63335912186,86200,63335998386,3,0,1,7680,3,589005288
502,63335926254,65896,63335992150,2,0,1,7168,2,4625486800
503,63335980469,52360,63336032829,2,0,1,3072,2,6249168525
504,63335991023,68353,63336059376,3,0,0,114176,3,4723925871
505,63336060825,167813,63336228638,3,0,1,1536,3,5266761743
506,63336204055,33758,63336237813,5,0,1,30208,5,10519093395
507,63336224998,14113,63336239111,4,0,0,58880,4,4486236189
508,63336264983,100564,63336365547,4,0,0,24064,4,249806569
509,63336319275,3383,63336322658,9,0,1,17408,9,898190518
510,63336336438,84376,63336420814,6,0,1,8704,6,2255182414
511,63336346689,70972,63336417661,7,0,0,9728,7,5961800713
512,63336498943,95488,63336594431,2,0,1,28672,2,10499557854
513,63336535443,91432,63336626875,1,0,1,15360,1,5684389565
514,63336599305,27581,63336626886,9,0,0,45568,9,2376681050
515,63336632463,12821,63336645284,3,0,1,10240,3,6059332650
516,63336649211,93429,63336742640,8,0,1,5120,8,8279846797
517,63336675946,62512,63336738458,4,0,0,21504,4,8603609115
518,63336687418,135639,63336823057,7,0,1,6144,7,2840265727
519,63336829928,42162,63336872090,7,0,0,68608,7,6310072081
520,63336901696,72664,63336974360,6,0,1,10752,6,9791213405
521,63336926422,100677,63337027099,1,0,1,9216,1,3978166763
522,63336984865,14113,63336998978,0,0,1,18944,0,7011223207
523,63337008582,1038,63337009620,7,0,0,24064,7,7610599796
524,63337036393,81772,63337118165,1,0,0,1024,1,4821336671
525,63337211952,112779,63337324731,5,0,0,182784,5,2355591923
526,63337328710,1038,63337329748,0,0,0,1024,0,5671243881
527,63337338755,1514,63337340269,1,0,0,1536,1,2830365330
528,63337386952,171362,63337558314,1,0,1,26112,1,3522030599
529,63337468285,90196,63337558481,2,0,1,512,2,1584215340
530,63337501120,99716,63337600836,0,0,1,13312,0,3147858425
531,63337665964,123496,63337789460,5,0,1,105472,5,4523090602
532,63337670231,121736,63337791967,9,0,1,8192,9,10249276079
533,63337706226,132704,63337838930,8,0,1,34816,8,5928088412
534,63337869293,81616,63337950909,4,0,1,18432,4,9135823654
535,63337910828,82003,63337992831,0,0,1,8704,0,5554470190
536,63337947885,562,63337948447,2,0,1,22528,2,101300822
537,63337969805,48976,63338018781,2,0,1,2048,2,6625296304
538,63337985435,562,63337985997,9,0,1,10240,9,7723220395
539,63337987549,72976,63338060525,1,0,1,4096,1,6738909657
540,63337996032,72121,63338068153,1,0,0,512,1,3562982303
541,63338035044,120156,63338155200,1,0,0,512,1,6110714779
542,63338127310,1514,63338128824,0,0,0,1536,0,8620298730
543,63338186603,34275,63338220878,9,0,0,59904,9,3504086965
544,63338190105,34959,63338225064,4,0,0,6656,4,3071129755
545,63338227228,3418,63338230646,4,0,0,3584,4,9980012992
546,63338234042,5708,63338239750,3,0,0,14336,3,901230745
547,63338256425,2466,63338258891,9,0,1,4608,9,3252903298
548,63338300901,21912,63338322813,9,0,1,3584,9,9154002465
549,63338303797,144977,63338448774,1,0,0,2560,1,6302429000
550,63338330332,22858,63338353190,5,0,0,35840,5,1487551199
551,63338348053,17621,63338365674,8,0,1,24576,8,3897247403
552,63338381325,129373,63338510698,3,0,0,40960,3,2517909347
553,63338387228,110140,63338497368,0,0,0,1024,0,8490592924
554,63338406240,51964,63338458204,2,0,0,78848,2,6475661087
555,63338423783,23721,63338447504,0,0,1,1536,0,999823086
556,63338464363,32295,63338496658,2,0,1,23552,2,7484042341
557,63338470603,149236,63338619839,7,0,0,39424,7,8581064533
558,63338539600,21654,63338561254,3,0,0,52736,3,7490989661
559,63338569227,24925,63338594152,2,0,0,35328,2,6525281512
560,63338580811,200462,63338781273,8,0,0,45056,8,3971331814
561,63338602328,23462,63338625790,4,0,1,150528,4,6748863413
562,63338657217,21912,63338679129,9,0,0,38912,9,3193350761
563,63338706288,288086,63338994374,4,0,1,69632,4,5795497319
564,63338738158,121612,63338859770,9,0,0,35840,9,9903861449
565,63338772619,258485,63339031104,3,0,0,196608,3,1225847290
566,63338971512,6225,63338977737,2,0,1,1024,2,326948686
567,63338977622,1514,63338979136,4,0,0,15360,4,4251811774
568,63339025959,14283,63339040242,7,0,0,1536,7,10551962905
569,63339040076,221037,63339261113,5,0,0,27648,5,3881207754
570,63339118583,132273,63339250856,4,0,1,29184,4,1262820832
571,63339177278,82816,63339260094,8,0,1,12288,8,6310017119
572,63339278530,62668,63339341198,2,0,1,6656,2,3310322654
573,63339411142,103528,63339514670,4,0,1,39936,4,9680009460
574,63339455054,20878,63339475932,4,0,1,242688,4,4159309516
575,63339527448,10237,63339537685,5,0,0,33792,5,9331091818
576,63339592702,4846,63339597548,3,0,0,16384,3,6083494813
577,63339610237,240006,63339850243,0,0,0,5120,0,801673181
578,63339687322,171798,63339859120,5,0,1,142848,5,5433669754
579,63339703059,170424,63339873483,4,0,1,47104,4,252934385
580,63339731744,155420,63339887164,7,0,1,15872,7,1105192821
581,63339854048,66867,63339920915,1,0,1,2048,1,3723545244
582,63339875900,49467,63339925367,2,0,1,1536,2,6135612048
583,63339900689,86200,63339986889,9,0,1,13312,9,8562289692
584,63339938366,105556,63340043922,5,0,1,46592,5,99805768
585,63340051109,43624,63340094733,2,0,0,74752,2,4053286479
586,63340270304,44229,63340314533,8,0,0,72704,8,9280118915
587,63340411508,12733,63340424241,4,0,0,24576,4,6580858250
588,63340454290,70972,63340525262,7,0,1,8704,7,2365828932
589,63340480526,53837,63340534363,4,0,0,88064,4,6370658406
590,63340511635,8198,63340519833,1,0,1,6144,1,3695477148
591,63340527151,6484,63340533635,1,0,0,1536,1,449803537
592,63340571040,103148,63340674188,7,0,0,15872,7,10324439240
593,63340743841,47284,63340791125,1,0,1,1536,1,3185045850
594,63340767754,45692,63340813446,9,0,0,78848,9,6280064871
595,63340805467,64479,63340869946,2,0,0,105472,2,8834325158
596,63340851964,19928,63340871892,1,0,0,3072,1,10278969852
597,63340868802,4370,63340873172,6,0,1,5632,6,5657965416
598,63340884109,60820,63340944929,1,0,0,4608,1,7928398704
599,63340914390,78886,63340993276,5,0,1,73216,5,4678491138
600,63340954861,75033,63341029894,3,0,1,5120,3,2230216472
601,63340966322,203423,63341169745,4,0,0,125952,4,9864901930
602,63341098977,4846,63341103823,3,0,1,18432,3,7157292658
603,63341137250,55558,63341192808,4,0,0,5120,4,726581502
604,63341155579,134742,63341290321,3,0,0,94720,3,6280771472
605,63341194009,76842,63341270851,5,0,1,121856,5,1126774789
606,63341256978,268439,63341525417,5,0,1,95232,5,2710910756
607,63341334748,266820,63341601568,7,0,0,129536,7,3748998328
608,63341417649,113812,63341531461,3,0,0,184832,3,3370052549
609,63341495264,41894,63341537158,7,0,0,18944,7,6707346133
610,63341632982,110266,63341743248,1,0,1,13824,1,10535591228
611,63341851625,73741,63341925366,8,0,0,123392,8,6721337052
612,63341852281,73751,63341926032,1,0,0,1024,1,6717827303
613,63341869447,49224,63341918671,6,0,1,4096,6,2127040703
614,63341877474,100463,63341977937,0,0,0,1024,0,7786361131
615,63341924351,51253,63341975604,7,0,0,82944,7,8347125842
616,63341963586,115104,63342078690,5,0,0,187392,5,10272894502
617,63342037616,68019,63342105635,8,0,0,96256,8,776090924
618,63342221155,4846,63342226001,9,0,1,11776,9,10672812909
619,63342230154,87707,63342317861,7,0,1,2048,7,2776952793
620,63342251666,81527,63342333193,7,0,0,5120,7,7158600110
621,63342289889,46398,63342336287,2,0,1,1024,2,7862062648
622,63342353225,12821,63342366046,9,0,1,26624,9,10051225816
623,63342418304,99472,63342517776,7,0,0,21504,7,5921423776
624,63342434619,66143,63342500762,6,0,1,3584,6,5487334213
625,63342504502,117143,63342621645,4,0,1,50176,4,3629129987
626,63342513380,153217,63342666597,3,0,0,368128,3,10027403668
627,63342528042,226738,63342754780,7,0,0,235520,7,960641083
628,63342570377,285218,63342855595,2,0,1,4608,2,9879306626
629,63342596165,223986,63342820151,1,0,1,2560,1,4526480186
630,63342626077,259609,63342885686,3,0,0,231936,3,4474589532
631,63342793557,93435,63342886992,1,0,0,2048,1,1672366915
632,63342887420,26734,63342914154,7,0,1,25088,7,3675254677
633,63342887505,179442,63343066947,3,0,1,9216,3,779458853
634,63342909325,80251,63342989576,3,0,0,48640,3,10259210536
635,63342974631,237125,63343211756,9,0,1,2560,9,520277635
636,63343010535,145054,63343155589,2,0,1,8192,2,9529877397
637,63343027459,194382,63343221841,1,0,1,4096,1,2377387017
638,63343029733,171346,63343201079,9,0,1,13312,9,5225758726
639,63343097101,107232,63343204333,2,0,1,4608,2,4373710745
640,63343121572,130225,63343251797,7,0,1,12288,7,3656455675
641,63343247257,22170,63343269427,2,0,0,36352,2,9069360905
642,63343263680,12821,63343276501,9,0,1,4608,9,5721576297
643,63343271754,57436,63343329190,8,0,0,21504,8,2559631758
644,63343314198,43196,63343357394,7,0,0,70656,7,2683189693
645,63343342173,2866,63343345039,1,0,1,24576,1,4890361649
646,63343413809,57436,63343471245,4,0,0,8704,4,10513365120
647,63343451044,62670,63343513714,8,0,1,5632,8,3125330751
648,63343457473,212738,63343670211,9,0,1,4608,9,7530200487
649,63343459247,107311,63343566558,6,0,1,7680,6,1308214571
650,63343479113,48762,63343527875,8,0,0,101888,8,811809764
651,63343514424,205225,63343719649,3,0,0,77824,3,3604214065
652,63343578939,93057,63343671996,1,0,1,7168,1,4255033667
653,63343667678,10495,63343678173,7,0,0,16896,7,889383916
654,63343691645,109740,63343801385,8,0,1,6656,8,7173453807
655,63343713631,64453,63343778084,4,0,1,188928,4,3698045165
656,63343798328,1038,63343799366,1,0,1,13312,1,3433823602
657,63343800798,146533,63343947331,4,0,0,107520,4,9258106084
658,63343845087,200714,63344045801,1,0,1,3072,1,1878550055
659,63343895667,66458,63343962125,0,0,0,1024,0,7060548301
660,63343943093,49275,63343992368,7,0,0,112640,7,10118044831
661,63343960840,383769,63344344609,8,0,0,10752,8,6858383958
662,63344105715,1990,63344107705,0,0,0,2048,0,7335917194
663,63344111440,33587,63344145027,8,0,0,55296,8,3461811488
664,63344119757,138480,63344258237,1,0,1,59904,1,4849278040
665,63344221337,62670,63344284007,3,0,0,101888,3,10217224130
666,63344329912,63962,63344393874,3,0,0,104448,3,2226900187
667,63344535946,98068,63344634014,5,0,1,22016,5,1446102485
668,63344602011,101620,63344703631,3,0,0,164352,3,8457367333
669,63344621514,70165,63344691679,0,0,1,18944,0,547293317
670,63344664725,169546,63344834271,3,0,0,100352,3,4444822923
671,63344665069,92633,63344757702,3,0,1,10752,3,7146877808
672,63344700233,142164,63344842397,2,0,1,3584,2,9055409638
673,63344746912,37517,63344784429,1,0,1,40960,1,10101411662
674,63344851570,33596,63344885166,4,0,0,56320,4,2358874598
675,63344855502,30391,63344885893,1,0,0,1536,1,5032899425
676,63344862375,562,63344862937,4,0,0,20992,4,5409362528
677,63344919948,276946,63345196894,1,0,0,512,1,7120168724
678,63344959782,56850,63345016632,2,0,0,97280,2,8549518073
679,63345013434,5144,63345018578,1,0,0,3072,1,7361205464
680,63345113393,62154,63345175547,4,0,1,49152,4,10542794007
681,63345122823,106336,63345229159,7,0,0,100864,7,6616452432
682,63345187308,65683,63345252991,4,0,0,111104,4,10138922494
683,63345192848,60489,63345253337,0,0,0,512,0,3541404215
684,63345295707,33241,63345328948,9,0,0,57856,9,2627621482
685,63345375697,1038,63345376735,7,0,1,3072,7,7032257878
686,63345398056,69190,63345467246,4,0,0,1024,4,7621837762
687,63345426226,20878,63345447104,4,0,0,33792,4,8476173559
688,63345488077,4370,63345492447,7,0,1,18432,7,8096421489
689,63345489625,68932,63345558557,3,0,1,2560,3,648034633
690,63345490400,43366,63345533766,1,0,0,4608,1,4789295875
691,63345571811,140187,63345711998,7,0,0,74240,7,8951436680
692,63345776338,23204,63345799542,9,0,0,38400,9,10196650501
693,63345818272,94596,63345912868,3,0,0,154112,3,6395572421
694,63345854040,56075,63345910115,1,0,1,10240,1,7388269554
695,63345885812,43454,63345929266,7,0,0,95744,7,1172094892
696,63345924266,170910,63346095176,7,0,0,71168,7,2366511962
697,63345953276,118909,63346072185,9,0,1,4608,9,6597717260
698,63346048972,274262,63346323234,5,0,0,443904,5,9944311219
699,63346288416,37404,63346325820,5,0,0,4096,5,882236901
700,63346316711,12015,63346328726,7,0,0,4608,7,5357135719
701,63346340209,35050,63346375259,2,0,1,16896,2,6561844166
702,63346400923,21395,63346422318,9,0,0,61440,9,6202941742
703,63346426949,146605,63346573554,4,0,0,34816,4,8719476215
704,63346435602,103962,63346539564,1,0,1,4096,1,7323416264
705,63346445665,129899,63346575564,8,0,1,16384,8,3836167741
706,63346570666,5928,63346576594,0,0,0,1024,0,9619429172
707,63346580805,3894,63346584699,5,0,0,4096,5,8497377691
708,63346619453,47284,63346666737,2,0,1,1536,2,6832668264
709,63346625577,230929,63346856506,5,0,1,188928,5,7815763482
710,63346668718,191387,63346860105,0,0,1,11776,0,1972144441
711,63346732279,235571,63346967850,5,0,0,381952,5,1590215454
712,63346749248,224401,63346973649,2,0,0,27648,2,2097098540
713,63346806430,157911,63346964341,3,0,1,1536,3,288660309
714,63346816724,239030,63347055754,0,0,0,1536,0,5261488510
715,63346883503,92787,63346976290,4,0,1,281088,4,3775141888
716,63346961607,45279,63347006886,2,0,0,150528,2,10405352337
717,63347014709,94337,63347109046,5,0,0,18432,5,1445585330
718,63347069774,14283,63347084057,3,0,0,153600,3,5443955524
719,63347092596,504676,63347597272,9,0,1,512,9,9740429720
720,63347185626,216621,63347402247,3,0,0,27648,3,3242089118
721,63347196221,338479,63347534700,3,0,1,6144,3,2151592905
722,63347310739,77296,63347388035,5,0,1,140800,5,10433441759
723,63347383958,81041,63347464999,8,0,1,5120,8,5529290375
724,63347386132,80056,63347466188,0,0,1,9728,0,9236036809
725,63347461461,98838,63347560299,2,0,1,23040,2,2314568417
726,63347471161,363776,63347834937,5,0,1,13312,5,4601761576
727,63347603395,42773,63347646168,5,0,1,14848,5,6759085788
728,63347633248,96062,63347729310,0,0,0,1536,0,8449096317
729,63347692301,7167,63347699468,4,0,0,8704,4,1336748936
730,63347788385,53837,63347842222,4,0,0,88064,4,9634984325
731,63347897131,1514,63347898645,4,0,1,12288,4,9974934296
732,63347937200,76672,63348013872,5,0,1,4608,5,7985071777
733,63347965736,57436,63348023172,1,0,0,1536,1,9328713459
734,63348069763,100408,63348170171,5,0,1,29696,5,10611276411
735,63348128668,59128,63348187796,8,0,1,5120,8,8311600956
736,63348249462,167708,63348417170,4,0,0,276480,4,10358038191
737,63348263525,159342,63348422867,5,0,0,18944,5,7020037211
738,63348291650,34275,63348325925,4,0,1,119296,4,5036681094
739,63348428436,319281,63348747717,8,0,0,59904,8,3177855621
740,63348606334,4908,63348611242,2,0,1,10240,2,6508979680
741,63348608906,114035,63348722941,4,0,0,8704,4,1247903330
742,63348769544,1038,63348770582,1,0,0,1024,1,10287332126
743,63348797181,2466,63348799647,1,0,0,2560,1,5548784930
744,63348842083,119596,63348961679,4,0,1,92672,4,1520442245
745,63348926016,35674,63348961690,7,0,0,59392,7,6096334992
746,63349181990,23891,63349205881,8,0,0,43008,8,9623468925
747,63349425625,33758,63349459383,9,0,0,58880,9,5373176443
748,63349496487,1038,63349497525,2,0,0,1024,2,9165744109
749,63349578827,1514,63349580341,9,0,1,1536,9,4734924555
750,63349581079,83389,63349664468,7,0,0,1536,7,38376078
751,63349702343,562,63349702905,2,0,1,2560,2,10533871523
752,63349730104,50668,63349780772,1,0,0,512,1,7312134937
753,63349753866,185116,63349938982,4,0,0,303616,4,5718890048
754,63349766366,226367,63349992733,0,0,1,1536,0,1112259945
755,63349909950,82816,63349992766,0,0,1,4608,0,10374078229
756,63349997351,188286,63350185637,9,0,1,12288,9,3261645217
757,63350169883,43971,63350213854,4,0,1,164352,4,8084095957
758,63350188614,190588,63350379202,4,0,0,72192,4,4549773489
759,63350211599,64391,63350275990,1,0,1,1536,1,10343284964
760,63350305672,173695,63350479367,8,0,0,108544,8,5770404992
761,63350307944,207606,63350515550,3,0,0,251904,3,8364011445
762,63350516496,64479,63350580975,2,0,0,105472,2,3105750310
763,63350535201,50920,63350586121,7,0,0,8192,7,3082555766
764,63350752549,23204,63350775753,3,0,0,38400,3,7236736872
765,63350804402,12733,63350817135,7,0,0,24576,7,35075111
766,63350815505,79210,63350894715,9,0,1,1024,9,2197590517
767,63350925777,62512,63350988289,8,0,1,6144,8,9345439179
768,63351106545,104776,63351211321,4,0,1,44032,4,8916837692
769,63351114376,107564,63351221940,2,0,1,34816,2,29138636
770,63351156339,76325,63351232664,9,0,1,17920,9,10245020746
771,63351173492,21137,63351194629,4,0,0,128512,4,2541134521
772,63351228269,81184,63351309453,2,0,1,1536,2,3470708181
773,63351284036,160836,63351444872,7,0,0,34304,7,2501417697
774,63351441506,80277,63351521783,6,0,1,36352,6,399121212
775,63351461157,82270,63351543427,5,0,1,10752,5,8156052235
776,63351465259,122087,63351587346,2,0,1,19968,2,3718307021
777,63351484260,109339,63351593599,9,0,1,7680,9,5105416507
778,63351490295,113491,63351603786,3,0,1,8704,3,1589350440
779,63351554834,81288,63351636122,4,0,0,117760,4,10731763533
780,63351597173,18351,63351615524,1,0,1,11264,1,18329495
781,63351621957,34353,63351656310,9,0,0,6656,9,1233887835
782,63351623010,32037,63351655047,9,0,0,54784,9,4765770167
783,63351653248,117421,63351770669,2,0,0,52224,2,4155205733
784,63351697299,50995,63351748294,5,0,0,82432,5,5980503827
785,63351705005,64487,63351769492,4,0,0,76800,4,9089985808
786,63351705471,160975,63351866446,8,0,1,9216,8,2434692427
787,63351912916,562,63351913478,4,0,0,512,4,498953779
788,63351922262,32037,63351954299,4,0,0,52224,4,7623584132
789,63352215954,77740,63352293694,8,0,1,10752,8,1233312994
790,63352273503,562,63352274065,1,0,1,3584,1,1664073700
791,63352326918,70915,63352397833,1,0,0,512,1,4193973026
792,63352350424,48976,63352399400,8,0,1,17408,8,8163457621
793,63352355650,88984,63352444634,3,0,1,2048,3,1881344513
794,63352389889,79753,63352469642,2,0,1,4608,2,2927822447
795,63352436866,46434,63352483300,2,0,1,512,2,4059338463
796,63352461098,45175,63352506273,4,0,1,86528,4,3086632888
797,63352492138,117872,63352610010,7,0,0,77824,7,1034374302
798,63352510725,71752,63352582477,2,0,1,9728,2,5510673796
799,63352541314,131057,63352672371,9,0,1,11264,9,6443696248
800,63352599807,83752,63352683559,8,0,1,2560,8,8345725724
801,63352616566,81904,63352698470,3,0,1,15360,3,8452846166
802,63352674973,86734,63352761707,9,0,1,14336,9,1440805627
803,63352675840,44658,63352720498,8,0,1,10752,8,6251734447
804,63352754728,203318,63352958046,8,0,1,15360,8,84755640
805,63352757043,85198,63352842241,5,0,0,76800,5,715617470
806,63352785300,129921,63352915221,5,0,1,3072,5,3828104131
807,63352793219,26475,63352819694,0,0,1,3584,0,7880433712
808,63352892914,25178,63352918092,4,0,0,48128,4,4747690346
809,63352895837,28026,63352923863,0,0,0,2560,0,5361122279
810,63352896855,190797,63353087652,4,0,0,6144,4,6402735859
811,63352930786,153279,63353084065,2,0,0,248320,2,698845171
812,63352964785,119434,63353084219,9,0,0,8704,9,157222288
813,63352982239,115104,63353097343,2,0,1,10752,2,9848160128
814,63353031994,106723,63353138717,2,0,0,187392,2,5121999137
815,63353051205,56525,63353107730,8,0,0,35328,8,9815275211
816,63353055909,200981,63353256890,4,0,1,32256,4,9778048820
817,63353118185,84594,63353202779,7,0,0,55808,7,4459122630
818,63353189428,300272,63353489700,3,0,1,16896,3,633958425
819,63353254054,203344,63353457398,3,0,1,6144,3,4523338503
820,63353315639,9518,63353325157,1,0,1,14848,1,10190786579
821,63353340762,150962,63353491724,8,0,1,41984,8,1376861087
822,63353383000,141616,63353524616,5,0,1,13824,5,2989224642
823,63353388696,219189,63353607885,2,0,0,13824,2,5577846391
824,63353440431,54008,63353494439,9,0,1,15872,9,480554454
825,63353494252,13766,63353508018,9,0,0,91648,9,9678037212
826,63353518281,280028,63353798309,4,0,1,78848,4,4921084809
827,63353641189,231936,63353873125,2,0,0,26624,2,7765225272
828,63353685889,130826,63353816715,6,0,1,69120,6,2937748513
829,63353796870,20399,63353817269,1,0,0,512,1,1299225697
830,63353854269,4846,63353859115,8,0,0,5120,8,3674199423
831,63353889175,55744,63353944919,8,0,1,4096,8,6309228002
832,63353982046,1514,63353983560,0,0,0,1536,0,2809827090
833,63354003173,43108,63354046281,4,0,0,73728,4,7892353499
834,63354019720,1990,63354021710,9,0,1,30720,9,1764670411
835,63354066138,6225,63354072363,4,0,0,2048,4,9596651883
836,63354075449,156158,63354231607,9,0,1,2560,9,576796140
837,63354120262,83486,63354203748,6,0,1,5120,6,8146667748
838,63354158037,135199,63354293236,4,0,0,15360,4,6210411962
839,63354212462,3894,63354216356,5,0,0,4096,5,773187120
840,63354265914,12045,63354277959,2,0,0,19968,2,6458511315
841,63354282829,128058,63354410887,7,0,0,248832,7,5806747808
842,63354288843,153537,63354442380,5,0,1,1024,5,3852359924
843,63354332034,141646,63354473680,9,0,0,129536,9,8381674028
844,63354415520,120392,63354535912,3,0,1,14848,3,2101322301
845,63354531824,84729,63354616553,9,0,1,14336,9,9459671149
846,63354552497,248747,63354801244,5,0,0,138240,5,5416978650
847,63354591750,211531,63354803281,3,0,1,2048,3,5984800387
848,63354617308,218773,63354836081,2,0,1,512,2,3928018056
849,63355078767,54099,63355132866,2,0,0,88576,2,2131021419
850,63355113157,14541,63355127698,5,0,1,6656,5,1589868628
851,63355132839,3705,63355136544,6,0,1,8704,6,7116686722
852,63355155351,87891,63355243242,4,0,0,28160,4,3393845478
853,63355163716,93409,63355257125,1,0,1,1024,1,10450914303
854,63355166533,85129,63355251662,0,0,0,512,0,1789427341
855,63355279992,2942,63355282934,4,0,0,3072,4,3968418560
856,63355306747,61895,63355368642,3,0,0,100352,3,4644421521
857,63355422385,32554,63355454939,9,0,0,53248,9,5961572939
858,63355463573,117600,63355581173,9,0,0,195584,9,6155714638
859,63355512561,80466,63355593027,9,0,0,40448,9,6748230099
860,63355665554,1038,63355666592,1,0,0,1024,1,3556745539
861,63355666600,21654,63355688254,0,0,1,10752,0,1086451340
862,63355671932,66500,63355738432,2,0,1,512,2,3934034139
863,63355696361,166250,63355862611,5,0,0,35328,5,75494752
864,63355807249,58840,63355866089,1,0,1,9216,1,7805034548
865,63355842052,50668,63355892720,0,0,1,5632,0,10455111201
866,63355848999,61687,63355910686,0,0,1,2560,0,136760940
867,63355861319,42431,63355903750,2,0,0,67072,2,4809811365
868,63355867229,68635,63355935864,0,0,1,3584,0,9837190085
869,63355943710,13766,63355957476,7,0,0,26624,7,9065692712
870,63355944071,94919,63356038990,4,0,1,21504,4,9551708298
871,63355989751,91635,63356081386,2,0,1,7168,2,7528961400
872,63356026053,64360,63356090413,2,0,1,16896,2,7645214486
873,63356096178,185964,63356282142,5,0,1,7168,5,4349102289
874,63356230468,118504,63356348972,4,0,1,89088,4,2522016376
875,63356266636,116266,63356382902,8,0,1,12800,8,6697298844
876,63356402137,12733,63356414870,5,0,0,24576,5,9385887973
877,63356439644,87484,63356527128,5,0,0,146944,5,1164075852
878,63356592886,31262,63356624148,4,0,1,104448,4,5814141221
879,63356604577,55041,63356659618,9,0,0,50688,9,10531452004
880,63356641509,164235,63356805744,9,0,0,93696,9,9312535790
881,63356680783,1514,63356682297,1,0,1,8704,1,4292976241
882,63356759103,172646,63356931749,0,0,0,1536,0,10170518128
883,63356807360,11270,63356818630,8,0,1,12288,8,4779315109
884,63356919871,144379,63357064250,9,0,1,13312,9,10425469998
885,63356935265,66232,63357001497,5,0,0,18432,5,1673381073
886,63356943693,114680,63357058373,2,0,1,22528,2,10469422103
887,63357035429,96317,63357131746,8,0,0,160768,8,310227127
888,63357039744,18395,63357058139,1,0,1,10240,1,958436729
889,63357114657,21395,63357136052,0,0,0,2048,0,191103582
890,63357162486,1038,63357163524,8,0,0,34816,8,7586841487
891,63357175135,140593,63357315728,4,0,1,133120,4,796658481
892,63357222277,279115,63357501392,1,0,0,1024,1,8216511796
893,63357274996,75033,63357350029,4,0,0,125952,4,4283813182
894,63357395155,16609,63357411764,5,0,0,32256,5,5592998702
895,63357433136,47284,63357480420,8,0,1,11264,8,8274508069
896,63357478434,136004,63357614438,6,0,1,1536,6,1395567273
897,63357583171,21654,63357604825,5,0,0,35328,5,7235591722
898,63357618805,2942,63357621747,4,0,1,97280,4,2626725094
899,63357670504,145651,63357816155,1,0,1,15872,1,1285879205
900,63357694966,128125,63357823091,0,0,0,3072,0,8386910183
901,63357779037,54354,63357833391,9,0,0,89088,9,5974663902
902,63357854840,26217,63357881057,8,0,1,49664,8,9761224211
903,63357890165,23979,63357914144,0,0,0,47616,0,2308943130
904,63358008461,229200,63358237661,3,0,0,39936,3,6666095330
905,63358037807,107734,63358145541,8,0,0,179712,8,8906048274
906,63358072572,76195,63358148767,4,0,0,5120,4,8275919348
907,63358088796,71415,63358160211,8,0,0,46592,8,8201033460
908,63358220594,562,63358221156,8,0,1,2560,8,3681221497
909,63358369114,171583,63358540697,2,0,0,512,2,712791871
910,63358502449,78832,63358581281,9,0,1,14336,9,6998128342
911,63358666069,562,63358666631,1,0,0,512,1,422400143
912,63358676591,31520,63358708111,3,0,0,51200,3,2898931116
913,63358681183,45332,63358726515,3,0,0,59904,3,6384922988
914,63358738619,53062,63358791681,6,0,1,14848,6,10735437385
915,63358745092,167133,63358912225,8,0,0,86528,8,9257179679
916,63358906840,113812,63359020652,5,0,0,184832,5,1131106347
917,63358947325,79945,63359027270,2,0,0,23552,2,3087148681
918,63359038762,23462,63359062224,3,0,1,17408,3,7700730964
919,63359050191,48976,63359099167,3,0,1,12288,3,7720013372
920,63359118533,227060,63359345593,9,0,0,38912,9,3873134916
921,63359199212,219386,63359418598,1,0,1,2048,1,8552197836
922,63359429165,1990,63359431155,1,0,0,2048,1,6027976758
923,63359444755,43366,63359488121,8,0,0,74240,8,1710780333
924,63359490704,15833,63359506537,0,0,0,30720,0,7555193335
925,63359576611,84212,63359660823,2,0,0,137216,2,9576979709
926,63359624420,4416,63359628836,3,0,1,18432,3,353032561
927,63359699691,73054,63359772745,2,0,0,11776,2,6339374541
928,63359704712,16030,63359720742,1,0,1,25088,1,5466660764
929,63359757210,223600,63359980810,7,0,0,118784,7,10538055259
930,63359815617,168718,63359984335,0,0,0,14848,0,4776381189
931,63359916068,2942,63359919010,1,0,0,3072,1,2610975569
932,63359916489,3187,63359919676,1,0,0,1024,1,10411061464
933,63360039236,53140,63360092376,2,0,1,5632,2,3219182073
934,63360070150,32983,63360103133,9,0,0,57344,9,3206518387
935,63360109263,125141,63360234404,4,0,1,97280,4,10481512960
936,63360110275,1514,63360111789,2,0,0,206848,2,8035104020
937,63360240616,270726,63360511342,0,0,1,17408,0,3359128826
938,63360242323,144688,63360387011,0,0,1,16384,0,6400798486
939,63360266257,147984,63360414241,1,0,0,1536,1,4764469535
940,63360438182,106960,63360545142,9,0,1,51200,9,7921450903
941,63360462035,142147,63360604182,5,0,1,15872,5,4032464300
942,63360528193,111745,63360639938,0,0,0,180736,0,9754927199
943,63360567488,94262,63360661750,5,0,0,79872,5,1496584341
944,63360575921,84245,63360660166,5,0,1,12800,5,9283256717
945,63360578171,226009,63360804180,1,0,0,1024,1,6233274069
946,63360622368,228773,63360851141,6,0,1,9728,6,4876926848
947,63360656783,280672,63360937455,9,0,1,48128,9,2278516803
948,63360874250,61966,63360936216,6,0,1,2560,6,8655116904
949,63361000626,66458,63361067084,9,0,0,112640,9,9226591720
950,63361060831,52360,63361113191,1,0,1,17408,1,5795845189
951,63361121096,55041,63361176137,1,0,1,3072,1,10034457712
952,63361148349,40811,63361189160,2,0,0,93696,2,2010664799
953,63361163885,11529,63361175414,1,0,0,2048,1,8129228210
954,63361222553,209548,63361432101,0,0,0,18944,0,1300892679
955,63361326487,13854,63361340341,3,0,0,23552,3,3069789271
956,63361503457,41387,63361544844,9,0,0,67072,9,6937963398
957,63361507518,41344,63361548862,2,0,1,1536,2,8772295897
958,63361519053,193182,63361712235,2,0,0,57856,2,1695006631
959,63361536400,97889,63361634289,4,0,1,79360,4,8262679039
960,63361538777,222562,63361761339,1,0,1,11264,1,2557323806
961,63361590062,217521,63361807583,1,0,1,4608,1,1056921253
962,63361631704,83485,63361715189,3,0,0,121856,3,8239103875
963,63361708216,76914,63361785130,4,0,0,99840,4,5034181019
964,63361721098,24925,63361746023,4,0,0,30208,4,2925768051
965,63361793404,240161,63362033565,3,0,0,45056,3,8545729793
966,63361875575,5798,63361881373,0,0,0,6144,0,7003580266
967,63361916134,183989,63362100123,0,0,1,14336,0,9471001931
968,63362073165,36342,63362109507,4,0,0,64000,4,8905208651
969,63362100623,10753,63362111376,8,0,1,3584,8,1066056756
970,63362141493,74111,63362215604,7,0,0,17408,7,6234644595
971,63362201344,24925,63362226269,8,0,0,45056,8,10694518429
972,63362234912,23462,63362258374,9,0,0,38912,9,10159177996
973,63362325746,14025,63362339771,2,0,1,4608,2,707275116
974,63362326539,80723,63362407262,9,0,0,27136,9,6861375674
975,63362391713,24666,63362416379,0,0,0,44544,0,6310659710
976,63362409921,76583,63362486504,5,0,0,129024,5,4427326504
977,63362485407,21912,63362507319,1,0,1,7168,1,7590909298
978,63362503036,61288,63362564324,4,0,0,35840,4,9427204650
979,63362554684,94420,63362649104,3,0,1,8192,3,10052410645
980,63362556015,4169,63362560184,1,0,1,15360,1,10664131520
981,63362648345,47284,63362695629,1,0,0,3584,1,8048233449
982,63362690485,7702,63362698187,0,0,1,1536,0,113270921
983,63362744069,227168,63362971237,0,0,0,8192,0,7483588441
984,63362813938,47284,63362861222,5,0,1,1536,5,6346791031
985,63362885657,15575,63362901232,0,0,0,30208,0,9766683400
986,63362930838,31262,63362962100,2,0,0,50688,2,5823155956
987,63362968532,5450,63362973982,4,0,1,104448,4,8204066140
988,63363022648,170393,63363193041,3,0,1,4096,3,8137073263
989,63363080590,60565,63363141155,5,0,0,13824,5,3108919253
990,63363081525,131730,63363213255,0,0,1,4096,0,2046200164
991,63363357448,53491,63363410939,8,0,0,90624,8,4316003691
992,63363361998,69832,63363431830,0,0,0,75264,0,4333067939
993,63363371581,76416,63363447997,9,0,0,52736,9,5212688860
994,63363437673,127707,63363565380,9,0,1,6144,9,4713960642
995,63363512748,12821,63363525569,0,0,1,14848,0,9886787846
996,63363562416,180745,63363743161,0,0,0,21504,0,38667577
997,63363571217,54052,63363625269,0,0,1,13824,0,317569367
998,63363647408,66099,63363713507,0,0,1,7168,0,2301458118
999,63363657260,176796,63363834056,0,0,1,3584,0,7757088614
1000,63363981872,13079,63363994951,0,0,0,22016,0,273405945
1001,63364164336,3418,63364167754,1,0,0,3584,1,4076608506
1002,63364221621,48976,63364270597,2,0,1,2048,2,9884573852
1003,63364282312,145391,63364427703,8,0,0,239616,8,2301531015
1004,63364323690,75372,63364399062,8,0,1,8704,8,5805372563
1005,63364338422,110274,63364448696,0,0,0,67584,0,3047636261
1006,63364354635,139216,63364493851,2,0,1,1024,2,5209817919
1007,63364361311,142637,63364503948,0,0,1,5120,0,8638092200
1008,63364382038,126086,63364508124,3,0,1,11776,3,9408348864
1009,63364398643,230619,63364629262,5,0,0,230912,5,3416998140
1010,63364420788,122942,63364543730,0,0,0,18432,0,7627730001
1011,63364431378,203927,63364635305,7,0,0,32256,7,5822534472
1012,63364603938,86967,63364690905,2,0,0,145920,2,3268909539
1013,63364611319,90928,63364702247,8,0,0,46080,8,4779500986
1014,63364661121,77211,63364738332,0,0,0,123392,0,8660792864
1015,63364680440,64305,63364744745,0,0,0,22528,0,2466766548
1016,63364771280,72279,63364843559,4,0,0,117248,4,573586997
1017,63364776245,25555,63364801800,1,0,1,17408,1,1552197835
1018,63364819950,231676,63365051626,1,0,0,3072,1,986711212
1019,63364973947,56075,63365030022,5,0,0,95744,5,7580084449
1020,63365000699,35567,63365036266,9,0,1,11264,9,6270141660
1021,63365135214,260654,63365395868,2,0,0,62464,2,10528936379
1022,63365224086,76874,63365300960,8,0,1,6656,8,8907216457
1023,63365298678,5322,63365304000,1,0,1,6144,1,9175122997
1024,63365334711,54832,63365389543,1,0,0,5632,1,113266109
1025,63365404955,87604,63365492559,5,0,1,17920,5,7497743043
1026,63365450213,52360,63365502573,8,0,1,31232,8,307847323
1027,63365460803,23633,63365484436,1,0,1,3072,1,10562529865
1028,63365516860,103576,63365620436,3,0,0,42496,3,4105505886
1029,63365673430,90743,63365764173,2,0,1,18944,2,9915797092
1030,63365701720,81436,63365783156,4,0,1,12800,4,4453659911
1031,63365716526,76048,63365792574,0,0,1,10240,0,5364292256
1032,63365834654,22170,63365856824,3,0,0,36352,3,7573295880
1033,63365884175,203894,63366088069,2,0,1,8704,2,3255525484
1034,63366045054,59128,63366104182,5,0,1,5120,5,1682210995
1035,63366096874,60862,63366157736,5,0,0,98304,5,7390637754
1036,63366107749,131913,63366239662,0,0,0,182784,0,6147476907
1037,63366186929,56599,63366243528,5,0,0,6144,5,9156935925
1038,63366208489,50592,63366259081,0,0,0,49664,0,1333773553
1039,63366276007,4370,63366280377,1,0,0,4608,1,7215462641
1040,63366307528,115094,63366422622,8,0,1,11264,8,6291074318
1041,63366456266,68680,63366524946,2,0,1,11264,2,5721495919
1042,63366491044,36342,63366527386,3,0,0,64000,3,4116586045
1043,63366556604,562,63366557166,1,0,0,512,1,2134192639
1044,63366565917,1990,63366567907,1,0,0,2048,1,3815627014
1045,63366637885,3894,63366641779,1,0,0,4096,1,7978452726
1046,63366724751,70372,63366795123,2,0,1,11776,2,7298512534
1047,63366733301,269083,63367002384,5,0,0,645632,5,1452060456
1048,63366859705,398346,63367258051,7,0,1,6144,7,10300994935
1049,63367051905,113849,63367165754,0,0,1,12800,0,8194551364
1050,63367064178,40612,63367104790,3,0,1,2048,3,6938022600
1051,63367137750,10787,63367148537,4,0,0,65536,4,6087803407
1052,63367172760,209631,63367382391,8,0,0,16384,8,7799048860
1053,63367254189,65942,63367320131,8,0,0,111616,8,10180526891
1054,63367269104,95355,63367364459,3,0,1,11264,3,4173218276
1055,63367295102,189454,63367484556,4,0,1,10752,4,9175875122
1056,63367389951,166921,63367556872,8,0,1,4608,8,1642912396
1057,63367588003,72795,63367660798,2,0,0,118272,2,493118571
1058,63367714921,145931,63367860852,7,0,1,16896,7,8785451253
1059,63368105031,66200,63368171231,8,0,0,112128,8,9114130674
1060,63368154864,102976,63368257840,4,0,1,7680,4,210775084
1061,63368290911,45592,63368336503,3,0,1,20992,3,8837094378
1062,63368322493,83932,63368406425,3,0,1,1024,3,2122253474
1063,63368355769,32554,63368388323,0,0,0,53248,0,6454795253
1064,63368380981,66717,63368447698,7,0,0,113152,7,8276552875
1065,63368410411,49141,63368459552,3,0,0,48640,3,1620465385
1066,63368540381,108572,63368648953,5,0,1,10240,5,4036745527
1067,63368615857,60910,63368676767,0,0,1,15872,0,5423124045
1068,63368682631,172018,63368854649,3,0,1,2560,3,659307765
1069,63368696962,136041,63368833003,3,0,0,224768,3,5341456516
1070,63368775105,96999,63368872104,8,0,1,1536,8,3109678685
1071,63369028499,33587,63369062086,4,0,0,55296,4,9117229106
1072,63369055829,23979,63369079808,4,0,1,107008,4,10219298162
1073,63369057614,23116,63369080730,3,0,0,39936,3,6751986803
1074,63369077184,34791,63369111975,8,0,0,41472,8,2724136550
1075,63369092831,49926,63369142757,7,0,1,11264,7,3131950947
1076,63369167756,115868,63369283624,5,0,0,60928,5,9849323113
1077,63369214325,306979,63369521304,0,0,1,15360,0,2745370815
1078,63369254893,76067,63369330960,8,0,1,1536,8,7353915203
1079,63369291821,303858,63369595679,2,0,0,128000,2,7438548870
1080,63369373506,25442,63369398948,1,0,1,11776,1,5246842051
1081,63369472925,97312,63369570237,4,0,1,24576,4,961846863
1082,63369481611,259319,63369740930,3,0,0,46080,3,8469511301
1083,63369630409,23462,63369653871,9,0,1,6656,9,6974703939
1084,63369639778,66612,63369706390,8,0,0,38912,8,2548160439
1085,63369704219,83608,63369787827,4,0,0,139264,4,6248401124
1086,63369730121,33431,63369763552,3,0,1,5120,3,5695806305
1087,63369761117,173550,63369934667,4,0,0,32256,4,1695396938
1088,63369861567,144176,63370005743,5,0,1,40448,5,1706773994
1089,63370028685,32554,63370061239,9,0,0,53248,9,8424363860
1090,63370073490,4416,63370077906,5,0,1,12288,5,6004051155
1091,63370095992,67456,63370163448,0,0,0,11776,0,952617676
1092,63370124984,20362,63370145346,8,0,1,15360,8,4842602275
1093,63370165022,102062,63370267084,7,0,0,32768,7,2467292896
1094,63370262896,6225,63370269121,2,0,0,15360,2,2508756254
1095,63370296479,3894,63370300373,8,0,0,4096,8,2104779154
1096,63370445277,43366,63370488643,4,0,0,74240,4,9883631003
1097,63370505777,24150,63370529927,7,0,0,43520,7,690203375
1098,63370516966,13307,63370530273,1,0,0,512,1,2414046521
1099,63370570154,48976,63370619130,1,0,1,2048,1,4217356016
1100,63370575482,161361,63370736843,4,0,1,79872,4,3777804538
1101,63370723749,79294,63370803043,2,0,1,8192,2,5991708891
1102,63370755082,48440,63370803522,1,0,1,1536,1,5992847194
1103,63370821917,3641,63370825558,4,0,1,255488,4,8044356213
1104,63370907435,218356,63371125791,1,0,1,6144,1,1422893150
1105,63370947478,82976,63371030454,9,0,0,10240,9,3257379495
1106,63370957308,134756,63371092064,4,0,0,25088,4,4821946807
1107,63370996803,110513,63371107316,7,0,0,110080,7,903089148
1108,63371004303,119180,63371123483,7,0,0,60928,7,10506221288
1109,63371019475,83437,63371102912,0,0,1,4608,0,10543582639
1110,63371138060,284044,63371422104,5,0,0,135680,5,3887367219
1111,63371182957,53837,63371236794,1,0,1,1536,1,547518180
1112,63371259696,145688,63371405384,8,0,0,88064,8,596137680
1113,63371275023,91454,63371366477,9,0,1,12800,9,5855293480
1114,63371361210,5967,63371367177,3,0,1,6656,3,8650166573
1115,63371366586,77286,63371443872,9,0,1,12800,9,2793086197
1116,63371380748,93186,63371473934,5,0,0,14848,5,2578985417
1117,63371442071,14784,63371456855,7,0,0,25088,7,6890282043
1118,63371489709,55744,63371545453,1,0,1,4096,1,8995379716
1119,63371599683,4675,63371604358,2,0,0,12288,2,1001077197
1120,63371621096,76048,63371697144,1,0,1,10240,1,1491273385
1121,63371656888,132238,63371789126,5,0,0,244224,5,6424427672
1122,63371660883,147717,63371808600,1,0,1,8704,1,5308514680
1123,63371693585,46493,63371740078,4,0,1,12288,4,1459210309
1124,63371726603,120621,63371847224,5,0,1,2560,5,6127766120
1125,63371758458,134469,63371892927,1,0,0,512,1,10635316170
1126,63371862690,2466,63371865156,7,0,1,1536,7,9501457561
1127,63371931798,82059,63372013857,1,0,0,2560,1,3649578227
1128,63371945598,4158,63371949756,5,0,0,11264,5,1005884266
1129,63371952884,11270,63371964154,2,0,0,18432,2,9318299928
1130,63372033559,22858,63372056417,8,0,0,40960,8,5316030867
1131,63372187636,3900,63372191536,9,0,0,10752,9,1566754573
1132,63372270527,34791,63372305318,0,0,0,60928,0,5276607070
1133,63372475362,4933,63372480295,5,0,0,12800,5,6068989506
1134,63372476119,8514,63372484633,8,0,0,5632,8,1676117480
1135,63372483021,34363,63372517384,5,0,0,56832,5,6915917111
1136,63372519528,61895,63372581423,4,0,0,100352,4,3037181101
1137,63372538157,148030,63372686187,3,0,1,1536,3,2339902023
1138,63372558998,136273,63372695271,7,0,1,6144,7,7653097689
1139,63372739307,68524,63372807831,1,0,1,10752,1,3206249145
1140,63372774106,54052,63372828158,9,0,1,3584,9,6400524978
1141,63372811410,48976,63372860386,7,0,1,2048,7,7424654839
1142,63372822590,81748,63372904338,0,0,1,13824,0,6960257478
1143,63372893060,60820,63372953880,1,0,1,5632,1,3064636711
1144,63372948624,44658,63372993282,9,0,0,76800,9,10390290172
1145,63373064918,33241,63373098159,4,0,1,155136,4,248235096
1146,63373108505,27013,63373135518,7,0,1,4608,7,3380541531
1147,63373127107,56505,63373183612,0,0,0,57856,0,9100027358
1148,63373143755,187780,63373331535,7,0,0,33280,7,10503822291
1149,63373148697,145608,63373294305,4,0,1,2048,4,2010890040
1150,63373294857,55744,63373350601,1,0,1,4096,1,70033400
1151,63373372409,57904,63373430313,0,0,1,6144,0,6264030356
1152,63373389356,73483,63373462839,4,0,0,122880,4,5377872540
1153,63373422239,101362,63373523601,2,0,1,1536,2,5619876776
1154,63373506830,106140,63373612970,9,0,1,15872,9,6211266406
1155,63373546057,115104,63373661161,2,0,0,187392,2,9582420033
1156,63373609624,72223,63373681847,8,0,0,74240,8,1398007473
1157,63373632006,49368,63373681374,4,0,1,227840,4,1864340931
1158,63373632825,27707,63373660532,1,0,0,512,1,734217270
1159,63373665213,6838,63373672051,3,0,0,43008,3,3547734417
1160,63373687388,4158,63373691546,1,0,0,2048,1,8743862780
1161,63373691877,4933,63373696810,4,0,0,11264,4,8975710468
1162,63373726915,16092,63373743007,8,0,1,12800,8,4033565803
1163,63373799591,14025,63373813616,2,0,0,12800,2,9071434874
1164,63373867819,199065,63374066884,4,0,0,31232,4,2287482247
1165,63373901213,405522,63374306735,0,0,0,27136,0,1461807224
1166,63373999023,46290,63374045313,2,0,1,16896,2,4718856658
1167,63374034709,118109,63374152818,8,0,0,71168,8,2686297225
1168,63374100646,82404,63374183050,4,0,0,133632,4,94576334
1169,63374123944,75785,63374199729,3,0,0,63488,3,3475448278
1170,63374146940,248422,63374395362,5,0,1,9216,5,2613718104
1171,63374342298,102912,63374445210,4,0,0,166912,4,2247178026
1172,63374354634,92164,63374446798,4,0,0,15872,4,795180105
1173,63374420647,61120,63374481767,8,0,0,98816,8,7084387658
1174,63374421894,69508,63374491402,2,0,0,219136,2,405836161
1175,63374493721,163755,63374657476,5,0,1,1024,5,5028619111
1176,63374516928,83958,63374600886,4,0,1,2048,4,7249696830
1177,63374642755,45433,63374688188,8,0,0,78336,8,4986559339
1178,63374655755,38744,63374694499,4,0,0,22016,4,8996354023
1179,63374902731,2866,63374905597,5,0,1,2048,5,861641586
1180,63374907695,48976,63374956671,4,0,0,8704,4,5282369348
1181,63374933066,56524,63374989590,0,0,1,6656,0,8130318999
1182,63375017291,134837,63375152128,7,0,0,219136,7,8862035985
1183,63375069778,99337,63375169115,8,0,0,56832,8,7593073945
1184,63375108976,218017,63375326993,8,0,1,512,8,1799468458
1185,63375201637,43366,63375245003,5,0,1,512,5,10410760058
1186,63375289443,174869,63375464312,0,0,0,74240,0,4045444487
1187,63375358229,248450,63375606679,5,0,0,407040,5,5043764771
1188,63375392077,267520,63375659597,9,0,0,179712,9,10593517889
1189,63375441116,136053,63375577169,2,0,1,13312,2,2341294263
1190,63375524530,147548,63375672078,5,0,0,1536,5,8447663741
1191,63375539966,127734,63375667700,2,0,1,4096,2,5667025479
1192,63375574169,105316,63375679485,8,0,0,132096,8,2572933064
1193,63375607929,293769,63375901698,8,0,0,37888,8,4387343414
1194,63375679485,144616,63375824101,3,0,1,45568,3,376519168
1195,63375679636,221086,63375900722,0,0,0,238080,0,8214684117
1196,63375738258,34361,63375772619,2,0,1,23040,2,3999209794
1197,63375900477,20308,63375920785,3,0,0,59904,3,9506613562
1198,63375915836,403768,63376319604,5,0,0,2048,5,3567631599
1199,63376057994,104116,63376162110,3,0,0,172544,3,6760987877
1200,63376218114,43900,63376262014,3,0,1,25088,3,2200081495
1201,63376227826,54354,63376282180,9,0,1,512,9,6945970855
1202,63376243937,34301,63376278238,3,0,1,16384,3,8731203652
1203,63376260204,63600,63376323804,4,0,0,89088,4,6268574155
1204,63376282933,158222,63376441155,9,0,1,5120,9,10178823837
1205,63376292111,109582,63376401693,0,0,0,48640,0,9415057693
1206,63376294887,183964,63376478851,3,0,1,45056,3,6350763137
1207,63376313097,46097,63376359194,8,0,1,22016,8,2416441750
1208,63376387684,47454,63376435138,0,0,1,10752,0,1705875542
1209,63376432765,311615,63376744380,0,0,0,63488,0,8674475453
1210,63376440787,47284,63376488071,4,0,0,63488,4,1885386837
1211,63376486076,174883,63376660959,8,0,1,33280,8,5375370623
1212,63376495422,234292,63376729714,7,0,1,1536,7,7572504491
1213,63376611578,119877,63376731455,7,0,1,36352,7,10152446960
1214,63376722563,24459,63376747022,2,0,0,30208,2,4960789100
1215,63376733067,22691,63376755758,0,0,0,29184,0,4813776519
1216,63376756371,84247,63376840618,0,0,1,2048,0,5194554069
1217,63376775205,55744,63376830949,8,0,1,8192,8,1179509135
1218,63376845239,145638,63376990877,9,0,1,4096,9,7433380100
1219,63376911350,45592,63376956942,3,0,1,1024,3,4446776132
1220,63377025682,14025,63377039707,9,0,0,27136,9,5990778131
1221,63377079000,16609,63377095609,4,0,1,39936,4,957387642
1222,63377087874,103528,63377191402,7,0,0,32256,7,6598126893
1223,63377155305,5967,63377161272,2,0,1,5120,2,7484101034
1224,63377177183,59128,63377236311,4,0,1,2048,4,7606980862
1225,63377192784,2466,63377195250,4,0,0,14848,4,7621269876
1226,63377221676,54313,63377275989,1,0,0,2560,1,7017108445
1227,63377329061,22946,63377352007,9,0,0,37888,9,9612871569
1228,63377380078,4416,63377384494,2,0,0,11776,2,5526146895
1229,63377515539,3900,63377519439,4,0,0,10752,4,6375705020
1230,63377556744,212737,63377769481,5,0,0,344064,5,4786807411
1231,63377605835,38931,63377644766,3,0,1,27136,3,8881173296
1232,63377637520,158838,63377796358,2,0,1,9216,2,174364931
1233,63377680163,255980,63377936143,9,0,1,8704,9,5112276789
1234,63377737271,208634,63377945905,4,0,0,24064,4,1394945351
1235,63377874240,126357,63378000597,4,0,1,11264,4,6091579390
1236,63377995904,58528,63378054432,2,0,1,8192,2,9837552691
1237,63378018119,102904,63378121023,4,0,1,37888,4,1468500458
1238,63378030195,92087,63378122282,9,0,1,4096,9,9223308758
1239,63378104254,107272,63378211526,4,0,1,52224,4,5718801616
1240,63378136158,156062,63378292220,4,0,1,89088,4,1404925139
1241,63378227160,71746,63378298906,4,0,1,10240,4,6278961242
1242,63378267626,83714,63378351340,2,0,1,5120,2,6744866336
1243,63378531350,69280,63378600630,3,0,1,8192,3,4222833452
1244,63378613031,51512,63378664543,9,0,0,83456,9,3444478962
1245,63378835950,113668,63378949618,4,0,1,73216,4,9517706412
1246,63379066827,3383,63379070210,0,0,1,12288,0,3302490608
1247,63379069430,68992,63379138422,9,0,0,9728,9,4599952325
1248,63379103112,104152,63379207264,8,0,1,41984,8,3453709029
1249,63379122096,132793,63379254889,4,0,1,44032,4,689778348
1250,63379240648,48976,63379289624,2,0,1,2048,2,10718285684
1251,63379255630,97156,63379352786,8,0,1,24064,8,9159449981
1252,63379365237,1990,63379367227,0,0,1,29184,0,370258499
1253,63379404881,95644,63379500525,8,0,0,2048,8,8228802918
1254,63379443464,65465,63379508929,9,0,1,8192,9,6337126069
1255,63379492949,186925,63379679874,4,0,0,307200,4,7549247846
1256,63379494606,187214,63379681820,8,0,0,3072,8,8426008440
1257,63379553987,93257,63379647244,4,0,1,108032,4,345644257
1258,63379625160,45726,63379670886,5,0,0,117760,5,1576545776
1259,63379688961,305385,63379994346,7,0,0,53248,7,6375203455
1260,63379825570,152762,63379978332,7,0,0,247296,7,2734973210
1261,63379838323,141635,63379979958,1,0,0,2560,1,1070218897
1262,63379920326,80216,63380000542,0,0,0,65536,0,4276950085
1263,63379967366,562,63379967928,0,0,1,5632,0,224285986
1264,63380019048,193406,63380212454,0,0,1,512,0,3999170420
1265,63380117782,154241,63380272023,9,0,0,512,9,10008165169
1266,63380129389,64137,63380193526,2,0,1,6144,2,6006925877
1267,63380226838,10237,63380237075,9,0,0,16384,9,6011942556
1268,63380292122,5450,63380297572,9,0,0,13824,9,4605383382
1269,63380329691,195329,63380525020,0,0,0,316928,0,10374093183
1270,63380334964,177233,63380512197,7,0,1,25088,7,3423679932
1271,63380363852,156896,63380520748,7,0,0,60416,7,2465649404
1272,63380389988,9492,63380399480,3,0,0,19456,3,5720304523
1273,63380509064,10169,63380519233,5,0,1,11264,5,7033158622
1274,63380537738,63358,63380601096,1,0,0,512,1,3857415871
1275,63380538367,295272,63380833639,1,0,0,2048,1,1961750735
1276,63380545393,162919,63380708312,3,0,0,106496,3,2857688375
1277,63380595485,260872,63380856357,0,0,1,8704,0,7468911798
1278,63380636089,219687,63380855776,5,0,1,5120,5,6971489617
1279,63380805451,13079,63380818530,9,0,1,3072,9,9259324494
1280,63380849984,58917,63380908901,5,0,0,22016,5,4422431497
1281,63380948482,1038,63380949520,1,0,0,1024,1,10042780417
1282,63381094724,158368,63381253092,4,0,1,139264,4,2311036110
1283,63381126900,127607,63381254507,0,0,1,4608,0,127177542
1284,63381157183,97335,63381254518,2,0,0,134144,2,10329013322
1285,63381161054,145494,63381306548,9,0,1,4608,9,2895143404
1286,63381281510,25958,63381307468,0,0,0,47104,0,4643816679
1287,63381324833,188474,63381513307,2,0,1,13824,2,2585521128
1288,63381541343,43883,63381585226,2,0,0,75264,2,6920121323
1289,63381608946,103687,63381712633,4,0,0,168448,4,4614036664
1290,63381748862,2866,63381751728,0,0,0,8704,0,1914305957
1291,63381763703,69280,63381832983,9,0,1,8192,9,1135438027
1292,63381807507,34791,63381842298,8,0,0,60928,8,1291722404
1293,63381925677,3894,63381929571,1,0,0,4096,1,4169655996
1294,63381970408,46208,63382016616,5,0,0,79872,5,9903550404
1295,63382081505,45592,63382127097,3,0,1,1024,3,6042203547
1296,63382084741,45592,63382130333,2,0,1,1024,2,2340697475
1297,63382119267,83214,63382202481,2,0,1,7168,2,2044490006
1298,63382236657,14541,63382251198,8,0,1,28672,8,6079870809
1299,63382240704,10200,63382250904,8,0,0,28160,8,6482996490
1300,63382245391,100096,63382345487,1,0,0,512,1,8251153363
1301,63382250324,114758,63382365082,4,0,0,189952,4,9200416441
1302,63382381710,194983,63382576693,8,0,0,319488,8,10354330494
1303,63382496120,49716,63382545836,7,0,1,1024,7,7940673926
1304,63382533295,140247,63382673542,2,0,1,512,2,1588569793
1305,63382538114,11529,63382549643,4,0,0,36864,4,3777799740
1306,63382544247,195824,63382740071,4,0,1,78336,4,4103012734
1307,63382571519,251110,63382822629,3,0,1,25600,3,8929424241
1308,63382663803,299560,63382963363,3,0,0,18944,3,8860468265
1309,63382709673,86018,63382795691,4,0,0,141312,4,9673266588
1310,63382714867,90891,63382805758,0,0,0,38400,0,4791731403
1311,63382851486,86601,63382938087,4,0,1,101376,4,4124518315
1312,63382931149,234274,63383165423,9,0,1,12288,9,9045436594
1313,63382984478,106597,63383091075,7,0,1,17408,7,2530085253
1314,63383046631,59325,63383105956,7,0,1,4096,7,4239663705
1315,63383051142,106336,63383157478,0,0,1,6144,0,10546021400
1316,63383098339,155416,63383253755,4,0,1,49152,4,8367776790
1317,63383159396,59128,63383218524,8,0,1,5120,8,9578170750
1318,63383217587,15833,63383233420,4,0,1,1536,4,5054950071
1319,63383229972,20620,63383250592,7,0,0,30720,7,270745066
1320,63383241033,48213,63383289246,5,0,0,33280,5,3721357230
1321,63383369234,1990,63383371224,3,0,0,2048,3,6044643112
1322,63383410333,74356,63383484689,0,0,1,9728,0,1133715744
1323,63383467313,34104,63383501417,3,0,1,12288,3,3051050736
1324,63383471673,67234,63383538907,4,0,0,56320,4,1024453762
1325,63383494879,44897,63383539776,2,0,0,114176,2,2730462411
1326,63383521402,115457,63383636859,7,0,0,6656,7,6120376535
1327,63383557734,66052,63383623786,0,0,1,7680,0,1908000690
1328,63383651857,92690,63383744547,9,0,1,7168,9,8310942072
1329,63383838040,1514,63383839554,1,0,0,1536,1,911506723
1330,63383890053,61120,63383951173,2,0,0,98816,2,10089314215
1331,63383901790,31561,63383933351,7,0,1,3584,7,10242510111
1332,63383907174,72497,63383979671,4,0,1,214016,4,5151545247
1333,63383920918,319076,63384239994,1,0,0,2048,1,8297914786
1334,63384407167,24666,63384431833,7,0,0,44544,7,4635856771
1335,63384432408,22170,63384454578,7,0,0,36352,7,302587197
1336,63384518616,42420,63384561036,7,0,0,69120,7,8458484752
1337,63384571428,6484,63384577912,0,0,0,15872,0,3892085514
1338,63384571917,12098,63384584015,5,0,0,8192,5,3007244682
1339,63384758347,205883,63384964230,4,0,0,337408,4,6203618692
1340,63384763892,181367,63384945259,7,0,1,11776,7,462293565
1341,63384793385,168919,63384962304,9,0,0,33792,9,468159451
1342,63384806909,178240,63384985149,5,0,0,13312,5,4857972318
1343,63384815093,254325,63385069418,0,0,1,512,0,57534618
1344,63385003252,1514,63385004766,7,0,1,20992,7,2575911566
1345,63385056352,5708,63385062060,9,0,0,1536,9,6011164318
1346,63385071409,165783,63385237192,3,0,0,14336,3,5070526753
1347,63385163689,52622,63385216311,8,0,1,1536,8,9151341376
1348,63385222317,23374,63385245691,2,0,0,41984,2,4163420995
1349,63385257981,6290,63385264271,8,0,1,14848,8,9623550174
1350,63385258006,64221,63385322227,3,0,0,6656,3,2240737908
1351,63385309146,132091,63385441237,7,0,0,104960,7,394319406
1352,63385410521,81112,63385491633,4,0,0,131072,4,8864237273
1353,63385495388,91237,63385586625,4,0,0,147456,4,1429311470
1354,63385632723,31520,63385664243,7,0,0,51200,7,10532949074
1355,63385637875,21654,63385659529,7,0,1,11776,7,3039751110
1356,63385684160,162939,63385847099,4,0,0,35328,4,2803693941
1357,63385760658,52360,63385813018,3,0,1,3072,3,1092669492
1358,63385778157,58565,63385836722,7,0,1,3072,7,4310618029
1359,63386549053,7702,63386556755,0,0,0,8192,0,9171975957
1360,63386550965,125169,63386676134,4,0,1,62464,4,9030182360
1361,63386587803,94426,63386682229,9,0,1,19968,9,2829659055
1362,63386607318,4370,63386611688,4,0,1,300032,4,10713030020
1363,63386672425,111296,63386783721,8,0,1,33280,8,3540523440
1364,63386682946,129411,63386812357,1,0,0,4608,1,9568137412
1365,63386683039,117083,63386800122,3,0,1,4608,3,3153511326
1366,63386691725,76264,63386767989,3,0,1,24576,3,5088355928
1367,63386769699,213208,63386982907,5,0,0,194560,5,4715325243
1368,63386812144,434970,63387247114,2,0,0,2560,2,10071747237
1369,63386981319,63920,63387045239,0,0,0,3072,0,2219810951
1370,63387006374,2466,63387008840,4,0,1,155648,4,5741806314
1371,63387065581,217723,63387283304,4,0,1,14848,4,4229106812
1372,63387102403,99367,63387201770,1,0,0,2560,1,1803817279
1373,63387126309,164630,63387290939,4,0,1,5120,4,829544810
1374,63387129298,103576,63387232874,4,0,1,8704,4,9122227232
1375,63387186649,60467,63387247116,2,0,0,27648,2,6729514536
1376,63387266592,107475,63387374067,2,0,0,179200,2,7640305502
1377,63387288578,97787,63387386365,9,0,1,18432,9,1772909231
1378,63387303328,4370,63387307698,5,0,0,88576,5,5501083040
1379,63387395261,114417,63387509678,0,0,1,18944,0,8494103123
1380,63387495330,230469,63387725799,1,0,0,4608,1,191385602
1381,63387546978,87004,63387633982,5,0,1,20992,5,8969819683
1382,63387593010,59128,63387652138,7,0,1,5120,7,7253171213
1383,63387607921,122904,63387730825,9,0,0,199168,9,5242345058
1384,63387639982,96130,63387736112,8,0,0,25088,8,2044374007
1385,63387670435,67060,63387737495,9,0,0,14848,9,7029645068
1386,63387672808,51770,63387724578,4,0,1,65024,4,9289151516
1387,63387713542,41316,63387754858,8,0,1,57856,8,4196017960
1388,63387845450,235418,63388080868,7,0,0,83968,7,9193458707
1389,63387862625,350870,63388213495,2,0,0,24064,2,8415657133
1390,63387919043,109720,63388028763,5,0,1,8704,5,2013632055
1391,63388039898,23374,63388063272,2,0,1,3584,2,1045629090
1392,63388079587,172276,63388251863,4,0,0,41984,4,2015642425
1393,63388089004,15317,63388104321,5,0,1,27136,5,5909182512
1394,63388113778,150384,63388264162,3,0,1,9728,3,2907690062
1395,63388203699,233389,63388437088,5,0,0,29696,5,4095654449
1396,63388340681,15833,63388356514,8,0,1,1536,8,4388994600
1397,63388342202,33758,63388375960,7,0,0,30720,7,5940835514
1398,63388381684,12943,63388394627,4,0,0,58880,4,4566263110
1399,63388406685,88078,63388494763,4,0,0,6656,4,2264288315
1400,63388411507,108290,63388519797,3,0,1,28160,3,872868194
1401,63388498452,92270,63388590722,8,0,0,149504,8,10377641498
1402,63388504326,86742,63388591068,1,0,0,512,1,7539151562
1403,63388600235,60220,63388660455,7,0,1,8704,7,5983935380
1404,63388600603,86276,63388686879,5,0,1,9728,5,2309870990
1405,63388623455,47158,63388670613,8,0,1,14848,8,3725567246
1406,63388639732,105604,63388745336,2,0,0,77312,2,3842841957
1407,63388718455,75291,63388793746,9,0,0,126464,9,9890976186
1408,63388737630,75808,63388813438,5,0,1,8704,5,2168359282
1409,63388780494,86824,63388867318,8,0,0,127488,8,8002129531
1410,63388790164,228281,63389018445,3,0,0,66048,3,9019381392
1411,63388874883,160913,63389035796,3,0,1,10752,3,2878098339
1412,63388989540,74628,63389064168,3,0,1,5120,3,3448454655
1413,63389065951,93460,63389159411,5,0,1,22016,5,8854475662
1414,63389200784,7226,63389208010,9,0,1,7680,9,1712586770
1415,63389214912,5450,63389220362,2,0,0,7680,2,5375786145
1416,63389238282,57874,63389296156,0,0,1,36352,0,8552132811
1417,63389243761,112154,63389355915,5,0,0,13824,5,7352817401
1418,63389246223,14344,63389260567,7,0,0,95744,7,9120221598
1419,63389325997,5322,63389331319,8,0,1,16384,8,9967019736
1420,63389348129,121468,63389469597,7,0,0,19968,7,3263423678
1421,63389403273,249032,63389652305,9,0,0,5632,9,3048716876
1422,63389526663,113983,63389640646,5,0,0,188416,5,7978102069
1423,63389567740,79115,63389646855,2,0,0,21504,2,7504847669
1424,63389582591,94901,63389677492,5,0,1,512,5,7127245514
1425,63389630812,54613,63389685425,0,0,1,8192,0,10375183055
1426,63389707848,46984,63389754832,2,0,0,89600,2,5530522246
1427,63389769162,276064,63390045226,8,0,0,81408,8,8438426527
1428,63389861773,31779,63389893552,3,0,1,6144,3,6346086829
1429,63389928814,64986,63389993800,4,0,0,51712,4,8207343112
1430,63389938761,93991,63390032752,9,0,1,5120,9,2456085482
1431,63389953390,213645,63390167035,9,0,0,156160,9,4968939178
1432,63389968751,117902,63390086653,5,0,1,8704,5,3471462600
1433,63389983246,135060,63390118306,3,0,1,28672,3,1267530013
1434,63390161334,44056,63390205390,0,0,1,1024,0,1142422143
1435,63390162772,45690,63390208462,3,0,1,1024,3,4163083681
1436,63390209876,53749,63390263625,2,0,0,91136,2,2576103158
1437,63390248269,77359,63390325628,7,0,1,5632,7,1545805481
1438,63390301180,112919,63390414099,3,0,1,45056,3,5035212101
1439,63390316447,197989,63390514436,2,0,0,130560,2,3786537965
1440,63390376809,83437,63390460246,9,0,0,135680,9,8104627050
1441,63390402198,163983,63390566181,4,0,0,244736,4,6258763346
1442,63390481509,126914,63390608423,8,0,0,136704,8,309623863
1443,63390561506,58668,63390620174,8,0,0,48128,8,3237259879
1444,63390582044,73741,63390655785,7,0,1,34816,7,6123243299
1445,63390592012,128023,63390720035,5,0,1,10752,5,23082176
1446,63390630293,246544,63390876837,7,0,0,123392,7,2480366704
1447,63390681680,12304,63390693984,7,0,1,7168,7,772483195
1448,63390846496,268763,63391115259,3,0,1,12800,3,4613727714
1449,63390854639,34104,63390888743,7,0,0,20480,7,2683570160
1450,63390918522,44141,63390962663,2,0,0,56320,2,1180832352
1451,63390975995,20125,63390996120,4,0,0,75776,4,10008710331
1452,63390998462,228846,63391227308,3,0,1,2048,3,5914936035
1453,63391002277,129551,63391131828,1,0,0,3584,1,7582600123
1454,63391279514,218075,63391497589,3,0,0,357888,3,1669226182
1455,63391404094,145389,63391549483,0,0,0,166400,0,3299309786
1456,63391439444,126923,63391566367,3,0,0,64512,3,4464801024
1457,63391524447,23462,63391547909,8,0,1,6144,8,7872917703
1458,63391539162,153685,63391692847,0,0,1,18432,0,9784218866
1459,63391593297,135008,63391728305,3,0,1,15360,3,4313100496
1460,63391623992,124827,63391748819,5,0,0,38912,5,10575054551
1461,63391667071,52217,63391719288,9,0,0,222720,9,6803542413
1462,63391677918,6652,63391684570,1,0,0,1024,1,2649043047
1463,63391734065,237680,63391971745,2,0,1,23040,2,6076214355
1464,63391766388,103943,63391870331,3,0,0,59392,3,8546906642
1465,63391813259,1990,63391815249,1,0,0,2048,1,1943290135
1466,63391844546,357914,63392202460,1,0,0,2048,1,1777957034
1467,63391855944,54525,63391910469,0,0,0,92672,0,10505023309
1468,63391882376,23979,63391906355,9,0,1,32768,9,1205643152
1469,63391938076,95283,63392033359,9,0,0,39936,9,4399492931
1470,63392036489,262102,63392298591,3,0,0,158720,3,3540866768
1471,63392037565,13508,63392051073,8,0,1,10240,8,3569277004
1472,63392132028,61637,63392193665,5,0,1,3584,5,7873951514
1473,63392145426,67310,63392212736,2,0,0,26112,2,302520101
1474,63392161529,157150,63392318679,7,0,0,99840,7,3365797773
1475,63392176952,55817,63392232769,0,0,0,76288,0,1668380543
1476,63392286082,40538,63392326620,4,0,0,95232,4,6594627752
1477,63392312191,66257,63392378448,2,0,0,35328,2,3082158143
1478,63392312701,359481,63392672182,0,0,0,84480,0,2764355173
1479,63392368051,30487,63392398538,4,0,0,49152,4,3048672284
1480,63392389783,14113,63392403896,5,0,1,2560,5,2933395206
1481,63392459625,63616,63392523241,8,0,0,24064,8,2569674355
1482,63392507061,24106,63392531167,8,0,0,107008,8,8728259624
1483,63392526151,194714,63392720865,2,0,1,2560,2,6068091144
1484,63392553189,6484,63392559673,0,0,0,23552,0,9498511559
1485,63392602733,1514,63392604247,7,0,0,15872,7,5164382987
1486,63392613303,3641,63392616944,1,0,0,1536,1,2538886220
1487,63392649742,208468,63392858210,2,0,0,10240,2,3922891264
1488,63392786036,3894,63392789930,5,0,1,16896,5,370506520
1489,63392829233,88640,63392917873,3,0,0,4096,3,699459272
1490,63392904640,45692,63392950332,8,0,0,78848,8,5419377239
1491,63392951331,31003,63392982334,4,0,1,303104,4,7987546479
1492,63392979778,28554,63393008332,5,0,1,11776,5,275633857
1493,63392986116,2942,63392989058,2,0,0,50176,2,1442805514
1494,63392994876,201217,63393196093,5,0,0,22016,5,5569016113
1495,63393105440,330716,63393436156,8,0,1,17408,8,1403820029
1496,63393140684,181922,63393322606,1,0,0,3072,1,881358969
1497,63393275157,15321,63393290478,4,0,0,9216,4,5161713117
1498,63393412438,1990,63393414428,1,0,0,2048,1,5721380639
1499,63393613945,5450,63393619395,7,0,0,13824,7,3108403787
1500,63393617144,57118,63393674262,7,0,1,5120,7,8758946580
1501,63393641518,74516,63393716034,4,0,0,124928,4,8773437510
1502,63393684588,42071,63393726659,9,0,0,34304,9,6986878823
1503,63393693755,38293,63393732048,5,0,0,25600,5,9861100219
1504,63393707895,55817,63393763712,4,0,1,139776,4,7307141822
1505,63393710286,130048,63393840334,9,0,0,95232,9,4025411178
1506,63393711157,274473,63393985630,9,0,1,26624,9,4821847332
1507,63393719060,279395,63393998455,9,0,1,52736,9,3038609129
1508,63393841882,156600,63393998482,5,0,0,230400,5,3672808391
1509,63393860545,137948,63393998493,1,0,0,512,1,3846169466
1510,63393866727,67389,63393934116,7,0,1,6656,7,4871461487
1511,63393953712,38495,63393992207,3,0,0,37376,3,765470740
1512,63393983592,230195,63394213787,1,0,0,1536,1,3126679766
1513,63394139899,41128,63394181027,0,0,1,24576,0,7232810120
1514,63394146049,91168,63394237217,5,0,0,66560,5,4178194875
1515,63394368903,42937,63394411840,2,0,0,70144,2,5002300751
1516,63394420777,31262,63394452039,8,0,0,50688,8,7683713036
1517,63394451813,23721,63394475534,8,0,0,39424,8,1129325384
1518,63394524861,15575,63394540436,9,0,0,30208,9,5412663841
1519,63394540528,41645,63394582173,3,0,0,67584,3,9323499278
1520,63394572571,114868,63394687439,2,0,1,41472,2,7750317710
1521,63394581217,177726,63394758943,7,0,1,3584,7,3832472753
1522,63394773318,85933,63394859251,0,0,0,143872,0,7282611108
1523,63394854953,120860,63394975813,0,0,1,16896,0,4871964119
1524,63394858682,48081,63394906763,8,0,1,1536,8,10618983137
1525,63394928055,137369,63395065424,7,0,1,1024,7,4082590789
1526,63395000190,24666,63395024856,3,0,0,44544,3,5802729513
1527,63395005580,60001,63395065581,9,0,0,83968,9,8203501557
1528,63395098957,25700,63395124657,9,0,0,46592,9,6507812390
1529,63395213992,33587,63395247579,2,0,0,55296,2,9891853609
1530,63395240600,53062,63395293662,7,0,1,21504,7,9383349993
1531,63395253620,58740,63395312360,3,0,0,86528,3,1284586322
1532,63395254458,105417,63395359875,0,0,0,31232,0,2586954419
1533,63395262014,2942,63395264956,4,0,1,161280,4,7639918705
1534,63395331400,160286,63395491686,2,0,1,7168,2,3202236834
1535,63395420815,282772,63395703587,4,0,0,3072,4,3368594535
1536,63395460347,86010,63395546357,5,0,1,5120,5,3624723042
1537,63395619573,60820,63395680393,0,0,1,5632,0,8164152716
1538,63395712174,54783,63395766957,5,0,0,93184,5,3509879089
1539,63395758565,64738,63395823303,5,0,0,105984,5,5858523145
1540,63395773424,81881,63395855305,7,0,0,108544,7,6323873512
1541,63396035889,61637,63396097526,5,0,0,99840,5,3171052282
1542,63396055751,42748,63396098499,9,0,0,12800,9,5601358533
1543,63396072590,63187,63396135777,7,0,0,102912,7,1528794902
1544,63396084515,52248,63396136763,3,0,0,1536,3,4941484435
1545,63396138627,5708,63396144335,8,0,0,14336,8,6625817929
1546,63396174898,46984,63396221882,4,0,1,23552,4,10167344557
1547,63396294724,16616,63396311340,0,0,0,81408,0,9900075841
1548,63396326718,214330,63396541048,1,0,0,2560,1,1145331928
1549,63396341261,14800,63396356061,7,0,1,22528,7,2183258937
1550,63396377022,160486,63396537508,2,0,0,28672,2,9710411370
1551,63396388857,280991,63396669848,4,0,1,190976,4,1431001792
1552,63396446237,169796,63396616033,4,0,1,22016,4,7359533695
1553,63396500071,169752,63396669823,7,0,0,244736,7,3534535648
1554,63396501979,117224,63396619203,3,0,0,72704,3,10654791857
1555,63396565337,29768,63396595105,3,0,0,43520,3,2445790194
1556,63396600276,272793,63396873069,8,0,1,3584,8,5238772287
1557,63396654099,247633,63396901732,4,0,0,2048,4,399002119
1558,63396809803,73054,63396882857,5,0,0,118784,5,8941934719
1559,63396834304,32486,63396866790,0,0,1,6656,0,10645954649
1560,63396845512,1038,63396846550,2,0,1,5120,2,4298542496
1561,63396850717,111430,63396962147,4,0,0,512,4,907028334
1562,63396888049,102532,63396990581,4,0,1,83968,4,3732167734
1563,63396890080,113781,63397003861,2,0,1,5120,2,1462573988
1564,63396899627,11787,63396911414,9,0,1,17920,9,7276924224
1565,63396903275,226539,63397129814,4,0,0,1024,4,1236206051
1566,63397024827,265812,63397290639,2,0,0,19456,2,5529242864
1567,63397060890,175508,63397236398,2,0,0,288256,2,3367915975
1568,63397281018,1038,63397282056,4,0,0,1024,4,6875582528
1569,63397321747,86825,63397408572,8,0,1,5632,8,2989827954
1570,63397361779,131737,63397493516,2,0,0,212992,2,2662714295
1571,63397457363,46983,63397504346,5,0,0,35328,5,689061380
1572,63397612740,562,63397613302,0,0,1,27136,0,3635859891
1573,63397635965,562,63397636527,0,0,0,512,0,8090043090
1574,63397691866,99628,63397791494,4,0,0,512,4,4301335726
1575,63397730719,1038,63397731757,7,0,1,3072,7,5789495509
1576,63397747595,1038,63397748633,5,0,1,8704,5,7427288719
1577,63397764576,66364,63397830940,1,0,0,1024,1,418962007
1578,63397796295,105740,63397902035,4,0,0,1024,4,8112545501
1579,63397838094,75004,63397913098,5,0,1,16896,5,290172977
1580,63397884096,30745,63397914841,9,0,0,49664,9,3891011455
1581,63398036965,33499,63398070464,7,0,0,58368,7,1898771356
1582,63398247919,3894,63398251813,8,0,0,4096,8,10610223730
1583,63398394306,47284,63398441590,3,0,1,1536,3,2000989535
1584,63398456720,3418,63398460138,4,0,0,3584,4,3610360258
1585,63398476707,65896,63398542603,3,0,1,7168,3,505502000
1586,63398593150,92529,63398685679,3,0,0,150016,3,3974258171
1587,63398605041,86847,63398691888,8,0,0,21504,8,3996868029
1588,63398692909,69636,63398762545,0,0,1,512,0,5170001414
1589,63398694641,41387,63398736028,3,0,1,3584,3,10505139092
1590,63398737308,88883,63398826191,7,0,1,14848,7,2391090369
1591,63398739457,84471,63398823928,0,0,0,67072,0,5034580443
1592,63398759937,123181,63398883118,8,0,1,7168,8,6750660027
1593,63398819709,89452,63398909161,5,0,1,18432,5,5021855688
1594,63398868554,4705,63398873259,8,0,1,18944,8,3592135556
1595,63398955759,249034,63399204793,1,0,0,2560,1,8365109745
1596,63398972918,101656,63399074574,8,0,1,33792,8,981313754
1597,63399107515,32295,63399139810,8,0,0,52736,8,885981537
1598,63399205401,109634,63399315035,4,0,1,211968,4,8688687252
1599,63399235984,245493,63399481477,3,0,1,2560,3,1514975311
1600,63399244141,206772,63399450913,8,0,0,268288,8,8596260343
1601,63399344142,106782,63399450924,5,0,0,129024,5,5227694216
1602,63399378942,71993,63399450935,1,0,0,512,1,8441596584
1603,63399391862,75390,63399467252,8,0,0,31744,8,5957702164
1604,63399497516,1990,63399499506,4,0,0,2048,4,10608700791
1605,63399622145,90293,63399712438,7,0,1,7168,7,4523837565
1606,63399668793,124624,63399793417,3,0,0,205824,3,7435811544
1607,63399712709,81374,63399794083,1,0,0,1024,1,8522137157
1608,63399713449,6274,63399719723,5,0,1,9728,5,9734964360
1609,63399867987,6308,63399874295,2,0,0,6656,2,3298389466
1610,63399868926,242319,63400111245,8,0,0,12800,8,10517294533
1611,63399888980,94130,63399983110,7,0,1,2560,7,445565058
1612,63399922102,83004,63400005106,8,0,1,9216,8,3126794669
1613,63399968623,36859,63400005482,7,0,0,65024,7,10140176216
1614,63400004036,7812,63400011848,5,0,0,7168,5,4825603369
1615,63400070305,31779,63400102084,2,0,0,51712,2,1756367823
1616,63400271497,32983,63400304480,9,0,0,57344,9,6444896995
1617,63400288798,2466,63400291264,9,0,1,27136,9,424827995
1618,63400295078,99848,63400394926,0,0,1,4608,0,4746152971
1619,63400313669,102384,63400416053,5,0,1,23552,5,9420742403
1620,63400366108,127965,63400494073,2,0,0,2560,2,3633173754
1621,63400429155,73539,63400502694,3,0,1,6656,3,8712042529
1622,63400522282,6484,63400528766,5,0,0,15872,5,6917940532
1623,63400623506,65896,63400689402,3,0,1,7168,3,8722307235
1624,63400716098,64479,63400780577,0,0,1,23552,0,1027492783
1625,63400718242,93928,63400812170,3,0,0,105472,3,836173077
1626,63400805192,31043,63400836235,0,0,0,47616,0,275907976
1627,63400875141,1038,63400876179,2,0,1,5632,2,1819040523
1628,63400944260,142959,63401087219,4,0,0,1024,4,4127031065
1629,63401081544,1514,63401083058,4,0,0,1536,4,5780219559
1630,63401183048,15575,63401198623,0,0,0,30208,0,3887102896
1631,63401207926,1990,63401209916,1,0,0,2048,1,4363728879
1632,63401240585,142637,63401383222,0,0,0,230912,0,8104964172
1633,63401689026,23462,63401712488,7,0,0,38912,7,5443442431
1634,63401722677,54783,63401777460,9,0,0,93184,9,7269411560
1635,63401768125,23462,63401791587,3,0,0,38912,3,7371194463
1636,63401792460,146425,63401938885,8,0,0,241664,8,5060159110
1637,63401885393,44488,63401929881,7,0,1,1024,7,2523384555
1638,63401927508,175812,63402103320,8,0,1,19456,8,2661745547
1639,63401928183,152500,63402080683,7,0,0,73216,7,8652254768
1640,63402080938,132770,63402213708,0,0,0,215040,0,428179931
1641,63402149605,162321,63402311926,3,0,1,9216,3,8611602860
1642,63402292184,20878,63402313062,9,0,0,33792,9,4415541388
1643,63402413652,10237,63402423889,7,0,0,16384,7,8887063945
1644,63402416903,10852,63402427755,0,0,0,6144,0,5216776648
1645,63402446066,4675,63402450741,2,0,0,12288,2,1529242584
1646,63402531663,44432,63402576095,2,0,1,512,2,10134730718
1647,63402552505,45748,63402598253,8,0,1,1536,8,770701087
1648,63402784481,5322,63402789803,4,0,1,78336,4,7642638917
1649,63402802963,43900,63402846863,0,0,1,512,0,2161804084
1650,63402812031,115228,63402927259,4,0,0,5632,4,453991502
1651,63402857708,63448,63402921156,5,0,1,9216,5,4956515314
1652,63403007177,43900,63403051077,8,0,1,512,8,7266697010
1653,63403039618,22858,63403062476,7,0,0,40960,7,7133868032
1654,63403040930,22429,63403063359,7,0,1,44032,7,820711795
1655,63403060585,115993,63403176578,8,0,0,36864,8,3394917960
1656,63403094568,148308,63403242876,7,0,1,16384,7,2354949501
1657,63403247682,1038,63403248720,1,0,0,1024,1,10641355118
1658,63403297382,13249,63403310631,9,0,1,10240,9,10705457
1659,63403300929,79456,63403380385,5,0,0,25600,5,6451752320
1660,63403323329,562,63403323891,5,0,1,16384,5,8577148391
1661,63403422846,144267,63403567113,8,0,1,3584,8,8487378460
1662,63403423476,1038,63403424514,1,0,0,512,1,3209050711
1663,63403463107,54323,63403517430,0,0,0,1024,0,676198330
1664,63403704649,1514,63403706163,1,0,0,1536,1,4099215273
1665,63403711702,50668,63403762370,3,0,1,15360,3,10170442204
1666,63403747297,92968,63403840265,7,0,1,2560,7,10180440904
1667,63403777177,56836,63403834013,0,0,1,7680,0,1113146745
1668,63403879337,66832,63403946169,2,0,1,10240,2,5074188728
1669,63403971182,43883,63404015065,7,0,0,75264,7,4021307110
1670,63403984044,45359,63404029403,7,0,1,7680,7,3522857402
1671,63403985464,70027,63404055491,2,0,0,50688,2,5869119758
1672,63404081433,92270,63404173703,7,0,0,149504,7,7069010569
1673,63404104396,90226,63404194622,5,0,1,7680,5,8609617633
1674,63404150087,54052,63404204139,0,0,1,3584,0,5088346021
1675,63404325584,15058,63404340642,9,0,0,29184,9,5740849983
1676,63404404493,5967,63404410460,9,0,1,3584,9,9072491494
1677,63404412576,54052,63404466628,3,0,1,3072,3,1460856988
1678,63404420382,49288,63404469670,5,0,0,14848,5,111965114
1679,63404423394,105507,63404528901,9,0,0,168960,9,6456379359
1680,63404554841,203815,63404758656,4,0,1,135680,4,1181961291
1681,63404576256,192091,63404768347,9,0,1,31744,9,2811672963
1682,63404656990,112772,63404769762,3,0,1,4608,3,10268783606
1683,63404683578,87919,63404771497,7,0,1,5632,7,7172856787
1684,63404718823,85431,63404804254,0,0,0,60416,0,9415844534
1685,63404774238,36020,63404810258,8,0,0,20480,8,2861639835
1686,63404828769,104152,63404932921,8,0,1,41984,8,5973803374
1687,63404939440,12991,63404952431,0,0,0,25088,0,10138001730
1688,63404995922,1990,63404997912,5,0,0,2048,5,5715945743
1689,63405009324,80524,63405089848,7,0,1,14848,7,4400805576
1690,63405029788,5450,63405035238,3,0,1,13824,3,8317910124
1691,63405084567,125525,63405210092,5,0,0,13824,5,5954207145
1692,63405147108,129152,63405276260,5,0,1,11264,5,9387561915
1693,63405284997,131995,63405416992,7,0,0,213504,7,7212669473
1694,63405318954,66093,63405385047,3,0,1,2048,3,9846184095
1695,63405352845,229592,63405582437,5,0,0,3072,5,10164345826
1696,63405451753,52360,63405504113,9,0,1,19456,9,3555928444
1697,63405522494,196154,63405718648,8,0,1,3072,8,1305451761
1698,63405560480,97912,63405658392,3,0,1,21504,3,82411195
1699,63405759185,52029,63405811214,2,0,0,84480,2,1598757136
1700,63405809153,2407,63405811560,5,0,0,512,5,4791385608
1701,63405848845,92787,63405941632,8,0,0,150528,8,4607406470
1702,63405855174,86101,63405941275,4,0,1,73216,4,2137680902
1703,63405896851,53780,63405950631,2,0,0,132096,2,5255471158
1704,63405930158,202193,63406132351,4,0,0,1536,4,9920729085
1705,63405977129,6484,63405983613,8,0,1,15872,8,9698731526
1706,63406181086,417245,63406598331,5,0,1,11776,5,5038581120
1707,63406181674,94932,63406276606,4,0,1,76288,4,3996392677
1708,63406188802,102712,63406291514,8,0,1,10240,8,4351087156
1709,63406222143,176503,63406398646,0,0,0,15872,0,9371182345
1710,63406259474,153046,63406412520,2,0,1,50688,2,9114650157
1711,63406361129,102748,63406463877,3,0,1,37376,3,6065164507
1712,63406393476,4810,63406398286,8,0,1,34304,8,4034864441
1713,63406461049,1990,63406463039,4,0,0,2048,4,5354505739
1714,63406474659,101812,63406576471,4,0,0,2048,4,6671505260
1715,63406539196,122915,63406662111,5,0,1,2048,5,7576960353
1716,63406672287,24925,63406697212,5,0,1,10240,5,1443586800
1717,63406704026,69904,63406773930,9,0,1,12800,9,9267493838
1718,63406706090,7226,63406713316,8,0,0,45056,8,5212913320
1719,63406773501,112615,63406886116,0,0,0,7680,0,7147649991
1720,63406809208,7444,63406816652,9,0,0,7680,9,4104328435
1721,63406894257,24408,63406918665,8,0,0,44032,8,554864211
1722,63406969071,69261,63407038332,0,0,1,1024,0,3275417031
1723,63407115761,98224,63407213985,6,0,1,22528,6,8838869303
1724,63407167142,67588,63407234730,3,0,1,7680,3,8306105340
1725,63407212953,46616,63407259569,3,0,1,1024,3,2028745641
1726,63407289900,56212,63407346112,7,0,1,5632,7,10624981299
1727,63407336064,23462,63407359526,7,0,0,38912,7,4921035785
1728,63407443649,77740,63407521389,2,0,1,10752,2,1696160160
1729,63407477719,62512,63407540231,0,0,1,6144,0,8022416001
1730,63407518527,44241,63407562768,3,0,0,67072,3,753427664
1731,63407548898,96492,63407645390,3,0,1,3584,3,4663684613
1732,63407636450,110632,63407747082,9,0,1,4096,9,464323815
1733,63407666722,98848,63407765570,3,0,1,24576,3,8807716887
1734,63407758888,7712,63407766600,5,0,0,1024,5,5852335588
1735,63407896024,34104,63407930128,2,0,0,56320,2,2966193682
1736,63407954997,1038,63407956035,4,0,1,70656,4,4278196972
1737,63407967119,76560,63408043679,7,0,1,5120,7,10664924364
1738,63407984690,104605,63408089295,0,0,1,3072,0,8717146702
1739,63408037683,74320,63408112003,5,0,0,1024,5,957170808
1740,63408042975,96575,63408139550,2,0,1,17408,2,6356376268
1741,63408063138,242442,63408305580,9,0,0,161280,9,1561513871
1742,63408125086,105258,63408230344,0,0,1,1024,0,10555376121
1743,63408236724,86981,63408323705,3,0,1,1536,3,710276609
1744,63408317840,53749,63408371589,8,0,1,18432,8,5620883963
1745,63408324797,23736,63408348533,8,0,0,91136,8,8709060114
1746,63408334161,96976,63408431137,9,0,1,8704,9,7387846529
1747,63408355796,89425,63408445221,5,0,0,1536,5,4293859369
1748,63408366497,104932,63408471429,7,0,1,44544,7,8595472784
1749,63408450026,44488,63408494514,4,0,1,165376,4,2228815496
1750,63408481993,32295,63408514288,3,0,0,73216,3,2858464509
1751,63408508549,206347,63408714896,8,0,1,4096,8,9824876148
1752,63408578608,319482,63408898090,2,0,1,55808,2,3838953565
1753,63408590747,181736,63408772483,4,0,1,9728,4,979104436
1754,63408620598,210890,63408831488,3,0,0,52736,3,4753645431
1755,63408783535,11922,63408795457,0,0,0,14848,0,6999525743
1756,63408797270,54520,63408851790,7,0,1,5120,7,10732450584
1757,63408864306,106804,63408971110,2,0,1,3072,2,4056396439
1758,63408893466,49132,63408942598,7,0,1,50688,7,10729263363
1759,63408952044,144937,63409096981,0,0,1,2560,0,1722599132
1760,63408970224,43712,63409013936,8,0,0,71680,8,6204376420
1761,63408977215,37387,63409014602,3,0,0,1024,3,9981451727
1762,63408992678,23230,63409015908,9,0,0,2048,9,481822761
1763,63409179075,73483,63409252558,7,0,0,122880,7,6384149720
1764,63409225181,105059,63409330240,2,0,1,6656,2,663705920
1765,63409349323,44400,63409393723,0,0,1,35328,0,3590395769
1766,63409381832,15791,63409397623,3,0,0,76288,3,10410366625
1767,63409386681,10228,63409396909,6,0,1,14336,6,9884951612
1768,63409410787,118837,63409529624,5,0,0,512,5,4649391527
1769,63409417336,3983,63409421319,4,0,0,1536,4,8655126614
1770,63409425854,562,63409426416,2,0,1,6144,2,7537612619
1771,63409440308,108028,63409548336,0,0,1,2560,0,1435086838
1772,63409468063,80659,63409548722,1,0,0,4096,1,3765256984
1773,63409482106,1990,63409484096,5,0,0,512,5,7971954494
1774,63409523615,105101,63409628716,4,0,0,2048,4,10428217351
1775,63409526410,40870,63409567280,3,0,1,15360,3,3999740018
1776,63409534716,77157,63409611873,3,0,0,66048,3,443489497
1777,63409658166,11787,63409669953,5,0,1,5120,5,8287335587
1778,63409660771,86462,63409747233,0,0,0,19456,0,348517044
1779,63409824441,33758,63409858199,9,0,1,2560,9,9777774602
1780,63409837664,50668,63409888332,9,0,0,58880,9,942955645
1781,63410035949,74356,63410110305,6,0,1,9728,6,7135554913
1782,63410138143,46208,63410184351,2,0,0,79872,2,10261674768
1783,63410171802,100862,63410272664,2,0,1,5120,2,7386209523
1784,63410351752,55744,63410407496,2,0,1,4096,2,7705970952
1785,63410397715,11270,63410408985,0,0,0,18432,0,9612759108
1786,63410415798,1038,63410416836,1,0,0,1024,1,1300763883
1787,63410515273,2942,63410518215,3,0,0,3072,3,5705191186
1788,63410524356,1990,63410526346,1,0,0,2048,1,9920894255
1789,63410599666,59128,63410658794,0,0,1,5120,0,5723869516
1790,63410640447,94854,63410735301,9,0,0,154624,9,666810235
1791,63410644196,112023,63410756219,0,0,0,236544,0,1109869925
1792,63410670649,188916,63410859565,9,0,1,1024,9,2188172851
1793,63410800974,193003,63410993977,3,0,0,312320,3,6471547423
1794,63410805376,197608,63411002984,0,0,1,4096,0,9840453637
1795,63410878567,126240,63411004807,2,0,0,35328,2,3355115845
1796,63410968394,5708,63410974102,3,0,1,5120,3,8570968983
1797,63411079926,178222,63411258148,4,0,0,14336,4,2803007827
1798,63411092560,562,63411093122,8,0,1,30720,8,1542235823
1799,63411097576,101337,63411198913,6,0,1,9216,6,3736829049
1800,63411189116,142431,63411331547,1,0,0,512,1,3238865574
1801,63411251867,562,63411252429,7,0,1,15872,7,1017337659
1802,63411265014,111217,63411376231,5,0,0,512,5,7608643779
1803,63411280618,6483,63411287101,7,0,1,2048,7,1061303451
1804,63411346715,72976,63411419691,7,0,1,10240,7,9790692026
1805,63411362867,53336,63411416203,5,0,0,6656,5,1170040495
1806,63411366366,167530,63411533896,0,0,0,84480,0,2261578008
1807,63411399172,34791,63411433963,7,0,1,27648,7,5246078177
1808,63411424295,2866,63411427161,8,0,1,2560,8,2888784629
1809,63411426025,95176,63411521201,8,0,0,60928,8,2271131806
1810,63411477667,132541,63411610208,2,0,0,8704,2,4567997200
1811,63411484100,94508,63411578608,3,0,0,157184,3,3204187492
1812,63411519492,74424,63411593916,9,0,1,1024,9,7368624682
1813,63411634742,1514,63411636256,7,0,0,1536,7,2863783300
1814,63411747061,30487,63411777548,3,0,0,49152,3,5642772489
1815,63411817876,16092,63411833968,7,0,1,13824,7,4339818023
1816,63411824528,1038,63411825566,8,0,0,31232,8,1178081055
1817,63411871109,3894,63411875003,1,0,0,1024,1,312625096
1818,63411918856,127127,63412045983,5,0,1,37888,5,2736678964
1819,63411926591,20878,63411947469,4,0,0,4096,4,7599320334
1820,63411932631,161469,63412094100,8,0,1,40448,8,4814212169
1821,63411955145,129251,63412084396,5,0,1,512,5,6069944592
1822,63412000450,47284,63412047734,0,0,0,33792,0,6840885301
1823,63412064684,250553,63412315237,7,0,1,1536,7,1997570066
1824,63412189149,53837,63412242986,4,0,1,306176,4,4788380712
1825,63412259448,282952,63412542400,0,0,0,88064,0,10094659242
1826,63412351142,120978,63412472120,4,0,0,113152,4,2579176857
1827,63412389328,133433,63412522761,6,0,1,2560,6,8538144157
1828,63412513470,81853,63412595323,8,0,1,3072,8,4219288580
1829,63412663829,59440,63412723269,7,0,1,6144,7,3387159645
1830,63412758907,562,63412759469,1,0,0,512,1,3484301091
1831,63412777374,21912,63412799286,3,0,1,6656,3,9212094660
1832,63412793432,64204,63412857636,9,0,0,35840,9,5505725079
1833,63412807521,16350,63412823871,6,0,1,9728,6,747143638
1834,63412842223,120176,63412962399,0,0,0,31744,0,6735498132
1835,63412984394,2942,63412987336,6,0,1,5120,6,3944475799
1836,63412990109,6274,63412996383,5,0,0,3072,5,9496650497
1837,63413010253,13079,63413023332,4,0,0,6656,4,1841962074
1838,63413041016,80660,63413121676,3,0,0,22016,3,9912924108
1839,63413068755,3418,63413072173,5,0,0,3584,5,10629431439
1840,63413109832,13854,63413123686,7,0,0,23552,7,2088685778
1841,63413121929,83696,63413205625,8,0,0,136192,8,2959099708
1842,63413285953,23204,63413309157,3,0,0,38400,3,4224564127
1843,63413330627,1990,63413332617,1,0,0,2048,1,4020594007
1844,63413479950,89320,63413569270,8,0,1,23552,8,3701582309
1845,63413551038,22429,63413573467,3,0,0,36864,3,3335783811
1846,63413564983,10750,63413575733,1,0,0,3584,1,5417652248
1847,63413739091,75448,63413814539,7,0,1,13312,7,6013011126
1848,63413777320,50668,63413827988,3,0,1,2560,3,7572738439
1849,63413796412,45592,63413842004,3,0,1,11264,3,9091248102
1850,63413826716,79432,63413906148,7,0,1,1024,7,140136272
1851,63413906038,69280,63413975318,9,0,1,19456,9,1763232034
1852,63413907359,94216,63414001575,3,0,1,8192,3,1244995716
1853,63413960873,119919,63414080792,6,0,1,55808,6,3843168258
1854,63414028520,52283,63414080803,3,0,0,79360,3,7625747207
1855,63414056428,237550,63414293978,0,0,0,389120,0,251116589
1856,63414133878,136114,63414269992,3,0,1,11776,3,8635255648
1857,63414158530,14113,63414172643,5,0,0,1024,5,10641629859
1858,63414182250,221268,63414403518,4,0,1,87040,4,7843503405
1859,63414330030,316339,63414646369,0,0,0,24064,0,733398039
1860,63414478059,83968,63414562027,3,0,0,103424,3,6858158509
1861,63414503947,97715,63414601662,7,0,0,115712,7,4936425987
1862,63414522825,79823,63414602648,7,0,0,1536,7,6123646068
1863,63414546015,56979,63414602994,1,0,0,512,1,4024587745
1864,63414575693,53749,63414629442,8,0,0,91136,8,5638336660
1865,63414602645,37422,63414640067,0,0,0,34304,0,9170779348
1866,63414606310,68837,63414675147,0,0,0,98816,0,5508341218
1867,63414628192,73696,63414701888,2,0,0,87040,2,2948242533
1868,63414666033,99792,63414765825,6,0,1,1024,6,3285982867
1869,63414706031,71762,63414777793,3,0,1,4608,3,4381255088
1870,63414720474,142205,63414862679,3,0,0,116224,3,10514577341
1871,63414732665,205469,63414938134,6,0,1,4608,6,5548730274
1872,63414936435,24408,63414960843,4,0,1,69120,4,3447668233
1873,63414959015,112420,63415071435,4,0,0,44032,4,3828089720
1874,63415013538,149900,63415163438,4,0,1,49664,4,5324981581
1875,63415100343,17623,63415117966,4,0,1,33792,4,7062821724
1876,63415151791,127721,63415279512,0,0,0,14848,0,8992955983
1877,63415151879,78246,63415230125,0,0,0,100864,0,149557082
1878,63415272976,48976,63415321952,2,0,1,2048,2,1549286578
1879,63415334161,2942,63415337103,5,0,0,3072,5,9712811164
1880,63415362581,108052,63415470633,4,0,1,54784,4,82886872
1881,63415436192,34452,63415470644,0,0,0,43008,0,5038543169
1882,63415451810,18845,63415470655,9,0,0,25600,9,1226563265
1883,63415536886,50668,63415587554,5,0,1,2560,5,3059604722
1884,63415563035,107734,63415670769,8,0,0,179712,8,1665732368
1885,63415582929,94151,63415677080,0,0,0,30208,0,5254502613
1886,63415598819,90115,63415688934,2,0,0,40448,2,8988015357
1887,63415689656,56645,63415746301,0,0,1,3584,0,6085134348
1888,63415757984,53491,63415811475,4,0,0,90624,4,6022097970
1889,63415762727,1990,63415764717,7,0,1,1024,7,4791361072
1890,63415872781,139083,63416011864,5,0,0,2048,5,1182769686
1891,63415939207,63760,63416002967,7,0,1,10240,7,9513384592
1892,63415970596,73444,63416044040,2,0,1,11776,2,4863735148
1893,63415997972,104308,63416102280,0,0,1,42496,0,7740117893
1894,63416039171,63120,63416102291,4,0,0,90624,4,3512093575
1895,63416059518,42784,63416102302,0,0,0,7168,0,6176606308
1896,63416239398,53140,63416292538,6,0,1,5632,6,8311328023
1897,63416368740,3894,63416372634,8,0,1,5120,8,1804111944
1898,63416409846,59128,63416468974,2,0,0,4096,2,8263958026
1899,63416413757,1990,63416415747,5,0,1,10240,5,3228920091
1900,63416433341,69904,63416503245,1,0,0,2048,1,8829986843
1901,63416515144,562,63416515706,5,0,0,512,5,8517906272
1902,63416680724,6484,63416687208,7,0,0,15872,7,1906848060
1903,63416694666,33329,63416727995,8,0,0,54784,8,8553208220
1904,63416705266,57133,63416762399,5,0,1,10752,5,8435666097
1905,63416708307,562,63416708869,4,0,0,91648,4,589436401
1906,63416788035,124539,63416912574,8,0,1,2560,8,9995429816
1907,63416824865,14283,63416839148,5,0,0,512,5,4315052128
1908,63416869520,74980,63416944500,2,0,1,8704,2,8326636274
1909,63416902989,34363,63416937352,8,0,0,27648,8,5512650641
1910,63416957155,13541,63416970696,2,0,0,56832,2,2195897659
1911,63416982803,210250,63417193053,3,0,0,7680,3,2854763206
1912,63417022252,45692,63417067944,2,0,0,78848,2,2822950494
1913,63417042945,47263,63417090208,0,0,0,75264,0,7043016733
1914,63417076502,11271,63417087773,3,0,1,9216,3,8345584142
1915,63417080217,1038,63417081255,8,0,0,14336,8,709565248
1916,63417096622,96706,63417193328,1,0,0,1024,1,2016067780
1917,63417186663,34104,63417220767,0,0,0,56320,0,8913948841
1918,63417239878,136145,63417376023,9,0,1,1024,9,8761326692
1919,63417252131,147717,63417399848,3,0,0,244224,3,8360645264
1920,63417260785,155128,63417415913,7,0,0,52224,7,5330052979
1921,63417277635,136866,63417414501,9,0,0,24064,9,10430896099
1922,63417287564,146806,63417434370,3,0,1,20992,3,6068413209
1923,63417314648,126047,63417440695,6,0,1,12800,6,9852755311
1924,63417321579,185354,63417506933,8,0,0,257536,8,8502699232
1925,63417322516,184697,63417507213,2,0,1,2560,2,2553236715
1926,63417328005,184480,63417512485,8,0,0,29696,8,5930912311
1927,63417332416,190591,63417523007,3,0,0,33792,3,7772069962
1928,63417387306,346947,63417734253,4,0,1,27648,4,1482422565
1929,63417436952,363573,63417800525,9,0,1,27136,9,7859820029
1930,63417516522,296338,63417812860,4,0,1,40448,4,9838632280
1931,63417661907,155087,63417816994,9,0,0,251904,9,9376362901
1932,63417687081,47795,63417734876,9,0,1,43008,9,1351019308
1933,63417770825,143154,63417913979,2,0,0,2560,2,1606744503
1934,63417787699,269838,63418057537,0,0,0,231936,0,43054804
1935,63417932241,52287,63417984528,2,0,1,3584,2,3057410445
1936,63417958939,92732,63418051671,7,0,0,84992,7,4765198219
1937,63417978090,1990,63417980080,5,0,1,26112,5,1959473583
1938,63418038928,15058,63418053986,2,0,0,2048,2,5995101
1939,63418045286,219304,63418264590,0,0,0,29184,0,632118003
1940,63418258420,166229,63418424649,4,0,1,88576,4,1711921420
1941,63418286509,144235,63418430744,8,0,1,19968,8,8996484915
1942,63418389381,60862,63418450243,9,0,0,98304,9,1737536732
1943,63418399822,39444,63418439266,3,0,1,21504,3,7855116418
1944,63418411145,102769,63418513914,1,0,0,512,1,51310761
1945,63418411833,122682,63418534515,8,0,1,1536,8,10378786617
1946,63418534153,60820,63418594973,0,0,1,5632,0,1243087916
1947,63418539395,91495,63418630890,3,0,0,147968,3,5068756074
1948,63418657758,48201,63418705959,3,0,1,512,3,3541569161
1949,63418658395,72027,63418730422,3,0,1,5120,3,583460979
1950,63418753563,10495,63418764058,4,0,0,16896,4,3571755062
1951,63418841064,15058,63418856122,3,0,1,512,3,3500334204
1952,63418851009,43900,63418894909,3,0,0,29184,3,10459058830
1953,63418881964,86068,63418968032,2,0,1,17920,2,7245577060
1954,63418894127,14541,63418908668,5,0,1,23552,5,10047432561
1955,63418975286,58060,63419033346,5,0,1,26112,5,2156284669
1956,63418994252,99316,63419093568,9,0,1,6656,9,5713463509
1957,63419011174,562,63419011736,9,0,0,28160,9,6044405082
1958,63419090109,206493,63419296602,5,0,0,512,5,8679935780
1959,63419163663,137176,63419300839,7,0,1,5120,7,3642697212
1960,63419276479,106442,63419382921,7,0,0,177152,7,5859097808
1961,63419444239,50668,63419494907,6,0,1,2560,6,8199220381
1962,63419447182,105308,63419552490,0,0,1,2560,0,1956068787
1963,63419483451,102748,63419586199,9,0,1,6144,9,2051567624
1964,63419525888,99940,63419625828,4,0,1,28160,4,1107411230
1965,63419702824,77359,63419780183,8,0,0,130560,8,7129143847
1966,63419749151,52640,63419801791,4,0,0,70656,4,3320269715
1967,63419767350,35747,63419803097,1,0,0,2048,1,7292562503
1968,63419769028,143108,63419912136,6,0,1,31232,6,10272151196
1969,63420027480,2942,63420030422,1,0,0,3072,1,5433149851
1970,63420061461,43900,63420105361,8,0,1,512,8,5159120998
1971,63420158956,43971,63420202927,0,0,0,72192,0,7474142987
1972,63420183101,57109,63420240210,9,0,0,97792,9,10734963241
1973,63420195017,56535,63420251552,4,0,0,37888,4,4482629864
1974,63420313367,21912,63420335279,9,0,0,35840,9,3815417685
1975,63420339220,80680,63420419900,7,0,1,15360,7,4317053974
1976,63420355958,81039,63420436997,8,0,1,7168,8,9902786776
1977,63420406886,64738,63420471624,3,0,1,11776,3,7185208887
1978,63420440660,10935,63420451595,2,0,0,105984,2,8110636093
1979,63420497049,10726,63420507775,8,0,0,4096,8,3660825724
1980,63420500164,161625,63420661789,8,0,0,4608,8,7267383581
1981,63420539822,3894,63420543716,3,0,0,4096,3,1314431086
1982,63420570753,134066,63420704819,7,0,1,2560,7,4947853911
1983,63420598513,154581,63420753094,4,0,1,61440,4,9817381083
1984,63420766248,52360,63420818608,7,0,1,3072,7,6790065899
1985,63420792098,50668,63420842766,9,0,1,2560,9,4887507929
1986,63420922154,562,63420922716,1,0,0,512,1,1687375679
1987,63420939916,43196,63420983112,7,0,0,70656,7,4981194456
1988,63421065398,52360,63421117758,5,0,1,3072,5,10254583887
1989,63421155966,43900,63421199866,3,0,1,512,3,8194153983
1990,63421222507,562,63421223069,5,0,0,512,5,3600114938
1991,63421362325,126772,63421489097,4,0,1,116224,4,2629121913
1992,63421438423,38203,63421476626,2,0,1,8192,2,3881615714
1993,63421450905,32710,63421483615,5,0,0,8192,5,5857219089
1994,63421464109,79882,63421543991,7,0,0,8192,7,1649982507
1995,63421472962,174255,63421647217,9,0,0,252928,9,830439994
1996,63421564284,99506,63421663790,7,0,1,1024,7,3052379375
1997,63421615839,2466,63421618305,7,0,1,10240,7,4442333636
1998,63421627821,134433,63421762254,5,0,1,1024,5,9526656763
1999,63421682574,178407,63421860981,3,0,1,3072,3,4840584642
2000,63421732200,147055,63421879255,1,0,0,2560,1,590160594
2001,63421836882,24238,63421861120,7,0,0,40448,7,1522217211
2002,63421852073,12913,63421864986,3,0,0,6144,3,10317289362
2003,63422116056,32295,63422148351,3,0,1,3072,3,4594498295
2004,63422128421,52360,63422180781,3,0,0,52736,3,7124595543
2005,63422169566,562,63422170128,3,0,1,9728,3,10035926643
2006,63422194235,108358,63422302593,2,0,1,4096,2,8777607485
2007,63422212440,45592,63422258032,1,0,0,512,1,6266221489
2008,63422258738,129749,63422388487,9,0,1,1024,9,387282955
2009,63422279107,194037,63422473144,9,0,0,314368,9,8720747131
2010,63422294789,159717,63422454506,4,0,1,112128,4,7433691621
2011,63422315373,355147,63422670520,5,0,0,3072,5,3706326479
2012,63422391909,95425,63422487334,9,0,1,3072,9,998279354
2013,63422554530,258993,63422813523,0,0,0,105984,0,1533225889
2014,63422587265,4370,63422591635,4,0,1,118784,4,4829267056
2015,63422616731,183674,63422800405,8,0,1,20480,8,6553698707
2016,63422668315,103682,63422771997,4,0,1,99328,4,2458896296
2017,63422684459,215652,63422900111,9,0,1,12800,9,6239221053
2018,63422714651,13508,63422728159,7,0,0,4608,7,6698182395
2019,63422798263,311138,63423109401,4,0,1,59904,4,2956679710
2020,63422877310,147869,63423025179,4,0,1,146432,4,5617398480
2021,63422893590,15317,63422908907,9,0,0,26112,9,6053905868
2022,63422929241,213999,63423143240,7,0,1,16384,7,7030239760
2023,63422951149,167071,63423118220,5,0,1,12288,5,2491261217
2024,63422953259,155955,63423109214,7,0,0,29696,7,1691609284
2025,63423007568,125907,63423133475,6,0,1,15872,6,6787272046
2026,63423161521,3894,63423165415,5,0,0,4096,5,2240546018
2027,63423247528,76048,63423323576,8,0,1,10240,8,1371680775
2028,63423367462,53749,63423421211,2,0,0,91136,2,9723663207
2029,63423388473,163550,63423552023,4,0,1,52224,4,6852169681
2030,63423457099,98679,63423555778,3,0,1,12288,3,2612945323
2031,63423585541,16092,63423601633,1,0,1,6144,1,4350243460
2032,63423610925,62512,63423673437,4,0,0,31232,4,4318460960
2033,63423691669,20620,63423712289,7,0,0,33280,7,2834053017
2034,63423727075,104979,63423832054,2,0,0,171008,2,1768762039
2035,63423735482,132555,63423868037,7,0,0,122880,7,5076086154
2036,63423760040,113591,63423873631,9,0,0,26624,9,1432090461
2037,63423820680,54257,63423874937,1,0,0,2048,1,2774893610
2038,63423863700,13183,63423876883,1,0,0,3072,1,611870948
2039,63423939962,26217,63423966179,2,0,1,10752,2,5944913816
2040,63423941257,108311,63424049568,3,0,0,47616,3,5615113449
2041,63424016260,142820,63424159080,9,0,1,3584,9,10323768401
2042,63424123622,72850,63424196472,6,0,1,3072,6,2940481459
2043,63424183960,73999,63424257959,2,0,0,123904,2,9927778260
2044,63424186871,71754,63424258625,5,0,0,1024,5,2680631773
2045,63424260373,146942,63424407315,7,0,0,242688,7,2099761330
2046,63424336895,82274,63424419169,4,0,0,40448,4,3418694873
2047,63424428001,562,63424428563,4,0,1,12288,4,4146744898
2048,63424530373,53646,63424584019,8,0,1,2560,8,3749304560
2049,63424554845,189702,63424744547,7,0,0,512,7,9498345574
2050,63424559723,142618,63424702341,8,0,0,320512,8,4650820475
2051,63424579256,195499,63424774755,8,0,1,10752,8,9063264487
2052,63424604943,198605,63424803548,0,0,1,2048,0,2204952463
2053,63424627495,153956,63424781451,7,0,0,84480,7,8840546206
2054,63424688352,93445,63424781797,5,0,0,512,5,6076898702
2055,63424764125,77100,63424841225,6,0,1,1536,6,5211257981
2056,63424779521,60463,63424839984,4,0,0,130048,4,2265811520
2057,63424799064,37169,63424836233,5,0,0,4608,5,4229627845
2058,63424826544,13337,63424839881,3,0,0,6656,3,3686799125
2059,63424859423,205688,63425065111,4,0,1,33792,4,1502700672
2060,63424869161,55300,63424924461,8,0,1,7168,8,3700523337
2061,63424886295,142202,63425028497,2,0,0,22528,2,8048375471
2062,63424903028,184788,63425087816,6,0,1,22016,6,7456553124
2063,63424945440,52360,63424997800,0,0,0,94208,0,1288810797
2064,63425064421,294166,63425358587,0,0,1,3072,0,10023020399
2065,63425132299,164406,63425296705,4,0,1,89600,4,10024652042
2066,63425312587,2466,63425315053,1,0,0,2560,1,6178667449
2067,63425331047,15058,63425346105,0,0,0,29184,0,411971683
2068,63425392121,15058,63425407179,7,0,0,29184,7,8783796525
2069,63425448591,48976,63425497567,5,0,1,2048,5,1266635794
2070,63425503704,95541,63425599245,3,0,0,159232,3,2426514721
2071,63425537358,52579,63425589937,1,0,1,4608,1,8962912669
2072,63425553284,112245,63425665529,9,0,0,31744,9,5559165008
2073,63425744798,4370,63425749168,8,0,1,17920,8,7226501900
2074,63425766970,33499,63425800469,5,0,0,4608,5,9317084778
2075,63425774813,75316,63425850129,0,0,0,58368,0,4230666816
2076,63425823004,137333,63425960337,4,0,1,34304,4,8971358268
2077,63425823418,98798,63425922216,0,0,0,227328,0,2198102905
2078,63425872475,40082,63425912557,0,0,0,41984,0,10193745469
2079,63425874735,113060,63425987795,1,0,1,1024,1,10117588262
2080,63425923992,42937,63425966929,5,0,1,18944,5,4482581246
2081,63425932497,264703,63426197200,1,0,0,2048,1,6074402272
2082,63425974603,169498,63426144101,3,0,0,70144,3,7938594714
2083,63426054036,55300,63426109336,2,0,1,12288,2,6034168523
2084,63426096988,220225,63426317213,4,0,0,94208,4,10442564455
2085,63426282580,86512,63426369092,0,0,1,14336,0,5880812804
2086,63426402553,54052,63426456605,7,0,1,3584,7,4213469354
2087,63426504450,23462,63426527912,8,0,1,16896,8,6835770006
2088,63426506651,87292,63426593943,9,0,0,38912,9,6552250027
2089,63426660378,46984,63426707362,5,0,1,12800,5,2158467117
2090,63426722843,127929,63426850772,9,0,0,81408,9,6129008578
2091,63426850191,101500,63426951691,8,0,1,33280,8,3867416411
2092,63426874180,77522,63426951702,9,0,0,118784,9,1586723579
2093,63426914858,28335,63426943193,7,0,1,16384,7,6241982830
2094,63426929626,25183,63426954809,7,0,0,34816,7,4368189601
2095,63426979403,146394,63427125797,3,0,1,9728,3,9582297833
2096,63427011770,1038,63427012808,5,0,1,4608,5,8082864541
2097,63427026642,69573,63427096215,8,0,0,45568,8,10705787815
2098,63427031822,103998,63427135820,6,0,1,5632,6,6428854474
2099,63427088736,146308,63427235044,5,0,0,1024,5,10018951579
2100,63427125008,11707,63427136715,3,0,0,17920,3,4699641081
2101,63427146300,102912,63427249212,7,0,0,166912,7,536069059
2102,63427159343,32491,63427191834,2,0,1,2560,2,9070338308
2103,63427177332,164423,63427341755,8,0,1,29184,8,9688513782
2104,63427222622,224008,63427446630,8,0,0,19968,8,8282725763
2105,63427372155,100564,63427472719,7,0,1,30208,7,757308221
2106,63427420342,57436,63427477778,3,0,1,4608,3,8517453956
2107,63427453349,24440,63427477789,2,0,0,44032,2,3743766148
2108,63427497855,1990,63427499845,3,0,1,3072,3,9066359469
2109,63427501315,84957,63427586272,5,0,0,2048,5,1350880270
2110,63427528373,92968,63427621341,2,0,1,15360,2,7260811007
2111,63427577442,59596,63427637038,5,0,1,20480,5,2587738504
2112,63427596443,84848,63427681291,3,0,1,6656,3,3261340764
2113,63427648088,71503,63427719591,0,0,0,115712,0,6188392029
2114,63427679467,71895,63427751362,9,0,0,102912,9,6383957040
2115,63427695448,126767,63427822215,4,0,1,8192,4,2993120736
2116,63427709931,228543,63427938474,0,0,1,3584,0,3163155439
2117,63427751690,223408,63427975098,2,0,1,1024,2,8103132032
2118,63427837061,59043,63427896104,5,0,1,28672,5,446785923
2119,63427875711,562,63427876273,1,0,1,4608,1,829491147
2120,63427960290,162651,63428122941,1,0,1,23040,1,2791397731
2121,63427970975,43900,63428014875,6,0,1,512,6,7022986616
2122,63427977720,1990,63427979710,1,0,0,512,1,392366657
2123,63428005412,109830,63428115242,0,0,1,60416,0,5116575598
2124,63428044285,149273,63428193558,5,0,0,2048,5,7324092400
2125,63428111224,97092,63428208316,4,0,0,162304,4,3939900100
2126,63428279108,55744,63428334852,1,0,1,4096,1,6127990962
2127,63428284388,96664,63428381052,4,0,1,17408,4,6556342845
2128,63428525062,1038,63428526100,1,0,0,1024,1,9835575140
2129,63428608615,31262,63428639877,8,0,0,50688,8,4780950099
2130,63428621785,20038,63428641823,0,0,0,3072,0,5472322802
2131,63428623514,66455,63428689969,3,0,0,109568,3,958470375
2132,63428660595,120059,63428780654,9,0,1,14336,9,6833651217
2133,63428784539,100105,63428884644,9,0,1,6144,9,10416272726
2134,63429030670,12304,63429042974,8,0,0,20480,8,9080608028
2135,63429135577,60376,63429195953,7,0,1,9216,7,6607014067
2136,63429161898,63616,63429225514,8,0,1,16384,8,10644763567
2137,63429172066,84197,63429256263,3,0,0,107008,3,10137054207
2138,63429240864,5242,63429246106,5,0,0,2048,5,10630707581
2139,63429276574,5967,63429282541,8,0,1,7680,8,6434853147
2140,63429288617,69290,63429357907,6,0,1,5632,6,3283614739
2141,63429292780,48976,63429341756,7,0,0,14848,7,4563232835
2142,63429327882,120250,63429448132,2,0,1,2048,2,5068965410
2143,63429403676,66458,63429470134,4,0,0,112640,4,6962780813
2144,63429405707,1990,63429407697,1,0,1,12288,1,1450582896
2145,63429464682,1038,63429465720,0,0,1,2048,0,7440802573
2146,63429511419,215474,63429726893,0,0,1,4096,0,9962129039
2147,63429518927,153688,63429672615,6,0,1,14848,6,1386254086
2148,63429553250,1724,63429554974,0,0,0,2048,0,8502593635
2149,63429588459,177104,63429765563,5,0,0,1024,5,4160444358
2150,63429637688,233593,63429871281,5,0,1,12288,5,7916092208
2151,63429663394,65920,63429729314,7,0,0,512,7,10080167534
2152,63429717655,67456,63429785111,8,0,1,12288,8,895046386
2153,63429730082,79456,63429809538,4,0,1,16384,4,4078385299
2154,63429749857,85528,63429835385,0,0,1,14848,0,8564364102
2155,63429778481,73741,63429852222,4,0,0,123392,4,7297671977
2156,63429789922,64246,63429854168,0,0,0,3072,0,1350549266
2157,63429822693,37581,63429860274,4,0,0,20992,4,4879960616
2158,63429929497,562,63429930059,5,0,0,512,5,5836223865
2159,63429962697,52672,63430015369,3,0,1,4096,3,3695271165
2160,63430002103,182620,63430184723,8,0,0,295424,8,2454082564
2161,63430015534,159056,63430174590,5,0,1,5120,5,4675664617
2162,63430026013,285468,63430311481,5,0,0,512,5,6318602156
2163,63430303007,44056,63430347063,7,0,1,1024,7,6003695100
2164,63430332209,42679,63430374888,8,0,1,6144,8,7946175586
2165,63430336664,50668,63430387332,4,0,1,2560,4,7968476306
2166,63430342383,2266,63430344649,8,0,0,69632,8,2386738803
2167,63430380742,62512,63430443254,2,0,1,1024,2,7158315903
2168,63430385077,82379,63430467456,5,0,0,1536,5,7931092558
2169,63430405838,41387,63430447225,8,0,1,18944,8,5114883066
2170,63430436420,30745,63430467165,8,0,0,67072,8,10055263988
2171,63430498523,155262,63430653785,3,0,0,49664,3,428535088
2172,63430555134,7226,63430562360,1,0,1,10752,1,7692831000
2173,63430608773,122843,63430731616,7,0,1,5632,7,9215174155
2174,63430662190,104850,63430767040,9,0,0,7680,9,2374461870
2175,63430695751,43900,63430739651,8,0,1,512,8,4395887530
2176,63430843216,7226,63430850442,2,0,0,7680,2,2386763155
2177,63430865492,14800,63430880292,9,0,0,28672,9,4348276203
2178,63430889496,25442,63430914938,9,0,0,46080,9,4571868088
2179,63431017014,48976,63431065990,3,0,1,2048,3,9777690802
2180,63431139099,41645,63431180744,3,0,1,14848,3,4138765441
2181,63431172433,91276,63431263709,7,0,0,67584,7,886108896
2182,63431240659,51019,63431291678,2,0,1,2560,2,3295121659
2183,63431266669,86404,63431353073,5,0,1,24064,5,8474551300
2184,63431373654,3418,63431377072,4,0,1,34304,4,8263891386
2185,63431390757,6274,63431397031,8,0,0,3584,8,5003083621
2186,63431398554,101812,63431500366,3,0,0,6656,3,9242229893
2187,63431408338,62552,63431470890,9,0,1,1024,9,7622686194
2188,63431413861,80370,63431494231,7,0,1,3072,7,7111494267
2189,63431518517,21654,63431540171,4,0,0,35328,4,9604537999
2190,63431589978,116567,63431706545,4,0,0,193536,4,9923975261
2191,63431618114,75152,63431693266,1,0,1,512,1,7890457437
2192,63431623783,22170,63431645953,7,0,1,3584,7,3173071399
2193,63431642120,35050,63431677170,8,0,0,43008,8,5697767649
2194,63431739533,228736,63431968269,2,0,0,36352,2,9278212685
2195,63431770392,76793,63431847185,8,0,0,61440,8,2560686106
2196,63431786197,10237,63431796434,4,0,0,120320,4,6364332239
2197,63431863949,294638,63432158587,7,0,0,16384,7,10501497900
2198,63431960863,127208,63432088071,8,0,0,210944,8,10483953402
2199,63431961465,130152,63432091617,0,0,0,5632,0,3367909720
2200,63431997152,46367,63432043519,1,0,1,5120,1,10681649267
2201,63432060701,21362,63432082063,4,0,0,49152,4,2308254179
2202,63432085860,235778,63432321638,0,0,0,8704,0,1629973536
2203,63432416523,21654,63432438177,4,0,0,35328,4,5325732956
2204,63432458575,43196,63432501771,9,0,1,24576,9,9601128989
2205,63432555529,147961,63432703490,0,0,0,70656,0,8498456316
2206,63432594824,11723,63432606547,1,0,0,1024,1,10059543233
2207,63432605480,1038,63432606518,2,0,1,34304,2,3669804442
2208,63432704493,144841,63432849334,8,0,1,2048,8,6860610956
2209,63432713947,84300,63432798247,5,0,0,1024,5,2956407522
2210,63432726340,48976,63432775316,0,0,1,22528,0,10068425003
2211,63432751335,22726,63432774061,0,0,1,2048,0,524053671
2212,63432788746,101853,63432890599,9,0,0,37376,9,1055097603
2213,63432808726,1038,63432809764,9,0,1,4608,9,10192664098
2214,63432852751,98404,63432951155,5,0,0,1024,5,5846471171
2215,63432936174,50668,63432986842,7,0,1,2560,7,8637813335
2216,63432980964,76852,63433057816,5,0,1,17920,5,4884250283
2217,63433052555,66890,63433119445,9,0,0,99840,9,772413162
2218,63433097122,22989,63433120111,1,0,0,1024,1,620441153
2219,63433100635,30715,63433131350,4,0,0,37376,4,7686461045
2220,63433113242,25183,63433138425,1,0,1,1536,1,3546263610
2221,63433149080,63358,63433212438,1,0,1,1536,1,4492996576
2222,63433165746,215483,63433381229,3,0,1,32768,3,1626370825
2223,63433167541,196065,63433363606,8,0,0,45568,8,605618919
2224,63433214356,23204,63433237560,9,0,0,106496,9,6388872641
2225,63433298738,241957,63433540695,5,0,1,1536,5,9412597278
2226,63433360003,109444,63433469447,9,0,0,38400,9,6625936489
2227,63433363504,114449,63433477953,2,0,1,11776,2,2487161456
2228,63433380900,104721,63433485621,4,0,0,170496,4,8096945561
2229,63433422534,63587,63433486121,8,0,1,1024,8,10597175253
2230,63433428652,104738,63433533390,0,0,0,31744,0,9676128846
2231,63433648108,111488,63433759596,1,0,1,1024,1,3038061380
2232,63433743718,43971,63433787689,7,0,0,72192,7,9714427641
2233,63433902867,1514,63433904381,5,0,0,1536,5,499017036
2234,63433969648,71908,63434041556,5,0,1,11776,5,7604198380
2235,63434035184,76956,63434112140,5,0,1,14336,5,911196302
2236,63434073905,47284,63434121189,3,0,1,1536,3,762914936
2237,63434166061,57436,63434223497,0,0,1,4608,0,7786137059
2238,63434168003,79432,63434247435,5,0,1,11264,5,6460784193
2239,63434187624,74512,63434262136,9,0,1,10240,9,175970943
2240,63434223215,73250,63434296465,9,0,1,10240,9,2269721405
2241,63434254370,129779,63434384149,1,0,1,23552,1,7720755946
2242,63434306064,60746,63434366810,9,0,1,18944,9,6848911909
2243,63434324506,84971,63434409477,8,0,1,3584,8,3807916610
2244,63434349674,89471,63434439145,8,0,1,10240,8,4467285235
2245,63434428601,48976,63434477577,4,0,1,2048,4,6965774837
2246,63434441062,77608,63434518670,7,0,1,15360,7,7888694057
2247,63434507870,45592,63434553462,2,0,1,1024,2,3699978451
2248,63434570350,97600,63434667950,6,0,1,20480,6,1460211453
2249,63434574299,129423,63434703722,1,0,1,16896,1,156836360
2250,63434750090,56368,63434806458,1,0,1,6144,1,7354096761
2251,63434856604,54354,63434910958,2,0,0,89088,2,603240105
2252,63434976701,36342,63435013043,0,0,0,64000,0,2858015565
2253,63435019053,23979,63435043032,2,0,0,39936,2,8369346643
2254,63435020353,62570,63435082923,3,0,1,10752,3,6203097063
2255,63435022304,47577,63435069881,3,0,0,87552,3,10140791405
2256,63435047615,127881,63435175496,0,0,0,32768,0,6219728925
2257,63435116925,119651,63435236576,5,0,1,6656,5,7007959648
2258,63435507966,64204,63435572170,1,0,1,6656,1,6106356133
2259,63435598522,16609,63435615131,4,0,0,32256,4,6071782075
2260,63435692797,4933,63435697730,8,0,0,12800,8,9582970234
2261,63435707658,60820,63435768478,7,0,1,15872,7,4077577041
2262,63435729080,54364,63435783444,9,0,1,5632,9,7485305618
2263,63435776075,167172,63435943247,8,0,1,4608,8,10589917465
2264,63435781079,111871,63435892950,4,0,1,14848,4,9351927187
2265,63435828562,93733,63435922295,4,0,0,155648,4,27934317
2266,63435934718,4158,63435938876,1,0,1,3584,1,1391616821
2267,63435944070,69280,63436013350,6,0,1,28160,6,3101909234
2268,63435959246,129091,63436088337,8,0,1,8192,8,3880255916
2269,63435959708,203223,63436162931,1,0,1,8704,1,1709908699
2270,63435984953,213678,63436198631,0,0,0,11264,0,6787887148
2271,63436252356,23979,63436276335,2,0,0,39936,2,3441703136
2272,63436305874,95157,63436401031,4,0,1,9728,4,10104272717
2273,63436387187,72279,63436459466,3,0,1,8704,3,8503868437
2274,63436397515,104763,63436502278,9,0,0,117248,9,1430053393
2275,63436402154,158109,63436560263,3,0,0,210432,3,9821239259
2276,63436412002,152032,63436564034,4,0,1,19456,4,4488157366
2277,63436441529,24925,63436466454,2,0,1,7168,2,6027639833
2278,63436529144,8010,63436537154,9,0,1,19968,9,8498503407
2279,63436569624,264974,63436834598,8,0,0,45056,8,10492371559
2280,63436588165,110787,63436698952,5,0,0,2560,5,9735054177
2281,63436609922,83696,63436693618,6,0,1,2560,6,9987321989
2282,63436650231,235049,63436885280,4,0,0,136192,4,9469921505
2283,63436753446,88936,63436842382,1,0,1,6144,1,3993651034
2284,63436819452,86708,63436906160,0,0,0,145408,0,3676710359
2285,63436822282,89779,63436912061,0,0,0,28160,0,5976532148
2286,63436837319,81258,63436918577,2,0,0,31232,2,5116115347
2287,63436934500,32812,63436967312,8,0,0,53760,8,1842602891
2288,63437051806,4158,63437055964,3,0,1,512,3,5650378937
2289,63437054761,87794,63437142555,8,0,0,11264,8,2574118294
2290,63437081612,136794,63437218406,7,0,1,9216,7,9638572723
2291,63437102059,115060,63437217119,2,0,1,34304,2,4362990389
2292,63437106746,112880,63437219626,8,0,1,8192,8,7884893624
2293,63437153425,156550,63437309975,0,0,0,258048,0,9422784969
2294,63437154631,155690,63437310321,0,0,0,512,0,6554790456
2295,63437186143,61925,63437248068,8,0,1,3584,8,3959989111
2296,63437259226,151015,63437410241,4,0,0,35328,4,8699279012
2297,63437285945,67489,63437353434,0,0,0,113664,0,4225261801
2298,63437322935,87225,63437410160,0,0,0,146432,0,10126147808
2299,63437343101,208161,63437551262,2,0,1,1536,2,2064031589
2300,63437443073,102137,63437545210,3,0,1,22016,3,4432050012
2301,63437460438,171603,63437632041,7,0,0,165376,7,3281293421
2302,63437541520,4724,63437546244,7,0,1,3072,7,10564198896
2303,63437611458,135128,63437746586,1,0,0,1536,1,9625153419
2304,63437734400,63962,63437798362,0,0,0,104448,0,5439405003
2305,63437773634,35558,63437809192,2,0,0,43520,2,2815205710
2306,63437846311,7702,63437854013,1,0,0,8192,1,4323746065
2307,63437891646,13508,63437905154,6,0,1,7168,6,2709530561
2308,63437928315,65896,63437994211,7,0,0,26112,7,3705040242
2309,63437947017,24150,63437971167,9,0,0,43520,9,1135154370
2310,63437951988,4158,63437956146,2,0,1,512,2,3151818007
2311,63437993823,87886,63438081709,0,0,1,8704,0,2559776973
2312,63438014949,194969,63438209918,2,0,0,11264,2,8744339352
2313,63438216317,1038,63438217355,5,0,0,1024,5,1531353962
2314,63438272953,26475,63438299428,2,0,0,48128,2,3216188946
2315,63438469109,54052,63438523161,1,0,1,3584,1,711945825
2316,63438518158,43900,63438562058,8,0,1,512,8,1466699308
2317,63438587147,70372,63438657519,3,0,1,11776,3,20693081
2318,63438629130,43624,63438672754,7,0,0,74752,7,9444731098
2319,63438680484,562,63438681046,1,0,0,512,1,2689284504
2320,63438697217,71464,63438768681,7,0,1,4096,7,4484165262
2321,63438713028,31262,63438744290,0,0,1,15360,0,1872957490
2322,63438815338,2466,63438817804,2,0,0,50688,2,7360129717
2323,63438840487,183697,63439024184,1,0,1,512,1,8690285605
2324,63438862228,43900,63438906128,1,0,0,2560,1,8354930991
2325,63438977196,100408,63439077604,9,0,1,29696,9,9080660134
2326,63439028816,21886,63439050702,3,0,1,20992,3,5035797153
2327,63439069476,95630,63439165106,3,0,0,26624,3,6365337327
2328,63439097158,562,63439097720,5,0,1,11776,5,6915039619
2329,63439133118,81124,63439214242,1,0,0,512,1,4475629281
2330,63439152973,45950,63439198923,2,0,0,79360,2,7987579717
2331,63439341394,79456,63439420850,5,0,1,16384,5,3064368970
2332,63439360561,71245,63439431806,2,0,0,115200,2,7638733381
2333,63439369012,7702,63439376714,7,0,1,3584,7,1871404382
2334,63439437972,3894,63439441866,7,0,0,8192,7,7170933116
2335,63439444803,128686,63439573489,5,0,0,4096,5,3938513497
2336,63439477893,46984,63439524877,0,0,0,81408,0,5195465010
2337,63439520985,103393,63439624378,2,0,1,32768,2,6818403468
2338,63439699731,54676,63439754407,1,0,1,5632,1,971422169
2339,63439717835,76048,63439793883,1,0,1,10240,1,3049482183
2340,63439794287,52360,63439846647,3,0,1,3072,3,1217999161
2341,63439796301,92529,63439888830,2,0,0,150016,2,1426535824
2342,63439859987,13854,63439873841,8,0,1,1024,8,291611289
2343,63439875049,45592,63439920641,1,0,1,2560,1,1462187572
2344,63439884129,167149,63440051278,8,0,0,23552,8,7489202081
2345,63439928628,202072,63440130700,1,0,1,1024,1,5940442650
2346,63440049079,35825,63440084904,1,0,0,62976,1,8998620584
2347,63440135818,14283,63440150101,8,0,0,27648,8,403893852
2348,63440140290,30735,63440171025,7,0,0,48640,7,1927846997
2349,63440148961,34178,63440183139,1,0,0,39936,1,21112919
2350,63440163350,34251,63440197601,4,0,0,47616,4,8609945615
2351,63440176011,1038,63440177049,4,0,1,1536,4,1902537556
2352,63440197574,61131,63440258705,5,0,0,1024,5,3060221874
2353,63440259832,23462,63440283294,9,0,1,29184,9,10170258538
2354,63440297640,100252,63440397892,0,0,0,38912,0,9007812071
2355,63440462346,70972,63440533318,0,0,1,8704,0,5271452109
2356,63440509716,11529,63440521245,5,0,1,3072,5,2381426512
2357,63440525948,52360,63440578308,8,0,0,18944,8,2910995742
2358,63440545923,43900,63440589823,9,0,1,512,9,9066198685
2359,63440689063,75033,63440764096,2,0,0,125952,2,1364066699
2360,63440783945,26217,63440810162,1,0,0,47616,1,5787046797
2361,63440851548,1990,63440853538,7,0,0,2048,7,2907760324
2362,63440880690,141691,63441022381,7,0,1,19968,7,1972786434
2363,63440996857,74668,63441071525,9,0,1,10752,9,7495336859
2364,63441035278,36258,63441071536,8,0,0,57856,8,8478573191
2365,63441064606,10753,63441075359,1,0,0,17408,1,964432911
2366,63441103145,5798,63441108943,3,0,1,2560,3,2187031426
2367,63441154276,133054,63441287330,0,0,1,33792,0,3480844321
2368,63441219981,101656,63441321637,7,0,0,6144,7,2951627164
2369,63441258733,55744,63441314477,2,0,1,4096,2,2677691664
2370,63441276566,103170,63441379736,7,0,0,167424,7,10113487465
2371,63441316930,95089,63441412019,0,0,0,105472,0,5448438051
2372,63441413144,40612,63441453756,4,0,1,512,4,1147283842
2373,63441485024,112194,63441597218,6,0,1,21504,6,2004496632
2374,63441487476,121313,63441608789,0,0,0,65536,0,647065193
2375,63441493041,208707,63441701748,1,0,1,7168,1,7950101579
2376,63441500434,122900,63441623334,1,0,0,192000,1,5154525502
2377,63441507402,163131,63441670533,0,0,1,23552,0,9593033558
2378,63441512609,290009,63441802618,7,0,0,177152,7,4691062549
2379,63441611118,87484,63441698602,4,0,1,2048,4,799208800
2380,63441666277,247143,63441913420,1,0,1,7680,1,7067474063
2381,63441717978,289635,63442007613,5,0,1,9728,5,870154806
2382,63441763689,75291,63441838980,9,0,0,146944,9,886203418
2383,63441864368,70651,63441935019,3,0,1,19968,3,5787232729
2384,63441883243,53170,63441936413,1,0,0,126464,1,8599633962
2385,63441894296,252724,63442147020,0,0,0,30720,0,233439798
2386,63441902928,157230,63442060158,2,0,1,12800,2,711706284
2387,63441912955,135751,63442048706,8,0,0,13824,8,4647418862
2388,63441953489,6750,63441960239,5,0,1,4096,5,1755276014
2389,63442006357,163474,63442169831,5,0,1,1536,5,2264728416
2390,63442082975,72664,63442155639,4,0,1,9216,4,2518955211
2391,63442108443,158126,63442266569,9,0,0,7168,9,4056510162
2392,63442118895,96874,63442215769,4,0,1,4096,4,4954935726
2393,63442204788,48976,63442253764,2,0,1,30720,2,2137160376
2394,63442232920,100720,63442333640,4,0,1,2048,4,2355357229
2395,63442336751,1990,63442338741,5,0,0,2048,5,9979431217
2396,63442355088,6750,63442361838,4,0,0,7168,4,1931831741
2397,63442357884,51253,63442409137,0,0,1,5632,0,4736920426
2398,63442358658,60820,63442419478,2,0,0,82944,2,6532363083
2399,63442371161,115480,63442486641,8,0,0,166400,8,740829048
2400,63442418270,140469,63442558739,1,0,0,201216,1,4377286894
2401,63442419211,62154,63442481365,1,0,1,26112,1,2266307071
2402,63442428568,37548,63442466116,2,0,1,59904,2,7290630312
2403,63442471795,206962,63442678757,9,0,1,2560,9,9314068150
2404,63442481104,212594,63442693698,8,0,1,10752,8,3464119873
2405,63442529316,278899,63442808215,9,0,0,100864,9,6286023197
2406,63442554178,93562,63442647740,1,0,0,9216,1,5438443885
2407,63442652118,271470,63442923588,4,0,0,152064,4,16667884
2408,63442748247,42420,63442790667,9,0,0,69120,9,10463776699
2409,63442764526,157431,63442921957,3,0,1,18432,3,10265007334
2410,63442982072,52659,63443034731,2,0,1,4096,2,926220188
2411,63443250257,107217,63443357474,2,0,0,178688,2,1963727194
2412,63443305580,67959,63443373539,9,0,0,60416,9,6476606011
2413,63443373058,174577,63443547635,0,0,1,512,0,79980153
2414,63443457340,72851,63443530191,2,0,1,9216,2,62600313
2415,63443507269,86692,63443593961,7,0,1,5120,7,5566698915
2416,63443538409,179666,63443718075,3,0,1,19968,3,8085112846
2417,63443633267,110392,63443743659,6,0,1,62464,6,2943041454
2418,63443693134,58372,63443751506,5,0,1,7680,5,8855374934
2419,63443831201,52360,63443883561,4,0,1,3072,4,3798945410
2420,63443870401,52360,63443922761,4,0,1,12800,4,1228971609
2421,63443877012,73756,63443950768,0,0,1,3072,0,7356326348
2422,63443937451,23116,63443960567,9,0,0,41472,9,1355226477
2423,63443966851,45592,63444012443,0,0,1,1024,0,1363089122
2424,63443969734,89626,63444059360,1,0,1,7168,1,618154654
2425,63443975756,94766,63444070522,0,0,1,61952,0,2519799312
2426,63444021967,61637,63444083604,7,0,0,157696,7,1904656018
2427,63444025947,182754,63444208701,0,0,1,11776,0,4612064200
2428,63444108150,254016,63444362166,8,0,0,99840,8,6369341535
2429,63444326541,83461,63444410002,2,0,1,13312,2,10366434191
2430,63444334525,98808,63444433333,0,0,1,10240,0,6227081959
2431,63444451772,83908,63444535680,0,0,1,15872,0,10638617699
2432,63444485190,72576,63444557766,6,0,1,1536,6,9821762671
2433,63444515845,55744,63444571589,0,0,1,4096,0,1016675650
2434,63444589089,57436,63444646525,1,0,1,27136,1,5406344364
2435,63444591536,99628,63444691164,7,0,1,4608,7,6239025669
2436,63444624367,70896,63444695263,0,0,1,7168,0,9870127604
2437,63444643022,88379,63444731401,5,0,1,8704,5,2064661064
2438,63444672783,77680,63444750463,0,0,1,4608,0,3256492430
2439,63444676343,96833,63444773176,8,0,0,161792,8,7689630946
2440,63444687259,92638,63444779897,9,0,0,32256,9,9348506394
2441,63444695715,87088,63444782803,5,0,0,4608,5,6568325101
2442,63444779742,11012,63444790754,6,0,1,1024,6,6892700164
2443,63444828575,1990,63444830565,1,0,1,11264,1,419010619
2444,63444830160,45950,63444876110,0,0,1,4096,0,3689088540
2445,63444837631,189310,63445026941,2,0,0,17920,2,9456071066
2446,63444884141,150618,63445034759,4,0,0,2048,4,991468079
2447,63444908804,23374,63444932178,7,0,0,79360,7,5719595247
2448,63444969639,182377,63445152016,2,0,0,41984,2,5291636669
2449,63445037953,100078,63445138031,1,0,1,2048,1,4500527979
2450,63445101341,43883,63445145224,3,0,0,75264,3,4448492836
2451,63445212210,72537,63445284747,9,0,0,117760,9,4477158203
2452,63445246408,55018,63445301426,1,0,0,63488,1,5192882872
2453,63445314365,50995,63445365360,9,0,1,6656,9,5733904485
2454,63445337338,33587,63445370925,7,0,0,82432,7,1975685991
2455,63445445103,183660,63445628763,4,0,0,55296,4,4398050224
2456,63445486188,54008,63445540196,2,0,0,91648,2,9658445643
2457,63445598415,562,63445598977,2,0,0,512,2,2423975019
2458,63445646073,85557,63445731630,8,0,1,11776,8,5880615480
2459,63445720414,53491,63445773905,3,0,0,90624,3,4101541417
2460,63445746189,53637,63445799826,0,0,0,82944,0,745547607
2461,63445794056,78732,63445872788,8,0,1,5120,8,978793996
2462,63445853713,34363,63445888076,3,0,0,56832,3,10406807483
2463,63445859961,28781,63445888742,5,0,0,1024,5,3158597360
2464,63445897022,23374,63445920396,0,0,0,41984,0,8455903773
2465,63445949873,98536,63446048409,4,0,1,23552,4,908334227
2466,63446040425,102280,63446142705,0,0,1,35840,0,10078614157
2467,63446114794,27922,63446142716,1,0,0,40448,1,7196950216
2468,63446184491,5450,63446189941,1,0,0,13824,1,4318489693
2469,63446225080,45592,63446270672,0,0,1,12800,0,9374178887
2470,63446279310,156180,63446435490,4,0,1,1024,4,1396002835
2471,63446320364,65166,63446385530,4,0,0,110080,4,324350744
2472,63446432406,57436,63446489842,1,0,1,4608,1,8519877328
2473,63446499115,59284,63446558399,6,0,1,5632,6,1522659391
2474,63446644594,49347,63446693941,8,0,1,13312,8,646739161
2475,63446666069,75448,63446741517,0,0,1,2048,0,8666834552
2476,63446863631,43900,63446907531,3,0,1,512,3,4996958806
2477,63446955761,44141,63446999902,0,0,0,75776,0,683848993
2478,63447088249,50668,63447138917,7,0,1,2560,7,2436478992
2479,63447142905,97756,63447240661,9,0,1,20992,9,5844305557
2480,63447269393,57904,63447327297,9,0,1,6144,9,4361386613
2481,63447407656,72664,63447480320,4,0,1,9216,4,5277154506
2482,63447459596,54052,63447513648,4,0,1,3584,4,8063752652
2483,63447521393,1990,63447523383,4,0,1,14848,4,4866839294
2484,63447525871,1990,63447527861,5,0,0,2048,5,1285269642
2485,63447533537,91276,63447624813,5,0,0,2048,5,1916657015
2486,63447599825,55744,63447655569,7,0,1,4096,7,2220798743
2487,63447690197,100564,63447790761,0,0,1,30208,0,5647413912
2488,63447859564,1990,63447861554,3,0,1,20480,3,10512529387
2489,63447914005,5450,63447919455,5,0,0,2048,5,596083467
2490,63447929307,85312,63448014619,7,0,0,13824,7,3592124677
2491,63448008970,52360,63448061330,9,0,1,3072,9,56066956
2492,63448081920,30487,63448112407,4,0,0,49152,4,3424394094
2493,63448083641,1038,63448084679,0,0,1,11776,0,7513322514
2494,63448115116,77532,63448192648,9,0,0,1024,9,9149151922
2495,63448200438,32037,63448232475,3,0,0,52224,3,6240948469
2496,63448238043,82145,63448320188,8,0,1,403968,8,4342392584
2497,63448252796,18940,63448271736,7,0,0,133120,7,271306908
2498,63448266804,1514,63448268318,7,0,1,512,7,1561553922
2499,63448316667,455105,63448771772,5,0,0,1024,5,4309977666
2500,63448485467,426511,63448911978,5,0,0,1536,5,9342693172
2501,63448510494,151370,63448661864,8,0,1,68096,8,3099419561
2502,63448541972,203607,63448745579,8,0,0,146944,8,8150565257
2503,63448565634,185051,63448750685,1,0,0,64512,1,4883291585
2504,63448597155,117997,63448715152,8,0,1,56320,8,2237962827
2505,63448648456,78851,63448727307,6,0,1,3072,6,8397358863
2506,63448719418,39797,63448759215,8,0,0,105472,8,3393829026
2507,63448734023,38739,63448772762,4,0,1,12800,4,501970736
2508,63448761058,2466,63448763524,8,0,0,4096,8,6975154046
2509,63448778386,122113,63448900499,3,0,0,61440,3,6215393614
2510,63448824506,292225,63449116731,5,0,0,2560,5,1186329566
2511,63448863373,218344,63449081717,3,0,1,38400,3,1145775661
2512,63448880316,220395,63449100711,9,0,1,512,9,1196575827
2513,63449079931,24238,63449104169,4,0,1,2560,4,2043982852
2514,63449103026,52446,63449155472,2,0,0,40448,2,8712425224
2515,63449183688,2866,63449186554,9,0,1,7168,9,4341592470
2516,63449194507,56680,63449251187,9,0,0,8704,9,2245473846
2517,63449217074,23305,63449240379,3,0,0,34304,3,6818112636
2518,63449424231,2942,63449427173,5,0,0,3072,5,3198449766
2519,63449464676,107475,63449572151,9,0,0,179200,9,5280577208
2520,63449502106,75434,63449577540,9,0,0,17408,9,8037360830
2521,63449523402,99291,63449622693,3,0,1,3072,3,2983093750
2522,63449618237,12045,63449630282,2,0,0,19968,2,10021477898
2523,63449679131,14283,63449693414,4,0,0,27648,4,764719497
2524,63449740903,48976,63449789879,9,0,1,2048,9,1557652425
2525,63449804644,46984,63449851628,3,0,0,81408,3,1714281465
2526,63449831454,50824,63449882278,0,0,1,3072,0,8756942903
2527,63449916099,1038,63449917137,0,0,0,1024,0,847483820
2528,63450036248,1514,63450037762,7,0,0,1536,7,7079746486
2529,63450114791,6274,63450121065,5,0,1,3584,5,4164600052
2530,63450123993,54052,63450178045,9,0,1,10752,9,5638367924
2531,63450161037,562,63450161599,5,0,0,6656,5,7729387772
2532,63450194203,78544,63450272747,5,0,0,512,5,7822723185
2533,63450450357,23462,63450473819,2,0,0,38912,2,1906364791
2534,63450537187,1990,63450539177,5,0,0,2048,5,9745832006
2535,63450557273,165383,63450722656,2,0,0,271872,2,3357207031
2536,63450627696,71841,63450699537,2,0,1,11776,2,4053782304
2537,63450676839,42937,63450719776,3,0,0,91648,3,3900057242
2538,63450679079,46583,63450725662,5,0,1,38400,5,3994331768
2539,63450758928,47130,63450806058,3,0,0,70144,3,1709154288
2540,63450761900,202227,63450964127,7,0,0,23552,7,8814446379
2541,63450772592,285601,63451058193,1,0,0,45568,1,8752126227
2542,63450787380,182505,63450969885,6,0,1,9216,6,1889132462
2543,63450848872,30487,63450879359,1,0,1,11264,1,278009322
2544,63450972597,231865,63451204462,0,0,1,13824,0,4692412209
2545,63451025895,131120,63451157015,2,0,0,49152,2,10149808788
2546,63451035425,80528,63451115953,9,0,0,125952,9,5037973774
2547,63451099478,43900,63451143378,0,0,1,44032,0,6609224307
2548,63451186266,86708,63451272974,3,0,1,512,3,3662768787
2549,63451222907,79430,63451302337,4,0,0,145408,4,10090479714
2550,63451241936,245203,63451487139,0,0,0,48128,0,5867341737
2551,63451249299,38109,63451287408,1,0,1,26112,1,6251318122
2552,63451306583,171678,63451478261,4,0,0,55808,4,3387338382
2553,63451327310,157668,63451484978,2,0,1,2560,2,3912237846
2554,63451363821,102495,63451466316,8,0,1,83968,8,1739545941
2555,63451422254,65386,63451487640,9,0,1,15360,9,4705755366
2556,63451478221,93460,63451571681,4,0,1,512,4,4758168400
2557,63451513130,107365,63451620495,5,0,1,3584,5,648413942
2558,63451525932,372274,63451898206,2,0,1,22016,2,2643680514
2559,63451575731,122144,63451697875,5,0,1,1024,5,579031508
2560,63451614742,161478,63451776220,4,0,1,2560,4,509065644
2561,63451748043,4846,63451752889,4,0,0,5120,4,8354639483
2562,63451827908,45950,63451873858,8,0,0,79360,8,2038849655
2563,63451996418,562,63451996980,4,0,1,31232,4,5613901372
2564,63452013805,100876,63452114681,5,0,0,512,5,1630903103
2565,63452035993,111952,63452147945,6,0,1,13312,6,4098734804
2566,63452066394,92270,63452158664,8,0,1,67584,8,6110379988
2567,63452105901,34363,63452140264,9,0,0,149504,9,2445619522
2568,63452268683,335821,63452604504,0,0,0,56832,0,1302614161
2569,63452286287,2466,63452288753,3,0,1,2048,3,7870847420
2570,63452396676,147310,63452543986,1,0,0,2560,1,2348467842
2571,63452427851,48976,63452476827,5,0,1,2048,5,2157632708
2572,63452455445,165988,63452621433,1,0,0,269824,1,6415204505
2573,63452488512,101599,63452590111,2,0,1,15872,2,9733119464
2574,63452524340,78472,63452602812,9,0,0,7168,9,3829486049
2575,63452554085,12733,63452566818,9,0,0,23552,9,7296664366
2576,63452627363,276430,63452903793,4,0,0,24576,4,3897400280
2577,63452750692,60663,63452811355,2,0,1,6656,2,6705232618
2578,63452764058,101252,63452865310,5,0,1,3072,5,2603297562
2579,63452792711,137743,63452930454,5,0,1,36352,5,5746808280
2580,63452885924,83776,63452969700,3,0,1,20480,3,3993292174
2581,63452981612,1038,63452982650,5,0,0,1024,5,2731599506
2582,63453004805,43366,63453048171,4,0,0,74240,4,10103796847
2583,63453074737,222862,63453297599,3,0,0,360448,3,1070255152
2584,63453087445,246028,63453333473,8,0,1,20992,8,3025630666
2585,63453088066,216355,63453304421,9,0,0,117248,9,3160631764
2586,63453123436,194637,63453318073,0,0,0,18944,0,7685679062
2587,63453186679,47444,63453234123,0,0,0,133120,0,4033191803
2588,63453259445,327497,63453586942,4,0,1,54784,4,3327407207
2589,63453349425,4370,63453353795,3,0,0,49664,3,7065562050
2590,63453381130,215287,63453596417,9,0,1,5120,9,547338640
2591,63453417887,28597,63453446484,3,0,0,4608,3,1360928493
2592,63453460427,29572,63453489999,1,0,0,27648,1,10188120349
2593,63453468393,106050,63453574443,4,0,0,28672,4,3726745302
2594,63453526494,252985,63453779479,6,0,1,4096,6,8732975625
2595,63453538726,101362,63453640088,7,0,0,163840,7,845676831
2596,63453601289,40079,63453641368,1,0,0,14336,1,5480712381
2597,63453651923,46208,63453698131,8,0,0,79872,8,10056792735
2598,63453684511,4846,63453689357,5,0,1,6144,5,1474847158
2599,63453762903,6484,63453769387,7,0,0,5120,7,8772962565
2600,63453792849,111990,63453904839,3,0,1,7168,3,10238236645
2601,63453828652,247409,63454076061,9,0,1,1536,9,4258581524
2602,63453839709,103747,63453943456,3,0,0,15872,3,2970857514
2603,63453883624,203128,63454086752,9,0,0,328704,9,3460334686
2604,63453897312,219928,63454117240,5,0,1,7680,5,1904494355
2605,63453904138,166839,63454070977,8,0,0,121344,8,3703307743
2606,63453958853,250014,63454208867,9,0,0,2560,9,7673591080
2607,63453964148,213233,63454177381,7,0,0,165376,7,1491918685
2608,63453979433,202774,63454182207,8,0,0,7680,8,5926704706
2609,63454014524,199761,63454214285,8,0,0,104448,8,1589019541
2610,63454031448,254853,63454286301,8,0,0,229888,8,4665667066
2611,63454041743,262803,63454304546,1,0,1,15360,1,6816263336
2612,63454055576,162267,63454217843,9,0,0,104448,9,8595344977
2613,63454118816,215935,63454334751,3,0,0,61952,3,4007256597
2614,63454164978,101474,63454266452,2,0,1,2560,2,7232248706
2615,63454260325,343674,63454603999,0,0,0,96768,0,9789812678
2616,63454391113,5192,63454396305,4,0,0,13312,4,634716507
2617,63454414814,41128,63454455942,1,0,1,12800,1,5950947437
2618,63454425797,34533,63454460330,8,0,0,66560,8,10416035614
2619,63454493250,167761,63454661011,9,0,0,60416,9,2553041892
2620,63454594453,177575,63454772028,4,0,0,292352,4,9377238510
2621,63454660550,159351,63454819901,1,0,1,8704,1,4754166048
2622,63454760424,174562,63454934986,0,0,1,9216,0,6249281367
2623,63454762562,235914,63454998476,3,0,1,7168,3,1069013944
2624,63454781970,265656,63455047626,5,0,1,4096,5,614569224
2625,63454940239,94972,63455035211,3,0,1,16896,3,1520935294
2626,63455267623,7702,63455275325,3,0,0,8192,3,5732642916
2627,63455314196,23891,63455338087,9,0,1,18944,9,8431203052
2628,63455330188,80236,63455410424,4,0,1,18944,4,10469345181
2629,63455331220,4933,63455336153,4,0,0,43008,4,2719205781
2630,63455347370,137407,63455484777,8,0,1,174080,8,9917950064
2631,63455423367,13079,63455436446,2,0,0,12800,2,2988605599
2632,63455443234,2942,63455446176,8,0,1,241664,8,2715969927
2633,63455455304,345178,63455800482,4,0,0,22016,4,3128614352
2634,63455465376,113888,63455579264,1,0,1,25600,1,6382316906
2635,63455503342,94682,63455598024,5,0,0,3072,5,3242650066
2636,63455578679,254105,63455832784,0,0,0,120320,0,10684490060
2637,63455597912,97571,63455695483,4,0,0,90112,4,2527109633
2638,63455650585,410366,63456060951,4,0,0,94720,4,352096124
2639,63455660359,179905,63455840264,2,0,1,12800,2,2574070782
2640,63455673706,197163,63455870869,3,0,0,108544,3,4007057586
2641,63455726917,194181,63455921098,4,0,1,17920,4,4281359160
2642,63455927448,84988,63456012436,3,0,1,512,3,9771263753
2643,63455938321,67769,63456006090,5,0,1,22528,5,10003655751
2644,63455966284,20682,63455986966,9,0,1,9216,9,678565534
2645,63455972213,181998,63456154211,0,0,0,138752,0,10508127630
2646,63456011449,212714,63456224163,3,0,0,72704,3,1438698327
2647,63456063362,15865,63456079227,2,0,0,7680,2,1904401787
2648,63456149962,218367,63456368329,2,0,0,28672,2,7831888617
2649,63456179728,43900,63456223628,2,0,1,14336,2,3811284258
2650,63456195006,89584,63456284590,9,0,1,512,9,6269220293
2651,63456266584,58464,63456325048,1,0,1,4096,1,10359660927
2652,63456269064,107655,63456376719,2,0,1,33280,2,8265853240
2653,63456339276,3894,63456343170,8,0,1,260096,8,3815941846
2654,63456339718,225165,63456564883,4,0,1,512,4,3788740413
2655,63456464021,224898,63456688919,2,0,1,4096,2,9440292482
2656,63456478412,101854,63456580266,0,0,0,4096,0,948143268
2657,63456492066,105247,63456597313,4,0,0,256000,4,6855817375
2658,63456528208,96296,63456624504,3,0,1,7680,3,5524330178
2659,63456542715,229359,63456772074,9,0,0,6144,9,1288955870
2660,63456559761,182576,63456742337,5,0,1,5120,5,8616203444
2661,63456634084,156143,63456790227,3,0,1,1536,3,6466515748
2662,63456753920,91495,63456845415,8,0,0,147968,8,3107166587
2663,63456905102,47284,63456952386,3,0,1,21504,3,2321859219
2664,63456986209,155520,63457141729,3,0,1,1536,3,4031813897
2665,63457135629,100252,63457235881,2,0,1,29184,2,1038830539
2666,63457199799,81190,63457280989,1,0,1,3584,1,107996022
2667,63457257791,52360,63457310151,4,0,1,3072,4,1413811946
2668,63457327445,43900,63457371345,2,0,1,512,2,700515775
2669,63457458485,57109,63457515594,1,0,0,97792,1,10028605269
2670,63457503153,40612,63457543765,0,0,0,65536,0,5696853094
2671,63457565047,76228,63457641275,0,0,1,15872,0,3260790412
2672,63457612082,4370,63457616452,4,0,1,12800,4,6157363727
2673,63457672831,82580,63457755411,7,0,0,4608,7,7345724914
2674,63457693643,163381,63457857024,8,0,0,262656,8,10473717942
2675,63457863320,33499,63457896819,8,0,1,264704,8,9385465024
2676,63457873891,98591,63457972482,1,0,1,1024,1,620581860
2677,63457877308,53088,63457930396,6,0,1,5120,6,2172961304
2678,63457884582,130375,63458014957,2,0,1,5632,2,9812017974
2679,63457906749,1514,63457908263,4,0,0,58368,4,1964883084
2680,63457931032,228079,63458159111,3,0,1,3072,3,4597572865
2681,63457954177,161494,63458115671,0,0,1,3584,0,9280583169
2682,63458029039,401373,63458430412,5,0,0,1536,5,7165815782
2683,63458056226,110091,63458166317,2,0,1,15872,2,5414903541
2684,63458125865,34533,63458160398,6,0,1,8704,6,6213320656
2685,63458195464,13190,63458208654,2,0,0,66048,2,2123013236
2686,63458293518,303302,63458596820,3,0,0,60416,3,9935907410
2687,63458303917,1990,63458305907,3,0,1,3584,3,5776074929
2688,63458317767,257933,63458575700,1,0,0,4608,1,6228904975
2689,63458372541,84465,63458457006,5,0,0,2048,5,4707440653
2690,63458376784,34533,63458411317,2,0,0,60416,2,2225497761
2691,63458419711,45592,63458465303,3,0,1,1536,3,2048035862
2692,63458449261,166322,63458615583,4,0,1,1024,4,494357059
2693,63458576843,56592,63458633435,2,0,0,96768,2,6897559110
2694,63458642510,31779,63458674289,8,0,0,51712,8,9544843588
2695,63458646373,30502,63458676875,9,0,0,4096,9,8936460556
2696,63458649044,63348,63458712392,9,0,1,3584,9,9472898765
2697,63458712365,22946,63458735311,6,0,1,8192,6,8145670260
2698,63458760426,122321,63458882747,2,0,0,37888,2,2360672325
2699,63458824290,7702,63458831992,4,0,1,14336,4,9551542328
2700,63458839524,14283,63458853807,9,0,0,8192,9,848346553
2701,63458931365,171339,63459102704,2,0,0,27648,2,8802456128
2702,63458962110,26475,63458988585,0,0,1,7680,0,7255077758
2703,63458974836,67588,63459042424,8,0,0,48128,8,7802278245
2704,63459011907,1038,63459012945,9,0,1,2048,9,1489496203
2705,63459065539,113888,63459179427,5,0,0,1024,5,7294123866
2706,63459148329,63704,63459212033,3,0,0,103936,3,6630810036
2707,63459242187,62512,63459304699,9,0,1,6144,9,8929492353
2708,63459277511,78398,63459355909,0,0,1,11776,0,1925830268
2709,63459310430,55558,63459365988,2,0,0,94720,2,9711042761
2710,63459319730,46412,63459366142,2,0,0,8704,2,8674117425
2711,63459349556,53837,63459403393,0,0,1,13824,0,309426947
2712,63459369410,128683,63459498093,9,0,0,88064,9,1767241449
2713,63459448548,55558,63459504106,0,0,0,94720,0,7740683420
2714,63459454251,50841,63459505092,3,0,0,1536,3,5016227921
2715,63459460065,50668,63459510733,4,0,1,2560,4,7980203888
2716,63459540591,188891,63459729482,5,0,1,2560,5,9606327221
2717,63459565597,50668,63459616265,3,0,1,2048,3,3974433134
2718,63459642674,60862,63459703536,5,0,1,2560,5,7690135476
2719,63459669232,211774,63459881006,3,0,0,98304,3,4922415839
2720,63459741261,74863,63459816124,3,0,0,122368,3,6275398563
2721,63459784799,32605,63459817404,7,0,0,14336,7,6936989392
2722,63459787421,76151,63459863572,0,0,1,9728,0,4041609823
2723,63459800841,168043,63459968884,2,0,1,1536,2,5894200826
2724,63459847520,185979,63460033499,2,0,0,302080,2,6567643323
2725,63459861575,177928,63460039503,0,0,0,20480,0,311293148
2726,63459878782,96659,63459975441,3,0,1,39424,3,7879265546
2727,63459959118,107234,63460066352,4,0,1,512,4,7187957517
2728,63459963735,76913,63460040648,4,0,0,75264,4,4591509886
2729,63459990099,14105,63460004204,9,0,0,23552,9,145351588
2730,63460053573,92787,63460146360,5,0,0,1024,5,8175598637
2731,63460063125,37073,63460100198,9,0,0,150528,9,7968500333
2732,63460125048,562,63460125610,1,0,0,21504,1,7955124859
2733,63460148131,347384,63460495515,4,0,1,9728,4,8423218228
2734,63460179201,85110,63460264311,5,0,0,512,5,1546705413
2735,63460280134,226232,63460506366,2,0,1,1024,2,6722734211
2736,63460435378,71284,63460506662,0,0,1,9728,0,2525988925
2737,63460455094,115438,63460570532,4,0,1,17408,4,3443788834
2738,63460553752,84688,63460638440,6,0,1,18432,6,6137026533
2739,63460620286,18165,63460638451,9,0,0,29184,9,8799151490
2740,63460679136,94596,63460773732,4,0,0,154112,4,1257619992
2741,63460933693,2466,63460936159,3,0,0,2560,3,69501133
2742,63460980221,13508,63460993729,4,0,0,26112,4,9418368019
2743,63461146016,45748,63461191764,9,0,1,1536,9,9402250395
2744,63461215315,45175,63461260490,0,0,0,77824,0,8970026795
2745,63461238611,4951,63461243562,4,0,1,4608,4,2702081102
2746,63461256205,207373,63461463578,1,0,0,1024,1,3679874094
2747,63461558720,79456,63461638176,6,0,1,16384,6,4460558771
2748,63461863066,45433,63461908499,9,0,0,78336,9,8948518205
2749,63461875614,65421,63461941035,1,0,1,3584,1,8991920675
2750,63461881270,73483,63461954753,9,0,1,24576,9,3598801192
2751,63461905917,141745,63462047662,2,0,0,122880,2,3410861703
2752,63461941523,65307,63462006830,4,0,1,12288,4,6618989344
2753,63461957727,67292,63462025019,0,0,0,106496,0,1089962001
2754,63461979714,18572,63461998286,9,0,0,91136,9,5852548876
2755,63462019729,23721,63462043450,0,0,1,45568,0,982146773
2756,63462028780,128797,63462157577,5,0,0,512,5,9084261672
2757,63462036959,35567,63462072526,3,0,0,39424,3,402743993
2758,63462132208,47449,63462179657,0,0,0,62464,0,7734621993
2759,63462149790,41730,63462191520,9,0,0,79360,9,3958329437
2760,63462156175,6484,63462162659,2,0,0,11264,2,5540256495
2761,63462161028,325295,63462486323,9,0,1,7680,9,8885057248
2762,63462213912,63874,63462277786,0,0,0,15872,0,1953008917
2763,63462260446,239203,63462499649,9,0,1,4608,9,9615892964
2764,63462298659,197559,63462496218,8,0,1,98816,8,9238172971
2765,63462324600,43712,63462368312,3,0,0,107520,3,5443766947
2766,63462438300,248784,63462687084,9,0,0,71680,9,4830081924
2767,63462496912,50550,63462547462,8,0,0,72704,8,9985127375
2768,63462531444,26734,63462558178,1,0,1,4608,1,1863442463
2769,63462654982,236648,63462891630,9,0,0,48640,9,3216401275
2770,63462753579,6225,63462759804,5,0,1,512,5,4681405120
2771,63462866080,131490,63462997570,9,0,0,15360,9,281300486
2772,63462934757,56333,63462991090,1,0,0,96256,1,3646315854
2773,63462963911,44123,63463008034,0,0,1,512,0,2764834351
2774,63463096879,84988,63463181867,2,0,0,138752,2,10734552722
2775,63463107435,21137,63463128572,4,0,1,9728,4,7689196140
2776,63463133853,20731,63463154584,9,0,1,2560,9,2835724380
2777,63463194645,102419,63463297064,2,0,0,34304,2,8660843314
2778,63463200645,175973,63463376618,7,0,0,26624,7,1324549979
2779,63463237432,98528,63463335960,5,0,1,1536,5,5751900141
2780,63463251637,48927,63463300564,1,0,1,17408,1,6500523226
2781,63463309101,3124,63463312225,0,0,1,2048,0,1279111007
2782,63463312875,98631,63463411506,2,0,1,21504,2,5100742871
2783,63463367655,206237,63463573892,8,0,0,9216,8,10058108917
2784,63463568863,68389,63463637252,3,0,1,36352,3,7532947890
2785,63463586656,102436,63463689092,4,0,1,2048,4,7317205415
2786,63463739877,93562,63463833439,7,0,0,152064,7,1237594847
2787,63463755523,98602,63463854125,0,0,0,66048,0,607784492
2788,63463766745,113916,63463880661,4,0,0,94208,4,7298458028
2789,63463769383,122824,63463892207,3,0,0,38912,3,7768331463
2790,63464044127,76067,63464120194,4,0,0,128000,4,3979391305
2791,63464047736,44352,63464092088,3,0,1,12288,3,7664218374
2792,63464081334,53491,63464134825,9,0,0,26112,9,5161063605
2793,63464126478,166192,63464292670,1,0,0,90624,1,995425215
2794,63464150460,104059,63464254519,5,0,1,2048,5,8067782172
2795,63464394534,44916,63464439450,9,0,0,77312,9,9207069041
2796,63464394976,67321,63464462297,1,0,0,75776,1,9031023941
2797,63464413217,55615,63464468832,0,0,1,2560,0,9383988298
2798,63464480202,54847,63464535049,9,0,1,1024,9,4430917091
2799,63464515560,178073,63464693633,2,0,1,25600,2,7913168197
2800,63464670788,84508,63464755296,9,0,1,12800,9,4796426595
2801,63464676482,134258,63464810740,0,0,1,22528,0,3815919294
2802,63464741875,71216,63464813091,3,0,1,7680,3,6740701832
2803,63464745194,83179,63464828373,8,0,0,135168,8,10536615550
2804,63464785988,71419,63464857407,9,0,1,8704,9,632502639
2805,63464837791,2466,63464840257,2,0,1,14336,2,1307300266
2806,63464893046,60820,63464953866,7,0,0,2560,7,3467369312
2807,63464911426,199161,63465110587,6,0,1,5632,6,7344276101
2808,63465048117,1514,63465049631,1,0,0,1536,1,5695279098
2809,63465055549,3418,63465058967,0,0,0,3584,0,8618906937
2810,63465102095,50668,63465152763,3,0,1,2560,3,327685217
2811,63465102642,53749,63465156391,8,0,1,164864,8,7740161060
2812,63465188579,211054,63465399633,4,0,0,91136,4,9848026804
2813,63465310496,64012,63465374508,4,0,1,5632,4,8266568113
2814,63465330096,122745,63465452841,0,0,1,2560,0,5130535209
2815,63465483325,6484,63465489809,0,0,0,15872,0,6759170308
2816,63465523754,23374,63465547128,3,0,0,41984,3,4993516516
2817,63465534037,15037,63465549074,1,0,0,3072,1,7667430128
2818,63465582528,5192,63465587720,0,0,0,13312,0,6948689433
2819,63465593715,121745,63465715460,8,0,1,225280,8,5311623570
2820,63465612218,253677,63465865895,3,0,1,9216,3,720043596
2821,63465619056,177777,63465796833,9,0,1,2560,9,6587117844
2822,63465670094,293454,63465963548,0,0,1,1536,0,1440495651
2823,63465907114,57436,63465964550,1,0,1,4608,1,7871985491
2824,63465954381,15575,63465969956,4,0,0,30208,4,7537826359
2825,63466076877,81748,63466158625,1,0,1,17408,1,2964736446
2826,63466090147,100333,63466190480,2,0,1,13824,2,10696608388
2827,63466139240,56075,63466195315,9,0,0,95744,9,2549443146
2828,63466166150,45742,63466211892,4,0,0,54784,4,1517356088
2829,63466211387,851,63466212238,5,0,0,512,5,8331650137
2830,63466358747,74725,63466433472,9,0,1,24576,9,1740721173
2831,63466378322,151076,63466529398,6,0,1,4608,6,1944663615
2832,63466481267,28567,63466509834,8,0,0,43008,8,5309716438
2833,63466552480,78691,63466631171,8,0,1,49664,8,8199118902
2834,63466561189,106492,63466667681,9,0,1,7168,9,9632409499
2835,63466744211,93436,63466837647,1,0,1,16896,1,5494335771
2836,63466901089,43900,63466944989,9,0,1,512,9,2094063581
2837,63466998517,54988,63467053505,1,0,1,6656,1,7727706359
2838,63467204481,1514,63467205995,3,0,1,12800,3,2843180920
2839,63467214583,73756,63467288339,5,0,0,1536,5,9215736544
2840,63467277295,67298,63467344593,1,0,1,8704,1,4926821659
2841,63467352171,53579,63467405750,0,0,0,87552,0,3618733445
2842,63467440410,84383,63467524793,1,0,0,140800,1,3559439116
2843,63467472928,83124,63467556052,2,0,0,108544,2,4694974681
2844,63467488906,80032,63467568938,2,0,1,35328,2,6675872223
2845,63467496911,99799,63467596710,8,0,0,75264,8,5885871335
2846,63467508710,11787,63467520497,2,0,0,110080,2,9998061464
2847,63467691170,300854,63467992024,2,0,0,19456,2,10293679214
2848,63467739558,72795,63467812353,2,0,0,118272,2,773595497
2849,63467757978,55041,63467813019,9,0,0,11264,9,5999934956
2850,63467793414,26326,63467819740,9,0,0,32256,9,7278858051
2851,63467832504,52360,63467884864,3,0,1,3072,3,736532491
2852,63467835655,46467,63467882122,9,0,1,9216,9,9241437053
2853,63467861569,27430,63467888999,2,0,0,80384,2,1722608035
2854,63467891026,562,63467891588,9,0,0,41472,9,2052301343
2855,63467926059,174127,63468100186,9,0,1,24064,9,1704091743
2856,63468002543,2466,63468005009,5,0,0,512,5,2022971442
2857,63468020714,209884,63468230598,7,0,0,2560,7,8452946879
2858,63468047649,21395,63468069044,5,0,1,15360,5,1160382207
2859,63468217287,224160,63468441447,9,0,0,34816,9,6714808501
2860,63468235657,120615,63468356272,4,0,1,19456,4,4714125863
2861,63468250840,164608,63468415448,1,0,0,270336,1,7578321106
2862,63468263670,158191,63468421861,8,0,0,22528,8,10235467028
2863,63468325331,79259,63468404590,0,0,1,2560,0,6728775385
2864,63468341239,42679,63468383918,8,0,1,39424,8,749783002
2865,63468349015,174355,63468523370,0,0,0,22528,0,4382711262
2866,63468414548,200877,63468615425,4,0,0,69632,4,4322132730
2867,63468627832,104224,63468732056,9,0,1,8704,9,9033351903
2868,63468712323,94240,63468806563,0,0,1,24576,0,5579957387
2869,63468758969,59128,63468818097,1,0,1,5120,1,1056420336
2870,63468827305,16350,63468843655,3,0,0,31744,3,341796798
2871,63468874855,82662,63468957517,9,0,0,134144,9,931084750
2872,63469063191,64420,63469127611,2,0,1,3584,2,4890513202
2873,63469194485,30487,63469224972,2,0,0,49152,2,5676260016
2874,63469205138,35285,63469240423,1,0,0,49152,1,6632778938
2875,63469260074,62412,63469322486,9,0,0,101376,9,2042697784
2876,63469278966,72795,63469351761,0,0,1,512,0,2610451420
2877,63469301759,52110,63469353869,2,0,0,118272,2,2865732568
2878,63469322790,32209,63469354999,7,0,0,512,7,4704392170
2879,63469343459,4933,63469348392,8,0,0,11776,8,7933107814
2880,63469474717,78674,63469553391,4,0,0,12800,4,1858291526
2881,63469483569,299593,63469783162,4,0,1,1024,4,2344658677
2882,63469497977,115133,63469613110,4,0,1,1536,4,80477628
2883,63469570316,47284,63469617600,5,0,1,1536,5,10007978153
2884,63469572151,55176,63469627327,2,0,1,2048,2,72758281
2885,63469575614,106335,63469681949,9,0,1,1536,9,4621637176
2886,63469607699,82507,63469690206,8,0,1,5632,8,1710292310
2887,63469671164,65683,63469736847,3,0,0,111104,3,46858365
2888,63469675209,62624,63469737833,7,0,0,1536,7,3457420866
2889,63469723745,53321,63469777066,0,0,0,87040,0,6343714471
2890,63469863342,56592,63469919934,3,0,0,96768,3,3915655583
2891,63469909641,11164,63469920805,1,0,0,12288,1,4636712991
2892,63469941739,1514,63469943253,3,0,1,16896,3,1716921149
2893,63469980560,142311,63470122871,7,0,0,1536,7,7835439164
2894,63470033869,70990,63470104859,5,0,1,6144,5,3163159084
2895,63470057998,80836,63470138834,2,0,1,15872,2,7517705652
2896,63470086487,106005,63470192492,1,0,1,19456,1,1412347084
2897,63470246258,13079,63470259337,9,0,0,22016,9,890389926
2898,63470283397,61796,63470345193,0,0,1,512,0,8206674190
2899,63470440112,59128,63470499240,2,0,1,5120,2,8718131724
2900,63470557742,23462,63470581204,0,0,0,38912,0,3487132784
2901,63470612796,106648,63470719444,5,0,1,50176,5,7046289884
2902,63470749405,5322,63470754727,5,0,0,5632,5,4055706019
2903,63470763241,82996,63470846237,9,0,1,17920,9,941229001
2904,63470802798,82145,63470884943,8,0,0,133120,8,396970232
2905,63470945803,106804,63471052607,0,0,1,50688,0,2221077431
2906,63471021233,90052,63471111285,5,0,1,15872,5,4954082235
2907,63471083758,178609,63471262367,1,0,0,294400,1,3157567013
2908,63471089679,117961,63471207640,5,0,1,4608,5,8022742550
2909,63471180389,120296,63471300685,3,0,0,122880,3,4645823065
2910,63471188372,63180,63471251552,0,0,0,40960,0,2530482453
2911,63471214953,155406,63471370359,4,0,1,4096,4,3116699997
2912,63471256522,342689,63471599211,8,0,0,44544,8,4363941767
2913,63471351347,169448,63471520795,5,0,1,22016,5,9753264749
2914,63471514403,50284,63471564687,9,0,1,512,9,7162425097
2915,63471547909,83437,63471631346,4,0,0,135680,4,6119773815
2916,63471602087,93675,63471695762,3,0,1,8192,3,2429127671
2917,63471684647,41645,63471726292,2,0,0,67584,2,1369193876
2918,63471742505,164608,63471907113,3,0,0,270336,3,3844513615
2919,63471791398,41637,63471833035,8,0,1,43008,8,3073159760
2920,63471818826,286125,63472104951,8,0,1,440320,8,6403002914
2921,63471865822,51220,63471917042,5,0,0,512,5,35844916
2922,63471920515,52804,63471973319,8,0,1,51712,8,6884112133
2923,63471974967,182019,63472156986,8,0,1,65024,8,217426529
2924,63471985328,3900,63471989228,8,0,1,30208,8,7304017771
2925,63471989092,282879,63472271971,0,0,1,5120,0,9208353295
2926,63472009176,94079,63472103255,3,0,1,20480,3,2673758124
2927,63472069749,58587,63472128336,9,0,0,71168,9,719445450
2928,63472102921,636838,63472739759,7,0,0,86016,7,4023800321
2929,63472176406,550932,63472727338,3,0,0,10752,3,7511044658
2930,63472214773,495334,63472710107,9,0,0,153088,9,1402969743
2931,63472261709,525518,63472787227,0,0,0,38400,0,4090270373
2932,63472328941,159518,63472488459,3,0,1,512,3,9746277264
2933,63472356243,1038,63472357281,3,0,0,29696,3,38516261
2934,63472492729,272520,63472765249,8,0,1,74240,8,1305352383
2935,63472583285,172584,63472755869,5,0,0,1024,5,10174287853
2936,63472610205,25413,63472635618,0,0,1,13312,0,3105366159
2937,63472623946,70840,63472694786,9,0,1,2560,9,9710482064
2938,63472639911,81813,63472721724,7,0,0,40960,7,9676242685
2939,63472726794,85675,63472812469,8,0,0,143360,8,4689860673
2940,63472831435,22429,63472853864,2,0,0,36864,2,3528169096
2941,63472935432,66975,63473002407,1,0,0,113664,1,3337010756
2942,63472950669,22687,63472973356,3,0,1,6144,3,3383147722
2943,63473014007,140790,63473154797,3,0,0,37376,3,9221141051
2944,63473134304,40612,63473174916,4,0,1,9216,4,7606021466
2945,63473176744,6225,63473182969,4,0,0,65536,4,10128427075
2946,63473215295,10495,63473225790,8,0,1,137216,8,9145039110
2947,63473233527,179985,63473413512,8,0,0,15360,8,5418433506
2948,63473250465,42162,63473292627,3,0,0,16896,3,5507893730
2949,63473274456,196553,63473471009,0,0,0,68608,0,4362114302
2950,63473308944,75550,63473384494,4,0,1,1536,4,1138652126
2951,63473338927,57417,63473396344,0,0,1,6144,0,10512218201
2952,63473353685,134258,63473487943,2,0,0,126976,2,8874064696
2953,63473374084,23891,63473397975,4,0,0,3584,4,2833231419
2954,63473411332,21574,63473432906,3,0,1,512,3,6776538898
2955,63473437964,218661,63473656625,7,0,0,43008,7,10465287022
2956,63473446080,123291,63473569371,8,0,0,19456,8,9114860262
2957,63473488489,108728,63473597217,6,0,1,32768,6,8915200171
2958,63473507906,239319,63473747225,1,0,1,12288,1,10165920831
2959,63473511329,186800,63473698129,6,0,1,2048,6,6104052339
2960,63473537135,156455,63473693590,6,0,1,33280,6,5564944541
2961,63473588239,234000,63473822239,8,0,1,68096,8,4658315209
2962,63473630371,179340,63473809711,8,0,1,46080,8,8111536990
2963,63473789383,47284,63473836667,2,0,1,1536,2,1461799421
2964,63473814417,7226,63473821643,0,0,1,10752,0,10120570978
2965,63473853874,77740,63473931614,7,0,0,7680,7,592252101
2966,63473854819,69032,63473923851,6,0,1,7680,6,9633418723
2967,63473981359,45592,63474026951,0,0,1,1024,0,6401097557
2968,63474007632,45592,63474053224,3,0,1,1024,3,3115993145
2969,63474118795,25442,63474144237,8,0,1,128512,8,4714071289
2970,63474131065,130516,63474261581,8,0,0,46080,8,7980031421
2971,63474174671,109056,63474283727,0,0,1,17408,0,6556398988
2972,63474210454,170941,63474381395,4,0,1,16384,4,9625497264
2973,63474259491,179299,63474438790,0,0,1,8192,0,5912640959
2974,63474280701,254549,63474535250,6,0,1,24576,6,678866738
2975,63474473504,31003,63474504507,4,0,0,50176,4,2627403428
2976,63474620397,6750,63474627147,5,0,0,7168,5,8347531236
2977,63474647048,63358,63474710406,3,0,0,106496,3,2043706397
2978,63474762454,137333,63474899787,2,0,0,227328,2,4009642170
2979,63474803851,122472,63474926323,8,0,0,86016,8,1833566348
2980,63474816600,126198,63474942798,7,0,0,62464,7,694162774
2981,63474931441,33587,63474965028,0,0,0,55296,0,2823001223
2982,63474993765,108240,63475102005,2,0,1,22016,2,10364371931
2983,63475082618,23721,63475106339,2,0,0,39424,2,8892356396
2984,63475113998,44141,63475158139,0,0,0,75776,0,9579838716
2985,63475160209,112003,63475272212,1,0,0,181248,1,64011747
2986,63475203916,76104,63475280020,3,0,1,512,3,5629526087
2987,63475236932,156808,63475393740,4,0,0,258560,4,1958017379
2988,63475357068,38618,63475395686,5,0,0,3072,5,9786095509
2989,63475382794,85956,63475468750,5,0,1,1536,5,8201262808
2990,63475446971,112779,63475559750,3,0,0,182784,3,2755760476
2991,63475503343,62411,63475565754,7,0,0,28672,7,5812119585
2992,63475732158,1038,63475733196,7,0,0,1024,7,147886778
2993,63475755495,145182,63475900677,0,0,1,15872,0,4064200737
2994,63475901602,7226,63475908828,2,0,0,7680,2,5163084239
2995,63475974306,70972,63476045278,0,0,1,8704,0,6678730534
2996,63476419873,4158,63476424031,2,0,0,11264,2,6792273102
2997,63476421228,59235,63476480463,1,0,0,97792,1,3545442105
2998,63476504159,84988,63476589147,9,0,0,138752,9,9505066627
2999,63476597474,54096,63476651570,7,0,0,88576,7,4161214203
3000,63476661371,87327,63476748698,6,0,1,10752,6,4291039228
3001,63476802607,62824,63476865431,6,0,1,7168,6,5216819356
3002,63476959900,82216,63477042116,9,0,1,15360,9,2765323128
3003,63477031741,57436,63477089177,3,0,1,50176,3,3521189418
3004,63477042110,5414,63477047524,5,0,1,4608,5,2409401589
3005,63477056131,106648,63477162779,6,0,1,2560,6,3207495740
3006,63477099446,112978,63477212424,9,0,0,5632,9,4077855628
3007,63477130687,11012,63477141699,1,0,1,4608,1,1293090203
3008,63477164599,160911,63477325510,8,0,0,17920,8,9652418608
3009,63477244603,115016,63477359619,4,0,0,190464,4,10175577001
3010,63477326941,10237,63477337178,9,0,1,4608,9,5117416391
3011,63477418564,132164,63477550728,1,0,1,15872,1,10285441517
3012,63477443389,128594,63477571983,2,0,0,16384,2,244815189
3013,63477525970,45950,63477571920,6,0,1,22016,6,10302689484
3014,63477558109,94419,63477652528,4,0,0,79360,4,5825514316
3015,63477666796,2866,63477669662,1,0,1,9728,1,5409452921
3016,63477710243,95800,63477806043,3,0,1,29696,3,5972298273
3017,63477785851,142230,63477928081,0,0,0,8704,0,772305882
3018,63477804166,5857,63477810023,5,0,0,1024,5,4696765239
3019,63477889871,1514,63477891385,5,0,0,1536,5,10072301918
3020,63477893488,69616,63477963104,2,0,1,14336,2,5157365873
3021,63477973559,31003,63478004562,0,0,0,50176,0,2009337554
3022,63478108927,56836,63478165763,9,0,1,7680,9,7742834005
3023,63478123313,73132,63478196445,1,0,1,10752,1,3500716956
3024,63478177416,30745,63478208161,7,0,0,49664,7,5211659389
3025,63478199653,8854,63478208507,5,0,0,512,5,7794698730
3026,63478248884,2466,63478251350,5,0,0,2560,5,3779756688
3027,63478280648,41387,63478322035,3,0,0,67072,3,9032917049
3028,63478298882,29566,63478328448,9,0,0,22528,9,1933957623
3029,63478372865,70996,63478443861,1,0,1,13824,1,9832755633
3030,63478405303,38569,63478443872,2,0,0,64000,2,9416306415
3031,63478431026,93966,63478524992,5,0,1,2560,5,4977620558
3032,63478485586,21137,63478506723,5,0,1,53248,5,6507578233
3033,63478520344,27813,63478548157,4,0,0,34304,4,6066716796
3034,63478528482,107584,63478636066,0,0,0,46080,0,7695277967
3035,63478565059,206656,63478771715,3,0,1,9216,3,1356651177
3036,63478570198,232677,63478802875,8,0,1,217088,8,8046355410
3037,63478773294,6274,63478779568,1,0,1,2048,1,9340715417
3038,63478782746,50992,63478833738,2,0,1,4608,2,4713020052
3039,63478792819,76454,63478869273,7,0,0,6656,7,2039066467
3040,63478936500,10753,63478947253,8,0,0,17408,8,8064980006
3041,63478973365,54525,63479027890,3,0,0,92672,3,3847452
3042,63479107256,54354,63479161610,4,0,1,4608,4,9862359946
3043,63479121926,44756,63479166682,4,0,0,89088,4,9026301407
3044,63479133790,63187,63479196977,2,0,0,3584,2,200940950
3045,63479159572,125731,63479285303,8,0,0,102912,8,6415709267
3046,63479206485,32134,63479238619,2,0,0,51200,2,6993156748
3047,63479216853,133674,63479350527,6,0,1,5120,6,5956593557
3048,63479265637,198401,63479464038,4,0,1,30720,4,1805194731
3049,63479339178,86708,63479425886,1,0,0,145408,1,5781624152
3050,63479396897,201639,63479598536,3,0,1,15360,3,202971641
3051,63479604169,58156,63479662325,0,0,1,1024,0,4359157245
3052,63479644158,84641,63479728799,8,0,1,235520,8,360160021
3053,63479656071,212272,63479868343,1,0,0,141312,1,5498332732
3054,63479688640,167801,63479856441,7,0,0,178176,7,9863180793
3055,63479840010,1514,63479841524,4,0,1,7680,4,9879463922
3056,63479874234,13508,63479887742,5,0,0,1536,5,6204012606
3057,63479877878,562,63479878440,7,0,0,26112,7,5620417573
3058,63479980923,175875,63480156798,5,0,0,512,5,10590869822
3059,63479988624,73571,63480062195,8,0,0,119808,8,7291440362
3060,63480053009,9532,63480062541,0,0,0,512,0,9987961512
3061,63480109820,54783,63480164603,2,0,0,93184,2,8246993352
3062,63480141037,124132,63480265169,9,0,1,24064,9,4565416328
3063,63480254323,63187,63480317510,4,0,0,102912,4,8081191885
3064,63480376281,23116,63480399397,4,0,0,41472,4,2717203809
3065,63480394739,74356,63480469095,6,0,1,9728,6,8145495838
3066,63480548630,48976,63480597606,5,0,1,2048,5,6708378613
3067,63480571174,107896,63480679070,8,0,1,54272,8,1990620293
3068,63480658641,112262,63480770903,7,0,0,181760,7,2881047214
3069,63480781157,1990,63480783147,5,0,0,2048,5,9779717129
3070,63480812011,83866,63480895877,8,0,0,139776,8,82559647
3071,63480874561,33758,63480908319,3,0,1,4608,3,4710958348
3072,63480913479,74426,63480987905,3,0,0,58880,3,6662204146
3073,63480987649,81112,63481068761,5,0,1,7168,5,6184952405
3074,63481002011,82545,63481084556,4,0,0,131072,4,6505394043
3075,63481006172,99678,63481105850,0,0,0,18432,0,8397844383
3076,63481015268,33758,63481049026,9,0,0,92672,9,7374563182
3077,63481017586,195328,63481212914,5,0,1,12800,5,1903876659
3078,63481168353,234301,63481402654,7,0,0,58880,7,3188141963
3079,63481183495,64204,63481247699,3,0,1,3584,3,10708863570
3080,63481199411,116360,63481315771,2,0,1,46592,2,8406110547
3081,63481225835,36083,63481261918,0,0,1,6656,0,8203739200
3082,63481278866,173040,63481451906,2,0,0,63488,2,4207527311
3083,63481299468,96254,63481395722,2,0,1,7680,2,7557752281
3084,63481370988,44821,63481415809,1,0,0,74240,1,9331533080
3085,63481463418,40870,63481504288,0,0,1,33280,0,2739643536
3086,63481490945,178362,63481669307,0,0,0,66048,0,10607988107
3087,63481569752,93750,63481663502,8,0,1,115200,8,953429816
3088,63481570044,177202,63481747246,4,0,1,3584,4,7980859806
3089,63481711942,66524,63481778466,4,0,0,51200,4,9630474406
3090,63481926508,1038,63481927546,5,0,0,1024,5,9033957132
3091,63481981501,43900,63482025401,3,0,1,512,3,3553352868
3092,63482119428,43900,63482163328,5,0,1,512,5,426581812
3093,63482244419,3418,63482247837,7,0,0,3584,7,7970482567
3094,63482328470,23462,63482351932,9,0,0,38912,9,2606966442
3095,63482357774,562,63482358336,5,0,0,512,5,7785137294
3096,63482397245,95113,63482492358,3,0,0,155136,3,10553885936
3097,63482427216,65808,63482493024,1,0,0,11264,1,6403531292
3098,63482495537,145316,63482640853,3,0,1,48640,3,10238999632
3099,63482559545,107036,63482666581,9,0,1,32256,9,4096599262
3100,63482596976,153020,63482749996,3,0,0,247808,3,5706485077
3101,63482809129,33241,63482842370,8,0,1,24064,8,5026234185
3102,63482823982,173305,63482997287,9,0,1,4096,9,2770825832
3103,63482846119,184966,63483031085,3,0,0,57856,3,2943966537
3104,63483004975,26734,63483031709,0,0,0,48640,0,10700033169
3105,63483049883,6750,63483056633,8,0,0,7168,8,6526275651
3106,63483161331,54266,63483215597,7,0,0,92160,7,821010321
3107,63483222275,92787,63483315062,9,0,0,150528,9,6266057374
3108,63483232601,184071,63483416672,9,0,1,10752,9,8863704098
3109,63483315951,1514,63483317465,4,0,1,16384,4,5262058898
3110,63483373594,562,63483374156,0,0,1,12800,0,2188814645
3111,63483427222,172260,63483599482,5,0,1,33280,5,4479342283
3112,63483450963,148047,63483599010,5,0,0,1536,5,4198228675
3113,63483481233,18854,63483500087,5,0,0,512,5,2672884663
3114,63483556426,228885,63483785311,4,0,0,17408,4,4635718178
3115,63483743152,21912,63483765064,4,0,0,35840,4,1041252090
3116,63483748697,17955,63483766652,9,0,0,15872,9,4771490013
3117,63483756540,76295,63483832835,7,0,0,120320,7,4877422137
3118,63483857298,21137,63483878435,4,0,1,1536,4,8482331291
3119,63483882957,55483,63483938440,4,0,0,34304,4,7042441180
3120,63484055459,1038,63484056497,6,0,1,5120,6,4976757612
3121,63484096176,59128,63484155304,8,0,1,148992,8,5452139700
3122,63484098012,25700,63484123712,0,0,0,1024,0,729019325
3123,63484125213,33758,63484158971,3,0,0,46592,3,10051735242
3124,63484144063,20825,63484164888,3,0,0,58880,3,6825439015
3125,63484162385,175156,63484337541,8,0,0,25600,8,10359664320
3126,63484266443,10589,63484277032,1,0,0,14336,1,4980605728
3127,63484275925,147218,63484423143,5,0,1,5120,5,2097564027
3128,63484293941,168750,63484462691,5,0,1,8704,5,7139610752
3129,63484325301,154893,63484480194,5,0,1,39424,5,2307293756
3130,63484420463,202192,63484622655,5,0,1,18944,5,2033836242
3131,63484516307,141243,63484657550,1,0,1,42496,1,6609837252
3132,63484719788,105088,63484824876,8,0,1,45056,8,6213428757
3133,63484764056,117859,63484881915,7,0,0,196096,7,9925444070
3134,63484791475,66896,63484858371,5,0,1,6656,5,5491027183
3135,63484846381,65171,63484911552,8,0,0,100864,8,1104053074
3136,63484848670,146782,63484995452,2,0,0,10752,2,8799162879
3137,63484895058,252404,63485147462,0,0,1,24064,0,9511319692
3138,63484947331,143412,63485090743,0,0,0,232448,0,8886764484
3139,63485032787,58622,63485091409,3,0,0,1024,3,2225083152
3140,63485056457,55740,63485112197,4,0,0,74752,4,4282282864
3141,63485058731,115059,63485173790,2,0,0,157184,2,288324902
3142,63485103243,23116,63485126359,6,0,1,6144,6,1802701937
3143,63485177006,145805,63485322811,0,0,0,41472,0,2396699518
3144,63485178635,96560,63485275195,9,0,1,10240,9,8800672828
3145,63485273591,14417,63485288008,2,0,0,21504,2,8006190352
3146,63485305853,43108,63485348961,3,0,1,2048,3,4454789247
3147,63485371123,144729,63485515852,2,0,1,15360,2,2386439547
3148,63485404105,43900,63485448005,8,0,0,73728,8,5858504072
3149,63485495769,177914,63485673683,5,0,1,512,5,7161947565
3150,63485587172,68056,63485655228,4,0,1,9216,4,2092560156
3151,63485726056,11787,63485737843,2,0,0,19456,2,4930080236
3152,63485738842,14025,63485752867,8,0,0,27136,8,2400156398
3153,63485750094,73444,63485823538,0,0,1,11776,0,7543056984
3154,63485811903,101431,63485913334,0,0,1,16896,0,2672693857
3155,63485892214,50995,63485943209,2,0,0,82432,2,2133614825
3156,63485941764,80549,63486022313,3,0,1,2048,3,9964614996
3157,63486027198,10237,63486037435,0,0,0,16384,0,3515266403
3158,63486055573,51253,63486106826,4,0,0,82944,4,5598540047
3159,63486083653,24159,63486107812,8,0,0,1536,8,10390400919
3160,63486088777,76540,63486165317,0,0,1,16896,0,3399529420
3161,63486098154,112003,63486210157,9,0,0,181248,9,2342722467
3162,63486132771,84876,63486217647,2,0,1,6656,2,7005447461
3163,63486152046,74995,63486227041,9,0,0,56320,9,1884610728
3164,63486172373,65896,63486238269,4,0,1,7680,4,10054691265
3165,63486196672,87988,63486284660,0,0,1,7168,0,4568810719
3166,63486217173,92758,63486309931,5,0,1,1024,5,8538285088
3167,63486260921,220341,63486481262,0,0,0,288768,0,6386301786
3168,63486261171,177422,63486438593,2,0,1,2560,2,5510861955
3169,63486265569,198593,63486464162,4,0,0,90624,4,10271217081
3170,63486297493,45592,63486343085,8,0,1,82944,8,9416644982
3171,63486396302,73249,63486469551,8,0,0,17408,8,3350240926
3172,63486420181,100252,63486520433,4,0,1,1024,4,5352000387
3173,63486435120,22170,63486457290,5,0,1,29184,5,2104435788
3174,63486559012,4416,63486563428,9,0,0,36352,9,2278680602
3175,63486585908,362791,63486948699,2,0,0,11776,2,2393227671
3176,63486600359,64259,63486664618,0,0,1,14336,0,6974068607
3177,63486606678,18548,63486625226,0,0,1,512,0,4120790709
3178,63486615277,179009,63486794286,6,0,1,11776,6,4454599136
3179,63486659375,217897,63486877272,7,0,0,106496,7,889529216
3180,63486711192,22170,63486733362,1,0,0,20992,1,9752311150
3181,63486802491,220391,63487022882,3,0,0,36352,3,7205628967
3182,63486844425,23891,63486868316,0,0,0,43008,0,10453143827
3183,63486867387,21912,63486889299,8,0,0,35840,8,3935956179
3184,63486883621,124967,63487008588,2,0,1,5632,2,8267898367
3185,63486944875,95283,63487040158,3,0,0,158720,3,5368220464
3186,63486987189,113003,63487100192,9,0,1,4608,9,8235323430
3187,63486992723,143223,63487135946,1,0,0,230912,1,9648225147
3188,63487018743,122490,63487141233,1,0,0,16896,1,4537124566
3189,63487023273,15833,63487039106,1,0,1,3072,1,7141440356
3190,63487111076,153795,63487264871,1,0,1,13312,1,5845350136
3191,63487146640,100854,63487247494,2,0,0,30720,2,10078650312
3192,63487174319,328899,63487503218,8,0,0,249344,8,3453417011
3193,63487226219,126764,63487352983,9,0,1,11264,9,4943612869
3194,63487233981,125767,63487359748,8,0,0,24064,8,8654029719
3195,63487249817,309089,63487558906,0,0,1,19456,0,3604265711
3196,63487255651,68775,63487324426,4,0,0,154112,4,3455091024
3197,63487272099,22494,63487294593,0,0,0,49152,0,7849187634
3198,63487364688,273897,63487638585,9,0,1,3584,9,4545688371
3199,63487365656,275835,63487641491,4,0,1,17920,4,5544307526
3200,63487418283,2466,63487420749,2,0,0,33280,2,7460652073
3201,63487526656,177759,63487704415,8,0,0,2560,8,8713952898
3202,63487683141,15058,63487698199,9,0,0,29184,9,151734396
3203,63487737368,34275,63487771643,2,0,0,59904,2,4442774128
3204,63487849836,161659,63488011495,3,0,1,12800,3,3964639841
3205,63488015147,15575,63488030722,6,0,1,1024,6,7932599842
3206,63488023072,75604,63488098676,7,0,0,30208,7,5404375812
3207,63488034273,95053,63488129326,1,0,1,13824,1,7413837002
3208,63488094905,6264,63488101169,4,0,1,3584,4,7791993514
3209,63488107346,11288,63488118634,8,0,0,3584,8,2149867104
3210,63488111315,11529,63488122844,7,0,0,18432,7,3684713688
3211,63488121752,65862,63488187614,3,0,0,18944,3,3555653402
3212,63488149586,149306,63488298892,6,0,1,2048,6,125726753
3213,63488276724,54525,63488331249,1,0,0,92672,1,5052712409
3214,63488314881,144220,63488459101,0,0,1,43520,0,218373665
3215,63488373493,562,63488374055,0,0,1,12800,0,1767530510
3216,63488470889,176590,63488647479,5,0,0,512,5,10090699430
3217,63488502077,103176,63488605253,3,0,1,11264,3,6796733439
3218,63488509386,88828,63488598214,3,0,1,29696,3,6809911455
3219,63488539902,12304,63488552206,3,0,1,16896,3,809488453
3220,63488569650,146482,63488716132,8,0,1,75776,8,2924436522
3221,63488647179,215805,63488862984,1,0,0,20480,1,5565123301
3222,63488751477,55041,63488806518,8,0,0,93696,8,5095212167
3223,63488789476,74516,63488863992,7,0,0,124928,7,8617584298
3224,63488820929,9796,63488830725,5,0,1,8704,5,257930079
3225,63488854964,235588,63489090552,8,0,0,11776,8,2461583585
3226,63488947211,132688,63489079899,3,0,1,8704,3,2982191182
3227,63488981487,139752,63489121239,4,0,1,13312,4,2679168321
3228,63489057212,58305,63489115517,0,0,1,20992,0,1636292403
3229,63489076245,99581,63489175826,1,0,1,4096,1,8063227549
3230,63489116262,132757,63489249019,1,0,1,4608,1,7959280990
3231,63489221814,23462,63489245276,1,0,1,7168,1,972626515
3232,63489227485,64360,63489291845,2,0,0,38912,2,3393368477
3233,63489254682,41904,63489296586,1,0,0,68096,1,10383324355
3234,63489284443,100259,63489384702,3,0,1,23552,3,9756261203
3235,63489314133,49893,63489364026,0,0,1,16384,0,8687379014
3236,63489349138,177567,63489526705,7,0,1,1536,7,9658657174
3237,63489383418,167264,63489550682,0,0,0,269824,0,6887876476
3238,63489426955,135376,63489562331,4,0,0,39424,4,3372929655
3239,63489572561,25700,63489598261,0,0,0,46592,0,10686734371
3240,63489590793,26734,63489617527,8,0,0,48640,8,520201523
3241,63489632893,69436,63489702329,2,0,1,8704,2,7537141453
3242,63489707327,157766,63489865093,1,0,1,35840,1,5537476384
3243,63489766620,260421,63490027041,5,0,1,512,5,10501183077
3244,63489948772,72020,63490020792,2,0,0,116736,2,2127394282
3245,63490100547,52029,63490152576,8,0,1,183808,8,6223501353
3246,63490176614,216826,63490393440,8,0,0,84480,8,2359795434
3247,63490224883,94373,63490319256,9,0,1,6144,9,248026908
3248,63490319386,43900,63490363286,0,0,1,4608,0,3798166496
3249,63490326355,53328,63490379683,0,0,1,3072,0,4981525389
3250,63490327323,64405,63490391728,2,0,1,512,2,6790813279
3251,63490366111,64989,63490431100,1,0,1,13824,1,1295166409
3252,63490372834,126467,63490499301,0,0,1,5120,0,5546501163
3253,63490525456,1038,63490526494,5,0,0,1024,5,8069740797
3254,63490601242,98848,63490700090,5,0,1,24576,5,2793221592
3255,63490653718,73288,63490727006,2,0,1,11264,2,7731931339
3256,63490657339,96317,63490753656,1,0,0,160768,1,2846862698
3257,63490663765,101437,63490765202,9,0,0,38912,9,6011620891
3258,63490700846,80831,63490781677,9,0,0,62464,9,1881470419
3259,63490808500,32812,63490841312,8,0,1,144384,8,9960349477
3260,63490876652,247911,63491124563,0,0,0,53760,0,5095602303
3261,63490926465,135989,63491062454,2,0,1,5632,2,9909769657
3262,63491020128,28098,63491048226,7,0,1,8192,7,7603496286
3263,63491025688,159604,63491185292,8,0,1,73728,8,466036013
3264,63491039884,56911,63491096795,4,0,0,18944,4,6751194443
3265,63491128548,240930,63491369478,0,0,1,512,0,5069207947
3266,63491229286,52058,63491281344,4,0,1,3072,4,5677450621
3267,63491229378,85426,63491314804,6,0,1,4608,6,10351506565
3268,63491241433,73999,63491315432,8,0,0,123904,8,6993092173
3269,63491284937,51386,63491336323,7,0,0,67072,7,6638437549
3270,63491328550,8119,63491336669,5,0,0,512,5,9710387746
3271,63491367401,35567,63491402968,4,0,0,62464,4,7704146575
3272,63491398314,50737,63491449051,9,0,1,12800,9,7342174679
3273,63491415268,65296,63491480564,2,0,0,81920,2,2368145260
3274,63491454689,158186,63491612875,4,0,1,10240,4,6855770448
3275,63491546675,11270,63491557945,4,0,0,18432,4,7763405998
3276,63491567796,13249,63491581045,4,0,1,7168,4,5137986232
3277,63491600222,56680,63491656902,9,0,0,25600,9,1820965724
3278,63491691367,125488,63491816855,3,0,0,204288,3,715538687
3279,63491709514,186266,63491895780,9,0,0,229888,9,12073384
3280,63491840327,81989,63491922316,8,0,0,94208,8,6383530445
3281,63491908501,13079,63491921580,9,0,1,7680,9,8343831110
3282,63491926602,20362,63491946964,2,0,0,22016,2,491574534
3283,63491996451,111732,63492108183,9,0,0,32768,9,9189820297
3284,63492043818,16609,63492060427,0,0,1,5632,0,477229306
3285,63492065722,118908,63492184630,7,0,1,8192,7,4009910178
3286,63492146283,150241,63492296524,7,0,0,32256,7,3893249692
3287,63492183804,15618,63492199422,0,0,0,28672,0,1407966439
3288,63492221058,1038,63492222096,5,0,0,1024,5,2498282523
3289,63492237569,117663,63492355232,3,0,1,4096,3,9250788811
3290,63492344219,32554,63492376773,9,0,0,53248,9,6631969866
3291,63492384958,48976,63492433934,0,0,1,2048,0,1307180814
3292,63492505643,41128,63492546771,2,0,1,4608,2,2722346629
3293,63492519566,61757,63492581323,8,0,0,66560,8,10672706284
3294,63492540016,125658,63492665674,9,0,0,207872,9,3399989782
3295,63492543373,190649,63492734022,6,0,1,5632,6,8161044387
3296,63492849063,15058,63492864121,1,0,1,6144,1,10374984753
3297,63492854105,25958,63492880063,2,0,0,29184,2,3124578107
3298,63492866854,90297,63492957151,9,0,1,5632,9,9987937350
3299,63492901856,109556,63493011412,8,0,0,47104,8,2254006090
3300,63492976948,11529,63492988477,1,0,0,18944,1,6156014222
3301,63493105762,20878,63493126640,4,0,0,33792,4,3807769617
3302,63493121640,89584,63493211224,9,0,1,14336,9,370635105
3303,63493129353,14663,63493144016,7,0,1,5120,7,7232172816
3304,63493189621,11270,63493200891,8,0,1,330752,8,3685206829
3305,63493210407,239546,63493449953,9,0,0,23552,9,10468678823
3306,63493315130,21395,63493336525,8,0,0,18432,8,753500076
3307,63493328757,310750,63493639507,7,0,1,28672,7,1775281797
3308,63493333330,180385,63493513715,8,0,1,296448,8,621988019
3309,63493373597,126316,63493499913,1,0,0,34816,1,4040252778
3310,63493420474,176390,63493596864,8,0,1,2560,8,9787261937
3311,63493451310,394550,63493845860,7,0,1,512,7,1616390041
3312,63493462396,267211,63493729607,0,0,1,5632,0,2621594783
3313,63493589341,183186,63493772527,3,0,1,28160,3,575334288
3314,63493748699,32037,63493780736,0,0,0,52224,0,7262326543
3315,63493764864,16858,63493781722,5,0,0,1536,5,46621950
3316,63493792723,180949,63493973672,6,0,1,33280,6,3254193634
3317,63493800039,165651,63493965690,2,0,1,15360,2,9645123595
3318,63493816596,57436,63493874032,6,0,1,4096,6,7128335298
3319,63493940458,221373,63494161831,4,0,1,4608,4,3848824640
3320,63494129215,5967,63494135182,2,0,0,14848,2,6034707704
3321,63494261097,12991,63494274088,8,0,0,25088,8,5442131852
3322,63494268191,7523,63494275714,5,0,0,2560,5,4951971359
3323,63494269580,7440,63494277020,5,0,0,2048,5,4357060351
3324,63494287141,49600,63494336741,7,0,1,4096,7,4608521690
3325,63494322147,60578,63494382725,4,0,1,1536,4,5980293283
3326,63494333594,51770,63494385364,1,0,0,83968,1,5125556835
3327,63494340424,62711,63494403135,3,0,1,512,3,4521918041
3328,63494359896,55558,63494415454,3,0,0,94720,3,8686784657
3329,63494390583,50668,63494441251,1,0,1,2560,1,3956359794
3330,63494405496,97609,63494503105,3,0,0,163328,3,2005923435
3331,63494459692,23150,63494482842,4,0,1,2560,4,2134964871
3332,63494480723,51099,63494531822,1,0,0,11776,1,2444620608
3333,63494525779,71905,63494597684,7,0,1,10752,7,6321949231
3334,63494594352,52287,63494646639,2,0,1,9728,2,2695490075
3335,63494604439,134828,63494739267,2,0,0,84992,2,3169349277
3336,63494751293,82920,63494834213,4,0,0,134656,4,8072566089
3337,63494766760,73354,63494840114,0,0,0,28160,0,7652668534
3338,63494799613,46198,63494845811,4,0,0,27136,4,10103464323
3339,63494959148,115356,63495074504,2,0,1,7680,2,7152732439
3340,63495117098,66520,63495183618,7,0,1,9216,7,8565719086
3341,63495225533,23633,63495249166,9,0,0,42496,9,4360382294
3342,63495260603,48976,63495309579,2,0,1,5120,2,10199843333
3343,63495277833,71509,63495349342,5,0,1,2048,5,3583209961
3344,63495735756,57436,63495793192,4,0,1,4608,4,7067694563
3345,63495818977,44658,63495863635,2,0,0,76800,2,362297698
3346,63495829046,50347,63495879393,1,0,0,50688,1,8568190362
3347,63495831658,49041,63495880699,2,0,0,2048,2,7561432379
3348,63495853529,76793,63495930322,9,0,0,116224,9,9284702442
3349,63495960108,74087,63496034195,3,0,0,120832,3,10065811320
3350,63495993095,30487,63496023582,0,0,1,14848,0,9171275817
3351,63496014558,129266,63496143824,9,0,1,2048,9,1783971113
3352,63496082380,110047,63496192427,0,0,0,49152,0,7950226934
3353,63496110442,166862,63496277304,6,0,1,33792,6,10690811628
3354,63496209453,51512,63496260965,6,0,1,6656,6,8033779369
3355,63496246857,121707,63496368564,3,0,0,83456,3,9475812777
3356,63496309132,100416,63496409548,6,0,1,7168,6,8830119774
3357,63496367931,126389,63496494320,3,0,1,2560,3,3516660756
3358,63496530634,50668,63496581302,4,0,1,31232,4,4156968880
3359,63496548158,100876,63496649034,3,0,1,2560,3,6193572148
3360,63496749829,2466,63496752295,7,0,0,2560,7,1600083781
3361,63496894374,125212,63497019586,8,0,1,111104,8,1426164469
3362,63496920912,98685,63497019597,3,0,0,145920,3,6019735908
3363,63497084986,1514,63497086500,3,0,0,1536,3,8707748291
3364,63497085772,2942,63497088714,5,0,0,3072,5,4241457141
3365,63497114155,6274,63497120429,1,0,1,4096,1,3388678296
3366,63497139687,105143,63497244830,2,0,0,6656,2,5174772965
3367,63497282251,65608,63497347859,8,0,1,11264,8,5213071889
3368,63497385995,1038,63497387033,8,0,1,15872,8,5216401731
3369,63497387107,5322,63497392429,7,0,0,1024,7,3021358745
3370,63497389321,6225,63497395546,1,0,0,5632,1,7606114764
3371,63497418227,88516,63497506743,2,0,0,15360,2,1811280247
3372,63497428616,87373,63497515989,4,0,1,9728,4,4337793359
3373,63497429298,146425,63497575723,3,0,0,241664,3,2560464802
3374,63497460152,52031,63497512183,8,0,1,400384,8,577212206
3375,63497524038,476798,63498000836,5,0,0,512,5,8477359704
3376,63497635472,305233,63497940705,9,0,1,12288,9,8674287972
3377,63497660666,280058,63497940724,3,0,0,414720,3,5892938465
3378,63497795174,57473,63497852647,7,0,1,7168,7,5657340471
3379,63497795174,242241,63498037415,1,0,1,13824,1,7444900175
3380,63497883786,261165,63498144951,5,0,0,512,5,9909328012
3381,63498004228,121943,63498126171,6,0,1,512,6,117336762
3382,63498172745,101656,63498274401,8,0,1,33792,8,2254072074
3383,63498174010,107890,63498281900,7,0,1,24576,7,10715412310
3384,63498188529,93382,63498281911,3,0,0,145408,3,2433472655
3385,63498245795,134129,63498379924,7,0,1,14848,7,7083621891
3386,63498287500,174004,63498461504,2,0,1,2560,2,3636882504
3387,63498553099,72020,63498625119,4,0,0,116736,4,7778524630
3388,63498669220,2942,63498672162,9,0,0,3072,9,4609249964
3389,63498856901,67588,63498924489,6,0,1,7680,6,233307370
3390,63499078875,81124,63499159999,2,0,1,11776,2,5818067552
3391,63499173899,562,63499174461,0,0,0,512,0,5402628036
3392,63499223794,2942,63499226736,7,0,0,3072,7,6586154568
3393,63499273492,58684,63499332176,1,0,1,8704,1,2804103926
3394,63499294180,206398,63499500578,8,0,1,177152,8,7162340835
3395,63499386647,113942,63499500589,1,0,0,121344,1,625395924
3396,63499511132,48976,63499560108,4,0,1,26624,4,7326157189
3397,63499558091,177182,63499735273,2,0,1,2048,2,9458236015
3398,63499713619,562,63499714181,7,0,0,512,7,740650033
3399,63499865634,100096,63499965730,6,0,1,28672,6,714298414
3400,63499998477,193864,63500192341,8,0,1,175104,8,4034390782
3401,63500027963,164857,63500192820,1,0,1,1536,1,4752942853
3402,63500317170,562,63500317732,0,0,1,1536,0,10027854311
3403,63500326422,47284,63500373706,6,0,1,6144,6,4307968718
3404,63500347510,63454,63500410964,5,0,0,512,5,9842447960
3405,63500404183,1990,63500406173,5,0,0,2048,5,5088091102
3406,63500422704,85158,63500507862,4,0,0,142336,4,2266562090
3407,63500432441,75767,63500508208,7,0,0,512,7,7853068581
3408,63500433390,81027,63500514417,0,0,0,29696,0,7691557076
3409,63500452509,68014,63500520523,0,0,0,20992,0,9367849487
3410,63500488899,562,63500489461,3,0,1,6144,3,7873732663
3411,63500565985,102223,63500668208,6,0,1,3072,6,10477964970
3412,63500637974,211922,63500849896,6,0,1,20992,6,9989570134
3413,63500640845,62373,63500703218,5,0,0,512,5,5048431481
3414,63500641973,97756,63500739729,0,0,1,4608,0,7273223888
3415,63500647525,123869,63500771394,7,0,1,27136,7,7917378919
3416,63500681300,107212,63500788512,2,0,1,1536,2,4534763885
3417,63500735557,94101,63500829658,9,0,1,512,9,4872040958
3418,63500790275,67841,63500858116,9,0,1,2048,9,8067314977
3419,63500799107,82708,63500881815,1,0,1,22016,1,5549806793
3420,63500833130,54613,63500887743,0,0,0,89600,0,7570662228
3421,63500907289,34363,63500941652,8,0,1,102912,8,10136910891
3422,63500963023,125378,63501088401,1,0,0,56832,1,7217459814
3423,63500976031,18732,63500994763,1,0,1,5632,1,311525508
3424,63501014965,154745,63501169710,9,0,0,1024,9,9679210076
3425,63501187208,55744,63501242952,0,0,1,4096,0,9943079329
3426,63501244908,1514,63501246422,8,0,1,75776,8,1393219996
3427,63501253746,1990,63501255736,2,0,1,4608,2,2923076893
3428,63501261610,70102,63501331712,0,0,0,1536,0,10251041623
3429,63501302316,131626,63501433942,5,0,0,2048,5,5033089385
3430,63501334436,62858,63501397294,8,0,1,512,8,5313927883
3431,63501491632,12562,63501504194,4,0,0,20992,4,6216561582
3432,63501520327,155258,63501675585,0,0,0,255488,0,1876655635
3433,63501531392,57611,63501589003,7,0,1,1536,7,9090913059
3434,63501623568,163584,63501787152,3,0,0,26624,3,5933440969
3435,63502001494,76852,63502078346,1,0,1,17920,1,9292122889
3436,63502076853,90961,63502167814,8,0,1,24064,8,5501849412
3437,63502127343,40482,63502167825,2,0,0,62464,2,3992513473
3438,63502203169,21395,63502224564,2,0,0,34816,2,5159131763
3439,63502321548,562,63502322110,7,0,0,512,7,8247105542
3440,63502399674,54676,63502454350,3,0,1,5632,3,10342620276
3441,63502543347,4846,63502548193,3,0,1,8192,3,9703766976
3442,63502563264,69280,63502632544,5,0,0,5120,5,9172636753
3443,63502609012,134749,63502743761,3,0,0,222208,3,4145887302
3444,63502624908,146271,63502771179,1,0,1,18944,1,3356977436
3445,63502667602,93607,63502761209,8,0,0,226816,8,5259082473
3446,63502721892,35567,63502757459,4,0,0,2560,4,6815977561
3447,63502810211,310478,63503120689,8,0,0,62464,8,8149105643
3448,63502812430,54525,63502866955,6,0,1,10752,6,1418609810
3449,63502924798,211225,63503136023,2,0,1,25088,2,7347642073
3450,63502941725,1990,63502943715,8,0,1,157184,8,9213003156
3451,63502946275,270097,63503216372,8,0,0,92672,8,3028279721
3452,63503027635,294687,63503322322,7,0,0,2048,7,5374777177
3453,63503167345,128611,63503295956,2,0,1,10752,2,170317888
3454,63503323014,2866,63503325880,3,0,0,8704,3,7865327793
3455,63503348882,198342,63503547224,9,0,0,326144,9,3695365174
3456,63503399991,65094,63503465085,6,0,1,5632,6,10354503336
3457,63503426439,188163,63503614602,0,0,1,9216,0,5728506140
3458,63503480732,192319,63503673051,3,0,1,14336,3,5923121942
3459,63503483410,141723,63503625133,1,0,0,14336,1,1825461234
3460,63503504054,87225,63503591279,6,0,1,2048,6,7671834992
3461,63503510151,93005,63503603156,8,0,1,121344,8,8055249805
3462,63503530943,139093,63503670036,8,0,1,424448,8,7605221413
3463,63503578115,93860,63503671975,8,0,0,146432,8,8497979796
3464,63503581734,86889,63503668623,8,0,1,13312,8,4847510888
3465,63503583574,386038,63503969612,3,0,0,37376,3,2063628229
3466,63503587153,393602,63503980755,4,0,0,148992,4,3853394527
3467,63503633372,191215,63503824587,7,0,0,1536,7,9898068836
3468,63503662155,598491,63504260646,2,0,0,79872,2,7936324215
3469,63503804050,296911,63504100961,0,0,1,7168,0,5082877681
3470,63503818858,313430,63504132288,4,0,1,8192,4,4555458352
3471,63503833662,569425,63504403087,0,0,1,37888,0,8648082932
3472,63503838626,264656,63504103282,1,0,1,19968,1,3229913781
3473,63503890742,146182,63504036924,4,0,1,13824,4,645659432
3474,63503945120,43905,63503989025,8,0,1,59904,8,373324427
3475,63503983881,344474,63504328355,3,0,1,5120,3,150762691
3476,63504009235,267299,63504276534,7,0,0,4096,7,5620338377
3477,63504114394,230109,63504344503,7,0,0,3072,7,7965177179
3478,63504177431,67234,63504244665,2,0,0,114176,2,2571623551
3479,63504210131,562,63504210693,4,0,1,13312,4,9319267809
3480,63504211457,139345,63504350802,9,0,1,43008,9,10687133240
3481,63504284865,156283,63504441148,2,0,1,13312,2,10217895241
3482,63504299514,149251,63504448765,7,0,0,512,7,2461810383
3483,63504405902,64221,63504470123,3,0,0,104960,3,1882329460
3484,63504537562,106336,63504643898,7,0,1,49152,7,4317665652
3485,63504691893,215062,63504906955,1,0,0,348672,1,1939891870
3486,63504725596,187977,63504913573,4,0,0,23552,4,9380576579
3487,63504758043,156810,63504914853,2,0,0,14336,2,1533372582
3488,63504774085,108136,63504882221,8,0,1,34816,8,9388674004
3489,63504800064,13508,63504813572,4,0,1,7168,4,9757326040
3490,63504853580,123410,63504976990,8,0,0,150528,8,4150358926
3491,63504856833,313301,63505170134,6,0,1,1536,6,8566752942
3492,63504950270,289517,63505239787,4,0,1,512,4,1762767217
3493,63504974108,73483,63505047591,3,0,0,26112,3,678898561
3494,63505038116,258650,63505296766,8,0,0,122880,8,4105078995
3495,63505052216,11727,63505063943,6,0,1,12800,6,547993674
3496,63505096770,152761,63505249531,9,0,1,23552,9,5770570181
3497,63505105018,119801,63505224819,9,0,0,8192,9,9294242353
3498,63505165715,63888,63505229603,0,0,1,3584,0,3550897776
3499,63505204837,63187,63505268024,6,0,1,7680,6,3694472164
3500,63505234793,216657,63505451450,2,0,0,102912,2,4659761662
3501,63505372554,70972,63505443526,6,0,1,8704,6,5325513862
3502,63505379111,145650,63505524761,3,0,0,240128,3,4180636542
3503,63505416204,21912,63505438116,0,0,1,32256,0,8827857916
3504,63505475822,236293,63505712115,2,0,1,512,2,10719664099
3505,63505490268,171953,63505662221,0,0,1,9216,0,9035599252
3506,63505497858,227845,63505725703,8,0,1,44544,8,2046846671
3507,63505538166,250048,63505788214,8,0,0,35840,8,9760046090
3508,63505722769,80233,63505803002,7,0,1,13824,7,6297604694
3509,63505729165,84702,63505813867,4,0,1,13312,4,1311365045
3510,63505760457,54832,63505815289,6,0,1,26112,6,2662036909
3511,63505781017,35102,63505816119,3,0,1,6144,3,2840694296
3512,63505792963,47284,63505840247,3,0,1,1536,3,8356473356
3513,63505801996,30984,63505832980,0,0,0,56320,0,3003701952
3514,63505811503,1514,63505813017,2,0,0,17408,2,9973607909
3515,63505852579,43883,63505896462,7,0,0,1536,7,5684298878
3516,63505857385,206998,63506064383,8,0,0,75264,8,7580788622
3517,63506043457,97288,63506140745,8,0,1,19456,8,874589214
3518,63506165535,93304,63506258839,0,0,0,151552,0,5224713828
3519,63506205088,54417,63506259505,5,0,0,1024,5,6276952279
3520,63506231347,33650,63506264997,3,0,0,17920,3,224233855
3521,63506325232,20878,63506346110,9,0,0,33792,9,2300268219
3522,63506329981,1992,63506331973,9,0,1,1024,9,4755484638
3523,63506452587,1990,63506454577,2,0,1,9216,2,7929066730
3524,63506452626,25442,63506478068,7,0,0,2048,7,10003318423
3525,63506459178,10256,63506469434,9,0,0,2048,9,6259713691
3526,63506486515,197588,63506684103,8,0,0,46080,8,10447521105
3527,63506502687,125436,63506628123,7,0,0,1536,7,5695014720
3528,63506519404,65425,63506584829,0,0,0,110592,0,5542345087
3529,63506617136,22858,63506639994,8,0,0,40960,8,8748017400
3530,63506633320,64391,63506697711,3,0,0,108544,3,3661996064
3531,63506725409,183395,63506908804,9,0,0,296960,9,8229703814
3532,63506822205,124345,63506946550,3,0,1,11776,3,448867626
3533,63506940130,73483,63507013613,4,0,0,122880,4,8431584341
3534,63507048002,91753,63507139755,0,0,0,148480,0,188964493
3535,63507061647,56629,63507118276,1,0,1,8192,1,3791483403
3536,63507112954,187155,63507300109,7,0,1,2560,7,9539762119
3537,63507332118,100829,63507432947,4,0,1,8704,4,2135147064
3538,63507372836,79612,63507452448,4,0,1,16896,4,10586119590
3539,63507428054,45592,63507473646,4,0,1,1024,4,7848593790
3540,63507504910,66975,63507571885,2,0,0,113664,2,10384142553
3541,63507652513,93986,63507746499,2,0,1,4608,2,3000182112
3542,63507677908,77740,63507755648,7,0,1,10752,7,8067154463
3543,63507725634,70586,63507796220,2,0,1,512,2,7347913253
3544,63507915400,23204,63507938604,8,0,0,38400,8,8663819949
3545,63507954208,83776,63508037984,4,0,1,20480,4,7955588236
3546,63508073047,41645,63508114692,8,0,0,67584,8,131640241
3547,63508095632,21646,63508117278,1,0,0,4096,1,5780823347
3548,63508157374,32983,63508190357,1,0,0,57344,1,4187802014
3549,63508247436,63187,63508310623,9,0,0,102912,9,8537748793
3550,63508270955,40014,63508310969,5,0,0,512,5,2047857743
3551,63508322150,1990,63508324140,6,0,1,3072,6,4230043207
3552,63508346466,154985,63508501451,3,0,1,4608,3,5707756410
3553,63508403028,180369,63508583397,5,0,0,2048,5,5029190817
3554,63508466251,74346,63508540597,8,0,0,121344,8,8759644167
3555,63508505715,174562,63508680277,2,0,0,283136,2,3657016454
3556,63508552825,127798,63508680623,5,0,0,512,5,3164587436
3557,63508602142,99884,63508702026,9,0,0,77824,9,402146013
3558,63508647139,12562,63508659701,9,0,1,17408,9,8181305581
3559,63508672148,2942,63508675090,9,0,1,16384,9,2397564067
3560,63508700478,181802,63508882280,2,0,0,20992,2,7169471343
3561,63508706927,214430,63508921357,4,0,1,18944,4,1817569442
3562,63508709386,188114,63508897500,3,0,1,7168,3,8753807061
3563,63508758983,147359,63508906342,1,0,1,4608,1,7384379744
3564,63508788345,237575,63509025920,3,0,1,16896,3,9590695675
3565,63508789973,161316,63508951289,7,0,0,3072,7,2215984687
3566,63508925721,59128,63508984849,7,0,1,5120,7,6551923551
3567,63509045885,85416,63509131301,0,0,0,142848,0,9792261959
3568,63509072051,60876,63509132927,7,0,0,2560,7,4574270987
3569,63509098359,40367,63509138726,3,0,0,19456,3,7992488809
3570,63509198566,14541,63509213107,9,0,1,8192,9,4564563703
3571,63509269213,127030,63509396243,1,0,0,28160,1,4757158319
3572,63509361109,103687,63509464796,2,0,0,168448,2,9632195428
3573,63509369391,13249,63509382640,6,0,1,1536,6,10245532056
3574,63509516555,261693,63509778248,8,0,0,25600,8,8559345340
3575,63509543321,75120,63509618441,2,0,1,14848,2,9802447175
3576,63509576155,168980,63509745135,3,0,1,12288,3,6072590324
3577,63509617856,133029,63509750885,8,0,0,215552,8,10730812529
3578,63509634239,117312,63509751551,5,0,0,1024,5,1726459995
3579,63509639746,143269,63509783015,0,0,0,101376,0,835803713
3580,63509670352,128421,63509798773,4,0,0,50688,4,8722684092
3581,63509717156,148910,63509866066,3,0,0,215552,3,3525399578
3582,63509779109,122000,63509901109,2,0,1,9216,2,9246347193
3583,63509843210,218788,63510061998,1,0,1,11264,1,4401280639
3584,63509986347,93562,63510079909,7,0,1,9216,7,414160879
3585,63509987613,59103,63510046716,9,0,0,152064,9,5535653912
3586,63510022840,35832,63510058672,9,0,0,11776,9,7256169145
3587,63510051910,110492,63510162402,8,0,0,27648,8,4840135864
3588,63510144691,562,63510145253,5,0,0,512,5,4811524202
3589,63510146597,562,63510147159,1,0,1,17408,1,1483969980
3590,63510234381,57436,63510291817,5,0,0,512,5,7005047516
3591,63510260002,195680,63510455682,6,0,1,4608,6,3240269845
3592,63510390492,108520,63510499012,2,0,1,56320,2,3734104651
3593,63510455067,44488,63510499555,3,0,1,22016,3,6394949393
3594,63510458305,49800,63510508105,9,0,0,73216,9,3976324687
3595,63510475778,123265,63510599043,9,0,0,77312,9,294500655
3596,63510573592,2466,63510576058,3,0,1,9216,3,5264008961
3597,63510676236,172898,63510849134,5,0,0,2560,5,2879637550
3598,63510725706,35050,63510760756,4,0,0,61440,4,586672130
3599,63510884019,1514,63510885533,2,0,0,1536,2,7899763914
3600,63510911888,124971,63511036859,4,0,0,203264,4,9543696219
3601,63510939258,129782,63511069040,9,0,0,113152,9,8137185062
3602,63511008655,84729,63511093384,8,0,1,140800,8,726129284
3603,63511027568,248946,63511276514,0,0,0,138240,0,8989489228
3604,63511196235,25958,63511222193,4,0,1,23040,4,8574357888
3605,63511219148,31243,63511250391,4,0,1,7680,4,4885977029
3606,63511326153,186837,63511512990,4,0,0,47104,4,2091482898
3607,63511326565,21137,63511347702,9,0,0,27136,9,4093425559
3608,63511390511,214499,63511605010,9,0,0,34304,9,2800471557
3609,63511484919,52360,63511537279,6,0,1,3072,6,2403008995
3610,63511558487,135525,63511694012,0,0,0,223744,0,10521220378
3611,63511571347,159979,63511731326,4,0,0,129536,4,8952986049
3612,63511768866,3894,63511772760,7,0,0,4096,7,6164461524
3613,63511794725,173641,63511968366,2,0,0,357376,2,10045685979
3614,63511796413,217817,63512014230,2,0,1,3072,2,6325862583
3615,63511818360,264636,63512082996,4,0,1,512,4,2253006157
3616,63511828983,63616,63511892599,6,0,1,32256,6,10211596974
3617,63512019085,268625,63512287710,9,0,0,107008,9,4133374343
3618,63512200898,173012,63512373910,2,0,0,280064,2,1378592877
3619,63512351789,22467,63512374256,5,0,0,512,5,6324718803
3620,63512381171,34104,63512415275,4,0,1,6144,4,3924592394
3621,63512426741,86319,63512513060,2,0,0,56320,2,1976779027
3622,63512431030,34104,63512465134,2,0,1,7168,2,1179244828
3623,63512529015,185721,63512714736,3,0,0,56320,3,5757673033
3624,63512551198,1038,63512552236,8,0,1,103936,8,2532196293
3625,63512585671,187491,63512773162,7,0,0,1024,7,2508552444
3626,63512768413,77740,63512846153,4,0,1,10752,4,5371417705
3627,63512806255,56592,63512862847,1,0,0,96768,1,3208600076
3628,63512827573,56984,63512884557,8,0,0,79360,8,6280655116
3629,63512846688,7226,63512853914,6,0,1,4096,6,2732349248
3630,63512891840,116162,63513008002,2,0,0,7680,2,1920693464
3631,63513184058,72537,63513256595,0,0,0,117760,0,4833835935
3632,63513337137,562,63513337699,5,0,0,512,5,9992926689
3633,63513362545,62512,63513425057,1,0,1,6144,1,1983127724
3634,63513409554,97350,63513506904,0,0,0,162816,0,5556995154
3635,63513412446,95738,63513508184,0,0,0,14336,0,8147573161
3636,63513436009,88445,63513524454,2,0,0,61440,2,7608872718
3637,63513482335,5708,63513488043,8,0,1,69120,8,1190384133
3638,63513495530,281415,63513776945,4,0,1,9216,4,2538582385
3639,63513543105,30016,63513573121,8,0,1,353280,8,8092047580
3640,63513592368,27343,63513619711,7,0,1,38912,7,8025028364
3641,63513680836,350407,63514031243,4,0,1,22528,4,8210068788
3642,63513685322,323458,63514008780,9,0,0,14336,9,8320480709
3643,63513748543,255876,63514004419,0,0,0,28672,0,2462229624
3644,63513751677,124874,63513876551,2,0,0,10240,2,6692006532
3645,63513793466,167919,63513961385,4,0,1,57856,4,10424636803
3646,63513813097,539845,63514352942,6,0,1,4096,6,1663354043
3647,63513980843,58550,63514039393,0,0,0,106496,0,3963266548
3648,63514022997,165524,63514188521,8,0,0,402432,8,5458725433
3649,63514043606,338584,63514382190,0,0,0,56832,0,2651845247
3650,63514079143,334962,63514414105,7,0,1,5632,7,3753956248
3651,63514100372,289640,63514390012,3,0,0,38400,3,4776008770
3652,63514276960,72431,63514349391,1,0,1,3584,1,9084183307
3653,63514323687,142922,63514466609,4,0,0,29184,4,3990459409
3654,63514465068,24925,63514489993,1,0,0,45056,1,5592719884
3655,63514584554,104374,63514688928,8,0,0,173056,8,4379039648
3656,63514823281,1038,63514824319,6,0,1,4096,6,8890950985
3657,63514864517,55744,63514920261,5,0,0,1024,5,5663924353
3658,63514927743,71464,63514999207,4,0,1,15360,4,10576583403
3659,63514954385,89164,63515043549,7,0,1,23040,7,7411028554
3660,63515177730,33846,63515211576,2,0,0,55808,2,9389672631
3661,63515261329,12045,63515273374,3,0,0,19968,3,6058538302
3662,63515271804,165988,63515437792,4,0,0,269824,4,5637027369
3663,63515435616,115016,63515550632,3,0,0,190464,3,8389154758
3664,63515574866,62670,63515637536,4,0,0,101888,4,6000956547
3665,63515673615,42420,63515716035,3,0,0,69120,3,7890588893
3666,63515710452,7209,63515717661,5,0,0,2560,5,5204089653
3667,63515838564,113209,63515951773,1,0,1,49664,1,1218555518
3668,63515851695,2416,63515854111,7,0,1,6656,7,5003378865
3669,63515918668,127252,63516045920,4,0,1,20992,4,10285063421
3670,63515951339,23884,63515975223,5,0,0,2048,5,6643649165
3671,63515955074,111069,63516066143,2,0,0,35840,2,323595713
3672,63516014837,86917,63516101754,3,0,1,2048,3,6391568371
3673,63516052778,11270,63516064048,8,0,1,3072,8,8939137374
3674,63516055931,6225,63516062156,4,0,1,1536,4,10576604892
3675,63516064893,120478,63516185371,4,0,1,3072,4,7354002076
3676,63516071744,132559,63516204303,8,0,1,139776,8,5257527622
3677,63516136165,160060,63516296225,4,0,0,18432,4,9833314735
3678,63516158905,167858,63516326763,3,0,0,15360,3,8900717280
3679,63516317343,3418,63516320761,3,0,0,3584,3,10280597800
3680,63516355293,122716,63516478009,8,0,1,102912,8,228780212
3681,63516461795,70027,63516531822,1,0,1,9216,1,1453382904
3682,63516464679,76582,63516541261,1,0,1,7168,1,3717422233
3683,63516496628,48976,63516545604,9,0,1,2048,9,7037340518
3684,63516551166,14283,63516565449,0,0,0,27648,0,1081589279
3685,63516725263,298396,63517023659,8,0,1,356864,8,1673655880
3686,63516937068,145711,63517082779,3,0,1,5120,3,5804565314
3687,63516940706,2466,63516943172,8,0,1,6656,8,5620482637
3688,63516976700,211661,63517188361,8,0,1,343552,8,5017209468
3689,63517014292,347777,63517362069,7,0,1,22528,7,4938770528
3690,63517050779,272616,63517323395,1,0,1,8192,1,7050357157
3691,63517052806,319107,63517371913,6,0,1,20480,6,4615605873
3692,63517053908,285127,63517339035,6,0,1,6656,6,5773317481
3693,63517078417,258280,63517336697,3,0,1,2560,3,5312320541
3694,63517144798,290166,63517434964,2,0,0,2560,2,9452801296
3695,63517249355,75513,63517324868,6,0,1,3584,6,7418415919
3696,63517265827,129166,63517394993,2,0,1,13824,2,598642961
3697,63517266793,140322,63517407115,1,0,1,23552,1,10609895062
3698,63517273126,171389,63517444515,0,0,0,14336,0,802656908
3699,63517355229,55377,63517410606,7,0,1,11264,7,8246183430
3700,63517375468,104242,63517479710,4,0,1,24576,4,8912280628
3701,63517389677,49085,63517438762,4,0,1,3072,4,1169035986
3702,63517422111,154334,63517576445,9,0,1,2048,9,5638962371
3703,63517560734,122904,63517683638,8,0,0,199168,8,7306583319
3704,63517658943,15750,63517674693,8,0,1,63488,8,330162021
3705,63517670474,3418,63517673892,8,0,0,4096,8,4416101018
3706,63517733899,264533,63517998432,2,0,1,1024,2,5665325130
3707,63517740144,193745,63517933889,7,0,0,3584,7,10510709583
3708,63517852838,106666,63517959504,9,0,1,14848,9,5637652275
3709,63518054435,11787,63518066222,4,0,0,19456,4,6574930716
3710,63518075714,5967,63518081681,0,0,0,14848,0,2903841214
3711,63518126360,62668,63518189028,4,0,1,6656,4,9725895568
3712,63518253953,109612,63518363565,4,0,1,59904,4,5913860927
3713,63518275942,138113,63518414055,8,0,1,43008,8,4091143386
3714,63518302158,114560,63518416718,6,0,1,8704,6,278609318
3715,63518453109,71503,63518524612,9,0,0,115712,9,6680570123
3716,63518627549,26475,63518654024,8,0,0,48128,8,4321392446
3717,63518669297,42679,63518711976,8,0,0,69632,8,1110985329
3718,63518680626,37866,63518718492,4,0,0,23040,4,3685819966
3719,63518704090,18908,63518722998,3,0,0,7168,3,7461560238
3720,63518733141,132567,63518865708,8,0,1,71168,8,2175362219
3721,63518829575,75217,63518904792,7,0,1,5632,7,1422795381
3722,63518865836,41904,63518907740,1,0,0,68096,1,8817907763
3723,63518982933,61444,63519044377,9,0,1,7680,9,303327612
3724,63519151702,56850,63519208552,0,0,0,97280,0,3921377090
3725,63519218246,81112,63519299358,6,0,1,41472,6,2559196258
3726,63519218518,138459,63519356977,4,0,0,131072,4,9827139917
3727,63519249698,146148,63519395846,3,0,1,8704,3,7311973713
3728,63519250085,172967,63519423052,7,0,1,19968,7,1579445623
3729,63519278829,54354,63519333183,6,0,1,3584,6,6115685262
3730,63519434527,3894,63519438421,1,0,0,89088,1,522015643
3731,63519505769,316177,63519821946,9,0,1,4608,9,9844038534
3732,63519531348,43900,63519575248,0,0,0,4096,0,8300603657
3733,63519564641,56970,63519621611,1,0,1,4096,1,4479056944
3734,63519575726,121387,63519697113,1,0,1,512,1,4459290624
3735,63519626706,159643,63519786349,4,0,1,90112,4,9891289487
3736,63519760095,41046,63519801141,0,0,0,28672,0,5353723666
3737,63519926403,20620,63519947023,2,0,0,33280,2,2204246245
3738,63519942242,106334,63520048576,1,0,1,6144,1,8963103232
3739,63520065263,43900,63520109163,6,0,1,512,6,9679919759
3740,63520150974,43900,63520194874,1,0,1,512,1,5718971071
3741,63520217091,14025,63520231116,3,0,1,34304,3,7905879066
3742,63520276581,101812,63520378393,1,0,0,27136,1,2005087497
3743,63520398775,82972,63520481747,9,0,1,12800,9,9924630020
3744,63520507453,122248,63520629701,4,0,1,101376,4,7389143840
3745,63520573501,123868,63520697369,8,0,1,38912,8,9596226161
3746,63520683874,73483,63520757357,3,0,0,122880,3,3867061369
3747,63520703371,73360,63520776731,6,0,1,1024,6,6091262196
3748,63520715871,114592,63520830463,2,0,0,103424,2,9236930159
3749,63520736570,88848,63520825418,2,0,0,115712,2,7616575062
3750,63521144445,76672,63521221117,2,0,1,12288,2,7155240377
3751,63521392990,12304,63521405294,3,0,1,3072,3,7980666571
3752,63521403970,98791,63521502761,1,0,0,20480,1,2125304767
3753,63521412352,81112,63521493464,1,0,0,131072,1,6275200385
3754,63521425556,94034,63521519590,9,0,0,83968,9,9496272332
3755,63521538433,31520,63521569953,6,0,1,6656,6,5189820860
3756,63521599914,131943,63521731857,8,0,1,22528,8,7558326758
3757,63521614127,100430,63521714557,8,0,0,51200,8,2446401303
3758,63521653233,201023,63521854256,7,0,1,4608,7,1591300180
3759,63521740877,91962,63521832839,6,0,1,5120,6,5672552593
3760,63521768227,81382,63521849609,3,0,1,3584,3,9425155174
3761,63521936285,45592,63521981877,1,0,1,1024,1,10642640657
3762,63522028979,78544,63522107523,4,0,1,18432,4,310994636
3763,63522130016,70996,63522201012,3,0,1,13824,3,2298567599
3764,63522151053,50594,63522201647,6,0,1,2048,6,927634466
3765,63522163881,81887,63522245768,3,0,0,132608,3,4306280939
3766,63522190624,115080,63522305704,1,0,0,163840,1,6190147346
3767,63522240798,65572,63522306370,5,0,0,1024,5,6474344693
3768,63522250066,98444,63522348510,4,0,0,136192,4,1045453671
3769,63522289473,128585,63522418058,4,0,1,16896,4,9934456806
3770,63522390330,111481,63522501811,6,0,1,3072,6,8692145777
3771,63522488667,87225,63522575892,8,0,0,146432,8,10041801459
3772,63522508838,68437,63522577275,1,0,0,14848,1,8201710896
3773,63522525115,1514,63522526629,1,0,1,27136,1,5096082647
3774,63522694166,218917,63522913083,7,0,0,1536,7,8931575555
3775,63522723246,134321,63522857567,1,0,0,218112,1,7313927266
3776,63522841609,75808,63522917417,6,0,1,3072,6,4712533296
3777,63522859296,53314,63522912610,0,0,0,127488,0,7044667829
3778,63522885954,270846,63523156800,3,0,1,38912,3,6865386930
3779,63522893132,125851,63523018983,8,0,0,37888,8,8600357833
3780,63523029846,15058,63523044904,0,0,1,12800,0,8380483445
3781,63523169804,355511,63523525315,8,0,0,29184,8,8830733600
3782,63523176540,192480,63523369020,6,0,1,19456,6,1757515462
3783,63523571467,4158,63523575625,9,0,0,11264,9,6623777301
3784,63523616639,54525,63523671164,0,0,0,92672,0,1325681033
3785,63523670458,5967,63523676425,9,0,0,14848,9,356218593
3786,63523941713,54052,63523995765,3,0,1,3584,3,4531169900
3787,63523975387,47284,63524022671,6,0,1,1536,6,3617290569
3788,63524055392,104152,63524159544,8,0,1,41984,8,787181391
3789,63524156148,24525,63524180673,1,0,0,34304,1,9301862200
3790,63524162935,55744,63524218679,2,0,1,11264,2,3845700714
3791,63524202363,45592,63524247955,2,0,1,4096,2,8995733635
3792,63524308141,232934,63524541075,9,0,1,1024,9,73361658
3793,63524351627,71116,63524422743,1,0,1,2560,1,6241817008
3794,63524409655,45592,63524455247,3,0,1,1024,3,7904401946
3795,63524444969,31003,63524475972,0,0,0,50176,0,5875944810
3796,63524446487,40212,63524486699,8,0,0,34816,8,3417041650
3797,63524481794,4675,63524486469,7,0,1,9216,7,2277092977
3798,63524495588,79144,63524574732,1,0,1,12800,1,1155097625
3799,63524498133,4675,63524502808,3,0,1,9216,3,383074745
3800,63524508200,95403,63524603603,9,0,0,12288,9,6439512943
3801,63524534729,1038,63524535767,2,0,1,2048,2,6496099001
3802,63524573439,106625,63524680064,2,0,0,12288,2,6868358527
3803,63524597229,124025,63524721254,5,0,0,1024,5,1524609129
3804,63524631724,43900,63524675624,8,0,1,12288,8,6237141850
3805,63524654931,1038,63524655969,9,0,1,512,9,10095510775
3806,63524707069,12304,63524719373,5,0,0,1024,5,685675480
3807,63524724034,209550,63524933584,4,0,0,20480,4,7596910874
3808,63524874552,1038,63524875590,0,0,0,1024,0,1085305836
3809,63524882195,5967,63524888162,6,0,1,11264,6,10174499073
3810,63524924804,79432,63525004236,3,0,0,14848,3,7132359651
3811,63525065904,2942,63525068846,0,0,1,5120,0,7919287889
3812,63525069671,78182,63525147853,7,0,0,3072,7,7196641650
3813,63525114357,54364,63525168721,1,0,1,4608,1,3936464184
3814,63525126826,120402,63525247228,4,0,1,20992,4,6327056753
3815,63525201201,76048,63525277249,1,0,1,10240,1,10178828801
3816,63525290568,75292,63525365860,6,0,1,12800,6,3426700620
3817,63525322105,44229,63525366334,8,0,0,72704,8,8453426507
3818,63525325030,25932,63525350962,6,0,1,512,6,1703437480
3819,63525341785,112648,63525454433,8,0,0,14848,8,7206048134
3820,63525442562,43971,63525486533,2,0,0,72192,2,7399142423
3821,63525443584,84914,63525528498,2,0,0,107520,2,2442876569
3822,63525450616,70528,63525521144,0,0,1,18432,0,8273792572
3823,63525473523,146301,63525619824,1,0,0,57856,1,3567507715
3824,63525527811,60820,63525588631,8,0,1,94208,8,10358650014
3825,63525679282,14755,63525694037,9,0,1,5632,9,7087820434
3826,63525739193,353002,63526092195,2,0,0,23552,2,665602519
3827,63525842974,67456,63525910430,6,0,1,12288,6,8757025902
3828,63525896898,78208,63525975106,9,0,1,12288,9,3509149930
3829,63526027745,1038,63526028783,7,0,1,9728,7,2943056745
3830,63526063145,74356,63526137501,7,0,0,1024,7,8464633687
3831,63526091780,45592,63526137372,0,0,1,1024,0,9739775880
3832,63526092703,60820,63526153523,4,0,1,172544,4,9049532822
3833,63526093475,14800,63526108275,7,0,1,5632,7,3680979361
3834,63526196423,210752,63526407175,9,0,1,6656,9,1097249448
3835,63526221776,109071,63526330847,9,0,0,28672,9,4066183955
3836,63526572990,53491,63526626481,1,0,0,90624,1,7414867234
3837,63526597056,122215,63526719271,6,0,1,12800,6,5625117374
3838,63526629180,97936,63526727116,8,0,1,78848,8,2841491731
3839,63526758766,258173,63527016939,8,0,1,26624,8,7644071336
3840,63526867056,44010,63526911066,0,0,0,39424,0,331128680
3841,63526913218,33329,63526946547,1,0,0,54784,1,5101341693
3842,63526979323,6274,63526985597,0,0,0,6656,0,2893195822
3843,63527010127,3418,63527013545,7,0,0,3584,7,261628421
3844,63527029795,1038,63527030833,7,0,0,1024,7,9345794119
3845,63527080222,115016,63527195238,8,0,0,190464,8,3814393379
3846,63527298847,94079,63527392926,1,0,0,153088,1,2672287110
3847,63527323904,70008,63527393912,7,0,0,1536,7,6226988443
3848,63527357224,37354,63527394578,7,0,0,1024,7,3633494161
3849,63527376360,23403,63527399763,1,0,0,24576,1,9318169853
3850,63527500435,33071,63527533506,1,0,0,54272,1,10361551190
3851,63527517889,56293,63527574182,7,0,1,10240,7,3190199660
3852,63527545711,223115,63527768826,3,0,1,13312,3,1211777996
3853,63527731619,1038,63527732657,2,0,1,15872,2,9192332195
3854,63527781286,85444,63527866730,5,0,0,1024,5,5672133255
3855,63527804634,85403,63527890037,1,0,1,18432,1,10717450414
3856,63527853332,80992,63527934324,3,0,1,16384,3,6580304371
3857,63527890415,62512,63527952927,0,0,1,6144,0,5563607086
3858,63527951266,562,63527951828,6,0,1,2560,6,8415470354
3859,63527971319,52472,63528023791,7,0,0,512,7,3631476503
3860,63528088149,93328,63528181477,0,0,1,26624,0,3444989831
3861,63528093960,94588,63528188548,5,0,1,2560,5,9070298532
3862,63528095168,96587,63528191755,0,0,1,27136,0,10529000481
3863,63528095643,18702,63528114345,6,0,1,4096,6,6468346981
3864,63528119687,106960,63528226647,4,0,1,2048,4,3123423864
3865,63528171856,108746,63528280602,0,0,0,17408,0,6150380449
3866,63528240855,1514,63528242369,5,0,0,1536,5,9333823246
3867,63528270890,15575,63528286465,9,0,1,19968,9,10122017670
3868,63528283202,80548,63528363750,3,0,0,30208,3,7369686752
3869,63528333977,36859,63528370836,0,0,0,65024,0,7475290728
3870,63528339172,37668,63528376840,2,0,0,28672,2,9524867954
3871,63528387062,7702,63528394764,1,0,1,8704,1,5058968263
3872,63528408000,43900,63528451900,8,0,0,8192,8,7402010125
3873,63528427935,109066,63528537001,5,0,1,512,5,9191426474
3874,63528505628,32812,63528538440,2,0,0,53760,2,1631281186
3875,63528539981,69748,63528609729,1,0,1,9728,1,463946192
3876,63528593865,3643,63528597508,0,0,1,7168,0,819913695
3877,63528606097,77208,63528683305,7,0,0,2560,7,9975965067
3878,63528620175,66458,63528686633,0,0,0,112640,0,3602687476
3879,63528727749,3418,63528731167,5,0,0,3584,5,7224381765
3880,63528791364,80236,63528871600,3,0,1,18944,3,6687126381
3881,63528792793,13079,63528805872,9,0,1,28160,9,3880499766
3882,63528889429,152000,63529041429,3,0,0,22016,3,4771096777
3883,63528900153,53233,63528953386,1,0,1,15360,1,4282626832
3884,63528915246,103145,63529018391,1,0,0,90112,1,5689301665
3885,63528920544,66082,63528986626,9,0,1,2048,9,1144199158
3886,63528938475,111315,63529049790,6,0,1,4096,6,10245550189
3887,63529119305,92012,63529211317,4,0,0,148992,4,9169115138
3888,63529125605,91511,63529217116,3,0,0,27648,3,8835808814
3889,63529137137,101484,63529238621,8,0,0,78336,8,10232614768
3890,63529293121,25724,63529318845,2,0,1,2560,2,6087867004
3891,63529293122,76757,63529369879,4,0,0,46592,4,6384222711
3892,63529324435,54815,63529379250,9,0,1,3072,9,2318717559
3893,63529359463,83437,63529442900,0,0,0,135680,0,7261367018
3894,63529360566,89055,63529449621,8,0,0,32256,8,9992612606
3895,63529383052,72675,63529455727,1,0,0,29184,1,4984690594
3896,63529476568,4846,63529481414,4,0,0,5120,4,7086732084
3897,63529581207,103946,63529685153,2,0,0,168960,2,5183285831
3898,63529639778,43454,63529683232,4,0,1,131584,4,4757029463
3899,63529682233,21395,63529703628,0,0,0,71168,0,2336962515
3900,63529700564,160656,63529861220,3,0,1,19968,3,1911666028
3901,63529796157,324912,63530121069,1,0,0,34816,1,9609543496
3902,63529809030,134142,63529943172,8,0,0,214016,8,3335764978
3903,63529831183,156306,63529987489,2,0,1,2048,2,9630032877
3904,63529953503,24646,63529978149,8,0,0,21504,8,7598898707
3905,63530022205,13596,63530035801,2,0,1,7168,2,2315523889
3906,63530030078,64134,63530094212,1,0,0,23040,1,617175770
3907,63530035167,1514,63530036681,1,0,0,100864,1,9653868170
3908,63530047089,124453,63530171542,9,0,1,7680,9,2961118051
3909,63530094424,122225,63530216649,7,0,1,1536,7,9520679301
3910,63530120789,125291,63530246080,5,0,0,1536,5,1273376250
3911,63530236648,1514,63530238162,7,0,1,12288,7,4624114078
3912,63530266395,118599,63530384994,5,0,0,1536,5,252982809
3913,63530271242,78208,63530349450,2,0,1,4608,2,10301683445
3914,63530343482,187717,63530531199,6,0,1,12288,6,2169665834
3915,63530400179,64999,63530465178,1,0,1,1536,1,7202650456
3916,63530402283,13854,63530416137,1,0,1,18432,1,3986118387
3917,63530462697,118062,63530580759,0,0,1,16384,0,4087156617
3918,63530464095,65452,63530529547,2,0,0,23552,2,2759493563
3919,63530500323,111126,63530611449,9,0,1,10752,9,3991406903
3920,63530548748,23462,63530572210,2,0,1,9216,2,8589152488
3921,63530554575,21284,63530575859,9,0,0,38912,9,8273660530
3922,63530562450,3418,63530565868,4,0,0,18944,4,8059047845
3923,63530596424,72664,63530669088,5,0,0,3584,5,4684651797
3924,63530627201,54520,63530681721,0,0,1,5120,0,1785817977
3925,63530685499,331250,63531016749,8,0,1,391168,8,4836272394
3926,63530997174,86801,63531083975,0,0,0,114176,0,10195101244
3927,63531021381,104972,63531126353,4,0,0,125440,4,6927355738
3928,63531091244,36735,63531127979,5,0,0,2560,5,271809238
3929,63531172426,106183,63531278609,0,0,0,176640,0,8900924490
3930,63531193677,162769,63531356446,6,0,1,18432,6,7308670266
3931,63531283762,52984,63531336746,1,0,1,29696,1,4805650002
3932,63531362863,242506,63531605369,5,0,1,5120,5,1438340828
3933,63531484578,1038,63531485616,3,0,1,2560,3,7636416358
3934,63531560093,83258,63531643351,0,0,0,1024,0,1989043969
3935,63531602959,4846,63531607805,2,0,0,5120,2,2654670817
3936,63531622904,40870,63531663774,9,0,0,66048,9,9600196999
3937,63531703291,4846,63531708137,1,0,0,5120,1,5086233048
3938,63531705417,68106,63531773523,9,0,1,5120,9,6847749544
3939,63531774505,121794,63531896299,1,0,1,14336,1,5224179239
3940,63531925723,50737,63531976460,1,0,0,81920,1,7994926556
3941,63532058156,59128,63532117284,9,0,1,5120,9,4767389875
3942,63532120428,30487,63532150915,2,0,0,49152,2,4920177911
3943,63532478166,562,63532478728,7,0,0,512,7,7236955541
3944,63532525385,96352,63532621737,6,0,1,16384,6,7551958941
3945,63532682481,197140,63532879621,4,0,1,185856,4,2847598894
3946,63532821764,58508,63532880272,8,0,1,2048,8,7203231258
3947,63532829479,53218,63532882697,5,0,0,2560,5,479638122
3948,63532847083,35960,63532883043,5,0,0,512,5,6624212812
3949,63532926770,45592,63532972362,2,0,1,1024,2,4834223041
3950,63532940798,78076,63533018874,9,0,1,16896,9,6633294249
3951,63532970818,73238,63533044056,5,0,1,7680,5,918134971
3952,63533027860,21654,63533049514,3,0,1,3584,3,1021884751
3953,63533029994,60964,63533090958,2,0,0,35328,2,10641548055
3954,63533032671,26734,63533059405,5,0,1,4608,5,4678725563
3955,63533089843,97059,63533186902,9,0,0,48640,9,10623368023
3956,63533114957,1990,63533116947,8,0,1,185856,8,6483192960
3957,63533225095,287215,63533512310,2,0,0,2048,2,7981776891
3958,63533289248,115603,63533404851,5,0,1,8704,5,7907529173
3959,63533372209,80623,63533452832,7,0,1,2560,7,4564567425
3960,63533386079,76930,63533463009,3,0,1,5632,3,3252406952
3961,63533476910,205108,63533682018,0,0,0,335872,0,5748000602
3962,63533493172,209430,63533702602,9,0,0,65536,9,6996420809
3963,63533593518,109430,63533702948,7,0,0,512,7,166507980
3964,63533642535,71345,63533713880,0,0,0,44032,0,4269458677
3965,63533642843,72663,63533715506,5,0,0,2560,5,7938807389
3966,63533697494,133146,63533830640,4,0,1,3072,4,9530121949
3967,63533773695,12821,63533786516,9,0,1,13824,9,3355883705
3968,63533889450,147268,63534036718,8,0,0,21504,8,7399759368
3969,63533892669,287510,63534180179,1,0,0,459776,1,575403718
3970,63533901619,290311,63534191930,8,0,0,39936,8,3508698638
3971,63534012726,126941,63534139667,8,0,1,10752,8,9997575048
3972,63534075511,124069,63534199580,4,0,0,41984,4,10239620022
3973,63534084182,226608,63534310790,4,0,0,27648,4,2726249179
3974,63534169966,1038,63534171004,6,0,1,512,6,5559853241
3975,63534276668,1990,63534278658,5,0,0,1024,5,4694063773
3976,63534298069,268197,63534566266,8,0,0,2048,8,10612238517
3977,63534479523,4933,63534484456,8,0,0,12800,8,10558842096
3978,63534511413,2866,63534514279,9,0,0,8704,9,1283463370
3979,63534576159,41904,63534618063,4,0,1,85504,4,1949539710
3980,63534577542,117412,63534694954,4,0,0,68096,4,1740834962
3981,63534711502,562,63534712064,7,0,0,512,7,1205661785
3982,63534712103,12733,63534724836,1,0,0,24576,1,5343747573
3983,63534757998,50980,63534808978,3,0,1,9728,3,7845040415
3984,63534759267,74356,63534833623,4,0,1,27136,4,3169899886
3985,63534768569,157341,63534925910,1,0,1,3584,1,3235818877
3986,63534911395,88642,63535000037,0,0,0,135680,0,2595499448
3987,63534956673,3894,63534960567,4,0,1,11264,4,2464531988
3988,63535006986,67900,63535074886,7,0,0,4096,7,9970935199
3989,63535077992,213324,63535291316,0,0,1,8704,0,1352896478
3990,63535126815,61833,63535188648,3,0,1,5632,3,7666304979
3991,63535198814,3894,63535202708,4,0,1,38912,4,6981308582
3992,63535217161,146415,63535363576,5,0,0,4096,5,8441252454
3993,63535256027,114916,63535370943,8,0,1,77312,8,253274083
3994,63535313460,87927,63535401387,3,0,1,3584,3,6707774505
3995,63535352049,50473,63535402522,3,0,0,51200,3,6974264528
3996,63535352544,52884,63535405428,5,0,0,4608,5,5447728504
3997,63535357432,37197,63535394629,7,0,1,25088,7,2250412693
3998,63535369716,112557,63535482273,8,0,0,15360,8,10172044985
3999,63535403919,125916,63535529835,3,0,0,208384,3,2010894582
4000,63535406891,124570,63535531461,2,0,0,2560,2,1844981964
4001,63535418838,64204,63535483042,0,0,1,10240,0,10063195824
4002,63535481187,2942,63535484129,1,0,1,6656,1,3585418048
4003,63535586788,218138,63535804926,7,0,0,3072,7,1521087020
4004,63535661617,92439,63535754056,6,0,1,5632,6,3791888412
4005,63535780187,21654,63535801841,2,0,0,35328,2,5376265103
4006,63535788348,70043,63535858391,1,0,1,7168,1,4033567042
4007,63535937533,128332,63536065865,4,0,1,121344,4,7451806146
4008,63536167355,562,63536167917,7,0,1,45056,7,6940557096
4009,63536246006,105088,63536351094,7,0,0,512,7,9384433247
4010,63536439214,34104,63536473318,8,0,1,111104,8,909582877
4011,63536461323,125212,63536586535,5,0,1,6656,5,3250267816
4012,63536464450,65674,63536530124,1,0,1,512,1,6627741536
4013,63536471675,100162,63536571837,4,0,0,56320,4,10115774788
4014,63536472094,133422,63536605516,9,0,1,91136,9,2504962675
4015,63536498771,72076,63536570847,0,0,0,71680,0,5806134084
4016,63536537489,89434,63536626923,1,0,1,27136,1,379888302
4017,63536571497,125488,63536696985,0,0,1,20480,0,8646122786
4018,63536597237,107999,63536705236,6,0,1,7168,6,1579394057
4019,63536610624,113541,63536724165,9,0,1,1024,9,1003737176
4020,63536616037,113985,63536730022,4,0,0,204288,4,7658633861
4021,63536620070,226257,63536846327,6,0,1,2560,6,3503199204
4022,63536631796,354526,63536986322,5,0,1,14336,5,5541259421
4023,63536638032,234367,63536872399,9,0,0,7168,9,678390615
4024,63536638596,245072,63536883668,9,0,0,29184,9,4413319762
4025,63536654627,128877,63536783504,0,0,0,54272,0,9992487183
4026,63536714867,188020,63536902887,0,0,1,9216,0,1635421935
4027,63536770365,411988,63537182353,1,0,1,10240,1,89568317
4028,63536851046,73741,63536924787,0,0,1,21504,0,7362261530
4029,63536882012,134402,63537016414,9,0,0,123392,9,2007312519
4030,63536987297,562,63536987859,7,0,0,512,7,10148741282
4031,63536991551,60820,63537052371,0,0,1,5632,0,9372410477
4032,63537052181,32219,63537084400,3,0,0,52224,3,10233138798
4033,63537060064,23168,63537083232,0,0,1,3584,0,7092164450
4034,63537063498,19210,63537082708,4,0,0,3584,4,8394125719
4035,63537068762,47284,63537116046,5,0,0,2048,5,7821553993
4036,63537203815,192385,63537396200,2,0,1,1536,2,10263617297
4037,63537204428,4933,63537209361,9,0,1,18432,9,8423063343
4038,63537252757,83152,63537335909,0,0,1,1024,0,5195965356
4039,63537276823,97609,63537374432,0,0,0,12800,0,8045068502
4040,63537296626,177994,63537474620,4,0,0,163328,4,2637911462
4041,63537436855,153279,63537590134,0,0,0,248320,0,9205300604
4042,63537495837,98803,63537594640,7,0,0,7168,7,6111680435
4043,63537665453,103946,63537769399,3,0,0,168960,3,3641873569
4044,63537951195,70972,63538022167,6,0,1,8704,6,915612417
4045,63538014079,47284,63538061363,2,0,1,1536,2,6940174402
4046,63538014524,50531,63538065055,3,0,1,1024,3,7603696222
4047,63538066075,4846,63538070921,3,0,1,13824,3,10416390480
4048,63538070422,70996,63538141418,0,0,0,5120,0,3562225625
4049,63538089025,93772,63538182797,8,0,1,23040,8,9158217996
4050,63538125437,210233,63538335670,4,0,1,150016,4,2267672414
4051,63538214315,99950,63538314265,2,0,1,19456,2,536885884
4052,63538236363,127937,63538364300,7,0,1,2048,7,9793449303
4053,63538305600,49690,63538355290,9,0,0,22016,9,3847437118
4054,63538352974,67588,63538420562,6,0,1,7680,6,561117487
4055,63538382273,176800,63538559073,1,0,0,290816,1,5959950265
4056,63538461536,118325,63538579861,8,0,0,66560,8,5016228523
4057,63538509846,1038,63538510884,6,0,1,9728,6,1255894
4058,63538515422,31262,63538546684,1,0,1,27136,1,12726621
4059,63538541670,175967,63538717637,9,0,1,6144,9,6640632964
4060,63538557686,220601,63538778287,4,0,1,91136,4,5402057522
4061,63538587208,210003,63538797211,7,0,0,1024,7,10370794420
4062,63538587804,267027,63538854831,4,0,0,50688,4,2500316601
4063,63538686111,161152,63538847263,1,0,1,31232,1,6242196321
4064,63538725231,128467,63538853698,6,0,1,3072,6,1997381560
4065,63538755098,107475,63538862573,1,0,0,179200,1,8022767121
4066,63538861194,4846,63538866040,3,0,1,34304,3,9931203731
4067,63538925763,188940,63539114703,2,0,1,19968,2,8821001794
4068,63538936147,43900,63538980047,8,0,0,5120,8,9295548306
4069,63539019734,55744,63539075478,0,0,1,512,0,4728582807
4070,63539039400,43366,63539082766,7,0,1,58880,7,10492476107
4071,63539090603,35397,63539126000,7,0,1,4096,7,9940749392
4072,63539113236,269516,63539382752,4,0,0,74240,4,7538440981
4073,63539121871,16609,63539138480,1,0,0,1024,1,3895838071
4074,63539188419,242166,63539430585,2,0,0,32256,2,91521466
4075,63539277810,19581,63539297391,8,0,0,30720,8,3930082668
4076,63539363812,67588,63539431400,9,0,1,7680,9,5966694982
4077,63539375020,64204,63539439224,5,0,1,6656,5,173649552
4078,63539467482,1990,63539469472,7,0,0,2048,7,3743534667
4079,63539504746,132770,63539637516,2,0,0,215040,2,9042886161
4080,63539539180,144311,63539683491,5,0,1,17920,5,10436766665
4081,63539630923,275240,63539906163,1,0,1,21504,1,8955591657
4082,63539663005,152518,63539815523,0,0,1,3584,0,4744841723
4083,63539666118,179391,63539845509,5,0,1,15872,5,999485621
4084,63539730210,142150,63539872360,1,0,1,38400,1,3690752042
4085,63540006968,562,63540007530,7,0,0,512,7,7579915163
4086,63540045678,25183,63540070861,8,0,0,45568,8,8978246185
4087,63540046878,24969,63540071847,5,0,0,1536,5,8386846752
4088,63540062294,13419,63540075713,1,0,0,6144,1,6954340910
4089,63540076169,150222,63540226391,5,0,1,29184,5,8381011608
4090,63540175804,149029,63540324833,2,0,1,18432,2,7894777911
4091,63540271727,175079,63540446806,4,0,0,284160,4,8321662858
4092,63540357739,174588,63540532327,5,0,1,5632,5,4710567288
4093,63540366881,80908,63540447789,6,0,1,13312,6,5097205360
4094,63540465862,214517,63540680379,6,0,1,2560,6,2491846585
4095,63540626514,45592,63540672106,3,0,1,1024,3,2007616589
4096,63540664325,54052,63540718377,5,0,1,3584,5,1305205685
4097,63540717652,143871,63540861523,9,0,0,231936,9,2811080249
4098,63540724818,148149,63540872967,8,0,0,46592,8,9534361537
4099,63540748474,412170,63541160644,4,0,1,275968,4,4750655098
4100,63540786384,374435,63541160819,9,0,1,512,9,4872662742
4101,63541050642,112840,63541163482,5,0,1,8704,5,3035451238
4102,63541081217,189655,63541270872,4,0,1,61952,4,9110350395
4103,63541168103,123679,63541291782,3,0,0,200704,3,1263706185
4104,63541171896,128234,63541300130,2,0,1,512,2,4973820743
4105,63541207264,163769,63541371033,9,0,1,46080,9,2208385396
4106,63541232169,106258,63541338427,7,0,1,4096,7,4690419938
4107,63541258629,175681,63541434310,7,0,1,4096,7,3909255047
4108,63541563156,50668,63541613824,3,0,1,2560,3,7940173701
4109,63541641635,65942,63541707577,1,0,0,111616,1,7560565072
4110,63541770378,47284,63541817662,2,0,1,1536,2,4984417338
4111,63541819458,1038,63541820496,7,0,1,5632,7,9272117254
4112,63541823223,60820,63541884043,7,0,0,1024,7,9090220299
4113,63541836512,74356,63541910868,5,0,1,9728,5,1063970213
4114,63541872935,136567,63542009502,8,0,1,105472,8,2256035849
4115,63541912939,96730,63542009669,9,0,1,512,9,3038320225
4116,63541958598,55300,63542013898,5,0,1,15872,5,5679762736
4117,63541960528,91872,63542052400,3,0,0,94208,3,2850937821
4118,63541994515,34275,63542028790,3,0,1,24064,3,3752217635
4119,63542009612,51292,63542060904,2,0,1,5120,2,3034882577
4120,63542021789,964,63542022753,4,0,0,59904,4,7982088150
4121,63542071314,147659,63542218973,7,0,1,4608,7,328041595
4122,63542118816,23204,63542142020,6,0,1,7680,6,6275309445
4123,63542122196,239078,63542361274,5,0,0,512,5,945398990
4124,63542176817,133075,63542309892,2,0,0,38400,2,9158468525
4125,63542233895,34363,63542268258,9,0,1,9216,9,4632272097
4126,63542297645,32983,63542330628,1,0,0,56832,1,10720203461
4127,63542320311,146131,63542466442,0,0,0,57344,0,9421079155
4128,63542327669,68223,63542395892,3,0,1,6656,3,9287160595
4129,63542501541,562,63542502103,7,0,0,512,7,5558517031
4130,63542669263,48976,63542718239,6,0,1,2048,6,2338608596
4131,63542714800,13337,63542728137,1,0,0,22528,1,3821159464
4132,63542780066,4675,63542784741,6,0,1,2560,6,1284205274
4133,63542811670,50668,63542862338,8,0,0,12288,8,6491897241
4134,63542878547,54364,63542932911,6,0,1,4608,6,7513677462
4135,63542884888,152245,63543037133,9,0,0,246272,9,4879884258
4136,63542943553,103964,63543047517,4,0,1,402944,4,8711803652
4137,63542959807,21912,63542981719,1,0,0,94720,1,7685560002
4138,63542985487,66200,63543051687,1,0,1,19968,1,10167253818
4139,63543117550,13249,63543130799,8,0,0,35840,8,6495339408
4140,63543184752,14113,63543198865,0,0,1,9728,0,1358129154
4141,63543217946,368803,63543586749,6,0,1,10752,6,8610425606
4142,63543243504,533520,63543777024,3,0,0,112128,3,4119916233
4143,63543299621,182775,63543482396,7,0,1,17408,7,109493803
4144,63543301909,267745,63543569654,9,0,0,25600,9,7259310056
4145,63543323868,117859,63543441727,3,0,0,24064,3,8455842865
4146,63543345096,324138,63543669234,9,0,1,15360,9,6129920226
4147,63543368829,7702,63543376531,5,0,0,1024,5,10300714181
4148,63543431068,214801,63543645869,2,0,1,2048,2,2896783912
4149,63543524564,173073,63543697637,0,0,0,8192,0,3875053841
4150,63543540628,97594,63543638222,1,0,1,12288,1,7979149567
4151,63543559956,124971,63543684927,3,0,0,203264,3,5102221904
4152,63543713709,157711,63543871420,2,0,1,9216,2,659081276
4153,63543866364,50668,63543917032,9,0,1,2560,9,2726467988
4154,63543929836,1038,63543930874,0,0,1,12800,0,1080623594
4155,63543937873,80719,63544018592,7,0,0,1024,7,6449056978
4156,63543950965,48976,63543999941,9,0,1,25088,9,9540994929
4157,63543964875,99004,63544063879,7,0,1,2048,7,5334281795
4158,63544046017,47844,63544093861,1,0,1,512,1,1932762348
4159,63544145144,2466,63544147610,7,0,0,2560,7,8213831298
4160,63544156463,23204,63544179667,4,0,0,38400,4,3190718414
4161,63544157176,11787,63544168963,6,0,1,23040,6,10264007888
4162,63544220420,71128,63544291548,9,0,1,9216,9,5024263469
4163,63544251307,146226,63544397533,8,0,0,19456,8,7436360150
4164,63544367288,49921,63544417209,6,0,1,512,6,17706226
4165,63544404669,71460,63544476129,6,0,1,5120,6,2289177301
4166,63544414380,137592,63544551972,4,0,0,227840,4,7687107666
4167,63544438583,81134,63544519717,5,0,1,2048,5,9427576469
4168,63544457843,4238,63544462081,8,0,1,187392,8,928894674
4169,63544482692,3894,63544486586,2,0,0,48640,2,2778532794
4170,63544518685,143779,63544662464,3,0,1,9216,3,290188182
4171,63544534423,20878,63544555301,9,0,1,9216,9,6155893618
4172,63544561854,41128,63544602982,8,0,0,3584,8,3933556350
4173,63544570130,29986,63544600116,5,0,0,4096,5,8932903801
4174,63544579277,10753,63544590030,0,0,1,512,0,6284155442
4175,63544579513,296286,63544875799,3,0,0,33792,3,8910912714
4176,63544599171,175019,63544774190,4,0,0,66560,4,2123756436
4177,63544613219,229686,63544842905,5,0,0,4608,5,4052292435
4178,63544672763,259014,63544931777,8,0,0,17408,8,1046341432
4179,63544787876,4933,63544792809,4,0,1,141312,4,4321183368
4180,63544798676,163186,63544961862,1,0,1,11264,1,6137109362
4181,63544808926,220701,63545029627,8,0,0,12800,8,8851941629
4182,63545025889,47284,63545073173,2,0,1,1536,2,4162968986
4183,63545038811,70528,63545109339,2,0,1,25600,2,4886703473
4184,63545087034,127897,63545214931,5,0,1,12288,5,3176644879
4185,63545174790,106180,63545280970,9,0,1,48640,9,363843226
4186,63545266879,55744,63545322623,5,0,1,21504,5,7130293410
4187,63545300520,104315,63545404835,3,0,1,4096,3,1150016821
4188,63545337463,132770,63545470233,1,0,0,215040,1,6274054844
4189,63545341988,58795,63545400783,4,0,1,46080,4,5844116103
4190,63545417544,22249,63545439793,0,0,0,20992,0,8103344419
4191,63545429534,302092,63545731626,2,0,1,20992,2,9283553704
4192,63545450365,225877,63545676242,4,0,1,103424,4,3970840434
4193,63545459479,161298,63545620777,2,0,0,17408,2,8789795453
4194,63545552256,301339,63545853595,2,0,1,15872,2,10709934303
4195,63545607833,218592,63545826425,4,0,0,358912,4,1801389426
4196,63545641459,269066,63545910525,4,0,0,637952,4,9838864676
4197,63545643074,459653,63546102727,1,0,1,6144,1,4698908594
4198,63545673365,466828,63546140193,1,0,0,71168,1,10179287215
4199,63545825335,456632,63546281967,1,0,1,3072,1,5584252406
4200,63545843541,312582,63546156123,8,0,0,83968,8,9559555631
4201,63545915280,240997,63546156277,8,0,0,8704,8,3038338272
4202,63546078622,11012,63546089634,3,0,1,14336,3,6802888518
4203,63546196960,214566,63546411526,3,0,0,17920,3,4079398234
4204,63546348775,65942,63546414717,1,0,0,111616,1,684328237
4205,63546394676,84560,63546479236,9,0,1,20480,9,9097052121
4206,63546420258,15575,63546435833,3,0,1,2560,3,9187357602
4207,63546557086,199990,63546757076,9,0,0,30208,9,1064136020
4208,63546608707,90706,63546699413,2,0,1,8704,2,1088632986
4209,63546672579,105344,63546777923,6,0,1,38400,6,5249933195
4210,63546778967,4675,63546783642,6,0,1,3584,6,45862694
4211,63546787517,60229,63546847746,0,0,0,12288,0,9441998131
4212,63546827633,1038,63546828671,1,0,1,1024,1,9211586065
4213,63546865117,45592,63546910709,6,0,1,5120,6,10143387674
4214,63546867923,57592,63546925515,7,0,0,1024,7,7572018331
4215,63546910788,69437,63546980225,5,0,1,5120,5,2805701444
4216,63546947173,73054,63547020227,1,0,0,118784,1,3572302812
4217,63546970435,50458,63547020893,7,0,0,1024,7,5076246965
4218,63547029872,31520,63547061392,8,0,0,51200,8,9637951999
4219,63547038672,23891,63547062563,3,0,1,11264,3,1472383615
4220,63547052104,9002,63547061106,9,0,1,2048,9,6845981455
4221,63547073901,87257,63547161158,4,0,0,43008,4,614658819
4222,63547089136,165097,63547254233,7,0,0,512,7,6840152888
4223,63547170757,34533,63547205290,9,0,0,60416,9,2985105800
4224,63547196614,54266,63547250880,0,0,0,92160,0,4208086048
4225,63547213600,52731,63547266331,0,0,0,57344,0,5210848055
4226,63547271792,1990,63547273782,7,0,0,2048,7,5859411620
4227,63547318804,286883,63547605687,3,0,0,468480,3,8449048523
4228,63547325287,282859,63547608146,9,0,1,7680,9,10418080254
4229,63547390231,272585,63547662816,3,0,0,191488,3,3712035221
4230,63547395794,293455,63547689249,1,0,0,93696,1,183679102
4231,63547402195,298191,63547700386,2,0,0,36864,2,10069061236
4232,63547470351,178531,63547648882,7,0,1,8192,7,7163074184
4233,63547481263,132919,63547614182,7,0,1,2560,7,1985260455
4234,63547484092,284465,63547768557,5,0,1,11776,5,4984782292
4235,63547553217,313989,63547867206,0,0,0,100864,0,4751613986
4236,63547600135,304974,63547905109,5,0,0,2048,5,3662612202
4237,63547630538,340609,63547971147,4,0,0,556544,4,2374286849
4238,63547669229,302994,63547972223,9,0,0,13312,9,8877068545
4239,63547723541,306323,63548029864,9,0,0,194048,9,8778418086
4240,63547723904,157997,63547881901,4,0,1,302080,4,1136742442
4241,63547749573,124810,63547874383,7,0,1,13824,7,806512
4242,63547883004,436777,63548319781,4,0,0,45056,4,9485525977
4243,63547922297,590828,63548513125,0,0,0,20992,0,6127115334
4244,63548040334,274409,63548314743,8,0,0,302080,8,8749403676
4245,63548110995,145052,63548256047,6,0,1,22016,6,10452884497
4246,63548169702,237714,63548407416,5,0,0,2048,5,3620287184
4247,63548175667,338013,63548513680,1,0,1,6144,1,10664758950
4248,63548241382,221222,63548462604,9,0,1,6144,9,6680632393
4249,63548255064,136817,63548391881,8,0,1,109568,8,2368428612
4250,63548403578,79259,63548482837,9,0,0,226304,9,431139245
4251,63548469843,53148,63548522991,9,0,1,22016,9,6345652233
4252,63548472170,206911,63548679081,4,0,0,44544,4,10476143403
4253,63548495100,485929,63548981029,9,0,1,6656,9,1524567177
4254,63548498947,305048,63548803995,3,0,0,1024,3,4072390847
4255,63548747582,99447,63548847029,7,0,1,13312,7,3945634844
4256,63548781284,2466,63548783750,1,0,1,5120,1,6467821596
4257,63548865015,1845,63548866860,5,0,0,2560,5,10281808682
4258,63548866622,14113,63548880735,3,0,0,1536,3,2608445655
4259,63548879776,130634,63549010410,4,0,0,24064,4,10409049964
4260,63548921577,136508,63549058085,8,0,1,16384,8,160380130
4261,63548927389,159084,63549086473,8,0,1,90112,8,1484396507
4262,63548980404,106088,63549086492,0,0,0,156672,0,9090070920
4263,63549059919,29670,63549089589,2,0,0,9216,2,6966970498
4264,63549105359,41387,63549146746,4,0,0,67072,4,6287401423
4265,63549241585,6225,63549247810,8,0,0,15360,8,8621498870
4266,63549254686,52516,63549307202,6,0,1,3584,6,2453507198
4267,63549298541,63916,63549362457,1,0,1,10752,1,9027595920
4268,63549413424,63962,63549477386,4,0,1,151552,4,5816825362
4269,63549432361,38141,63549470502,0,0,0,104448,0,6114019354
4270,63549461408,180544,63549641952,5,0,0,5120,5,5510860578
4271,63549464473,62129,63549526602,0,0,1,27136,0,6525729411
4272,63549531850,22786,63549554636,4,0,0,59904,4,3748740370
4273,63549574603,23462,63549598065,5,0,0,3584,5,8725478571
4274,63549611141,181720,63549792861,8,0,0,38912,8,9609348055
4275,63549629242,55744,63549684986,7,0,1,4096,7,120637298
4276,63549711078,2466,63549713544,3,0,1,3584,3,1821372944
4277,63549768014,62926,63549830940,7,0,0,2560,7,10542764012
4278,63549815455,78832,63549894287,8,0,1,14336,8,1451094937
4279,63549870648,54052,63549924700,6,0,1,3584,6,617828416
4280,63549921007,105141,63550026148,4,0,1,36864,4,9589425608
4281,63550163477,94508,63550257985,9,0,0,157184,9,6547576053
4282,63550196997,66134,63550263131,3,0,0,8192,3,8083013068
4283,63550202446,67201,63550269647,9,0,0,23040,9,5090128449
4284,63550210069,77123,63550287192,8,0,1,512,8,190709788
4285,63550229428,5322,63550234750,0,0,0,127488,0,8840384728
4286,63550326510,127286,63550453796,8,0,0,5632,8,5135236751
4287,63550451022,78077,63550529099,0,0,1,16896,0,9482416010
4288,63550468676,84124,63550552800,9,0,0,140288,9,3004060268
4289,63550519989,34399,63550554388,1,0,0,15872,1,10555599766
4290,63550576128,33758,63550609886,4,0,0,58880,4,2946991420
4291,63550612378,75291,63550687669,4,0,0,126464,4,7510835301
4292,63550626531,3418,63550629949,6,0,1,8192,6,1878019864
4293,63550645392,1038,63550646430,9,0,1,13312,9,6311016468
4294,63550713604,155212,63550868816,7,0,0,3584,7,8346579449
4295,63550756615,184333,63550940948,5,0,0,1024,5,2172008003
4296,63550917106,61378,63550978484,8,0,1,157184,8,8111709605
4297,63550959999,57482,63551017481,1,0,0,99328,1,5191446941
4298,63550966161,11637,63550977798,5,0,0,3584,5,8245213553
4299,63551014912,182260,63551197172,5,0,0,4608,5,6223081728
4300,63551022553,95113,63551117666,8,0,0,155136,8,4427988659
4301,63551030610,170152,63551200762,8,0,0,163840,8,1829611068
4302,63551068752,143398,63551212150,9,0,1,22528,9,8086353510
4303,63551094294,118491,63551212785,2,0,1,2048,2,9214837838
4304,63551160196,52828,63551213024,6,0,1,12288,6,435338557
4305,63551201442,148980,63551350422,9,0,1,4608,9,4648122939
4306,63551241651,95029,63551336680,6,0,1,29696,6,7487250530
4307,63551300307,2866,63551303173,0,0,1,3584,0,8665021607
4308,63551304159,213884,63551518043,0,0,1,14848,0,10095014227
4309,63551414225,199418,63551613643,3,0,0,8704,3,3374306804
4310,63551480172,57436,63551537608,0,0,1,4608,0,5704325521
4311,63551507413,88672,63551596085,5,0,1,16384,5,1869320101
4312,63551530322,145685,63551676007,9,0,1,24064,9,1850179791
4313,63551673384,53321,63551726705,8,0,1,182272,8,2097065085
4314,63551730314,198663,63551928977,3,0,1,10240,3,8618374304
4315,63551747236,144872,63551892108,1,0,0,87040,1,1495880956
4316,63551784964,90233,63551875197,9,0,0,139264,9,9133930728
4317,63551803195,149320,63551952515,1,0,0,130560,1,8815976911
4318,63551933599,185736,63552119335,0,0,1,2048,0,6513300605
4319,63551978661,231433,63552210094,1,0,1,28160,1,7711877368
4320,63552048135,56333,63552104468,5,0,1,10240,5,10096239404
4321,63552067065,145585,63552212650,8,0,1,128512,8,3250586116
4322,63552133867,4933,63552138800,3,0,0,96256,3,2752538495
4323,63552213136,276167,63552489303,3,0,1,1536,3,7221890234
4324,63552282680,168710,63552451390,3,0,0,12800,3,6101987007
4325,63552331896,60304,63552392200,1,0,1,2048,1,10725889248
4326,63552359640,64908,63552424548,2,0,0,109568,2,6310643032
4327,63552402990,65780,63552468770,9,0,1,1024,9,3125910047
4328,63552447518,158512,63552606030,3,0,1,5120,3,3416032396
4329,63552565368,1514,63552566882,5,0,1,5120,5,8893619251
4330,63552569367,57592,63552626959,1,0,1,30720,1,6443385852
4331,63552608092,102865,63552710957,5,0,0,1536,5,7256846407
4332,63552629818,96317,63552726135,0,0,0,160768,0,8558591486
4333,63552697285,49434,63552746719,0,0,0,73728,0,4473916749
4334,63552701145,27262,63552728407,8,0,1,81920,8,9125781484
4335,63552731003,74142,63552805145,9,0,0,38912,9,5410119872
4336,63552771581,189939,63552961520,0,0,1,2560,0,9901619167
4337,63552810359,80459,63552890818,0,0,1,9216,0,8422273180
4338,63552846487,81971,63552928458,5,0,1,1536,5,7188151719
4339,63552853301,1990,63552855291,2,0,1,4608,2,9910186981
4340,63552889630,166885,63553056515,5,0,1,42496,5,10565331098
4341,63552954591,11529,63552966120,5,0,0,2048,5,8217913911
4342,63552978656,98166,63553076822,6,0,1,13824,6,4964775242
4343,63552994753,215211,63553209964,1,0,0,18944,1,8951591898
4344,63553057133,123621,63553180754,6,0,1,19968,6,2601591828
4345,63553128270,57109,63553185379,8,0,1,102400,8,2772990465
4346,63553159175,562,63553159737,9,0,0,97792,9,8462400006
4347,63553221079,232782,63553453861,5,0,1,19456,5,4983687667
4348,63553289700,159587,63553449287,3,0,1,512,3,2843975472
4349,63553306561,92692,63553399253,7,0,0,512,7,883852678
4350,63553384805,6274,63553391079,0,0,0,6656,0,9346334305
4351,63553444166,4846,63553449012,7,0,1,3072,7,9293055394
4352,63553459791,52360,63553512151,0,0,0,5120,0,2533342145
4353,63553569725,98380,63553668105,6,0,1,23040,6,5397512254
4354,63553628919,60820,63553689739,3,0,1,5632,3,5203096301
4355,63553668430,36699,63553705129,2,0,1,7680,2,7702513272
4356,63553685003,59908,63553744911,7,0,1,1024,7,9699707238
4357,63553708960,77140,63553786100,1,0,1,13824,1,5039006999
4358,63553710191,84471,63553794662,0,0,0,137728,0,522687355
4359,63553734482,66081,63553800563,2,0,0,19968,2,5915769176
4360,63553810101,22687,63553832788,3,0,0,37376,3,6285308022
4361,63553813209,34546,63553847755,3,0,0,47616,3,10535530078
4362,63553822741,94034,63553916775,0,0,1,15360,0,10029268645
4363,63553863414,83752,63553947166,1,0,1,15360,1,10104564437
4364,63553887693,59484,63553947177,4,0,0,96256,4,5371869903
4365,63553956543,22687,63553979230,9,0,0,37376,9,5081851714
4366,63554152228,96976,63554249204,5,0,1,18432,5,8149473114
4367,63554182964,250127,63554433091,8,0,1,69632,8,2857694681
4368,63554320666,114308,63554434974,3,0,1,6144,3,9003411967
4369,63554481081,63448,63554544529,0,0,1,33280,0,277632460
4370,63554495791,11270,63554507061,5,0,1,9216,5,5978162802
4371,63554523777,113512,63554637289,9,0,1,6656,9,4681716295
4372,63554531024,75334,63554606358,6,0,1,10240,6,5742801441
4373,63554571582,109115,63554680697,9,0,0,18432,9,494329877
4374,63554672270,35050,63554707320,9,0,0,61440,9,7861126547
4375,63554785887,105712,63554891599,8,0,1,47104,8,9570474934
4376,63554903004,44400,63554947404,3,0,0,76288,3,4132413973
4377,63554930696,55300,63554985996,1,0,0,94208,1,161486455
4378,63554932483,58800,63554991283,3,0,0,25088,3,7427384986
4379,63554956027,46598,63555002625,4,0,0,37888,4,1638216275
4380,63555164165,1990,63555166155,9,0,1,6656,9,5572928473
4381,63555203322,126005,63555329327,7,0,0,2048,7,3416654508
4382,63555218269,223011,63555441280,7,0,1,40960,7,3845949098
4383,63555431438,8408,63555439846,9,0,1,2560,9,3144423829
4384,63555433451,2942,63555436393,7,0,0,512,7,4606498279
4385,63555450369,60502,63555510871,5,0,0,3072,5,178926366
4386,63555533804,47284,63555581088,6,0,1,1536,6,7997265060
4387,63555639230,54052,63555693282,5,0,1,3584,5,8895232450
4388,63555666499,33758,63555700257,8,0,0,58880,8,3486816829
4389,63555692880,8043,63555700923,9,0,0,1024,9,8607545866
4390,63555699993,72995,63555772988,1,0,1,9728,1,7199514546
4391,63555818940,1990,63555820930,7,0,1,12800,7,4045958363
4392,63555844148,79900,63555924048,9,0,0,2048,9,4732069871
4393,63555855291,47284,63555902575,6,0,1,3584,6,10539510999
4394,63555862444,65659,63555928103,6,0,1,1536,6,8133060354
4395,63555877021,100096,63555977117,1,0,1,28672,1,8817372826
4396,63556333427,74604,63556408031,1,0,0,121856,1,8569857584
4397,63556454658,3124,63556457782,3,0,1,1024,3,195156218
4398,63556460804,51738,63556512542,3,0,1,10240,3,10504267871
4399,63556471568,76048,63556547616,5,0,1,1536,5,8923874950
4400,63556474625,95792,63556570417,2,0,0,9216,2,8867233745
4401,63556700677,45592,63556746269,0,0,1,1024,0,6655307011
4402,63556703654,48976,63556752630,0,0,1,2048,0,129667667
4403,63556738237,100252,63556838489,5,0,1,29184,5,1060356699
4404,63556819257,4158,63556823415,3,0,1,10752,3,3097379268
4405,63556861073,77740,63556938813,4,0,0,11264,4,9597994991
4406,63556881132,24150,63556905282,4,0,0,43520,4,5173727084
4407,63556959323,36342,63556995665,8,0,1,43008,8,6086317264
4408,63556961232,34625,63556995857,0,0,0,64000,0,5744504005
4409,63556963295,136994,63557100289,9,0,0,512,9,7310757979
4410,63557107762,49444,63557157206,6,0,1,3584,6,150722396
4411,63557234116,43900,63557278016,9,0,1,512,9,9640308405
4412,63557281350,1990,63557283340,7,0,1,3072,7,2001847399
4413,63557301199,52360,63557353559,5,0,0,2048,5,6981418105
4414,63557394976,110860,63557505836,1,0,1,64000,1,2893790170
4415,63557571779,95020,63557666799,1,0,1,27136,1,6777382688
4416,63557626271,48976,63557675247,3,0,1,2048,3,9402517012
4417,63557843768,33071,63557876839,1,0,0,54272,1,843803600
4418,63557911457,5798,63557917255,9,0,0,6144,9,10301806105
4419,63557945861,31262,63557977123,2,0,0,50688,2,6839577112
4420,63557969080,10949,63557980029,5,0,0,4608,5,1938444929
4421,63558019127,2466,63558021593,7,0,1,8704,7,1724554942
4422,63558021657,2466,63558024123,9,0,0,2560,9,8925038425
4423,63558042824,45592,63558088416,2,0,0,2560,2,8061792715
4424,63558051080,32554,63558083634,2,0,1,1024,2,7035833466
4425,63558066204,84897,63558151101,8,0,0,53248,8,6899279230
4426,63558130073,66458,63558196531,8,0,0,112640,8,3450094961
4427,63558249659,11529,63558261188,0,0,0,18944,0,3024481361
4428,63558257246,45950,63558303196,8,0,1,87552,8,5585769312
4429,63558261580,12045,63558273625,3,0,0,79360,3,8888327898
4430,63558329021,156275,63558485296,4,0,0,19968,4,7471292823
4431,63558331062,132770,63558463832,7,0,1,22016,7,7521794175
4432,63558353017,165797,63558518814,1,0,0,215040,1,4075840307
4433,63558370517,34229,63558404746,5,0,1,20992,5,564981563
4434,63558415765,29851,63558445616,3,0,1,2048,3,5126466334
4435,63558432795,95258,63558528053,5,0,1,17408,5,9060287925
4436,63558462641,194796,63558657437,7,0,0,7680,7,3821527314
4437,63558467030,23204,63558490234,4,0,0,19968,4,844653127
4438,63558592781,266978,63558859759,1,0,0,38400,1,235859605
4439,63558609388,3418,63558612806,5,0,1,11264,5,8821697149
4440,63558681107,145345,63558826452,0,0,1,6656,0,6599576965
4441,63558688211,112500,63558800711,9,0,0,3584,9,6470223172
4442,63558732241,26939,63558759180,8,0,1,580096,8,332770822
4443,63558792102,36083,63558828185,3,0,0,46080,3,8727001664
4444,63558803204,75456,63558878660,7,0,1,8704,7,8084295582
4445,63558817234,10495,63558827729,4,0,0,63488,4,3008323183
4446,63558880781,77206,63558957987,3,0,1,4608,3,2863974361
4447,63558885607,1038,63558886645,4,0,0,16896,4,3365133286
4448,63558985383,102912,63559088295,7,0,0,1024,7,8651582051
4449,63559103539,43712,63559147251,1,0,0,166912,1,7371249972
4450,63559159328,751149,63559910477,6,0,1,16896,6,3376601137
4451,63559232115,194055,63559426170,5,0,1,7168,5,1806474995
4452,63559243739,253981,63559497720,4,0,0,71680,4,4604633413
4453,63559289822,331927,63559621749,5,0,1,1536,5,2173263595
4454,63559333319,61637,63559394956,6,0,1,6144,6,1385892331
4455,63559352104,345862,63559697966,1,0,1,113152,1,9008445278
4456,63559353424,399309,63559752733,8,0,1,179712,8,9675957443
4457,63559372249,381587,63559753836,3,0,1,3584,3,5244120323
4458,63559513937,422408,63559936345,9,0,1,11264,9,5942062824
4459,63559520421,242049,63559762470,3,0,1,22016,3,8177313714
4460,63559554873,133804,63559688677,3,0,0,99840,3,1524156372
4461,63559584629,296915,63559881544,7,0,1,11776,7,5308224754
4462,63559636065,260822,63559896887,3,0,0,217088,3,6566876222
4463,63559694410,151052,63559845462,3,0,0,145920,3,4508072338
4464,63559715629,129844,63559845473,5,0,0,512,5,4683740120
4465,63559738326,42162,63559780488,8,0,1,10752,8,6042330106
4466,63559840451,204336,63560044787,1,0,1,297984,1,881616063
4467,63559854429,101433,63559955862,4,0,0,68608,4,5196820626
4468,63559884601,53837,63559938438,3,0,1,3584,3,4734150951
4469,63560034705,1038,63560035743,0,0,0,88064,0,9141346502
4470,63560129267,5192,63560134459,5,0,0,1024,5,8509387864
4471,63560173720,462410,63560636130,3,0,0,13312,3,1981234530
4472,63560206808,96064,63560302872,3,0,0,14848,3,9263057962
4473,63560213959,133821,63560347780,2,0,0,77312,2,6588060557
4474,63560348413,21912,63560370325,4,0,0,35840,4,2064047670
4475,63560349188,1514,63560350702,7,0,1,1024,7,574610691
4476,63560389474,173492,63560562966,5,0,0,1536,5,9135802956
4477,63560481717,55041,63560536758,6,0,1,20480,6,4414001978
4478,63560588274,41857,63560630131,4,0,0,93696,4,8526160739
4479,63560613107,208156,63560821263,0,0,0,39424,0,588961829
4480,63560649571,75300,63560724871,9,0,1,8192,9,5166813177
4481,63560687399,37483,63560724882,4,0,0,58368,4,6014317150
4482,63560756139,1038,63560757177,8,0,1,135680,8,9903353634
4483,63560760171,48976,63560809147,7,0,0,1024,7,3604536259
4484,63560762535,175502,63560938037,7,0,1,2048,7,10353187253
4485,63560932709,562,63560933271,0,0,1,6656,0,1707368370
4486,63560939394,1990,63560941384,0,0,1,9216,0,5716432303
4487,63560944911,139459,63561084370,5,0,0,512,5,3315565170
4488,63560962465,176904,63561139369,5,0,0,2048,5,4481044765
4489,63561154263,1514,63561155777,5,0,0,1536,5,39297736
4490,63561181866,5798,63561187664,1,0,1,77312,1,5753023076
4491,63561195787,15872,63561211659,3,0,0,6144,3,4652818579
4492,63561196119,114916,63561311035,4,0,0,27648,4,1343545211
4493,63561294830,4410,63561299240,3,0,0,2560,3,4497669547
4494,63561438682,143140,63561581822,8,0,1,134656,8,5121927729
4495,63561482348,101850,63561584198,7,0,1,4096,7,9328440219
4496,63561520784,75882,63561596666,7,0,1,9728,7,10155427764
4497,63561574198,54900,63561629098,7,0,1,1536,7,6505749908
4498,63561645729,155258,63561800987,0,0,0,255488,0,9617988992
4499,63561680800,126396,63561807196,8,0,0,21504,8,8127357149
4500,63561801623,74907,63561876530,2,0,1,18944,2,7458909168
4501,63561896676,95593,63561992269,3,0,1,2048,3,8075540229
4502,63561942788,242541,63562185329,9,0,1,23552,9,4277041709
4503,63562023706,1990,63562025696,0,0,1,13312,0,6040416454
4504,63562055585,52846,63562108431,7,0,1,3072,7,2335699701
4505,63562063796,89039,63562152835,5,0,0,2048,5,2191525813
4506,63562205689,23633,63562229322,1,0,0,42496,1,30942541
4507,63562250323,34275,63562284598,2,0,0,59904,2,6103289926
4508,63562297958,168610,63562466568,1,0,1,22016,1,10615501359
4509,63562382580,167797,63562550377,1,0,1,129536,1,4973115495
4510,63562459501,134976,63562594477,6,0,1,19968,6,3768481199
4511,63562518207,86214,63562604421,3,0,1,3584,3,1954137318
4512,63562527283,1514,63562528797,1,0,1,275968,1,8011487176
4513,63562596365,294528,63562890893,5,0,1,2048,5,9160868814
4514,63562618420,204026,63562822446,6,0,1,2048,6,2224445817
4515,63562654713,226716,63562881429,9,0,0,1536,9,5266585061
4516,63562797657,3918,63562801575,8,0,1,144384,8,8125661755
4517,63562820694,42937,63562863631,7,0,0,1536,7,7767061199
4518,63562853906,95909,63562949815,3,0,1,4096,3,6490838922
4519,63562865513,199168,63563064681,5,0,0,70144,5,3828207612
4520,63562885519,114593,63563000112,6,0,1,10752,6,6472653259
4521,63563091874,45592,63563137466,0,0,1,1024,0,1782467884
4522,63563094377,75033,63563169410,3,0,0,125952,3,1928228579
4523,63563152301,562,63563152863,2,0,1,4608,2,9536993188
4524,63563202240,44916,63563247156,7,0,0,512,7,3789953309
4525,63563227921,48976,63563276897,5,0,1,2048,5,8232187589
4526,63563231096,45433,63563276529,3,0,0,77312,3,4452681923
4527,63563256918,64663,63563321581,3,0,0,78336,3,6167046568
4528,63563260088,63861,63563323949,4,0,0,75264,4,7658630438
4529,63563261146,187409,63563448555,9,0,0,9216,9,7707899720
4530,63563308151,74236,63563382387,5,0,1,6144,5,4810842566
4531,63563534764,33758,63563568522,5,0,1,29696,5,10637832022
4532,63563545081,100408,63563645489,5,0,1,15872,5,4495558464
4533,63563571893,94938,63563666831,0,0,0,58880,0,796571271
4534,63563585596,70378,63563655974,6,0,1,4608,6,7425361376
4535,63563730900,103946,63563834846,3,0,0,168960,3,8506852074
4536,63563827809,36083,63563863892,6,0,1,3584,6,3059797846
4537,63563864743,79990,63563944733,0,0,0,63488,0,3039270771
4538,63563902727,54354,63563957081,5,0,1,1024,5,9863158783
4539,63563911875,75291,63563987166,2,0,0,89088,2,5688999532
4540,63563935763,125302,63564061065,7,0,1,3072,7,4668606118
4541,63563943051,104222,63564047273,4,0,0,126464,4,5086184101
4542,63563958957,46725,63564005682,9,0,1,512,9,1091277784
4543,63564053927,205137,63564259064,2,0,0,80896,2,4922505785
4544,63564068717,90207,63564158924,6,0,1,1536,6,8650393358
4545,63564133512,75560,63564209072,3,0,1,2560,3,5420438754
4546,63564207156,80992,63564288148,8,0,1,7680,8,3850784115
4547,63564242887,77691,63564320578,0,0,1,16384,0,5882437960
4548,63564246199,77335,63564323534,4,0,0,121344,4,10656190726
4549,63564246566,46159,63564292725,9,0,0,512,9,1285602912
4550,63564255179,11133,63564266312,8,0,1,33792,8,5987814450
4551,63564291207,136052,63564427259,3,0,0,54272,3,2509625427
4552,63564326579,250649,63564577228,9,0,0,512,9,5436000262
4553,63564353137,172938,63564526075,9,0,1,5120,9,4453746089
4554,63564572250,23462,63564595712,5,0,0,38912,5,1169465512
4555,63564587033,14478,63564601511,8,0,0,19456,8,1854304981
4556,63564624363,52360,63564676723,2,0,1,5120,2,3170845726
4557,63564629959,76414,63564706373,6,0,1,3072,6,5624939633
4558,63564690031,67479,63564757510,3,0,1,1536,3,980034249
4559,63564730415,52218,63564782633,7,0,1,1024,7,673683523
4560,63564772802,36859,63564809661,8,0,1,141824,8,8843508639
4561,63564850366,166828,63565017194,5,0,0,65024,5,9779450922
4562,63564909963,45793,63564955756,4,0,0,31232,4,980309122
4563,63564929132,66259,63564995391,3,0,1,4096,3,4212930791
4564,63564934766,93779,63565028545,5,0,1,5632,5,9055786344
4565,63565044017,124883,63565168900,3,0,0,206336,3,10130352751
4566,63565130291,39915,63565170206,7,0,0,2048,7,6727790773
4567,63565137281,2501,63565139782,9,0,1,8192,9,3652855183
4568,63565168691,22687,63565191378,9,0,0,1536,9,713590885
4569,63565213935,16666,63565230601,1,0,0,37376,1,1911709210
4570,63565225492,15833,63565241325,8,0,1,8192,8,3649312149
4571,63565226574,60064,63565286638,8,0,0,23552,8,568803853
4572,63565240920,253646,63565494566,0,0,0,30720,0,4457398741
4573,63565355913,72664,63565428577,6,0,1,9216,6,8187353347
4574,63565422531,54052,63565476583,8,0,1,12288,8,259639803
4575,63565445635,44229,63565489864,9,0,1,3584,9,4128971169
4576,63565488689,185319,63565674008,0,0,0,72704,0,8627535996
4577,63565506500,107568,63565614068,0,0,0,167424,0,4718430856
4578,63565513282,137793,63565651075,5,0,0,119808,5,4832680200
4579,63565533009,124284,63565657293,6,0,1,1024,6,10089376665
4580,63565626636,40914,63565667550,2,0,0,62464,2,5155644743
4581,63565758619,80216,63565838835,9,0,1,6144,9,1801710928
4582,63565859612,5798,63565865410,7,0,1,5632,7,4637896629
4583,63565878209,13508,63565891717,7,0,0,6144,7,4399634992
4584,63565903758,24238,63565927996,2,0,0,26112,2,904194686
4585,63565928082,18925,63565947007,1,0,1,218112,1,4231985975
4586,63565978011,234080,63566212091,8,0,0,40448,8,5523974379
4587,63565983580,73999,63566057579,0,0,0,9216,0,2969610856
4588,63566064462,290969,63566355431,2,0,0,123904,2,7674405330
4589,63566173224,67773,63566240997,2,0,0,35840,2,7486331149
4590,63566210562,32061,63566242623,7,0,0,2560,7,7497418022
4591,63566214522,106071,63566320593,6,0,1,33280,6,10091359640
4592,63566253873,143670,63566397543,4,0,0,232960,4,6231550437
4593,63566312552,21097,63566333649,7,0,1,12800,7,6361407097
4594,63566378072,120207,63566498279,0,0,0,2560,0,8816409018
4595,63566492633,175079,63566667712,3,0,0,284160,3,2075307555
4596,63566526524,134844,63566661368,3,0,1,20992,3,872015403
4597,63566601435,106911,63566708346,2,0,0,219136,2,9807729057
4598,63566614720,142996,63566757716,2,0,1,1536,2,1160385769
4599,63566630949,140603,63566771552,5,0,0,15872,5,6343640727
4600,63566656921,354448,63567011369,4,0,0,206848,4,1065348567
4601,63566701863,347458,63567049321,8,0,0,138240,8,4060052778
4602,63566742221,60862,63566803083,2,0,1,7168,2,8680538444
4603,63566834671,275379,63567110050,3,0,1,42496,3,1964103536
4604,63566850037,171857,63567021894,3,0,1,2048,3,3952853682
4605,63566927229,347654,63567274883,1,0,1,229376,1,7663553050
4606,63566932690,218592,63567151282,5,0,0,98304,5,3824024981
4607,63566978646,381498,63567360144,3,0,0,358912,3,1946328535
4608,63567222377,86361,63567308738,0,0,0,119296,0,4443028953
4609,63567346148,14025,63567360173,5,0,0,27136,5,8611583299
4610,63567376547,1990,63567378537,0,0,1,8704,0,1445444940
4611,63567416998,122959,63567539957,9,0,0,2048,9,4337885788
4612,63567560835,23721,63567584556,4,0,0,39424,4,721426276
4613,63567562958,36158,63567599116,8,0,1,22016,8,7418752922
4614,63567570867,5322,63567576189,4,0,0,56320,4,5845578968
4615,63567610743,134438,63567745181,6,0,1,11776,6,3619877187
4616,63567630689,35050,63567665739,9,0,0,5632,9,9305786937
4617,63567633815,95028,63567728843,3,0,1,16384,3,5131690684
4618,63567686006,143872,63567829878,1,0,0,61440,1,7085979439
4619,63567779631,56592,63567836223,0,0,0,96768,0,3929688831
4620,63567818814,106806,63567925620,7,0,1,6144,7,3552357939
4621,63567911742,14283,63567926025,3,0,1,29184,3,60654311
4622,63567916963,100252,63568017215,3,0,0,27648,3,2971700590
4623,63567956733,92381,63568049114,6,0,1,3072,6,9146033892
4624,63567979298,83437,63568062735,3,0,0,135680,3,1960450496
4625,63567979834,104406,63568084240,1,0,0,78336,1,3413133165
4626,63568015297,101329,63568116626,5,0,0,114176,5,1433829577
4627,63568017229,67857,63568085086,3,0,1,16384,3,10411922407
4628,63568065448,95943,63568161391,2,0,0,55296,2,1520838900
4629,63568073345,74283,63568147628,4,0,0,114688,4,1593412189
4630,63568106039,182006,63568288045,0,0,0,44544,0,1178285513
4631,63568132643,22170,63568154813,8,0,1,44544,8,1547254970
4632,63568217144,4675,63568221819,5,0,0,36352,5,5150597368
4633,63568291517,247979,63568539496,8,0,1,127488,8,394941826
4634,63568330116,3418,63568333534,4,0,0,12288,4,6479239431
4635,63568398330,189347,63568587677,5,0,1,4608,5,3215758102
4636,63568448066,144999,63568593065,5,0,1,7168,5,6391415536
4637,63568504378,31520,63568535898,7,0,0,3584,7,308251012
4638,63568615279,403062,63569018341,8,0,0,51200,8,8060349624
4639,63568616877,1990,63568618867,0,0,1,13312,0,8123143663
4640,63568638367,1514,63568639881,1,0,1,62976,1,4477299228
4641,63568686892,132705,63568819597,7,0,1,20480,7,7640022477
4642,63568704453,130414,63568834867,0,0,1,5120,0,1992108015
4643,63568710937,75353,63568786290,7,0,0,2048,7,5301047247
4644,63568733467,42679,63568776146,7,0,0,1536,7,9015439758
4645,63568739094,50361,63568789455,3,0,0,69632,3,6068525727
4646,63568741730,134458,63568876188,3,0,0,32768,3,4911955512
4647,63568752354,12304,63568764658,9,0,1,11776,9,2661338070
4648,63568855862,179517,63569035379,8,0,1,27648,8,10144998949
4649,63568892159,2866,63568895025,4,0,0,20480,4,9866624539
4650,63568952991,50668,63569003659,3,0,1,2560,3,2488070809
4651,63568971961,40870,63569012831,2,0,1,23040,2,5081556718
4652,63568976697,93772,63569070469,0,0,0,8704,0,5876091496
4653,63568981277,151128,63569132405,8,0,1,90624,8,2269429761
4654,63569012347,284978,63569297325,6,0,1,8704,6,9437362388
4655,63569013363,112206,63569125569,0,0,0,66048,0,4204796948
4656,63569087399,112675,63569200074,7,0,1,26624,7,10026753412
4657,63569128877,232055,63569360932,2,0,1,30720,2,6813489133
4658,63569196498,10019,63569206517,1,0,1,286208,1,2195759034
4659,63569234394,6750,63569241144,7,0,0,512,7,4276892136
4660,63569273862,66975,63569340837,4,0,0,7168,4,8380377912
4661,63569284465,71522,63569355987,2,0,0,113664,2,9259220645
4662,63569301423,290704,63569592127,4,0,0,70144,4,8646259324
4663,63569346021,141192,63569487213,0,0,0,94208,0,5522832565
4664,63569346302,140922,63569487224,4,0,0,39936,4,1557631382
4665,63569348921,201458,63569550379,2,0,0,264704,2,627510334
4666,63569530928,36028,63569566956,5,0,0,62976,5,8071206039
4667,63569587550,24408,63569611958,9,0,0,44032,9,1675290806
4668,63569651203,31003,63569682206,9,0,0,50176,9,7395917382
4669,63569690254,213556,63569903810,5,0,0,478720,5,9119472338
4670,63569740412,295545,63570035957,1,0,1,313856,1,3198895835
4671,63569746123,81370,63569827493,7,0,1,9728,7,4015512195
4672,63569804747,67019,63569871766,5,0,1,5632,5,2801909955
4673,63569858108,273065,63570131173,8,0,1,243200,8,2282621597
4674,63569898919,209914,63570108833,5,0,1,4096,5,2318804133
4675,63569914951,30487,63569945438,9,0,0,41984,9,5572308338
4676,63569939722,125658,63570065380,0,0,0,33280,0,4559070641
4677,63570000211,229446,63570229657,1,0,1,15360,1,6566329623
4678,63570044701,112478,63570157179,0,0,1,5632,0,10291700324
4679,63570097353,638903,63570736256,2,0,0,49152,2,463276977
4680,63570123202,383803,63570507005,2,0,0,207872,2,7017981676
4681,63570162611,600025,63570762636,4,0,0,84480,4,1074479191
4682,63570251983,185180,63570437163,3,0,1,3584,3,6380692017
4683,63570284441,240948,63570525389,5,0,0,18944,5,5640967873
4684,63570335617,34533,63570370150,7,0,1,34304,7,8350781276
4685,63570468811,140077,63570608888,8,0,1,202752,8,2043750865
4686,63570533300,348647,63570881947,8,0,1,72192,8,3510384141
4687,63570573859,63691,63570637550,0,0,0,60416,0,4851196796
4688,63570621878,63616,63570685494,1,0,1,75264,1,8575594610
4689,63570677415,409563,63571086978,4,0,0,97280,4,10321418543
4690,63570714873,287114,63571001987,5,0,1,12288,5,10177781898
4691,63570727196,197874,63570925070,1,0,0,107008,1,4802091758
4692,63570830571,104387,63570934958,5,0,0,96768,5,9273830449
4693,63570979150,34533,63571013683,1,0,0,60416,1,2522621149
4694,63570991267,28420,63571019687,5,0,0,28672,5,2086250688
4695,63571037637,3894,63571041531,7,0,1,4096,7,9592951953
4696,63571134786,194576,63571329362,2,0,0,4096,2,767423909
4697,63571314567,117600,63571432167,1,0,0,195584,1,7920106144
4698,63571406465,54096,63571460561,8,0,1,215040,8,4960736912
4699,63571434883,135266,63571570149,0,0,0,88576,0,5917984752
4700,63571482317,33758,63571516075,5,0,1,8704,5,9934676026
4701,63571539150,365965,63571905115,8,0,0,223232,8,8323711650
4702,63571599649,292776,63571892425,6,0,1,9216,6,1748158551
4703,63571672945,18836,63571691781,2,0,0,58880,2,2935501530
4704,63571698345,211185,63571909530,7,0,1,5632,7,8936916031
4705,63571757287,73683,63571830970,7,0,0,1024,7,6580521609
4706,63571852017,345107,63572197124,0,0,1,7168,0,3444282984
4707,63571960785,20878,63571981663,0,0,0,33792,0,2214230202
4708,63572039116,22858,63572061974,0,0,0,40960,0,5755898110
4709,63572156731,72537,63572229268,0,0,1,5632,0,2966670954
4710,63572172276,92978,63572265254,9,0,0,117760,9,5629061721
4711,63572199208,562,63572199770,1,0,1,13824,1,6474411353
4712,63572319820,138128,63572457948,7,0,0,512,7,1368382302
4713,63572322167,15180,63572337347,2,0,0,19456,2,970029652
4714,63572326421,23979,63572350400,1,0,1,226816,1,1068024081
4715,63572363187,74087,63572437274,5,0,0,39936,5,8513624840
4716,63572463805,46951,63572510756,4,0,0,120832,4,10379822499
4717,63572507006,345377,63572852383,3,0,0,60416,3,3615204401
4718,63572534353,81710,63572616063,6,0,1,7168,6,8464445511
4719,63572590099,61404,63572651503,5,0,0,67072,5,2474530405
4720,63572656364,211361,63572867725,3,0,0,79360,3,4564827773
4721,63572656527,42937,63572699464,7,0,1,25600,7,9528640718
4722,63572703517,43339,63572746856,7,0,1,6656,7,5379984956
4723,63572741563,106617,63572848180,8,0,0,70144,8,7659097451
4724,63572742544,139687,63572882231,1,0,0,14848,1,4801353105
4725,63572795521,92787,63572888308,2,0,1,7168,2,8565870157
4726,63572863824,331300,63573195124,4,0,0,150528,4,7895929828
4727,63572941831,73483,63573015314,8,0,0,122880,8,8083197673
4728,63572994851,52029,63573046880,0,0,0,84480,0,4809492065
4729,63573045830,32983,63573078813,5,0,1,22016,5,10547666188
4730,63573148920,74356,63573223276,0,0,1,9728,0,566881099
4731,63573169594,211955,63573381549,3,0,0,57344,3,8847105490
4732,63573213220,53837,63573267057,0,0,0,88064,0,599267649
4733,63573223509,112619,63573336128,2,0,1,4608,2,10709796395
4734,63573267435,73999,63573341434,5,0,0,123904,5,4543134997
4735,63573483558,5708,63573489266,8,0,0,14336,8,6852169063
4736,63573535232,110236,63573645468,8,0,1,61952,8,9371010402
4737,63573706648,73312,63573779960,3,0,0,119296,3,6558258830
4738,63573733010,106791,63573839801,6,0,1,1536,6,9730506469
4739,63573835555,119028,63573954583,2,0,0,295424,2,5565754205
4740,63573885065,182620,63574067685,7,0,1,2048,7,6805109984
4741,63573912471,106690,63574019161,7,0,0,1536,7,8853615802
4742,63573992422,6230,63573998652,2,0,1,12288,2,5199101609
4743,63574013277,13079,63574026356,7,0,0,512,7,7422565025
4744,63574108383,135673,63574244056,3,0,0,22016,3,5824821793
4745,63574133343,106180,63574239523,8,0,1,48640,8,4397399791
4746,63574148128,151935,63574300063,1,0,1,86016,1,4567613463
4747,63574295701,43712,63574339413,1,0,1,62464,1,10497186595
4748,63574311560,114746,63574426306,0,0,0,71680,0,4670413531
4749,63574365121,66717,63574431838,3,0,0,113152,3,5206006962
4750,63574380108,52294,63574432402,4,0,0,10752,4,5178867372
4751,63574473414,2942,63574476356,0,0,0,3072,0,5302289195
4752,63574473486,63325,63574536811,5,0,0,101376,5,10430484808
4753,63574526125,115274,63574641399,6,0,1,2560,6,3158776691
4754,63574532731,125613,63574658344,7,0,1,1536,7,8827857456
4755,63574584606,105666,63574690272,3,0,0,175616,3,3425402508
4756,63574591702,114635,63574706337,1,0,0,52224,1,4146260726
4757,63574615339,4370,63574619709,0,0,1,1536,0,4963071977
4758,63574719214,219580,63574938794,8,0,1,178688,8,4201390348
4759,63574757006,78286,63574835292,2,0,1,4096,2,5407119070
4760,63574801495,155431,63574956926,0,0,0,4608,0,5157298713
4761,63574810151,69280,63574879431,8,0,1,70144,8,3495606247
4762,63574839083,221050,63575060133,6,0,1,512,6,5989858143
4763,63574868987,127216,63574996203,9,0,1,1024,9,6568885922
4764,63574907398,395001,63575302399,6,0,1,8192,6,6292874693
4765,63575131467,114241,63575245708,8,0,0,188928,8,8727937224
4766,63575230074,97283,63575327357,7,0,1,512,7,5621856553
4767,63575272426,82404,63575354830,4,0,0,133632,4,1883752361
4768,63575298587,72206,63575370793,4,0,0,59904,4,3548417049
4769,63575331233,319334,63575650567,8,0,0,521216,8,2688224151
4770,63575422152,229081,63575651233,7,0,0,1024,7,1110323421
4771,63575442259,268586,63575710845,6,0,1,2560,6,5990422407
4772,63575648711,69426,63575718137,0,0,1,4608,0,3125517614
4773,63575669029,76842,63575745871,2,0,0,129536,2,5055473556
4774,63575679886,77019,63575756905,4,0,0,44544,4,10702289707
4775,63575719748,208274,63575928022,1,0,1,137216,1,9623702160
4776,63575785403,144034,63575929437,8,0,1,4608,8,2669625215
4777,63576017854,141318,63576159172,8,0,1,94208,8,808828002
4778,63576134808,38469,63576173277,1,0,0,24064,1,137332698
4779,63576168725,5538,63576174263,7,0,0,1536,7,4279073949
4780,63576196743,83696,63576280439,8,0,0,136192,8,2052075222
4781,63576281581,61120,63576342701,0,0,0,98816,0,504679581
4782,63576327739,26406,63576354145,1,0,0,46592,1,7729539252
4783,63576366339,93935,63576460274,9,0,1,2560,9,773057497
4784,63576393580,77777,63576471357,6,0,1,3584,6,9960500010
4785,63576405360,22687,63576428047,5,0,1,5120,5,3835568795
4786,63576453849,139594,63576593443,5,0,0,37376,5,3942042329
4787,63576624362,57109,63576681471,2,0,0,97792,2,1904492730
4788,63576716786,3418,63576720204,1,0,1,197632,1,298006379
4789,63576727505,40612,63576768117,3,0,0,3584,3,2454690442
4790,63576774877,562,63576775439,3,0,0,65536,3,10470100650
4791,63576916120,273623,63577189743,7,0,0,512,7,420781523
4792,63576928905,130178,63577059083,2,0,1,28160,2,10727961296
4793,63576968572,90522,63577059094,4,0,0,113664,4,3538491256
4794,63577022240,155194,63577177434,2,0,1,32768,2,350393876
4795,63577085217,176031,63577261248,1,0,1,79872,1,10678450360
4796,63577297204,4933,63577302137,3,0,0,12800,3,3142418917
4797,63577310629,33846,63577344475,4,0,0,55808,4,9822303813
4798,63577330310,14831,63577345141,7,0,0,1024,7,5703593201
4799,63577356930,83437,63577440367,4,0,0,135680,4,3415358881
4800,63577418647,27621,63577446268,1,0,0,19968,1,1967786374
4801,63577455447,96833,63577552280,5,0,0,161792,5,4707850550
4802,63577462375,110693,63577573068,4,0,0,66560,4,1915685192
4803,63577507053,77664,63577584717,1,0,0,47616,1,8961685143
4804,63577551961,73483,63577625444,2,0,1,19968,2,7765716878
4805,63577554649,159806,63577714455,8,0,0,122880,8,466767815
4806,63577627757,15833,63577643590,6,0,1,12800,6,5921875921
4807,63577670960,177456,63577848416,1,0,1,9728,1,1073530767
4808,63577729289,21137,63577750426,5,0,0,30720,5,3974585564
4809,63577759567,11216,63577770783,2,0,1,9216,2,10374461871
4810,63577779569,188551,63577968120,8,0,1,80384,8,4254594096
4811,63577789980,281922,63578071902,5,0,0,34304,5,4584499493
4812,63577801284,94657,63577895941,9,0,0,14848,9,5094217360
4813,63577863228,202819,63578066047,5,0,1,16384,5,3519169501
4814,63577915817,101944,63578017761,0,0,1,3584,0,3437515298
4815,63577920935,137333,63578058268,0,0,0,227328,0,5431545256
4816,63577959219,104234,63578063453,2,0,0,16384,2,4492363060
4817,63578008740,61024,63578069764,8,0,0,30208,8,1662203338
4818,63578016404,68913,63578085317,8,0,0,57856,8,4005883732
4819,63578165809,3900,63578169709,2,0,1,10752,2,3028856014
4820,63578212035,103216,63578315251,8,0,1,38912,8,8710632953
4821,63578239933,152737,63578392670,8,0,0,10752,8,3849957137
4822,63578306341,23693,63578330034,0,0,0,18944,0,10317251821
4823,63578402449,3641,63578406090,4,0,0,10240,4,9553374208
4824,63578417291,48976,63578466267,6,0,1,2048,6,1894703632
4825,63578493315,41904,63578535219,8,0,0,68096,8,2825990884
4826,63578589983,72664,63578662647,2,0,1,9216,2,2426322816
4827,63578666379,22858,63578689237,4,0,0,40960,4,1389131055
4828,63578679191,88505,63578767696,9,0,1,5632,9,1083279797
4829,63578694260,94940,63578789200,6,0,1,5632,6,656419662
4830,63578725568,81628,63578807196,1,0,0,132096,1,334842318
4831,63578746946,289339,63579036285,1,0,1,96768,1,2177891925
4832,63578762181,322998,63579085179,1,0,1,99840,1,295033432
4833,63579017019,40416,63579057435,7,0,1,48640,7,5160759764
4834,63579044782,28221,63579073003,9,0,0,36352,9,8185663339
4835,63579057988,143868,63579201856,7,0,0,1024,7,7043973796
4836,63579104640,6750,63579111390,8,0,1,268288,8,9108127795
4837,63579169178,241785,63579410963,9,0,0,7168,9,4809567266
4838,63579179449,313484,63579492933,8,0,1,174080,8,8066957989
4839,63579301698,70972,63579372670,1,0,1,78848,1,4901850252
4840,63579423511,231681,63579655192,8,0,1,57344,8,7100465046
4841,63579431801,152468,63579584269,2,0,1,37888,2,3414708921
4842,63579433402,194051,63579627453,6,0,1,8704,6,10424336963
4843,63579558527,78581,63579637108,2,0,0,98816,2,5290281602
4844,63579573875,102373,63579676248,7,0,1,29184,7,7969827987
4845,63579641928,66717,63579708645,8,0,1,416256,8,3983869110
4846,63579678073,82249,63579760322,0,0,0,113152,0,3849729702
4847,63579683841,149976,63579833817,4,0,0,77312,4,996852788
4848,63579700986,256377,63579957363,9,0,0,189952,9,3892002556
4849,63579712436,213070,63579925506,9,0,0,286720,9,1424206318
4850,63579766573,143673,63579910246,9,0,0,35328,9,6494411621
4851,63579878622,67318,63579945940,2,0,0,146944,2,10081770184
4852,63579965807,65785,63580031592,8,0,0,43520,8,9562217980
4853,63579972525,557435,63580529960,8,0,0,16384,8,106143512
4854,63580020433,178941,63580199374,4,0,0,107008,4,3962271735
4855,63580054410,144975,63580199385,2,0,0,43520,2,2747181216
4856,63580214385,15317,63580229702,7,0,1,16384,7,474880518
4857,63580323650,164388,63580488038,6,0,1,19456,6,8113156729
4858,63580335294,245508,63580580802,4,0,0,29696,4,1115792169
4859,63580495570,183912,63580679482,9,0,0,297984,9,456529758
4860,63580598326,117651,63580715977,3,0,0,117248,3,5930084306
4861,63580608292,22687,63580630979,7,0,1,7680,7,690187012
4862,63580755140,247992,63581003132,4,0,0,37376,4,1874100767
4863,63580880874,33071,63580913945,3,0,0,54272,3,3752572694
4864,63580894010,40325,63580934335,3,0,0,65024,3,7394421407
4865,63580896304,101432,63580997736,1,0,1,29184,1,4426057115
4866,63581014385,12045,63581026430,1,0,0,19968,1,5924273308
4867,63581088165,79098,63581167263,6,0,1,8192,6,7656965311
4868,63581165947,3774,63581169721,7,0,0,2560,7,5374906886
4869,63581333559,84900,63581418459,3,0,0,141824,3,2511779459
4870,63581517026,76048,63581593074,6,0,1,10240,6,6117018151
4871,63581578837,83179,63581662016,3,0,0,135168,3,1933579040
4872,63581725828,24925,63581750753,3,0,0,45056,3,8102696736
4873,63581817726,562,63581818288,7,0,0,512,7,10006336297
4874,63581857312,46725,63581904037,4,0,0,80896,4,2780629789
4875,63581942845,562,63581943407,7,0,1,13312,7,2907824602
4876,63581996486,78520,63582075006,7,0,0,512,7,9761620912
4877,63582004617,64738,63582069355,0,0,0,105984,0,585579950
4878,63582046722,1287,63582048009,0,0,1,8704,0,9593606184
4879,63582068734,70972,63582139706,7,0,0,1024,7,3709115528
4880,63582108910,75808,63582184718,1,0,1,231936,1,3438285967
4881,63582112291,240251,63582352542,8,0,1,6144,8,6979324692
4882,63582185645,143376,63582329021,0,0,0,127488,0,7059637990
4883,63582206264,239232,63582445496,7,0,1,1536,7,7177877996
4884,63582341784,40870,63582382654,7,0,1,10240,7,4768152043
4885,63582400626,122737,63582523363,1,0,0,66048,1,4479999270
4886,63582491210,11270,63582502480,8,0,1,243712,8,4239713282
4887,63582597503,17698,63582615201,5,0,0,18432,5,779646096
4888,63582598978,244677,63582843655,8,0,0,26112,8,9976396298
4889,63582670231,1514,63582671745,6,0,1,1536,6,3335310762
4890,63582784363,5708,63582790071,7,0,0,1536,7,9087221031
4891,63582796998,138268,63582935266,0,0,0,14336,0,3886205533
4892,63582809420,117859,63582927279,1,0,0,196096,1,1329381595
4893,63583125012,34533,63583159545,4,0,0,60416,4,6645675395
4894,63583156454,10753,63583167207,0,0,1,37888,0,3338151090
4895,63583171425,52287,63583223712,4,0,0,17408,4,4483382532
4896,63583187071,140927,63583327998,1,0,0,84992,1,8948590488
4897,63583213072,92270,63583305342,9,0,0,149504,9,1472570847
4898,63583313800,13249,63583327049,6,0,1,39424,6,7495029005
4899,63583483138,197717,63583680855,4,0,0,25600,4,8169597826
4900,63583524476,20620,63583545096,1,0,0,33280,1,8543930028
4901,63583564292,34275,63583598567,9,0,0,59904,9,569201615
4902,63583663869,71689,63583735558,9,0,1,1024,9,3477433677
4903,63583810421,4846,63583815267,7,0,0,5120,7,841108239
4904,63583826357,10753,63583837110,1,0,0,17408,1,6946681494
4905,63583860399,20878,63583881277,4,0,0,33792,4,10732758085
4906,63583891816,79300,63583971116,7,0,1,15872,7,9141627154
4907,63583973177,90740,63584063917,8,0,1,143872,8,7514342652
4908,63584000719,172060,63584172779,6,0,1,1536,6,10229361897
4909,63584211837,13854,63584225691,1,0,0,23552,1,5434428784
4910,63584279786,114071,63584393857,0,0,0,185344,0,2483908164
4911,63584357928,218850,63584576778,4,0,0,359424,4,10643843878
4912,63584373240,218806,63584592046,7,0,1,1024,7,207865022
4913,63584420859,172394,63584593253,1,0,0,62464,1,10579532739
4914,63584450204,169994,63584620198,9,0,0,96256,9,7446677625
4915,63584838274,1990,63584840264,7,0,0,2048,7,5112368955
4916,63584862435,15317,63584877752,4,0,0,29696,4,7921645907
4917,63584886167,5192,63584891359,3,0,0,13312,3,5225315067
4918,63584901009,5708,63584906717,0,0,0,14336,0,8212610598
4919,63584924146,70075,63584994221,1,0,1,77312,1,2344700823
4920,63584953394,35308,63584988702,6,0,1,5632,6,9186797448
4921,63584995210,153761,63585148971,2,0,0,61952,2,4491772103
4922,63585162175,24238,63585186413,1,0,1,347136,1,4005039992
4923,63585170469,296968,63585467437,9,0,1,2560,9,2664477334
4924,63585172499,289465,63585461964,1,0,0,40448,1,9444342175
4925,63585322929,176541,63585499470,1,0,0,290304,1,3917067405
4926,63585369725,135749,63585505474,4,0,0,20480,4,3655569228
4927,63585420789,77228,63585498017,9,0,1,512,9,8362229377
4928,63585438666,128670,63585567336,2,0,0,33280,2,9683019120
4929,63585847186,3641,63585850827,4,0,0,10240,4,3769424603
4930,63585900353,1038,63585901391,8,0,0,1024,8,1764303638
4931,63585949877,1990,63585951867,7,0,0,2048,7,5929641271
4932,63586023632,15317,63586038949,2,0,0,29696,2,9620729041
4933,63586110707,117880,63586228587,1,0,1,87040,1,10046567217
4934,63586209824,19793,63586229617,7,0,0,1024,7,10105681713
4935,63586798119,3641,63586801760,3,0,0,10240,3,2783600755
4936,63586908957,132770,63587041727,5,0,0,215040,5,6021581125
4937,63587092033,6484,63587098517,9,0,1,13824,9,4892470698
4938,63587096910,53749,63587150659,8,0,0,15872,8,2422454323
4939,63587171363,158618,63587329981,2,0,0,91136,2,8051655883
4940,63587194140,99548,63587293688,4,0,0,157184,4,9758586282
4941,63587317094,73829,63587390923,1,0,1,202240,1,2383965248
4942,63587346118,21395,63587367513,6,0,1,3584,6,34227911
4943,63587352521,156335,63587508856,6,0,1,1024,6,6533413112
4944,63587366662,33241,63587399903,9,0,0,120320,9,8248147862
4945,63587369545,191508,63587561053,1,0,1,50176,1,6198372742
4946,63587412576,187468,63587600044,8,0,1,154112,8,7019136598
4947,63587424898,348816,63587773714,1,0,1,60416,1,9827388477
4948,63587456214,5887,63587462101,0,0,0,34816,0,9436852794
4949,63587493756,314725,63587808481,3,0,0,57856,3,4134618795
4950,63587591555,19877,63587611432,7,0,1,12288,7,3582870785
4951,63587713028,6274,63587719302,7,0,0,512,7,10603900145
4952,63587721728,535203,63588256931,7,0,0,2048,7,1582598581
4953,63587749536,264505,63588014041,3,0,0,6656,3,10178204173
4954,63587827581,33309,63587860890,9,0,0,5120,9,3201264469
4955,63587840331,92081,63587932412,6,0,1,11264,6,221569534
4956,63587865557,214467,63588080024,8,0,1,208384,8,518767234
4957,63588049268,118064,63588167332,7,0,1,22016,7,4229009644
4958,63588110962,173556,63588284518,1,0,1,143360,1,4093407827
4959,63588113353,171176,63588284529,1,0,0,263680,1,3979598885
4960,63588116124,197123,63588313247,4,0,0,128000,4,7351158362
4961,63588174776,164904,63588339680,4,0,0,85504,4,6363068488
4962,63588335677,22429,63588358106,3,0,0,36864,3,5862189031
4963,63588534070,3383,63588537453,9,0,0,9728,9,801792515
4964,63588560042,107677,63588667719,7,0,1,11776,7,2681917132
4965,63588563315,123679,63588686994,9,0,0,200704,9,8491194678
4966,63588571715,126928,63588698643,4,0,0,39424,4,8454183281
4967,63588593495,98423,63588691918,2,0,1,11776,2,5440768702
4968,63588603446,90926,63588694372,4,0,0,5120,4,2789483519
4969,63588621568,162788,63588784356,3,0,0,34304,3,7116259279
4970,63588752487,60298,63588812785,2,0,1,1024,2,6721275330
4971,63588798007,20362,63588818369,0,0,0,32768,0,10068951081
4972,63588839282,45592,63588884874,0,0,1,1024,0,10595529771
4973,63588928610,274779,63589203389,4,0,0,444928,4,9872917909
4974,63588993658,220352,63589214010,2,0,1,2048,2,3106074708
4975,63589093567,145805,63589239372,3,0,0,122880,3,256541583
4976,63589154352,85584,63589239936,2,0,0,10752,2,8202245677
4977,63589188091,46541,63589234632,7,0,1,3072,7,5199867235
4978,63589198221,26205,63589224426,7,0,0,7680,7,10420217097
4979,63589218813,105631,63589324444,4,0,0,9216,4,1584918383
4980,63589286046,7687,63589293733,2,0,0,7168,2,4996300050
4981,63589313113,114867,63589427980,2,0,1,512,2,229472767
4982,63589430322,25442,63589455764,2,0,0,46080,2,5333819230
4983,63589436083,562,63589436645,0,0,1,29184,0,5138479721
4984,63589472239,158052,63589630291,7,0,0,512,7,3221784519
4985,63589635922,13079,63589649001,4,0,0,22016,4,92387411
4986,63589725707,33758,63589759465,5,0,0,58880,5,10324725667
4987,63589818480,32812,63589851292,0,0,0,53760,0,3795288036
4988,63589943019,23633,63589966652,1,0,0,42496,1,5181477947
4989,63589982948,103820,63590086768,7,0,1,12288,7,9790189381
4990,63590109243,24666,63590133909,1,0,0,44544,1,5960747239
4991,63590110943,55821,63590166764,7,0,1,512,7,3804815944
4992,63590169940,1038,63590170978,7,0,0,1024,7,568374018
4993,63590326598,95283,63590421881,1,0,0,158720,1,2482016811
4994,63590696251,13596,63590709847,2,0,1,2560,2,4942351014
4995,63590727088,50668,63590777756,1,0,0,23040,1,1269965846
4996,63590750560,105925,63590856485,1,0,0,176128,1,2930158270
4997,63590755432,112702,63590868134,3,0,0,39424,3,2711767116
4998,63590763498,105302,63590868800,3,0,0,1024,3,8290182515
4999,63590781637,87931,63590869568,8,0,0,11776,8,4049712464
5000,63590848797,23721,63590872518,7,0,1,1536,7,7494817590
5001,63590890820,82116,63590972936,7,0,1,9216,7,8286064603
5002,63590906043,223407,63591129450,2,0,0,39424,2,6732677111
5003,63590913970,200268,63591114238,8,0,0,314368,8,6111379549
5004,63590924008,87917,63591011925,9,0,1,13312,9,1667423158
5005,63591026332,74524,63591100856,4,0,0,1024,4,873064592
5006,63591043570,261290,63591304860,8,0,0,25088,8,4275444283
5007,63591100290,4158,63591104448,9,0,1,8704,9,4182122318
5008,63591143241,203556,63591346797,1,0,1,18944,1,7107849894
5009,63591198398,2942,63591201340,9,0,1,17920,9,7530526404
5010,63591213195,238172,63591451367,0,0,0,11264,0,5345217467
5011,63591306311,198405,63591504716,3,0,0,3072,3,3733150710
5012,63591447005,23204,63591470209,7,0,1,4096,7,4126276281
5013,63591449253,85079,63591534332,0,0,0,38400,0,6974540908
5014,63591460335,101075,63591561410,6,0,1,29696,6,7517120743
5015,63591495891,118841,63591614732,7,0,1,27136,7,7820068041
5016,63591504139,132787,63591636926,9,0,1,3072,9,4544369644
5017,63591645466,1514,63591646980,3,0,0,1536,3,5101640184
5018,63591650414,67588,63591718002,0,0,1,7680,0,9275464072
5019,63591727018,12821,63591739839,8,0,0,21504,8,4531064532
5020,63591795598,23891,63591819489,8,0,0,43008,8,109475462
5021,63591848321,41904,63591890225,4,0,0,68096,4,1220626727
5022,63591974393,133470,63592107863,7,0,1,2048,7,7544121747
5023,63592019854,111912,63592131766,1,0,1,66560,1,404636414
5024,63592114855,64490,63592179345,0,0,0,149504,0,3851085955
5025,63592116269,109215,63592225484,1,0,1,2048,1,10279436877
5026,63592128055,102121,63592230176,4,0,0,20992,4,7894967506
5027,63592133728,70703,63592204431,6,0,1,9728,6,9195543813
5028,63592160139,64651,63592224790,7,0,0,1024,7,9139990642
5029,63592166345,10762,63592177107,2,0,0,8704,2,1713769864
5030,63592220580,189347,63592409927,3,0,0,512,3,5546941650
5031,63592308726,14800,63592323526,2,0,0,28672,2,2675922246
5032,63592426066,3894,63592429960,2,0,1,2048,2,7679543750
5033,63592438224,48976,63592487200,1,0,0,4096,1,5430306346
5034,63592546152,31520,63592577672,8,0,1,40448,8,1822476470
5035,63592573254,103684,63592676938,1,0,1,84992,1,1828234089
5036,63592595856,55731,63592651587,0,0,0,51200,0,1623111136
5037,63592633309,181462,63592814771,9,0,1,512,9,5067710353
5038,63592722477,51136,63592773613,7,0,1,4096,7,1138848797
5039,63592835254,14113,63592849367,0,0,1,12288,0,6867312123
5040,63592864718,79744,63592944462,8,0,0,24064,8,2724381450
5041,63592936778,21395,63592958173,4,0,0,34816,4,1751636943
5042,63592946291,12868,63592959159,3,0,0,1536,3,5370233059
5043,63593059653,25958,63593085611,1,0,1,24576,1,8240392204
5044,63593075095,98848,63593173943,1,0,0,47104,1,1182686089
5045,63593153526,219771,63593373297,2,0,0,348160,2,7392466978
5046,63593189604,184999,63593374603,5,0,0,2048,5,7425276419
5047,63593193155,219752,63593412907,9,0,0,201728,9,2062251121
5048,63593213562,244120,63593457682,0,0,1,9216,0,455361406
5049,63593252841,196083,63593448924,0,0,0,47616,0,5262963594
5050,63593254609,195595,63593450204,9,0,0,14336,9,9004230092
5051,63593316288,134262,63593450550,3,0,0,512,3,10470484993
5052,63593540198,2466,63593542664,3,0,0,2560,3,3352881325
5053,63593683233,41387,63593724620,1,0,0,67072,1,5654911294
5054,63593828400,60820,63593889220,1,0,1,5632,1,4992974287
5055,63594130729,33846,63594164575,9,0,0,55808,9,10354385706
5056,63594194136,31779,63594225915,8,0,1,84480,8,8020498725
5057,63594239282,120218,63594359500,9,0,0,51712,9,10130155658
5058,63594246262,14683,63594260945,7,0,1,5120,7,3567554728
5059,63594300225,5967,63594306192,1,0,0,512,1,4302381137
5060,63594379526,47284,63594426810,6,0,1,1536,6,4189928137
5061,63594397664,250941,63594648605,2,0,0,14848,2,5471351484
5062,63594423062,103687,63594526749,2,0,0,168448,2,2708547916
5063,63594465092,62003,63594527095,7,0,0,512,7,6078869700
5064,63594527409,67113,63594594522,7,0,1,4096,7,1234692685
5065,63594560635,66200,63594626835,7,0,1,18432,7,4924752225
5066,63594561422,44932,63594606354,9,0,0,112128,9,9869185893
5067,63594584073,562,63594584635,0,0,0,14848,0,7560579045
5068,63594663394,129059,63594792453,7,0,0,512,7,4598112682
5069,63594909207,60820,63594970027,0,0,1,5632,0,4125424838
5070,63595025143,13337,63595038480,2,0,0,22528,2,2195587300
5071,63595084638,7226,63595091864,2,0,1,35328,2,5370324078
5072,63595143828,102124,63595245952,8,0,0,7680,8,7123560955
5073,63595518098,72664,63595590762,9,0,1,9216,9,10195056734
5074,63595539598,121166,63595660764,1,0,1,91648,1,335361136
5075,63595601957,73829,63595675786,0,0,0,120320,0,5010448033
5076,63595610531,175681,63595786212,0,0,1,15872,0,4107416968
5077,63595731317,33727,63595765044,9,0,1,24576,9,10372557719
5078,63595752496,108577,63595861073,9,0,0,49664,9,7852175605
5079,63595802588,1514,63595804102,6,0,1,23040,6,5910564375
5080,63595887990,134979,63596022969,6,0,1,16896,6,430771277
5081,63595896409,76540,63595972949,8,0,1,292864,8,2370039901
5082,63595920686,6332,63595927018,3,0,0,1536,3,4912586590
5083,63595944018,2466,63595946484,7,0,1,6144,7,8767368755
5084,63595962560,10237,63595972797,7,0,0,4608,7,5436963675
5085,63595990443,165376,63596155819,7,0,0,2560,7,177425252
5086,63596022753,313827,63596336580,6,0,1,4608,6,538973328
5087,63596061455,188906,63596250361,4,0,0,16384,4,562101765
5088,63596138329,74327,63596212656,7,0,0,1024,7,1509207607
5089,63596402006,1514,63596403520,7,0,0,1536,7,4261977827
5090,63596534091,25183,63596559274,6,0,1,1024,6,8499256607
5091,63596539759,45592,63596585351,4,0,0,45568,4,4802140970
5092,63596661531,94337,63596755868,0,0,0,153600,0,7773731779
5093,63596691116,65738,63596756854,7,0,0,1536,7,3758310790
5094,63596747673,1514,63596749187,9,0,1,10752,9,8670848838
5095,63596764742,80680,63596845422,5,0,0,1536,5,4446856068
5096,63596804892,210282,63597015174,9,0,1,15360,9,9049962228
5097,63596929994,1038,63596931032,9,0,1,20480,9,3470884286
5098,63596990784,97600,63597088384,2,0,0,1024,2,381749402
5099,63597121427,64650,63597186077,9,0,0,109056,9,8699544852
5100,63597340033,562,63597340595,5,0,0,512,5,4405070846
5101,63597343480,201146,63597544626,8,0,1,56832,8,4095138731
5102,63597590310,63833,63597654143,8,0,1,30208,8,6341491532
5103,63597607739,100564,63597708303,9,0,1,1024,9,10077011338
5104,63597622326,70936,63597693262,6,0,1,512,6,4490361493
5105,63597634547,1038,63597635585,7,0,1,20480,7,4592908214
5106,63597713159,97600,63597810759,5,0,0,1024,5,10456319083
5107,63597746483,70972,63597817455,9,0,1,8704,9,5380856264
5108,63597908603,81370,63597989973,9,0,0,131584,9,1814178235
5109,63597909770,2466,63597912236,8,0,1,16896,8,1406921798
5110,63598072730,175738,63598248468,5,0,0,2560,5,8335928529
5111,63598105872,77740,63598183612,9,0,1,10752,9,574198153
5112,63598200904,50668,63598251572,0,0,1,9728,0,2995800481
5113,63598268885,123732,63598392617,0,0,1,2560,0,10000011664
5114,63598314277,69280,63598383557,7,0,1,8192,7,1773227439
5115,63598318686,125658,63598444344,2,0,0,207872,2,6286520898
5116,63598334749,120117,63598454866,8,0,0,41984,8,7717814183
5117,63598336964,46161,63598383125,2,0,1,1536,2,2266702422
5118,63598430415,183696,63598614111,2,0,0,71168,2,2997062581
5119,63598579690,1990,63598581680,1,0,1,100864,1,9070422253
5120,63598688808,190008,63598878816,7,0,0,2048,7,6388681000
5121,63598699254,104800,63598804054,6,0,1,9728,6,8762172886
5122,63598902397,1514,63598903911,7,0,0,1536,7,6464366451
5123,63598923763,65896,63598989659,7,0,1,7168,7,5403824559
5124,63599140114,26217,63599166331,2,0,0,47616,2,8137247443
5125,63599205561,2466,63599208027,0,0,1,3072,0,781609771
5126,63599210951,137460,63599348411,3,0,0,2560,3,7598641939
5127,63599331742,13766,63599345508,0,0,0,26624,0,5468677724
5128,63599341701,6393,63599348094,8,0,0,4096,8,8698138743
5129,63599366188,144709,63599510897,9,0,1,21504,9,10062078390
5130,63599391123,133804,63599524927,1,0,0,217088,1,2274063432
5131,63599404503,10495,63599414998,7,0,1,3072,7,8255408981
5132,63599450446,240821,63599691267,6,0,1,1024,6,419930043
5133,63599511587,201934,63599713521,2,0,1,3584,2,4672137650
5134,63599548259,172635,63599720894,2,0,0,16896,2,2031657710
5135,63599785647,64204,63599849851,2,0,1,6656,2,7566034541
5136,63599841913,22946,63599864859,4,0,0,37888,4,2724243229
5137,63599845851,14541,63599860392,6,0,1,4096,6,1062222678
5138,63599930260,112871,63600043131,4,0,0,28160,4,6685947240
5139,63600005214,25958,63600031172,4,0,0,47104,4,1708898054
5140,63600228257,2866,63600231123,8,0,1,282624,8,3459527058
5141,63600233338,268096,63600501434,2,0,0,8704,2,4594004477
5142,63600258364,241276,63600499640,2,0,1,10752,2,10158988047
5143,63600388448,111203,63600499651,1,0,0,70144,1,1785726039
5144,63600394815,33827,63600428642,9,0,1,4096,9,6064248532
5145,63600469974,119437,63600589411,0,0,0,11264,0,8419752121
5146,63600587690,79432,63600667122,9,0,1,11264,9,9480803297
5147,63600737899,20620,63600758519,7,0,1,17920,7,7416415775
5148,63600780794,19210,63600800004,1,0,0,33280,1,820194268
5149,63600782870,93748,63600876618,3,0,0,1024,3,8075264978
5150,63600855021,562,63600855583,7,0,0,512,7,6812484407
5151,63600929111,3418,63600932529,7,0,0,3584,7,8918723253
5152,63600934547,562,63600935109,8,0,1,50176,8,5848029258
5153,63601030468,185777,63601216245,7,0,0,512,7,4789772793
5154,63601168013,74516,63601242529,3,0,0,124928,3,7491895096
5155,63601297672,12821,63601310493,3,0,0,21504,3,3346710181
5156,63601303842,107465,63601411307,7,0,1,17920,7,7370046508
5157,63601344968,106563,63601451531,2,0,1,19968,2,2940736583
5158,63601416224,43900,63601460124,2,0,1,512,2,3166328212
5159,63601486315,562,63601486877,0,0,0,512,0,1989502007
5160,63601517058,1038,63601518096,5,0,0,1024,5,6098461319
5161,63601558300,4370,63601562670,5,0,0,4608,5,6963269695
5162,63601562823,10753,63601573576,4,0,0,17408,4,6836639333
5163,63601671598,74604,63601746202,2,0,0,121856,2,826242627
5164,63601697317,49346,63601746663,8,0,0,10240,8,2730625202
5165,63601962308,84900,63602047208,1,0,0,141824,1,7119773359
5166,63602030992,103170,63602134162,2,0,0,167424,2,1061208860
5167,63602034815,184338,63602219153,2,0,0,226816,2,1072467395
5168,63602076202,148852,63602225054,2,0,0,28160,2,343062785
5169,63602156725,68893,63602225618,8,0,0,10752,8,4072283632
5170,63602204226,121781,63602326007,2,0,1,8704,2,3659690942
5171,63602229594,1038,63602230632,7,0,1,2560,7,1889299946
5172,63602254858,210822,63602465680,6,0,1,6656,6,5592683971
5173,63602372997,41645,63602414642,6,0,1,8192,6,9253000030
5174,63602398428,212151,63602610579,5,0,0,1024,5,8330069256
5175,63602399232,192944,63602592176,2,0,0,67584,2,4287943634
5176,63602701561,562,63602702123,7,0,0,512,7,8390529918
5177,63602721715,2466,63602724181,8,0,1,165376,8,2410010447
5178,63602756348,225533,63602981881,0,0,0,2560,0,7538953398
5179,63602802747,144512,63602947259,8,0,0,157696,8,5345427976
5180,63602928484,12703,63602941187,7,0,1,23040,7,8168763975
5181,63602935611,104859,63603040470,7,0,0,1024,7,9581813005
5182,63603071641,135354,63603206995,4,0,0,220160,4,7013368888
5183,63603219480,26217,63603245697,4,0,0,47616,4,3676876668
5184,63603284408,5322,63603289730,5,0,0,5632,5,9981382997
5185,63603496330,24925,63603521255,9,0,1,1024,9,7372212394
5186,63603506635,45592,63603552227,9,0,1,36864,9,6208186486
5187,63603511401,121385,63603632786,4,0,0,45056,4,8614295375
5188,63603590375,1514,63603591889,6,0,1,3072,6,629423703
5189,63603629592,562,63603630154,5,0,0,1536,5,7181119002
5190,63603657043,12733,63603669776,5,0,0,512,5,5735041149
5191,63603665242,109441,63603774683,1,0,0,24576,1,6142360094
5192,63603736562,67144,63603803706,2,0,1,11264,2,10598831021
5193,63603825764,12991,63603838755,4,0,0,25088,4,8862975896
5194,63603876484,562,63603877046,8,0,1,157696,8,2886712564
5195,63604007069,216851,63604223920,0,0,0,512,0,241275231
5196,63604013976,84988,63604098964,2,0,0,138752,2,8486296761
5197,63604030483,274734,63604305217,0,0,1,512,0,8760320323
5198,63604311760,3418,63604315178,8,0,1,61952,8,293226547
5199,63604367393,110236,63604477629,0,0,1,15872,0,2930928103
5200,63604387735,83940,63604471675,6,0,1,13824,6,8526544897
5201,63604391037,98612,63604489649,0,0,0,3584,0,9769893370
5202,63604828715,47284,63604875999,2,0,1,1536,2,1456766529
5203,63604869826,13766,63604883592,3,0,0,26624,3,6342124606
5204,63604912907,80020,63604992927,6,0,1,16384,6,10454870644
5205,63604922111,155608,63605077719,9,0,1,3072,9,4074868093
5206,63605108979,1514,63605110493,8,0,1,23040,8,7435185773
5207,63605153975,93772,63605247747,0,0,0,1536,0,10549494531
5208,63605217675,43900,63605261575,2,0,1,512,2,7287199630
5209,63605337417,25700,63605363117,2,0,0,46592,2,2704817420
5210,63605359698,4675,63605364373,3,0,0,12288,3,9457518531
5211,63605369139,4370,63605373509,2,0,1,3584,2,3192394281
5212,63605407677,86047,63605493724,7,0,0,4608,7,6401118148
5213,63605441797,82404,63605524201,4,0,0,133632,4,8961818642
5214,63605465023,85135,63605550158,7,0,1,7680,7,5355677962
5215,63605539688,84900,63605624588,1,0,0,141824,1,7718780781
5216,63605540051,67484,63605607535,8,0,1,29696,8,3796701773
5217,63605557872,562,63605558434,4,0,0,11776,4,9997195046
5218,63605675356,304209,63605979565,7,0,0,512,7,1701347054
5219,63605951400,1990,63605953390,5,0,0,2048,5,7507519463
5220,63605997083,562,63605997645,8,0,1,158208,8,2398578261
5221,63606000347,188716,63606189063,7,0,0,512,7,4730445229
5222,63606125109,60701,63606185810,8,0,0,95232,8,7661552306
5223,63606268410,562,63606268972,7,0,0,512,7,2552905464
5224,63606328127,70528,63606398655,6,0,1,12288,6,9151237652
5225,63606373207,103170,63606476377,4,0,0,167424,4,5527922342
5226,63606530661,33499,63606564160,1,0,0,58368,1,10327158083
5227,63606755826,80836,63606836662,9,0,1,15872,9,10324045362
5228,63606866866,1514,63606868380,7,0,0,1536,7,7165058906
5229,63606933523,562,63606934085,0,0,0,512,0,151779936
5230,63607327961,30487,63607358448,8,0,0,49152,8,10544948757
5231,63607366163,56075,63607422238,4,0,0,95744,4,10024609794
5232,63607469135,12045,63607481180,2,0,0,19968,2,6901768446
5233,63607650776,6274,63607657050,0,0,1,11264,0,9675667102
5234,63607670300,80682,63607750982,5,0,0,6656,5,6330015838
5235,63607690994,196204,63607887198,8,0,1,182784,8,9363935178
5236,63607763223,152503,63607915726,3,0,0,246784,3,9939966575
5237,63607796391,135298,63607931689,4,0,0,59904,4,1770800529
5238,63607831344,115898,63607947242,2,0,0,49664,2,8490456748
5239,63607905833,43035,63607948868,5,0,0,2560,5,2111356767
5240,63607913223,26052,63607939275,0,0,1,2560,0,4963482409
5241,63607928103,96740,63608024843,4,0,0,16896,4,8288100455
5242,63608031019,83826,63608114845,6,0,1,6656,6,5789548248
5243,63608117771,12562,63608130333,8,0,0,20992,8,1673581163
5244,63608183708,48976,63608232684,9,0,1,2048,9,4966883743
5245,63608250181,52360,63608302541,2,0,1,3072,2,4540310309
5246,63608339648,562,63608340210,0,0,0,512,0,7756323551
5247,63608352024,562,63608352586,6,0,1,16896,6,1910408352
5248,63608362245,96508,63608458753,0,0,0,512,0,1173355613
5249,63608476354,64650,63608541004,1,0,0,109056,1,7042685226
5250,63608586484,2942,63608589426,5,0,0,3072,5,9029857764
5251,63608654362,100720,63608755082,0,0,1,30720,0,1708961992
5252,63608792224,12045,63608804269,9,0,1,11264,9,4836337204
5253,63608810132,64072,63608874204,6,0,1,11776,6,6527768604
5254,63608822865,79588,63608902453,8,0,0,19968,8,3493458432
5255,63608897940,13854,63608911794,9,0,1,11776,9,9751400967
5256,63608919369,78841,63608998210,2,0,0,23552,2,1223498838
5257,63608981491,21654,63609003145,1,0,0,35328,1,6825975189
5258,63609090620,1038,63609091658,0,0,1,14848,0,4978653550
5259,63609120696,71308,63609192004,7,0,0,1024,7,9629461781
5260,63609227776,10237,63609238013,2,0,0,16384,2,4301416858
5261,63609240664,1038,63609241702,0,0,0,1024,0,7579322794
5262,63609244208,51512,63609295720,6,0,1,6656,6,6449516475
5263,63609303195,114915,63609418110,3,0,0,83456,3,4541605209
5264,63609425412,4846,63609430258,9,0,1,25088,9,4971248767
5265,63609470211,2466,63609472677,7,0,0,5120,7,3495209135
5266,63609504231,138676,63609642907,2,0,1,7168,2,7147970924
5267,63609535780,65896,63609601676,0,0,0,2560,0,4260045653
5268,63609675384,25442,63609700826,2,0,0,46080,2,7761333449
5269,63609745715,3418,63609749133,2,0,1,4096,2,1038259309
5270,63609779396,55744,63609835140,0,0,0,3584,0,6992569047
5271,63609881418,90856,63609972274,6,0,1,23552,6,4499176043
5272,63610162125,562,63610162687,0,0,0,512,0,8819546031
5273,63610167831,34363,63610202194,4,0,0,56832,4,9739033568
5274,63610306452,562,63610307014,5,0,0,512,5,1166478868
5275,63610320652,11012,63610331664,1,0,0,17920,1,3083451615
5276,63610356408,5450,63610361858,8,0,0,13824,8,7403637786
5277,63610403020,10237,63610413257,8,0,1,57344,8,1830116930
5278,63610431846,1514,63610433360,4,0,0,16384,4,2403384598
5279,63610485066,108832,63610593898,7,0,0,1536,7,5636085395
5280,63610788395,35308,63610823703,3,0,0,61952,3,4595987718
5281,63610791115,59829,63610850944,1,0,0,74752,1,1550497798
5282,63610848232,1990,63610850222,9,0,1,3072,9,7142979489
5283,63610899491,82766,63610982257,5,0,0,2048,5,1745778999
5284,63611073927,15317,63611089244,2,0,0,29696,2,149885099
5285,63611126127,50263,63611176390,8,0,1,30720,8,9203549424
5286,63611132775,134897,63611267672,9,0,1,1024,9,7082877058
5287,63611340776,100720,63611441496,0,0,1,30720,0,4203921552
5288,63611469254,67456,63611536710,6,0,1,12288,6,2992333297
5289,63611582727,23979,63611606706,1,0,0,39936,1,9651388102
5290,63611734904,1038,63611735942,0,0,0,1024,0,1214978376
5291,63611773418,2942,63611776360,7,0,0,3072,7,7793737115
5292,63612004626,56592,63612061218,4,0,0,96768,4,3437099741
5293,63612014888,139520,63612154408,6,0,1,20480,6,5635651870
5294,63612015904,166343,63612182247,0,0,1,11264,0,755005320
5295,63612395731,102904,63612498635,0,0,1,37888,0,4398476868
5296,63612693713,562,63612694275,5,0,0,512,5,8789471593
5297,63612895029,3383,63612898412,3,0,0,9728,3,6568151726
5298,63612937300,139720,63613077020,0,0,1,2560,0,2462651757
5299,63613315728,5322,63613321050,2,0,1,2560,2,7900497300
5300,63613344126,50668,63613394794,5,0,0,5632,5,6217435069
5301,63613421819,47284,63613469103,7,0,1,1536,7,3935080118
5302,63613459979,106336,63613566315,8,0,1,49152,8,7711832413
5303,63613559679,9094,63613568773,7,0,0,2560,7,7279157818
5304,63613889324,3418,63613892742,7,0,0,3584,7,9678188422
5305,63613952346,562,63613952908,7,0,1,512,7,9405456800
5306,63613973936,43900,63614017836,7,0,0,512,7,652311921
5307,63613991964,33071,63614025035,2,0,0,54272,2,759909561
5308,63614065561,562,63614066123,9,0,1,17920,9,1082147159
5309,63614086372,119886,63614206258,3,0,0,512,3,5750788178
5310,63614166652,53218,63614219870,9,0,1,2560,9,7493031093
5311,63614436740,95283,63614532023,1,0,0,158720,1,439789961
5312,63614586563,1038,63614587601,0,0,0,1024,0,8729857865
5313,63614685347,1514,63614686861,2,0,0,1536,2,2813323284
5314,63614724391,1990,63614726381,9,0,1,9728,9,2615420577
5315,63614766116,74356,63614840472,0,0,0,2048,0,7022128706
5316,63614789188,4370,63614793558,8,0,1,100864,8,838562013
5317,63614807686,3894,63614811580,0,0,0,4608,0,1392999638
5318,63614842512,142002,63614984514,5,0,0,4096,5,8136152832
5319,63614985431,562,63614985993,5,0,0,512,5,1879437825
5320,63615045938,1038,63615046976,5,0,0,1024,5,2376010167
5321,63615082472,232987,63615315459,4,0,0,376832,4,2057814737
5322,63615286222,45712,63615331934,3,0,0,62464,3,4357449107
5323,63615289491,143642,63615433133,6,0,1,10752,6,2880829015
5324,63615710640,96833,63615807473,4,0,0,161792,4,5393738241
5325,63615745861,62380,63615808241,1,0,0,11776,1,3594847450
5326,63615869382,62512,63615931894,9,0,1,6144,9,4194303938
5327,63616057663,562,63616058225,5,0,0,512,5,4202436748
5328,63616061245,562,63616061807,0,0,0,512,0,1225981265
5329,63616062539,2466,63616065005,7,0,1,5632,7,7326890515
5330,63616063676,59284,63616122960,7,0,0,2560,7,1161584171
5331,63616080538,33241,63616113779,8,0,1,135168,8,4210104111
5332,63616134740,215312,63616350052,4,0,0,57856,4,4430991532
5333,63616165093,131860,63616296953,6,0,1,3584,6,3229436239
5334,63616414262,6225,63616420487,4,0,0,15360,4,8747001411
5335,63616416865,117917,63616534782,1,0,0,192000,1,47956533
5336,63616537035,25183,63616562218,8,0,0,45568,8,2663638696
5337,63616540936,61012,63616601948,9,0,1,3584,9,5843968700
5338,63616568683,138079,63616706762,2,0,1,6144,2,547024733
5339,63616739863,3894,63616743757,0,0,0,4096,0,8708013055
5340,63616828644,1038,63616829682,7,0,1,31232,7,7583340065
5341,63616856067,2466,63616858533,0,0,0,1024,0,4549457185
5342,63616867369,100876,63616968245,7,0,0,2560,7,1768082570
5343,63616966225,2466,63616968691,0,0,0,2560,0,10309328546
5344,63617206994,3894,63617210888,2,0,0,4096,2,10651120193
5345,63617350353,34791,63617385144,8,0,0,60928,8,1006093779
5346,63617401513,174829,63617576342,0,0,1,6144,0,1579925981
5347,63617635465,1514,63617636979,7,0,0,1536,7,5163237205
5348,63617750147,43900,63617794047,0,0,1,512,0,6683865113
5349,63617885279,103528,63617988807,6,0,1,39936,6,2002259727
5350,63617892709,114722,63618007431,6,0,1,15360,6,111514421
5351,63617984600,62935,63618047535,5,0,1,3584,5,6473933732
5352,63618011693,131995,63618143688,4,0,0,213504,4,363127026
5353,63618053136,106207,63618159343,8,0,0,50176,8,7813676913
5354,63618112618,50911,63618163529,0,0,0,6656,0,4009065185
5355,63618116828,48007,63618164835,2,0,0,2048,2,404753626
5356,63618132477,32780,63618165257,5,0,1,5120,5,875841446
5357,63618132721,3894,63618136615,5,0,0,1024,5,7579523743
5358,63618212832,105792,63618318624,3,0,0,4096,3,9186239120
5359,63618279120,1514,63618280634,5,0,0,1536,5,3834747421
5360,63618369071,73468,63618442539,5,0,1,16896,5,10427719819
5361,63618527241,562,63618527803,9,0,1,8704,9,1569819338
5362,63618530435,562,63618530997,0,0,0,512,0,6537386432
5363,63618576907,562,63618577469,7,0,0,512,7,10596586713
5364,63618579452,70972,63618650424,7,0,0,512,7,10032348734
5365,63618619136,562,63618619698,2,0,0,512,2,5599026003
5366,63618648445,562,63618649007,5,0,0,512,5,6788172401
5367,63618858439,1038,63618859477,0,0,0,1024,0,3807148437
5368,63618946415,2942,63618949357,2,0,0,3072,2,4316212175
5369,63618961185,562,63618961747,0,0,0,512,0,826390891
5370,63619009065,51770,63619060835,2,0,1,30720,2,8332447644
5371,63619017597,82060,63619099657,7,0,1,14848,7,10216175940
5372,63619020463,100720,63619121183,8,0,0,83968,8,10367420633
5373,63619080628,10753,63619091381,0,0,1,7168,0,536507404
5374,63619128881,72664,63619201545,8,0,0,17408,8,2279287725
5375,63619141060,180836,63619321896,0,0,1,9216,0,6267615359
5376,63619174555,43900,63619218455,7,0,1,10240,7,2903649556
5377,63619220173,125051,63619345224,6,0,1,512,6,186290305
5378,63619324893,1990,63619326883,0,0,0,2048,0,6689608373
5379,63619437795,1038,63619438833,7,0,0,1024,7,4005250612
5380,63619535566,48976,63619584542,6,0,1,2048,6,9653788134
5381,63619678190,47284,63619725474,5,0,1,1536,5,10251150288
5382,63619730602,36600,63619767202,8,0,0,64512,8,10637174559
5383,63619815707,4158,63619819865,8,0,1,16896,8,5105569241
5384,63619851363,96282,63619947645,3,0,0,11264,3,1296351455
5385,63620099971,110392,63620210363,8,0,1,62464,8,3142961234
5386,63620145247,65127,63620210374,8,0,0,100864,8,958160800
5387,63620253384,2942,63620256326,5,0,0,3072,5,2718396973
5388,63620295357,1038,63620296395,7,0,1,32256,7,2459953642
5389,63620301126,102744,63620403870,2,0,1,1024,2,9972574046
5390,63620313489,131131,63620444620,5,0,0,1024,5,1283957179
5391,63620447681,562,63620448243,7,0,0,512,7,1677546947
5392,63620456069,90364,63620546433,9,0,1,16896,9,7426418104
5393,63620539901,12821,63620552722,8,0,0,21504,8,5306282202
5394,63620550475,124121,63620674596,9,0,1,27648,9,2683859822
5395,63620678987,3418,63620682405,1,0,0,3584,1,9517171542
5396,63620741696,562,63620742258,5,0,0,512,5,6248727703
5397,63620755831,92270,63620848101,3,0,0,149504,3,4738300781
5398,63620781555,108890,63620890445,1,0,0,137216,1,7334299473
5399,63620794588,96843,63620891431,4,0,0,1536,4,6493108931
5400,63620815102,5322,63620820424,0,0,1,5632,0,9910184340
5401,63620928558,99936,63621028494,2,0,1,4096,2,1643176978
5402,63621009035,234380,63621243415,2,0,0,5632,2,7769997878
5403,63621030883,60820,63621091703,7,0,1,5632,7,6805280900
5404,63621187683,1038,63621188721,6,0,1,16896,6,2473642562
5405,63621244956,91900,63621336856,2,0,0,1024,2,1061032664
5406,63621303105,1990,63621305095,7,0,0,2048,7,5845366870
5407,63621316988,53837,63621370825,4,0,0,88064,4,4140589491
5408,63621362295,93733,63621456028,4,0,0,155648,4,4413092033
5409,63621486691,562,63621487253,1,0,1,21504,1,8684653037
5410,63621569165,35567,63621604732,2,0,0,512,2,6297103071
5411,63621574042,5967,63621580009,1,0,0,62464,1,1186137578
5412,63621648998,184627,63621833625,1,0,0,14848,1,3616215524
5413,63621718919,101188,63621820107,9,0,1,32256,9,4700408058
5414,63621728966,109327,63621838293,7,0,1,5120,7,5470076186
5415,63621741530,176541,63621918071,4,0,0,290304,4,6479407139
5416,63621774493,144244,63621918737,5,0,0,1024,5,2171160167
5417,63621777411,343909,63622121320,1,0,1,169984,1,8247149425
5418,63621879533,251478,63622131011,0,0,1,31744,0,4705436154
5419,63622085043,86937,63622171980,6,0,1,2560,6,6813734513
5420,63622207393,12045,63622219438,8,0,0,19968,8,7974186708
5421,63622327028,86200,63622413228,2,0,1,13312,2,4440249986
5422,63622476764,71776,63622548540,9,0,1,16384,9,8269120012
5423,63622557301,30487,63622587788,3,0,0,49152,3,1692385717
5424,63622602612,68056,63622670668,0,0,1,4608,0,9575613670
5425,63622618205,103076,63622721281,5,0,1,9216,5,2207490300
5426,63622729356,90703,63622820059,2,0,1,512,2,3484977917
5427,63622740831,102124,63622842955,1,0,1,35328,1,7388557286
5428,63622781153,130796,63622911949,7,0,1,33792,7,1790522865
5429,63622790630,157067,63622947697,4,0,0,259072,4,1658533359
5430,63622793289,201578,63622994867,8,0,0,152064,8,2947409545
5431,63622919315,148739,63623068054,0,0,1,15360,0,6281741427
5432,63622953965,148979,63623102944,5,0,1,12800,5,1831068698
5433,63623036858,110386,63623147244,7,0,1,10752,7,5074370209
5434,63623068703,562,63623069265,8,0,1,12288,8,2421639230
5435,63623158266,174382,63623332648,7,0,0,512,7,10673795757
5436,63623195079,57109,63623252188,3,0,0,97792,3,3774200192
5437,63623220683,3418,63623224101,6,0,1,512,6,4513513925
5438,63623260111,97613,63623357724,8,0,1,6144,8,10675957032
5439,63623302160,76797,63623378957,0,0,0,3584,0,3561846276
5440,63623307613,97180,63623404793,0,0,1,29184,0,4855473059
5441,63623492238,1990,63623494228,7,0,0,2048,7,2419375994
5442,63623499247,52360,63623551607,9,0,1,3072,9,544193781
5443,63623551600,24238,63623575838,1,0,0,40448,1,7833962843
5444,63623616916,2466,63623619382,0,0,0,2560,0,9917363753
5445,63623735919,1514,63623737433,5,0,0,1536,5,7590876232
5446,63623765112,132988,63623898100,8,0,1,131584,8,6549267995
5447,63623780070,135070,63623915140,3,0,1,31232,3,7003760814
5448,63623792146,136440,63623928586,2,0,1,8704,2,20049070
5449,63623888678,60667,63623949345,8,0,0,82944,8,2414414126
5450,63623906579,44712,63623951291,5,0,0,3072,5,3553973158
5451,63623952559,74668,63624027227,2,0,1,10752,2,9005215497
5452,63623986005,80683,63624066688,1,0,1,8704,1,5214552354
5453,63624109511,562,63624110073,1,0,0,512,1,655542143
5454,63624113247,25183,63624138430,3,0,0,45568,3,6631278045
5455,63624170984,6225,63624177209,8,0,1,910336,8,6908063667
5456,63624186019,5967,63624191986,4,0,0,15360,4,8897647853
5457,63624498043,745022,63625243065,4,0,0,14848,4,8345202032
5458,63624507025,349769,63624856794,3,0,1,2560,3,4270878088
5459,63624569680,413215,63624982895,0,0,1,11264,0,10204285865
5460,63624613718,306705,63624920423,5,0,1,512,5,6356981871
5461,63624686364,264913,63624951277,1,0,0,49664,1,9121982284
5462,63624699413,252530,63624951943,0,0,0,1024,0,6247060417
5463,63624762867,194773,63624957640,8,0,0,18944,8,10576861922
5464,63624824682,133304,63624957986,0,0,0,512,0,6975843129
5465,63624837055,121277,63624958332,2,0,0,512,2,6703924976
5466,63624866017,95861,63624961878,2,0,0,5632,2,188388112
5467,63624888285,48321,63624936606,4,0,0,27648,4,2056065489
5468,63624916119,79392,63624995511,6,0,1,512,6,9913357531
5469,63624943901,29473,63624973374,4,0,0,18944,4,7631705369
5470,63624976502,35825,63625012327,7,0,1,2048,7,8122656581
5471,63624995878,86190,63625082068,4,0,0,62976,4,8094892588
5472,63625028759,55817,63625084576,3,0,1,1536,3,409363258
5473,63625046799,210917,63625257716,9,0,1,53248,9,1587256595
5474,63625073757,3124,63625076881,8,0,0,95232,8,9212761304
5475,63625089873,205372,63625295245,8,0,1,271872,8,2255233529
5476,63625230122,397327,63625627449,3,0,0,9216,3,6656285759
5477,63625357525,165729,63625523254,8,0,0,269312,8,7522336985
5478,63625390287,23822,63625414109,3,0,1,10240,3,8316514863
5479,63625392403,562,63625392965,2,0,1,5632,2,9660640495
5480,63625502658,228878,63625731536,7,0,0,5120,7,204851468
5481,63625586434,276629,63625863063,7,0,0,512,7,10638972426
5482,63625597492,1038,63625598530,2,0,1,6656,2,4771001376
5483,63625677881,96092,63625773973,0,0,0,1024,0,4860398019
5484,63625788044,64204,63625852248,0,0,1,6656,0,2368104576
5485,63625804755,93045,63625897800,8,0,0,151040,8,5024575755
5486,63625831906,68800,63625900706,0,0,0,4608,0,4352257672
5487,63625893857,12733,63625906590,8,0,0,24576,8,10255814013
5488,63625896209,10945,63625907154,1,0,0,10752,1,7322037681
5489,63625913007,151619,63626064626,6,0,1,26112,6,6864708050
5490,63625990826,105374,63626096200,1,0,1,3584,1,6277037718
5491,63626207330,562,63626207892,2,0,0,512,2,730716739
5492,63626242721,74980,63626317701,9,0,1,11776,9,9510740361
5493,63626269575,64133,63626333708,4,0,0,108032,4,3223328635
5494,63626285084,76584,63626361668,5,0,1,5120,5,5366574414
5495,63626387871,6225,63626394096,5,0,1,8192,5,10536431147
5496,63626417801,69280,63626487081,8,0,0,15360,8,10083496277
5497,63626489107,70972,63626560079,5,0,1,8704,5,8820442561
5498,63626595752,26475,63626622227,3,0,0,48128,3,6953771731
5499,63626626406,44916,63626671322,4,0,0,77312,4,1099568399
5500,63626649967,84773,63626734740,8,0,0,138240,8,6368469955
5501,63626804213,46984,63626851197,1,0,0,81408,1,1147550601
5502,63626888710,98248,63626986958,1,0,1,4096,1,7715520276
5503,63626944788,69686,63627014474,6,0,1,27648,6,1181202249
5504,63626975545,60820,63627036365,0,0,1,7168,0,1761996335
5505,63627006717,186946,63627193663,9,0,1,5632,9,2902479174
5506,63627085035,562,63627085597,2,0,0,512,2,7492422000
5507,63627303539,1514,63627305053,7,0,0,1536,7,5260075616
5508,63627498706,21395,63627520101,4,0,0,34816,4,5076070326
5509,63627532097,2466,63627534563,5,0,1,6656,5,2533347064
5510,63627553688,81045,63627634733,3,0,1,3584,3,8232304289
5511,63627622845,562,63627623407,5,0,0,2560,5,8626504095
5512,63627636688,175582,63627812270,0,0,0,512,0,5431491325
5513,63627681078,31779,63627712857,3,0,1,12800,3,5790817020
5514,63627708867,65896,63627774763,6,0,1,7168,6,8344006534
5515,63627711514,106851,63627818365,4,0,0,51712,4,6653144345
5516,63627975460,57436,63628032896,3,0,1,4608,3,7417829932
5517,63627999539,79300,63628078839,5,0,1,15872,5,1492156630
5518,63628084171,52360,63628136531,0,0,1,3072,0,2107478756
5519,63628129989,43900,63628173889,5,0,1,512,5,2411981131
5520,63628293883,11012,63628304895,4,0,0,17920,4,7218483068
5521,63628326752,1038,63628327790,9,0,1,36864,9,6159210415
5522,63628348881,14800,63628363681,7,0,0,1024,7,1613512477
5523,63628377006,1990,63628378996,1,0,0,28672,1,1369015411
5524,63628458454,150976,63628609430,7,0,0,2048,7,2204542311
5525,63628464118,13621,63628477739,1,0,0,22016,1,6048751993
5526,63628524046,117497,63628641543,0,0,1,6656,0,4188357726
5527,63628603692,96976,63628700668,6,0,1,18432,6,6892610523
5528,63628649970,60820,63628710790,9,0,1,5632,9,5449575597
5529,63628712445,50668,63628763113,2,0,1,2560,2,6252350096
5530,63628971009,562,63628971571,0,0,1,4608,0,6187441499
5531,63628978496,54364,63629032860,7,0,0,512,7,7705130266
5532,63629174307,57109,63629231416,1,0,0,97792,1,513008022
5533,63629256610,22687,63629279297,2,0,1,4608,2,9673499879
5534,63629265745,55558,63629321303,3,0,0,37376,3,1825334607
5535,63629293661,174404,63629468065,8,0,0,94720,8,1673999382
5536,63629388413,562,63629388975,8,0,1,92672,8,5054943393
5537,63629449955,1514,63629451469,0,0,0,512,0,2403546155
5538,63629452756,120482,63629573238,5,0,0,1536,5,2076879462
5539,63629472379,8958,63629481337,2,0,1,12288,2,9981831683
5540,63629501443,85550,63629586993,5,0,0,1536,5,2973499539
5541,63629609196,48976,63629658172,3,0,1,2048,3,6448373487
5542,63629676047,1038,63629677085,7,0,0,1024,7,10119582197
5543,63629794871,16609,63629811480,4,0,0,32256,4,2457163921
5544,63629925767,43900,63629969667,1,0,1,512,1,9322386185
5545,63629979077,1038,63629980115,7,0,0,1024,7,2835054533
5546,63629989228,57109,63630046337,4,0,0,97792,4,5742933134
5547,63629994284,52399,63630046683,2,0,0,512,2,1775336827
5548,63630024015,68951,63630092966,1,0,1,12800,1,7474311643
5549,63630066876,52360,63630119236,7,0,1,512,7,4758804551
5550,63630086269,159866,63630246135,0,0,1,4096,0,4115426029
5551,63630183770,260100,63630443870,2,0,1,3072,2,2902233555
5552,63630289408,1038,63630290446,9,0,1,18432,9,3041904579
5553,63630328384,90832,63630419216,1,0,1,1536,1,8127294253
5554,63630336615,52335,63630388950,7,0,0,1024,7,10124118936
5555,63630347330,66076,63630413406,6,0,1,12800,6,2650510099
5556,63630366307,78037,63630444344,6,0,1,14848,6,171095986
5557,63630446032,61132,63630507164,9,0,1,6656,9,4806709180
5558,63630455103,84988,63630540091,4,0,0,138752,4,7465586738
5559,63630546632,1990,63630548622,9,0,1,18944,9,8174565235
5560,63630562376,113102,63630675478,2,0,0,2048,2,9374072945
5561,63630590485,37901,63630628386,8,0,1,55296,8,9578492451
5562,63630621844,110872,63630732716,8,0,0,64000,8,7744942307
5563,63630625230,171128,63630796358,2,0,1,10240,2,7899323799
5564,63630735384,2466,63630737850,2,0,1,15360,2,495059806
5565,63630793901,138221,63630932122,7,0,1,9216,7,8740538245
5566,63630805184,88540,63630893724,2,0,0,2560,2,5066304523
5567,63630821459,1038,63630822497,7,0,1,20992,7,10579762092
5568,63630913846,182782,63631096628,7,0,0,1024,7,3271637206
5569,63630952767,72664,63631025431,7,0,1,9216,7,4449520614
5570,63630975287,74208,63631049495,1,0,1,9728,1,5963927933
5571,63630985570,69387,63631054957,9,0,1,9216,9,2113421267
5572,63631022338,108609,63631130947,8,0,1,25600,8,3806940080
5573,63631190614,2942,63631193556,5,0,0,3072,5,7155367568
5574,63631382996,60820,63631443816,1,0,1,5632,1,7094981834
5575,63631435530,67924,63631503454,2,0,1,13824,2,9385574351
5576,63631768122,54676,63631822798,9,0,1,5632,9,8040812120
5577,63631799998,98380,63631898378,6,0,1,23040,6,9146020406
5578,63631806435,107734,63631914169,8,0,0,179712,8,2230046882
5579,63631824691,144484,63631969175,6,0,1,18432,6,9868853243
5580,63631855812,142536,63631998348,5,0,1,14336,5,5135012194
5581,63631949303,282997,63632232300,8,0,1,60416,8,8516109970
5582,63631997869,207785,63632205654,1,0,0,336384,1,4310197510
5583,63632142037,14393,63632156430,9,0,1,24576,9,5947044903
5584,63632196548,2466,63632199014,8,0,0,16896,8,2889599249
5585,63632246051,33241,63632279292,2,0,0,2560,2,3818625218
5586,63632253671,238006,63632491677,7,0,1,1536,7,3629016844
5587,63632294529,1038,63632295567,3,0,0,57856,3,8236413040
5588,63632375832,157860,63632533692,0,0,1,2560,0,7637951978
5589,63632400900,54871,63632455771,2,0,0,1024,2,8703034187
5590,63632540391,82060,63632622451,3,0,1,14848,3,165510761
5591,63632905934,112779,63633018713,3,0,0,182784,3,1261538255
5592,63632913625,151439,63633065064,1,0,0,156160,1,1901918904
5593,63633011206,29941,63633041147,8,0,1,161792,8,9958648165
5594,63633038669,25577,63633064246,3,0,0,5632,3,2649976103
5595,63633048422,247574,63633295996,1,0,0,17408,1,1072788886
5596,63633170546,88245,63633258791,3,0,0,71168,3,8324835795
5597,63633176530,201211,63633377741,1,0,0,301056,1,8268225220
5598,63633335888,78143,63633414031,4,0,0,116224,4,1227223101
5599,63633408286,6225,63633414511,8,0,1,147968,8,7382257479
5600,63633415381,99065,63633514446,1,0,0,15360,1,649881985
5601,63633417075,1038,63633418113,2,0,1,3584,2,4264683515
5602,63633537149,60189,63633597338,6,0,1,29184,6,6634576107
5603,63633578893,131139,63633710032,0,0,1,16384,0,787402062
5604,63633613824,184430,63633798254,6,0,1,4096,6,6259161634
5605,63633663334,409259,63634072593,7,0,0,1024,7,2434220980
5606,63633722300,96317,63633818617,4,0,0,160768,4,9764094732
5607,63633757206,62717,63633819923,0,0,0,2048,0,685222278
5608,63633833778,2942,63633836720,5,0,0,3072,5,8075617996
5609,63633896544,47284,63633943828,5,0,1,45056,5,10003846755
5610,63633924233,1038,63633925271,6,0,1,1536,6,10422699510
5611,63633985582,135854,63634121436,0,0,0,1024,0,5527750836
5612,63633996644,72844,63634069488,7,0,1,14848,7,5525256461
5613,63634036980,70972,63634107952,6,0,1,8704,6,6021062813
5614,63634112963,32983,63634145946,8,0,0,57344,8,6019590571
5615,63634210065,59128,63634269193,5,0,1,5120,5,4027485801
5616,63634399578,57436,63634457014,7,0,1,4608,7,9100668487
5617,63634408220,101120,63634509340,7,0,1,18944,7,8891172393
5618,63634463415,64391,63634527806,8,0,0,108544,8,6419028813
5619,63634491443,50668,63634542111,3,0,1,8704,3,8163101326
5620,63634549389,120929,63634670318,2,0,1,2560,2,7409837169
5621,63634586320,62512,63634648832,2,0,1,6144,2,9737598640
5622,63634646147,65140,63634711287,8,0,1,11264,8,7409788217
5623,63634653243,75679,63634728922,9,0,1,9728,9,10249756629
5624,63634847634,2466,63634850100,2,0,0,2560,2,6332681283
5625,63634871702,62412,63634934114,1,0,0,101376,1,8547825130
5626,63634880326,134297,63635014623,9,0,1,6144,9,2474146343
5627,63634934584,3383,63634937967,0,0,1,4096,0,1661280935
5628,63635020042,159395,63635179437,2,0,1,23040,2,871165426
5629,63635047532,81682,63635129214,4,0,0,9728,4,6897816207
5630,63635051769,128913,63635180682,6,0,1,5632,6,8151379968
5631,63635059079,129088,63635188167,1,0,1,15360,1,5125375151
5632,63635062017,185462,63635247479,3,0,0,301056,3,8672084709
5633,63635155213,109150,63635264363,8,0,0,56320,8,1770899533
5634,63635194532,562,63635195094,8,0,1,79360,8,5262862611
5635,63635303641,562,63635304203,7,0,0,512,7,4779578104
5636,63635310490,294229,63635604719,0,0,0,512,0,3294733235
5637,63635345356,30256,63635375612,8,0,1,77824,8,893750481
5638,63635365932,196313,63635562245,5,0,1,12288,5,2856032683
5639,63635458524,1990,63635460514,1,0,0,29184,1,4020457745
5640,63635459263,330036,63635789299,5,0,1,12800,5,9968271636
5641,63635589342,220048,63635809390,7,0,0,2048,7,10640317749
5642,63635661706,18126,63635679832,2,0,0,512,2,8724511067
5643,63635695935,45592,63635741527,2,0,1,4608,2,4929844078
5644,63635704968,57436,63635762404,7,0,1,1024,7,374946447
5645,63635750164,59187,63635809351,5,0,1,4608,5,2647520646
5646,63635808547,64556,63635873103,1,0,1,10240,1,10406583311
5647,63635816050,58312,63635874362,5,0,1,4096,5,10735557216
5648,63636061275,91012,63636152287,1,0,1,24064,1,5356948906
5649,63636123983,66748,63636190731,6,0,1,16896,6,5414122569
5650,63636131411,79612,63636211023,0,0,1,4096,0,10081332573
5651,63636175942,27664,63636203606,1,0,0,37376,1,7624572985
5652,63636263791,87225,63636351016,8,0,0,146432,8,1312302236
5653,63636280400,73522,63636353922,5,0,0,4608,5,6175840996
5654,63636294252,60336,63636354588,7,0,0,1024,7,8968653725
5655,63636374007,3418,63636377425,5,0,0,3584,5,6779827062
5656,63636379982,41387,63636421369,8,0,0,67072,8,8697813318
5657,63636481918,61378,63636543296,3,0,0,99328,3,6231058191
5658,63636626316,1038,63636627354,0,0,0,1024,0,4067156423
5659,63636640917,146166,63636787083,2,0,0,241152,2,8441572430
5660,63636663865,4389,63636668254,9,0,1,14336,9,6971605519
5661,63636783680,217642,63637001322,7,0,0,1536,7,2280930151
5662,63636971167,64204,63637035371,5,0,1,6656,5,7293794877
5663,63636994488,115072,63637109560,8,0,1,77824,8,4129683596
5664,63637109465,4762,63637114227,8,0,0,12288,8,115302310
5665,63637243419,4933,63637248352,4,0,0,12800,4,1453393711
5666,63637292187,45592,63637337779,7,0,1,1024,7,8544566334
5667,63637397318,13337,63637410655,8,0,0,22528,8,9584580204
5668,63637498564,57436,63637556000,6,0,1,4608,6,10301016718
5669,63637505201,94060,63637599261,3,0,1,18944,3,3460647736
5670,63637574619,3117,63637577736,6,0,1,7168,6,2445582403
5671,63637597174,562,63637597736,0,0,0,1024,0,3853886249
5672,63637606648,84714,63637691362,7,0,1,10752,7,3573130991
5673,63637623226,70060,63637693286,6,0,1,21504,6,388059657
5674,63637628338,52360,63637680698,5,0,0,512,5,1160986343
5675,63637648670,562,63637649232,0,0,1,3072,0,9109308788
5676,63637770921,157724,63637928645,5,0,0,512,5,10208420840
5677,63637776035,6421,63637782456,5,0,0,1536,5,10692183723
5678,63637868917,113554,63637982471,1,0,0,184320,1,669456250
5679,63637924638,43971,63637968609,8,0,1,117248,8,82729632
5680,63637972167,68479,63638040646,8,0,0,72192,8,563572290
5681,63638048212,251836,63638300048,5,0,1,6144,5,3028375852
5682,63638068680,130145,63638198825,3,0,1,5120,3,8444896487
5683,63638123696,84773,63638208469,7,0,1,6144,7,10636216667
5684,63638178430,43971,63638222401,4,0,0,72192,4,1479022537
5685,63638288204,1990,63638290194,8,0,1,36352,8,1676334278
5686,63638299886,102436,63638402322,7,0,0,2048,7,5375877347
5687,63638378225,142120,63638520345,8,0,0,229888,8,8060177194
5688,63638572243,1038,63638573281,2,0,0,1024,2,2662703574
5689,63638668155,50668,63638718823,5,0,1,21504,5,9953822295
5690,63638678970,98906,63638777876,1,0,1,2560,1,5925768597
5691,63638708274,101621,63638809895,9,0,1,9728,9,4607274332
5692,63638813521,57904,63638871425,3,0,1,6144,3,1304390679
5693,63638928551,15058,63638943609,4,0,0,29184,4,3601134491
5694,63638980643,72795,63639053438,0,0,1,21504,0,6307387886
5695,63639006924,28937,63639035861,8,0,1,318464,8,10184932650
5696,63639038505,562,63639039067,6,0,1,8192,6,3468421782
5697,63639043941,119005,63639162946,8,0,0,118272,8,6829760457
5698,63639091025,287505,63639378530,0,0,0,5120,0,449629581
5699,63639129078,358267,63639487345,5,0,1,512,5,969869420
5700,63639166981,108826,63639275807,0,0,0,512,0,6348458913
5701,63639208028,329212,63639537240,0,0,1,9216,0,6838167508
5702,63639225726,167470,63639393196,2,0,1,67072,2,8611814797
5703,63639256376,101452,63639357828,2,0,0,17920,2,4495086536
5704,63639282341,25651,63639307992,8,0,0,31232,8,7460024113
5705,63639362968,62670,63639425638,3,0,0,7680,3,3485946985
5706,63639402787,23721,63639426508,3,0,0,101888,3,10286923968
5707,63639455035,282067,63639737102,1,0,0,39424,1,4916847227
5708,63639489114,94820,63639583934,5,0,1,4096,5,7128093283
5709,63639507367,74120,63639581487,1,0,1,2048,1,550176479
5710,63639557875,189624,63639747499,0,0,1,4096,0,4455173199
5711,63639657661,1038,63639658699,8,0,1,51712,8,5646891660
5712,63639715579,41128,63639756707,7,0,0,1024,7,7299496739
5713,63639737336,144841,63639882177,4,0,0,66560,4,670206575
5714,63639767406,45592,63639812998,6,0,1,1024,6,8950271562
5715,63639795728,89606,63639885334,5,0,1,17408,5,1908977621
5716,63639914357,65896,63639980253,2,0,1,7168,2,1635223633
5717,63640024899,1990,63640026889,9,0,1,10752,9,5398771809
5718,63640073356,77740,63640151096,0,0,0,2048,0,2355074810
5719,63640081773,33329,63640115102,4,0,0,54784,4,6202953338
5720,63640136725,1514,63640138239,0,0,0,1536,0,3975710699
5721,63640138099,57436,63640195535,5,0,1,4608,5,2505428770
5722,63640192508,4933,63640197441,8,0,0,12800,8,6526279988
5723,63640204675,257490,63640462165,8,0,1,162304,8,3810032243
5724,63640349994,114382,63640464376,0,0,1,7168,0,2882126383
5725,63640382473,87842,63640470315,1,0,1,19456,1,7929590695
5726,63640441129,47032,63640488161,8,0,1,208896,8,2643765657
5727,63640443604,67648,63640511252,3,0,0,32768,3,3033001090
5728,63640524451,272500,63640796951,6,0,1,18432,6,6486196884
5729,63640573327,121317,63640694644,5,0,1,4608,5,4477276877
5730,63640592323,252520,63640844843,3,0,0,126464,3,6687581097
5731,63640593872,183715,63640777587,0,0,0,242176,0,2941948956
5732,63640649936,168826,63640818762,5,0,1,14336,5,8553008207
5733,63640665583,192177,63640857760,2,0,0,181760,2,6656997022
5734,63640703030,147034,63640850064,1,0,0,50176,1,2932965877
5735,63640731381,120066,63640851447,4,0,0,14848,4,138230570
5736,63640911053,122128,63641033181,9,0,0,197632,9,2634078515
5737,63641001332,33155,63641034487,7,0,0,2048,7,6623159
5738,63641060272,562,63641060834,8,0,1,10240,8,4588319536
5739,63641124710,160555,63641285265,5,0,1,512,5,7656033081
5740,63641211302,3383,63641214685,7,0,0,512,7,10351723339
5741,63641252697,142465,63641395162,2,0,0,9728,2,1174772190
5742,63641253143,48976,63641302119,0,0,1,3072,0,5837153377
5743,63641276350,41128,63641317478,0,0,1,2048,0,10451917825
5744,63641300556,94483,63641395039,0,0,1,4096,0,4665835510
5745,63641304293,55744,63641360037,0,0,0,66560,0,4039564544
5746,63641318136,60538,63641378674,7,0,1,3584,7,3322647935
5747,63641446499,104979,63641551478,4,0,0,171008,4,2050815887
5748,63641521347,76325,63641597672,6,0,1,6656,6,311678665
5749,63641587352,190981,63641778333,1,0,0,128512,1,5177623940
5750,63641623798,21654,63641645452,0,0,1,11264,0,5070671945
5751,63641632539,151973,63641784512,3,0,1,3584,3,6762704241
5752,63641702876,144335,63641847211,2,0,0,35328,2,4939564774
5753,63641898344,102912,63642001256,0,0,0,166912,0,8672284418
5754,63641914166,90316,63642004482,1,0,0,5120,1,170412462
5755,63642110789,10495,63642121284,8,0,0,16896,8,10623871005
5756,63642154065,1038,63642155103,7,0,0,1024,7,2830438080
5757,63642232480,3418,63642235898,5,0,0,3584,5,9768547989
5758,63642259937,43900,63642303837,2,0,1,512,2,6219938216
5759,63642309002,53491,63642362493,4,0,0,90624,4,1291017886
5760,63642323708,131707,63642455415,3,0,1,8192,3,5529021933
5761,63642324437,144406,63642468843,3,0,1,22016,3,8279999494
5762,63642430406,189839,63642620245,8,0,1,68608,8,1788329443
5763,63642495860,145787,63642641647,1,0,1,6656,1,6343249224
5764,63642612330,138111,63642750441,0,0,1,127488,0,7962298130
5765,63642695258,70987,63642766245,3,0,0,114688,3,6014737180
5766,63642700885,155048,63642855933,7,0,1,4608,7,5084541111
5767,63642771019,86017,63642857036,8,0,1,3584,8,3148425764
5768,63642783053,103984,63642887037,7,0,1,20992,7,8705158500
5769,63642787728,25958,63642813686,7,0,1,47104,7,9660356807
5770,63642849658,173916,63643023574,0,0,1,92160,0,5655506492
5771,63642903579,291580,63643195159,8,0,0,47104,8,8411159530
5772,63643071014,46167,63643117181,3,0,1,11776,3,3514530088
5773,63643077058,1038,63643078096,6,0,1,512,6,4751317722
5774,63643158977,95326,63643254303,5,0,0,1024,5,8533259407
5775,63643169601,75550,63643245151,4,0,0,126976,4,2380285437
5776,63643185869,59628,63643245497,1,0,0,512,1,7021166827
5777,63643215960,116444,63643332404,0,0,1,88576,0,5363820457
5778,63643299080,127945,63643427025,2,0,1,25088,2,3936971567
5779,63643351137,147472,63643498609,5,0,1,10752,5,9865592334
5780,63643354044,314300,63643668344,0,0,1,69120,0,10115339743
5781,63643371757,5798,63643377555,1,0,1,5120,1,2795128300
5782,63643376674,193705,63643570379,0,0,1,60928,0,707618712
5783,63643532485,200193,63643732678,0,0,0,6144,0,2817644149
5784,63643603371,562,63643603933,1,0,0,512,1,6994486572
5785,63643733071,130048,63643863119,0,0,1,126976,0,2091680351
5786,63643781770,11189,63643792959,3,0,1,23040,3,1570016173
5787,63643852484,562,63643853046,5,0,0,512,5,5948660361
5788,63643896571,131773,63644028344,1,0,0,512,1,10468571829
5789,63643916089,11012,63643927101,0,0,0,17920,0,576347563
5790,63644059233,1990,63644061223,9,0,1,4096,9,826542014
5791,63644060659,52672,63644113331,7,0,0,2048,7,4142120957
5792,63644091997,50668,63644142665,5,0,1,2560,5,3379626839
5793,63644099789,64133,63644163922,2,0,0,108032,2,8483736092
5794,63644105793,68959,63644174752,8,0,0,35328,8,8951231788
5795,63644214255,562,63644214817,7,0,0,512,7,5319465181
5796,63644300020,562,63644300582,3,0,1,23040,3,3880447058
5797,63644315213,2942,63644318155,7,0,0,512,7,5618838664
5798,63644327370,3894,63644331264,1,0,0,3072,1,9780448846
5799,63644337056,98380,63644435436,8,0,1,1536,8,4182452098
5800,63644350060,5708,63644355768,1,0,0,4096,1,10299868702
5801,63644444772,116197,63644560969,8,0,0,14336,8,1850165247
5802,63644521326,61895,63644583221,4,0,0,100352,4,352827290
5803,63644555038,110589,63644665627,3,0,1,6656,3,8768505313
5804,63644608255,104286,63644712541,9,0,1,13312,9,4109930452
5805,63644732954,16609,63644749563,0,0,0,32256,0,10586143861
5806,63644749180,76048,63644825228,1,0,1,10240,1,2881959467
5807,63644823651,4370,63644828021,2,0,1,512,2,6022431885
5808,63644857336,45469,63644902805,7,0,0,4608,7,4518665652
5809,63644964625,52804,63645017429,8,0,0,86016,8,5724257017
5810,63644987654,36086,63645023740,4,0,0,22016,4,4348431691
5811,63645024399,14113,63645038512,8,0,0,24064,8,5335882637
5812,63645038599,12562,63645051161,0,0,0,20992,0,10242284668
5813,63645115888,35567,63645151455,3,0,0,62464,3,3067871167
5814,63645276518,73825,63645350343,3,0,1,1024,3,2233566590
5815,63645436349,11012,63645447361,8,0,0,17920,8,10053052195
5816,63645439091,16880,63645455971,0,0,0,24064,0,5909451597
5817,63645506852,6225,63645513077,0,0,0,15360,0,6748183781
5818,63645590542,68836,63645659378,8,0,1,11776,8,8533800141
5819,63645713240,16092,63645729332,2,0,0,31232,2,4439126854
5820,63645723976,48976,63645772952,2,0,1,2048,2,1865786609
5821,63645813931,4933,63645818864,8,0,0,12800,8,8418488622
5822,63645987120,3124,63645990244,4,0,0,9216,4,6403328791
5823,63646004459,55744,63646060203,9,0,1,4096,9,6949541792
5824,63646071356,1514,63646072870,2,0,0,1536,2,5337608054
5825,63646085300,75160,63646160460,9,0,1,17408,9,164090030
5826,63646112771,50824,63646163595,8,0,1,3072,8,6501889628
5827,63646197244,98848,63646296092,7,0,1,24576,7,6722514864
5828,63646336505,2942,63646339447,5,0,0,3072,5,4918206548
5829,63646463170,4933,63646468103,7,0,1,12800,7,4234608438
5830,63646506810,77922,63646584732,4,0,0,12800,4,4484330413
5831,63646568171,60820,63646628991,8,0,1,5632,8,6190282314
5832,63646824170,165136,63646989306,0,0,1,141312,0,9473123614
5833,63646938617,50700,63646989317,0,0,0,18944,0,1418011228
5834,63647011754,76067,63647087821,4,0,0,128000,4,8174897417
5835,63647079963,45175,63647125138,8,0,1,15872,8,2960538808
5836,63647098657,12045,63647110702,5,0,1,6656,5,361708764
5837,63647137019,226066,63647363085,4,0,0,77824,4,52809332
5838,63647253894,210708,63647464602,6,0,1,18944,6,8684410610
5839,63647278310,136936,63647415246,3,0,0,19968,3,10598492549
5840,63647337498,172297,63647509795,2,0,1,39936,2,3647159625
5841,63647509014,1335,63647510349,7,0,0,512,7,679518738
5842,63647578105,6274,63647584379,7,0,0,6656,7,9915690203
5843,63647605007,1514,63647606521,5,0,0,1536,5,8895192613
5844,63647635086,36859,63647671945,4,0,0,65024,4,4611242580
5845,63647731445,54364,63647785809,7,0,1,4608,7,9812614106
5846,63647755793,23979,63647779772,2,0,1,1024,2,9691918703
5847,63647816140,116064,63647932204,4,0,0,39936,4,10202444670
5848,63647893996,21912,63647915908,0,0,0,35840,0,7852142954
5849,63647894362,283571,63648177933,0,0,1,171008,0,404901451
5850,63648085334,61343,63648146677,1,0,1,8704,1,6858339797
5851,63648119417,108127,63648227544,6,0,1,9216,6,10231178963
5852,63648145559,47981,63648193540,1,0,0,21504,1,4635767145
5853,63648199502,55900,63648255402,2,0,1,4608,2,4303267574
5854,63648204908,109396,63648314304,0,0,1,45568,0,2930232839
5855,63648237765,109815,63648347580,8,0,1,33792,8,2187309013
5856,63648309650,37941,63648347591,3,0,0,38912,3,10551173306
5857,63648320408,61537,63648381945,2,0,1,4096,2,6844367156
5858,63648492026,6750,63648498776,1,0,1,5632,1,6620223660
5859,63648525089,60820,63648585909,4,0,0,7168,4,228322522
5860,63648607706,3418,63648611124,3,0,1,8192,3,333028006
5861,63648615356,26734,63648642090,7,0,0,3584,7,10105506032
5862,63648641812,69280,63648711092,2,0,0,48640,2,1997274755
5863,63648653685,11529,63648665214,2,0,1,5120,2,8207859135
5864,63648744374,69280,63648813654,2,0,1,8192,2,4665192140
5865,63648753148,211596,63648964744,0,0,0,18944,0,3337550529
5866,63648837235,53837,63648891072,7,0,1,9728,7,1106601003
5867,63648854283,45503,63648899786,1,0,0,88064,1,6070855340
5868,63648862963,74356,63648937319,7,0,0,512,7,9447814875
5869,63648871640,22858,63648894498,7,0,1,5632,7,1507050710
5870,63648957664,125421,63649083085,0,0,0,40960,0,6970660352
5871,63649033471,56836,63649090307,8,0,1,7680,8,8399890804
5872,63649049668,74258,63649123926,1,0,0,124416,1,1377005332
5873,63649099498,4416,63649103914,6,0,1,4096,6,1987031029
5874,63649133497,113981,63649247478,3,0,1,14848,3,5992772802
5875,63649237258,16092,63649253350,4,0,0,11776,4,9657108093
5876,63649242729,193674,63649436403,1,0,0,31232,1,2553120061
5877,63649447130,5450,63649452580,5,0,1,4096,5,5069120913
5878,63649465032,55744,63649520776,3,0,1,14336,3,9796042989
5879,63649485427,69616,63649555043,2,0,0,13824,2,6685826656
5880,63649601171,56592,63649657763,1,0,1,15872,1,2025461150
5881,63649608573,93124,63649701697,2,0,0,96768,2,9899790210
5882,63649781518,15833,63649797351,2,0,0,30720,2,358221465
5883,63649855375,43900,63649899275,5,0,1,27136,5,6595743929
5884,63649855418,69969,63649925387,5,0,1,512,5,9472389349
5885,63649867370,34533,63649901903,8,0,1,512,8,1505345405
5886,63649882428,99628,63649982056,5,0,1,3584,5,1903443887
5887,63649899032,95469,63649994501,3,0,0,60416,3,6751386838
5888,63650051329,48976,63650100305,9,0,1,2048,9,942458053
5889,63650221587,52360,63650273947,3,0,1,3072,3,7971631200
5890,63650316526,1514,63650318040,5,0,0,1536,5,5806212902
5891,63650438910,1990,63650440900,0,0,1,34816,0,2769836482
5892,63650462426,101968,63650564394,5,0,0,2048,5,156594083
5893,63650485878,56103,63650541981,7,0,1,3584,7,1509061983
5894,63650569972,20878,63650590850,0,0,0,33792,0,4619043908
5895,63650652539,69280,63650721819,1,0,1,8192,1,7324233736
5896,63650848394,54208,63650902602,7,0,1,4096,7,5363598135
5897,63650885020,47284,63650932304,6,0,1,1536,6,1955663890
5898,63650927437,55300,63650982737,0,0,0,94208,0,2444808518
5899,63650947291,127795,63651075086,9,0,1,11264,9,9632763041
5900,63650958571,34363,63650992934,2,0,1,20480,2,5782486282
5901,63651053102,62370,63651115472,8,0,0,56832,8,6936138129
5902,63651055381,1038,63651056419,3,0,1,1536,3,10622499118
5903,63651074378,113218,63651187596,6,0,1,13312,6,8498410508
5904,63651160296,252080,63651412376,9,0,1,21504,9,5353527349
5905,63651161257,97912,63651259169,5,0,0,1024,5,5195350708
5906,63651167868,100683,63651268551,1,0,1,9216,1,6656120169
5907,63651227664,40898,63651268562,1,0,0,66048,1,6078552617
5908,63651274610,1038,63651275648,7,0,0,1024,7,3944568075
5909,63651278209,23633,63651301842,1,0,0,42496,1,7857935938
5910,63651297681,205108,63651502789,4,0,0,335872,4,8940135664
5911,63651410953,92502,63651503455,7,0,0,1024,7,8764538456
5912,63651416621,87910,63651504531,1,0,0,13312,1,9441592861
5913,63651441915,156550,63651598465,2,0,0,258048,2,895861534
5914,63651625212,21137,63651646349,1,0,0,34304,1,7853225494
5915,63651644350,2985,63651647335,7,0,0,1536,7,5324441589
5916,63651658105,152270,63651810375,5,0,1,9728,5,8544657805
5917,63651716604,268172,63651984776,9,0,1,3584,9,6442656282
5918,63651758994,311673,63652070667,0,0,1,238592,0,5418219401
5919,63651960745,50668,63652011413,7,0,1,8192,7,10637843816
5920,63652040128,135693,63652175821,8,0,1,2560,8,4329616329
5921,63652207313,3641,63652210954,2,0,0,10240,2,7787342669
5922,63652245341,3641,63652248982,3,0,1,8704,3,7182187134
5923,63652275094,70972,63652346066,9,0,1,16384,9,510971958
5924,63652300336,4846,63652305182,8,0,0,10240,8,3677331764
5925,63652330452,16350,63652346802,8,0,0,5120,8,9084065836
5926,63652333286,141276,63652474562,2,0,0,31744,2,1389423262
5927,63652503897,14283,63652518180,4,0,0,27648,4,6178128066
5928,63652571073,23891,63652594964,9,0,1,3072,9,796017092
5929,63652637772,135449,63652773221,3,0,0,43008,3,3276975755
5930,63652742801,32983,63652775784,1,0,0,57344,1,7106616525
5931,63652770166,183395,63652953561,1,0,0,296960,1,117842497
5932,63652784088,141801,63652925889,4,0,0,75776,4,5343150589
5933,63652832214,190466,63653022680,6,0,1,8704,6,767398226
5934,63653034905,1514,63653036419,4,0,0,1536,4,9648870625
5935,63653072636,105408,63653178044,2,0,0,175104,2,1267880842
5936,63653122345,64824,63653187169,9,0,1,6656,9,10356846393
5937,63653129573,95232,63653224805,3,0,0,150016,3,2885598938
5938,63653152423,239441,63653391864,7,0,1,7680,7,3480147163
5939,63653407839,109106,63653516945,7,0,1,5632,7,4041436730
5940,63653496107,80392,63653576499,1,0,1,19456,1,7111581484
5941,63653599630,95440,63653695070,7,0,1,18432,7,8983402551
5942,63653794694,23462,63653818156,8,0,0,38912,8,7582325832
5943,63653957039,46467,63654003506,4,0,0,80384,4,1672389148
5944,63653975044,84383,63654059427,6,0,1,16384,6,3457061721
5945,63654085315,289828,63654375143,8,0,0,140800,8,320995023
5946,63654149092,152128,63654301220,0,0,1,70144,0,6595931100
5947,63654169627,3641,63654173268,6,0,1,28672,6,9385193149
5948,63654174411,181697,63654356108,7,0,1,1024,7,6759194910
5949,63654259671,228923,63654488594,0,0,1,207872,0,5838868260
5950,63654281682,327714,63654609396,5,0,1,19456,5,2092333152
5951,63654352041,142663,63654494704,2,0,0,10240,2,7320004021
5952,63654356717,225110,63654581827,2,0,1,6656,2,6244265676
5953,63654530008,25183,63654555191,2,0,1,9216,2,5073149125
5954,63654536901,72664,63654609565,8,0,1,5120,8,1865448642
5955,63654560956,79883,63654640839,2,0,0,45568,2,5917017855
5956,63654605732,228458,63654834190,8,0,0,374784,8,2001491298
5957,63654750637,119638,63654870275,0,0,0,115200,0,4093218924
5958,63654759786,115981,63654875767,1,0,0,17920,1,5634427048
5959,63654836896,39025,63654875921,1,0,0,8704,1,1564692027
5960,63654876818,205624,63655082442,1,0,1,22528,1,9729130216
5961,63654884417,100654,63654985071,8,0,0,336896,8,7655411169
5962,63654990373,107104,63655097477,5,0,0,1536,5,4608881463
5963,63654995674,172497,63655168171,1,0,0,48128,1,705804801
5964,63654998495,159155,63655157650,0,0,0,220160,0,7091968769
5965,63655010034,31240,63655041274,3,0,1,10752,3,9420065663
5966,63655012196,371441,63655383637,2,0,0,9728,2,9207274925
5967,63655111272,256193,63655367465,1,0,1,5632,1,1765743817
5968,63655146524,92270,63655238794,3,0,0,22528,3,6880302618
5969,63655184857,316081,63655500938,0,0,1,184320,0,8943114485
5970,63655202353,380141,63655582494,8,0,0,149504,8,8399152960
5971,63655316840,248481,63655565321,9,0,1,1024,9,3452025459
5972,63655381000,226479,63655607479,3,0,0,367616,3,1076622811
5973,63655381885,160735,63655542620,3,0,1,5632,3,8127137128
5974,63655417333,144198,63655561531,1,0,1,14336,1,4031718937
5975,63655452236,50634,63655502870,0,0,0,26112,0,2209002871
5976,63655469439,12518,63655481957,7,0,0,1024,7,6479294958
5977,63655522046,85295,63655607341,3,0,1,14848,3,4680856037
5978,63655558901,301161,63655860062,4,0,1,8704,4,6291666946
5979,63655563771,6530,63655570301,3,0,0,11776,3,9312926282
5980,63655570920,363502,63655934422,8,0,1,1536,8,1755929147
5981,63655571813,198085,63655769898,8,0,1,512,8,9078084045
5982,63655604153,224628,63655828781,5,0,0,3584,5,3581562489
5983,63655711975,23204,63655735179,7,0,0,3072,7,8341959893
5984,63655766129,59707,63655825836,2,0,1,4096,2,8304541549
5985,63655788929,58582,63655847511,0,0,0,38400,0,5927579344
5986,63655793108,73083,63655866191,2,0,0,82432,2,5070633032
5987,63655795082,7719,63655802801,8,0,0,62464,8,7133094330
5988,63655860792,379961,63656240753,5,0,0,512,5,3131736725
5989,63655872845,131329,63656004174,4,0,1,45568,4,4359125728
5990,63655897987,234981,63656132968,7,0,1,15872,7,2620891400
5991,63655927258,83152,63656010410,8,0,1,23552,8,3418419174
5992,63656082518,253115,63656335633,8,0,1,18432,8,5664451207
5993,63656152151,96064,63656248215,5,0,1,20480,5,3374844950
5994,63656195088,86824,63656281912,6,0,1,15360,6,73234278
5995,63656309578,1038,63656310616,3,0,0,1024,3,7192973489
5996,63656317811,24925,63656342736,3,0,0,45056,3,1276315481
5997,63656364075,1038,63656365113,0,0,1,11776,0,10635823473
5998,63656367811,82749,63656450560,7,0,0,1024,7,6775247505
5999,63656374723,50824,63656425547,4,0,1,178688,4,2384907922
6000,63656441762,1038,63656442800,4,0,1,3072,4,1813036479
6001,63656522226,73732,63656595958,9,0,1,512,9,7013757768
6002,63656593020,2466,63656595486,5,0,0,1024,5,9773286842
6003,63656616108,11012,63656627120,5,0,0,2560,5,10643732621
6004,63656621001,323139,63656944140,8,0,0,17920,8,5656500992
6005,63656741677,23979,63656765656,4,0,0,39936,4,6022723520
6006,63656837574,63358,63656900932,3,0,0,106496,3,9078648720
6007,63656914893,25442,63656940335,5,0,1,1536,5,3948383439
6008,63656946579,151934,63657098513,7,0,1,10240,7,3026952974
6009,63656995949,11529,63657007478,2,0,0,46080,2,6708981446
6010,63657069887,5322,63657075209,0,0,0,18944,0,1136044504
6011,63657101316,193917,63657295233,0,0,0,5632,0,2872703384
6012,63657192292,66253,63657258545,8,0,1,512,8,4697079769
6013,63657260114,5967,63657266081,8,0,0,14848,8,5783600136
6014,63657270888,47284,63657318172,9,0,1,1536,9,3837850961
6015,63657313681,41904,63657355585,0,0,0,68096,0,8807967021
6016,63657355678,6225,63657361903,1,0,0,15360,1,7495207533
6017,63657460983,3418,63657464401,0,0,0,3584,0,6619526260
6018,63657471216,26217,63657497433,2,0,0,47616,2,5088276603
6019,63657504986,55558,63657560544,3,0,0,94720,3,800192614
6020,63657549526,43900,63657593426,3,0,1,5632,3,9170750331
6021,63657583772,166849,63657750621,7,0,1,512,7,3196875816
6022,63657701353,46984,63657748337,4,0,0,81408,4,9760199863
6023,63657754237,1514,63657755751,3,0,0,1536,3,4862384390
6024,63657779749,110201,63657889950,1,0,1,4096,1,1082143913
6025,63657888160,2942,63657891102,5,0,0,3072,5,2205411407
6026,63657931541,44229,63657975770,4,0,0,72704,4,835716767
6027,63657933254,48213,63657981467,1,0,0,27136,1,8278553000
6028,63657942995,38818,63657981813,5,0,0,512,5,4829018784
6029,63657944665,80033,63658024698,5,0,1,2560,5,8060984368
6030,63658058066,94124,63658152190,7,0,1,2048,7,2669537227
6031,63658087379,141932,63658229311,0,0,1,41984,0,880266486
6032,63658190094,103687,63658293781,4,0,0,168448,4,5847214369
6033,63658247080,51886,63658298966,1,0,0,16384,1,7376414508
6034,63658261585,63814,63658325399,8,0,0,93696,8,247156860
6035,63658323604,3894,63658327498,8,0,1,19968,8,7804636019
6036,63658393927,149780,63658543707,4,0,1,292864,4,8479675259
6037,63658405417,227773,63658633190,0,0,1,143360,0,10601906343
6038,63658407892,190632,63658598524,5,0,0,4096,5,258812372
6039,63658464686,188743,63658653429,2,0,1,14336,2,6430628245
6040,63658507223,417339,63658924562,6,0,1,1024,6,1940554254
6041,63658777238,36962,63658814200,5,0,0,3072,5,9322072238
6042,63658872977,60532,63658933509,8,0,1,9728,8,10720388209
6043,63659036316,45592,63659081908,7,0,1,1024,7,2373685925
6044,63659181373,107428,63659288801,6,0,1,52736,6,6368131981
6045,63659295865,31779,63659327644,3,0,0,51712,3,9447910398
6046,63659346782,90258,63659437040,1,0,1,3584,1,5560515786
6047,63659437951,562,63659438513,0,0,1,73728,0,5184626142
6048,63659509053,137015,63659646068,8,0,1,20992,8,2616766643
6049,63659509647,93148,63659602795,5,0,0,512,5,2397207664
6050,63659535611,99150,63659634761,8,0,1,1024,8,1301181591
6051,63659558516,122378,63659680894,2,0,1,22016,2,239248266
6052,63659666595,91900,63659758495,4,0,1,16896,4,3083585179
6053,63659697108,67744,63659764852,6,0,1,2048,6,2969982643
6054,63659698441,83317,63659781758,9,0,1,8192,9,6987269724
6055,63659788102,1514,63659789616,5,0,0,1536,5,7011295237
6056,63659831131,36342,63659867473,0,0,0,64000,0,3173143129
6057,63660094318,69280,63660163598,7,0,1,8192,7,4062380715
6058,63660110033,99742,63660209775,0,0,1,172544,0,3508866342
6059,63660125345,193084,63660318429,7,0,1,1024,7,8778823831
6060,63660271586,32363,63660303949,2,0,1,3584,2,2117300160
6061,63660292941,85575,63660378516,4,0,0,36352,4,5018679135
6062,63660332052,55744,63660387796,4,0,1,37376,4,5600340871
6063,63660393355,3894,63660397249,6,0,1,4096,6,5002461960
6064,63660496188,15833,63660512021,1,0,0,4096,1,2067212819
6065,63660514810,220603,63660735413,0,0,0,30720,0,5535596302
6066,63660528196,562,63660528758,5,0,1,18944,5,7383547227
6067,63660560139,144163,63660704302,7,0,0,512,7,4234940589
6068,63660798201,4370,63660802571,4,0,0,4608,4,1825370671
6069,63660819093,124624,63660943717,1,0,0,205824,1,2436461645
6070,63661186877,12733,63661199610,5,0,1,15360,5,3721798265
6071,63661187018,91389,63661278407,4,0,0,24576,4,8759122601
6072,63661320901,61132,63661382033,1,0,1,6656,1,5938212156
6073,63661414541,3383,63661417924,1,0,0,9728,1,1433671600
6074,63661511872,86068,63661597940,1,0,1,17920,1,34787510
6075,63661644386,3124,63661647510,5,0,1,11264,5,8419793961
6076,63661660904,74824,63661735728,3,0,0,9216,3,10017622659
6077,63661675730,50668,63661726398,7,0,1,2560,7,166963177
6078,63661707520,57109,63661764629,0,0,0,97792,0,1168389581
6079,63661714432,2942,63661717374,7,0,1,39424,7,4824403792
6080,63661759294,200979,63661960273,0,0,1,41472,0,1122766116
6081,63661770078,149712,63661919790,1,0,1,14336,1,8925699042
6082,63661840185,184105,63662024290,4,0,0,3072,4,6036123087
6083,63661870979,96833,63661967812,4,0,0,161792,4,9260392070
6084,63661883187,46348,63661929535,6,0,1,5632,6,9096526437
6085,63661887634,158512,63662046146,5,0,1,10240,5,9420738594
6086,63661906886,145241,63662052127,7,0,1,9216,7,6471149677
6087,63661922770,172005,63662094775,5,0,0,2048,5,1361227813
6088,63662070235,3894,63662074129,7,0,0,4096,7,4559593688
6089,63662100988,73054,63662174042,3,0,0,118784,3,10328840273
6090,63662138810,35578,63662174388,5,0,0,512,5,975058192
6091,63662314123,81772,63662395895,3,0,1,18944,3,8323014541
6092,63662434679,2466,63662437145,5,0,0,2560,5,7421816799
6093,63662505832,10237,63662516069,7,0,1,14848,7,3618445697
6094,63662509385,24150,63662533535,2,0,0,16384,2,6228848116
6095,63662509932,24976,63662534908,2,0,1,5632,2,4717336803
6096,63662551351,91276,63662642627,4,0,0,43520,4,7813098784
6097,63662561355,54008,63662615363,4,0,0,35328,4,7359904602
6098,63662602347,63502,63662665849,4,0,0,91648,4,7452499889
6099,63662603171,210370,63662813541,4,0,0,32768,4,6138671566
6100,63662719932,2828,63662722760,5,0,0,2560,5,4131133500
6101,63662898729,65896,63662964625,3,0,1,7168,3,6492110823
6102,63662932771,52029,63662984800,6,0,1,16384,6,1407345901
6103,63662956902,84156,63663041058,8,0,0,84480,8,1868691348
6104,63662964789,54869,63663019658,8,0,0,34816,8,7843045104
6105,63663016013,4311,63663020324,5,0,0,1024,5,4980886405
6106,63663032580,154829,63663187409,0,0,0,251392,0,2651023757
6107,63663063623,192199,63663255822,9,0,1,23040,9,2541353590
6108,63663067231,96317,63663163548,7,0,1,7168,7,6010555294
6109,63663184891,257362,63663442253,2,0,0,160768,2,286798738
6110,63663213933,122545,63663336478,6,0,1,10752,6,6410801123
6111,63663307347,215568,63663522915,3,0,1,1024,3,9187643461
6112,63663428171,246241,63663674412,0,0,1,248832,0,9365106630
6113,63663585657,90490,63663676147,8,0,1,5632,8,9957572311
6114,63663589543,88183,63663677726,2,0,1,5120,2,9412304374
6115,63663611769,66954,63663678723,7,0,0,1024,7,6243696987
6116,63663658713,115806,63663774519,0,0,1,23040,0,7986343479
6117,63663729397,97024,63663826421,5,0,1,28672,5,815222882
6118,63663873597,84383,63663957980,4,0,0,140800,4,10392277461
6119,63663912670,98125,63664010795,4,0,0,156672,4,3407030951
6120,63663983767,84212,63664067979,3,0,0,137216,3,9822375185
6121,63663996833,108153,63664104986,4,0,0,128000,4,5728418345
6122,63664086494,43108,63664129602,6,0,1,23552,6,5688594269
6123,63664094100,168025,63664262125,9,0,1,1024,9,186351575
6124,63664133545,148078,63664281623,3,0,0,73728,3,3211851517
6125,63664173897,155346,63664329243,9,0,1,14848,9,9938672452
6126,63664187120,327924,63664515044,0,0,0,252416,0,2063838795
6127,63664299699,202596,63664502295,8,0,1,1024,8,10268096760
6128,63664360856,51536,63664412392,1,0,1,12800,1,6329486218
6129,63664456740,169027,63664625767,9,0,1,1024,9,5989350091
6130,63664538774,74356,63664613130,5,0,1,9728,5,461081292
6131,63664635697,43900,63664679597,2,0,1,512,2,2561963255
6132,63664650291,91885,63664742176,4,0,1,120320,4,7178117155
6133,63664656534,145232,63664801766,7,0,1,2048,7,6256598922
6134,63664696549,40573,63664737122,7,0,1,16384,7,7487769941
6135,63664746743,562,63664747305,5,0,1,11264,5,1694538923
6136,63664749696,85337,63664835033,7,0,1,5632,7,6275580911
6137,63664768984,146326,63664915310,2,0,0,27136,2,8136069715
6138,63664787746,94906,63664882652,2,0,1,51712,2,3187601050
6139,63664813640,126120,63664939760,5,0,0,512,5,135297764
6140,63665005120,45592,63665050712,4,0,1,1024,4,10599150087
6141,63665011894,79588,63665091482,3,0,1,11776,3,5983011517
6142,63665014064,79926,63665093990,0,0,1,14336,0,4605280733
6143,63665015311,88048,63665103359,3,0,1,12288,3,2225349226
6144,63665143860,5708,63665149568,8,0,0,14336,8,612548398
6145,63665167211,58060,63665225271,5,0,1,6656,5,7746470772
6146,63665212982,54052,63665267034,7,0,1,3584,7,6633259910
6147,63665234334,50668,63665285002,1,0,1,2560,1,3571248427
6148,63665390648,96352,63665487000,6,0,1,16384,6,2488415423
6149,63665415260,150898,63665566158,1,0,1,53248,1,217614273
6150,63665588843,32295,63665621138,0,0,1,176640,0,8401786966
6151,63665642771,6750,63665649521,1,0,0,52736,1,10725039609
6152,63665716469,194332,63665910801,8,0,0,7168,8,688308581
6153,63665755247,60820,63665816067,7,0,1,15360,7,9086421364
6154,63665807407,119427,63665926834,8,0,1,5632,8,5166642864
6155,63665854388,92368,63665946756,4,0,1,18432,4,2276614370
6156,63665881205,103687,63665984892,2,0,0,168448,2,7540873660
6157,63665921439,95736,63666017175,2,0,0,105472,2,7406146905
6158,63665992489,46703,63666039192,0,0,0,72704,0,6096382811
6159,63666000902,157557,63666158459,8,0,1,10240,8,5664368029
6160,63666002206,178333,63666180539,5,0,1,2048,5,4425703404
6161,63666016897,207484,63666224381,3,0,1,8704,3,3205879052
6162,63666133347,163962,63666297309,3,0,1,512,3,1532547695
6163,63666228432,102395,63666330827,7,0,1,6656,7,7324670854
6164,63666242919,82675,63666325594,3,0,0,165888,3,10436958369
6165,63666274390,62691,63666337081,8,0,0,48128,8,2289949556
6166,63666293347,1514,63666294861,8,0,1,26112,8,5011807628
6167,63666294720,195022,63666489742,5,0,0,512,5,2456578581
6168,63666358528,267116,63666625644,7,0,0,1536,7,4382247475
6169,63666505173,63704,63666568877,1,0,0,103936,1,1683419705
6170,63666610994,49288,63666660282,6,0,1,46080,6,4813367618
6171,63666614497,6484,63666620981,2,0,1,3072,2,3828784539
6172,63666629281,75956,63666705237,2,0,1,3072,2,7469056782
6173,63666656672,164214,63666820886,3,0,1,1536,3,622807628
6174,63666670312,68550,63666738862,6,0,1,3584,6,3754229991
6175,63666684281,125778,63666810059,0,0,0,15872,0,2602130160
6176,63666707293,59128,63666766421,6,0,1,2048,6,9740131569
6177,63666727556,158350,63666885906,1,0,1,5120,1,8958921512
6178,63666797828,562,63666798390,7,0,0,512,7,4405990980
6179,63666954227,74356,63667028583,4,0,1,9728,4,458662475
6180,63667063499,23204,63667086703,0,0,1,306176,0,2426422011
6181,63667065004,7967,63667072971,2,0,1,14336,2,6141936716
6182,63667189490,282952,63667472442,4,0,0,38400,4,7193401032
6183,63667206315,285826,63667492141,1,0,0,15872,1,5101774804
6184,63667207659,144922,63667352581,7,0,1,5632,7,1389288983
6185,63667266758,150409,63667417167,3,0,1,8704,3,3522807069
6186,63667273414,149724,63667423138,3,0,1,10240,3,4690012268
6187,63667277849,61549,63667339398,4,0,0,125952,4,3243074182
6188,63667382294,15112,63667397406,0,0,0,61440,0,9496642062
6189,63667431637,250996,63667682633,7,0,0,4608,7,2348817651
6190,63667484959,1038,63667485997,1,0,1,89600,1,7078129258
6191,63667497439,122736,63667620175,5,0,1,8704,5,6283466898
6192,63667534408,32812,63667567220,2,0,1,4608,2,7768920550
6193,63667581266,94728,63667675994,5,0,0,1024,5,247542136
6194,63667591048,1514,63667592562,8,0,0,53760,8,8948519421
6195,63667650322,222230,63667872552,7,0,0,1536,7,6031133756
6196,63667658741,41335,63667700076,7,0,1,512,7,7432318750
6197,63667663698,48626,63667712324,6,0,1,4608,6,8133377762
6198,63667664598,57436,63667722034,3,0,1,4608,3,1789098409
6199,63667665865,57951,63667723816,1,0,0,46080,1,4986854716
6200,63667704595,22170,63667726765,9,0,1,17408,9,8597978937
6201,63667707802,179820,63667887622,4,0,1,8192,4,9866814782
6202,63667760528,189610,63667950138,3,0,0,36352,3,10646742542
6203,63667829967,65683,63667895650,6,0,1,10752,6,7226417919
6204,63667833309,33071,63667866380,0,0,0,111104,0,4976540422
6205,63667931567,186301,63668117868,6,0,1,512,6,7754174556
6206,63667963266,165371,63668128637,2,0,0,54272,2,6801409480
6207,63667998629,154680,63668153309,7,0,1,23552,7,7604763562
6208,63668050995,58826,63668109821,4,0,1,20480,4,2391705549
6209,63668094494,23979,63668118473,8,0,0,87552,8,8446034640
6210,63668142636,160568,63668303204,2,0,0,39936,2,7082587073
6211,63668203176,23721,63668226897,7,0,1,18432,7,8484571090
6212,63668224968,148841,63668373809,6,0,1,5632,6,10469685088
6213,63668245628,215239,63668460867,4,0,1,41472,4,1594286935
6214,63668247931,262185,63668510116,4,0,0,39424,4,2754390221
6215,63668649249,78544,63668727793,0,0,1,74752,0,3932868451
6216,63668665445,117527,63668782972,1,0,1,18432,1,5308111118
6217,63668718811,51253,63668770064,8,0,0,82944,8,5296907838
6218,63668737358,37852,63668775210,3,0,0,8192,3,854245746
6219,63668737744,85891,63668823635,8,0,0,89088,8,8719109771
6220,63668846356,13596,63668859952,0,0,0,23040,0,2160036777
6221,63668920160,184946,63669105106,0,0,0,300032,0,4964328792
6222,63669039821,51240,63669091061,5,0,1,6656,5,2686173166
6223,63669054852,156839,63669211691,5,0,0,1536,5,709123096
6224,63669118181,144704,63669262885,4,0,0,235008,4,2010326789
6225,63669182112,91091,63669273203,2,0,0,32768,2,1281525374
6226,63669188911,84638,63669273549,5,0,0,512,5,5554361339
6227,63669225699,89682,63669315381,0,0,0,142848,0,5606600589
6228,63669309318,194678,63669503996,2,0,1,2560,2,5689980612
6229,63669406704,194037,63669600741,1,0,0,314368,1,5104174659
6230,63669469072,142396,63669611468,2,0,0,43008,2,5667136465
6231,63669473910,143357,63669617267,8,0,0,19456,8,5208160994
6232,63669519669,103192,63669622861,1,0,0,18432,1,1945865936
6233,63669575824,29585,63669605409,0,0,1,15872,0,7532541483
6234,63669597462,164069,63669761531,2,0,0,6656,2,6877041390
6235,63669743251,136817,63669880068,8,0,0,226304,8,3797025127
6236,63669743735,158145,63669901880,3,0,0,71680,3,3940302984
6237,63669797741,107365,63669905106,2,0,0,5120,2,6451693329
6238,63669800390,91314,63669891704,0,0,1,15872,0,959808624
6239,63669862240,244402,63670106642,1,0,1,6144,1,9106039885
6240,63669897727,562,63669898289,4,0,1,5632,4,9454305238
6241,63670041957,174122,63670216079,8,0,1,2560,8,6178281695
6242,63670064427,20878,63670085305,7,0,0,512,7,3805600280
6243,63670083589,76933,63670160522,0,0,0,33792,0,1894551329
6244,63670154558,59128,63670213686,0,0,1,17920,0,8624379429
6245,63670157952,82996,63670240948,2,0,1,5120,2,8895331312
6246,63670242595,104464,63670347059,1,0,1,43008,1,3435217826
6247,63670437559,43900,63670481459,4,0,1,512,4,6582933239
6248,63670547581,6225,63670553806,0,0,0,15360,0,3475102787
6249,63670552925,74258,63670627183,8,0,0,124416,8,2983515120
6250,63670604572,104627,63670709199,8,0,1,6144,8,642588947
6251,63670643263,65947,63670709210,4,0,0,108032,4,10512310736
6252,63670726532,125121,63670851653,0,0,1,15360,0,7837285674
6253,63670794817,196268,63670991085,0,0,1,38912,0,8513401621
6254,63670900612,200153,63671100765,0,0,1,172032,0,7763569488
6255,63671022030,61245,63671083275,9,0,1,34816,9,1601580282
6256,63671039531,40096,63671079627,8,0,0,43008,8,3398183920
6257,63671065347,101968,63671167315,1,0,0,12288,1,4015198161
6258,63671107470,1990,63671109460,2,0,1,2560,2,6660340727
6259,63671179751,89893,63671269644,3,0,0,2048,3,2048722081
6260,63671212474,47284,63671259758,2,0,1,1536,2,214427778
6261,63671246158,95113,63671341271,4,0,0,155136,4,9101702130
6262,63671270833,76851,63671347684,8,0,0,22528,8,5559087418
6263,63671271235,167731,63671438966,7,0,1,3072,7,2513158714
6264,63671330516,149862,63671480378,1,0,1,23040,1,3667209162
6265,63671334718,187979,63671522697,4,0,1,6144,4,8884173907
6266,63671535048,562,63671535610,7,0,0,512,7,3014677953
6267,63671551512,52360,63671603872,6,0,1,3072,6,1525478265
6268,63671570020,64204,63671634224,6,0,1,6656,6,9051252452
6269,63671627959,47284,63671675243,5,0,1,1536,5,6316806476
6270,63671647204,26734,63671673938,9,0,1,10240,9,3182220405
6271,63671664534,60688,63671725222,2,0,0,48640,2,5938033605
6272,63671680784,45592,63671726376,3,0,1,1024,3,4071458373
6273,63671711959,43712,63671755671,4,0,0,71680,4,3074443388
6274,63671845382,4846,63671850228,7,0,0,5120,7,10580021147
6275,63672002469,36859,63672039328,3,0,0,65024,3,7953748399
6276,63672008504,59418,63672067922,7,0,1,1024,7,6638946171
6277,63672134682,30487,63672165169,1,0,1,67584,1,2924638128
6278,63672230862,149113,63672379975,1,0,0,49152,1,468320634
6279,63672380856,116476,63672497332,0,0,1,82432,0,553518883
6280,63672483295,24266,63672507561,0,0,0,16384,0,5362572301
6281,63672557412,101362,63672658774,1,0,1,154112,1,1940984668
6282,63672654901,14662,63672669563,0,0,0,163840,0,2079867397
6283,63672655947,277627,63672933574,4,0,1,9216,4,1550378145
6284,63672742907,185089,63672927996,7,0,0,2048,7,10523344905
6285,63672801542,96935,63672898477,2,0,0,103424,2,3693131969
6286,63672908956,53233,63672962189,7,0,1,14848,7,10107149188
6287,63672916928,111014,63673027942,4,0,0,90112,4,1379660268
6288,63672945920,88540,63673034460,5,0,1,20992,5,4560883748
6289,63673127731,55817,63673183548,1,0,1,381952,1,2878534171
6290,63673154300,1514,63673155814,4,0,0,95232,4,777351733
6291,63673209593,3383,63673212976,5,0,0,1536,5,7330796959
6292,63673254562,43196,63673297758,3,0,0,9728,3,4659434470
6293,63673256495,326350,63673582845,7,0,1,3584,7,3859471782
6294,63673261658,198705,63673460363,0,0,0,70656,0,3927610494
6295,63673382110,107177,63673489287,5,0,1,5120,5,9730504643
6296,63673391203,77891,63673469094,8,0,0,70656,8,8245394108
6297,63673421462,253652,63673675114,0,0,0,12800,0,1968217984
6298,63673500495,211719,63673712214,1,0,1,94720,1,2735364519
6299,63673541489,207692,63673749181,0,0,0,340992,0,9580070566
6300,63673564983,188384,63673753367,3,0,0,6656,3,9676400108
6301,63673636981,1514,63673638495,1,0,1,248320,1,6032388585
6302,63673780064,375310,63674155374,3,0,1,2560,3,2354028703
6303,63673789300,226286,63674015586,9,0,1,10752,9,4951696579
6304,63673793482,236313,63674029795,3,0,1,2048,3,2135836725
6305,63673876854,223538,63674100392,4,0,0,1536,4,3053409169
6306,63673887616,92740,63673980356,9,0,1,30208,9,7649835513
6307,63673956150,1038,63673957188,2,0,0,53248,2,5235098613
6308,63674048579,190798,63674239377,4,0,1,1536,4,6635263762
6309,63674059810,47214,63674107024,7,0,0,1024,7,2823309329
6310,63674060986,99034,63674160020,4,0,1,512,4,8754606244
6311,63674127640,57436,63674185076,9,0,1,4608,9,9498558481
6312,63674343524,56524,63674400048,4,0,1,6656,4,6068764501
6313,63674350553,73444,63674423997,4,0,1,11776,4,341169051
6314,63674488660,1038,63674489698,6,0,1,2048,6,2593520359
6315,63674507821,48976,63674556797,4,0,0,1024,4,8512504358
6316,63674544866,48976,63674593842,9,0,1,2048,9,10178802043
6317,63674560575,77320,63674637895,8,0,1,23040,8,8288680813
6318,63674575404,99180,63674674584,2,0,1,19456,2,5723485995
6319,63674592346,169503,63674761849,0,0,1,142848,0,8976304085
6320,63674596339,126529,63674722868,3,0,1,2048,3,3784301756
6321,63674635331,170444,63674805775,3,0,0,167424,3,9758526154
6322,63674655341,562,63674655903,6,0,1,4608,6,4724627976
6323,63674778319,4416,63674782735,3,0,1,5120,3,3839617211
6324,63674826911,1990,63674828901,5,0,0,512,5,9741695726
6325,63674855005,278631,63675133636,1,0,0,11776,1,214071027
6326,63674888448,170250,63675058698,7,0,0,2048,7,10048978367
6327,63674891613,56967,63674948580,3,0,0,94720,3,4238965657
6328,63674913158,35639,63674948797,4,0,0,2560,4,8842762095
6329,63675031477,11012,63675042489,0,0,1,22528,0,966504368
6330,63675037612,84664,63675122276,5,0,1,13312,5,9517743003
6331,63675090172,162020,63675252192,3,0,0,17920,3,7784981743
6332,63675291788,1990,63675293778,4,0,0,2048,4,9892556304
6333,63675292853,48976,63675341829,5,0,1,2048,5,1080575821
6334,63675394926,1038,63675395964,7,0,1,17920,7,9655971997
6335,63675398210,98888,63675497098,5,0,0,1024,5,1910843361
6336,63675483606,562,63675484168,1,0,1,102400,1,9470675560
6337,63675502530,59080,63675561610,3,0,1,1536,3,5416949087
6338,63675558301,122560,63675680861,8,0,0,512,8,974700087
6339,63675657915,147696,63675805611,0,0,1,122880,0,1283013003
6340,63675770203,135200,63675905403,1,0,1,274944,1,7131551827
6341,63675788835,284260,63676073095,6,0,1,8192,6,9246105791
6342,63675829473,229221,63676058694,2,0,1,13824,2,4682776194
6343,63675934943,127046,63676061989,9,0,1,10752,9,3600359544
6344,63675982415,142947,63676125362,2,0,0,290816,2,6081066896
6345,63676011023,256333,63676267356,0,0,1,17920,0,10729044247
6346,63676070436,48700,63676119136,9,0,1,1536,9,7504764300
6347,63676194234,197254,63676391488,0,0,0,6656,0,3586370037
6348,63676307590,562,63676308152,4,0,0,512,4,8708457357
6349,63676327615,88950,63676416565,4,0,1,14848,4,6739797019
6350,63676361267,127235,63676488502,6,0,1,5632,6,9017878832
6351,63676415308,36600,63676451908,1,0,1,39424,1,1914181183
6352,63676426216,103372,63676529588,8,0,0,64512,8,3167074574
6353,63676465605,95531,63676561136,2,0,1,5120,2,4766286554
6354,63676487551,68368,63676555919,3,0,1,6144,3,313976153
6355,63676500130,103100,63676603230,8,0,1,10240,8,6271960494
6356,63676555366,54826,63676610192,3,0,1,2560,3,835161482
6357,63676581579,1990,63676583569,1,0,1,48128,1,9161645342
6358,63676596370,113172,63676709542,5,0,1,13312,5,1199702142
6359,63676597579,20726,63676618305,4,0,1,26624,4,10064658452
6360,63676661496,136700,63676798196,4,0,0,2048,4,1613095475
6361,63676674036,3418,63676677454,7,0,0,7168,7,7053393348
6362,63676747085,186761,63676933846,5,0,0,3584,5,5827322743
6363,63676762046,68680,63676830726,8,0,1,11264,8,521883729
6364,63676799039,194519,63676993558,1,0,1,140800,1,9902419091
6365,63676847462,146887,63676994349,8,0,1,2560,8,1887620327
6366,63676873492,121656,63676995148,3,0,1,2560,3,5300886229
6367,63676931502,63665,63676995167,1,0,0,69632,1,6789799889
6368,63676953108,102271,63677055379,6,0,1,18944,6,8257941315
6369,63676967406,129367,63677096773,5,0,1,1024,5,2708146566
6370,63677085317,72688,63677158005,2,0,1,14336,2,2282742932
6371,63677120601,40870,63677161471,1,0,1,303616,1,10340175720
6372,63677177413,15575,63677192988,8,0,0,66048,8,2767869264
6373,63677251444,290238,63677541682,8,0,0,30208,8,8709355215
6374,63677256739,127477,63677384216,9,0,1,11264,9,5589203345
6375,63677284949,159138,63677444087,7,0,1,5120,7,553191036
6376,63677331638,151563,63677483201,5,0,1,7168,5,5825147376
6377,63677363015,258354,63677621369,3,0,0,343552,3,3367751051
6378,63677415597,217216,63677632813,0,0,0,46592,0,8747183014
6379,63677615179,223321,63677838500,2,0,1,4608,2,5394258551
6380,63677617057,295029,63677912086,2,0,0,477696,2,551696757
6381,63677657339,256693,63677914032,2,0,0,3072,2,4065694831
6382,63677735984,178394,63677914378,4,0,0,512,4,9246470397
6383,63677755278,169725,63677925003,2,0,0,42496,2,9824334218
6384,63677782154,90981,63677873135,2,0,1,31232,2,5665918172
6385,63677866203,1514,63677867717,8,0,0,113152,8,8374098565
6386,63677981504,2942,63677984446,5,0,0,1536,5,6557975703
6387,63678051368,329874,63678381242,3,0,1,7680,3,1353942360
6388,63678084194,1038,63678085232,0,0,0,3072,0,1841948580
6389,63678095453,77026,63678172479,1,0,1,356352,1,6951908194
6390,63678117893,2942,63678120835,5,0,0,1024,5,1274907814
6391,63678162392,353224,63678515616,8,0,1,2560,8,6081535079
6392,63678188380,287076,63678475456,4,0,1,2048,4,6222555006
6393,63678251216,198419,63678449635,5,0,1,512,5,7220194430
6394,63678274907,261890,63678536797,5,0,0,3072,5,8576130917
6395,63678383172,562,63678383734,6,0,1,12800,6,7270853951
6396,63678491836,151598,63678643434,7,0,0,512,7,10121979725
6397,63678509315,2466,63678511781,5,0,1,9728,5,10560316565
6398,63678520078,47284,63678567362,2,0,1,1536,2,7306494496
6399,63678555723,65140,63678620863,5,0,0,2560,5,5158295370
6400,63678562434,153020,63678715454,2,0,0,247808,2,1611860623
6401,63678680018,36102,63678716120,4,0,0,1024,4,920881098
6402,63678823402,82662,63678906064,2,0,0,134144,2,7489013064
6403,63678868749,42807,63678911556,1,0,0,26112,1,1069347285
6404,63678869598,52583,63678922181,0,0,0,34304,0,1139152602
6405,63678900619,200357,63679100976,0,0,1,146944,0,4242307596
6406,63679286632,52545,63679339177,3,0,0,85504,3,3880222482
6407,63679330110,12821,63679342931,7,0,1,11776,7,7219208889
6408,63679401697,99395,63679501092,8,0,0,21504,8,1708166549
6409,63679468704,562,63679469266,7,0,0,512,7,9189687438
6410,63679569266,52351,63679621617,2,0,1,2560,2,3683021212
6411,63679652316,25958,63679678274,3,0,0,47104,3,2942169493
6412,63679765328,36342,63679801670,8,0,0,64000,8,1371805658
6413,63679782119,2866,63679784985,0,0,1,161792,0,4229992041
6414,63679789623,1038,63679790661,3,0,1,5632,3,4185899547
6415,63679830361,100618,63679930979,3,0,0,8704,3,6895217761
6416,63679868265,192566,63680060831,7,0,0,1024,7,2895229333
6417,63680028704,562,63680029266,4,0,0,512,4,6526116997
6418,63680068434,40612,63680109046,7,0,1,51200,7,8960774594
6419,63680085233,106960,63680192193,3,0,0,65536,3,5232505321
6420,63680161955,37581,63680199536,2,0,0,43520,2,1101774365
6421,63680245476,14541,63680260017,8,0,0,28160,8,10642528754
6422,63680303409,5967,63680309376,8,0,0,14848,8,5935481241
6423,63680305446,64690,63680370136,0,0,0,100864,0,3521685859
6424,63680365217,2466,63680367683,9,0,1,18432,9,8607607135
6425,63680392020,109242,63680501262,2,0,1,12800,2,3175476753
6426,63680434542,228682,63680663224,4,0,0,2560,4,6337989350
6427,63680505213,69681,63680574894,6,0,1,18432,6,290637064
6428,63680567235,106648,63680673883,1,0,1,50176,1,1119561328
6429,63680584486,174379,63680758865,8,0,1,5632,8,5771831137
6430,63680606045,74552,63680680597,8,0,1,512,8,8432913560
6431,63680710164,13766,63680723930,1,0,0,26624,1,8713663577
6432,63680852512,33241,63680885753,3,0,0,57856,3,5062706664
6433,63680867533,68552,63680936085,1,0,1,7168,1,392704099
6434,63680959873,1038,63680960911,4,0,0,1024,4,4987769546
6435,63681007370,48976,63681056346,1,0,1,2048,1,6715575870
6436,63681041102,58684,63681099786,4,0,1,8704,4,223570199
6437,63681212919,6750,63681219669,8,0,0,7168,8,155960416
6438,63681222640,2466,63681225106,3,0,0,2560,3,4375624438
6439,63681299347,14025,63681313372,0,0,0,27136,0,1756601250
6440,63681309025,76842,63681385867,8,0,0,129536,8,4961598742
6441,63681309291,102077,63681411368,4,0,1,9216,4,7727886517
6442,63681311722,113461,63681425183,2,0,0,129024,2,8391264874
6443,63681329189,101179,63681430368,2,0,0,16384,2,5358260613
6444,63681406069,30712,63681436781,2,0,0,22528,2,6814188191
6445,63681428550,140473,63681569023,0,0,1,16896,0,3972797887
6446,63681542783,86992,63681629775,2,0,1,3584,2,1597146144
6447,63681549635,144358,63681693993,4,0,1,27136,4,8948627654
6448,63681595055,36806,63681631861,3,0,1,8704,3,1146703881
6449,63681595763,76777,63681672540,0,0,0,237568,0,10324576700
6450,63681664872,139356,63681804228,0,0,1,30720,0,7851131506
6451,63681679925,33071,63681712996,2,0,1,1536,2,1544295572
6452,63681686712,334543,63682021255,1,0,1,200192,1,3549002981
6453,63681697093,365754,63682062847,1,0,1,7680,1,60635261
6454,63681698459,335884,63682034343,2,0,1,52736,2,5907845545
6455,63681705259,318416,63682023675,3,0,1,3584,3,4799613103
6456,63681709626,350920,63682060546,8,0,0,30208,8,1260178827
6457,63681714884,200057,63681914941,8,0,1,1024,8,6770575114
6458,63681821304,122608,63681943912,7,0,1,18432,7,7327787523
6459,63681851049,236844,63682087893,2,0,1,5632,2,5507946334
6460,63681906601,517880,63682424481,1,0,0,54272,1,4723077130
6461,63681929913,479132,63682409045,4,0,1,4608,4,1448324512
6462,63682058284,10495,63682068779,1,0,1,131584,1,3412769530
6463,63682086248,51126,63682137374,4,0,1,2048,4,5978143562
6464,63682088485,35567,63682124052,3,0,0,16896,3,61935740
6465,63682168271,350163,63682518434,1,0,0,62464,1,1456579267
6466,63682412155,43900,63682456055,0,0,1,14848,0,8132115423
6467,63682433156,91276,63682524432,5,0,1,512,5,9941217588
6468,63682519917,74356,63682594273,4,0,1,9728,4,5012139232
6469,63682598585,23979,63682622564,8,0,0,39936,8,5674000241
6470,63682608906,942,63682609848,6,0,1,22528,6,8003622917
6471,63682621968,86296,63682708264,4,0,0,512,4,5738660689
6472,63682743733,1038,63682744771,4,0,0,1024,4,9795677822
6473,63682755287,5322,63682760609,3,0,1,6656,3,7554252894
6474,63682787851,64204,63682852055,5,0,0,5632,5,5710896894
6475,63682883564,5708,63682889272,3,0,0,14336,3,10308321977
6476,63682931134,73001,63683004135,7,0,1,3584,7,10085861935
6477,63683011298,1038,63683012336,4,0,0,1024,4,6696232525
6478,63683059288,562,63683059850,4,0,0,512,4,1519668349
6479,63683140421,5322,63683145743,8,0,1,4096,8,446267175
6480,63683179419,55744,63683235163,5,0,0,5632,5,8954458784
6481,63683200293,562,63683200855,8,0,1,12800,8,2309654511
6482,63683207111,70684,63683277795,1,0,1,164864,1,9702327695
6483,63683227810,7226,63683235036,7,0,0,512,7,4117956667
6484,63683270421,232881,63683503302,0,0,1,138752,0,2194418446
6485,63683276048,144068,63683420116,8,0,0,7680,8,2948626811
6486,63683298431,241975,63683540406,9,0,1,8192,9,3108581854
6487,63683358865,200841,63683559706,0,0,1,66048,0,1779849975
6488,63683524302,50668,63683574970,6,0,1,2560,6,2764761493
6489,63683567344,3418,63683570762,9,0,1,16896,9,4889134980
6490,63683600084,87292,63683687376,5,0,0,3584,5,6109502944
6491,63683638821,23462,63683662283,2,0,0,38912,2,10591927876
6492,63683678321,62154,63683740475,0,0,0,100864,0,9689554825
6493,63683711122,29699,63683740821,7,0,0,512,7,4688657653
6494,63683784374,60820,63683845194,7,0,1,5632,7,7705449930
6495,63683794527,3900,63683798427,1,0,1,103936,1,4724131379
6496,63683871595,20620,63683892215,2,0,0,10752,2,9864940019
6497,63683885247,93304,63683978551,1,0,0,33280,1,8668060259
6498,63683904312,253202,63684157514,3,0,0,151552,3,328385314
6499,63683978402,11787,63683990189,0,0,1,119296,0,9112914270
6500,63684075158,562,63684075720,1,0,1,6144,1,2347214332
6501,63684091801,231776,63684323577,2,0,0,19456,2,10252859585
6502,63684113640,140621,63684254261,7,0,1,512,7,6518322990
6503,63684118642,119414,63684238056,7,0,0,512,7,3259722415
6504,63684172900,195246,63684368146,2,0,1,20480,2,773965062
6505,63684189305,164667,63684353972,3,0,1,26624,3,3517637384
6506,63684304105,45901,63684350006,0,0,0,66560,0,3236959193
6507,63684435986,85912,63684521898,9,0,1,17408,9,8224901363
6508,63684534182,1038,63684535220,4,0,1,3584,4,10275572037
6509,63684575748,54052,63684629800,5,0,0,1024,5,7259231662
6510,63684611378,2942,63684614320,4,0,0,3072,4,941881078
6511,63684642818,22170,63684664988,1,0,0,36352,1,1964723982
6512,63684672754,136041,63684808795,3,0,0,224768,3,5338515803
6513,63684729770,79371,63684809141,7,0,0,512,7,8909064988
6514,63684747147,194781,63684941928,1,0,1,33792,1,5236440902
6515,63684805776,53697,63684859473,6,0,1,12288,6,10682616935
6516,63684917361,6484,63684923845,8,0,1,512,8,9156337406
6517,63684982991,211168,63685194159,8,0,0,15872,8,8267134156
6518,63685037372,34533,63685071905,8,0,0,60416,8,2469618323
6519,63685098564,71245,63685169809,3,0,0,115200,3,6329510049
6520,63685142118,30277,63685172395,5,0,0,4096,5,3259156719
6521,63685241603,5798,63685247401,5,0,0,6144,5,10108938725
6522,63685274230,1038,63685275268,4,0,0,1024,4,7346465600
6523,63685286916,24408,63685311324,3,0,0,44032,3,6982291039
6524,63685364233,1990,63685366223,4,0,0,2048,4,8348595283
6525,63685386073,1038,63685387111,5,0,0,1024,5,1685457219
6526,63685440854,23204,63685464058,3,0,0,38400,3,515008109
6527,63685495347,2466,63685497813,1,0,1,120832,1,8351535197
6528,63685538521,134904,63685673425,4,0,0,2560,4,1105201190
6529,63685680387,34104,63685714491,2,0,0,56320,2,6587401075
6530,63685711563,31779,63685743342,3,0,0,51712,3,7848979249
6531,63685719944,50668,63685770612,6,0,1,3584,6,5426127591
6532,63685731895,52287,63685784182,6,0,1,4096,6,780631943
6533,63685750951,1514,63685752465,9,0,1,2560,9,9806066580
6534,63685770915,160014,63685930929,2,0,0,84992,2,122791435
6535,63685844500,87772,63685932272,4,0,0,1536,4,7892331181
6536,63685851973,212750,63686064723,7,0,1,512,7,7484407918
6537,63685923181,5708,63685928889,3,0,1,11776,3,9393598144
6538,63685975363,80291,63686055654,1,0,0,14336,1,5719415209
6539,63685977229,47440,63686024669,5,0,1,10752,5,6238916228
6540,63686008506,562,63686009068,3,0,1,20480,3,2284792526
6541,63686015803,3418,63686019221,8,0,1,2048,8,474012253
6542,63686035750,173659,63686209409,8,0,1,11776,8,6095286755
6543,63686044765,81124,63686125889,1,0,1,264704,1,7852368567
6544,63686079651,32554,63686112205,2,0,1,8704,2,7596480612
6545,63686082907,146348,63686229255,2,0,0,512,2,9752625897
6546,63686085441,6489,63686091930,4,0,0,3584,4,3205218227
6547,63686110320,282805,63686393125,8,0,0,53248,8,6803319605
6548,63686148919,250590,63686399509,4,0,0,512,4,323966402
6549,63686210413,58862,63686269275,9,0,1,25088,9,10009777123
6550,63686271925,33071,63686304996,2,0,0,512,2,5743410363
6551,63686310412,84025,63686394437,0,0,1,6656,0,3801706093
6552,63686341261,203510,63686544771,8,0,0,54272,8,2099757966
6553,63686402625,16534,63686419159,4,0,1,1024,4,7814228998
6554,63686409685,49091,63686458776,8,0,0,20480,8,7127332499
6555,63686448491,7226,63686455717,1,0,0,7680,1,6370006442
6556,63686468684,1514,63686470198,9,0,1,38400,9,9647520735
6557,63686489810,1038,63686490848,4,0,0,1536,4,7748742328
6558,63686555618,103060,63686658678,4,0,0,1024,4,5442069769
6559,63686561718,66610,63686628328,0,0,0,96768,0,2298947089
6560,63686574559,126850,63686701409,7,0,1,2560,7,1233483879
6561,63686636085,1038,63686637123,4,0,1,6656,4,6380765246
6562,63686718877,50668,63686769545,5,0,1,2560,5,780248134
6563,63686730531,178860,63686909391,7,0,0,1024,7,9353729512
6564,63686817622,64384,63686882006,9,0,1,12288,9,6571819377
6565,63687057083,562,63687057645,7,0,0,512,7,3448982805
6566,63687158575,22687,63687181262,0,0,0,37376,0,4847883797
6567,63687283732,1038,63687284770,1,0,1,101376,1,6000594988
6568,63687348448,122248,63687470696,5,0,0,1024,5,4761999687
6569,63687375010,30981,63687405991,8,0,0,29696,8,9415326324
6570,63687450336,69280,63687519616,3,0,1,8192,3,5462976352
6571,63687518052,2466,63687520518,3,0,1,18432,3,2800104514
6572,63687544309,4370,63687548679,4,0,0,2560,4,588873169
6573,63687592827,93924,63687686751,2,0,0,4608,2,8720115956
6574,63687745234,33071,63687778305,0,0,0,54272,0,3324608769
6575,63687795475,56850,63687852325,8,0,0,97280,8,3066025594
6576,63687819461,34490,63687853951,2,0,0,2560,2,3115072230
6577,63687822435,42550,63687864985,1,0,0,44544,1,9713962322
6578,63687872775,84530,63687957305,8,0,1,13312,8,7231638567
6579,63687876643,111745,63687988388,6,0,1,8192,6,7708636492
6580,63687892830,34693,63687927523,0,0,0,180736,0,95963730
6581,63687972468,10753,63687983221,7,0,0,4096,7,3195237938
6582,63688006548,226546,63688233094,2,0,1,1536,2,8336684318
6583,63688044515,117536,63688162051,0,0,0,17408,0,7199451451
6584,63688055358,63874,63688119232,7,0,1,15872,7,7051731680
6585,63688096023,139442,63688235465,7,0,1,1536,7,5327227432
6586,63688118188,216389,63688334577,8,0,0,107520,8,10689821252
6587,63688270972,1805,63688272777,5,0,0,1024,5,170824993
6588,63688333764,105238,63688439002,3,0,0,171520,3,3045334762
6589,63688369090,43898,63688412988,2,0,1,11776,2,3541662482
6590,63688398650,82086,63688480736,3,0,0,5632,3,1669042370
6591,63688441861,62880,63688504741,6,0,1,4096,6,5915697635
6592,63688515511,227611,63688743122,4,0,1,4096,4,4065595331
6593,63688559422,121537,63688680959,0,0,1,55296,0,6994047568
6594,63688842702,1990,63688844692,5,0,0,2048,5,2646182932
6595,63688917913,67588,63688985501,8,0,1,7680,8,10583679645
6596,63689130634,55744,63689186378,2,0,1,4096,2,5723172817
6597,63689145375,47596,63689192971,7,0,1,2560,7,2472288285
6598,63689294357,2942,63689297299,0,0,1,57344,0,8570001762
6599,63689376486,108832,63689485318,2,0,0,3072,2,6114968736
6600,63689445267,13079,63689458346,8,0,0,22016,8,3925639134
6601,63689515505,562,63689516067,5,0,0,512,5,6766192479
6602,63689524194,58060,63689582254,3,0,1,6656,3,10304770386
6603,63689552748,119954,63689672702,7,0,1,18432,7,9962483
6604,63689931249,2942,63689934191,5,0,0,3072,5,7343264144
6605,63689935569,87821,63690023390,3,0,1,70656,3,7875885225
6606,63689936060,112888,63690048948,7,0,1,5120,7,7562321820
6607,63689978431,93120,63690071551,9,0,1,9216,9,9710064811
6608,63690138550,562,63690139112,3,0,1,8192,3,1376295131
6609,63690149433,61600,63690211033,4,0,0,512,4,10388243556
6610,63690262681,72537,63690335218,8,0,0,117760,8,7431174643
6611,63690329585,562,63690330147,1,0,1,147968,1,7673258673
6612,63690334355,88375,63690422730,9,0,1,14336,9,8260998826
6613,63690342442,1038,63690343480,5,0,0,512,5,2055002972
6614,63690376451,258949,63690635400,3,0,1,7168,3,8109210322
6615,63690496825,324403,63690821228,5,0,0,1024,5,9731084920
6616,63690497217,197325,63690694542,1,0,1,108544,1,8364755911
6617,63690504875,118489,63690623364,9,0,1,24064,9,6782830264
6618,63690608536,108707,63690717243,6,0,1,5632,6,6028378739
6619,63690623481,234656,63690858137,2,0,1,12288,2,3520072746
6620,63690975879,1038,63690976917,4,0,1,3072,4,7055942812
6621,63691013968,50824,63691064792,4,0,0,1024,4,7531853741
6622,63691018655,117083,63691135738,1,0,0,194560,1,8722017035
6623,63691085396,51648,63691137044,7,0,0,2048,7,3818951050
6624,63691178889,4370,63691183259,0,0,0,4608,0,4940602001
6625,63691180906,183419,63691364325,1,0,0,363008,1,3555051309
6626,63691191883,159602,63691351485,4,0,1,1536,4,1209966324
6627,63691209262,224154,63691433416,2,0,0,512,2,3814214328
6628,63691225852,196144,63691421996,8,0,1,4608,8,9918777291
6629,63691384975,21737,63691406712,7,0,0,2048,7,1190570140
6630,63691463251,3894,63691467145,2,0,0,4096,2,368654982
6631,63691481143,1990,63691483133,5,0,0,2048,5,901441590
6632,63691516440,4846,63691521286,7,0,0,5120,7,1740447718
6633,63691661250,57436,63691718686,6,0,1,4608,6,6000335331
6634,63691682034,125658,63691807692,3,0,0,207872,3,4863365382
6635,63691714522,92811,63691807333,0,0,1,89088,0,6753764779
6636,63691715227,99098,63691814325,5,0,0,512,5,7069929405
6637,63691769663,562,63691770225,6,0,1,26112,6,4503304884
6638,63691835006,286585,63692121591,2,0,1,3584,2,5996335071
6639,63691934897,239411,63692174308,4,0,1,23552,4,8447710912
6640,63691960081,123745,63692083826,5,0,0,512,5,1616239398
6641,63692001586,1038,63692002624,3,0,1,50176,3,4662072304
6642,63692060876,114128,63692175004,7,0,0,1024,7,1719676998
6643,63692085266,43108,63692128374,1,0,0,73728,1,2168364851
6644,63692092203,36837,63692129040,5,0,0,1024,5,1150447360
6645,63692117896,17455,63692135351,3,0,0,30208,3,5586142693
6646,63692135716,562,63692136278,2,0,0,512,2,2747973129
6647,63692139414,2942,63692142356,2,0,0,3072,2,1885732194
6648,63692172731,562,63692173293,2,0,0,512,2,1064993383
6649,63692202476,74419,63692276895,4,0,1,4608,4,1617520393
6650,63692278084,562,63692278646,9,0,1,8192,9,7603291162
6651,63692282847,73973,63692356820,2,0,1,3072,2,6080798090
6652,63692317072,78744,63692395816,5,0,0,512,5,139195488
6653,63692349008,64705,63692413713,6,0,1,6656,6,1104766995
6654,63692487970,1514,63692489484,0,0,1,75264,0,5650653303
6655,63692548527,114292,63692662819,2,0,0,1536,2,7197499589
6656,63692600317,58787,63692659104,3,0,0,97280,3,8498132050
6657,63692853680,64204,63692917884,7,0,1,6656,7,1271482798
6658,63692860648,70460,63692931108,9,0,1,9728,9,3698451604
6659,63692863776,114292,63692978068,0,0,1,75264,0,7355190984
6660,63692946616,94848,63693041464,5,0,1,18944,5,7706571603
6661,63692979639,64828,63693044467,3,0,1,8704,3,8552370392
6662,63692989634,72380,63693062014,2,0,1,4608,2,8853705558
6663,63693012178,67900,63693080078,5,0,1,8704,5,4944430895
6664,63693071226,82528,63693153754,3,0,1,16384,3,2493281526
6665,63693138208,108052,63693246260,1,0,1,54784,1,2969550048
6666,63693160786,94324,63693255110,6,0,1,2048,6,825573101
6667,63693289648,100252,63693389900,1,0,1,29184,1,10424811010
6668,63693360833,12625,63693373458,5,0,1,3072,5,8738238264
6669,63693366194,55744,63693421938,7,0,1,4096,7,2393709670
6670,63693377286,63188,63693440474,1,0,0,6656,1,6237064243
6671,63693409273,55817,63693465090,0,0,0,95232,0,2747070183
6672,63693450429,562,63693450991,8,0,1,4096,8,6039150938
6673,63693518699,188517,63693707216,7,0,0,512,7,9205118479
6674,63693636299,2658,63693638957,4,0,0,1536,4,7584758148
6675,63693661570,3124,63693664694,8,0,0,9216,8,10506096940
6676,63693842231,60064,63693902295,7,0,1,8192,7,4016983736
6677,63693920635,2866,63693923501,6,0,1,7680,6,6798929440
6678,63693929026,67588,63693996614,7,0,0,8704,7,3476223210
6679,63693935867,53233,63693989100,8,0,0,90112,8,8515606051
6680,63693944385,83933,63694028318,2,0,1,1024,2,4058107699
6681,63693963457,74356,63694037813,5,0,1,9728,5,2279912963
6682,63694003212,115262,63694118474,5,0,1,17408,5,6062853633
6683,63694202567,50668,63694253235,5,0,1,2560,5,4630754325
6684,63694241451,12821,63694254272,3,0,0,21504,3,7510941448
6685,63694247124,62565,63694309689,1,0,0,99840,1,10372235574
6686,63694369613,2942,63694372555,4,0,0,3072,4,4151971592
6687,63694381971,1514,63694383485,7,0,1,7680,7,10645644465
6688,63694413963,59908,63694473871,7,0,1,19968,7,7145150771
6689,63694419156,1038,63694420194,5,0,0,1536,5,3833936117
6690,63694419752,121669,63694541421,9,0,1,7680,9,5353564295
6691,63694436741,110692,63694547433,5,0,1,12288,5,226677518
6692,63694505770,152706,63694658476,7,0,0,1024,7,1930561694
6693,63694528527,74257,63694602784,3,0,1,5120,3,4421092244
6694,63694531372,94507,63694625879,8,0,1,11264,8,2867416421
6695,63694554526,1038,63694555564,7,0,1,11776,7,7825814246
6696,63694611689,81124,63694692813,2,0,1,8192,2,4050938045
6697,63694626711,88065,63694714776,4,0,0,1024,4,2169268302
6698,63694709256,562,63694709818,2,0,0,512,2,1053385311
6699,63694843577,74516,63694918093,1,0,0,124928,1,1188476103
6700,63694959218,1514,63694960732,2,0,0,1536,2,8727566463
6701,63695121734,50668,63695172402,7,0,1,2560,7,7978132294
6702,63695180377,1514,63695181891,8,0,0,1536,8,3782696267
6703,63695226877,99160,63695326037,8,0,1,25600,8,9868106379
6704,63695232217,43900,63695276117,6,0,1,7168,6,7812776367
6705,63695232423,130018,63695362441,8,0,1,11264,8,6088177478
6706,63695258838,114282,63695373120,8,0,1,10752,8,9444194415
6707,63695287095,154677,63695441772,2,0,1,512,2,3353417433
6708,63695379312,13766,63695393078,2,0,1,15872,2,5203695660
6709,63695399618,74692,63695474310,8,0,0,26624,8,5748007487
6710,63695445811,52360,63695498171,2,0,1,3072,2,2822800876
6711,63695451663,101954,63695553617,6,0,1,6656,6,6990418241
6712,63695548256,3894,63695552150,0,0,1,32256,0,3105225023
6713,63695617842,2466,63695620308,4,0,0,4096,4,4912658108
6714,63695630918,120499,63695751417,2,0,0,2560,2,8939349568
6715,63695687003,70528,63695757531,6,0,1,12288,6,7945013653
6716,63695704500,48976,63695753476,0,0,1,10240,0,3506244764
6717,63695721683,562,63695722245,8,0,1,2048,8,2607078132
6718,63695804904,1514,63695806418,2,0,0,512,2,7495972707
6719,63695819377,841,63695820218,2,0,0,1536,2,2379510379
6720,63695820396,155702,63695976098,7,0,0,512,7,7980930518
6721,63695850589,2466,63695853055,5,0,1,2048,5,8765385010
6722,63695872714,48976,63695921690,8,0,1,12800,8,6351767899
6723,63695891288,87301,63695978589,7,0,0,2560,7,10255668979
6724,63695934537,63704,63695998241,0,0,0,103936,0,3776602919
6725,63695977189,35050,63696012239,3,0,1,8192,3,3707510353
6726,63696021626,104745,63696126371,8,0,0,61440,8,8870270084
6727,63696092058,173270,63696265328,1,0,0,280576,1,197474688
6728,63696162861,167639,63696330500,8,0,1,14336,8,5261289378
6729,63696309207,19694,63696328901,9,0,1,8704,9,9743103259
6730,63696327148,143301,63696470449,8,0,0,31744,8,1296380764
6731,63696391853,10753,63696402606,8,0,1,19968,8,5715911257
6732,63696487155,165843,63696652998,1,0,0,17408,1,805184615
6733,63696540967,52360,63696593327,8,0,1,4608,8,1832581366
6734,63696543562,57436,63696600998,3,0,1,3072,3,4387831118
6735,63696563623,1038,63696564661,1,0,1,53248,1,2407975394
6736,63696655361,166356,63696821717,5,0,0,1024,5,10563813298
6737,63696663461,3193,63696666654,6,0,1,1536,6,9168769116
6738,63696728768,72608,63696801376,5,0,0,2048,5,7647558846
6739,63696732850,4370,63696737220,1,0,0,4608,1,4768610973
6740,63696765575,1990,63696767565,4,0,0,2048,4,5694170315
6741,63696773063,66988,63696840051,5,0,1,10752,5,9658859093
6742,63696794594,64204,63696858798,6,0,1,6656,6,9753677740
6743,63696816331,101032,63696917363,0,0,1,31744,0,7985363764
6744,63696883879,45950,63696929829,3,0,1,4608,3,4355200403
6745,63696887152,562,63696887714,0,0,0,79360,0,122569003
6746,63696950669,1990,63696952659,4,0,1,10752,4,3250270202
6747,63696952302,114100,63697066402,7,0,0,512,7,10330770169
6748,63696955063,70060,63697025123,7,0,0,2048,7,2651103623
6749,63697053431,2466,63697055897,1,0,1,110080,1,10328674074
6750,63697091077,77418,63697168495,0,0,0,2560,0,4446500021
6751,63697104682,163334,63697268016,4,0,1,6144,4,3903516410
6752,63697372268,7226,63697379494,0,0,1,128512,0,5128143923
6753,63697379194,121262,63697500456,6,0,1,25088,6,4742526469
6754,63697392611,175842,63697568453,5,0,0,7680,5,3919714977
6755,63697397397,172677,63697570074,9,0,1,25600,9,984781344
6756,63697585622,88672,63697674294,6,0,1,16384,6,2710905946
6757,63697664882,110080,63697774962,0,0,1,61440,0,8016756062
6758,63697718119,94996,63697813115,2,0,1,22016,2,6647010079
6759,63697869585,13249,63697882834,0,0,0,25600,0,7173708150
6760,63697925743,105556,63698031299,1,0,1,46592,1,9775431464
6761,63698325538,90364,63698415902,7,0,1,16896,7,8547177024
6762,63698328626,111540,63698440166,3,0,1,15872,3,331546448
6763,63698414275,88911,63698503186,5,0,1,16896,5,1249761689
6764,63698518506,59908,63698578414,2,0,1,7680,2,2710671573
6765,63698578762,32295,63698611057,0,0,0,52736,0,6110005585
6766,63698634850,562,63698635412,5,0,0,512,5,1359294150
6767,63698676151,95541,63698771692,8,0,1,32256,8,471106920
6768,63698741340,191234,63698932574,1,0,0,159232,1,10484481150
6769,63698893238,52545,63698945783,3,0,0,85504,3,8502678812
6770,63698975991,1990,63698977981,4,0,0,2048,4,5691630421
6771,63699149015,1514,63699150529,4,0,0,1536,4,620333005
6772,63699152351,562,63699152913,6,0,1,2048,6,8957432379
6773,63699166535,47440,63699213975,1,0,1,120320,1,7013790153
6774,63699170193,128020,63699298213,4,0,0,512,4,10113920837
6775,63699218697,70311,63699289008,3,0,1,16896,3,6248813336
6776,63699236508,33025,63699269533,3,0,1,2048,3,2126679684
6777,63699274876,111078,63699385954,3,0,0,22528,3,1104664063
6778,63699285744,2942,63699288686,4,0,1,15360,4,8856942132
6779,63699371136,193418,63699564554,2,0,0,3072,2,1470350269
6780,63699475798,3918,63699479716,5,0,0,512,5,7133016230
6781,63699618776,21395,63699640171,1,0,0,34816,1,5907025836
6782,63699737240,54520,63699791760,4,0,1,5120,4,10543538968
6783,63699846577,2942,63699849519,2,0,0,3072,2,2665187181
6784,63699896102,48976,63699945078,9,0,1,2048,9,277662810
6785,63699914290,76204,63699990494,3,0,1,10752,3,832564140
6786,63699951410,67588,63700018998,3,0,1,7680,3,9551741566
6787,63700013186,562,63700013748,1,0,1,116736,1,6277295107
6788,63700077155,126928,63700204083,2,0,0,512,2,1457179154
6789,63700113536,29512,63700143048,4,0,0,3072,4,7753986476
6790,63700245993,2942,63700248935,2,0,0,3072,2,8393152794
6791,63700373075,4158,63700377233,8,0,0,11264,8,2339418861
6792,63700396507,7226,63700403733,1,0,0,7680,1,5506814314
6793,63700459793,1038,63700460831,7,0,0,1024,7,7094934122
6794,63700567913,3418,63700571331,5,0,0,3584,5,3807250359
6795,63700600747,56836,63700657583,6,0,1,11776,6,2448332606
6796,63700618236,79588,63700697824,2,0,1,7680,2,8383707860
6797,63700655389,59128,63700714517,9,0,1,5120,9,10223115844
6798,63700718774,30487,63700749261,1,0,0,49152,1,7261893240
6799,63700737839,97948,63700835787,9,0,1,3584,9,81194655
6800,63700897910,23462,63700921372,1,0,0,38912,1,7046135167
6801,63700970848,73054,63701043902,8,0,0,118784,8,201199604
6802,63701087286,78076,63701165362,6,0,1,16896,6,9332396527
6803,63701165297,13508,63701178805,9,0,1,3072,9,2147762110
6804,63701173186,50881,63701224067,1,0,0,26112,1,5756491566
6805,63701186947,55373,63701242320,9,0,1,2048,9,5909262789
6806,63701247454,16609,63701264063,0,0,0,32256,0,8455404758
6807,63701271137,1038,63701272175,1,0,1,1536,1,6979987467
6808,63701286264,1514,63701287778,3,0,0,1024,3,5023526920
6809,63701316817,205939,63701522756,7,0,0,1536,7,5784293297
6810,63701347089,145263,63701492352,7,0,1,16384,7,6398318870
6811,63701350363,177166,63701527529,5,0,1,24064,5,9592676744
6812,63701360330,194476,63701554806,1,0,1,144384,1,10277349583
6813,63701528969,17852,63701546821,4,0,0,2048,4,3697536112
6814,63701573285,2466,63701575751,5,0,0,2560,5,5106995128
6815,63701593761,562,63701594323,5,0,0,512,5,9862679731
6816,63701708132,102395,63701810527,3,0,0,165888,3,173497222
6817,63701840391,47284,63701887675,8,0,1,11776,8,5516533211
6818,63701851232,144322,63701995554,4,0,1,1536,4,7206395904
6819,63701944736,45592,63701990328,2,0,1,1024,2,6532046617
6820,63702044670,562,63702045232,4,0,1,45056,4,4582288447
6821,63702093478,105088,63702198566,2,0,0,512,2,6478924974
6822,63702101444,30587,63702132031,7,0,1,3584,7,4506274622
6823,63702114366,21278,63702135644,0,0,1,182784,0,7193477017
6824,63702119182,17099,63702136281,1,0,0,33280,1,3010987781
6825,63702144394,2466,63702146860,6,0,1,1536,6,5247682407
6826,63702148870,137558,63702286428,0,0,0,32768,0,7357528302
6827,63702155635,95520,63702251155,2,0,0,4096,2,5587619542
6828,63702165250,76642,63702241892,6,0,1,2048,6,984489526
6829,63702189589,250361,63702439950,6,0,1,1024,6,3586505011
6830,63702226794,134062,63702360856,5,0,0,2560,5,6211164407
6831,63702289596,101717,63702391313,0,0,0,217600,0,4291201077
6832,63702323247,268833,63702592080,7,0,0,2048,7,3558639078
6833,63702405635,30363,63702435998,8,0,0,36352,8,3636902219
6834,63702610782,1038,63702611820,5,0,0,1024,5,2366124866
6835,63702636994,26217,63702663211,0,0,0,47616,0,9458963617
6836,63702656213,7344,63702663557,4,0,0,512,4,6551497982
6837,63702744939,52360,63702797299,8,0,1,3072,8,6400241213
6838,63702761715,34533,63702796248,6,0,1,3584,6,10028017108
6839,63702808995,28346,63702837341,2,0,0,60416,2,9316234897
6840,63702815528,93360,63702908888,5,0,0,512,5,10652919688
6841,63702818638,7226,63702825864,0,0,1,195072,0,4976614670
6842,63702899968,32037,63702932005,1,0,0,7680,1,3253845138
6843,63702937909,41128,63702979037,3,0,0,52224,3,4014024807
6844,63702958224,252250,63703210474,6,0,1,6144,6,9985897131
6845,63702964003,114555,63703078558,8,0,0,66560,8,848982907
6846,63703038324,48527,63703086851,8,0,0,24064,8,812732126
6847,63703127011,175794,63703302805,6,0,1,8704,6,7306230388
6848,63703127653,192545,63703320198,8,0,1,20480,8,6666109954
6849,63703271336,55139,63703326475,9,0,1,4608,9,1384780445
6850,63703444153,562,63703444715,0,0,0,512,0,6778482817
6851,63703457854,50668,63703508522,5,0,1,2560,5,1019056455
6852,63703480854,55658,63703536512,3,0,1,2560,3,9990872140
6853,63703519548,1038,63703520586,6,0,1,6656,6,7147301986
6854,63703547012,64204,63703611216,7,0,0,1024,7,7980242738
6855,63703590782,5798,63703596580,8,0,0,6144,8,7931948783
6856,63703814096,12821,63703826917,0,0,0,21504,0,3570573078
6857,63703865361,75916,63703941277,8,0,1,4096,8,10266912555
6858,63703874131,82996,63703957127,2,0,1,14848,2,5524857227
6859,63703912730,160552,63704073282,9,0,1,17920,9,3551535411
6860,63703936972,2942,63703939914,5,0,1,32768,5,7693691467
6861,63704019059,111236,63704130295,2,0,1,1536,2,7922288586
6862,63704023475,3418,63704026893,4,0,0,3072,4,7727789737
6863,63704051842,47284,63704099126,4,0,0,3584,4,4275914983
6864,63704129097,145133,63704274230,8,0,0,239104,8,4594208077
6865,63704259749,15833,63704275582,2,0,1,8192,2,4378585810
6866,63704345941,204370,63704550311,0,0,0,30720,0,9634086637
6867,63704370646,144436,63704515082,3,0,0,486912,3,1113885464
6868,63704414035,298041,63704712076,0,0,0,6656,0,10724378593
6869,63704514400,258838,63704773238,6,0,1,5632,6,1286978896
6870,63704590683,81986,63704672669,2,0,1,11264,2,9779035523
6871,63704591553,45301,63704636854,7,0,0,1024,7,8498742878
6872,63704599327,227657,63704826984,7,0,1,14336,7,1493973295
6873,63704629224,95816,63704725040,5,0,0,1536,5,3574065764
6874,63704790994,298393,63705089387,7,0,1,9728,7,5080524078
6875,63704945925,76048,63705021973,6,0,1,10240,6,3018494923
6876,63704962606,63951,63705026557,9,0,1,5120,9,2972559545
6877,63705024517,52360,63705076877,8,0,1,3072,8,263709831
6878,63705046120,64908,63705111028,2,0,0,109568,2,4448579619
6879,63705084194,28140,63705112334,5,0,0,2048,5,4515194273
6880,63705147581,36370,63705183951,8,0,1,4096,8,9858349681
6881,63705148848,3418,63705152266,8,0,1,20992,8,7582409966
6882,63705164667,159034,63705323701,9,0,1,7168,9,845686583
6883,63705291159,190563,63705481722,7,0,0,3584,7,4126293904
6884,63705388077,69592,63705457669,5,0,1,9216,5,9290347596
6885,63705478731,20362,63705499093,6,0,1,4096,6,6671411713
6886,63705492782,55744,63705548526,1,0,0,32768,1,1138013150
6887,63705618399,59128,63705677527,7,0,1,5120,7,30790097
6888,63705686866,103684,63705790550,1,0,1,40448,1,8530147151
6889,63705774975,52331,63705827306,5,0,1,2560,5,1075007676
6890,63705820899,45175,63705866074,0,0,0,77824,0,5452179772
6891,63705830689,23204,63705853893,9,0,1,37376,9,3869336597
6892,63705898130,264655,63706162785,1,0,0,38400,1,8350180354
6893,63706086590,10736,63706097326,4,0,0,2048,4,4028595425
6894,63706126913,1038,63706127951,7,0,0,1024,7,5780512685
6895,63706128621,112779,63706241400,3,0,0,182784,3,2978408621
6896,63706166634,126864,63706293498,3,0,0,175616,3,10655636633
6897,63706262466,22687,63706285153,5,0,1,4096,5,6751432325
6898,63706302776,176625,63706479401,8,0,0,37376,8,3591420272
6899,63706451449,2942,63706454391,7,0,0,3072,7,2077004827
6900,63706751851,33071,63706784922,2,0,0,54272,2,4578889282
6901,63706884113,1514,63706885627,7,0,0,1536,7,9489152702
6902,63706926797,32554,63706959351,7,0,1,11776,7,6305110290
6903,63706947555,64228,63707011783,1,0,0,53248,1,5987762703
6904,63707015663,1990,63707017653,0,0,1,124928,0,9706423201
6905,63707034347,261753,63707296100,4,0,0,2048,4,6132291818
6906,63707206802,90870,63707297672,5,0,1,7680,5,6056459255
6907,63707249646,88641,63707338287,1,0,0,98304,1,6144373938
6908,63707271655,72431,63707344086,0,0,0,27648,0,7737994377
6909,63707302458,41987,63707344445,2,0,0,9728,2,470329681
6910,63707308156,75746,63707383902,3,0,1,512,3,6861055605
6911,63707345628,112152,63707457780,0,0,1,25088,0,1554718979
6912,63707391980,76984,63707468964,5,0,1,13312,5,6296078007
6913,63707415170,4661,63707419831,5,0,1,6144,5,3799097645
6914,63707464314,62512,63707526826,7,0,0,1024,7,5670070123
6915,63707604091,96844,63707700935,7,0,1,23040,7,10265687420
6916,63707721856,562,63707722418,5,0,1,18944,5,9493161305
6917,63707753434,562,63707753996,7,0,1,11264,7,9007833696
6918,63707781052,97132,63707878184,4,0,0,512,4,6059002821
6919,63707791653,117316,63707908969,7,0,0,512,7,5659986237
6920,63707927823,2866,63707930689,5,0,0,8704,5,3559388089
6921,63708027267,76048,63708103315,7,0,1,10240,7,8050012804
6922,63708169593,54676,63708224269,7,0,1,5632,7,7793101753
6923,63708260115,14283,63708274398,4,0,1,15872,4,6393083002
6924,63708279991,50980,63708330971,9,0,1,3584,9,10552060729
6925,63708282029,90052,63708372081,0,0,0,27648,0,7222140597
6926,63708328200,167450,63708495650,3,0,0,275968,3,8256707688
6927,63708328377,186971,63708515348,7,0,1,512,7,7660039914
6928,63708353784,248687,63708602471,9,0,1,11264,9,10264452004
6929,63708376484,236966,63708613450,8,0,0,226304,8,8561139488
6930,63708458944,131817,63708590761,0,0,0,89088,0,7035348648
6931,63708560221,31690,63708591911,4,0,0,2048,4,9519638060
6932,63708568463,73746,63708642209,6,0,1,7168,6,5630166543
6933,63708624502,2942,63708627444,1,0,1,1536,1,6105645271
6934,63708718249,1514,63708719763,4,0,0,3072,4,4724881973
6935,63708756511,329623,63709086134,4,0,0,1536,4,9280132012
6936,63708851033,47376,63708898409,2,0,1,1024,2,9463528329
6937,63708951147,2466,63708953613,9,0,1,43520,9,9530872446
6938,63708953027,104620,63709057647,0,0,1,204800,0,8266205652
6939,63708984547,33587,63709018134,5,0,0,2560,5,1941091661
6940,63709023278,221342,63709244620,1,0,0,55296,1,2818224826
6941,63709173643,1280,63709174923,5,0,0,512,5,3272026812
6942,63709230138,33329,63709263467,8,0,1,19968,8,9796235632
6943,63709269692,89764,63709359456,0,0,0,54784,0,10331022029
6944,63709340579,2466,63709343045,6,0,1,2048,6,5409588698
6945,63709368813,48976,63709417789,4,0,0,2560,4,9704017003
6946,63709385326,67588,63709452914,5,0,1,7680,5,4054234824
6947,63709535305,65166,63709600471,1,0,0,110080,1,5202667987
6948,63709694965,55635,63709750600,2,0,1,2048,2,4615218892
6949,63709712066,94223,63709806289,5,0,1,11776,5,3249973927
6950,63709731861,81124,63709812985,4,0,1,1536,4,4942288959
6951,63709779803,43900,63709823703,5,0,1,512,5,840724393
6952,63709835298,114846,63709950144,0,0,0,186880,0,4975295985
6953,63709856093,144794,63710000887,7,0,1,5120,7,7371699882
6954,63709961686,73741,63710035427,0,0,1,138240,0,843101722
6955,63709993857,172695,63710166552,0,0,0,123392,0,7197937789
6956,63710028165,96293,63710124458,0,0,1,54784,0,6661827219
6957,63710133415,4370,63710137785,4,0,1,1024,4,4413209374
6958,63710262295,384912,63710647207,9,0,1,8704,9,3959529290
6959,63710288916,92880,63710381796,4,0,0,4608,4,74360909
6960,63710445855,52287,63710498142,3,0,0,84992,3,3711521167
6961,63710478226,103866,63710582092,2,0,1,5632,2,5612725661
6962,63710578140,44658,63710622798,3,0,0,76800,3,5395171981
6963,63710624796,1990,63710626786,1,0,0,2048,1,3667743001
6964,63710663339,54354,63710717693,3,0,0,89088,3,7280474906
6965,63710711155,83437,63710794592,1,0,0,135680,1,6233029086
6966,63710774907,94367,63710869274,6,0,1,2048,6,893100276
6967,63710977321,125488,63711102809,1,0,0,204288,1,8644575149
6968,63711014512,30260,63711044772,9,0,1,20480,9,846522487
6969,63711073855,86708,63711160563,5,0,0,2048,5,4748378360
6970,63711146444,236846,63711383290,8,0,0,145408,8,3423499776
6971,63711269313,562,63711269875,7,0,0,512,7,1526441863
6972,63711276069,1038,63711277107,5,0,0,1024,5,2239764864
6973,63711313069,84473,63711397542,6,0,1,1536,6,8626692906
6974,63711353490,92270,63711445760,2,0,0,149504,2,9102999781
6975,63711387851,16154,63711404005,8,0,1,14336,8,1333507470
6976,63711432192,15855,63711448047,1,0,0,4096,1,9691971743
6977,63711434117,562,63711434679,6,0,0,2560,6,4277771363
6978,63711473560,118218,63711591778,5,0,0,512,5,4171163619
6979,63711497657,227020,63711724677,5,0,1,38400,5,3759750804
6980,63711777462,52545,63711830007,8,0,0,85504,8,5711887649
6981,63711859314,60820,63711920134,9,0,1,5632,9,1084665903
6982,63712241293,72376,63712313669,7,0,1,13312,7,8091627179
6983,63712322359,54988,63712377347,5,0,1,6656,5,6586870007
6984,63712389841,113037,63712502878,0,0,0,183296,0,2317115293
6985,63712398355,107749,63712506104,7,0,0,5120,7,1443272475
6986,63712454107,53303,63712507410,5,0,0,2048,5,7381279394
6987,63712520858,3418,63712524276,5,0,0,3584,5,8860839175
6988,63712613633,52399,63712666032,9,0,1,2048,9,6678872915
6989,63712705058,562,63712705620,1,0,1,55296,1,4463578343
6990,63712708045,52516,63712760561,9,0,1,7168,9,8207422477
6991,63712708694,65896,63712774590,2,0,1,28672,2,3374882978
6992,63712716274,95488,63712811762,2,0,1,3584,2,7344609399
6993,63712724769,154545,63712879314,5,0,0,512,5,5387868260
6994,63712777929,125658,63712903587,8,0,0,207872,8,2718400225
6995,63712789012,135671,63712924683,2,0,0,68096,2,8682905676
6996,63712815772,112694,63712928466,4,0,1,16896,4,4727200208
6997,63712828873,63033,63712891906,3,0,0,56320,3,4815654390
6998,63712879200,20362,63712899562,4,0,0,1024,4,7064925818
6999,63712964592,197995,63713162587,8,0,0,32768,8,6905586308
7000,63712988310,2942,63712991252,8,0,1,14848,8,10620179958
7001,63712992324,104846,63713097170,1,0,1,32256,1,483095156
7002,63713068239,144055,63713212294,4,0,0,3072,4,4251111539
7003,63713226152,62512,63713288664,3,0,1,6144,3,2367898566
7004,63713300217,89764,63713389981,3,0,1,19968,3,6728380578
7005,63713458019,89584,63713547603,1,0,1,14336,1,475119681
7006,63713631859,115791,63713747650,0,0,0,192000,0,7910501925
7007,63713717172,12304,63713729476,8,0,1,13824,8,1983618976
7008,63713791783,42420,63713834203,1,0,0,20480,1,9161242962
7009,63713868196,119284,63713987480,0,0,1,91648,0,3038748201
7010,63713870660,27761,63713898421,0,0,1,54784,0,2722590186
7011,63713886507,288068,63714174575,8,0,0,69120,8,8375489862
7012,63713898740,159690,63714058430,3,0,1,50688,3,7647437746
7013,63713960273,184431,63714144704,4,0,0,512,4,2730032295
7014,63714004807,79779,63714084586,5,0,1,4608,5,6526862375
7015,63714024457,2942,63714027399,7,0,1,2560,7,4819271290
7016,63714149051,161649,63714310700,7,0,0,3072,7,8290457338
7017,63714221197,85169,63714306366,2,0,1,12288,2,5558687205
7018,63714223550,90832,63714314382,3,0,1,18432,3,9070746752
7019,63714319616,50737,63714370353,0,0,0,81920,0,2729222878
7020,63714327561,4002,63714331563,2,0,1,3072,2,10266653655
7021,63714367337,112752,63714480089,7,0,0,1536,7,9395969659
7022,63714369071,111076,63714480147,2,0,1,6656,2,4000631561
7023,63714440948,1445,63714442393,5,0,1,5632,5,5203758181
7024,63714462457,112433,63714574890,2,0,1,4096,2,10129524439
7025,63714479732,11012,63714490744,4,0,0,1024,4,4498323407
7026,63714599674,171035,63714770709,1,0,0,17920,1,1699268911
7027,63714665421,93991,63714759412,1,0,0,156160,1,6566898547
7028,63714713419,2942,63714716361,8,0,1,22528,8,6190384711
7029,63714750498,148098,63714898596,0,0,1,82944,0,3757680529
7030,63714761161,150521,63714911682,6,0,0,3072,6,385997130
7031,63714793260,23003,63714816263,5,0,1,12288,5,3145180575
7032,63714881391,1514,63714882905,2,0,0,9728,2,2602225238
7033,63714909521,185037,63715094558,1,0,1,310272,1,6073905007
7034,63714964101,327334,63715291435,7,0,0,1536,7,7323763878
7035,63714972052,266530,63715238582,8,0,1,5632,8,1238408353
7036,63715121931,125094,63715247025,5,0,1,27648,5,4196479077
7037,63715198192,59804,63715257996,8,0,0,17920,8,6051291648
7038,63715243057,56404,63715299461,2,0,0,81408,2,1800376385
7039,63715316019,5967,63715321986,3,0,1,512,3,3114880464
7040,63715340074,47284,63715387358,3,0,0,14848,3,2134824859
7041,63715396479,154683,63715551162,4,0,1,1536,4,8948253961
7042,63715456949,52516,63715509465,2,0,1,3584,2,7484161628
7043,63715582056,47284,63715629340,7,0,1,1536,7,9103835408
7044,63715667387,89944,63715757331,5,0,1,27136,5,1269454417
7045,63715670346,101182,63715771528,5,0,1,25600,5,9228018372
7046,63715718040,82924,63715800964,6,0,1,11776,6,9971360970
7047,63715729544,115172,63715844716,0,0,1,39424,0,10657961861
7048,63715760607,43366,63715803973,9,0,1,29696,9,5855995419
7049,63715804442,1990,63715806432,2,0,0,74240,2,94242272
7050,63715812094,139333,63715951427,0,0,1,44544,0,8149784731
7051,63715857932,84314,63715942246,9,0,1,5632,9,3615357701
7052,63715879697,243812,63716123509,6,0,1,1024,6,7358186253
7053,63715899090,74356,63715973446,8,0,1,5120,8,7247766306
7054,63715918322,2981,63715921303,4,0,0,2048,4,7670996059
7055,63715925588,133511,63716059099,3,0,1,4096,3,1541571950
7056,63715936085,185053,63716121138,8,0,1,9728,8,6307948232
7057,63715962372,92487,63716054859,6,0,1,8192,6,10002788285
7058,63716008490,152543,63716161033,4,0,0,1024,4,4717898812
7059,63716076903,42865,63716119768,2,0,0,67584,2,507587081
7060,63716095008,40415,63716135423,0,0,0,50176,0,1303557823
7061,63716095175,66126,63716161301,7,0,1,6144,7,3274333218
7062,63716135366,4846,63716140212,6,0,1,24576,6,3194419156
7063,63716252481,562,63716253043,8,0,1,6144,8,9760526779
7064,63716261250,60976,63716322226,5,0,0,5120,5,8140705648
7065,63716281552,248918,63716530470,5,0,0,512,5,5105234641
7066,63716529355,86450,63716615805,2,0,0,144896,2,5637704114
7067,63716531663,84488,63716616151,4,0,0,512,4,9354064135
7068,63716560590,56547,63716617137,5,0,0,1536,5,9413860051
7069,63716649661,1514,63716651175,9,0,1,12288,9,2442891770
7070,63716653672,562,63716654234,6,0,0,1536,6,2892247309
7071,63716710863,1038,63716711901,5,0,0,512,5,5439022502
7072,63716718824,153468,63716872292,4,0,0,1024,4,2132426057
7073,63716743660,63136,63716806796,9,0,1,23552,9,9195989832
7074,63716745975,100252,63716846227,3,0,1,8192,3,9648301528
7075,63716752638,74068,63716826706,1,0,1,29184,1,932533838
7076,63716821829,16567,63716838396,1,0,1,13824,1,10064406930
7077,63716859305,167760,63717027065,9,0,1,40960,9,8008312529
7078,63716879341,103840,63716983181,1,0,0,31232,1,4560541536
7079,63717001462,1990,63717003452,0,0,1,25600,0,3508077508
7080,63717059059,91480,63717150539,1,0,1,77824,1,4327295975
7081,63717063015,54008,63717117023,6,0,0,2048,6,4051740749
7082,63717082186,115072,63717197258,3,0,0,91648,3,5997702802
7083,63717248274,1514,63717249788,0,0,1,210432,0,8429544087
7084,63717259670,224938,63717484608,5,0,0,1536,5,9296014364
7085,63717303502,133495,63717436997,9,0,1,26112,9,5272981069
7086,63717309343,27272,63717336615,8,0,1,22528,8,3169881536
7087,63717324827,171704,63717496531,7,0,1,9216,7,4426210078
7088,63717339744,219681,63717559425,8,0,0,180224,8,1919408537
7089,63717364784,242635,63717607419,9,0,1,19968,9,3730115147
7090,63717429979,139993,63717569972,4,0,1,19968,4,4681974307
7091,63717446995,211283,63717658278,4,0,0,1024,4,2820475960
7092,63717711468,67588,63717779056,3,0,1,7680,3,1680440717
7093,63717777289,15267,63717792556,0,0,0,26112,0,784568408
7094,63717856295,14800,63717871095,8,0,0,28672,8,7557789467
7095,63717921006,6750,63717927756,2,0,1,20992,2,10071659063
7096,63717927684,91530,63718019214,6,0,1,12288,6,3785577344
7097,63717950582,110564,63718061146,2,0,0,7168,2,124160223
7098,63718034420,25958,63718060378,8,0,0,47104,8,8912309767
7099,63718065391,12045,63718077436,1,0,1,1536,1,5956521114
7100,63718066763,47284,63718114047,1,0,0,19968,1,1662602608
7101,63718072399,54851,63718127250,0,0,0,89088,0,9631653802
7102,63718073999,59050,63718133049,0,0,0,19456,0,10165036286
7103,63718109477,54783,63718164260,1,0,1,4608,1,9141362484
7104,63718127997,11274,63718139271,7,0,1,36864,7,1476791130
7105,63718144121,97520,63718241641,1,0,0,93184,1,5475377208
7106,63718181004,1990,63718182994,0,0,1,34304,0,8231762799
7107,63718188616,221988,63718410604,0,0,0,1536,0,4099140769
7108,63718233122,123738,63718356860,1,0,1,22528,1,8305017101
7109,63718321214,226569,63718547783,7,0,0,2048,7,6022380860
7110,63718374003,33581,63718407584,1,0,0,39936,1,4496746360
7111,63718487527,33241,63718520768,2,0,0,57856,2,5222135605
7112,63718531097,55744,63718586841,0,0,1,4096,0,10201979343
7113,63718618477,62929,63718681406,8,0,0,102400,8,10349739969
7114,63718634118,47634,63718681752,4,0,0,512,4,223967405
7115,63718662885,19533,63718682418,7,0,0,1024,7,3887891180
7116,63718725001,24925,63718749926,1,0,1,3072,1,429967084
7117,63718800845,48976,63718849821,9,0,1,2048,9,8953359306
7118,63718814276,126557,63718940833,2,0,0,45056,2,1284025117
7119,63718879881,36342,63718916223,8,0,0,64000,8,6231669757
7120,63718913841,24925,63718938766,1,0,1,240128,1,7597679107
7121,63719046877,269047,63719315924,1,0,0,45056,1,5175910404
7122,63719109360,60196,63719169556,5,0,1,6144,5,374446900
7123,63719132938,55861,63719188799,1,0,0,16384,1,3179296042
7124,63719140179,12829,63719153008,5,0,0,4608,5,4500766398
7125,63719186757,92317,63719279074,1,0,0,5632,1,2989294936
7126,63719250590,14541,63719265131,3,0,0,28160,3,1464293332
7127,63719386206,36083,63719422289,2,0,0,63488,2,1321513481
7128,63719446817,62474,63719509291,3,0,1,7680,3,5243434059
7129,63719449745,5527,63719455272,4,0,1,8704,4,9453912180
7130,63719480018,70163,63719550181,9,0,1,6144,9,5964925551
7131,63719480629,77140,63719557769,2,0,1,512,2,1521783139
7132,63719506711,162216,63719668927,6,0,0,9728,6,3814466829
7133,63719509289,562,63719509851,1,0,1,188928,1,8814893365
7134,63719550125,260426,63719810551,6,0,1,1024,6,1755384791
7135,63719606978,166664,63719773642,8,0,1,12800,8,10046309948
7136,63719667020,329176,63719996196,2,0,1,1024,2,5118623565
7137,63719705239,57043,63719762282,5,0,0,512,5,4281750582
7138,63719720423,111457,63719831880,4,0,0,1536,4,631003200
7139,63719729915,272759,63720002674,1,0,1,246784,1,1063066146
7140,63719921556,81129,63720002685,5,0,0,7168,5,7225321333
7141,63719925374,77322,63720002696,5,0,0,2560,5,1109827246
7142,63720027350,4846,63720032196,1,0,1,12288,1,2264120052
7143,63720036513,65920,63720102433,4,0,0,5120,4,6631074407
7144,63720245030,1038,63720246068,0,0,1,287232,0,4252612422
7145,63720272064,266428,63720538492,7,0,0,1024,7,168840922
7146,63720326285,190824,63720517109,0,0,1,18432,0,4898142281
7147,63720383269,133851,63720517120,0,0,0,178688,0,388839508
7148,63720392891,127130,63720520021,7,0,0,3072,7,4519671096
7149,63720417268,1038,63720418306,0,0,1,20480,0,7953808040
7150,63720460869,177143,63720638012,5,0,1,1536,5,2552703265
7151,63720568218,145008,63720713226,7,0,0,1024,7,9860016993
7152,63720657511,70972,63720728483,7,0,1,8704,7,6282311532
7153,63720705710,47284,63720752994,5,0,1,1536,5,6992634429
7154,63720726915,101344,63720828259,6,0,1,27648,6,2653920798
7155,63720869752,43971,63720913723,3,0,0,72192,3,1241282782
7156,63720923815,562,63720924377,4,0,0,512,4,4617810642
7157,63720967748,10495,63720978243,3,0,0,16896,3,7617735569
7158,63720975964,1514,63720977478,5,0,1,8704,5,9635036574
7159,63720993494,33758,63721027252,7,0,0,1536,7,8709204755
7160,63721010424,100529,63721110953,3,0,0,58880,3,7878031440
7161,63721016920,69753,63721086673,7,0,1,16896,7,6692517863
7162,63721083732,150725,63721234457,3,0,1,10752,3,5661640824
7163,63721260471,3894,63721264365,6,0,0,4096,6,777358202
7164,63721262818,11787,63721274605,8,0,0,19456,8,6117071475
7165,63721295436,43900,63721339336,4,0,1,8192,4,7082158472
7166,63721309033,69280,63721378313,3,0,1,5120,3,1969549235
7167,63721315148,59128,63721374276,4,0,1,512,4,4783080250
7168,63721352071,1038,63721353109,5,0,1,4096,5,4905244957
7169,63721390472,54208,63721444680,5,0,0,1024,5,2548681713
7170,63721423456,562,63721424018,0,0,1,97280,0,2062855044
7171,63721424069,191769,63721615838,7,0,0,512,7,10323956760
7172,63721495455,65896,63721561351,7,0,1,13824,7,9659622111
7173,63721579727,156124,63721735851,3,0,1,7168,3,8315881633
7174,63721700327,51292,63721751619,6,0,1,4608,6,3535355195
7175,63721717562,48976,63721766538,9,0,1,2048,9,3199749804
7176,63721832035,2466,63721834501,4,0,0,2560,4,4999718700
7177,63721970141,96976,63722067117,3,0,1,18432,3,5235771644
7178,63722112312,61288,63722173600,3,0,1,7168,3,5010012219
7179,63722135344,65859,63722201203,0,0,1,37376,0,9175793979
7180,63722139091,119994,63722259085,2,0,1,3072,2,2314521396
7181,63722182431,72918,63722255349,2,0,0,106496,2,1400675794
7182,63722182904,109772,63722292676,7,0,1,9728,7,431576229
7183,63722194154,104440,63722298594,2,0,0,139264,2,1329400419
7184,63722201800,55570,63722257370,0,0,1,48128,0,7259889456
7185,63722248721,52360,63722301081,2,0,0,18944,2,6353899964
7186,63722288257,203798,63722492055,9,0,1,3072,9,913077134
7187,63722399298,60129,63722459427,2,0,0,88064,2,8723416246
7188,63722430472,34344,63722464816,2,0,0,25600,2,1698288788
7189,63722689872,80056,63722769928,7,0,1,13312,7,9133160792
7190,63722734755,52393,63722787148,8,0,1,2048,8,9489822869
7191,63722737089,81241,63722818330,7,0,1,9728,7,10114323558
7192,63722744084,76583,63722820667,2,0,0,129024,2,10668851319
7193,63722781471,117938,63722899409,2,0,1,14336,2,7013763514
7194,63722924429,60820,63722985249,6,0,1,5632,6,8026908367
7195,63722936020,47284,63722983304,5,0,1,9728,5,7279343711
7196,63722941448,90875,63723032323,9,0,1,1536,9,66776533
7197,63723044127,2466,63723046593,5,0,0,2560,5,10468586451
7198,63723176781,42679,63723219460,2,0,0,69632,2,9360830277
7199,63723207184,12622,63723219806,6,0,0,512,6,4135097967
7200,63723280381,562,63723280943,3,0,0,512,3,3447694624
7201,63723536655,45592,63723582247,2,0,1,1024,2,5012937986
7202,63723560609,23204,63723583813,3,0,1,1024,3,1811629380
7203,63723578168,45592,63723623760,8,0,0,38400,8,2863339280
7204,63723626271,1514,63723627785,5,0,0,1536,5,5468305152
7205,63723627140,65425,63723692565,8,0,0,110592,8,854511150
7206,63723767026,93991,63723861017,6,0,0,156160,6,6846669260
7207,63723824111,85452,63723909563,5,0,1,512,5,3409359433
7208,63723851538,99495,63723951033,3,0,1,4608,3,3842599951
7209,63723853164,104721,63723957885,2,0,0,170496,2,10057974646
7210,63723858357,127676,63723986033,4,0,1,1536,4,6551966939
7211,63723901159,127471,63724028630,3,0,1,2560,3,9293022733
7212,63723904759,168099,63724072858,3,0,0,210944,3,2780981112
7213,63723910456,232168,63724142624,0,0,0,17920,0,9815311239
7214,63723995381,160128,63724155509,4,0,1,1024,4,7876277520
7215,63724077292,5708,63724083000,1,0,1,133120,1,6766202222
7216,63724101714,152542,63724254256,6,0,1,22016,6,10115141587
7217,63724105578,253107,63724358685,6,0,1,57344,6,1598144185
7218,63724139297,102185,63724241482,4,0,1,25600,4,9784542663
7219,63724256437,373943,63724630380,2,0,0,14336,2,4258873379
7220,63724265296,93146,63724358442,9,0,1,512,9,5774120405
7221,63724379102,385131,63724764233,8,0,1,2048,8,10556106251
7222,63724583558,63916,63724647474,2,0,1,10752,2,800349236
7223,63724616275,104152,63724720427,1,0,1,41984,1,7803664084
7224,63724703457,81616,63724785073,3,0,1,18432,3,192086026
7225,63724805193,4846,63724810039,3,0,0,5120,3,4399218980
7226,63724815010,562,63724815572,5,0,0,512,5,4651930592
7227,63724833288,94684,63724927972,3,0,1,20992,3,722081749
7228,63724968199,5450,63724973649,1,0,0,13824,1,10508884525
7229,63725020515,7702,63725028217,6,0,0,8192,6,6810958922
7230,63725044392,47757,63725092149,3,0,1,1536,3,8355148288
7231,63725112433,48976,63725161409,4,0,1,2048,4,3914527107
7232,63725228284,78079,63725306363,8,0,1,10240,8,6520643439
7233,63725253746,60820,63725314566,7,0,1,5632,7,3158250625
7234,63725269784,58845,63725328629,9,0,1,1536,9,3951851617
7235,63725316114,45592,63725361706,6,0,1,1024,6,431130567
7236,63725363381,13249,63725376630,7,0,1,11776,7,10655556962
7237,63725372288,1990,63725374278,1,0,0,25600,1,10671387649
7238,63725377518,2942,63725380460,3,0,1,6144,3,10297198986
7239,63725405235,65131,63725470366,6,0,1,10752,6,7429712402
7240,63725426067,82867,63725508934,5,0,0,2048,5,9325408780
7241,63725431932,2942,63725434874,5,0,0,3072,5,4658250716
7242,63725462616,3383,63725465999,5,0,0,3072,5,3577474080
7243,63725516928,1038,63725517966,1,0,0,9728,1,10247163963
7244,63725527763,196312,63725724075,7,0,0,1024,7,10731124369
7245,63725546837,82220,63725629057,5,0,1,16896,5,1266685003
7246,63725595144,123652,63725718796,0,0,1,105984,0,3432117616
7247,63725631955,21137,63725653092,0,0,1,152064,0,7382420825
7248,63725777995,241341,63726019336,6,0,0,34304,6,237989915
7249,63725792539,104776,63725897315,5,0,1,44032,5,9940558970
7250,63725899540,3418,63725902958,5,0,0,3584,5,39824794
7251,63725926093,44400,63725970493,7,0,1,8192,7,3821672195
7252,63725928371,69280,63725997651,0,0,0,76288,0,677527299
7253,63725943659,14113,63725957772,9,0,1,8704,9,7991316095
7254,63726040224,121280,63726161504,2,0,0,24064,2,6830002531
7255,63726129061,52360,63726181421,5,0,1,3072,5,2422198201
7256,63726228369,69904,63726298273,4,0,1,10240,4,4726953306
7257,63726298407,36859,63726335266,2,0,0,65024,2,2127139705
7258,63726384268,76067,63726460335,2,0,0,128000,2,568907214
7259,63726384491,77470,63726461961,8,0,0,2560,8,2829008483
7260,63726410502,58077,63726468579,8,0,0,31744,8,3400512151
7261,63726440093,29472,63726469565,0,0,0,1536,0,2598265549
7262,63726500242,65866,63726566108,2,0,1,5632,2,4572381911
7263,63726578349,2466,63726580815,2,0,0,2560,2,3129322040
7264,63726614589,1514,63726616103,5,0,0,1536,5,2597105813
7265,63726749235,20878,63726770113,8,0,0,33792,8,4720466059
7266,63726876409,1038,63726877447,3,0,0,1024,3,1565397033
7267,63726907691,5708,63726913399,6,0,0,14336,6,818595898
7268,63726933446,54832,63726988278,7,0,1,6144,7,2146387576
7269,63726952541,174304,63727126845,6,0,0,282624,6,297770589
7270,63726990426,90471,63727080897,7,0,1,20992,7,7609392652
7271,63727047680,5798,63727053478,1,0,1,89600,1,8336085841
7272,63727062295,1038,63727063333,2,0,0,82944,2,2705518791
7273,63727082132,213938,63727296070,9,0,1,6656,9,1293430152
7274,63727170815,316156,63727486971,4,0,1,36352,4,10354579025
7275,63727209330,7984,63727217314,6,0,0,6144,6,10487455341
7276,63727255505,14800,63727270305,4,0,0,1024,4,8694979731
7277,63727305074,330513,63727635587,2,0,0,15872,2,3811841589
7278,63727315013,307024,63727622037,6,0,0,28672,6,9294522188
7279,63727320241,193904,63727514145,6,0,1,8192,6,2996416364
7280,63727479047,45592,63727524639,8,0,1,1024,8,5945829294
7281,63727495345,148240,63727643585,0,0,1,130048,0,8946681789
7282,63727513377,132091,63727645468,7,0,1,6144,7,9926785847
7283,63727620246,111882,63727732128,5,0,1,14848,5,2971663868
7284,63728153301,48976,63728202277,3,0,1,2048,3,9740033404
7285,63728303812,6750,63728310562,5,0,1,6656,5,5565697243
7286,63728304988,59596,63728364584,0,0,0,7168,0,5762578440
7287,63728406709,1038,63728407747,3,0,0,1024,3,10473443640
7288,63728406739,15058,63728421797,4,0,1,7168,4,6002265518
7289,63728425301,66211,63728491512,2,0,0,29184,2,6783542054
7290,63728527067,1038,63728528105,8,0,1,13824,8,631639910
7291,63728559306,86356,63728645662,3,0,0,1024,3,5848136504
7292,63728571514,103372,63728674886,1,0,1,39424,1,5087778257
7293,63728581265,96596,63728677861,4,0,1,9728,4,4534209733
7294,63728635470,51978,63728687448,4,0,1,12800,4,8686862596
7295,63728637974,114932,63728752906,9,0,1,2048,9,7802701333
7296,63728952592,5322,63728957914,6,0,1,5632,6,1659148467
7297,63728965804,60820,63729026624,1,0,0,5632,1,5926696001
7298,63728983560,102912,63729086472,0,0,0,166912,0,6483208202
7299,63729016670,101368,63729118038,1,0,0,101888,1,10584065913
7300,63729046165,136261,63729182426,5,0,1,2048,5,6863703594
7301,63729049579,50668,63729100247,9,0,1,4096,9,2536336388
7302,63729141751,261461,63729403212,2,0,1,7680,2,1934526730
7303,63729168292,213731,63729382023,5,0,1,2560,5,9396012239
7304,63729395152,7226,63729402378,2,0,0,7680,2,10187831058
7305,63729425258,13508,63729438766,8,0,0,26112,8,2107010280
7306,63729459926,1038,63729460964,0,0,1,81920,0,2970440178
7307,63729473647,132985,63729606632,7,0,1,16384,7,5690848144
7308,63729483204,124267,63729607471,7,0,1,6144,7,3525757454
7309,63729493048,125361,63729618409,7,0,0,1024,7,9493553698
7310,63729508435,148234,63729656669,8,0,0,245248,8,2414931816
7311,63729667392,1514,63729668906,9,0,1,24064,9,9592773347
7312,63729743418,22687,63729766105,8,0,0,1536,8,2111997473
7313,63729830109,34791,63729864900,2,0,0,37376,2,9241028679
7314,63729843736,224587,63730068323,6,0,0,60928,6,7447928460
7315,63729905464,1038,63729906502,7,0,0,1024,7,1412258356
7316,63729931095,2466,63729933561,3,0,0,2560,3,5367855933
7317,63730002266,63962,63730066228,2,0,0,104448,2,7254217283
7318,63730034284,5322,63730039606,1,0,1,143360,1,78874285
7319,63730047186,1038,63730048224,8,0,1,3584,8,1064627759
7320,63730111981,113859,63730225840,5,0,0,5632,5,5783515390
7321,63730146875,66332,63730213207,7,0,0,1024,7,9984929369
7322,63730169417,97288,63730266705,9,0,1,5632,9,4407940875
7323,63730184577,312357,63730496934,5,0,1,19456,5,4174804572
7324,63730295639,67958,63730363597,6,0,1,10240,6,10349978257
7325,63730332013,115416,63730447429,8,0,1,20992,8,7655386701
7326,63730515497,20878,63730536375,8,0,0,33792,8,5448956843
7327,63730548960,86668,63730635628,9,0,1,14848,9,1804697469
7328,63730624055,88048,63730712103,7,0,1,14336,7,3772021348
7329,63730686680,40870,63730727550,1,0,0,66048,1,10448704319
7330,63730725674,65452,63730791126,9,0,1,4608,9,3040497505
7331,63730767675,562,63730768237,6,0,1,10752,6,1493617971
7332,63730836949,188087,63731025036,3,0,0,512,3,6547080550
7333,63730903856,48976,63730952832,1,0,1,2048,1,6362956298
7334,63730955508,196204,63731151712,0,0,1,182784,0,5327350948
7335,63731081500,70847,63731152347,9,0,1,2048,9,6410052930
7336,63731083501,70737,63731154238,4,0,1,6144,4,1989956593
7337,63731138879,21592,63731160471,1,0,0,6656,1,2575327857
7338,63731221923,4370,63731226293,6,0,1,8192,6,8298721940
7339,63731237162,67518,63731304680,4,0,0,4608,4,9377613991
7340,63731325692,103060,63731428752,3,0,1,38400,3,10574060798
7341,63731429862,1990,63731431852,8,0,0,2048,8,766979101
7342,63731515305,95800,63731611105,4,0,0,159744,4,2930968846
7343,63731538336,122446,63731660782,7,0,1,1536,7,4682215524
7344,63731585998,5322,63731591320,1,0,1,28672,1,2514452134
7345,63731595666,23633,63731619299,1,0,1,50176,1,1459332248
7346,63731670762,147906,63731818668,2,0,0,5632,2,10082260929
7347,63731701217,231509,63731932726,8,0,0,42496,8,10697698938
7348,63731760069,68053,63731828122,7,0,1,3072,7,3627414774
7349,63731855692,97264,63731952956,6,0,1,39424,6,4294502011
7350,63731877732,181562,63732059294,0,0,1,182272,0,6962763952
7351,63731887278,237180,63732124458,0,0,1,100864,0,4656353396
7352,63731915900,258385,63732174285,5,0,1,4608,5,199890256
7353,63732026537,30677,63732057214,0,0,1,478720,0,7371335146
7354,63732089498,61178,63732150676,4,0,1,29696,4,10602112168
7355,63732120317,562,63732120879,5,0,0,5632,5,9653843710
7356,63732143319,466615,63732609934,4,0,0,97792,4,8701354291
7357,63732233653,412713,63732646366,4,0,1,33280,4,8259666248
7358,63732264048,278725,63732542773,7,0,0,512,7,882143978
7359,63732389492,142276,63732531768,7,0,1,9216,7,3617018452
7360,63732422332,223275,63732645607,6,0,1,10752,6,7379922290
7361,63732566961,217300,63732784261,2,0,0,356352,2,1981240816
7362,63732621482,163547,63732785029,4,0,0,11776,4,5358104351
7363,63732650982,135033,63732786015,7,0,0,1536,7,1690439203
7364,63732801044,5450,63732806494,4,0,1,7168,4,5116971807
7365,63732836829,562,63732837391,2,0,1,5632,2,9492154337
7366,63732869785,226161,63733095946,8,0,0,13824,8,9008778220
7367,63732908767,239383,63733148150,0,0,1,138752,0,472096875
7368,63732997270,227992,63733225262,5,0,0,512,5,3388404640
7369,63733066889,70973,63733137862,3,0,1,3584,3,9407651027
7370,63733173453,21912,63733195365,0,0,0,35840,0,5433111921
7371,63733182302,1038,63733183340,3,0,1,40960,3,8930934739
7372,63733197052,128752,63733325804,6,0,1,23552,6,6036945863
7373,63733206894,144575,63733351469,3,0,0,1024,3,2227867467
7374,63733316131,67868,63733383999,9,0,1,4096,9,1183834460
7375,63733343853,107428,63733451281,0,0,1,52736,0,10713398717
7376,63733374020,113501,63733487521,9,0,1,3072,9,4806380464
7377,63733436702,67087,63733503789,7,0,1,3584,7,24578810
7378,63733488114,77896,63733566010,7,0,1,11264,7,8034472315
7379,63733509975,57138,63733567113,9,0,1,3584,9,706234361
7380,63733527454,43196,63733570650,2,0,0,70656,2,2513854667
7381,63733607729,5192,63733612921,6,0,0,13312,6,4114470265
7382,63733828821,43900,63733872721,7,0,1,512,7,10403598198
7383,63733865773,22687,63733888460,1,0,1,46592,1,4871338275
7384,63733868529,4933,63733873462,2,0,0,37376,2,8220672554
7385,63733927622,148911,63734076533,6,0,1,10240,6,6063383361
7386,63733946767,127016,63734073783,4,0,0,12800,4,719696303
7387,63734013058,1038,63734014096,3,0,1,14848,3,7158555752
7388,63734027446,80606,63734108052,2,0,1,18432,2,541264361
7389,63734067683,83152,63734150835,3,0,0,1024,3,7041467573
7390,63734105909,89023,63734194932,3,0,1,30208,3,7688356376
7391,63734108416,105245,63734213661,6,0,1,15360,6,7989402818
7392,63734260167,211024,63734471191,1,0,1,231424,1,2545731364
7393,63734350128,121074,63734471202,2,0,0,96768,2,7698384535
7394,63734481275,45175,63734526450,8,0,0,77824,8,6262416216
7395,63734507941,562,63734508503,0,0,1,120832,0,7371943734
7396,63734583295,274743,63734858038,7,0,0,512,7,8678543297
7397,63734726910,55793,63734782703,2,0,0,67072,2,7910639414
7398,63734759697,43366,63734803063,6,0,1,512,6,5875624609
7399,63734789894,64441,63734854335,4,0,0,74240,4,2443526212
7400,63734793759,87773,63734881532,6,0,1,2048,6,7846953944
7401,63734798039,103953,63734901992,3,0,1,8704,3,7890818488
7402,63734812313,1514,63734813827,6,0,0,108032,6,140996796
7403,63734825580,26475,63734852055,1,0,1,313856,1,9110613394
7404,63734851674,53321,63734904995,6,0,1,2560,6,8485806765
7405,63734877710,8549,63734886259,3,0,1,2560,3,10532589804
7406,63734905084,330423,63735235507,5,0,0,1536,5,9576839942
7407,63734966432,2466,63734968898,1,0,0,48128,1,9971411608
7408,63735011124,231174,63735242298,2,0,1,12800,2,8171955681
7409,63735020214,267060,63735287274,8,0,0,87040,8,6287508432
7410,63735023084,406977,63735430061,1,0,1,100864,1,8719025003
7411,63735037106,225344,63735262450,1,0,1,309760,1,4458601226
7412,63735065332,79420,63735144752,3,0,0,512,3,4250122683
7413,63735101922,316786,63735418708,7,0,0,2560,7,9289885192
7414,63735157619,150723,63735308342,3,0,0,512,3,4292717519
7415,63735190094,138407,63735328501,6,0,1,3072,6,5641539884
7416,63735270500,485026,63735755526,9,0,1,13824,9,5069543016
7417,63735437839,46298,63735484137,4,0,1,20992,4,2220395154
7418,63735479234,175897,63735655131,2,0,0,9728,2,10184472168
7419,63735603628,10042,63735613670,6,0,1,51712,6,4731962465
7420,63735603705,107116,63735710821,8,0,0,11264,8,6560586865
7421,63735606216,146191,63735752407,8,0,0,236032,8,9204861897
7422,63735686493,116307,63735802800,9,0,1,26112,9,4942612431
7423,63735697742,2866,63735700608,4,0,1,4608,4,1462242583
7424,63735846518,190959,63736037477,6,0,0,8704,6,10343287919
7425,63735884966,14025,63735898991,6,0,0,27136,6,9199927069
7426,63735964053,35050,63735999103,6,0,0,61440,6,10348156761
7427,63736013417,44056,63736057473,4,0,1,1024,4,478648447
7428,63736123750,59128,63736182878,6,0,1,18944,6,2203814856
7429,63736210839,156776,63736367615,3,0,1,5120,3,5550288401
7430,63736216640,99628,63736316268,3,0,1,27136,3,10563559536
7431,63736257236,60135,63736317371,3,0,1,3584,3,7626443092
7432,63736346653,46725,63736393378,6,0,0,80896,6,8164392140
7433,63736362377,4370,63736366747,0,0,1,64000,0,9127890575
7434,63736408654,158914,63736567568,3,0,0,4608,3,2732443404
7435,63736467926,95856,63736563782,1,0,1,15872,1,244763060
7436,63736649009,2866,63736651875,1,0,0,8704,1,3636554016
7437,63736686584,24150,63736710734,2,0,0,43520,2,7197464919
7438,63736839006,61973,63736900979,6,0,1,4096,6,2005897814
7439,63736899740,43900,63736943640,3,0,1,3584,3,3625821267
7440,63736939456,113530,63737052986,4,0,1,512,4,7189627225
7441,63736940662,166302,63737106964,0,0,1,71680,0,3048282657
7442,63736962951,562,63736963513,2,0,1,4608,2,3400334945
7443,63737043875,106475,63737150350,0,0,1,49664,0,6168744064
7444,63737066273,2942,63737069215,7,0,0,512,7,4872976059
7445,63737071180,2942,63737074122,7,0,0,3072,7,5836906195
7446,63737099954,4370,63737104324,5,0,0,3072,5,10191264120
7447,63737110902,5322,63737116224,6,0,0,4608,6,6334020366
7448,63737126055,124008,63737250063,7,0,0,5632,7,5220296596
7449,63737160828,67867,63737228695,5,0,1,5632,5,10612470511
7450,63737162069,2942,63737165011,6,0,1,4096,6,4164446946
7451,63737247285,122974,63737370259,5,0,0,3072,5,2008477636
7452,63737345111,1990,63737347101,7,0,0,2048,7,729947482
7453,63737370216,2466,63737372682,5,0,0,2560,5,2910269844
7454,63737403866,1514,63737405380,2,0,1,9728,2,4090037993
7455,63737466967,74356,63737541323,3,0,0,1536,3,9250504974
7456,63737476670,86708,63737563378,0,0,1,94208,0,865943064
7457,63737482164,121608,63737603772,6,0,0,145408,6,9695608584
7458,63737617467,562,63737618029,1,0,1,86528,1,2115480362
7459,63737650818,32983,63737683801,7,0,0,512,7,9102633621
7460,63737675014,119292,63737794306,2,0,0,57344,2,586128197
7461,63737722089,90359,63737812448,5,0,1,512,5,10332610981
7462,63737758277,73288,63737831565,5,0,1,11264,5,3822334523
7463,63737779967,104937,63737884904,6,0,1,9216,6,4926812234
7464,63737804072,25442,63737829514,7,0,1,14336,7,3784954984
7465,63737850429,124534,63737974963,2,0,1,24576,2,154613670
7466,63737876034,89632,63737965666,6,0,0,46080,6,5155706778
7467,63737933550,12470,63737946020,2,0,0,14848,2,3219448017
7468,63737957219,140725,63738097944,3,0,1,512,3,1773118936
7469,63738126539,4370,63738130909,1,0,1,169472,1,6283272726
7470,63738225618,192148,63738417766,5,0,1,10752,5,5687964584
7471,63738242907,73087,63738315994,3,0,1,5632,3,929676347
7472,63738243031,106725,63738349756,2,0,0,4608,2,6444534833
7473,63738245611,127301,63738372912,6,0,0,50176,6,6229950434
7474,63738330826,49444,63738380270,5,0,1,3584,5,2523720475
7475,63738422150,562,63738422712,7,0,1,5120,7,9632437041
7476,63738427317,69501,63738496818,7,0,0,512,7,10047078854
7477,63738469143,15317,63738484460,2,0,1,16896,2,839536228
7478,63738491800,90364,63738582164,6,0,0,29696,6,7690105549
7479,63738566590,44141,63738610731,0,0,0,75776,0,8753179987
7480,63738611403,40870,63738652273,8,0,0,66048,8,2226431719
7481,63738703791,96931,63738800722,6,0,1,5632,6,2374738540
7482,63738712796,32554,63738745350,7,0,1,13824,7,6373636098
7483,63738768324,130016,63738898340,2,0,0,53248,2,7163836586
7484,63738897046,15575,63738912621,9,0,1,2560,9,6187418942
7485,63738984843,143561,63739128404,4,0,0,30208,4,1316825181
7486,63739012849,11270,63739024119,0,0,1,26112,0,1335348884
7487,63739036279,10495,63739046774,1,0,1,201728,1,7015057694
7488,63739063285,99316,63739162601,0,0,1,73728,0,7273762372
7489,63739071503,1514,63739073017,0,0,0,18432,0,1801071255
7490,63739082355,36859,63739119214,1,0,0,16896,1,9806980026
7491,63739129031,154663,63739283694,3,0,0,1536,3,5978155519
7492,63739131618,12045,63739143663,6,0,0,65024,6,7263392328
7493,63739253093,6484,63739259577,1,0,0,19968,1,8400322088
7494,63739321926,417496,63739739422,0,0,0,15872,0,10471986161
7495,63739404818,52268,63739457086,1,0,1,5632,1,2805528945
7496,63739419828,88640,63739508468,0,0,1,5632,0,193025721
7497,63739446037,109769,63739555806,1,0,0,73216,1,2447546151
7498,63739525723,5192,63739530915,8,0,0,13312,8,2279989357
7499,63739562729,218999,63739781728,5,0,1,14848,5,3200836430
7500,63739607098,209808,63739816906,2,0,1,8192,2,6038269289
7501,63739680000,182620,63739862620,1,0,0,295424,1,3385864213
7502,63739765254,160756,63739926010,6,0,1,13312,6,8467895318
7503,63739975965,74087,63740050052,8,0,0,120832,8,3694503341
7504,63739986903,103286,63740090189,6,0,0,130560,6,630366394
7505,63740019316,71744,63740091060,2,0,0,12288,2,3959049082
7506,63740061984,117083,63740179067,9,0,1,13312,9,8486057128
7507,63740082965,66132,63740149097,2,0,0,194560,2,7100763371
7508,63740104970,54932,63740159902,5,0,1,18432,5,181185697
7509,63740136182,281604,63740417786,2,0,0,3584,2,7468923154
7510,63740169194,395906,63740565100,4,0,0,79872,4,9400497497
7511,63740356330,134770,63740491100,4,0,1,45568,4,6339992390
7512,63740574477,51253,63740625730,1,0,0,82944,1,10155998915
7513,63740763171,43712,63740806883,2,0,0,71680,2,8312358069
7514,63740899948,562,63740900510,3,0,0,512,3,656922034
7515,63740974434,26217,63741000651,0,0,0,47616,0,7740275701
7516,63740987180,1038,63740988218,4,0,1,4096,4,3126262754
7517,63741011320,60820,63741072140,3,0,1,5632,3,1100218067
7518,63741012581,92009,63741104590,2,0,1,5120,2,1672144869
7519,63741014510,60316,63741074826,3,0,0,1024,3,10148801474
7520,63741066549,189960,63741256509,4,0,1,2048,4,552545652
7521,63741199973,105400,63741305373,9,0,1,46080,9,8443617806
7522,63741270181,562,63741270743,0,0,1,109056,0,4500984800
7523,63741298957,124588,63741423545,0,0,1,195072,0,6839381078
7524,63741303912,159646,63741463558,2,0,1,9728,2,121952948
7525,63741315217,1514,63741316731,5,0,1,17920,5,5246705203
7526,63741342542,260944,63741603486,7,0,0,512,7,4968108316
7527,63741494481,258964,63741753445,7,0,0,1536,7,7898487691
7528,63741536520,70248,63741606768,9,0,1,512,9,1068519989
7529,63741584930,562,63741585492,0,0,1,34816,0,7978714734
7530,63741614276,101968,63741716244,5,0,0,512,5,9817351004
7531,63741702565,2466,63741705031,3,0,0,2560,3,2615043771
7532,63741707814,156033,63741863847,4,0,0,257024,4,10146214301
7533,63741715998,211033,63741927031,1,0,0,212480,1,3665323784
7534,63741740249,175357,63741915606,0,0,1,59904,0,3221277841
7535,63741752340,256059,63742008399,3,0,0,1024,3,5812026281
7536,63741787811,230859,63742018670,2,0,1,6144,2,8867233901
7537,63741800656,236002,63742036658,4,0,1,9728,4,8046794725
7538,63741801470,268921,63742070391,0,0,1,83968,0,5126436091
7539,63741830079,87033,63741917112,0,0,1,41472,0,10042923931
7540,63741983369,2466,63741985835,8,0,0,96256,8,8246544254
7541,63742067854,383184,63742451038,7,0,1,15872,7,8469748553
7542,63742160801,191548,63742352349,7,0,0,2560,7,6462976846
7543,63742266184,196104,63742462288,1,0,0,318464,1,9117031032
7544,63742350962,113272,63742464234,7,0,0,3072,7,10257345930
7545,63742530863,23462,63742554325,9,0,1,16384,9,4489910450
7546,63742557123,1038,63742558161,1,0,0,38912,1,842080105
7547,63742585046,3124,63742588170,0,0,1,396800,0,9782550419
7548,63742701102,341626,63743042728,5,0,0,1024,5,182697156
7549,63742749949,400812,63743150761,8,0,0,9216,8,5765616692
7550,63742757995,173699,63742931694,0,0,0,116736,0,1253086215
7551,63742774520,157185,63742931705,7,0,0,3072,7,1586616201
7552,63742827246,14852,63742842098,9,0,1,4096,9,266318240
7553,63742917894,160165,63743078059,7,0,0,1024,7,7209899800
7554,63743020021,562,63743020583,7,0,0,512,7,3860899240
7555,63743159452,20362,63743179814,4,0,0,32768,4,8394409895
7556,63743240758,1038,63743241796,3,0,0,1024,3,7529752162
7557,63743250191,1514,63743251705,3,0,0,1536,3,5709477641
7558,63743268383,13337,63743281720,0,0,0,22528,0,6681387146
7559,63743392003,2466,63743394469,6,0,1,6144,6,4641892004
7560,63743428085,62512,63743490597,7,0,0,2560,7,9619204226
7561,63743529230,34275,63743563505,4,0,1,24576,4,3233913604
7562,63743547614,91168,63743638782,0,0,0,59904,0,4577734698
7563,63743698566,43900,63743742466,4,0,1,512,4,776543384
7564,63743725336,47284,63743772620,5,0,1,1536,5,2507802027
7565,63743749178,267925,63744017103,0,0,0,438272,0,9783767335
7566,63743771593,287445,63744059038,8,0,0,143360,8,3174871551
7567,63743784559,296169,63744080728,5,0,1,19968,5,6087256088
7568,63743897888,186969,63744084857,8,0,0,82432,8,10496428597
7569,63743918411,14636,63743933047,0,0,1,283136,0,4268062134
7570,63743945480,42937,63743988417,0,0,1,140288,0,297926059
7571,63744071847,3894,63744075741,5,0,0,2560,5,6504781379
7572,63744105930,372961,63744478891,4,0,0,70144,4,5607500117
7573,63744139977,508408,63744648385,4,0,1,24576,4,1081259579
7574,63744174619,294349,63744468968,8,0,0,4096,8,1971153145
7575,63744341165,74793,63744415958,6,0,1,512,6,3778589931
7576,63744372533,75216,63744447749,2,0,0,25088,2,9385865102
7577,63744411163,192096,63744603259,2,0,0,76288,2,751927110
7578,63744485059,74087,63744559146,7,0,1,16384,7,5322429848
7579,63744558092,15065,63744573157,0,0,0,120832,0,2871633332
7580,63744617575,33758,63744651333,0,0,0,10240,0,213587349
7581,63744685283,1514,63744686797,3,0,1,3072,3,582092822
7582,63744713698,90111,63744803809,0,0,1,307200,0,10514049341
7583,63744724385,4158,63744728543,0,0,0,58880,0,4347905740
7584,63744742764,395656,63745138420,0,0,1,108032,0,431026747
7585,63744771802,325087,63745096889,3,0,0,1536,3,8344096807
7586,63744840537,328964,63745169501,1,0,0,11264,1,578938604
7587,63744966760,96716,63745063476,6,0,1,4608,6,6857808697
7588,63744982197,56099,63745038296,4,0,0,7680,4,1777194183
7589,63745041594,148001,63745189595,4,0,0,42496,4,10553395284
7590,63745074532,68108,63745142640,1,0,0,94720,1,4884241541
7591,63745082604,13337,63745095941,4,0,1,2048,4,8433912687
7592,63745134578,140347,63745274925,2,0,1,5120,2,922433656
7593,63745143466,179853,63745323319,7,0,1,1536,7,1576369035
7594,63745178317,237035,63745415352,2,0,0,22528,2,9871275151
7595,63745199202,43712,63745242914,4,0,1,17920,4,4591016190
7596,63745284897,205506,63745490403,4,0,0,71680,4,7351304702
7597,63745437149,63448,63745500597,2,0,1,9216,2,3279681337
7598,63745469771,96556,63745566327,5,0,1,27136,5,8783341758
7599,63745641272,2466,63745643738,0,0,1,3584,0,3046520266
7600,63745669650,54052,63745723702,5,0,0,2560,5,5969903777
7601,63745740504,2466,63745742970,2,0,1,8192,2,7840123240
7602,63745758238,69280,63745827518,7,0,0,2560,7,4978437240
7603,63745853034,10753,63745863787,6,0,0,17408,6,523160232
7604,63745863335,3894,63745867229,0,0,1,336896,0,7978665554
7605,63745901798,1990,63745903788,2,0,0,4096,2,1676299767
7606,63745933005,34533,63745967538,0,0,1,307200,0,4868657456
7607,63745937429,324548,63746261977,7,0,0,2048,7,9859947980
7608,63745983708,153803,63746137511,4,0,0,60416,4,9130100390
7609,63746005504,185841,63746191345,7,0,1,2048,7,3814043329
7610,63746036907,106849,63746143756,5,0,1,9216,5,7279190869
7611,63746084507,107438,63746191945,8,0,0,132096,8,6995697627
7612,63746094139,12821,63746106960,2,0,0,16384,2,7553099258
7613,63746173047,469595,63746642642,6,0,1,9728,6,10338557015
7614,63746269930,98149,63746368079,0,0,0,21504,0,3214671533
7615,63746293901,232547,63746526448,4,0,1,13312,4,10426287457
7616,63746304470,151954,63746456424,2,0,0,46592,2,3837296196
7617,63746305366,154662,63746460028,3,0,1,4608,3,3873397478
7618,63746443566,169958,63746613524,0,0,1,118272,0,4177686704
7619,63746497974,115561,63746613535,6,0,0,137216,6,4421677368
7620,63746528385,85161,63746613546,5,0,0,3072,5,4229783701
7621,63746556153,57404,63746613557,7,0,0,1536,7,8075729132
7622,63746609661,5402,63746615063,7,0,0,1536,7,6547217711
7623,63746641802,65425,63746707227,0,0,0,110592,0,7383694518
7624,63746689028,28619,63746717647,4,0,0,33280,4,10030092029
7625,63746821516,195241,63747016757,1,0,0,320000,1,510632716
7626,63746824093,219405,63747043498,1,0,0,87040,1,186994434
7627,63746865147,276339,63747141486,4,0,0,313344,4,6525191846
7628,63746909927,202763,63747112690,0,0,1,204288,0,2753233290
7629,63746944522,90923,63747035445,1,0,0,27648,1,8266274316
7630,63747061188,562,63747061750,1,0,0,7680,1,3429313134
7631,63747109420,497442,63747606862,6,0,1,18944,6,2743001566
7632,63747160623,303732,63747464355,4,0,1,4096,4,6084850755
7633,63747239611,67920,63747307531,3,0,0,512,3,9570129254
7634,63747369391,290262,63747659653,4,0,0,43520,4,2291506414
7635,63747412443,44723,63747457166,6,0,0,49664,6,297018636
7636,63747424476,8111,63747432587,6,0,1,14848,6,9383098990
7637,63747449401,93325,63747542726,8,0,0,512,8,9613104026
7638,63747494519,48976,63747543495,2,0,1,2048,2,1129296270
7639,63747522356,2466,63747524822,6,0,1,8704,6,281301911
7640,63747588989,87790,63747676779,5,0,0,2560,5,5116743935
7641,63747633306,41904,63747675210,0,0,0,68096,0,10315702357
7642,63747661087,62670,63747723757,2,0,0,101888,2,1013559407
7643,63747714350,14592,63747728942,6,0,0,16384,6,8213929549
7644,63747762751,1514,63747764265,5,0,0,1536,5,8080858370
7645,63747968779,54052,63748022831,2,0,1,3584,2,994954808
7646,63748028183,115533,63748143716,6,0,0,191488,6,9701497167
7647,63748067106,77916,63748145022,7,0,0,2048,7,6367368292
7648,63748087899,63844,63748151743,2,0,0,24064,2,9565145441
7649,63748109560,52603,63748162163,0,0,0,41472,0,179073107
7650,63748121909,55300,63748177209,6,0,1,16384,6,5265163255
7651,63748166634,55608,63748222242,6,0,0,94208,6,5862006869
7652,63748166672,47284,63748213956,7,0,0,512,7,7821765757
7653,63748246197,199739,63748445936,7,0,1,1536,7,7033217986
7654,63748247838,264183,63748512021,0,0,1,125440,0,4670424706
7655,63748335242,389818,63748725060,0,0,1,225792,0,5293134321
7656,63748603652,114364,63748718016,6,0,1,14336,6,5179736536
7657,63748633977,36342,63748670319,0,0,1,192512,0,3000143846
7658,63748723134,246189,63748969323,4,0,0,64000,4,8335377823
7659,63748744108,137629,63748881737,1,0,1,5120,1,9899438932
7660,63748934843,35567,63748970410,2,0,1,24576,2,10292058246
7661,63748947153,2942,63748950095,0,0,0,62464,0,8449728994
7662,63748962621,91168,63749053789,3,0,1,4096,3,7379151781
7663,63748993755,89748,63749083503,3,0,0,3072,3,9023001918
7664,63749057997,2466,63749060463,6,0,1,17408,6,2071631929
7665,63749063252,2942,63749066194,3,0,0,2560,3,195171223
7666,63749202583,170075,63749372658,7,0,0,3072,7,4567969308
7667,63749284846,562,63749285408,2,0,1,41472,2,3369223095
7668,63749333722,103996,63749437718,8,0,0,512,8,5335503183
7669,63749334609,84212,63749418821,1,0,0,137216,1,8774691123
7670,63749415977,44229,63749460206,2,0,0,72704,2,3710599248
7671,63749426925,56853,63749483778,3,0,1,1024,3,5585424126
7672,63749430940,2466,63749433406,3,0,1,10752,3,9171736850
7673,63749547890,123676,63749671566,7,0,0,2560,7,1531024544
7674,63749549203,183137,63749732340,4,0,0,296448,4,7146999631
7675,63749604209,198556,63749802765,6,0,1,6656,6,10059892766
7676,63749609648,209701,63749819349,4,0,1,5632,4,6744090418
7677,63749818858,1045,63749819903,7,0,0,512,7,464949509
7678,63749842732,21137,63749863869,2,0,0,34304,2,8312661225
7679,63749959041,1514,63749960555,8,0,0,1536,8,2532209499
7680,63750169741,4846,63750174587,6,0,0,5120,6,7799251114
7681,63750179243,162887,63750342130,0,0,0,263680,0,3265703467
7682,63750365302,1514,63750366816,5,0,0,1536,5,7548286941
7683,63750467025,562,63750467587,7,0,0,512,7,10099050463
7684,63750544646,11012,63750555658,4,0,0,17920,4,5435856916
7685,63750641771,24666,63750666437,0,0,0,44544,0,3107924289
7686,63750643260,35903,63750679163,1,0,0,39424,1,9257280956
7687,63750645635,34514,63750680149,7,0,0,1536,7,8567510098
7688,63750647515,32788,63750680303,7,0,0,8704,7,5312107665
7689,63750818355,1038,63750819393,2,0,1,36864,2,1707819751
7690,63750837191,102592,63750939783,5,0,0,1024,5,4177528365
7691,63751045474,144704,63751190178,6,0,0,235008,6,3598042323
7692,63751086192,166453,63751252645,1,0,0,208896,1,8710613961
7693,63751189919,104251,63751294170,0,0,0,133120,0,9486033493
7694,63751328847,1038,63751329885,1,0,0,1024,1,6586358261
7695,63751419708,112176,63751531884,3,0,1,4096,3,9551530258
7696,63751431338,124196,63751555534,0,0,1,46592,0,6593611907
7697,63751436226,83804,63751520030,6,0,0,201728,6,8190661943
7698,63751477284,64335,63751541619,5,0,0,1024,5,1777029171
7699,63751501259,10643,63751511902,3,0,0,7168,3,6301315350
7700,63751555617,183247,63751738864,7,0,0,1024,7,7787918753
7701,63751623589,45592,63751669181,5,0,1,1024,5,5026565601
7702,63751795921,45904,63751841825,0,0,1,26624,0,8643913311
7703,63751806625,94864,63751901489,4,0,1,2048,4,868422654
7704,63751840661,64133,63751904794,0,0,0,108032,0,6501462180
7705,63751906451,35825,63751942276,0,0,0,62976,0,1689899526
7706,63751909012,103076,63752012088,1,0,1,11264,1,7000377199
7707,63752008591,562,63752009153,3,0,1,7680,3,8042261606
7708,63752042465,122392,63752164857,0,0,1,163840,0,3523137044
7709,63752044191,142448,63752186639,4,0,0,512,4,10614822277
7710,63752106510,276376,63752382886,5,0,1,20992,5,283440491
7711,63752202648,119012,63752321660,4,0,1,9216,4,9866839647
7712,63752232560,89275,63752321835,5,0,1,512,5,2176991175
7713,63752295410,26971,63752322381,8,0,0,512,8,9932923763
7714,63752299110,23617,63752322727,5,0,0,512,5,9936266436
7715,63752325335,44137,63752369472,3,0,1,512,3,6773616411
7716,63752434245,54676,63752488921,5,0,1,5632,5,6632494457
7717,63752648718,1514,63752650232,8,0,0,1536,8,751029537
7718,63752691257,54783,63752746040,6,0,0,93184,6,1172556156
7719,63752722741,26205,63752748946,2,0,0,4608,2,4008928621
7720,63752811713,562,63752812275,7,0,0,512,7,7341826009
7721,63752967168,76583,63753043751,2,0,0,129024,2,8233914327
7722,63753025843,562,63753026405,0,0,1,158720,0,5679236386
7723,63753048107,1038,63753049145,4,0,0,512,4,3261290778
7724,63753199432,269878,63753469310,8,0,0,1024,8,4425441178
7725,63753278143,64854,63753342997,6,0,1,1536,6,6956017488
7726,63753355080,1038,63753356118,7,0,0,1024,7,3706932277
7727,63753382333,1038,63753383371,4,0,0,1024,4,2821219094
7728,63753612651,1514,63753614165,0,0,1,8704,0,8896117672
7729,63753621224,70972,63753692196,3,0,0,1536,3,6371777319
7730,63753648186,129703,63753777889,0,0,1,90112,0,5622486803
7731,63753690499,87409,63753777908,0,0,0,138240,0,2574979575
7732,63753742317,1038,63753743355,4,0,1,7168,4,2440794499
7733,63753764515,107255,63753871770,3,0,1,4608,3,3730511790
7734,63753844491,96907,63753941398,5,0,0,1024,5,271999489
7735,63754124865,102137,63754227002,0,0,0,165376,0,5784400947
7736,63754127126,162763,63754289889,6,0,0,186368,6,6392348238
7737,63754328648,562,63754329210,5,0,1,512,5,4191175001
7738,63754379418,562,63754379980,4,0,0,512,4,7366079256
7739,63754379670,2959,63754382629,0,0,1,153600,0,5508909895
7740,63754392623,1038,63754393661,3,0,0,512,3,9022943891
7741,63754418491,201160,63754619651,4,0,0,3072,4,6070275013
7742,63754418493,203794,63754622287,7,0,1,1024,7,7524488980
7743,63754465188,165294,63754630482,4,0,0,1024,4,476122865
7744,63754505665,78289,63754583954,7,0,1,512,7,4544474295
7745,63754530344,74337,63754604681,3,0,1,2560,3,9366650493
7746,63754637657,79300,63754716957,5,0,1,15872,5,6927030120
7747,63754659843,117300,63754777143,4,0,1,35840,4,1136439842
7748,63754673169,59128,63754732297,7,0,1,23552,7,3233230858
7749,63754723693,135558,63754859251,6,0,1,5120,6,7954352583
7750,63754740905,3418,63754744323,0,0,1,8704,0,8249864694
7751,63754830346,4522,63754834868,5,0,1,1536,5,1645879700
7752,63754833978,122350,63754956328,4,0,0,3584,4,4951096265
7753,63754834820,47284,63754882104,5,0,0,3072,5,254174104
7754,63754893234,104116,63754997350,1,0,0,172544,1,3271231666
7755,63754899435,41855,63754941290,0,0,1,205312,0,5916614054
7756,63754955841,9836,63754965677,3,0,0,512,3,8318985900
7757,63754989166,368783,63755357949,7,0,0,2048,7,6347158797
7758,63755206726,62046,63755268772,5,0,0,512,5,8268388713
7759,63755295276,3641,63755298917,0,0,0,10240,0,8477964060
7760,63755570121,92704,63755662825,0,0,1,24576,0,9164128520
7761,63755841226,5967,63755847193,3,0,1,39936,3,5960570454
7762,63755857781,103528,63755961309,0,0,0,14848,0,1646205361
7763,63755876324,86724,63755963048,5,0,1,3072,5,2814913161
7764,63755883733,63704,63755947437,3,0,1,11776,3,4218549968
7765,63755906739,1990,63755908729,0,0,0,103936,0,7114237058
7766,63755978799,101102,63756079901,3,0,0,2048,3,1759475537
7767,63756042920,1038,63756043958,5,0,1,14336,5,6023965273
7768,63756135374,163548,63756298922,6,0,0,1024,6,9115493103
7769,63756147462,66200,63756213662,6,0,0,112128,6,4827629265
7770,63756166714,58861,63756225575,4,0,1,512,4,3787532067
7771,63756208328,22946,63756231274,0,0,0,37888,0,3662682976
7772,63756224149,562,63756224711,7,0,1,512,7,4872251791
7773,63756288763,166053,63756454816,8,0,0,512,8,604288149
7774,63756316324,111852,63756428176,5,0,1,33280,5,2681945242
7775,63756327928,106834,63756434762,4,0,1,2048,4,8679014047
7776,63756344930,111368,63756456298,6,0,1,28672,6,8315534154
7777,63756422526,60376,63756482902,6,0,1,29696,6,6728965395
7778,63756430289,57109,63756487398,7,0,1,9216,7,7724261525
7779,63756435439,111968,63756547407,3,0,1,41984,3,9702680825
7780,63756436312,10495,63756446807,0,0,1,21504,0,10539653678
7781,63756445396,151951,63756597347,1,0,0,97792,1,10634920338
7782,63756522300,66037,63756588337,4,0,1,3072,4,5624181642
7783,63756552591,562,63756553153,2,0,0,16896,2,5386348768
7784,63756610759,185116,63756795875,0,0,1,311296,0,1894632704
7785,63756613418,1038,63756614456,7,0,0,512,7,1786244838
7786,63756625838,2942,63756628780,5,0,0,1024,5,10049745348
7787,63756692198,336554,63757028752,1,0,0,3072,1,10034171280
7788,63756794612,152720,63756947332,6,0,0,216064,6,22294035
7789,63756916692,36411,63756953103,2,0,0,6144,2,9908357931
7790,63757098042,43454,63757141496,2,0,0,71168,2,8615313149
7791,63757315002,59128,63757374130,5,0,1,5120,5,8896792113
7792,63757454795,4846,63757459641,4,0,1,11264,4,1751062602
7793,63757471816,79432,63757551248,6,0,0,5120,6,8234074815
7794,63757527470,3418,63757530888,7,0,1,35328,7,4798858090
7795,63757574689,102124,63757676813,1,0,0,3584,1,10152423790
7796,63757597722,105925,63757703647,2,0,0,176128,2,5029604380
7797,63757688441,15552,63757703993,7,0,0,512,7,7783104100
7798,63757708721,54988,63757763709,2,0,1,45568,2,1864651855
7799,63757729833,131583,63757861416,6,0,1,6656,6,4212852695
7800,63757923473,3124,63757926597,6,0,1,11264,6,7647696649
7801,63757927307,76360,63758003667,2,0,1,9216,2,1805547028
7802,63757931225,90334,63758021559,5,0,0,9216,5,2051665689
7803,63757963428,160647,63758124075,1,0,1,130560,1,129359479
7804,63757991910,133596,63758125506,5,0,1,4608,5,8172546744
7805,63758092464,79985,63758172449,6,0,0,81408,6,3232883673
7806,63758094543,98490,63758193033,6,0,0,65536,6,5485798875
7807,63758172680,135096,63758307776,2,0,0,219648,2,2368436441
7808,63758232488,56803,63758289291,1,0,1,11776,1,8150480135
7809,63758251639,27415,63758279054,7,0,0,1024,7,5446250628
7810,63758286724,94867,63758381591,6,0,0,18944,6,6311988184
7811,63758317747,1514,63758319261,3,0,1,4096,3,7537759143
7812,63758348497,55744,63758404241,7,0,0,1536,7,3509770409
7813,63758393464,210332,63758603796,2,0,1,7168,2,1439264373
7814,63758499613,145908,63758645521,2,0,0,240640,2,6139504964
7815,63758503658,142529,63758646187,4,0,0,1024,4,7515725768
7816,63758554708,92785,63758647493,3,0,0,2048,3,9572032773
7817,63758611613,36546,63758648159,8,0,0,1024,8,5627223705
7818,63758612405,77100,63758689505,0,0,0,130048,0,2166935109
7819,63758646890,42961,63758689851,7,0,0,512,7,8832272045
7820,63758664724,78879,63758743603,7,0,1,2048,7,4114176297
7821,63758668501,106706,63758775207,0,0,1,2560,0,6223276984
7822,63758784213,33499,63758817712,0,0,1,18944,0,5778821415
7823,63758829924,122401,63758952325,0,0,0,58368,0,3649025771
7824,63758928055,43454,63758971509,1,0,0,71168,1,5367742405
7825,63758958471,63220,63759021691,3,0,1,1536,3,10607665630
7826,63759011297,104866,63759116163,0,0,1,32256,0,9731473142
7827,63759173647,1038,63759174685,5,0,0,1024,5,7245518288
7828,63759308055,562,63759308617,5,0,0,512,5,9895666606
7829,63759323327,54052,63759377379,5,0,1,3584,5,5149708630
7830,63759338009,54676,63759392685,4,0,1,33280,4,5946344800
7831,63759398006,65111,63759463117,5,0,1,6656,5,6618475072
7832,63759406402,144171,63759550573,2,0,1,5632,2,8829758680
7833,63759607589,84508,63759692097,4,0,1,12800,4,6203307971
7834,63759678981,5710,63759684691,2,0,1,37376,2,7694071607
7835,63759689321,1038,63759690359,3,0,0,3072,3,4998728483
7836,63759732430,102748,63759835178,4,0,0,1024,4,6815112130
7837,63759831203,25442,63759856645,8,0,0,46080,8,1462417302
7838,63759880270,1038,63759881308,7,0,0,1024,7,1356493834
7839,63760026147,2942,63760029089,0,0,0,3072,0,6658699947
7840,63760032818,53140,63760085958,5,0,1,5632,5,6597174296
7841,63760043782,56333,63760100115,6,0,0,96256,6,9660062718
7842,63760093063,71762,63760164825,8,0,0,116224,8,2903562467
7843,63760132053,33950,63760166003,0,0,0,13824,0,2913200395
7844,63760235785,219667,63760455452,3,0,1,18944,3,2933109041
7845,63760432741,81148,63760513889,6,0,1,16896,6,1130076053
7846,63760485058,28842,63760513900,2,0,0,48640,2,4292408858
7847,63760487542,26369,63760513911,3,0,0,1024,3,9450451286
7848,63760542563,4370,63760546933,6,0,0,4608,6,7852509601
7849,63760557006,7702,63760564708,1,0,1,27136,1,3623255802
7850,63760576997,1514,63760578511,4,0,0,8192,4,7500576701
7851,63760585283,562,63760585845,5,0,0,1536,5,1687543395
7852,63760624683,114476,63760739159,7,0,0,512,7,10560757500
7853,63760640902,117859,63760758761,6,0,0,196096,6,9025816568
7854,63760696812,93618,63760790430,6,0,0,110592,6,9010590667
7855,63760696994,94742,63760791736,7,0,0,2048,7,7324021128
7856,63760854967,22946,63760877913,1,0,0,37888,1,4767309666
7857,63760857507,119002,63760976509,3,0,1,5120,3,224282259
7858,63760889791,152857,63761042648,7,0,1,6656,7,10340929389
7859,63760925029,15575,63760940604,6,0,1,11776,6,10681833057
7860,63760992786,46486,63761039272,2,0,1,3584,2,3185428825
7861,63761005485,66443,63761071928,0,0,0,30208,0,1698651823
7862,63761010430,11012,63761021442,0,0,0,68608,0,6566229134
7863,63761060152,562,63761060714,2,0,0,17920,2,8334806711
7864,63761069560,200684,63761270244,6,0,1,4096,6,9762323015
7865,63761090486,79385,63761169871,3,0,1,20992,3,9042777016
7866,63761095826,120993,63761216819,7,0,0,512,7,3726696420
7867,63761210318,46745,63761257063,7,0,1,1024,7,6743103614
7868,63761237109,52436,63761289545,0,0,1,11264,0,4821262596
7869,63761254931,79432,63761334363,4,0,1,2560,4,1034162294
7870,63761267745,96130,63761363875,2,0,1,9216,2,8689804289
7871,63761301833,62053,63761363886,6,0,0,98816,6,3213792982
7872,63761515172,67588,63761582760,0,0,1,7680,0,6833780140
7873,63761521079,4846,63761525925,0,0,1,37376,0,3018864086
7874,63761578948,562,63761579510,0,0,1,4608,0,961290507
7875,63761587499,102748,63761690247,1,0,0,5120,1,1433134862
7876,63761597331,84750,63761682081,7,0,0,512,7,4977115705
7877,63761679871,31262,63761711133,1,0,0,50688,1,3074869782
7878,63761837398,48976,63761886374,0,0,1,2048,0,4002595795
7879,63761888443,44400,63761932843,6,0,0,76288,6,7217098505
7880,63762009735,3641,63762013376,8,0,0,10240,8,5159981474
7881,63762036407,110129,63762146536,1,0,1,36864,1,8960756121
7882,63762141150,42237,63762183387,8,0,0,65024,8,4745233711
7883,63762294700,23891,63762318591,1,0,0,43008,1,4719745142
7884,63762436055,55627,63762491682,3,0,1,1024,3,2688377342
7885,63762523322,105150,63762628472,8,0,0,174592,8,1421708749
7886,63762589120,40018,63762629138,4,0,0,1024,4,799839559
7887,63762683724,1038,63762684762,4,0,0,1024,4,3186346542
7888,63762790545,57436,63762847981,5,0,1,13824,5,4632538616
7889,63762798287,78676,63762876963,4,0,1,4608,4,5600086992
7890,63762804778,85617,63762890395,3,0,1,1536,3,7918096146
7891,63762839022,54052,63762893074,1,0,1,3584,1,7149555519
7892,63762867759,52434,63762920193,4,0,1,3584,4,3671933562
7893,63762904197,102592,63763006789,3,0,1,36864,3,7446363174
7894,63762993414,88984,63763082398,7,0,1,17408,7,8778140673
7895,63763092394,1038,63763093432,5,0,0,1024,5,7928326829
7896,63763116752,54525,63763171277,8,0,0,92672,8,9818048072
7897,63763225562,72664,63763298226,5,0,1,9216,5,7909058532
7898,63763236206,105925,63763342131,1,0,0,176128,1,577789433
7899,63763237927,105510,63763343437,7,0,0,2048,7,4911107734
7900,63763254030,7428,63763261458,7,0,1,8704,7,5805325645
7901,63763336355,33329,63763369684,4,0,0,512,4,3930577209
7902,63763390540,31003,63763421543,8,0,0,54784,8,1814344140
7903,63763440957,233293,63763674250,6,0,1,13824,6,593495380
7904,63763452191,87259,63763539450,8,0,0,50176,8,8863832822
7905,63763452806,86932,63763539738,1,0,0,117760,1,4355969456
7906,63763469608,85285,63763554893,1,0,0,54272,1,1626901363
7907,63763472433,151883,63763624316,0,0,0,13824,0,3923744535
7908,63763538741,4370,63763543111,2,0,1,14336,2,2476949919
7909,63763630816,2866,63763633682,6,0,0,4608,6,3357902230
7910,63763731741,206821,63763938562,6,0,0,8704,6,2413359498
7911,63763810540,68460,63763879000,7,0,1,4096,7,3394299287
7912,63763879881,52360,63763932241,3,0,1,3072,3,4881667234
7913,63763928657,59128,63763987785,3,0,1,25600,3,4760341202
7914,63763954077,99160,63764053237,4,0,1,5120,4,7274602061
7915,63764026924,84793,63764111717,5,0,1,15872,5,4531068614
7916,63764088176,54832,63764143008,6,0,1,6144,6,10256088374
7917,63764103595,50668,63764154263,0,0,1,2560,0,2325962111
7918,63764172638,1038,63764173676,4,0,0,1024,4,5148146956
7919,63764242347,2866,63764245213,8,0,0,8704,8,8241855475
7920,63764306856,91237,63764398093,1,0,0,147456,1,1154362888
7921,63764338094,150297,63764488391,8,0,0,225792,8,4929290490
7922,63764391381,110811,63764502192,6,0,1,11776,6,9952411393
7923,63764409556,65938,63764475494,2,0,0,103936,2,10014482586
7924,63764454775,81627,63764536402,5,0,0,512,5,244961233
7925,63764465128,2942,63764468070,3,0,1,4096,3,10389243018
7926,63764487266,228273,63764715539,4,0,1,7680,4,3941613347
7927,63764504805,194703,63764699508,0,0,1,3072,0,8739164745
7928,63764576034,169732,63764745766,4,0,0,3072,4,7727862151
7929,63764695813,63962,63764759775,2,0,0,104448,2,9460187373
7930,63764701416,198765,63764900181,9,0,0,279040,9,7875181979
7931,63765008295,115104,63765123399,1,0,0,187392,1,8563604010
7932,63765090153,33912,63765124065,3,0,0,1024,3,870630251
7933,63765107153,17898,63765125051,3,0,0,1536,3,842506242
7934,63765162657,13079,63765175736,9,0,0,22016,9,8372418550
7935,63765221368,67588,63765288956,6,0,1,7680,6,6581821151
7936,63765253991,81112,63765335103,8,0,0,131072,8,7083436548
7937,63765519837,61637,63765581474,9,0,0,99840,9,8138519901
7938,63765529649,115721,63765645370,2,0,1,1024,2,3636221962
7939,63765632593,45175,63765677768,3,0,1,16896,3,5370794914
7940,63765643931,35308,63765679239,1,0,0,77824,1,1707526394
7941,63765701262,177859,63765879121,4,0,1,10240,4,9359176667
7942,63765745010,112329,63765857339,2,0,0,61952,2,7851616652
7943,63765809705,3641,63765813346,1,0,1,116224,1,3266164352
7944,63765946630,176930,63766123560,9,0,0,10240,9,10376143260
7945,63766013672,7702,63766021374,1,0,1,86528,1,7340823784
7946,63766087355,117724,63766205079,9,0,0,8192,9,5219203948
7947,63766176558,562,63766177120,5,0,0,512,5,1692997429
7948,63766267211,44488,63766311699,2,0,0,73216,2,2162634025
7949,63766276015,37310,63766313325,7,0,0,2560,7,10220557020
7950,63766290446,23545,63766313991,4,0,0,1024,4,3346204974
7951,63766320875,562,63766321437,5,0,0,512,5,1495433933
7952,63766343595,54525,63766398120,9,0,0,92672,9,10230844536
7953,63766407930,2942,63766410872,7,0,0,3072,7,1222882759
7954,63766590918,1038,63766591956,4,0,0,1024,4,7392889321
7955,63766610781,2942,63766613723,1,0,1,105984,1,4050869630
7956,63766624607,65166,63766689773,1,0,1,159744,1,10474764644
7957,63766647200,206940,63766854140,4,0,0,3072,4,8260085490
7958,63766677577,241797,63766919374,2,0,0,110080,2,4161045357
7959,63766719893,149018,63766868911,5,0,1,8192,5,4782172737
7960,63766929676,96317,63767025993,0,0,0,160768,0,9247399714
7961,63766937863,70887,63767008750,7,0,1,40960,7,6611038554
7962,63766955452,4846,63766960298,5,0,0,512,5,5154562324
7963,63767056245,199127,63767255372,7,0,0,5120,7,2699006283
7964,63767143565,1990,63767145555,4,0,0,2048,4,10270497720
7965,63767187677,15058,63767202735,3,0,1,1024,3,7843421961
7966,63767223924,57455,63767281379,8,0,0,29184,8,2224783416
7967,63767282371,48976,63767331347,2,0,1,2048,2,1135477531
7968,63767328703,52029,63767380732,9,0,0,84480,9,4894019867
7969,63767423861,7702,63767431563,4,0,0,8192,4,2154649925
7970,63767450486,562,63767451048,4,0,0,512,4,1640462652
7971,63767539455,13766,63767553221,6,0,0,26624,6,9459559900
7972,63767566345,3418,63767569763,4,0,0,3584,4,3150114830
7973,63767597025,129175,63767726200,1,0,1,123904,1,2634956161
7974,63767766247,1038,63767767285,3,0,0,1024,3,7264786842
7975,63767795484,3383,63767798867,0,0,1,8704,0,1790230988
7976,63767818352,1038,63767819390,2,0,1,21504,2,4506459669
7977,63767835207,97912,63767933119,2,0,0,9728,2,1285720312
7978,63767893364,167334,63768060698,4,0,0,1024,4,2976399635
7979,63767934176,155258,63768089434,9,0,0,255488,9,2030403576
7980,63767950064,21737,63767971801,3,0,1,3584,3,7590389801
7981,63768068043,17746,63768085789,3,0,0,512,3,5930776823
7982,63768073020,10237,63768083257,1,0,0,1536,1,6030375854
7983,63768138930,215042,63768353972,1,0,0,16384,1,8727337523
7984,63768383355,23979,63768407334,9,0,0,39936,9,4986794153
7985,63768410456,562,63768411018,3,0,0,512,3,3061891324
7986,63768441847,63704,63768505551,1,0,0,103936,1,8603910396
7987,63768451278,61120,63768512398,1,0,1,1536,1,4411832438
7988,63768477367,147032,63768624399,1,0,1,13312,1,6926579271
7989,63768506487,127261,63768633748,8,0,0,98816,8,7261548592
7990,63768528021,106555,63768634576,9,0,0,291328,9,7519536028
7991,63768581178,185681,63768766859,6,0,1,3072,6,8301967965
7992,63768590418,123768,63768714186,7,0,1,7168,7,1747439128
7993,63768595119,36047,63768631166,9,0,0,24576,9,2366109122
7994,63768684466,143731,63768828197,3,0,0,2560,3,2029350771
7995,63768743091,42162,63768785253,1,0,0,68608,1,9657659752
7996,63768777857,15317,63768793174,6,0,0,29696,6,6893829335
7997,63768836363,1038,63768837401,5,0,1,3584,5,557947464
7998,63768874493,54052,63768928545,5,0,0,1024,5,4053796878
7999,63768876085,78519,63768954604,6,0,1,8704,6,8959483955
8000,63768895920,55817,63768951737,1,0,1,13824,1,9423205120
8001,63768899479,43571,63768943050,0,0,0,95232,0,4476846796
8002,63768906415,96164,63769002579,4,0,1,2048,4,8812425758
8003,63768912391,123664,63769036055,3,0,0,1024,3,4467091607
8004,63769116143,117942,63769234085,3,0,1,16896,3,5264110087
8005,63769292727,1514,63769294241,7,0,0,1536,7,2129135624
8006,63769299659,91753,63769391412,8,0,0,148480,8,6667801532
8007,63769336860,54911,63769391771,2,0,0,9728,2,3950136302
8008,63769337577,57740,63769395317,8,0,0,5632,8,6094047247
8009,63769417478,1514,63769418992,6,0,1,12288,6,5783935618
8010,63769419440,181604,63769601044,3,0,0,1536,3,6924918627
8011,63769529346,50845,63769580191,6,0,1,23040,6,3572850934
8012,63769568187,107146,63769675333,1,0,1,1024,1,5725902978
8013,63769661276,5450,63769666726,1,0,0,13824,1,8261940838
8014,63769662293,27652,63769689945,1,0,0,44032,1,3070106252
8015,63769666205,24406,63769690611,1,0,0,11264,1,1040990620
8016,63769743569,3124,63769746693,2,0,0,9216,2,400864081
8017,63769748685,562,63769749247,7,0,1,45568,7,8818593087
8018,63769790844,2466,63769793310,4,0,0,512,4,5394875718
8019,63769850003,162402,63770012405,3,0,0,2560,3,5570221694
8020,63769907325,69962,63769977287,6,0,1,8192,6,5144306524
8021,63769973736,1038,63769974774,1,0,1,9216,1,10590638221
8022,63769975504,35308,63770010812,6,0,1,4608,6,1450508364
8023,63769988122,4846,63769992968,7,0,0,1024,7,4871092378
8024,63769990302,71599,63770061901,8,0,0,61952,8,5504681799
8025,63770033295,71246,63770104541,1,0,0,5120,1,1407834210
8026,63770130730,45592,63770176322,4,0,1,1024,4,7642538900
8027,63770256610,97609,63770354219,1,0,0,163328,1,2127653701
8028,63770262571,93594,63770356165,2,0,0,3072,2,5880589153
8029,63770335393,21118,63770356511,4,0,0,512,4,8889367803
8030,63770337292,156671,63770493963,1,0,1,1536,1,8474075724
8031,63770453978,1514,63770455492,6,0,1,10240,6,7219012722
8032,63770532137,123231,63770655368,7,0,0,1536,7,97285975
8033,63770545403,65760,63770611163,1,0,1,4608,1,10136505869
8034,63770620223,23721,63770643944,9,0,0,39424,9,2937123266
8035,63770712064,52516,63770764580,7,0,1,3584,7,10685810485
8036,63770765598,32812,63770798410,0,0,0,53760,0,5598797717
8037,63770783456,15620,63770799076,3,0,0,1024,3,5463768948
8038,63770902777,93436,63770996213,0,0,1,16896,0,9804937982
8039,63771142306,106442,63771248748,9,0,0,177152,9,4220517312
8040,63771208307,110628,63771318935,5,0,1,10752,5,3992443982
8041,63771246056,66975,63771313031,0,0,1,1536,0,7586203893
8042,63771286120,196544,63771482664,2,0,0,113664,2,591786734
8043,63771331254,4416,63771335670,0,0,1,17408,0,6878835221
8044,63771389027,138682,63771527709,4,0,1,4608,4,6831523409
8045,63771391218,142035,63771533253,3,0,1,7680,3,9888678777
8046,63771488563,226467,63771715030,2,0,0,11776,2,479723851
8047,63771614864,562,63771615426,0,0,1,8192,0,1205515962
8048,63771636506,72661,63771709167,6,0,1,4096,6,7333419724
8049,63771638576,62059,63771700635,5,0,0,512,5,6459475929
8050,63771665188,48976,63771714164,6,0,1,2048,6,4902514150
8051,63771697697,53664,63771751361,2,0,0,86016,2,10726722836
8052,63771804277,54096,63771858373,0,0,0,88576,0,7993831231
8053,63772319273,71440,63772390713,0,0,1,10240,0,5036683131
8054,63772377604,45592,63772423196,3,0,1,1024,3,9152241286
8055,63772465633,74824,63772540457,1,0,1,11264,1,8405920377
8056,63772580359,1514,63772581873,5,0,0,1536,5,10598538198
8057,63772610664,47284,63772657948,0,0,1,1536,0,8494030480
8058,63772643532,159402,63772802934,2,0,1,17920,2,10127785399
8059,63772837024,12562,63772849586,0,0,0,20992,0,187233216
8060,63772885832,101362,63772987194,8,0,0,163840,8,9964190636
8061,63772905975,96874,63773002849,8,0,0,58368,8,4426972685
8062,63772979214,27181,63773006395,4,0,0,5632,4,620586586
8063,63773030575,134837,63773165412,1,0,0,219136,1,7458815501
8064,63773075075,110921,63773185996,6,0,0,65536,6,9965911943
8065,63773112349,73993,63773186342,5,0,0,512,5,5037847900
8066,63773129135,20154,63773149289,1,0,1,14336,1,1959197606
8067,63773144817,132288,63773277105,2,0,1,8704,2,8387863222
8068,63773166534,1990,63773168524,4,0,0,512,4,3535757169
8069,63773284162,204241,63773488403,4,0,1,4096,4,6087637712
8070,63773303568,58794,63773362362,5,0,0,2048,5,2347736173
8071,63773306714,93790,63773400504,0,0,1,3584,0,6631884236
8072,63773373573,89715,63773463288,0,0,1,3584,0,760295411
8073,63773412494,113723,63773526217,3,0,1,13312,3,9474306961
8074,63773656173,55744,63773711917,7,0,1,4096,7,3156684995
8075,63773748523,45592,63773794115,7,0,1,1024,7,6000685505
8076,63773894946,94854,63773989800,1,0,0,154624,1,7661965569
8077,63773919633,61949,63773981582,6,0,1,2560,6,1711543297
8078,63773928197,165983,63774094180,7,0,0,512,7,6389037300
8079,63774060723,134062,63774194785,2,0,0,217600,2,2156824648
8080,63774065261,135835,63774201096,6,0,0,30208,6,8669304506
8081,63774081411,120991,63774202402,5,0,0,2048,5,3327963657
8082,63774214093,12821,63774226914,8,0,0,21504,8,3716506660
8083,63774295413,7226,63774302639,2,0,0,7680,2,8121227504
8084,63774407471,93748,63774501219,4,0,1,17920,4,2191555809
8085,63774414540,120291,63774534831,4,0,1,7168,4,8247168653
8086,63774471882,105105,63774576987,1,0,1,12288,1,8047843003
8087,63774629942,20362,63774650304,9,0,0,32768,9,9628830553
8088,63774737599,64650,63774802249,8,0,0,109056,8,2907894839
8089,63774739505,136350,63774875855,2,0,0,171008,2,7676131990
8090,63774775156,252552,63775027708,1,0,0,331776,1,8979301266
8091,63774885213,148089,63775033302,2,0,0,26624,2,7543264639
8092,63774914009,130123,63775044132,1,0,0,35328,1,5858833691
8093,63775011051,33747,63775044798,7,0,0,1024,7,10437153620
8094,63775114681,2466,63775117147,3,0,0,2560,3,1956979614
8095,63775248685,60820,63775309505,0,0,1,30720,0,5475844739
8096,63775274841,100720,63775375561,8,0,1,5632,8,1078882098
8097,63775309907,33499,63775343406,1,0,1,4608,1,2774509934
8098,63775333409,51295,63775384704,9,0,0,58368,9,1365116536
8099,63775345547,91069,63775436616,2,0,1,1024,2,2161083905
8100,63775354678,1038,63775355716,7,0,1,30208,7,4348343267
8101,63775376942,105128,63775482070,6,0,1,6656,6,6997829935
8102,63775436743,7495,63775444238,6,0,0,1024,6,7767418825
8103,63775452865,86782,63775539647,4,0,0,512,4,6119391752
8104,63775558988,1038,63775560026,5,0,0,1024,5,5904055624
8105,63775632387,30487,63775662874,2,0,0,49152,2,3502652061
8106,63775766711,562,63775767273,5,0,0,512,5,722502566
8107,63775852791,5192,63775857983,8,0,0,13312,8,4457700892
8108,63775901831,80704,63775982535,4,0,1,20480,4,8789156935
8109,63775958775,23771,63775982546,2,0,0,42496,2,6109975283
8110,63775962805,41128,63776003933,7,0,1,23040,7,7837723054
8111,63776001326,105674,63776107000,8,0,0,66560,8,839586511
8112,63776023924,65425,63776089349,0,0,1,5632,0,7690571270
8113,63776149547,36873,63776186420,1,0,0,110592,1,3039432682
8114,63776178445,208023,63776386468,3,0,0,512,3,1879958498
8115,63776264713,76842,63776341555,8,0,0,129536,8,6135293176
8116,63776266798,77023,63776343821,4,0,0,3584,4,6078161121
8117,63776515653,69280,63776584933,3,0,1,8192,3,9280242622
8118,63776817413,1038,63776818451,5,0,0,1024,5,5385965984
8119,63776938374,55744,63776994118,5,0,1,4096,5,966748374
8120,63776974119,33241,63777007360,8,0,0,57856,8,6320907694
8121,63776989509,107503,63777097012,8,0,1,4096,8,5363823568
8122,63777170058,49827,63777219885,4,0,1,9728,4,2700903858
8123,63777175039,65140,63777240179,4,0,1,1024,4,4717463766
8124,63777215023,203904,63777418927,6,0,0,330240,6,29909080
8125,63777304452,92452,63777396904,6,0,1,6656,6,1703495708
8126,63777327141,148322,63777475463,4,0,0,1024,4,2710736867
8127,63777410194,82404,63777492598,2,0,1,27136,2,9723136432
8128,63777437098,23979,63777461077,8,0,0,133632,8,8757132803
8129,63777572611,225957,63777798568,8,0,0,39936,8,3697040167
8130,63777746509,562,63777747071,4,0,1,11776,4,2848920272
8131,63777754452,76943,63777831395,6,0,0,512,6,9388377685
8132,63777816889,3418,63777820307,8,0,1,4608,8,1083639107
8133,63777858034,57436,63777915470,7,0,0,3584,7,73558642
8134,63777880533,50668,63777931201,2,0,1,2560,2,195299085
8135,63777891000,54096,63777945096,8,0,0,88576,8,9389014679
8136,63777937603,8159,63777945762,7,0,0,1024,7,784724101
8137,63777979621,101200,63778080821,1,0,0,380928,1,4375485917
8138,63778012633,152364,63778164997,2,0,0,94720,2,6305685266
8139,63778027091,235054,63778262145,6,0,0,1024,6,6581705580
8140,63778043083,228680,63778271763,8,0,1,7680,8,6419090843
8141,63778085765,214888,63778300653,1,0,1,4096,1,4054578638
8142,63778178097,165729,63778343826,8,0,1,10752,8,9314935160
8143,63778183313,56075,63778239388,2,0,0,269312,2,2612060153
8144,63778214559,244618,63778459177,5,0,1,18944,5,7749745050
8145,63778300187,276480,63778576667,1,0,1,6144,1,7542141409
8146,63778330207,132253,63778462460,8,0,0,95744,8,6013545403
8147,63778338506,76856,63778415362,4,0,1,5120,4,5838706359
8148,63778361145,30373,63778391518,1,0,0,214016,1,5670345192
8149,63778405743,227230,63778632973,5,0,1,10752,5,4527491120
8150,63778417208,166428,63778583636,3,0,0,1024,3,3873325373
8151,63778471913,562,63778472475,6,0,1,6144,6,8201235484
8152,63778475135,286030,63778761165,1,0,0,46592,1,6386405992
8153,63778572980,2942,63778575922,5,0,0,512,5,9163914527
8154,63778721668,266436,63778988104,3,0,0,3072,3,604648895
8155,63778762354,3641,63778765995,9,0,0,10240,9,4536621888
8156,63778865033,4158,63778869191,9,0,0,11264,9,8319134828
8157,63778919429,1038,63778920467,4,0,0,1024,4,4309301269
8158,63778974408,1990,63778976398,3,0,0,2048,3,9247285579
8159,63779048943,69436,63779118379,7,0,1,8704,7,3895392559
8160,63779191542,22946,63779214488,8,0,0,37888,8,9331765121
8161,63779306766,23462,63779330228,2,0,1,39424,2,9556683678
8162,63779309246,170914,63779480160,5,0,1,1024,5,4689990061
8163,63779350137,180116,63779530253,9,0,0,38912,9,2123591336
8164,63779428511,138309,63779566820,7,0,1,1536,7,2176310676
8165,63779525024,1990,63779527014,2,0,1,21504,2,2407395289
8166,63779611160,97912,63779709072,7,0,0,2048,7,5775630655
8167,63779679695,1038,63779680733,4,0,0,1024,4,3863778557
8168,63779747702,2942,63779750644,2,0,0,3072,2,7333606110
8169,63779799161,90491,63779889652,6,0,1,6144,6,618634803
8170,63779833586,57325,63779890911,8,0,1,4096,8,4433705482
8171,63779943168,69748,63780012916,8,0,1,9728,8,307684925
8172,63780121665,6484,63780128149,0,0,0,15872,0,8906869360
8173,63780144237,45904,63780190141,8,0,1,2048,8,7714452667
8174,63780214657,2466,63780217123,3,0,0,2560,3,5031139637
8175,63780282253,2466,63780284719,1,0,1,2048,1,661113755
8176,63780325796,48976,63780374772,6,0,0,2560,6,4509760900
8177,63780326910,12821,63780339731,0,0,1,3072,0,1475771431
8178,63780345420,52360,63780397780,9,0,0,21504,9,6170632708
8179,63780429229,2942,63780432171,7,0,0,3072,7,2441003812
8180,63780483766,84383,63780568149,2,0,0,140800,2,4753461413
8181,63780491604,15833,63780507437,6,0,1,6144,6,2173677708
8182,63780511192,141043,63780652235,1,0,1,10240,1,3623545674
8183,63780584294,1514,63780585808,8,0,0,30720,8,8906856740
8184,63780663418,52360,63780715778,4,0,0,1536,4,6152214094
8185,63780673223,247095,63780920318,1,0,1,3072,1,1674712341
8186,63780801131,43900,63780845031,4,0,1,10240,4,1347031757
8187,63780882298,142773,63781025071,1,0,1,512,1,5595036994
8188,63780945833,54832,63781000665,1,0,1,6144,1,2044557528
8189,63780983721,56592,63781040313,1,0,0,96768,1,6165527174
8190,63781071931,80708,63781152639,3,0,1,7680,3,493290967
8191,63781079912,117435,63781197347,1,0,1,10240,1,1596320230
8192,63781161668,61878,63781223546,2,0,1,5632,2,9961618475
8193,63781218024,115275,63781333299,0,0,0,190976,0,1818242118
8194,63781322358,12247,63781334605,4,0,0,2048,4,2527544399
8195,63781436065,16350,63781452415,6,0,1,4096,6,3943434328
8196,63781490658,94040,63781584698,0,0,0,31744,0,4469819426
8197,63781678113,43900,63781722013,3,0,1,512,3,3208075626
8198,63781729315,52029,63781781344,8,0,0,84480,8,7889506779
8199,63781751771,31519,63781783290,5,0,0,3072,5,6806334239
8200,63781786757,5192,63781791949,1,0,0,13312,1,795063420
8201,63781844310,1990,63781846300,3,0,0,2048,3,6227729108
8202,63781868261,71976,63781940237,3,0,1,40960,3,2671721413
8203,63781893420,140155,63782033575,5,0,1,5632,5,5903164769
8204,63781896860,137866,63782034726,0,0,1,10240,0,2256243715
8205,63782057810,10237,63782068047,8,0,0,16384,8,5338679876
8206,63782157213,1990,63782159203,4,0,1,7680,4,6117691128
8207,63782166829,1038,63782167867,2,0,1,1024,2,4243691819
8208,63782181052,45592,63782226644,6,0,1,11776,6,526752191
8209,63782188436,59908,63782248344,5,0,0,2048,5,8153139590
8210,63782196865,87604,63782284469,4,0,0,1024,4,1921537116
8211,63782220552,125658,63782346210,8,0,0,207872,8,7621851595
8212,63782226448,121350,63782347798,1,0,0,15872,1,2737364936
8213,63782492718,45677,63782538395,6,0,1,1024,6,9008649003
8214,63782512823,100252,63782613075,6,0,1,29184,6,6715482120
8215,63782560463,58372,63782618835,8,0,1,22016,8,6158318180
8216,63782584397,11787,63782596184,0,0,1,7680,0,6192583316
8217,63782635410,134632,63782770042,2,0,0,19456,2,3887405368
8218,63782639946,58559,63782698505,2,0,1,4096,2,4019535841
8219,63782697788,1514,63782699302,6,0,1,4096,6,7403948038
8220,63782720490,562,63782721052,8,0,1,4608,8,5134659806
8221,63782722632,56453,63782779085,0,0,0,1536,0,4909853860
8222,63782747972,69577,63782817549,5,0,0,512,5,3273936353
8223,63782801250,64204,63782865454,7,0,1,6656,7,4214743366
8224,63782867330,52828,63782920158,8,0,1,4608,8,9451032889
8225,63782930901,23891,63782954792,9,0,0,43008,9,10128433264
8226,63783069404,1038,63783070442,4,0,1,2048,4,1122558832
8227,63783072684,48976,63783121660,5,0,0,1024,5,1272380181
8228,63783144487,164866,63783309353,2,0,0,270848,2,10383470182
8229,63783160176,149523,63783309699,7,0,0,512,7,8439477988
8230,63783232380,88149,63783320529,1,0,0,35328,1,2009241621
8231,63783318528,2347,63783320875,4,0,0,512,4,1664197997
8232,63783346552,2466,63783349018,0,0,1,14848,0,430248168
8233,63783401882,84935,63783486817,2,0,0,2560,2,2456639218
8234,63783518798,12304,63783531102,8,0,0,20480,8,5393838023
8235,63783557833,3418,63783561251,2,0,1,4608,2,4345363636
8236,63783561979,57436,63783619415,4,0,0,3584,4,7543171288
8237,63783632351,1038,63783633389,6,0,0,1024,6,3266085021
8238,63783663153,2466,63783665619,4,0,0,2560,4,3196584059
8239,63783668336,100408,63783768744,6,0,1,29696,6,1812315272
8240,63783799040,562,63783799602,5,0,0,512,5,579733009
8241,63784036506,45592,63784082098,0,0,1,1024,0,8863106969
8242,63784076565,13337,63784089902,8,0,1,1024,8,532424222
8243,63784078191,50761,63784128952,0,0,0,22528,0,9989126552
8244,63784113981,64828,63784178809,5,0,1,8704,5,332921084
8245,63784145501,52029,63784197530,3,0,1,2560,3,8131557197
8246,63784191096,117045,63784308141,9,0,0,84480,9,10347714629
8247,63784235311,562,63784235873,6,0,1,11264,6,1680771416
8248,63784237639,16092,63784253731,7,0,1,512,7,726913732
8249,63784269116,74154,63784343270,5,0,0,512,5,6160541137
8250,63784278375,167997,63784446372,0,0,0,31232,0,4575891515
8251,63784312404,140414,63784452818,5,0,1,11264,5,243497120
8252,63784387640,104979,63784492619,0,0,0,171008,0,10382269057
8253,63784407610,83852,63784491462,8,0,1,12800,8,4889673316
8254,63784411993,12783,63784424776,3,0,0,5120,3,5531308146
8255,63784484650,157641,63784642291,0,0,0,15872,0,10167138830
8256,63784578963,52360,63784631323,7,0,1,3072,7,4634715429
8257,63784629422,58349,63784687771,4,0,1,4608,4,8769374574
8258,63784736874,23633,63784760507,2,0,0,42496,2,7859518462
8259,63784770536,1514,63784772050,3,0,0,1536,3,6426389930
8260,63784841292,49132,63784890424,2,0,1,2560,2,4414731933
8261,63784872548,50668,63784923216,4,0,1,2560,4,9277134955
8262,63784930503,58372,63784988875,1,0,1,7680,1,1707867575
8263,63785088169,63316,63785151485,3,0,1,13824,3,3144423796
8264,63785182271,562,63785182833,3,0,0,512,3,9171488663
8265,63785187840,99160,63785287000,4,0,1,25600,4,5766151644
8266,63785213311,87003,63785300314,2,0,1,7680,2,5383550206
8267,63785275048,16905,63785291953,6,0,1,6144,6,1162742749
8268,63785286696,57904,63785344600,9,0,0,32256,9,10416041661
8269,63785440862,1514,63785442376,4,0,0,1536,4,10723317875
8270,63785446463,14541,63785461004,2,0,0,28160,2,5788891577
8271,63785524193,78544,63785602737,4,0,1,18432,4,6636413769
8272,63785538331,67588,63785605919,0,0,1,7680,0,9030455004
8273,63785612415,35825,63785648240,1,0,1,24576,1,10571687770
8274,63785614203,98848,63785713051,1,0,0,62976,1,6332001324
8275,63785794331,1038,63785795369,3,0,0,1024,3,10604124803
8276,63785883568,562,63785884130,7,0,0,512,7,3186996263
8277,63785898416,562,63785898978,8,0,1,13824,8,1462861093
8278,63785929530,562,63785930092,7,0,0,512,7,6569149662
8279,63785951251,87892,63786039143,6,0,0,512,6,5270580024
8280,63785953997,44400,63785998397,8,0,0,76288,8,9782438255
8281,63785961820,160432,63786122252,8,0,0,235520,8,10146106459
8282,63786111005,12553,63786123558,3,0,0,2048,3,7933711712
8283,63786201008,4846,63786205854,1,0,1,25600,1,8285027906
8284,63786224149,562,63786224711,3,0,0,5120,3,10493825566
8285,63786232447,562,63786233009,5,0,0,512,5,9599474375
8286,63786241289,133498,63786374787,2,0,1,3072,2,10073708305
8287,63786307167,131038,63786438205,8,0,1,20480,8,4742535318
8288,63786314981,75296,63786390277,0,0,1,2048,0,8883462795
8289,63786322013,105414,63786427427,5,0,0,512,5,513007834
8290,63786332459,114926,63786447385,8,0,1,28160,8,1680650601
8291,63786478263,43900,63786522163,5,0,1,512,5,10121541935
8292,63786516715,81124,63786597839,5,0,1,11776,5,5700317703
8293,63786554416,1514,63786555930,0,0,1,2560,0,83930317
8294,63786609965,90451,63786700416,7,0,0,1536,7,2206438242
8295,63786694147,74775,63786768922,2,0,0,125440,2,3802502082
8296,63786855132,1038,63786856170,3,0,0,1024,3,5444289869
8297,63786857591,2942,63786860533,4,0,0,3072,4,419132835
8298,63786883302,68992,63786952294,0,0,1,12288,0,9211922675
8299,63786995966,14541,63787010507,7,0,1,5632,7,2589210753
8300,63787009128,60820,63787069948,2,0,0,28160,2,6748494823
8301,63787016701,61931,63787078632,8,0,1,5632,8,7865885384
8302,63787027091,7226,63787034317,1,0,1,18432,1,7639300158
8303,63787124461,121754,63787246215,0,0,0,7680,0,7710774224
8304,63787194041,95776,63787289817,3,0,1,24576,3,6780788139
8305,63787429960,1038,63787430998,7,0,0,1024,7,3322538729
8306,63787567581,21137,63787588718,8,0,0,34304,8,8308623332
8307,63787576072,64939,63787641011,0,0,0,102400,0,1260268577
8308,63787606679,39517,63787646196,8,0,0,24576,8,3843735262
8309,63787832872,32295,63787865167,6,0,1,512,6,4302559146
8310,63787835421,91728,63787927149,2,0,0,52736,2,1416106648
8311,63787865730,111487,63787977217,8,0,0,180224,8,7854892780
8312,63787879681,188532,63788068213,7,0,1,10752,7,676603807
8313,63787992791,94809,63788087600,5,0,1,13824,5,6749891119
8314,63788134027,3418,63788137445,3,0,0,3584,3,8592157568
8315,63788231522,42937,63788274459,1,0,0,70144,1,2269027637
8316,63788252444,23641,63788276085,5,0,0,2560,5,7987922534
8317,63788287830,32295,63788320125,2,0,0,52736,2,3517306154
8318,63788333769,52360,63788386129,3,0,1,3072,3,8412324828
8319,63788446407,101620,63788548027,8,0,0,164352,8,565893976
8320,63788490214,35004,63788525218,0,0,1,25600,0,9439776476
8321,63788513369,5835,63788519204,5,0,0,512,5,10529568472
8322,63788543204,3418,63788546622,3,0,0,1024,3,1503408338
8323,63788583765,154950,63788738715,8,0,0,3584,8,6466445118
8324,63788591725,562,63788592287,3,0,1,36864,3,990699024
8325,63788653006,117478,63788770484,5,0,0,512,5,8683926810
8326,63788832706,13854,63788846560,2,0,0,23552,2,6478776241
8327,63788840339,7207,63788847546,4,0,0,1536,4,10084059459
8328,63788908540,95541,63789004081,2,0,0,159232,2,2966936127
8329,63788932383,5192,63788937575,5,0,1,2560,5,7753374969
8330,63788942871,1038,63788943909,5,0,1,18432,5,4017028687
8331,63789055185,179475,63789234660,2,0,0,13312,2,6305832764
8332,63789092909,223326,63789316235,6,0,0,1024,6,8385407040
8333,63789280720,1514,63789282234,6,0,0,1536,6,5913162132
8334,63789309089,64516,63789373605,8,0,1,7680,8,8957091834
8335,63789369822,58528,63789428350,6,0,1,25088,6,8927307103
8336,63789392818,94396,63789487214,5,0,1,8192,5,3736133624
8337,63789467557,2466,63789470023,1,0,1,23040,1,1228011176
8338,63789473332,86092,63789559424,3,0,0,2560,3,913413183
8339,63789512729,54678,63789567407,6,0,1,1536,6,3360607685
8340,63789550220,1514,63789551734,1,0,1,25600,1,7596636226
8341,63789570493,1514,63789572007,4,0,0,1536,4,9939084604
8342,63789589706,94901,63789684607,5,0,0,1536,5,7656712216
8343,63789600594,86687,63789687281,2,0,1,17408,2,7609094611
8344,63789612483,94066,63789706549,6,0,1,8192,6,5700214596
8345,63789617028,133408,63789750436,6,0,1,16384,6,7903480309
8346,63789751655,562,63789752217,7,0,0,512,7,8490799988
8347,63789843011,26475,63789869486,3,0,1,26112,3,4178467696
8348,63789854790,99316,63789954106,2,0,0,48128,2,4968861885
8349,63789904629,43883,63789948512,2,0,0,75264,2,9714515521
8350,63790007549,562,63790008111,6,0,0,512,6,2941485163
8351,63790012147,562,63790012709,7,0,0,512,7,4355721952
8352,63790038756,562,63790039318,7,0,0,512,7,660961889
8353,63790064042,24150,63790088192,2,0,1,1536,2,4064767688
8354,63790103952,87742,63790191694,9,0,0,43520,9,2513876390
8355,63790246107,40870,63790286977,0,0,0,66048,0,9800710791
8356,63790287421,2942,63790290363,5,0,0,3072,5,3819553592
8357,63790328593,10495,63790339088,1,0,0,16896,1,8888958914
8358,63790340876,22858,63790363734,0,0,0,40960,0,3007389542
8359,63790403535,82816,63790486351,2,0,1,12288,2,10008466044
8360,63790483857,2942,63790486799,7,0,1,5120,7,8369425164
8361,63790494009,4370,63790498379,0,0,1,12288,0,5253526053
8362,63790501788,1514,63790503302,5,0,0,3072,5,2032416997
8363,63790525404,61614,63790587018,7,0,0,4608,7,7482529571
8364,63790531956,83940,63790615896,1,0,1,19968,1,3181984447
8365,63790539454,41904,63790581358,6,0,0,1536,6,1493501742
8366,63790568262,97444,63790665706,1,0,0,68096,1,238394650
8367,63790671534,1514,63790673048,5,0,0,1536,5,204291615
8368,63790673949,52360,63790726309,7,0,1,10240,7,808780899
8369,63790684937,76048,63790760985,5,0,1,3072,5,9749256944
8370,63790956366,2466,63790958832,5,0,1,17920,5,8170823952
8371,63790963040,65140,63791028180,3,0,0,2560,3,578813716
8372,63790965570,4791,63790970361,5,0,1,9728,5,5150682801
8373,63791025930,82996,63791108926,3,0,0,2560,3,3949047008
8374,63791056533,7702,63791064235,8,0,1,12288,8,7984457471
8375,63791079625,1038,63791080663,5,0,1,17408,5,9275360181
8376,63791090149,82816,63791172965,8,0,0,8192,8,2986439502
8377,63791120464,88984,63791209448,7,0,0,1024,7,8783572526
8378,63791148306,52360,63791200666,5,0,1,3072,5,7757336424
8379,63791270371,26475,63791296846,2,0,0,48128,2,8247586211
8380,63791408368,50668,63791459036,6,0,1,2560,6,7456447886
8381,63791537264,1038,63791538302,4,0,1,3584,4,1548437067
8382,63791550066,6484,63791556550,4,0,0,1024,4,8740791260
8383,63791554484,54052,63791608536,0,0,0,15872,0,2569112966
8384,63791631142,73741,63791704883,2,0,0,123392,2,9762299187
8385,63791813770,115104,63791928874,9,0,0,187392,9,5197757320
8386,63791814038,188202,63792002240,8,0,1,3072,8,6530491045
8387,63791891600,887,63791892487,7,0,1,7680,7,2304991166
8388,63792001907,1514,63792003421,6,0,0,512,6,8303608055
8389,63792002955,59128,63792062083,4,0,0,1536,4,3479649519
8390,63792014364,194839,63792209203,1,0,1,5120,1,5522693458
8391,63792032244,147458,63792179702,2,0,1,7168,2,9291900045
8392,63792035258,172377,63792207635,2,0,0,243712,2,5485058568
8393,63792046334,158298,63792204632,9,0,0,67072,9,3483669056
8394,63792055620,159533,63792215153,2,0,0,38912,2,1167913471
8395,63792082169,175355,63792257524,0,0,1,2048,0,8328243748
8396,63792135331,131920,63792267251,2,0,0,175616,2,110909058
8397,63792177688,131600,63792309288,1,0,0,143872,1,480556722
8398,63792178495,127873,63792306368,5,0,1,1536,5,6729426807
8399,63792182081,111095,63792293176,4,0,0,1024,4,69483918
8400,63792201765,90626,63792292391,3,0,0,4608,3,943147034
8401,63792222580,79056,63792301636,7,0,0,512,7,1866743489
8402,63792231434,124624,63792356058,3,0,1,7168,3,10009291748
8403,63792239642,104475,63792344117,9,0,0,17920,9,3033936798
8404,63792285703,24541,63792310244,2,0,0,205824,2,10446673973
8405,63792289588,248696,63792538284,5,0,1,15360,5,149382047
8406,63792306198,259545,63792565743,6,0,0,512,6,8799681973
8407,63792386478,1514,63792387992,5,0,0,512,5,1668110728
8408,63792526712,284087,63792810799,7,0,1,5120,7,8794937092
8409,63792527168,5450,63792532618,6,0,0,1536,6,8410092420
8410,63792692585,184192,63792876777,0,0,0,13824,0,5763423951
8411,63792818209,1038,63792819247,5,0,1,14336,5,8197848715
8412,63792823042,81274,63792904316,3,0,0,1024,3,9539745916
8413,63792867463,54008,63792921471,1,0,0,91648,1,3248512393
8414,63792937716,2466,63792940182,3,0,1,29696,3,8814400388
8415,63792970108,34791,63793004899,6,0,0,2560,6,5074246715
8416,63793004951,129446,63793134397,2,0,0,60928,2,8148275096
8417,63793005416,122452,63793127868,5,0,1,6144,5,5498639319
8418,63793128064,45592,63793173656,5,0,1,1024,5,2648064333
8419,63793132622,45592,63793178214,0,0,1,1024,0,2414694127
8420,63793156267,12562,63793168829,6,0,1,3584,6,9898543067
8421,63793209246,4176,63793213422,8,0,0,20992,8,6401815681
8422,63793218298,69285,63793287583,3,0,0,1024,3,464821930
8423,63793336281,5192,63793341473,7,0,1,4608,7,7059072986
8424,63793349732,62682,63793412414,9,0,0,13312,9,10370616236
8425,63793539551,53062,63793592613,9,0,0,86528,9,3161860316
8426,63793563632,31887,63793595519,6,0,0,4608,6,3304385833
8427,63793625613,105666,63793731279,0,0,0,175616,0,7166203950
8428,63793689166,58588,63793747754,3,0,0,54272,3,800261139
8429,63793694145,120302,63793814447,6,0,1,7680,6,6632138663
8430,63793700416,107620,63793808036,7,0,1,46080,7,7537731142
8431,63793730677,227777,63793958454,6,0,1,9216,6,8064590060
8432,63793887208,86450,63793973658,1,0,1,9216,1,1405834154
8433,63793895485,99557,63793995042,5,0,1,29696,5,6642315571
8434,63793896038,88428,63793984466,8,0,0,144896,8,2916620699
8435,63793898886,18167,63793917053,7,0,0,7680,7,3949703939
8436,63793970453,108272,63794078725,4,0,0,2048,4,7592607289
8437,63793996503,35567,63794032070,3,0,1,9728,3,851770781
8438,63794151033,26371,63794177404,1,0,0,62464,1,3936236653
8439,63794170956,222042,63794392998,1,0,0,34816,1,7164342587
8440,63794178949,54052,63794233001,7,0,1,2560,7,6375084738
8441,63794200993,84295,63794285288,5,0,1,3584,5,3752479785
8442,63794207721,191305,63794399026,3,0,1,1536,3,5386025651
8443,63794396411,3124,63794399535,8,0,0,9216,8,7504202870
8444,63794413171,4370,63794417541,4,0,0,4608,4,4716127247
8445,63794458128,2942,63794461070,7,0,0,3072,7,3763909000
8446,63794480113,1038,63794481151,2,0,1,29696,2,9818284077
8447,63794499260,1038,63794500298,1,0,1,2560,1,10695920640
8448,63794518143,50668,63794568811,5,0,0,1024,5,3287888160
8449,63794519855,101213,63794621068,5,0,0,1024,5,9808661911
8450,63794588355,117342,63794705697,1,0,0,195072,1,4260123240
8451,63794652548,53815,63794706363,7,0,0,1024,7,10664066473
8452,63794661240,93664,63794754904,1,0,1,5120,1,65694487
8453,63794753219,12991,63794766210,7,0,1,6144,7,2569320006
8454,63794778815,47284,63794826099,9,0,0,25088,9,8024765518
8455,63794790170,32554,63794822724,7,0,1,1536,7,538901607
8456,63794803367,149974,63794953341,1,0,1,19968,1,1314150227
8457,63794824936,133222,63794958158,9,0,0,53248,9,2979351051
8458,63794906376,87292,63794993668,5,0,1,16896,5,9602246677
8459,63794998604,562,63794999166,6,0,0,512,6,2013791172
8460,63795003720,102137,63795105857,3,0,0,165376,3,6250831351
8461,63795076040,20878,63795096918,7,0,1,10240,7,8927210749
8462,63795146146,22858,63795169004,2,0,0,33792,2,6488133594
8463,63795156795,2466,63795159261,3,0,0,40960,3,5032093552
8464,63795227600,170388,63795397988,5,0,0,2560,5,9253020479
8465,63795313411,562,63795313973,4,0,0,512,4,9268430727
8466,63795339744,2942,63795342686,5,0,1,4608,5,3195400291
8467,63795354225,86878,63795441103,3,0,1,14848,3,2401336382
8468,63795388145,120080,63795508225,4,0,0,3072,4,1808744878
8469,63795617847,74516,63795692363,2,0,0,124928,2,2788579593
8470,63795636369,55595,63795691964,8,0,0,146944,8,2484778608
8471,63795645982,107092,63795753074,4,0,1,1024,4,10530969044
8472,63795678144,562,63795678706,7,0,1,24576,7,6087201980
8473,63795799744,299097,63796098841,6,0,0,512,6,9893936673
8474,63795911271,68165,63795979436,4,0,1,7168,4,605798283
8475,63795914583,157325,63796071908,3,0,0,259584,3,8082676468
8476,63795929642,23413,63795953055,0,0,1,1536,0,3742303548
8477,63796049878,160838,63796210716,0,0,0,14848,0,928963210
8478,63796139477,1514,63796140991,5,0,1,3584,5,1045144689
8479,63796158312,57771,63796216083,8,0,1,3584,8,5851054054
8480,63796188326,57063,63796245389,6,0,0,1536,6,4238588566
8481,63796205322,88407,63796293729,7,0,1,14336,7,6480915148
8482,63796241192,94060,63796335252,0,0,1,18944,0,9745674814
8483,63796519756,1514,63796521270,9,0,0,1536,9,8907652196
8484,63796538173,55900,63796594073,4,0,1,4608,4,1755244319
8485,63796635719,1990,63796637709,7,0,0,2048,7,10505742661
8486,63796688493,62154,63796750647,0,0,0,100864,0,4994816481
8487,63796712814,39011,63796751825,9,0,0,13824,9,6047172614
8488,63796721808,71122,63796792930,4,0,1,8704,4,4801314492
8489,63796742197,76048,63796818245,4,0,1,10240,4,2457031846
8490,63796852561,55391,63796907952,7,0,1,2560,7,5289358777
8491,63796857284,2866,63796860150,3,0,1,1536,3,3831997797
8492,63796956852,104215,63797061067,3,0,0,8704,3,6778863518
8493,63797004833,11787,63797016620,8,0,0,19456,8,8138164001
8494,63797034001,21654,63797055655,7,0,0,35328,7,8194141871
8495,63797197046,65896,63797262942,2,0,1,7168,2,202952488
8496,63797223446,54052,63797277498,4,0,1,3584,4,7249748382
8497,63797399347,33587,63797432934,2,0,0,55296,2,7799293287
8498,63797502531,1038,63797503569,5,0,0,1024,5,5538931168
8499,63797611598,47284,63797658882,5,0,1,1536,5,6155578328
8500,63797743892,562,63797744454,4,0,0,512,4,9782869444
8501,63797763000,1038,63797764038,6,0,0,1024,6,1950939890
8502,63797774470,1514,63797775984,5,0,0,1536,5,2065228939
8503,63797823576,20620,63797844196,1,0,1,7680,1,415849991
8504,63797841661,67588,63797909249,7,0,0,33280,7,6832404979
8505,63797926800,7702,63797934502,7,0,0,8192,7,2673154619
8506,63797963069,1038,63797964107,5,0,0,1024,5,4471341947
8507,63797996451,2942,63797999393,5,0,0,3072,5,9590236152
8508,63798097924,56850,63798154774,9,0,0,97280,9,7757488525
8509,63798110096,128769,63798238865,1,0,1,13824,1,1230565519
8510,63798167114,93821,63798260935,7,0,0,152576,7,4665251686
8511,63798245945,141134,63798387079,8,0,1,6656,8,129736366
8512,63798316394,1038,63798317432,7,0,1,30208,7,2729714298
8513,63798351093,99472,63798450565,5,0,1,26624,5,8041261814
8514,63798419241,147974,63798567215,5,0,0,1024,5,1776007074
8515,63798426623,45433,63798472056,2,0,1,4608,2,5937389162
8516,63798440282,144484,63798584766,2,0,0,78336,2,31658286
8517,63798526789,61637,63798588426,7,0,0,99840,7,5469725335
8518,63798536804,57933,63798594737,1,0,0,22016,1,5950832292
8519,63798584206,17149,63798601355,2,0,0,23552,2,4279409870
8520,63798616236,34363,63798650599,8,0,1,13824,8,4898220741
8521,63798637083,26217,63798663300,8,0,0,56832,8,3976037829
8522,63798666459,175314,63798841773,2,0,0,47616,2,10624088279
8523,63798765410,130824,63798896234,4,0,1,512,4,8391252382
8524,63798904260,103858,63799008118,2,0,0,172032,2,5235040581
8525,63798934795,89183,63799023978,3,0,0,59392,3,779943825
8526,63799111635,103047,63799214682,2,0,1,4608,2,5851815914
8527,63799142267,155346,63799297613,7,0,0,252416,7,608753709
8528,63799143790,157287,63799301077,7,0,1,3072,7,6132725348
8529,63799226447,97395,63799323842,9,0,0,92672,9,3735411944
8530,63799291746,81887,63799373633,8,0,0,132608,8,6364804089
8531,63799393730,57436,63799451166,3,0,1,19968,3,1605176733
8532,63799395581,228428,63799624009,1,0,1,4096,1,10566452522
8533,63799503422,227885,63799731307,5,0,1,4608,5,10555581930
8534,63799576417,66717,63799643134,3,0,0,113152,3,8152554437
8535,63799580934,3124,63799584058,5,0,1,512,5,2748674827
8536,63799607425,88598,63799696023,4,0,1,3584,4,379814773
8537,63799620798,123380,63799744178,5,0,1,3072,5,9448538231
8538,63799675861,60820,63799736681,0,0,0,9216,0,6657529878
8539,63799729159,192307,63799921466,0,0,1,5632,0,6057338860
8540,63799803568,99340,63799902908,5,0,1,31232,5,10684248508
8541,63799853491,74356,63799927847,2,0,1,9728,2,1265717767
8542,63799909687,25700,63799935387,7,0,0,46592,7,9113476060
8543,63799942324,40612,63799982936,1,0,0,65536,1,310014134
8544,63799946668,135903,63800082571,7,0,1,11264,7,2934087888
8545,63799951866,183128,63800134994,0,0,1,13824,0,6327861793
8546,63800051987,93350,63800145337,8,0,1,5632,8,7099553852
8547,63800140002,15058,63800155060,8,0,0,29184,8,456995388
8548,63800142670,90769,63800233439,3,0,0,137728,3,3309295962
8549,63800148515,73931,63800222446,1,0,1,18944,1,6310454044
8550,63800160174,133517,63800293691,6,0,0,1024,6,6033846041
8551,63800420810,64984,63800485794,3,0,1,9216,3,4911015281
8552,63800424935,125400,63800550335,8,0,0,207360,8,2797336269
8553,63800446193,114664,63800560857,0,0,0,33792,0,92344998
8554,63800467640,93563,63800561203,5,0,0,512,5,9969806951
8555,63800524083,69096,63800593179,7,0,0,112128,7,632451145
8556,63800540524,69027,63800609551,9,0,0,53760,9,9029882035
8557,63800697100,52804,63800749904,2,0,0,86016,2,3043817484
8558,63800744253,5997,63800750250,5,0,0,512,5,2652616169
8559,63800829417,206393,63801035810,0,0,1,8192,0,4785876328
8560,63800918591,216266,63801134857,7,0,0,354304,7,1316527017
8561,63800942826,216783,63801159609,7,0,1,3584,7,2380883496
8562,63800996823,179252,63801176075,7,0,0,131584,7,8680179423
8563,63801001916,24307,63801026223,3,0,1,10752,3,7668570630
8564,63801152946,21395,63801174341,2,0,0,13824,2,2233450364
8565,63801234641,7492,63801242133,7,0,0,34816,7,1684612099
8566,63801248890,272760,63801521650,4,0,0,512,4,1050847383
8567,63801301673,81124,63801382797,2,0,1,11776,2,9539413437
8568,63801403238,6225,63801409463,4,0,1,3584,4,9862968321
8569,63801409099,103697,63801512796,0,0,0,15360,0,9938211692
8570,63801460895,172237,63801633132,8,0,0,278528,8,6583799302
8571,63801463214,123353,63801586567,5,0,1,7168,5,7748179196
8572,63801511405,212095,63801723500,5,0,0,2560,5,717403490
8573,63801602561,82662,63801685223,8,0,0,134144,8,10592534301
8574,63801668959,118877,63801787836,1,0,1,2048,1,666721399
8575,63801710722,132322,63801843044,4,0,1,20480,4,4439744223
8576,63801863600,25700,63801889300,1,0,0,46592,1,4640409036
8577,63801906443,30487,63801936930,7,0,0,49152,7,6109728852
8578,63801964626,68212,63802032838,7,0,1,9728,7,8697667373
8579,63802153038,5450,63802158488,5,0,0,13824,5,8552322717
8580,63802325940,24408,63802350348,3,0,0,44032,3,225140007
8581,63802369541,108208,63802477749,3,0,1,32256,3,4587026301
8582,63802412657,168300,63802580957,8,0,1,55296,8,860220117
8583,63802463002,117083,63802580085,2,0,0,194560,2,3690814147
8584,63802688038,6274,63802694312,3,0,1,20992,3,5802340922
8585,63802697446,21912,63802719358,8,0,0,6656,8,1942270268
8586,63802747983,97756,63802845739,3,0,0,35840,3,9320272125
8587,63802933909,55744,63802989653,1,0,1,4096,1,2140187796
8588,63802978141,15575,63802993716,0,0,1,12288,0,10676592640
8589,63803033070,93028,63803126098,3,0,0,30208,3,1749101126
8590,63803038613,55997,63803094610,7,0,0,84992,7,5498618952
8591,63803095258,5322,63803100580,0,0,0,5632,0,1918197848
8592,63803109615,217817,63803327432,0,0,0,357376,0,8970507465
8593,63803150262,177836,63803328098,6,0,0,1024,6,4942078337
8594,63803167721,79940,63803247661,5,0,1,22016,5,10197090502
8595,63803181666,73808,63803255474,1,0,1,16384,1,3574132510
8596,63803270175,100282,63803370457,8,0,0,72704,8,6485664177
8597,63803279149,83586,63803362735,4,0,1,5632,4,7293316239
8598,63803292270,93095,63803385365,1,0,0,59904,1,3281630210
8599,63803306912,35395,63803342307,3,0,0,131072,3,4361839347
8600,63803307625,24361,63803331986,4,0,1,11264,4,8482882629
8601,63803324274,138857,63803463131,6,0,0,1024,6,7218081968
8602,63803335656,285480,63803621136,3,0,0,67072,3,6323492841
8603,63803385069,281174,63803666243,0,0,1,3584,0,4580347320
8604,63803395302,23891,63803419193,6,0,0,3072,6,2779877770
8605,63803409882,189192,63803599074,5,0,0,5632,5,3964837313
8606,63803448757,52287,63803501044,8,0,1,13824,8,7626510857
8607,63803491953,200937,63803692890,3,0,1,19456,3,9451175397
8608,63803535794,427057,63803962851,9,0,0,43008,9,2412903885
8609,63803567846,273137,63803840983,0,0,1,1536,0,2788595727
8610,63803568337,111275,63803679612,2,0,0,84992,2,8889505900
8611,63803627619,175222,63803802841,0,0,1,5632,0,3913908961
8612,63803689114,79835,63803768949,0,0,0,128000,0,174492494
8613,63803843600,11529,63803855129,4,0,1,18944,4,9765544761
8614,63803916524,232180,63804148704,7,0,0,18944,7,4744675392
8615,63803997707,78084,63804075791,7,0,0,123904,7,3566584568
8616,63803997983,77819,63804075802,2,0,0,1024,2,10027883225
8617,63804065573,25183,63804090756,3,0,0,45568,3,9104532122
8618,63804071525,92985,63804164510,0,0,0,138752,0,7440851889
8619,63804086659,217809,63804304468,0,0,1,23552,0,9068863697
8620,63804087421,290062,63804377483,2,0,1,28160,2,4098344223
8621,63804212400,92898,63804305298,5,0,1,9216,5,10316154785
8622,63804312077,206755,63804518832,5,0,1,14336,5,9889723893
8623,63804479786,16609,63804496395,8,0,0,32256,8,7876015894
8624,63804481904,17717,63804499621,0,0,0,5120,0,10181451739
8625,63804483931,96317,63804580248,7,0,1,23552,7,6381609746
8626,63804496280,97092,63804593372,3,0,0,160768,3,2472669669
8627,63804504001,77884,63804581885,1,0,1,8704,1,3507951956
8628,63804563180,45155,63804608335,0,0,0,162304,0,3484110744
8629,63804578414,30059,63804608473,1,0,1,8704,1,3268773057
8630,63804584334,41904,63804626238,4,0,0,3072,4,7358521017
8631,63804617409,32302,63804649711,5,0,0,512,5,8452246489
8632,63804637894,31982,63804669876,3,0,0,25600,3,704835389
8633,63804658867,21797,63804680664,8,0,1,10240,8,825368044
8634,63804725989,325099,63805051088,8,0,0,68096,8,2842779414
8635,63804735937,1990,63804737927,6,0,0,512,6,4300264980
8636,63804736411,335338,63805071749,8,0,0,8704,8,1420426444
8637,63804739321,5322,63804744643,0,0,1,5120,0,1588788322
8638,63804747262,197187,63804944449,6,0,0,1024,6,8098399512
8639,63804812873,3547,63804816420,5,0,0,2048,5,8960787344
8640,63804836146,133392,63804969538,9,0,0,5632,9,2331857879
8641,63804852518,314519,63805167037,6,0,0,512,6,2650788959
8642,63805045278,75808,63805121086,7,0,0,127488,7,10331824556
8643,63805056005,65427,63805121432,4,0,0,512,4,5445866629
8644,63805182345,562,63805182907,5,0,0,512,5,10230933166
8645,63805275869,41387,63805317256,1,0,0,67072,1,8224763763
8646,63805301603,274003,63805575606,3,0,0,443392,3,215386540
8647,63805320999,256873,63805577872,6,0,0,3584,6,1916865507
8648,63805466457,122552,63805589009,1,0,0,45056,1,6292582392
8649,63805474440,163010,63805637450,4,0,1,2560,4,1138072805
8650,63805503815,153945,63805657760,0,0,1,2560,0,9530018163
8651,63805591939,153215,63805745154,2,0,1,7680,2,1096476566
8652,63805619836,52360,63805672196,5,0,1,2048,5,7944912216
8653,63805700165,165777,63805865942,7,0,1,3072,7,7974200489
8654,63805739086,61132,63805800218,5,0,1,6656,5,8334889146
8655,63805769136,125488,63805894624,3,0,0,204288,3,8963245998
8656,63805777090,175482,63805952572,2,0,0,187392,2,10525462655
8657,63805837830,79932,63805917762,4,0,1,18944,4,9377680789
8658,63805841051,114756,63805955807,7,0,1,25088,7,8428962056
8659,63805874586,130047,63806004633,3,0,0,3072,3,1142157042
8660,63805876052,140831,63806016883,9,0,0,124416,9,8996098589
8661,63805922511,95182,63806017693,1,0,0,205312,1,6538749080
8662,63805959307,287890,63806247197,2,0,0,162304,2,2466244773
8663,63806011267,33758,63806045025,1,0,0,22016,1,1253269865
8664,63806095319,334808,63806430127,0,0,0,58880,0,6378960793
8665,63806147922,33758,63806181680,1,0,0,58880,1,7540682591
8666,63806154886,206382,63806361268,1,0,1,18944,1,386270495
8667,63806305594,86450,63806392044,2,0,0,144896,2,4207534374
8668,63806405980,562,63806406542,5,0,0,512,5,8666491003
8669,63806424067,26475,63806450542,3,0,1,1536,3,6500417364
8670,63806535488,33071,63806568559,0,0,0,48128,0,6871760344
8671,63806566307,19264,63806585571,5,0,1,46592,5,8987876406
8672,63806592950,227922,63806820872,1,0,0,54272,1,7924392108
8673,63806607103,14541,63806621644,6,0,0,512,6,3880833604
8674,63806657871,168872,63806826743,1,0,0,28160,1,8895574953
8675,63806779540,74087,63806853627,9,0,0,120832,9,4497988551
8676,63806793607,129752,63806923359,3,0,1,9216,3,1522792761
8677,63806796022,150656,63806946678,1,0,1,20480,1,2061237790
8678,63806806051,78864,63806884915,3,0,1,12800,3,10153721885
8679,63806870778,234023,63807104801,2,0,1,2560,2,10331434861
8680,63806920535,161647,63807082182,1,0,1,10240,1,5389809250
8681,63806929435,88211,63807017646,2,0,1,5632,2,4715044639
8682,63806971136,133292,63807104428,4,0,1,4096,4,3258905485
8683,63807237200,3900,63807241100,0,0,0,10752,0,8060865109
8684,63807256121,77100,63807333221,0,0,0,130048,0,4795329089
8685,63807271929,66989,63807338918,7,0,0,27136,7,6852147489
8686,63807352035,25958,63807377993,7,0,1,512,7,4689606733
8687,63807407555,48976,63807456531,8,0,1,2048,8,4301952903
8688,63807408741,13249,63807421990,2,0,0,47104,2,9097602635
8689,63807503678,182223,63807685901,1,0,0,25600,1,3498028317
8690,63807540506,2466,63807542972,4,0,0,2560,4,2058581628
8691,63807567840,15058,63807582898,3,0,0,29184,3,3332621084
8692,63807578960,67588,63807646548,2,0,1,4608,2,9518699702
8693,63807599159,134391,63807733550,0,0,1,7680,0,8183044325
8694,63807664742,66201,63807730943,4,0,1,6656,4,2930717319
8695,63807669350,124911,63807794261,2,0,1,10240,2,7231075943
8696,63807835433,64204,63807899637,0,0,1,6656,0,6791746759
8697,63807835607,86708,63807922315,2,0,0,145408,2,7311404474
8698,63807890025,43836,63807933861,3,0,0,38912,3,89457422
8699,63807932567,13337,63807945904,9,0,0,22528,9,1047477825
8700,63807958243,56333,63808014576,7,0,0,96256,7,9689915257
8701,63807975736,39826,63808015562,5,0,0,1536,5,2855546211
8702,63807986277,167583,63808153860,7,0,1,26624,7,781543846
8703,63808216141,75808,63808291949,3,0,0,127488,3,1417219083
8704,63808358825,13079,63808371904,1,0,0,22016,1,10539241193
8705,63808375230,31003,63808406233,4,0,1,7168,4,7430320266
8706,63808427753,43900,63808471653,8,0,1,159232,8,3877224229
8707,63808429145,159702,63808588847,2,0,0,50176,2,3334418818
8708,63808456840,73999,63808530839,4,0,1,512,4,2571223588
8709,63808487258,52545,63808539803,8,0,1,18944,8,1923011689
8710,63808518935,28562,63808547497,1,0,0,123904,1,7608945100
8711,63808565018,272063,63808837081,1,0,1,2048,1,5757388967
8712,63808579509,135433,63808714942,2,0,0,85504,2,3262252862
8713,63808591956,117281,63808709237,5,0,1,7168,5,5401521030
8714,63808594957,248872,63808843829,7,0,1,1024,7,948882282
8715,63808607998,3894,63808611892,4,0,0,7168,4,10265683099
8716,63808720121,182400,63808902521,5,0,1,8704,5,7848207880
8717,63808741366,112238,63808853604,6,0,0,4096,6,614541010
8718,63808786699,45671,63808832370,3,0,0,71168,3,6921793341
8719,63808804638,31826,63808836464,2,0,0,22016,2,9198777755
8720,63808913809,562,63808914371,5,0,0,512,5,5813834618
8721,63809033158,109612,63809142770,8,0,1,59904,8,6862799576
8722,63809057863,131071,63809188934,0,0,1,5120,0,9255443733
8723,63809064361,159523,63809223884,7,0,1,14848,7,9057703455
8724,63809417265,23979,63809441244,4,0,1,8704,4,8687435589
8725,63809433605,70972,63809504577,8,0,1,15872,8,3727162450
8726,63809449457,46291,63809495748,9,0,0,39936,9,2393610799
8727,63809461333,1038,63809462371,9,0,0,79360,9,7574201891
8728,63809547998,3124,63809551122,5,0,0,1024,5,2611149881
8729,63809564865,146607,63809711472,7,0,0,9216,7,4836578612
8730,63809605002,2942,63809607944,3,0,0,3072,3,8833027107
8731,63809649176,75033,63809724209,1,0,0,125952,1,5952417654
8732,63809793201,73312,63809866513,3,0,1,7680,3,4857989133
8733,63809811792,51770,63809863562,5,0,1,16384,5,2148171120
8734,63809852645,4370,63809857015,0,0,0,83968,0,2963875526
8735,63809903414,145955,63810049369,3,0,1,9216,3,8757496344
8736,63809925948,65796,63809991744,9,0,0,4608,9,829058364
8737,63809930016,62560,63809992576,3,0,1,3072,3,8409179995
8738,63809937704,83696,63810021400,3,0,1,2560,3,8527247409
8739,63810039761,278524,63810318285,7,0,0,136192,7,9653665978
8740,63810122183,193002,63810315185,4,0,1,5120,4,7542179491
8741,63810279292,6274,63810285566,8,0,1,16384,8,3143656974
8742,63810325250,73312,63810398562,8,0,0,6656,8,7062529306
8743,63810335454,80236,63810415690,2,0,1,18944,2,8158486956
8744,63810429320,10237,63810439557,1,0,0,16384,1,4353352488
8745,63810467386,54052,63810521438,2,0,1,3584,2,10083253266
8746,63810507361,93484,63810600845,4,0,1,27136,4,2330190627
8747,63810512858,84820,63810597678,1,0,1,32768,1,849214543
8748,63810530107,113633,63810643740,5,0,1,2048,5,8540879624
8749,63810531676,132898,63810664574,5,0,1,13824,5,2229673117
8750,63810725572,562,63810726134,7,0,1,9216,7,7698893428
8751,63810731795,58840,63810790635,4,0,0,512,4,5430192718
8752,63810794921,54354,63810849275,2,0,0,89088,2,8271665464
8753,63810853409,2466,63810855875,6,0,0,2560,6,1348950765
8754,63810878997,105135,63810984132,5,0,1,23040,5,3579828452
8755,63810896819,90912,63810987731,0,0,1,11776,0,5654296264
8756,63811141801,4416,63811146217,7,0,1,6144,7,4489182794
8757,63811149740,62512,63811212252,0,0,0,11776,0,1240867342
8758,63811180437,138109,63811318546,8,0,0,228864,8,5871745316
8759,63811194360,45175,63811239535,1,0,1,2560,1,129568792
8760,63811310970,562,63811311532,9,0,0,77824,9,6556161102
8761,63811370486,22170,63811392656,6,0,0,512,6,3515652356
8762,63811375707,255998,63811631705,4,0,1,4096,4,6999825631
8763,63811398831,128912,63811527743,2,0,0,36352,2,6581583214
8764,63811559197,56850,63811616047,2,0,0,97280,2,2110128267
8765,63811599396,115010,63811714406,7,0,1,10240,7,8987340507
8766,63811634025,2866,63811636891,5,0,1,4096,5,10216321346
8767,63811715301,3418,63811718719,1,0,0,8704,1,10103537971
8768,63811758736,83128,63811841864,6,0,0,3584,6,5929848271
8769,63811761140,76325,63811837465,5,0,1,13312,5,5733109980
8770,63811787201,92840,63811880041,2,0,0,128512,2,5641533142
8771,63811798396,299133,63812097529,3,0,1,2560,3,7264278551
8772,63811830166,1514,63811831680,2,0,1,1024,2,6024153635
8773,63811843210,16609,63811859819,1,0,1,43520,1,4273242993
8774,63811950094,9020,63811959114,5,0,0,1536,5,6385766928
8775,63811985275,228150,63812213425,1,0,0,32256,1,9163713783
8776,63811992426,33758,63812026184,8,0,1,66048,8,4287796772
8777,63811994170,237329,63812231499,4,0,0,2048,4,6918439728
8778,63812009725,86127,63812095852,2,0,1,2048,2,3144063778
8779,63812021299,122627,63812143926,7,0,0,58880,7,6136259663
8780,63812026770,169900,63812196670,8,0,1,104960,8,8783834755
8781,63812034300,70734,63812105034,1,0,1,3584,1,8246894668
8782,63812125955,274480,63812400435,3,0,0,71168,3,3808336364
8783,63812139024,146236,63812285260,0,0,1,56832,0,5631901533
8784,63812168037,43208,63812211245,3,0,1,15360,3,7685644920
8785,63812247928,194326,63812442254,9,0,0,40448,9,771659102
8786,63812382153,11270,63812393423,2,0,0,18432,2,8708617775
8787,63812438826,11529,63812450355,0,0,0,18944,0,4628644415
8788,63812579827,1514,63812581341,0,0,1,12800,0,2623164024
8789,63812627776,16092,63812643868,3,0,1,13312,3,6411647744
8790,63812638364,86092,63812724456,2,0,1,23040,2,6172009093
8791,63812645787,4072,63812649859,4,0,0,1536,4,5487610033
8792,63812649653,562,63812650215,7,0,0,31232,7,231939900
8793,63812720938,2942,63812723880,5,0,0,512,5,4567443438
8794,63812729406,176507,63812905913,4,0,0,512,4,8623559281
8795,63812735119,562,63812735681,4,0,1,6656,4,6578252898
8796,63812748839,157898,63812906737,9,0,0,3072,9,9649198766
8797,63812770436,116613,63812887049,5,0,0,512,5,3565900373
8798,63812816221,114499,63812930720,7,0,0,189440,7,7526184054
8799,63812865230,66156,63812931386,5,0,0,1024,5,10114649881
8800,63812973140,97606,63813070746,4,0,1,1536,4,4486794290
8801,63813116751,114329,63813231080,7,0,0,185856,7,1083354747
8802,63813130410,4846,63813135256,5,0,1,512,5,9347826836
8803,63813236549,136390,63813372939,7,0,0,5120,7,4205395094
8804,63813310306,48976,63813359282,4,0,1,2048,4,7471154118
8805,63813321690,25958,63813347648,7,0,1,18944,7,1815763401
8806,63813361696,18852,63813380548,0,0,0,47104,0,2155315772
8807,63813374089,27094,63813401183,9,0,0,25088,9,1207288810
8808,63813378350,106364,63813484714,7,0,0,35328,7,427829237
8809,63813423402,19185,63813442587,0,0,0,28160,0,10416552442
8810,63813499852,36342,63813536194,9,0,0,64000,9,10465157388
8811,63813521937,75342,63813597279,3,0,1,3072,3,3231067492
8812,63813636001,199296,63813835297,2,0,1,8704,2,226055916
8813,63813723262,2942,63813726204,7,0,0,3072,7,8326761511
8814,63813913873,5967,63813919840,2,0,0,14848,2,1029520772
8815,63813919564,10237,63813929801,7,0,1,19968,7,6388545938
8816,63813982330,107398,63814089728,1,0,0,16384,1,9889861622
8817,63813996838,75808,63814072646,1,0,0,127488,1,2469923381
8818,63814117407,101188,63814218595,5,0,1,32256,5,9808247891
8819,63814138499,144614,63814283113,7,0,1,26112,7,7114829663
8820,63814381166,12562,63814393728,1,0,1,10240,1,3026426176
8821,63814432365,2942,63814435307,3,0,0,20992,3,4796326154
8822,63814444823,76048,63814520871,4,0,0,3072,4,9003051146
8823,63814456612,74681,63814531293,9,0,0,120832,9,157337496
8824,63814523871,192186,63814716057,4,0,1,2560,4,1415790220
8825,63814657393,64908,63814722301,3,0,0,109568,3,8525614363
8826,63814659356,66491,63814725847,6,0,0,5632,6,3956372765
8827,63814664654,61539,63814726193,5,0,0,512,5,4033564211
8828,63814690937,51731,63814742668,9,0,0,54272,9,8760527982
8829,63814825071,1038,63814826109,5,0,0,1024,5,9306439255
8830,63814838706,3124,63814841830,8,0,0,9216,8,4771829035
8831,63814930039,45592,63814975631,3,0,1,1024,3,2835904452
8832,63814960371,54520,63815014891,0,0,1,5120,0,5821796311
8833,63815024482,101620,63815126102,1,0,0,164352,1,5460171931
8834,63815063901,73747,63815137648,7,0,0,38912,7,2975741533
8835,63815102268,73999,63815176267,1,0,0,123904,1,7558642016
8836,63815118965,44360,63815163325,5,0,1,1024,5,8742236234
8837,63815135773,72552,63815208325,7,0,0,6144,7,5561812785
8838,63815198411,1514,63815199925,5,0,0,1536,5,7946086087
8839,63815250051,1990,63815252041,9,0,0,2048,9,10108289812
8840,63815320775,154431,63815475206,7,0,1,17408,7,9766687067
8841,63815507210,7702,63815514912,1,0,0,8192,1,8197326455
8842,63815511671,562,63815512233,3,0,1,13312,3,4257139228
8843,63815549328,83128,63815632456,6,0,0,512,6,7533573409
8844,63815648170,16350,63815664520,8,0,0,31744,8,8805290706
8845,63815666820,95711,63815762531,7,0,1,12288,7,6212232054
8846,63815722574,2288,63815724862,1,0,1,8704,1,2102890582
8847,63815762225,1038,63815763263,5,0,0,2048,5,574321780
8848,63815771495,58684,63815830179,5,0,0,1024,5,2547158750
8849,63815779680,2942,63815782622,0,0,1,8192,0,4736803663
8850,63815790842,69314,63815860156,5,0,0,3072,5,4169436550
8851,63815879249,2466,63815881715,5,0,0,2560,5,705129791
8852,63815929485,88204,63816017689,4,0,1,14848,4,8134305530
8853,63816103871,43900,63816147771,5,0,1,512,5,2602925410
8854,63816196910,1038,63816197948,7,0,0,1024,7,968929828
8855,63816260580,43712,63816304292,9,0,0,71680,9,9500306259
8856,63816265473,39485,63816304958,7,0,0,1024,7,8156150291
8857,63816416729,12045,63816428774,1,0,0,19968,1,1145560681
8858,63816436053,1038,63816437091,6,0,0,1024,6,9273817597
8859,63816440079,43900,63816483979,7,0,1,512,7,345097927
8860,63816568230,562,63816568792,6,0,0,512,6,4231504921
8861,63816569981,54520,63816624501,7,0,1,5120,7,6590237366
8862,63816573726,75531,63816649257,1,0,1,10752,1,2082650572
8863,63816713471,74068,63816787539,7,0,1,13824,7,6345002068
8864,63816742517,64479,63816806996,1,0,0,105472,1,1263707031
8865,63816803054,210554,63817013608,7,0,1,7680,7,9450229890
8866,63817105016,91276,63817196292,1,0,1,14848,1,2790084160
8867,63817220786,1990,63817222776,5,0,0,2048,5,9729268614
8868,63817299863,1514,63817301377,6,0,0,1536,6,3301207786
8869,63817310630,72664,63817383294,0,0,1,9216,0,10021600571
8870,63817366613,56056,63817422669,0,0,1,5120,0,8490755962
8871,63817401818,60926,63817462744,3,0,1,4608,3,7520449777
8872,63817455849,51187,63817507036,2,0,1,1536,2,6573376860
8873,63817539451,1514,63817540965,6,0,0,1536,6,3124686270
8874,63817554310,49132,63817603442,1,0,1,2560,1,1671942207
8875,63817576904,54372,63817631276,4,0,1,2048,4,3915662511
8876,63817648467,33758,63817682225,8,0,0,58880,8,2668670314
8877,63817736796,562,63817737358,5,0,0,512,5,3876713342
8878,63817797940,56850,63817854790,2,0,0,97280,2,4737213053
8879,63817930362,45950,63817976312,8,0,0,79360,8,4059437439
8880,63818100282,96329,63818196611,8,0,1,24064,8,2174529699
8881,63818226309,16092,63818242401,8,0,0,31232,8,1837881214
8882,63818259806,562,63818260368,7,0,0,512,7,3497296754
8883,63818277354,52287,63818329641,8,0,0,84992,8,10572082346
8884,63818292745,30074,63818322819,4,0,1,3072,4,5863731606
8885,63818294660,22950,63818317610,4,0,1,6656,4,5870742456
8886,63818306288,105655,63818411943,9,0,0,32256,9,7251740016
8887,63818318904,1990,63818320894,8,0,0,17920,8,1760054176
8888,63818414335,144961,63818559296,7,0,0,2048,7,3332957934
8889,63818644643,1990,63818646633,0,0,1,22528,0,10547477936
8890,63818678464,98224,63818776688,5,0,0,2048,5,8440699382
8891,63818734099,67900,63818801999,2,0,1,8704,2,4118255919
8892,63818791500,47440,63818838940,0,0,1,2048,0,10570551962
8893,63818840243,1990,63818842233,2,0,1,512,2,542877662
8894,63818881657,43900,63818925557,6,0,0,2048,6,8688671034
8895,63818913945,1990,63818915935,9,0,0,2048,9,4005209489
8896,63818957674,107734,63819065408,2,0,0,179712,2,814588600
8897,63818978865,87209,63819066074,5,0,0,1024,5,8651475561
8898,63818992716,154631,63819147347,3,0,1,5632,3,5666671669
8899,63818998644,232490,63819231134,8,0,1,92672,8,2458144301
8900,63819177139,55634,63819232773,7,0,1,2048,7,5315131055
8901,63819303174,1990,63819305164,0,0,1,2560,0,1146677470
8902,63819335219,47596,63819382815,1,0,1,5120,1,2000930687
8903,63819336338,59128,63819395466,4,0,0,2048,4,3499031895
8904,63819380622,59397,63819440019,4,0,1,1536,4,8159842673
8905,63819400425,562,63819400987,8,0,1,97792,8,2162795069
8906,63819487577,138384,63819625961,7,0,0,512,7,10621825419
8907,63819514663,25652,63819540315,0,0,0,1536,0,9703200713
8908,63819558299,1038,63819559337,1,0,1,6656,1,449764383
8909,63819561330,62668,63819623998,7,0,0,1024,7,6796666284
8910,63819627892,562,63819628454,0,0,1,4096,0,5794627619
8911,63819638046,55744,63819693790,8,0,1,17408,8,3757233165
8912,63819669988,1038,63819671026,3,0,0,512,3,3346071828
8913,63819694559,75160,63819769719,5,0,0,1024,5,3951461362
8914,63819708038,7626,63819715664,0,0,0,2560,0,7637760031
8915,63819897697,1038,63819898735,5,0,0,1024,5,3651043023
8916,63819953436,77296,63820030732,2,0,1,14336,2,1996329912
8917,63819993975,35308,63820029283,8,0,1,35328,8,469404332
8918,63820031144,112615,63820143759,2,0,1,29696,2,2845718810
8919,63820056701,100408,63820157109,2,0,0,61952,2,8583988005
8920,63820081783,164437,63820246220,8,0,0,266752,8,1953840210
8921,63820103657,169406,63820273063,3,0,0,87552,3,10277856223
8922,63820120358,158504,63820278862,0,0,0,27648,0,7939261917
8923,63820275462,25442,63820300904,0,0,0,46080,0,10420075851
8924,63820292188,183912,63820476100,2,0,0,297984,2,8360828861
8925,63820313916,178630,63820492546,0,0,1,46080,0,335829814
8926,63820327928,43971,63820371899,4,0,1,1536,4,3204527453
8927,63820403580,374378,63820777958,8,0,1,169984,8,3086273773
8928,63820504579,336517,63820841096,5,0,1,2560,5,7725973227
8929,63820527995,236309,63820764304,8,0,1,192000,8,2021271806
8930,63820589535,5728,63820595263,9,0,0,72192,9,10336776340
8931,63820739069,8173,63820747242,5,0,0,10752,5,2025235001
8932,63820739418,4370,63820743788,6,0,0,3584,6,8159543118
8933,63820831886,445580,63821277466,0,0,0,4608,0,5461118141
8934,63821029950,65896,63821095846,1,0,1,7168,1,2334355271
8935,63821139624,62068,63821201692,5,0,1,9728,5,5147957462
8936,63821153852,48475,63821202327,2,0,1,2048,2,6055383740
8937,63821245519,20362,63821265881,0,0,0,32768,0,8049364113
8938,63821299635,40870,63821340505,7,0,1,1536,7,983936854
8939,63821302298,27452,63821329750,0,0,0,66048,0,2357535927
8940,63821317342,13766,63821331108,4,0,0,2560,4,8629973695
8941,63821334789,1038,63821335827,1,0,1,2560,1,9331114437
8942,63821340157,70683,63821410840,3,0,1,1536,3,3678944297
8943,63821343181,96076,63821439257,0,0,0,26624,0,8519528654
8944,63821347698,110493,63821458191,1,0,1,7680,1,489270107
8945,63821406011,174519,63821580530,5,0,0,1024,5,8711263955
8946,63821545518,2942,63821548460,8,0,0,3072,8,10592363131
8947,63821684477,113554,63821798031,2,0,0,184320,2,8599171953
8948,63821694788,23721,63821718509,8,0,1,5632,8,6619149904
8949,63821818792,156190,63821974982,2,0,0,39424,2,5168809176
8950,63821821301,52918,63821874219,1,0,0,74240,1,9514885176
8951,63821872182,163218,63822035400,4,0,1,3072,4,967067036
8952,63821956084,94995,63822051079,3,0,1,7168,3,5785895131
8953,63821959773,80844,63822040617,2,0,1,6144,2,2192489388
8954,63822040086,167041,63822207127,2,0,1,8192,2,9978100370
8955,63822137627,92080,63822229707,7,0,1,22528,7,1099089828
8956,63822267277,34363,63822301640,3,0,0,56832,3,6305041140
8957,63822309612,1038,63822310650,5,0,0,1024,5,1946832079
8958,63822420572,54520,63822475092,7,0,1,5120,7,9392226681
8959,63822422061,44229,63822466290,4,0,1,34304,4,4134521994
8960,63822447666,101812,63822549478,8,0,0,72704,8,7188718908
8961,63822593715,47284,63822640999,1,0,1,1536,1,8125020436
8962,63822621227,31779,63822653006,3,0,0,51712,3,3383478827
8963,63822781671,15058,63822796729,8,0,1,71168,8,8724394562
8964,63822798623,113044,63822911667,3,0,0,29184,3,360746840
8965,63822983983,55744,63823039727,3,0,1,12800,3,2918909212
8966,63822994814,79900,63823074714,4,0,1,4096,4,8437287559
8967,63823069076,10237,63823079313,8,0,0,16384,8,1067601224
8968,63823115318,1514,63823116832,4,0,1,15872,4,1397043224
8969,63823142171,82372,63823224543,5,0,1,34816,5,5249754155
8970,63823149096,110785,63823259881,6,0,0,1536,6,3632568941
8971,63823436478,1038,63823437516,7,0,0,1024,7,4982958314
8972,63823449967,23374,63823473341,7,0,1,7680,7,6978959315
8973,63823477479,59908,63823537387,2,0,0,41984,2,813990949
8974,63823572689,48976,63823621665,4,0,1,2048,4,7197704135
8975,63823576137,90052,63823666189,1,0,1,15872,1,4490290971
8976,63823623151,1990,63823625141,4,0,1,16384,4,9815896565
8977,63823675511,4846,63823680357,4,0,0,2048,4,7828207737
8978,63823709698,5798,63823715496,9,0,0,5120,9,2960571821
8979,63823734907,123750,63823858657,4,0,0,6144,4,5477119815
8980,63823760234,108364,63823868598,1,0,1,5120,1,6019410826
8981,63823775032,2942,63823777974,8,0,1,55808,8,8340229818
8982,63823875756,56608,63823932364,5,0,1,2048,5,3241162948
8983,63823880557,176320,63824056877,3,0,1,5120,3,5817431270
8984,63823904899,77843,63823982742,2,0,1,12288,2,5753381013
8985,63823928157,68992,63823997149,4,0,0,3072,4,8378228935
8986,63824004648,1038,63824005686,7,0,1,17408,7,4028237970
8987,63824037299,81304,63824118603,6,0,0,1024,6,4179516305
8988,63824129096,61627,63824190723,3,0,1,512,3,3934155418
8989,63824145226,99160,63824244386,1,0,1,25600,1,3286866493
8990,63824308653,65452,63824374105,4,0,1,10752,4,3662712370
8991,63824405750,562,63824406312,4,0,0,512,4,8700249177
8992,63824548756,33499,63824582255,8,0,0,58368,8,8415610422
8993,63824574877,42679,63824617556,0,0,0,69632,0,4041835790
8994,63824590049,29133,63824619182,5,0,0,2560,5,2709231671
8995,63824703408,1514,63824704922,6,0,0,1536,6,4750701708
8996,63824711508,4846,63824716354,0,0,0,5120,0,9438733557
8997,63824790225,99042,63824889267,4,0,1,3584,4,4871592740
8998,63824901354,1038,63824902392,7,0,0,1024,7,1576514687
8999,63824940652,49288,63824989940,1,0,1,3072,1,8745831098
9000,63824963939,121870,63825085809,8,0,0,197120,8,8422753814
9001,63825017161,1990,63825019151,8,0,1,237056,8,6431817400
9002,63825050310,75291,63825125601,2,0,1,6656,2,6214512889
9003,63825114477,209461,63825323938,0,0,0,2048,0,2322378330
9004,63825151007,340458,63825491465,9,0,0,126464,9,9829191772
9005,63825159388,181766,63825341154,4,0,1,17408,4,1266438586
9006,63825175864,126373,63825302237,0,0,0,170496,0,3282423458
9007,63825231276,43788,63825275064,2,0,0,111616,2,4159874368
9008,63825314446,204202,63825518648,7,0,0,512,7,7202938015
9009,63825326352,37249,63825363601,5,0,0,512,5,8841422236
9010,63825343617,3844,63825347461,7,0,1,8704,7,6686957233
9011,63825362215,13596,63825375811,9,0,0,2560,9,10299476937
9012,63825364147,44240,63825408387,8,0,1,188928,8,4695035099
9013,63825414539,209894,63825624433,2,0,0,23040,2,3383205194
9014,63825421268,562,63825421830,5,0,1,512,5,10258550072
9015,63825564917,313738,63825878655,4,0,0,512,4,1522016196
9016,63825586294,64520,63825650814,1,0,1,26624,1,431352804
9017,63825613400,45111,63825658511,8,0,0,102912,8,9568084135
9018,63825636234,127303,63825763537,4,0,0,3584,4,3467397510
9019,63825644753,20878,63825665631,3,0,1,45056,3,10621048529
9020,63825656435,193435,63825849870,8,0,1,33280,8,10177783190
9021,63825773499,1514,63825775013,2,0,0,33792,2,9111558953
9022,63825858392,233198,63826091590,5,0,0,1536,5,5709098810
9023,63825953458,55817,63826009275,0,0,0,95232,0,1232001102
9024,63826034518,69991,63826104509,4,0,1,2560,4,176136146
9025,63826143602,76159,63826219761,5,0,1,12288,5,3239043860
9026,63826195624,4370,63826199994,7,0,1,2048,7,819200809
9027,63826197772,48976,63826246748,8,0,1,12288,8,885314863
9028,63826227816,76060,63826303876,0,0,0,4608,0,1795596077
9029,63826263145,91753,63826354898,2,0,0,148480,2,4276232102
9030,63826320454,115397,63826435851,0,0,1,10240,0,5500376531
9031,63826457010,14800,63826471810,4,0,1,10240,4,204655390
9032,63826465903,95718,63826561621,0,0,1,512,0,8111160831
9033,63826517637,94974,63826612611,2,0,0,28672,2,1307408718
9034,63826560584,52360,63826612944,3,0,1,3072,3,9462360866
9035,63826664319,3418,63826667737,3,0,1,12288,3,1202041418
9036,63826672457,79744,63826752201,1,0,1,12800,1,5472395256
9037,63826715049,75517,63826790566,5,0,0,3584,5,830435697
9038,63826825607,2866,63826828473,3,0,0,8704,3,10613388359
9039,63826846449,2942,63826849391,5,0,0,3072,5,4184318597
9040,63826881814,12045,63826893859,2,0,0,19968,2,992318894
9041,63826921178,562,63826921740,4,0,0,512,4,9917686036
9042,63826925379,2942,63826928321,7,0,0,3072,7,2163558172
9043,63826965219,1990,63826967209,8,0,1,133120,8,3406268533
9044,63826977249,138064,63827115313,7,0,0,2048,7,6253823412
9045,63827122193,1038,63827123231,3,0,0,1024,3,5317974672
9046,63827228935,43454,63827272389,8,0,0,71168,8,2854091449
9047,63827410048,2466,63827412514,4,0,0,2560,4,700278138
9048,63827447140,79432,63827526572,0,0,1,11264,0,6467173825
9049,63827535041,2466,63827537507,6,0,0,2560,6,2958564713
9050,63827633298,33241,63827666539,8,0,0,57856,8,2753576205
9051,63827725257,1038,63827726295,4,0,0,1024,4,6899101090
9052,63827868861,4416,63827873277,1,0,0,11776,1,7643659627
9053,63827912498,59128,63827971626,3,0,1,5120,3,7566325649
9054,63828006421,1514,63828007935,2,0,1,7168,2,6158804523
9055,63828010685,65896,63828076581,5,0,0,1536,5,5327567080
9056,63828124691,95025,63828219716,2,0,0,158208,2,656539371
9057,63828189959,45208,63828235167,1,0,0,57344,1,8627718764
9058,63828328313,174408,63828502721,5,0,1,41472,5,1958167877
9059,63828501125,188771,63828689896,1,0,0,307712,1,3912708683
9060,63828513230,187291,63828700521,1,0,0,34304,1,3706370150
9061,63828625261,75926,63828701187,4,0,0,1024,4,6343857326
9062,63828681717,19816,63828701533,6,0,0,512,6,544149853
9063,63828747306,54096,63828801402,2,0,1,15360,2,5016170342
9064,63828755513,29605,63828785118,2,0,0,88576,2,6263287761
9065,63828784510,21654,63828806164,7,0,0,7168,7,6507811272
9066,63828816670,181462,63828998132,1,0,1,6144,1,5323578604
9067,63828817754,115795,63828933549,1,0,0,35328,1,5909721059
9068,63828887419,230301,63829117720,0,0,1,21504,0,2098023762
9069,63828908530,4519,63828913049,8,0,1,174080,8,4976944361
9070,63829113839,271019,63829384858,0,0,1,49152,0,8305955568
9071,63829114256,562,63829114818,5,0,0,1024,5,1413486073
9072,63829200853,118954,63829319807,4,0,0,512,4,726147611
9073,63829232130,562,63829232692,1,0,1,6144,1,3183491504
9074,63829261280,63167,63829324447,5,0,0,512,5,6697754281
9075,63829295746,50668,63829346414,3,0,1,2560,3,5322730217
9076,63829372064,562,63829372626,0,0,0,512,0,4507384184
9077,63829386052,60064,63829446116,5,0,1,42496,5,4102826591
9078,63829402162,104308,63829506470,1,0,1,8192,1,8578642418
9079,63829482302,1038,63829483340,3,0,1,13312,3,6260853182
9080,63829496656,4370,63829501026,2,0,1,1024,2,6338364572
9081,63829506663,44056,63829550719,7,0,0,1024,7,6935914387
9082,63829514660,94250,63829608910,1,0,0,4608,1,5768239362
9083,63829582228,3418,63829585646,7,0,0,3584,7,4743272705
9084,63829619221,562,63829619783,7,0,1,16896,7,1989372963
9085,63829659930,2466,63829662396,5,0,0,512,5,5412733067
9086,63829671715,13596,63829685311,7,0,0,2560,7,5697390832
9087,63829687774,91900,63829779674,2,0,0,23040,2,6510920871
9088,63829693554,59776,63829753330,1,0,1,8192,1,190744440
9089,63829863467,562,63829864029,6,0,0,512,6,100396087
9090,63829873727,3894,63829877621,4,0,0,4096,4,8407131590
9091,63829960377,4370,63829964747,4,0,0,4608,4,360374579
9092,63830038828,1038,63830039866,3,0,1,3584,3,446382324
9093,63830058221,54052,63830112273,4,0,0,1024,4,1662765391
9094,63830103167,4933,63830108100,2,0,0,12800,2,2357143733
9095,63830134706,1038,63830135744,8,0,1,57344,8,801214715
9096,63830148080,562,63830148642,7,0,0,1024,7,7619204059
9097,63830229778,2866,63830232644,6,0,0,512,6,7607092479
9098,63830235274,138233,63830373507,0,0,0,8704,0,2559180674
9099,63830285002,56592,63830341594,2,0,0,96768,2,461011824
9100,63830292244,5657,63830297901,0,0,1,98816,0,32740846
9101,63830304438,2466,63830306904,2,0,1,66048,2,563055030
9102,63830315451,45433,63830360884,2,0,1,7168,2,337610567
9103,63830336283,5322,63830341605,5,0,0,512,5,2058900257
9104,63830343927,114132,63830458059,3,0,0,2560,3,5939114572
9105,63830347871,6274,63830354145,3,0,0,78336,3,3085430032
9106,63830350793,253477,63830604270,5,0,1,65536,5,120962176
9107,63830358337,214907,63830573244,8,0,1,16896,8,2117699322
9108,63830401781,281397,63830683178,6,0,0,5632,6,7716464848
9109,63830453852,158822,63830612674,1,0,1,16384,1,9120077930
9110,63830454909,1038,63830455947,7,0,1,7680,7,3550438501
9111,63830472838,177753,63830650591,9,0,0,6656,9,6729962897
9112,63830592755,280205,63830872960,3,0,1,10752,3,5054873258
9113,63830608112,14025,63830622137,3,0,1,1536,3,3932011467
9114,63830614624,69442,63830684066,4,0,1,1536,4,1526587581
9115,63830619733,116267,63830736000,4,0,0,1024,4,1725317049
9116,63830649807,166021,63830815828,8,0,0,27136,8,5209568145
9117,63830722651,64204,63830786855,7,0,1,13312,7,7267293285
9118,63830727476,105097,63830832573,3,0,1,6656,3,3711614000
9119,63830983376,4370,63830987746,1,0,0,4608,1,4232166462
9120,63831019638,1038,63831020676,4,0,1,41984,4,7008824927
9121,63831076758,4158,63831080916,9,0,0,1024,9,2086167996
9122,63831096078,104152,63831200230,1,0,0,11264,1,9506772365
9123,63831187987,1990,63831189977,3,0,1,23040,3,5540124082
9124,63831253724,562,63831254286,6,0,0,2048,6,3817651998
9125,63831264584,98380,63831362964,5,0,0,512,5,6204416503
9126,63831370163,67588,63831437751,4,0,1,7680,4,476943344
9127,63831483866,5192,63831489058,8,0,0,13312,8,4300024250
9128,63831543643,2466,63831546109,0,0,1,329728,0,8215875883
9129,63831612484,562,63831613046,6,0,0,2560,6,4464463363
9130,63831638100,12991,63831651091,9,0,0,512,9,2500604184
9131,63831650620,562,63831651182,1,0,0,25088,1,3061846541
9132,63831683855,290470,63831974325,9,0,0,512,9,4455423664
9133,63831734363,188531,63831922894,4,0,1,7168,4,10246223208
9134,63831739782,15058,63831754840,8,0,1,56320,8,3027091680
9135,63831908255,2942,63831911197,1,0,0,29184,1,6859735186
9136,63831932892,110392,63832043284,8,0,1,62464,8,2694451159
9137,63831933380,350782,63832284162,4,0,0,3072,4,6705792900
9138,63832121972,84400,63832206372,8,0,1,22528,8,6143576934
9139,63832162512,72846,63832235358,1,0,1,5632,1,8369301389
9140,63832206444,43971,63832250415,0,0,1,114176,0,10352079535
9141,63832243404,126148,63832369552,3,0,0,72192,3,2218601498
9142,63832388696,1514,63832390210,4,0,0,1536,4,7226081308
9143,63832419059,1038,63832420097,7,0,0,1024,7,7047841556
9144,63832513178,47284,63832560462,4,0,1,14848,4,7932195891
9145,63832521818,75916,63832597734,4,0,1,1536,4,3244754844
9146,63832595696,5708,63832601404,3,0,0,14336,3,1406093320
9147,63832636682,1514,63832638196,6,0,0,1536,6,8191339599
9148,63832660328,204937,63832865265,2,0,0,332288,2,3594485187
9149,63832739678,186824,63832926502,0,0,1,7168,0,6319280349
9150,63832865425,215316,63833080741,1,0,1,27648,1,5659002751
9151,63832959737,121015,63833080752,8,0,0,186368,8,8701746407
9152,63833023719,91721,63833115440,1,0,0,139264,1,5454594457
9153,63833124740,1514,63833126254,4,0,0,1536,4,7863969051
9154,63833179401,1514,63833180915,3,0,1,8192,3,4237185055
9155,63833209104,1038,63833210142,6,0,0,1536,6,823119387
9156,63833251495,127280,63833378775,7,0,0,1024,7,441426193
9157,63833421853,7702,63833429555,8,0,0,8192,8,7136980523
9158,63833426590,52360,63833478950,4,0,1,4096,4,2786045380
9159,63833429272,56301,63833485573,3,0,1,3072,3,9080705440
9160,63833468708,48976,63833517684,2,0,1,2048,2,1120910264
9161,63833534126,57436,63833591562,7,0,1,4608,7,10406821681
9162,63833597573,44229,63833641802,3,0,1,12288,3,1588233047
9163,63833598637,68992,63833667629,1,0,0,72704,1,6890810905
9164,63833633374,34533,63833667907,0,0,0,60416,0,10362373151
9165,63833636541,36192,63833672733,6,0,0,7680,6,5230075262
9166,63833637796,21971,63833659767,2,0,1,9728,2,8056038821
9167,63833651108,88432,63833739540,4,0,0,512,4,5752930744
9168,63833818817,7226,63833826043,1,0,0,7680,1,6116925422
9169,63834103557,2466,63834106023,4,0,0,2560,4,3233376189
9170,63834144481,3894,63834148375,1,0,1,3584,1,5348120249
9171,63834152558,50980,63834203538,2,0,1,18432,2,4093929327
9172,63834179234,1038,63834180272,6,0,0,4096,6,8405060517
9173,63834204038,80080,63834284118,5,0,0,1024,5,5343135926
9174,63834417065,3383,63834420448,2,0,0,9728,2,995526739
9175,63834419089,108929,63834528018,8,0,1,28160,8,6937916766
9176,63834567489,1990,63834569479,7,0,0,2048,7,4208684829
9177,63834618916,99628,63834718544,4,0,1,27136,4,8997387380
9178,63834906711,127240,63835033951,8,0,1,117760,8,4800591436
9179,63835118741,50824,63835169565,3,0,1,3072,3,2888447674
9180,63835212355,1038,63835213393,9,0,0,1024,9,6544367192
9181,63835223162,4370,63835227532,4,0,0,4608,4,7745869662
9182,63835337842,48976,63835386818,2,0,1,2048,2,7665942820
9183,63835437904,24408,63835462312,1,0,0,44032,1,9282146775
9184,63835527335,64204,63835591539,8,0,1,6656,8,6896719781
9185,63835546679,64984,63835611663,5,0,1,7168,5,9031772059
9186,63835585326,83179,63835668505,8,0,0,135168,8,9597582946
9187,63835672009,136041,63835808050,3,0,1,1536,3,8825051686
9188,63835686245,108531,63835794776,2,0,0,224768,2,6776728877
9189,63835720066,6484,63835726550,3,0,0,30208,3,7179509427
9190,63835841429,254949,63836096378,2,0,0,15872,2,10576640910
9191,63835911122,67234,63835978356,1,0,0,114176,1,8009548531
9192,63836065447,48976,63836114423,4,0,1,18944,4,296267294
9193,63836105402,117213,63836222615,4,0,1,2048,4,7486984158
9194,63836179222,5420,63836184642,7,0,0,2048,7,8630871944
9195,63836239554,32983,63836272537,8,0,0,57344,8,2892274933
9196,63836240205,32678,63836272883,5,0,0,512,5,5603735616
9197,63836331433,228100,63836559533,0,0,1,130560,0,1222758589
9198,63836450418,29902,63836480320,5,0,1,14848,5,10375728946
9199,63836450745,124889,63836575634,4,0,1,10752,4,10014594976
9200,63836473237,103017,63836576254,7,0,1,3072,7,5813814647
9201,63836531154,128796,63836659950,9,0,0,1536,9,10366319100
9202,63836532255,69142,63836601397,1,0,0,67072,1,2889490459
9203,63836607184,5798,63836612982,9,0,0,6144,9,6335831675
9204,63836741730,1038,63836742768,6,0,0,1024,6,9609480198
9205,63836756638,1514,63836758152,6,0,0,1536,6,933905460
9206,63836953299,2942,63836956241,4,0,0,3072,4,4447349630
9207,63836956636,21137,63836977773,0,0,0,34304,0,2327398978
9208,63837021026,84729,63837105755,3,0,0,138240,3,3436070669
9209,63837075174,32207,63837107381,5,0,0,2560,5,6991091746
9210,63837246173,16609,63837262782,5,0,1,6656,5,8429235940
9211,63837255418,64204,63837319622,2,0,0,32256,2,8915758105
9212,63837271329,103687,63837375016,0,0,0,168448,0,2284748859
9213,63837308136,57064,63837365200,0,0,1,15360,0,8872635960
9214,63837323853,40870,63837364723,8,0,0,19968,8,6542907445
9215,63837399284,228332,63837627616,1,0,0,66048,1,322430648
9216,63837419307,163882,63837583189,2,0,1,10240,2,3929000181
9217,63837591771,1514,63837593285,7,0,0,1536,7,4937489159
9218,63837697756,76360,63837774116,3,0,1,11264,3,7189633833
9219,63837794806,1038,63837795844,6,0,0,1024,6,7386258888
9220,63837821456,73571,63837895027,0,0,0,119808,0,672148281
9221,63838046817,87225,63838134042,3,0,0,146432,3,645036832
9222,63838068117,92358,63838160475,3,0,0,93696,3,2522772807
9223,63838125234,20845,63838146079,8,0,1,114176,8,8119601803
9224,63838140032,23633,63838163665,8,0,1,78336,8,2054912854
9225,63838141256,256971,63838398227,8,0,0,2560,8,613321916
9226,63838149905,306568,63838456473,8,0,1,35328,8,8972569561
9227,63838176603,112525,63838289128,4,0,1,1536,4,4803082403
9228,63838190635,255689,63838446324,2,0,1,1024,2,1344623877
9229,63838194921,293162,63838488083,0,0,1,79360,0,4434656003
9230,63838240315,242812,63838483127,5,0,1,12800,5,4437798919
9231,63838247338,312286,63838559624,1,0,0,42496,1,10628612637
9232,63838319288,52287,63838371575,1,0,0,129536,1,1075631661
9233,63838461988,343918,63838805906,1,0,0,84992,1,10538729204
9234,63838491175,128433,63838619608,2,0,1,11264,2,5734327274
9235,63838546589,82920,63838629509,3,0,0,134656,3,2926893860
9236,63838550433,90622,63838641055,2,0,0,38912,2,3427994300
9237,63838720437,11012,63838731449,7,0,1,17408,7,8504934342
9238,63838755600,110189,63838865789,0,0,0,17920,0,6564175889
9239,63838795555,52014,63838847569,8,0,1,139776,8,6671899814
9240,63838796927,57347,63838854274,7,0,1,2560,7,1192930996
9241,63838826333,30643,63838856976,2,0,0,86528,2,8825967585
9242,63838858183,28037,63838886220,0,0,0,8192,0,2169944809
9243,63838861455,2942,63838864397,9,0,0,1024,9,5680483287
9244,63838917900,213827,63839131727,5,0,0,3072,5,4660490652
9245,63838941368,149741,63839091109,7,0,1,5120,7,2792993813
9246,63838943306,162005,63839105311,4,0,1,37888,4,5822365960
9247,63839070324,40870,63839111194,0,0,0,66048,0,7530070987
9248,63839116238,65896,63839182134,3,0,1,8192,3,7687004612
9249,63839153103,114857,63839267960,7,0,1,7168,7,4386193040
9250,63839233083,2466,63839235549,4,0,1,6656,4,1496297057
9251,63839248838,64204,63839313042,4,0,1,4096,4,3382849934
9252,63839251478,55744,63839307222,7,0,0,2560,7,2619123591
9253,63839332716,79432,63839412148,5,0,1,11264,5,6380995524
9254,63839446251,41645,63839487896,3,0,1,3584,3,7241429843
9255,63839457080,23490,63839480570,2,0,0,67584,2,776119401
9256,63839475581,54052,63839529633,7,0,0,512,7,4165462521
9257,63839485149,25571,63839510720,8,0,0,39424,8,1861766984
9258,63839608662,562,63839609224,8,0,0,512,8,2022641834
9259,63839615054,1990,63839617044,9,0,0,2048,9,1792402010
9260,63839618807,46725,63839665532,0,0,0,80896,0,8888141173
9261,63839628626,73809,63839702435,2,0,1,4608,2,120436559
9262,63839773980,94084,63839868064,5,0,1,24064,5,8476948095
9263,63839860985,562,63839861547,5,0,1,5632,5,134491917
9264,63839883336,67891,63839951227,7,0,0,512,7,4629083355
9265,63839988768,55744,63840044512,3,0,1,4096,3,5792542411
9266,63840043007,49444,63840092451,7,0,1,3584,7,7694410970
9267,63840189239,1990,63840191229,6,0,0,2048,6,7841189177
9268,63840226848,1514,63840228362,5,0,0,1536,5,3685595504
9269,63840252244,1514,63840253758,4,0,0,1536,4,8976849605
9270,63840335880,69304,63840405184,4,0,1,13312,4,4842322383
9271,63840453155,1990,63840455145,3,0,1,19456,3,7554191993
9272,63840491698,97288,63840588986,5,0,0,2048,5,6524400801
9273,63840541976,64391,63840606367,2,0,0,108544,2,4332532183
9274,63840583473,1990,63840585463,4,0,1,2560,4,4992154078
9275,63840672183,191764,63840863947,8,0,1,60416,8,8954359780
9276,63840701163,53749,63840754912,4,0,0,2048,4,6661030818
9277,63840755526,14240,63840769766,1,0,0,91136,1,4218322149
9278,63840795701,177856,63840973557,9,0,0,1024,9,8717494107
9279,63840840943,9650,63840850593,4,0,0,512,4,9619277292
9280,63840881845,115016,63840996861,2,0,0,190464,2,10594714175
9281,63840990603,109625,63841100228,0,0,1,17408,0,3215181764
9282,63841169322,45592,63841214914,3,0,1,1024,3,6175793285
9283,63841204028,23204,63841227232,0,0,1,235520,0,8957780287
9284,63841257154,41645,63841298799,0,0,0,38400,0,680549373
9285,63841290898,212272,63841503170,8,0,0,67584,8,8790181262
9286,63841336642,121144,63841457786,7,0,1,4096,7,559366419
9287,63841576532,77896,63841654428,4,0,1,11264,4,4997276041
9288,63841710525,5798,63841716323,5,0,0,6144,5,5484079719
9289,63841770475,1038,63841771513,4,0,0,1024,4,791673072
9290,63841890742,85288,63841976030,7,0,1,15360,7,5427018009
9291,63841967099,80212,63842047311,4,0,1,13824,4,5284089256
9292,63842039134,4416,63842043550,4,0,1,2048,4,587539460
9293,63842041673,562,63842042235,0,0,1,147456,0,8820304474
9294,63842058457,100667,63842159124,0,0,1,1024,0,9819377254
9295,63842088369,182368,63842270737,3,0,0,11776,3,10476228181
9296,63842131233,165907,63842297140,5,0,0,512,5,222780394
9297,63842163465,62782,63842226247,5,0,1,6144,5,6796330242
9298,63842248683,55744,63842304427,3,0,1,4096,3,7186884395
9299,63842306237,1514,63842307751,4,0,0,1536,4,6852010974
9300,63842306260,3117,63842309377,6,0,0,2560,6,3624469922
9301,63842432007,73312,63842505319,2,0,1,16384,2,7888480492
9302,63842517478,22858,63842540336,1,0,0,40960,1,9764783369
9303,63842607697,2942,63842610639,1,0,0,3072,1,10717842548
9304,63842712237,34533,63842746770,3,0,0,60416,3,4927092111
9305,63842877779,3418,63842881197,6,0,0,3584,6,520531971
9306,63843020532,64072,63843084604,3,0,1,11264,3,9137049136
9307,63843155373,24238,63843179611,0,0,1,102400,0,8791314782
9308,63843185147,122560,63843307707,8,0,0,40448,8,2333545588
9309,63843255891,44480,63843300371,3,0,0,36864,3,3220968379
9310,63843271078,13079,63843284157,2,0,1,45056,2,4523433616
9311,63843327471,43900,63843371371,0,0,0,22016,0,3435161555
9312,63843330284,152395,63843482679,8,0,1,52224,8,2828690350
9313,63843361669,237529,63843599198,7,0,1,512,7,6202276685
9314,63843552964,67201,63843620165,7,0,1,3072,7,9328945477
9315,63843655770,63962,63843719732,1,0,0,104448,1,1592487596
9316,63843656186,83866,63843740052,0,0,1,274944,0,2780426950
9317,63843691379,562,63843691941,0,0,0,139776,0,3446363968
9318,63843720539,373500,63844094039,8,0,1,90112,8,4721777337
9319,63843784877,342209,63844127086,7,0,0,512,7,3785316559
9320,63843899950,136921,63844036871,0,0,1,74240,0,4373876912
9321,63843975483,15058,63843990541,0,0,1,18944,0,10020306504
9322,63844045589,174391,63844219980,0,0,1,75776,0,2373183653
9323,63844153900,342661,63844496561,1,0,0,29184,1,10008758022
9324,63844181394,154571,63844335965,1,0,0,250880,1,1271574468
9325,63844251425,84886,63844336311,6,0,0,512,6,10382439709
9326,63844312633,29170,63844341803,9,0,0,26112,9,748246856
9327,63844363419,4846,63844368265,4,0,0,5120,4,2037143682
9328,63844385634,76583,63844462217,2,0,0,129024,2,9097950331
9329,63844449706,116277,63844565983,2,0,1,512,2,4203608407
9330,63844480370,34016,63844514386,2,0,1,12288,2,3446783926
9331,63844548393,110705,63844659098,9,0,0,59392,9,2587295456
9332,63844615879,40612,63844656491,2,0,1,5120,2,7414520151
9333,63844616745,29379,63844646124,2,0,0,65536,2,2717424624
9334,63844629284,32037,63844661321,6,0,0,2048,6,4631545758
9335,63844701065,174961,63844876026,9,0,0,52224,9,1507565720
9336,63844801901,1038,63844802939,6,0,0,1024,6,4058219046
9337,63844822911,24238,63844847149,3,0,1,30720,3,6914257020
9338,63844872614,105798,63844978412,0,0,0,40448,0,7020326390
9339,63844943086,72347,63845015433,4,0,1,5120,4,5278901
9340,63845033178,64672,63845097850,2,0,1,8192,2,5790647185
9341,63845067809,105712,63845173521,2,0,1,47104,2,9350282259
9342,63845161294,59503,63845220797,4,0,1,1536,4,10435423262
9343,63845195867,5322,63845201189,0,0,1,49664,0,10229624564
9344,63845232056,109056,63845341112,2,0,1,20992,2,4446279153
9345,63845263772,146731,63845410503,3,0,0,5632,3,1954231886
9346,63845444780,32295,63845477075,2,0,0,52736,2,147722810
9347,63845468321,9420,63845477741,6,0,0,1024,6,5080517208
9348,63845481038,43900,63845524938,3,0,1,512,3,10460855996
9349,63845575485,45692,63845621177,2,0,0,78848,2,4839775840
9350,63845635933,5450,63845641383,4,0,0,13824,4,3433706542
9351,63845641101,205248,63845846349,5,0,1,7168,5,2848515152
9352,63845814824,52360,63845867184,5,0,1,3072,5,2329877017
9353,63845903953,91237,63845995190,2,0,0,147456,2,7190241988
9354,63845935826,104337,63846040163,6,0,1,2560,6,6095613410
9355,63845999960,56075,63846056035,4,0,0,95744,4,6010555331
9356,63846024575,38181,63846062756,0,0,0,32256,0,2651644555
9357,63846105119,562,63846105681,5,0,0,512,5,9920158925
9358,63846159029,135525,63846294554,2,0,0,223744,2,1443719961
9359,63846235132,38104,63846273236,2,0,1,15872,2,10128638570
9360,63846257218,31003,63846288221,3,0,0,11776,3,1318814788
9361,63846299788,7575,63846307363,2,0,0,50176,2,6645455848
9362,63846301218,107785,63846409003,7,0,1,1536,7,8331052503
9363,63846326122,1038,63846327160,5,0,0,4608,5,2569904615
9364,63846384180,130373,63846514553,0,0,1,33792,0,1722557871
9365,63846386965,11787,63846398752,3,0,0,1024,3,6715735877
9366,63846420017,11344,63846431361,3,0,1,11264,3,10164105425
9367,63846436849,131491,63846568340,1,0,0,19456,1,2403921973
9368,63846437638,1990,63846439628,7,0,0,512,7,2468335230
9369,63846535590,146306,63846681896,6,0,0,2048,6,9015163858
9370,63846545160,65945,63846611105,6,0,1,2560,6,1944307125
9371,63846591223,45592,63846636815,7,0,1,1024,7,9612476253
9372,63846705378,167192,63846872570,9,0,0,275456,9,7771242825
9373,63846724375,140183,63846864558,7,0,1,10752,7,10049224002
9374,63846733053,137810,63846870863,6,0,0,1024,6,9959188451
9375,63846777258,26782,63846804040,0,0,0,142848,0,9930042582
9376,63846895007,223273,63847118280,8,0,0,32256,8,6741493183
9377,63846966639,182855,63847149494,2,0,1,8704,2,3345031627
9378,63847027220,162447,63847189667,3,0,1,11264,3,4138161920
9379,63847125321,62929,63847188250,6,0,1,36864,6,6959241857
9380,63847144578,17667,63847162245,4,0,0,102400,4,7171728422
9381,63847196561,20362,63847216923,1,0,0,32256,1,2873023675
9382,63847216521,124061,63847340582,8,0,0,32768,8,556404492
9383,63847246177,78230,63847324407,4,0,0,125952,4,10168865252
9384,63847291130,54680,63847345810,9,0,0,77824,9,7670014986
9385,63847322611,26745,63847349356,1,0,0,5632,1,3344304898
9386,63847334682,15545,63847350227,2,0,0,12288,2,4125209919
9387,63847339329,11884,63847351213,5,0,0,1536,5,10301043492
9388,63847389306,78330,63847467636,4,0,1,2560,4,10400218071
9389,63847389519,91804,63847481323,7,0,1,2048,7,3109674278
9390,63847457668,5322,63847462990,0,0,1,126464,0,5589729067
9391,63847486030,562,63847486592,6,0,0,5632,6,7745737164
9392,63847649858,23462,63847673320,3,0,0,512,3,1711980392
9393,63847660437,31779,63847692216,4,0,0,38912,4,7426008326
9394,63847678849,88360,63847767209,6,0,1,15360,6,998659973
9395,63847696412,74965,63847771377,6,0,1,4096,6,4485451877
9396,63847699892,88473,63847788365,7,0,1,1536,7,2754146725
9397,63847712455,410064,63848122519,4,0,0,51712,4,3031429910
9398,63847861305,8885,63847870190,7,0,0,2560,7,6276649565
9399,63848313587,562,63848314149,6,0,0,512,6,10155346271
9400,63848356637,2942,63848359579,6,0,0,3072,6,10300179976
9401,63848467821,1990,63848469811,3,0,0,2048,3,6689682425
9402,63848505052,4370,63848509422,6,0,0,4608,6,8614701456
9403,63848606127,562,63848606689,4,0,0,512,4,5339735565
9404,63848652545,88072,63848740617,2,0,1,19456,2,4330009284
9405,63848784620,562,63848785182,6,0,0,512,6,1565741666
9406,63848825559,67234,63848892793,0,0,0,114176,0,9018374398
9407,63848852097,61484,63848913581,9,0,0,74752,9,10316061404
9408,63848892242,22005,63848914247,1,0,0,11264,1,3948054840
9409,63848945591,264912,63849210503,8,0,0,429056,8,4569379248
9410,63848974794,4416,63848979210,3,0,1,14848,3,5365296819
9411,63849056284,239796,63849296080,0,0,1,16384,0,64947183
9412,63849261039,325821,63849586860,2,0,0,11776,2,7605046257
9413,63849281787,3900,63849285687,8,0,1,86528,8,3342693651
9414,63849325068,195246,63849520314,1,0,0,10752,1,7004931257
9415,63849450846,27234,63849478080,5,0,0,1024,5,4668298436
9416,63849453763,24663,63849478426,6,0,0,512,6,727179081
9417,63849481744,1514,63849483258,5,0,1,10240,5,2285615098
9418,63849481900,68524,63849550424,0,0,1,89600,0,1541456961
9419,63849492570,1038,63849493608,6,0,0,1536,6,1314006290
9420,63849564305,118660,63849682965,3,0,0,1024,3,1205695813
9421,63849578980,23086,63849602066,7,0,0,1536,7,4008960038
9422,63849600761,81624,63849682385,7,0,1,11776,7,3998160999
9423,63849654665,140748,63849795413,8,0,1,44032,8,1420017194
9424,63849812344,3124,63849815468,0,0,0,9216,0,4722757088
9425,63849845971,1038,63849847009,5,0,0,1024,5,10253125498
9426,63849850348,4370,63849854718,3,0,0,4608,3,3802014189
9427,63849952524,1990,63849954514,2,0,1,13312,2,9457249779
9428,63849963302,72376,63850035678,3,0,1,6144,3,912381411
9429,63849978632,85868,63850064500,5,0,0,2048,5,10026947324
9430,63850058487,1038,63850059525,1,0,0,1024,1,2793328174
9431,63850146193,197050,63850343243,4,0,0,323584,4,1019068758
9432,63850214082,140400,63850354482,2,0,0,45568,2,3938853448
9433,63850395842,127984,63850523826,2,0,0,212480,2,5520079964
9434,63850413807,47648,63850461455,0,0,1,47104,0,1967672986
9435,63850481324,48976,63850530300,7,0,0,8192,7,6935638708
9436,63850606318,22607,63850628925,4,0,1,2048,4,8330942990
9437,63850633742,302008,63850935750,6,0,1,19456,6,6350143525
9438,63850654849,88020,63850742869,8,0,0,36352,8,6513425002
9439,63850708628,562,63850709190,5,0,1,4608,5,7478375737
9440,63850756495,58471,63850814966,6,0,0,512,6,4605905063
9441,63850822384,562,63850822946,6,0,1,4608,6,7076426709
9442,63850843591,55900,63850899491,7,0,0,512,7,2481317823
9443,63850865435,21654,63850887089,2,0,1,15360,2,2692179825
9444,63850901454,71464,63850972918,0,0,0,35328,0,7449509512
9445,63850998038,562,63850998600,9,0,0,512,9,7577682592
9446,63851027390,30487,63851057877,8,0,0,49152,8,6575827777
9447,63851029681,63402,63851093083,5,0,1,2560,5,10449672943
9448,63851044010,57436,63851101446,5,0,1,4608,5,5344945874
9449,63851128629,1514,63851130143,1,0,0,1536,1,2025585012
9450,63851181805,110548,63851292353,5,0,1,62976,5,740891272
9451,63851249042,50668,63851299710,5,0,1,2560,5,9310540868
9452,63851299766,54525,63851354291,9,0,0,92672,9,8121250658
9453,63851451222,72664,63851523886,7,0,1,9216,7,9434484862
9454,63851511718,3714,63851515432,3,0,1,28672,3,7571061146
9455,63851521202,100096,63851621298,4,0,0,1024,4,1301784476
9456,63851564571,106492,63851671063,0,0,1,49664,0,1207617614
9457,63851704888,112420,63851817308,0,0,1,69120,0,6627098164
9458,63851795471,21848,63851817319,6,0,0,1024,6,8178819527
9459,63851822400,1514,63851823914,8,0,1,44544,8,7865371216
9460,63851830900,1038,63851831938,7,0,0,1536,7,10193174091
9461,63851870102,113908,63851984010,6,0,1,33280,6,4467563027
9462,63851915275,111314,63852026589,7,0,0,1024,7,8780820345
9463,63851970181,59128,63852029309,4,0,1,5120,4,8628721551
9464,63852078467,562,63852079029,0,0,1,277504,0,6309579312
9465,63852144686,251176,63852395862,2,0,1,2048,2,10141030414
9466,63852204118,185600,63852389718,3,0,0,512,3,4886593592
9467,63852255064,1038,63852256102,5,0,1,172544,5,4174485210
9468,63852365193,267655,63852632848,7,0,0,1024,7,8744950328
9469,63852543509,32812,63852576321,2,0,0,53760,2,6498693409
9470,63852550500,32030,63852582530,2,0,0,21504,2,5760914273
9471,63852556053,56270,63852612323,3,0,1,3072,3,7379557800
9472,63852844218,3894,63852848112,8,0,1,2560,8,8644907159
9473,63852860576,50668,63852911244,3,0,1,2048,3,6927902096
9474,63852883042,48976,63852932018,1,0,0,4096,1,10117928745
9475,63852959033,48976,63853008009,4,0,1,20480,4,4901991160
9476,63852967358,2466,63852969824,6,0,1,2048,6,7266778755
9477,63853042599,97600,63853140199,6,0,0,2560,6,6216884605
9478,63853112798,102748,63853215546,8,0,1,37376,8,9117081079
9479,63853124630,103429,63853228059,8,0,0,167936,8,9864814898
9480,63853126127,138119,63853264246,0,0,0,123904,0,5906227418
9481,63853127623,1514,63853129137,5,0,1,10752,5,7459400092
9482,63853140280,3894,63853144174,2,0,1,7168,2,2034645721
9483,63853265946,245259,63853511205,1,0,0,1536,1,8911978459
9484,63853314071,241719,63853555790,0,0,0,4096,0,9554588117
9485,63853355410,36600,63853392010,9,0,0,64512,9,10607240656
9486,63853374987,53715,63853428702,8,0,0,87552,8,10130572540
9487,63853437446,562,63853438008,7,0,1,512,7,5871442277
9488,63853460084,82090,63853542174,5,0,0,512,5,4117928333
9489,63853596299,62154,63853658453,9,0,0,100864,9,10712448138
9490,63853673449,152245,63853825694,8,0,1,158208,8,8327966394
9491,63853704588,53090,63853757678,9,0,0,246272,9,4832642478
9492,63853804673,6800,63853811473,7,0,1,5120,7,9079810063
9493,63853814470,1514,63853815984,8,0,0,34816,8,10137100975
9494,63853861426,285024,63854146450,5,0,0,1024,5,8241237597
9495,63853867733,193674,63854061407,6,0,0,1536,6,1213338186
9496,63854008073,126175,63854134248,8,0,0,208896,8,5800705815
9497,63854033597,67148,63854100745,2,0,1,9216,2,2786834220
9498,63854069046,160350,63854229396,1,0,0,3072,1,7611905674
9499,63854111546,185675,63854297221,8,0,1,43520,8,8445471694
9500,63854162072,179735,63854341807,2,0,1,12288,2,6205353179
9501,63854327723,130672,63854458395,5,0,1,129024,5,1425759714
9502,63854452966,562,63854453528,0,0,1,13312,0,7168009797
9503,63854479163,2466,63854481629,7,0,0,512,7,7840107379
9504,63854522039,88549,63854610588,3,0,0,2560,3,335514839
9505,63854526931,35050,63854561981,8,0,0,61440,8,368348225
9506,63854656661,1990,63854658651,5,0,0,2048,5,5938115402
9507,63854681875,5322,63854687197,5,0,0,5632,5,8447069640
9508,63854883260,1514,63854884774,3,0,0,1536,3,2875905292
9509,63854947219,56212,63855003431,7,0,1,5632,7,6831610421
9510,63855051379,54008,63855105387,2,0,1,35328,2,8894211442
9511,63855052288,102124,63855154412,0,0,0,91648,0,7562958931
9512,63855073074,43971,63855117045,8,0,1,18944,8,8609471071
9513,63855117851,137528,63855255379,6,0,1,1536,6,170799553
9514,63855159726,46208,63855205934,4,0,0,72192,4,453850861
9515,63855246049,181012,63855427061,8,0,0,79872,8,8101647842
9516,63855274039,2942,63855276981,5,0,1,5632,5,1709194110
9517,63855348596,1038,63855349634,1,0,0,3072,1,10119209669
9518,63855369353,255006,63855624359,3,0,1,3584,3,2168825987
9519,63855500637,166748,63855667385,1,0,0,1024,1,10524214247
9520,63855533899,4846,63855538745,3,0,0,5120,3,4790620566
9521,63855555138,562,63855555700,7,0,0,512,7,6569703613
9522,63855577518,1038,63855578556,5,0,1,394240,5,3390274608
9523,63855671308,330094,63856001402,7,0,0,1024,7,3522401445
9524,63855795552,113257,63855908809,5,0,1,19968,5,3997559202
9525,63855811738,151635,63855963373,6,0,1,4096,6,2792353267
9526,63855825959,134340,63855960299,2,0,0,51200,2,4999704091
9527,63855833185,27560,63855860745,9,0,0,72704,9,9192557610
9528,63855889500,204913,63856094413,3,0,1,27136,3,4364318099
9529,63855941271,182611,63856123882,6,0,0,2048,6,2945653533
9530,63856007607,102361,63856109968,0,0,1,16384,0,3341894373
9531,63856058910,75292,63856134202,5,0,1,12800,5,9283952553
9532,63856122508,1514,63856124022,6,0,1,17408,6,1516314663
9533,63856128472,1990,63856130462,3,0,1,6656,3,924179984
9534,63856132912,87180,63856220092,4,0,1,14848,4,3850045260
9535,63856187649,109351,63856297000,3,0,0,1536,3,6525871915
9536,63856212512,13596,63856226108,5,0,0,2048,5,6862061182
9537,63856308377,207922,63856516299,4,0,0,23040,4,6929234573
9538,63856322671,7770,63856330441,9,0,0,7168,9,2696909288
9539,63856490960,60820,63856551780,7,0,1,5632,7,7091539649
9540,63856576339,49132,63856625471,7,0,1,2560,7,1076848767
9541,63856657876,1990,63856659866,7,0,0,2048,7,10320107321
9542,63856696183,4370,63856700553,7,0,1,7680,7,678155074
9543,63856727957,67588,63856795545,1,0,0,4608,1,9132908542
9544,63856764391,2942,63856767333,1,0,0,3072,1,2449232603
9545,63856985789,83866,63857069655,8,0,0,139776,8,8351839315
9546,63856992764,82178,63857074942,9,0,0,25088,9,9984048569
9547,63857050965,53062,63857104027,8,0,1,98304,8,9714549360
9548,63857089373,562,63857089935,0,0,0,86528,0,8275481353
9549,63857301826,1038,63857302864,3,0,0,512,3,8221426608
9550,63857323729,317173,63857640902,5,0,0,1024,5,2613702932
9551,63857362977,6191,63857369168,3,0,0,1024,3,5554128531
9552,63857390327,1038,63857391365,6,0,1,37376,6,7529843162
9553,63857424351,102748,63857527099,5,0,0,1024,5,4531247139
9554,63857484361,10696,63857495057,1,0,0,2048,1,10453679241
9555,63857494132,5708,63857499840,2,0,1,3072,2,112225102
9556,63857527750,52360,63857580110,0,0,0,14336,0,914951555
9557,63857573635,70216,63857643851,7,0,1,11264,7,5726571758
9558,63857732452,53062,63857785514,9,0,0,86528,9,1748676628
9559,63857981569,77140,63858058709,6,0,1,13824,6,892020857
9560,63858061994,3894,63858065888,7,0,0,4096,7,5939818847
9561,63858085493,98848,63858184341,5,0,1,24576,5,2676500891
9562,63858284045,562,63858284607,5,0,1,60928,5,3860282982
9563,63858314150,3894,63858318044,6,0,0,512,6,1136348427
9564,63858334809,109924,63858444733,7,0,0,4096,7,6231728299
9565,63858351439,42541,63858393980,2,0,0,48128,2,2893050247
9566,63858414659,5967,63858420626,9,0,0,14848,9,2777961658
9567,63858577455,6484,63858583939,8,0,0,15872,8,184373311
9568,63858758340,3894,63858762234,7,0,0,4096,7,6011465786
9569,63858846792,562,63858847354,5,0,0,512,5,9057293259
9570,63858948571,52287,63859000858,0,0,0,84992,0,4766915488
9571,63858952772,49366,63859002138,2,0,0,14336,2,5828667069
9572,63859045638,106442,63859152080,2,0,0,177152,2,10727221466
9573,63859077648,77018,63859154666,7,0,0,4096,7,366299912
9574,63859106825,73660,63859180485,8,0,0,82432,8,8861724706
9575,63859109002,6274,63859115276,8,0,1,360448,8,2877558309
9576,63859176188,53579,63859229767,4,0,1,25088,4,8529204411
9577,63859177665,11787,63859189452,4,0,1,2048,4,3303111630
9578,63859198728,562,63859199290,3,0,0,6656,3,2073258935
9579,63859206101,224428,63859430529,2,0,0,87552,2,6623288286
9580,63859265133,5833,63859270966,3,0,1,19456,3,5944232817
9581,63859292650,428280,63859720930,4,0,0,19456,4,9610790340
9582,63859383634,126321,63859509955,1,0,0,512,1,9754594255
9583,63859395337,360263,63859755600,3,0,0,512,3,1656831094
9584,63859410972,278734,63859689706,2,0,0,48128,2,182515273
9585,63859538282,1038,63859539320,0,0,1,78848,0,582052320
9586,63859568542,205931,63859774473,3,0,1,23040,3,2983035063
9587,63859649698,229665,63859879363,5,0,0,1024,5,8338831642
9588,63859887471,1038,63859888509,1,0,0,1024,1,2945092896
9589,63859910915,2466,63859913381,7,0,0,2560,7,2500499549
9590,63859959964,562,63859960526,7,0,1,14848,7,2529596815
9591,63860002457,71308,63860073765,6,0,0,512,6,1025221100
9592,63860070871,104374,63860175245,0,0,0,173056,0,5120214083
9593,63860091643,83948,63860175591,7,0,0,512,7,10249659432
9594,63860098570,88875,63860187445,9,0,0,40448,9,1013911901
9595,63860152242,1038,63860153280,6,0,1,14848,6,4112641501
9596,63860246479,132464,63860378943,6,0,0,1024,6,2485579851
9597,63860338140,26217,63860364357,0,0,0,47616,0,10367201856
9598,63860368272,2466,63860370738,6,0,1,2048,6,4614317426
9599,63860396750,102363,63860499113,5,0,0,2560,5,4790665230
9600,63860459342,45592,63860504934,2,0,1,1024,2,6852917067
9601,63860493483,164696,63860658179,0,0,0,267264,0,2348588635
9602,63860558069,100776,63860658845,7,0,0,1024,7,10173192435
9603,63860564818,88862,63860653680,2,0,1,22528,2,8670682966
9604,63860570649,217906,63860788555,3,0,0,1024,3,338476401
9605,63860620522,51253,63860671775,5,0,1,99840,5,3237530877
9606,63860728186,143264,63860871450,2,0,1,3584,2,4024289769
9607,63860742605,64479,63860807084,2,0,0,82944,2,4214648499
9608,63860833813,318656,63861152469,0,0,0,105472,0,414858400
9609,63860845144,94053,63860939197,8,0,0,110080,8,243606390
9610,63860858552,196470,63861055022,3,0,1,8704,3,7598358665
9611,63860914384,562,63860914946,2,0,1,10752,2,2658712734
9612,63860955181,163897,63861119078,3,0,1,15872,3,9779958537
9613,63860978993,222878,63861201871,5,0,1,43520,5,2967272380
9614,63861078917,269737,63861348654,5,0,0,512,5,4322827076
9615,63861104845,131735,63861236580,6,0,1,33280,6,7286270344
9616,63861140323,261767,63861402090,5,0,1,207360,5,10616468640
9617,63861186138,145786,63861331924,0,0,1,221184,0,4603879091
9618,63861267859,14839,63861282698,2,0,1,37888,2,4467547661
9619,63861401740,338777,63861740517,6,0,0,3072,6,6558834168
9620,63861546167,562,63861546729,7,0,0,512,7,4617596869
9621,63861560442,61912,63861622354,2,0,1,9216,2,8637298581
9622,63861678384,2942,63861681326,3,0,0,3072,3,8897004547
9623,63861782912,84820,63861867732,3,0,1,13824,3,402635230
9624,63861867682,7268,63861874950,7,0,0,7680,7,9887503614
9625,63861897383,1038,63861898421,1,0,0,1024,1,645009662
9626,63862013652,70972,63862084624,6,0,1,8704,6,685043137
9627,63862072192,67588,63862139780,4,0,1,7680,4,3210396482
9628,63862149394,14541,63862163935,0,0,1,147456,0,2076579022
9629,63862150628,61637,63862212265,8,0,0,28160,8,5705215141
9630,63862181077,33241,63862214318,2,0,0,99840,2,3970536913
9631,63862217449,198353,63862415802,6,0,1,15360,6,8171059728
9632,63862257730,192188,63862449918,9,0,0,57856,9,1068230774
9633,63862362208,63995,63862426203,4,0,1,3072,4,6314189326
9634,63862368501,62412,63862430913,8,0,1,68096,8,504572632
9635,63862419928,146976,63862566904,0,0,0,101376,0,1105778165
9636,63862674532,55900,63862730432,3,0,1,4608,3,3839966647
9637,63862761610,2466,63862764076,3,0,0,2560,3,720180152
9638,63862790407,2466,63862792873,3,0,0,2560,3,7992996297
9639,63862897049,1990,63862899039,5,0,0,2048,5,1940016894
9640,63862912290,23374,63862935664,9,0,0,41984,9,913504438
9641,63862917691,48827,63862966518,9,0,0,67072,9,2204711726
9642,63863017307,1038,63863018345,6,0,0,1024,6,2073897920
9643,63863036295,2466,63863038761,5,0,1,53248,5,7069305044
9644,63863117325,53919,63863171244,4,0,1,1024,4,10093352854
9645,63863151445,2942,63863154387,5,0,0,2560,5,4149251427
9646,63863186146,172365,63863358511,4,0,0,3072,4,6406880421
9647,63863214799,34363,63863249162,4,0,0,56832,4,6955223319
9648,63863245474,76852,63863322326,4,0,1,17920,4,1282443728
9649,63863297286,84508,63863381794,8,0,1,423424,8,879831439
9650,63863327791,2942,63863330733,0,0,1,12800,0,10334022113
9651,63863474871,562,63863475433,1,0,0,3072,1,4585103035
9652,63863489897,75033,63863564930,1,0,0,512,1,6980132002
9653,63863511073,88920,63863599993,2,0,0,125952,2,850414165
9654,63863513149,38381,63863551530,4,0,0,59904,4,4195444156
9655,63863580572,474024,63864054596,0,0,0,56320,0,7120225267
9656,63863659689,169049,63863828738,7,0,1,4608,7,2858759888
9657,63863670573,129102,63863799675,3,0,1,5632,3,2349040991
9658,63863693024,52931,63863745955,8,0,1,45568,8,9053892012
9659,63863699647,161574,63863861221,4,0,0,95744,4,10706824183
9660,63863739834,148311,63863888145,2,0,1,10752,2,2748937921
9661,63863775844,1514,63863777358,1,0,0,2048,1,4869340349
9662,63863790744,143200,63863933944,2,0,1,3584,2,1747145035
9663,63863889652,276727,63864166379,7,0,0,1536,7,8255280404
9664,63864050972,1514,63864052486,6,0,0,1536,6,9917361237
9665,63864158843,33329,63864192172,0,0,0,54784,0,2303656792
9666,63864213152,83954,63864297106,0,0,1,256512,0,504386836
9667,63864265891,1990,63864267881,0,0,0,136704,0,4599650537
9668,63864350808,16609,63864367417,1,0,0,2048,1,5680949707
9669,63864371984,1160,63864373144,0,0,0,32256,0,4088065519
9670,63864388099,562,63864388661,5,0,0,1024,5,525526724
9671,63864390672,54096,63864444768,7,0,0,512,7,639250173
9672,63864403088,352779,63864755867,9,0,0,88576,9,6435874853
9673,63864409212,133758,63864542970,6,0,1,5120,6,10005341813
9674,63864432184,128386,63864560570,9,0,0,133120,9,451891747
9675,63864437204,158312,63864595516,7,0,1,9728,7,7263425616
9676,63864437567,112808,63864550375,9,0,0,3584,9,3996198528
9677,63864460232,151737,63864611969,3,0,1,2560,3,8462974121
9678,63864716847,106648,63864823495,8,0,1,50176,8,237069783
9679,63864754507,115890,63864870397,8,0,1,21504,8,1463874090
9680,63864847454,59128,63864906582,7,0,1,5120,7,8086464768
9681,63864855629,1514,63864857143,5,0,1,15360,5,6889876648
9682,63864922594,79144,63865001738,1,0,0,1536,1,9965762721
9683,63864951439,562,63864952001,1,0,0,512,1,6165463222
9684,63864969705,104776,63865074481,2,0,1,44032,2,10356976872
9685,63865072698,4241,63865076939,5,0,0,2560,5,9282226042
9686,63865175966,562,63865176528,5,0,0,512,5,2424358901
9687,63865184071,1038,63865185109,5,0,0,1024,5,3354010842
9688,63865227468,562,63865228030,5,0,1,18944,5,2206933710
9689,63865248225,79311,63865327536,1,0,0,512,1,6140315752
9690,63865313841,59752,63865373593,0,0,1,7168,0,825377468
9691,63865370026,3578,63865373604,7,0,0,2560,7,9847588094
9692,63865405866,3383,63865409249,1,0,0,9728,1,8148135681
9693,63865461763,1038,63865462801,6,0,0,1024,6,186181499
9694,63865489727,2466,63865492193,6,0,1,4096,6,4242320698
9695,63865502733,60574,63865563307,1,0,0,2560,1,419292566
9696,63865529735,2879,63865532614,0,0,1,110592,0,5287782392
9697,63865549404,6274,63865555678,5,0,0,2048,5,9262457582
9698,63865567536,562,63865568098,2,0,0,6656,2,5231190995
9699,63865585801,3894,63865589695,6,0,0,512,6,5562602900
9700,63865592896,228390,63865821286,0,0,0,4096,0,3174930760
9701,63865662004,86499,63865748503,7,0,1,3584,7,345783504
9702,63865671637,2466,63865674103,0,0,0,119296,0,833884837
9703,63865782295,149554,63865931849,6,0,0,2560,6,2497848294
9704,63865815643,115533,63865931176,8,0,1,94720,8,8532706914
9705,63865847898,138506,63865986404,8,0,0,191488,8,9253177117
9706,63865893031,98998,63865992029,2,0,0,203776,2,10496152304
9707,63865904050,65290,63865969340,0,0,1,8192,0,9141379533
9708,63865932885,260340,63866193225,6,0,0,512,6,5354880492
9709,63865964944,216567,63866181511,0,0,1,109568,0,2591287687
9710,63865966939,1514,63865968453,7,0,0,512,7,7818373202
9711,63866132925,32295,63866165220,5,0,0,1536,5,8963237684
9712,63866153526,311517,63866465043,6,0,1,22016,6,2715630080
9713,63866156836,186031,63866342867,8,0,0,52736,8,6314816807
9714,63866240893,26475,63866267368,6,0,1,39936,6,9500172776
9715,63866367794,212113,63866579907,8,0,0,48128,8,9724412577
9716,63866475392,3894,63866479286,5,0,1,171520,5,1475414252
9717,63866536902,192772,63866729674,8,0,1,333312,8,9276019031
9718,63866550706,41876,63866592582,1,0,0,4096,1,6715337087
9719,63866552243,562,63866552805,0,0,1,109568,0,1686340472
9720,63866648984,348324,63866997308,8,0,0,37376,8,9330151038
9721,63866667336,252739,63866920075,0,0,1,106496,0,9158514750
9722,63866671167,401235,63867072402,0,0,1,16384,0,8386407348
9723,63866688339,146761,63866835100,5,0,1,247808,5,3817188716
9724,63866741405,71991,63866813396,6,0,0,512,6,10683031462
9725,63866753666,207538,63866961204,7,0,1,4608,7,4357814992
9726,63866806736,123720,63866930456,9,0,0,62976,9,2916497486
9727,63866819974,412239,63867232213,0,0,1,221184,0,2748688110
9728,63866881517,487463,63867368980,9,0,0,6144,9,3878944552
9729,63866886303,466330,63867352633,5,0,1,380416,5,10378482835
9730,63866913366,555371,63867468737,9,0,0,139264,9,4630258264
9731,63867180075,239626,63867419701,0,0,1,151552,0,5497364945
9732,63867203151,26475,63867229626,7,0,1,3584,7,10437885019
9733,63867284532,227738,63867512270,6,0,1,8192,6,4152936854
9734,63867443373,414941,63867858314,2,0,0,48128,2,8386579468
9735,63867577067,74791,63867651858,8,0,0,97280,8,9614078305
9736,63867633077,19447,63867652524,6,0,0,1024,6,10372975701
9737,63867723851,1990,63867725841,4,0,1,26624,4,8685019509
9738,63867727654,1990,63867729644,0,0,1,5632,0,3716547957
9739,63867739344,5322,63867744666,5,0,0,2048,5,1074214363
9740,63867747245,59284,63867806529,3,0,0,2048,3,4453135252
9741,63867749602,2466,63867752068,1,0,0,5632,1,2274337362
9742,63867818758,154538,63867973296,1,0,0,2560,1,3087750678
9743,63867825600,58060,63867883660,6,0,1,6656,6,5398619354
9744,63867854934,72388,63867927322,6,0,1,7680,6,6118604001
9745,63867862392,81887,63867944279,0,0,0,132608,0,7098190195
9746,63867923443,25022,63867948465,6,0,0,6656,6,2553998376
9747,63868137856,1514,63868139370,3,0,1,6656,3,10279364790
9748,63868180203,56524,63868236727,6,0,0,1536,6,5580378574
9749,63868202526,75291,63868277817,4,0,0,126464,4,10334465682
9750,63868233618,44865,63868278483,6,0,0,1024,6,493692916
9751,63868244698,2339,63868247037,8,0,1,295424,8,6913611436
9752,63868247419,61120,63868308539,7,0,1,10240,7,9694276302
9753,63868276490,150289,63868426779,5,0,0,512,5,4875570343
9754,63868306584,370443,63868677027,4,0,0,98816,4,8761807187
9755,63868333170,281982,63868615152,2,0,0,338944,2,2184437406
9756,63868368007,165840,63868533847,7,0,1,3584,7,3129332012
9757,63868449323,157210,63868606533,9,0,0,92160,9,8430603180
9758,63868457972,248278,63868706250,2,0,0,54272,2,7669616989
9759,63868573524,45186,63868618710,9,0,0,2560,9,4727222520
9760,63868649570,1038,63868650608,1,0,0,1024,1,4696406479
9761,63868710328,13249,63868723577,9,0,0,25600,9,7996974457
9762,63868720327,2942,63868723269,4,0,1,2048,4,11262103
9763,63868729267,86039,63868815306,4,0,0,3072,4,38871416
9764,63868790248,43971,63868834219,7,0,0,72192,7,2111351753
9765,63868842076,127570,63868969646,3,0,1,23040,3,5335805188
9766,63868961652,8005,63868969657,6,0,0,1024,6,1020966139
9767,63869076850,15833,63869092683,4,0,1,18432,4,8512525218
9768,63869111173,160654,63869271827,8,0,0,30720,8,866448790
9769,63869259863,45748,63869305611,4,0,1,1536,4,9385725499
9770,63869371960,32554,63869404514,4,0,0,53248,4,49798639
9771,63869548925,1514,63869550439,0,0,1,42496,0,2093849813
9772,63869560823,104308,63869665131,1,0,0,1536,1,9526209498
9773,63869654098,1990,63869656088,6,0,0,2048,6,3929429303
9774,63869684032,44400,63869728432,9,0,0,76288,9,4075238523
9775,63869692801,36617,63869729418,2,0,0,1536,2,8680913959
9776,63869773270,1514,63869774784,3,0,0,1536,3,3125395160
9777,63869799909,66052,63869865961,4,0,1,7680,4,7103303279
9778,63869818730,107197,63869925927,2,0,1,1536,2,1148672049
9779,63869986989,2466,63869989455,5,0,1,3584,5,4997096982
9780,63870010468,54052,63870064520,6,0,0,2560,6,3112216146
9781,63870030110,1990,63870032100,2,0,1,18432,2,1237878473
9782,63870097596,92939,63870190535,3,0,0,2048,3,249388605
9783,63870142370,562,63870142932,3,0,0,512,3,3689947052
9784,63870177197,45592,63870222789,8,0,1,1024,8,1296623989
9785,63870277038,101656,63870378694,3,0,1,33792,3,6266896394
9786,63870360517,18188,63870378705,4,0,0,25088,4,898403085
9787,63870448470,194020,63870642490,8,0,1,175616,8,2500644375
9788,63870525787,125961,63870651748,5,0,1,13312,5,9904588067
9789,63870617531,80695,63870698226,4,0,1,4096,4,4103785727
9790,63870701537,25958,63870727495,0,0,1,87040,0,160348264
9791,63870707310,117880,63870825190,7,0,1,12800,7,5141443478
9792,63870758824,116018,63870874842,0,0,0,47104,0,859565145
9793,63870856130,32295,63870888425,7,0,0,52736,7,3015251678
9794,63870875183,99159,63870974342,6,0,1,3584,6,999089129
9795,63870880562,562,63870881124,8,0,1,120832,8,8616426404
9796,63870891087,138372,63871029459,8,0,1,53760,8,1051683612
9797,63870968949,3543,63870972492,8,0,1,45568,8,4435844246
9798,63870994894,218485,63871213379,5,0,0,512,5,3554411781
9799,63871029032,57822,63871086854,9,0,0,9216,9,410470479
9800,63871076567,62601,63871139168,8,0,0,61952,8,658434542
9801,63871078509,198474,63871276983,9,0,0,24064,9,7765577876
9802,63871098311,90682,63871188993,4,0,0,103936,4,2965895996
9803,63871101453,129595,63871231048,7,0,0,107008,7,5624280634
9804,63871141994,90130,63871232124,8,0,0,13312,8,2510365537
9805,63871186608,46182,63871232790,5,0,0,1024,5,3806822978
9806,63871202135,37376,63871239511,9,0,0,32256,9,4712002539
9807,63871224775,190370,63871415145,0,0,1,31744,0,377759513
9808,63871301966,104721,63871406687,6,0,1,1536,6,5485639830
9809,63871319459,169532,63871488991,0,0,0,170496,0,1678994612
9810,63871471274,5538,63871476812,5,0,0,5632,5,7282238988
9811,63871475420,1038,63871476458,8,0,1,25088,8,5983682900
9812,63871534829,188947,63871723776,3,0,0,1024,3,586843224
9813,63871709615,45175,63871754790,8,0,0,77824,8,10189046987
9814,63871719640,35816,63871755456,3,0,0,1024,3,3311981569
9815,63871746028,107660,63871853688,3,0,1,13312,3,6024467598
9816,63871864263,143929,63872008192,2,0,0,233472,2,2320254707
9817,63871864329,360980,63872225309,5,0,1,160256,5,3954461990
9818,63871997577,233531,63872231108,5,0,1,18944,5,8552201614
9819,63872115803,127208,63872243011,8,0,0,210944,8,15831374
9820,63872152386,132260,63872284646,9,0,0,87552,9,421836897
9821,63872168612,116802,63872285414,0,0,0,11776,0,3127479914
9822,63872245426,40334,63872285760,3,0,0,512,3,3078715592
9823,63872288932,4158,63872293090,9,0,0,11264,9,6836095873
9824,63872323451,133999,63872457450,7,0,1,3584,7,3691348216
9825,63872415770,1640,63872417410,3,0,1,2048,3,8027460756
9826,63872456331,83674,63872540005,1,0,0,512,1,1128956644
9827,63872485324,70972,63872556296,2,0,1,8704,2,6525375915
9828,63872599718,198856,63872798574,5,0,1,191488,5,3941871682
9829,63872760257,70863,63872831120,7,0,0,53248,7,7110811870
9830,63872802994,26217,63872829211,8,0,1,92160,8,9009954957
9831,63872856695,180757,63873037452,4,0,0,47616,4,2960516555
9832,63872858562,130356,63872988918,2,0,1,16896,2,7164626629
9833,63872973926,80776,63873054702,3,0,1,5120,3,1004658674
9834,63872983001,139713,63873122714,2,0,0,217088,2,9241562887
9835,63873060915,34016,63873094931,5,0,1,12288,5,7156728257
9836,63873072018,128012,63873200030,3,0,1,3072,3,9510439174
9837,63873150055,157812,63873307867,2,0,0,59392,2,896814244
9838,63873223523,93045,63873316568,2,0,0,151040,2,8695676657
9839,63873277621,65073,63873342694,8,0,0,83968,8,1589724190
9840,63873440099,46208,63873486307,4,0,0,79872,4,4070528024
9841,63873478035,23116,63873501151,8,0,0,41472,8,8872144045
9842,63873508187,2466,63873510653,2,0,0,2560,2,5215837519
9843,63873616556,43196,63873659752,0,0,0,70656,0,9960748508
9844,63873688546,64391,63873752937,8,0,0,108544,8,3431250094
9845,63873694512,59091,63873753603,3,0,0,1024,3,4198414381
9846,63873760809,11787,63873772596,9,0,0,19456,9,4863571474
9847,63873812744,136633,63873949377,7,0,1,11264,7,8997191457
9848,63873865992,3383,63873869375,5,0,1,123904,5,7007917686
9849,63873929627,166857,63874096484,3,0,1,512,3,1724780575
9850,63873982288,12533,63873994821,9,0,0,9728,9,4811564763
9851,63873987745,88192,63874075937,8,0,1,6656,8,7732098958
9852,63874027534,173667,63874201201,9,0,0,7680,9,83828610
9853,63874053612,144483,63874198095,2,0,1,7680,2,2448532177
9854,63874359427,77608,63874437035,4,0,1,15360,4,3963493323
9855,63874474648,104462,63874579110,4,0,0,169984,4,7330635375
9856,63874487911,92185,63874580096,5,0,0,1536,5,3767630845
9857,63874685722,136558,63874822280,9,0,0,225792,9,4017879415
9858,63874827710,98855,63874926565,4,0,1,6656,4,1513296900
9859,63874860928,4347,63874865275,0,0,1,4096,0,225734795
9860,63874943781,140533,63875084314,6,0,1,19456,6,3232045270
9861,63874955447,92680,63875048127,3,0,0,4096,3,9379801895
9862,63875039284,13854,63875053138,3,0,1,512,3,6834280796
9863,63875048179,43900,63875092079,0,0,0,23552,0,1802717060
9864,63875087892,105925,63875193817,7,0,0,176128,7,561414585
9865,63875114009,65203,63875179212,8,0,0,5120,8,2174969544
9866,63875118331,83034,63875201365,0,0,1,66048,0,6189545416
9867,63875131374,233743,63875365117,7,0,1,512,7,5252207789
9868,63875169500,215518,63875385018,4,0,1,12288,4,7785471295
9869,63875177371,253887,63875431258,7,0,1,34304,7,1288032845
9870,63875452328,65896,63875518224,2,0,1,7168,2,252672047
9871,63875459487,62412,63875521899,7,0,0,101376,7,9860410483
9872,63875577797,5967,63875583764,0,0,1,119808,0,5138075533
9873,63875623693,127864,63875751557,2,0,0,14848,2,2998818232
9874,63875679768,26447,63875706215,1,0,0,512,1,8147740693
9875,63875780934,80368,63875861302,2,0,1,14336,2,7456730839
9876,63875983694,562,63875984256,2,0,1,10240,2,1053470044
9877,63875986184,69904,63876056088,0,0,1,24064,0,7221703927
9878,63876019667,98692,63876118359,1,0,0,512,1,2838784122
9879,63876020266,106183,63876126449,7,0,0,176640,7,2235781539
9880,63876024975,103100,63876128075,1,0,0,2560,1,6667010841
9881,63876206039,1514,63876207553,6,0,0,1536,6,185778154
9882,63876251984,3894,63876255878,6,0,0,4096,6,10096517623
9883,63876291650,75808,63876367458,9,0,0,127488,9,4882957298
9884,63876293067,95077,63876388144,8,0,0,74240,8,384541182
9885,63876369733,1038,63876370771,4,0,1,18432,4,4278154908
9886,63876397805,45592,63876443397,1,0,0,1024,1,2493081529
9887,63876416272,129104,63876545376,6,0,1,1024,6,5482155287
9888,63876443642,1990,63876445632,7,0,1,17408,7,10652840577
9889,63876513914,87481,63876601395,5,0,0,2048,5,2444256997
9890,63876542231,4370,63876546601,3,0,0,4608,3,4568760339
9891,63876577470,55300,63876632770,2,0,0,94208,2,10213445447
9892,63876662333,1514,63876663847,5,0,0,1536,5,1941734701
9893,63876679200,47800,63876727000,0,0,1,10240,0,13377965
9894,63876690514,119581,63876810095,5,0,1,221696,5,5114998402
9895,63876720525,55300,63876775825,3,0,1,1024,3,1738436708
9896,63876787270,21021,63876808291,8,0,0,94208,8,1399983120
9897,63876799146,1514,63876800660,7,0,1,25088,7,8510147655
9898,63876826055,291309,63877117364,7,0,0,7168,7,4638547923
9899,63876885378,562,63876885940,3,0,0,1536,3,329225667
9900,63876947226,280650,63877227876,7,0,1,9216,7,3514956230
9901,63876990620,141919,63877132539,2,0,1,512,2,548290269
9902,63877036818,98692,63877135510,1,0,0,512,1,7142601342
9903,63877122632,2942,63877125574,0,0,1,411136,0,10049948508
9904,63877128478,1963,63877130441,1,0,0,3072,1,3862861548
9905,63877129803,562,63877130365,5,0,0,512,5,3601379358
9906,63877189449,362548,63877551997,4,0,1,5120,4,3047451074
9907,63877196063,290064,63877486127,3,0,1,3072,3,2061490840
9908,63877264566,298249,63877562815,1,0,0,512,1,6793365488
9909,63877307408,180325,63877487733,4,0,0,211968,4,9949365739
9910,63877336534,157054,63877493588,9,0,0,6144,9,9319888709
9911,63877339993,153941,63877493934,5,0,0,512,5,5746463542
9912,63877359289,135311,63877494600,3,0,0,1024,3,5105053865
9913,63877435240,63226,63877498466,6,0,0,6144,6,9270321103
9914,63877469295,121348,63877590643,6,0,1,1536,6,6536039869
9915,63877598590,1038,63877599628,5,0,0,1024,5,9571551865
9916,63877698438,1038,63877699476,3,0,0,1024,3,6405467157
9917,63877717319,3124,63877720443,4,0,1,10752,4,450989201
9918,63877717681,68524,63877786205,9,0,0,9216,9,1329423004
9919,63877760655,111617,63877872272,2,0,1,24576,2,6184283928
9920,63877765238,121024,63877886262,7,0,1,512,7,3769857978
9921,63877849921,36083,63877886004,6,0,1,7680,6,3807043947
9922,63877878875,67588,63877946463,8,0,0,63488,8,1578660428
9923,63877907589,9939,63877917528,1,0,0,3072,1,6660583219
9924,63877915130,2900,63877918030,1,0,0,512,1,8716984901
9925,63877923709,1514,63877925223,8,0,1,6144,8,4929993125
9926,63877989722,108389,63878098111,3,0,0,1536,3,10641893633
9927,63878035588,85756,63878121344,8,0,1,16896,8,9624071508
9928,63878064843,132501,63878197344,7,0,1,6144,7,1080808314
9929,63878088281,167831,63878256112,3,0,1,6144,3,659555862
9930,63878098290,146276,63878244566,0,0,1,91136,0,6680447705
9931,63878270431,1038,63878271469,1,0,0,1024,1,7903443160
9932,63878305419,1038,63878306457,5,0,0,1024,5,9882092055
9933,63878310668,32812,63878343480,2,0,0,53760,2,5229318524
9934,63878326536,35352,63878361888,7,0,0,60928,7,7848990374
9935,63878338701,23853,63878362554,6,0,0,1024,6,2358914738
9936,63878367322,562,63878367884,3,0,0,512,3,7875040657
9937,63878368391,54096,63878422487,8,0,0,88576,8,2705324012
9938,63878413922,8911,63878422833,5,0,0,512,5,4095428207
9939,63878446228,2466,63878448694,2,0,1,28672,2,5270327276
9940,63878453715,1514,63878455229,2,0,0,2560,2,5277307039
9941,63878522638,120046,63878642684,6,0,0,1536,6,7866451325
9942,63878527985,7392,63878535377,6,0,1,28672,6,1144384375
9943,63878549502,72355,63878621857,2,0,1,7680,2,1906690013
9944,63878558640,125736,63878684376,5,0,1,12288,5,7138905137
9945,63878559937,188977,63878748914,5,0,0,1024,5,2976702176
9946,63878679915,91233,63878771148,3,0,1,13824,3,5383521916
9947,63878846784,55558,63878902342,8,0,0,94720,8,4128983823
9948,63878919084,11529,63878930613,9,0,0,18944,9,2830048086
9949,63878927380,3579,63878930959,5,0,0,512,5,4994707858
9950,63878931723,2942,63878934665,5,0,0,3072,5,9912044522
9951,63878954181,3124,63878957305,6,0,0,9216,6,5992149055
9952,63878983061,13854,63878996915,2,0,0,23552,2,875455723
9953,63878993330,16092,63879009422,0,0,1,297984,0,6394841245
9954,63878997624,102833,63879100457,3,0,1,10752,3,6544376549
9955,63879053302,12872,63879066174,0,0,1,334848,0,7983779843
9956,63879099606,247277,63879346883,0,0,0,31232,0,10330488100
9957,63879107958,1038,63879108996,2,0,0,164352,2,5730328807
9958,63879198995,466917,63879665912,0,0,0,13312,0,5406956883
9959,63879247433,508996,63879756429,7,0,1,7168,7,10569833956
9960,63879277584,317084,63879594668,3,0,1,1024,3,2885246933
9961,63879291450,287264,63879578714,3,0,0,1024,3,843387687
9962,63879375523,172379,63879547902,0,0,1,175616,0,4130188866
9963,63879392504,84647,63879477151,6,0,0,2048,6,9054712110
9964,63879481223,76464,63879557687,6,0,0,1024,6,2783702826
9965,63879490392,54775,63879545167,3,0,0,1536,3,3150449157
9966,63879513707,25974,63879539681,3,0,0,2560,3,7677440400
9967,63879544326,86708,63879631034,4,0,0,10752,4,4141147884
9968,63879598315,31503,63879629818,7,0,0,145408,7,7873354396
9969,63879649982,69898,63879719880,8,0,1,6144,8,10364798181
9970,63879654084,105838,63879759922,9,0,0,10752,9,6572326576
9971,63879686523,474342,63880160865,3,0,1,11776,3,6336760294
9972,63879690500,166949,63879857449,3,0,1,24064,3,6729132597
9973,63879749131,107012,63879856143,3,0,1,8704,3,1845543445
9974,63879789245,115362,63879904607,8,0,0,93184,8,2396446650
9975,63879835322,24150,63879859472,0,0,1,128000,0,9599931000
9976,63879952915,73571,63880026486,9,0,0,43520,9,542573649
9977,63879970410,4846,63879975256,8,0,0,119808,8,5632351847
9978,63880051615,1038,63880052653,7,0,0,5120,7,8339104342
9979,63880058807,385475,63880444282,3,0,0,1024,3,1147764826
9980,63880116163,107297,63880223460,3,0,1,8704,3,5818609196
9981,63880212723,14623,63880227346,6,0,0,4096,6,6988782495
9982,63880224788,4370,63880229158,5,0,1,114176,5,10439762622
9983,63880258703,187550,63880446253,5,0,1,107520,5,6612537447
9984,63880338320,15037,63880353357,0,0,1,443392,0,9689895071
9985,63880364844,43883,63880408727,6,0,0,4608,6,8447502272
9986,63880379125,87098,63880466223,3,0,1,7680,3,705379873
9987,63880399308,68230,63880467538,6,0,0,2048,6,484147912
9988,63880422544,46907,63880469451,9,0,0,75264,9,9399965508
9989,63880431910,389614,63880821524,2,0,0,122880,2,7110485432
9990,63880453044,502010,63880955054,3,0,0,3584,3,6628377205
9991,63880475033,383939,63880858972,1,0,0,1024,1,7756556412
9992,63880637551,1038,63880638589,5,0,1,18944,5,2721036287
9993,63880771520,562,63880772082,3,0,0,1024,3,5129326287
9994,63880774644,192322,63880966966,1,0,0,512,1,590762229
9995,63880880709,4933,63880885642,3,0,1,10752,3,3840510610
9996,63880925312,3641,63880928953,4,0,0,12800,4,4880177144
9997,63880934319,65452,63880999771,9,0,0,10240,9,5690540358
9998,63880953050,298240,63881251290,6,0,1,5120,6,10550404104
9999,63880985587,332348,63881317935,0,0,1,356352,0,1150070799
