RequestID,ArrivalTime,DelayTime,FinishTime,InitiatorID,TargetID,IOType,Size,VolumeID,Offset
0,0,5607,5607,0,0,1,5632,9,2976849248
1,1,10752,10753,4,0,1,8192,29,5503218865
2,2,118604,118606,2,0,0,23040,0,8381445002
3,3,211384,211387,5,0,0,39936,25,6535023168
4,4,98014,98018,6,0,0,5632,11,2874840570
5,5,11414,11419,7,0,1,1024,5,8829487917
6,6,304469,304475,1,0,0,47616,22,9805137504
7,7,150548,150555,8,0,0,47616,17,7954105634
8,8,12179,12187,9,0,1,11776,9,9607474538
9,9,15084,15093,3,0,1,4608,25,10707469203
10,1500,17779,19279,7,0,1,6656,5,2589279390
11,3780,19365,23145,9,0,1,6144,9,9656356320
12,6569,20122,26691,5,0,1,5632,25,3245908083
13,9480,442977,452457,6,0,0,59904,11,3987498985
14,11020,343853,354873,8,0,0,64512,17,6439106735
15,27640,5196,32836,0,0,1,13312,9,13373830
16,34950,686005,720955,2,0,0,98304,0,3391980598
17,36150,194652,230802,6,0,0,7680,11,8239926221
18,41180,1042,42222,7,0,1,1024,5,3479815582
19,42170,498758,540928,1,0,0,40448,22,3035661365
20,42369,7706,50075,5,0,1,8192,25,2698602918
21,45500,208101,253601,6,0,0,33792,11,10536496600
22,48990,413310,462300,2,0,0,32256,0,1342760003
23,49180,1241,50421,9,0,1,512,9,3367577558
24,57660,373145,430805,8,0,0,73728,17,9208883071
25,58640,7706,66346,9,0,1,8192,9,3392788668
26,59660,6840,66500,4,0,1,8704,29,7593151712
27,71750,6754,78504,7,0,1,7168,5,24814267
28,72649,560842,633491,0,0,0,4608,9,5305276920
29,73130,236219,309349,4,0,0,1024,29,9260769469
30,76830,2980,79810,9,0,1,2048,9,6813102233
31,77060,3416,80476,0,0,1,1024,9,7606184822
32,80500,187765,268265,4,0,0,512,29,1379374752
33,80920,1518,82438,0,0,1,1536,9,4047718686
34,82750,1994,84744,7,0,1,2048,5,5361376192
35,82999,2731,85730,5,0,1,1536,25,5260548106
36,93130,163942,257072,1,0,0,11264,22,8175179319
37,96140,4162,100302,4,0,1,11264,29,10416116581
38,102830,4374,107204,4,0,1,4608,29,6563584754
39,103889,3661,107550,5,0,1,512,25,624958329
40,105090,436336,541426,4,0,0,1536,29,7614485625
41,120039,482833,602872,7,0,0,82432,5,7093380596
42,136410,14795,151205,0,0,1,512,9,9098409622
43,137750,608357,746107,5,0,0,24576,25,8068334411
44,141170,614570,755740,4,0,0,512,29,9553464192
45,149869,7680,157549,5,0,1,7168,25,293499751
46,149999,137782,287781,0,0,0,5632,9,7287507934
47,162510,1994,164504,7,0,1,2048,5,8584660056
48,163390,780969,944359,1,0,0,43520,22,3517589355
49,167840,298858,466698,1,0,0,14336,22,7833056225
50,169699,102536,272235,7,0,0,6144,5,6739344453
51,177040,464754,641794,8,0,0,512,17,473004239
52,193010,735016,928026,2,0,0,128512,0,2533548275
53,193960,17458,211418,7,0,1,18432,5,9504195742
54,199729,15598,215327,1,0,1,4096,22,3209904340
55,204669,11964,216633,1,0,1,2048,22,9445227060
56,207030,913398,1120428,8,0,0,111616,17,6744005820
57,212980,7839,220819,7,0,1,6656,5,4813922120
58,214989,935258,1150247,0,0,0,8704,9,9697842170
59,217390,5196,222586,9,0,1,13312,9,3151236093
60,219709,3543,223252,1,0,1,1024,22,3381060766
61,222909,1518,224427,1,0,1,1536,22,5012068445
62,232699,3904,236603,5,0,1,10752,25,1979127451
63,234059,7767,241826,1,0,1,6144,22,6087924401
64,248730,640125,888855,6,0,0,69120,11,3128538018
65,248800,8797,257597,9,0,1,512,9,10657334101
66,249000,130673,379673,6,0,0,11776,11,3606366726
67,266090,1518,267608,9,0,1,1536,9,9773863065
68,267070,715906,982976,4,0,0,512,29,2314672303
69,267860,4398,272258,0,0,1,9216,9,2463028128
70,268050,5219,273269,9,0,1,1024,9,6808694042
71,276750,651627,928377,6,0,0,1024,11,9977787830
72,278490,872732,1151222,6,0,0,3072,11,3040859411
73,280210,1518,281728,9,0,1,1536,9,4100316045
74,289180,15318,304498,0,0,1,8704,9,8463699903
75,291340,15246,306586,9,0,1,2048,9,4623610794
76,294520,14844,309364,9,0,1,4096,9,5515983727
77,296430,178952,475382,4,0,0,1024,29,1715875123
78,296650,15428,312078,0,0,1,4608,9,7891903049
79,299950,631126,931076,5,0,0,8704,25,7410942110
80,300360,15584,315944,0,0,1,6144,9,4865808100
81,305600,994018,1299618,2,0,0,64512,0,8426422167
82,306189,11381,317570,5,0,1,2560,25,2803776225
83,317630,526525,844155,2,0,0,68608,0,7418766384
84,325480,760925,1086405,1,0,0,18432,22,2223652507
85,326730,228371,555101,2,0,0,512,0,7248547350
86,327950,926797,1254747,2,0,0,16896,0,2904356626
87,329689,25199,354888,5,0,1,6656,25,4955765800
88,331070,33771,364841,0,0,1,54272,9,6750530866
89,332060,33959,366019,0,0,1,13824,9,8571382756
90,333470,36735,370205,9,0,1,6656,9,9987342724
91,333699,649098,982797,7,0,0,48640,5,7209372044
92,345890,195935,541825,8,0,0,512,17,8677288288
93,348980,1036881,1385861,1,0,0,7680,22,9613213848
94,354429,441053,795482,0,0,0,3584,9,1249060912
95,355930,799363,1155293,1,0,0,13312,22,8696655881
96,359960,249224,609184,1,0,0,10752,22,4361462380
97,361379,9492,370871,5,0,1,1024,25,5523836043
98,362139,887389,1249528,7,0,0,81408,5,7970766104
99,366740,1260533,1627273,6,0,0,512,11,792913519
100,375660,753231,1128891,5,0,0,27648,25,4217117687
101,388170,43887,432057,0,0,1,75264,9,4276828916
102,392420,69895,462315,0,0,1,22016,9,1121877573
103,394689,1089538,1484227,7,0,0,44032,5,76583496
104,400910,72591,473501,0,0,1,62976,9,9099302813
105,408389,69298,477687,5,0,1,6656,25,4432200838
106,409149,581174,990323,7,0,0,24064,5,1366275231
107,419140,715866,1135006,5,0,0,19968,25,3317175672
108,419979,1121535,1541514,0,0,0,44544,9,4634468862
109,428889,51384,480273,1,0,1,4096,22,5620716770
110,431010,881579,1312589,1,0,0,42496,22,4761013575
111,434450,740847,1175297,1,0,0,32768,22,2718641137
112,435270,76154,511424,0,0,1,73216,9,5750175795
113,438790,975221,1414011,8,0,0,9216,17,9595202589
114,441410,836385,1277795,8,0,0,35328,17,8157125298
115,449390,875741,1325131,4,0,0,2048,29,10349055672
116,451310,724664,1175974,4,0,0,2048,29,2697395980
117,456741,60994,517735,8,0,1,22016,17,1403477775
118,458079,62242,520321,2,0,1,4096,0,5582523657
119,459639,735984,1195623,7,0,0,30720,5,7360866301
120,460980,79963,540943,0,0,1,59392,9,1214458921
121,477800,63641,541441,3,0,1,8192,25,4732616562
122,481930,742771,1224701,8,0,0,13312,17,4817116739
123,485679,58554,544233,5,0,1,4608,25,2316055680
124,490180,644997,1135177,2,0,0,512,0,703412891
125,491400,1785445,2276845,2,0,0,136704,0,6076354902
126,492930,51662,544592,3,0,1,9728,25,3958550221
127,493239,52979,546218,5,0,1,2560,25,4748894763
128,501010,47154,548164,3,0,1,3072,25,4068921246
129,502000,887821,1389821,4,0,0,512,29,6151846815
130,507310,47063,554373,3,0,1,21504,25,8675352376
131,507940,46779,554719,6,0,1,512,11,5989310027
132,512950,89945,602895,0,0,1,100864,9,9445658530
133,535970,66940,602910,6,0,1,9216,11,2771490398
134,541350,1035697,1577047,6,0,0,73728,11,7184009590
135,550600,666418,1217018,2,0,0,70144,0,5346841938
136,555890,1516243,2072133,1,0,0,45568,22,792974777
137,556150,46775,602925,6,0,1,2560,11,922756808
138,559240,588284,1147524,6,0,0,40448,11,6546215094
139,564700,432346,997046,2,0,0,22016,0,3485948529
140,579190,25212,604402,6,0,1,1536,11,8359768577
141,603000,1528018,2131018,1,0,0,15360,22,5548918208
142,604590,1211528,1816118,5,0,0,73216,25,3806617799
143,607029,1085464,1692493,0,0,0,53248,9,6736125514
144,615220,329366,944586,4,0,0,512,29,7632072228
145,623000,566,623566,7,0,1,512,5,6886988077
146,625429,842928,1468357,0,0,0,28160,9,3561086366
147,626750,13600,640350,6,0,1,23040,11,7100220160
148,631260,11036,642296,6,0,1,3072,11,9063921046
149,634420,9502,643922,6,0,1,2560,11,1084656691
150,636320,32558,668878,0,0,1,53248,9,2534886098
151,636440,940778,1577218,4,0,0,512,29,4144472689
152,639839,684645,1324484,7,0,0,38912,5,4424001131
153,644640,1141065,1785705,4,0,0,512,29,10734011056
154,648530,21334,669864,6,0,1,1536,11,3241091870
155,648570,933294,1581864,8,0,0,14848,17,6977747443
156,653970,20400,674370,7,0,1,7168,5,10069750889
157,655170,65832,721002,0,0,1,93696,9,3273294874
158,660470,60547,721017,0,0,1,18944,9,6654013356
159,670230,1686501,2356731,1,0,0,142848,22,3078123195
160,672449,1439338,2111787,0,0,0,4608,9,8419795565
161,699740,1819842,2519582,8,0,0,34304,17,7595417472
162,701950,52671,754621,0,0,1,55296,9,6087336801
163,705030,819630,1524660,8,0,0,38912,17,6040534927
164,709750,1478222,2187972,2,0,0,59392,0,7323680553
165,721320,34607,755927,6,0,1,2048,11,10310988012
166,722120,36393,758513,6,0,1,4096,11,5649457856
167,724970,1236615,1961585,8,0,0,25600,17,4386789827
168,727020,2488148,3215168,4,0,0,512,29,8383396997
169,733420,1166381,1899801,4,0,0,512,29,10086737807
170,753230,1693478,2446708,1,0,0,12800,22,3080742218
171,753820,1693059,2446879,4,0,0,512,29,2443502778
172,762009,1296225,2058234,0,0,0,12800,9,7741559660
173,763630,2035910,2799540,6,0,0,100352,11,4614792660
174,769440,1430857,2200297,2,0,0,6656,0,4195107925
175,775510,650705,1426215,8,0,0,24064,17,4926297844
176,783099,1371895,2154994,0,0,0,18432,9,7055067816
177,784180,3898,788078,6,0,1,4096,11,9857130277
178,790589,366435,1157024,7,0,0,5632,5,8050093397
179,797390,1994,799384,6,0,1,2048,11,3358934787
180,813169,1584206,2397375,0,0,0,104448,9,10422038567
181,827000,20034,847034,6,0,1,8704,11,2331382778
182,827660,21150,848810,7,0,1,2048,5,4858524702
183,845780,6413,852193,7,0,1,12288,5,9448632369
184,846180,7319,853499,7,0,1,2048,5,3884213021
185,849940,5505,855445,7,0,1,3072,5,6753080404
186,859880,2161560,3021440,1,0,0,7168,22,6377153401
187,872260,619800,1492060,8,0,0,512,17,721271234
188,877370,340311,1217681,1,0,0,2048,22,1515369008
189,880770,502613,1383383,4,0,0,1536,29,3919778286
190,903540,1699237,2602777,8,0,0,272896,17,2562096739
191,904590,1048472,1953062,8,0,0,11264,17,761869849
192,912930,42971,955901,6,0,1,18944,11,5162103499
193,917779,954634,1872413,0,0,0,34816,9,1590626492
194,919490,36872,956362,0,0,1,10240,9,5049766236
195,921880,1704881,2626761,2,0,0,69120,0,5920692911
196,922950,1580845,2503795,4,0,0,1024,29,10686788773
197,928850,1375965,2304815,2,0,0,43008,0,859903239
198,935329,2421445,3356774,7,0,0,55808,5,8913155140
199,936330,21018,957348,6,0,1,1536,11,2141758966
200,939100,1944369,2883469,2,0,0,104448,0,8750693177
201,945820,14114,959934,6,0,1,4096,11,5444676337
202,951659,1684789,2636448,0,0,0,31744,9,10612721247
203,952130,2834514,3786644,5,0,0,86528,25,4393626240
204,953160,1548343,2501503,1,0,0,3584,22,8359251609
205,963460,930025,1893485,1,0,0,8192,22,2825870761
206,964020,566,964586,6,0,1,512,11,342315619
207,965160,1074818,2039978,2,0,0,39424,0,5595362818
208,968940,31036,999976,7,0,1,3072,5,7289373207
209,981220,1384308,2365528,6,0,0,28160,11,3560205818
210,993360,1696333,2689693,5,0,0,35328,25,10240559229
211,1004570,1984907,2989477,6,0,0,15872,11,10154604605
212,1033340,1732442,2765782,5,0,0,43008,25,6403557678
213,1035350,1042,1036392,6,0,1,1024,11,5982111345
214,1041550,566,1042116,6,0,1,512,11,4096368356
215,1048570,1704033,2752603,8,0,0,79360,17,5724527891
216,1061310,2150070,3211380,1,0,0,22528,22,4574371611
217,1074580,781561,1856141,8,0,0,7168,17,453213948
218,1076040,1908251,2984291,8,0,0,76800,17,5292018472
219,1083270,2196927,3280197,6,0,0,22528,11,10603401145
220,1084700,2841733,3926433,8,0,0,68096,17,4587060890
221,1084890,72165,1157055,6,0,1,13312,11,3436255303
222,1096290,60804,1157094,7,0,1,4096,5,10506879590
223,1098860,877205,1976065,2,0,0,13824,0,197292169
224,1102560,56548,1159108,6,0,1,5632,11,10397798877
225,1108730,51364,1160094,7,0,1,1536,5,10590339081
226,1116540,46460,1163000,7,0,1,4608,5,3221110574
227,1116889,1174791,2291680,0,0,0,48640,9,3742216413
228,1126250,1584332,2710582,5,0,0,10240,25,10659644608
229,1126330,1183500,2309830,8,0,0,16384,17,5298482386
230,1130460,44852,1175312,7,0,1,4608,5,1283269405
231,1133710,1526074,2659784,8,0,0,2560,17,2435596281
232,1149640,1509349,2658989,2,0,0,4608,0,3253816522
233,1152110,610885,1762995,5,0,0,12800,25,7709647005
234,1155650,19685,1175335,6,0,1,4096,11,173354873
235,1167760,2410872,3578632,5,0,0,82944,25,9749732457
236,1173270,937082,2110352,1,0,0,37376,22,3009993461
237,1180220,549390,1729610,1,0,0,1024,22,5238846236
238,1182350,2470,1184820,6,0,1,2560,11,3733581986
239,1188130,685390,1873520,1,0,0,3584,22,6043196900
240,1200930,1789382,2990312,2,0,0,2560,0,1083649283
241,1201420,1702936,2904356,1,0,0,68096,22,4785198485
242,1212349,1445002,2657351,0,0,0,17920,9,9020140792
243,1213980,1626167,2840147,2,0,0,15360,0,5394926834
244,1222590,32196,1254786,6,0,1,4096,11,3191017315
245,1224320,623476,1847796,4,0,0,1024,29,9493167489
246,1232359,1943576,3175935,0,0,0,4096,9,4888023225
247,1236540,20160,1256700,0,0,1,2048,9,10005980296
248,1239629,1711496,2951125,0,0,0,102400,9,2642489166
249,1239760,17926,1257686,6,0,1,1536,11,5198134943
250,1240080,1808271,3048351,8,0,0,31232,17,7308335780
251,1250179,2851581,4101760,7,0,0,71680,5,9583575319
252,1254190,4802,1258992,6,0,1,2048,11,2304262407
253,1268360,1648471,2916831,4,0,0,512,29,9594662469
254,1269590,2043945,3313535,5,0,0,11264,25,7256698153
255,1278770,1871733,3150503,8,0,0,18432,17,778654421
256,1291620,2080271,3371891,1,0,0,41472,22,10354586656
257,1301539,669986,1971525,1,0,0,11264,22,6989841190
258,1305319,1519273,2824592,0,0,0,25600,9,3122661700
259,1307060,1004345,2311405,6,0,0,5120,11,3982474707
260,1308659,22308,1330967,5,0,1,6144,25,8864943149
261,1314420,1454529,2768949,8,0,0,10240,17,2737623845
262,1319060,3517634,4836694,8,0,0,139776,17,9338105134
263,1323360,3312632,4635992,5,0,0,160768,25,7765918494
264,1332740,1871761,3204501,5,0,0,71168,25,7353812459
265,1337070,50741,1387811,0,0,1,81920,9,2848125160
266,1345680,48442,1394122,4,0,1,22016,29,7154588428
267,1346270,792089,2138359,6,0,0,8704,11,8009366112
268,1347630,47478,1395108,6,0,1,1536,11,5679222512
269,1348530,48524,1397054,4,0,1,3072,29,9449874787
270,1351530,48110,1399640,7,0,1,4096,5,7023328445
271,1354330,46296,1400626,6,0,1,1536,11,6773315608
272,1358520,1602356,2960876,1,0,0,31744,22,8665283625
273,1360170,40802,1400972,4,0,1,512,29,5789153448
274,1363710,37416,1401126,0,0,1,8704,9,8559168686
275,1367220,729487,2096707,4,0,0,3072,29,2339626617
276,1388870,1613485,3002355,1,0,0,16384,22,9508409523
277,1389110,12362,1401472,6,0,1,512,11,191567258
278,1393750,2626776,4020526,5,0,0,53760,25,1335691320
279,1396100,6038,1402138,4,0,1,1024,29,9627086939
280,1401470,2262999,3664469,4,0,0,512,29,1864897144
281,1401880,4850,1406730,6,0,1,5120,11,3520823589
282,1402890,7095,1409985,7,0,1,15872,5,3464952624
283,1403740,2790867,4194607,2,0,0,60416,0,6544674033
284,1414440,1019132,2433572,5,0,0,32256,25,7924965868
285,1422970,2685544,4108514,5,0,0,7168,25,7927893015
286,1423940,5679,1429619,7,0,1,9728,5,5464284717
287,1426560,8139,1434699,6,0,1,13824,11,9126070489
288,1431780,4225,1436005,6,0,1,2048,11,8190608357
289,1435050,1373709,2808759,6,0,0,30208,11,5657119212
290,1439510,460120,1899630,2,0,0,8704,0,3290149513
291,1443500,1196239,2639739,8,0,0,10752,17,4829038523
292,1443790,97739,1541529,0,0,1,142848,9,9682441705
293,1444110,133123,1577233,0,0,1,114176,9,567961120
294,1445230,1635731,3080961,4,0,0,1024,29,7492148388
295,1456620,120628,1577248,6,0,1,8704,11,8310639507
296,1461990,2091323,3553313,2,0,0,71168,0,5052619042
297,1475790,1176078,2651868,2,0,0,25600,0,4858942964
298,1493420,83851,1577271,6,0,1,5120,11,501540440
299,1494739,1421126,2915865,1,0,0,20992,22,6186309513
300,1499520,3442583,4942103,5,0,0,105984,25,9418283547
301,1503560,73742,1577302,4,0,1,6656,29,2134657939
302,1509730,67587,1577317,7,0,1,6656,5,4039252677
303,1525870,56009,1581879,7,0,1,3584,5,8913069268
304,1527590,785546,2313136,8,0,0,5632,17,6193395799
305,1543410,38508,1581918,4,0,1,6144,29,10734761441
306,1545480,36453,1581933,7,0,1,1024,5,9310153249
307,1547030,3438909,4985939,6,0,0,54784,11,6630952935
308,1564040,22172,1586212,6,0,1,4608,11,5256658893
309,1566570,2288914,3855484,6,0,0,2048,11,7744024017
310,1568010,2734551,4302561,1,0,0,47104,22,3565023075
311,1574040,12518,1586558,7,0,1,512,5,291145423
312,1578890,1026469,2605359,4,0,0,2048,29,10502445083
313,1582280,4624,1586904,7,0,1,512,5,3435387488
314,1589480,2214054,3803534,2,0,0,25600,0,3170550675
315,1591270,1217816,2809086,4,0,0,1024,29,1310919365
316,1605240,4850,1610090,6,0,1,5120,11,8203323810
317,1609410,1982783,3592193,4,0,0,512,29,224663292
318,1617960,2007237,3625197,5,0,0,26112,25,468269106
319,1620630,4374,1625004,7,0,1,4608,5,1257197411
320,1631170,1285490,2916660,1,0,0,2560,22,10203597023
321,1634190,1350436,2984626,4,0,0,1024,29,1524400496
322,1646299,1621785,3268084,0,0,0,24576,9,10107303106
323,1662419,3465228,5127647,7,0,0,48640,5,3197492143
324,1664289,3126423,4790712,0,0,0,238080,9,2647185246
325,1673840,18684,1692524,7,0,1,13312,5,10427295561
326,1674940,1475890,3150830,6,0,0,1024,11,8743381002
327,1678400,2081865,3760265,5,0,0,22528,25,1178325079
328,1684160,11329,1695489,6,0,1,3072,11,110995344
329,1693670,963852,2657522,4,0,0,512,29,2125931525
330,1699550,975987,2675537,4,0,0,512,29,5344470508
331,1701330,2964637,4665967,6,0,0,98304,11,3326029686
332,1708690,5326,1714016,4,0,1,5632,29,8252683175
333,1709170,2977248,4686418,6,0,0,67072,11,737719611
334,1713280,7706,1720986,4,0,1,8192,29,8309821639
335,1725740,1869681,3595421,4,0,0,1024,29,3716066287
336,1730720,874966,2605686,4,0,0,1024,29,5996047468
337,1730729,3345298,5076027,7,0,0,89088,5,4395399913
338,1734830,1994,1736824,4,0,1,2048,29,8373949378
339,1743320,2336577,4079897,8,0,0,40960,17,5592976020
340,1755010,2087473,3842483,8,0,0,3584,17,4955551036
341,1761440,3338351,5099791,5,0,0,32256,25,9119892037
342,1774619,2937259,4711878,0,0,0,22016,9,5429787814
343,1774730,1687837,3462567,5,0,0,25088,25,1578971020
344,1776970,1274697,3051667,4,0,0,512,29,9132483952
345,1783440,1573817,3357257,4,0,0,1536,29,5798263342
346,1785309,1521293,3306602,0,0,0,8704,9,4371103239
347,1789989,2005722,3795711,1,0,0,29184,22,7707504174
348,1793910,2184668,3978578,2,0,0,27136,0,4073701
349,1797820,75723,1873543,0,0,1,83968,9,9739549042
350,1801080,1572854,3373934,6,0,0,6656,11,8736785817
351,1812269,2363915,4176184,0,0,0,20992,9,3748251097
352,1844300,1255117,3099417,2,0,0,6144,0,4455516061
353,1849440,3008992,4858432,2,0,0,70144,0,5904958619
354,1857480,1663943,3521423,2,0,0,16384,0,5613587451
355,1866740,2461072,4327812,5,0,0,11264,25,9438024943
356,1879140,3286741,5165881,4,0,0,1024,29,9350326870
357,1902841,2470,1905311,8,0,1,2560,17,4310308125
358,1909461,5326,1914787,8,0,1,5632,17,5741331406
359,1916370,1575665,3492035,5,0,0,16384,25,5986390915
360,1917441,1518,1918959,8,0,1,1536,17,2105287431
361,1919910,6754,1926664,4,0,1,7168,29,10560890637
362,1921889,2767236,4689125,0,0,0,8704,9,907682054
363,1926120,3791215,5717335,5,0,0,44544,25,6746122580
364,1971899,3349064,5320963,7,0,0,80384,5,10521760485
365,1980320,2988880,4969200,5,0,0,86528,25,424332382
366,1989729,453064,2442793,0,0,0,3584,9,9353608873
367,1996179,3369786,5365965,1,0,0,53760,22,650269236
368,2003681,3904,2007585,8,0,1,10752,17,9488661376
369,2011929,1697449,3709378,1,0,0,12800,22,6995192447
370,2020169,796600,2816769,7,0,0,25088,5,8460343580
371,2038410,1344417,3382827,2,0,0,3584,0,4885841182
372,2040699,5802,2046501,2,0,1,6144,0,1848436192
373,2040999,619760,2660759,0,0,0,3072,9,8701107948
374,2045890,1889337,3935227,5,0,0,2560,25,9606501482
375,2056710,300215,2356925,4,0,0,512,29,3358594636
376,2062750,2268843,4331593,6,0,0,9216,11,1443681331
377,2084690,969373,3054063,2,0,0,4608,0,10060061872
378,2093869,2047542,4141411,7,0,0,82432,5,5067758469
379,2095529,509191,2604720,7,0,0,6144,5,8644102341
380,2101940,1763793,3865733,6,0,0,13824,11,5355830505
381,2108910,1312317,3421227,6,0,0,3072,11,4462544237
382,2111200,532829,2644029,8,0,0,13824,17,4094941470
383,2115739,3138315,5254054,0,0,0,24064,9,9098586408
384,2123340,1592134,3715474,5,0,0,2560,25,716086162
385,2135150,3387,2138537,4,0,1,9728,29,5216542351
386,2157920,566,2158486,4,0,1,512,29,5463530307
387,2165670,1717593,3883263,8,0,0,25088,17,4725353337
388,2166180,2081545,4247725,2,0,0,47104,0,2568510160
389,2167600,2186898,4354498,8,0,0,56320,17,6240215654
390,2167900,20087,2187987,0,0,1,17920,9,7653788902
391,2180670,1235486,3416156,2,0,0,9216,0,2299462917
392,2192939,2393243,4586182,0,0,0,53248,9,3698997202
393,2196720,2196006,4392726,8,0,0,29696,17,5576735094
394,2203790,2955884,5159674,4,0,0,2048,29,1663479051
395,2211789,3206315,5418104,7,0,0,24576,5,5940927204
396,2217250,2085794,4303044,4,0,0,1536,29,8467019668
397,2222060,2209193,4431253,5,0,0,41472,25,3097354636
398,2225689,1608272,3833961,7,0,0,512,5,10100361402
399,2226060,1260952,3487012,8,0,0,36864,17,6248815562
400,2226790,1087712,3314502,2,0,0,3072,0,1670188052
401,2227489,944470,3171959,1,0,0,8192,22,10141379562
402,2244050,4045882,6289932,5,0,0,137728,25,6074589132
403,2249660,107094,2356754,4,0,1,1024,29,6782780536
404,2250950,2797910,5048860,8,0,0,28160,17,10609820327
405,2268030,3904127,6172157,4,0,0,3072,29,7032138169
406,2270270,2727502,4997772,5,0,0,18432,25,6707000232
407,2277960,1774498,4052458,8,0,0,17408,17,9262576758
408,2290930,3109289,5400219,8,0,0,69632,17,6794652735
409,2300250,97180,2397430,4,0,1,4096,29,9324582299
410,2304329,1892393,4196722,1,0,0,6656,22,7795970314
411,2324950,1543602,3868552,6,0,0,4608,11,3949106876
412,2330599,3373141,5703740,1,0,0,66048,22,588886261
413,2333019,4454377,6787396,0,0,0,117760,9,4925432777
414,2340970,1393154,3734124,4,0,0,512,29,8200997118
415,2343200,2547851,4891051,8,0,0,43008,17,1559320453
416,2359059,2518857,4877916,0,0,0,48128,9,1830435978
417,2360190,2134066,4494256,2,0,0,45056,0,6963187404
418,2364319,2785963,5150282,0,0,0,20480,9,9836726134
419,2365740,36752,2402492,4,0,1,5120,29,835983307
420,2370480,2950654,5321134,4,0,0,512,29,8328078640
421,2371010,38949,2409959,0,0,1,17408,9,2045991830
422,2373060,1362600,3735660,4,0,0,512,29,5663842585
423,2389950,20675,2410625,4,0,1,11264,29,10434363943
424,2391850,1218335,3610185,4,0,0,2048,29,989510515
425,2410950,2666184,5077134,2,0,0,3584,0,7646420686
426,2418670,1896794,4315464,6,0,0,4096,11,8969789322
427,2420230,3207623,5627853,2,0,0,133120,0,1154122367
428,2425199,2484135,4909334,0,0,0,59904,9,8005421981
429,2428619,2818088,5246707,7,0,0,1536,5,9184990091
430,2430379,1721448,4151827,9,0,0,10752,9,10467058654
431,2431130,23908,2455038,0,0,1,34816,9,10056055605
432,2435950,19434,2455384,4,0,1,512,29,3208249
433,2445140,3275346,5720486,6,0,0,10240,11,351086243
434,2452950,2252189,4705139,8,0,0,28672,17,1579234151
435,2454499,3283965,5738464,1,0,0,11264,22,8043626091
436,2457890,2946,2460836,0,0,1,3072,9,489600912
437,2468800,3483693,5952493,5,0,0,171520,25,8941576270
438,2474690,3408957,5883647,2,0,0,12800,0,2208708397
439,2480779,1955628,4436407,0,0,0,14336,9,4232594013
440,2484510,729419,3213929,8,0,0,3072,17,3363020357
441,2501090,1447,2502537,4,0,1,1024,29,9612450530
442,2508789,1851661,4360450,0,0,0,15360,9,826995668
443,2509540,1898843,4408383,8,0,0,5120,17,4809027168
444,2509560,1069415,3578975,4,0,0,1024,29,7361329957
445,2509679,3530849,6040528,9,0,0,51712,9,6472057806
446,2511480,128322,2639802,4,0,1,1024,29,5099864694
447,2516470,4379649,6896119,5,0,0,59392,25,5721291883
448,2528689,2993821,5522510,7,0,0,2560,5,4480150149
449,2531780,3421252,5953032,4,0,0,1536,29,10727014529
450,2537390,1894566,4431956,4,0,0,2048,29,8154608634
451,2549940,1970502,4520442,8,0,0,7168,17,960060940
452,2553510,3419708,5973218,4,0,0,512,29,409544341
453,2582609,1560589,4143198,9,0,0,5632,9,6627901737
454,2583499,1748577,4332076,0,0,0,1536,9,1883665122
455,2599080,2921505,5520585,2,0,0,50176,0,1417474478
456,2601170,59644,2660814,4,0,1,3072,29,10734370990
457,2602160,2256451,4858611,4,0,0,512,29,3968518463
458,2603129,1503170,4106299,9,0,0,14848,9,433063287
459,2604570,100393,2704963,0,0,1,80384,9,1499624082
460,2604790,115624,2720414,0,0,1,57344,9,3639427992
461,2613969,1044546,3658515,7,0,0,512,5,10630531743
462,2617080,3719806,6336886,5,0,0,59904,25,2543382605
463,2625369,3680810,6306179,9,0,0,53248,9,5262260351
464,2627950,95370,2723320,4,0,1,4608,29,6347320288
465,2631700,120918,2752618,4,0,1,20992,29,6143010901
466,2645239,1557051,4202290,9,0,0,7680,9,10398320320
467,2649989,1180962,3830951,7,0,0,1024,5,3542260309
468,2652750,2985289,5638039,6,0,0,3072,11,7199562370
469,2654970,2634865,5289835,8,0,0,1536,17,6250521829
470,2656819,2589405,5246224,1,0,0,86528,22,5256794530
471,2657340,3157150,5814490,5,0,0,68096,25,8003029124
472,2671500,1605748,4277248,4,0,0,512,29,1837378780
473,2677320,75313,2752633,0,0,1,13824,9,248850325
474,2683340,69308,2752648,0,0,1,10240,9,8192793620
475,2695100,2892162,5587262,5,0,0,53760,25,10362517860
476,2699619,1887366,4586985,7,0,0,2560,5,7846367874
477,2709760,3461080,6170840,5,0,0,14336,25,627929329
478,2716679,4550484,7267163,9,0,0,50688,9,425803349
479,2722250,3364400,6086650,6,0,0,103936,11,1618608875
480,2722720,29943,2752663,7,0,1,1536,5,10558880409
481,2741189,1976960,4718149,9,0,0,20480,9,3679117761
482,2746050,1699455,4445505,2,0,0,5120,0,2050929910
483,2751100,3831462,6582562,6,0,0,4096,11,7372793233
484,2752870,3220153,5973023,2,0,0,65536,0,6827648062
485,2765779,59488,2825267,5,0,1,512,25,4029830625
486,2770920,77574,2848494,0,0,1,42496,9,2133575514
487,2771030,2414780,5185810,8,0,0,7168,17,2824712972
488,2773109,110375,2883484,1,0,1,7168,22,343841041
489,2777400,106099,2883499,0,0,1,5632,9,1006806436
490,2789069,3353061,6142130,9,0,0,91136,9,1323724167
491,2789079,874790,3663869,9,0,0,3584,9,678546788
492,2801100,82446,2883546,0,0,1,46080,9,3951761616
493,2802079,81482,2883561,5,0,1,9728,25,7011984614
494,2802290,3312049,6114339,5,0,0,53248,25,3309435692
495,2827600,2255350,5082950,5,0,0,512,25,1121325575
496,2834219,2904416,5738635,7,0,0,512,5,2666049295
497,2858919,2551634,5410553,1,0,0,33280,22,10194439774
498,2866270,4619963,7486233,0,0,1,47616,9,8593231631
499,2871780,1242898,4114678,5,0,0,19968,25,9929654633
500,2873509,1822807,4696316,0,0,0,23552,9,8493201513
501,2874379,6288885,9163264,5,0,1,15360,25,4578450231
502,2878610,3280102,6158712,6,0,0,38912,11,4083604113
503,2882510,4575106,7457616,8,0,0,99328,17,2107399013
504,2886430,3129498,6015928,6,0,0,108032,11,4185405565
505,2889999,4535482,7425481,0,0,0,86016,9,1097687547
506,2896469,3582545,6479014,1,0,0,32256,22,8628478797
507,2897190,4120744,7017934,8,0,0,128000,17,8564679211
508,2897700,3668561,6566261,8,0,0,12800,17,10310963039
509,2900549,6614873,9515422,1,0,1,1536,22,1847683031
510,2902670,6616298,9518968,9,0,1,5632,9,6547278603
511,2903639,6879011,9782650,5,0,1,19968,25,9067464895
512,2906209,4602401,7508610,0,0,0,52736,9,7546612036
513,2911949,2199066,5111015,0,0,0,25088,9,6832138743
514,2923950,2104732,5028682,6,0,0,60928,11,4448046721
515,2927629,2564367,5491996,1,0,0,74240,22,10204069021
516,2934300,3513167,6447467,6,0,0,88576,11,3007722913
517,2960729,2234106,5194835,7,0,0,512,5,4455255291
518,2962299,3741426,6703725,9,0,0,16384,9,4286168131
519,2973309,3687537,6660846,9,0,0,76288,9,5025676544
520,2973480,6900068,9873548,9,0,1,10240,9,9246358033
521,2976480,7285333,10261813,9,0,1,22528,9,10367231589
522,2979089,3327737,6306826,7,0,0,2048,5,10456348318
523,2989209,2777953,5767162,7,0,0,1024,5,5732670676
524,2989570,3108522,6098092,2,0,0,32256,0,243912158
525,2991709,4303085,7294794,0,0,0,16896,9,1510281843
526,2999160,1837877,4837037,8,0,0,1024,17,1458817952
527,3012600,7587720,10600320,9,0,1,27136,9,5279464235
528,3013559,7586784,10600343,5,0,1,7168,25,356861866
529,3017019,978594,3995613,7,0,0,512,5,6536166967
530,3022820,7577546,10600366,0,0,1,1536,9,2382120797
531,3023260,3850354,6873614,6,0,0,100864,11,9509361411
532,3029430,7570967,10600397,3,0,1,6144,25,8724142673
533,3029720,3593950,6623670,4,0,0,512,29,5094768548
534,3031459,2251408,5282867,9,0,0,40448,9,8571880193
535,3031830,7578129,10609959,3,0,1,2560,25,4170382358
536,3039739,1354250,4393989,9,0,0,4096,9,2912471651
537,3048609,2152630,5201239,9,0,0,4608,9,5778943662
538,3057920,7971288,11029208,0,0,1,9728,9,10279884570
539,3057979,8007785,11065764,5,0,1,3584,25,4789623677
540,3062099,8045331,11107430,5,0,1,25088,25,685028004
541,3075790,5071301,8147091,2,0,0,11776,0,3787785143
542,3093180,3460832,6554012,6,0,0,7680,11,9046672672
543,3096410,8142956,11239366,3,0,1,2560,25,7557309297
544,3099759,5346689,8446448,0,0,0,28160,9,3101532068
545,3103310,3420213,6523523,2,0,0,31744,0,4182660982
546,3118079,1824710,4942789,7,0,0,1024,5,7423996576
547,3133600,8446114,11579714,0,0,1,96256,9,2611037971
548,3136380,1855729,4992109,8,0,0,19456,17,3601822318
549,3136960,3200292,6337252,4,0,0,512,29,6256990105
550,3141359,2016924,5158283,7,0,0,1536,5,6841468901
551,3144080,1866023,5010103,5,0,0,17408,25,7418577701
552,3144419,4618048,7762467,9,0,0,16384,9,9823419008
553,3144959,8434778,11579737,5,0,1,2560,25,1772020564
554,3154440,1639579,4794019,5,0,0,10752,25,3424540798
555,3155980,1707217,4863197,8,0,0,7168,17,356732002
556,3156559,1883682,5040241,0,0,0,37888,9,2460418272
557,3157980,3540395,6698375,6,0,0,57856,11,9988499884
558,3169579,2151774,5321353,9,0,0,512,9,2437769835
559,3171350,8914132,12085482,0,0,1,90624,9,8685594920
560,3177709,4609483,7787192,0,0,0,9728,9,8041681568
561,3200650,8940148,12140798,0,0,1,5120,9,2698052383
562,3206270,2431948,5638218,5,0,0,512,25,3413636524
563,3210550,9243863,12454413,0,0,1,61440,9,4270283873
564,3212060,9327654,12539714,0,0,1,18432,9,8352381809
565,3218449,3336054,6554503,9,0,0,1536,9,7906821049
566,3221120,3026825,6247945,4,0,0,1536,29,5390772503
567,3228139,5293720,8521859,7,0,0,512,5,10091020194
568,3228429,3082187,6310616,1,0,0,10752,22,7742473512
569,3236170,2034318,5270488,5,0,0,52736,25,8495114224
570,3239900,3272107,6512007,8,0,0,63488,17,1060648018
571,3245419,1269306,4514725,7,0,0,3072,5,1471201092
572,3248349,3625935,6874284,7,0,0,512,5,2698250644
573,3250840,5864639,9115479,5,0,0,44544,25,3816427405
574,3252450,1028026,4280476,4,0,0,1024,29,3881091537
575,3257639,3810107,7067746,1,0,0,49152,22,1247123239
576,3271280,9394642,12665922,0,0,1,60928,9,763960484
577,3278849,1250987,4529836,7,0,0,512,5,6283334856
578,3281200,9456066,12737266,3,0,1,15360,25,1692544945
579,3284440,9469505,12753945,3,0,1,4608,25,7754968963
580,3294449,9477601,12772050,5,0,1,15360,25,10388572431
581,3296459,6442393,9738852,9,0,0,512,9,4869173416
582,3303030,3248440,6551470,8,0,0,91648,17,4142237205
583,3311730,3142647,6454377,4,0,0,512,29,2882125620
584,3312549,1941840,5254389,9,0,0,1024,9,523413914
585,3314960,3880450,7195410,5,0,0,6144,25,4036452749
586,3317430,2582780,5900210,5,0,0,29184,25,837271306
587,3325200,2114936,5440136,4,0,0,512,29,2904501900
588,3329610,2725301,6054911,6,0,0,47104,11,7340105499
589,3337039,2345145,5682184,9,0,0,512,9,10020156603
590,3339179,682026,4021205,0,0,0,2048,9,1278115142
591,3361490,1580940,4942430,4,0,0,1024,29,7024961280
592,3370729,9459934,12830663,5,0,1,6656,25,266258661
593,3380510,9682526,13063036,0,0,1,131072,9,2070757529
594,3389610,2483183,5872793,2,0,0,68608,0,9767190380
595,3391239,3764911,7156150,1,0,0,33792,22,2692458998
596,3392789,3874709,7267498,0,0,0,1024,9,5453031199
597,3396670,3544735,6941405,8,0,0,62464,17,10239360521
598,3400389,2770809,6171198,1,0,0,512,22,1758527212
599,3402770,3984946,7387716,8,0,0,96768,17,6399890920
600,3413920,2602211,6016131,4,0,0,512,29,5775340019
601,3415629,9687960,13103589,5,0,1,4096,25,2099516927
602,3425539,9678073,13103612,5,0,1,7168,25,9201250384
603,3427260,4287379,7714639,4,0,0,512,29,3731504266
604,3428550,4755516,8184066,2,0,0,12800,0,9464559204
605,3435230,2100001,5535231,5,0,0,19456,25,8250656866
606,3436609,9701057,13137666,5,0,1,7680,25,7314291122
607,3449130,872131,4321261,5,0,0,512,25,6747566678
608,3449740,6122145,9571885,5,0,0,52736,25,2921398177
609,3456809,2861786,6318595,0,0,0,26112,9,7119045768
610,3457729,9679960,13137689,5,0,1,7680,25,3481837344
611,3462990,4969684,8432674,5,0,0,82944,25,5820855430
612,3463340,3612187,7075527,6,0,0,11776,11,8357245643
613,3465579,9672133,13137712,5,0,1,11776,25,9345104645
614,3466120,3046378,6512498,4,0,0,1536,29,7255315479
615,3480450,4405528,7885978,6,0,0,74240,11,782742381
616,3482160,3311100,6793260,6,0,0,3584,11,2378604197
617,3490359,9650535,13140894,5,0,1,10240,25,1742150861
618,3496670,3126821,6623491,2,0,0,109568,0,4151578106
619,3508899,3977311,7486210,9,0,0,1024,9,217231655
620,3518569,2506172,6024741,0,0,0,19456,9,5292007895
621,3519130,4991381,8510511,4,0,0,2048,29,1205133977
622,3521499,9649081,13170580,5,0,1,13824,25,7420910603
623,3522050,3505625,7027675,6,0,0,1536,11,1694548699
624,3524890,3586391,7111281,6,0,0,53248,11,9354880027
625,3528019,779558,4307577,1,0,0,3072,22,5699786095
626,3533610,3683021,7216631,2,0,0,14336,0,9473962582
627,3542910,2911288,6454198,5,0,0,22016,25,10420280048
628,3545549,9625054,13170603,5,0,1,10240,25,8377293277
629,3545780,3083864,6629644,2,0,0,18944,0,8108567823
630,3552909,3404306,6957215,0,0,0,19456,9,831968542
631,3568430,6346107,9914537,6,0,0,16384,11,9063479965
632,3568649,3061486,6630135,9,0,0,1536,9,9231167026
633,3576459,9609166,13185625,5,0,1,6656,25,2340153358
634,3583149,2724168,6307317,9,0,0,1536,9,9589479939
635,3588659,9596989,13185648,5,0,1,2560,25,2686491558
636,3591020,3160473,6751493,8,0,0,44544,17,4970149855
637,3601419,4618809,8220228,1,0,0,19456,22,8198395795
638,3608060,4880803,8488863,2,0,0,94720,0,2700928074
639,3614410,3354241,6968651,6,0,0,30208,11,878622269
640,3615300,9608404,13223704,0,0,1,64000,9,381960180
641,3616889,2896412,6513301,9,0,0,2560,9,3950623497
642,3620979,9602748,13223727,5,0,1,11264,25,2271299968
643,3624760,10340559,13965319,0,0,1,214528,9,8501827053
644,3635570,3570880,7206450,4,0,0,2048,29,10516550012
645,3637389,1647526,5284915,7,0,0,512,5,5867609836
646,3644539,716706,4361245,7,0,0,2560,5,2114701887
647,3649150,3496681,7145831,5,0,0,20480,25,2726950325
648,3652180,2595274,6247454,5,0,0,118784,25,6312460262
649,3652630,3942645,7595275,2,0,0,100352,0,1155832792
650,3658700,1690862,5349562,6,0,0,10240,11,5419931142
651,3665499,3843766,7509265,7,0,0,2048,5,5251244233
652,3666739,3953353,7620092,0,0,0,4096,9,2682611261
653,3671269,2997088,6668357,2,0,0,24576,0,7733355668
654,3673159,2144535,5817694,9,0,0,512,9,5326906825
655,3675349,10412684,14088033,5,0,1,6144,25,1115455372
656,3682389,3275481,6957870,9,0,0,2048,9,1865669817
657,3683679,2668572,6352251,0,0,0,49152,9,10298691858
658,3692370,10585011,14277381,0,0,1,97280,9,9499176768
659,3696260,6428907,10125167,5,0,0,51200,25,3255140267
660,3700130,10701317,14401447,0,0,1,103424,9,6929020632
661,3701119,10701314,14402433,5,0,1,1536,25,2162915756
662,3708429,2056402,5764831,9,0,0,3072,9,49445872
663,3710379,833776,4544155,0,0,0,2560,9,5325165734
664,3720929,2450090,6171019,9,0,0,512,9,2642620016
665,3720939,1188745,4909684,9,0,0,512,9,9047448300
666,3726949,3960647,7687596,0,0,0,60416,9,3512118680
667,3729530,5235486,8965016,1,0,0,36352,22,7406750338
668,3736591,10667148,14403739,8,0,1,2048,17,1415050156
669,3738430,10669495,14407925,0,0,1,6656,9,8703430933
670,3740580,10727296,14467876,0,0,1,58368,9,9559619297
671,3746029,1654361,5400390,7,0,0,512,5,276136746
672,3752499,2406868,6159367,0,0,0,2048,9,10246368627
673,3760120,4943380,8703500,4,0,0,512,29,9144550271
674,3761549,1888402,5649951,7,0,0,512,5,9384406378
675,3765849,10702050,14467899,5,0,1,2048,25,5888989343
676,3766100,2949968,6716068,6,0,0,11776,11,6495305218
677,3769029,10698893,14467922,5,0,1,12800,25,6092757786
678,3769330,4235665,8004995,5,0,0,70144,25,1562279069
679,3770730,2410826,6181556,4,0,0,3072,29,2445254285
680,3770850,5016254,8787104,1,0,0,9216,22,9160868465
681,3774070,1212088,4986158,4,0,0,512,29,2525333995
682,3778350,10722661,14501011,4,0,1,3584,29,4332987962
683,3786600,10855528,14642128,0,0,1,58880,9,9050287175
684,3788169,10897591,14685760,5,0,1,512,25,10584015668
685,3798510,3627314,7425824,4,0,0,1024,29,5811758763
686,3799829,3536778,7336607,7,0,0,512,5,5196110885
687,3801080,224257,4025337,6,0,0,1536,11,636204413
688,3802960,3949789,7752749,6,0,0,56832,11,1927254216
689,3802981,10882802,14685783,8,0,1,4096,17,6222037542
690,3812369,10873437,14685806,5,0,1,10240,25,5368300582
691,3813670,2855022,6668692,5,0,0,1024,25,10598328671
692,3826230,10859599,14685829,4,0,1,512,29,5123750262
693,3826580,2898464,6725044,5,0,0,26112,25,9843166233
694,3828809,2663644,6492453,0,0,0,44032,9,8780631952
695,3843540,4520675,8364215,5,0,0,151040,25,4826109667
696,3860449,3166735,7027184,0,0,0,29184,9,8058417094
697,3861379,4791938,8653317,2,0,0,67072,0,8117744151
698,3864649,1772439,5637088,2,0,0,30208,0,6684452384
699,3866219,3933763,7799982,7,0,0,1024,5,5250116799
700,3875820,10821475,14697295,3,0,1,6656,25,5091050938
701,3887481,10816737,14704218,8,0,1,1536,17,1348296961
702,3891040,3031310,6922350,8,0,0,86016,17,10510995477
703,3897269,963697,4860966,0,0,0,7680,9,930118512
704,3898320,10806564,14704884,4,0,1,1024,29,8641324225
705,3899170,10822323,14721493,0,0,1,34816,9,4853074563
706,3900560,5262681,9163241,8,0,0,10240,17,560445310
707,3903051,10821141,14724192,8,0,1,6656,17,7542815515
708,3903110,11089965,14993075,0,0,1,163328,9,5596211942
709,3906750,11096595,15003345,0,0,1,33280,9,8297073305
710,3927879,3470872,7398751,9,0,0,512,9,5674019765
711,3933709,3722044,7655753,2,0,0,512,0,8479515243
712,3934780,2939325,6874105,4,0,0,1536,29,3665008882
713,3949970,2856538,6806508,5,0,0,23040,25,6676987926
714,3966549,11038742,15005291,5,0,1,3072,25,9223304499
715,3977830,11093041,15070871,0,0,1,46592,9,3743524222
716,3978629,3193002,7171631,0,0,0,19456,9,10081612421
717,3980780,3920854,7901634,6,0,0,27136,11,8964703409
718,3985180,11150196,15135376,4,0,1,3584,29,1180530407
719,3987330,3562457,7549787,8,0,0,71168,17,9169042466
720,3993990,11141409,15135399,4,0,1,2560,29,3897909733
721,3994030,11202278,15196308,4,0,1,13312,29,4261010797
722,3998470,3490750,7489220,6,0,0,9728,11,3436009108
723,3999959,2736588,6736547,7,0,0,1024,5,4678876142
724,4003080,11193251,15196331,4,0,1,11264,29,2209221569
725,4021420,3464455,7485875,6,0,0,92672,11,1887411127
726,4027869,976830,5004699,2,0,0,22528,0,1567381276
727,4029230,11198035,15227265,9,0,1,4096,9,2711216875
728,4030969,2599345,6630314,9,0,0,512,9,1998794070
729,4034580,11192716,15227296,4,0,1,3584,29,151023138
730,4034869,11192450,15227319,5,0,1,1536,25,282806410
731,4037969,6267312,10305281,0,0,0,73728,9,2254634917
732,4049780,4141587,8191367,4,0,0,512,29,2748809055
733,4057989,2729586,6787575,7,0,0,512,5,1658194874
734,4059339,11168003,15227342,5,0,1,9728,25,2396878173
735,4060289,1958509,6018798,2,0,0,8704,0,9465773882
736,4065090,3454158,7519248,4,0,0,512,29,10184223189
737,4071819,11155546,15227365,5,0,1,36352,25,7476065507
738,4085279,11161218,15246497,5,0,1,50688,25,1635137268
739,4088489,2646858,6735347,2,0,0,7168,0,10251453656
740,4091589,817916,4909505,9,0,0,512,9,7986276545
741,4091719,11182514,15274233,5,0,1,54272,25,4708372503
742,4092909,4038981,8131890,0,0,0,14336,9,1163365064
743,4097060,11177196,15274256,7,0,1,4608,5,8090569325
744,4105470,3663728,7769198,5,0,0,22016,25,10093980051
745,4107079,5214405,9321484,0,0,0,31232,9,5591185790
746,4110339,11333204,15443543,5,0,1,113152,25,2937621312
747,4112480,11331086,15443566,4,0,1,512,29,2135367243
748,4122689,1767806,5890495,2,0,0,7168,0,3509195502
749,4128290,366137,4494427,4,0,0,512,29,8212908840
750,4130100,3521699,7651799,5,0,0,103936,25,5279016274
751,4138100,2560610,6698710,4,0,0,1024,29,1997950587
752,4151659,1340680,5492339,7,0,0,1024,5,1959553892
753,4153030,11290567,15443597,7,0,1,2048,5,8495239736
754,4155489,11288131,15443620,5,0,1,5632,25,8226323873
755,4158439,3533860,7692299,0,0,0,15360,9,10386985645
756,4182610,3895675,8078285,5,0,0,33792,25,437547569
757,4183189,3632750,7815939,9,0,0,512,9,1308683427
758,4190399,11347214,15537613,5,0,1,67584,25,808406156
759,4192219,2965810,7158029,0,0,0,4608,9,6325763962
760,4192399,907898,5100297,9,0,0,1024,9,10436669119
761,4198070,2590152,6788222,4,0,0,2048,29,3454967990
762,4200999,1945834,6146833,2,0,0,15360,0,3908533288
763,4203929,11517329,15721258,5,0,1,89088,25,8368523486
764,4206079,11661586,15867665,5,0,1,128000,25,10091384990
765,4206510,4160544,8367054,8,0,0,9216,17,5843369170
766,4236919,11659259,15896178,5,0,1,43008,25,3254049225
767,4238489,2719568,6958057,9,0,0,512,9,2109315854
768,4239649,2778620,7018269,9,0,0,1024,9,7475791727
769,4245729,2995602,7241331,7,0,0,512,5,5832446461
770,4247269,11692410,15939679,5,0,1,46080,25,7773823131
771,4250140,11689562,15939702,4,0,1,512,29,7818317044
772,4255490,3034133,7289623,6,0,0,18432,11,1981491243
773,4257129,5176478,9433607,0,0,0,16384,9,8001894288
774,4261520,2530625,6792145,5,0,0,12800,25,10343579225
775,4264249,3162846,7427095,9,0,0,4096,9,2773673965
776,4264849,2865050,7129899,9,0,0,512,9,8646317463
777,4265429,11722399,15987828,5,0,1,71680,25,1644629067
778,4265570,1618404,5883974,5,0,0,1024,25,870587214
779,4268490,11720324,15988814,4,0,1,1536,29,2234333783
780,4287750,11703853,15991603,4,0,1,3072,29,5363823828
781,4288429,11761291,16049720,5,0,1,115712,25,8734284982
782,4319610,2836719,7156329,4,0,0,512,29,944931006
783,4321409,4045824,8367233,2,0,0,512,0,9906678974
784,4322030,1055034,5377064,5,0,0,36352,25,4957241584
785,4322110,1318613,5640723,4,0,0,512,29,977643262
786,4322199,5317995,9640194,0,0,0,39424,9,8441912165
787,4329449,11744300,16073749,5,0,1,33280,25,4782669540
788,4354570,5504884,9859454,5,0,0,39936,25,4135575906
789,4358840,11715895,16074735,4,0,1,1536,29,10687633127
790,4360929,4135312,8496241,9,0,0,1536,9,54075086
791,4364649,11934834,16299483,5,0,1,235008,25,12810744
792,4369609,11933665,16303274,5,0,1,30720,25,1489369569
793,4371189,3138255,7509444,7,0,0,512,5,2157156336
794,4371750,11935710,16307460,7,0,1,6656,5,6550254404
795,4372000,727970,5099970,4,0,0,512,29,4983433922
796,4372969,3514170,7887139,7,0,0,1024,5,2096851377
797,4377730,2752512,7130242,4,0,0,1024,29,5086925824
798,4379260,3113259,7492519,6,0,0,10752,11,3391530176
799,4379969,3011358,7391327,0,0,0,11776,9,4608628189
800,4389899,2561365,6951264,2,0,0,32256,0,10657307306
801,4392009,11917077,16309086,5,0,1,2560,25,1268704716
802,4394079,3202186,7596265,0,0,0,512,9,8598788664
803,4402180,11907777,16309957,4,0,1,12288,29,2177981297
804,4405800,11910609,16316409,7,0,1,10240,5,2589396210
805,4423390,11893365,16316755,7,0,1,512,5,4818711915
806,4430000,3120457,7550457,6,0,0,1536,11,865947826
807,4441570,2949936,7391506,4,0,0,512,29,338091266
808,4442140,11878801,16320941,7,0,1,6656,5,2864441363
809,4446730,11893310,16340040,4,0,1,5632,29,7598516731
810,4448369,1272296,5720665,7,0,0,512,5,8384619489
811,4448940,11893046,16341986,7,0,1,3072,5,8726451754
812,4453579,11889393,16342972,5,0,1,1536,25,10506162057
813,4453910,11893248,16347158,7,0,1,6656,5,3703799767
814,4461470,11886713,16348183,7,0,1,1536,5,507645655
815,4464649,4397098,8861747,0,0,0,117760,9,2454463909
816,4473609,2595096,7068705,9,0,0,3072,9,4863656052
817,4479659,11873030,16352689,5,0,1,7168,25,8002931354
818,4483510,2860143,7343653,5,0,0,3072,25,10397657427
819,4485510,11869125,16354635,7,0,1,3072,5,1729150379
820,4490129,2213775,6703904,7,0,0,512,5,6707849851
821,4495960,5898071,10394031,6,0,0,39424,11,4231693435
822,4497190,11860057,16357247,7,0,1,4096,5,9517765175
823,4502719,3284964,7787683,7,0,0,1536,5,747340712
824,4504509,1832564,6337073,9,0,0,512,9,2327414931
825,4526980,3268335,7795315,5,0,0,6656,25,5958907293
826,4533060,11824751,16357811,4,0,1,10752,29,6848213039
827,4536710,2339157,6875867,6,0,0,5120,11,5721177456
828,4549199,2778869,7328068,2,0,0,70656,0,9269689717
829,4551739,3716926,8268665,9,0,0,1024,9,5668112480
830,4553989,3101585,7655574,0,0,0,12288,9,5472776248
831,4561459,3222738,7784197,0,0,0,49152,9,6648210128
832,4563050,11799293,16362343,7,0,1,7168,5,2362994037
833,4565270,3030808,7596078,4,0,0,2560,29,9333296646
834,4571410,3095973,7667383,8,0,0,10240,17,4355750559
835,4581020,11784229,16365249,4,0,1,4608,29,9749585996
836,4602459,4734105,9336564,2,0,0,10752,0,9956048577
837,4605900,4125624,8731524,8,0,0,5632,17,979826368
838,4606389,3280929,7887318,7,0,0,512,5,3181367101
839,4612990,3704691,8317681,5,0,0,32768,25,8177681757
840,4613440,11756635,16370075,4,0,1,7680,29,6742119861
841,4619260,3183085,7802345,4,0,0,1024,29,3270672184
842,4626219,11745482,16371701,2,0,1,2560,0,7791984651
843,4627800,3867950,8495750,8,0,0,22528,17,2724294463
844,4640239,1526202,6166441,9,0,0,1024,9,2430196802
845,4647440,11725567,16373007,7,0,1,2048,5,7696380500
846,4648879,3199738,7848617,0,0,0,73728,9,1087022110
847,4651660,11722653,16374313,7,0,1,2048,5,9929712267
848,4653869,11720790,16374659,2,0,1,512,0,5220966282
849,4657459,2741791,7399250,7,0,0,1536,5,7166650686
850,4662370,2934386,7596756,4,0,0,1536,29,8839135336
851,4662900,11714665,16377565,7,0,1,4608,5,7578562022
852,4678570,11706407,16384977,7,0,1,11776,5,7194482993
853,4680310,11706613,16386923,4,0,1,3072,29,9299960220
854,4690960,11697909,16388869,4,0,1,3072,29,9764931680
855,4691359,3363418,8054777,7,0,0,512,5,9214461468
856,4698959,11691216,16390175,2,0,1,2048,0,6985496283
857,4707299,11686102,16393401,2,0,1,5120,0,2541588462
858,4718739,2454007,7172746,7,0,0,3584,5,10069541592
859,4728900,11664847,16393747,7,0,1,512,5,890435693
860,4730740,11667193,16397933,7,0,1,6656,5,2680178791
861,4758609,3129044,7887653,9,0,0,1024,9,5205589235
862,4762289,11637590,16399879,2,0,1,3072,0,6155115972
863,4772210,3076586,7848796,4,0,0,512,29,9301332390
864,4777669,2620903,7398572,0,0,0,22528,9,3630985652
865,4780349,11624310,16404659,2,0,1,16896,0,479638308
866,4787230,11618095,16405325,7,0,1,1024,5,5096974683
867,4789199,3097114,7886313,9,0,0,1024,9,3050649996
868,4794649,11610830,16405479,2,0,1,8704,0,6151983360
869,4808239,3499100,8307339,0,0,0,126464,9,4154369478
870,4815539,4440233,9255772,0,0,0,7168,9,1049039504
871,4815840,3047487,7863327,8,0,0,47616,17,2463801924
872,4819849,11586936,16406785,2,0,1,2048,0,7240891143
873,4832300,3543544,8375844,5,0,0,28160,25,7205265224
874,4833190,4304588,9137778,5,0,0,45056,25,1013008091
875,4835050,2729626,7564676,5,0,0,46592,25,851444992
876,4839779,11567672,16407451,2,0,1,1024,0,3788679738
877,4845160,4176130,9021290,6,0,0,23552,11,4022724791
878,4851970,11556467,16408437,7,0,1,1536,5,9968312308
879,4867359,11542704,16410063,2,0,1,2560,0,8134778901
880,4874580,3228198,8102778,8,0,0,21504,17,5999527817
881,4880681,11530368,16411049,8,0,1,1536,17,3982137815
882,4881880,3627805,8509685,8,0,0,23552,17,7344458602
883,4888609,11526306,16414915,2,0,1,6144,0,3471891474
884,4902899,2124963,7027862,9,0,0,512,9,7981415611
885,4907990,4692622,9600612,5,0,0,94208,25,8596749839
886,4908059,5909983,10818042,9,0,0,512,9,959779503
887,4909190,11508017,16417207,7,0,1,3584,5,6521590103
888,4912149,3585588,8497737,7,0,0,1024,5,2220121775
889,4925769,2053142,6978911,0,0,0,7680,9,6802446939
890,4927759,3568817,8496576,7,0,0,1024,5,6747037655
891,4928920,3167283,8096203,8,0,0,56832,17,5459257258
892,4930369,11488144,16418513,2,0,1,2048,0,3739633525
893,4932580,4074913,9007493,6,0,0,40448,11,536420605
894,4936930,4794068,9730998,5,0,0,83456,25,3093227443
895,4941289,4800238,9741527,0,0,0,8704,9,3949263794
896,4943190,2792220,7735410,8,0,0,68096,17,3753058836
897,4967059,11451800,16418859,2,0,1,512,0,3600999916
898,4967400,3628185,8595585,6,0,0,11264,11,9257520715
899,4971329,846848,5818177,7,0,0,1536,5,10453039597
900,4971669,11448061,16419730,2,0,1,12288,0,7338860054
901,4972889,2629974,7602863,6,0,0,19968,11,7196280034
902,4992459,1594806,6587265,6,0,0,15360,11,9864142112
903,4998730,2037629,7036359,4,0,0,512,29,7161245678
904,5004210,3403169,8407379,5,0,0,103424,25,10267961964
905,5027750,2985536,8013286,8,0,0,27136,17,5412456934
906,5032690,3421737,8454427,5,0,0,26112,25,1770803248
907,5038660,11381416,16420076,9,0,1,512,9,5982699172
908,5048600,3646110,8694710,8,0,0,65024,17,7187123485
909,5064750,11389216,16453966,9,0,1,11264,9,5933612654
910,5067020,2893947,7960967,8,0,0,24576,17,5004057003
911,5070550,11383762,16454312,7,0,1,512,5,7178815488
912,5073090,4689924,9763014,4,0,0,512,29,1657166546
913,5074820,11404182,16479002,9,0,1,15872,9,10204984645
914,5083359,5473306,10556665,6,0,0,35328,11,1614763629
915,5086969,3422895,8509864,9,0,0,512,9,7175843782
916,5092939,3367041,8459980,7,0,0,512,5,1903008939
917,5100350,11378675,16479025,9,0,1,4608,9,4106578292
918,5114809,1377823,6492632,9,0,0,512,9,2205025359
919,5118210,11361111,16479321,7,0,1,8192,5,3654161165
920,5121279,2270406,7391685,7,0,0,512,5,9844238576
921,5140130,11340177,16480307,7,0,1,1536,5,10506990111
922,5144790,4996000,10140790,4,0,0,51200,29,6196688478
923,5149969,3347098,8497067,9,0,0,1536,9,7636958499
924,5152669,3948382,9101051,9,0,0,1536,9,811437375
925,5158570,11323363,16481933,6,0,1,2560,11,4698540463
926,5168230,11316609,16484839,6,0,1,4608,11,2523088438
927,5192780,11293135,16485915,6,0,1,13312,11,2804258304
928,5194950,4744022,9938972,8,0,0,27136,17,2606115764
929,5196130,5178339,10374469,4,0,0,16384,29,9632517011
930,5198660,11288241,16486901,9,0,1,1536,9,5161237445
931,5204899,11282348,16487247,2,0,1,512,0,875596840
932,5205250,2938051,8143301,4,0,0,37376,29,2588328640
933,5205719,2344247,7549966,7,0,0,512,5,700597294
934,5210590,11295403,16505993,6,0,1,10752,11,4506400618
935,5212749,2674055,7886804,7,0,0,1536,5,1558268160
936,5218340,3511145,8729485,8,0,0,2048,17,105568431
937,5222990,3312429,8535419,5,0,0,9728,25,5690660242
938,5232060,11275559,16507619,9,0,1,2560,9,7152354656
939,5232710,5343010,10575720,4,0,0,62464,29,2821398667
940,5255739,3718036,8973775,0,0,0,28672,9,7586541472
941,5256359,4781355,10037714,0,0,0,37888,9,2191953862
942,5261159,11251747,16512906,2,0,1,16896,0,6847255285
943,5264990,11258214,16523204,7,0,1,15360,5,9877507411
944,5272030,11276074,16548104,6,0,1,13824,11,5048915359
945,5273759,3223643,8497402,0,0,0,1024,9,10197279109
946,5274650,3398211,8672861,8,0,0,61440,17,1025744208
947,5283790,3470186,8753976,5,0,0,44032,25,4273617111
948,5289019,1262630,6551649,7,0,0,512,5,2932910686
949,5293460,11255630,16549090,9,0,1,1536,9,6100400729
950,5296840,11274656,16571496,7,0,1,10752,5,4997107831
951,5298209,1831511,7129720,6,0,0,60416,11,10295572481
952,5305540,11267582,16573122,6,0,1,2560,11,5461668014
953,5308399,2903238,8211637,7,0,0,2048,5,5757711332
954,5310250,3452150,8762400,4,0,0,6144,29,8663016640
955,5324560,2782297,8106857,5,0,0,13312,25,1494245367
956,5325480,11249588,16575068,6,0,1,3072,11,7948919827
957,5326779,4758444,10085223,6,0,0,26624,11,6266949999
958,5344940,11231114,16576054,6,0,1,1536,11,7288723914
959,5347960,11228440,16576400,3,0,1,512,25,9423764708
960,5365969,3410383,8776352,0,0,0,9216,9,2962287217
961,5373319,2740059,8113378,9,0,0,512,9,6012277771
962,5373779,792319,6166098,6,0,0,22016,11,10686879781
963,5382789,4894210,10276999,0,0,0,43008,9,3627484095
964,5387180,11250816,16637996,3,0,1,12288,25,555072297
965,5387929,3209670,8597599,0,0,0,5120,9,1266565866
966,5388609,3481296,8869905,0,0,0,25600,9,7909619871
967,5394910,3042935,8437845,4,0,0,16896,29,6049256517
968,5397719,1226130,6623849,9,0,0,512,9,7840562420
969,5401330,11251835,16653165,3,0,1,512,25,6573059936
970,5411289,5198647,10609936,6,0,0,31232,11,6845687173
971,5418499,11235652,16654151,2,0,1,1536,0,7070868421
972,5431299,3377636,8808935,6,0,0,9216,11,7722688856
973,5431700,11233888,16665588,0,0,1,512,9,9553359870
974,5433720,11231899,16665619,6,0,1,8192,11,9801788422
975,5457990,3702108,9160098,5,0,0,22528,25,3656436684
976,5476239,2129455,7605694,0,0,0,9216,9,2979205140
977,5477520,5000515,10478035,8,0,0,9216,17,3356601227
978,5489630,11176012,16665642,3,0,1,512,25,9128471838
979,5499179,3530181,9029360,7,0,0,512,5,9208251802
980,5508799,1586235,7095034,0,0,0,37888,9,7650612806
981,5509279,11156386,16665665,2,0,1,11776,0,8686649956
982,5509980,11174718,16684698,0,0,1,24064,9,7160856136
983,5534380,11160422,16694802,3,0,1,13312,25,2767093010
984,5556800,3696765,9253565,8,0,0,59392,17,6058890215
985,5559779,4779804,10339583,0,0,0,39936,9,8384505393
986,5561200,3324195,8885395,4,0,0,50176,29,5755933473
987,5578100,11118648,16696748,0,0,1,3072,9,10111055053
988,5579660,5357948,10937608,8,0,0,3072,17,619513524
989,5583370,11122523,16705893,3,0,1,5632,25,6679509762
990,5601120,11107679,16708799,6,0,1,4608,11,5556048382
991,5625910,11085795,16711705,6,0,1,4608,11,1305005312
992,5632269,999004,6631273,9,0,0,3072,9,10016591903
993,5651180,3069659,8720839,4,0,0,56832,29,6550150836
994,5658489,2484991,8143480,9,0,0,512,9,5545957848
995,5662649,11054202,16716851,2,0,1,8192,0,602962509
996,5665009,2586438,8251447,9,0,0,512,9,8695123424
997,5674669,3510620,9185289,0,0,0,6144,9,5881935544
998,5679999,2431904,8111903,7,0,0,1024,5,1012207695
999,5695060,11236375,16931435,0,0,1,87552,9,9694553766
1000,5702990,11228468,16931458,3,0,1,3072,25,10230043886
1001,5706310,11284938,16991248,0,0,1,88576,9,1349603360
1002,5720839,11297608,17018447,2,0,1,4608,0,24841658
1003,5725580,11292890,17018470,3,0,1,3584,25,9557835614
1004,5728060,11290433,17018493,3,0,1,6656,25,9809214050
1005,5728700,4917139,10645839,8,0,0,17920,17,7188823697
1006,5735929,1570588,7306517,6,0,0,38400,11,2234316834
1007,5739570,11284389,17023959,3,0,1,512,25,5672829273
1008,5754940,11270965,17025905,7,0,1,3072,5,1909939376
1009,5755260,1579021,7334281,5,0,0,2560,25,4634127676
1010,5759010,11267241,17026251,3,0,1,512,25,8518463297
1011,5762680,1994772,7757452,5,0,0,15360,25,6801972110
1012,5772569,3113005,8885574,9,0,0,512,9,5502713907
1013,5772830,11257927,17030757,0,0,1,7168,9,3122847013
1014,5773589,11267968,17041557,2,0,1,19456,0,4793550647
1015,5776149,312092,6088241,6,0,0,5120,11,1939247305
1016,5785709,11259074,17044783,2,0,1,5120,0,4315764943
1017,5800100,11246271,17046371,7,0,1,15872,5,8730072428
1018,5801250,2902063,8703313,5,0,0,28160,25,2450736720
1019,5806889,3315072,9121961,9,0,0,512,9,59090493
1020,5807039,3114679,8921718,7,0,0,1024,5,10000748711
1021,5807709,5221476,11029185,6,0,0,88576,11,5379086484
1022,5817200,11233357,17050557,3,0,1,6656,25,9378224233
1023,5821980,11229243,17051223,3,0,1,1024,25,3053480983
1024,5827319,3511163,9338482,9,0,0,1536,9,3305838451
1025,5828189,3185902,9014091,6,0,0,14336,11,2586652336
1026,5837220,1877240,7714460,5,0,0,33792,25,6788810241
1027,5838690,4979173,10817863,5,0,0,113152,25,10469800623
1028,5839979,2914176,8754155,9,0,0,512,9,7257233109
1029,5851230,11202899,17054129,7,0,1,4608,5,4033238530
1030,5857819,11198576,17056395,2,0,1,3584,0,4069616945
1031,5859869,3255953,9115822,9,0,0,1024,9,2154056324
1032,5866340,11204995,17071335,3,0,1,8704,25,9103769587
1033,5871769,11200232,17072001,2,0,1,1024,0,6461686145
1034,5891589,11180873,17072462,2,0,1,10240,0,5056486844
1035,5894699,11187739,17082438,2,0,1,4096,0,3872862102
1036,5898030,11184431,17082461,4,0,1,2048,29,9333695483
1037,5903619,2717816,8621435,9,0,0,1024,9,9434725497
1038,5904369,2957713,8862082,7,0,0,1024,5,8618553292
1039,5908749,3519843,9428592,9,0,0,512,9,10443344872
1040,5914820,11176134,17090954,7,0,1,8192,5,2744089773
1041,5917270,11173723,17090993,7,0,1,4096,5,7285742459
1042,5924699,3624000,9548699,0,0,0,45568,9,10224919544
1043,5926910,2044844,7971754,8,0,0,35328,17,9891833032
1044,5929539,11161477,17091016,2,0,1,12800,0,1832038159
1045,5936110,11154929,17091039,3,0,1,1024,25,9462542932
1046,5941239,11149823,17091062,2,0,1,8704,0,4417624936
1047,5941779,2691079,8632858,6,0,0,19456,11,6621861628
1048,5949730,11173828,17123558,4,0,1,512,29,4807929944
1049,5951699,1667122,7618821,0,0,0,43008,9,4244355374
1050,5953529,11173575,17127104,2,0,1,5632,0,7503093004
1051,5954450,2785365,8739815,5,0,0,27136,25,3863639774
1052,5961769,11166641,17128410,2,0,1,2048,0,8745335970
1053,5974600,11156640,17131240,7,0,1,14336,5,5810932425
1054,5986029,11149397,17135426,2,0,1,6656,0,3765429341
1055,5986079,11151636,17137715,2,0,1,9216,0,5037585394
1056,5988529,4894224,10882753,6,0,0,139264,11,1454470890
1057,5998180,5241163,11239343,5,0,0,33280,25,10596470659
1058,6004800,11145554,17150354,7,0,1,4096,5,63642863
1059,6011329,2520877,8532206,7,0,0,512,5,2681194906
1060,6011909,2934176,8946085,7,0,0,79872,5,3544725106
1061,6015030,11135347,17150377,3,0,1,2560,25,10316318837
1062,6015759,2799462,8815221,7,0,0,9216,5,526823914
1063,6015809,3689738,9705547,6,0,0,40960,11,1372061152
1064,6017330,1791057,7808387,5,0,0,13824,25,7969068998
1065,6018300,3209081,9227381,4,0,0,12800,29,3736590960
1066,6018440,3369032,9387472,5,0,0,51200,25,9337303401
1067,6018740,11131660,17150400,3,0,1,512,25,1944522630
1068,6021379,11129044,17150423,2,0,1,3072,0,621758222
1069,6032500,11117946,17150446,7,0,1,1536,5,5297750751
1070,6033939,3403420,9437359,9,0,0,512,9,2177543848
1071,6046289,1000027,7046316,0,0,0,16384,9,137303030
1072,6046389,2413388,8459777,9,0,0,1024,9,7332339547
1073,6046930,2271242,8318172,4,0,0,1536,29,5675566666
1074,6047700,2873683,8921383,8,0,0,57344,17,3051753903
1075,6050270,11100199,17150469,9,0,1,1536,9,3835461198
1076,6051100,11099392,17150492,3,0,1,4096,25,4190401571
1077,6059109,3041443,9100552,7,0,0,43520,5,7334146825
1078,6069940,3616685,9686625,4,0,0,37888,29,10648313225
1079,6077400,4186464,10263864,5,0,0,6656,25,1800769963
1080,6080080,3332531,9412611,5,0,0,82432,25,4090786480
1081,6082360,11068155,17150515,3,0,1,2048,25,4306817437
1082,6090560,11071669,17162229,9,0,1,9216,9,6199732720
1083,6092729,3780788,9873517,7,0,0,46080,5,1853999255
1084,6116300,11049475,17165775,3,0,1,5632,25,6094196924
1085,6119750,3712741,9832491,4,0,0,2048,29,7569056705
1086,6131680,4908003,11039683,8,0,0,34304,17,4738171277
1087,6136370,11046409,17182779,4,0,1,5120,29,5158171901
1088,6137549,5425219,11562768,0,0,0,68096,9,195879524
1089,6137899,3085559,9223458,7,0,0,74752,5,7876350717
1090,6149440,11048527,17197967,3,0,1,8704,25,6091163628
1091,6151109,11053457,17204566,2,0,1,512,0,5040608029
1092,6152740,11053452,17206192,7,0,1,2560,5,6202167483
1093,6158409,11049729,17208138,2,0,1,3072,0,8111308996
1094,6161039,3937935,10098974,7,0,0,45056,5,6342213536
1095,6164610,5064570,11229180,5,0,0,89600,25,2569012266
1096,6166989,4175004,10341993,6,0,0,6656,11,9259816361
1097,6173660,11035784,17209444,9,0,1,2048,9,877519632
1098,6176120,2727425,8903545,4,0,0,58880,29,325048738
1099,6178609,1882468,8061077,9,0,0,1024,9,8959953955
1100,6182580,11028208,17210788,3,0,1,8704,25,4797854722
1101,6194110,11037778,17231888,9,0,1,1024,9,9866171122
1102,6198010,11036464,17234474,7,0,1,4096,5,438308241
1103,6208980,11026160,17235140,9,0,1,1024,9,384650626
1104,6209220,11029786,17239006,7,0,1,6144,5,2858603998
1105,6212390,11030520,17242910,7,0,1,13312,5,3779503457
1106,6213100,11033831,17246931,7,0,1,13824,5,8035883355
1107,6213130,11036945,17250075,4,0,1,2048,29,3835289303
1108,6213570,3618274,9831844,8,0,0,30208,17,4189700122
1109,6214869,11035872,17250741,2,0,1,1024,0,3309276857
1110,6225359,11026368,17251727,2,0,1,1536,0,3108699262
1111,6235779,11020126,17255905,2,0,1,4096,0,3406943576
1112,6238550,11018021,17256571,7,0,1,11264,5,2229857196
1113,6251369,11006508,17257877,2,0,1,2048,0,2334435760
1114,6253470,3569139,9822609,4,0,0,131072,29,7491839628
1115,6278149,5110661,11388810,0,0,0,99328,9,5739166973
1116,6278249,2987328,9265577,0,0,0,17408,9,1153937479
1117,6280759,10980024,17260783,2,0,1,4608,0,1396072960
1118,6285129,2618759,8903888,9,0,0,1024,9,2689282053
1119,6286550,3141528,9428078,4,0,0,50688,29,10731830574
1120,6289679,3787393,10077072,0,0,0,123392,9,8613207381
1121,6293469,3141097,9434566,9,0,0,3072,9,1361468432
1122,6299540,10983391,17282931,7,0,1,2048,5,5630445495
1123,6300550,10982404,17282954,3,0,1,7168,25,9597649122
1124,6306740,11004059,17310799,9,0,1,6656,9,8180492771
1125,6307789,2719139,9026928,9,0,0,512,9,7109174279
1126,6308129,2284001,8592130,6,0,0,47104,11,7017512452
1127,6312429,10998393,17310822,2,0,1,512,0,7796353184
1128,6320359,10990486,17310845,2,0,1,10240,0,6851649668
1129,6334580,3277755,9612335,4,0,0,38400,29,4190113489
1130,6339909,10970959,17310868,1,0,1,512,22,4785361916
1131,6340339,10970552,17310891,1,0,1,9728,22,7939789523
1132,6351390,3860871,10212261,8,0,0,234496,17,3616604426
1133,6351950,2657750,9009700,4,0,0,7168,29,9246231866
1134,6353969,5543482,11897451,7,0,0,7168,5,8071774904
1135,6358160,10952754,17310914,9,0,1,2048,9,10712410361
1136,6359099,10951838,17310937,1,0,1,1536,22,4433464704
1137,6365529,3478092,9843621,6,0,0,5632,11,9893513427
1138,6379979,10930981,17310960,2,0,1,4608,0,4787665078
1139,6380380,10930603,17310983,9,0,1,3072,9,207591311
1140,6387289,10923717,17311006,1,0,1,2560,22,8646950978
1141,6390309,10920720,17311029,2,0,1,3584,0,3184220798
1142,6394610,10916458,17311068,7,0,1,512,5,289340402
1143,6398039,10915111,17313150,2,0,1,3584,0,7131355312
1144,6398310,5370975,11769285,3,0,0,1024,25,8343226032
1145,6402069,10913987,17316056,1,0,1,4608,22,577981757
1146,6406540,3264024,9670564,8,0,0,1536,17,3212947813
1147,6418000,3951454,10369454,5,0,0,74752,25,9420999788
1148,6419869,2667400,9087269,6,0,0,31744,11,10628297145
1149,6420159,10898163,17318322,1,0,1,3584,22,8440762683
1150,6421120,10897548,17318668,7,0,1,512,5,7463246001
1151,6423219,4051985,10475204,9,0,0,512,9,7291634618
1152,6425719,2757675,9183394,0,0,0,37888,9,6806619710
1153,6426519,5652014,12078533,0,0,0,68608,9,9727211195
1154,6442139,3171007,9613146,9,0,0,2560,9,9119419673
1155,6449679,10869143,17318822,1,0,1,8704,22,3039556588
1156,6450670,10891580,17342250,9,0,1,1024,9,5695955753
1157,6450899,3189630,9640529,6,0,0,1024,11,3361356945
1158,6466499,2258591,8725090,0,0,0,13824,9,144787017
1159,6469049,1838625,8307674,9,0,0,1024,9,4145561253
1160,6470609,2821404,9292013,7,0,0,15872,5,9550111939
1161,6483009,10859587,17342596,1,0,1,512,22,7964677957
1162,6483789,3837005,10320794,6,0,0,18432,11,2227661800
1163,6484599,10861543,17346142,1,0,1,5632,22,1501610601
1164,6490479,3292148,9782627,7,0,0,52736,5,9457059851
1165,6498019,2947186,9445205,9,0,0,512,9,2630092343
1166,6502720,10854626,17357346,7,0,1,3072,5,7085516432
1167,6507250,3110607,9617857,5,0,0,15360,25,8316886307
1168,6507660,1603908,8111568,5,0,0,15360,25,6341988914
1169,6510860,3750930,10261790,4,0,0,29184,29,8841531886
1170,6512939,3513208,10026147,6,0,0,37376,11,5770421671
1171,6524239,4021623,10545862,7,0,0,56320,5,3482345142
1172,6524809,2345275,8870084,9,0,0,512,9,5496282201
1173,6535099,10869521,17404620,2,0,1,4608,0,735977915
1174,6538259,4224794,10763053,7,0,0,76288,5,8811188518
1175,6538720,3929106,10467826,8,0,0,96768,17,6600159359
1176,6551419,2979412,9530831,9,0,0,2048,9,8768560601
1177,6557160,3757816,10314976,5,0,0,31744,25,983129002
1178,6559649,2227634,8787283,9,0,0,512,9,5736095870
1179,6561970,5651272,12213242,5,0,0,18944,25,151928497
1180,6569049,3396386,9965435,0,0,0,10240,9,5753934421
1181,6572200,10832443,17404643,9,0,1,1536,9,6521875207
1182,6573229,3466224,10039453,0,0,0,5632,9,3195653481
1183,6575349,3117695,9693044,6,0,0,20992,11,1599676730
1184,6583379,4339160,10922539,6,0,0,29184,11,9869926550
1185,6584100,10821369,17405469,9,0,1,8192,9,4684089713
1186,6587550,5795668,12383218,8,0,0,196096,17,4534663347
1187,6590989,3736403,10327392,0,0,0,15360,9,10351576240
1188,6594459,3929018,10523477,7,0,0,104448,5,1220244546
1189,6601540,5199528,11801068,4,0,0,11776,29,7989969620
1190,6602300,10803192,17405492,9,0,1,1536,9,7846066130
1191,6610980,3880650,10491630,4,0,0,44544,29,8657857551
1192,6620429,3719505,10339934,9,0,0,1024,9,8806520357
1193,6620530,4863706,11484236,5,0,0,34816,25,6026906244
1194,6631080,5066110,11697190,8,0,0,22016,17,6917170641
1195,6635110,10771777,17406887,9,0,1,6144,9,4948724165
1196,6641219,5865078,12506297,7,0,0,43520,5,2683501442
1197,6646149,2782264,9428413,9,0,0,1024,9,2637789209
1198,6648449,4283021,10931470,0,0,0,29184,9,2445390846
1199,6655880,10755219,17411099,9,0,1,6656,9,5106199219
1200,6661430,3180444,9841874,5,0,0,30720,25,3284161193
1201,6670420,3969936,10640356,4,0,0,97280,29,2800792259
1202,6675800,3646889,10322689,8,0,0,6144,17,8804974671
1203,6680980,4517615,11198595,8,0,0,100352,17,4460504762
1204,6684519,3726024,10410543,0,0,0,34816,9,1983458776
1205,6685129,10728876,17414005,2,0,1,4608,0,9827582960
1206,6686269,10729682,17415951,2,0,1,3072,0,10490466098
1207,6692890,3897993,10590883,5,0,0,49664,25,7660510054
1208,6697459,4239182,10936641,6,0,0,16896,11,1387282817
1209,6698960,10718297,17417257,9,0,1,2048,9,2569024455
1210,6701889,1757553,8459442,6,0,0,16384,11,3487500352
1211,6704589,4577638,11282227,6,0,0,25088,11,1047693433
1212,6715910,6021333,12737243,5,0,0,73728,25,8967941743
1213,6717939,10702864,17420803,2,0,1,5632,0,904830686
1214,6718350,10734183,17452533,3,0,1,13824,25,2607668829
1215,6718659,4113013,10831672,9,0,0,2048,9,3668417320
1216,6722959,4175261,10898220,0,0,0,50688,9,8394797973
1217,6724159,4059197,10783356,0,0,0,66560,9,3133314722
1218,6745490,3179708,9925198,5,0,0,2560,25,2020205583
1219,6746219,4311340,11057559,7,0,0,41472,5,3631885057
1220,6746349,4298551,11044900,6,0,0,2560,11,3531106741
1221,6758990,10693574,17452564,4,0,1,13312,29,181570020
1222,6760310,3233743,9994053,4,0,0,24576,29,8428240149
1223,6768769,3484106,10252875,7,0,0,50688,5,7287780356
1224,6773100,10679487,17452587,9,0,1,512,9,2962661765
1225,6774740,3752980,10527720,4,0,0,13824,29,5084146219
1226,6776110,10676500,17452610,6,0,1,2048,11,1530535363
1227,6788300,3593688,10381988,4,0,0,24576,29,5438027544
1228,6791860,10660773,17452633,4,0,1,512,29,1297222047
1229,6798590,10654066,17452656,4,0,1,1536,29,8601312354
1230,6810480,10642199,17452679,6,0,1,1024,11,7833335991
1231,6815760,2331293,9147053,5,0,0,6144,25,1106277865
1232,6820169,1792032,8612201,7,0,0,5632,5,8174404400
1233,6820960,10631742,17452702,6,0,1,1536,11,984704358
1234,6824109,4479721,11303830,6,0,0,10752,11,5754270738
1235,6827969,4932089,11760058,6,0,0,21504,11,5994758420
1236,6834820,10617905,17452725,4,0,1,2560,29,2197156592
1237,6836300,10616448,17452748,9,0,1,14336,9,7007255015
1238,6838190,2900483,9738673,8,0,0,25088,17,7325944705
1239,6844450,4577384,11421834,5,0,0,60928,25,5047644087
1240,6845390,10610123,17455513,6,0,1,8192,11,9857954552
1241,6848989,4049574,10898563,9,0,0,1024,9,8380361691
1242,6850399,4756761,11607160,0,0,0,14848,9,3342029592
1243,6851789,4192308,11044097,6,0,0,8704,11,8096689052
1244,6851950,10686950,17538900,9,0,1,5632,9,5717617440
1245,6858980,4660121,11519101,5,0,0,5632,25,7727664442
1246,6860630,10681816,17542446,9,0,1,5632,9,5414432960
1247,6864040,10679392,17543432,6,0,1,1536,11,7673373127
1248,6864340,6005697,12870037,5,0,0,47104,25,8075458150
1249,6869880,10675818,17545698,4,0,1,3584,29,3542355405
1250,6870979,3968048,10839027,7,0,0,24064,5,4621590299
1251,6880789,3356619,10237408,7,0,0,82432,5,6857541547
1252,6881000,10666324,17547324,4,0,1,2560,29,5931058096
1253,6892819,5636991,12529810,9,0,0,512,9,3974789062
1254,6907619,6230024,13137643,7,0,0,111616,5,2369161107
1255,6912009,3688288,10600297,0,0,0,29696,9,8828276992
1256,6923909,10628702,17552611,5,0,1,16896,25,7412295211
1257,6924230,10658721,17582951,4,0,1,16384,29,2494946387
1258,6925419,4214654,11140073,7,0,0,31744,5,4938550173
1259,6929199,5061828,11991027,7,0,0,92672,5,7172820103
1260,6947960,4568903,11516863,6,0,0,107008,11,8201293845
1261,6951060,3739624,10690684,8,0,0,18944,17,56554501
1262,6952499,4301733,11254232,7,0,0,45568,5,9311642448
1263,6956249,2381742,9337991,0,0,0,4608,9,7701318979
1264,6962919,2508081,9471000,9,0,0,1024,9,9910249042
1265,6965289,10832819,17798108,5,0,1,72704,25,4954853610
1266,6967750,6294578,13262328,8,0,0,45568,17,7285971294
1267,6971569,3043167,10014736,6,0,0,58368,11,4222823685
1268,6975710,10829100,17804810,9,0,1,7680,9,5138520463
1269,6975739,3124054,10099793,9,0,0,2560,9,4893758298
1270,6979479,2639181,9618660,0,0,0,2560,9,8810091090
1271,6981810,10880557,17862367,4,0,1,15360,29,8257434153
1272,6985109,11082246,18067355,5,0,1,73216,25,2019184350
1273,6987249,11215966,18203215,5,0,1,72704,25,538733839
1274,6991909,3434925,10426834,7,0,0,6144,5,2234487423
1275,6993669,3918824,10912493,7,0,0,43520,5,1893640647
1276,6994869,5897522,12892391,0,0,0,37376,9,2679925714
1277,6994880,4728217,11723097,4,0,0,76288,29,8771484794
1278,6995320,4172676,11167996,4,0,0,38400,29,1187937224
1279,6995549,5089902,12085451,0,0,0,14848,9,7205926389
1280,7004780,1970890,8975670,5,0,0,6144,25,9398386532
1281,7006589,11200839,18207428,5,0,1,4608,25,5652924051
1282,7011880,4384932,11396812,4,0,0,13824,29,6364489481
1283,7019290,6309008,13328298,4,0,0,15872,29,8287145641
1284,7020460,3981714,11002174,4,0,0,125440,29,5635707680
1285,7030929,11199532,18230461,5,0,1,6656,25,4655039656
1286,7034229,5170075,12204304,6,0,0,59392,11,1131887353
1287,7044779,4555891,11600670,6,0,0,19968,11,1242559371
1288,7048460,5009146,12057606,8,0,0,81408,17,9009958039
1289,7050709,11179775,18230484,5,0,1,1024,25,6239786678
1290,7066470,11164037,18230507,4,0,1,5632,29,9864216270
1291,7067600,4031953,11099553,4,0,0,45568,29,7131644096
1292,7071540,4748782,11820322,4,0,0,31232,29,7242784515
1293,7072359,3889784,10962143,0,0,0,1024,9,6387362677
1294,7074660,11155870,18230530,7,0,1,512,5,6838951374
1295,7077450,11153103,18230553,7,0,1,2560,5,1177232124
1296,7112680,11117896,18230576,4,0,1,4608,29,2706335294
1297,7124860,11105739,18230599,7,0,1,3072,5,2350775185
1298,7127079,4999766,12126845,6,0,0,135680,11,7806422691
1299,7129800,11107874,18237674,9,0,1,1536,9,10196445232
1300,7130060,3461166,10591226,4,0,0,1024,29,6540997786
1301,7136070,4222453,11358523,8,0,0,114176,17,9756554523
1302,7139220,11181166,18320386,7,0,1,11776,5,3100993865
1303,7142100,11182792,18324892,7,0,1,7168,5,8101152341
1304,7145979,11182459,18328438,5,0,1,5632,25,133409059
1305,7151089,4165400,11316489,7,0,0,41472,5,10844357
1306,7165920,5327086,12493006,5,0,0,1024,25,2955335576
1307,7173279,11164106,18337385,5,0,1,4608,25,2633188664
1308,7175659,4297946,11473605,0,0,0,82944,9,5830412902
1309,7189130,4641043,11830173,4,0,0,32256,29,4075506051
1310,7191419,3850003,11041422,6,0,0,5632,11,4512564194
1311,7191510,11148461,18339971,4,0,1,4096,29,8861466513
1312,7193600,4769168,11962768,5,0,0,69120,25,9037927410
1313,7211390,2719291,9930681,5,0,0,17920,25,6069779785
1314,7212839,11129078,18341917,5,0,1,3072,25,1460391635
1315,7216539,3477924,10694463,9,0,0,1536,9,4126634743
1316,7225600,5097847,12323447,8,0,0,73728,17,9233587259
1317,7227980,11141376,18369356,4,0,1,1024,29,704813280
1318,7238950,3885149,11124099,4,0,0,6144,29,7811055830
1319,7245599,3653611,10899210,9,0,0,2048,9,10318204395
1320,7250330,6139695,13390025,8,0,0,32768,17,6501501299
1321,7258980,11110399,18369379,4,0,1,5120,29,530026798
1322,7261950,2293012,9554962,8,0,0,20480,17,3852110905
1323,7267570,11210325,18477895,7,0,1,4608,5,3822849658
1324,7286620,6261107,13547727,4,0,0,57344,29,9762624141
1325,7290420,11187498,18477918,4,0,1,1536,29,1812034323
1326,7295969,5807597,13103566,0,0,0,97792,9,785048257
1327,7311150,4526074,11837224,5,0,0,23040,25,4143360591
1328,7324610,4812554,12137164,8,0,0,33792,17,7427078835
1329,7328100,5137669,12465769,4,0,0,1024,29,8186488541
1330,7330679,11147262,18477941,5,0,1,6144,25,608436123
1331,7340679,2608295,9948974,9,0,0,1024,9,3457809818
1332,7342560,3186119,10528679,4,0,0,3072,29,5309819729
1333,7356430,11263201,18619631,3,0,1,9216,25,3457660029
1334,7361389,4082050,11443439,9,0,0,512,9,1937200365
1335,7389340,2893454,10282794,5,0,0,18944,25,4508386380
1336,7401159,6316982,13718141,6,0,0,23552,11,6803818891
1337,7406189,3795237,11201426,6,0,0,9216,11,8351445291
1338,7411569,11208085,18619654,5,0,1,16384,25,4049051677
1339,7414479,2900676,10315155,9,0,0,512,9,6615773291
1340,7416750,11227371,18644121,4,0,1,512,29,6189448778
1341,7421219,5217015,12638234,6,0,0,57344,11,8970574531
1342,7450369,4945196,12395565,6,0,0,40448,11,8010016685
1343,7452780,11191687,18644467,9,0,1,512,9,5760935753
1344,7470939,3968086,11439025,7,0,0,56320,5,8214664171
1345,7470989,6343061,13814050,9,0,0,1024,9,8015140527
1346,7471739,4561040,12032779,0,0,0,60928,9,10570219771
1347,7478160,11166973,18645133,7,0,1,1024,5,8925816125
1348,7480829,4399747,11880576,7,0,0,4096,5,475055207
1349,7486390,11173335,18659725,4,0,1,5120,29,10312971738
1350,7507530,3406078,10913608,8,0,0,3584,17,8695050640
1351,7508580,11176369,18684949,4,0,1,1024,29,1580549240
1352,7508950,11186965,18695915,7,0,1,3584,5,3046245253
1353,7509119,5069592,12578711,0,0,0,37376,9,6951818156
1354,7509210,4698237,12207447,5,0,0,10240,25,1172853274
1355,7519800,11234996,18754796,9,0,1,4096,9,4903513355
1356,7525280,11230202,18755482,7,0,1,7680,5,9421452353
1357,7531159,11228932,18760091,1,0,1,1536,22,2108944599
1358,7536410,4619395,12155805,5,0,0,49152,25,5636335159
1359,7539500,11220614,18760114,9,0,1,1536,9,7918096298
1360,7543110,11217051,18760161,9,0,1,13824,9,2010179773
1361,7545340,4244754,11790094,5,0,0,52736,25,9712541885
1362,7557820,11276931,18834751,7,0,1,6144,5,4565731690
1363,7561469,4713236,12274705,0,0,0,77824,9,9454887947
1364,7562539,3954823,11517362,9,0,0,1536,9,2135587380
1365,7564170,11270604,18834774,9,0,1,1024,9,6946517045
1366,7564710,11270087,18834797,9,0,1,5632,9,4485349578
1367,7566410,11268410,18834820,4,0,1,6656,29,4198459390
1368,7577630,11260458,18838088,9,0,1,11264,9,6576430553
1369,7581110,4835607,12416717,5,0,0,34816,25,8977539967
1370,7583159,4667811,12250970,7,0,0,11776,5,3778514747
1371,7588030,11284164,18872194,9,0,1,2048,9,8446875726
1372,7595579,4138461,11734040,6,0,0,35840,11,9924329825
1373,7598749,3980942,11579691,7,0,0,30208,5,7303877769
1374,7605329,4695631,12300960,7,0,0,86016,5,8565277664
1375,7614510,4791576,12406086,8,0,0,11776,17,9835315313
1376,7621020,11252160,18873180,7,0,1,1536,5,7509955705
1377,7621370,11253436,18874806,7,0,1,2560,5,2946200384
1378,7626909,3480490,11107399,6,0,0,9216,11,6744037491
1379,7643859,6321429,13965288,0,0,0,62464,9,1655566904
1380,7656240,11226875,18883115,9,0,1,7680,9,2762328516
1381,7656919,3059028,10715947,6,0,0,16384,11,4939646800
1382,7673449,2321875,9995324,7,0,0,4096,5,6635775581
1383,7674479,5111238,12785717,0,0,0,19968,9,5637059242
1384,7675179,6021932,13697111,7,0,0,15360,5,2456476638
1385,7681120,6584796,14265916,5,0,0,68096,25,4019526841
1386,7681409,6457829,14139238,6,0,0,28160,11,10617543573
1387,7691850,11243738,18935588,0,0,1,47616,9,2706999385
1388,7701520,11266953,18968473,4,0,1,4608,29,2221198276
1389,7703439,4961881,12665320,9,0,0,512,9,3263514832
1390,7712940,2240631,9953571,5,0,0,9216,25,9686714181
1391,7713240,11273634,18986874,9,0,1,17920,9,9575767233
1392,7718500,4295684,12014184,8,0,0,11776,17,5052924654
1393,7720649,4733741,12454390,6,0,0,34304,11,8121919526
1394,7728640,11302061,19030701,9,0,1,7168,9,40175843
1395,7741069,3499256,11240325,9,0,0,3072,9,8190659236
1396,7741330,11418902,19160232,0,0,1,83456,9,8562218471
1397,7755129,3648102,11403231,6,0,0,20992,11,2028829985
1398,7761089,5293929,13055018,9,0,0,512,9,7160955284
1399,7770760,11396231,19166991,0,0,1,3584,9,6680273436
1400,7776579,5079067,12855646,7,0,0,81920,5,1709309822
1401,7779490,11391047,19170537,9,0,1,5632,9,1801640408
1402,7780790,11394932,19175722,4,0,1,16384,29,5037582359
1403,7791470,2889496,10680966,5,0,0,1024,25,5325018977
1404,7792969,4721339,12514308,6,0,0,26112,11,4632864814
1405,7816950,4648484,12465434,5,0,0,15872,25,9723469896
1406,7818120,11371991,19190111,6,0,1,6144,11,4914288428
1407,7820150,4320625,12140775,5,0,0,11776,25,5576845038
1408,7826289,4017206,11843495,0,0,0,20480,9,762988897
1409,7831250,4092949,11924199,5,0,0,44544,25,7302065488
1410,7839880,11365862,19205742,4,0,1,2560,29,4754986896
1411,7851440,11355928,19207368,6,0,1,2560,11,1444172611
1412,7851700,4705231,12556931,8,0,0,15872,17,241286661
1413,7857999,4750271,12608270,7,0,0,35328,5,9750813769
1414,7869500,11356906,19226406,0,0,1,30208,9,8120360467
1415,7872010,11354419,19226429,6,0,1,512,11,4127317057
1416,7876360,11350092,19226452,9,0,1,1536,9,6172697320
1417,7881530,11362076,19243606,9,0,1,8704,9,8751371641
1418,7882480,11400865,19283345,4,0,1,6656,29,5453904764
1419,7884099,2590926,10475025,6,0,0,23552,11,10518635574
1420,7891889,3424779,11316668,9,0,0,512,9,6262401303
1421,7908520,11376413,19284933,9,0,1,15872,9,1981332980
1422,7909920,11375679,19285599,9,0,1,1024,9,6832144078
1423,7915190,4090056,12005246,5,0,0,46592,25,1706501431
1424,7918989,3473588,11392577,6,0,0,12288,11,7816091147
1425,7932950,5237607,13170557,5,0,0,97280,25,3404025972
1426,7935670,4311689,12247359,5,0,0,86016,25,8616958089
1427,7938740,5464443,13403183,5,0,0,13824,25,8843367347
1428,7945410,5069055,13014465,5,0,0,26112,25,4215162283
1429,7952379,6353284,14305663,7,0,0,77824,5,7041362189
1430,7957690,4228495,12186185,8,0,0,33280,17,3724676743
1431,7983350,11339860,19323210,0,0,1,48640,9,8153598658
1432,7983360,11343076,19326436,6,0,1,5120,11,7970372347
1433,7990979,4019594,12010573,0,0,0,17408,9,10301018644
1434,7994939,2845359,10840298,7,0,0,4096,5,6003283513
1435,7997260,11331442,19328702,6,0,1,3584,11,6610969866
1436,8035210,11293748,19328958,6,0,1,9216,11,4089223370
1437,8041220,3063348,11104568,8,0,0,16384,17,7897717658
1438,8048840,11298069,19346909,7,0,1,4096,5,6963794621
1439,8062780,11285119,19347899,6,0,1,4608,11,8401020469
1440,8063439,4380468,12443907,7,0,0,68096,5,1514083515
1441,8070190,3015456,11085646,8,0,0,43008,17,9324329
1442,8079130,11318734,19397864,0,0,1,48128,9,1208022298
1443,8084640,11313255,19397895,6,0,1,3072,11,8154743032
1444,8094780,2855180,10949960,5,0,0,26624,25,4191170654
1445,8097400,4426915,12524315,8,0,0,32768,17,1715169531
1446,8106720,4774260,12880980,8,0,0,35840,17,1817941000
1447,8115699,4052656,12168355,7,0,0,8704,5,4865556157
1448,8119659,4045997,12165656,0,0,0,32256,9,2046878946
1449,8132600,11265318,19397918,7,0,1,12288,5,2817610868
1450,8140770,5044832,13185602,8,0,0,49152,17,1098935032
1451,8148409,11249532,19397941,7,0,1,2048,5,1963717982
1452,8158730,11240501,19399231,7,0,1,2560,5,2457295622
1453,8193030,4488369,12681399,8,0,0,14336,17,4193973761
1454,8213691,11222632,19436323,8,0,1,1024,17,8385571240
1455,8216920,11219426,19436346,7,0,1,1024,5,5933799562
1456,8219851,11216518,19436369,8,0,1,5120,17,5411797117
1457,8221179,2895540,11116719,6,0,0,25600,11,2798533185
1458,8224299,3218961,11443260,0,0,0,13824,9,1866679074
1459,8226330,11210062,19436392,3,0,1,4096,25,454366323
1460,8229380,11207035,19436415,3,0,1,512,25,10572744706
1461,8237449,3355034,11592483,0,0,0,6656,9,2169692839
1462,8238571,11215144,19453715,8,0,1,7680,17,1172579381
1463,8245770,4729613,12975383,5,0,0,71680,25,6316540780
1464,8275730,4950204,13225934,5,0,0,7168,25,6612262375
1465,8281650,11172088,19453738,7,0,1,1024,5,8343262620
1466,8293950,11159811,19453761,4,0,1,6656,29,4136174343
1467,8302431,11174956,19477387,8,0,1,1024,17,9713632037
1468,8322130,11155603,19477733,3,0,1,512,25,4213299389
1469,8328119,3613459,11941578,0,0,0,52736,9,9179170596
1470,8334820,11143579,19478399,3,0,1,11264,25,10043862654
1471,8339499,11146163,19485662,7,0,1,2560,5,2336347772
1472,8364869,4534409,12899278,0,0,0,22528,9,2209135755
1473,8366621,11124187,19490808,8,0,1,8192,17,4283025226
1474,8370611,11141780,19512391,8,0,1,512,17,3649622075
1475,8373209,4669439,13042648,6,0,0,39424,11,5446221323
1476,8387089,3788933,12176022,7,0,0,25088,5,3802535594
1477,8391911,11124621,19516532,8,0,1,17408,17,10533873217
1478,8395379,4431471,12826850,6,0,0,112128,11,9944451148
1479,8402880,5727739,14130619,5,0,0,30720,25,7688534472
1480,8405471,11133045,19538516,8,0,1,4608,17,5171653029
1481,8412270,11134017,19546287,4,0,1,1536,29,4085173869
1482,8412911,11133940,19546851,8,0,1,10752,17,3321334528
1483,8413770,11148071,19561841,4,0,1,6144,29,6715465671
1484,8426720,11136747,19563467,3,0,1,2560,25,6570937235
1485,8431760,4780650,13212410,8,0,0,85504,17,1178422415
1486,8434269,5769490,14203759,7,0,0,77824,5,9523038879
1487,8441100,11127859,19568959,4,0,1,8704,29,96537202
1488,8441370,11128255,19569625,3,0,1,1024,25,4089178108
1489,8447160,11126331,19573491,3,0,1,6144,25,4489370906
1490,8453110,6010188,14463298,5,0,0,154112,25,6226931851
1491,8457939,4034716,12492655,6,0,0,87552,11,946480472
1492,8457950,4682905,13140855,5,0,0,10240,25,6256839318
1493,8464269,4439712,12903981,0,0,0,15360,9,3537346935
1494,8466949,5063275,13530224,7,0,0,66560,5,7348641466
1495,8481719,4788509,13270228,7,0,0,10240,5,5902235276
1496,8485760,11092557,19578317,3,0,1,7680,25,701594469
1497,8504239,4992064,13496303,7,0,0,153600,5,9871769750
1498,8506690,3892018,12398708,5,0,0,10240,25,5832255880
1499,8509640,3287809,11797449,5,0,0,24064,25,6854681794
1500,8523340,11057243,19580583,3,0,1,3584,25,1481746483
1501,8523709,2996039,11519748,6,0,0,2048,11,7975887073
1502,8529819,4793620,13323439,7,0,0,6144,5,9822242071
1503,8532199,11049370,19581569,1,0,1,1536,22,3222912345
1504,8532319,5079565,13611884,7,0,0,8192,5,7012200912
1505,8533120,11049435,19582555,4,0,1,1536,29,2928346264
1506,8537329,6064467,14601796,6,0,0,29696,11,10386255723
1507,8540599,4403336,12943935,7,0,0,6656,5,8359407127
1508,8540719,4522278,13062997,6,0,0,26112,11,260978969
1509,8545540,4285100,12830640,5,0,0,9216,25,8458270128
1510,8551610,4395936,12947546,8,0,0,11776,17,3085519198
1511,8554480,11030367,19584847,3,0,1,3584,25,7160794202
1512,8559731,11027382,19587113,8,0,1,3584,17,267440522
1513,8560339,4625980,13186319,6,0,0,2048,11,9130120301
1514,8566379,11023320,19589699,1,0,1,4096,22,8669760915
1515,8570530,6094397,14664927,5,0,0,74752,25,7043528983
1516,8576039,4672382,13248421,6,0,0,73728,11,4571871146
1517,8577170,11013195,19590365,3,0,1,1024,25,8795054905
1518,8583759,3637353,12221112,0,0,0,20992,9,5418324961
1519,8599409,5727828,14327237,6,0,0,45568,11,776477390
1520,8603280,10989671,19592951,4,0,1,4096,29,10340119156
1521,8609620,10985597,19595217,4,0,1,3584,29,6900237661
1522,8610499,5038909,13649408,0,0,0,79360,9,8257303461
1523,8616280,10981203,19597483,4,0,1,3584,29,10628695828
1524,8617730,4886708,13504438,5,0,0,26624,25,4221752039
1525,8618660,3804476,12423136,5,0,0,20992,25,5919050274
1526,8620340,10981009,19601349,4,0,1,6144,29,4436878943
1527,8622009,11006370,19628379,1,0,1,14336,22,1253081965
1528,8630330,10998072,19628402,4,0,1,2560,29,7702418801
1529,8642059,5150591,13792650,0,0,0,26624,9,7245760164
1530,8642579,10986239,19628818,1,0,1,1024,22,6194875918
1531,8643279,10986525,19629804,1,0,1,1536,22,10416762038
1532,8648020,10982770,19630790,7,0,1,1536,5,4149488950
1533,8649699,10982077,19631776,5,0,1,1536,25,5613457762
1534,8656400,10992551,19648951,3,0,1,37888,25,2951965261
1535,8666349,3548328,12214677,7,0,0,4608,5,7478011421
1536,8668251,10988149,19656400,8,0,1,1536,17,7549122391
1537,8676069,10982597,19658666,1,0,1,3584,22,202681644
1538,8679119,10980213,19659332,5,0,1,1024,25,8883475731
1539,8683769,10976549,19660318,5,0,1,1536,25,1887040388
1540,8689409,4575438,13264847,6,0,0,8192,11,5411164787
1541,8690149,10973075,19663224,7,0,1,4608,5,5051907711
1542,8691739,4531942,13223681,6,0,0,36864,11,7484784352
1543,8694880,3386024,12080904,8,0,0,7680,17,8502324030
1544,8703960,4611454,13315414,7,0,0,38400,5,7015951227
1545,8710669,6174899,14885568,6,0,0,32768,11,6885245307
1546,8712690,10955717,19668407,3,0,1,10752,25,903137473
1547,8712750,10972726,19685476,7,0,1,1536,5,3644505885
1548,8714610,11034100,19748710,0,0,1,37376,9,6194027396
1549,8717729,11031004,19748733,5,0,1,6656,25,5371162266
1550,8727700,11268978,19996678,0,0,1,130048,9,616974696
1551,8735069,11274650,20009719,1,0,1,3072,22,9755167997
1552,8743350,4949058,13692408,8,0,0,99328,17,4556789382
1553,8750930,3651545,12402475,8,0,0,12288,17,2526524122
1554,8751520,11266357,20017877,3,0,1,8192,25,7717999063
1555,8758659,6177291,14935950,6,0,0,91136,11,244847289
1556,8774440,11243460,20017900,0,0,1,15872,9,3531997952
1557,8779420,4524271,13303691,8,0,0,37888,17,8157914517
1558,8781560,11236363,20017923,4,0,1,1024,29,2334144087
1559,8796019,3663729,12459748,7,0,0,17408,5,8009299732
1560,8809980,11207974,20017954,0,0,1,15360,9,5171526184
1561,8813539,5098118,13911657,0,0,0,37376,9,8108824492
1562,8818099,5082147,13900246,7,0,0,50688,5,8228730374
1563,8825599,11192378,20017977,1,0,1,512,22,4298665046
1564,8829459,11189196,20018655,7,0,1,7168,5,8211782836
1565,8831849,11198956,20030805,5,0,1,2560,25,5414157493
1566,8834119,11197032,20031151,1,0,1,512,22,5798261692
1567,8837549,11202214,20039763,5,0,1,4608,25,5496271120
1568,8837949,11223997,20061946,5,0,1,4608,25,2037113101
1569,8865659,11196310,20061969,2,0,1,1536,0,10536877134
1570,8870609,3589958,12460567,6,0,0,2560,11,7181773720
1571,8871440,4483510,13354950,8,0,0,55296,17,5165446946
1572,8873160,5398395,14271555,5,0,0,18432,25,5571435544
1573,8882640,11188423,20071063,4,0,1,5632,29,7416123906
1574,8891959,11179143,20071102,5,0,1,17920,25,1322424125
1575,8898599,11236144,20134743,5,0,1,1536,25,9067153631
1576,8900530,6092522,14993052,7,0,0,10240,5,5492671632
1577,8905420,4604501,13509921,8,0,0,17920,17,5780337463
1578,8908170,11227559,20135729,6,0,1,1536,11,10715040652
1579,8908590,11228765,20137355,3,0,1,2560,25,8779296638
1580,8911799,11225902,20137701,1,0,1,512,22,8904720402
1581,8911829,5000007,13911836,0,0,0,512,9,9198642836
1582,8914809,3667139,12581948,7,0,0,6656,5,8064961588
1583,8916100,5117811,14033911,6,0,0,40960,11,19529586
1584,8922970,5173533,14096503,8,0,0,25600,17,3342528274
1585,8924540,3541416,12465956,3,0,0,512,25,4860825671
1586,8924820,4859695,13784515,8,0,0,36352,17,1858224394
1587,8931659,11207028,20138687,5,0,1,1536,25,1798248192
1588,8931790,11271601,20203391,0,0,1,50688,9,9468385023
1589,8935109,11268948,20204057,5,0,1,1024,25,1910680104
1590,8947850,11258153,20206003,4,0,1,3072,29,5985798490
1591,8957100,11250529,20207629,3,0,1,2560,25,5427150629
1592,8957369,4333932,13291301,0,0,0,4608,9,1314807822
1593,8963710,4091129,13054839,5,0,0,39936,25,5463588750
1594,8977220,11231280,20208500,3,0,1,12288,25,3385220130
1595,8980350,11233065,20213415,0,0,1,4096,9,1317979891
1596,8989860,11227741,20217601,3,0,1,6656,25,10364025271
1597,8990970,11227617,20218587,4,0,1,1536,29,1187920768
1598,8997489,11222750,20220239,5,0,1,2560,25,7450814298
1599,9008859,11213742,20222601,5,0,1,3584,25,3506114608
1600,9010310,11261071,20271381,0,0,1,23552,9,8536002238
1601,9014790,11344844,20359634,0,0,1,77312,9,2735897730
1602,9022910,3804899,12827809,8,0,0,3072,17,7376744161
1603,9024920,4584445,13609365,7,0,0,36864,5,9023099944
1604,9026290,11380751,20407041,0,0,1,5632,9,1310113413
1605,9034640,6026794,15061434,8,0,0,41984,17,4649262248
1606,9045679,11372504,20418183,1,0,1,4096,22,1859077614
1607,9048680,11371769,20420449,0,0,1,3584,9,7501037960
1608,9051940,5036070,14088010,8,0,0,32256,17,1975195387
1609,9055140,11365463,20420603,4,0,1,8704,29,5290729114
1610,9058560,11365589,20424149,0,0,1,5632,9,2431213351
1611,9071879,3920620,12992499,0,0,0,45056,9,2704644135
1612,9079760,11345695,20425455,4,0,1,2048,29,8172485028
1613,9082449,11343365,20425814,1,0,1,9728,22,4089093790
1614,9091570,11582106,20673676,0,0,1,104960,9,10570679229
1615,9092350,11594823,20687173,0,0,1,12800,9,5399937336
1616,9102269,11601498,20703767,1,0,1,5632,22,8563864145
1617,9105279,11600279,20705558,1,0,1,9216,22,3123927375
1618,9114460,11594644,20709104,3,0,1,5632,25,9213115022
1619,9119310,11602643,20721953,4,0,1,1536,29,7372422132
1620,9120349,11602910,20723259,1,0,1,2048,22,3173131103
1621,9122490,4966190,14088680,8,0,0,2048,17,5358428398
1622,9126019,4687696,13813715,6,0,0,23552,11,8950270086
1623,9126760,4819473,13946233,8,0,0,14336,17,8167155304
1624,9142329,11584725,20727054,1,0,1,14848,22,9804609744
1625,9143710,11611010,20754720,9,0,1,1024,9,2344985499
1626,9150790,4914710,14065500,7,0,0,32768,5,6086648127
1627,9170510,4680130,13850640,8,0,0,70656,17,403811616
1628,9171639,4094799,13266438,0,0,0,5120,9,6278245311
1629,9172270,3834216,13006486,5,0,0,3072,25,6261364833
1630,9192070,11562673,20754743,0,0,1,512,9,4806708505
1631,9194450,11560316,20754766,3,0,1,8704,25,6894437785
1632,9197690,4123854,13321544,8,0,0,512,17,1384716306
1633,9197760,11557029,20754789,0,0,1,1536,9,669158237
1634,9208559,11546253,20754812,1,0,1,13312,22,2003071269
1635,9221870,11630755,20852625,0,0,1,14336,9,1640788804
1636,9222140,4704227,13926367,7,0,0,47616,5,5385596561
1637,9223040,11655567,20878607,3,0,1,3584,25,2253168404
1638,9226990,11687722,20914712,3,0,1,2560,25,3034030629
1639,9250229,4016856,13267085,7,0,0,2048,5,729791360
1640,9252980,11661763,20914743,0,0,1,6656,9,7467368354
1641,9259070,11742385,21001455,9,0,1,512,9,1127267338
1642,9259100,4790278,14049378,5,0,0,50688,25,3508451893
1643,9268070,11736484,21004554,3,0,1,2048,25,3688194228
1644,9270689,11760731,21031420,1,0,1,10752,22,6878123263
1645,9271790,5924495,15196285,8,0,0,61440,17,7820407081
1646,9278199,5985653,15263852,0,0,0,56832,9,344160842
1647,9281380,11774129,21055509,9,0,1,6144,9,7353199465
1648,9283470,4037895,13321365,5,0,0,19456,25,8480155444
1649,9285280,4992078,14277358,8,0,0,18944,17,5815235703
1650,9289240,11768855,21058095,4,0,1,4096,29,3762015254
1651,9294460,11764301,21058761,7,0,1,1024,5,620169147
1652,9294940,11768967,21063907,3,0,1,8192,25,6329159225
1653,9311520,4087420,13398940,7,0,0,29184,5,5164454148
1654,9317530,11746633,21064163,0,0,1,9216,9,8841118718
1655,9329859,11736890,21066749,7,0,1,4096,5,8053413039
1656,9331180,4790056,14121236,5,0,0,49664,25,7045835245
1657,9333529,4237652,13571181,0,0,0,44544,9,3580340272
1658,9335620,11731283,21066903,7,0,1,8704,5,3040081885
1659,9338809,4387924,13726733,0,0,0,1536,9,8469919294
1660,9340250,11737223,21077473,7,0,1,4608,5,7579578804
1661,9351650,4828358,14180008,5,0,0,132096,25,5045907023
1662,9360109,4265096,13625205,7,0,0,8192,5,5600595822
1663,9363839,4973452,14337291,0,0,0,14848,9,6656176485
1664,9365680,4191898,13557578,5,0,0,32256,25,6848888580
1665,9366240,11720738,21086978,0,0,1,3584,9,2257545504
1666,9377800,11709237,21087037,3,0,1,1024,25,4104004900
1667,9378340,11709683,21088023,9,0,1,1536,9,3176656707
1668,9383259,4370702,13753961,0,0,0,10240,9,10292336715
1669,9385370,11703319,21088689,9,0,1,11264,9,6214751772
1670,9397730,4586800,13984530,5,0,0,62976,25,7561306184
1671,9402399,4986000,14388399,0,0,0,34304,9,2377558836
1672,9421790,4462989,13884779,8,0,0,25088,17,1235442513
1673,9424449,11698224,21122673,1,0,1,7680,22,8353017356
1674,9481660,4763485,14245145,8,0,0,81408,17,4826677786
1675,9483870,4655859,14139729,8,0,0,1536,17,1067995051
1676,9490450,4530958,14021408,8,0,0,90624,17,2545868231
1677,9494080,4499685,13993765,8,0,0,30208,17,3577233423
1678,9509290,11613414,21122704,0,0,1,7680,9,5463917921
1679,9510239,4545254,14055493,6,0,0,19968,11,1061777459
1680,9524730,4417104,13941834,7,0,0,50688,5,3191007474
1681,9535020,11587707,21122727,3,0,1,1536,25,940840149
1682,9549899,4547571,14097470,0,0,0,3072,9,5449629989
1683,9559760,4546321,14106081,7,0,0,28160,5,135836002
1684,9559839,11562911,21122750,1,0,1,4096,22,778106609
1685,9584920,11588676,21173596,3,0,1,3584,25,247563932
1686,9589490,11584129,21173619,9,0,1,7168,9,2284479459
1687,9593720,11608189,21201909,3,0,1,1536,25,10080189040
1688,9595440,4872405,14467845,5,0,0,14848,25,10267711254
1689,9612570,11589370,21201940,3,0,1,512,25,339342504
1690,9618319,11583644,21201963,1,0,1,4608,22,9523886781
1691,9634389,11567597,21201986,1,0,1,6144,22,9506905444
1692,9641290,11560719,21202009,9,0,1,4608,9,6000939277
1693,9647820,11554212,21202032,0,0,1,12288,9,2082426380
1694,9649310,4428849,14078159,5,0,0,41472,25,7532386494
1695,9652570,11549509,21202079,0,0,1,3584,9,8340329105
1696,9673009,11544895,21217904,1,0,1,11264,22,9654715087
1697,9674519,4545799,14220318,0,0,0,54272,9,6330300203
1698,9678440,11539487,21217927,0,0,1,9728,9,3116701965
1699,9681270,4632060,14313330,6,0,0,25088,11,5912603967
1700,9695550,11522400,21217950,0,0,1,9216,9,708477875
1701,9698379,11519594,21217973,1,0,1,5120,22,2947965740
1702,9699159,4582769,14281928,0,0,0,14848,9,1727191834
1703,9703350,4637880,14341230,7,0,0,12800,5,2379546752
1704,9706440,11533640,21240080,0,0,1,7168,9,10171997058
1705,9709019,5037447,14746466,0,0,0,9216,9,6003246530
1706,9711809,4866838,14578647,6,0,0,6144,11,10060780307
1707,9711949,11533810,21245759,2,0,1,5120,0,2403543440
1708,9726639,11525392,21252031,2,0,1,6144,0,8625719705
1709,9728340,11536964,21265304,9,0,1,2560,9,250416131
1710,9736380,4596348,14332728,6,0,0,17920,11,2756902333
1711,9753030,11513109,21266139,9,0,1,1024,9,309706158
1712,9763260,4933980,14697240,8,0,0,37376,17,1833816982
1713,9770340,4572801,14343141,8,0,0,6144,17,6851182364
1714,9779809,11489876,21269685,1,0,1,5632,22,1407396558
1715,9790140,5064884,14855024,5,0,0,26624,25,7523501514
1716,9793190,11482704,21275894,3,0,1,21504,25,10593630128
1717,9794480,5110902,14905382,5,0,0,14336,25,4698448076
1718,9799140,11500589,21299729,3,0,1,4096,25,1460494455
1719,9801610,4597888,14399498,5,0,0,36352,25,5479100091
1720,9802119,4771670,14573789,0,0,0,43520,9,8386867058
1721,9810149,4692757,14502906,0,0,0,6144,9,6559376393
1722,9824790,5402452,15227242,5,0,0,101376,25,6079147706
1723,9831250,11492820,21324070,3,0,1,17920,25,2681804783
1724,9832880,4999244,14832124,5,0,0,71680,25,8218034013
1725,9843569,4657419,14500988,0,0,0,59904,9,440690510
1726,9882660,11458753,21341413,0,0,1,1536,9,2515638431
1727,9887250,11454186,21341436,3,0,1,3584,25,265687961
1728,9890260,11451199,21341459,3,0,1,8704,25,1545675336
1729,9908280,5404757,15313037,6,0,0,36352,11,5136645211
1730,9921170,11421367,21342537,3,0,1,5632,25,9104753167
1731,9950960,4691145,14642105,7,0,0,101376,5,1305423968
1732,9953330,11392433,21345763,3,0,1,5120,25,5493019254
1733,9966740,11381609,21348349,3,0,1,4096,25,8545195394
1734,9973740,11375275,21349015,3,0,1,1024,25,7344697605
1735,9975550,4745920,14721470,5,0,0,17920,25,619365826
1736,9990539,11364608,21355147,2,0,1,9728,0,5195649016
1737,9994050,4691679,14685729,7,0,0,43008,5,6013750811
1738,9994090,11388906,21382996,0,0,1,14848,9,10149369640
1739,9998119,11386183,21384302,2,0,1,2048,0,7274741596
1740,10000350,5070311,15070661,7,0,0,30208,5,252495319
1741,10021729,11367079,21388808,2,0,1,7168,0,1188686628
1742,10029920,4642682,14672602,7,0,0,25088,5,3129908774
1743,10037260,11354774,21392034,0,0,1,5120,9,6623647515
1744,10037930,11355410,21393340,3,0,1,2048,25,2286908276
1745,10049499,11348275,21397774,2,0,1,4096,0,5088409007
1746,10049520,4837943,14887463,8,0,0,6144,17,4983720792
1747,10049730,4892414,14942144,6,0,0,2560,11,8528832615
1748,10051100,11430847,21481947,0,0,1,37376,9,5971308195
1749,10061680,4924065,14985745,6,0,0,38400,11,6341561635
1750,10067599,5109943,15177542,0,0,0,138240,9,5226185537
1751,10071260,11422047,21493307,0,0,1,3072,9,2464268110
1752,10073510,5228420,15301930,5,0,0,39936,25,9756771849
1753,10074810,11479648,21554458,3,0,1,4608,25,7266986109
1754,10076019,4863386,14939405,0,0,0,11264,9,10731503457
1755,10076550,4733711,14810261,7,0,0,65024,5,9433743879
1756,10078080,5167248,15245328,5,0,0,58880,25,4105899014
1757,10079270,11491013,21570283,0,0,1,6656,9,7456976685
1758,10087530,11515252,21602782,0,0,1,10240,9,2544063067
1759,10087770,4948253,15036023,5,0,0,1024,25,7999707248
1760,10089100,11513705,21602805,3,0,1,1024,25,9824778635
1761,10109500,11523311,21632811,3,0,1,13312,25,906188592
1762,10112770,4875132,14987902,5,0,0,1024,25,8920177933
1763,10113350,11537649,21650999,3,0,1,3072,25,3371630339
1764,10115700,11540033,21655733,3,0,1,4608,25,10059090990
1765,10121640,4748966,14870606,5,0,0,1024,25,4842962624
1766,10126720,11529999,21656719,0,0,1,1536,9,6050445724
1767,10137780,11520885,21658665,3,0,1,3072,25,8681586231
1768,10144300,11517271,21661571,3,0,1,4608,25,5912526733
1769,10146110,5297410,15443520,8,0,0,69120,17,178069382
1770,10156040,11513178,21669218,0,0,1,3584,9,2071044693
1771,10175810,11494097,21669907,0,0,1,4608,9,8226598683
1772,10176960,4662142,14839102,8,0,0,512,17,9535211489
1773,10182530,11492996,21675526,9,0,1,4096,9,4289005345
1774,10187960,11487589,21675549,0,0,1,512,9,5014896222
1775,10189179,4946174,15135353,0,0,0,78848,9,4769907316
1776,10198830,4872010,15070840,5,0,0,512,25,2570604747
1777,10202001,11514974,21716975,8,0,1,20992,17,9443705557
1778,10232840,11484158,21716998,0,0,1,1536,9,1035462890
1779,10237990,11479164,21717154,4,0,1,1024,29,2503629159
1780,10240640,4772986,15013626,5,0,0,1024,25,8376434846
1781,10243879,5027484,15271363,0,0,0,24576,9,7094585920
1782,10250089,5540229,15790318,0,0,0,163840,9,1667253661
1783,10254660,11463058,21717718,3,0,1,10752,25,828034622
1784,10263090,4983041,15246131,6,0,0,2560,11,8234958476
1785,10269650,11477341,21746991,0,0,1,512,9,9424440768
1786,10274240,5015483,15289723,7,0,0,50688,5,4770146741
1787,10278690,11537101,21815791,3,0,1,9728,25,7601145901
1788,10281760,4964706,15246466,5,0,0,1024,25,10623178083
1789,10291650,11526727,21818377,0,0,1,4096,9,6569773683
1790,10291840,5127922,15419762,6,0,0,87040,11,8328099290
1791,10299620,11523086,21822706,6,0,1,4096,11,2654211091
1792,10326599,5029659,15356258,0,0,0,39936,9,8187227456
1793,10331480,11560233,21891713,0,0,1,9728,9,3812052151
1794,10339689,5082748,15422437,0,0,0,8704,9,2065515108
1795,10341990,11550987,21892977,4,0,1,7680,29,5777432215
1796,10345779,5203375,15549154,0,0,0,26624,9,5333798312
1797,10346149,4928045,15274194,0,0,0,9216,9,2125452587
1798,10355160,11539443,21894603,0,0,1,2560,9,3669559252
1799,10356840,5002717,15359557,8,0,0,10752,17,3071924348
1800,10369270,11525999,21895269,7,0,1,1024,5,2948717135
1801,10369560,5132256,15501816,7,0,0,16384,5,10732806806
1802,10383930,5417822,15801752,6,0,0,16384,11,7030371536
1803,10388300,5119802,15508102,8,0,0,6144,17,2653396519
1804,10411470,11487025,21898495,7,0,1,5120,5,8904549282
1805,10424660,11503480,21928140,0,0,1,18944,9,5448277887
1806,10446260,5059947,15506207,7,0,0,14336,5,9533812925
1807,10460210,11514452,21974662,4,0,1,512,29,6977145747
1808,10475950,11498735,21974685,0,0,1,512,9,10492956109
1809,10484590,5026039,15510629,8,0,0,7680,17,10176856029
1810,10488939,5238346,15727285,0,0,0,4608,9,8360485967
1811,10499720,5136428,15636148,7,0,0,64000,5,8532666232
1812,10515120,5034369,15549489,5,0,0,1024,25,1306430634
1813,10532600,5120910,15653510,7,0,0,56320,5,6437562425
1814,10542120,11432588,21974708,0,0,1,8192,9,7930196843
1815,10551590,5245147,15796737,6,0,0,20992,11,8634303650
1816,10559300,11457763,22017063,7,0,1,1536,5,10010494413
1817,10560039,5001911,15561950,2,0,0,28160,0,6494742042
1818,10573340,5366316,15939656,5,0,0,1024,25,2156059341
1819,10573710,5062617,15636327,5,0,0,512,25,1259935919
1820,10585700,11433629,22019329,0,0,1,3584,9,5837718083
1821,10590650,11455808,22046458,4,0,1,512,29,8974839720
1822,10597030,11449451,22046481,7,0,1,2048,5,8321063149
1823,10597890,5059387,15657277,8,0,0,12288,17,10634775044
1824,10602480,4882523,15485003,5,0,0,1024,25,10718536567
1825,10608720,11437784,22046504,0,0,1,2048,9,2481316604
1826,10622380,4953350,15575730,6,0,0,15872,11,7633388384
1827,10626200,5370496,15996696,8,0,0,14848,17,4196009111
1828,10626339,5231474,15857813,0,0,0,60416,9,9117910629
1829,10643660,5070269,15713929,6,0,0,6144,11,6175215174
1830,10650640,11395887,22046527,9,0,1,512,9,5342521237
1831,10654220,11393338,22047558,9,0,1,3584,9,10506383321
1832,10671120,5268201,15939321,6,0,0,89088,11,643709787
1833,10676090,4922572,15598662,6,0,0,1024,11,4299817498
1834,10683120,5020368,15703488,6,0,0,512,11,8545560973
1835,10688150,11402360,22090510,0,0,1,9216,9,2939934555
1836,10694420,5125763,15820183,7,0,0,60416,5,56103773
1837,10695899,5330611,16026510,0,0,0,10752,9,8316273334
1838,10699119,5160924,15860043,0,0,0,1536,9,2977911597
1839,10701439,5357299,16058738,0,0,0,7680,9,9335868852
1840,10702310,4985611,15687921,8,0,0,3072,17,7988534295
1841,10704370,5027108,15731478,6,0,0,512,11,8964961669
1842,10709650,11393511,22103161,7,0,1,512,5,5515169446
1843,10712890,5183265,15896155,8,0,0,31744,17,4758636539
1844,10717800,5372053,16089853,7,0,0,4608,5,4560713884
1845,10721990,5174367,15896357,6,0,0,512,11,1920158461
1846,10723550,11381877,22105427,6,0,1,3584,11,9653072353
1847,10725200,5095474,15820674,6,0,0,1536,11,2317770412
1848,10728050,5131502,15859552,5,0,0,5632,25,8316214873
1849,10735569,5351474,16087043,0,0,0,10752,9,9721289825
1850,10739970,11366620,22106590,4,0,1,1536,29,7504064896
1851,10756780,5187911,15944691,6,0,0,1024,11,2572174316
1852,10759789,11373099,22132888,7,0,1,6144,5,7341882156
1853,10765700,11367211,22132911,4,0,1,9728,29,907865298
1854,10767670,5277608,16045278,8,0,0,16896,17,399388810
1855,10797190,11335744,22132934,0,0,1,2560,9,6345585040
1856,10814950,11318007,22132957,6,0,1,512,11,47902688
1857,10818430,5195193,16013623,8,0,0,7168,17,7205340422
1858,10820580,11312400,22132980,4,0,1,1536,29,663169995
1859,10821550,5210594,16032144,5,0,0,1024,25,5171637378
1860,10821880,5432046,16253926,8,0,0,48640,17,228798182
1861,10822410,5448987,16271397,8,0,0,52736,17,7090752305
1862,10824019,11308984,22133003,7,0,1,6144,5,3059053662
1863,10825790,11307236,22133026,6,0,1,11776,11,275878046
1864,10840340,5103995,15944335,8,0,0,6144,17,6955845198
1865,10845090,11294745,22139835,7,0,1,4608,5,7768543436
1866,10851350,11310097,22161447,9,0,1,4096,9,9161742838
1867,10860970,11302423,22163393,0,0,1,3072,9,1616619467
1868,10869910,11297518,22167428,0,0,1,1536,9,4086125208
1869,10871599,11498588,22370187,7,0,1,13824,5,1168965867
1870,10874140,11496393,22370533,6,0,1,512,11,3658754942
1871,10891190,11479689,22370879,6,0,1,512,11,10081461163
1872,10897860,11473365,22371225,0,0,1,512,9,1165714746
1873,10898280,11475211,22373491,4,0,1,3584,29,3612548637
1874,10907499,5230066,16137565,0,0,0,33280,9,2696646748
1875,10910430,11498078,22408508,6,0,1,11264,11,1058508916
1876,10911960,5342145,16254105,5,0,0,512,25,3916584527
1877,10923450,5173938,16097388,5,0,0,512,25,1682211116
1878,10929580,11478959,22408539,4,0,1,1024,29,2237925581
1879,10933160,11534678,22467838,4,0,1,4608,29,6229424821
1880,10934050,5337526,16271576,5,0,0,512,25,7811270113
1881,10934339,11572931,22507270,7,0,1,15360,5,5539748556
1882,10942410,5332293,16274703,5,0,0,512,25,10311424239
1883,10943220,5355228,16298448,6,0,0,1024,11,9852480822
1884,10943329,5535650,16478979,0,0,0,79360,9,1874607848
1885,10943339,11564917,22508256,2,0,1,1536,0,5144714088
1886,10943420,11565400,22508820,0,0,1,10752,9,5766965890
1887,10943610,5409939,16353549,5,0,0,1024,25,9496277191
1888,10944210,11568128,22512338,4,0,1,5120,29,10710856362
1889,10954890,11578345,22533235,7,0,1,7680,5,10628972352
1890,10955350,5543173,16498523,6,0,0,2048,11,3979377077
1891,10962569,5675404,16637973,0,0,0,27648,9,6932925634
1892,10976910,11561844,22538754,7,0,1,4096,5,2969558323
1893,10981700,11557077,22538777,0,0,1,512,9,1891065433
1894,10982910,5545389,16528299,5,0,0,1536,25,7675397324
1895,10985640,11554739,22540379,4,0,1,6656,29,3836765686
1896,10988220,5856689,16844909,7,0,0,104448,5,3072930119
1897,10990000,5720378,16710378,6,0,0,1024,11,9380435243
1898,10994600,11547725,22542325,0,0,1,3072,9,10252495451
1899,11000140,11579420,22579560,4,0,1,4096,29,241612701
1900,11000709,5664856,16665565,0,0,0,36864,9,393714601
1901,11001150,11578433,22579583,0,0,1,7680,9,7211051694
1902,11037400,5807688,16845088,6,0,0,512,11,6015579928
1903,11039310,6051621,17090931,8,0,0,26624,17,6336797973
1904,11048550,5540619,16589169,5,0,0,3584,25,5582188989
1905,11050260,11529346,22579606,9,0,1,512,9,6521988228
1906,11055200,5875854,16931054,8,0,0,123392,17,6998111739
1907,11059850,11519779,22579629,0,0,1,5632,9,8406157730
1908,11060480,5870932,16931412,8,0,0,512,17,7788436185
1909,11077570,5655800,16733370,8,0,0,22528,17,5334755673
1910,11085540,5806905,16892445,8,0,0,5120,17,247021498
1911,11093460,11486192,22579652,4,0,1,14336,29,6561938583
1912,11109650,5533463,16643113,7,0,0,5632,5,9402293353
1913,11120720,5724726,16845446,5,0,0,512,25,1155134639
1914,11127390,11455671,22583061,7,0,1,2560,5,7133007863
1915,11129519,5658092,16787611,0,0,0,48128,9,702791630
1916,11161470,11422897,22584367,3,0,1,2048,25,6254048492
1917,11162770,11425096,22587866,7,0,1,2048,5,652306372
1918,11166370,11422482,22588852,7,0,1,1536,5,7677885550
1919,11167880,11445914,22613794,7,0,1,24064,5,7189417895
1920,11169009,11472551,22641560,2,0,1,3584,0,1635406721
1921,11169939,5381586,16551525,6,0,0,1024,11,9309652694
1922,11170410,5707074,16877484,5,0,0,1024,25,5516851733
1923,11172770,11468813,22641583,0,0,1,5632,9,6988892537
1924,11178860,11462746,22641606,0,0,1,8192,9,15041062
1925,11179560,11462504,22642064,0,0,1,2560,9,3198506878
1926,11181810,11481024,22662834,9,0,1,7168,9,4855834005
1927,11185610,11496585,22682195,9,0,1,8192,9,10145288964
1928,11188630,11539024,22727654,3,0,1,14336,25,4759519930
1929,11191029,11595435,22786464,2,0,1,1024,0,3320568026
1930,11193460,5375541,16569001,8,0,0,7168,17,5389971881
1931,11209880,11576607,22786487,4,0,1,1024,29,9829786877
1932,11220150,11567163,22787313,7,0,1,1024,5,1111452629
1933,11237051,11550285,22787336,8,0,1,2560,17,7667678878
1934,11241700,11545667,22787367,4,0,1,2560,29,352753344
1935,11244530,11606286,22850816,9,0,1,6144,9,10077811702
1936,11245200,5702467,16947667,5,0,0,1536,25,3348776314
1937,11246830,11604009,22850839,0,0,1,6144,9,6080876188
1938,11249980,11651427,22901407,7,0,1,1024,5,5371892881
1939,11250481,11653777,22904258,8,0,1,7168,17,2919069893
1940,11252040,11668396,22920436,0,0,1,2048,9,599548065
1941,11253650,5481265,16734915,5,0,0,1536,25,3770000590
1942,11261210,11661492,22922702,7,0,1,3584,5,3211688630
1943,11263920,5581347,16845267,6,0,0,512,11,1739390084
1944,11267531,11656477,22924008,8,0,1,2048,17,7995946812
1945,11274990,5807806,17082796,5,0,0,1024,25,3725495368
1946,11279449,5651784,16931233,6,0,0,512,11,7679921207
1947,11280740,11644894,22925634,4,0,1,2560,29,9635411942
1948,11295320,5723104,17018424,8,0,0,88576,17,276551389
1949,11306030,11627849,22933879,7,0,1,4096,5,2193962964
1950,11311700,5545469,16857169,7,0,0,38400,5,1229259816
1951,11312120,11621782,22933902,9,0,1,2560,9,550690881
1952,11312170,11622502,22934672,9,0,1,7680,9,9784720397
1953,11322401,11617763,22940164,8,0,1,8704,17,8561034390
1954,11333259,11607469,22940728,2,0,1,10752,0,753184207
1955,11337090,11618828,22955918,3,0,1,7168,25,9183011422
1956,11338169,11662941,23001110,2,0,1,2560,0,9346674362
1957,11338950,11662183,23001133,3,0,1,4096,25,6616057991
1958,11341411,11660200,23001611,8,0,1,4608,17,5579397617
1959,11356230,11650527,23006757,3,0,1,8192,25,10401266616
1960,11358130,5323969,16682099,5,0,0,512,25,92488631
1961,11360760,11683447,23044207,7,0,1,3584,5,6467208196
1962,11382460,5800296,17182756,8,0,0,41984,17,3983276821
1963,11388651,11700697,23089348,8,0,1,9216,17,7164889042
1964,11392760,11705740,23098500,4,0,1,5120,29,9897307499
1965,11396960,5408797,16805757,5,0,0,512,25,8256532868
1966,11398980,11701146,23100126,3,0,1,2560,25,438134201
1967,11402050,11698422,23100472,0,0,1,512,9,3961421084
1968,11402840,5290576,16693416,5,0,0,3072,25,6898819718
1969,11404180,11697598,23101778,3,0,1,2048,25,8824808339
1970,11405730,5877178,17282908,8,0,0,60928,17,7963409642
1971,11408860,11694864,23103724,0,0,1,3072,9,2965212871
1972,11417070,5882599,17299669,7,0,0,54784,5,3987272721
1973,11420830,11684200,23105030,4,0,1,2048,29,2168148102
1974,11422830,11682866,23105696,0,0,1,1024,9,10249075618
1975,11424300,11685928,23110228,7,0,1,7168,5,9577985461
1976,11447700,11666074,23113774,4,0,1,5632,29,9568125088
1977,11450620,11663718,23114338,0,0,1,10752,9,4034788514
1978,11461130,11655794,23116924,0,0,1,4096,9,7986067327
1979,11463610,11654856,23118466,0,0,1,1024,9,2173049183
1980,11482490,5599925,17082415,8,0,0,24064,17,4351383614
1981,11482559,11649224,23131783,2,0,1,3584,0,2998520726
1982,11483700,5827076,17310776,8,0,0,36352,17,8875370349
1983,11491479,11652268,23143747,2,0,1,1024,0,3873557417
1984,11491510,11656423,23147933,4,0,1,6656,29,6852778049
1985,11513830,11733609,23247439,4,0,1,12800,29,8325325966
1986,11524930,5625222,17150152,7,0,0,38912,5,8962792792
1987,11526399,11721063,23247462,2,0,1,1536,0,8491382188
1988,11530650,11716835,23247485,0,0,1,512,9,985886846
1989,11534339,11713169,23247508,2,0,1,6144,0,5459720245
1990,11537009,11710530,23247539,2,0,1,9216,0,9012095218
1991,11540789,11727396,23268185,2,0,1,7680,0,2643604446
1992,11541980,5789058,17331038,5,0,0,512,25,9329176383
1993,11553090,11715118,23268208,7,0,1,9216,5,7568384606
1994,11559060,11740114,23299174,0,0,1,5632,9,472411176
1995,11565030,5585301,17150331,5,0,0,512,25,9835605643
1996,11565380,11767318,23332698,7,0,1,5120,5,4584740568
1997,11567739,5460549,17028288,6,0,0,1536,11,1582131392
1998,11571390,5494840,17066230,5,0,0,1536,25,573033356
1999,11584360,11896498,23480858,0,0,1,10240,9,9000987529
2000,11588480,11893044,23481524,4,0,1,1024,29,6750630441
2001,11598320,11883550,23481870,0,0,1,512,9,4228074606
2002,11631350,11865830,23497180,7,0,1,1024,5,8944171378
2003,11632340,11872405,23504745,0,0,1,7168,9,6139706443
2004,11632480,5626288,17258768,5,0,0,512,25,6827791669
2005,11633929,5405535,17039464,6,0,0,512,11,9647197069
2006,11642180,11862588,23504768,7,0,1,5120,5,311504469
2007,11643890,11860901,23504791,4,0,1,3584,29,3198331169
2008,11649260,11855570,23504830,4,0,1,2560,29,8859670144
2009,11655240,11854324,23509564,7,0,1,7680,5,5905009037
2010,11665950,11844792,23510742,4,0,1,13824,29,9926073053
2011,11673480,5731117,17404597,7,0,0,53760,5,5462171322
2012,11680510,12328169,24008679,9,0,1,29184,9,3812871433
2013,11686020,12353093,24039113,4,0,1,2560,29,6263474946
2014,11687580,5811942,17499522,5,0,0,2048,25,10136884230
2015,11689491,12349645,24039136,8,0,1,1536,17,4928478366
2016,11694610,12344728,24039338,0,0,1,8704,9,7104582703
2017,11702380,5522511,17224891,5,0,0,2048,25,8952443301
2018,11704341,12520049,24224390,8,0,1,34304,17,7625706553
2019,11705510,12552439,24257949,0,0,1,30720,9,4621734266
2020,11709899,12565962,24275861,2,0,1,2560,0,8188609255
2021,11716759,5613589,17330348,6,0,0,1536,11,5452974537
2022,11724681,12551203,24275884,8,0,1,4096,17,9388131018
2023,11737690,12538298,24275988,0,0,1,512,9,4586757972
2024,11739020,12537634,24276654,7,0,1,1024,5,3419962576
2025,11749230,12538476,24287706,4,0,1,3072,29,332694650
2026,11765610,12523082,24288692,0,0,1,1536,9,6976955037
2027,11768001,12625289,24393290,8,0,1,11776,17,4260587592
2028,11780899,5414139,17195038,6,0,0,512,11,799063065
2029,11781260,12612053,24393313,4,0,1,2048,29,6550518525
2030,11787119,12606217,24393336,2,0,1,1536,0,524138374
2031,11789090,12604269,24393359,3,0,1,512,25,2226848977
2032,11802650,5634081,17436731,8,0,0,21504,17,8055413328
2033,11810290,5642220,17452510,7,0,0,51712,5,4670439991
2034,11821430,12571952,24393382,0,0,1,4096,9,3194708239
2035,11833630,12593026,24426656,4,0,1,12800,29,1953492474
2036,11842660,12584027,24426687,0,0,1,16384,9,2458337981
2037,11843731,12644350,24488081,8,0,1,5120,17,3170957460
2038,11846110,12646245,24492355,7,0,1,4608,5,7277957852
2039,11860120,5716679,17576799,7,0,0,2048,5,4432920013
2040,11864890,12627488,24492378,0,0,1,1536,9,2773682257
2041,11869101,12669819,24538920,8,0,1,5632,17,4007036870
2042,11872220,12666723,24538943,4,0,1,2560,29,8775640715
2043,11885361,12653605,24538966,8,0,1,1536,17,7524862814
2044,11890280,5497691,17387971,5,0,0,2048,25,8239002274
2045,11905071,12633918,24538989,8,0,1,1536,17,10108126680
2046,11924100,12614920,24539020,0,0,1,4096,9,777320076
2047,11928831,12624166,24552997,8,0,1,5632,17,9099270294
2048,11932911,12620109,24553020,8,0,1,3072,17,1394105648
2049,11933001,12684673,24617674,8,0,1,6656,17,9768946222
2050,11935600,12682113,24617713,0,0,1,14336,9,1096590036
2051,11936390,5815587,17751977,8,0,0,12800,17,8779018195
2052,11944921,12720635,24665556,8,0,1,1536,17,10246660752
2053,11947741,12717838,24665579,8,0,1,4096,17,227383355
2054,11958209,5508559,17466768,9,0,0,1536,9,3078738697
2055,11964120,5664664,17628784,7,0,0,7680,5,1766585684
2056,11968980,12696622,24665602,7,0,1,2560,5,3470133342
2057,11971531,12694094,24665625,8,0,1,3584,17,5667168781
2058,11980610,5714416,17695026,7,0,0,46592,5,3523288269
2059,11992220,5413226,17405446,5,0,0,2560,25,5187124430
2060,11997190,12701272,24698462,7,0,1,7680,5,9028170390
2061,12002951,12695558,24698509,8,0,1,1024,17,2224965989
2062,12004730,5961096,17965826,7,0,0,198656,5,116956923
2063,12028600,12669932,24698532,0,0,1,7168,9,8012336796
2064,12037820,12669777,24707597,7,0,1,512,5,6110292053
2065,12044690,6185748,18230438,7,0,0,69632,5,10062664324
2066,12048550,12663873,24712423,0,0,1,7680,9,477511711
2067,12068559,5607475,17676034,6,0,0,512,11,5203308962
2068,12081400,5545021,17626421,7,0,0,45056,5,9420098596
2069,12087640,5476440,17564080,5,0,0,512,25,485167250
2070,12091550,12657247,24748797,7,0,1,2560,5,6459277341
2071,12094741,12654079,24748820,8,0,1,512,17,3616395542
2072,12098050,12650793,24748843,7,0,1,9728,5,2104852397
2073,12110580,12638286,24748866,4,0,1,512,29,5342775027
2074,12124060,12624829,24748889,7,0,1,4608,5,2070322229
2075,12133409,5200857,17334266,6,0,0,1024,11,10690595392
2076,12148370,12603294,24751664,7,0,1,1024,5,8549184343
2077,12154000,12599610,24753610,0,0,1,3072,9,9139406925
2078,12157250,5965565,18122815,5,0,0,1024,25,1207782
2079,12160830,12593126,24753956,4,0,1,512,29,7409329063
2080,12165220,12591322,24756542,7,0,1,4096,5,10446334864
2081,12173860,12586868,24760728,0,0,1,6656,9,10000351904
2082,12188030,12573684,24761714,7,0,1,1536,5,10342483767
2083,12191501,12574719,24766220,8,0,1,7168,17,3698541465
2084,12201370,5902154,18103524,5,0,0,512,25,1162809372
2085,12206801,12563925,24770726,8,0,1,7168,17,9367447045
2086,12232980,5358484,17591464,7,0,0,9728,5,122261905
2087,12234490,5147323,17381813,5,0,0,1024,25,4451664742
2088,12237820,12560035,24797855,6,0,1,6144,11,6600369203
2089,12238650,5394276,17632926,7,0,0,4096,5,5619335442
2090,12250651,12547227,24797878,8,0,1,4096,17,400558679
2091,12254100,12543801,24797901,6,0,1,2560,11,1215595925
2092,12267791,12531243,24799034,8,0,1,13312,17,2169821343
2093,12271470,5397311,17668781,7,0,0,89088,5,8683698844
2094,12274010,12528187,24802197,4,0,1,512,29,2435841781
2095,12279169,6028445,18307614,0,0,0,114688,9,544176971
2096,12284870,5461737,17746607,7,0,0,19968,5,8820509813
2097,12303701,12501722,24805423,8,0,1,5120,17,2261837506
2098,12304580,5376168,17680748,5,0,0,2048,25,8548955377
2099,12304969,5286761,17591730,6,0,0,512,11,8556852268
2100,12318930,5737202,18056132,7,0,0,90624,5,5336307932
2101,12320870,12532032,24852902,4,0,1,1536,29,7252521990
2102,12321091,12531834,24852925,8,0,1,1024,17,2782253898
2103,12332360,5342372,17674732,8,0,0,19456,17,3373296306
2104,12337570,12515378,24852948,4,0,1,1536,29,5361196841
2105,12341680,5450332,17792012,7,0,0,22528,5,2311963630
2106,12343721,12509250,24852971,8,0,1,512,17,6981204641
2107,12350390,5192000,17542390,5,0,0,1024,25,2161400982
2108,12353610,5360166,17713776,5,0,0,2560,25,5003653946
2109,12357339,5206358,17563697,6,0,0,512,11,1527239526
2110,12359791,12493203,24852994,8,0,1,3584,17,2102940757
2111,12361160,5623932,17985092,7,0,0,12288,5,5270412467
2112,12361639,5274592,17636231,6,0,0,512,11,1357260400
2113,12363661,12489356,24853017,8,0,1,3072,17,6512388894
2114,12363990,12489050,24853040,4,0,1,7168,29,7060949115
2115,12364440,12488623,24853063,4,0,1,2048,29,8561086002
2116,12381430,12471656,24853086,4,0,1,4608,29,6364008718
2117,12395369,5396822,17792191,6,0,0,512,11,4605819381
2118,12400010,12504155,24904165,4,0,1,24064,29,144043910
2119,12401891,12611466,25013357,8,0,1,1536,17,9428446952
2120,12402400,5563761,17966161,5,0,0,1024,25,10338048374
2121,12422029,5650164,18072193,6,0,0,1024,11,2141063206
2122,12422320,5602038,18024358,5,0,0,2560,25,3245295476
2123,12427711,12585669,25013380,8,0,1,7168,17,4541207967
2124,12438610,5395990,17834600,8,0,0,5632,17,2969879190
2125,12441250,12572153,25013403,7,0,1,1024,5,8569190066
2126,12445120,12568306,25013426,0,0,1,7680,9,8859367215
2127,12447221,12566228,25013449,8,0,1,1024,17,5270235295
2128,12449969,5259495,17709464,6,0,0,512,11,2235227385
2129,12453460,12560012,25013472,7,0,1,2048,5,5840937982
2130,12456430,5510066,17966496,5,0,0,1024,25,5555514436
2131,12479179,5083138,17562317,6,0,0,1024,11,8843847274
2132,12489220,12524275,25013495,4,0,1,2048,29,6252899492
2133,12500590,5682105,18182695,7,0,0,39936,5,7170793004
2134,12520010,5469580,17989590,7,0,0,2048,5,504763209
2135,12525290,12488228,25013518,0,0,1,11776,9,2697197280
2136,12533050,12513986,25047036,4,0,1,1024,29,9911349187
2137,12539080,12509262,25048342,4,0,1,2048,29,2780501666
2138,12549850,12501583,25051433,0,0,1,4096,9,1970805971
2139,12552219,5122692,17674911,6,0,0,512,11,2998997469
2140,12556169,4985029,17541198,6,0,0,1024,11,797806116
2141,12561450,5241156,17802606,7,0,0,5632,5,4147550028
2142,12562621,12498092,25060713,8,0,1,5120,17,2772627792
2143,12565410,12496315,25061725,4,0,1,1536,29,5677814620
2144,12576291,12515498,25091789,8,0,1,6656,17,4945063380
2145,12585270,6219756,18805026,8,0,0,10240,17,1125083645
2146,12588680,12525247,25113927,0,0,1,14848,9,7160170823
2147,12595370,6041467,18636837,7,0,0,56320,5,3461704267
2148,12608840,6145933,18754773,7,0,0,49664,5,9754805171
2149,12610860,12503221,25114081,0,0,1,8704,9,6145180512
2150,12624380,5628077,18252457,8,0,0,29696,17,7083660175
2151,12625210,5345411,17970621,7,0,0,11776,5,1723455076
2152,12644411,12471296,25115707,8,0,1,2560,17,6352378479
2153,12651230,5334197,17985427,5,0,0,1024,25,1464272468
2154,12694000,5547091,18241091,5,0,0,1536,25,10401158771
2155,12705620,12410446,25116066,0,0,1,9728,9,2011791751
2156,12717850,5037064,17754914,8,0,0,1024,17,10001660717
2157,12718599,5248411,17967010,6,0,0,512,11,4324167600
2158,12740940,5255959,17996899,5,0,0,2048,25,6058178618
2159,12747829,5144401,17892230,6,0,0,1024,11,1276350150
2160,12757139,5346051,18103190,6,0,0,512,11,1280846801
2161,12771091,12433752,25204843,8,0,1,6656,17,6572081976
2162,12785700,5833908,18619608,4,0,0,144384,29,3197518056
2163,12786840,5179991,17966831,5,0,0,1024,25,666482613
2164,12787040,5690653,18477693,8,0,0,111104,17,6842964092
2165,12789191,12450638,25239829,8,0,1,27648,17,4089931145
2166,12790221,12450914,25241135,8,0,1,2048,17,10634178209
2167,12800069,5170731,17970800,6,0,0,512,11,1716704351
2168,12827800,5650072,18477872,5,0,0,512,25,250493429
2169,12835260,12430164,25265424,0,0,1,5632,9,5900634935
2170,12842830,12424752,25267582,0,0,1,2560,9,3371626387
2171,12848201,12478636,25326837,8,0,1,3072,17,6669125319
2172,12850560,5834366,18684926,8,0,0,69632,17,6586720438
2173,12859200,12558774,25417974,0,0,1,12800,9,2310673768
2174,12867400,5653972,18521372,8,0,0,83456,17,3335058168
2175,12874630,6075617,18950247,8,0,0,36864,17,4819260891
2176,12887681,12530316,25417997,8,0,1,512,17,3255078811
2177,12908440,12509580,25418020,0,0,1,18944,9,7589381042
2178,12911790,12549246,25461036,3,0,1,1024,25,10243978091
2179,12912630,5528153,18440783,5,0,0,512,25,253041540
2180,12916909,5399482,18316391,6,0,0,512,11,3520673866
2181,12919300,5416846,18336146,7,0,0,22016,5,5689152293
2182,12939450,5429883,18369333,8,0,0,88064,17,8975293082
2183,12940991,12527891,25468882,8,0,1,2048,17,5895496516
2184,12943110,5218208,18161318,8,0,0,4096,17,10610820565
2185,12949540,5424542,18374082,8,0,0,15360,17,4574141864
2186,12960609,5354402,18315011,6,0,0,1024,11,898211407
2187,12982010,12500210,25482220,0,0,1,3072,9,9366569463
2188,12982230,12503468,25485698,9,0,1,4096,9,4797234428
2189,12994179,5342302,18336481,6,0,0,1024,11,5856943463
2190,12994700,5329984,18324684,8,0,0,13312,17,1263088888
2191,12999620,5549430,18549050,8,0,0,38912,17,5016315233
2192,13010630,5564963,18575593,7,0,0,87040,5,5527447682
2193,13023690,12462031,25485721,0,0,1,2048,9,4666109269
2194,13056080,5478909,18534989,7,0,0,38912,5,5107859717
2195,13058440,5701293,18759733,8,0,0,13824,17,9670643878
2196,13064450,5244903,18309353,7,0,0,5632,5,6386136453
2197,13069761,12415983,25485744,8,0,1,8192,17,1374816448
2198,13070750,12415025,25485775,0,0,1,7680,9,836631730
2199,13125139,5249278,18374417,6,0,0,1024,11,4749004709
2200,13127389,5509783,18637172,6,0,0,1024,11,4111700083
2201,13128590,5934548,19063138,8,0,0,82432,17,9622090668
2202,13140781,12346152,25486933,8,0,1,3072,17,1816418303
2203,13146390,5759944,18906334,5,0,0,512,25,7577169017
2204,13155550,5673211,18828761,8,0,0,77824,17,1696637255
2205,13156369,5247295,18403664,6,0,0,512,11,6131394609
2206,13158639,5257007,18415646,6,0,0,512,11,4668884590
2207,13166550,5265168,18431718,5,0,0,512,25,2565705241
2208,13172510,5567108,18739618,8,0,0,143360,17,1645125145
2209,13177760,12313359,25491119,0,0,1,6656,9,4929893696
2210,13184040,12354621,25538661,0,0,1,14848,9,8144269132
2211,13197561,12355496,25553057,8,0,1,3072,17,6106132567
2212,13211190,5623530,18834720,8,0,0,19456,17,8562859182
2213,13217280,5584579,18801859,7,0,0,16896,5,9285618635
2214,13220499,12333544,25554043,2,0,1,1536,0,7505218810
2215,13228259,12356251,25584510,2,0,1,3584,0,1578696862
2216,13235899,12359082,25594981,2,0,1,16384,0,5288015821
2217,13250730,5445162,18695892,8,0,0,35840,17,3871186014
2218,13270641,12324363,25595004,8,0,1,512,17,7968728090
2219,13276070,12320863,25596933,0,0,1,5632,9,4112177069
2220,13280080,5873206,19153286,8,0,0,37888,17,9112368498
2221,13286320,12337576,25623896,0,0,1,3584,9,8055987755
2222,13288249,12336103,25624352,2,0,1,512,0,539071977
2223,13302150,5602358,18904508,7,0,0,20992,5,8029356443
2224,13304329,12352999,25657328,2,0,1,4096,0,7483811563
2225,13315950,5825062,19141012,7,0,0,1024,5,10571496040
2226,13317540,12343047,25660587,0,0,1,6656,9,2790608683
2227,13318820,5634414,18953234,7,0,0,9728,5,9087307221
2228,13326250,5690048,19016298,7,0,0,20480,5,104247675
2229,13332190,12341264,25673454,0,0,1,5120,9,2986271864
2230,13341011,12339144,25680155,8,0,1,2048,17,380545713
2231,13342079,5193811,18535890,6,0,0,512,11,3814503249
2232,13351530,5445158,18796688,8,0,0,119808,17,3601474434
2233,13352291,12328850,25681141,8,0,1,1536,17,10049175089
2234,13369100,12313027,25682127,0,0,1,1536,9,4459418163
2235,13371991,12320691,25692682,8,0,1,3072,17,6263292324
2236,13374501,12318335,25692836,8,0,1,8704,17,3174888287
2237,13377520,12316302,25693822,0,0,1,1536,9,4509099903
2238,13394049,5361394,18755443,6,0,0,2048,11,1799511851
2239,13431170,5578865,19010035,7,0,0,48128,5,2014308715
2240,13433610,5695789,19129399,7,0,0,117248,5,6907820435
2241,13441820,5393655,18835475,5,0,0,2048,25,5542986197
2242,13447850,5688904,19136754,8,0,0,24064,17,10144049354
2243,13448640,5927463,19376103,7,0,0,87552,5,282389818
2244,13450860,5427151,18878011,7,0,0,512,5,579251004
2245,13465229,5504379,18969608,6,0,0,512,11,5792042708
2246,13467090,5549387,19016477,5,0,0,512,25,2609631338
2247,13474750,5506505,18981255,7,0,0,3072,5,2727405029
2248,13476360,6272327,19748687,7,0,0,71680,5,8513995043
2249,13477730,5517068,18994798,7,0,0,19456,5,3114094606
2250,13483160,5863726,19346886,7,0,0,26112,5,8328934709
2251,13532479,5227589,18760068,6,0,0,1024,11,3045617752
2252,13537870,12156298,25694168,9,0,1,512,9,5368702395
2253,13538470,6236755,19775225,8,0,0,56832,17,3922150965
2254,13546210,12148304,25694514,9,0,1,512,9,5449902938
2255,13556771,12138409,25695180,8,0,1,1024,17,2373808389
2256,13575090,12127973,25703063,0,0,1,2560,9,10244939053
2257,13577220,12151827,25729047,0,0,1,7168,9,8736410856
2258,13595810,5544867,19140677,7,0,0,12800,5,9568763402
2259,13600430,12128640,25729070,0,0,1,3072,9,2081462062
2260,13602290,12127102,25729392,3,0,1,3072,25,158225472
2261,13613020,12118318,25731338,0,0,1,3072,9,2798859174
2262,13614270,5574398,19188668,5,0,0,1536,25,2216980205
2263,13615969,6005101,19621070,9,0,0,512,9,6409560177
2264,13620320,12111684,25732004,0,0,1,1024,9,2392761946
2265,13620500,12111850,25732350,0,0,1,512,9,1647559978
2266,13634890,5384262,19019152,7,0,0,8704,5,5915199524
2267,13637750,12097826,25735576,9,0,1,5120,9,5589535996
2268,13638400,12100014,25738414,0,0,1,512,9,8880877238
2269,13648080,5620838,19268918,7,0,0,62464,5,9036944233
2270,13651680,12087400,25739080,9,0,1,1024,9,8188793086
2271,13658500,12092143,25750643,9,0,1,6144,9,9992303757
2272,13663420,12104160,25767580,0,0,1,8192,9,9679620554
2273,13669750,5471909,19141659,5,0,0,2048,25,5973684380
2274,13675940,5550443,19226383,7,0,0,41984,5,4481245864
2275,13682380,12086826,25769206,0,0,1,2560,9,5650938245
2276,13685220,12090438,25775658,0,0,1,10240,9,9521183501
2277,13696270,12084563,25780833,9,0,1,4608,9,432431512
2278,13697000,12083856,25780856,0,0,1,3584,9,809084863
2279,13716860,12064329,25781189,9,0,1,9728,9,7914786621
2280,13729660,5663002,19392662,7,0,0,54272,5,7333075845
2281,13731989,5344255,19076244,6,0,0,512,11,4684157982
2282,13740850,12119941,25860791,0,0,1,12288,9,3910416381
2283,13750600,12113097,25863697,7,0,1,4608,5,1383741605
2284,13752139,12119506,25871645,2,0,1,512,0,1545696462
2285,13754929,12118342,25873271,5,0,1,2560,25,8417561412
2286,13771599,6017023,19788622,6,0,0,512,11,7270340782
2287,13787629,12091339,25878968,2,0,1,18944,0,10671633610
2288,13790499,12099455,25889954,5,0,1,4608,25,8750970458
2289,13801650,12088650,25890300,6,0,1,512,11,2291984403
2290,13816470,12102290,25918760,7,0,1,12800,5,7259978027
2291,13841640,12077376,25919016,7,0,1,9216,5,8560636554
2292,13843410,5554423,19397833,7,0,0,16896,5,8209815356
2293,13843760,12112655,25956415,6,0,1,6144,11,1604399968
2294,13848200,5588100,19436300,8,0,0,102400,17,2332779751
2295,13854929,12154421,26009350,5,0,1,3072,25,7555417631
2296,13857760,12151613,26009373,9,0,1,11264,9,2959106396
2297,13862860,5590832,19453692,8,0,0,24576,17,3237442904
2298,13908569,12113041,26021610,5,0,1,2560,25,4757107732
2299,13921019,12100614,26021633,5,0,1,512,25,5931820615
2300,13936891,12084765,26021656,8,0,1,13312,17,6894995960
2301,13938880,5701049,19639929,8,0,0,5120,17,1195673991
2302,13947840,12100421,26048261,7,0,1,1024,5,8841503224
2303,13964999,12087052,26052051,5,0,1,2560,25,1923888009
2304,13971730,5804766,19776496,8,0,0,4096,17,4612010137
2305,13974309,5297661,19271970,6,0,0,2048,11,5123386719
2306,13980141,12072284,26052425,8,0,1,4096,17,10692589851
2307,13985591,12066857,26052448,8,0,1,1536,17,10278626148
2308,13985890,5919051,19904941,8,0,0,2048,17,4528491450
2309,13993561,12069326,26062887,8,0,1,12288,17,1869329366
2310,14012350,12094702,26107052,6,0,1,3584,11,8979359676
2311,14022230,5966111,19988341,8,0,0,48640,17,2837599787
2312,14024640,12082435,26107075,0,0,1,5120,9,5323802321
2313,14038220,12078573,26116793,6,0,1,18944,11,9156750309
2314,14047890,12068926,26116816,0,0,1,1536,9,10189001344
2315,14051100,12073757,26124857,0,0,1,4608,9,5291545369
2316,14061370,12103227,26164597,0,0,1,14336,9,9323260482
2317,14066219,5418252,19484471,6,0,0,512,11,599966666
2318,14066850,5471643,19538493,7,0,0,71680,5,7818508932
2319,14067530,5373928,19441458,5,0,0,1536,25,9502667870
2320,14069220,5470879,19540099,8,0,0,5120,17,9173204919
2321,14075100,12094477,26169577,7,0,1,4608,5,2735047256
2322,14097200,12123279,26220479,4,0,1,7680,29,228915637
2323,14101140,12119362,26220502,0,0,1,3072,9,3204916840
2324,14109629,12110896,26220525,5,0,1,3584,25,9324864239
2325,14127419,5343112,19470531,6,0,0,1024,11,7556165100
2326,14148551,12071997,26220548,8,0,1,512,17,1344351414
2327,14149359,12072262,26221621,5,0,1,2560,25,792522233
2328,14155641,12084589,26240230,8,0,1,1024,17,8869133799
2329,14166429,5843267,20009696,6,0,0,512,11,6805937254
2330,14169290,12070971,26240261,6,0,1,3072,11,3861783141
2331,14171370,5527765,19699135,7,0,0,2560,5,10383908623
2332,14176890,12070053,26246943,6,0,1,6656,11,6966342793
2333,14180080,12069449,26249529,0,0,1,4096,9,7551420322
2334,14180341,12078433,26258774,8,0,1,5120,17,4253510307
2335,14185819,12083736,26269555,5,0,1,2048,25,816849812
2336,14204930,12068979,26273909,3,0,1,11264,25,7845258201
2337,14206801,12090243,26297044,8,0,1,6144,17,5227319109
2338,14209169,12097987,26307156,5,0,1,5120,25,6580332831
2339,14210500,5487832,19698332,7,0,0,26112,5,1402769248
2340,14218310,5591264,19809574,7,0,0,13824,5,9986437040
2341,14218790,12089672,26308462,0,0,1,2048,9,977645704
2342,14219280,12092088,26311368,7,0,1,4608,5,1292008423
2343,14233060,5395296,19628356,7,0,0,11776,5,8492087473
2344,14245960,5763533,20009493,8,0,0,41984,17,5251595335
2345,14251210,12061050,26312260,6,0,1,9216,11,9336200349
2346,14263510,12053129,26316639,3,0,1,2048,25,4182228588
2347,14264580,5639021,19903601,5,0,0,1024,25,4182782798
2348,14272189,12050624,26322813,1,0,1,2560,22,3101474225
2349,14274309,12048658,26322967,1,0,1,8704,22,956834872
2350,14274840,12055434,26330274,3,0,1,7168,25,7246202781
2351,14278489,12054691,26333180,5,0,1,4608,25,2945051124
2352,14282269,12072690,26354959,5,0,1,13824,25,8918966883
2353,14283850,5803479,20087329,8,0,0,48640,17,7989933396
2354,14286850,12068365,26355215,0,0,1,9216,9,4038956296
2355,14288230,5496401,19784631,8,0,0,26624,17,871383148
2356,14290240,12067241,26357481,0,0,1,3584,9,9976720388
2357,14299059,12059408,26358467,5,0,1,1536,25,4196523156
2358,14299150,12062789,26361939,7,0,1,5120,5,7963791259
2359,14302180,5528647,19830827,7,0,0,15360,5,8578875438
2360,14309449,12059551,26369000,1,0,1,5632,22,706060505
2361,14323589,12045757,26369346,1,0,1,512,22,1553565498
2362,14333180,12040352,26373532,0,0,1,6656,9,7813267630
2363,14336259,5487445,19823704,6,0,0,512,11,9714558908
2364,14344319,12031997,26376316,5,0,1,1024,25,3883631619
2365,14345269,12034273,26379542,7,0,1,5120,5,1288905150
2366,14355030,5609524,19964554,8,0,0,152576,17,6921735650
2367,14362060,5708980,20071040,7,0,0,29696,5,6393951891
2368,14365210,5604919,19970129,7,0,0,14848,5,2915809481
2369,14369599,12010289,26379888,7,0,1,512,5,2684269674
2370,14372359,5460519,19832878,0,0,0,6656,9,4607935454
2371,14375260,12007214,26382474,0,0,1,4096,9,5096371801
2372,14381039,12005941,26386980,7,0,1,7168,5,10476705955
2373,14385270,5777419,20162689,8,0,0,21504,17,4567150391
2374,14394670,11994896,26389566,0,0,1,4096,9,2707306601
2375,14399720,11992752,26392472,3,0,1,4608,25,4919690414
2376,14401970,5562919,19964889,5,0,0,1024,25,9736159223
2377,14403949,12006624,26410573,7,0,1,5120,5,9211639544
2378,14410399,5608225,20018624,6,0,0,2048,11,5803424381
2379,14413870,11997369,26411239,3,0,1,1024,25,2583000754
2380,14429209,5452688,19881897,6,0,0,512,11,5603548551
2381,14439560,5556604,19996164,8,0,0,25600,17,1560124710
2382,14443020,5522048,19965068,5,0,0,512,25,4395599368
2383,14448269,11966516,26414785,5,0,1,5632,25,6129467841
2384,14449959,5515288,19965247,9,0,0,512,9,3359637711
2385,14452400,5447973,19900373,5,0,0,512,25,3616918851
2386,14459059,11977551,26436610,1,0,1,6144,22,6565561578
2387,14462550,11974083,26436633,0,0,1,5632,9,6461379689
2388,14468329,11968764,26437093,2,0,1,7168,0,5296675523
2389,14469189,11980977,26450166,1,0,1,1024,22,6298704716
2390,14477869,11983403,26461272,1,0,1,7680,22,8266985346
2391,14478369,11983262,26461631,2,0,1,9728,0,2066810569
2392,14482919,12003077,26485996,2,0,1,2048,0,8650376837
2393,14486989,11999038,26486027,2,0,1,10752,0,9176742618
2394,14492509,12030280,26522789,1,0,1,10752,22,1466635454
2395,14492599,5525255,20017854,6,0,0,26624,11,7090681366
2396,14499719,12038515,26538234,2,0,1,3072,0,3430125427
2397,14499880,5771478,20271358,8,0,0,50176,17,1053192568
2398,14500420,5610031,20110451,7,0,0,23040,5,9969133073
2399,14507479,12031741,26539220,2,0,1,1536,0,4024189475
2400,14511499,12095654,26607153,1,0,1,15872,22,5704225864
2401,14512579,12094597,26607176,1,0,1,1024,22,5984905747
2402,14517140,5479515,19996655,8,0,0,1536,17,8700778700
2403,14519970,5541953,20061923,8,0,0,25088,17,3310263851
2404,14522219,12086611,26608830,2,0,1,3072,0,2893055897
2405,14525279,5795518,20320797,6,0,0,15360,11,5322953897
2406,14525419,5440163,19965582,9,0,0,1024,9,2582827572
2407,14529329,12093302,26622631,1,0,1,3584,22,9211709782
2408,14531859,12090795,26622654,2,0,1,1536,0,5830714918
2409,14540419,12082258,26622677,1,0,1,9216,22,6347313061
2410,14545489,5478492,20023981,9,0,0,2048,9,3672442985
2411,14549490,5845797,20395287,7,0,0,21504,5,9674615848
2412,14558080,5697967,20256047,8,0,0,72192,17,10712343467
2413,14567149,12148656,26715805,5,0,1,3584,25,7673066589
2414,14571520,5552886,20124406,5,0,0,512,25,1448408351
2415,14575599,5702669,20278268,6,0,0,22528,11,4373609543
2416,14578690,5893024,20471714,7,0,0,41984,5,7060157799
2417,14583279,12198889,26782168,1,0,1,3584,22,1618992608
2418,14596479,12215762,26812241,2,0,1,4096,0,2408288347
2419,14627429,12187743,26815172,1,0,1,3072,22,5219645115
2420,14632630,12182888,26815518,3,0,1,512,25,1591884936
2421,14642789,12174355,26817144,2,0,1,2560,0,3639114355
2422,14650020,5861454,20511474,7,0,0,3584,5,1100267591
2423,14656979,12161151,26818130,2,0,1,1536,0,4798053858
2424,14662129,12165075,26827204,1,0,1,6144,22,8450143855
2425,14664080,12165710,26829790,3,0,1,4096,25,4798784756
2426,14664299,12221274,26885573,2,0,1,13824,0,1730794470
2427,14665509,12220087,26885596,1,0,1,15360,22,2468648768
2428,14666890,5649204,20316094,7,0,0,7680,5,7871461693
2429,14668019,5720514,20388533,6,0,0,72192,11,5602366241
2430,14669759,5718953,20388712,9,0,0,512,9,2766563903
2431,14670619,12215000,26885619,2,0,1,6144,0,2253900499
2432,14678459,12229863,26908322,1,0,1,8192,22,755550121
2433,14684349,5882190,20566539,6,0,0,27136,11,2397201058
2434,14695299,12213369,26908668,2,0,1,512,0,10202029138
2435,14701589,5577638,20279227,9,0,0,3072,9,10149108487
2436,14702499,12211661,26914160,7,0,1,8704,5,5295701806
2437,14705649,12212377,26918026,2,0,1,6144,0,10073937029
2438,14713619,5739960,20453579,6,0,0,47616,11,3225232976
2439,14722999,12196653,26919652,1,0,1,2560,22,7097250515
2440,14735840,5671170,20407010,7,0,0,38400,5,6139533978
2441,14736249,12197716,26933965,1,0,1,4096,22,8817614890
2442,14737739,6016950,20754689,6,0,0,90624,11,10556071410
2443,14739760,12194564,26934324,3,0,1,9728,25,197708645
2444,14744949,5410037,20154986,9,0,0,512,9,10067612885
2445,14745969,12278045,27024014,2,0,1,1024,0,5567459476
2446,14756840,5832990,20589830,5,0,0,2048,25,3717318979
2447,14758729,5696745,20455474,6,0,0,6144,11,5080896401
2448,14764299,12259738,27024037,1,0,1,1024,22,3656555840
2449,14770560,5662123,20432683,7,0,0,14336,5,238668938
2450,14776130,5813053,20589183,8,0,0,40960,17,9097736880
2451,14784559,6094025,20878584,6,0,0,84992,11,7064923180
2452,14788829,6197908,20986737,6,0,0,8192,11,6255906900
2453,14804470,5890520,20694990,8,0,0,13824,17,9645499467
2454,14814380,5672844,20487224,5,0,0,1024,25,3342008496
2455,14820029,12204031,27024060,2,0,1,3072,0,255256834
2456,14821849,12218169,27040018,2,0,1,23552,0,6553262504
2457,14822900,12217944,27040844,3,0,1,1536,25,6930788447
2458,14823239,12217628,27040867,2,0,1,512,0,6136464895
2459,14826790,6087899,20914689,8,0,0,113152,17,4070035780
2460,14830209,12210681,27040890,1,0,1,2048,22,3984208575
2461,14837599,12203314,27040913,1,0,1,1536,22,2444100530
2462,14862100,5864931,20727031,7,0,0,11776,5,6497074397
2463,14863780,6137644,21001424,7,0,0,48128,5,6725156518
2464,14869919,5829319,20699238,6,0,0,2560,11,1599547732
2465,14881079,5931809,20812888,6,0,0,73728,11,8028134320
2466,14908350,12132602,27040952,3,0,1,5632,25,5690725844
2467,14913970,5587159,20501129,7,0,0,14848,5,9518371569
2468,14915489,5897578,20813067,9,0,0,512,9,4013060956
2469,14915799,12125176,27040975,2,0,1,8192,0,3448797705
2470,14931739,12127740,27059479,2,0,1,12800,0,6306936712
2471,14935650,5737327,20672977,8,0,0,22016,17,7541887218
2472,14944089,6101148,21045237,9,0,0,3584,9,9011113822
2473,14951950,12143963,27095913,6,0,1,2048,11,9375550203
2474,14955840,5829702,20785542,8,0,0,65024,17,3562074019
2475,14958690,5666196,20624886,5,0,0,512,25,6443560266
2476,14965410,5684115,20649525,5,0,0,512,25,8438208128
2477,14970290,12125646,27095936,3,0,1,1024,25,9031200700
2478,14973569,12122390,27095959,1,0,1,512,22,4813321432
2479,14977549,5947989,20925538,9,0,0,35328,9,9680205443
2480,14987229,5803172,20790401,6,0,0,15872,11,6034983500
2481,15004709,5932864,20937573,6,0,0,39424,11,1652081230
2482,15014169,5948114,20962283,6,0,0,78336,11,8713154302
2483,15021479,12074511,27095990,1,0,1,3584,22,2662493331
2484,15034069,12061944,27096013,2,0,1,7168,0,5890792031
2485,15043600,5770442,20814042,7,0,0,3072,5,9696453746
2486,15046180,5834010,20880190,7,0,0,5120,5,9065354714
2487,15062750,6046929,21109679,8,0,0,55296,17,198987171
2488,15073100,12022936,27096036,3,0,1,1024,25,3696602457
2489,15073789,5686038,20759827,9,0,0,16384,9,8803556585
2490,15076259,6125619,21201878,6,0,0,92672,11,49404776
2491,15078360,12017699,27096059,7,0,1,3584,5,6511781203
2492,15082669,6004286,21086955,6,0,0,7168,11,7631042181
2493,15085050,12011032,27096082,0,0,1,2048,9,8204771206
2494,15088100,6085473,21173573,8,0,0,79360,17,4088652823
2495,15105300,6042331,21147631,8,0,0,56832,17,6554484956
2496,15109840,11986265,27096105,7,0,1,9216,5,8710429382
2497,15110100,5904421,21014521,7,0,0,7168,5,10567330630
2498,15115449,11983937,27099386,7,0,1,512,5,1186280623
2499,15121889,11980403,27102292,1,0,1,4608,22,8008625708
2500,15122970,11983828,27106798,3,0,1,7168,25,4402091588
2501,15153040,5785336,20938376,5,0,0,2560,25,1856612033
2502,15159090,6046912,21206002,6,0,0,12800,11,2655844112
2503,15161520,5961130,21122650,8,0,0,42496,17,8148827834
2504,15170850,11966633,27137483,0,0,1,5632,9,6541183650
2505,15172690,11990533,27163223,4,0,1,6656,29,1297398247
2506,15183110,5847335,21030445,5,0,0,1024,25,7004493296
2507,15188490,11974756,27163246,3,0,1,2560,25,8124616822
2508,15190410,6070357,21260767,7,0,0,6656,5,9907990928
2509,15193080,11970189,27163269,4,0,1,10240,29,4843224487
2510,15199880,11963412,27163292,4,0,1,2560,29,8170660390
2511,15202629,6015252,21217881,6,0,0,38912,11,281491692
2512,15203940,11959375,27163315,7,0,1,4096,5,5285148056
2513,15206749,11956589,27163338,1,0,1,8704,22,3681429736
2514,15207169,11956556,27163725,7,0,1,11264,5,8865298402
2515,15209890,11967397,27177287,4,0,1,3072,29,2059494635
2516,15216120,11962153,27178273,4,0,1,1536,29,1783723559
2517,15232890,11949889,27182779,7,0,1,7168,5,9195676333
2518,15234371,11962486,27196857,8,0,1,1024,17,920869225
2519,15241110,11960253,27201363,0,0,1,7168,9,2575571277
2520,15242149,11982968,27225117,1,0,1,5120,22,6797230153
2521,15244550,11981081,27225631,4,0,1,2560,29,6737782676
2522,15246700,11998789,27245489,3,0,1,1536,25,2094620687
2523,15246779,6011937,21258716,9,0,0,16896,9,60405655
2524,15249610,11995902,27245512,4,0,1,4608,29,7743145529
2525,15263241,11982294,27245535,8,0,1,5120,17,2854916938
2526,15263371,11984300,27247671,8,0,1,512,17,6887618524
2527,15264450,5973727,21238177,7,0,0,12800,5,1544562666
2528,15264519,6076871,21341390,9,0,0,50176,9,10639661159
2529,15266960,11980734,27247694,0,0,1,1536,9,10611488500
2530,15269021,11978696,27247717,8,0,1,5632,17,1266367970
2531,15270959,5878411,21149370,9,0,0,5632,9,1372234289
2532,15278271,11969469,27247740,8,0,1,1024,17,6864577247
2533,15282230,11965533,27247763,6,0,1,4096,11,3096020944
2534,15286141,11961645,27247786,8,0,1,4608,17,6018462000
2535,15294110,11953699,27247809,4,0,1,512,29,6332937623
2536,15295990,12069597,27365587,7,0,1,10240,5,5475372943
2537,15297340,12070208,27367548,9,0,1,2048,9,8974644911
2538,15299259,12120749,27420008,1,0,1,9728,22,5718407899
2539,15306721,12190442,27497163,8,0,1,5632,17,10674858817
2540,15308410,12202657,27511067,4,0,1,512,29,1729415790
2541,15311390,12213872,27525262,0,0,1,4096,9,4810560255
2542,15317129,6207823,21524952,6,0,0,57344,11,98813231
2543,15320479,12207369,27527848,7,0,1,4096,5,9708274752
2544,15324049,12207025,27531074,7,0,1,5120,5,8943895135
2545,15324650,12209010,27533660,3,0,1,4096,25,2169897583
2546,15330249,6314308,21644557,9,0,0,3072,9,2295693944
2547,15336410,6567506,21903916,5,0,0,512,25,6527010366
2548,15338990,6311986,21650976,7,0,0,20992,5,5256059378
2549,15339440,5960266,21299706,8,0,0,32256,17,830908705
2550,15346419,12252011,27598430,1,0,1,7680,22,8870922973
2551,15350280,12248173,27598453,3,0,1,5632,25,1408112181
2552,15351770,12246706,27598476,3,0,1,512,25,5413915524
2553,15353930,6248829,21602759,6,0,0,105984,11,7168925945
2554,15357730,12244583,27602313,0,0,1,7680,9,9631143407
2555,15361190,12241146,27602336,3,0,1,1024,25,8572123837
2556,15365530,12263552,27629082,4,0,1,7168,29,5620053114
2557,15368050,12261071,27629121,4,0,1,2560,29,7783845684
2558,15373330,6183749,21557079,8,0,0,4096,17,3843261663
2559,15379979,12249165,27629144,7,0,1,4096,5,2336142491
2560,15384521,12261302,27645823,8,0,1,2560,17,10701736524
2561,15385620,12261189,27646809,3,0,1,1536,25,4422261675
2562,15391560,12263072,27654632,4,0,1,10752,29,706993974
2563,15394450,12264623,27659073,4,0,1,8704,29,2597335480
2564,15394630,12272088,27666718,9,0,1,1024,9,2589171413
2565,15395890,6111101,21506991,5,0,0,1024,25,4529086458
2566,15396780,12363813,27760593,3,0,1,13312,25,10200315
2567,15402669,6272834,21675503,6,0,0,9216,11,1727121787
2568,15406629,12392432,27799061,7,0,1,512,5,9023641773
2569,15409030,12390054,27799084,9,0,1,7168,9,6173154430
2570,15428189,12370918,27799107,7,0,1,4096,5,5122362838
2571,15433940,5971086,21405026,8,0,0,512,17,3268551206
2572,15445499,6286834,21732333,6,0,0,31744,11,179290924
2573,15446809,6205024,21651833,6,0,0,2048,11,6368259699
2574,15454179,6073760,21527939,6,0,0,9728,11,5827377826
2575,15455609,6894455,22350064,9,0,0,138240,9,6065013154
2576,15455980,6349760,21805740,7,0,0,67584,5,2923264883
2577,15456190,12342940,27799130,0,0,1,8192,9,7525704965
2578,15468660,12330493,27799153,0,0,1,512,9,1052856186
2579,15474520,12324656,27799176,0,0,1,512,9,715525714
2580,15475839,6456069,21931908,9,0,0,1536,9,6769958441
2581,15475849,5956489,21432338,6,0,0,1024,11,9597843093
2582,15476630,5972366,21448996,5,0,0,512,25,9899238938
2583,15480390,6074045,21554435,7,0,0,61952,5,4798892717
2584,15480950,12318249,27799199,4,0,1,6144,29,6031274722
2585,15482149,6150631,21632780,9,0,0,98304,9,135210420
2586,15487510,6229442,21716952,8,0,0,16384,17,6320888099
2587,15491230,12332039,27823269,9,0,1,2560,9,8819633803
2588,15491489,12331803,27823292,7,0,1,1024,5,4967889969
2589,15493439,6150159,21643598,6,0,0,35328,11,1040902200
2590,15500069,6285056,21785125,9,0,0,67072,9,6406363829
2591,15505400,12317931,27823331,4,0,1,5632,29,10728020493
2592,15518601,12336669,27855270,8,0,1,7168,17,3373000314
2593,15525789,6283258,21809047,6,0,0,10752,11,9108148816
2594,15525910,6125268,21651178,5,0,0,512,25,5377383980
2595,15526130,6296553,21822683,5,0,0,1024,25,2375396732
2596,15531690,12329525,27861215,9,0,1,18432,9,4621255022
2597,15542590,12334176,27876766,9,0,1,2560,9,3722517284
2598,15548310,12332002,27880312,3,0,1,5632,25,5562951376
2599,15554429,6279631,21834060,9,0,0,15360,9,2703969082
2600,15558960,12325936,27884896,3,0,1,5120,25,5476643246
2601,15570460,6102212,21672672,8,0,0,7168,17,1899542819
2602,15572090,12315771,27887861,0,0,1,1536,9,4360349325
2603,15573510,12315337,27888847,4,0,1,1536,29,5669898149
2604,15577740,12314333,27892073,4,0,1,5120,29,7811932126
2605,15584660,12310319,27894979,4,0,1,4608,29,4916819603
2606,15596031,12300254,27896285,8,0,1,2048,17,5174730167
2607,15609199,6059996,21669195,6,0,0,19968,11,5210102389
2608,15620900,12297521,27918421,4,0,1,10752,29,8093008242
2609,15627490,12292557,27920047,9,0,1,2560,9,9161270724
2610,15634060,12288298,27922358,9,0,1,3584,9,10022861878
2611,15639899,12283080,27922979,5,0,1,1024,25,4428516573
2612,15655050,12291881,27946931,3,0,1,5632,25,8371200823
2613,15678760,12268194,27946954,3,0,1,17408,25,503207790
2614,15689989,6201366,21891355,6,0,0,46592,11,8477309336
2615,15692330,6447115,22139445,8,0,0,20992,17,2126174996
2616,15704600,6223517,21928117,7,0,0,50176,5,7647584581
2617,15710510,12236467,27946977,3,0,1,1024,25,5941370226
2618,15712540,6333895,22046435,7,0,0,27648,5,4916790280
2619,15715290,6417575,22132865,8,0,0,75264,17,4027423346
2620,15717380,12229620,27947000,3,0,1,5120,25,6708304361
2621,15718310,6248350,21966660,8,0,0,20480,17,6948440530
2622,15723329,6572561,22295890,9,0,0,14336,9,5088795345
2623,15728730,6562769,22291499,7,0,0,46080,5,9788410291
2624,15734350,12272331,28006681,3,0,1,14336,25,1748048586
2625,15736849,7113936,22850785,6,0,0,104448,11,593933441
2626,15748630,6226009,21974639,7,0,0,26112,5,3908177544
2627,15767100,6124590,21891690,5,0,0,1024,25,1737549090
2628,15775199,6631329,22406528,6,0,0,57344,11,2407761654
2629,15776550,6330017,22106567,5,0,0,512,25,6609182108
2630,15779110,12227594,28006704,0,0,1,1536,9,2111104903
2631,15791070,12215657,28006727,9,0,1,512,9,5594869006
2632,15796969,6782568,22579537,6,0,0,105472,11,10462295709
2633,15800159,6285937,22086096,6,0,0,46592,11,3347086853
2634,15800241,12206509,28006750,8,0,1,2048,17,7661052688
2635,15800680,6187231,21987911,8,0,0,25088,17,10262229103
2636,15813200,12193573,28006773,3,0,1,1024,25,6127702637
2637,15829610,5992738,21822348,7,0,0,7168,5,8956083488
2638,15835160,12171636,28006796,0,0,1,7168,9,1890086122
2639,15861560,12145259,28006819,3,0,1,3584,25,7800389244
2640,15864430,7069426,22933856,8,0,0,22016,17,4791688419
2641,15865980,12140862,28006842,0,0,1,14848,9,10241953073
2642,15871719,6667012,22538731,9,0,0,9728,9,1626972351
2643,15875310,6573054,22448364,7,0,0,83456,5,7038306261
2644,15878131,12134663,28012794,8,0,1,4096,17,10650023586
2645,15879989,12133791,28013780,2,0,1,1536,0,9487956345
2646,15888040,6214496,22102536,8,0,0,14848,17,10512803626
2647,15889959,12134792,28024751,2,0,1,3584,0,4125310080
2648,15897920,12135198,28033118,0,0,1,1536,9,1262198428
2649,15898470,6569166,22467636,8,0,0,10752,17,7480762635
2650,15901541,12132883,28034424,8,0,1,2048,17,4245770607
2651,15914239,12124486,28038725,1,0,1,4608,22,4504986961
2652,15918589,12123712,28042301,2,0,1,512,0,7635677435
2653,15929990,6477505,22407495,5,0,0,3072,25,9259448096
2654,15930640,12113607,28044247,9,0,1,3072,9,5317509497
2655,15931340,6457693,22389033,8,0,0,40448,17,3433242521
2656,15951809,12095664,28047473,2,0,1,5120,0,10631115141
2657,15971761,12079578,28051339,8,0,1,6144,17,650481087
2658,15972090,12120541,28092631,9,0,1,7680,9,5577644005
2659,15978090,6207556,22185646,8,0,0,7680,17,1528445366
2660,15994069,7050115,23044184,9,0,0,17408,9,2602730928
2661,16012079,6806859,22818938,9,0,0,24064,9,8313937590
2662,16033620,12059997,28093617,9,0,1,1536,9,2018792193
2663,16034190,6443773,22477963,8,0,0,5120,17,8279479836
2664,16043079,7178996,23222075,9,0,0,205312,9,3158312406
2665,16046039,6595498,22641537,9,0,0,78848,9,6979311626
2666,16046069,6044418,22090487,9,0,0,14336,9,6261615209
2667,16060600,6849576,22910176,5,0,0,512,25,1787705918
2668,16061020,6406795,22467815,5,0,0,512,25,3379370003
2669,16063880,6163420,22227300,5,0,0,512,25,3639597431
2670,16064380,6075400,22139780,5,0,0,1024,25,10699153637
2671,16079080,12014883,28093963,9,0,1,512,9,10546298308
2672,16086230,12013460,28099690,9,0,1,14848,9,239933822
2673,16135049,8018613,24153662,9,0,0,164864,9,9620243693
2674,16144470,7141233,23285703,7,0,0,57344,5,1912068285
2675,16149440,6025058,22174498,8,0,0,21504,17,5249752702
2676,16154230,11974765,28128995,9,0,1,11776,9,8752290650
2677,16165220,11967641,28132861,9,0,1,6144,9,1509213696
2678,16186839,11979425,28166264,2,0,1,8704,0,547729288
2679,16198520,12020337,28218857,9,0,1,2560,9,2607902142
2680,16211619,12007597,28219216,2,0,1,9728,0,1986450104
2681,16218049,7029367,23247416,9,0,0,80896,9,5352482425
2682,16223050,12007443,28230493,9,0,1,18944,9,6599609305
2683,16225360,12005156,28230516,0,0,1,1024,9,531934580
2684,16227899,12002640,28230539,2,0,1,11776,0,2877929933
2685,16229721,12040361,28270082,8,0,1,1024,17,760832530
2686,16232430,6122672,22355102,7,0,0,12800,5,1586723807
2687,16237270,6171207,22408477,5,0,0,1536,25,9200656428
2688,16251450,12019938,28271388,9,0,1,2048,9,10163876471
2689,16251640,12020721,28272361,4,0,1,12800,29,6364007775
2690,16253250,12108990,28362240,9,0,1,4096,9,8004128238
2691,16254070,6326697,22580767,5,0,0,3584,25,8099363274
2692,16260780,6861325,23122105,7,0,0,1024,5,5375900413
2693,16265120,6086059,22351179,8,0,0,3584,17,6925096284
2694,16270650,12129096,28399746,9,0,1,1536,9,1772648857
2695,16292670,6064803,22357473,8,0,0,7680,17,8285934222
2696,16303459,12096437,28399896,2,0,1,512,0,6872704928
2697,16314800,12090421,28405221,3,0,1,4096,25,8782882077
2698,16325779,7028994,23354773,9,0,0,51200,9,4500298413
2699,16333330,12141468,28474798,3,0,1,14336,25,8432011316
2700,16341669,12193643,28535312,2,0,1,2048,0,1057377650
2701,16350940,6057046,22407986,5,0,0,1536,25,8509463166
2702,16350990,12184988,28535978,3,0,1,11264,25,4932475071
2703,16358700,6101699,22460399,8,0,0,39424,17,6968484661
2704,16375000,6500996,22875996,5,0,0,512,25,2779610907
2705,16402020,5905901,22307921,8,0,0,3072,17,7235706623
2706,16407390,6070752,22478142,8,0,0,512,17,709886785
2707,16409390,6203422,22612812,8,0,0,1024,17,2453921798
2708,16416019,12161615,28577634,2,0,1,12288,0,5705567382
2709,16429930,6109065,22538995,5,0,0,512,25,1547599324
2710,16443429,6471450,22914879,9,0,0,15360,9,6289864851
2711,16444409,12154572,28598981,2,0,1,15872,0,7077604593
2712,16462519,6429881,22892400,9,0,0,42496,9,1410624619
2713,16463470,6565340,23028810,7,0,0,70656,5,350853415
2714,16469800,12146716,28616516,3,0,1,1536,25,2398284607
2715,16495579,12158061,28653640,1,0,1,4096,22,8505331293
2716,16513759,12139904,28653663,1,0,1,6144,22,9115210901
2717,16516460,7741466,24257926,8,0,0,19968,17,1118018090
2718,16531970,6058772,22590742,5,0,0,1536,25,9694467172
2719,16534789,12118897,28653686,1,0,1,1536,22,4918314233
2720,16566089,12087620,28653709,1,0,1,2560,22,6386784146
2721,16572710,6695444,23268154,7,0,0,67584,5,4987864840
2722,16576159,12077573,28653732,2,0,1,3072,0,2374399487
2723,16576389,12077366,28653755,1,0,1,4608,22,6155512303
2724,16576859,12139030,28715889,1,0,1,18944,22,10101849296
2725,16587500,6198941,22786441,7,0,0,11264,5,10580597762
2726,16602530,6298854,22901384,7,0,0,9728,5,7351178967
2727,16608360,12107552,28715912,3,0,1,9728,25,5564389087
2728,16614680,12102316,28716996,3,0,1,4608,25,9032952366
2729,16617039,12099980,28717019,2,0,1,512,0,7085892359
2730,16623210,6239040,22862250,7,0,0,37376,5,1469535227
2731,16644050,6356850,23000900,5,0,0,512,25,10264628646
2732,16656730,6126256,22782986,7,0,0,55808,5,1485016973
2733,16666489,12051044,28717533,2,0,1,9728,0,1184418393
2734,16666999,12063389,28730388,1,0,1,3584,22,1505105976
2735,16667989,12069786,28737775,2,0,1,4096,0,7971268758
2736,16671279,12067802,28739081,2,0,1,2048,0,3179661231
2737,16674019,12067328,28741347,1,0,1,3584,22,9638274787
2738,16690799,12052174,28742973,1,0,1,2560,22,7702010610
2739,16709890,12038907,28748797,0,0,1,512,9,9687141827
2740,16727549,12022119,28749668,2,0,1,12288,0,1135735449
2741,16739519,12026882,28766401,2,0,1,3584,0,2206122450
2742,16740910,6323044,23063954,5,0,0,512,25,5797139647
2743,16746189,12020235,28766424,1,0,1,1024,22,8424841252
2744,16749470,6713273,23462743,7,0,0,41472,5,5742110367
2745,16752700,6826281,23578981,7,0,0,58880,5,2591078838
2746,16760650,12005797,28766447,0,0,1,1536,9,4966979103
2747,16765610,12006256,28771866,0,0,1,23040,9,8683541129
2748,16766239,12019253,28785492,1,0,1,1024,22,750444239
2749,16784360,6216361,23000721,7,0,0,43008,5,4453186957
2750,16785039,6002251,22787290,9,0,0,2560,9,9590733959
2751,16796329,11991429,28787758,2,0,1,3584,0,9297547127
2752,16816590,6254009,23070599,7,0,0,7680,5,10041480176
2753,16819749,11968675,28788424,1,0,1,1024,22,8398572255
2754,16819849,6466033,23285882,9,0,0,512,9,7695014090
2755,16822670,6777468,23600138,5,0,0,2560,25,3035949572
2756,16825910,6671247,23497157,7,0,0,49664,5,7169790881
2757,16852489,11939712,28792201,2,0,1,16896,0,7294008965
2758,16855109,11939357,28794466,1,0,1,9216,22,2954583449
2759,16865419,11944860,28810279,1,0,1,5632,22,8780274904
2760,16912520,11900665,28813185,0,0,1,4608,9,10728287321
2761,16923600,6761768,23685368,7,0,0,23040,5,5409591961
2762,16933950,11879901,28813851,6,0,1,1024,11,9862577588
2763,16944240,6043354,22987594,7,0,0,26624,5,10655745048
2764,16944399,11878225,28822624,1,0,1,8704,22,1471619990
2765,16956870,6136775,23093645,5,0,0,1536,25,3787477999
2766,16997699,11836513,28834212,2,0,1,9728,0,4906326011
2767,17014929,11822829,28837758,1,0,1,5632,22,1136654792
2768,17025280,6065763,23091043,5,0,0,1024,25,2826317590
2769,17031249,11810927,28842176,1,0,1,13824,22,9979388149
2770,17033580,5967499,23001079,5,0,0,512,25,7059851659
2771,17041640,7384993,24426633,7,0,0,109056,5,2359593717
2772,17049350,6016140,23065490,5,0,0,512,25,1438715869
2773,17052970,11809120,28862090,0,0,1,7680,9,7421048410
2774,17078620,11785416,28864036,0,0,1,3072,9,10170414056
2775,17081980,11785116,28867096,0,0,1,13312,9,6277748972
2776,17093280,5965663,23058943,5,0,0,1536,25,5409250822
2777,17097270,11771106,28868376,0,0,1,14336,9,9228008792
2778,17101249,6046507,23147756,9,0,0,512,9,672261126
2779,17105140,6011575,23116715,5,0,0,512,25,2066966523
2780,17106369,6451520,23557889,9,0,0,512,9,9019847921
2781,17106919,5924290,23031209,9,0,0,512,9,5644123642
2782,17107009,11769778,28876787,1,0,1,2048,22,8440804045
2783,17116100,11766179,28882279,0,0,1,8704,9,4213519157
2784,17126809,11759016,28885825,2,0,1,5632,0,4342495550
2785,17128440,5989369,23117809,5,0,0,2048,25,4955290894
2786,17132849,11756842,28889691,2,0,1,6144,0,1646880071
2787,17140029,11754514,28894543,1,0,1,7680,22,6598403989
2788,17157439,6197513,23354952,9,0,0,512,9,3080238785
2789,17169209,11726640,28895849,1,0,1,2048,22,10374765072
2790,17186399,11715222,28901621,1,0,1,2560,22,9120058894
2791,17198500,6359210,23557710,7,0,0,37376,5,6210535137
2792,17204210,6099645,23303855,7,0,0,7680,5,5673354781
2793,17205540,11724676,28930216,0,0,1,30720,9,10224638332
2794,17214960,6740564,23955524,7,0,0,211968,5,9770981379
2795,17218429,11723043,28941472,1,0,1,2048,22,4318659288
2796,17226290,6311260,23537550,7,0,0,23040,5,996300615
2797,17247009,11696089,28943098,1,0,1,2560,22,8836780291
2798,17252520,6759013,24011533,5,0,0,1024,25,2547116495
2799,17277130,7149744,24426874,5,0,0,512,25,1145535030
2800,17289240,5933326,23222566,5,0,0,1536,25,9851026355
2801,17312219,6727096,24039315,9,0,0,512,9,8747481286
2802,17334739,6464237,23798976,9,0,0,512,9,8368672607
2803,17350159,11625330,28975489,2,0,1,26112,0,2572217821
2804,17373660,5849085,23222745,5,0,0,512,25,5913583877
2805,17391660,5940675,23332335,5,0,0,1024,25,4003493530
2806,17392960,6186200,23579160,5,0,0,512,25,908340948
2807,17400810,6252853,23653663,5,0,0,1024,25,10137167094
2808,17414969,5991527,23406496,9,0,0,1024,9,9007951666
2809,17420100,11561118,28981218,0,0,1,6656,9,9622668700
2810,17427870,11567912,28995782,0,0,1,512,9,2293808157
2811,17433070,11565438,28998508,0,0,1,7680,9,7732397861
2812,17443919,6060312,23504231,9,0,0,23040,9,8034940716
2813,17455870,6289034,23744904,7,0,0,60416,5,2699433593
2814,17466380,11536314,29002694,0,0,1,6656,9,9196406931
2815,17480439,6735193,24215632,9,0,0,8192,9,6632501619
2816,17490139,6236334,23726473,9,0,0,27136,9,4291464645
2817,17514699,11490581,29005280,1,0,1,4096,22,4098923031
2818,17514750,6319995,23834745,7,0,0,26112,5,3637321569
2819,17533640,6470157,24003797,7,0,0,141312,5,8667548298
2820,17545430,6224504,23769934,7,0,0,27136,5,9427645089
2821,17559650,5858998,23418648,5,0,0,512,25,6949765619
2822,17582870,5976602,23559472,7,0,0,5120,5,7259100560
2823,17600170,6027674,23627844,7,0,0,10752,5,10257673586
2824,17612620,11396846,29009466,0,0,1,6656,9,5838169719
2825,17657629,6445778,24103407,9,0,0,7168,9,8333135040
2826,17673639,5801139,23474778,9,0,0,39424,9,10258392684
2827,17680230,5857655,23537885,5,0,0,1024,25,5621245559
2828,17709740,5794982,23504722,5,0,0,1536,25,1066047627
2829,17727239,6464119,24191358,9,0,0,29184,9,5208548035
2830,17735799,6309799,24045598,9,0,0,2048,9,5712396468
2831,17746330,5998761,23745091,5,0,0,512,25,9955051675
2832,17772390,5835750,23608140,5,0,0,1536,25,1706820195
2833,17797179,6286689,24083868,9,0,0,10752,9,3400435830
2834,17819260,5537587,23356847,7,0,0,6144,5,6863733120
2835,17828750,11181062,29009812,7,0,1,512,5,5582281625
2836,17835659,5758515,23594174,9,0,0,8192,9,7309538047
2837,17846410,6757598,24604008,7,0,0,71680,5,10025347546
2838,17888541,11121937,29010478,8,0,1,1024,17,6061588071
2839,17888550,6456889,24345439,7,0,0,136192,5,4681714157
2840,17928550,6464717,24393267,5,0,0,49152,25,1466371721
2841,17933980,5940758,23874738,5,0,0,1024,25,9777750640
2842,17976000,6600934,24576934,7,0,0,62976,5,1284289036
2843,18037839,6120370,24158209,9,0,0,14848,9,619490954
2844,18063530,5975536,24039066,7,0,0,12800,5,5488644974
2845,18113520,6584919,24698439,5,0,0,21504,25,8240263699
2846,18123929,6346478,24470407,9,0,0,24064,9,7494612950
2847,18148209,10863255,29011464,2,0,1,1536,0,7670185069
2848,18180040,5498285,23678325,5,0,0,29184,25,6160513117
2849,18222730,10789080,29011810,6,0,1,512,11,7193102033
2850,18255679,6232379,24488058,9,0,0,57856,9,1227892298
2851,18302620,5946098,24248718,5,0,0,11264,25,3165253744
2852,18309950,6228947,24538897,7,0,0,152576,5,6375204399
2853,18321609,10691213,29012822,2,0,1,1536,0,1411477982
2854,18347039,6318494,24665533,9,0,0,59904,9,6476902935
2855,18379239,5649945,24029184,9,0,0,57856,9,3579771120
2856,18405269,10608859,29014128,2,0,1,2048,0,4051272888
2857,18419520,5589136,24008656,5,0,0,15872,25,7019998246
2858,18441710,5519008,23960718,7,0,0,15360,5,4895297814
2859,18452699,5582444,24035143,9,0,0,19456,9,10192708182
2860,18476699,10540975,29017674,2,0,1,5632,0,8761933582
2861,18513700,5337336,23851036,7,0,0,19968,5,4214218388
2862,18531350,10486670,29018020,9,0,1,512,9,9221531292
2863,18531859,10490027,29021886,2,0,1,6144,0,2527441553
2864,18581270,6065988,24647258,5,0,0,68608,25,10691322195
2865,18585540,10443959,29029499,3,0,1,3584,25,8735169963
2866,18589269,10442176,29031445,5,0,1,3072,25,8131811050
2867,18593930,6097934,24691864,7,0,0,86016,5,6074404178
2868,18596980,5119198,23716178,5,0,0,3072,25,1125634565
2869,18691229,5584609,24275838,9,0,0,29696,9,70163314
2870,18703679,5665362,24369041,9,0,0,73216,9,1825067240
2871,18710160,10330314,29040474,3,0,1,6656,25,5234972829
2872,18712360,10332751,29045111,3,0,1,1024,25,6329503000
2873,18717830,6074675,24792505,7,0,0,64512,5,4721746982
2874,18728359,5454076,24182435,9,0,0,18432,9,10422733393
2875,18741760,5520684,24262444,7,0,0,10240,5,7529112629
2876,18746409,5209606,23956015,9,0,0,1536,9,9193267665
2877,18747879,10297386,29045265,5,0,1,8704,25,487531150
2878,18751180,5953155,24704335,5,0,0,18944,25,1536596825
2879,18774309,5282329,24056638,9,0,0,19968,9,7902502023
2880,18786439,10271142,29057581,7,0,1,5632,5,9923471400
2881,18792949,5383847,24176796,9,0,0,60928,9,1950095047
2882,18801539,5660366,24461905,9,0,0,114688,9,3340862612
2883,18804180,10257907,29062087,3,0,1,7168,25,1647472206
2884,18812139,10254315,29066454,7,0,1,5120,5,3968361049
2885,18816110,10252364,29068474,7,0,1,512,5,9282143600
2886,18816640,5194558,24011198,7,0,0,8192,5,5966990794
2887,18821179,5981976,24803155,9,0,0,2560,9,9418251821
2888,18826000,10244149,29070149,7,0,1,2560,5,1352191222
2889,18835709,10239537,29075246,5,0,1,8192,25,196876418
2890,18883730,5396596,24280326,7,0,0,4096,5,361506929
2891,18925079,10150513,29075592,5,0,1,512,25,6400305231
2892,18925420,5537600,24463020,7,0,0,3584,5,7557669748
2893,18926229,10151949,29078178,5,0,1,4096,25,2043452462
2894,18934090,10144242,29078332,7,0,1,8704,5,7080452187
2895,18939010,5678601,24617611,7,0,0,44544,5,814878059
2896,18940100,5438168,24378268,5,0,0,30208,25,2936546272
2897,18944030,5880426,24824456,5,0,0,49152,25,617759948
2898,18956970,10125205,29082175,3,0,1,1536,25,1915623792
2899,18984839,5568119,24552958,9,0,0,36352,9,2765747447
2900,18984910,10098891,29083801,7,0,1,2560,5,4041536036
2901,18991500,10097447,29088947,6,0,1,8192,11,6712344091
2902,18999499,10099002,29098501,5,0,1,6144,25,9651186681
2903,18999670,5705952,24705622,7,0,0,4096,5,5085204315
2904,19002980,10103351,29106331,6,0,1,512,11,3596929196
2905,19003889,5488427,24492316,9,0,0,13824,9,4405341429
2906,19003960,10106237,29110197,6,0,1,6144,11,1836215951
2907,19007440,5550283,24557723,5,0,0,15360,25,8837381215
2908,19010729,10103692,29114421,5,0,1,1536,25,810873933
2909,19015740,10111986,29127726,3,0,1,8192,25,6795938712
2910,19018990,10109402,29128392,6,0,1,11264,11,455396799
2911,19048520,5749312,24797832,5,0,0,17408,25,7776734805
2912,19050569,10082009,29132578,5,0,1,6656,25,2473528446
2913,19052660,10102767,29155427,3,0,1,24064,25,5210640208
2914,19055790,5823103,24878893,5,0,0,63488,25,3712543417
2915,19058029,5524076,24582105,9,0,0,16896,9,4232758706
2916,19063709,10105299,29169008,5,0,1,7168,25,7616109974
2917,19076080,5776791,24852871,7,0,0,93184,5,5770900655
2918,19077030,5269680,24346710,5,0,0,4096,25,921283144
2919,19082960,5876352,24959312,7,0,0,62976,5,5989805086
2920,19085111,10084563,29169674,8,0,1,1024,17,3406735958
2921,19088340,5453519,24541859,7,0,0,9216,5,5576930619
2922,19091620,10079360,29170980,3,0,1,2048,25,5531470739
2923,19096761,10078725,29175486,8,0,1,7168,17,6072962447
2924,19098030,6218674,25316704,7,0,0,75776,5,9601665475
2925,19100100,5889031,24989131,5,0,0,97792,25,4692397708
2926,19123621,10067995,29191616,8,0,1,3584,17,9359612957
2927,19137129,10058673,29195802,5,0,1,6656,25,6438658149
2928,19139800,5608974,24748774,5,0,0,58880,25,2677543842
2929,19158510,10037958,29196468,6,0,1,11264,11,7705833030
2930,19166449,10030173,29196622,5,0,1,8704,25,281085287
2931,19167000,10045386,29212386,0,0,1,10240,9,9394505792
2932,19173370,10068563,29241933,3,0,1,5120,25,6678426890
2933,19178069,10070830,29248899,7,0,1,8704,5,7503723694
2934,19182880,10070525,29253405,7,0,1,7168,5,2389707526
2935,19182920,10076297,29259217,6,0,1,9216,11,2927949468
2936,19183490,10075881,29259371,7,0,1,8704,5,2329696830
2937,19192180,10083934,29276114,0,0,1,8704,9,6219819249
2938,19201350,10075123,29276473,7,0,1,9728,5,8272259998
2939,19213470,10068171,29281641,3,0,1,11776,25,1173699580
2940,19223760,10063477,29287237,7,0,1,1536,5,4825958545
2941,19225430,10072392,29297822,7,0,1,12288,5,8401551873
2942,19230030,10077269,29307299,6,0,1,1024,11,4254204029
2943,19233450,10076985,29310435,6,0,1,512,11,6548669193
2944,19244230,10070391,29314621,0,0,1,6656,9,2799898738
2945,19261810,10061382,29323192,3,0,1,6656,25,3666458876
2946,19266361,10058457,29324818,8,0,1,2560,17,6202257458
2947,19267980,10062330,29330310,6,0,1,17920,11,8936195318
2948,19274961,10098308,29373269,8,0,1,10752,17,86419310
2949,19275980,10100515,29376495,3,0,1,5120,25,4426867162
2950,19280020,10106081,29386101,3,0,1,5632,25,9451894471
2951,19285119,5619023,24904142,9,0,0,67584,9,1745560228
2952,19287140,10100911,29388051,0,0,1,24576,9,5985827170
2953,19294450,10103777,29398227,7,0,1,16384,5,396642471
2954,19319001,10087273,29406274,8,0,1,10240,17,3800264716
2955,19319500,10087440,29406940,0,0,1,1024,9,994599696
2956,19321070,10089096,29410166,7,0,1,5120,5,8937696841
2957,19331870,10081202,29413072,3,0,1,4608,25,5959177713
2958,19335960,10078738,29414698,0,0,1,2560,9,6222541821
2959,19341440,10073924,29415364,0,0,1,1024,9,4259349811
2960,19342250,10073575,29415825,3,0,1,10240,25,5781517564
2961,19346480,10070971,29417451,6,0,1,2560,11,6587792329
2962,19351960,10068077,29420037,6,0,1,4096,11,9039423593
2963,19356110,10065873,29421983,0,0,1,3072,9,7700767018
2964,19359120,10063209,29422329,3,0,1,512,25,9861831374
2965,19372180,10050815,29422995,7,0,1,1024,5,6220933252
2966,19385520,10041021,29426541,0,0,1,5632,9,10260717505
2967,19395020,10031953,29426973,6,0,1,512,11,2097381571
2968,19396760,10030879,29427639,6,0,1,11264,11,4559788958
2969,19405579,5615294,25020873,9,0,0,24064,9,7907152304
2970,19408760,10031762,29440522,3,0,1,3584,25,10150080157
2971,19422450,10022284,29444734,0,0,1,6656,9,4304400917
2972,19423210,5457734,24880944,5,0,0,6656,25,7922610060
2973,19426460,10023459,29449919,0,0,1,16384,9,9099512732
2974,19431380,5581954,25013334,5,0,0,79360,25,3737988159
2975,19446190,5979505,25425695,5,0,0,25088,25,1546093054
2976,19465659,9985566,29451225,2,0,1,2048,0,1196346959
2977,19471460,9980751,29452211,6,0,1,1536,11,2898640490
2978,19472600,9986400,29459000,0,0,1,8704,9,1997592882
2979,19475090,9990342,29465432,0,0,1,8192,9,3904843400
2980,19479371,10004958,29484329,8,0,1,7168,17,2281397230
2981,19487900,10000981,29488881,0,0,1,2048,9,4613332104
2982,19490290,9999257,29489547,6,0,1,1024,11,5666021514
2983,19496580,5697730,25194310,7,0,0,15872,5,5824633997
2984,19503491,9988322,29491813,8,0,1,3584,17,1226003416
2985,19513700,9984783,29498483,3,0,1,7680,25,3637301965
2986,19525799,5390473,24916272,9,0,0,10752,9,4041991833
2987,19546080,9968118,29514198,6,0,1,3072,11,2080364690
2988,19570880,9966474,29537354,6,0,1,4096,11,3927993010
2989,19576830,5709692,25286522,7,0,0,2560,5,10564727380
2990,19588220,9961305,29549525,3,0,1,7680,25,10581732655
2991,19596681,9962757,29559438,8,0,1,20480,17,7800697860
2992,19610201,9952169,29562370,8,0,1,4608,17,3108507740
2993,19612730,5576721,25189451,7,0,0,108544,5,9187799795
2994,19614850,5752355,25367205,5,0,0,45056,25,7573710379
2995,19622020,9940606,29562626,0,0,1,9216,9,9957885445
2996,19623119,5503972,25127091,9,0,0,26624,9,9286598740
2997,19623690,9944325,29568015,0,0,1,17408,9,539686256
2998,19641081,9927280,29568361,8,0,1,512,17,6180643933
2999,19643840,5838325,25482165,7,0,0,43520,5,1957150468
3000,19656870,5828805,25485675,5,0,0,11264,25,866648604
3001,19661830,9908477,29570307,0,0,1,3072,9,2685002295
3002,19663010,9907963,29570973,0,0,1,1024,9,5673266849
3003,19675480,9898719,29574199,0,0,1,5120,9,2739500756
3004,19680150,5548061,25228211,5,0,0,5632,25,10387074396
3005,19693140,9901051,29594191,0,0,1,6144,9,3043473036
3006,19708880,9889817,29598697,0,0,1,7168,9,10335042825
3007,19709019,9895460,29604479,5,0,1,3584,25,4326384013
3008,19724590,9884858,29609448,0,0,1,4096,9,6141395595
3009,19744630,9872306,29616936,6,0,1,1024,11,8552855816
3010,19747290,6003330,25750620,5,0,0,37376,25,5666299945
3011,19795440,9822482,29617922,0,0,1,1536,9,621857181
3012,19797830,9822038,29619868,6,0,1,3072,11,9208990443
3013,19806220,9816881,29623101,6,0,1,5120,11,7953256292
3014,19816490,9806950,29623440,6,0,1,512,11,862237759
3015,19817609,9809723,29627332,2,0,1,6144,0,2284022939
3016,19818570,9809108,29627678,3,0,1,512,25,10201555254
3017,19823740,9807164,29630904,6,0,1,5120,11,5602626135
3018,19829170,9803360,29632530,6,0,1,2560,11,10132421146
3019,19833210,9800908,29634118,0,0,1,15872,9,9155438179
3020,19838190,9819190,29657380,6,0,1,14848,11,6680608065
3021,19846321,9822443,29668764,8,0,1,12800,17,6894363974
3022,19854340,9817970,29672310,0,0,1,5632,9,3810820583
3023,19859380,5525632,25385012,7,0,0,58368,5,5141622171
3024,19860880,5557071,25417951,5,0,0,108032,25,5490123379
3025,19874900,9802702,29677602,0,0,1,1536,9,7796458684
3026,19879430,9802678,29682108,0,0,1,7168,9,9717139906
3027,19880749,6127775,26008524,9,0,0,155648,9,8296920562
3028,19884550,5776014,25660564,7,0,0,5120,5,3346345404
3029,19892560,9790854,29683414,6,0,1,2048,11,5572430683
3030,19897110,9794996,29692106,0,0,1,13824,9,3314168724
3031,19901610,5567249,25468859,7,0,0,25600,5,952953954
3032,19903791,9790261,29694052,8,0,1,3072,17,115491903
3033,19912379,5373340,25285719,9,0,0,35840,9,6844778238
3034,19918700,9775698,29694398,6,0,1,512,11,7008823384
3035,19925220,5535793,25461013,5,0,0,53248,25,2034952066
3036,19934050,5887676,25821726,5,0,0,27648,25,9124116026
3037,19934470,9762834,29697304,0,0,1,4608,9,10671957345
3038,19941769,5502981,25444750,9,0,0,62464,9,1804763248
3039,19944160,9757010,29701170,6,0,1,6144,11,10690378816
3040,19957501,9754930,29712431,8,0,1,1024,17,4892058403
3041,19964741,9748458,29713199,8,0,1,11776,17,6645929017
3042,19977170,5910930,25888100,7,0,0,16384,5,377109267
3043,19984981,9737991,29722972,8,0,1,4096,17,3817395064
3044,19990320,5560029,25550349,5,0,0,8704,25,7743300677
3045,19994940,9731898,29726838,0,0,1,6144,9,10446304001
3046,20012130,6208326,26220456,7,0,0,67584,5,2161161923
3047,20026661,9703438,29730099,8,0,1,12288,17,2412727260
3048,20027159,6079854,26107013,9,0,0,75264,9,1574799850
3049,20034560,5746250,25780810,5,0,0,13312,25,5426997561
3050,20048680,5474907,25523587,7,0,0,26624,5,6962116176
3051,20051321,9685005,29736326,8,0,1,512,17,9307579919
3052,20058401,9678591,29736992,8,0,1,1024,17,4308277433
3053,20079099,5967236,26046335,9,0,0,80896,9,1692484605
3054,20081709,5575596,25657305,9,0,0,4608,9,7197060433
3055,20093610,5966045,26059655,7,0,0,23552,5,6788466131
3056,20098150,9641108,29739258,3,0,1,3584,25,3779756175
3057,20102800,5548442,25651242,7,0,0,45056,5,7296898809
3058,20103271,9639853,29743124,8,0,1,6144,17,3988827846
3059,20124509,5578515,25703024,9,0,0,22016,9,3381783236
3060,20131699,5882377,26014076,9,0,0,15360,9,2221343753
3061,20141749,5365978,25507727,9,0,0,11264,9,8368941318
3062,20150089,5560474,25710563,9,0,0,512,9,1555298988
3063,20151370,9604803,29756173,3,0,1,4608,25,2869285799
3064,20154311,9629990,29784301,8,0,1,27136,17,216844887
3065,20155970,5687540,25843510,7,0,0,52736,5,10562899485
3066,20162440,6077767,26240207,5,0,0,51200,25,9955394346
3067,20163659,5565365,25729024,9,0,0,15872,9,9618535748
3068,20165831,9619776,29785607,8,0,1,2048,17,10116982065
3069,20173350,5421608,25594958,7,0,0,24576,5,9449271174
3070,20196929,9591264,29788193,3,0,1,4096,25,9293883092
3071,20198021,9590838,29788859,8,0,1,1024,17,870809092
3072,20208980,9582785,29791765,6,0,1,4608,11,9382513464
3073,20209510,9585161,29794671,6,0,1,4608,11,6774024688
3074,20216440,9581058,29797498,3,0,1,1536,25,6631936955
3075,20248869,5799361,26048230,9,0,0,6144,9,9164332866
3076,20255499,9548451,29803950,3,0,1,10240,25,10078338670
3077,20262950,5820929,26083879,7,0,0,48640,5,8558695506
3078,20269960,5642802,25912762,5,0,0,66048,25,7779554239
3079,20306320,5715267,26021587,5,0,0,24576,25,695295266
3080,20309829,5492293,25802122,9,0,0,1536,9,8962508660
3081,20336670,9468839,29805509,3,0,1,2048,25,2623408491
3082,20344020,5801460,26145480,7,0,0,17408,5,1940254508
3083,20349620,6232176,26581796,5,0,0,14848,25,6274588681
3084,20369191,9455559,29824750,8,0,1,11776,17,7739594836
3085,20374289,9471348,29845637,3,0,1,512,25,4779560829
3086,20382860,5546510,25929370,5,0,0,33792,25,9170783324
3087,20394050,6128716,26522766,5,0,0,83456,25,2614431987
3088,20394090,9452853,29846943,0,0,1,2048,9,5420942261
3089,20394191,9453008,29847199,8,0,1,9216,17,2049414274
3090,20404380,9444087,29848467,6,0,1,1024,11,6340500717
3091,20414810,9436883,29851693,6,0,1,5120,11,7654750707
3092,20421730,9431269,29852999,0,0,1,2048,9,843523697
3093,20422359,6013269,26435628,9,0,0,33792,9,6421488170
3094,20435039,9420546,29855585,1,0,1,4096,22,4307485523
3095,20435549,9426161,29861710,1,0,1,3584,22,6173396671
3096,20436090,9426926,29863016,6,0,1,2048,11,10182708321
3097,20438220,9425564,29863784,0,0,1,11776,9,4941471842
3098,20446930,9430770,29877700,6,0,1,1536,11,1026477824
3099,20449760,9429566,29879326,6,0,1,2560,11,9717516581
3100,20453831,9439122,29892953,8,0,1,1024,17,3502819000
3101,20458830,9440519,29899349,3,0,1,9216,25,8129651829
3102,20471219,9430076,29901295,3,0,1,3072,25,7999684768
3103,20479671,9424772,29904443,8,0,1,4608,17,7597887079
3104,20488769,9417779,29906548,1,0,1,512,22,10437124083
3105,20497839,5511488,26009327,9,0,0,2560,9,9241694177
3106,20498190,9452878,29951068,6,0,1,12288,11,2128680149
3107,20508821,9448012,29956833,8,0,1,11264,17,116626461
3108,20513849,5972124,26485973,9,0,0,45568,9,4656998641
3109,20516021,9441158,29957179,8,0,1,512,17,4214249670
3110,20518340,5533688,26052028,5,0,0,12288,25,3986290172
3111,20527189,9434176,29961365,1,0,1,6656,22,9371746545
3112,20538149,9423984,29962133,3,0,1,11776,25,6443603095
3113,20538241,9424238,29962479,8,0,1,512,17,4533402328
3114,20561790,9403915,29965705,0,0,1,5120,9,10095779958
3115,20561990,6060618,26622608,5,0,0,28672,25,245882673
3116,20579690,9386681,29966371,0,0,1,1024,9,5892282659
3117,20599689,9371828,29971517,1,0,1,8192,22,6474821066
3118,20600889,6114893,26715782,9,0,0,58368,9,4965837164
3119,20609289,9378789,29988078,1,0,1,1536,22,5511861139
3120,20623229,9373506,29996735,1,0,1,5120,22,4913066360
3121,20625769,6001904,26627673,9,0,0,13312,9,2351236170
3122,20626829,5425573,26052402,9,0,0,1024,9,4893375108
3123,20627639,9377628,30005267,1,0,1,5632,22,3730845785
3124,20630000,5486770,26116770,5,0,0,31744,25,3432052189
3125,20631230,5929772,26561002,5,0,0,47616,25,6673466991
3126,20639869,9367664,30007533,1,0,1,3584,22,950059716
3127,20647580,5492573,26140153,7,0,0,20480,5,4878274657
3128,20648070,5476101,26124171,5,0,0,24064,25,7545471037
3129,20651699,9378054,30029753,3,0,1,2048,25,9584750343
3130,20653180,5515606,26168786,7,0,0,6656,5,6299606555
3131,20658409,9371957,30030366,1,0,1,512,22,6935390341
3132,20659330,5515525,26174855,5,0,0,3072,25,1917757768
3133,20669220,9361492,30030712,6,0,1,512,11,7461665522
3134,20690509,9341189,30031698,1,0,1,1536,22,9177116159
3135,20702750,9331534,30034284,6,0,1,4096,11,4835927128
3136,20707580,9328650,30036230,6,0,1,3072,11,7452100785
3137,20712049,5372009,26084058,9,0,0,512,9,7608621746
3138,20714709,9323467,30038176,5,0,1,3072,25,1770704609
3139,20722639,5453988,26176627,9,0,0,1024,9,10613456113
3140,20723210,5854039,26577249,5,0,0,53248,25,3797623928
3141,20724100,9315702,30039802,6,0,1,2560,11,8118205657
3142,20730089,9310379,30040468,5,0,1,1024,25,8058525415
3143,20738829,9305185,30044014,3,0,1,5632,25,9665659440
3144,20746679,5778961,26525640,9,0,0,1024,9,7510449968
3145,20751000,5601006,26352006,5,0,0,9216,25,717137727
3146,20768820,9276820,30045640,6,0,1,2560,11,8126895617
3147,20780609,9279208,30059817,5,0,1,4096,25,1961920627
3148,20786480,9273360,30059840,6,0,1,4096,11,4255732033
3149,20789880,5816595,26606475,7,0,0,80896,5,10572732026
3150,20792870,5331964,26124834,5,0,0,2048,25,9270666839
3151,20799129,5349043,26148172,9,0,0,512,9,1453164002
3152,20805529,9254334,30059863,3,0,1,1024,25,7444371163
3153,20806889,9252997,30059886,3,0,1,3072,25,8767701413
3154,20815720,5620867,26436587,1,0,0,3072,22,4920974584
3155,20822089,5303119,26125208,9,0,0,1024,9,8184587704
3156,20822669,9237240,30059909,1,0,1,4608,22,10317566603
3157,20824919,9235013,30059932,5,0,1,3584,25,4634086607
3158,20826839,9249879,30076718,5,0,1,21504,25,8701579552
3159,20827719,9251585,30079304,5,0,1,4096,25,5333602848
3160,20841360,9238405,30079765,6,0,1,10240,11,9073107667
3161,20845639,5514191,26359830,9,0,0,1024,9,10060267693
3162,20856459,9242713,30099172,3,0,1,5632,25,10079169056
3163,20856649,9244240,30100889,1,0,1,2560,22,1658667599
3164,20858859,5381581,26240440,9,0,0,512,9,6683892908
3165,20861679,9266403,30128082,3,0,1,9728,25,7428755697
3166,20878589,9249724,30128313,3,0,1,5632,25,2931167083
3167,20886640,5925578,26812218,5,0,0,20992,25,10173669149
3168,20891769,9257130,30148899,1,0,1,512,22,1021085868
3169,20902569,9260418,30162987,1,0,1,3584,22,886311623
3170,20909430,5896190,26805620,5,0,0,62464,25,1738979614
3171,20909510,9281754,30191264,4,0,1,8704,29,9085604699
3172,20926549,9268901,30195450,3,0,1,6656,25,5981898481
3173,20928739,5446061,26374800,9,0,0,512,9,3000011355
3174,20938359,9265993,30204352,5,0,1,1536,25,437264928
3175,20942439,9261936,30204375,5,0,1,1024,25,3690545022
3176,20948329,9256069,30204398,3,0,1,2048,25,7745561222
3177,20960089,9244332,30204421,1,0,1,9216,22,9712683115
3178,20977970,6117920,27095890,5,0,0,112640,25,8234602933
3179,20999449,9204995,30204444,5,0,1,1536,25,9060601099
3180,21007190,5464876,26472066,5,0,0,9216,25,784882870
3181,21014329,5436570,26450899,9,0,0,2048,9,6980160642
3182,21015409,9189058,30204467,1,0,1,6144,22,7344191120
3183,21019850,9194463,30214313,4,0,1,23552,29,4005237048
3184,21044019,9171280,30215299,1,0,1,1536,22,7146333895
3185,21057139,5552420,26609559,9,0,0,2048,9,9853579195
3186,21059850,5914315,26974165,5,0,0,96256,25,1215549916
3187,21065199,9152046,30217245,5,0,1,3072,25,969244395
3188,21076040,9147337,30223377,4,0,1,9728,29,951082835
3189,21087859,9137784,30225643,5,0,1,3584,25,3990911657
3190,21091389,9135560,30226949,1,0,1,2048,22,5948053755
3191,21093919,9134016,30227935,5,0,1,1536,25,3272197567
3192,21098859,9130382,30229241,1,0,1,2048,22,6441234775
3193,21126570,9111594,30238164,4,0,1,24064,29,8385316759
3194,21155770,9180324,30336094,4,0,1,57344,29,1557783610
3195,21156529,9205039,30361568,5,0,1,25600,25,3371669310
3196,21162769,9198822,30361591,5,0,1,1536,25,6946614510
3197,21167360,9213755,30381115,4,0,1,43008,29,704904763
3198,21170239,5436891,26607130,9,0,0,2048,9,1759697889
3199,21175969,9205492,30381461,3,0,1,512,25,3926247059
3200,21230910,9223800,30454710,4,0,1,75264,29,4747878361
3201,21236089,9267350,30503439,5,0,1,28672,25,540623953
3202,21239059,5527507,26766566,9,0,0,512,9,8891416416
3203,21241880,9262687,30504567,4,0,1,21504,29,10634012614
3204,21246490,9348229,30594719,4,0,1,40960,29,565857547
3205,21247119,9360984,30608103,5,0,1,1024,25,1575853331
3206,21257980,5686834,26944814,5,0,0,29184,25,8087022068
3207,21261169,5570705,26831874,9,0,0,1024,9,1328679408
3208,21262641,9350634,30613275,8,0,1,8192,17,10392086413
3209,21263710,9526550,30790260,4,0,1,153088,29,6938090326
3210,21270451,9519832,30790283,8,0,1,5120,17,7366376764
3211,21288049,9502257,30790306,1,0,1,512,22,6048107016
3212,21293199,9499967,30793166,1,0,1,7168,22,4041445217
3213,21342699,9456669,30799368,1,0,1,512,22,10145840458
3214,21346139,5188783,26534922,9,0,0,1536,9,2451939250
3215,21346999,9454635,30801634,1,0,1,3584,22,7228158903
3216,21347981,9456470,30804451,8,0,1,12288,17,3730252589
3217,21350270,5534477,26884747,5,0,0,10752,25,2589653584
3218,21350441,9455956,30806397,8,0,1,3072,17,5835800308
3219,21371481,9454135,30825616,8,0,1,2560,17,5349964610
3220,21376419,9455582,30832001,1,0,1,512,22,2035581238
3221,21388550,5309425,26697975,4,0,0,40960,29,9190121094
3222,21392591,9439756,30832347,8,0,1,512,17,6926526109
3223,21410099,9426754,30836853,5,0,1,7168,25,4851560378
3224,21412871,9424648,30837519,8,0,1,1024,17,6169715793
3225,21413179,9424686,30837865,3,0,1,512,25,6316179988
3226,21413489,5331851,26745340,9,0,0,512,9,7535396890
3227,21415140,5608851,27023991,5,0,0,83456,25,2622352694
3228,21423549,9415942,30839491,3,0,1,2560,25,7056480922
3229,21424411,9417666,30842077,8,0,1,4096,17,2544336766
3230,21430840,5814626,27245466,5,0,0,65024,25,7524857777
3231,21444579,9400084,30844663,2,0,1,4096,0,3837811590
3232,21453739,9397376,30851115,5,0,1,10240,25,6148743826
3233,21458529,5789119,27247648,9,0,0,1024,9,6922939740
3234,21462351,9389750,30852101,8,0,1,1536,17,1062883966
3235,21469889,9383518,30853407,5,0,1,2048,25,6679721406
3236,21473029,9382964,30855993,5,0,1,4096,25,6086218990
3237,21498600,5386950,26885550,4,0,0,2560,29,4003623954
3238,21504289,9352063,30856352,5,0,1,9728,25,5368359069
3239,21507689,9377456,30885145,3,0,1,5120,25,2525358467
3240,21516449,9370642,30887091,3,0,1,3072,25,8430044944
3241,21546350,5335074,26881424,4,0,0,149504,29,2617723919
3242,21555200,5484795,27039995,5,0,0,52224,25,4841354493
3243,21563139,9324311,30887450,1,0,1,9728,22,9578003685
3244,21567239,9377225,30944464,3,0,1,12288,25,9937952803
3245,21570060,9374427,30944487,9,0,1,3072,9,6350693737
3246,21571879,9372631,30944510,1,0,1,1024,22,810881506
3247,21579760,9402310,30982070,4,0,1,39936,29,2130499271
3248,21586019,9396074,30982093,1,0,1,512,22,1057784668
3249,21588790,9419593,31008383,4,0,1,25088,29,3387053712
3250,21591400,9418609,31010009,9,0,1,2560,9,5885143422
3251,21593980,5404560,26998540,5,0,0,79872,25,4567964224
3252,21601319,5172959,26774278,9,0,0,2048,9,309866816
3253,21601789,9413322,31015111,1,0,1,5120,22,8079708914
3254,21604519,9423374,31027893,5,0,1,2560,25,1437394477
3255,21605670,5619424,27225094,4,0,0,70656,29,1333154884
3256,21614359,5191440,26805799,9,0,0,512,9,6309382189
3257,21622410,9405842,31028252,4,0,1,9728,29,2441267295
3258,21623320,9499766,31123086,4,0,1,69632,29,8127837604
3259,21627130,9545418,31172548,9,0,1,30208,9,6419589613
3260,21636720,9553119,31189839,9,0,1,16384,9,10363872202
3261,21637069,9552793,31189862,2,0,1,2048,0,10138306886
3262,21638369,9566812,31205181,3,0,1,512,25,4734355602
3263,21638699,9566505,31205204,1,0,1,1536,22,7832381095
3264,21640049,9565178,31205227,2,0,1,1024,0,2972546729
3265,21646980,9602190,31249170,9,0,1,19456,9,1301191920
3266,21656920,5383901,27040821,5,0,0,2560,25,3625889906
3267,21669269,9601284,31270553,1,0,1,1536,22,2120792648
3268,21679069,9595678,31274747,1,0,1,512,22,2273057356
3269,21686809,9590204,31277013,2,0,1,3584,0,4718778628
3270,21695060,5442400,27137460,4,0,0,48128,29,5533859659
3271,21707790,9571169,31278959,9,0,1,3072,9,10688510757
3272,21711330,5451870,27163200,4,0,0,67072,29,4993402289
3273,21715439,9564506,31279945,1,0,1,1536,22,2545767715
3274,21722939,9557992,31280931,2,0,1,1536,0,9942649359
3275,21727760,9673542,31401302,4,0,1,76800,29,7946473141
3276,21732369,9690315,31422684,1,0,1,19456,22,3841415767
3277,21736319,9708634,31444953,3,0,1,6656,25,6118926010
3278,21755799,5469809,27225608,9,0,0,1536,9,3656706172
3279,21760180,9693582,31453762,9,0,1,512,9,6309578105
3280,21761299,5285401,27046700,9,0,0,1024,9,8035592750
3281,21764690,9691018,31455708,9,0,1,3072,9,7858814309
3282,21767599,5584263,27351862,9,0,0,512,9,5406680664
3283,21768279,5412164,27180443,9,0,0,2048,9,7465398054
3284,21769980,9829751,31599731,4,0,1,86528,29,9843403295
3285,21770720,9829034,31599754,9,0,1,1024,9,5862864081
3286,21778589,9821188,31599777,3,0,1,512,25,8044295750
3287,21783809,9815991,31599800,1,0,1,3072,22,2312545979
3288,21789279,9811035,31600314,1,0,1,6144,22,5809969842
3289,21794640,5803767,27598407,5,0,0,9216,25,9071284720
3290,21804329,9796008,31600337,1,0,1,11264,22,3026995964
3291,21817939,9801144,31619083,1,0,1,5120,22,1314417180
3292,21820219,9800042,31620261,1,0,1,13824,22,3671763467
3293,21820409,9843145,31663554,1,0,1,3584,22,2889055380
3294,21821429,9842148,31663577,3,0,1,2560,25,3012827256
3295,21827380,9918733,31746113,4,0,1,59392,29,874693782
3296,21850999,9922360,31773359,3,0,1,3072,25,7822122568
3297,21852579,5423594,27276173,9,0,0,1024,9,6564085950
3298,21871819,9912414,31784233,1,0,1,512,22,5653677018
3299,21898210,5377628,27275838,5,0,0,37376,25,3015541899
3300,21899420,5511082,27410502,5,0,0,26624,25,772966198
3301,21907790,5441254,27349044,4,0,0,49664,29,2249493646
3302,21909379,9878400,31787779,3,0,1,5632,25,10729608429
3303,21922159,9883126,31805285,3,0,1,26112,25,10637207742
3304,21931739,5315566,27247305,9,0,0,512,9,5122483030
3305,21931909,9878225,31810134,2,0,1,4608,0,3720101533
3306,21936340,5824230,27760570,5,0,0,258048,25,5000309287
3307,21956920,5290198,27247118,5,0,0,5120,25,9967444706
3308,21965110,9846330,31811440,9,0,1,2048,9,4992319119
3309,21968329,5414052,27382381,9,0,0,1536,9,5048702428
3310,21968469,9858113,31826582,3,0,1,6656,25,2917900539
3311,21974410,5611760,27586170,4,0,0,166400,29,241337749
3312,21980550,9848298,31828848,9,0,1,3584,9,1261859350
3313,22003470,9964448,31967918,4,0,1,38912,29,1653218043
3314,22006579,9992548,31999127,1,0,1,18432,22,7544208811
3315,22008470,10054266,32062736,4,0,1,22016,29,3505833771
3316,22010449,10052310,32062759,1,0,1,2560,22,1585857750
3317,22012990,5993668,28006658,4,0,0,88576,29,10257940807
3318,22027839,10092204,32120043,3,0,1,3584,25,6699578971
3319,22035790,10215616,32251406,4,0,1,25088,29,9531057625
3320,22050149,5842454,27892603,9,0,0,1536,9,735709404
3321,22090960,5511135,27602095,5,0,0,11776,25,6729083050
3322,22096729,10155347,32252076,1,0,1,9728,22,3987690936
3323,22112339,10188176,32300515,1,0,1,10240,22,8942465835
3324,22121659,10200476,32322135,3,0,1,15360,25,9631375043
3325,22150859,10175527,32326386,3,0,1,4608,25,7804643629
3326,22155329,10171403,32326732,3,0,1,512,25,6371905491
3327,22203149,10124889,32328038,1,0,1,2048,22,7417110339
3328,22204370,5278841,27483211,5,0,0,8704,25,542348259
3329,22214220,5641027,27855247,5,0,0,17920,25,5983985929
3330,22245689,10087175,32332864,1,0,1,7680,22,6619432986
3331,22257529,5522454,27779983,1,0,0,62976,22,10258813180
3332,22260099,10073751,32333850,1,0,1,1536,22,3867562853
3333,22276919,10084491,32361410,1,0,1,11264,22,887232845
3334,22289409,10074236,32363645,1,0,1,1024,22,8784366254
3335,22302379,10120152,32422531,1,0,1,16384,22,3756524177
3336,22302929,10127760,32430689,5,0,1,4096,25,4493012980
3337,22304160,5324891,27629051,5,0,0,87552,25,10466613196
3338,22304479,10126233,32430712,1,0,1,2048,22,5967274834
3339,22307499,10123236,32430735,5,0,1,1024,25,6236763853
3340,22318959,10118298,32437257,5,0,1,14848,25,6549858361
3341,22329260,10108983,32438243,7,0,1,1536,5,9210420159
3342,22332700,5261605,27594305,4,0,0,26624,29,4266400140
3343,22336419,5548454,27884873,9,0,0,512,9,2646831601
3344,22339179,5335574,27674753,9,0,0,512,9,4147602173
3345,22340259,10109266,32449525,1,0,1,1536,22,7868767576
3346,22347950,5306659,27654609,4,0,0,11776,29,3787646991
3347,22350919,10102152,32453071,5,0,1,5632,25,6940725997
3348,22360650,5466760,27827410,5,0,0,13312,25,7742052142
3349,22372240,5451006,27823246,4,0,0,78848,29,786882982
3350,22392149,10061588,32453737,2,0,1,1024,0,4211732559
3351,22396179,10059504,32455683,5,0,1,3072,25,9766073294
3352,22409589,10057632,32467221,2,0,1,2048,0,7050299319
3353,22428940,5370098,27799038,5,0,0,62464,25,9286114850
3354,22431979,5170311,27602290,9,0,0,512,9,2096771695
3355,22435429,10032458,32467887,1,0,1,1024,22,7687336275
3356,22447400,10040919,32488319,7,0,1,5632,5,5092255951
3357,22479609,10046528,32526137,2,0,1,512,0,3150886908
3358,22479780,10046380,32526160,9,0,1,6144,9,8325199977
3359,22488709,10037474,32526183,5,0,1,8704,25,7977853333
3360,22506209,10019997,32526206,1,0,1,3584,22,1106848231
3361,22510220,5339544,27849764,5,0,0,66560,25,8173672797
3362,22520139,10006090,32526229,1,0,1,1024,22,1428259848
3363,22531440,5064136,27595576,4,0,0,4096,29,4177201510
3364,22537669,9988583,32526252,5,0,1,4096,25,3085049731
3365,22544330,9981945,32526275,7,0,1,512,5,1195802149
3366,22553999,9972299,32526298,2,0,1,10752,0,2715548835
3367,22561959,9988604,32550563,1,0,1,512,22,1900331257
3368,22567689,9984500,32552189,2,0,1,2560,0,6668185481
3369,22572060,5289132,27861192,5,0,0,18432,25,7340467745
3370,22573649,9992768,32566417,5,0,1,5632,25,340566303
3371,22576270,10032889,32609159,7,0,1,4608,5,7549630134
3372,22585680,10053518,32639198,7,0,1,3584,5,1008615617
3373,22586499,10057525,32644024,2,0,1,7680,0,4949950360
3374,22590699,10054951,32645650,2,0,1,2560,0,1991910417
3375,22629420,5200041,27829461,5,0,0,6656,25,6614118530
3376,22631099,10084301,32715400,5,0,1,13312,25,1222017000
3377,22632629,10083335,32715964,5,0,1,10752,25,6708622139
3378,22633880,5313028,27946908,4,0,0,68096,29,5592253709
3379,22637619,10135784,32773403,2,0,1,5632,0,1055115924
3380,22637889,10135537,32773426,5,0,1,2560,25,3913490926
3381,22638039,10135410,32773449,2,0,1,512,0,3985599876
3382,22642019,5213494,27855513,9,0,0,512,9,9466721958
3383,22652829,10120643,32773472,5,0,1,2560,25,5443396853
3384,22654389,5106383,27760772,9,0,0,512,9,10412152062
3385,22656210,10117285,32773495,7,0,1,14336,5,6542651848
3386,22667449,10135494,32802943,2,0,1,14848,0,1612349788
3387,22673109,10154237,32827346,5,0,1,9728,25,10484596394
3388,22677820,5187942,27865762,4,0,0,14848,29,9450017533
3389,22679400,10148292,32827692,7,0,1,512,5,7396989960
3390,22686710,10143888,32830598,7,0,1,4608,5,4513070055
3391,22689909,5209157,27899066,9,0,0,1024,9,5584355458
3392,22691959,10168108,32860067,2,0,1,7680,0,1489917086
3393,22692280,5182368,27874648,4,0,0,22528,29,10042553938
3394,22695139,10187096,32882235,5,0,1,6656,25,6702717174
3395,22703669,10344893,33048562,5,0,1,1024,25,7118898397
3396,22712819,10335766,33048585,5,0,1,3072,25,5825140815
3397,22715119,5150822,27865941,9,0,0,512,9,6844680894
3398,22717070,5205265,27922335,5,0,0,5632,25,4683206021
3399,22729759,10318849,33048608,2,0,1,2560,0,2462691422
3400,22731070,10317561,33048631,7,0,1,8704,5,4704435628
3401,22731260,5242753,27974013,5,0,0,12800,25,3199739535
3402,22737980,10310674,33048654,7,0,1,9216,5,1009899411
3403,22759510,10289175,33048685,7,0,1,9216,5,6139437013
3404,22762199,10396321,33158520,2,0,1,14336,0,10385266414
3405,22767529,10443884,33211413,5,0,1,6144,25,2414459688
3406,22776349,10435087,33211436,2,0,1,3072,0,10360727628
3407,22784429,10427030,33211459,5,0,1,4096,25,3494539101
3408,22795149,10466515,33261664,2,0,1,3584,0,3594492268
3409,22816639,10449211,33265850,2,0,1,6656,0,9055092279
3410,22827019,10455822,33282841,1,0,1,2048,22,261006517
3411,22851199,10432308,33283507,5,0,1,1024,25,1472803724
3412,22851480,5373951,28225431,4,0,0,17920,29,8912305266
3413,22870789,10419319,33290108,5,0,1,7680,25,5508315972
3414,22890969,10452400,33343369,5,0,1,1024,25,9429720685
3415,22911559,10548267,33459826,3,0,1,15360,25,3715130293
3416,22913600,5165895,28079495,4,0,0,55808,29,9885370721
3417,22935820,5147598,28083418,4,0,0,12800,29,3321683212
3418,22939879,10519970,33459849,2,0,1,512,0,6763511322
3419,22966989,10493062,33460051,5,0,1,5120,25,6047095760
3420,22985379,5115445,28100824,9,0,0,1536,9,8460810557
3421,23026830,5359142,28385972,5,0,0,8704,25,9997020974
3422,23030789,4982706,28013495,9,0,0,512,9,3171120313
3423,23032780,5177469,28210249,4,0,0,77312,29,9945319908
3424,23048360,5163784,28212144,4,0,0,6144,29,1616022340
3425,23072930,5220173,28293103,4,0,0,66048,29,2128922065
3426,23077030,5153440,28230470,5,0,0,16384,25,9933303816
3427,23105069,10355005,33460074,2,0,1,5632,0,4406545316
3428,23149760,5094809,28244569,4,0,0,44032,29,2239948992
3429,23170329,10289768,33460097,5,0,1,512,25,5115225322
3430,23172670,5087661,28260331,4,0,0,38912,29,2712830764
3431,23196759,10263369,33460128,5,0,1,12288,25,8955059692
3432,23224709,4990724,28215433,9,0,0,1536,9,8293218305
3433,23244580,10215571,33460151,0,0,1,512,9,9053086476
3434,23260949,4882016,28142965,9,0,0,1024,9,8105731303
3435,23269679,10190495,33460174,2,0,1,3072,0,5155293539
3436,23270620,5054565,28325185,4,0,0,18944,29,6035479004
3437,23273520,5109769,28383289,5,0,0,48128,25,860145217
3438,23282440,4896403,28178843,4,0,0,2560,29,9926160086
3439,23314309,4849206,28163515,9,0,0,512,9,5730542497
3440,23316870,4803025,28119895,4,0,0,11264,29,5819482071
3441,23328789,10138139,33466928,5,0,1,4608,25,675513824
3442,23341379,10125572,33466951,5,0,1,7680,25,9413947558
3443,23350919,5048804,28399723,9,0,0,1536,9,5007490132
3444,23367459,10175675,33543134,5,0,1,21504,25,6974802828
3445,23379379,10174666,33554045,5,0,1,13312,25,2948182881
3446,23407899,4726654,28134553,9,0,0,512,9,6925142572
3447,23418999,10152756,33571755,2,0,1,3072,0,1069760759
3448,23422329,10149449,33571778,5,0,1,2048,25,3452532449
3449,23423310,4926779,28350089,5,0,0,34816,25,1646355269
3450,23428799,10144153,33572952,2,0,1,6656,0,5005516024
3451,23436029,10286475,33722504,2,0,1,3584,0,1973368893
3452,23438119,10284408,33722527,5,0,1,2560,25,8469205362
3453,23450089,5084069,28534158,9,0,0,512,9,4307615222
3454,23487080,5090196,28577276,4,0,0,71680,29,5933296655
3455,23498480,5217386,28715866,5,0,0,203776,25,10270353296
3456,23503330,4996993,28500323,5,0,0,43008,25,271394791
3457,23516699,10205851,33722550,5,0,1,1024,25,7602794375
3458,23521169,10201404,33722573,2,0,1,3584,0,4401240560
3459,23531460,4682579,28214039,4,0,0,6144,29,867723049
3460,23545369,10177227,33722596,5,0,1,4608,25,1386094477
3461,23557519,10312259,33869778,5,0,1,4096,25,856732546
3462,23579459,4932794,28512253,9,0,0,512,9,7295215107
3463,23592319,4985990,28578309,9,0,0,1024,9,9539184264
3464,23627220,4735813,28363033,5,0,0,2048,25,4254593843
3465,23629189,4615739,28244928,9,0,0,1024,9,8061153760
3466,23638689,10231112,33869801,5,0,1,2560,25,10734532658
3467,23641099,4723817,28364916,9,0,0,512,9,3958091345
3468,23644560,4798729,28443289,5,0,0,58368,25,10500020308
3469,23649910,4836454,28486364,5,0,0,6656,25,6182748265
3470,23675769,4788160,28463929,9,0,0,512,9,9463556310
3471,23702280,4951337,28653617,4,0,0,107520,29,1574501735
3472,23707660,10189487,33897147,9,0,1,4608,9,7970858394
3473,23712379,5005131,28717510,9,0,0,1536,9,8841926516
3474,23762690,5003688,28766378,5,0,0,50176,25,2680749884
3475,23779569,10122148,33901717,3,0,1,2048,25,1649056741
3476,23780720,10121020,33901740,9,0,1,512,9,7642550148
3477,23793240,4567792,28361032,5,0,0,35840,25,1246119326
3478,23801590,10100173,33901763,9,0,1,2560,9,10049565973
3479,23805580,10096206,33901786,9,0,1,1024,9,8175373107
3480,23812369,10089440,33901809,5,0,1,2048,25,10599382098
3481,23819369,10082463,33901832,5,0,1,5120,25,4577545108
3482,23826959,10074896,33901855,5,0,1,5120,25,8369214907
3483,23836479,10065399,33901878,2,0,1,1536,0,4661695676
3484,23846440,10055461,33901901,9,0,1,1536,9,2500126595
3485,23853610,10048322,33901932,9,0,1,17408,9,389799882
3486,23890850,10011105,33901955,9,0,1,3072,9,3371511424
3487,23921650,10025223,33946873,9,0,1,8704,9,878169906
3488,23929049,10019130,33948179,5,0,1,2048,25,10445564940
3489,23929540,10033595,33963135,9,0,1,15360,9,1766798821
3490,23968740,9995573,33964313,9,0,1,13824,9,8227769367
3491,24017489,4700691,28718180,9,0,0,2048,9,6098059552
3492,24048280,10029805,34078085,9,0,1,2560,9,1350844913
3493,24056179,10021929,34078108,5,0,1,1024,25,7491906922
3494,24086369,4630604,28716973,9,0,0,512,9,3476004218
3495,24100639,9977500,34078139,5,0,1,8192,25,7140094930
3496,24119729,9958433,34078162,5,0,1,2560,25,1278394032
3497,24142629,9937607,34080236,5,0,1,3584,25,9940822757
3498,24154249,9926010,34080259,3,0,1,4096,25,7518587159
3499,24161439,9918843,34080282,3,0,1,512,25,4289564713
3500,24173099,4342890,28515989,9,0,0,2560,9,8394178807
3501,24185059,9909178,34094237,5,0,1,16384,25,6664742999
3502,24188629,10260052,34448681,1,0,1,3072,22,570137091
3503,24203449,4374162,28577611,9,0,0,1024,9,4090174812
3504,24229719,4486428,28716147,9,0,0,512,9,5520018520
3505,24235009,4267998,28503007,9,0,0,512,9,10151201088
3506,24244959,10203745,34448704,1,0,1,1536,22,10097695663
3507,24247079,10509031,34756110,1,0,1,21504,22,7293900918
3508,24253929,10502204,34756133,5,0,1,6144,25,954029935
3509,24255579,10598520,34854099,5,0,1,1536,25,573944247
3510,24259949,10613763,34873712,1,0,1,512,22,8940124196
3511,24279499,10594559,34874058,3,0,1,512,25,4164314098
3512,24296079,10578645,34874724,3,0,1,1024,25,6673016600
3513,24305871,10570159,34876030,8,0,1,2048,17,3311236205
3514,24319699,4399128,28718827,9,0,0,2048,9,4597396065
3515,24325529,4391265,28716794,9,0,0,2048,9,6839978663
3516,24327589,10549107,34876696,1,0,1,1024,22,7746351191
3517,24337929,10539113,34877042,3,0,1,512,25,9663990691
3518,24357181,10521167,34878348,8,0,1,2048,17,9330678784
3519,24378890,10579366,34958256,4,0,1,45568,29,1666103876
3520,24383049,10723800,35106849,2,0,1,512,0,9555156564
3521,24384480,11105696,35490176,4,0,1,51712,29,7060638527
3522,24384759,11105440,35490199,2,0,1,7168,0,8884330626
3523,24403049,4438809,28841858,9,0,0,512,9,6570854074
3524,24403969,4181570,28585539,9,0,0,1024,9,14640313
3525,24414030,11160016,35574046,4,0,1,20480,29,2163875668
3526,24414269,11170108,35584377,1,0,1,8192,22,7769462562
3527,24418321,11180922,35599243,8,0,1,6656,17,5824850529
3528,24419821,11179445,35599266,8,0,1,1536,17,10283342853
3529,24437219,11162070,35599289,3,0,1,4608,25,8213938567
3530,24438689,4405290,28843979,9,0,0,512,9,1168845694
3531,24460879,4361722,28822601,9,0,0,2048,9,895407967
3532,24466539,11173221,35639760,3,0,1,10752,25,3570683439
3533,24521350,11118433,35639783,4,0,1,13312,29,1352663014
3534,24534620,11210708,35745328,4,0,1,49664,29,9554831407
3535,24544210,11245480,35789690,9,0,1,5632,9,10610787811
3536,24547309,11242583,35789892,3,0,1,5120,25,6788698212
3537,24555479,11383876,35939355,3,0,1,29696,25,9368495999
3538,24563551,11376201,35939752,8,0,1,1024,17,1205075067
3539,24584180,11751344,36335524,4,0,1,189440,29,8576078027
3540,24587509,11748361,36335870,3,0,1,512,25,2050721770
3541,24593599,4324018,28917617,9,0,0,1536,9,1068571991
3542,24609119,11730297,36339416,3,0,1,5632,25,8420321899
3543,24616770,11804757,36421527,4,0,1,8192,29,460315377
3544,24619689,4376070,28995759,9,0,0,512,9,10629545213
3545,24621039,11846365,36467404,3,0,1,17920,25,7942496904
3546,24628480,11838947,36467427,0,0,1,2048,9,30229995
3547,24630879,11852054,36482933,2,0,1,1536,0,6120108717
3548,24636459,11846497,36482956,3,0,1,512,25,780228632
3549,24645860,11837119,36482979,0,0,1,5632,9,3239444588
3550,24651930,11831072,36483002,0,0,1,1024,9,2930632615
3551,24670229,11812796,36483025,3,0,1,2560,25,636073485
3552,24683990,11799058,36483048,0,0,1,3072,9,701166884
3553,24687939,4382187,29070126,9,0,0,1024,9,1752187873
3554,24711220,11791397,36502617,0,0,1,5632,9,2196738679
3555,24711459,11791181,36502640,3,0,1,3072,25,4858100660
3556,24717809,4277771,28995580,1,0,0,33280,22,4107079944
3557,24721560,11781103,36502663,0,0,1,3072,9,5505956231
3558,24722150,11780536,36502686,3,0,1,4096,25,2281485778
3559,24722620,11782764,36505384,3,0,1,2560,25,9209878603
3560,24728960,11776455,36505415,3,0,1,5120,25,2664371763
3561,24746659,11767756,36514415,3,0,1,512,25,4030597940
3562,24760980,11753466,36514446,6,0,1,3584,11,4393148444
3563,24764431,11750038,36514469,8,0,1,1024,17,6212588470
3564,24777170,11737322,36514492,9,0,1,512,9,2230085761
3565,24786801,11772219,36559020,8,0,1,8192,17,3448607496
3566,24790019,11769104,36559123,2,0,1,512,0,8228595605
3567,24818101,11741045,36559146,8,0,1,3584,17,2220452656
3568,24831121,11728048,36559169,8,0,1,2560,17,2986873738
3569,24837899,11721293,36559192,3,0,1,5120,25,10521285621
3570,24840929,11718286,36559215,3,0,1,3584,25,2766272277
3571,24845940,11749454,36595394,4,0,1,14848,29,7491354320
3572,24847939,11764012,36611951,3,0,1,6144,25,760615661
3573,24850420,11771038,36621458,0,0,1,3584,9,542630968
3574,24855800,11766964,36622764,3,0,1,2048,25,6661321630
3575,24873871,11749879,36623750,8,0,1,1536,17,4872202123
3576,24875239,4183070,29058309,9,0,0,512,9,2315063842
3577,24875740,11841099,36716839,3,0,1,27136,25,3343763184
3578,24876320,11841185,36717505,0,0,1,1024,9,2972619068
3579,24880160,11937548,36817708,4,0,1,28160,29,3481561418
3580,24885140,11937714,36822854,4,0,1,8192,29,6709477983
3581,24885861,11967696,36853557,8,0,1,8704,17,2297761203
3582,24894130,12004059,36898189,3,0,1,19456,25,6325378444
3583,24894510,12005716,36900226,3,0,1,512,25,4616519422
3584,24895290,12006012,36901302,0,0,1,13312,9,3669373310
3585,24896821,12029768,36926589,8,0,1,1536,17,1680816790
3586,24906770,12020280,36927050,0,0,1,10240,9,10654374944
3587,24908330,12061561,36969891,3,0,1,1536,25,4418261785
3588,24930001,12040236,36970237,8,0,1,512,17,9080351628
3589,24942760,12029743,36972503,3,0,1,3584,25,2849928529
3590,24958500,12017229,36975729,0,0,1,5120,9,228248517
3591,24963551,12016070,36979621,8,0,1,6144,17,9834571732
3592,24966410,12016437,36982847,3,0,1,5120,25,848269683
3593,24973490,12037395,37010885,0,0,1,4608,9,9690723379
3594,24982380,12080350,37062730,0,0,1,512,9,3218657407
3595,24984329,4241687,29226016,9,0,0,512,9,6040624445
3596,24990759,4212620,29203379,9,0,0,512,9,7354932539
3597,24998770,12063991,37062761,0,0,1,4608,9,10602150448
3598,24998941,12063843,37062784,8,0,1,4096,17,7090053147
3599,25004160,12058647,37062807,0,0,1,4096,9,5779216330
3600,25037771,12043813,37081584,8,0,1,4096,17,10710939387
3601,25056440,12034276,37090716,0,0,1,1024,9,3304403793
3602,25075030,12016762,37091792,0,0,1,13312,9,1946300006
3603,25095900,12052552,37148452,3,0,1,3072,25,3615738116
3604,25119730,12031068,37150798,3,0,1,12288,25,1062874038
3605,25132181,12020243,37152424,8,0,1,2560,17,1268774341
3606,25148199,4036311,29184510,9,0,0,512,9,3263023638
3607,25184091,12040609,37224700,8,0,1,9728,17,9922835974
3608,25189270,12044547,37233817,6,0,1,3584,11,6375941512
3609,25190290,12091106,37281396,3,0,1,7680,25,10425571666
3610,25205910,12081939,37287849,6,0,1,6144,11,2058176735
3611,25229361,12061394,37290755,8,0,1,4608,17,4132201744
3612,25238461,12087452,37325913,8,0,1,2560,17,7394639713
3613,25258209,3886890,29145099,9,0,0,512,9,8054835270
3614,25267470,12061029,37328499,0,0,1,4096,9,4745166547
3615,25283590,12045575,37329165,0,0,1,1024,9,1017646274
3616,25284320,12049351,37333671,6,0,1,7168,11,7295626981
3617,25284710,12115110,37399820,6,0,1,7168,11,7846908214
3618,25285960,12113883,37399843,0,0,1,1536,9,5960740835
3619,25294360,12126121,37420481,0,0,1,7168,9,8888006119
3620,25323689,12096815,37420504,1,0,1,1024,22,453877397
3621,25331150,12089377,37420527,0,0,1,5120,9,4643182888
3622,25332360,12088190,37420550,0,0,1,1024,9,4983677293
3623,25338290,12082283,37420573,6,0,1,20480,11,3987610621
3624,25341689,3862793,29204482,9,0,0,1536,9,8053456719
3625,25352710,12067886,37420596,7,0,1,2560,5,10184607336
3626,25378130,12042489,37420619,7,0,1,5120,5,1663947561
3627,25387030,12193087,37580117,7,0,1,111104,5,1531014006
3628,25391800,12188340,37580140,6,0,1,2048,11,7043615322
3629,25418090,12214434,37632524,7,0,1,46592,5,8858972803
3630,25427420,12206384,37633804,6,0,1,14336,11,3359262463
3631,25434450,12203265,37637715,6,0,1,3584,11,9546602665
3632,25460010,12225442,37685452,7,0,1,28160,5,1589617196
3633,25476790,12212208,37688998,6,0,1,5632,11,4596900080
3634,25487680,12205850,37693530,6,0,1,7168,11,7631823794
3635,25496240,12199876,37696116,6,0,1,4096,11,8732668388
3636,25513290,12183799,37697089,0,0,1,12800,9,5977032546
3637,25515130,12214043,37729173,9,0,1,2560,9,1881704062
3638,25522020,12207176,37729196,9,0,1,2048,9,6238132301
3639,25529390,12199829,37729219,7,0,1,6144,5,3702883846
3640,25571810,12235149,37806959,7,0,1,86528,5,8709409508
3641,25575050,12280974,37856024,7,0,1,27136,5,6520897964
3642,25586040,12270007,37856047,9,0,1,3072,9,7044681453
3643,25592060,12292292,37884352,9,0,1,3584,9,7213532337
3644,25599520,12284855,37884375,6,0,1,7680,11,7191098362
3645,25600000,12284398,37884398,6,0,1,512,11,1636129928
3646,25615709,12268712,37884421,5,0,1,7168,25,8763449120
3647,25624480,12259964,37884444,9,0,1,15872,9,2192906544
3648,25630629,3840076,29470705,9,0,0,512,9,10510496903
3649,25635160,12249307,37884467,9,0,1,9728,9,8994795636
3650,25685880,12198610,37884490,9,0,1,1536,9,1618991041
3651,25695800,12188713,37884513,9,0,1,4096,9,2008474890
3652,25702309,3612203,29314512,9,0,0,1536,9,4835258286
3653,25711889,3720758,29432647,9,0,0,2048,9,3140156754
3654,25726589,3632636,29359225,9,0,0,512,9,1487246553
3655,25782759,3615445,29398204,9,0,0,512,9,4446255984
3656,25826230,12058641,37884871,3,0,1,22528,25,10464087078
3657,25862329,3633286,29495615,9,0,0,1024,9,756257965
3658,25862460,12022434,37884894,7,0,1,512,5,9064444343
3659,25872870,12012047,37884917,9,0,1,4608,9,3710520051
3660,25889510,11995438,37884948,9,0,1,5632,9,3191369197
3661,25898549,11994662,37893211,5,0,1,1024,25,9733962229
3662,25900289,11993908,37894197,2,0,1,1536,0,1058835373
3663,25942410,11953093,37895503,3,0,1,2048,25,6184066282
3664,25957380,11938469,37895849,9,0,1,512,9,2450233933
3665,26005470,11894565,37900035,9,0,1,6656,9,8178623804
3666,26016009,3505181,29521190,9,0,0,1024,9,1263129729
3667,26036790,11865511,37902301,3,0,1,3584,25,6804328267
3668,26039219,3459241,29498460,9,0,0,512,9,9625159116
3669,26041880,11901422,37943302,9,0,1,8192,9,4511002768
3670,26065210,11889232,37954442,9,0,1,5632,9,7591274728
3671,26097759,11924557,38022316,2,0,1,11264,0,7059737318
3672,26109910,11950300,38060210,3,0,1,5120,25,4166180232
3673,26110479,3441923,29552402,9,0,0,1024,9,9283045144
3674,26126210,11948795,38075005,7,0,1,5632,5,6331816064
3675,26128330,11954588,38082918,3,0,1,512,25,4326958347
3676,26153460,11934097,38087557,9,0,1,6656,9,4895584681
3677,26153930,11935893,38089823,3,0,1,3584,25,2241751117
3678,26186179,3520814,29706993,9,0,0,2560,9,1706516432
3679,26193150,11900219,38093369,3,0,1,5632,25,4871873486
3680,26208619,3420245,29628864,9,0,0,512,9,2868955933
3681,26214150,11893589,38107739,3,0,1,1536,25,3099639917
3682,26223470,11931991,38155461,9,0,1,2560,9,4280985376
3683,26234050,11923997,38158047,9,0,1,4096,9,6620187502
3684,26243151,11962155,38205306,8,0,1,3072,17,8082317221
3685,26249420,11974691,38224111,3,0,1,13312,25,8186161704
3686,26253570,11970564,38224134,4,0,1,3584,29,4501916991
3687,26256530,11989151,38245681,4,0,1,512,29,8195920948
3688,26258560,11987479,38246039,4,0,1,7680,29,10446211369
3689,26268250,11977812,38246062,9,0,1,3072,9,8192111763
3690,26272410,11974166,38246576,4,0,1,10752,29,7161870178
3691,26273360,11982515,38255875,3,0,1,7680,25,4227654798
3692,26278070,11983163,38261233,9,0,1,12288,9,530203569
3693,26284390,11976866,38261256,3,0,1,1024,25,9486016803
3694,26284760,11976519,38261279,6,0,1,2048,11,7825579987
3695,26305870,11955432,38261302,6,0,1,512,11,2405867003
3696,26308410,12138966,38447376,6,0,1,114176,11,5937603608
3697,26311700,12205511,38517211,9,0,1,13312,9,6795254475
3698,26311810,12237673,38549483,3,0,1,3584,25,9403870716
3699,26320179,3293182,29613361,9,0,0,1024,9,3229779821
3700,26323149,3287140,29610289,9,0,0,1024,9,7646335851
3701,26328540,12226090,38554630,4,0,1,2048,29,3158564054
3702,26330659,3285052,29615711,9,0,0,1536,9,7949367303
3703,26340110,12215826,38555936,3,0,1,2048,25,4683340002
3704,26340460,12217742,38558202,3,0,1,3584,25,7358695135
3705,26351140,12207728,38558868,9,0,1,1024,9,8293657581
3706,26358380,12259780,38618160,9,0,1,8192,9,10535297899
3707,26385630,12232553,38618183,9,0,1,3072,9,7163298317
3708,26385969,3342886,29728855,9,0,0,512,9,4169306359
3709,26410640,12207566,38618206,9,0,1,11264,9,5739579263
3710,26414639,3298911,29713550,9,0,0,512,9,6975924873
3711,26476830,12147007,38623837,9,0,1,7680,9,9100403131
3712,26479119,3460203,29939322,9,0,0,53760,9,2309159930
3713,26499530,12152764,38652294,9,0,1,1024,9,4008080167
3714,26543430,12108887,38652317,9,0,1,1536,9,8947455617
3715,26604849,12047499,38652348,5,0,1,2560,25,428017633
3716,26611609,12040762,38652371,5,0,1,1536,25,4048398264
3717,26661201,11991193,38652394,8,0,1,512,17,8819513691
3718,26695989,3226930,29922919,9,0,0,36864,9,3896590265
3719,26720349,3230696,29951045,9,0,0,38400,9,2023043855
3720,26730350,11980212,38710562,6,0,1,26624,11,5249932208
3721,26746950,11975643,38722593,9,0,1,15360,9,1670847453
3722,26747249,11980436,38727685,5,0,1,15872,25,10715984193
3723,26760480,12048602,38809082,6,0,1,60416,11,8117605898
3724,26765760,12051636,38817396,4,0,1,6144,29,3238848723
3725,26773549,12043870,38817419,5,0,1,3584,25,10245130369
3726,26789820,12072313,38862133,9,0,1,5632,9,2808348420
3727,26818969,12043187,38862156,5,0,1,1536,25,5247436720
3728,26849849,12012330,38862179,5,0,1,9216,25,3794904080
3729,26879820,12025451,38905271,6,0,1,78336,11,6185917723
3730,26917079,12039671,38956750,5,0,1,7168,25,6752736891
3731,26932330,12026686,38959016,9,0,1,3584,9,2154491787
3732,26949359,12014483,38963842,5,0,1,7680,25,9459182695
3733,26966260,12002869,38969129,6,0,1,16896,11,5508455795
3734,26966790,12029445,38996235,6,0,1,15360,11,7576794986
3735,26977519,12019702,38997221,5,0,1,1536,25,5596911828
3736,26997669,12003098,39000767,5,0,1,5632,25,8069515818
3737,27039610,11962783,39002393,6,0,1,2560,11,4370170437
3738,27044630,11967850,39012480,6,0,1,26624,11,3506380792
3739,27054669,11984959,39039628,5,0,1,3072,25,3095381221
3740,27062020,12049797,39111817,6,0,1,72192,11,10015928398
3741,27070290,12106909,39177199,6,0,1,57856,11,1325859794
3742,27105220,12073285,39178505,6,0,1,2048,11,4320194929
3743,27116051,12072302,39188353,8,0,1,19456,17,1507344269
3744,27144630,12257403,39402033,6,0,1,104960,11,8139932284
3745,27166080,12290664,39456744,6,0,1,27648,11,3125091492
3746,27193700,12407070,39600770,6,0,1,135168,11,5613884633
3747,27213960,12443378,39657338,6,0,1,29696,11,8522493707
3748,27230350,12517243,39747593,6,0,1,35840,11,3435856818
3749,27340059,12439690,39779749,2,0,1,4096,0,703165415
3750,27341260,12498507,39839767,6,0,1,24576,11,2690114690
3751,27342760,12523622,39866382,6,0,1,32256,11,322084988
3752,27361580,12538209,39899789,4,0,1,5120,29,1363161631
3753,27394910,12637899,40032809,6,0,1,35328,11,8682334050
3754,27429629,2698430,30128059,6,0,0,67584,11,7032206067
3755,27452290,12580550,40032840,6,0,1,5632,11,7495792310
3756,27456870,12575993,40032863,6,0,1,11776,11,4537090974
3757,27473541,12559345,40032886,8,0,1,7168,17,5263825990
3758,27501440,12531469,40032909,6,0,1,14848,11,1872346202
3759,27579280,12507694,40086974,6,0,1,54784,11,5027963752
3760,27586260,12500737,40086997,6,0,1,12800,11,6044030997
3761,27595981,12522886,40118867,8,0,1,2048,17,7841340328
3762,27635820,12483070,40118890,6,0,1,1536,11,4855226284
3763,27669570,12449359,40118929,6,0,1,13824,11,3155434954
3764,27679230,12439722,40118952,6,0,1,14336,11,10399640050
3765,27750540,12414502,40165042,6,0,1,26112,11,5110503465
3766,27802961,12413900,40216861,8,0,1,1536,17,2835839063
3767,27871850,12345034,40216884,6,0,1,12800,11,6864122987
3768,28029870,12187037,40216907,0,0,1,2048,9,3767148713
3769,28035020,12181910,40216930,6,0,1,5120,11,7254643854
3770,28044580,12262542,40307122,6,0,1,143872,11,9961837628
3771,28045930,12288814,40334744,0,0,1,2048,9,8443688880
3772,28059140,12275950,40335090,0,0,1,512,9,2294472068
3773,28068870,12270086,40338956,0,0,1,6144,9,6090339682
3774,28086940,12258634,40345574,0,0,1,23552,9,9066767105
3775,28121519,12228241,40349760,1,0,1,6656,22,101777335
3776,28128460,12221966,40350426,0,0,1,1024,9,5304130611
3777,28199240,12154208,40353448,0,0,1,16384,9,6936947395
3778,28208649,1851145,30059794,1,0,0,39424,22,3874280582
3779,28208830,12162036,40370866,6,0,1,15872,11,3085098920
3780,28212970,12169424,40382394,0,0,1,11264,9,9489906074
3781,28216080,12177522,40393602,6,0,1,15360,11,8257782613
3782,28227420,12181243,40408663,0,0,1,6144,9,4843838215
3783,28233460,12375194,40608654,6,0,1,106496,11,5518723250
3784,28245109,1959220,30204329,2,0,0,27648,0,10614782846
3785,28258109,2173487,30431596,2,0,0,16896,0,7205259166
3786,28269760,12345505,40615265,0,0,1,3072,9,2919036348
3787,28294950,12320981,40615931,0,0,1,1024,9,9857902679
3788,28309660,12396208,40705868,6,0,1,50688,11,7707477947
3789,28314670,12393464,40708134,0,0,1,3584,9,4362323423
3790,28334319,1750729,30085048,1,0,0,9216,22,4248028817
3791,28365520,12356496,40722016,6,0,1,14336,11,4551806372
3792,28366500,12359062,40725562,0,0,1,5632,9,982110118
3793,28366860,12359368,40726228,6,0,1,11264,11,7596797221
3794,28404900,12321674,40726574,0,0,1,512,9,8253794245
3795,28404930,12336590,40741520,0,0,1,8704,9,1951420889
3796,28410570,12363238,40773808,6,0,1,43008,11,3750577879
3797,28412759,1948786,30361545,1,0,0,83456,22,2160714389
3798,28456219,1879852,30336071,1,0,0,32768,22,8818611405
3799,28476909,1669324,30146233,1,0,0,5120,22,6133830372
3800,28505840,12463553,40969393,6,0,1,145920,11,2869945778
3801,28521790,12448909,40970699,0,0,1,2048,9,7210399843
3802,28547890,12430038,40977928,0,0,1,1536,9,324370414
3803,28604080,12379033,40983113,6,0,1,24576,11,9064940682
3804,28618790,12377005,40995795,0,0,1,1536,9,6858845085
3805,28640640,12376116,41016756,6,0,1,2560,11,270985782
3806,28651030,12415451,41066481,6,0,1,95744,11,2074588012
3807,28659830,12410837,41070667,0,0,1,6656,9,1986512782
3808,28691730,12380985,41072715,6,0,1,26112,11,1162907876
3809,28708600,12447177,41155777,6,0,1,91648,11,1551172063
3810,28729070,12512159,41241229,6,0,1,95232,11,7233850249
3811,28736490,12507325,41243815,0,0,1,4096,9,1985747128
3812,28746360,12605793,41352153,6,0,1,101888,11,7460030528
3813,28752940,12601799,41354739,0,0,1,4096,9,9093252501
3814,28767140,12613789,41380929,6,0,1,49664,11,4116691642
3815,28768489,1703499,30471988,1,0,0,1024,22,1669680053
3816,28779850,12606476,41386326,0,0,1,3584,9,487554957
3817,28825779,12586114,41411893,5,0,1,6656,25,7083148027
3818,28838419,12573497,41411916,2,0,1,512,0,5020238693
3819,28846449,12565490,41411939,2,0,1,8704,0,7810118605
3820,28852620,12559342,41411962,6,0,1,3584,11,6592470927
3821,28853090,12558895,41411985,0,0,1,6656,9,2753888197
3822,28861159,12551184,41412343,2,0,1,11264,0,239665440
3823,28862979,12561224,41424203,2,0,1,4096,0,5285656256
3824,28867070,12590171,41457241,6,0,1,37888,11,10285302775
3825,28870680,12660095,41530775,6,0,1,36864,11,378380543
3826,28871390,12665210,41536600,9,0,1,6144,9,4690531499
3827,28873659,12669261,41542920,5,0,1,2048,25,6773843790
3828,28886850,12658656,41545506,6,0,1,4096,11,720133576
3829,28888510,12660542,41549052,9,0,1,5632,9,9050709234
3830,28895620,12653778,41549398,0,0,1,512,9,3936790326
3831,28899731,12650973,41550704,8,0,1,2048,17,1439945546
3832,28904430,12660140,41564570,4,0,1,8704,29,4434681239
3833,28918600,12645993,41564593,9,0,1,9728,9,9540322470
3834,28923669,1866568,30790237,1,0,0,35328,22,5788829984
3835,28932140,12632476,41564616,0,0,1,1024,9,1855337147
3836,28936450,12628189,41564639,0,0,1,512,9,10461714218
3837,28952499,1615756,30568255,1,0,0,20480,22,5573303330
3838,28956130,12608532,41564662,9,0,1,512,9,6510395489
3839,28961710,12603495,41565205,9,0,1,1024,9,9713040539
3840,28961829,12605322,41567151,5,0,1,3072,25,1406336212
3841,28962040,12652598,41614638,6,0,1,24064,11,9774844380
3842,28972380,12667635,41640015,9,0,1,1024,9,3457691724
3843,28984400,12696410,41680810,6,0,1,31744,11,5024369622
3844,28990340,12701434,41691774,9,0,1,7680,9,10432576513
3845,28995910,12698130,41694040,0,0,1,3584,9,6967787286
3846,29001600,12695026,41696626,9,0,1,4096,9,9878819808
3847,29002530,12785146,41787676,6,0,1,108032,11,6425399183
3848,29017850,12772746,41790596,6,0,1,24064,11,4692492743
3849,29031190,12802325,41833515,6,0,1,32256,11,8945057653
3850,29034580,12836655,41871235,6,0,1,16384,11,8478627317
3851,29098379,12776536,41874915,5,0,1,5120,25,2776514143
3852,29098600,12792813,41891413,3,0,1,12800,25,3262396598
3853,29104809,1594733,30699542,1,0,0,156672,22,1231462901
3854,29116899,1534607,30651506,1,0,0,34304,22,5289831433
3855,29122580,12800363,41922943,0,0,1,4096,9,5548817306
3856,29124389,12798577,41922966,5,0,1,3072,25,4594263044
3857,29125040,12797949,41922989,9,0,1,17920,9,4246607279
3858,29127871,12804663,41932534,8,0,1,7680,17,3129265387
3859,29133060,1479479,30612539,3,0,0,1024,25,5658170644
3860,29145370,1448790,30594160,3,0,0,512,25,10375709050
3861,29151360,12799804,41951164,0,0,1,18432,9,5523330921
3862,29153270,12809199,41962469,9,0,1,5632,9,2856213386
3863,29179039,12786362,41965401,5,0,1,14848,25,5618201896
3864,29207719,12758028,41965747,5,0,1,512,25,9993999925
3865,29214329,1538720,30753049,1,0,0,64512,22,6041208815
3866,29216349,1728092,30944441,1,0,0,93696,22,3019401190
3867,29237650,1586758,30824408,3,0,0,1536,25,65984477
3868,29238299,1712162,30950461,1,0,0,19456,22,5694724964
3869,29275170,1438530,30713700,3,0,0,1536,25,5105995755
3870,29281009,12687324,41968333,5,0,1,4096,25,10204017535
3871,29282980,1560104,30843084,3,0,0,512,25,3640365189
3872,29300209,12678131,41978340,5,0,1,11776,25,3783948434
3873,29327670,1568223,30895893,3,0,0,512,25,9379274808
3874,29355560,12634227,41989787,6,0,1,1536,11,8686001968
3875,29376399,12617254,41993653,2,0,1,6144,0,4925625213
3876,29378609,1603438,30982047,1,0,0,55296,22,9315624191
3877,29385169,1599706,30984875,1,0,0,1536,22,8758256898
3878,29392489,12604070,41996559,2,0,1,4608,0,5948191079
3879,29399419,12602595,42002014,2,0,1,10752,0,4974284934
3880,29407200,1586301,30993501,3,0,0,1024,25,108470334
3881,29411700,1653472,31065172,3,0,0,1536,25,3860005951
3882,29418660,12607482,42026142,0,0,1,3584,9,2059562737
3883,29419940,1726814,31146754,4,0,0,27136,29,3357673912
3884,29429800,12697766,42127566,6,0,1,69120,11,2984146950
3885,29430640,1666218,31096858,4,0,0,3584,29,2654683204
3886,29432410,12695179,42127589,6,0,1,10752,11,3364059987
3887,29433009,1756807,31189816,1,0,0,35328,22,247925013
3888,29443650,12683962,42127612,0,0,1,5120,9,1303838764
3889,29446160,1568773,31014933,4,0,0,3072,29,6687819408
3890,29449339,12678296,42127635,5,0,1,10240,25,3780131015
3891,29452439,12676403,42128842,2,0,1,24064,0,2773034306
3892,29460270,12674901,42135171,0,0,1,9216,9,8534110225
3893,29473980,1646934,31120914,4,0,0,2560,29,3861275683
3894,29506100,1699034,31205134,4,0,0,28160,29,1392027072
3895,29511139,1661378,31172517,1,0,0,84480,22,3882366058
3896,29513449,12622068,42135517,5,0,1,512,25,4028694486
3897,29513879,12626464,42140343,2,0,1,7680,0,1946431238
3898,29522920,12656455,42179375,3,0,1,1536,25,9397224316
3899,29529029,12653252,42182281,5,0,1,4608,25,267701295
3900,29534219,12663757,42197976,5,0,1,18944,25,5463107442
3901,29535659,12666379,42202038,5,0,1,10240,25,4064373851
3902,29540300,12666244,42206544,3,0,1,7168,25,7821170754
3903,29542479,12687395,42229874,5,0,1,11264,25,7545456205
3904,29565190,12665990,42231180,3,0,1,2048,25,3956915210
3905,29569379,1853282,31422661,1,0,0,68096,22,3100120839
3906,29573180,1739150,31312330,4,0,0,48128,29,4399270962
3907,29573460,12658706,42232166,3,0,1,1536,25,5155537277
3908,29577519,12657873,42235392,5,0,1,5120,25,3224533518
3909,29581240,12689930,42271170,3,0,1,21504,25,4095131384
3910,29581550,2024582,31606132,4,0,0,18944,29,8271071821
3911,29599569,12674853,42274422,5,0,1,5120,25,9582017110
3912,29600320,1632444,31232764,4,0,0,14336,29,954920786
3913,29601040,12673536,42274576,3,0,1,8704,25,4680579130
3914,29609989,12707267,42317256,5,0,1,10752,25,4523721783
3915,29647680,1698231,31345911,4,0,0,55808,29,7519504441
3916,29688760,1712519,31401279,4,0,0,58880,29,1859249244
3917,29696209,12628933,42325142,2,0,1,4096,0,10295394605
3918,29713859,12614027,42327886,2,0,1,4608,0,10348578645
3919,29716309,12612345,42328654,1,0,1,11776,22,6125332790
3920,29730949,12609432,42340381,1,0,1,8192,22,9903817459
3921,29734870,12616207,42351077,1,0,1,5120,22,108377169
3922,29739719,12613624,42353343,5,0,1,3584,25,7640768560
3923,29744830,1882804,31627634,3,0,0,1536,25,5337363400
3924,29752709,1766016,31518725,1,0,0,99840,22,3493322986
3925,29777569,12576440,42354009,2,0,1,1024,0,9585545110
3926,29788260,1812031,31600291,3,0,0,1536,25,518538978
3927,29796260,12622275,42418535,6,0,1,82944,11,8648891077
3928,29831619,12589182,42420801,2,0,1,3584,0,8259398131
3929,29847939,12580145,42428084,5,0,1,9728,25,4927067899
3930,29853759,12582929,42436688,5,0,1,4608,25,7545256929
3931,29855920,1398712,31254632,3,0,0,1024,25,8804512764
3932,29860170,1811652,31671822,5,0,0,19456,25,9286633157
3933,29866360,1862993,31729353,4,0,0,55808,29,1036382607
3934,29869590,12567444,42437034,9,0,1,512,9,418685281
3935,29888719,12554487,42443206,5,0,1,6144,25,4779958676
3936,29898700,1620204,31518904,3,0,0,512,25,9021373823
3937,29901280,1809578,31710858,4,0,0,14848,29,2405568500
3938,29901749,12541803,42443552,2,0,1,512,0,3715270030
3939,29902780,1695657,31598437,5,0,0,115200,25,1556942846
3940,29919409,12525628,42445037,2,0,1,15360,0,4385302528
3941,29925459,1752002,31677461,1,0,0,18432,22,487757989
3942,29925979,1673729,31599708,1,0,0,4096,22,240338646
3943,29931960,1994379,31926339,5,0,0,21504,25,3010002636
3944,29932040,12550803,42482843,0,0,1,6144,9,3742230517
3945,29934929,12553099,42488028,5,0,1,16384,25,4507904496
3946,29938179,12552435,42490614,5,0,1,4096,25,1541248675
3947,29958819,12533101,42491920,5,0,1,2048,25,9612529783
3948,29967399,1914255,31881654,1,0,0,105984,22,8517249775
3949,29971190,1948574,31919764,5,0,0,62976,25,2881031467
3950,29977980,1685551,31663531,5,0,0,34304,25,3645540843
3951,29988799,12504427,42493226,2,0,1,2048,0,3741496080
3952,29995619,1638419,31634038,2,0,0,7680,0,5950622863
3953,30010520,2295585,32306105,5,0,0,6656,25,4497837825
3954,30033239,12462573,42495812,5,0,1,4096,25,4049990996
3955,30035639,1864914,31900553,1,0,0,61952,22,7125277597
3956,30035670,12460808,42496478,9,0,1,1024,9,9003225388
3957,30041129,2153354,32194483,2,0,0,40448,0,3745116016
3958,30069540,12444515,42514055,6,0,1,27648,11,49513525
3959,30082749,12437663,42520412,5,0,1,1024,25,10053778882
3960,30088610,1903300,31991910,5,0,0,25088,25,4040963835
3961,30089349,1973364,32062713,2,0,0,5632,0,4132492264
3962,30107789,12413609,42521398,5,0,1,1536,25,517246396
3963,30113050,2138325,32251375,5,0,0,7680,25,8279055108
3964,30114380,12408004,42522384,3,0,1,1536,25,8016963884
3965,30131450,1574861,31706311,3,0,0,512,25,2858700601
3966,30135399,2129716,32265115,1,0,0,39424,22,818429170
3967,30154990,12376522,42531512,3,0,1,5632,25,3938275609
3968,30155999,1904975,32060974,2,0,0,159744,0,4201580832
3969,30157740,12440515,42598255,3,0,1,10752,25,4569825846
3970,30159250,12439028,42598278,3,0,1,1024,25,6789915377
3971,30168760,2080244,32249004,4,0,0,97280,29,1925042594
3972,30169890,1841164,32011054,5,0,0,29184,25,7531990940
3973,30176830,1984668,32161498,4,0,0,119296,29,9173651274
3974,30191520,1916938,32108458,4,0,0,33280,29,719407618
3975,30194049,12412231,42606280,5,0,1,4096,25,1614239306
3976,30194689,2019161,32213850,2,0,0,63488,0,765437904
3977,30207130,1975006,32182136,5,0,0,29184,25,4570654018
3978,30207959,12398344,42606303,5,0,1,1536,25,8768080129
3979,30235899,12370427,42606326,5,0,1,7680,25,8477598255
3980,30256040,1917181,32173221,5,0,0,38400,25,2082321039
3981,30263330,12343019,42606349,3,0,1,3072,25,176638157
3982,30282689,2139819,32422508,1,0,0,156672,22,8984134713
3983,30292090,1799526,32091616,5,0,0,5120,25,1182381258
3984,30304300,1804961,32109261,3,0,0,2560,25,8736519036
3985,30322569,12283803,42606372,5,0,1,2560,25,2640607479
3986,30333929,2192185,32526114,2,0,0,42496,0,1726510130
3987,30366859,1904675,32271534,1,0,0,20992,22,2026057329
3988,30379510,1683584,32063094,3,0,0,1024,25,8779022996
3989,30385379,1866674,32252053,1,0,0,2048,22,6904372971
3990,30390210,2040456,32430666,5,0,0,26624,25,10117825845
3991,30397649,12223121,42620770,1,0,1,15872,22,6679795781
3992,30401750,1817591,32219341,4,0,0,17920,29,10606027382
3993,30406929,1868380,32275309,2,0,0,12288,0,5629890270
3994,30413780,2247803,32661583,5,0,0,24576,25,4427206213
3995,30420139,12200654,42620793,1,0,1,1024,22,4354210383
3996,30435850,1868204,32304054,3,0,0,2048,25,6143118551
3997,30437860,1846258,32284118,3,0,0,1024,25,9876226823
3998,30449600,1875832,32325432,3,0,0,512,25,10282650074
3999,30463270,1877476,32340746,5,0,0,3072,25,5933113438
4000,30463469,1885501,32348970,1,0,0,1024,22,8190074066
4001,30464600,2160970,32625570,3,0,0,512,25,930020395
4002,30471400,12149416,42620816,4,0,1,14336,29,815198198
4003,30485640,2250013,32735653,5,0,0,24576,25,10371528999
4004,30493090,2419173,32912263,4,0,0,43520,29,9474424335
4005,30510120,12112051,42622171,9,0,1,512,9,10239473610
4006,30519959,12104158,42624117,1,0,1,3072,22,742794141
4007,30520819,12103657,42624476,1,0,1,9728,22,3530788047
4008,30527670,2072985,32600655,4,0,0,15360,29,10628395565
4009,30533709,12091433,42625142,1,0,1,1024,22,4540147096
4010,30538450,2440858,32979308,4,0,0,137728,29,2669725205
4011,30545220,12108091,42653311,6,0,1,40960,11,4264098369
4012,30549229,1963914,32513143,2,0,0,58880,0,6708758002
4013,30549290,2245391,32794681,4,0,0,67072,29,1713865282
4014,30558719,12111747,42670466,1,0,1,1536,22,5627416855
4015,30563949,12112200,42676149,1,0,1,9728,22,833079343
4016,30564759,2429103,32993862,1,0,0,27648,22,4531785858
4017,30565319,12116219,42681538,1,0,1,17408,22,9116692881
4018,30567110,12121504,42688614,7,0,1,2560,5,1850986112
4019,30574389,2051002,32625391,1,0,0,36864,22,7333817899
4020,30586689,2186691,32773380,1,0,0,74240,22,3433207219
4021,30594290,12104213,42698503,7,0,1,3584,5,7861168505
4022,30632610,2170273,32802883,5,0,0,7168,25,10366463320
4023,30661089,12040000,42701089,1,0,1,4096,22,4335627454
4024,30666989,12118272,42785261,7,0,1,70656,5,6056604997
4025,30694839,12104741,42799580,7,0,1,19456,5,3457193614
4026,30703359,1899815,32603174,2,0,0,8192,0,5925766013
4027,30714459,12086107,42800566,1,0,1,1536,22,1182101534
4028,30720179,12101351,42821530,7,0,1,40960,5,1790270286
4029,30731179,12092617,42823796,1,0,1,3584,22,6570525343
4030,30739461,12105766,42845227,8,0,1,2048,17,7264668291
4031,30748980,2129229,32878209,4,0,0,25600,29,7965038637
4032,30767610,2256227,33023837,5,0,0,98304,25,9697436665
4033,30787820,2197595,32985415,4,0,0,19968,29,10481970665
4034,30789119,12056364,42845483,7,0,1,9216,5,7149578590
4035,30792500,12054929,42847429,7,0,1,3072,5,395352172
4036,30794721,12056254,42850975,8,0,1,5632,17,9343142948
4037,30794939,12072153,42867092,7,0,1,12288,5,6436297905
4038,30796640,2249224,33045864,1,0,0,72192,22,5134753693
4039,30797750,2139571,32937321,1,0,0,43520,22,6765785210
4040,30803559,12220445,43024004,7,0,1,124928,5,1767572605
4041,30827130,2592067,33419197,4,0,0,75264,29,4765233481
4042,30838699,12233798,43072497,7,0,1,6144,5,14164294
4043,30850379,12326283,43176662,7,0,1,131584,5,802155547
4044,30850649,12355355,43206004,1,0,1,12288,22,495177893
4045,30851329,12449907,43301236,7,0,1,94720,5,6082177795
4046,30855931,12510716,43366647,8,0,1,8704,17,10239531419
4047,30861199,2272830,33134029,2,0,0,38912,0,8738146344
4048,30862271,12508617,43370888,8,0,1,3072,17,6233316076
4049,30882990,2272613,33155603,5,0,0,24064,25,2376104395
4050,30886099,12544270,43430369,7,0,1,41984,5,803611066
4051,30886960,2413539,33300499,5,0,0,24576,25,6458853180
4052,30894620,2162075,33056695,1,0,0,13824,22,7934115731
4053,30903659,2307723,33211382,1,0,0,80896,22,5829865418
4054,30907910,12522482,43430392,4,0,1,3584,29,776794317
4055,30912901,12517514,43430415,8,0,1,1536,17,2411119875
4056,30914919,2165104,33080023,2,0,0,9728,0,5745798062
4057,30934759,12517682,43452441,7,0,1,23552,5,9712949438
4058,30938099,2772457,33710556,2,0,0,47616,0,8794487758
4059,30940489,2492147,33432636,2,0,0,44032,0,6276573929
4060,30947011,12510922,43457933,8,0,1,17920,17,9526860718
4061,30950199,1965363,32915562,2,0,0,10752,0,9873669850
4062,30956870,2091669,33048539,8,0,0,8704,17,1881795803
4063,30957140,2912615,33869755,5,0,0,194560,25,5554173141
4064,30980629,2650024,33630653,2,0,0,8192,0,8660564707
4065,30983729,12492432,43476161,7,0,1,15360,5,3346947146
4066,31019030,2471218,33490248,1,0,0,66560,22,9307172322
4067,31022700,2164003,33186703,8,0,0,42496,17,2475530210
4068,31026190,2756156,33782346,1,0,0,57344,22,5215727687
4069,31040510,2655515,33696025,5,0,0,134656,25,5952712934
4070,31042649,12495549,43538198,7,0,1,44032,5,9348084255
4071,31064160,2084088,33148248,5,0,0,46592,25,3352843148
4072,31071380,2482642,33554022,8,0,0,32768,17,4635367395
4073,31075659,2914960,33990619,2,0,0,44544,0,6054394129
4074,31083350,2544784,33628134,4,0,0,114688,29,2583951644
4075,31084941,12458626,43543567,8,0,1,10752,17,10206058308
4076,31088410,2962759,34051169,5,0,0,54272,25,9749784523
4077,31096170,2265229,33361399,4,0,0,23552,29,1882877073
4078,31103209,12442433,43545642,7,0,1,1536,5,518024650
4079,31105761,12446349,43552110,8,0,1,6656,17,2463404859
4080,31109929,12443154,43553083,7,0,1,12800,5,1970783128
4081,31120159,12473852,43594011,7,0,1,26624,5,6068932816
4082,31127060,2783810,33910870,4,0,0,29184,29,8430692058
4083,31136000,3090237,34226237,8,0,0,31744,17,6261657866
4084,31138470,2111820,33250290,8,0,0,1024,17,2563167801
4085,31147600,2157894,33305494,8,0,0,512,17,9174501469
4086,31188629,12405405,43594034,5,0,1,3072,25,9807049473
4087,31189480,2888582,34078062,1,0,0,35840,22,5854400946
4088,31196510,2305091,33501601,1,0,0,16384,22,417075138
4089,31200930,2085944,33286874,5,0,0,5120,25,8032816573
4090,31210940,2255965,33466905,1,0,0,22016,22,640187462
4091,31220500,3101094,34321594,1,0,0,5120,22,4030394856
4092,31221520,12372537,43594057,9,0,1,512,9,6339198877
4093,31227920,12366160,43594080,9,0,1,512,9,6617259753
4094,31231840,2490641,33722481,1,0,0,7168,22,912484284
4095,31232260,2912830,34145090,8,0,0,1536,17,1164442161
4096,31235590,2410000,33645590,5,0,0,22528,25,4684356398
4097,31239461,12354642,43594103,8,0,1,8704,17,3794682257
4098,31242050,12356957,43599007,7,0,1,29696,5,2908587529
4099,31254060,2205968,33460028,8,0,0,512,17,49432252
4100,31259210,2659219,33918429,4,0,0,24576,29,5078392832
4101,31270010,2189793,33459803,4,0,0,89088,29,8824165647
4102,31270529,12333624,43604153,7,0,1,8192,5,3877424028
4103,31282929,2007156,33290085,2,0,0,8192,0,1368647554
4104,31283710,2879366,34163076,4,0,0,13824,29,10433705043
4105,31296080,2676528,33972608,1,0,0,8704,22,147421980
4106,31302359,12370076,43672435,7,0,1,64000,5,7644525758
4107,31304861,12379665,43684526,8,0,1,3072,17,6710261165
4108,31309180,12385172,43694352,9,0,1,1536,9,1195058276
4109,31315350,12401205,43716555,7,0,1,28160,5,3748809803
4110,31318731,12412186,43730917,8,0,1,19968,17,6189747231
4111,31320501,12414282,43734783,8,0,1,6144,17,5241979654
4112,31322610,2237542,33560152,5,0,0,19968,25,7258947466
4113,31326500,12411983,43738483,7,0,1,14336,5,2009886452
4114,31331129,2319632,33650761,2,0,0,16896,0,3251872883
4115,31333869,12410926,43744795,7,0,1,37888,5,5437610759
4116,31346729,2225003,33571732,2,0,0,27136,0,2952932830
4117,31355720,2541404,33897124,4,0,0,89600,29,6586523591
4118,31380570,12380502,43761072,9,0,1,8704,9,6247621056
4119,31385970,12400039,43786009,9,0,1,5120,9,4845918388
4120,31388740,2691473,34080213,4,0,0,6656,29,2228502815
4121,31403970,3044688,34448658,8,0,0,512,17,9797461769
4122,31413470,2969997,34383467,5,0,0,77824,25,719249879
4123,31426481,12362434,43788915,8,0,1,4608,17,9377023902
4124,31433140,2349697,33782837,8,0,0,1536,17,8828416891
4125,31436860,2283414,33720274,5,0,0,30720,25,1806895472
4126,31444649,12362172,43806821,7,0,1,23040,5,3652033491
4127,31460499,2707592,34168091,2,0,0,16384,0,317939795
4128,31470031,12340976,43811007,8,0,1,6656,17,9243912805
4129,31476869,3079800,34556669,2,0,0,90624,0,3559406356
4130,31505281,12305880,43811161,8,0,1,8704,17,10300083012
4131,31510020,2889160,34399180,8,0,0,1536,17,4887292382
4132,31528739,2777484,34306223,2,0,0,81408,0,1566926884
4133,31530971,12281368,43812339,8,0,1,13824,17,4699666549
4134,31531030,2370664,33901694,4,0,0,14848,29,2030192826
4135,31537990,2529129,34067119,4,0,0,31232,29,8577184009
4136,31538560,2411988,33950548,1,0,0,5632,22,1145613526
4137,31539570,12279820,43819390,4,0,1,6656,29,6339167692
4138,31540390,12279666,43820056,4,0,1,1024,29,6613705734
4139,31549420,2161471,33710891,8,0,0,1024,17,5875297218
4140,31551061,12271581,43822642,8,0,1,4096,17,6324592551
4141,31554670,3030882,34585552,5,0,0,94720,25,8959149903
4142,31554730,12289328,43844058,6,0,1,19456,11,3768840702
4143,31556290,3287553,34843843,5,0,0,121344,25,8032807368
4144,31579200,2885283,34464483,1,0,0,51712,22,6933032705
4145,31591520,2173331,33764851,5,0,0,14336,25,19370656
4146,31595970,2716851,34312821,8,0,0,512,17,2393793802
4147,31613600,2591736,34205336,4,0,0,64512,29,1786878362
4148,31617510,2818466,34435976,4,0,0,83968,29,7263614830
4149,31626540,12223307,43849847,4,0,1,16896,29,6960883900
4150,31635610,3259995,34895605,1,0,0,48128,22,1048384011
4151,31647750,2294781,33942531,4,0,0,8192,29,9321492955
4152,31650399,2494200,34144599,2,0,0,44032,0,228115628
4153,31685349,2396330,34081679,2,0,0,2048,0,3140857387
4154,31687320,2368708,34056028,4,0,0,15872,29,7588309623
4155,31704570,2779308,34483878,5,0,0,29184,25,9644975232
4156,31705730,2285224,33990954,8,0,0,1024,17,10462107964
4157,31712230,12203538,43915768,4,0,1,2560,29,7840260300
4158,31722301,12198293,43920594,8,0,1,7680,17,2965393508
4159,31741939,3014148,34756087,2,0,0,45056,0,6768805641
4160,31756770,2402071,34158841,5,0,0,45056,25,6725597790
4161,31759800,3265549,35025349,1,0,0,23040,22,10059769086
4162,31763841,12157112,43920953,8,0,1,9728,17,2685852740
4163,31767040,2681439,34448479,5,0,0,40960,25,10264336882
4164,31778189,12143430,43921619,5,0,1,1024,25,4156264002
4165,31801610,3169505,34971115,2,0,0,27648,0,5273637943
4166,31812349,12109616,43921965,5,0,1,512,25,1610858847
4167,31852540,12069989,43922529,4,0,1,10752,29,7299886338
4168,31865360,2788189,34653549,4,0,0,55296,29,6919767486
4169,31876079,2887877,34763956,2,0,0,25600,0,10026956744
4170,31883550,12071913,43955463,4,0,1,3072,29,978170308
4171,31890120,2582750,34472870,8,0,0,1536,17,2156756485
4172,31895810,2273248,34169058,5,0,0,3072,25,1005651246
4173,31900530,12056559,43957089,4,0,1,2560,29,8286667416
4174,31916670,3042077,34958747,8,0,0,1536,17,2026187180
4175,31939639,12062928,44002567,5,0,1,17408,25,10162706364
4176,31947980,3247067,35195047,4,0,0,140288,29,959535137
4177,31951650,12051903,44003553,4,0,1,1536,29,944175541
4178,31952670,2221662,34174332,5,0,0,9728,25,6508506275
4179,31954320,2321268,34275588,8,0,0,2048,17,7322576561
4180,31956149,2638162,34594311,2,0,0,28672,0,10546113481
4181,31958220,2939934,34898154,8,0,0,3072,17,8892049572
4182,32019170,11986329,44005499,4,0,1,3072,29,2938999815
4183,32027889,11977764,44005653,5,0,1,8704,25,3888708194
4184,32028030,3035719,35063749,5,0,0,23040,25,8884567552
4185,32043060,3064904,35107964,1,0,0,3584,22,1731636831
4186,32056579,3050247,35106826,2,0,0,39936,0,10625333683
4187,32064109,2940464,35004573,2,0,0,87040,0,676872799
4188,32064640,2248002,34312642,1,0,0,20992,22,4504088404
4189,32064870,11942409,44007279,4,0,1,2560,29,8056557026
4190,32069509,2315541,34385050,2,0,0,5120,0,7479204488
4191,32071750,11990125,44061875,7,0,1,15360,5,2207181610
4192,32073090,2315415,34388505,5,0,0,11264,25,9088251714
4193,32079850,3011174,35091024,5,0,0,46080,25,7391480512
4194,32079940,2234308,34314248,4,0,0,4608,29,7550001277
4195,32080810,11989379,44070189,4,0,1,5632,29,9221617040
4196,32081450,2542359,34623809,1,0,0,37376,22,10078025858
4197,32088880,12052747,44141627,4,0,1,1536,29,1940949051
4198,32094350,2566695,34661045,8,0,0,1024,17,2568391897
4199,32136230,3179207,35315437,1,0,0,151552,22,1572603271
4200,32140420,3496642,35637062,5,0,0,16384,25,5093050895
4201,32141370,2204050,34345420,5,0,0,1536,25,1394939365
4202,32147300,3387522,35534822,2,0,0,3072,0,9561637932
4203,32183730,3075751,35259481,2,0,0,145920,0,9321770067
4204,32192680,3153067,35345747,1,0,0,68608,22,4977346670
4205,32194710,3277434,35472144,4,0,0,2560,29,2039284955
4206,32199890,11943967,44143857,4,0,1,4096,29,8540139824
4207,32203830,3507507,35711337,2,0,0,15872,0,6423330576
4208,32205360,3227894,35433254,1,0,0,100864,22,2834584691
4209,32208320,3147176,35355496,8,0,0,1024,17,5967034433
4210,32210470,3579197,35789667,5,0,0,105472,25,9843919914
4211,32228370,11915510,44143880,4,0,1,6656,29,1142071384
4212,32232080,3029764,35261844,4,0,0,7680,29,7566944226
4213,32241000,2717225,34958225,4,0,0,68096,29,7838447142
4214,32241900,2828066,35069966,8,0,0,512,17,2549283791
4215,32247130,2070885,34318015,2,0,0,12288,0,3569628831
4216,32259130,2367042,34626172,2,0,0,7680,0,5818356906
4217,32264740,2653636,34918376,2,0,0,9216,0,10224261219
4218,32269260,3081369,35350629,5,0,0,9216,25,7324838897
4219,32280390,3645324,35925714,1,0,0,128000,22,8219389810
4220,32281490,2348605,34630095,4,0,0,12800,29,9597961711
4221,32282350,3795076,36077426,5,0,0,152576,25,7614326368
4222,32309859,3180294,35490153,2,0,0,24576,0,2238790137
4223,32315780,2451179,34766959,5,0,0,9728,25,3245848117
4224,32355780,11788123,44143903,4,0,1,6144,29,4600127152
4225,32364370,3106971,35471341,4,0,0,124928,29,7593581968
4226,32364830,3117812,35482642,1,0,0,33792,22,9319397950
4227,32368430,3170783,35539213,4,0,0,14336,29,5594101845
4228,32380810,3434930,35815740,2,0,0,2048,0,8234310713
4229,32394150,3186726,35580876,4,0,0,20992,29,1775427793
4230,32396150,3543182,35939332,5,0,0,38912,25,3982791886
4231,32399600,3184754,35584354,1,0,0,10240,22,8926057014
4232,32415000,3273990,35688990,4,0,0,41984,29,2809649644
4233,32456740,2480714,34937454,1,0,0,31232,22,453413239
4234,32477399,11666527,44143926,2,0,1,2048,0,9672406951
4235,32505609,2842189,35347798,2,0,0,6656,0,3415164418
4236,32505910,2339672,34845582,5,0,0,5632,25,8672223669
4237,32507500,2964823,35472323,8,0,0,512,17,7200266265
4238,32510250,3578234,36088484,1,0,0,8192,22,3657899282
4239,32514650,2988988,35503638,1,0,0,44032,22,7514254234
4240,32515470,3646782,36162252,1,0,0,38912,22,6635276045
4241,32535020,3081394,35616414,1,0,0,3584,22,7537468755
4242,32542460,2492837,35035297,4,0,0,15360,29,8332327220
4243,32560110,2466354,35026464,2,0,0,3584,0,5945296882
4244,32566980,2966344,35533324,1,0,0,65024,22,265929529
4245,32569690,2813204,35382894,1,0,0,62976,22,8773499258
4246,32570570,11651318,44221888,6,0,1,71680,11,603175152
4247,32574130,11845992,44420122,6,0,1,4608,11,6582538737
4248,32592170,2518625,35110795,5,0,0,9216,25,2870006816
4249,32592549,2502086,35094635,2,0,0,11776,0,9577168989
4250,32595400,3144820,35740220,5,0,0,94720,25,7486004548
4251,32604120,2664455,35268575,4,0,0,22016,29,3734337898
4252,32606660,3242959,35849619,4,0,0,14336,29,7935937506
4253,32625120,3036492,35661612,2,0,0,18432,0,3814578592
4254,32635060,3786444,36421504,5,0,0,240128,25,6238163714
4255,32661580,12156011,44817591,6,0,1,139776,11,505064779
4256,32678220,3134159,35812379,5,0,0,73728,25,9219493358
4257,32684810,2640010,35324820,4,0,0,30720,29,8070693600
4258,32688010,2845845,35533855,4,0,0,1536,29,4711595210
4259,32733120,2848091,35581211,4,0,0,1024,29,1503121309
4260,32748409,3756952,36505361,2,0,0,8704,0,4196118049
4261,32752440,2786960,35539400,8,0,0,512,17,5218686356
4262,32783479,2730010,35513489,2,0,0,32256,0,1178078568
4263,32791370,12049846,44841216,9,0,1,3072,9,3405061957
4264,32797240,12051245,44848485,6,0,1,23552,11,3675071975
4265,32813060,12093167,44906227,9,0,1,10752,9,5070391187
4266,32854340,12051918,44906258,9,0,1,2048,9,9836343306
4267,32856440,12049841,44906281,9,0,1,15872,9,655985005
4268,32871630,12034674,44906304,9,0,1,4096,9,9009454677
4269,32882800,2790954,35673754,2,0,0,16896,0,6535638641
4270,32908370,2360852,35269222,8,0,0,2048,17,1190561538
4271,32924550,2674670,35599220,1,0,0,48640,22,3130667962
4272,32945639,12145902,45091541,7,0,1,109568,5,6600685676
4273,32950150,12141414,45091564,9,0,1,2048,9,4874208543
4274,32951860,2987869,35939729,4,0,0,512,29,7017539823
4275,32972510,3031972,36004482,2,0,0,110080,0,9224822256
4276,32988830,2751748,35740578,8,0,0,512,17,4860288610
4277,33010680,12080907,45091587,9,0,1,4608,9,1138088707
4278,33043019,12048591,45091610,5,0,1,4608,25,8141521839
4279,33043250,12071026,45114276,9,0,1,2560,9,4629765227
4280,33043640,2596097,35639737,2,0,0,8704,0,8609626869
4281,33043770,2574373,35618143,3,0,0,1536,25,872492818
4282,33056180,12069616,45125796,9,0,1,18944,9,1885491680
4283,33066299,12067710,45134009,1,0,1,1536,22,10659546227
4284,33071600,3170415,36242015,8,0,0,1024,17,6592868093
4285,33073460,2955849,36029309,2,0,0,81408,0,1946254073
4286,33087690,2535280,35622970,8,0,0,512,17,8104026064
4287,33091310,2481249,35572559,4,0,0,1536,29,4725299347
4288,33091570,2665789,35757359,8,0,0,512,17,554643356
4289,33095010,2832443,35927453,2,0,0,5632,0,6780661673
4290,33097670,2980270,36077940,8,0,0,1024,17,1110276937
4291,33106180,2833354,35939534,4,0,0,512,29,4547973819
4292,33107410,2496092,35603502,4,0,0,1536,29,3695480155
4293,33109180,2736048,35845228,8,0,0,2048,17,1944411918
4294,33111320,2629079,35740399,8,0,0,512,17,3843830303
4295,33127049,12069001,45196050,1,0,1,14336,22,1611173073
4296,33149780,12046293,45196073,9,0,1,3584,9,3598936689
4297,33150380,2670030,35820410,4,0,0,512,29,6436788539
4298,33151359,12044737,45196096,1,0,1,512,22,6585729467
4299,33163990,2680591,35844581,5,0,0,53760,25,1044030320
4300,33166500,12031455,45197955,9,0,1,8192,9,10248424348
4301,33168309,12030312,45198621,1,0,1,1024,22,2372422504
4302,33168750,12036246,45204996,7,0,1,18944,5,143784062
4303,33168780,12037202,45205982,9,0,1,1536,9,2659275691
4304,33172509,3026242,36198751,2,0,0,21504,0,984396334
4305,33180270,12028938,45209208,9,0,1,5120,9,8881952218
4306,33184680,2699257,35883937,8,0,0,3584,17,7546073614
4307,33196120,2593749,35789869,8,0,0,512,17,7458921852
4308,33196630,3645462,36842092,1,0,0,53248,22,5935311374
4309,33198660,12013800,45212460,9,0,1,5120,9,7514249044
4310,33202140,2657550,35859690,5,0,0,5120,25,8092680938
4311,33203300,3845937,37049237,1,0,0,79360,22,9608521757
4312,33205700,2872419,36078119,4,0,0,512,29,5336776671
4313,33208500,2606102,35814602,2,0,0,7168,0,4712472605
4314,33214720,2815392,36030112,8,0,0,2560,17,1598695203
4315,33230670,2872517,36103187,8,0,0,48128,17,8769367127
4316,33234390,11981936,45216326,9,0,1,6144,9,264208071
4317,33238219,12194597,45432816,7,0,1,196608,5,601625370
4318,33256409,2774506,36030915,2,0,0,2560,0,2969055210
4319,33256520,12188074,45444594,7,0,1,6656,5,10378995818
4320,33261519,12183098,45444617,1,0,1,2560,22,6191188281
4321,33268350,12185430,45453780,9,0,1,18944,9,679812465
4322,33282460,12173330,45455790,4,0,1,1536,29,6626047033
4323,33301109,12246820,45547929,7,0,1,97792,5,5002702766
4324,33304269,2510824,35815093,2,0,0,1536,0,6575086118
4325,33309140,2877939,36187079,1,0,0,81408,22,3422470441
4326,33314430,12233522,45547952,4,0,1,512,29,1905354386
4327,33318690,12229285,45547975,4,0,1,3072,29,3698381112
4328,33322440,12225558,45547998,0,0,1,8704,9,7692475796
4329,33338460,2778665,36117125,8,0,0,28160,17,7761848725
4330,33348370,12199651,45548021,0,0,1,11264,9,10056269329
4331,33349200,3165192,36514392,4,0,0,1024,29,3682546967
4332,33350190,12223371,45573561,9,0,1,22528,9,7062515399
4333,33362270,12212277,45574547,0,0,1,1536,9,7955034336
4334,33362489,12212404,45574893,1,0,1,512,22,10008582417
4335,33400980,3032894,36433874,5,0,0,40448,25,598713306
4336,33402450,12174389,45576839,4,0,1,3072,29,23969024
4337,33411880,2670318,36082198,8,0,0,13312,17,642529638
4338,33415530,12200435,45615965,4,0,1,27648,29,6189470206
4339,33419130,3039571,36458701,1,0,0,81408,22,10362411829
4340,33422000,3045381,36467381,1,0,0,3072,22,7642126153
4341,33423740,2653865,36077605,4,0,0,512,29,10129948121
4342,33432920,2653045,36085965,8,0,0,12288,17,9283940108
4343,33437810,2518423,35956233,2,0,0,3584,0,680909008
4344,33441150,3021029,36462179,8,0,0,10752,17,7680392114
4345,33448920,12645126,46094046,7,0,1,120832,5,8283311931
4346,33461240,3021654,36482894,1,0,0,50688,22,4572228351
4347,33470759,2721046,36191805,2,0,0,14848,0,6893215814
4348,33482040,2749229,36231269,1,0,0,42496,22,6447844358
4349,33486220,12607857,46094077,9,0,1,5120,9,6776657455
4350,33487490,12621814,46109304,9,0,1,10752,9,4740456569
4351,33497260,3565447,37062707,5,0,0,26112,25,8090147163
4352,33500980,2699198,36200178,1,0,0,4608,22,3995946296
4353,33502970,2816183,36319153,4,0,0,1024,29,2782863294
4354,33503050,2684208,36187258,4,0,0,512,29,7613078209
4355,33517219,12811281,46328500,7,0,1,47104,5,5189881285
4356,33523080,12805443,46328523,7,0,1,2560,5,2363221812
4357,33530899,2961844,36492743,9,0,0,31744,9,2498421608
4358,33531810,2679514,36211324,1,0,0,12288,22,2894686164
4359,33550680,3008317,36558997,1,0,0,141824,22,10322096642
4360,33557130,3015738,36572868,8,0,0,9216,17,1246171519
4361,33559040,2943554,36502594,5,0,0,32256,25,2871978705
4362,33562970,2903452,36466422,8,0,0,13824,17,9953646307
4363,33583009,12815541,46398550,7,0,1,60928,5,10402432895
4364,33590740,12811290,46402030,9,0,1,6656,9,6976220784
4365,33593020,2921037,36514057,5,0,0,26624,25,4074653878
4366,33600759,2691173,36291932,2,0,0,8704,0,2426052457
4367,33623460,12779031,46402491,9,0,1,10240,9,4356424493
4368,33624720,3599957,37224677,5,0,0,179200,25,3278313755
4369,33625080,12787923,46413003,9,0,1,15360,9,8604168536
4370,33643130,2815750,36458880,4,0,0,512,29,2847433817
4371,33685160,2934147,36619307,8,0,0,9216,17,3813138836
4372,33685480,2820426,36505906,1,0,0,1536,22,8341458815
4373,33693030,12759380,46452410,0,0,1,16896,9,9783564169
4374,33703240,12783411,46486651,7,0,1,34304,5,9871415220
4375,33715940,3414347,37130287,4,0,0,512,29,9128762417
4376,33718950,12775932,46494882,9,0,1,6144,9,4365022536
4377,33736260,12759928,46496188,0,0,1,2048,9,641062477
4378,33756030,2903309,36659339,8,0,0,27136,17,4191555300
4379,33760210,3023409,36783619,2,0,0,114176,0,358846844
4380,33771190,3079349,36850539,8,0,0,27648,17,1153693106
4381,33772909,3026512,36799421,2,0,0,50688,0,6849801737
4382,33774849,12897035,46671884,7,0,1,123392,5,4339526739
4383,33777489,12899901,46677390,1,0,1,11264,22,3893869679
4384,33777649,13054217,46831866,7,0,1,142336,5,395644129
4385,33789180,13042709,46831889,0,0,1,2560,9,10401815624
4386,33816690,2815135,36631825,4,0,0,512,29,10226070591
4387,33820310,3682723,37503033,1,0,0,195584,22,7103978541
4388,33820700,3347010,37167710,1,0,0,11776,22,5650612880
4389,33825949,13021758,46847707,7,0,1,30208,5,7339802470
4390,33838639,3112460,36951099,2,0,0,4096,0,5206718140
4391,33848660,3469445,37318105,8,0,0,30208,17,9422804049
4392,33875229,12973892,46849121,7,0,1,12288,5,4661729382
4393,33875749,12973718,46849467,1,0,1,512,22,9948598789
4394,33885799,12966254,46852053,1,0,1,4096,22,7034818612
4395,33893350,2890604,36783954,4,0,0,1024,29,7385313101
4396,33897039,12963420,46860459,1,0,1,4608,22,3944536718
4397,33900800,2923378,36824178,4,0,0,1536,29,10481548214
4398,33912230,2834873,36747103,1,0,0,9728,22,10271497301
4399,33915270,2779884,36695154,1,0,0,38912,22,7760368298
4400,33933019,12986854,46919873,7,0,1,40960,5,1707673577
4401,33933119,13174899,47108018,7,0,1,55808,5,1087396379
4402,33935450,3702242,37637692,8,0,0,5632,17,1816744060
4403,33948269,2948114,36896383,2,0,0,23552,0,8884061719
4404,33992159,13361125,47353284,7,0,1,99840,5,7994937184
4405,34023650,3547061,37570711,8,0,0,51200,17,1565515846
4406,34042429,13343104,47385533,7,0,1,18944,5,3535671875
4407,34060039,13326365,47386404,7,0,1,12288,5,5907205947
4408,34064319,13561731,47626050,7,0,1,150528,5,1335424898
4409,34079249,13546824,47626073,1,0,1,6656,22,4626931684
4410,34087110,2982553,37069663,1,0,0,4608,22,1292528230
4411,34099660,2955060,37054720,8,0,0,17920,17,618771088
4412,34107169,13518927,47626096,2,0,1,11264,0,5751329207
4413,34107390,3007406,37114796,1,0,0,30208,22,2347435704
4414,34110260,2743274,36853534,8,0,0,9728,17,8451417806
4415,34115140,2889543,37004683,8,0,0,3072,17,2545131615
4416,34117749,13550108,47667857,7,0,1,40448,5,4174927778
4417,34119699,3113916,37233615,2,0,0,29184,0,6979729512
4418,34122690,3538308,37660998,4,0,0,512,29,5608666950
4419,34132950,3124524,37257474,1,0,0,43520,22,6044455677
4420,34135689,13629944,47765633,7,0,1,145408,5,5627415952
4421,34165030,3116335,37281365,8,0,0,78336,17,3474686909
4422,34166120,2953535,37119655,8,0,0,15872,17,7480279549
4423,34182860,2716399,36899259,8,0,0,2560,17,7552159950
4424,34186990,2943118,37130108,1,0,0,19968,22,10076835712
4425,34191690,13592885,47784575,9,0,1,1536,9,1410282971
4426,34211599,13572999,47784598,5,0,1,11776,25,7437001953
4427,34218320,13566301,47784621,9,0,1,15360,9,2397999363
4428,34227939,13569293,47797232,5,0,1,5120,25,6348578076
4429,34269920,13566128,47836048,7,0,1,78848,5,5948853957
4430,34270610,3129187,37399797,1,0,0,150528,22,1461789264
4431,34272270,13564764,47837034,9,0,1,1536,9,6722238234
4432,34291929,13545669,47837598,1,0,1,10752,22,5366457338
4433,34292760,2941034,37233794,4,0,0,512,29,1243673061
4434,34296180,3208055,37504235,4,0,0,512,29,9012833972
4435,34297380,2695263,36992643,8,0,0,19456,17,7836192431
4436,34303989,13536195,47840184,1,0,1,4096,22,4421988436
4437,34306360,3114098,37420458,2,0,0,67584,0,6190050874
4438,34318450,13523014,47841464,9,0,1,14336,9,4829221152
4439,34327979,13535862,47863841,7,0,1,4096,5,1824022758
4440,34340910,13522954,47863864,7,0,1,9728,5,8497975183
4441,34341230,13522657,47863887,9,0,1,7168,9,1148783616
4442,34342579,13521331,47863910,1,0,1,11776,22,2978067144
4443,34346190,13535088,47881278,9,0,1,4096,9,7109452059
4444,34362699,13520845,47883544,1,0,1,3584,22,1935688825
4445,34364839,13521931,47886770,7,0,1,5120,5,1149170477
4446,34370479,2774339,37144818,2,0,0,47616,0,9916111714
4447,34384370,13504026,47888396,3,0,1,2560,25,4707332807
4448,34406580,13482802,47889382,9,0,1,1536,9,7188471468
4449,34416389,13475899,47892288,1,0,1,4608,22,6774024108
4450,34417121,13478073,47895194,8,0,1,4608,17,7469969030
4451,34434420,13461440,47895860,3,0,1,1024,25,658297883
4452,34451489,13444832,47896321,5,0,1,10240,25,6365296073
4453,34458729,13437848,47896577,5,0,1,9216,25,4396266176
4454,34486271,13410972,47897243,8,0,1,1024,17,2339550673
4455,34486660,3093434,37580094,2,0,0,30720,0,6430176715
4456,34488809,13411020,47899829,1,0,1,4096,22,2891627
4457,34488820,3026046,37514866,1,0,0,34816,22,8484360872
4458,34490709,3159360,37650069,2,0,0,30208,0,1043658431
4459,34493410,13409645,47903055,3,0,1,5120,25,4655475467
4460,34494001,13415417,47909418,8,0,1,19968,17,501389083
4461,34498919,3034230,37533149,2,0,0,59904,0,4369638685
4462,34501180,13410184,47911364,3,0,1,3072,25,3284131196
4463,34502860,13417928,47920788,3,0,1,8192,25,8355804143
4464,34504439,13416372,47920811,1,0,1,2048,22,9262011349
4465,34506629,13414205,47920834,5,0,1,10752,25,2871095051
4466,34511800,13409057,47920857,3,0,1,3072,25,7377039277
4467,34512850,3369428,37882278,8,0,0,86016,17,7789718938
4468,34516520,2987488,37504008,8,0,0,3072,17,5878594624
4469,34518010,13406874,47924884,9,0,1,7168,9,4433128082
4470,34527630,3201520,37729150,2,0,0,77824,0,4977683776
4471,34530939,13394406,47925345,5,0,1,10240,25,7684716643
4472,34549650,13377784,47927434,9,0,1,2048,9,3033426399
4473,34561310,13366892,47928202,9,0,1,11776,9,4599706110
4474,34569879,13374311,47944190,1,0,1,7168,22,4836052649
4475,34570660,2770474,37341134,8,0,0,20480,17,8695070732
4476,34573731,13372725,47946456,8,0,1,3584,17,3630183736
4477,34579930,2863488,37443418,8,0,0,74752,17,10644525669
4478,34581990,3047998,37629988,4,0,0,512,29,5971121504
4479,34589131,13364737,47953868,8,0,1,11776,17,2252326959
4480,34591999,13365415,47957414,1,0,1,5632,22,4015615803
4481,34606340,13356220,47962560,9,0,1,8192,9,4486068643
4482,34607359,13367901,47975260,1,0,1,6144,22,10137015370
4483,34621779,13357053,47978832,5,0,1,5632,25,8569277557
4484,34622809,13357009,47979818,5,0,1,1536,25,2061245389
4485,34629170,13354834,47984004,9,0,1,6656,9,7780021515
4486,34633609,13351061,47984670,5,0,1,1024,25,7970632246
4487,34635999,13349337,47985336,5,0,1,1024,25,2339639858
4488,34636601,13353881,47990482,8,0,1,8192,17,7859617961
4489,34655659,13353610,48009269,1,0,1,1024,22,9782951695
4490,34669220,13363171,48032391,9,0,1,6656,9,4289147315
4491,34669879,13364138,48034017,5,0,1,2560,25,9660896660
4492,34669999,13364684,48034683,1,0,1,11264,22,3610020823
4493,34672981,13383399,48056380,8,0,1,16384,17,380801697
4494,34678919,13387218,48066137,5,0,1,11264,25,5344139473
4495,34682919,13385804,48068723,5,0,1,4096,25,93629392
4496,34689320,13404266,48093586,3,0,1,5120,25,8551038747
4497,34695189,13400983,48096172,1,0,1,4096,22,8042976078
4498,34696239,2964580,37660819,2,0,0,20480,0,4919199024
4499,34697301,13403377,48100678,8,0,1,7168,17,3610066788
4500,34700041,13401623,48101664,8,0,1,1536,17,3304481886
4501,34706309,13401608,48107917,7,0,1,19456,5,9335822559
4502,34712520,2895778,37608298,4,0,0,1024,29,8303533431
4503,34714400,2953543,37667943,4,0,0,2048,29,9522313420
4504,34723910,2820011,37543921,4,0,0,1536,29,4906617073
4505,34724309,13392072,48116381,5,0,1,1536,25,9805069410
4506,34737209,13379518,48116727,5,0,1,512,25,1430360778
4507,34738331,13383993,48122324,8,0,1,13312,17,3328140556
4508,34742399,13647396,48389795,1,0,1,76800,22,6714729280
4509,34753980,13645740,48399720,3,0,1,4096,25,3696808970
4510,34756439,13654038,48410477,1,0,1,9216,22,5944943242
4511,34761369,2904956,37666325,2,0,0,17408,0,3881587989
4512,34762520,13650863,48413383,9,0,1,4608,9,8516828172
4513,34776609,3079392,37856001,2,0,0,100352,0,6701036727
4514,34790890,13697588,48488478,3,0,1,13824,25,5366221084
4515,34791430,13700274,48491704,9,0,1,5120,9,10076011167
4516,34794020,13711039,48505059,3,0,1,5632,25,6307313803
4517,34798731,13711474,48510205,8,0,1,8192,17,4867363735
4518,34803530,3081318,37884848,4,0,0,1024,29,2320471797
4519,34805190,13706961,48512151,9,0,1,3072,9,7948431684
4520,34819880,13695497,48515377,9,0,1,5120,9,3765622029
4521,34826661,13787800,48614461,8,0,1,11264,17,6015227586
4522,34839569,2951375,37790944,2,0,0,19456,0,8398170994
4523,34854070,13760414,48614484,3,0,1,2560,25,9859376495
4524,34854569,13768385,48622954,1,0,1,13312,22,65408213
4525,34867990,13754987,48622977,9,0,1,5120,9,363605644
4526,34870620,13752380,48623000,9,0,1,5632,9,2531650306
4527,34890089,3307995,38198084,2,0,0,122880,0,6065453537
4528,34891111,13731912,48623023,8,0,1,15360,17,1615468118
4529,34892009,3109934,38001943,2,0,0,92160,0,582097398
4530,34897280,13740944,48638224,9,0,1,2048,9,8798990930
4531,34903471,13734776,48638247,8,0,1,6656,17,3337212922
4532,34918321,13724519,48642840,8,0,1,6656,17,131734182
4533,34969189,3063882,38033071,2,0,0,31232,0,9916327146
4534,34986350,3259308,38245658,1,0,0,40960,22,5420908922
4535,35010671,13632192,48642863,8,0,1,3072,17,1577122548
4536,35013290,14003301,49016591,7,0,1,152576,5,5008278637
4537,35017170,2956670,37973840,1,0,0,9216,22,1568587930
4538,35027270,3005980,38033250,4,0,0,512,29,3408894061
4539,35061340,2822989,37884329,1,0,0,6656,22,3648094203
4540,35079449,3267541,38346990,2,0,0,46592,0,4060271737
4541,35110680,3120809,38231489,1,0,0,24064,22,7897438424
4542,35113239,3214673,38327912,2,0,0,82944,0,4587755888
4543,35118620,14027206,49145826,9,0,1,11264,9,1209933349
4544,35118689,3104580,38223269,2,0,0,58880,0,8541844520
4545,35121009,2986636,38107645,2,0,0,7680,0,2492353017
4546,35132830,3100250,38233080,1,0,0,5120,22,2267171117
4547,35178800,14029674,49208474,6,0,1,10240,11,1936668874
4548,35194570,14016490,49211060,9,0,1,4096,9,10141667181
4549,35213119,3216243,38429362,2,0,0,34816,0,10557176734
4550,35236090,3154883,38390973,4,0,0,512,29,9523083735
4551,35236870,14187858,49424728,6,0,1,95232,11,5259859245
4552,35256060,2999792,38255852,1,0,0,24576,22,7725659725
4553,35269170,3123253,38392423,4,0,0,512,29,8329758773
4554,35276599,2947489,38224088,9,0,0,2560,9,7916422151
4555,35278839,14146235,49425074,5,0,1,512,25,597826521
4556,35287519,2995178,38282697,6,0,0,25600,11,7000346656
4557,35327249,3037275,38364524,9,0,0,17920,9,2302416848
4558,35333619,3025414,38359033,2,0,0,39424,0,3433853095
4559,35339990,2921212,38261202,2,0,0,17408,0,3390532853
4560,35389090,2750102,38139192,1,0,0,6656,22,6356039106
4561,35397280,14028460,49425740,9,0,1,1024,9,6336937595
4562,35406770,14195173,49601943,6,0,1,139264,11,8927526557
4563,35409819,14192155,49601974,5,0,1,6656,25,636143189
4564,35411460,2921311,38332771,1,0,0,15872,22,8998120898
4565,35429310,2816706,38246016,4,0,0,1024,29,5200247306
4566,35429799,2955496,38385295,2,0,0,68096,0,10047938102
4567,35431019,2774264,38205283,2,0,0,23552,0,7859307779
4568,35439420,2673798,38113218,4,0,0,512,29,6862559200
4569,35451640,14246104,49697744,6,0,1,101376,11,708829862
4570,35465569,14239920,49705489,5,0,1,22528,25,1699204186
4571,35470840,14331200,49802040,4,0,1,47104,29,9929490738
4572,35471940,2964332,38436272,1,0,0,12800,22,5978996853
4573,35474359,14327704,49802063,5,0,1,512,25,6688666276
4574,35479969,2912275,38392244,9,0,0,4096,9,7101653359
4575,35505280,14296806,49802086,9,0,1,2560,9,6073310407
4576,35511160,2735393,38246553,4,0,0,1536,29,9101728000
4577,35515389,14286736,49802125,5,0,1,5120,25,7561656135
4578,35516689,14285459,49802148,5,0,1,8192,25,941447492
4579,35526330,14321351,49847681,6,0,1,11776,11,2998948595
4580,35537990,14313284,49851274,9,0,1,512,9,9410488728
4581,35541259,14310783,49852042,5,0,1,11776,25,1809877885
4582,35541400,14321093,49862493,9,0,1,10752,9,7563826128
4583,35542089,2905264,38447353,2,0,0,19968,0,8012718391
4584,35544609,14320790,49865399,5,0,1,4608,25,9639118261
4585,35545860,2844926,38390786,1,0,0,17920,22,1862242514
4586,35559609,14307416,49867025,5,0,1,2560,25,4852577012
4587,35566059,2866290,38432349,2,0,0,9728,0,4268947250
4588,35569059,14299592,49868651,5,0,1,2560,25,4453972573
4589,35572340,14296977,49869317,9,0,1,1024,9,6538078116
4590,35586509,2950514,38537023,2,0,0,28160,0,3038164127
4591,35592830,14296839,49889669,6,0,1,39424,11,7649679663
4592,35611409,3040862,38652271,9,0,0,81408,9,10659986666
4593,35616790,3001347,38618137,1,0,0,36864,22,10158925537
4594,35620450,2847759,38468209,1,0,0,12800,22,3815234416
4595,35634300,3023194,38657494,1,0,0,11776,22,208612090
4596,35634510,3069134,38703644,1,0,0,109568,22,9463561813
4597,35638139,3134947,38773086,2,0,0,107008,0,9641997405
4598,35659470,3072620,38732090,4,0,0,512,29,4854948287
4599,35664300,3153073,38817373,1,0,0,27136,22,8171941660
4600,35667120,2911663,38578783,4,0,0,1536,29,6884686369
4601,35678819,14239082,49917901,1,0,1,27648,22,7107427672
4602,35696420,14223747,49920167,9,0,1,3584,9,1431276102
4603,35709379,2834843,38544222,9,0,0,23552,9,8198648355
4604,35711579,14209894,49921473,5,0,1,2048,25,6691608266
4605,35714510,2950440,38664950,1,0,0,4608,22,4281934665
4606,35722079,14470889,50192968,1,0,1,157184,22,5215905245
4607,35731109,14462205,50193314,2,0,1,512,0,1672318705
4608,35733871,14466997,50200868,8,0,1,5632,17,8042275228
4609,35734609,2657993,38392602,2,0,0,512,0,1468242929
4610,35735489,2975042,38710531,2,0,0,22528,0,2602505885
4611,35744679,14476117,50220796,5,0,1,2560,25,4511859148
4612,35757340,2896348,38653688,4,0,0,2048,29,4173103922
4613,35762489,14458330,50220819,2,0,1,4096,0,1296605551
4614,35766981,14463431,50230412,8,0,1,2560,17,4653214788
4615,35767191,14463244,50230435,8,0,1,3072,17,1516816876
4616,35771849,3037023,38808872,2,0,0,38912,0,10068510849
4617,35775590,14454868,50230458,9,0,1,5120,9,3882554688
4618,35783090,14448978,50232068,9,0,1,9216,9,313329874
4619,35791970,14442684,50234654,9,0,1,4096,9,4753510534
4620,35801879,2995114,38796993,9,0,0,74752,9,1642009153
4621,35805139,14471351,50276490,2,0,1,9728,0,3336103951
4622,35814250,2838791,38653041,4,0,0,2048,29,983167970
4623,35816740,2837127,38653867,4,0,0,512,29,1244267070
4624,35833439,14443922,50277361,1,0,1,5120,22,5049115011
4625,35843060,2965999,38809059,4,0,0,512,29,1113342625
4626,35848540,14429692,50278232,6,0,1,12288,11,10119837389
4627,35853479,3008631,38862110,9,0,0,41984,9,4881436197
4628,35863050,14427054,50290104,9,0,1,4608,9,6691073781
4629,35865039,14426371,50291410,5,0,1,2048,25,8289141090
4630,35867000,14472063,50339063,6,0,1,45568,11,929180754
4631,35876459,14463590,50340049,5,0,1,1536,25,2867842129
4632,35876651,14465344,50341995,8,0,1,3072,17,4244222147
4633,35877370,2945259,38822629,4,0,0,1024,29,4721935375
4634,35878859,14464442,50343301,2,0,1,2048,0,2611898014
4635,35894560,14451967,50346527,9,0,1,5120,9,9479250243
4636,35898749,3028143,38926892,2,0,0,26624,0,3341770576
4637,35905790,14446144,50351934,6,0,1,12800,11,5538666689
4638,35907420,14492788,50400208,6,0,1,22016,11,9927441523
4639,35914400,14488714,50403114,0,0,1,4608,9,9952795200
4640,35928920,3081971,39010891,4,0,0,1024,29,3386188740
4641,35930709,14543551,50474260,2,0,1,3584,0,9400722829
4642,35941879,3148052,39089931,9,0,0,55296,9,5087602946
4643,35944469,14575422,50519891,1,0,1,33792,22,9584392509
4644,35964019,14556849,50520868,2,0,1,3584,0,9620706699
4645,35966619,2855675,38822294,9,0,0,15872,9,8558235252
4646,36018119,14504055,50522174,2,0,1,2048,0,774764803
4647,36020600,3019519,39040119,4,0,0,1536,29,9358367945
4648,36024620,14508575,50533195,9,0,1,23552,9,3061939584
4649,36026109,14644134,50670243,1,0,1,75776,22,8379188244
4650,36045169,14625433,50670602,1,0,1,9728,22,1759674622
4651,36047799,14638786,50686585,2,0,1,5120,0,1662153412
4652,36050990,14717806,50768796,6,0,1,51712,11,8377814662
4653,36053369,14812605,50865974,1,0,1,41984,22,490506854
4654,36056389,14817119,50873508,2,0,1,3584,0,1519463548
4655,36066510,2837281,38903791,4,0,0,512,29,8201639223
4656,36074419,14799455,50873874,2,0,1,4096,0,5035011446
4657,36085480,2954125,39039605,1,0,0,84992,22,8041025608
4658,36091659,3020135,39111794,2,0,0,71680,0,8586762843
4659,36093991,14779906,50873897,8,0,1,2560,17,8654385677
4660,36097720,14776200,50873920,9,0,1,4608,9,1574315562
4661,36103309,14846272,50949581,1,0,1,30208,22,5473548972
4662,36128660,3221397,39350057,4,0,0,1024,29,8211724411
4663,36133719,15166228,51299947,1,0,1,150016,22,1607880451
4664,36144940,15173973,51318913,9,0,1,6144,9,6658936868
4665,36148280,2908676,39056956,1,0,0,8704,22,2707783957
4666,36152450,15238451,51390901,6,0,1,68608,11,1614336310
4667,36153640,15237284,51390924,9,0,1,512,9,4719637272
4668,36160330,15230617,51390947,9,0,1,3072,9,7108038828
4669,36172690,15243527,51416217,6,0,1,48128,11,7880946949
4670,36177390,15239493,51416883,9,0,1,1024,9,4944034827
4671,36179789,15241126,51420915,1,0,1,4096,22,6031242866
4672,36185200,15238621,51423821,9,0,1,4608,9,8080694941
4673,36189189,3160533,39349722,9,0,0,109056,9,4830855448
4674,36194400,3023460,39217860,1,0,0,43520,22,9007904921
4675,36195390,15228995,51424385,9,0,1,10752,9,3469590184
4676,36196099,3095469,39291568,9,0,0,53248,9,918814006
4677,36196300,15312759,51509059,6,0,1,28160,11,6146519815
4678,36197260,15338061,51535321,6,0,1,48128,11,1729553098
4679,36227010,3229376,39456386,2,0,0,169984,0,1554653989
4680,36228280,15316858,51545138,9,0,1,15360,9,6210815621
4681,36232330,3301972,39534302,2,0,0,45568,0,4914540963
4682,36239989,3397183,39637172,9,0,0,29184,9,10671640749
4683,36240909,3587393,39828302,9,0,0,79872,9,5011635616
4684,36246480,15319287,51565767,6,0,1,40448,11,3962192788
4685,36253770,3202951,39456721,4,0,0,1024,29,8950771105
4686,36268559,15297362,51565921,1,0,1,8704,22,5563189256
4687,36270080,3085928,39356008,1,0,0,19456,22,5642922048
4688,36274279,15358787,51633066,1,0,1,18432,22,8467149279
4689,36275800,3271872,39547672,1,0,0,41984,22,8304220907
4690,36282870,15367566,51650436,9,0,1,6656,9,6227210909
4691,36300280,3065891,39366171,1,0,0,33280,22,3324224744
4692,36307830,3292917,39600747,2,0,0,28672,0,6058166780
4693,36310219,3278695,39588914,9,0,0,63488,9,8634873237
4694,36323990,3132933,39456923,4,0,0,512,29,10712969817
4695,36327030,3062992,39390022,1,0,0,4608,22,9213914596
4696,36346849,3278270,39625119,9,0,0,17920,9,415663374
4697,36355100,3206858,39561958,4,0,0,2048,29,1858854394
4698,36376930,3120716,39497646,2,0,0,5632,0,3043092038
4699,36386550,3221654,39608204,1,0,0,9728,22,4059912116
4700,36401230,3533009,39934239,1,0,0,35328,22,3274341352
4701,36401950,3432615,39834565,2,0,0,20480,0,477627125
4702,36405729,3373997,39779726,1,0,0,71680,22,7666303355
4703,36407269,15243802,51651071,2,0,1,2048,0,5473607008
4704,36410909,15241468,51652377,2,0,1,2048,0,6710361094
4705,36413819,3596145,40009964,9,0,0,179712,9,10223392958
4706,36420719,3666232,40086951,1,0,0,60416,22,1381322430
4707,36420999,15232684,51653683,2,0,1,2048,0,8767986813
4708,36430530,15226602,51657132,9,0,1,1024,9,6857815162
4709,36457879,3381857,39839736,2,0,0,16896,0,10559683700
4710,36458169,3405531,39863700,1,0,0,28672,22,6392659808
4711,36465549,15191606,51657155,2,0,1,14336,0,6165856343
4712,36476960,3387543,39864503,4,0,0,2560,29,7395268180
4713,36485630,3193757,39679387,4,0,0,2048,29,9968792392
4714,36492549,3387480,39880029,1,0,0,5632,22,1159945287
4715,36493659,3565071,40058730,2,0,0,26624,0,6482658348
4716,36500550,15168021,51668571,9,0,1,7680,9,4007254493
4717,36506970,3611874,40118844,2,0,0,104448,0,1954448410
4718,36527439,3505168,40032607,1,0,0,74240,22,14232007
4719,36530520,3528545,40059065,4,0,0,1024,29,8472448593
4720,36532130,3402288,39934418,4,0,0,512,29,4456310526
4721,36555300,15120529,51675829,9,0,1,16384,9,4939788778
4722,36587619,15164691,51752310,2,0,1,11776,0,1455294670
4723,36598439,15153894,51752333,2,0,1,4096,0,6257166603
4724,36599610,3433176,40032786,4,0,0,512,29,9408430517
4725,36609839,3544186,40154025,1,0,0,19456,22,2515069658
4726,36610690,3439229,40049919,4,0,0,1536,29,8574135794
4727,36633559,15118797,51752356,2,0,1,1024,0,10547595025
4728,36641519,3574672,40216191,1,0,0,58880,22,5541240044
4729,36675149,3541689,40216838,1,0,0,2048,22,9542008847
4730,36676019,3450814,40126833,2,0,0,8704,0,8147894536
4731,36677899,3498596,40176495,1,0,0,20992,22,5304603057
4732,36687769,3491897,40179666,1,0,0,6144,22,4927873661
4733,36688509,3474816,40163325,2,0,0,4608,0,4599035103
4734,36710829,15049186,51760015,2,0,1,16896,0,4279716697
4735,36717040,3544563,40261603,4,0,0,5120,29,3607782380
4736,36723080,3504015,40227095,4,0,0,512,29,5018189599
4737,36734040,15111132,51845172,9,0,1,14336,9,946292445
4738,36738089,15174332,51912421,2,0,1,4096,0,4429288471
4739,36739929,15172515,51912444,2,0,1,1536,0,3911556733
4740,36746730,15165737,51912467,9,0,1,2560,9,9377467351
4741,36773330,15139160,51912490,3,0,1,1536,25,1692327658
4742,36777370,15135143,51912513,3,0,1,1536,25,4806678235
4743,36780850,15131686,51912536,3,0,1,2048,25,4068462610
4744,36786720,15125839,51912559,9,0,1,3072,9,1951575565
4745,36797419,3505246,40302665,1,0,0,34816,22,7698798895
4746,36838940,15073642,51912582,3,0,1,2048,25,9262362054
4747,36841729,15088134,51929863,2,0,1,5120,0,1909737623
4748,36844000,3558520,40402520,4,0,0,1024,29,3137824540
4749,36850760,15102248,51953008,3,0,1,15872,25,4261067716
4750,36857450,15107654,51965104,3,0,1,5120,25,8811734919
4751,36872339,15092788,51965127,2,0,1,4096,0,5911745109
4752,36877009,3505362,40382371,2,0,0,26624,0,9727814842
4753,36898339,3604278,40502617,1,0,0,47104,22,792075391
4754,36911469,3529571,40441040,1,0,0,26624,22,7851970079
4755,36914109,15077506,51991615,5,0,1,512,25,7262515925
4756,36922489,3739812,40662301,1,0,0,1024,22,2705421464
4757,36943859,3681837,40625696,2,0,0,29696,0,743197797
4758,36949259,15042379,51991638,2,0,1,4096,0,3221459691
4759,36953760,15038527,51992287,9,0,1,2048,9,7798236434
4760,36959429,3572071,40531500,1,0,0,94720,22,6826460232
4761,36962159,3503781,40465940,1,0,0,15360,22,2219322859
4762,36970970,15048195,52019165,3,0,1,3584,25,440897017
4763,36982990,3441376,40424366,4,0,0,1024,29,8052161819
4764,37003990,15015198,52019188,9,0,1,8704,9,2995087136
4765,37012719,3563519,40576238,1,0,0,70144,22,9993146586
4766,37023789,3559648,40583437,1,0,0,23552,22,4715381615
4767,37038499,3618295,40656794,2,0,0,6656,0,3139025909
4768,37040210,14979001,52019211,3,0,1,2560,25,9829788224
4769,37051149,3488299,40539448,1,0,0,17408,22,9947730601
4770,37057090,3611603,40668693,4,0,0,512,29,6261629927
4771,37066990,14956347,52023337,9,0,1,2560,9,1494531848
4772,37075619,14949077,52024696,2,0,1,3584,0,8092532495
4773,37081000,3532145,40613145,4,0,0,1024,29,8224695831
4774,37098249,14930517,52028766,2,0,1,5632,0,7188754049
4775,37104289,3593383,40697672,2,0,0,14336,0,4308389442
4776,37130919,3523816,40654735,1,0,0,95232,22,4117645992
4777,37143329,3639892,40783221,1,0,0,6144,22,5524293371
4778,37144970,3438646,40583616,4,0,0,512,29,7796516014
4779,37185940,14845732,52031672,9,0,1,4608,9,8939188395
4780,37190359,3551138,40741497,1,0,0,32768,22,1822280390
4781,37193280,3573811,40767091,4,0,0,512,29,9653422674
4782,37201939,3571846,40773785,2,0,0,11776,0,3681339089
4783,37212940,3396597,40609537,4,0,0,2560,29,3204256703
4784,37233040,3424112,40657152,4,0,0,512,29,3959017565
4785,37253869,14819752,52073621,7,0,1,25600,5,505296101
4786,37267820,14828896,52096716,9,0,1,8704,9,1982867100
4787,37288590,3368383,40656973,4,0,0,512,29,3211844960
4788,37296800,3426770,40723570,4,0,0,512,29,5093232586
4789,37321720,14775764,52097484,9,0,1,11776,9,8508035837
4790,37322200,14813587,52135787,9,0,1,4608,9,10566533467
4791,37322680,14825672,52148352,9,0,1,12800,9,2259914454
4792,37325940,3443417,40769357,4,0,0,512,29,1639290035
4793,37326349,3618410,40944759,2,0,0,29696,0,6129948908
4794,37344610,14803765,52148375,9,0,1,10240,9,5018995872
4795,37363629,3572059,40935688,2,0,0,78336,0,1921748707
4796,37390540,14786445,52176985,9,0,1,1024,9,3204441874
4797,37395800,3393137,40788937,4,0,0,512,29,4779111514
4798,37400970,14776373,52177343,9,0,1,4608,9,5720460778
4799,37418860,3427977,40846837,4,0,0,1024,29,4490471618
4800,37432169,3584564,41016733,1,0,0,67584,22,6226836988
4801,37438940,3323361,40762301,4,0,0,1024,29,3312856713
4802,37450110,14727256,52177366,9,0,1,10752,9,9856376285
4803,37457789,3576953,41034742,1,0,0,47104,22,6836041971
4804,37459841,14721270,52181111,8,0,1,1024,17,5125754142
4805,37462390,3318167,40780557,4,0,0,1536,29,6901327624
4806,37468559,14881402,52349961,1,0,1,112128,22,8181152201
4807,37496969,14886385,52383354,1,0,1,18944,22,9530622269
4808,37505219,14903166,52408385,1,0,1,18944,22,10022802429
4809,37510690,3456894,40967584,4,0,0,1536,29,3962264921
4810,37513069,15159748,52672817,1,0,1,108544,22,10405331060
4811,37513929,15189467,52703396,1,0,1,51712,22,7716362370
4812,37554239,3466128,41020367,2,0,0,11776,0,5899360377
4813,37558641,15144778,52703419,8,0,1,1024,17,9379332126
4814,37559039,15165635,52724674,1,0,1,68608,22,5027750871
4815,37563841,15190653,52754494,8,0,1,4608,17,2123690928
4816,37564430,3683175,41247605,4,0,0,512,29,8663181704
4817,37587869,3553614,41141483,2,0,0,11264,0,6553793664
4818,37589910,3449067,41038977,4,0,0,13824,29,403316880
4819,37589940,3709968,41299908,4,0,0,44544,29,8155065375
4820,37591519,3632275,41223794,2,0,0,19456,0,4011354648
4821,37597459,15227720,52825179,1,0,1,53248,22,10230600759
4822,37683869,3639551,41323420,1,0,0,57344,22,2429297791
4823,37694300,15130902,52825202,9,0,1,4096,9,8061252886
4824,37705130,3581183,41286313,4,0,0,29696,29,6577572156
4825,37717279,15154351,52871630,1,0,1,68608,22,1810035947
4826,37748839,15399236,53148075,1,0,1,197120,22,1475446388
4827,37751739,3457830,41209569,2,0,0,75776,0,8680638977
4828,37752609,15594281,53346890,1,0,1,114688,22,5816029465
4829,37766310,15604524,53370834,9,0,1,11264,9,7137650728
4830,37801800,3610046,41411846,4,0,0,71680,29,9172426682
4831,37802710,15616457,53419167,9,0,1,15872,9,5046600458
4832,37805329,3418644,41223973,2,0,0,512,0,317357803
4833,37807760,15611430,53419190,4,0,1,15872,29,7068575355
4834,37808110,15611103,53419213,4,0,1,6144,29,4043198335
4835,37816789,3533904,41350693,2,0,0,9728,0,4568313421
4836,37829589,15649272,53478861,1,0,1,73728,22,7696940477
4837,37840729,3637771,41478500,1,0,0,62464,22,6898205122
4838,37840800,15641287,53482087,4,0,1,5120,29,589015109
4839,37851080,15631161,53482241,9,0,1,8704,9,8928213003
4840,37852450,3630308,41482758,4,0,0,12288,29,3040038342
4841,37868509,3617704,41486213,1,0,0,11264,22,476041551
4842,37871960,3692547,41564507,2,0,0,41984,0,4992576322
4843,37881469,3655108,41536577,1,0,0,17920,22,6083333660
4844,37885510,3593481,41478991,3,0,0,1536,25,4047163760
4845,37888159,15640806,53528965,1,0,1,32768,22,9234880289
4846,37899359,15673623,53572982,1,0,1,108032,22,6001779068
4847,37916880,3495440,41412320,2,0,0,1024,0,4333525887
4848,37921530,3718462,41639992,4,0,0,19968,29,8256609201
4849,37938759,15716679,53655438,1,0,1,130560,22,7396872717
4850,37947860,15714786,53662646,4,0,1,2048,29,2318294005
4851,37950699,3730088,41680787,1,0,0,86016,22,9052826917
4852,37951510,15715642,53667152,4,0,1,7168,29,7521988127
4853,37973651,15696753,53670404,8,0,1,5120,17,7824142421
4854,37975839,15695871,53671710,1,0,1,2048,22,3993838268
4855,37989640,3692909,41682549,2,0,0,5632,0,2316129458
4856,38004279,4224987,42229266,1,0,0,57856,22,8660954021
4857,38005341,15669915,53675256,8,0,1,5632,17,8380367276
4858,38006361,15671801,53678162,8,0,1,4608,17,3822998655
4859,38025509,15662737,53688246,1,0,1,30208,22,1894064872
4860,38027520,3843684,41871204,4,0,0,73216,29,6272390902
4861,38030019,4295100,42325119,1,0,0,16384,22,6203788936
4862,38036509,3810453,41846962,1,0,0,44032,22,9148562263
4863,38040111,15653281,53693392,8,0,1,8192,17,7888158215
4864,38048901,15645797,53694698,8,0,1,2048,17,7863256264
4865,38059641,15637643,53697284,8,0,1,4096,17,6521134335
4866,38064991,15632959,53697950,8,0,1,1024,17,5677182902
4867,38104039,3729453,41833492,1,0,0,26112,22,4457989600
4868,38105319,15626746,53732065,1,0,1,86016,22,6350259954
4869,38110691,15636040,53746731,8,0,1,16896,17,4786764515
4870,38115430,3814176,41929606,4,0,0,5632,29,1646014053
4871,38121699,15660596,53782295,7,0,1,47104,5,9185170218
4872,38139969,15661683,53801652,1,0,1,16896,22,2839142272
4873,38182911,15635079,53817990,8,0,1,9728,17,3378563279
4874,38186349,15781130,53967479,1,0,1,122368,22,10625477279
4875,38188890,3751308,41940198,2,0,0,23040,0,7196856441
4876,38194870,15783453,53978323,4,0,1,12288,29,6649531973
4877,38197389,3620559,41817948,2,0,0,1024,0,23157400
4878,38200751,15777918,53978669,8,0,1,512,17,5527225219
4879,38203110,3719810,41922920,2,0,0,65536,0,6895526269
4880,38220209,3805910,42026119,1,0,0,55808,22,5320010389
4881,38223630,15755295,53978925,4,0,1,9216,29,3737647208
4882,38226061,15783045,54009106,8,0,1,3584,17,8348226144
4883,38231730,3719411,41951141,4,0,0,35840,29,5370935609
4884,38242241,15767211,54009452,8,0,1,512,17,10130702586
4885,38251359,3597514,41848873,1,0,0,6144,22,2180723578
4886,38262870,3864673,42127543,2,0,0,125952,0,10173290783
4887,38269399,15781729,54051128,1,0,1,68608,22,3928902073
4888,38274229,15861327,54135556,1,0,1,40960,22,1477584458
4889,38280520,15858046,54138566,4,0,1,5120,29,2655208322
4890,38284319,3674027,41958346,1,0,0,9216,22,10085982306
4891,38285619,15852970,54138589,1,0,1,16896,22,6358372683
4892,38286270,15852342,54138612,4,0,1,1536,29,905663388
4893,38298730,15963653,54262383,6,0,1,141824,11,894852452
4894,38299320,15965969,54265289,4,0,1,4608,29,7191520303
4895,38300660,4127401,42428061,4,0,0,15360,29,3653952662
4896,38318431,15947204,54265635,8,0,1,512,17,5425180436
4897,38331930,15946375,54278305,4,0,1,8192,29,5190537959
4898,38359630,3791079,42150709,4,0,0,14336,29,3461437210
4899,38362779,15915549,54278328,5,0,1,8704,25,9029974011
4900,38366049,3720088,42086137,1,0,0,6144,22,4253310696
4901,38375760,3780652,42156412,4,0,0,16384,29,2302670495
4902,38379880,15898471,54278351,4,0,1,8704,29,982329929
4903,38385299,3812654,42197953,1,0,0,33280,22,192870439
4904,38388369,16018542,54406911,1,0,1,128512,22,8417050605
4905,38399930,16012127,54412057,4,0,1,8192,29,9600069529
4906,38411220,16004089,54415309,4,0,1,5120,29,5868411191
4907,38415561,16000721,54416282,8,0,1,12800,17,2439046657
4908,38420910,3885633,42306543,2,0,0,7168,0,3620105715
4909,38424640,3831330,42255970,4,0,0,14336,29,2408160930
4910,38440060,15976888,54416948,4,0,1,1024,29,5814347640
4911,38455260,3791774,42247034,2,0,0,6656,0,9687217498
4912,38462070,15956184,54418254,4,0,1,2048,29,7502295651
4913,38468340,15950580,54418920,4,0,1,1024,29,2224476877
4914,38480510,15939396,54419906,4,0,1,1536,29,5866376463
4915,38484539,15940028,54424567,5,0,1,5632,25,7795052298
4916,38494700,15931173,54425873,0,0,1,2048,9,1898783587
4917,38503480,15924339,54427819,4,0,1,3072,29,5091477306
4918,38509040,3702575,42211615,4,0,0,15872,29,4949070955
4919,38510380,15919065,54429445,4,0,1,2560,29,2268712576
4920,38520610,15909501,54430111,4,0,1,1024,29,3514078751
4921,38534841,15961541,54496382,8,0,1,11776,17,8759970294
4922,38552549,4045667,42598216,2,0,0,218624,0,9388142135
4923,38554241,15989867,54544108,8,0,1,15360,17,2427664680
4924,38563541,15980590,54544131,8,0,1,10752,17,1712368944
4925,38565569,15978585,54544154,5,0,1,3584,25,6457191374
4926,38568380,15975797,54544177,4,0,1,2048,29,7761765819
4927,38575249,15974129,54549378,5,0,1,5120,25,3525301942
4928,38592099,16090010,54682109,1,0,1,46592,22,8238025069
4929,38600359,16088894,54689253,1,0,1,61440,22,2404607731
4930,38600419,16093225,54693644,1,0,1,19968,22,8581053011
4931,38604230,4025706,42629936,2,0,0,4608,0,7987415728
4932,38607679,16163825,54771504,1,0,1,72704,22,2622985347
4933,38612639,16284903,54897542,1,0,1,146432,22,767120465
4934,38634899,16271711,54906610,5,0,1,9216,25,421708890
4935,38636470,16272086,54908556,0,0,1,3072,9,10704805296
4936,38639231,16296089,54935320,8,0,1,4096,17,2827886019
4937,38651871,16284009,54935880,8,0,1,3584,17,10021008214
4938,38663931,16271972,54935903,8,0,1,1536,17,3888862559
4939,38687459,16377701,55065160,1,0,1,175616,22,2976586351
4940,38697259,16372727,55069986,2,0,1,7680,0,4042212703
4941,38700650,3630787,42331437,2,0,0,2048,0,5708515079
4942,38708750,3731753,42440503,2,0,0,1536,0,3044518626
4943,38723550,3882707,42606257,2,0,0,26112,0,3966389931
4944,38725979,16348221,55074200,5,0,1,1536,25,6921136509
4945,38730401,16344465,55074866,8,0,1,1024,17,6150305010
4946,38731359,16344493,55075852,5,0,1,1536,25,10422242201
4947,38741309,16335209,55076518,1,0,1,1024,22,2219613199
4948,38741749,16335115,55076864,5,0,1,512,25,8604369544
4949,38748629,3872118,42620747,1,0,0,47104,22,4610684472
4950,38751939,16327191,55079130,5,0,1,3584,25,9881475597
4951,38757399,16325277,55082676,5,0,1,5632,25,6923643863
4952,38770459,16313203,55083662,5,0,1,1536,25,8895266706
4953,38770790,16313538,55084328,4,0,1,1024,29,10627501643
4954,38780349,16304543,55084892,1,0,1,10752,22,10166963458
4955,38785861,16299697,55085558,8,0,1,1024,17,5001575370
4956,38794010,16296720,55090730,4,0,1,8192,29,4782954806
4957,38806839,16284877,55091716,5,0,1,1536,25,1014044915
4958,38808059,3841756,42649815,1,0,0,1024,22,8876920662
4959,38815960,16278022,55093982,4,0,1,3584,29,1345337707
4960,38818790,3609629,42428419,2,0,0,1024,0,8259584841
4961,38822379,16290489,55112868,1,0,1,36864,22,7292638537
4962,38826311,16287543,55113854,8,0,1,1536,17,550585876
4963,38830289,3817390,42647679,1,0,0,4096,22,366886211
4964,38852691,16277840,55130531,8,0,1,8192,17,6291252182
4965,38860820,16277133,55137953,6,0,1,5120,11,10408830211
4966,38868810,16283874,55152684,4,0,1,3584,29,5943487705
4967,38870540,3866830,42737370,4,0,0,75776,29,3564822215
4968,38872280,16333340,55205620,6,0,1,59392,11,5527651234
4969,38875870,16372253,55248123,6,0,1,73216,11,6837027989
4970,38876489,16375500,55251989,5,0,1,6144,25,2194350579
4971,38880141,16372194,55252335,8,0,1,512,17,7256470719
4972,38901619,16353980,55255599,5,0,1,2560,25,6040554730
4973,38912360,16422721,55335081,6,0,1,40960,11,1471215188
4974,38919210,16512376,55431586,6,0,1,24576,11,994861425
4975,38924029,16539421,55463450,5,0,1,18944,25,8021989925
4976,38932910,3837870,42770780,2,0,0,2048,0,6040877202
4977,38932919,16530733,55463652,5,0,1,5632,25,6059424765
4978,38935520,3855536,42791056,2,0,0,512,0,2465751247
4979,38946980,3982991,42929971,4,0,0,134656,29,10463452448
4980,38947720,16615041,55562761,6,0,1,42496,11,3986859227
4981,38950240,16612982,55563222,4,0,1,10240,29,10679167359
4982,38977139,16624779,55601918,2,0,1,1536,0,1073746647
4983,38977180,16645816,55622996,6,0,1,12800,11,1189799989
4984,38985449,16662341,55647790,2,0,1,2560,0,497143326
4985,38988520,16747921,55736441,6,0,1,52736,11,5834089068
4986,38990601,16787179,55777780,8,0,1,1024,17,1092249237
4987,38997409,16795908,55793317,1,0,1,25088,22,5755072397
4988,39010299,16869852,55880151,2,0,1,4096,0,8666940398
4989,39018179,4147649,43165828,1,0,0,26112,22,7729098106
4990,39018980,16861841,55880821,6,0,1,36352,11,10514246014
4991,39026379,16898965,55925344,5,0,1,2560,25,10569922683
4992,39029630,17081655,56111285,6,0,1,89088,11,1871515373
4993,39036919,4111120,43148039,1,0,0,48128,22,6084268295
4994,39043559,17094525,56138084,5,0,1,7680,25,8595623381
4995,39055590,17082517,56138107,6,0,1,7168,11,1812475965
4996,39074879,3927942,43002821,2,0,0,512,0,10467293689
4997,39077050,17061080,56138130,9,0,1,16896,9,4841564609
4998,39077219,3717811,42795030,2,0,0,1024,0,5079166491
4999,39086789,17051364,56138153,1,0,1,13824,22,6202770743
5000,39087080,17082075,56169155,6,0,1,11776,11,7349160402
5001,39096159,3845696,42941855,2,0,0,1024,0,7956747822
5002,39111239,17077630,56188869,5,0,1,2048,25,5328108845
5003,39139679,3796913,42936592,2,0,0,1536,0,7901498472
5004,39157680,3731240,42888920,4,0,0,24576,29,864366448
5005,39176651,17012884,56189535,8,0,1,1024,17,6767461155
5006,39178970,3893504,43072474,4,0,0,31232,29,386158936
5007,39181701,17008820,56190521,8,0,1,1536,17,6105622129
5008,39185659,3753928,42939587,1,0,0,9728,22,5059746365
5009,39192320,3743781,42936101,4,0,0,9216,29,8392720126
5010,39204931,16989456,56194387,8,0,1,6144,17,7231541575
5011,39213699,3788943,43002642,2,0,0,97280,0,7006489745
5012,39217379,4136313,43353692,1,0,0,49664,22,4913733819
5013,39220309,3712961,42933270,1,0,0,10752,22,7327740782
5014,39224109,4040702,43264811,1,0,0,68096,22,2073924533
5015,39229650,3778812,43008462,4,0,0,3072,29,5809112500
5016,39243769,16951924,56195693,1,0,1,2048,22,5659732523
5017,39299049,3974365,43273414,1,0,0,28160,22,4071222050
5018,39342440,3958765,43301205,4,0,0,91136,29,7530809265
5019,39347039,16849115,56196154,1,0,1,10240,22,2671696220
5020,39386839,16884819,56271658,1,0,1,87040,22,2882250042
5021,39426640,3817400,43244040,2,0,0,76800,0,4583408035
5022,39444220,3735866,43180086,3,0,0,1024,25,391594902
5023,39448570,3981776,43430346,2,0,0,15872,0,254167536
5024,39455139,16923560,56378699,1,0,1,49152,22,5551890594
5025,39461590,16919375,56380965,4,0,1,3584,29,193452697
5026,39461960,3856303,43318263,4,0,0,55808,29,1388765521
5027,39464240,16917391,56381631,4,0,1,1024,29,2601781614
5028,39468359,16946475,56414834,1,0,1,38912,22,3418951136
5029,39468930,3965707,43434637,4,0,0,13312,29,7869078036
5030,39470009,17006481,56476490,1,0,1,61952,22,10366391938
5031,39490880,3914928,43405808,2,0,0,59392,0,4354723471
5032,39493600,16999334,56492934,4,0,1,4608,29,9100439490
5033,39498140,17001190,56499330,4,0,1,1024,29,442896993
5034,39499820,4009351,43509171,3,0,0,1024,25,2626533974
5035,39501039,17004295,56505334,1,0,1,20480,22,8409229587
5036,39508389,3709073,43217462,1,0,0,10240,22,5227911615
5037,39510070,3808380,43318450,3,0,0,512,25,249363859
5038,39521420,3680356,43201776,3,0,0,512,25,5349908862
5039,39533860,17022128,56555988,4,0,1,512,29,7893546435
5040,39551269,3874218,43425487,1,0,0,64512,22,8655190974
5041,39577550,16978461,56556011,4,0,1,9728,29,4263514580
5042,39643049,16942237,56585286,1,0,1,31232,22,208639623
5043,39659059,4256425,43915484,1,0,0,18944,22,520190347
5044,39666629,16972706,56639335,1,0,1,38912,22,6018690451
5045,39671650,16968199,56639849,4,0,1,5632,29,9500278306
5046,39703980,3946292,43650272,4,0,0,55808,29,3590720094
5047,39708420,3879906,43588326,2,0,0,75264,0,2174884158
5048,39710410,16930577,56640987,4,0,1,512,29,1730684582
5049,39714410,3780708,43495118,4,0,0,17408,29,7059258621
5050,39727760,3882936,43610696,3,0,0,512,25,9776680862
5051,39734680,16906330,56641010,4,0,1,2048,29,7577667393
5052,39750129,16986831,56736960,1,0,1,61440,22,8958181227
5053,39767680,3888458,43656138,4,0,0,5120,29,3671537741
5054,39770769,3882958,43653727,1,0,0,11264,22,3628699217
5055,39773030,16999702,56772732,4,0,1,2560,29,8775914191
5056,39773520,17092458,56865978,4,0,1,1024,29,5464293989
5057,39782470,3674870,43457340,3,0,0,1536,25,5439335438
5058,39783030,17082971,56866001,4,0,1,4096,29,1846247018
5059,39798600,3795388,43593988,4,0,0,8704,29,3341348874
5060,39816069,3775244,43591313,1,0,0,9728,22,6974865750
5061,39830639,17118846,56949485,1,0,1,93184,22,4029674048
5062,39850479,17211411,57061890,1,0,1,71168,22,1436989310
5063,39854220,17256758,57110978,4,0,1,8704,29,1271401043
5064,39862080,3965686,43827766,3,0,0,1024,25,9244127455
5065,39864940,17265705,57130645,0,0,1,3584,9,1465879914
5066,39891920,3802409,43694329,2,0,0,28160,0,4518249477
5067,39907820,3942004,43849824,4,0,0,12800,29,1902647355
5068,39914230,3704723,43618953,3,0,0,1024,25,6529834865
5069,39919859,3861414,43781273,1,0,0,17408,22,9619850412
5070,39934030,17213340,57147370,4,0,1,2560,29,10678567743
5071,39952880,17199298,57152178,4,0,1,4096,29,3661940851
5072,39960890,3948799,43909689,2,0,0,43520,0,6256512360
5073,39963420,4109296,44072716,4,0,0,8192,29,2587455107
5074,39973859,4167745,44141604,1,0,0,87552,22,7488376490
5075,39979980,17174144,57154124,4,0,1,3072,29,1315773476
5076,39980090,3792126,43772216,4,0,0,23552,29,10428484368
5077,39980749,3990317,43971066,1,0,0,30208,22,1649682385
5078,39984320,17170470,57154790,6,0,1,1024,11,649490158
5079,39986281,17173015,57159296,8,0,1,7168,17,9321190697
5080,39991840,4070012,44061852,4,0,0,90112,29,4193375844
5081,40013200,3963755,43976955,3,0,0,1024,25,5184190639
5082,40015700,17144582,57160282,4,0,1,1536,29,10725834902
5083,40027530,17135431,57162961,4,0,1,8704,29,6334228769
5084,40030110,3822582,43852692,3,0,0,2048,25,7090400600
5085,40063109,17101798,57164907,5,0,1,3072,25,10030515303
5086,40068830,3784625,43853455,3,0,0,512,25,5289704820
5087,40070670,17096503,57167173,6,0,1,3584,11,10297833610
5088,40081161,17093869,57175030,8,0,1,6144,17,9429318526
5089,40082830,4397647,44480477,4,0,0,104960,29,5269458147
5090,40084620,17108889,57193509,6,0,1,6144,11,4749068844
5091,40105251,17088604,57193855,8,0,1,512,17,4695843047
5092,40119759,3970522,44090281,1,0,0,15872,22,3823930246
5093,40122180,4237187,44359367,4,0,0,96768,29,8535316162
5094,40129930,3843953,43973883,3,0,0,1024,25,10673036975
5095,40133300,4066827,44200127,4,0,0,32768,29,8680769209
5096,40133780,4523129,44656909,4,0,0,70144,29,1070088007
5097,40134209,17069299,57203508,5,0,1,16384,25,4514522856
5098,40138430,17066704,57205134,6,0,1,2560,11,1840678677
5099,40140840,4002994,44143834,2,0,0,7168,0,6919268865
5100,40142189,3943046,44085235,1,0,0,40960,22,10139534845
5101,40150050,4001936,44151986,2,0,0,17920,0,8680439362
5102,40171589,3898577,44070166,1,0,0,27136,22,9150660727
5103,40187079,17032632,57219711,5,0,1,8192,25,8894898563
5104,40211990,3759255,43971245,3,0,0,512,25,530978272
5105,40219219,3785247,44004466,1,0,0,512,22,8619826297
5106,40226281,16993453,57219734,8,0,1,6144,17,3421822209
5107,40239220,4319617,44558837,2,0,0,22016,0,1027153901
5108,40239589,3971369,44210958,6,0,0,31744,11,5791289834
5109,40244840,17005589,57250429,6,0,1,6656,11,4084127858
5110,40244950,3840472,44085422,3,0,0,512,25,4765330434
5111,40248611,17002164,57250775,8,0,1,512,17,7308743738
5112,40260509,4231379,44491888,2,0,0,37376,0,4492209828
5113,40281930,4039662,44321592,3,0,0,512,25,5720339769
5114,40285309,17033517,57318826,7,0,1,38912,5,405108517
5115,40295340,4124759,44420099,2,0,0,87040,0,1985684474
5116,40295430,3873963,44169393,3,0,0,1024,25,9865767427
5117,40303311,17016821,57320132,8,0,1,2048,17,9884359299
5118,40324401,17018940,57343341,8,0,1,2048,17,362427516
5119,40329860,4395347,44725207,2,0,0,11264,0,7063017104
5120,40342361,17001182,57343543,8,0,1,512,17,3479735302
5121,40353080,4160455,44513535,3,0,0,1024,25,9978212771
5122,40358679,3956808,44315487,9,0,0,3584,9,8796635829
5123,40373100,3827206,44200306,3,0,0,512,25,3769229964
5124,40375969,4446949,44822918,6,0,0,17408,11,528553209
5125,40407561,16936005,57343566,8,0,1,2048,17,10606182054
5126,40412660,16930929,57343589,6,0,1,5120,11,2164203216
5127,40413860,16929752,57343612,6,0,1,2048,11,3769075286
5128,40414050,4677468,45091518,4,0,0,170496,29,10210752394
5129,40427659,4462243,44889902,1,0,0,61440,22,1523402491
5130,40435960,4073545,44509505,4,0,0,38912,29,10682384737
5131,40444470,3812460,44256930,3,0,0,1536,25,9917739129
5132,40461399,4219267,44680666,9,0,0,63488,9,2905993608
5133,40475649,3890132,44365781,2,0,0,19968,0,10516799170
5134,40479469,4033179,44512648,1,0,0,10240,22,9330612996
5135,40487450,3954643,44442093,2,0,0,4608,0,7091691186
5136,40489770,4167794,44657564,3,0,0,2048,25,6673488667
5137,40500179,3996591,44496770,2,0,0,14848,0,7259883064
5138,40503749,16908552,57412301,7,0,1,50688,5,9498634239
5139,40504620,16908987,57413607,9,0,1,2048,9,1753804152
5140,40515960,4110759,44626719,2,0,0,32768,0,7698551080
5141,40518280,16960530,57478810,9,0,1,40448,9,4634059449
5142,40559000,16923342,57482342,6,0,1,17408,11,1062296593
5143,40568250,16931917,57500167,4,0,1,1536,29,2430480878
5144,40569939,4301212,44871151,2,0,0,1536,0,7038544422
5145,40575759,4360833,44936592,9,0,0,97280,9,2479245714
5146,40589339,4046175,44635514,6,0,0,13312,11,2343961799
5147,40589540,4374768,44964308,4,0,0,28672,29,984493961
5148,40600350,16966502,57566852,4,0,1,4096,29,4920695354
5149,40602070,16964805,57566875,6,0,1,512,11,2959274644
5150,40605959,4264701,44870660,6,0,0,72704,11,9748321693
5151,40611339,16970736,57582075,7,0,1,28160,5,6491293595
5152,40613009,4204559,44817568,9,0,0,202752,9,6413869211
5153,40619470,4221723,44841193,2,0,0,59904,0,3436380485
5154,40624799,3867424,44492223,9,0,0,1024,9,8036683326
5155,40626669,4279527,44906196,6,0,0,49152,11,4395743693
5156,40639629,4251552,44891181,1,0,0,4096,22,5886848526
5157,40643170,4618344,45261514,2,0,0,78848,0,1002124078
5158,40656529,4457724,45114253,9,0,0,74240,9,3121546673
5159,40672130,16918885,57591015,9,0,1,4608,9,1898424505
5160,40673909,16941740,57615649,7,0,1,26112,5,8535166368
5161,40676519,16953683,57630202,5,0,1,3584,25,8844467065
5162,40677690,16952858,57630548,3,0,1,512,25,7415167360
5163,40678349,16952353,57630702,7,0,1,8704,5,5265908585
5164,40680000,4681439,45361439,3,0,0,1536,25,1359673237
5165,40686799,4032725,44719524,1,0,0,53760,22,9079709279
5166,40691060,16953820,57644880,6,0,1,3072,11,6325049007
5167,40698759,4497268,45196027,1,0,0,26112,22,8389227280
5168,40713750,4223045,44936795,3,0,0,512,25,5986319010
5169,40720420,4121599,44842019,3,0,0,2560,25,8058497309
5170,40726940,4820966,45547906,4,0,0,123904,29,9024744248
5171,40729339,4685773,45415112,1,0,0,10752,22,5025035585
5172,40742260,16904246,57646506,3,0,1,2560,25,3940806066
5173,40748350,16900742,57649092,3,0,1,4096,25,7273901113
5174,40751019,4413366,45164385,1,0,0,34304,22,7921814244
5175,40770730,16881908,57652638,6,0,1,5632,11,7591443167
5176,40770940,4077522,44848462,2,0,0,20992,0,9139208914
5177,40775030,16879234,57654264,6,0,1,2560,11,1953086126
5178,40778590,16882421,57661011,9,0,1,10240,9,4585478962
5179,40781650,16882907,57664557,3,0,1,5632,25,8300550639
5180,40794710,16876254,57670964,4,0,1,1536,29,7157009388
5181,40798529,4543364,45341893,9,0,0,105472,9,5146874428
5182,40799249,4498113,45297362,6,0,0,40448,11,10623618468
5183,40804120,16955222,57759342,9,0,1,2048,9,5646663505
5184,40813999,16945366,57759365,1,0,1,18432,22,2094633199
5185,40816370,16943026,57759396,3,0,1,7680,25,3532255926
5186,40822209,4462806,45285015,6,0,0,49664,11,10232103515
5187,40828830,4406981,45235811,3,0,0,1024,25,8227850848
5188,40837130,16922289,57759419,9,0,1,10240,9,4544808248
5189,40857250,16925927,57783177,9,0,1,15872,9,265391856
5190,40861529,4499419,45360948,1,0,0,62464,22,4306904022
5191,40864570,16941631,57806201,3,0,1,1024,25,10181332316
5192,40880000,16948274,57828274,3,0,1,12288,25,3150449199
5193,40902910,16925387,57828297,3,0,1,13824,25,845868737
5194,40906140,16937771,57843911,4,0,1,3072,29,8427600640
5195,40918800,4296622,45215422,3,0,0,1536,25,8669034794
5196,40921360,16926737,57848097,9,0,1,6656,9,351917033
5197,40924619,4519773,45444392,1,0,0,31232,22,3055909136
5198,40933430,16951772,57885202,6,0,1,10240,11,2635464532
5199,40943540,16958385,57901925,9,0,1,10240,9,6806531330
5200,40945730,16962855,57908585,9,0,1,7680,9,5267824496
5201,40952230,16956386,57908616,6,0,1,3072,11,6270824391
5202,40956599,4405799,45362398,9,0,0,3072,9,9694609034
5203,40964270,16945910,57910180,6,0,1,512,11,5934773458
5204,40967050,16944434,57911484,4,0,1,2048,29,1987521932
5205,40974790,16949123,57923913,3,0,1,7168,25,5674671992
5206,40975180,16960293,57935473,6,0,1,512,11,3638481115
5207,40976770,16995991,57972761,3,0,1,4096,25,7905032098
5208,40984339,16988445,57972784,1,0,1,5120,22,79005229
5209,40985260,4276433,45261693,2,0,0,512,0,6376216463
5210,41002210,16981800,57984010,3,0,1,1536,25,5101418915
5211,41003849,4622123,45625972,9,0,0,32768,9,5850829933
5212,41006440,4356137,45362577,3,0,0,512,25,7652786962
5213,41029130,4415441,45444571,3,0,0,512,25,6801362390
5214,41043999,4669448,45713447,1,0,0,3072,22,6224965406
5215,41051930,4811889,45863819,2,0,0,103936,0,7995486603
5216,41055370,4560572,45615942,4,0,0,83456,29,2208556582
5217,41060750,16956606,58017356,4,0,1,512,29,10306371211
5218,41064099,4812073,45876172,9,0,0,8192,9,4998350223
5219,41064519,4389238,45453757,1,0,0,13824,22,2890965205
5220,41081170,16936209,58017379,6,0,1,1536,11,4862661337
5221,41093030,4701445,45794475,4,0,0,14848,29,7570155183
5222,41106399,5122497,46228896,1,0,0,32768,22,8912083197
5223,41108949,4603539,45712488,1,0,0,61440,22,8428398920
5224,41111339,4884140,45995479,9,0,0,52224,9,3694015635
5225,41111930,16959935,58071865,4,0,1,14336,29,2170469295
5226,41131440,4656106,45787546,4,0,0,12800,29,4535801665
5227,41144999,4834545,45979544,9,0,0,141312,9,7954217232
5228,41145130,4948893,46094023,4,0,0,41472,29,10719652956
5229,41154690,16917198,58071888,3,0,1,1536,25,6957010622
5230,41161710,4497536,45659246,8,0,0,6144,17,8950497637
5231,41168379,4881107,46049486,6,0,0,177152,11,3479896397
5232,41172510,16899401,58071911,4,0,1,1024,29,1910805932
5233,41175530,16896404,58071934,4,0,1,1024,29,6770289256
5234,41179780,4693133,45872913,4,0,0,29184,29,6817707465
5235,41182410,16889547,58071957,3,0,1,4608,25,8606759006
5236,41183220,16888760,58071980,6,0,1,1536,11,7694004074
5237,41183350,4680648,45863998,2,0,0,512,0,2148142803
5238,41204760,16867243,58072003,3,0,1,6144,25,10595624521
5239,41208149,4664943,45873092,9,0,0,512,9,8006078104
5240,41217720,4855969,46073689,4,0,0,79360,29,5937886792
5241,41225639,5058059,46283698,9,0,0,134144,9,7670343146
5242,41227610,5121060,46348670,8,0,0,66048,17,8764899845
5243,41228470,5100007,46328477,2,0,0,120832,0,5760531616
5244,41232479,5408596,46641075,9,0,0,36352,9,10480753394
5245,41232820,16839206,58072026,3,0,1,4608,25,7901566271
5246,41235549,4845815,46081364,9,0,0,25088,9,10395246987
5247,41252679,4530944,45783623,9,0,0,2048,9,8562320421
5248,41258910,16813139,58072049,3,0,1,15872,25,9018661550
5249,41265979,4829213,46095192,1,0,0,3584,22,37926594
5250,41269680,16850069,58119749,4,0,1,1536,29,6807018288
5251,41277419,5450275,46727694,9,0,0,50176,9,140267013
5252,41280500,5200957,46481457,2,0,0,95232,0,9329580742
5253,41294231,16846774,58141005,8,0,1,9216,17,8004670091
5254,41297620,5052009,46349629,3,0,0,3072,25,5067203399
5255,41298270,5453285,46751555,3,0,0,1024,25,1257168386
5256,41299100,4636226,45935326,2,0,0,4608,0,9913802130
5257,41309060,4933743,46242803,2,0,0,45568,0,3271852889
5258,41309930,16873272,58183202,3,0,1,11776,25,6941372942
5259,41310219,4826962,46137181,9,0,0,35840,9,208439371
5260,41312859,5317109,46629968,2,0,0,103936,0,2451087358
5261,41315339,4810899,46126238,1,0,0,23040,22,7844609007
5262,41322809,5073175,46395984,9,0,0,152064,9,9991482582
5263,41324689,5507154,46831843,9,0,0,41472,9,5374733535
5264,41326080,16965025,58291105,4,0,1,2560,29,6646145641
5265,41327899,5158729,46486628,9,0,0,16896,9,4511970574
5266,41329880,5068623,46398503,4,0,0,8192,29,10550641093
5267,41340159,5102533,46442692,9,0,0,36352,9,9822554456
5268,41347089,5235409,46582498,1,0,0,100864,22,3446027780
5269,41349860,16941268,58291128,3,0,1,2560,25,3513953936
5270,41356070,16935081,58291151,4,0,1,512,29,7766933484
5271,41361189,5310672,46671861,9,0,0,14336,9,1222081382
5272,41362341,16928833,58291174,8,0,1,4608,17,5266604256
5273,41364110,5625640,46989750,2,0,0,71168,0,6008579567
5274,41365310,16925887,58291197,3,0,1,1536,25,9579707464
5275,41367320,5641340,47008660,3,0,0,512,25,9400873823
5276,41382879,5069508,46452387,6,0,0,31744,11,6535255709
5277,41384620,16906600,58291220,4,0,1,1024,29,1104127933
5278,41385510,5281952,46667462,2,0,0,86528,0,4964770641
5279,41387960,16903283,58291243,4,0,1,512,29,962006042
5280,41393721,16982887,58376608,8,0,1,15872,17,6711601294
5281,41395860,5023393,46419253,3,0,0,1024,25,5901524489
5282,41401780,16974851,58376631,4,0,1,3072,29,4938432467
5283,41402480,17123881,58526361,3,0,1,512,25,3254755712
5284,41403260,17125047,58528307,4,0,1,3072,29,4889085929
5285,41414891,17131776,58546667,8,0,1,7680,17,4535564479
5286,41418940,17127750,58546690,3,0,1,10240,25,10560781786
5287,41424309,5173968,46598277,9,0,0,51712,9,2133692609
5288,41424939,5252428,46677367,6,0,0,17920,11,2706335241
5289,41431270,5297071,46728341,3,0,0,2048,25,7377069738
5290,41436820,5264569,46701389,2,0,0,8704,0,5942204099
5291,41446800,17192412,58639212,4,0,1,2560,29,5589376670
5292,41453130,5298090,46751220,4,0,0,15360,29,5870030614
5293,41462269,5409838,46872107,6,0,0,7680,11,5068966681
5294,41462411,17177147,58639558,8,0,1,512,17,10657370382
5295,41466721,17177983,58644704,8,0,1,8192,17,5899912374
5296,41469460,17176519,58645979,3,0,1,512,25,8252695151
5297,41471749,5347435,46819184,6,0,0,78848,11,5639822376
5298,41474700,5525208,46999908,8,0,0,2560,17,8504717590
5299,41482340,5365328,46847668,8,0,0,51712,17,2701020547
5300,41490360,5192794,46683154,3,0,0,512,25,4007040610
5301,41495089,17153476,58648565,3,0,1,4096,25,8614215163
5302,41505699,5364027,46869726,1,0,0,25088,22,5555001833
5303,41511790,17137761,58649551,7,0,1,1536,5,5611447817
5304,41519370,5837426,47356796,4,0,0,2048,29,3162787655
5305,41527831,17124626,58652457,8,0,1,4608,17,9359702937
5306,41541781,17115233,58657014,8,0,1,2560,17,7117138088
5307,41542310,5240598,46782908,3,0,0,512,25,2670080498
5308,41543890,5787625,47331515,4,0,0,55808,29,702214779
5309,41549559,5764929,47314488,1,0,0,171008,22,3397498105
5310,41556879,5705482,47262361,1,0,0,223744,22,8093536656
5311,41557749,5620313,47178062,6,0,0,17408,11,2226341433
5312,41557750,17119422,58677172,6,0,1,512,11,2530746988
5313,41563499,17115939,58679438,3,0,1,3584,25,2859246459
5314,41564921,17114863,58679784,8,0,1,512,17,2925940486
5315,41568120,5439800,47007920,8,0,0,15872,17,2442429664
5316,41572360,5944630,47516990,8,0,0,66048,17,7754428103
5317,41576790,5562520,47139310,4,0,0,45056,29,4205747527
5318,41596611,17084479,58681090,8,0,1,2048,17,763632426
5319,41610290,17072426,58682716,6,0,1,2560,11,5193101796
5320,41621200,17064422,58685622,4,0,1,4608,29,6843035420
5321,41622629,5732090,47354719,1,0,0,4608,22,7771654180
5322,41628331,17167870,58796201,8,0,1,8192,17,7171310256
5323,41628520,5544215,47172735,8,0,0,43520,17,487749669
5324,41636980,5765073,47402053,8,0,0,4608,17,7714920115
5325,41641620,5982824,47624444,2,0,0,175616,0,3914973277
5326,41648179,5705082,47353261,1,0,0,22016,22,759623915
5327,41653490,6007105,47660595,2,0,0,113152,0,7454487823
5328,41654709,17141515,58796224,3,0,1,2048,25,2374681574
5329,41661681,17152073,58813754,8,0,1,6656,17,8267381266
5330,41671280,17142827,58814107,4,0,1,6144,29,8966433248
5331,41674869,5809615,47484484,1,0,0,102400,22,2809079551
5332,41686569,5659945,47346514,6,0,0,49152,11,9848835471
5333,41697520,5791043,47488563,4,0,0,13312,29,4340112932
5334,41701469,17113304,58814773,7,0,1,1024,5,8255455640
5335,41703719,17113000,58816719,3,0,1,3072,25,7575346156
5336,41711200,5827965,47539165,2,0,0,72704,0,6678775751
5337,41724800,5714445,47439245,4,0,0,13824,29,7886678919
5338,41733600,6130218,47863818,8,0,0,67584,17,3495483165
5339,41739070,17166509,58905579,4,0,1,4096,29,6336563544
5340,41739379,5800753,47540132,6,0,0,3072,11,3254817575
5341,41741859,5884168,47626027,6,0,0,5120,11,8311555606
5342,41743810,17208505,58952315,4,0,1,22528,29,5078023569
5343,41748270,17204068,58952338,6,0,1,8192,11,6882044153
5344,41750299,17202062,58952361,7,0,1,9728,5,2258036363
5345,41752090,5929475,47681565,8,0,0,32256,17,821545072
5346,41754281,17226445,58980726,8,0,1,2048,17,3027731868
5347,41759830,17220919,58980749,4,0,1,4096,29,9508400371
5348,41763050,5904744,47667794,4,0,0,23552,29,5932447162
5349,41771529,17215689,58987218,3,0,1,5632,25,9459761793
5350,41775040,6009512,47784552,8,0,0,40448,17,1192509278
5351,41782569,17441239,59223808,2,0,1,13824,0,2597191909
5352,41787940,17435891,59223831,6,0,1,512,11,1964672856
5353,41810349,17414610,59224959,3,0,1,4096,25,9220775612
5354,41811890,17418215,59230105,4,0,1,8192,29,10337867348
5355,41816861,17413398,59230259,8,0,1,8704,17,2435440230
5356,41818071,17735643,59553714,8,0,1,6656,17,9032217133
5357,41821919,17731818,59553737,2,0,1,2048,0,7203152102
5358,41825090,17728670,59553760,4,0,1,2048,29,9920848468
5359,41826331,17740111,59566442,8,0,1,7168,17,8180374922
5360,41830370,17736095,59566465,3,0,1,3584,25,88530392
5361,41830559,17735929,59566488,3,0,1,3072,25,7206767226
5362,41834460,17732051,59566511,6,0,1,1536,11,9637732413
5363,41835460,17731074,59566534,4,0,1,2048,29,3659926095
5364,41847579,6073186,47920765,9,0,0,20992,9,7775548028
5365,41847729,6208360,48056089,1,0,0,38912,22,3495346144
5366,41848760,17717797,59566557,6,0,1,2560,11,3747023932
5367,41857030,6343745,48200775,3,0,0,512,25,8856548550
5368,41866409,17846927,59713336,2,0,1,7680,0,10389159633
5369,41866780,6772114,48638894,4,0,0,2048,29,361814296
5370,41869510,17889442,59758952,0,0,1,2560,9,2297344400
5371,41877290,17883928,59761218,3,0,1,3584,25,5461901937
5372,41880269,17916122,59796391,2,0,1,3584,0,2057205885
5373,41891119,6447037,48338156,9,0,0,12800,9,1102651542
5374,41891439,17946852,59838291,7,0,1,1536,5,8500637426
5375,41897520,17940794,59838314,4,0,1,2560,29,4618166974
5376,41901130,17937207,59838337,3,0,1,3584,25,4686599298
5377,41903319,6387250,48290569,1,0,0,9728,22,9180020484
5378,41917360,17921000,59838360,3,0,1,7168,25,1814775195
5379,41918019,6329974,48247993,9,0,0,1536,9,7275376682
5380,41928569,6694362,48622931,6,0,0,27648,11,4640140329
5381,41934140,17904243,59838383,6,0,1,2560,11,3089275884
5382,41935929,6087770,48023699,1,0,0,2048,22,4928426563
5383,41935990,6336481,48272471,8,0,0,22016,17,8372473711
5384,41937590,17933957,59871547,4,0,1,512,29,7014705529
5385,41947429,6229432,48176861,1,0,0,47104,22,8067278202
5386,41948570,6281415,48229985,4,0,0,45568,29,5229024752
5387,41949799,17931649,59881448,3,0,1,13824,25,4187027225
5388,41955159,7415500,49370659,1,0,0,15872,22,1919420072
5389,41968039,6646399,48614438,1,0,0,162816,22,5068769296
5390,41968700,17913004,59881704,0,0,1,9216,9,10065647099
5391,41972359,17910011,59882370,3,0,1,1024,25,4582796782
5392,41976789,6722556,48699345,1,0,0,20480,22,2567222576
5393,41977600,6222996,48200596,2,0,0,77824,0,9676206042
5394,41979569,17905707,59885276,2,0,1,4608,0,6424897479
5395,41989890,17895540,59885430,0,0,1,8704,9,2934440474
5396,41995520,17900678,59896198,0,0,1,2560,9,4931900681
5397,42000579,17896605,59897184,3,0,1,1536,25,665037140
5398,42001799,17931029,59932828,7,0,1,8704,5,4749245492
5399,42002439,18031613,60034052,3,0,1,3072,25,5195969241
5400,42005000,18029075,60034075,6,0,1,2560,11,9431231664
5401,42008430,6254997,48263427,8,0,0,29696,17,2428739718
5402,42017160,18016938,60034098,4,0,1,9728,29,1086136797
5403,42026210,6538597,48564807,8,0,0,138752,17,1086481105
5404,42027319,6443417,48470736,1,0,0,36352,22,17476548
5405,42036939,6241639,48278578,6,0,0,19968,11,9548467703
5406,42037510,18209254,60246764,4,0,1,18944,29,2795136919
5407,42037849,6305959,48343808,1,0,0,6144,22,7072114038
5408,42041929,18305987,60347916,2,0,1,3584,0,1512536319
5409,42045559,18305903,60351462,2,0,1,5632,0,10291354563
5410,42058559,18296129,60354688,2,0,1,5120,0,4814491703
5411,42066380,18330021,60396401,0,0,1,8192,9,2234391721
5412,42067629,18582795,60650424,3,0,1,20480,25,2456775751
5413,42074210,6668208,48742418,8,0,0,47616,17,2902775288
5414,42086119,18564328,60650447,7,0,1,2560,5,10187401274
5415,42088790,18570603,60659393,6,0,1,3584,11,4204731409
5416,42092740,18566676,60659416,6,0,1,1536,11,5660959185
5417,42095569,18563870,60659439,2,0,1,2560,0,6597058857
5418,42101019,6219918,48320937,1,0,0,25088,22,3725026992
5419,42103300,6534410,48637710,4,0,0,48128,29,5739165656
5420,42104380,18555114,60659494,4,0,1,4608,29,8794435453
5421,42112840,18546677,60659517,6,0,1,2048,11,6080441496
5422,42118540,6784558,48903098,8,0,0,144896,17,2447776228
5423,42118899,18540641,60659540,2,0,1,2048,0,7162563545
5424,42128049,18531514,60659563,3,0,1,512,25,9916866388
5425,42130300,18529286,60659586,6,0,1,12288,11,8568524386
5426,42144289,18641695,60785984,2,0,1,3584,0,6226684420
5427,42149649,18637001,60786650,2,0,1,1024,0,9893541047
5428,42152169,6490648,48642817,6,0,0,12800,11,4756806827
5429,42157249,6316474,48473723,6,0,0,9728,11,4794878333
5430,42157789,18727759,60885548,3,0,1,512,25,2975909652
5431,42162290,6183300,48345590,3,0,0,512,25,8845558373
5432,42162400,18725414,60887814,4,0,1,3584,29,8812621384
5433,42166319,18775082,60941401,2,0,1,7680,0,3094326216
5434,42172940,6261258,48434198,4,0,0,14336,29,1627600007
5435,42177710,18768885,60946595,6,0,1,15872,11,5860078409
5436,42179460,6918566,49098026,8,0,0,47616,17,6597702037
5437,42180240,18914545,61094785,6,0,1,2048,11,1933109101
5438,42180639,6770555,48951194,1,0,0,39936,22,3421537759
5439,42181129,6473465,48654594,9,0,0,38400,9,1066242996
5440,42181740,18913068,61094808,6,0,1,7680,11,2859865615
5441,42199469,6731934,48931403,6,0,0,41472,11,7024093303
5442,42208440,18886570,61095010,6,0,1,1024,11,7251588791
5443,42212460,18900810,61113270,6,0,1,512,11,9142928700
5444,42217129,6641798,48858927,9,0,0,53248,9,516112071
5445,42221369,6697375,48918744,1,0,0,44544,22,857887244
5446,42224259,7326479,49550738,6,0,0,163328,11,4137071205
5447,42242120,6800932,49043052,2,0,0,18432,0,6109844604
5448,42242160,18873056,61115216,4,0,1,3072,29,10599440652
5449,42243899,6942148,49186047,9,0,0,3072,9,3383444995
5450,42251300,6832179,49083479,8,0,0,132608,17,4830284991
5451,42257490,6500551,48758041,8,0,0,51200,17,3521388890
5452,42262400,18961376,61223776,0,0,1,2048,9,7740396325
5453,42266159,18957640,61223799,2,0,1,6144,0,7630374228
5454,42270409,6661797,48932206,6,0,0,2560,11,6330730746
5455,42282740,7197284,49480024,2,0,0,110080,0,8439593122
5456,42291840,7310056,49601896,4,0,0,11264,29,81828222
5457,42311470,6326731,48638201,3,0,0,1536,25,9732115826
5458,42313310,7383881,49697191,4,0,0,16384,29,9429460914
5459,42313599,6720960,49034559,1,0,0,52736,22,3080129676
5460,42320389,6584760,48905149,1,0,0,6656,22,2586170118
5461,42320630,7007793,49328423,8,0,0,89600,17,8835025183
5462,42349830,6666738,49016568,2,0,0,25600,0,10280789662
5463,42356959,18889038,61245997,2,0,1,5632,0,7501892140
5464,42376660,6658390,49035050,3,0,0,1536,25,107396962
5465,42382370,6756039,49138409,4,0,0,29184,29,10171545773
5466,42387989,6968233,49356222,6,0,0,91136,11,9603387464
5467,42388339,6649074,49037413,6,0,0,7680,11,9047004922
5468,42396069,18849951,61246020,2,0,1,1024,0,9677104525
5469,42398940,18983771,61382711,4,0,1,11776,29,9427316810
5470,42404460,18980197,61384657,4,0,1,3072,29,2195180367
5471,42415790,6392157,48807947,3,0,0,2048,25,981768824
5472,42424320,6781645,49205965,3,0,0,1536,25,7076150717
5473,42425879,6538720,48964599,6,0,0,9728,11,2369567540
5474,42437420,6678805,49116225,2,0,0,2048,0,1581029873
5475,42446069,6839720,49285789,6,0,0,104448,11,8889682749
5476,42470570,18917633,61388203,4,0,1,5632,29,671066626
5477,42473669,7027282,49500951,1,0,0,68608,22,6855273094
5478,42479689,6765330,49245019,6,0,0,57344,11,10523375636
5479,42480249,6885543,49365792,9,0,0,18944,9,9318062034
5480,42500840,6483597,48984437,8,0,0,2048,17,683068555
5481,42513180,18877929,61391109,4,0,1,4608,29,8239108431
5482,42523129,18893198,61416327,2,0,1,2560,0,6641894216
5483,42527099,18889251,61416350,2,0,1,5632,0,8949197530
5484,42533549,6720385,49253934,1,0,0,29184,22,5164779455
5485,42537869,7060572,49598441,9,0,0,51712,9,9553794664
5486,42548489,7198368,49746857,1,0,0,25088,22,7038451815
5487,42550950,7031712,49582662,8,0,0,35840,17,1270453211
5488,42554930,6805067,49359997,2,0,0,12288,0,162840636
5489,42564850,6857736,49422586,4,0,0,33280,29,1585649498
5490,42568559,18888716,61457275,1,0,1,40960,22,8352825024
5491,42571229,18930716,61501945,2,0,1,7680,0,5007196205
5492,42584550,6583355,49167905,2,0,0,2048,0,9675545222
5493,42589640,6790937,49380577,8,0,0,12800,17,9527397803
5494,42612549,6688551,49301100,6,0,0,50176,11,3519422210
5495,42615010,6822543,49437553,2,0,0,32768,0,7166083928
5496,42617849,7316742,49934591,6,0,0,33792,11,10373102693
5497,42626419,18956915,61583334,2,0,1,22528,0,3143068379
5498,42630329,19319634,61949963,1,0,1,82944,22,6850269997
5499,42633869,6737281,49371150,1,0,0,1536,22,7453313282
5500,42636429,19316411,61952840,1,0,1,11776,22,488088749
5501,42639319,6932392,49571711,1,0,0,33792,22,7421825269
5502,42652779,19327016,61979795,2,0,1,4096,0,10424662737
5503,42656430,7082760,49739190,4,0,0,31232,29,2185427009
5504,42660499,6900714,49561213,6,0,0,34304,11,1266031777
5505,42666710,6982437,49649147,3,0,0,512,25,2505431835
5506,42668919,19311429,61980348,2,0,1,3584,0,776082463
5507,42671059,7118143,49789202,6,0,0,17920,11,2023497828
5508,42682450,19297929,61980379,9,0,1,2560,9,5991489439
5509,42684919,19395697,62080616,1,0,1,83456,22,4518661349
5510,42691649,7035583,49727232,9,0,0,6144,9,8382429366
5511,42692589,19388050,62080639,2,0,1,7680,0,1151184110
5512,42694989,19459008,62153997,1,0,1,20992,22,1372913081
5513,42702069,19591332,62293401,1,0,1,60928,22,10554925277
5514,42706099,7077285,49783384,1,0,0,119808,22,136079905
5515,42717879,6931089,49648968,1,0,0,17920,22,8699314427
5516,42721329,7080688,49802017,1,0,0,41984,22,4104912686
5517,42727550,7056169,49783719,3,0,0,1024,25,3462872900
5518,42729429,19580477,62309906,7,0,1,512,5,812163356
5519,42747220,6814172,49561392,3,0,0,512,25,790908054
5520,42747489,19563711,62311200,2,0,1,2560,0,2666918220
5521,42748149,19563877,62312026,2,0,1,8192,0,10501662343
5522,42757369,7061866,49819235,6,0,0,8192,11,6248123882
5523,42758869,19553180,62312049,2,0,1,4096,0,7529629630
5524,42758989,19553083,62312072,2,0,1,512,0,4832821468
5525,42759820,7069594,49829414,2,0,0,24576,0,6405735317
5526,42760869,7219117,49979986,1,0,0,51712,22,998448362
5527,42778759,19533336,62312095,7,0,1,512,5,5712523145
5528,42781439,7027908,49809347,9,0,0,23552,9,1917255148
5529,42782359,19585430,62367789,2,0,1,13824,0,308743574
5530,42784479,19585576,62370055,7,0,1,3584,5,9767437541
5531,42795671,19645474,62441145,8,0,1,23040,17,4832050347
5532,42806149,19635019,62441168,2,0,1,512,0,5312507551
5533,42822299,7141908,49964207,1,0,0,53248,22,215504310
5534,42824719,7259444,50084163,9,0,0,11264,9,3669042730
5535,42826809,7616962,50443771,1,0,0,132096,22,4522424653
5536,42841190,7204467,50045657,4,0,0,29184,29,171441046
5537,42843859,7386343,50230202,9,0,0,30720,9,4457566731
5538,42844039,19597152,62441191,2,0,1,1536,0,4619692955
5539,42845709,7320840,50166549,6,0,0,48640,11,2542663653
5540,42847279,7140182,49987461,1,0,0,3072,22,4731160671
5541,42851720,7735962,50587682,8,0,0,30208,17,7232413417
5542,42857020,7988114,50845134,4,0,0,165376,29,2905904107
5543,42872619,7112070,49984689,1,0,0,15360,22,6454817339
5544,42873309,19567905,62441214,5,0,1,4608,25,3939825054
5545,42875409,19565828,62441237,5,0,1,8192,25,8639499229
5546,42880069,7339589,50219658,9,0,0,55296,9,8762118816
5547,42885001,19556259,62441260,8,0,1,1024,17,1965190614
5548,42890389,19551229,62441618,2,0,1,5632,0,5333445100
5549,42897509,19595066,62492575,5,0,1,17408,25,10455139403
5550,42898220,7150580,50048800,6,0,0,10240,11,5937687648
5551,42908959,19639029,62547988,7,0,1,1536,5,10135269118
5552,42922250,7574970,50497220,4,0,0,6656,29,1546075150
5553,42933049,7116554,50049603,6,0,0,2560,11,2405813663
5554,42940700,7137397,50078097,3,0,0,1024,25,3595301331
5555,42943469,8116355,51059824,9,0,0,161792,9,8308245452
5556,42978120,7569228,50547348,4,0,0,13824,29,7049289619
5557,42981020,7113384,50094404,3,0,0,512,25,2414266046
5558,42981339,7295128,50276467,1,0,0,12288,22,1528249427
5559,42982319,19569092,62551411,7,0,1,13312,5,7863161644
5560,42986479,7137781,50124260,9,0,0,2048,9,8166855304
5561,42990810,7081088,50071898,3,0,0,2560,25,7286654230
5562,42999929,19555028,62554957,2,0,1,5632,0,5969062630
5563,43000360,7230021,50230381,3,0,0,512,25,6662512638
5564,43013330,7177252,50190582,3,0,0,1024,25,3826504308
5565,43017460,19592094,62609554,6,0,1,512,11,9015427471
5566,43020340,19589237,62609577,6,0,1,1024,11,1225285239
5567,43023640,19585960,62609600,9,0,1,4608,9,9608375047
5568,43027289,19584229,62611518,2,0,1,15360,0,907930278
5569,43036390,7437847,50474237,4,0,0,26112,29,10299966585
5570,43039340,7181433,50220773,3,0,0,3584,25,5780120775
5571,43042330,7477538,50519868,2,0,0,4096,0,3819591181
5572,43045730,19565811,62611541,6,0,1,2560,11,1939525355
5573,43045960,19570307,62616267,9,0,1,15360,9,321767529
5574,43047209,19584224,62631433,2,0,1,7680,0,3366716349
5575,43049180,7469417,50518597,8,0,0,31744,17,4431669803
5576,43052659,19604659,62657318,5,0,1,2560,25,4536538179
5577,43057409,19826495,62883904,1,0,1,83456,22,6096175786
5578,43059720,7785749,50845469,3,0,0,1024,25,937770259
5579,43064470,19839019,62903489,6,0,1,1536,11,7804647413
5580,43076660,7578270,50654930,2,0,0,89600,0,1371822320
5581,43078330,7387928,50466258,4,0,0,73728,29,9400254059
5582,43078899,7807649,50886548,6,0,0,12288,11,10339489182
5583,43082739,19820773,62903512,1,0,1,14336,22,7349535930
5584,43085170,7414413,50499583,8,0,0,7680,17,2685478235
5585,43092520,19830249,62922769,6,0,1,10240,11,314462107
5586,43093769,7571576,50665345,1,0,0,22528,22,7657802103
5587,43099969,8184577,51284546,6,0,0,59904,11,1870988420
5588,43105349,7689374,50794723,9,0,0,84992,9,2268928891
5589,43109520,19813272,62922792,0,0,1,512,9,7778171472
5590,43113220,7647106,50760326,8,0,0,27648,17,6258792304
5591,43119729,7736839,50856568,6,0,0,36352,11,9643129763
5592,43120769,8007538,51128307,6,0,0,62976,11,2547903753
5593,43122140,7402008,50524148,3,0,0,2048,25,10061848899
5594,43125960,19796855,62922815,0,0,1,2560,9,10210446743
5595,43128580,19794258,62922838,0,0,1,512,9,1338356022
5596,43134761,19788100,62922861,8,0,1,512,17,6927167633
5597,43142221,19780663,62922884,8,0,1,1024,17,2647847668
5598,43142559,19801458,62944017,2,0,1,7680,0,4496873178
5599,43144369,7512768,50657137,9,0,0,7168,9,2100007698
5600,43146480,8261477,51407957,8,0,0,27648,17,8401689568
5601,43152091,19945397,63097488,8,0,1,512,17,8675612732
5602,43158030,7747136,50905166,2,0,0,46592,0,4902604488
5603,43163840,7552490,50716330,4,0,0,12288,29,6379354743
5604,43186100,19912694,63098794,0,0,1,2048,9,8507191232
5605,43187759,19913301,63101060,2,0,1,3584,0,7566996657
5606,43192359,7697332,50889691,6,0,0,10240,11,7673972616
5607,43194990,19908682,63103672,0,0,1,14336,9,1493277642
5608,43210890,20003138,63214028,0,0,1,3072,9,7989019959
5609,43220199,8154636,51374835,1,0,0,3584,22,1973463039
5610,43222650,7650835,50873485,4,0,0,24576,29,667031843
5611,43222730,7377490,50600220,4,0,0,1536,29,5574553452
5612,43227270,19986781,63214051,0,0,1,512,9,6104500457
5613,43229789,7699419,50929208,6,0,0,36352,11,1372808617
5614,43231120,7634831,50865951,4,0,0,30720,29,5057802158
5615,43231711,20013522,63245233,8,0,1,4608,17,8134842143
5616,43259070,8124742,51383812,2,0,0,17920,0,8875934853
5617,43260810,7822416,51083226,3,0,0,512,25,8830308818
5618,43263390,8245646,51509036,8,0,0,54784,17,5128841706
5619,43264930,7503843,50768773,2,0,0,27648,0,10538573597
5620,43267079,19978177,63245256,2,0,1,1536,0,3162445990
5621,43269929,19975350,63245279,5,0,1,6656,25,10010977114
5622,43271030,7602821,50873851,3,0,0,1024,25,6689247353
5623,43279351,20086381,63365732,8,0,1,5632,17,5786799703
5624,43289050,7958017,51247067,2,0,0,58880,0,8315163275
5625,43292229,20073526,63365755,2,0,1,1024,0,7598072854
5626,43303219,7707286,51010505,9,0,0,143360,9,5152325655
5627,43303549,7763162,51066711,1,0,0,22528,22,5208123710
5628,43307880,8082998,51390878,2,0,0,22016,0,3846628249
5629,43331359,7959762,51291121,6,0,0,21504,11,494659448
5630,43336310,7543657,50879967,3,0,0,1024,25,4665043488
5631,43339000,7890104,51229104,2,0,0,147456,0,6370077790
5632,43342301,20023656,63365957,8,0,1,3584,17,8603089228
5633,43346430,8026955,51373385,3,0,0,1024,25,5699159179
5634,43348849,20082517,63431366,2,0,1,3072,0,9855299967
5635,43350429,8185071,51535500,6,0,0,512,11,1948286988
5636,43350939,7905355,51256294,6,0,0,30208,11,7161612663
5637,43387890,7962650,51350540,8,0,0,71680,17,8557488476
5638,43388060,20060789,63448849,9,0,1,512,9,4903807971
5639,43391559,7927331,51318890,6,0,0,29184,11,7212355827
5640,43391630,8143660,51535290,4,0,0,86016,29,7614158658
5641,43391910,8196276,51588186,2,0,0,5120,0,9202652153
5642,43397720,7976000,51373720,2,0,0,1024,0,944103347
5643,43401150,20048365,63449515,0,0,1,1024,9,1618978045
5644,43406690,7756946,51163636,3,0,0,1024,25,4169216040
5645,43408080,7964970,51373050,2,0,0,60416,0,438492453
5646,43412640,20037541,63450181,9,0,1,11264,9,3630227194
5647,43414660,8337627,51752287,8,0,0,50176,17,464480259
5648,43416999,20278971,63695970,1,0,1,59904,22,3866556365
5649,43419830,20276163,63695993,9,0,1,512,9,462019981
5650,43423239,7952711,51375950,1,0,0,3584,22,8571520301
5651,43434770,7960256,51395026,2,0,0,13312,0,8086882665
5652,43436701,20259315,63696016,8,0,1,3584,17,8017593347
5653,43439291,20299754,63739045,8,0,1,8192,17,9718126766
5654,43439600,20299468,63739068,9,0,1,3072,9,9365507866
5655,43468820,7915327,51384147,3,0,0,1024,25,8493892075
5656,43474199,7904122,51378321,9,0,0,7680,9,6369437153
5657,43477470,7877149,51354619,2,0,0,13312,0,8446407749
5658,43484039,20255052,63739091,7,0,1,512,5,2024102408
5659,43489979,7941769,51431748,1,0,0,4096,22,9427411519
5660,43493090,20264626,63757716,0,0,1,4096,9,8672540823
5661,43507229,8197111,51704340,1,0,0,53248,22,4275746464
5662,43513040,20304547,63817587,9,0,1,2560,9,18507263
5663,43513330,8399068,51912398,4,0,0,42496,29,8796443570
5664,43527289,8052701,51579990,6,0,0,9216,11,3920533954
5665,43532209,8007526,51539735,9,0,0,13824,9,4440261615
5666,43534939,8115466,51650405,6,0,0,56832,11,4784040699
5667,43535860,20283353,63819213,0,0,1,2560,9,9106062754
5668,43541340,8481950,52023290,2,0,0,13312,0,4873421330
5669,43546610,20308564,63855174,0,0,1,5120,9,261823802
5670,43550260,20304937,63855197,4,0,1,12800,29,8343668130
5671,43552991,20328483,63881474,8,0,1,6656,17,2885284404
5672,43553199,8346228,51899427,9,0,0,90112,9,7757087271
5673,43553830,8150689,51704519,3,0,0,512,25,10401838102
5674,43560500,9015261,52575761,8,0,0,8704,17,3443597334
5675,43582710,8003893,51586603,2,0,0,17408,0,9706860381
5676,43594659,8062450,51657109,9,0,0,10752,9,2956311632
5677,43607869,7994756,51602625,6,0,0,3584,11,2149472923
5678,43617490,8015553,51633043,8,0,0,28672,17,776627813
5679,43621279,8305553,51926832,1,0,0,32768,22,6293464078
5680,43625620,8175325,51800945,4,0,0,52224,29,8976630358
5681,43627810,8157200,51785010,4,0,0,12800,29,1007666045
5682,43633640,8385502,52019142,4,0,0,45568,29,4938035468
5683,43637599,20281440,63919039,3,0,1,2560,25,3167987122
5684,43651749,8265076,51916825,9,0,0,13824,9,1052235473
5685,43653799,20265263,63919062,3,0,1,512,25,7313733768
5686,43655139,8125948,51781087,9,0,0,33792,9,7615085575
5687,43655231,20263854,63919085,8,0,1,8192,17,10702147782
5688,43663669,20255439,63919108,3,0,1,7680,25,8013637152
5689,43663799,20283638,63947437,5,0,1,22016,25,6677099363
5690,43667640,8437837,52105477,8,0,0,23040,17,1958274202
5691,43678389,8286692,51965081,1,0,0,34304,22,1089862144
5692,43678911,20268549,63947460,8,0,1,3584,17,10191779458
5693,43680529,8781343,52461872,9,0,0,20480,9,7439027424
5694,43681609,20265874,63947483,5,0,1,1536,25,6735448846
5695,43686099,20261407,63947506,5,0,1,4608,25,607756100
5696,43693329,8442435,52135764,1,0,0,99328,22,7374628469
5697,43694159,20280630,63974789,1,0,1,29184,22,9827420784
5698,43700519,8476427,52176946,6,0,0,93696,11,700192986
5699,43701451,20292707,63994158,8,0,1,8704,17,2446796997
5700,43703581,20327521,64031102,8,0,1,3584,17,3016023324
5701,43706739,20332767,64039506,3,0,1,8192,25,2887898784
5702,43709159,20342841,64052000,5,0,1,10240,25,7521428993
5703,43719419,20333947,64053366,3,0,1,512,25,1329014563
5704,43723359,8350239,52073598,1,0,0,62976,22,7031840978
5705,43723469,20332483,64055952,5,0,1,4096,25,9188285509
5706,43724829,20373823,64098652,1,0,1,18944,22,3929988850
5707,43726370,8265222,51991592,8,0,0,36352,17,2088286111
5708,43731131,20475043,64206174,8,0,1,3072,17,3896739985
5709,43753469,20493456,64246925,5,0,1,11776,25,1209259099
5710,43754139,20493452,64247591,5,0,1,1024,25,6275311235
5711,43758160,8419160,52177320,2,0,0,1024,0,10233541236
5712,43764149,20487308,64251457,3,0,1,6144,25,5543203887
5713,43764829,20547680,64312509,1,0,1,36352,22,8767508458
5714,43765049,20792758,64557807,1,0,1,62464,22,177320800
5715,43773639,20893523,64667162,5,0,1,1536,25,4378831378
5716,43776639,8371690,52148329,9,0,0,31232,9,7802443979
5717,43780181,20887004,64667185,8,0,1,10752,17,9885127775
5718,43787679,20897047,64684726,5,0,1,1536,25,2710722284
5719,43788509,20896240,64684749,3,0,1,8704,25,9420624727
5720,43793940,8236568,52030508,2,0,0,512,0,4636378339
5721,43801909,20882871,64684780,5,0,1,1024,25,9317806273
5722,43802429,8278859,52081288,6,0,0,25088,11,1798453829
5723,43804601,20880202,64684803,8,0,1,12288,17,1572075429
5724,43817879,8754716,52572595,6,0,0,70144,11,6207716469
5725,43819261,20926243,64745504,8,0,1,13824,17,4806425256
5726,43825539,8392126,52217665,9,0,0,20992,9,9798012082
5727,43826650,20919212,64745862,6,0,1,6144,11,9691748803
5728,43836730,8214160,52050890,2,0,0,1536,0,2245197759
5729,43841859,8488400,52330259,1,0,0,52736,22,112219128
5730,43845860,8504078,52349938,4,0,0,64512,29,8870291299
5731,43848001,20897884,64745885,8,0,1,12288,17,807509587
5732,43853550,8602059,52455609,8,0,0,87040,17,6529380007
5733,43861059,20983078,64844137,5,0,1,3072,25,5776212202
5734,43864700,8493955,52358655,2,0,0,1024,0,4020772701
5735,43868019,21254329,65122348,1,0,1,111104,22,627703904
5736,43871170,8680030,52551200,8,0,0,16896,17,5558248987
5737,43873249,21275623,65148872,5,0,1,4608,25,8532015192
5738,43873719,21278667,65152386,3,0,1,7168,25,8590161988
5739,43880281,21272771,65153052,8,0,1,1024,17,7716369209
5740,43901479,21252559,65154038,5,0,1,1536,25,2064747569
5741,43903189,21273299,65176488,3,0,1,1536,25,3489758727
5742,43903559,21272952,65176511,1,0,1,5120,22,9462383157
5743,43904070,8387308,52291378,8,0,0,7168,17,10093145994
5744,43904269,8743698,52647967,9,0,0,89088,9,9330379780
5745,43909139,21267395,65176534,1,0,1,2560,22,8282734894
5746,43913369,8632660,52546029,6,0,0,120832,11,2667001336
5747,43918181,21258376,65176557,8,0,1,3584,17,753538412
5748,43923359,21253948,65177307,3,0,1,6656,25,9885272651
5749,43927349,8673013,52600362,9,0,0,27648,9,6155654842
5750,43928040,21288424,65216464,6,0,1,9728,11,2655828494
5751,43930311,21286176,65216487,8,0,1,4608,17,1355097038
5752,43930999,8741795,52672794,1,0,0,81408,22,6281058771
5753,43934239,21282271,65216510,5,0,1,2048,25,728962496
5754,43951790,21267106,65218896,6,0,1,5120,11,8958131738
5755,43952879,21266040,65218919,1,0,1,5120,22,8409712880
5756,43954370,8412557,52366927,8,0,0,5632,17,4989200307
5757,43965219,21294502,65259721,5,0,1,512,25,2300285812
5758,43978439,21283228,65261667,5,0,1,3072,25,9271603132
5759,43980009,8772232,52752241,6,0,0,77312,11,145361910
5760,43983821,21291739,65275560,8,0,1,14848,17,10623892773
5761,43986949,8604966,52591915,6,0,0,26112,11,7066918377
5762,43987100,21290726,65277826,6,0,1,3584,11,8874506196
5763,43987199,21290973,65278172,3,0,1,512,25,6209855647
5764,43987389,8947196,52934585,1,0,0,69632,22,8892205075
5765,43990980,8785377,52776357,8,0,0,71680,17,9551845461
5766,43995679,21283159,65278838,5,0,1,11264,25,2458421501
5767,44016010,8453288,52469298,2,0,0,512,0,1139971298
5768,44016399,21281273,65297672,5,0,1,2560,25,179357127
5769,44018029,21279666,65297695,1,0,1,12800,22,562467932
5770,44018489,21279229,65297718,5,0,1,2048,25,10511701504
5771,44021690,8773426,52795116,8,0,0,61440,17,9412083227
5772,44022219,21278564,65300783,5,0,1,6144,25,9615302668
5773,44035139,21267590,65302729,3,0,1,3072,25,9351966011
5774,44036779,21271096,65307875,1,0,1,8192,22,1670144196
5775,44037079,8536007,52573086,6,0,0,1536,11,4041209066
5776,44040179,21268042,65308221,5,0,1,512,25,3842728479
5777,44056870,8646503,52703373,7,0,0,24576,5,5205562827
5778,44058399,8696072,52754471,9,0,0,6656,9,6435702508
5779,44063020,8815858,52878878,3,0,0,512,25,6146040584
5780,44066770,8608254,52675024,8,0,0,7168,17,10287909396
5781,44074459,21234735,65309194,5,0,1,12800,25,1024913895
5782,44076190,8499906,52576096,3,0,0,1024,25,10429704110
5783,44081160,8638464,52719624,3,0,0,1024,25,3047838544
5784,44081270,8600915,52682185,4,0,0,8704,29,3709721608
5785,44094161,21258698,65352859,8,0,1,1024,17,6145425839
5786,44095870,8656550,52752420,3,0,0,512,25,5443085346
5787,44096530,8728626,52825156,8,0,0,33792,17,3562496416
5788,44098470,8803864,52902334,3,0,0,512,25,4569843393
5789,44108399,21244483,65352882,3,0,1,512,25,195084700
5790,44117699,8753908,52871607,9,0,0,72192,9,3304339147
5791,44127959,8813201,52941160,6,0,0,21504,11,8569763305
5792,44134300,9013752,53148052,4,0,0,50176,29,5479516688
5793,44141410,8903549,53044959,2,0,0,1024,0,9651235591
5794,44145709,9077140,53222849,6,0,0,47104,11,2631960977
5795,44151199,8831517,52982716,1,0,0,36352,22,3499437980
5796,44152270,8681416,52833686,8,0,0,1536,17,3931327353
5797,44161099,9138159,53299258,6,0,0,121856,11,2514684194
5798,44163731,21189174,65352905,8,0,1,6656,17,9646818458
5799,44168179,21184749,65352928,1,0,1,7680,22,8011570238
5800,44178750,21184553,65363303,0,0,1,7680,9,10425007108
5801,44182831,21221211,65404042,8,0,1,2560,17,9132529764
5802,44184919,8822848,53007767,6,0,0,76800,11,7115761925
5803,44189179,21214886,65404065,3,0,1,2048,25,33424022
5804,44194630,21210105,65404735,0,0,1,12800,9,2512332826
5805,44200561,21204197,65404758,8,0,1,2048,17,5366238922
5806,44206020,8916023,53122043,8,0,0,41472,17,8345372127
5807,44206260,21198521,65404781,0,0,1,11264,9,1275487381
5808,44206850,8830289,53037139,2,0,0,512,0,8814261901
5809,44210950,21193854,65404804,0,0,1,10240,9,4755142850
5810,44223900,9082516,53306416,3,0,0,1024,25,910801459
5811,44224159,9006023,53230182,6,0,0,16384,11,5369528283
5812,44239640,9010714,53250354,8,0,0,21504,17,8812676693
5813,44241469,21180602,65422071,3,0,1,2048,25,742865220
5814,44252880,9050815,53303695,4,0,0,1536,29,96949825
5815,44256500,21166557,65423057,0,0,1,1536,9,4640411418
5816,44258819,9160325,53419144,0,0,0,77312,9,6614440272
5817,44259859,9039890,53299749,9,0,0,1536,9,3785765327
5818,44260731,21163312,65424043,8,0,1,1536,17,6331464959
5819,44261059,8947415,53208474,9,0,0,132096,9,5707729022
5820,44263740,21185715,65449455,0,0,1,512,9,6593148567
5821,44268670,8981863,53250533,3,0,0,512,25,8362007449
5822,44271699,9123866,53395565,6,0,0,35328,11,5412607470
5823,44274210,9072322,53346532,8,0,0,74240,17,3457001669
5824,44280981,21178331,65459312,8,0,1,17408,17,7696270990
5825,44285579,8954231,53239810,0,0,0,20480,9,7401836089
5826,44286001,21207018,65493019,8,0,1,2048,17,1777759585
5827,44288419,21204671,65493090,5,0,1,6144,25,9473868773
5828,44300399,9002805,53303204,0,0,0,11264,9,1822284702
5829,44315749,21177886,65493635,3,0,1,6656,25,3374646051
5830,44317929,21178401,65496330,5,0,1,4608,25,8043475656
5831,44322989,21182101,65505090,5,0,1,16384,25,2886400240
5832,44323129,9023738,53346867,9,0,0,1024,9,4322843309
5833,44323359,21257733,65581092,5,0,1,2048,25,6158650399
5834,44326269,9129147,53455416,0,0,0,22528,9,7492703645
5835,44327050,21254065,65581115,0,0,1,1024,9,9503596639
5836,44335310,9190367,53525677,3,0,0,3072,25,1061948945
5837,44335369,9221146,53556515,1,0,0,6144,22,8119663158
5838,44349270,21231868,65581138,0,0,1,6656,9,5912790074
5839,44355510,9073521,53429031,2,0,0,512,0,4810690068
5840,44357409,21223752,65581161,5,0,1,8704,25,3981841736
5841,44361169,21224429,65585598,3,0,1,4608,25,14102686
5842,44370439,21215401,65585840,5,0,1,2048,25,7786187094
5843,44372551,21213312,65585863,8,0,1,3072,17,9996940295
5844,44374020,9192870,53566890,2,0,0,1024,0,1462756421
5845,44378570,9289053,53667623,2,0,0,512,0,7726142135
5846,44380590,9323709,53704299,2,0,0,1024,0,3749823043
5847,44384139,21201747,65585886,5,0,1,2560,25,666560146
5848,44391479,9239455,53630934,9,0,0,2048,9,7241198317
5849,44392280,21193629,65585909,4,0,1,2560,29,434294640
5850,44393171,21192761,65585932,8,0,1,6656,17,5771902337
5851,44399860,9191555,53591415,3,0,0,512,25,4997189372
5852,44405140,9370884,53776024,4,0,0,12800,29,1293669614
5853,44408139,9393490,53801629,1,0,0,19968,22,5192626228
5854,44414980,9308560,53723540,4,0,0,10240,29,5244591658
5855,44419219,21166744,65585963,5,0,1,9216,25,1437836063
5856,44422229,9414270,53836499,6,0,0,16384,11,1608249767
5857,44422989,21195436,65618425,3,0,1,8192,25,2120608438
5858,44426499,9432550,53859049,1,0,0,47104,22,504313895
5859,44433230,9334930,53768160,3,0,0,2048,25,1120418708
5860,44442219,9446707,53888926,9,0,0,39424,9,3786976445
5861,44451930,9437331,53889261,3,0,0,1024,25,10002273132
5862,44457290,21175231,65632521,4,0,1,8192,29,616142356
5863,44458339,9677194,54135533,6,0,0,79360,11,3068508070
5864,44464249,21169258,65633507,5,0,1,1536,25,3910315930
5865,44470210,9601471,54071681,8,0,0,31232,17,3762865849
5866,44471909,9457368,53929277,1,0,0,13824,22,7867242097
5867,44474229,21164424,65638653,3,0,1,8192,25,9479409657
5868,44475159,21168000,65643159,3,0,1,7168,25,8615195202
5869,44477989,9330288,53808277,9,0,0,7168,9,2488590444
5870,44478190,21170380,65648570,0,0,1,2048,9,9536801927
5871,44485320,21163916,65649236,0,0,1,1024,9,583222384
5872,44485910,9439132,53925042,4,0,0,14336,29,3041985979
5873,44489890,21159692,65649582,4,0,1,512,29,3981873577
5874,44497160,9546341,54043501,2,0,0,512,0,10277896531
5875,44510129,9591571,54101700,1,0,0,11264,22,734223132
5876,44518529,9531181,54049710,6,0,0,3072,11,177899556
5877,44523240,9498727,54021967,3,0,0,1536,25,2501455441
5878,44523749,21128099,65651848,3,0,1,3584,25,2372169875
5879,44523780,21128427,65652207,4,0,1,9728,29,3090735206
5880,44530120,21151977,65682097,0,0,1,7680,9,4083677339
5881,44531610,9746672,54278282,8,0,0,26624,17,8902343480
5882,44537020,9392600,53929620,2,0,0,1024,0,9571569081
5883,44545130,21137531,65682661,0,0,1,10752,9,1196728924
5884,44546739,9591804,54138543,6,0,0,9728,11,10436761904
5885,44546979,21213197,65760176,5,0,1,6144,25,6064845770
5886,44558470,21204292,65762762,0,0,1,4096,9,5661825954
5887,44561249,9446129,54007378,9,0,0,23552,9,10465381982
5888,44562730,9520234,54082964,4,0,0,15360,29,1664177386
5889,44563950,21199158,65763108,0,0,1,512,9,7571111659
5890,44566790,9612251,54179041,2,0,0,512,0,6045668001
5891,44584119,9655645,54239764,0,0,0,29184,9,5734669005
5892,44586779,21178275,65765054,3,0,1,3072,25,9943038680
5893,44593980,9650516,54244496,4,0,0,2560,29,4779036214
5894,44594449,9914619,54509068,1,0,0,13312,22,2798611470
5895,44597850,10171222,54769072,8,0,0,132608,17,9001204538
5896,44598250,21169390,65767640,4,0,1,4096,29,533655368
5897,44601759,9581491,54183250,0,0,0,6144,9,10342874574
5898,44606179,21234870,65841049,5,0,1,16384,25,8933895108
5899,44615979,9602911,54218890,0,0,0,8192,9,10364116742
5900,44616190,9495140,54111330,2,0,0,1024,0,547949227
5901,44623159,10100216,54723375,0,0,0,52224,9,10327321586
5902,44625180,21220695,65845875,4,0,1,7680,29,9395034120
5903,44628390,9816171,54444561,2,0,0,1536,0,7094101992
5904,44636040,9692986,54329026,2,0,0,4096,0,2527460474
5905,44640570,21262625,65903195,4,0,1,13824,29,7931435948
5906,44641840,9854519,54496359,8,0,0,9728,17,1329450740
5907,44645789,21258072,65903861,5,0,1,1024,25,7193211403
5908,44648079,9778847,54426926,0,0,0,3072,9,10546670376
5909,44651760,9892325,54544085,4,0,0,39936,29,1553943375
5910,44651849,21253958,65905807,5,0,1,3072,25,5742711602
5911,44664309,9812465,54476774,1,0,0,4096,22,6244443295
5912,44667939,10267358,54935297,0,0,0,85504,9,3968615028
5913,44682719,9848702,54531421,6,0,0,50176,11,4279528059
5914,44684649,21351807,66036456,3,0,1,1536,25,1440805858
5915,44693350,9890951,54584301,8,0,0,19968,17,7539608029
5916,44696790,9715916,54412706,4,0,0,512,29,6733020575
5917,44696959,21341123,66038082,3,0,1,2560,25,2910592247
5918,44702339,10024959,54727298,6,0,0,12800,11,1629062851
5919,44702690,9974358,54677048,8,0,0,74752,17,9448523733
5920,44702870,10066537,54769407,3,0,0,1024,25,4035982
5921,44706410,9878712,54585122,4,0,0,1024,29,1190760694
5922,44710550,9903238,54613788,3,0,0,1536,25,1936705856
5923,44714899,9929507,54644406,9,0,0,5120,9,1511397724
5924,44731469,9950438,54681907,9,0,0,15872,9,10391941092
5925,44733609,10098790,54832399,9,0,0,35840,9,1843097383
5926,44734839,9949789,54684628,1,0,0,8192,22,4451891037
5927,44735499,21313288,66048787,5,0,1,4096,25,7637324977
5928,44744170,10025416,54769586,3,0,0,512,25,949266196
5929,44747059,21315212,66062271,5,0,1,17408,25,1545341371
5930,44759190,9968287,54727477,4,0,0,512,29,4804733498
5931,44762070,10028734,54790804,4,0,0,512,29,2669147493
5932,44765809,21344107,66109916,5,0,1,1024,25,7545061449
5933,44791820,21318557,66110377,4,0,1,10240,29,10332528442
5934,44793900,10015940,54809840,4,0,0,1024,29,4830225300
5935,44807690,10128167,54935857,8,0,0,512,17,6770765358
5936,44808129,21357814,66165943,5,0,1,8192,25,8185293898
5937,44809599,21389306,66198905,3,0,1,12800,25,6330352991
5938,44821340,9860746,54682086,8,0,0,512,17,6153111316
5939,44841979,21356949,66198928,3,0,1,4096,25,6474817339
5940,44842459,9864981,54707440,9,0,0,23552,9,7445585896
5941,44849970,21348989,66198959,4,0,1,2048,29,10405718416
5942,44858559,9912922,54771481,1,0,0,6144,22,8765790192
5943,44862259,21336723,66198982,3,0,1,1536,25,8693316671
5944,44866399,10126326,54992725,1,0,0,40960,22,1993311609
5945,44870879,10020584,54891463,1,0,0,11776,22,583765703
5946,44871030,21327975,66199005,4,0,1,2560,29,4003935743
5947,44880440,21318588,66199028,4,0,1,1024,29,1745564693
5948,44883429,21315622,66199051,3,0,1,512,25,8441882537
5949,44889530,9962148,54851678,4,0,0,1024,29,2276235049
5950,44892150,21306924,66199074,4,0,1,3584,29,9099370775
5951,44911679,9864586,54776265,1,0,0,1536,22,8384363421
5952,44912101,21297683,66209784,8,0,1,3584,17,1419053094
5953,44916829,9921355,54838184,6,0,0,18432,11,9385055885
5954,44918430,9865117,54783547,4,0,0,1536,29,9558970922
5955,44921029,21303008,66224037,3,0,1,6656,25,5277586506
5956,44921900,9943491,54865391,3,0,0,1024,25,5264314486
5957,44921949,10094969,55016918,9,0,0,17408,9,9913184740
5958,44935309,9875870,54811179,6,0,0,4096,11,5617727909
5959,44938850,9996649,54935499,3,0,0,512,25,8899788818
5960,44944739,9923030,54867769,1,0,0,1536,22,570799254
5961,44947430,9834304,54781734,3,0,0,512,25,10618921201
5962,44955869,10001664,54957533,9,0,0,55296,9,10148509452
5963,44959390,21279485,66238875,0,0,1,7168,9,3851263582
5964,44961180,9974498,54935678,2,0,0,512,0,3209578966
5965,44961459,10137472,55098931,0,0,0,15360,9,8516556191
5966,44963379,10308712,55272091,6,0,0,37888,11,5089692498
5967,44971250,10088078,55059328,4,0,0,2048,29,7388332903
5968,44981630,21273406,66255036,9,0,1,19456,9,4552961082
5969,44988989,21270873,66259862,3,0,1,7680,25,3892544989
5970,44998079,21267112,66265191,3,0,1,5632,25,1870748378
5971,44998520,21297694,66296214,9,0,1,2048,9,2954874675
5972,45003319,21293097,66296416,5,0,1,10752,25,4723052572
5973,45006179,10297385,55303564,6,0,0,7680,11,4740343572
5974,45011029,10194568,55205597,1,0,0,7168,22,220933221
5975,45015690,9983701,54999391,4,0,0,1024,29,10582293593
5976,45038230,10038026,55076256,2,0,0,1024,0,1859025135
5977,45046889,21316518,66363407,3,0,1,8192,25,1100212628
5978,45077940,9975862,55053802,8,0,0,1024,17,2496420932
5979,45090349,21273081,66363430,3,0,1,1536,25,5848624882
5980,45091579,21288753,66380332,3,0,1,13824,25,9923327519
5981,45091999,21288356,66380355,5,0,1,4096,25,5854290411
5982,45101949,21284145,66386094,5,0,1,1024,25,8470337513
5983,45102859,21305426,66408285,5,0,1,7680,25,5830488744
5984,45107249,10084724,55191973,1,0,0,512,22,5754322702
5985,45107819,10109118,55216937,0,0,0,34304,9,1983571583
5986,45111419,10313702,55425121,0,0,0,34816,9,8149095426
5987,45112039,10382713,55494752,1,0,0,59392,22,975517649
5988,45112179,21296129,66408308,5,0,1,3072,25,1363821634
5989,45113140,10323388,55436528,4,0,0,512,29,6040787099
5990,45113659,21294672,66408331,3,0,1,3072,25,7670830128
5991,45115499,21293280,66408779,5,0,1,6144,25,5503778553
5992,45119619,9988323,55107942,0,0,0,3072,9,3017354720
5993,45120449,10054982,55175431,0,0,0,17920,9,8108969958
5994,45124800,9879578,55004378,2,0,0,512,0,4688133409
5995,45127089,21283982,66411071,5,0,1,3584,25,6324648795
5996,45128240,10280048,55408288,2,0,0,512,0,6531355510
5997,45130820,10178505,55309325,4,0,0,2560,29,1518958960
5998,45146639,21265610,66412249,3,0,1,13824,25,4191415929
5999,45148570,10146735,55295305,2,0,0,2048,0,1812833931
6000,45153819,21303361,66457180,3,0,1,35328,25,6583914837
6001,45156060,10425007,55581067,2,0,0,1536,0,9446483962
6002,45161169,10302258,55463427,1,0,0,50176,22,1736520420
6003,45162679,10499103,55661782,6,0,0,43520,11,4497017036
6004,45171060,10584936,55755996,4,0,0,11776,29,5090841648
6005,45173239,10352167,55525406,9,0,0,31744,9,1419070795
6006,45175279,10704849,55880128,6,0,0,89600,11,6709777104
6007,45182110,10197948,55380058,8,0,0,512,17,1172716349
6008,45194569,10091684,55286253,0,0,0,9216,9,5515287792
6009,45205260,10675538,55880798,8,0,0,2048,17,919662693
6010,45206910,10171612,55378522,2,0,0,512,0,4645236538
6011,45210929,21342987,66553916,5,0,1,3072,25,1865968569
6012,45211880,9932984,55144864,8,0,0,1536,17,6947666336
6013,45223140,21330799,66553939,9,0,1,1536,9,3999536978
6014,45232290,9952128,55184418,2,0,0,512,0,10630358106
6015,45247640,21306413,66554053,9,0,1,2560,9,4128815234
6016,45268710,10031047,55299757,3,0,0,1536,25,174251929
6017,45269839,10652513,55922352,9,0,0,95744,9,6461404873
6018,45270549,10767249,56037798,1,0,0,9728,22,9204749300
6019,45270910,10029299,55300209,3,0,0,512,25,6133023412
6020,45280109,10273970,55554079,1,0,0,56320,22,8425625784
6021,45293190,10732631,56025821,2,0,0,1024,0,4700042472
6022,45296599,10366842,55663441,9,0,0,3584,9,8201295887
6023,45299810,10109781,55409591,3,0,0,1536,25,1036139204
6024,45307309,10118459,55425768,2,0,0,2048,0,9375343948
6025,45314589,10915269,56229858,6,0,0,66560,11,2990900980
6026,45323570,21231789,66555359,9,0,1,2048,9,4512666391
6027,45350700,21205965,66556665,9,0,1,2048,9,1399437822
6028,45371810,10124213,55496023,3,0,0,4096,25,8034632011
6029,45375489,21191737,66567226,3,0,1,5632,25,6497335290
6030,45384360,10602598,55986958,3,0,0,512,25,2591737191
6031,45385079,10467726,55852805,6,0,0,166400,11,7082210504
6032,45386360,10498860,55885220,8,0,0,512,17,3572189529
6033,45387570,21268521,66656091,9,0,1,6144,9,10661341214
6034,45393219,10625968,56019187,9,0,0,59904,9,9425435111
6035,45403000,10799079,56202079,2,0,0,1024,0,2276457745
6036,45406079,21277012,66683091,3,0,1,1536,25,2091657587
6037,45413370,9993382,55406752,3,0,0,512,25,3904320632
6038,45414680,21268434,66683114,9,0,1,2560,9,2035888373
6039,45420080,10192554,55612634,2,0,0,1536,0,5129122631
6040,45422840,10270368,55693208,2,0,0,1536,0,522251716
6041,45436999,10542864,55979863,1,0,0,92160,22,9011027222
6042,45441210,10022419,55463629,3,0,0,512,25,3445919651
6043,45448569,10812591,56261160,1,0,0,52224,22,9235547701
6044,45452669,11103296,56555965,9,0,0,75264,9,4151995824
6045,45454810,21255376,66710186,9,0,1,3584,9,2318034101
6046,45461150,10173576,55634726,4,0,0,18432,29,551340464
6047,45464689,10642182,56106871,9,0,0,186368,9,8321922588
6048,45465180,10459114,55924294,4,0,0,2560,29,3532076174
6049,45467179,10648653,56115832,9,0,0,14848,9,1925202381
6050,45482519,11273943,56756462,9,0,0,59392,9,6472310521
6051,45486770,10836751,56323521,8,0,0,512,17,449919548
6052,45488939,21221270,66710209,3,0,1,1024,25,6746918053
6053,45494390,10643663,56138053,4,0,0,71680,29,8813090648
6054,45496070,21214162,66710232,9,0,1,9728,9,745567757
6055,45512460,10223958,55736418,3,0,0,1024,25,8429277595
6056,45516580,21193675,66710255,9,0,1,512,9,1979144790
6057,45522840,10846244,56369084,4,0,0,33280,29,3812968270
6058,45525619,11340336,56865955,6,0,0,9728,11,8279882730
6059,45537609,21172669,66710278,3,0,1,7168,25,8220177547
6060,45538520,10245500,55784020,2,0,0,1024,0,6164536414
6061,45548560,21161741,66710301,9,0,1,3584,9,5824498789
6062,45555510,10716125,56271635,4,0,0,34304,29,10188115670
6063,45556409,10554853,56111262,1,0,0,14336,22,5418708713
6064,45559770,21150554,66710324,9,0,1,8704,9,407833996
6065,45576200,10461777,56037977,2,0,0,512,0,6386982467
6066,45582059,11057253,56639312,9,0,0,44032,9,1432169399
6067,45595779,10864642,56460421,9,0,0,67584,9,8808221204
6068,45611560,21167248,66778808,9,0,1,3584,9,5183034614
6069,45611570,10567358,56178928,8,0,0,2560,17,4545724783
6070,45622529,10792282,56414811,9,0,0,66560,9,7092037578
6071,45625060,10394774,56019834,2,0,0,2048,0,9177106192
6072,45642780,21137334,66780114,9,0,1,2048,9,2655846831
6073,45643370,10472820,56116190,3,0,0,512,25,4690741402
6074,45657820,10780197,56438017,8,0,0,512,17,7177670997
6075,45659320,10935256,56594576,3,0,0,512,25,7777891065
6076,45680560,10617279,56297839,2,0,0,512,0,5020609543
6077,45684000,21098380,66782380,9,0,1,3584,9,5927775579
6078,45706499,10626585,56333084,0,0,0,20992,9,2052778305
6079,45709030,21075936,66784966,9,0,1,4096,9,2399497908
6080,45714700,10329702,56044402,3,0,0,512,25,1286340768
6081,45718629,10719209,56437838,9,0,0,46080,9,10604185918
6082,45722080,10393931,56116011,2,0,0,512,0,611258786
6083,45723300,21125858,66849158,9,0,1,11776,9,700187697
6084,45724809,11413802,57138611,6,0,0,16896,11,1648963543
6085,45726140,10747899,56474039,2,0,0,1024,0,9281077329
6086,45738870,11071435,56810305,2,0,0,1536,0,2737268262
6087,45741540,21107641,66849181,9,0,1,5632,9,1558311051
6088,45753749,10489081,56242830,0,0,0,15872,9,189615022
6089,45755380,10718838,56474218,2,0,0,512,0,4805044873
6090,45761460,10468733,56230193,8,0,0,1024,17,4494159831
6091,45766559,10927526,56694085,0,0,0,60928,9,9168767464
6092,45771230,11274216,57045446,4,0,0,57856,29,132282310
6093,45778220,10704190,56482410,3,0,0,512,25,10334568539
6094,45784210,21064994,66849204,9,0,1,18432,9,6453328501
6095,45792789,10601719,56394508,0,0,0,29184,9,4716154218
6096,45794889,11664976,57459865,0,0,0,46080,9,954314
6097,45805070,10567662,56372732,3,0,0,1536,25,6824327842
6098,45807529,10515813,56323342,6,0,0,23552,11,7705644716
6099,45811450,11670869,57482319,8,0,0,1024,17,5784841710
6100,45812059,10514103,56326162,0,0,0,2560,9,1147224773
6101,45817290,21044463,66861753,0,0,1,3584,9,10565758486
6102,45826510,21044649,66871159,9,0,1,11776,9,5257896144
6103,45826700,10758563,56585263,8,0,0,1024,17,6323109482
6104,45830440,10458329,56288769,3,0,0,2048,25,6324955750
6105,45837049,10514642,56351691,1,0,0,10240,22,505255392
6106,45838889,11458762,57297651,9,0,0,30208,9,8932737031
6107,45854560,21016622,66871182,9,0,1,5120,9,2139118623
6108,45855860,10916849,56772709,4,0,0,53248,29,695251659
6109,45856650,21014555,66871205,0,0,1,1536,9,483329424
6110,45861930,10471801,56333731,8,0,0,2048,17,5066946382
6111,45868589,10716339,56584928,9,0,0,58880,9,8544909069
6112,45870099,10622812,56492911,9,0,0,3584,9,10676321970
6113,45877339,20993889,66871228,2,0,1,8192,0,6881309099
6114,45883780,20987471,66871251,0,0,1,13312,9,3709008417
6115,45884470,21004235,66888705,0,0,1,1536,9,852214700
6116,45885040,21037894,66922934,9,0,1,8192,9,2227990265
6117,45886019,10587685,56473704,9,0,0,43520,9,4320357061
6118,45886890,10606621,56493511,2,0,0,512,0,3229949882
6119,45888129,11045944,56934073,0,0,0,12288,9,7913368625
6120,45890399,10715865,56606264,6,0,0,3584,11,23053538
6121,45891260,11724366,57615626,8,0,0,54784,17,10497622179
6122,45908130,21029381,66937511,4,0,1,5120,29,8602540543
6123,45915179,10921472,56836651,9,0,0,11264,9,8252440328
6124,45921790,21019043,66940833,0,0,1,3584,9,3527827088
6125,45923950,21016914,66940864,9,0,1,14336,9,2280674924
6126,45924260,10715566,56639826,3,0,0,1536,25,6807303601
6127,45924610,21016277,66940887,9,0,1,512,9,798048919
6128,45928640,21013870,66942510,0,0,1,3072,9,1928086613
6129,45938609,10702355,56640964,1,0,0,3584,22,3056606730
6130,45948629,11857549,57806178,0,0,0,49152,9,2728525979
6131,45952439,11740089,57692528,6,0,0,69120,11,5130689966
6132,45954389,10908579,56862968,1,0,0,65024,22,9530971783
6133,45957789,10857814,56815603,9,0,0,11776,9,5499091677
6134,45968000,10942829,56910829,3,0,0,1536,25,856632122
6135,45968719,12322363,58291082,6,0,0,101888,11,3666008134
6136,45969750,10951243,56920993,3,0,0,512,25,2662558169
6137,45976810,20967001,66943811,9,0,1,2048,9,5384367510
6138,45982550,11237138,57219688,4,0,0,37888,29,8585201926
6139,45986230,20959207,66945437,0,0,1,2560,9,5672896230
6140,45992849,12078993,58071842,0,0,0,171008,9,8965090275
6141,46009749,10925907,56935656,6,0,0,5120,11,4416029757
6142,46014429,11131741,57146170,0,0,0,24576,9,8314363653
6143,46030270,20915935,66946205,0,0,1,11776,9,5194632306
6144,46039719,10847500,56887219,1,0,0,1024,22,10274057047
6145,46049700,11012167,57061867,4,0,0,37376,29,2696707893
6146,46052530,10652985,56705515,8,0,0,1536,17,9366693916
6147,46054590,20892601,66947191,9,0,1,1536,9,9999741342
6148,46060510,20887027,66947537,0,0,1,512,9,5050859793
6149,46062059,10949766,57011825,1,0,0,7168,22,4577661806
6150,46062780,12118028,58180808,8,0,0,130560,17,1226468328
6151,46064320,20927788,66992108,9,0,1,12800,9,5363235882
6152,46075190,20916941,66992131,0,0,1,2560,9,3450477557
6153,46079890,10870613,56950503,3,0,0,512,25,2283343747
6154,46080590,20925914,67006504,0,0,1,6144,9,391994715
6155,46081690,20924837,67006527,9,0,1,8192,9,3151868225
6156,46089919,11142585,57232504,6,0,0,19456,11,9943819778
6157,46090120,20916609,67006729,6,0,1,3072,11,2449478050
6158,46094050,21013752,67107802,9,0,1,20480,9,9044369754
6159,46104641,21003588,67108229,8,0,1,3584,17,5605466839
6160,46105120,21048766,67153886,4,0,1,24064,29,6074095646
6161,46106811,21047499,67154310,8,0,1,2560,17,2609135785
6162,46108120,21743839,67851959,4,0,1,110592,29,2298050541
6163,46109710,11122973,57232683,2,0,0,512,0,3488534582
6164,46113771,21738211,67851982,8,0,1,2560,17,10140717657
6165,46115159,11644160,57759319,9,0,0,219136,9,7091069796
6166,46121760,10868093,56989853,8,0,0,5632,17,1118919779
6167,46123850,21857688,67981538,4,0,1,35328,29,1087115728
6168,46124360,11697799,57822159,2,0,0,36352,0,9553759514
6169,46127619,11774283,57901902,1,0,0,47104,22,7651495699
6170,46135149,11723331,57858480,9,0,0,31744,9,3264069115
6171,46142070,21988942,68131012,4,0,1,93696,29,7226935063
6172,46148049,11195269,57343318,0,0,0,5120,9,3431709557
6173,46156569,11322218,57478787,6,0,0,38912,11,7415587360
6174,46163610,10902451,57066061,3,0,0,512,25,4092285119
6175,46178509,11418318,57596827,0,0,0,17408,9,7688875581
6176,46183430,22011239,68194669,0,0,1,1536,9,6832475873
6177,46188690,11367485,57556175,8,0,0,58880,17,7487991271
6178,46196019,11145716,57341735,9,0,0,41984,9,163926404
6179,46200851,22069920,68270771,8,0,1,16384,17,3698552494
6180,46204440,11139080,57343520,3,0,0,512,25,7102543422
6181,46205829,22064965,68270794,2,0,1,1024,0,6369957360
6182,46206919,11765819,57972738,6,0,0,118272,11,9257261187
6183,46208659,11574495,57783154,0,0,0,77824,9,2566341633
6184,46215171,22065029,68280200,8,0,1,2560,17,10351765478
6185,46220459,22060271,68280730,3,0,1,7680,25,1024714517
6186,46221740,22063463,68285203,9,0,1,2560,9,4411018059
6187,46236559,12091501,58328060,0,0,0,20480,9,3774745791
6188,46238209,22048620,68286829,3,0,1,2560,25,8775039422
6189,46239610,11294101,57533711,8,0,0,7680,17,6062672040
6190,46240180,11430761,57670941,2,0,0,16384,0,6572351401
6191,46240530,22046645,68287175,9,0,1,512,9,1226019369
6192,46250271,22038287,68288558,8,0,1,14848,17,600156493
6193,46250371,22040773,68291144,8,0,1,4096,17,1510749894
6194,46250759,11216149,57466908,6,0,0,23040,11,5230035118
6195,46250929,12126841,58377770,1,0,0,1024,22,2881361120
6196,46263209,22042648,68305857,2,0,1,4096,0,2840043963
6197,46270121,22312181,68582302,8,0,1,18944,17,3886797346
6198,46271100,22316552,68587652,9,0,1,4608,9,8279681200
6199,46271320,11518120,57789440,8,0,0,20480,17,2415062615
6200,46282209,11198816,57481025,9,0,0,7168,9,1921417780
6201,46282249,12326340,58608589,9,0,0,13312,9,4044942812
6202,46288419,22416703,68705122,3,0,1,5120,25,8787740301
6203,46311459,11597087,57908546,0,0,0,8192,9,6698890311
6204,46315830,22430921,68746751,0,0,1,22528,9,8037601129
6205,46325610,12151249,58476859,3,0,0,512,25,1247039456
6206,46330350,11235364,57565714,8,0,0,31232,17,1102597715
6207,46334529,11147455,57481984,0,0,0,3072,9,2052243431
6208,46339769,11545410,57885179,1,0,0,87552,22,4622051610
6209,46340280,11484157,57824437,3,0,0,512,25,3023105606
6210,46348380,22434601,68782981,0,0,1,3072,9,3202334369
6211,46352789,22430858,68783647,2,0,1,1024,0,8664485856
6212,46370780,22418013,68788793,9,0,1,8192,9,4493007766
6213,46372520,22421445,68793965,0,0,1,8192,9,8638574389
6214,46390859,11175970,57566829,0,0,0,3584,9,8399425920
6215,46392060,22442412,68834472,0,0,1,5120,9,5813306088
6216,46398740,10996553,57395293,3,0,0,512,25,2213946354
6217,46420509,11086598,57507107,1,0,0,1024,22,1075702963
6218,46421930,22421035,68842965,0,0,1,5632,9,862823245
6219,46433970,22409018,68842988,9,0,1,1536,9,408966956
6220,46437280,22462191,68899471,9,0,1,3584,9,7867208862
6221,46447700,22451794,68899494,6,0,1,8704,11,1334497626
6222,46448260,11379983,57828243,8,0,0,11776,17,2920422600
6223,46458210,11186974,57645184,8,0,0,512,17,3207323792
6224,46459550,22439967,68899517,9,0,1,3072,9,9690117276
6225,46464600,22434940,68899540,6,0,1,8704,11,2135690191
6226,46470209,22429354,68899563,2,0,1,3584,0,8903936373
6227,46473399,22426187,68899586,2,0,1,1536,0,9435106513
6228,46479059,11332001,57811060,9,0,0,15872,9,1862002569
6229,46483999,22444057,68928056,2,0,1,17408,0,1629670820
6230,46485919,11305260,57791179,0,0,0,5632,9,7609650485
6231,46486700,22441558,68928258,9,0,1,3584,9,404625151
6232,46489829,11334413,57824242,9,0,0,6656,9,2449609256
6233,46490480,11704510,58194990,3,0,0,1024,25,301912124
6234,46491560,11414467,57906027,3,0,0,2560,25,8715282072
6235,46500739,11342877,57843616,6,0,0,50176,11,1963155813
6236,46501000,12290631,58791631,2,0,0,93696,0,763095941
6237,46505099,11512234,58017333,9,0,0,34304,9,6899169522
6238,46506340,22421941,68928281,6,0,1,512,11,256878260
6239,46512210,22416094,68928304,9,0,1,5632,9,7125607015
6240,46516539,12400139,58916678,9,0,0,36352,9,1324394462
6241,46523899,22404428,68928327,2,0,1,3584,0,3839815556
6242,46531899,11789530,58321429,6,0,0,41984,11,1820726991
6243,46543670,22384680,68928350,6,0,1,512,11,10727980111
6244,46546310,11278306,57824616,3,0,0,512,25,6569532757
6245,46548370,11356854,57905224,1,0,0,10752,22,3121449936
6246,46557960,22370738,68928698,6,0,1,1024,11,5411345878
6247,46559910,22371374,68931284,9,0,1,4096,9,9650251410
6248,46572349,22360881,68933230,2,0,1,3072,0,6916709489
6249,46573330,11802764,58376094,2,0,0,53760,0,3917005872
6250,46574589,11608590,58183179,0,0,0,7680,9,3887180974
6251,46577270,22356319,68933589,6,0,1,9728,11,4309066559
6252,46595981,22338594,68934575,8,0,1,1536,17,7194255292
6253,46598770,12022197,58620967,2,0,0,2048,0,6625549086
6254,46605460,11528167,58133627,2,0,0,40960,0,9600882798
6255,46607809,22326920,68934729,2,0,1,8704,0,1491327874
6256,46608369,12437566,59045935,9,0,0,64512,9,8406083525
6257,46609640,12437591,59047231,3,0,0,512,25,187706344
6258,46611870,22361509,68973379,9,0,1,5632,9,2275743333
6259,46612829,11392758,58005587,0,0,0,19968,9,538537102
6260,46614630,22358772,68973402,6,0,1,3072,11,7214756270
6261,46616940,11691642,58308582,3,0,0,56832,25,8358033254
6262,46617290,11523692,58140982,3,0,0,24064,25,9406555647
6263,46621890,11949783,58571673,8,0,0,81920,17,8568742010
6264,46622950,22362066,68985016,6,0,1,7168,11,8414492240
6265,46627449,22358122,68985571,2,0,1,3072,0,9623754221
6266,46630749,12098625,58729374,1,0,0,74240,22,1338115298
6267,46631340,22370807,69002147,6,0,1,10240,11,3093236374
6268,46631491,22385814,69017305,8,0,1,7168,17,1143937820
6269,46635089,22384162,69019251,5,0,1,3072,25,10662892941
6270,46638159,22391975,69030134,2,0,1,1536,0,3881205983
6271,46639870,12562778,59202648,2,0,0,81920,0,9470125028
6272,46642669,11364189,58006858,6,0,0,4096,11,6216835401
6273,46645860,22400660,69046520,0,0,1,512,9,1827353050
6274,46646711,22428417,69075128,8,0,1,3072,17,2411229849
6275,46648020,22430410,69078430,0,0,1,3584,9,1904409419
6276,46655860,22422916,69078776,6,0,1,512,11,1184606648
6277,46656059,22423639,69079698,5,0,1,20480,25,4682979271
6278,46665380,22434997,69100377,6,0,1,1536,11,7986514743
6279,46670099,11582382,58252481,6,0,0,44544,11,1497184643
6280,46675760,22520843,69196603,4,0,1,36864,29,7501854656
6281,46675830,12229726,58905556,8,0,0,62464,17,5113923357
6282,46678920,22575956,69254876,9,0,1,13824,9,8806687084
6283,46681490,22573409,69254899,0,0,1,19968,9,1140785418
6284,46691840,22648670,69340510,4,0,1,68096,29,5917326889
6285,46693449,11564671,58258120,9,0,0,18432,9,4371796142
6286,46698469,11678116,58376585,1,0,0,1536,22,3557538411
6287,46703000,22656544,69359544,9,0,1,10752,9,6367432768
6288,46705700,22667376,69373076,6,0,1,4096,11,8988973013
6289,46708460,22664639,69373099,0,0,1,11264,9,8191231876
6290,46710249,11729146,58439395,1,0,0,41984,22,9812408208
6291,46711411,22661711,69373122,8,0,1,4608,17,401121091
6292,46719200,22661908,69381108,6,0,1,512,11,430175954
6293,46720990,11825654,58546644,8,0,0,57856,17,8501352169
6294,46723110,22658152,69381262,6,0,1,8704,11,8288428640
6295,46731221,22655688,69386909,8,0,1,5120,17,2902519939
6296,46731990,22656225,69388215,9,0,1,2048,9,8686387895
6297,46732609,22656348,69388957,2,0,1,8704,0,3724792420
6298,46740919,22698532,69439451,2,0,1,26624,0,5518598231
6299,46757929,11575735,58333664,9,0,0,3584,9,2977426921
6300,46772440,22667164,69439604,6,0,1,6144,11,8545664624
6301,46787509,11789335,58576844,9,0,0,16896,9,9116404919
6302,46788359,12472731,59261090,0,0,0,52224,9,4284435191
6303,46789959,12271961,59061920,0,0,0,4608,9,5956156165
6304,46800019,12078035,58878054,0,0,0,91136,9,3267237494
6305,46810860,22671357,69482217,6,0,1,512,11,9478240774
6306,46812419,12139873,58952292,0,0,0,110592,9,3537239571
6307,46815309,11375231,58190540,9,0,0,23040,9,7220641611
6308,46816490,22665750,69482240,6,0,1,3072,11,2260999016
6309,46821740,22660523,69482263,6,0,1,512,11,2098682903
6310,46822080,22660206,69482286,6,0,1,3584,11,8486201837
6311,46822559,11846932,58669491,1,0,0,37376,22,3696874280
6312,46827800,22671692,69499492,6,0,1,13312,11,5404282934
6313,46829479,12123685,58953164,9,0,0,2560,9,6068592906
6314,46829870,12195583,59025453,8,0,0,74752,17,3120851861
6315,46833299,12475808,59309107,0,0,0,81408,9,5926156732
6316,46833660,11962518,58796178,8,0,0,14848,17,2021198912
6317,46835689,12993352,59829041,0,0,0,54784,9,6399635124
6318,46837019,11751825,58588844,1,0,0,15872,22,3793110154
6319,46838839,11575276,58414115,9,0,0,14336,9,7615745912
6320,46839679,12619585,59459264,1,0,0,247808,22,4306045708
6321,46841850,22657665,69499515,0,0,1,3072,9,9028559040
6322,46859510,12357209,59216719,3,0,0,46080,25,2654064625
6323,46862320,11951411,58813731,3,0,0,18432,25,5676404387
6324,46863980,22635558,69499538,6,0,1,4608,11,653989478
6325,46878790,22620771,69499561,0,0,1,3584,9,8823061604
6326,46883050,11452556,58335606,8,0,0,1536,17,10061930275
6327,46883070,12981099,59864169,2,0,0,7680,0,1348167679
6328,46883370,22616214,69499584,6,0,1,512,11,6960902195
6329,46885491,22614116,69499607,8,0,1,2048,17,8656716807
6330,46887710,12665981,59553691,3,0,0,176128,25,8035838709
6331,46890359,13060736,59951095,9,0,0,24064,9,3933900981
6332,46895889,12130367,59026256,9,0,0,2560,9,1167296084
6333,46907909,11749082,58656991,9,0,0,9728,9,7624801256
6334,46909669,12558377,59468046,6,0,0,6144,11,3034964728
6335,46912520,22628060,69540580,6,0,1,8192,11,2783546902
6336,46927650,22718234,69645884,4,0,1,105984,29,941600252
6337,46935380,22710543,69645923,9,0,1,3584,9,4654209783
6338,46950500,22695446,69645946,0,0,1,512,9,1065136539
6339,46950799,11967774,58918573,6,0,0,6144,11,2447363480
6340,46956230,11775507,58731737,8,0,0,7680,17,9012174733
6341,46961061,22684908,69645969,8,0,1,4096,17,9851581697
6342,46964900,12512084,59476984,8,0,0,28160,17,9297618694
6343,46972980,11848593,58821573,3,0,0,6656,25,6443732068
6344,46974610,12591809,59566419,2,0,0,41472,0,264696071
6345,47004289,11982906,58987195,0,0,0,13312,9,385416535
6346,47006250,12071989,59078239,3,0,0,6144,25,2523668018
6347,47009169,11722747,58731916,1,0,0,512,22,136468612
6348,47009399,11877102,58886501,6,0,0,27648,11,2683217280
6349,47024990,12192064,59217054,8,0,0,1024,17,4056403015
6350,47036000,22609992,69645992,0,0,1,512,9,8929634092
6351,47089809,13029249,60119058,0,0,0,31744,9,9536075770
6352,47093519,12515277,59608796,0,0,0,20480,9,3901037310
6353,47103960,11695929,58799889,3,0,0,1024,25,5834633831
6354,47110299,12517181,59627480,0,0,0,41472,9,85361946
6355,47129709,12732097,59861806,0,0,0,76800,9,4366892217
6356,47132090,12203003,59335093,8,0,0,22528,17,10510688051
6357,47142159,12696109,59838268,6,0,0,30208,11,5877459493
6358,47142899,12080886,59223785,1,0,0,22016,22,6136711289
6359,47150000,12093476,59243476,3,0,0,7680,25,8760730276
6360,47161289,12547209,59708498,1,0,0,49152,22,6873363438
6361,47179360,13197796,60377156,8,0,0,10240,17,435612663
6362,47179380,11819054,58998434,2,0,0,6144,0,6841164933
6363,47183960,11993705,59177665,2,0,0,8704,0,5821652776
6364,47198029,12447300,59645329,0,0,0,1536,9,7315830314
6365,47207141,22438874,69646015,8,0,1,1024,17,1418558617
6366,47219649,11761054,58980703,0,0,0,37376,9,4499397163
6367,47231889,11839569,59071458,6,0,0,2048,11,3023082691
6368,47245010,13215589,60460599,8,0,0,34304,17,3390310395
6369,47256169,12118452,59374621,0,0,0,58368,9,6991902913
6370,47264140,13240558,60504698,3,0,0,14336,25,6726927061
6371,47267171,22378867,69646038,8,0,1,2560,17,9392450971
6372,47286950,13372412,60659362,3,0,0,29184,25,997623722
6373,47287509,12916685,60204194,0,0,0,48640,9,2046783123
6374,47293129,12740721,60033850,1,0,0,57856,22,7877241346
6375,47294301,22366338,69660639,8,0,1,3584,17,5045740829
6376,47299899,12496469,59796368,1,0,0,109568,22,6286300396
6377,47311700,12331938,59643638,2,0,0,7680,0,8605651441
6378,47323830,12547694,59871524,3,0,0,24064,25,6706738947
6379,47338979,12832752,60171731,1,0,0,42496,22,4999265503
6380,47341020,12715483,60056503,8,0,0,41984,17,6429771799
6381,47351271,22309882,69661153,8,0,1,2560,17,8538576170
6382,47352889,13015568,60368457,1,0,0,17920,22,6367281190
6383,47365450,13405534,60770984,8,0,0,78336,17,4296004048
6384,47366211,22294965,69661176,8,0,1,12800,17,7540552954
6385,47374611,22286596,69661207,8,0,1,1536,17,6262869677
6386,47378989,12730374,60109363,6,0,0,22016,11,1332989396
6387,47380550,13254509,60635059,8,0,0,84480,17,10248761591
6388,47380619,12758306,60138925,6,0,0,54272,11,8147483960
6389,47382850,11711424,59094274,3,0,0,3072,25,8558596527
6390,47390620,13193051,60583671,3,0,0,178688,25,2042122728
6391,47391499,12074652,59466151,6,0,0,22528,11,2954550898
6392,47409569,11937317,59346886,1,0,0,8192,22,4415761315
6393,47410440,12921597,60332037,8,0,0,14336,17,5916344859
6394,47416299,12542619,59958918,0,0,0,25600,9,10392268837
6395,47427179,13044980,60472159,6,0,0,31744,11,2012978758
6396,47427969,12467311,59895280,0,0,0,27648,9,4325381148
6397,47434290,13240935,60675225,3,0,0,36864,25,4010687732
6398,47434910,13010904,60445814,3,0,0,67072,25,4348523371
6399,47434940,12050491,59485431,3,0,0,27648,25,7947683437
6400,47451239,13385049,60836288,1,0,0,70656,22,1417956540
6401,47454631,22213483,69668114,8,0,1,5120,17,10348937683
6402,47461500,13570317,61031817,8,0,0,58368,17,2565772227
6403,47462029,13479349,60941378,6,0,0,81920,11,806638435
6404,47474930,11860654,59335584,8,0,0,1536,17,4291559280
6405,47489340,12936015,60425355,3,0,0,84992,25,7898813279
6406,47491601,22178459,69670060,8,0,1,3072,17,7519616750
6407,47512360,11956021,59468381,8,0,0,1024,17,9645710034
6408,47516259,12450807,59967066,0,0,0,25600,9,10012332709
6409,47539479,12272847,59812326,0,0,0,52224,9,8018327102
6410,47541229,12617531,60158760,1,0,0,65024,22,6827479393
6411,47551260,22122986,69674246,6,0,1,6656,11,4222970723
6412,47553691,22170763,69724454,8,0,1,6656,17,6091068162
6413,47562489,13517578,61080067,6,0,0,103424,11,9281415315
6414,47565470,13024152,60589622,3,0,0,19456,25,5451759437
6415,47568501,22171452,69739953,8,0,1,1024,17,10558918082
6416,47569121,22182694,69751815,8,0,1,6144,17,6669144120
6417,47576579,12608926,60185505,6,0,0,43520,11,1507294602
6418,47589820,22204360,69794180,9,0,1,5120,9,9743246387
6419,47613260,13157903,60771163,8,0,0,512,17,7684373289
6420,47620639,13680353,61300992,6,0,0,81920,11,4451627825
6421,47621399,13480506,61101905,6,0,0,22528,11,573491936
6422,47626179,13320393,60946572,0,0,0,16896,9,6932290335
6423,47633881,22160322,69794203,8,0,1,4608,17,6246356911
6424,47640251,22165711,69805962,8,0,1,11264,17,4826589456
6425,47643199,22165029,69808228,2,0,1,3584,0,9621604868
6426,47644520,12565024,60209544,2,0,0,8704,0,5293057896
6427,47655031,22167078,69822109,8,0,1,4096,17,1125377886
6428,47658549,12931564,60590113,1,0,0,1536,22,1847780842
6429,47663000,13341624,61004624,3,0,0,1024,25,6399992555
6430,47695289,13650863,61346152,6,0,0,33792,11,9005385962
6431,47701549,13490825,61192374,6,0,0,25088,11,8350917658
6432,47706020,12944381,60650401,8,0,0,1024,17,3452796663
6433,47709379,22150333,69859712,2,0,1,512,0,9975966703
6434,47715419,12562785,60278204,6,0,0,6656,11,8892455603
6435,47723750,12202180,59925930,2,0,0,31744,0,6076051377
6436,47727471,22132264,69859735,8,0,1,7680,17,8988127275
6437,47733939,13767983,61501922,6,0,0,6656,11,7861414974
6438,47735639,11949185,59684824,1,0,0,1536,22,2257276026
6439,47758889,13572507,61331396,6,0,0,32768,11,1478503169
6440,47763601,22102219,69865820,8,0,1,11776,17,8459071273
6441,47796569,12462088,60258657,0,0,0,6144,9,876919147
6442,47800439,11881174,59681613,1,0,0,1024,22,7569134234
6443,47820210,13403543,61223753,3,0,0,102912,25,4357744930
6444,47848559,12338217,60186776,0,0,0,4096,9,3313395594
6445,47848980,11810614,59659594,8,0,0,512,17,6205217399
6446,47851339,12655254,60506593,6,0,0,6144,11,9301736512
6447,47858069,13827086,61685155,0,0,0,51200,9,7686817245
6448,47868619,12377787,60246406,6,0,0,37376,11,4696925199
6449,47871780,13704777,61576557,3,0,0,62976,25,5682958535
6450,47871950,12787815,60659765,8,0,0,512,17,8286594547
6451,47876440,12620418,60496858,8,0,0,512,17,1362678223
6452,47886540,12301397,60187937,8,0,0,1536,17,8115625030
6453,47898010,12136019,60034029,8,0,0,512,17,4882836712
6454,47939160,13382229,61321389,3,0,0,44032,25,4490060347
6455,47986730,13821960,61808690,3,0,0,256000,25,2309860827
6456,47999350,13275700,61275050,2,0,0,17920,0,3690707154
6457,48002179,13595485,61597664,6,0,0,42496,11,8882561288
6458,48007100,12000272,60007372,3,0,0,2048,25,1507139726
6459,48010819,13240917,61251736,1,0,0,1024,22,10173095204
6460,48058420,12162255,60220675,3,0,0,5120,25,10157532997
6461,48078040,12531256,60609296,2,0,0,38912,0,3969522593
6462,48088460,12098986,60187446,8,0,0,1536,17,4957136503
6463,48096199,13733316,61829515,0,0,0,33792,9,1549027023
6464,48105300,11938207,60043507,3,0,0,5632,25,2529147717
6465,48107749,12570463,60678212,0,0,0,9728,9,6467193231
6466,48124750,11933336,60058086,3,0,0,5120,25,7729899506
6467,48130129,13703777,61833906,6,0,0,14336,11,8050771682
6468,48133720,12968364,61102084,8,0,0,512,17,6366147814
6469,48135059,13308845,61443904,1,0,0,512,22,5284819429
6470,48149579,12022643,60172222,6,0,0,1536,11,9181743708
6471,48173069,13207439,61380508,1,0,0,1024,22,7340972587
6472,48182899,12531929,60714828,0,0,0,10240,9,6086045112
6473,48198319,12640831,60839150,0,0,0,8704,9,8241979015
6474,48204220,12445846,60650066,2,0,0,49152,0,403335682
6475,48210239,12008452,60218691,6,0,0,7168,11,5842451565
6476,48212710,11994159,60206869,3,0,0,8704,25,6826501289
6477,48215870,21651576,69867446,0,0,1,2560,9,4006368714
6478,48223519,12023222,60246741,1,0,0,1024,22,8268309500
6479,48225620,21663481,69889101,0,0,1,4608,9,8705303063
6480,48229170,13691575,61920745,3,0,0,104960,25,2442546711
6481,48262849,12025466,60288315,1,0,0,1536,22,3915029879
6482,48264730,12529985,60794715,8,0,0,512,17,4822426487
6483,48291980,21597467,69889447,0,0,1,512,9,649997992
6484,48306829,21586510,69893339,2,0,1,6144,0,5332821173
6485,48314169,11872786,60186955,1,0,0,512,22,7389450143
6486,48317079,12055687,60372766,6,0,0,8192,11,5586372218
6487,48342219,13113895,61456114,1,0,0,1024,22,6716504612
6488,48345500,21549465,69894965,0,0,1,2560,9,4187369584
6489,48349080,12465657,60814737,3,0,0,64000,25,122792459
6490,48349850,21549922,69899772,0,0,1,2560,9,9215637633
6491,48352530,12131218,60483748,2,0,0,18432,0,8648723590
6492,48358620,21596416,69955036,0,0,1,18432,9,6321662482
6493,48358750,13764601,62123351,3,0,0,14848,25,9820380445
6494,48371890,13618036,61989926,3,0,0,31232,25,6091450379
6495,48373900,13311746,61685646,8,0,0,1536,17,9137724170
6496,48385730,12389824,60775554,2,0,0,14336,0,270815635
6497,48396190,13161156,61557346,2,0,0,166912,0,8579536795
6498,48412599,21542460,69955059,1,0,1,9216,22,10046328742
6499,48421479,11930386,60351865,1,0,0,1024,22,6705701452
6500,48433810,12949770,61383580,8,0,0,1024,17,4248641067
6501,48450260,13594804,62045064,2,0,0,178688,0,6698686814
6502,48451219,12408524,60859743,6,0,0,24064,11,9614362138
6503,48474850,12860804,61335654,2,0,0,4608,0,3330805694
6504,48481889,12357448,60839337,1,0,0,512,22,7163967680
6505,48483570,21482771,69966341,9,0,1,12288,9,4213221829
6506,48490499,12558033,61048532,0,0,0,54784,9,430623814
6507,48496999,13452941,61949940,0,0,0,95744,9,6279017799
6508,48511699,13721294,62232993,6,0,0,70656,11,7386544503
6509,48520860,11963629,60484489,2,0,0,512,0,6971189567
6510,48524699,12161296,60685995,1,0,0,512,22,10627686665
6511,48529950,21463256,69993206,9,0,1,7680,9,1318549600
6512,48571969,12522785,61094754,0,0,0,48128,9,367090183
6513,48576720,12199013,60775733,8,0,0,512,17,6024248072
6514,48585829,13568137,62153966,6,0,0,48128,11,676057870
6515,48625719,12252078,60877797,1,0,0,1536,22,9471839235
6516,48631530,12676412,61307942,2,0,0,14848,0,9023890562
6517,48633340,12469703,61103043,8,0,0,3072,17,6718904727
6518,48654600,12614943,61269543,3,0,0,58368,25,8850071105
6519,48656089,12451345,61107434,6,0,0,14336,11,5348771449
6520,48673439,12572535,61245974,0,0,0,72704,9,5694116457
6521,48680639,12504068,61184707,0,0,0,84992,9,6163511882
6522,48682369,13268865,61951234,6,0,0,4096,11,9120746233
6523,48686960,13358299,62045259,8,0,0,512,17,3121668687
6524,48688649,12894483,61583132,6,0,0,21504,11,9146728567
6525,48690830,12921214,61612044,8,0,0,1536,17,5394185355
6526,48694339,12551860,61246199,1,0,0,512,22,9468014713
6527,48697390,12554011,61251401,2,0,0,16384,0,3837209388
6528,48699959,12136508,60836467,1,0,0,512,22,7868092568
6529,48717049,21276180,69993229,7,0,1,4608,5,9713649922
6530,48736399,12566980,61303379,6,0,0,7680,11,723882574
6531,48741969,21253879,69995848,1,0,1,512,22,819734685
6532,48744090,12350897,61094987,8,0,0,512,17,9927169532
6533,48747940,12586287,61334227,3,0,0,9216,25,8706073773
6534,48751279,21248115,69999394,7,0,1,5632,5,10642540310
6535,48757709,13670910,62428619,6,0,0,112128,11,6339084142
6536,48763869,21235781,69999650,7,0,1,9216,5,5510493957
6537,48767259,21233057,70000316,7,0,1,1024,5,9063015569
6538,48768279,12478099,61246378,1,0,0,512,22,9675344399
6539,48768629,21232865,70001494,1,0,1,13824,22,3459609656
6540,48768960,13479188,62248148,3,0,0,49664,25,8608835864
6541,48770859,21271182,70042041,7,0,1,7168,5,3592905709
6542,48774850,21270818,70045668,6,0,1,8192,11,346081028
6543,48785869,21308694,70094563,1,0,1,4608,22,585454109
6544,48787070,21307516,70094586,6,0,1,5120,11,10265203421
6545,48804060,21290549,70094609,4,0,1,17408,29,7502948799
6546,48814960,21280319,70095279,4,0,1,29184,29,7354875190
6547,48816469,21279365,70095834,1,0,1,6656,22,9982491936
6548,48820640,21405939,70226579,4,0,1,50688,29,4486962463
6549,48821309,21406896,70228205,1,0,1,2560,22,5273987441
6550,48836959,21395752,70232711,1,0,1,7168,22,4072113480
6551,48845759,12273397,61119156,6,0,0,1536,11,9019060108
6552,48849589,21383468,70233057,1,0,1,512,22,765463689
6553,48849880,12055970,60905850,8,0,0,512,17,8322316689
6554,48851970,21420558,70272528,4,0,1,27648,29,4694539798
6555,48859619,21413677,70273296,7,0,1,11776,5,9602281178
6556,48870740,12405269,61276009,2,0,0,3072,0,9130613363
6557,48878449,12840495,61718944,0,0,0,56320,9,866021958
6558,48896499,21398368,70294867,7,0,1,512,5,5605017295
6559,48912249,21383284,70295533,7,0,1,1024,5,3542178896
6560,48912310,12216172,61128482,2,0,0,1536,0,1875383905
6561,48915319,21388112,70303431,3,0,1,512,25,3523848064
6562,48929829,12673474,61603303,6,0,0,18432,11,9869278257
6563,48938120,12478184,61416304,2,0,0,76288,0,73401763
6564,48948390,13708905,62657295,3,0,0,29696,25,8123542823
6565,48965380,12451305,61416685,8,0,0,1024,17,3266575174
6566,48976639,21329378,70306017,7,0,1,4096,5,5580026324
6567,48976649,13634846,62611495,0,0,0,6144,9,7572363292
6568,48979460,21339865,70319325,9,0,1,6656,9,2502210140
6569,48982419,21336929,70319348,7,0,1,5632,5,8261451858
6570,48994909,12984528,61979437,0,0,0,48128,9,9369714607
6571,48996390,21358058,70354448,4,0,1,28160,29,9625585927
6572,49001950,12419282,61421232,2,0,0,14848,0,1545250712
6573,49010740,13252319,62263059,3,0,0,22016,25,10268989398
6574,49025430,21329479,70354909,4,0,1,10240,29,9854021100
6575,49026160,21344648,70370808,6,0,1,4608,11,1088864009
6576,49031000,21339831,70370831,4,0,1,6656,29,2599012632
6577,49044269,13036316,62080585,2,0,0,110080,0,10019149888
6578,49047140,12767353,61814493,3,0,0,18944,25,4409822775
6579,49065019,21305835,70370854,7,0,1,1536,5,623975540
6580,49068550,21493287,70561837,4,0,1,149504,29,540486122
6581,49068980,21614905,70683885,4,0,1,134144,29,7555750191
6582,49071430,21632639,70704069,6,0,1,5632,11,164706618
6583,49072709,12510602,61583311,1,0,0,512,22,10212910517
6584,49075600,12530660,61606260,3,0,0,3584,25,10228124124
6585,49085590,21660931,70746521,4,0,1,83968,29,8888823951
6586,49088480,21694279,70782759,4,0,1,55296,29,6090371888
6587,49090300,12245533,61335833,8,0,0,512,17,4389349075
6588,49094060,21820499,70914559,4,0,1,153088,29,7614774674
6589,49116879,21801219,70918098,7,0,1,512,5,2716156648
6590,49117710,13695234,62812944,3,0,0,111104,25,8443303116
6591,49117899,12701297,61819196,0,0,0,15360,9,7585051003
6592,49128580,21794344,70922924,6,0,1,7680,11,2765657184
6593,49140049,13547259,62687308,6,0,0,76288,11,10526417483
6594,49141799,21787257,70929056,5,0,1,9728,25,10642702477
6595,49155290,21789998,70945288,4,0,1,52736,29,7018247622
6596,49156669,21790591,70947260,3,0,1,3072,25,7027255868
6597,49163099,21785787,70948886,1,0,1,2560,22,2902913293
6598,49170399,12274840,61445239,1,0,0,1024,22,6410670016
6599,49179129,12551538,61730667,6,0,0,38400,11,9475957933
6600,49180280,12275069,61455349,3,0,0,9216,25,4974394472
6601,49190220,21785476,70975696,4,0,1,61952,29,5941792169
6602,49191279,21787963,70979242,5,0,1,5632,25,6836493772
6603,49193800,21826268,71020068,4,0,1,24576,29,6607182979
6604,49198469,21842736,71041205,3,0,1,15872,25,2483732830
6605,49209849,21834918,71044767,5,0,1,1536,25,2284354153
6606,49211200,21834553,71045753,6,0,1,1536,11,6515711687
6607,49211790,21835589,71047379,6,0,1,2560,11,6595383064
6608,49213519,12412032,61625551,0,0,0,16896,9,5867233266
6609,49215350,13143369,62358719,2,0,0,44032,0,116266019
6610,49219459,21830826,71050285,5,0,1,4608,25,7906355742
6611,49221859,12873612,62095471,1,0,0,1536,22,9740454893
6612,49230529,21822279,71052808,7,0,1,1536,5,1840024905
6613,49231570,21823184,71054754,9,0,1,3072,9,4893107877
6614,49237579,13819149,63056728,0,0,0,87552,9,10397778824
6615,49240580,13200542,62441122,2,0,0,40960,0,6050442744
6616,49244969,12361749,61606718,1,0,0,512,22,8043389516
6617,49252759,12700058,61952817,1,0,0,5120,22,2596198659
6618,49258669,13520400,62779069,1,0,0,512,22,10224923198
6619,49262030,21793974,71056004,0,0,1,1024,9,2158171628
6620,49266100,21790250,71056350,6,0,1,512,11,481081711
6621,49279040,21777976,71057016,4,0,1,1024,29,615702930
6622,49281370,21778183,71059553,4,0,1,11264,29,2569127121
6623,49282100,12672947,61955047,2,0,0,7168,0,4042809412
6624,49286699,21774160,71060859,1,0,1,2048,22,6859885551
6625,49293390,21769095,71062485,6,0,1,2560,11,5345307370
6626,49300949,21763828,71064777,7,0,1,3584,5,10127330746
6627,49311619,21753517,71065136,3,0,1,9728,25,5892702119
6628,49318420,12993583,62312003,8,0,0,2560,17,6188613380
6629,49322069,13611142,62933211,6,0,0,33792,11,421477064
6630,49326350,13505204,62831554,3,0,0,55296,25,10244379557
6631,49335749,12974134,62309883,0,0,0,49664,9,4468029622
6632,49336650,12643122,61979772,3,0,0,1024,25,8639584329
6633,49339160,12549582,61888742,2,0,0,64512,0,7063639199
6634,49339589,21727173,71066762,7,0,1,2560,5,8294106730
6635,49340109,12772206,62112315,0,0,0,23552,9,6890217710
6636,49347389,13200576,62547965,0,0,0,104448,9,2761033909
6637,49359619,13854386,63214005,6,0,0,70144,11,9992377259
6638,49360310,21720942,71081252,6,0,1,5632,11,7965218680
6639,49363229,12255177,61618406,0,0,0,3584,9,9525126972
6640,49369249,21715229,71084478,7,0,1,5120,5,10727480758
6641,49380389,12985373,62365762,0,0,0,23040,9,9941391845
6642,49383900,13001179,62385079,1,0,0,2048,22,10121825507
6643,49393440,21692024,71085464,6,0,1,1536,11,4990175580
6644,49408180,21680190,71088370,4,0,1,4608,29,336869271
6645,49417910,13944812,63362722,2,0,0,74752,0,1300567752
6646,49429240,21662356,71091596,6,0,1,5120,11,708946357
6647,49433239,12547086,61980325,1,0,0,512,22,10475492477
6648,49434949,12401307,61836256,6,0,0,512,11,10700011151
6649,49439500,21653722,71093222,6,0,1,2560,11,7383838081
6650,49441010,13190095,62631105,3,0,0,36864,25,9880137209
6651,49449220,12515530,61964750,2,0,0,31744,0,3265002619
6652,49456960,21639488,71096448,4,0,1,5120,29,8375104661
6653,49464139,21636815,71100954,5,0,1,7168,25,4118588879
6654,49466969,12513161,61980130,6,0,0,1024,11,7378057607
6655,49470509,21632071,71102580,5,0,1,2560,25,5521715609
6656,49476689,21626045,71102734,7,0,1,8704,5,5142275753
6657,49494689,12551061,62045750,0,0,0,1536,9,3228280182
6658,49500480,21629110,71129590,6,0,1,3072,11,9575722894
6659,49501949,13741522,63243471,6,0,0,22528,11,3880862196
6660,49502570,21627276,71129846,6,0,1,9216,11,9731923335
6661,49509630,21623522,71133152,4,0,1,4608,29,1083623254
6662,49521109,12790068,62311177,6,0,0,4096,11,10419975858
6663,49522340,12616939,62139279,3,0,0,23552,25,3506552249
6664,49524789,12465784,61990573,1,0,0,2048,22,4006807679
6665,49527850,21610448,71138298,6,0,1,8192,11,594815551
6666,49528779,21614665,71143444,2,0,1,8192,0,6225548228
6667,49530980,21615625,71146605,4,0,1,3584,29,6700329568
6668,49535099,21621625,71156724,7,0,1,7680,5,9394696287
6669,49542469,13217522,62759991,6,0,0,65536,11,1634862496
6670,49543450,13438831,62982281,3,0,0,15872,25,607044094
6671,49548620,21608450,71157070,6,0,1,512,11,6492230234
6672,49553520,13056011,62609531,2,0,0,99840,0,9424431143
6673,49558490,21602126,71160616,4,0,1,5632,29,5419099495
6674,49573079,12905234,62478313,0,0,0,47616,9,9110272391
6675,49585029,21576253,71161282,7,0,1,1024,5,3222016758
6676,49597940,12981148,62579088,2,0,0,40960,0,8220012725
6677,49598620,21564288,71162908,4,0,1,2560,29,7199870497
6678,49614530,13044215,62658745,3,0,0,4608,25,2934707682
6679,49618920,13296315,62915235,2,0,0,38400,0,9531350526
6680,49619789,21550992,71170781,5,0,1,6656,25,10175128475
6681,49622230,21548574,71170804,9,0,1,1024,9,1651801499
6682,49627340,13257055,62884395,3,0,0,1536,25,9447252770
6683,49635499,12750471,62385970,1,0,0,512,22,9671615100
6684,49639190,21543387,71182577,6,0,1,3072,11,7078693378
6685,49655539,12524292,62179831,0,0,0,3584,9,8750806881
6686,49656259,12892376,62548635,1,0,0,2048,22,3226332876
6687,49664579,12622697,62287276,1,0,0,1536,22,7420812966
6688,49666540,21517663,71184203,6,0,1,2560,11,10141522527
6689,49668999,21518483,71187482,5,0,1,512,25,1528776576
6690,49669890,13252856,62922746,3,0,0,24576,25,2432919808
6691,49674990,21515718,71190708,6,0,1,5120,11,1988609900
6692,49678329,21516762,71195091,5,0,1,13312,25,6664142999
6693,49680289,13658831,63339120,0,0,0,8192,9,7030897680
6694,49699329,12666612,62365941,1,0,0,512,22,9905162080
6695,49704049,13179832,62883881,0,0,0,138752,9,8194417546
6696,49711399,21488943,71200342,7,0,1,512,5,2411370163
6697,49723230,21481938,71205168,4,0,1,7680,29,6088903820
6698,49724650,13569893,63294543,2,0,0,40960,0,10248165107
6699,49728169,21536514,71264683,5,0,1,4096,25,7872971378
6700,49745640,21519218,71264858,6,0,1,3584,11,4574135511
6701,49755759,12860703,62616462,1,0,0,512,22,7987949122
6702,49757270,14048951,63806221,3,0,0,58368,25,2533334506
6703,49763870,21501011,71264881,4,0,1,512,29,6790338084
6704,49771459,12876765,62648224,6,0,0,28672,11,2575792463
6705,49777210,21504743,71281953,4,0,1,29184,29,7875832252
6706,49825870,13833500,63659370,3,0,0,54784,25,9189808644
6707,49826729,13076721,62903450,6,0,0,62464,11,8783129213
6708,49831899,21450400,71282299,7,0,1,512,5,8600622803
6709,49838930,13632355,63471285,2,0,0,55296,0,8120080097
6710,49848029,21453095,71301124,5,0,1,3584,25,5862366549
6711,49851669,21449478,71301147,7,0,1,3584,5,5628382684
6712,49870979,21430191,71301170,5,0,1,1536,25,2136111004
6713,49871249,12787675,62658924,1,0,0,512,22,7802981869
6714,49876029,13154000,63030029,0,0,0,41472,9,9350207478
6715,49883679,13482457,63366136,1,0,0,512,22,3420101172
6716,49894809,13226706,63121515,0,0,0,25088,9,4721065922
6717,49940190,12838700,62778890,2,0,0,61952,0,7114368377
6718,49946040,13538684,63484724,3,0,0,44032,25,8043593714
6719,49946289,13792554,63738843,6,0,0,62976,11,3089276690
6720,49955690,13686965,63642655,2,0,0,102400,0,1265996706
6721,49958230,13124306,63082536,2,0,0,12800,0,6948906404
6722,49977149,12960181,62937330,6,0,0,13312,11,1566301661
6723,49986781,21314412,71301193,8,0,1,1024,17,2443227570
6724,49988320,13607927,63596247,3,0,0,66048,25,4335864009
6725,50002040,12614204,62616244,3,0,0,15360,25,10372458918
6726,50004229,12829025,62833254,0,0,0,4608,9,5675784105
6727,50033411,21267805,71301216,8,0,1,6144,17,1731507114
6728,50044631,21256608,71301239,8,0,1,11776,17,9204525513
6729,50045920,12931502,62977422,2,0,0,41984,0,10014068576
6730,50057209,21245104,71302313,5,0,1,3584,25,9752635131
6731,50058339,21244960,71303299,7,0,1,1536,5,6171032081
6732,50060259,12754424,62814683,0,0,0,5632,9,10365481308
6733,50065329,13460671,63526000,6,0,0,33792,11,1854411921
6734,50066100,13270501,63336601,3,0,0,74240,25,9802042160
6735,50068459,21236146,71304605,3,0,1,2048,25,5206289657
6736,50072030,13041818,63113848,2,0,0,18944,0,3453477733
6737,50078581,21268358,71346939,8,0,1,3072,17,9153183524
6738,50092830,13323194,63416024,2,0,0,17920,0,9272469435
6739,50094010,13142574,63236584,2,0,0,16384,0,742753259
6740,50095009,21255796,71350805,3,0,1,6144,25,3227045574
6741,50100799,21254312,71355111,3,0,1,512,25,8828942848
6742,50109619,21246363,71355982,3,0,1,12288,25,9724286342
6743,50128739,13236970,63365709,0,0,0,9728,9,8646859690
6744,50135069,21247224,71382293,7,0,1,6656,5,4311516168
6745,50136809,13620884,63757693,6,0,0,60416,11,3282301232
6746,50142189,13805201,63947390,6,0,0,92160,11,6285725616
6747,50145280,13550667,63695947,2,0,0,36352,0,6609155962
6748,50161509,21220807,71382316,3,0,1,6656,25,9859848295
6749,50178979,13527752,63706731,6,0,0,28160,11,6573001675
6750,50189460,12886469,63075929,2,0,0,5120,0,8146544460
6751,50189810,13729206,63919016,2,0,0,17408,0,7639902941
6752,50190909,13040660,63231569,0,0,0,32256,9,3133269917
6753,50206239,13707271,63913510,6,0,0,90112,11,6071980174
6754,50211249,13188675,63399924,0,0,0,13824,9,10061449923
6755,50214539,21194747,71409286,1,0,1,2560,22,3044771150
6756,50220230,13464439,63684669,2,0,0,47616,0,4225630472
6757,50224389,21184920,71409309,3,0,1,512,25,5543915386
6758,50237169,21174348,71411517,3,0,1,6144,25,10666722828
6759,50248099,13970944,64219043,0,0,0,38912,9,921644475
6760,50248229,21168114,71416343,7,0,1,7680,5,2943758464
6761,50256529,21163754,71420283,1,0,1,4096,22,714531193
6762,50259469,13311726,63571195,6,0,0,29184,11,8907535091
6763,50259870,12961848,63221718,3,0,0,25088,25,5274881893
6764,50266119,13888277,64154396,6,0,0,76800,11,1178550751
6765,50276859,21146847,71423706,3,0,1,5632,25,10716586560
6766,50288859,21135193,71424052,1,0,1,512,22,9735579329
6767,50291819,21135459,71427278,1,0,1,5120,22,1759803221
6768,50292859,12711373,63004232,1,0,0,512,22,3498162291
6769,50295939,12949271,63245210,0,0,0,5632,9,3645370861
6770,50301621,21128243,71429864,8,0,1,4096,17,7818598898
6771,50311011,21122399,71433410,8,0,1,5632,17,3224752938
6772,50331251,21104745,71435996,8,0,1,4096,17,2180778589
6773,50333710,14133100,64466810,3,0,0,157696,25,4873114369
6774,50335681,21101301,71436982,8,0,1,1536,17,178089483
6775,50339869,13928559,64268428,0,0,0,9216,9,372171285
6776,50341090,13230908,63571998,2,0,0,2560,0,4995745009
6777,50343529,13024190,63367719,0,0,0,5120,9,7465843873
6778,50346999,14246319,64593318,0,0,0,40448,9,5811427282
6779,50355049,21084199,71439248,3,0,1,3584,25,7204260721
6780,50355779,21084455,71440234,3,0,1,1536,25,9743825726
6781,50360081,21080819,71440900,8,0,1,1024,17,1056107850
6782,50361540,13004394,63365934,2,0,0,512,0,10083959901
6783,50375899,13479252,63855151,6,0,0,101888,11,1001620537
6784,50393000,13590416,63983416,3,0,0,20992,25,4009104111
6785,50411559,21032787,71444346,3,0,1,2048,25,5028544763
6786,50428199,13343205,63771404,1,0,0,2048,22,2276133569
6787,50434529,21010278,71444807,3,0,1,10240,25,5681926047
6788,50441890,13009718,63451608,2,0,0,512,0,6675137686
6789,50467469,12872454,63339923,1,0,0,2560,22,1201592942
6790,50480320,13008562,63488882,3,0,0,7680,25,2357531002
6791,50500840,13286561,63787401,3,0,0,6144,25,1285263424
6792,50511099,12912124,63423223,0,0,0,23552,9,2273056332
6793,50525749,20973955,71499704,1,0,1,2560,22,9251613594
6794,50534819,13563475,64098294,0,0,0,115200,9,9506269960
6795,50546730,13192292,63739022,2,0,0,512,0,4934016382
6796,50552689,12990427,63543116,0,0,0,19456,9,4020633936
6797,50552779,13624913,64177692,0,0,0,6656,9,6200170718
6798,50560049,21015150,71575199,5,0,1,18944,25,473277788
6799,50574949,13446242,64021191,1,0,0,1024,22,928645100
6800,50576209,13108639,63684848,1,0,0,512,22,10602324974
6801,50610579,13715893,64326472,6,0,0,38400,11,5013556442
6802,50614519,13592146,64206665,1,0,0,1536,22,417976606
6803,50615510,13303777,63919287,2,0,0,512,0,7283276707
6804,50627199,13859078,64486277,0,0,0,6656,9,5522908966
6805,50647929,13658282,64306211,6,0,0,81408,11,10527902227
6806,50653770,14030933,64684703,3,0,0,41984,25,2826609202
6807,50655210,13008551,63663761,3,0,0,14336,25,7627569110
6808,50659769,13536797,64196566,0,0,0,21504,9,1565125872
6809,50660629,13601161,64261790,1,0,0,1024,22,9569922024
6810,50674820,13726353,64401173,3,0,0,49152,25,2442030635
6811,50678380,12921197,63599577,3,0,0,10752,25,8133778562
6812,50687609,13435300,64122909,0,0,0,5120,9,2377491672
6813,50695689,20879856,71575545,3,0,1,512,25,1707460479
6814,50696709,20880462,71577171,1,0,1,2560,22,10305091777
6815,50699939,13181512,63881451,6,0,0,37376,11,4141782700
6816,50700939,13780916,64481855,6,0,0,40960,11,9240866506
6817,50712359,20873789,71586148,3,0,1,3072,25,9244466156
6818,50714979,20888593,71603572,3,0,1,2560,25,9109172925
6819,50730579,13489111,64219690,6,0,0,2048,11,1663605747
6820,50730810,13182879,63913689,2,0,0,512,0,10054762928
6821,50734019,20869576,71603595,3,0,1,6144,25,4988051902
6822,50746429,20857189,71603618,3,0,1,1024,25,8366882528
6823,50754680,13115360,63870040,3,0,0,48640,25,6051395186
6824,50758919,20844722,71603641,1,0,1,7168,22,2341115844
6825,50776440,13465257,64241697,2,0,0,1536,0,9987644131
6826,50809129,20797263,71606392,3,0,1,8192,25,4425605178
6827,50813769,20793609,71607378,3,0,1,1536,25,3184885212
6828,50822039,20793711,71615750,1,0,1,13312,22,6717170862
6829,50865289,20755959,71621248,3,0,1,5120,25,6300298604
6830,50894400,12988821,63883221,3,0,0,5632,25,3821162364
6831,50895870,13127202,64023072,2,0,0,512,0,1284808433
6832,50898439,13087753,63986192,6,0,0,4608,11,5880931033
6833,50900039,20735246,71635285,1,0,1,14336,22,849765023
6834,50901599,20736592,71638191,3,0,1,4608,25,9284927176
6835,50904870,13091925,63996795,3,0,0,1024,25,6008940162
6836,50930520,13168109,64098629,2,0,0,1024,0,1200797929
6837,50943009,20753813,71696822,1,0,1,1536,22,4140122906
6838,50958709,20738136,71696845,2,0,1,1536,0,5141257863
6839,50966059,13054797,64020856,0,0,0,12800,9,8455169028
6840,50972380,13074113,64046493,3,0,0,11776,25,6607810166
6841,50973979,20765551,71739530,1,0,1,3584,22,7721099642
6842,50976010,20769438,71745448,6,0,1,3072,11,1389111566
6843,50976340,13144487,64120827,3,0,0,72704,25,1511401553
6844,50985639,20760795,71746434,1,0,1,1536,22,10457422208
6845,50993160,20767254,71760414,6,0,1,8704,11,3951503905
6846,50993400,13333586,64326986,2,0,0,1024,0,10621019361
6847,51009199,20751238,71760437,3,0,1,15872,25,6176347886
6848,51011179,13019900,64031079,6,0,0,14336,11,4451784020
6849,51015089,13226117,64241206,0,0,0,13824,9,169631571
6850,51024579,13106394,64130973,0,0,0,6144,9,4842844574
6851,51026259,13877779,64904038,0,0,0,73216,9,7378119908
6852,51034369,12963806,63998175,1,0,0,512,22,4187126425
6853,51054679,20768929,71823608,2,0,1,6144,0,859416214
6854,51067179,13133021,64200200,6,0,0,10240,11,1626916253
6855,51068389,20772480,71840869,3,0,1,4096,25,3489844286
6856,51072409,13761207,64833616,6,0,0,100864,11,5035997837
6857,51087629,13493342,64580971,0,0,0,37376,9,4043642307
6858,51088090,20770218,71858308,6,0,1,8704,11,7592382453
6859,51089949,20815999,71905948,3,0,1,4096,25,10659822946
6860,51106439,13014887,64121326,1,0,0,1536,22,8325537091
6861,51110150,20795821,71905971,6,0,1,512,11,5444594758
6862,51122419,13084737,64207156,1,0,0,1536,22,3417542218
6863,51128239,13068818,64197057,1,0,0,1536,22,6224582440
6864,51130450,13614852,64745302,3,0,0,139264,25,9712525008
6865,51136999,13530140,64667139,1,0,0,2560,22,9104368652
6866,51149140,13070737,64219877,2,0,0,512,0,4027708565
6867,51152150,13174501,64326651,2,0,0,512,0,6448537490
6868,51163760,13502576,64666336,3,0,0,143360,25,9470945012
6869,51173849,20732145,71905994,3,0,1,3072,25,2943361461
6870,51177430,20802223,71979653,6,0,1,16384,11,9311904223
6871,51178510,13926127,65104637,2,0,0,1536,0,2059559706
6872,51184289,20795395,71979684,3,0,1,2560,25,5833362422
6873,51188709,13172794,64361503,6,0,0,25088,11,958223298
6874,51229180,12976971,64206151,3,0,0,19456,25,7594736465
6875,51247240,12996366,64243606,2,0,0,1536,0,8061216081
6876,51262829,20744061,72006890,3,0,1,2048,25,8400734123
6877,51274489,13229013,64503502,6,0,0,55808,11,7196963938
6878,51287069,13040252,64327321,1,0,0,1024,22,5768104799
6879,51303860,13114879,64418739,3,0,0,37376,25,9075389557
6880,51304649,20702264,72006913,3,0,1,24576,25,6992249662
6881,51312529,13535843,64848372,0,0,0,13824,9,6584578808
6882,51312879,13531235,64844114,0,0,0,33280,9,4319206637
6883,51319620,13908202,65227822,3,0,0,24576,25,6523669785
6884,51339429,13191514,64530943,6,0,0,14336,11,5651369930
6885,51347050,13137168,64484218,3,0,0,7680,25,1337003571
6886,51347089,13203363,64550452,1,0,0,512,22,1126418488
6887,51349449,20657487,72006936,3,0,1,4096,25,6316208243
6888,51353120,12915487,64268607,2,0,0,512,0,7000835535
6889,51355949,13113403,64469352,6,0,0,5632,11,2607170498
6890,51366939,20640020,72006959,7,0,1,6144,5,7921340092
6891,51370359,13409740,64780099,0,0,0,3072,9,3742864606
6892,51387579,20726279,72113858,7,0,1,512,5,5960129444
6893,51389559,20724322,72113881,7,0,1,4096,5,3875599622
6894,51403309,13597526,65000835,0,0,0,19968,9,5424739118
6895,51405289,13217113,64622402,6,0,0,9728,11,8856301501
6896,51416339,20698368,72114707,7,0,1,4608,5,9489350740
6897,51442400,12919282,64361682,2,0,0,512,0,8725425194
6898,51469549,20645181,72114730,5,0,1,6144,25,5724594655
6899,51520490,13553673,65074163,3,0,0,22016,25,4064100149
6900,51526739,13084763,64611502,0,0,0,35328,9,8342855288
6901,51526779,13620121,65146900,0,0,0,37376,9,1212724970
6902,51544219,13127669,64671888,0,0,0,15360,9,10416233775
6903,51553649,12958768,64512417,6,0,0,29184,11,6152236383
6904,51570859,12896754,64467613,0,0,0,2560,9,1840521334
6905,51578610,13015892,64594502,2,0,0,512,0,1840456105
6906,51607910,13386818,64994728,3,0,0,65536,25,10724024524
6907,51611870,20502883,72114753,4,0,1,14848,29,10454376771
6908,51621480,20493296,72114776,4,0,1,3584,29,1538240774
6909,51623940,20494166,72118106,6,0,1,6656,11,7378575029
6910,51632760,20492100,72124860,6,0,1,4096,11,10145832638
6911,51643679,12950286,64593965,1,0,0,2048,22,2214107972
6912,51656599,12897610,64554209,6,0,0,8192,11,5831332504
6913,51685310,13279286,64964596,3,0,0,44544,25,7713455624
6914,51686790,12825806,64512596,2,0,0,512,0,9931374489
6915,51689360,12923101,64612461,3,0,0,3072,25,10608804995
6916,51689379,13144572,64833951,1,0,0,1024,22,4236002339
6917,51692780,13155771,64848551,2,0,0,512,0,7096307739
6918,51723070,20401813,72124883,4,0,1,2048,29,9215113141
6919,51723729,12961409,64685138,1,0,0,1024,22,3531535048
6920,51724090,13643011,65367101,2,0,0,1536,0,1791262209
6921,51737350,13166867,64904217,2,0,0,512,0,4249590009
6922,51746369,13358915,65105284,1,0,0,2048,22,5915418940
6923,51752970,12841353,64594323,2,0,0,512,0,9423261872
6924,51761799,13466358,65228157,1,0,0,1024,22,5771092234
6925,51784980,13217773,65002753,3,0,0,5632,25,4458441762
6926,51791350,20333556,72124906,6,0,1,512,11,1593598067
6927,51793839,13422602,65216441,6,0,0,89600,11,6935997368
6928,51806209,12787935,64594144,1,0,0,512,22,7858847150
6929,51807919,20317010,72124929,7,0,1,1536,5,7212123446
6930,51808730,20316270,72125000,6,0,1,3072,11,6211211195
6931,51813949,13207108,65021057,1,0,0,1024,22,6639327378
6932,51814450,13289688,65104138,3,0,0,98304,25,615483234
6933,51816809,12928672,64745481,1,0,0,512,22,8600021884
6934,51836470,13567549,65404019,3,0,0,70656,25,6271484602
6935,51843789,12902050,64745839,1,0,0,1024,22,2063583586
6936,51851340,20273691,72125031,6,0,1,1024,11,4925954379
6937,51861620,20263442,72125062,6,0,1,15872,11,809116161
6938,51872519,13479624,65352143,6,0,0,130560,11,2476641718
6939,51880349,13094388,64974737,6,0,0,30720,11,6843208871
6940,51890109,13407361,65297470,6,0,0,41984,11,55022471
6941,51904900,13676169,65581069,3,0,0,153600,25,3054673635
6942,51936810,13239639,65176449,6,0,0,71680,11,3609719895
6943,51941480,20243384,72184864,6,0,1,1536,11,3359705381
6944,51941920,13309836,65251756,3,0,0,19456,25,4942370270
6945,51943650,12976577,64920227,3,0,0,512,25,8459875419
6946,51952030,20232865,72184895,6,0,1,5120,11,131019523
6947,51962360,13277832,65240192,6,0,0,39424,11,9743208309
6948,51969919,13178564,65148483,0,0,0,5120,9,2408242815
6949,51971040,13333204,65304244,2,0,0,2048,0,10595410195
6950,51972860,13841520,65814380,7,0,0,52736,5,246649552
6951,51980940,13124523,65105463,1,0,0,512,22,1104662201
6952,52010100,13342736,65352836,3,0,0,512,25,9357977597
6953,52035379,13317278,65352657,1,0,0,1024,22,3442748933
6954,52061020,20171789,72232809,6,0,1,3072,11,5310859851
6955,52083581,20149267,72232848,8,0,1,7680,17,7279181968
6956,52099349,13119524,65218873,0,0,0,7680,9,3902206584
6957,52117220,20115794,72233014,6,0,1,3072,11,7805394569
6958,52122900,12897822,65020722,6,0,0,14336,11,10688473460
6959,52146179,20093866,72240045,3,0,1,3584,25,4671509020
6960,52157070,13106453,65263523,3,0,0,1024,25,3026762035
6961,52160840,13136809,65297649,2,0,0,512,0,8540504449
6962,52170460,13284468,65454928,3,0,0,512,25,10200854737
6963,52174740,12826274,65001014,3,0,0,512,25,1490300539
6964,52189839,20093884,72283723,3,0,1,28160,25,1345041812
6965,52197169,20103719,72300888,5,0,1,10752,25,4130074929
6966,52199319,20101662,72300981,3,0,1,5120,25,600668396
6967,52201280,13416779,65618059,6,0,0,41984,11,5875887341
6968,52205200,20099647,72304847,6,0,1,6144,11,9669081059
6969,52205709,20109151,72314860,3,0,1,6656,25,9499816283
6970,52217799,20097215,72315014,3,0,1,8704,25,10092129267
6971,52236900,20126471,72363371,6,0,1,9728,11,7115646829
6972,52243370,13213726,65457096,3,0,0,1024,25,5327875634
6973,52244310,13177194,65421504,6,0,0,10240,11,2993682208
6974,52259109,13216245,65475354,1,0,0,512,22,10540998426
6975,52262789,20197912,72460701,5,0,1,96768,25,5249045309
6976,52271589,20324194,72595783,5,0,1,109056,25,4652992250
6977,52271610,12877052,65148662,3,0,0,512,25,6944000404
6978,52286440,20314285,72600725,6,0,1,512,11,8812246413
6979,52286769,20319102,72605871,3,0,1,8192,25,6999250881
6980,52290230,20316627,72606857,6,0,1,1536,11,6498914402
6981,52291919,20318804,72610723,3,0,1,6144,25,9566111207
6982,52305800,12843049,65148849,2,0,0,512,0,5401225084
6983,52307070,20305279,72612349,6,0,1,2560,11,8105423025
6984,52317190,20297105,72614295,6,0,1,3072,11,3345834532
6985,52319439,20320929,72640368,3,0,1,4096,25,5618071654
6986,52320180,13161678,65481858,3,0,0,512,25,6730968880
6987,52321560,20347422,72668982,6,0,1,21504,11,8163390049
6988,52338570,13637228,65975798,6,0,0,41984,11,6155272695
6989,52349810,20372935,72722745,6,0,1,2048,11,10264238122
6990,52353090,12899001,65252091,2,0,0,1024,0,5105830
6991,52353889,20383200,72737089,1,0,1,7168,22,6849340151
6992,52353960,20394887,72748847,6,0,1,2048,11,2080318156
6993,52367340,13218056,65585396,6,0,0,13824,11,3301080513
6994,52372970,12925083,65298053,2,0,0,1024,0,10456703863
6995,52373230,20378203,72751433,6,0,1,4096,11,6629633667
6996,52385349,20378579,72763928,3,0,1,1024,25,4238282431
6997,52398149,12954173,65352322,1,0,0,512,22,2622533583
6998,52402809,12881506,65284315,1,0,0,512,22,3233171869
6999,52419890,12942291,65362181,2,0,0,512,0,2300505602
7000,52431829,13026171,65458000,1,0,0,512,22,7115814866
7001,52432919,20363476,72796395,3,0,1,11776,25,8144862935
7002,52441179,13162610,65603789,0,0,0,11776,9,8375830969
7003,52446220,13021640,65467860,2,0,0,1024,0,167293261
7004,52452000,20394628,72846628,6,0,1,7168,11,2695463906
7005,52467229,20465186,72932415,5,0,1,43520,25,5669238205
7006,52482719,20449719,72932438,5,0,1,30720,25,10389160071
7007,52484309,12920403,65404712,1,0,0,2048,22,7743654647
7008,52486390,12812666,65299056,2,0,0,512,0,8798891899
7009,52497299,12909244,65406543,0,0,0,5632,9,8915370880
7010,52498919,20780985,73279904,5,0,1,202240,25,218948350
7011,52508429,20795085,73303514,5,0,1,22016,25,3960697847
7012,52510249,20922226,73432475,5,0,1,165376,25,6162438320
7013,52513269,13275232,65788501,0,0,0,15872,9,9625932492
7014,52515180,20919881,73435061,9,0,1,4096,9,9079284673
7015,52523020,20914773,73437793,6,0,1,512,11,3099643219
7016,52526940,13671942,66198882,6,0,0,108032,11,2771630090
7017,52530080,13184903,65714983,3,0,0,2560,25,6639882723
7018,52530719,20907740,73438459,3,0,1,1024,25,2562677208
7019,52537589,20922585,73460174,5,0,1,20992,25,2350398039
7020,52551360,13614560,66165920,6,0,0,113664,11,10114604548
7021,52552369,20908151,73460520,3,0,1,512,25,2673620299
7022,52587440,12941684,65529124,3,0,0,512,25,8180663180
7023,52590950,20872156,73463106,6,0,1,4096,11,6052327968
7024,52597060,13029751,65626811,2,0,0,512,0,5402800580
7025,52600620,12926056,65526676,3,0,0,2560,25,9173022350
7026,52608450,12977125,65585575,2,0,0,512,0,3432419191
7027,52611020,20853712,73464732,6,0,1,2560,11,5089357014
7028,52615959,20853279,73469238,3,0,1,7168,25,534628273
7029,52617290,13001112,65618402,8,0,0,1024,17,3215497404
7030,52621299,12964486,65585785,1,0,0,512,22,5184386710
7031,52645179,13095122,65740301,0,0,0,54272,9,9909830779
7032,52645829,20827074,73472903,3,0,1,9216,25,8737080489
7033,52646589,12846407,65492996,0,0,0,29184,9,7641270896
7034,52653470,12844748,65498218,2,0,0,1024,0,5907581573
7035,52657369,12836056,65493425,1,0,0,1024,22,4051712837
7036,52663680,20837619,73501299,6,0,1,2048,11,9939151421
7037,52675119,20831062,73506181,5,0,1,24576,25,4655705516
7038,52692979,20838049,73531028,3,0,1,6144,25,7772682403
7039,52704829,20829105,73533934,3,0,1,4608,25,6015342955
7040,52721610,12757176,65478786,3,0,0,512,25,187615794
7041,52726279,20811201,73537480,5,0,1,5632,25,4483814578
7042,52727539,20810812,73538351,5,0,1,12288,25,9803667966
7043,52730600,20826492,73557092,6,0,1,6656,11,6531859967
7044,52737480,13088431,65825911,2,0,0,2560,0,5097003678
7045,52742490,12751114,65493604,3,0,0,512,25,2683279242
7046,52742759,20815306,73558065,3,0,1,12800,25,9759975425
7047,52750280,20814256,73564536,6,0,1,2560,11,4284933827
7048,52758200,20819141,73577341,4,0,1,3584,29,3477306714
7049,52765610,12928844,65694454,6,0,0,19968,11,6922633525
7050,52775119,20816765,73591884,5,0,1,40448,25,7945759194
7051,52785639,20806911,73592550,1,0,1,11264,22,7398363740
7052,52793589,20925722,73719311,5,0,1,167424,25,6353265019
7053,52794229,20947712,73741941,3,0,1,25088,25,7073838351
7054,52806490,20936437,73742927,6,0,1,1536,11,10158447285
7055,52806849,12947985,65754834,0,0,0,22528,9,9366308969
7056,52816730,13392975,66209705,6,0,0,34816,11,5320352496
7057,52825019,13471172,66296191,0,0,0,46592,9,7689629822
7058,52844239,20913252,73757491,1,0,1,11264,22,2734330769
7059,52861319,20949522,73810841,5,0,1,58368,25,6337875087
7060,52863280,13016567,65879847,6,0,0,33280,11,6289723121
7061,52900970,12797818,65698788,2,0,0,1024,0,9191693672
7062,52910609,20900255,73810864,2,0,1,2560,0,3459638818
7063,52929479,20987126,73916605,5,0,1,143360,25,10704742074
7064,52956069,13141578,66097647,1,0,0,1024,22,6122908813
7065,52958459,13090305,66048764,6,0,0,3072,11,4661385478
7066,52969859,20970449,73940308,2,0,1,5120,0,182932708
7067,53012520,12930187,65942707,3,0,0,512,25,8934034353
7068,53013909,20926655,73940564,2,0,1,9216,0,1769368515
7069,53032760,13413534,66446294,3,0,0,18944,25,7352694792
7070,53045229,20913343,73958572,5,0,1,30720,25,9383326376
7071,53045279,12804565,65849844,1,0,0,512,22,7784521082
7072,53046249,20924076,73970325,2,0,1,3584,0,6930535620
7073,53061650,13301555,66363205,3,0,0,141312,25,9737768896
7074,53108019,13212107,66320126,6,0,0,22016,11,10189063894
7075,53121379,20850363,73971742,2,0,1,2048,0,3399402370
7076,53131959,20841409,73973368,2,0,1,2560,0,1520666014
7077,53140999,20835595,73976594,5,0,1,5120,25,145017256
7078,53143249,12740209,65883458,6,0,0,11776,11,6724895662
7079,53165699,20811561,73977260,5,0,1,11264,25,4686002290
7080,53170480,12865071,66035551,1,0,0,512,22,7835525789
7081,53175649,13378244,66553893,6,0,0,47104,11,741993689
7082,53178679,12809154,65987833,6,0,0,39424,11,21916494
7083,53181160,13094496,66275656,3,0,0,20992,25,4220231226
7084,53193199,13170185,66363384,1,0,0,512,22,2060719693
7085,53201570,13238929,66440499,3,0,0,79360,25,8631300301
7086,53217850,13719638,66937488,2,0,0,512,0,1080162049
7087,53246671,20734561,73981232,8,0,1,3072,17,3573820906
7088,53249059,20732196,73981255,5,0,1,1024,25,2086458380
7089,53260299,20720979,73981278,2,0,1,2048,0,10436509213
7090,53272051,20711124,73983175,8,0,1,3072,17,8320076844
7091,53287139,20698942,73986081,5,0,1,4608,25,252375660
7092,53291459,20697848,73989307,2,0,1,5120,0,5127733410
7093,53298109,20692184,73990293,2,0,1,1536,0,7377446658
7094,53298440,12528383,65826823,1,0,0,512,22,7388676269
7095,53302919,12647786,65950705,1,0,0,1536,22,1535030762
7096,53306669,13500947,66807616,6,0,0,73728,11,9646417615
7097,53306819,13920334,67227153,6,0,0,15360,11,6720676324
7098,53318389,20674810,73993199,2,0,1,4608,0,9675713359
7099,53319650,13060651,66380301,3,0,0,55296,25,4959610260
7100,53326109,13384054,66710163,6,0,0,84992,11,7489537007
7101,53376089,20617456,73993545,5,0,1,512,25,1218182146
7102,53378359,13492777,66871136,6,0,0,30720,11,2538324703
7103,53380151,20614816,73994967,8,0,1,13824,17,7923803900
7104,53394249,20608388,74002637,5,0,1,2560,25,4205600575
7105,53397060,13098029,66495089,6,0,0,2048,11,6346941650
7106,53401569,13104548,66506117,6,0,0,16896,11,2320801496
7107,53407240,13441895,66849135,6,0,0,136192,11,9429367066
7108,53415099,20590124,74005223,2,0,1,4096,0,5780073918
7109,53420569,20586600,74007169,5,0,1,3072,25,10662634090
7110,53429140,20579975,74009115,4,0,1,3072,29,296251148
7111,53439411,20580057,74019468,8,0,1,512,17,8318771038
7112,53458531,20566749,74025280,8,0,1,9216,17,3782102099
7113,53462270,13188483,66650753,2,0,0,1536,0,6682052820
7114,53462689,12588541,66051230,1,0,0,512,22,8763066045
7115,53465910,13107761,66573671,1,0,0,2560,22,6270135504
7116,53469031,20557389,74026420,8,0,1,1536,17,6979980825
7117,53471571,20561036,74032607,8,0,1,8704,17,6866214369
7118,53476540,12511472,65988012,2,0,0,512,0,3448059277
7119,53476629,20558506,74035135,2,0,1,3584,0,4455610224
7120,53488850,13383048,66871898,2,0,0,2048,0,6159481023
7121,53489729,20546712,74036441,5,0,1,2048,25,1568398558
7122,53511820,13073994,66585814,3,0,0,7168,25,1987365928
7123,53512919,20527068,74039987,5,0,1,5632,25,3525327425
7124,53513939,20526394,74040333,5,0,1,512,25,9487173545
7125,53519189,20522450,74041639,5,0,1,2048,25,2999492872
7126,53542420,20502445,74044865,4,0,1,5120,29,5952581830
7127,53547741,20497790,74045531,8,0,1,1024,17,1325900660
7128,53555400,13127668,66683068,3,0,0,37888,25,5779104223
7129,53568210,13372600,66940810,3,0,0,10752,25,4370643910
7130,53580491,20473723,74054214,8,0,1,24064,17,1627437487
7131,53593820,12671348,66265168,3,0,0,11776,25,1068034587
7132,53602200,20455563,74057763,4,0,1,4096,29,6596935861
7133,53629369,12778893,66408262,6,0,0,66048,11,10413459818
7134,53629630,12638050,66267680,1,0,0,512,22,7207939489
7135,53630141,20430208,74060349,8,0,1,4096,17,8564938620
7136,53667369,20393646,74061015,5,0,1,1024,25,5523911000
7137,53668150,20394145,74062295,4,0,1,14336,29,5767147646
7138,53673380,13275417,66948797,2,0,0,512,0,2341073608
7139,53673590,20394685,74068275,4,0,1,16384,29,3402082014
7140,53680901,20389640,74070541,8,0,1,3584,17,5431285268
7141,53688361,20383486,74071847,8,0,1,2048,17,5522604289
7142,53702320,12836287,66538607,3,0,0,26624,25,9550980229
7143,53706471,20367642,74074113,8,0,1,3584,17,9052409472
7144,53707330,20371609,74078939,4,0,1,7680,29,4310834917
7145,53709120,12587273,66296393,2,0,0,512,0,7259165070
7146,53712681,20392265,74104946,8,0,1,10240,17,4696066076
7147,53721759,13215550,66937309,6,0,0,47104,11,10012692957
7148,53726091,20381121,74107212,8,0,1,3584,17,7703322550
7149,53729270,13128381,66857651,3,0,0,27648,25,1528680445
7150,53735791,20375927,74111718,8,0,1,7168,17,1584982734
7151,53738969,20374117,74113086,5,0,1,13824,25,6328126678
7152,53750040,20371482,74121522,4,0,1,2560,29,2521701026
7153,53768690,20355098,74123788,6,0,1,3584,11,1663150283
7154,53773380,20379316,74152696,4,0,1,6144,29,7968675551
7155,53773760,12816663,66590423,2,0,0,5120,0,40431841
7156,53784520,20368199,74152719,4,0,1,2048,29,9235048231
7157,53788430,13546510,67334940,3,0,0,130048,25,4264454159
7158,53791070,12800855,66591925,6,0,0,4096,11,10696288596
7159,53791610,20361132,74152742,6,0,1,8704,11,5266998715
7160,53797410,13188412,66985822,6,0,0,1536,11,7356251350
7161,53802700,13120211,66922911,3,0,0,88576,25,8636055588
7162,53804630,12685915,66490545,1,0,0,512,22,2675430656
7163,53814410,20338355,74152765,6,0,1,2048,11,4034450857
7164,53816029,20356534,74172563,5,0,1,1536,25,2353527601
7165,53820611,20353258,74173869,8,0,1,2048,17,4042700090
7166,53832639,20347433,74180072,2,0,1,9728,0,6585290647
7167,53833790,12739078,66572868,3,0,0,13312,25,6645481556
7168,53834890,13171816,67006706,1,0,0,512,22,5963657720
7169,53846549,20348694,74195243,5,0,1,5120,25,7104157483
7170,53850040,20388170,74238210,4,0,1,14848,29,1858338950
7171,53868500,13161867,67030367,1,0,0,512,22,5605408752
7172,53869320,13122765,66992085,3,0,0,20480,25,9520638938
7173,53872911,20383187,74256098,8,0,1,1536,17,5081188829
7174,53885870,13099461,66985331,3,0,0,51712,25,2330932441
7175,53909110,13097371,67006481,3,0,0,36352,25,406089082
7176,53914821,20341431,74256252,8,0,1,8704,17,5309145162
7177,53917790,20344471,74262261,9,0,1,512,9,4347260216
7178,53927079,13162481,67089560,6,0,0,100864,11,2135872827
7179,53930360,12704911,66635271,1,0,0,512,22,7659976456
7180,53931669,20331258,74262927,3,0,1,1024,25,8939558705
7181,53943290,20320303,74263593,4,0,1,1024,29,5517947723
7182,53943390,20322149,74265539,6,0,1,3072,11,5512208595
7183,53943400,12791257,66734657,1,0,0,512,22,7516105293
7184,53943639,20322246,74265885,2,0,1,512,0,8997052270
7185,53959561,20311496,74271057,8,0,1,8192,17,3276918262
7186,53960930,20354763,74315693,4,0,1,2048,29,7215066611
7187,53961850,20359232,74321082,4,0,1,17408,29,3160817071
7188,53994799,20327768,74322567,5,0,1,15360,25,2210458046
7189,54002831,20342981,74345812,8,0,1,27136,17,5889809829
7190,54003440,12707991,66711431,2,0,0,1024,0,6984155716
7191,54020180,20356455,74376635,6,0,1,5120,11,923345970
7192,54025330,20356451,74381781,6,0,1,8192,11,10333777340
7193,54031780,12745867,66777647,2,0,0,1536,0,8955036085
7194,54035701,20417113,74452814,8,0,1,3584,17,7818260282
7195,54046620,20407180,74453800,4,0,1,1536,29,4394973258
7196,54048360,12726102,66774462,2,0,0,1536,0,7085755540
7197,54051680,12600032,66651712,2,0,0,512,0,1475212836
7198,54065329,20393617,74458946,3,0,1,8192,25,4968926127
7199,54069290,12663513,66732803,6,0,0,21504,11,10247373775
7200,54072129,20426817,74498946,5,0,1,7168,25,6699181458
7201,54073610,20442492,74516102,4,0,1,12288,29,7559462154
7202,54077089,20466580,74543669,5,0,1,1024,25,441225601
7203,54090820,12770910,66861730,6,0,0,13312,11,3180653492
7204,54095749,20447943,74543692,3,0,1,512,25,3615812852
7205,54107179,12780317,66887496,6,0,0,23552,11,5425150823
7206,54129559,20414156,74543715,5,0,1,5632,25,4939481725
7207,54131539,20420773,74552312,5,0,1,2048,25,3166171410
7208,54141329,20421655,74562984,5,0,1,19968,25,7107746948
7209,54153869,20410741,74564610,5,0,1,2560,25,2696869095
7210,54184900,12708151,66893051,1,0,0,1024,22,3373536350
7211,54186560,13260142,67446702,5,0,0,11776,25,3068161036
7212,54189309,20377247,74566556,2,0,1,3072,0,3557934416
7213,54189770,20474840,74664610,6,0,1,28160,11,511863617
7214,54202020,13382508,67584528,7,0,0,14336,5,8867609349
7215,54210429,20454204,74664633,5,0,1,11776,25,8506524221
7216,54222030,20482776,74704806,6,0,1,9216,11,8565372458
7217,54235610,12636639,66872249,1,0,0,1024,22,2113481023
7218,54264360,12836322,67100682,1,0,0,512,22,7980507172
7219,54270460,12740711,67011171,1,0,0,512,22,5205537550
7220,54286079,12821357,67107436,6,0,0,10240,11,9549834695
7221,54288100,20448648,74736748,9,0,1,4096,9,1557076689
7222,54297680,13188395,67486075,7,0,0,19456,5,6618398860
7223,54301879,20434892,74736771,5,0,1,2048,25,9831758795
7224,54304410,12664963,66969373,3,0,0,31744,25,8340490062
7225,54320960,13397398,67718358,3,0,0,49152,25,3195444177
7226,54326109,20410685,74736794,3,0,1,8192,25,9780703869
7227,54329100,12794811,67123911,3,0,0,8192,25,2569120892
7228,54334419,20402398,74736817,3,0,1,1024,25,729128008
7229,54350739,12766780,67117519,6,0,0,23552,11,77157433
7230,54353130,12664982,67018112,1,0,0,1024,22,5819947891
7231,54363699,20373141,74736840,5,0,1,5632,25,6336503169
7232,54375330,12887215,67262545,7,0,0,54784,5,1175744504
7233,54381789,20355074,74736863,5,0,1,2048,25,8178525475
7234,54400779,12568773,66969552,1,0,0,512,22,6287969657
7235,54417419,20319467,74736886,5,0,1,2560,25,7917923300
7236,54430140,12670363,67100503,7,0,0,35840,5,9781463164
7237,54436139,20300770,74736909,2,0,1,4096,0,8112909173
7238,54438259,13219010,67657269,6,0,0,58880,11,4465679227
7239,54444729,20292203,74736932,5,0,1,8192,25,598316029
7240,54478320,12871136,67349456,3,0,0,6656,25,120694822
7241,54486510,12667353,67153863,3,0,0,17920,25,8441128180
7242,54500970,12546873,67047843,2,0,0,512,0,8560399732
7243,54530250,13227824,67758074,7,0,0,109056,5,1758194514
7244,54538530,12569249,67107779,3,0,0,1024,25,3688173086
7245,54541579,13097727,67639306,1,0,0,1024,22,5621211707
7246,54556109,20182136,74738245,5,0,1,6656,25,8329805626
7247,54561740,12853115,67414855,3,0,0,8704,25,6563363577
7248,54563029,20179418,74742447,5,0,1,3072,25,356313993
7249,54566649,13327251,67893900,6,0,0,69632,11,4045501643
7250,54576430,13438594,68015024,2,0,0,512,0,1776757528
7251,54584500,12888761,67473261,1,0,0,512,22,242022583
7252,54586249,20246371,74832620,5,0,1,5120,25,7118091327
7253,54594549,13530552,68125101,9,0,0,26624,9,6637148662
7254,54596570,13025829,67622399,1,0,0,1024,22,6979868383
7255,54597840,12792117,67389957,3,0,0,21504,25,6843292452
7256,54606349,13187409,67793758,6,0,0,67072,11,6740677698
7257,54609409,20223234,74832643,5,0,1,5632,25,5259658844
7258,54614899,13741457,68356356,6,0,0,46592,11,4245644541
7259,54615629,12532708,67148337,1,0,0,1536,22,6228554130
7260,54619140,12588032,67207172,7,0,0,10752,5,1675444516
7261,54620299,13228338,67848637,6,0,0,15872,11,1652976441
7262,54623890,13646858,68270748,3,0,0,115712,25,9927947911
7263,54623990,12855534,67479524,7,0,0,20480,5,5439140397
7264,54629859,12474434,67104293,6,0,0,11776,11,4748206151
7265,54641440,12621440,67262880,2,0,0,1024,0,9925199380
7266,54644100,12554941,67199041,7,0,0,7680,5,10335816509
7267,54658200,12677075,67335275,1,0,0,1024,22,4817890135
7268,54667430,13638404,68305834,3,0,0,39424,25,9363071336
7269,54669260,13611447,68280707,1,0,0,1536,22,9718778622
7270,54672370,13512354,68184724,7,0,0,31232,5,811435355
7271,54672600,12774749,67447349,1,0,0,2048,22,8002934731
7272,54673899,20171114,74845013,5,0,1,1536,25,5349406887
7273,54685180,13412575,68097755,7,0,0,94720,5,9295184225
7274,54713499,12678712,67392211,1,0,0,2048,22,5664544954
7275,54719450,13565637,68285087,1,0,0,1536,22,10717097706
7276,54720060,12692120,67412180,3,0,0,51200,25,10325129695
7277,54738089,20106947,74845036,5,0,1,11776,25,10618279675
7278,54745449,12543553,67289002,1,0,0,1024,22,6757976442
7279,54777959,13451406,68229365,6,0,0,81920,11,1687085450
7280,54782149,12793314,67575463,6,0,0,21504,11,8073331859
7281,54784659,20060400,74845059,5,0,1,1024,25,8027627636
7282,54801209,13721609,68522818,6,0,0,13312,11,8955654523
7283,54803570,12888065,67691635,3,0,0,44032,25,10326978990
7284,54804079,12918069,67722148,6,0,0,11776,11,9604615227
7285,54821000,12652082,67473082,3,0,0,33280,25,302978655
7286,54823039,12994634,67817673,6,0,0,40448,11,7505986291
7287,54835489,13228827,68064316,1,0,0,1536,22,2717411397
7288,54837620,12887203,67724823,3,0,0,8704,25,2847300062
7289,54858969,13296558,68155527,6,0,0,2048,11,5625814352
7290,54872159,12806037,67678196,0,0,0,68608,9,9083547162
7291,54876700,12506682,67383382,2,0,0,1024,0,6977778293
7292,54876970,12505713,67382683,2,0,0,1024,0,1500583843
7293,54879410,12759561,67638971,7,0,0,43520,5,927291471
7294,54881749,12453705,67335454,1,0,0,512,22,10295044577
7295,54885629,19959453,74845082,5,0,1,1536,25,10188505803
7296,54886219,13818880,68705099,6,0,0,159744,11,9226274000
7297,54896609,13140261,68036870,1,0,0,512,22,5643986702
7298,54910220,13053777,67963997,1,0,0,1536,22,3561204229
7299,54914419,19930686,74845105,5,0,1,1024,25,8323994875
7300,54925720,13191246,68116966,7,0,0,62976,5,2218256557
7301,54952510,12766027,67718537,2,0,0,512,0,4635611752
7302,54955679,13626265,68581944,0,0,0,184832,9,1603537535
7303,54962579,12797414,67759993,0,0,0,6144,9,8768434317
7304,54975220,13174957,68150177,3,0,0,47616,25,51216588
7305,54976949,19868179,74845128,5,0,1,6656,25,9367452546
7306,54988670,12841851,67830521,1,0,0,2048,22,6186914149
7307,54989120,13291057,68280177,7,0,0,30720,5,10123840966
7308,55014040,12837896,67851936,7,0,0,10752,5,2318904462
7309,55025140,13874121,68899261,3,0,0,94720,25,6331178386
7310,55038280,13935076,68973356,7,0,0,109056,5,2864658011
7311,55044259,13826119,68870378,0,0,0,69632,9,7111227427
7312,55047190,13119434,68166624,4,0,0,2048,29,8357776418
7313,55061350,12803469,67864819,1,0,0,1024,22,815534777
7314,55064589,19782646,74847235,5,0,1,4608,25,4033180934
7315,55064691,19784490,74849181,8,0,1,3072,17,4284496189
7316,55073419,19807149,74880568,5,0,1,16384,25,7996011756
7317,55073780,19806811,74880591,4,0,1,1024,29,7687483268
7318,55078209,12932323,68010532,6,0,0,40960,11,8275848478
7319,55094720,12952067,68046787,4,0,0,8704,29,6615269330
7320,55100130,13234961,68335091,2,0,0,64000,0,10641148077
7321,55100419,13884550,68984969,0,0,0,37888,9,5832072464
7322,55104690,13970415,69075105,2,0,0,78848,0,9826277105
7323,55105840,13255219,68361059,7,0,0,15360,5,6857038297
7324,55108199,12803271,67911470,0,0,0,5632,9,7298377633
7325,55112110,19768504,74880614,4,0,1,2048,29,2003882663
7326,55114740,19781364,74896104,4,0,1,6656,29,4851135033
7327,55115280,19780847,74896127,4,0,1,512,29,8094735989
7328,55129759,19768310,74898069,5,0,1,19456,25,663725706
7329,55180470,12985507,68165977,1,0,0,512,22,7830147007
7330,55200399,13315560,68515959,6,0,0,9216,11,5423439408
7331,55200480,12954400,68154880,2,0,0,15360,0,6872206399
7332,55214970,19695738,74910708,9,0,1,1024,9,2584298339
7333,55233269,13918897,69152166,6,0,0,20992,11,3171655666
7334,55233330,13162705,68396035,7,0,0,15872,5,6061342791
7335,55237059,14036996,69274055,0,0,0,34816,9,10682341382
7336,55251010,19661024,74912034,4,0,1,2048,29,1910919792
7337,55251960,19660740,74912700,4,0,1,1024,29,5386317605
7338,55255350,13081948,68337298,2,0,0,7168,0,8472531361
7339,55256169,13998684,69254853,6,0,0,108032,11,10597235120
7340,55266909,19696854,74963763,5,0,1,15872,25,5451954443
7341,55276499,13379905,68656404,6,0,0,111616,11,9936270460
7342,55283729,19681020,74964749,5,0,1,1536,25,1032645820
7343,55286659,13028893,68315552,0,0,0,31744,9,4901637183
7344,55287979,19683240,74971219,5,0,1,3584,25,7236965630
7345,55297649,13449079,68746728,6,0,0,19456,11,7091158252
7346,55304619,13101745,68406364,0,0,0,10752,9,4619485105
7347,55316029,19655213,74971242,5,0,1,1536,25,312426308
7348,55316600,19662644,74979244,4,0,1,6144,29,3433807611
7349,55320609,13267020,68587629,6,0,0,17408,11,4299687419
7350,55322010,14160184,69482194,7,0,0,115200,5,6232091944
7351,55322360,13418417,68740777,2,0,0,39936,0,7182845246
7352,55329649,14108439,69438088,0,0,0,117760,9,1465239237
7353,55347980,19631619,74979599,4,0,1,12288,29,3673951313
7354,55348479,13979933,69328412,0,0,0,66560,9,1585803615
7355,55380269,19630912,75011181,5,0,1,7168,25,162948890
7356,55388980,19633005,75021985,4,0,1,5632,29,5423283388
7357,55398840,19871967,75270807,4,0,1,140800,29,3091145362
7358,55400520,13697264,69097784,7,0,0,47616,5,4749521857
7359,55421499,13035291,68456790,6,0,0,2048,11,10101701393
7360,55426850,19845391,75272241,4,0,1,23040,29,1451513610
7361,55431360,14068109,69499469,7,0,0,56320,5,5025730363
7362,55444190,19845511,75289701,4,0,1,11776,29,1422968906
7363,55444619,19867229,75311848,5,0,1,7680,25,9534020949
7364,55450100,13477901,68928001,7,0,0,93184,5,7435678338
7365,55463909,19850205,75314114,5,0,1,3584,25,7099385616
7366,55472960,13455275,68928235,1,0,0,512,22,6175532584
7367,55473719,14158276,69631995,6,0,0,211456,11,9896664426
7368,55476230,19845623,75321853,4,0,1,2560,29,7816834681
7369,55479250,19842949,75322199,9,0,1,512,9,1540962626
7370,55480000,19843185,75323185,9,0,1,1536,9,3297676172
7371,55497240,13851600,69348840,2,0,0,6144,0,472145286
7372,55504180,13091046,68595226,1,0,0,1536,22,7235104072
7373,55506140,19859544,75365684,4,0,1,35840,29,10496650681
7374,55507970,19927346,75435316,4,0,1,42496,29,6599273048
7375,55524599,13318343,68842942,6,0,0,18944,11,6335826987
7376,55533319,13687615,69220934,0,0,0,23552,9,3383964397
7377,55535650,13065777,68601427,1,0,0,2560,22,10212898499
7378,55569330,19866009,75435339,9,0,1,15360,9,6115138068
7379,55577379,13017324,68594703,0,0,0,23040,9,6130204509
7380,55582560,12999719,68582279,1,0,0,1024,22,8969422060
7381,55582630,13212910,68795540,1,0,0,1024,22,8878193097
7382,55584780,19850582,75435362,4,0,1,23552,29,1565649832
7383,55592020,14041425,69633445,2,0,0,3584,0,144857873
7384,55593910,19841475,75435385,9,0,1,1024,9,5861595704
7385,55604200,19907684,75511884,4,0,1,48640,29,603331982
7386,55621300,19921773,75543073,9,0,1,10752,9,9591973183
7387,55623971,19959499,75583470,8,0,1,4096,17,1000578270
7388,55624870,19958623,75583493,9,0,1,2048,9,8081597051
7389,55627570,19955946,75583516,9,0,1,4096,9,1093467145
7390,55634790,19988672,75623462,4,0,1,52736,29,8184679208
7391,55661120,14133037,69794157,1,0,0,1536,22,6853017087
7392,55667569,14056683,69724252,0,0,0,89600,9,8588157658
7393,55687010,13212438,68899448,1,0,0,512,22,5889767782
7394,55694449,19958182,75652631,2,0,1,5632,0,842866566
7395,55700980,13417599,69118579,7,0,0,48640,5,10247202684
7396,55701369,19961099,75662468,2,0,1,5120,0,8995420722
7397,55724291,19938200,75662491,8,0,1,1536,17,5259492347
7398,55734301,19959864,75694165,8,0,1,2048,17,5848189161
7399,55738279,19957171,75695450,5,0,1,3584,25,6156998871
7400,55739700,13699237,69438937,1,0,0,1024,22,5389559797
7401,55745100,13451838,69196938,1,0,0,1024,22,10096909791
7402,55751029,19958394,75709423,2,0,1,1024,0,2802103588
7403,55751151,19958303,75709454,8,0,1,6656,17,9647442453
7404,55757850,13438730,69196580,2,0,0,111104,0,4623261236
7405,55758300,19951177,75709477,6,0,1,2560,11,2616962388
7406,55759339,19950161,75709500,2,0,1,1536,0,5046055758
7407,55771781,19937742,75709523,8,0,1,2560,17,9961003333
7408,55775129,19934417,75709546,2,0,1,1024,0,1051578707
7409,55777541,19939390,75716931,8,0,1,11264,17,4776880938
7410,55782469,19936088,75718557,5,0,1,2560,25,3951923759
7411,55783490,13589563,69373053,2,0,0,34304,0,3749110847
7412,55796889,13743668,69540557,0,0,0,133632,9,2612723415
7413,55808339,19911844,75720183,5,0,1,2560,25,4152056081
7414,55823529,19901826,75725355,5,0,1,8192,25,9374794002
7415,55836140,13453725,69289865,1,0,0,1536,22,3765554266
7416,55839469,13313032,69152501,6,0,0,1024,11,9432751116
7417,55845770,19882811,75728581,6,0,1,5120,11,8282163306
7418,55850449,13288670,69139119,6,0,0,1536,11,1438684305
7419,55867599,19874647,75742246,5,0,1,9216,25,10696803556
7420,55878429,19864803,75743232,5,0,1,1536,25,7028317056
7421,55880410,19863488,75743898,6,0,1,1024,11,1360039123
7422,55886760,19859084,75745844,6,0,1,3072,11,3035453118
7423,55892709,13306875,69199584,6,0,0,1536,11,3411675049
7424,55900181,19850169,75750350,8,0,1,7168,17,5638308176
7425,55912339,19838677,75751016,5,0,1,1024,25,2173905024
7426,55919699,13238393,69158092,6,0,0,3584,11,6940929836
7427,55922550,19828812,75751362,6,0,1,512,11,4675195709
7428,55925169,13271948,69197117,6,0,0,512,11,4975154288
7429,55927899,19828609,75756508,7,0,1,8192,5,8558207582
7430,55942460,13155503,69097963,1,0,0,512,22,2688893329
7431,55947890,19812164,75760054,6,0,1,5632,11,7176995467
7432,55961189,19810126,75771315,5,0,1,5632,25,2542561457
7433,55961459,19809879,75771338,5,0,1,1024,25,1518037730
7434,55963960,19807409,75771369,6,0,1,512,11,1226141006
7435,55981049,13889943,69870992,6,0,0,1024,11,8941475604
7436,55994150,19777242,75771392,6,0,1,1024,11,5533548029
7437,56012480,19758935,75771415,6,0,1,12800,11,525097374
7438,56028379,19743075,75771454,5,0,1,8192,25,8324520027
7439,56038709,19736554,75775263,5,0,1,6144,25,1487820333
7440,56041399,13215967,69257366,6,0,0,512,11,1106494919
7441,56049680,19741668,75791348,6,0,1,20480,11,4447408670
7442,56051080,19741409,75792489,6,0,1,1536,11,4385894895
7443,56055171,19756598,75811769,8,0,1,8192,17,8360750008
7444,56057171,19758391,75815562,8,0,1,5632,17,6167547938
7445,56068600,13140603,69209203,1,0,0,1024,22,10705982404
7446,56076680,13144433,69221113,1,0,0,512,22,8189773410
7447,56077460,19755451,75832911,6,0,1,11264,11,4430342123
7448,56081359,13209136,69290495,6,0,0,512,11,4055843880
7449,56082621,19751276,75833897,8,0,1,1536,17,2608353540
7450,56085580,19748663,75834243,6,0,1,512,11,869656344
7451,56085799,19750070,75835869,5,0,1,2560,25,6413180074
7452,56092000,19744215,75836215,6,0,1,512,11,9495818631
7453,56095189,19744572,75839761,7,0,1,5632,5,4683737921
7454,56111769,13147133,69258902,0,0,0,512,9,1518605005
7455,56113879,19727828,75841707,7,0,1,3072,5,528390355
7456,56128539,13227793,69356332,0,0,0,10752,9,10016158222
7457,56129131,19714202,75843333,8,0,1,2560,17,2593330905
7458,56144839,13293584,69438423,6,0,0,1024,11,7561233006
7459,56150789,13494535,69645324,0,0,0,38912,9,7005181680
7460,56153879,13285549,69439428,6,0,0,1536,11,5180364817
7461,56156941,19688338,75845279,8,0,1,3072,17,10361466248
7462,56159059,13279543,69438602,6,0,0,512,11,4542369217
7463,56174770,13172175,69346945,1,0,0,1536,22,2770222273
7464,56176890,19670335,75847225,0,0,1,3072,9,8694702812
7465,56188470,19660381,75848851,6,0,1,2560,11,4671728728
7466,56197339,13302447,69499786,6,0,0,512,11,2497621446
7467,56203569,19645628,75849197,7,0,1,512,5,1761355210
7468,56209560,13334202,69543762,1,0,0,512,22,4563912728
7469,56214309,19640380,75854689,3,0,1,8704,25,766071192
7470,56218579,13324988,69543567,0,0,0,9728,9,6380184963
7471,56222550,13168714,69391264,8,0,0,1024,17,7431506246
7472,56229601,19628954,75858555,8,0,1,6144,17,1349135537
7473,56232759,19626142,75858901,3,0,1,512,25,5006190033
7474,56239041,19621806,75860847,8,0,1,3072,17,3399733285
7475,56246550,19614643,75861193,9,0,1,512,9,9131282970
7476,56256500,13467931,69724431,1,0,0,512,22,8606757111
7477,56257479,13427578,69685057,1,0,0,512,22,1999251511
7478,56259019,13718073,69977092,0,0,0,28160,9,9266066199
7479,56261250,13384432,69645682,1,0,0,512,22,8375923505
7480,56265589,13395541,69661130,6,0,0,1536,11,6546318615
7481,56265830,13366500,69632330,1,0,0,1024,22,8881070225
7482,56266770,13378733,69645503,1,0,0,512,22,7929971341
7483,56269309,19597478,75866787,7,0,1,18432,5,2201136752
7484,56271929,19596624,75868553,5,0,1,2560,25,118055275
7485,56282599,19625505,75908104,5,0,1,1536,25,9347438006
7486,56283061,19629549,75912610,8,0,1,7168,17,10736071741
7487,56285259,19645797,75931056,7,0,1,10752,5,7474685329
7488,56287269,19644453,75931722,7,0,1,1024,5,4749548867
7489,56289259,13356602,69645861,6,0,0,512,11,5974908644
7490,56289659,19644649,75934308,3,0,1,4096,25,10100692086
7491,56293659,19641315,75934974,3,0,1,1024,25,10683045907
7492,56293849,13509113,69802962,0,0,0,28672,9,4629985842
7493,56301850,13491816,69793666,5,0,0,79360,25,188629464
7494,56318379,19618861,75937240,5,0,1,3584,25,125482453
7495,56322199,13362628,69684827,6,0,0,1024,11,9707456404
7496,56328441,19611255,75939696,8,0,1,3072,17,1224626597
7497,56344991,19598828,75943819,8,0,1,2560,17,126158508
7498,56354619,19621939,75976558,7,0,1,7680,5,5713330544
7499,56364030,13480375,69844405,5,0,0,32256,25,882954236
7500,56377910,13577103,69955013,5,0,0,54784,25,9747094516
7501,56382249,13278367,69660616,0,0,0,7168,9,1560385513
7502,56400840,13257553,69658393,5,0,0,40448,25,7764641672
7503,56402619,19574787,75977406,3,0,1,2560,25,4472887422
7504,56418119,13452518,69870637,6,0,0,3584,11,8443053044
7505,56438819,13223379,69662198,6,0,0,3072,11,6694409651
7506,56455759,19522006,75977765,5,0,1,9728,25,5530592247
7507,56461529,19518528,75980057,3,0,1,3584,25,2392644698
7508,56468201,19515082,75983283,8,0,1,5120,17,1982890630
7509,56477621,19506008,75983629,8,0,1,512,17,4452817537
7510,56480931,19504286,75985217,8,0,1,15872,17,1202127008
7511,56485001,19500882,75985883,8,0,1,1024,17,9728597648
7512,56494069,19492685,75986754,7,0,1,12288,5,6616298051
7513,56498349,13466582,69964931,6,0,0,512,11,7375022149
7514,56507869,19481151,75989020,1,0,1,3584,22,202780372
7515,56511359,13582534,70093893,0,0,0,94208,9,605945827
7516,56514589,19477977,75992566,3,0,1,5632,25,4650899305
7517,56521841,19471071,75992912,8,0,1,512,17,9378981650
7518,56521890,13337799,69859689,5,0,0,31744,25,9829772462
7519,56537049,19456529,75993578,3,0,1,1024,25,3830128772
7520,56542409,13552847,70095256,0,0,0,2048,9,1507003421
7521,56562729,13282635,69845364,0,0,0,3072,9,3515384441
7522,56571651,19422913,75994564,8,0,1,1536,17,5363827513
7523,56576649,19418261,75994910,3,0,1,512,25,1300643184
7524,56582261,19423796,76006057,8,0,1,5120,17,4755431539
7525,56598429,13443589,70042018,0,0,0,43520,9,5347257536
7526,56602791,19404572,76007363,8,0,1,2048,17,1974975424
7527,56608289,13241551,69849840,6,0,0,1536,11,4654284710
7528,56630640,13300915,69931555,5,0,0,15872,25,756837840
7529,56635629,19372720,76008349,5,0,1,1536,25,3516217004
7530,56641311,19436668,76077979,8,0,1,12800,17,10399513459
7531,56649150,19619593,76268743,0,0,1,2048,9,918627502
7532,56651629,19617780,76269409,5,0,1,1024,25,7751389479
7533,56652670,13340513,69993183,5,0,0,52736,25,8999177832
7534,56654891,19615088,76269979,8,0,1,512,17,7158292906
7535,56665639,13583817,70249456,6,0,0,1536,11,2465410031
7536,56669460,19600859,76270319,3,0,1,10752,25,5516937439
7537,56688969,13135397,69824366,6,0,0,512,11,6262001514
7538,56695939,19932299,76628238,3,0,1,2560,25,9420839671
7539,56702820,19925441,76628261,0,0,1,1024,9,2151394619
7540,56703730,19924554,76628284,0,0,1,512,9,4139037742
7541,56703869,19924438,76628307,7,0,1,2048,5,10442267650
7542,56707429,13411074,70118503,6,0,0,1024,11,2106852652
7543,56709041,19919289,76628330,8,0,1,5632,17,1250518667
7544,56724800,13337091,70061891,5,0,0,22016,25,9795820889
7545,56725899,19902454,76628353,7,0,1,5632,5,6098575187
7546,56727479,13367061,70094540,6,0,0,2048,11,7311842041
7547,56728921,19899455,76628376,8,0,1,512,17,5791265427
7548,56735641,19892758,76628399,8,0,1,1536,17,2937280446
7549,56743740,19884886,76628626,0,0,1,2048,9,8097326780
7550,56745959,19883333,76629292,3,0,1,1024,25,10415114445
7551,56746450,19886708,76633158,3,0,1,6144,25,3441524384
7552,56755749,19895647,76651396,7,0,1,9216,5,2673567999
7553,56765979,19925650,76691629,7,0,1,3072,5,2007722395
7554,56770480,13347149,70117629,5,0,0,43520,25,9247410557
7555,56771471,20031634,76803105,8,0,1,16384,17,8087259054
7556,56773150,20596798,77369948,4,0,1,164864,29,5105572044
7557,56780231,20597011,77377242,8,0,1,512,17,1018963210
7558,56780511,20601572,77382083,8,0,1,7680,17,8385880324
7559,56785599,13349839,70135438,0,0,0,47616,9,480217251
7560,56789020,20637061,77426081,3,0,1,2048,25,8280302138
7561,56793239,20633508,77426747,3,0,1,1024,25,10609379138
7562,56795820,20632233,77428053,0,0,1,2048,9,1442063452
7563,56796740,13389440,70186180,5,0,0,34304,25,2553345650
7564,56805200,20761936,77567136,4,0,1,122880,29,10361411707
7565,56807230,20771075,77578305,0,0,1,8704,9,5142456050
7566,56810279,20769972,77580251,7,0,1,3072,5,2968335237
7567,56811550,13437415,70248965,5,0,0,40448,25,5225810659
7568,56824020,20778541,77602561,0,0,1,10240,9,7526738938
7569,56829379,20773205,77602584,1,0,1,512,22,6181405612
7570,56841870,20765617,77607487,0,0,1,7168,9,4759908017
7571,56845369,13290248,70135617,6,0,0,512,11,4560446940
7572,56848541,20759292,77607833,8,0,1,512,17,10497465254
7573,56859300,13352737,70212037,5,0,0,9216,25,1341995506
7574,56875999,13311452,70187451,0,0,0,4096,9,5656894919
7575,56890820,20782670,77673490,4,0,1,55296,29,3805712805
7576,56899021,20774492,77673513,8,0,1,7680,17,8406034183
7577,56899191,20774345,77673536,8,0,1,11264,17,1482711453
7578,56900040,13419262,70319302,5,0,0,39936,25,4823775466
7579,56901459,13286639,70188098,6,0,0,2048,11,8464411717
7580,56914621,20758938,77673559,8,0,1,1536,17,8031481635
7581,56914741,20758841,77673582,8,0,1,2048,17,3584529434
7582,56941289,13429496,70370785,0,0,0,47616,9,3778294133
7583,56945521,20736258,77681779,8,0,1,4608,17,9859121237
7584,56958960,20778731,77737691,4,0,1,47104,29,1927915987
7585,56965770,20776773,77742543,4,0,1,7680,29,2927883953
7586,56973131,20769771,77742902,8,0,1,9728,17,3468368805
7587,56984280,13204153,70188433,5,0,0,1024,25,6367651920
7588,56999190,20824488,77823678,4,0,1,42496,29,5052922342
7589,56999391,20824957,77824348,8,0,1,16384,17,3118917304
7590,57004431,20831748,77836179,8,0,1,2048,17,1302218369
7591,57032770,13355217,70387987,5,0,0,7168,25,6580131799
7592,57036620,20867054,77903674,4,0,1,61952,29,10492529954
7593,57048101,20855596,77903697,8,0,1,1024,17,2876332827
7594,57049479,20854241,77903720,7,0,1,512,5,9619550832
7595,57052011,20851732,77903743,8,0,1,4096,17,2644225201
7596,57060379,20843387,77903766,7,0,1,512,5,3118472018
7597,57062089,20841700,77903789,7,0,1,4096,5,6382883935
7598,57075521,20831884,77907405,8,0,1,6144,17,6133509025
7599,57076570,13211242,70287812,5,0,0,1536,25,8755223414
7600,57091641,20847157,77938798,8,0,1,5632,17,3936898585
7601,57106731,20836573,77943304,8,0,1,7168,17,2934559812
7602,57109220,20837310,77946530,4,0,1,5120,29,8604141670
7603,57110269,20867165,77977434,7,0,1,7168,5,2732570278
7604,57112379,20898749,78011128,7,0,1,2048,5,4899066597
7605,57118989,20899767,78018756,7,0,1,4096,5,9750181834
7606,57125899,20896053,78021952,7,0,1,1536,5,1847551816
7607,57133060,13242968,70376028,5,0,0,2048,25,6998747637
7608,57154309,20889435,78043744,7,0,1,2048,5,4041735104
7609,57162209,20920512,78082721,7,0,1,5120,5,578055768
7610,57177990,20904754,78082744,4,0,1,17408,29,8540527477
7611,57180541,20927142,78107683,8,0,1,13312,17,7269558753
7612,57187790,13406777,70594567,5,0,0,1024,25,4176487653
7613,57210030,20911469,78121499,4,0,1,16384,29,932995206
7614,57211219,20925309,78136528,7,0,1,6656,5,3739793434
7615,57223870,20915592,78139462,4,0,1,5120,29,10479046793
7616,57226629,13325072,70551701,0,0,0,94720,9,6277603849
7617,57247790,20929328,78177118,4,0,1,12800,29,3184262380
7618,57258391,20918750,78177141,8,0,1,2560,17,8555423074
7619,57261321,20915843,78177164,8,0,1,4608,17,9394617801
7620,57262781,20914741,78177522,8,0,1,3584,17,3524796658
7621,57267699,13363937,70631636,0,0,0,67584,9,10065138754
7622,57275651,20917990,78193641,8,0,1,8192,17,1984930751
7623,57277331,20961778,78239109,8,0,1,27648,17,10367156971
7624,57369869,13224363,70594232,0,0,0,29184,9,4430814124
7625,57381690,20875772,78257462,4,0,1,3072,29,5500578369
7626,57421530,20837212,78258742,4,0,1,14336,29,2969776699
7627,57422249,13294251,70716500,0,0,0,18944,9,3769687181
7628,57469090,20821234,78290324,4,0,1,11776,29,7791577045
7629,57469601,20898393,78367994,8,0,1,38400,17,10672740401
7630,57483539,20920218,78403757,7,0,1,13312,5,1435958994
7631,57509980,20895083,78405063,4,0,1,2048,29,7866490172
7632,57535301,21040524,78575825,8,0,1,76800,17,2692904623
7633,57551130,21025668,78576798,4,0,1,12800,29,8140878550
7634,57561480,21025297,78586777,4,0,1,512,29,6164805813
7635,57567871,21110858,78678729,8,0,1,56320,17,2430002556
7636,57576109,13672460,71248569,0,0,0,126976,9,3679164851
7637,57588230,21095005,78683235,6,0,1,7168,11,5923151526
7638,57615889,13648771,71264660,0,0,0,52736,9,7981196552
7639,57619509,13984040,71603549,0,0,0,47104,9,534047325
7640,57622889,13901665,71524554,0,0,0,15872,9,8681211330
7641,57625479,13710260,71335739,0,0,0,23040,9,9653387982
7642,57632309,13668792,71301101,0,0,0,58880,9,9371538219
7643,57632920,21055461,78688381,0,0,1,8192,9,7273343066
7644,57667740,21022907,78690647,4,0,1,3584,29,4613457214
7645,57668981,21122447,78791428,8,0,1,71680,17,578679239
7646,57668991,21122460,78791451,8,0,1,2560,17,10478423682
7647,57673349,13497409,71170758,0,0,0,12800,9,591793316
7648,57686181,21239285,78925466,8,0,1,140288,17,1011630731
7649,57693150,21238027,78931177,4,0,1,3584,29,7293004529
7650,57698970,21237353,78936323,0,0,1,8192,9,7568587802
7651,57703981,21441065,79145046,8,0,1,138240,17,8089885149
7652,57705681,21508346,79214027,8,0,1,61440,17,4336089800
7653,57715801,21522045,79237846,8,0,1,11776,17,1279015290
7654,57740440,21522276,79262716,0,0,1,10240,9,2918342262
7655,57757429,13762266,71519695,0,0,0,65536,9,8581303453
7656,57768561,21584536,79353097,8,0,1,108544,17,3950156770
7657,57773909,21592504,79366413,5,0,1,7168,25,10268141200
7658,57813211,21562137,79375348,8,0,1,23040,17,9883368826
7659,57858719,21527801,79386520,5,0,1,1536,25,5758858285
7660,57869571,21530613,79400184,8,0,1,12288,17,1179697915
7661,57875619,21541841,79417460,5,0,1,4096,25,14449209
7662,57891089,13491181,71382270,0,0,0,82432,9,1109819800
7663,57906481,21535424,79441905,8,0,1,24064,17,1912792728
7664,57908679,21533249,79441928,3,0,1,8704,25,9278732963
7665,57919369,21532199,79451568,5,0,1,2560,25,5429920249
7666,57967481,21639971,79607452,8,0,1,95744,17,6791510029
7667,58006749,21602009,79608758,3,0,1,2048,25,5662336751
7668,58034151,21670433,79704584,8,0,1,34816,17,8306237853
7669,58047739,21656868,79704607,3,0,1,1024,25,8376598867
7670,58054629,13705762,71760391,0,0,0,45568,9,1653471947
7671,58056409,21648221,79704630,5,0,1,9216,25,10329270620
7672,58063659,13915971,71979630,0,0,0,72704,9,8234035829
7673,58065809,21638844,79704653,3,0,1,7168,25,830469322
7674,58075539,13424142,71499681,0,0,0,90624,9,1546671042
7675,58079719,21667830,79747549,3,0,1,14848,25,3335433996
7676,58080569,13760277,71840846,0,0,0,19968,9,7563651528
7677,58092409,21657650,79750059,3,0,1,10752,25,10646965374
7678,58105579,13303604,71409183,0,0,0,38400,9,4208155974
7679,58112589,21667293,79779882,5,0,1,15360,25,986721799
7680,58117619,21663249,79780868,3,0,1,1536,25,411631123
7681,58167359,13649963,71817322,0,0,0,63488,9,9624699796
7682,58171889,13259902,71431791,6,0,0,2560,11,819048490
7683,58173919,21608093,79782012,3,0,1,1536,25,7317484585
7684,58192511,21782319,79974830,8,0,1,140288,17,9488118686
7685,58213079,13523673,71736752,0,0,0,15360,9,5209711554
7686,58245579,21775565,80021144,3,0,1,19968,25,3930000440
7687,58255139,21766351,80021490,3,0,1,512,25,1227945867
7688,58274219,21749230,80023449,3,0,1,14336,25,555538631
7689,58312221,21717539,80029760,8,0,1,22016,17,4678125867
7690,58316331,21755789,80072120,8,0,1,16384,17,5524654954
7691,58319919,21752224,80072143,3,0,1,8192,25,5386666024
7692,58325670,13094590,71420260,5,0,0,1024,25,7018290067
7693,58333589,21738577,80072166,2,0,1,5632,0,5735766563
7694,58366959,21705230,80072189,5,0,1,2048,25,10394029749
7695,58368799,21703413,80072212,3,0,1,5632,25,7649473953
7696,58373411,21714847,80088258,8,0,1,23040,17,10248175097
7697,58374811,21805101,80179912,8,0,1,95232,17,3176317815
7698,58378319,21852536,80230855,2,0,1,5632,0,2769271570
7699,58401509,21829369,80230878,2,0,1,512,0,5669241711
7700,58403760,13486352,71890112,5,0,0,512,25,9268795545
7701,58406279,21824622,80230901,3,0,1,26624,25,1206978908
7702,58432890,13284301,71717191,5,0,0,1024,25,7591225750
7703,58453889,21777035,80230924,2,0,1,2560,0,7414479318
7704,58455710,13416123,71871833,5,0,0,512,25,3019723613
7705,58460409,13497046,71957455,0,0,0,26112,9,5883562638
7706,58461419,21769528,80230947,2,0,1,2560,0,4861590710
7707,58462829,13408825,71871654,0,0,0,7168,9,2429456228
7708,58466099,13265950,71732049,0,0,0,20480,9,899468248
7709,58477419,21753551,80230970,3,0,1,9728,25,6247153213
7710,58477970,13427464,71905434,3,0,0,37376,25,6008111652
7711,58479150,13344435,71823585,3,0,0,20480,25,7650610561
7712,58481189,21749804,80230993,5,0,1,4096,25,2776555576
7713,58492249,21738767,80231016,3,0,1,1024,25,5881834426
7714,58492559,21738667,80231226,2,0,1,2560,0,9170427093
7715,58497640,13509211,72006851,3,0,0,89088,25,1921670630
7716,58508269,21723028,80231297,1,0,1,3072,22,8566822426
7717,58514040,13589453,72103493,3,0,0,157184,25,1258502602
7718,58514119,21720669,80234788,1,0,1,5632,22,9650533229
7719,58528700,13101555,71630255,3,0,0,2560,25,7895169901
7720,58531619,21707355,80238974,1,0,1,6656,22,7750385390
7721,58534390,13579445,72113835,7,0,0,20992,5,7290906690
7722,58536140,13637415,72173555,7,0,0,154112,5,1606784479
7723,58543329,21696951,80240280,2,0,1,2048,0,3460787246
7724,58567731,21686619,80254350,8,0,1,47104,17,6206335954
7725,58596030,13518654,72114684,4,0,0,2560,29,1105065140
7726,58599799,21691328,80291127,1,0,1,4096,22,6264302685
7727,58605360,13622029,72227389,7,0,0,65536,5,1956996152
7728,58606079,21685714,80291793,1,0,1,1024,22,4105016810
7729,58613899,21741475,80355374,3,0,1,11264,25,8106493584
7730,58639540,13295059,71934599,3,0,0,5120,25,1839948002
7731,58644269,21711771,80356040,1,0,1,1024,22,7068382082
7732,58649819,13256106,71905925,0,0,0,1536,9,9870302473
7733,58650079,21706307,80356386,2,0,1,512,0,5852012565
7734,58687069,21682517,80369586,2,0,1,3584,0,859517392
7735,58689979,13006820,71696799,0,0,0,28160,9,5236386693
7736,58702919,21684646,80387565,1,0,1,20992,22,10445332523
7737,58703549,21746932,80450481,3,0,1,2560,25,6081081701
7738,58715999,21734505,80450504,3,0,1,1536,25,2081980028
7739,58721320,13136965,71858285,5,0,0,512,25,10608457042
7740,58726140,13051990,71778130,5,0,0,1024,25,6304949287
7741,58727919,21729651,80457570,2,0,1,2048,0,10479788988
7742,58734709,21737571,80472280,5,0,1,4096,25,10506634405
7743,58743979,21728324,80472303,1,0,1,4608,22,9459508425
7744,58755459,13607889,72363348,9,0,0,24064,9,2745367245
7745,58764899,21707427,80472326,5,0,1,1024,25,10517109113
7746,58766890,13091216,71858106,3,0,0,33280,25,10122967616
7747,58776149,13331267,72107416,9,0,0,12800,9,2859262752
7748,58785419,21686930,80472349,5,0,1,13824,25,4776821745
7749,58793549,13413833,72207382,0,0,0,73728,9,8472774371
7750,58795129,13329708,72124837,9,0,0,22016,9,694437421
7751,58799830,13432956,72232786,3,0,0,12800,25,4874445990
7752,58804260,13313815,72118075,7,0,0,10752,5,6683013469
7753,58804969,21667403,80472372,5,0,1,10752,25,9569235879
7754,58810289,21662628,80472917,3,0,1,11264,25,1372388193
7755,58810759,21670153,80480912,5,0,1,22528,25,8659942420
7756,58811789,21672349,80484138,5,0,1,5120,25,827358079
7757,58829789,21656935,80486724,3,0,1,4096,25,8669750429
7758,58834630,13466235,72300865,7,0,0,30720,5,185730754
7759,58834789,21655187,80489976,5,0,1,5120,25,1936526842
7760,58841029,21651853,80492882,5,0,1,4608,25,860908616
7761,58847070,21648540,80495610,4,0,1,2560,29,2312992992
7762,58856400,21661101,80517501,4,0,1,12288,29,8313204400
7763,58857339,21675004,80532343,5,0,1,7680,25,2292171598
7764,58858569,21683106,80541675,1,0,1,14848,22,5933992814
7765,58866020,13417590,72283610,7,0,0,512,5,209484716
7766,58867449,21674572,80542021,3,0,1,512,25,5734459956
7767,58874730,21667637,80542367,4,0,1,512,29,9749453918
7768,58882769,21662824,80545593,1,0,1,5120,22,2847960626
7769,58900729,21645210,80545939,5,0,1,512,25,9608612650
7770,58901359,13283482,72184841,0,0,0,35840,9,5060428182
7771,58907509,21641016,80548525,5,0,1,4096,25,2627115224
7772,58911480,21637711,80549191,6,0,1,1024,11,5600782766
7773,58913950,13314726,72228676,7,0,0,4096,5,4409274061
7774,58914780,21637983,80552763,4,0,1,5632,29,2069170230
7775,58919620,13309235,72228855,5,0,0,512,25,5804807609
7776,58926229,21626893,80553122,5,0,1,9728,25,864364915
7777,58926559,21628829,80555388,5,0,1,3584,25,10680283283
7778,58937740,21627355,80565095,4,0,1,10752,29,2158289171
7779,58941139,21634997,80576136,1,0,1,4608,22,296108247
7780,58943670,13230220,72173890,5,0,0,1024,25,2290615852
7781,58959250,21622173,80581423,6,0,1,16896,11,34650963
7782,58970570,13549853,72520423,7,0,0,61440,5,6421587159
7783,58977099,21606031,80583130,5,0,1,2048,25,9456867249
7784,58988700,13289808,72278508,7,0,0,20992,5,8443960080
7785,58992889,21593467,80586356,1,0,1,5120,22,1669261361
7786,58999600,13531352,72530952,3,0,0,26624,25,4832715768
7787,59001089,21589133,80590222,1,0,1,6144,22,6372938819
7788,59017950,21579568,80597518,4,0,1,9728,29,8988044140
7789,59018219,21579965,80598184,2,0,1,1024,0,459958962
7790,59047880,13265956,72313836,3,0,0,20992,25,4662850343
7791,59065019,21533831,80598850,3,0,1,1024,25,1994638059
7792,59065919,21536157,80602076,3,0,1,5120,25,5007090923
7793,59067720,21541768,80609488,6,0,1,11776,11,6863096020
7794,59069549,13305433,72374982,0,0,0,11264,9,4537081900
7795,59090199,13157468,72247667,0,0,0,15872,9,2741746055
7796,59093350,13352645,72445995,7,0,0,11776,5,2828079410
7797,59104449,21532634,80637083,3,0,1,6656,25,4361311996
7798,59106620,21534649,80641269,4,0,1,6656,29,9475223618
7799,59106740,13174985,72281725,7,0,0,4096,5,8059948305
7800,59109200,13232995,72342195,7,0,0,1024,5,8082294327
7801,59109609,21532006,80641615,5,0,1,512,25,6885142886
7802,59117769,21524307,80642076,3,0,1,10240,25,5783955060
7803,59123850,21525531,80649381,4,0,1,9728,29,6270022256
7804,59128610,21523037,80651647,4,0,1,3584,29,3776928898
7805,59129329,21523304,80652633,5,0,1,1536,25,7708575871
7806,59131859,21522720,80654579,5,0,1,3072,25,3050616465
7807,59136670,13353131,72489801,7,0,0,53248,5,1322479144
7808,59139250,21521640,80660890,4,0,1,22016,29,468095917
7809,59140689,21559358,80700047,3,0,1,10240,25,4556997744
7810,59142390,21558323,80700713,6,0,1,1024,11,161297617
7811,59154140,21551719,80705859,4,0,1,8192,29,10526676465
7812,59154429,21555936,80710365,5,0,1,7168,25,7208926388
7813,59160519,13478165,72638684,0,0,0,22528,9,10565890648
7814,59168969,21546658,80715627,5,0,1,10752,25,8540042117
7815,59171349,21545264,80716613,5,0,1,1536,25,5953241594
7816,59176220,13325460,72501680,7,0,0,38912,5,2986938727
7817,59180760,21547825,80728585,6,0,1,9728,11,479489677
7818,59182740,21552604,80735344,4,0,1,7168,29,3840221140
7819,59184949,21550823,80735772,3,0,1,12288,25,10478819380
7820,59193079,21543359,80736438,5,0,1,1024,25,2041023719
7821,59203030,21535674,80738704,6,0,1,3584,11,6515277599
7822,59204009,13182384,72386393,9,0,0,37376,9,4843483486
7823,59210060,21530590,80740650,6,0,1,3072,11,9939140370
7824,59226449,13161535,72387984,9,0,0,5120,9,2288914778
7825,59230059,21513817,80743876,3,0,1,5120,25,9941193342
7826,59238219,21505913,80744132,5,0,1,9216,25,6755657774
7827,59239789,21507249,80747038,1,0,1,4608,22,4104282410
7828,59246440,13276369,72522809,3,0,0,6144,25,2301977298
7829,59249079,13482425,72731504,0,0,0,28672,9,2864205111
7830,59259589,21488115,80747704,5,0,1,1024,25,42597079
7831,59261280,13545122,72806402,7,0,0,32768,5,6113156963
7832,59289530,21464626,80754156,0,0,1,10240,9,8480110636
7833,59303350,21456938,80760288,4,0,1,9728,29,2931746895
7834,59307860,13262558,72570418,7,0,0,69120,5,6615522076
7835,59333549,21455308,80788857,5,0,1,2560,25,2855285720
7836,59351120,21437760,80788880,0,0,1,10240,9,8555938265
7837,59358529,21473843,80832372,5,0,1,1024,25,636188407
7838,59359660,21473297,80832957,0,0,1,11264,9,7676819354
7839,59387910,13544482,72932392,3,0,0,53760,25,3189043177
7840,59403560,21471516,80875076,0,0,1,1536,9,7853806273
7841,59403989,21476919,80880908,5,0,1,4608,25,7563257833
7842,59422139,13374233,72796372,0,0,0,58368,9,436942726
7843,59454509,13066405,72520914,6,0,0,1536,11,10153096026
7844,59461979,21419241,80881220,5,0,1,512,25,8818564978
7845,59493279,21389247,80882526,5,0,1,2048,25,512955009
7846,59506639,13216083,72722722,9,0,0,49664,9,2826812557
7847,59508679,21378915,80887594,5,0,1,14336,25,10717655803
7848,59512669,21396095,80908764,5,0,1,1024,25,5441845564
7849,59522189,13393800,72915989,9,0,0,174592,9,4188573298
7850,59562640,21367628,80930268,0,0,1,14336,9,784139095
7851,59568880,21373401,80942281,0,0,1,14336,9,2081439110
7852,59586019,13162486,72748505,9,0,0,512,9,8772886709
7853,59608999,13694484,73303483,9,0,0,77312,9,2403598871
7854,59611290,21331862,80943152,0,0,1,12288,9,3433273635
7855,59620559,13422168,73042727,0,0,0,39936,9,3661516093
7856,59625959,13312118,72938077,0,0,0,18432,9,5372260172
7857,59636320,13360329,72996649,3,0,0,92160,25,1399313548
7858,59640880,13514461,73155341,3,0,0,70656,25,1386348524
7859,59648960,21360195,81009155,0,0,1,16896,9,6147281731
7860,59652660,21357161,81009821,0,0,1,1024,9,2816357414
7861,59668399,13391066,73059465,0,0,0,27648,9,1644598221
7862,59688230,13321078,73009308,3,0,0,41472,25,5514508347
7863,59701109,13238871,72939980,0,0,0,6144,9,6020812748
7864,59702709,13384295,73087004,0,0,0,38400,9,9904918196
7865,59746029,13019063,72765092,0,0,0,512,9,6234176927
7866,59751269,21263787,81015056,5,0,1,4096,25,1930436192
7867,59788660,13390439,73179099,3,0,0,65536,25,5676431517
7868,59850879,13192183,73043062,9,0,0,1024,9,2547488317
7869,59860939,21155103,81016042,3,0,1,1536,25,6694590973
7870,59861199,13198445,73059644,0,0,0,512,9,591975709
7871,59915939,21100449,81016388,5,0,1,512,25,7925586179
7872,59920129,13469075,73389204,9,0,0,39424,9,5231014748
7873,59932789,21084905,81017694,2,0,1,2048,0,3584093215
7874,59946830,21071850,81018680,4,0,1,1536,29,4624403039
7875,59954629,21085812,81040441,2,0,1,9728,0,9954326478
7876,59979200,13300681,73279881,3,0,0,27136,25,4174069211
7877,59980719,21062409,81043128,2,0,1,3072,0,8632472423
7878,60003730,21043900,81047630,6,0,1,9216,11,7575924970
7879,60006369,21055105,81061474,2,0,1,6144,0,2443935819
7880,60008490,21095579,81104069,4,0,1,9728,29,7261587565
7881,60019459,13230404,73249863,9,0,0,86016,9,6040408282
7882,60019920,21087658,81107578,4,0,1,4096,29,1764023906
7883,60021039,21087205,81108244,2,0,1,1024,0,6178410460
7884,60035849,21076607,81112456,5,0,1,6656,25,9218051961
7885,60043490,13115618,73159108,3,0,0,12288,25,6403893049
7886,60090769,21022673,81113442,2,0,1,1536,0,3021578891
7887,60126889,20986899,81113788,5,0,1,512,25,6956202369
7888,60134099,20980035,81114134,5,0,1,512,25,8791520106
7889,60151769,20962711,81114480,2,0,1,512,0,9415005621
7890,60156239,13194336,73350575,0,0,0,512,9,351001655
7891,60159940,13217229,73377169,3,0,0,43008,25,6269859774
7892,60163580,20951156,81114736,4,0,1,9216,29,4879604836
7893,60163719,13166931,73330650,9,0,0,1536,9,908045897
7894,60165849,20954981,81120830,2,0,1,2048,0,5463400462
7895,60173139,20948037,81121176,5,0,1,512,25,7522528071
7896,60174439,13075603,73250042,0,0,0,512,9,1888136401
7897,60176039,13152789,73328828,0,0,0,512,9,4691106990
7898,60197779,13423236,73621015,9,0,0,54784,9,3377746223
7899,60207359,20914163,81121522,2,0,1,512,0,3715794882
7900,60216789,20907639,81124428,2,0,1,4608,0,162591047
7901,60224200,13277076,73501276,3,0,0,20480,25,3180265791
7902,60227309,13290091,73517400,0,0,0,3584,9,5805353869
7903,60229529,13440507,73670036,0,0,0,512,9,3489872582
7904,60236209,20906561,81142770,2,0,1,1536,0,5113112334
7905,60243199,20899594,81142793,2,0,1,10752,0,3970265027
7906,60257079,20885737,81142816,5,0,1,5120,25,4681743218
7907,60287310,13368429,73655739,3,0,0,1536,25,1772665845
7908,60294859,20847980,81142839,3,0,1,1024,25,2856699920
7909,60296479,20848925,81145404,5,0,1,2560,25,6727342971
7910,60299619,20845808,81145427,5,0,1,2560,25,1925896295
7911,60318669,20835170,81153839,3,0,1,3584,25,9719676588
7912,60325790,20831915,81157705,4,0,1,6144,29,4088340708
7913,60337849,20826631,81164480,3,0,1,3072,25,4627603073
7914,60342799,13367966,73710765,9,0,0,18432,9,3654026902
7915,60342980,13467838,73810818,3,0,0,61440,25,7085734595
7916,60345159,20819344,81164503,5,0,1,512,25,5177567153
7917,60360829,13280569,73641398,0,0,0,1024,9,7768686047
7918,60368449,20796291,81164740,3,0,1,512,25,9845242164
7919,60383359,20844838,81228197,2,0,1,14336,0,7864125410
7920,60400009,20830774,81230783,2,0,1,4096,0,6437761133
7921,60406109,20825340,81231449,2,0,1,1024,0,6766652974
7922,60412929,20819800,81232729,3,0,1,14336,25,8091828343
7923,60440529,20864360,81304889,2,0,1,1024,0,1931678043
7924,60444139,13453375,73897514,0,0,0,2048,9,6016471065
7925,60444660,13327056,73771716,3,0,0,4608,25,7383145116
7926,60469609,13321317,73790926,9,0,0,3584,9,4383601222
7927,60513780,20840224,81354004,7,0,1,15360,5,1935999049
7928,60523329,20830698,81354027,7,0,1,2048,5,8863137559
7929,60526340,13304735,73831075,3,0,0,22016,25,4448643422
7930,60535829,20818221,81354050,5,0,1,1536,25,8347177239
7931,60537789,13305009,73842798,9,0,0,38400,9,4913725447
7932,60548739,20832687,81381426,7,0,1,7168,5,10122890195
7933,60553919,13323865,73877784,0,0,0,512,9,132166444
7934,60576489,20854630,81431119,7,0,1,7168,5,120839605
7935,60589991,20841151,81431142,8,0,1,9728,17,4188065028
7936,60601019,20830146,81431165,2,0,1,3072,0,192697270
7937,60626939,13254073,73881012,0,0,0,1024,9,5867595306
7938,60630089,13461953,74092042,9,0,0,39424,9,681928941
7939,60653259,20777929,81431188,5,0,1,10240,25,3900204808
7940,60662289,13240098,73902387,0,0,0,512,9,6785507191
7941,60712249,20747017,81459266,5,0,1,3584,25,1968128909
7942,60718139,20800856,81518995,5,0,1,5120,25,10222978170
7943,60739909,20779109,81519018,2,0,1,4096,0,5117838336
7944,60747979,20771062,81519041,2,0,1,3072,0,9246496323
7945,60752969,20769746,81522715,2,0,1,8704,0,10156790800
7946,60776359,20765956,81542315,2,0,1,10752,0,7936736292
7947,60797879,13183330,73981209,9,0,0,12288,9,7968134269
7948,60803300,13349373,74152673,3,0,0,44544,25,5075002071
7949,60803499,20739482,81542981,3,0,1,1024,25,10028478626
7950,60819740,20723907,81543647,0,0,1,1024,9,8481908821
7951,60829329,13338483,74167812,0,0,0,512,9,804086230
7952,60832449,20724816,81557265,5,0,1,3584,25,6864241530
7953,60837329,13508460,74345789,9,0,0,26624,9,8180937590
7954,60838120,13188277,74026397,3,0,0,1536,25,7072196841
7955,60840209,20717722,81557931,2,0,1,1024,0,5024407612
7956,60849959,20723057,81573016,1,0,1,13824,22,6667653571
7957,60852929,20720110,81573039,1,0,1,2048,22,9105477480
7958,60854100,20737633,81591733,0,0,1,6656,9,5320656989
7959,60856260,20747456,81603716,0,0,1,6656,9,1415416068
7960,60858769,13363062,74221831,9,0,0,35328,9,1218014010
7961,60861529,20774078,81635607,2,0,1,5120,0,5723884772
7962,60887889,13655757,74543646,9,0,0,9216,9,1479095656
7963,60893529,20742101,81635630,2,0,1,2048,0,620224510
7964,60905251,20730402,81635653,8,0,1,54272,17,5205806153
7965,60908249,20783860,81692109,1,0,1,3072,22,2478381673
7966,60910669,13534198,74444867,9,0,0,118784,9,2269228044
7967,60919620,20830070,81749690,9,0,1,3584,9,5090397401
7968,60941429,20824714,81766143,2,0,1,4608,0,4045364443
7969,60942620,13149641,74092261,3,0,0,512,25,7193397073
7970,60948460,20819309,81767769,0,0,1,2560,9,4140632265
7971,60950679,20818076,81768755,2,0,1,1536,0,9827295275
7972,60961941,20814686,81776627,8,0,1,12800,17,5784313524
7973,60973990,13432713,74406703,3,0,0,39936,25,5026004748
7974,60980189,20804977,81785166,7,0,1,2048,5,1921056305
7975,60987001,20853529,81840530,8,0,1,56832,17,3804517767
7976,60991359,13172385,74163744,0,0,0,512,9,9173917106
7977,61003219,13733506,74736725,9,0,0,103936,9,1766527169
7978,61015220,20829564,81844784,7,0,1,9728,5,4909352605
7979,61015280,20877252,81892532,7,0,1,8192,5,3904421961
7980,61015479,20915432,81930911,2,0,1,1024,0,5951267378
7981,61017679,20931332,81949011,1,0,1,2560,22,8140301194
7982,61018019,13281058,74299077,9,0,0,4608,9,9057349061
7983,61021819,20928498,81950317,1,0,1,2048,22,5089250689
7984,61024649,13782006,74806655,9,0,0,105472,9,7799081924
7985,61039131,20911750,81950881,8,0,1,10752,17,773399357
7986,61039310,20946495,81985805,0,0,1,3072,9,7768257271
7987,61054071,20941899,81995970,8,0,1,22528,17,813600225
7988,61058181,21063853,82122034,8,0,1,109056,17,9249872041
7989,61064679,21057378,82122057,3,0,1,7680,25,10607633622
7990,61066679,13778311,74844990,9,0,0,40448,9,4707040974
7991,61069920,13470895,74540815,3,0,0,30208,25,6876700046
7992,61072319,13823762,74896081,9,0,0,50688,9,9108333739
7993,61073779,13476623,74550402,0,0,0,1024,9,10609449516
7994,61088619,21033461,82122080,1,0,1,8704,22,7444420677
7995,61089059,21037897,82126956,3,0,1,4608,25,8041341946
7996,61108719,13192338,74301057,0,0,0,1024,9,8145425090
7997,61124519,21011759,82136278,2,0,1,4608,0,8172450791
7998,61126449,21012735,82139184,2,0,1,4608,0,4033325674
7999,61130079,21010590,82140669,3,0,1,15360,25,851480950
8000,61130179,21027746,82157925,3,0,1,3072,25,2193188162
8001,61130729,13261506,74392235,0,0,0,2560,9,1687059193
8002,61140181,21185917,82326098,8,0,1,139264,17,7873170480
8003,61154639,21171667,82326306,2,0,1,9216,0,3053024019
8004,61176560,21153292,82329852,0,0,1,5632,9,1556984830
8005,61188100,13509328,74697428,3,0,0,56832,25,2310908769
8006,61190479,21144519,82334998,1,0,1,8192,22,6668414725
8007,61197380,21138796,82336176,0,0,1,13824,9,7541774296
8008,61198450,13455639,74654089,3,0,0,168960,25,10418535486
8009,61216399,13448009,74664408,9,0,0,33792,9,8404638461
8010,61217889,13308975,74526864,0,0,0,512,9,6834373176
8011,61218070,21118260,82336330,0,0,1,8704,9,8944965645
8012,61219709,21125069,82344778,1,0,1,8704,22,2508091856
8013,61221120,13224394,74445514,3,0,0,2048,25,9901424187
8014,61229211,21164819,82394030,8,0,1,29696,17,7891701654
8015,61251860,13580737,74832597,3,0,0,83456,25,735383204
8016,61257811,21141023,82398834,8,0,1,17408,17,1076897527
8017,61259129,21150842,82409971,2,0,1,1536,0,9334471858
8018,61267499,21144098,82411597,2,0,1,2560,0,5121327596
8019,61275280,13695916,74971196,3,0,0,19456,25,5835176262
8020,61280900,13741062,75021962,3,0,0,31232,25,5029233826
8021,61284239,21131224,82415463,1,0,1,6144,22,6803852518
8022,61285599,21131490,82417089,2,0,1,2560,0,4129678032
8023,61291039,21130368,82421407,5,0,1,12800,25,5691696134
8024,61298849,21124824,82423673,3,0,1,3584,25,7495404639
8025,61302600,21130868,82433468,0,0,1,14336,9,2285598027
8026,61313339,21151375,82464714,3,0,1,512,25,3636231736
8027,61317989,21147391,82465380,2,0,1,1024,0,3355766077
8028,61322039,13558506,74880545,0,0,0,3072,9,9522123602
8029,61334140,21132546,82466686,0,0,1,2048,9,8751481749
8030,61338709,21128323,82467032,3,0,1,512,25,1866247526
8031,61347949,13631272,74979221,9,0,0,26112,9,5823782624
8032,61360569,21125497,82486066,1,0,1,15872,22,5681771788
8033,61363100,13341683,74704783,3,0,0,24064,25,3912248880
8034,61375409,13070284,74445693,0,0,0,512,9,10356957495
8035,61375629,21115724,82491353,1,0,1,16896,22,1943874995
8036,61376449,21127047,82503496,1,0,1,15360,22,10502258623
8037,61379629,21158284,82537913,3,0,1,12800,25,999276334
8038,61380541,21418578,82799119,8,0,1,148480,17,10120680616
8039,61384340,21417567,82801907,0,0,1,512,9,8796352000
8040,61388349,13276238,74664587,0,0,0,512,9,5723543501
8041,61393590,21412503,82806093,0,0,1,6656,9,7544911714
8042,61400900,13779738,75180638,3,0,0,108032,25,7306401000
8043,61411669,13674811,75086480,9,0,0,16896,9,3364452243
8044,61417201,21389878,82807079,8,0,1,1536,17,2078361181
8045,61426500,21382845,82809345,0,0,1,3584,9,543041473
8046,61436589,21393566,82830155,1,0,1,7680,22,2098467576
8047,61438599,21400248,82838847,3,0,1,13824,25,5200998094
8048,61453230,21413013,82866243,0,0,1,8704,9,804447894
8049,61459909,21411929,82871838,3,0,1,1024,25,8516512223
8050,61465819,21407005,82872824,1,0,1,1536,22,7688419052
8051,61482839,13396747,74879586,9,0,0,80384,9,264211754
8052,61485990,13412032,74898022,3,0,0,6144,25,5734806181
8053,61488479,21384691,82873170,3,0,1,512,25,2221144949
8054,61489279,13317867,74807146,9,0,0,1536,9,5156874867
8055,61499969,13402440,74902409,0,0,0,1536,9,2370588154
8056,61501091,21443123,82944214,8,0,1,88064,17,4546493948
8057,61509620,21434617,82944237,0,0,1,1024,9,9712938305
8058,61513721,21444122,82957843,8,0,1,55808,17,8335995920
8059,61516419,21442410,82958829,2,0,1,1536,0,2041170006
8060,61527169,21436806,82963975,1,0,1,8192,22,8480599398
8061,61530879,13835373,75366252,0,0,0,512,9,7641972522
8062,61549629,13885664,75435293,9,0,0,108032,9,6767317263
8063,61555919,21413228,82969147,2,0,1,8192,0,6308789553
8064,61564579,13485121,75049700,0,0,0,2048,9,3943383459
8065,61565849,21403644,82969493,1,0,1,512,22,405270942
8066,61566909,13552567,75119476,0,0,0,512,9,5299031321
8067,61572241,21408535,82980776,8,0,1,6656,17,8970524627
8068,61577431,21459292,83036723,8,0,1,58368,17,4624970576
8069,61601809,13579476,75181285,9,0,0,2048,9,2834013740
8070,61619539,21422010,83041549,2,0,1,7680,0,3353836797
8071,61644749,21397786,83042535,2,0,1,1536,0,792702951
8072,61645869,21397332,83043201,1,0,1,1024,22,2469463447
8073,61673149,21371678,83044827,1,0,1,2560,22,7867539799
8074,61681890,13329268,75011158,3,0,0,34304,25,7603611674
8075,61704291,21381132,83085423,8,0,1,34816,17,6488926451
8076,61710209,13534748,75244957,9,0,0,55296,9,8312626650
8077,61715131,21467404,83182535,8,0,1,29184,17,7365102090
8078,61717059,13268489,74985548,0,0,0,1024,9,6711724115
8079,61724089,13350651,75074740,9,0,0,25088,9,7203137538
8080,61727299,21458462,83185761,1,0,1,5120,22,3450762672
8081,61729180,13737317,75466497,3,0,0,10240,25,4759222837
8082,61744089,21445218,83189307,2,0,1,5632,0,5062826896
8083,61749521,21601818,83351339,8,0,1,92160,17,10568635592
8084,61755879,21595854,83351733,2,0,1,1024,0,2900574911
8085,61782929,21573630,83356559,1,0,1,7680,22,9677560621
8086,61790391,21635119,83425510,8,0,1,29696,17,4345750149
8087,61790439,13572637,75363076,9,0,0,14336,9,2569743258
8088,61797199,13508991,75306190,9,0,0,10240,9,8165827252
8089,61808999,13285626,75094625,0,0,0,1024,9,7497251062
8090,61810169,13454802,75264971,0,0,0,512,9,7825886364
8091,61813869,13769578,75583447,9,0,0,33280,9,5886016991
8092,61815599,13455185,75270784,0,0,0,1024,9,742619832
8093,61819521,21636455,83455976,8,0,1,12800,17,4899682900
8094,61822191,21826866,83649057,8,0,1,308224,17,5217837222
8095,61870679,13323670,75194349,0,0,0,1024,9,7887356279
8096,61879920,13384872,75264792,3,0,0,65024,25,3420197927
8097,61902089,13606186,75508275,0,0,0,512,9,8163519534
8098,61905159,13579350,75484509,9,0,0,47104,9,3707650829
8099,61909929,21740114,83650043,5,0,1,1536,25,833405247
8100,61924649,13186538,75111187,0,0,0,512,9,4780238628
8101,61925849,21735309,83661158,1,0,1,8704,22,5455532437
8102,61929071,21781009,83710080,8,0,1,80384,17,5502808558
8103,61956621,21821231,83777852,8,0,1,77312,17,10536849321
8104,61957691,21854530,83812221,8,0,1,27136,17,2997268333
8105,61976509,21838298,83814807,5,0,1,4096,25,1546518535
8106,61992609,21825104,83817713,5,0,1,4608,25,6233791480
8107,61993709,21824670,83818379,5,0,1,11264,25,201637448
8108,61995181,21906267,83901448,8,0,1,143360,17,2970509658
8109,61997549,21914143,83911692,3,0,1,9216,25,7008711597
8110,61998609,13509479,75508088,9,0,0,77312,9,5566601377
8111,62005049,21907719,83912768,3,0,1,13312,25,5528039267
8112,62012101,21932009,83944110,8,0,1,45056,17,7825433133
8113,62017969,21926189,83944158,3,0,1,512,25,1047390396
8114,62047159,21900225,83947384,3,0,1,5120,25,7998806884
8115,62088021,21867675,83955696,8,0,1,14336,17,1689948680
8116,62089649,13310320,75399969,0,0,0,1024,9,5767494119
8117,62124300,13424092,75548392,3,0,0,15360,25,8349085336
8118,62124999,13226567,75351566,9,0,0,3072,9,5070034632
8119,62130330,13167732,75298062,9,0,0,9728,9,5055421733
8120,62132449,21823708,83956157,3,0,1,10240,25,7415940989
8121,62141899,13083222,75225121,0,0,0,1024,9,114127980
8122,62143620,13627672,75771292,3,0,0,29696,25,8618878283
8123,62153790,13354820,75508610,3,0,0,1024,25,9373327942
8124,62155241,21840344,83995585,8,0,1,54272,17,3872165839
8125,62174791,21872633,84047424,8,0,1,44032,17,4818267318
8126,62186819,13157519,75344338,0,0,0,1024,9,10555646220
8127,62196709,21858979,84055688,3,0,1,1024,25,3010775541
8128,62216570,21841384,84057954,7,0,1,3584,5,7172369342
8129,62240929,13080860,75321789,0,0,0,512,9,6717774935
8130,62248540,13214814,75463354,4,0,0,42496,29,8746920814
8131,62256870,13437272,75694142,4,0,0,50176,29,10426996483
8132,62260659,21798281,84058940,3,0,1,1536,25,1163017402
8133,62262030,13358134,75620164,3,0,0,89600,25,930917174
8134,62271259,13367008,75638267,0,0,0,512,9,10369771445
8135,62274079,13161797,75435876,0,0,0,1536,9,3209202124
8136,62277580,13384865,75662445,3,0,0,22016,25,3596734137
8137,62287881,21778971,84066852,8,0,1,9216,17,3736980372
8138,62337081,21734277,84071358,8,0,1,7168,17,4357481156
8139,62351669,21724835,84076504,1,0,1,8192,22,2021788013
8140,62352829,21724981,84077810,1,0,1,2048,22,8124572086
8141,62359319,21751262,84110581,3,0,1,48640,25,4456403052
8142,62363520,21751887,84115407,9,0,1,7680,9,1790349909
8143,62366239,21753785,84120024,1,0,1,2048,22,7257637466
8144,62386340,21741923,84128263,6,0,1,6144,11,514404373
8145,62400510,13530507,75931017,4,0,0,7680,29,4591407985
8146,62401440,13107661,75509101,3,0,0,1536,25,7933771853
8147,62401769,21727160,84128929,2,0,1,1024,0,2547404738
8148,62404731,21727424,84132155,8,0,1,5120,17,4624494234
8149,62407240,13165385,75572625,4,0,0,3072,29,7999962218
8150,62410489,21723057,84133546,3,0,1,10240,25,5853954411
8151,62412279,21722573,84134852,2,0,1,2048,0,8681268547
8152,62438321,21701677,84139998,8,0,1,8192,17,9576609173
8153,62450810,13258574,75709384,9,0,0,45056,9,6735245617
8154,62469311,21673273,84142584,8,0,1,4096,17,5179716421
8155,62477469,21670096,84147565,2,0,1,5120,0,8790421990
8156,62477890,13324434,75802324,3,0,0,30720,25,3700849547
8157,62493569,21654019,84147588,1,0,1,9216,22,4953826907
8158,62495191,21659254,84154445,8,0,1,3072,17,2811154790
8159,62499550,21655241,84154791,6,0,1,512,11,8825224684
8160,62501659,21657958,84159617,1,0,1,7680,22,3014379733
8161,62502529,21657754,84160283,1,0,1,1024,22,4022462599
8162,62503010,13307605,75810615,9,0,0,27136,9,6555959474
8163,62530399,21665100,84195499,2,0,1,8704,0,3735018551
8164,62536129,21659393,84195522,3,0,1,21504,25,2070914634
8165,62543420,13403581,75947001,9,0,0,6144,9,10296853191
8166,62544050,13247275,75791325,3,0,0,39936,25,7248496464
8167,62546780,13278338,75825118,4,0,0,3584,29,7710001796
8168,62548309,21647236,84195545,2,0,1,2560,0,9046240391
8169,62556030,13336716,75892746,3,0,0,3072,25,7212781893
8170,62589690,21605878,84195568,6,0,1,5120,11,674652049
8171,62591070,13385465,75976535,3,0,0,12800,25,872071568
8172,62596049,21599542,84195591,3,0,1,18432,25,4144583688
8173,62596399,21826308,84422707,3,0,1,188928,25,8884310043
8174,62604250,21827638,84431888,6,0,1,7168,11,8750162791
8175,62616419,13381446,75997865,0,0,0,1024,9,8253819262
8176,62622000,21837044,84459044,6,0,1,4608,11,1671852965
8177,62625960,13906917,76532877,3,0,0,51200,25,6835451771
8178,62626230,13302424,75928654,9,0,0,11264,9,1629091886
8179,62629229,13549491,76178720,0,0,0,512,9,10002227987
8180,62631969,21829661,84461630,2,0,1,4096,0,10432598532
8181,62636179,21827077,84463256,3,0,1,2560,25,3810220570
8182,62643280,13385285,76028565,9,0,0,20992,9,8034979561
8183,62643490,13296183,75939673,3,0,0,7680,25,6782205858
8184,62643749,21845857,84489606,2,0,1,8192,0,5241870488
8185,62653819,21835810,84489629,2,0,1,11776,0,3191500434
8186,62657009,13419763,76076772,0,0,0,1536,9,5240972626
8187,62664840,21824812,84489652,6,0,1,6144,11,644147784
8188,62670089,13359607,76029696,0,0,0,512,9,7772591435
8189,62678780,13412907,76091687,4,0,0,20480,29,1195038051
8190,62694350,13402988,76097338,4,0,0,10752,29,6042016359
8191,62694650,13525411,76220061,9,0,0,512,9,6610912205
8192,62696600,13954773,76651373,4,0,0,41984,29,5481975169
8193,62697699,13117840,75815539,0,0,0,1024,9,4409943567
8194,62698559,21791116,84489675,2,0,1,25600,0,10278810027
8195,62708439,21788009,84496448,3,0,1,21504,25,8505156831
8196,62712409,21797016,84509425,3,0,1,12288,25,7136449510
8197,62715969,21793815,84509784,2,0,1,9728,0,2129730023
8198,62728060,13952491,76680551,8,0,0,512,17,7240088212
8199,62736890,13437222,76174112,4,0,0,512,29,3302317085
8200,62743950,21792734,84536684,6,0,1,5632,11,7327588758
8201,62759070,13694065,76453135,3,0,0,1024,25,6307769794
8202,62759950,13596832,76356782,3,0,0,2560,25,7834189746
8203,62761689,21775018,84536707,2,0,1,1024,0,3459991110
8204,62766660,21770070,84536730,6,0,1,4096,11,4381249290
8205,62767309,21774040,84541349,2,0,1,7680,0,5771117352
8206,62786019,21769150,84555169,3,0,1,25600,25,8126519733
8207,62797090,13275274,76072364,8,0,0,1024,17,8158243582
8208,62799470,13426891,76226361,8,0,0,1024,17,1334406872
8209,62807070,13996012,76803082,3,0,0,128000,25,3855099182
8210,62811730,13641070,76452800,4,0,0,26624,29,2337153389
8211,62820059,13385583,76205642,0,0,0,2048,9,1397272337
8212,62823429,13384817,76208246,0,0,0,512,9,3367934473
8213,62828140,14026655,76854795,3,0,0,33792,25,9174150351
8214,62831740,13307380,76139120,3,0,0,54272,25,8454585819
8215,62842870,13817542,76660412,3,0,0,4096,25,9906692366
8216,62848119,21710276,84558395,1,0,1,5120,22,7181692671
8217,62862810,14169742,77032552,9,0,0,71168,9,8604390647
8218,62884370,13263600,76147970,8,0,0,1536,17,2179383310
8219,62891120,13248647,76139767,8,0,0,2048,17,7804717301
8220,62893419,21665642,84559061,1,0,1,1024,22,7056683151
8221,62895369,21663846,84559215,1,0,1,8704,22,7802231485
8222,62910930,13533735,76444665,4,0,0,59904,29,5545367394
8223,62914079,21702326,84616405,2,0,1,7168,0,9664765186
8224,62916949,21706834,84623783,2,0,1,1536,0,7242362460
8225,62934100,13231211,76165311,4,0,0,7680,29,3329222731
8226,62936980,13516334,76453314,8,0,0,512,17,7263650909
8227,62950070,13638409,76588479,9,0,0,23552,9,5224396977
8228,62959890,13086087,76045977,4,0,0,18432,29,3949121721
8229,62964800,13070773,76035573,4,0,0,8704,29,5577593335
8230,62969169,13934112,76903281,9,0,0,33280,9,4881036475
8231,62976630,13424278,76400908,8,0,0,512,17,7257134706
8232,63021599,13070872,76092471,0,0,0,512,9,1198221661
8233,63033839,21589967,84623806,2,0,1,2560,0,1079830407
8234,63037480,13034549,76072029,4,0,0,5120,29,597159510
8235,63042810,13190084,76232894,4,0,0,15872,29,2268729069
8236,63043740,13584140,76627880,4,0,0,38400,29,5827489570
8237,63046040,13870682,76916722,3,0,0,9728,25,5889625806
8238,63049170,13068040,76117210,8,0,0,512,17,5718111289
8239,63049509,13299281,76348790,0,0,0,1536,9,9239886756
8240,63053260,13598471,76651731,8,0,0,1024,17,4837428890
8241,63058369,21565460,84623829,2,0,1,4096,0,5356447200
8242,63059899,13424163,76484062,9,0,0,5120,9,2440597869
8243,63065900,13778568,76844468,4,0,0,135680,29,5051351157
8244,63075170,13581444,76656614,8,0,0,512,17,3789987419
8245,63075849,13130861,76206710,0,0,0,512,9,4176939536
8246,63077799,13619790,76697589,0,0,0,512,9,1934962637
8247,63108820,13648106,76756926,4,0,0,22016,29,3905901681
8248,63118419,21505433,84623852,1,0,1,4608,22,9466885202
8249,63123640,14549827,77673467,9,0,0,152576,9,8510004869
8250,63127410,13779817,76907227,3,0,0,12288,25,5967831405
8251,63133499,21490376,84623875,2,0,1,1536,0,3453934620
8252,63134569,21489329,84623898,1,0,1,512,22,3800019915
8253,63143209,13283119,76426328,9,0,0,19456,9,9605748198
8254,63146350,13969634,77115984,3,0,0,118272,25,4587352127
8255,63153359,21470562,84623921,2,0,1,8704,0,2775295268
8256,63159170,13308284,76467454,8,0,0,1024,17,9294763881
8257,63160540,13532807,76693347,8,0,0,2048,17,9320389359
8258,63163639,21460305,84623944,2,0,1,1536,0,4906797160
8259,63171670,13098286,76269956,8,0,0,1024,17,3492960437
8260,63198950,13216383,76415333,8,0,0,512,17,8096092813
8261,63203020,21420963,84623983,4,0,1,10752,29,6802210630
8262,63231809,21404576,84636385,1,0,1,4608,22,1645103744
8263,63249740,14252660,77502400,3,0,0,238592,25,9857481470
8264,63261229,21394039,84655268,1,0,1,1536,22,6731370477
8265,63278420,13176321,76454741,3,0,0,4608,25,10577857525
8266,63300880,21356014,84656894,6,0,1,2560,11,6698597918
8267,63310300,13894712,77205012,4,0,0,96768,29,1441479476
8268,63321999,21337801,84659800,1,0,1,4608,22,3421949376
8269,63328870,21331596,84660466,9,0,1,1024,9,9975131650
8270,63340359,21323013,84663372,1,0,1,4608,22,2673689388
8271,63356939,21318616,84675555,1,0,1,3072,22,9336039742
8272,63391759,21311806,84703565,1,0,1,14336,22,9165231276
8273,63405419,13815114,77220533,9,0,0,30208,9,5867697893
8274,63411430,12996769,76408199,4,0,0,7680,29,447251003
8275,63411619,13663603,77075222,9,0,0,123904,9,3282278565
8276,63415609,13218230,76633839,0,0,0,1024,9,8038717601
8277,63424720,13655205,77079925,4,0,0,15360,29,8676963369
8278,63425440,13294336,76719776,3,0,0,52736,25,7978936499
8279,63427469,13274929,76702398,9,0,0,4096,9,2713264420
8280,63431170,13485731,76916901,8,0,0,512,17,6728266309
8281,63437469,13737701,77175170,9,0,0,179200,9,3568996932
8282,63439049,13478031,76917080,9,0,0,512,9,10568601325
8283,63464709,21238887,84703596,5,0,1,5120,25,2219988238
8284,63464739,13198916,76663655,0,0,0,512,9,6006345860
8285,63476090,21231101,84707191,9,0,1,7168,9,8018066402
8286,63483959,13144256,76628215,0,0,0,1024,9,168722732
8287,63489580,13256598,76746178,4,0,0,6144,29,5599928419
8288,63501440,14209303,77710743,3,0,0,67584,25,1927189309
8289,63507839,21203858,84711697,5,0,1,7168,25,50005477
8290,63512659,13167604,76680263,9,0,0,4608,9,6211467652
8291,63515180,21196863,84712043,9,0,1,512,9,3549488319
8292,63515750,13743057,77258807,3,0,0,79872,25,4035112361
8293,63521219,13689908,77211127,9,0,0,19968,9,4600142481
8294,63529229,13460674,76989903,9,0,0,13824,9,6124387266
8295,63532990,13764340,77297330,4,0,0,65536,29,8815397082
8296,63536860,21177769,84714629,9,0,1,4096,9,8457176139
8297,63536950,14203263,77740213,8,0,0,3584,17,5688430975
8298,63538059,13212096,76750155,0,0,0,512,9,2411683521
8299,63539009,14007319,77546328,9,0,0,1024,9,1982132078
8300,63542430,13839630,77382060,4,0,0,3584,29,5433274525
8301,63544989,21172226,84717215,5,0,1,4096,25,6451147825
8302,63558740,13700605,77259345,8,0,0,1024,17,4736736476
8303,63582840,21143067,84725907,6,0,1,13824,11,9448261293
8304,63587650,21145833,84733483,9,0,1,5632,9,4788772450
8305,63588650,13401588,76990238,8,0,0,1024,17,8260157888
8306,63592060,21161618,84753678,6,0,1,512,11,4960716847
8307,63599049,13308513,76907562,0,0,0,1024,9,1140567330
8308,63621310,21132708,84754018,6,0,1,1024,11,8723614599
8309,63624870,13890813,77515683,9,0,0,43520,9,4793843969
8310,63627770,21152665,84780435,6,0,1,4096,11,8643366870
8311,63638970,21146854,84785824,6,0,1,17408,11,3195417722
8312,63649299,13013927,76663226,0,0,0,2048,9,2631996225
8313,63661810,21131033,84792843,9,0,1,8192,9,5606236152
8314,63676910,13599774,77276684,9,0,0,56832,9,7891903277
8315,63677590,13868224,77545814,9,0,0,98816,9,7496173246
8316,63708480,13525968,77234448,4,0,0,45568,29,3522010654
8317,63711539,13143443,76854982,0,0,0,512,9,1321986678
8318,63717590,13849523,77567113,4,0,0,12800,29,8415057570
8319,63718640,13540362,77259002,8,0,0,512,17,3366061309
8320,63723340,21069526,84792866,9,0,1,512,9,9098459680
8321,63724510,21068379,84792889,7,0,1,512,5,1331363194
8322,63750850,13811022,77561872,4,0,0,9728,29,6776137263
8323,63752340,13595440,77347780,4,0,0,5120,29,8651632861
8324,63762719,13140741,76903460,0,0,0,512,9,1390129552
8325,63766460,13089442,76855902,8,0,0,1536,17,5542097973
8326,63766540,21026372,84792912,7,0,1,1536,5,7453642420
8327,63779411,21019369,84798780,8,0,1,20992,17,875724723
8328,63794390,21005056,84799446,9,0,1,1024,9,5732013929
8329,63806771,20992931,84799702,8,0,1,9216,17,8413088799
8330,63809090,13366415,77175505,8,0,0,1024,17,8860896333
8331,63829399,13156214,76985613,0,0,0,1024,9,998534331
8332,63832019,13201180,77033199,0,0,0,2048,9,7218164037
8333,63843560,13502637,77346197,9,0,0,39424,9,1826674604
8334,63844751,20960031,84804782,8,0,1,2560,17,3120277100
8335,63847330,20958746,84806076,9,0,1,5632,9,8787982627
8336,63847980,13429359,77277339,4,0,0,2048,29,7386417242
8337,63848600,20957499,84806099,4,0,1,512,29,9456577242
8338,63857880,13471762,77329642,3,0,0,59392,25,6541317359
8339,63860520,13260019,77120539,9,0,0,14848,9,9438458588
8340,63862560,13695803,77558363,4,0,0,39424,29,3245856026
8341,63864860,13958795,77823655,3,0,0,69632,25,4555083025
8342,63866110,20944372,84810482,4,0,1,19968,29,1655955059
8343,63869960,13522774,77392734,3,0,0,5632,25,8847407094
8344,63871160,13755796,77626956,3,0,0,48128,25,433449561
8345,63874100,13130960,77005060,9,0,0,6144,9,7900846833
8346,63884440,13829469,77713909,8,0,0,512,17,437936803
8347,63885830,20955335,84841165,4,0,1,4096,29,4207241090
8348,63886030,13325276,77211306,8,0,0,512,17,7913732646
8349,63893550,20947961,84841511,7,0,1,512,5,1208635271
8350,63894770,13707768,77602538,3,0,0,36352,25,10245940503
8351,63900541,20999658,84900199,8,0,1,12288,17,10180686953
8352,63901440,21005382,84906822,6,0,1,8704,11,2178220758
8353,63901580,21011846,84913426,9,0,1,16384,9,2989042511
8354,63904160,13401375,77305535,8,0,0,1536,17,7370105367
8355,63908070,13396163,77304233,3,0,0,22528,25,8906713447
8356,63915139,13389897,77305036,0,0,0,2560,9,6835767544
8357,63915670,20998923,84914593,9,0,1,4096,9,1007091773
8358,63926609,20988445,84915054,7,0,1,10240,5,10475932478
8359,63933900,13434766,77368666,4,0,0,27648,29,7360146558
8360,63935290,14042121,77977411,9,0,0,88064,9,8204483467
8361,63940579,20991115,84931694,7,0,1,9728,5,3201692646
8362,63943800,21009514,84953314,6,0,1,8192,11,7330823902
8363,63944630,13618536,77563166,4,0,0,2048,29,6105839360
8364,63949171,21008649,84957820,8,0,1,7168,17,5803493277
8365,63950951,21007535,84958486,8,0,1,1024,17,10479805516
8366,63955810,21002932,84958742,6,0,1,9216,11,4421886706
8367,63955961,21003447,84959408,8,0,1,11264,17,9405134264
8368,63964041,21007635,84971676,8,0,1,2560,17,10289767808
8369,63965930,14051266,78017196,4,0,0,18944,29,2166630496
8370,63970210,21003562,84973772,6,0,1,16384,11,926976992
8371,63975810,13397034,77372844,4,0,0,3584,29,5268234152
8372,63976339,21028847,85005186,7,0,1,1024,5,37497661
8373,63979291,21026049,85005340,8,0,1,8704,17,8373821773
8374,63981520,13802217,77783737,4,0,0,67584,29,5529613379
8375,63985120,13573578,77558698,8,0,0,1024,17,3345903421
8376,63995500,21030994,85026494,6,0,1,7680,11,10564801569
8377,64000200,13545793,77545993,8,0,0,512,17,9466752614
8378,64008660,21018820,85027480,6,0,1,1536,11,7334169777
8379,64027230,21031278,85058508,6,0,1,10240,11,7569421326
8380,64032529,21033967,85066496,7,0,1,512,5,893377023
8381,64032869,13526016,77558885,0,0,0,512,9,390505717
8382,64042430,21036211,85078641,6,0,1,12288,11,5730865897
8383,64052649,21029884,85082533,7,0,1,6144,5,9634748314
8384,64062550,21022249,85084799,9,0,1,3584,9,9596939431
8385,64064970,21021775,85086745,6,0,1,3072,11,9160431537
8386,64065820,13496699,77562519,8,0,0,2048,17,9389768192
8387,64070980,21045565,85116545,6,0,1,3584,11,9630104775
8388,64078080,13603481,77681561,3,0,0,26112,25,1431386455
8389,64085740,21034671,85120411,6,0,1,6144,11,2255213686
8390,64090829,13486759,77577588,0,0,0,2048,9,1367271856
8391,64094120,13738775,77832895,3,0,0,9216,25,6067591307
8392,64099090,21025187,85124277,6,0,1,6144,11,10332645272
8393,64100221,21025042,85125263,8,0,1,1536,17,457983931
8394,64109390,21038672,85148062,9,0,1,1024,9,10496606771
8395,64118560,21029525,85148085,6,0,1,16384,11,767212601
8396,64131100,21027390,85158490,9,0,1,6656,9,5086020640
8397,64132321,21027347,85159668,8,0,1,13824,17,354973857
8398,64132580,21034494,85167074,6,0,1,6656,11,6218549922
8399,64138489,13601903,77740392,0,0,0,512,9,7458978656
8400,64152230,21019842,85172072,6,0,1,3072,11,8220583812
8401,64152780,21020598,85173378,6,0,1,2048,11,355331464
8402,64154110,21019614,85173724,6,0,1,512,11,3293593789
8403,64174900,20999170,85174070,9,0,1,512,9,6901538017
8404,64175201,21011552,85186753,8,0,1,1024,17,3111575172
8405,64180610,13723041,77903651,9,0,0,79872,9,20670913
8406,64198340,13515390,77713730,4,0,0,9728,29,10060491440
8407,64204961,20983072,85188033,8,0,1,14336,17,9015040409
8408,64215670,21009249,85224919,6,0,1,11264,11,7997415340
8409,64228669,13453087,77681756,0,0,0,512,9,193135783
8410,64238040,13637580,77875620,9,0,0,4608,9,8434838758
8411,64272741,20952201,85224942,8,0,1,1536,17,6016006526
8412,64282469,13541856,77824325,0,0,0,2048,9,6850172243
8413,64286830,20938135,85224965,9,0,1,512,9,9241562479
8414,64298179,13491683,77789862,0,0,0,1536,9,2105301753
8415,64299230,13489301,77788531,8,0,0,1536,17,7000906926
8416,64309550,20915438,85224988,9,0,1,2048,9,5667626678
8417,64316340,13860755,78177095,9,0,0,121344,9,4235477084
8418,64316920,13666777,77983697,4,0,0,20480,29,5468685872
8419,64320910,13689353,78010263,4,0,0,81920,29,9803226562
8420,64345220,13762440,78107660,9,0,0,19968,9,4161467766
8421,64358760,13762716,78121476,9,0,0,17920,9,1136521807
8422,64364400,13646058,78010458,9,0,0,512,9,6913820327
8423,64365030,20860691,85225721,9,0,1,4096,9,5327731941
8424,64374000,14042671,78416671,9,0,0,29184,9,5965251985
8425,64374600,14075619,78450219,3,0,0,24576,25,1008589817
8426,64377291,20852616,85229907,8,0,1,6656,17,10203304841
8427,64388220,13844975,78233195,9,0,0,39424,9,323775305
8428,64392740,13934860,78327600,4,0,0,51712,29,3216659597
8429,64422350,13660348,78082698,9,0,0,43008,9,606590463
8430,64427839,20802222,85230061,1,0,1,8704,22,5414626058
8431,64446599,20802740,85249339,1,0,1,512,22,7761295017
8432,64459299,13794147,78253446,0,0,0,1024,9,3613627542
8433,64462871,20807702,85270573,8,0,1,4608,17,10161159967
8434,64484391,20809160,85293551,8,0,1,7168,17,199039206
8435,64485560,13525545,78011105,8,0,0,2048,17,6286212818
8436,64488890,13496390,77985280,9,0,0,5120,9,3324346038
8437,64489110,13602173,78091283,8,0,0,1024,17,3632652038
8438,64500271,20793303,85293574,8,0,1,5632,17,1482410156
8439,64509170,13605963,78115133,3,0,0,5632,25,519658957
8440,64511440,20787450,85298890,9,0,1,5120,9,10696007527
8441,64520670,14007796,78528466,3,0,0,15872,25,2207703188
8442,64528830,13607675,78136505,8,0,0,1024,17,4559196468
8443,64539330,14098609,78637939,3,0,0,89600,25,2149110903
8444,64542810,13832000,78374810,8,0,0,512,17,8016015350
8445,64543811,20820763,85364574,8,0,1,1536,17,7192155275
8446,64556301,20808296,85364597,8,0,1,3072,17,8309435885
8447,64567900,14109927,78677827,3,0,0,13824,25,154686187
8448,64567961,20796659,85364620,8,0,1,1536,17,3000312252
8449,64575139,13752796,78327935,0,0,0,1024,9,8622176402
8450,64576919,13637742,78214661,0,0,0,1536,9,6744596764
8451,64580300,13940676,78520976,4,0,0,40448,29,2319650388
8452,64600650,20764001,85364651,9,0,1,1536,9,6311351893
8453,64612620,13737659,78350279,7,0,0,57344,5,10103704013
8454,64613841,20750833,85364674,8,0,1,4096,17,7784322512
8455,64616799,20747898,85364697,5,0,1,2048,25,572092197
8456,64623691,20741029,85364720,8,0,1,512,17,71117280
8457,64627159,20737584,85364743,1,0,1,2560,22,3866152949
8458,64628521,20736245,85364766,8,0,1,3584,17,4154452704
8459,64635409,20737918,85373327,1,0,1,26112,22,7435110174
8460,64656089,20743053,85399142,1,0,1,4608,22,2308990889
8461,64657520,14016064,78673584,9,0,0,32256,9,4721842575
8462,64658550,13669564,78328114,8,0,0,512,17,3498996002
8463,64660030,20783739,85443769,9,0,1,16384,9,2970401400
8464,64663500,13730737,78394237,3,0,0,19456,25,6964871734
8465,64670831,20772961,85443792,8,0,1,8704,17,4779258375
8466,64675840,14115230,78791070,3,0,0,54784,25,106555227
8467,64686171,20757644,85443815,8,0,1,7168,17,3591713566
8468,64691339,20752499,85443838,5,0,1,512,25,8536334312
8469,64694671,20749190,85443861,8,0,1,7168,17,5218359194
8470,64710159,13467340,78177499,0,0,0,1024,9,4333989741
8471,64714351,20729533,85443884,8,0,1,512,17,6803281999
8472,64717500,20726407,85443907,9,0,1,5632,9,3710744817
8473,64723300,13712521,78435821,4,0,0,14336,29,10641691407
8474,64726291,20718450,85444741,8,0,1,5632,17,5865165509
8475,64727670,14149248,78876918,9,0,0,9728,9,1811749273
8476,64743070,13920663,78663733,4,0,0,22528,29,8187598257
8477,64745150,14252116,78997266,4,0,0,90112,29,237271343
8478,64752520,14362220,79114740,3,0,0,76288,25,3944217157
8479,64753071,20752171,85505242,8,0,1,2048,17,3233674168
8480,64757600,14155725,78913325,9,0,0,44032,9,9316208509
8481,64761019,20744246,85505265,1,0,1,9216,22,5289908656
8482,64762990,13679718,78442708,4,0,0,22528,29,1653018073
8483,64767019,20741426,85508445,5,0,1,5632,25,6911415823
8484,64767880,13953231,78721111,4,0,0,19968,29,5736524605
8485,64767929,14058765,78826694,0,0,0,2560,9,3475078859
8486,64768209,13603884,78372093,0,0,0,1024,9,310036563
8487,64769600,20749153,85518753,9,0,1,1536,9,202193575
8488,64773699,20749240,85522939,5,0,1,6656,25,7741668222
8489,64774669,20749243,85523912,1,0,1,12800,22,7998426114
8490,64777579,13900427,78678006,0,0,0,512,9,6777435180
8491,64786510,20767246,85553756,9,0,1,512,9,6341914372
8492,64789909,14008639,78798548,0,0,0,2048,9,1050105534
8493,64796530,13860308,78656838,4,0,0,61952,29,10307261891
8494,64803740,13704889,78508629,3,0,0,72704,25,949115034
8495,64806250,14357721,79163971,4,0,0,8704,29,4017263533
8496,64817440,20738902,85556342,9,0,1,4096,9,7167758253
8497,64823510,14138703,78962213,9,0,0,5632,9,5824870284
8498,64824309,20739652,85563961,5,0,1,7168,25,5962247798
8499,64825009,20740258,85565267,1,0,1,2048,22,5857854449
8500,64831209,13750588,78581797,0,0,0,512,9,5560598896
8501,64832549,13747554,78580103,0,0,0,1024,9,4511484695
8502,64834980,13870333,78705313,3,0,0,37376,25,6124155781
8503,64843550,14030381,78873931,3,0,0,44032,25,1873426156
8504,64845369,20753048,85598417,7,0,1,24064,5,9844107858
8505,64864500,13926905,78791405,8,0,0,1024,17,6776633225
8506,64865380,13994920,78860300,4,0,0,28160,29,10160662690
8507,64880109,20722814,85602923,7,0,1,7168,5,1043878028
8508,64883310,13887278,78770588,3,0,0,45056,25,6902293973
8509,64898270,13824424,78722694,4,0,0,5120,29,3174628439
8510,64900539,20752563,85653102,5,0,1,5632,25,3520977809
8511,64901929,20751196,85653125,5,0,1,3072,25,6531077216
8512,64907789,20745375,85653164,7,0,1,7168,5,10032194504
8513,64929960,13792913,78722873,8,0,0,512,17,1698298483
8514,64935729,20717458,85653187,5,0,1,2048,25,2105989650
8515,64937220,20715990,85653210,9,0,1,4096,9,2559805757
8516,64937770,13836585,78774355,3,0,0,12288,25,10590214386
8517,64946520,20706713,85653233,9,0,1,4096,9,2394993907
8518,64947779,20705477,85653256,5,0,1,512,25,9710760887
8519,64948879,20797268,85746147,7,0,1,10240,5,8844379434
8520,64949639,20799541,85749180,5,0,1,17920,25,5878862066
8521,64950119,13881279,78831398,0,0,0,1536,9,8147655205
8522,64950940,13909539,78860479,8,0,0,512,17,8489313054
8523,64952610,14334709,79287319,3,0,0,28160,25,6831403189
8524,64961050,14290023,79251073,3,0,0,36352,25,7424607349
8525,64966720,13919546,78886266,8,0,0,1536,17,3440960489
8526,64971440,13958065,78929505,3,0,0,2048,25,6881349229
8527,65012539,20770708,85783247,5,0,1,4096,25,9984954739
8528,65013610,14166723,79180333,9,0,0,52224,9,7347106849
8529,65015650,13811956,78827606,8,0,0,512,17,10716332992
8530,65016760,13982245,78999005,3,0,0,5632,25,4435573450
8531,65021459,20762454,85783913,7,0,1,1024,5,10246973526
8532,65023520,20760739,85784259,9,0,1,512,9,1762998223
8533,65024190,14012712,79036902,3,0,0,58880,25,5372292195
8534,65026169,14154967,79181136,0,0,0,2560,9,7344372152
8535,65037200,20747405,85784605,9,0,1,512,9,7563823824
8536,65045859,20739092,85784951,5,0,1,512,25,10658992299
8537,65060830,13993318,79054148,3,0,0,10240,25,7200093194
8538,65066380,20719557,85785937,6,0,1,1536,11,389441412
8539,65067410,13971387,79038797,9,0,0,6144,9,642938159
8540,65068690,13972750,79041440,8,0,0,1024,17,3463207057
8541,65069150,14075382,79144532,3,0,0,42496,25,10127739329
8542,65091660,13955116,79046776,4,0,0,12800,29,7492962579
8543,65094229,13905267,78999496,0,0,0,1536,9,2134826972
8544,65097589,13972365,79069954,0,0,0,2048,9,10671473205
8545,65113850,14079188,79193038,8,0,0,512,17,3965216562
8546,65119430,14131978,79251408,8,0,0,1024,17,9385345720
8547,65124930,20665688,85790618,9,0,1,2560,9,6007812986
8548,65131440,13907848,79039288,8,0,0,1536,17,2317146178
8549,65132460,14060399,79192859,3,0,0,38400,25,5975230935
8550,65142480,14064777,79207257,4,0,0,46592,29,3332871717
8551,65144370,14063230,79207600,8,0,0,1024,17,8128464209
8552,65151749,13993274,79145023,0,0,0,1536,9,4886803661
8553,65174640,14156351,79330991,4,0,0,45056,29,2538230236
8554,65186170,14089219,79275389,4,0,0,19968,29,10546896313
8555,65193670,14071401,79265071,8,0,0,512,17,4012332472
8556,65210570,14231312,79441882,9,0,0,5120,9,7477824467
8557,65218980,20579333,85798313,9,0,1,21504,9,9442185325
8558,65221149,14030602,79251751,0,0,0,1024,9,10144613946
8559,65227880,14125194,79353074,9,0,0,34816,9,3599047690
8560,65228090,14085213,79313303,3,0,0,7168,25,6696479169
8561,65240360,14225119,79465479,9,0,0,2048,9,2351364627
8562,65250590,14036908,79287498,8,0,0,512,17,8270791353
8563,65256270,14195275,79451545,3,0,0,14336,25,6183937478
8564,65262570,14172844,79435414,4,0,0,34304,29,10425305258
8565,65271369,20592263,85863632,7,0,1,1024,5,4384394155
8566,65277090,20586565,85863655,4,0,1,5120,29,3304543344
8567,65277400,14268772,79546172,9,0,0,30208,9,1065239540
8568,65277889,14053281,79331170,0,0,0,512,9,9480027833
8569,65280160,14120001,79400161,9,0,0,3072,9,3278895966
8570,65280990,14171092,79452082,8,0,0,512,17,9884119014
8571,65290330,20573348,85863678,4,0,1,7680,29,8715317005
8572,65299820,14206089,79505909,9,0,0,46592,9,1186485099
8573,65309720,20594674,85904394,4,0,1,5632,29,1468023333
8574,65337920,14138771,79476691,3,0,0,36352,25,3740576534
8575,65344119,20560298,85904417,7,0,1,512,5,3814656977
8576,65356740,14214756,79571496,3,0,0,59904,25,2551849463
8577,65361639,20542801,85904440,7,0,1,512,5,7087256208
8578,65361880,14229449,79591329,4,0,0,9728,29,9108209708
8579,65412500,14102751,79515251,8,0,0,512,17,8770857939
8580,65420110,14172751,79592861,3,0,0,2048,25,9643027671
8581,65420620,20484172,85904792,4,0,1,3072,29,7763074299
8582,65432170,20476488,85908658,4,0,1,6144,29,8779686877
8583,65449770,14002133,79451903,3,0,0,1024,25,4988540306
8584,65469220,14007650,79476870,8,0,0,512,17,9405645580
8585,65509839,20460348,85970187,7,0,1,8192,5,3561924040
8586,65516050,13960999,79477049,8,0,0,512,17,10262036137
8587,65535019,20435191,85970210,7,0,1,9216,5,1722560452
8588,65556020,14044118,79600138,8,0,0,512,17,3626842236
8589,65563330,14047037,79610367,8,0,0,512,17,10082703678
8590,65576139,20422532,85998671,7,0,1,512,5,7511606658
8591,65592470,13937213,79529683,8,0,0,512,17,8871893610
8592,65596619,20465489,86062108,3,0,1,12288,25,3640943856
8593,65598340,14149186,79747526,3,0,0,82944,25,7421388664
8594,65599589,14011611,79611200,0,0,0,512,9,10551311524
8595,65605490,13973013,79578503,8,0,0,1024,17,1331233675
8596,65605570,20457844,86063414,4,0,1,2048,29,2637587530
8597,65613110,14091451,79704561,3,0,0,66560,25,7791457969
8598,65614239,20453041,86067280,7,0,1,6144,5,7451788144
8599,65617180,14247503,79864683,3,0,0,70144,25,5164958136
8600,65620679,20449507,86070186,7,0,1,4608,5,7448328941
8601,65622780,14051933,79674713,4,0,0,5632,29,7272336421
8602,65634670,20452111,86086781,6,0,1,1024,11,6119200952
8603,65635159,20452928,86088087,7,0,1,2048,5,5880432486
8604,65646270,13906951,79553221,8,0,0,1024,17,8694130272
8605,65660440,14137519,79797959,8,0,0,512,17,3656496393
8606,65664420,20425293,86089713,4,0,1,2560,29,7706019781
8607,65670180,20420301,86090481,6,0,1,11776,11,1412998240
8608,65686310,14179207,79865517,8,0,0,1024,17,6961297180
8609,65697870,20426283,86124153,6,0,1,8192,11,6955070173
8610,65702080,20487370,86189450,6,0,1,6656,11,8463913937
8611,65733390,20456730,86190120,6,0,1,1024,11,4713133616
8612,65733840,20456303,86190143,6,0,1,9216,11,4713728887
8613,65739199,14125975,79865174,0,0,0,1536,9,9987344449
8614,65749980,14072229,79822209,3,0,0,16896,25,475357506
8615,65751100,20443243,86194343,4,0,1,8192,29,6894558417
8616,65764970,13956675,79721645,8,0,0,1536,17,5149160309
8617,65772709,20423017,86195726,3,0,1,14848,25,4425187016
8618,65779769,13925219,79704988,0,0,0,1024,9,10673458510
8619,65789480,14282617,80072097,3,0,0,99840,25,5240158599
8620,65789759,20443185,86232944,5,0,1,3584,25,10662588865
8621,65790400,14344271,80134671,4,0,0,72192,29,8248542116
8622,65792540,14436241,80228781,3,0,0,153088,25,9854384942
8623,65794270,20439980,86234250,6,0,1,2048,11,132307160
8624,65802459,20436297,86238756,7,0,1,7168,5,1174336433
8625,65817139,20426763,86243902,5,0,1,8192,25,1076266990
8626,65817270,14157537,79974807,4,0,0,20992,29,1789744637
8627,65820430,14285886,80106316,8,0,0,512,17,7629581350
8628,65820840,20423408,86244248,4,0,1,512,29,2404592549
8629,65844380,20405053,86249433,4,0,1,16384,29,9832173998
8630,65846459,20404831,86251290,7,0,1,13824,5,6577277893
8631,65851810,20400786,86252596,4,0,1,2048,29,8717847046
8632,65852309,20402873,86255182,7,0,1,4096,5,460076209
8633,65855780,20416648,86272428,6,0,1,4608,11,4084063554
8634,65869330,14057510,79926840,4,0,0,1024,29,6709056756
8635,65870000,20402451,86272451,6,0,1,5632,11,10143065239
8636,65879310,20393164,86272474,9,0,1,3072,9,2990238860
8637,65881369,20391128,86272497,5,0,1,2048,25,9482531677
8638,65894570,20403713,86298283,6,0,1,2560,11,9795448133
8639,65894680,20403626,86298306,4,0,1,7680,29,7370398462
8640,65897709,14180009,80077718,0,0,0,512,9,4703756469
8641,65899100,14178953,80078053,3,0,0,1024,25,10179361927
8642,65908010,14169529,80077539,4,0,0,17408,29,729545312
8643,65919410,20378927,86298337,6,0,1,18944,11,4551948763
8644,65924110,14321030,80245140,8,0,0,512,17,10200998005
8645,65930519,20367841,86298360,7,0,1,1024,5,8802630498
8646,65942430,14328274,80270704,8,0,0,1024,17,6159831675
8647,65947279,20351595,86298874,5,0,1,3584,25,6443133964
8648,65950560,14499407,80449967,3,0,0,167936,25,1290257142
8649,65963289,20335608,86298897,7,0,1,1024,5,10167876363
8650,65968840,20331584,86300424,6,0,1,3072,11,511494599
8651,65970250,20373710,86343960,6,0,1,2560,11,3374869851
8652,65977430,14341204,80318634,4,0,0,7168,29,3173436529
8653,65979870,14368058,80347928,8,0,0,512,17,7764460058
8654,65980449,20363534,86343983,5,0,1,6656,25,6811990882
8655,65980689,14250143,80230832,0,0,0,6656,9,7733613699
8656,65992360,20351646,86344006,4,0,1,512,29,6929183081
8657,65998189,20345840,86344029,5,0,1,4608,25,6454206980
8658,66004680,14467577,80472257,3,0,0,48128,25,4847485571
8659,66005440,20338612,86344052,4,0,1,2048,29,3986504686
8660,66012039,14219156,80231195,0,0,0,512,9,8983504521
8661,66012629,20331446,86344075,5,0,1,4096,25,8756324876
8662,66023480,20320618,86344098,6,0,1,8704,11,352764333
8663,66031309,20314727,86346036,5,0,1,3584,25,6937159792
8664,66041809,14430750,80472559,0,0,0,512,9,7644893608
8665,66050610,20296194,86346804,6,0,1,11776,11,9469865470
8666,66055809,14394649,80450458,0,0,0,1536,9,774167711
8667,66060340,14397207,80457547,3,0,0,23040,25,2125430698
8668,66062649,14410245,80472894,0,0,0,1024,9,1746719039
8669,66067540,20279623,86347163,6,0,1,9728,11,4534193891
8670,66074929,20277835,86352764,5,0,1,5632,25,7781353579
8671,66082030,20307575,86389605,6,0,1,11264,11,9592675179
8672,66082639,14390925,80473564,0,0,0,2048,9,10456310969
8673,66087559,20304632,86392191,5,0,1,4096,25,6149561197
8674,66101040,20343145,86444185,4,0,1,11776,29,5834276896
8675,66114809,20337563,86452372,7,0,1,15872,5,3613059556
8676,66118300,14455684,80573984,3,0,0,17920,25,8444530624
8677,66122520,20333078,86455598,6,0,1,5120,11,7004598574
8678,66130960,20381498,86512458,4,0,1,2048,29,7541236279
8679,66135960,20379404,86515364,6,0,1,4608,11,5386293938
8680,66143689,20385037,86528726,5,0,1,6144,25,689891700
8681,66145380,14408969,80554349,8,0,0,1024,17,1286475328
8682,66170900,20362652,86533552,6,0,1,7680,11,2242664901
8683,66179819,20355039,86534858,7,0,1,2048,5,7230531424
8684,66189740,14485824,80675564,4,0,0,46592,29,9076853119
8685,66190120,20406077,86596197,6,0,1,8192,11,1739334718
8686,66216520,20380663,86597183,6,0,1,1536,11,4270565387
8687,66219220,14297858,80517078,8,0,0,512,17,5146003588
8688,66252499,20347659,86600158,7,0,1,4096,5,6855392128
8689,66264210,14471111,80735321,8,0,0,2048,17,9987819064
8690,66267849,14386987,80654836,0,0,0,512,9,2419005708
8691,66269630,20360606,86630236,4,0,1,6656,29,4914422469
8692,66275949,14316113,80592062,0,0,0,512,9,10219937987
8693,66286820,20368900,86655720,6,0,1,4096,11,2477515642
8694,66286960,20368783,86655743,4,0,1,1536,29,8856235271
8695,66301080,14682260,80983340,4,0,0,66048,29,10115366318
8696,66301949,20353817,86655766,5,0,1,24064,25,8608302761
8697,66344770,14176836,80521606,8,0,0,512,17,4167669801
8698,66346560,14210861,80557421,8,0,0,1024,17,6562292567
8699,66347019,20371974,86718993,7,0,1,15360,5,10259659355
8700,66354000,14321743,80675743,8,0,0,512,17,8651546206
8701,66381530,14550279,80931809,8,0,0,512,17,1057331843
8702,66384080,20455264,86839344,4,0,1,15360,29,6778106985
8703,66386490,14484706,80871196,4,0,0,69632,29,5240352599
8704,66393670,14126400,80520070,8,0,0,512,17,1048731689
8705,66403759,20479213,86882972,5,0,1,1024,25,3832192562
8706,66406180,20480018,86886198,4,0,1,5120,29,2760899336
8707,66409109,14427016,80836125,0,0,0,2560,9,10181096484
8708,66412100,20474444,86886544,4,0,1,512,29,4274223934
8709,66434990,20454780,86889770,4,0,1,5120,29,5713760640
8710,66438490,14192964,80631454,8,0,0,512,17,5767357725
8711,66445110,14387239,80832349,8,0,0,512,17,1139181928
8712,66449770,20461144,86910914,4,0,1,2048,29,8571314126
8713,66479590,20486103,86965693,4,0,1,10240,29,9039507053
8714,66486169,20481150,86967319,2,0,1,2560,0,7989470556
8715,66487260,20481045,86968305,9,0,1,1536,9,4451330947
8716,66492870,14713543,81206413,3,0,0,35328,25,4010756477
8717,66504710,15130874,81635584,8,0,0,1536,17,6046721293
8718,66511460,14196177,80707637,8,0,0,1024,17,7303346507
8719,66512400,20457211,86969611,4,0,1,2048,29,5151572603
8720,66517440,14271394,80788834,4,0,0,37376,29,7768974797
8721,66518270,14381671,80899941,3,0,0,40448,25,9388141770
8722,66518520,20471293,86989813,9,0,1,7168,9,9561435167
8723,66521150,20511443,87032593,6,0,1,4096,11,682062785
8724,66524230,14288476,80812706,8,0,0,1536,17,2318539724
8725,66530080,15254876,81784956,3,0,0,8704,25,4643393545
8726,66537700,20513594,87051294,4,0,1,1536,29,6420607863
8727,66550889,20505231,87056120,5,0,1,7680,25,8444091873
8728,66553010,14589737,81142747,2,0,0,59392,0,1449852847
8729,66555890,20564610,87120500,4,0,1,6656,29,10255147625
8730,66567600,20561435,87129035,4,0,1,8192,29,2920699336
8731,66572460,14663784,81236244,8,0,0,1024,17,452558017
8732,66586600,14446360,81032960,8,0,0,512,17,2405354001
8733,66589140,20565079,87154219,6,0,1,3072,11,7400907415
8734,66596690,20557875,87154565,6,0,1,512,11,4291963062
8735,66597850,20558195,87156045,4,0,1,11776,29,2550763815
8736,66615010,20812958,87427968,6,0,1,2560,11,8020309311
8737,66627250,20827931,87455181,4,0,1,512,29,6156173327
8738,66629540,15083995,81713535,4,0,0,24576,29,3879859951
8739,66635350,20869726,87505076,4,0,1,8192,29,7388133359
8740,66636250,14509131,81145381,3,0,0,7168,25,5294088893
8741,66636570,20868537,87505107,4,0,1,6656,29,4507892881
8742,66639449,14567455,81206904,0,0,0,1536,9,6715296767
8743,66664639,20840491,87505130,5,0,1,4096,25,2384997252
8744,66672190,20832963,87505153,6,0,1,1536,11,3231799757
8745,66673430,20833337,87506767,9,0,1,1024,9,1145409682
8746,66673779,20833011,87506790,5,0,1,3584,25,4537323791
8747,66675700,20831113,87506813,6,0,1,3584,11,9805262391
8748,66680330,14034962,80715292,4,0,0,5120,29,7262404971
8749,66687400,14193485,80880885,8,0,0,1024,17,5944615721
8750,66696370,14685033,81381403,3,0,0,69120,25,1816858424
8751,66698510,20808326,87506836,9,0,1,6144,9,5540152310
8752,66709230,20797629,87506859,9,0,1,2560,9,9024592646
8753,66717650,20790503,87508153,4,0,1,16384,29,8572587324
8754,66765620,20747593,87513213,9,0,1,12288,9,2148217988
8755,66774100,14329946,81104046,4,0,0,21504,29,1069003603
8756,66782489,20773853,87556342,5,0,1,1024,25,5035749277
8757,66783590,20772775,87556365,6,0,1,4608,11,5881049269
8758,66784390,14639008,81423398,4,0,0,95744,29,4478692940
8759,66784720,20771668,87556388,4,0,1,5632,29,500122322
8760,66796770,20759649,87556419,4,0,1,2048,29,4934190274
8761,66802250,20769988,87572238,0,0,1,7680,9,7785765304
8762,66815979,20756873,87572852,5,0,1,512,25,5957121960
8763,66836190,20740528,87576718,4,0,1,6144,29,142037915
8764,66839820,20752583,87592403,4,0,1,512,29,6895030147
8765,66846169,20746257,87592426,5,0,1,1024,25,10029383988
8766,66849490,20742959,87592449,9,0,1,5120,9,2418462304
8767,66852039,14131480,80983519,0,0,0,512,9,9009795259
8768,66853009,20755534,87608543,5,0,1,8192,25,9264813532
8769,66855110,14264386,81119496,8,0,0,512,17,470063437
8770,66855180,20789519,87644699,4,0,1,2048,29,3873683399
8771,66857650,20787072,87644722,6,0,1,3072,11,4017044370
8772,66871189,20841345,87712534,5,0,1,12288,25,2938142956
8773,66877670,20836170,87713840,4,0,1,2048,29,6214670003
8774,66880390,14055269,80935659,3,0,0,2560,25,9628527185
8775,66886120,20867156,87753276,4,0,1,1024,29,1267432786
8776,66889100,14131120,81020220,8,0,0,1024,17,1546076572
8777,66894809,20859453,87754262,5,0,1,1536,25,9701143088
8778,66902460,15039590,81942050,4,0,0,9728,29,4707970030
8779,66902750,15190058,82092808,4,0,0,64000,29,4484371460
8780,66915650,14248807,81164457,3,0,0,3072,25,7568643550
8781,66923790,20841292,87765082,9,0,1,7168,9,7152303480
8782,66931610,20835098,87766708,9,0,1,2560,9,7424797506
8783,66932270,20836384,87768654,6,0,1,3072,11,9104039083
8784,66946480,20824440,87770920,6,0,1,3584,11,3224531722
8785,66947070,14196104,81143174,8,0,0,1024,17,7700495078
8786,66960680,20817133,87777813,0,0,1,10752,9,4126170334
8787,66970260,14996109,81966369,8,0,0,1536,17,2227644178
8788,66981900,14357652,81339552,3,0,0,39936,25,6976291856
8789,66992600,14401603,81394203,3,0,0,37888,25,1789704626
8790,67010480,14211582,81222062,8,0,0,512,17,8688240642
8791,67010980,14479976,81490956,4,0,0,91136,29,1153295995
8792,67019399,20773898,87793297,2,0,1,6144,0,9371209268
8793,67029860,14489112,81518972,4,0,0,63488,29,8457182039
8794,67046750,14516453,81563203,3,0,0,8192,25,1352910781
8795,67047430,14244897,81292327,4,0,0,37376,29,988871676
8796,67067401,20726242,87793643,8,0,1,512,17,5635091492
8797,67083210,14461807,81545017,8,0,0,512,17,3565148623
8798,67085160,14490577,81575737,8,0,0,512,17,4572578933
8799,67105190,14417462,81522652,4,0,0,11776,29,4836374230
8800,67115379,14558875,81674254,0,0,0,1024,9,5859952756
8801,67118799,14312289,81431088,0,0,0,512,9,7905039260
8802,67138160,14201883,81340043,8,0,0,1536,17,3877380950
8803,67164720,14182054,81346774,4,0,0,22016,29,4261984824
8804,67172530,14258379,81430909,4,0,0,24576,29,8120883484
8805,67180739,14359534,81540273,0,0,0,2048,9,1846697790
8806,67190090,14445003,81635093,3,0,0,67072,25,10011004725
8807,67242300,14036002,81278302,4,0,0,17408,29,10649239133
8808,67255620,14410999,81666619,3,0,0,59392,25,695103228
8809,67265190,14307803,81572993,4,0,0,24576,29,6217503607
8810,67274110,14301448,81575558,4,0,0,8192,29,3325931208
8811,67286110,14212669,81498779,4,0,0,25600,29,5821899264
8812,67303650,14425889,81729539,4,0,0,49664,29,5715139665
8813,67304769,14194189,81498958,0,0,0,512,9,8643936072
8814,67312179,14402205,81714384,0,0,0,1024,9,2853298182
8815,67316980,14840922,82157902,3,0,0,49664,25,2993825498
8816,67326449,20494450,87820899,1,0,1,15872,22,7131775451
8817,67338739,14414113,81752852,0,0,0,512,9,6433245581
8818,67342310,14249400,81591710,3,0,0,8704,25,324263759
8819,67348840,20540773,87889613,4,0,1,1536,29,9043888532
8820,67358410,14547955,81906365,3,0,0,32256,25,2306495350
8821,67372540,14157858,81530398,4,0,0,25088,29,8395056557
8822,67391720,14417683,81809403,3,0,0,54784,25,10698368395
8823,67392030,20497606,87889636,4,0,1,1024,29,1438644232
8824,67398279,14101326,81499605,0,0,0,2048,9,7669563445
8825,67408309,14352223,81760532,0,0,0,512,9,1741528211
8826,67409790,14323472,81733262,3,0,0,3584,25,376710951
8827,67424430,20465229,87889659,4,0,1,5632,29,5652629519
8828,67424570,14306428,81730998,3,0,0,4608,25,1156716752
8829,67434860,13919113,81353973,3,0,0,23552,25,6333199071
8830,67471419,20418263,87889682,5,0,1,512,25,1667995012
8831,67489820,14096898,81586718,4,0,0,30208,29,10590751704
8832,67499389,20391587,87890976,5,0,1,5120,25,3455029137
8833,67506420,14887587,82394007,3,0,0,68096,25,9208135075
8834,67509949,20394801,87904750,5,0,1,26624,25,5517629865
8835,67516299,14169900,81686199,0,0,0,512,9,1349254338
8836,67518040,20421238,87939278,4,0,1,3584,29,4721039257
8837,67521559,14118294,81639853,0,0,0,1536,9,6749879709
8838,67530930,20411574,87942504,0,0,1,5120,9,6237614706
8839,67533889,20409793,87943682,3,0,1,13824,25,10376151417
8840,67535160,20430949,87966109,4,0,1,4096,29,1917100
8841,67535910,20430222,87966132,0,0,1,512,9,7473817725
8842,67540909,20425246,87966155,5,0,1,1024,25,283403238
8843,67548350,20417828,87966178,0,0,1,512,9,4543450338
8844,67552230,20413971,87966201,0,0,1,1024,9,7696989576
8845,67554800,20411424,87966224,0,0,1,1024,9,9226789503
8846,67560359,14016442,81576801,0,0,0,512,9,9632035298
8847,67565800,14264224,81830024,4,0,0,27648,29,5902998809
8848,67609940,20356307,87966247,0,0,1,1024,9,1657608914
8849,67610719,20355551,87966270,7,0,1,1536,5,7492243446
8850,67613859,20397549,88011408,3,0,1,40448,25,10677295695
8851,67619980,20392583,88012563,4,0,1,2048,29,745076049
8852,67635500,20378689,88014189,0,0,1,2560,9,5548651726
8853,67642259,14142876,81785135,0,0,0,512,9,8344673041
8854,67662160,20359808,88021968,0,0,1,512,9,10517578090
8855,67675869,20346867,88022736,2,0,1,11776,0,7504466289
8856,67676489,14192050,81868539,0,0,0,512,9,7413646889
8857,67680559,20401709,88082268,3,0,1,36352,25,876680609
8858,67681239,20403961,88085200,2,0,1,4608,0,4407302363
8859,67690079,20577868,88267947,3,0,1,77824,25,3582570355
8860,67691310,13872228,81563538,4,0,0,1024,29,4107660355
8861,67705189,20617751,88322940,3,0,1,52736,25,10541183161
8862,67707119,14052345,81759464,0,0,0,2048,9,395496346
8863,67709679,20674722,88384401,3,0,1,56832,25,5133857901
8864,67717329,20782789,88500118,3,0,1,130048,25,8509518214
8865,67718009,20783389,88501398,2,0,1,14336,0,2179488249
8866,67727229,20782579,88509808,3,0,1,12288,25,4127433517
8867,67747980,14267568,82015548,4,0,0,25600,29,4358799546
8868,67752699,20775079,88527778,2,0,1,2560,0,147114729
8869,67756729,13957141,81713870,0,0,0,1024,9,1788072016
8870,67765329,20819115,88584444,3,0,1,63488,25,1083294738
8871,67768970,20818700,88587670,4,0,1,5120,29,480842861
8872,67773449,20816641,88590090,5,0,1,12288,25,3640489550
8873,67773769,20896418,88670187,3,0,1,86016,25,440429089
8874,67777940,20892270,88670210,4,0,1,11264,29,9926930064
8875,67790259,20881225,88671484,2,0,1,1024,0,4152844745
8876,67796700,20875130,88671830,4,0,1,512,29,5238602650
8877,67797320,14018406,81815726,4,0,0,4096,29,10232713614
8878,67800460,14092049,81892509,3,0,0,49152,25,6570510246
8879,67802630,20874346,88676976,0,0,1,8192,9,6592074152
8880,67805089,14047158,81852247,0,0,0,512,9,6122127582
8881,67812120,14194926,82007046,3,0,0,11264,25,6275569296
8882,67815339,20892955,88708294,3,0,1,24064,25,4053402965
8883,67824259,13985635,81809894,0,0,0,1536,9,290055292
8884,67824579,20886621,88711200,2,0,1,4608,0,10074626403
8885,67825680,20888106,88713786,4,0,1,4096,29,5913444757
8886,67845579,20869180,88714759,3,0,1,12800,25,5243415524
8887,67848470,20874703,88723173,9,0,1,2048,9,7715962572
8888,67855240,13985259,81840499,3,0,0,34304,25,3988213975
8889,67858720,20865119,88723839,9,0,1,1024,9,3543867258
8890,67868009,20900150,88768159,3,0,1,88064,25,10011836132
8891,67868180,20915929,88784109,4,0,1,4608,29,5886800834
8892,67890100,20900781,88790881,9,0,1,10752,9,6014336749
8893,67894690,20898777,88793467,9,0,1,4096,9,5066427553
8894,67911020,20882793,88793813,4,0,1,512,29,2299234000
8895,67968600,14153403,82122003,3,0,0,95744,25,9041882415
8896,67969339,13744710,81714049,0,0,0,512,9,8594514259
8897,67971770,20824629,88796399,9,0,1,4096,9,431116847
8898,67979359,20820993,88800352,7,0,1,13312,5,7267663443
8899,67987070,20813436,88800506,9,0,1,8704,9,10371693497
8900,67988790,14056758,82045548,3,0,0,83456,25,3679395615
8901,67996400,20808186,88804586,9,0,1,6144,9,8665138906
8902,68002449,20804083,88806532,7,0,1,3072,5,3210293728
8903,68004690,14044024,82048714,4,0,0,8704,29,5314982985
8904,68009339,20798499,88807838,7,0,1,2048,5,2880555461
8905,68022460,20792830,88815290,9,0,1,12800,9,338199373
8906,68024720,20795396,88820116,4,0,1,7680,29,3917309321
8907,68028150,20801870,88830020,9,0,1,2048,9,5332579989
8908,68031630,20800016,88831646,9,0,1,2560,9,5893409186
8909,68033770,20798222,88831992,9,0,1,512,9,6451017002
8910,68037519,13869033,81906552,0,0,0,512,9,1568703567
8911,68039880,20795658,88835538,4,0,1,5632,29,8568760633
8912,68063320,20787887,88851207,4,0,1,3072,29,2220185559
8913,68086990,20765702,88852692,4,0,1,15360,29,1536568061
8914,68094020,20772959,88866979,9,0,1,4096,9,2606199044
8915,68108339,20760906,88869245,2,0,1,3584,0,9071701489
8916,68108380,20761851,88870231,9,0,1,1536,9,7122596293
8917,68119029,20755068,88874097,7,0,1,6144,5,9900234093
8918,68133580,20741823,88875403,0,0,1,2048,9,4312533725
8919,68140740,13908161,82048901,1,0,0,512,22,912121705
8920,68146040,20731629,88877669,4,0,1,3584,29,567407630
8921,68147019,20731956,88878975,5,0,1,2048,25,1030469328
8922,68149990,13832148,81982138,1,0,0,2048,22,6514740598
8923,68153500,20728061,88881561,9,0,1,4096,9,2176361078
8924,68164689,13798249,81962938,0,0,0,512,9,2510361659
8925,68166840,20716373,88883213,0,0,1,12800,9,10679258149
8926,68190080,20700622,88890702,9,0,1,3584,9,3803679454
8927,68204769,20691758,88896527,7,0,1,7168,5,1390486528
8928,68206510,20700731,88907241,4,0,1,7168,29,10072562837
8929,68211229,20696358,88907587,7,0,1,512,5,4252271307
8930,68216970,20693843,88910813,9,0,1,5120,9,5502625916
8931,68220079,13825960,82046039,0,0,0,1536,9,9362639400
8932,68229470,20682799,88912269,0,0,1,11264,9,10442479654
8933,68230749,20683146,88913895,7,0,1,2560,5,7164600004
8934,68235250,20681551,88916801,9,0,1,4608,9,7283972416
8935,68241200,14392213,82633413,4,0,0,33792,29,1100756205
8936,68251629,20783070,89034699,3,0,1,146944,25,604269697
8937,68252709,13909588,82162297,0,0,0,512,9,1065094006
8938,68253360,13941166,82194526,4,0,0,64000,29,860220172
8939,68253809,20813028,89066837,7,0,1,37888,5,7718366668
8940,68261279,20824716,89085995,7,0,1,5632,5,8825293039
8941,68263559,13876210,82139769,0,0,0,1536,9,6531263708
8942,68269590,14049979,82319569,4,0,0,46080,29,6798559191
8943,68283030,13974494,82257524,4,0,0,10752,29,8979143625
8944,68287920,14175242,82463162,1,0,0,2048,22,760893713
8945,68292390,20797955,89090345,9,0,1,4608,9,4604382414
8946,68308699,13965374,82274073,0,0,0,512,9,9601413936
8947,68311679,20779652,89091331,7,0,1,1536,5,7526155508
8948,68315960,14010115,82326075,1,0,0,1536,22,3498648770
8949,68331499,13811186,82142685,1,0,0,1024,22,2083890650
8950,68334150,20757745,89091895,0,0,1,10752,9,4389781534
8951,68337559,20755002,89092561,7,0,1,11264,5,9466262739
8952,68339790,13959414,82299204,4,0,0,35840,29,8807558261
8953,68341220,14121295,82462515,3,0,0,53760,25,8114523915
8954,68353679,20760413,89114092,1,0,1,3584,22,1178149964
8955,68353700,13858107,82211807,1,0,0,1024,22,5747895740
8956,68361620,13844048,82205668,7,0,0,4608,5,7912262773
8957,68362070,20753968,89116038,9,0,1,3072,9,9772027700
8958,68368440,20752744,89121184,0,0,1,8192,9,981251240
8959,68369940,13892784,82262724,4,0,0,5632,29,469215649
8960,68381409,20741721,89123130,7,0,1,3072,5,10493406970
8961,68389419,20734582,89124001,7,0,1,12288,5,8055018369
8962,68389979,13950837,82340816,0,0,0,2560,9,2717400474
8963,68396870,13908620,82305490,3,0,0,19456,25,8993927359
8964,68397730,20727103,89124833,9,0,1,1024,9,4506464641
8965,68399180,13942548,82341728,1,0,0,512,22,6584908187
8966,68401100,14325415,82726515,7,0,0,209920,5,10077362169
8967,68404390,14024506,82428896,1,0,0,2048,22,6562939261
8968,68416490,14004175,82420665,3,0,0,512,25,9194566267
8969,68418380,20710319,89128699,9,0,1,6144,9,2846855404
8970,68418540,13880999,82299539,1,0,0,1024,22,10138356699
8971,68419770,14177715,82597485,4,0,0,19456,29,3766110285
8972,68429630,14047254,82476884,1,0,0,1024,22,2667906181
8973,68436930,20697222,89134152,0,0,1,20480,9,5733680842
8974,68453860,20694859,89148719,9,0,1,2560,9,7963031392
8975,68479930,20671849,89151779,0,0,1,13312,9,2196906966
8976,68484000,14258074,82742074,7,0,0,2560,5,8032306938
8977,68484270,14167735,82652005,4,0,0,24576,29,8848820097
8978,68489130,20671091,89160221,9,0,1,512,9,6129767796
8979,68503209,20660238,89163447,7,0,1,5120,5,1278183214
8980,68510060,20653848,89163908,0,0,1,10240,9,7821953829
8981,68517249,20656094,89173343,7,0,1,8192,5,4347557751
8982,68520010,20654959,89174969,0,0,1,2560,9,9907414718
8983,68522370,13921931,82444301,7,0,0,6144,5,8808896485
8984,68531260,14220681,82751941,3,0,0,32256,25,7761004167
8985,68550870,20625405,89176275,0,0,1,2048,9,243591834
8986,68560550,14577860,83138410,3,0,0,74752,25,6034982862
8987,68565210,20613651,89178861,0,0,1,4096,9,1740376170
8988,68579430,13847094,82426524,1,0,0,1024,22,10133662501
8989,68581680,14055968,82637648,4,0,0,13824,29,8522772910
8990,68583179,20598268,89181447,7,0,1,4096,5,8781117579
8991,68589109,20595244,89184353,7,0,1,4608,5,8717684967
8992,68603790,20582025,89185815,4,0,1,14848,29,5898366935
8993,68606620,14174087,82780707,1,0,0,1536,22,9962882831
8994,68613880,20587578,89201458,4,0,1,6144,29,3166647156
8995,68614710,14126561,82741271,4,0,0,11264,29,9588567661
8996,68615380,14116462,82731842,4,0,0,17408,29,4328260276
8997,68616969,20588355,89205324,7,0,1,6144,5,382660586
8998,68627839,20578791,89206630,5,0,1,2048,25,7132780954
8999,68652069,20555432,89207501,5,0,1,12288,25,10170344865
9000,68655400,14230838,82886238,1,0,0,2048,22,8750564913
9001,68659950,20559172,89219122,4,0,1,4608,29,8608948296
9002,68660210,14112091,82772301,3,0,0,512,25,2991592535
9003,68668359,20551109,89219468,7,0,1,512,5,909607251
9004,68680290,20539524,89219814,0,0,1,512,9,4425668911
9005,68685910,14051415,82737325,3,0,0,17920,25,9634271627
9006,68687340,20534100,89221440,4,0,1,2560,29,7869796183
9007,68706040,14079275,82785315,1,0,0,1536,22,7989772299
9008,68707780,20517526,89225306,0,0,1,6144,9,9534934889
9009,68709900,14027916,82737816,1,0,0,1536,22,9305852373
9010,68717960,20519658,89237618,0,0,1,1024,9,2107942117
9011,68720660,14145560,82866220,4,0,0,61440,29,1049174867
9012,68721340,14052544,82773884,1,0,0,5120,22,6656872687
9013,68722860,14049262,82772122,7,0,0,24576,5,3920722749
9014,68723720,20514244,89237964,0,0,1,512,9,9062837522
9015,68734459,20507691,89242150,5,0,1,6656,25,4951125148
9016,68746370,20509736,89256106,4,0,1,21504,29,7047185176
9017,68746740,14197451,82944191,4,0,0,71680,29,8218292939
9018,68750559,20510053,89260612,5,0,1,7168,25,5947837322
9019,68753470,20508448,89261918,4,0,1,2048,29,2113888988
9020,68753960,14113086,82867046,1,0,0,2560,22,277197024
9021,68754549,20508035,89262584,1,0,1,1024,22,3015782674
9022,68755379,20509471,89264850,1,0,1,3584,22,3099897886
9023,68770459,20497617,89268076,5,0,1,5120,25,1184125373
9024,68799610,20714139,89513749,3,0,1,226304,25,4658034733
9025,68803870,20712785,89516655,4,0,1,4608,29,2332990008
9026,68821390,20696891,89518281,4,0,1,2560,29,7792284868
9027,68825400,14260000,83085400,3,0,0,87040,25,7997526621
9028,68828609,20696833,89525442,5,0,1,14336,25,1918757477
9029,68835579,20690209,89525788,1,0,1,512,22,618606866
9030,68836170,20692542,89528712,0,0,1,3072,9,10344782559
9031,68841179,20710520,89551699,7,0,1,4096,5,9176327281
9032,68847929,20731902,89579831,7,0,1,12800,5,294963125
9033,68851960,20729177,89581137,4,0,1,2048,29,7064820501
9034,68863420,14391586,83255006,7,0,0,14848,5,3897034867
9035,68872940,14478376,83351316,7,0,0,73216,5,5689492194
9036,68877849,20705874,89583723,5,0,1,4096,25,7506392128
9037,68886189,20698840,89585029,7,0,1,2048,5,4415935206
9038,68886309,20699693,89586002,5,0,1,12800,25,5301664222
9039,68890030,14359626,83249656,4,0,0,141312,29,7453751358
9040,68893470,20692878,89586348,4,0,1,512,29,3499829430
9041,68898050,20689604,89587654,0,0,1,2048,9,2651118667
9042,68902510,14251806,83154316,4,0,0,19968,29,512443224
9043,68907860,14548093,83455953,3,0,0,99840,25,9092338788
9044,68908639,20682561,89591200,5,0,1,5632,25,10104819044
9045,68910459,20717311,89627770,3,0,1,74240,25,6806367842
9046,68913540,20720996,89634536,3,0,1,6656,25,146723630
9047,68913880,14547930,83461810,7,0,0,18432,5,4926675544
9048,68918110,20722136,89640246,0,0,1,18944,9,6462823272
9049,68922169,20721943,89644112,1,0,1,6144,22,2223727409
9050,68922780,14490204,83412984,4,0,0,151040,29,1784251297
9051,68925139,20725374,89650513,5,0,1,4608,25,2199791463
9052,68925989,20732244,89658233,3,0,1,18944,25,6263322836
9053,68926090,20872792,89798882,3,0,1,174592,25,618594249
9054,68934619,20867776,89802395,5,0,1,512,25,3483638637
9055,68935530,20934196,89869726,3,0,1,98304,25,3645458301
9056,68936319,20936313,89872632,7,0,1,4608,5,1785746438
9057,68942509,20931749,89874258,5,0,1,2560,25,2544096101
9058,68944799,20938896,89883695,1,0,1,7168,22,8768943894
9059,68947010,14303449,83250459,7,0,0,2560,5,699908715
9060,68948790,20935571,89884361,0,0,1,1024,9,2692100586
9061,68953330,20935857,89889187,4,0,1,7680,29,8941639173
9062,68953950,14471537,83425487,4,0,0,40960,29,9385721450
9063,68962749,20935240,89897989,1,0,1,5120,22,730192690
9064,68963799,20942988,89906787,5,0,1,2560,25,1269569945
9065,68966189,20945104,89911293,1,0,1,7168,22,9266891926
9066,68981569,20931030,89912599,1,0,1,2048,22,9013300463
9067,68982530,14473641,83456171,1,0,0,512,22,9045929415
9068,68984420,20928525,89912945,0,0,1,512,9,1626772988
9069,68988060,14520694,83508754,4,0,0,42496,29,2571122121
9070,68988290,14551033,83539323,7,0,0,23040,5,2393051133
9071,68990749,20922542,89913291,7,0,1,512,5,5196204163
9072,68993959,20920318,89914277,5,0,1,1536,25,9886524852
9073,68999650,14605295,83604945,3,0,0,28160,25,6248860046
9074,69000080,20914863,89914943,4,0,1,1024,29,3844307908
9075,69011010,14699047,83710057,7,0,0,29696,5,3728754290
9076,69022099,20893190,89915289,7,0,1,512,5,8437159225
9077,69028889,20888346,89917235,5,0,1,3072,25,8822088150
9078,69032649,20885507,89918156,5,0,1,1024,25,5069111776
9079,69050329,20870413,89920742,1,0,1,4096,22,3860620237
9080,69072669,14511857,83584526,1,0,0,512,22,5283216361
9081,69074300,14791303,83865603,4,0,0,46592,29,5926186813
9082,69075740,20846308,89922048,4,0,1,2048,29,8725958617
9083,69078180,14614130,83692310,7,0,0,13824,5,9933961255
9084,69081230,20842764,89923994,4,0,1,3072,29,6050140970
9085,69098359,20826301,89924660,1,0,1,1024,22,230577030
9086,69100359,20825927,89926286,5,0,1,2560,25,581559289
9087,69105169,14686304,83791473,1,0,0,1024,22,7104257434
9088,69108049,20822743,89930792,7,0,1,7168,5,6650466532
9089,69108650,14904476,84013126,3,0,0,33280,25,5798597285
9090,69110000,14834087,83944087,3,0,0,25600,25,5582214311
9091,69116739,14802859,83919598,1,0,0,1024,22,104609829
9092,69133579,20797981,89931560,5,0,1,11776,25,1194577285
9093,69157550,20778196,89935746,0,0,1,6656,9,2756776377
9094,69158130,15037346,84195476,3,0,0,100864,25,10184230488
9095,69173589,20766983,89940572,7,0,1,7680,5,5080272215
9096,69178009,20765149,89943158,1,0,1,4096,22,6872967877
9097,69178820,20779149,89957969,0,0,1,7168,9,8381093169
9098,69180120,15060039,84240159,4,0,0,8192,29,4237899194
9099,69192879,20767996,89960875,1,0,1,4608,22,725959487
9100,69205819,20764223,89970042,1,0,1,34304,22,1144720119
9101,69208280,20763708,89971988,3,0,1,3072,25,2827065614
9102,69209480,20766694,89976174,0,0,1,6656,9,2922414446
9103,69215300,20761438,89976738,0,0,1,10752,9,5249506357
9104,69216070,14903931,84120001,3,0,0,13824,25,9774088510
9105,69224859,20757697,89982556,7,0,1,512,5,5605111170
9106,69226720,14920822,84147542,4,0,0,12800,29,8576815856
9107,69227760,20816089,90043849,3,0,1,41472,25,371501310
9108,69236079,20808116,90044195,7,0,1,512,5,334603124
9109,69254140,20794881,90049021,0,0,1,7680,9,6187836739
9110,69271510,20783003,90054513,0,0,1,17920,9,6939190325
9111,69271700,15157964,84429664,4,0,0,6656,29,1746784428
9112,69272960,15027457,84300417,7,0,0,43520,5,7380603227
9113,69276460,15260201,84536661,4,0,0,46080,29,10307886166
9114,69286009,20769170,90055179,1,0,1,1024,22,1646425631
9115,69291850,20766235,90058085,4,0,1,4608,29,6746910255
9116,69299109,15021996,84321105,1,0,0,512,22,1677913253
9117,69303519,20766030,90069549,7,0,1,14336,5,103242603
9118,69315449,15010355,84325804,1,0,0,1024,22,6492319862
9119,69316140,20755995,90072135,0,0,1,4096,9,5442649436
9120,69325510,20753596,90079106,3,0,1,19968,25,5100254367
9121,69326419,20753993,90080412,1,0,1,2048,22,4285819418
9122,69348140,20736458,90084598,0,0,1,6656,9,9960572761
9123,69349630,14926744,84276374,3,0,0,27136,25,6899240936
9124,69351430,20734474,90085904,4,0,1,2048,29,4437769395
9125,69358200,15064484,84422684,3,0,0,37376,25,8331625681
9126,69380270,20708566,90088836,0,0,1,4608,9,7056199286
9127,69391410,14961790,84353200,7,0,0,45568,5,5310881805
9128,69421140,14953624,84374764,3,0,0,8192,25,10195408574
9129,69429869,20660273,90090142,7,0,1,2048,5,7504468266
9130,69437079,20675748,90112827,7,0,1,3584,5,4076577520
9131,69456560,20661298,90117858,4,0,1,1024,29,4527673982
9132,69464189,14870147,84334336,1,0,0,1024,22,5501501328
9133,69468779,20656034,90124813,7,0,1,512,5,3084639433
9134,69492360,20634719,90127079,0,0,1,3584,9,6449945656
9135,69504640,20623105,90127745,4,0,1,1024,29,10294488859
9136,69511620,14977963,84489583,4,0,0,68096,29,215673538
9137,69516640,15107120,84623760,7,0,0,24064,5,6798558231
9138,69519749,20608662,90128411,7,0,1,11264,5,2477282631
9139,69519890,20616152,90136042,0,0,1,3072,9,10182929264
9140,69522630,15093752,84616382,7,0,0,42496,5,6104759637
9141,69522649,20614379,90137028,2,0,1,1536,0,3165626388
9142,69530559,20614521,90145080,7,0,1,12800,5,2398865295
9143,69534579,20622116,90156695,7,0,1,5120,5,3399179543
9144,69536640,20652891,90189531,4,0,1,21504,29,2364497380
9145,69540869,20649328,90190197,7,0,1,1024,5,7097266239
9146,69545579,20644964,90190543,2,0,1,512,0,5139847794
9147,69546359,20647743,90194102,7,0,1,16896,5,6139637380
9148,69592520,15256009,84848529,3,0,0,6144,25,171674721
9149,69594160,15042170,84636330,7,0,0,40448,5,8021709239
9150,69594190,15109352,84703542,4,0,0,91648,29,9222339180
9151,69608380,15067152,84675532,7,0,0,39424,5,10288352275
9152,69608889,15050339,84659228,1,0,0,512,22,592119653
9153,69613589,20581819,90195408,2,0,1,2048,0,10073651675
9154,69622339,15029116,84651455,1,0,0,2048,22,871026835
9155,69626589,20569165,90195754,2,0,1,512,0,736965377
9156,69627999,20572901,90200900,2,0,1,8192,0,5404919475
9157,69628250,20574276,90202526,9,0,1,2560,9,1259164648
9158,69646750,20556442,90203192,9,0,1,1024,9,7630286449
9159,69671850,14973895,84645745,7,0,0,2560,5,7775195607
9160,69672229,20531629,90203858,7,0,1,1024,5,7971919941
9161,69690330,20514217,90204547,9,0,1,512,9,6428213023
9162,69698719,20508414,90207133,2,0,1,4096,0,6529691655
9163,69700719,15052936,84753655,1,0,0,1536,22,7637119661
9164,69703179,20512224,90215403,7,0,1,15872,5,8526708426
9165,69705690,20512619,90218309,9,0,1,4608,9,905254206
9166,69719849,20502326,90222175,2,0,1,6144,0,747045702
9167,69727909,20497492,90225401,7,0,1,5120,5,2788134747
9168,69749140,20477887,90227027,9,0,1,2560,9,9835416514
9169,69750720,15022533,84773253,4,0,0,18432,29,1111938635
9170,69761670,20470503,90232173,9,0,1,8192,9,2534530936
9171,69767050,20465469,90232519,9,0,1,512,9,5916428530
9172,69771159,20462666,90233825,1,0,1,2048,22,6940438179
9173,69771779,20474828,90246607,1,0,1,14336,22,2382032582
9174,69772439,20475154,90247593,7,0,1,1536,5,1611516536
9175,69774810,20474089,90248899,9,0,1,2048,9,10729344709
9176,69775159,20476966,90252125,7,0,1,5120,5,1078656433
9177,69780980,15276935,85057915,4,0,0,93696,29,3492132666
9178,69785159,20467632,90252791,2,0,1,1024,0,4959442753
9179,69790320,20509466,90299786,9,0,1,81408,9,1241261839
9180,69794099,15011954,84806053,1,0,0,4096,22,6624635188
9181,69799109,20518217,90317326,2,0,1,17408,0,9988704122
9182,69800210,15197772,84997982,3,0,0,8192,25,9149040911
9183,69810199,20509713,90319912,2,0,1,4096,0,9745289301
9184,69813780,14990979,84804759,3,0,0,14848,25,1448036986
9185,69814570,15156904,84971474,7,0,0,36352,5,3317060208
9186,69825830,14880861,84706691,3,0,0,1536,25,3915949258
9187,69837959,15220470,85058429,1,0,0,512,22,9508019648
9188,69837999,20484499,90322498,7,0,1,4096,5,6609782830
9189,69840560,15217690,85058250,1,0,0,1024,22,4950109264
9190,69841800,15071603,84913403,3,0,0,5632,25,9393409347
9191,69855209,20469875,90325084,1,0,1,4096,22,5749820126
9192,69864020,20499101,90363121,9,0,1,58880,9,6682300788
9193,69870529,20494218,90364747,7,0,1,2560,5,7880511561
9194,69874029,20491704,90365733,2,0,1,1536,0,9843505365
9195,69881390,15090263,84971653,7,0,0,512,5,515573131
9196,69885490,15100993,84986483,4,0,0,4096,29,5595203132
9197,69886350,20482289,90368639,9,0,1,4608,9,8950631982
9198,69888960,14903860,84792820,3,0,0,8192,25,1634316518
9199,69889040,15047292,84936332,4,0,0,3584,29,6035639184
9200,69892160,20602303,90494463,9,0,1,156672,9,1444988321
9201,69906609,20600854,90507463,1,0,1,7168,22,7326514517
9202,69928020,15291237,85219257,7,0,0,40960,5,2115488742
9203,69935760,20628813,90564573,9,0,1,65536,9,538457851
9204,69949150,20628089,90577239,9,0,1,34304,9,5389857527
9205,69958980,20678594,90637574,9,0,1,65024,9,4759234081
9206,69966249,20674231,90640480,1,0,1,4608,22,4493918371
9207,69968189,14959116,84927305,1,0,0,2560,22,10488579888
9208,69979230,15031959,85011189,7,0,0,3072,5,841179299
9209,69981740,15311788,85293528,7,0,0,75264,5,6532083608
9210,69990869,20650277,90641146,2,0,1,1024,0,4865113107
9211,70003249,20638256,90641505,1,0,1,9728,22,10680897628
9212,70006909,20639614,90646523,1,0,1,7680,22,9494460374
9213,70006980,15141051,85148031,3,0,0,41984,25,4993962754
9214,70009750,15339490,85349240,3,0,0,37376,25,4922105983
9215,70011749,20635338,90647087,2,0,1,10752,0,8637232906
9216,70012530,15191393,85203923,3,0,0,12800,25,9167135574
9217,70018850,20744783,90763633,9,0,1,157696,9,8973015963
9218,70020179,20758645,90778824,2,0,1,13312,0,5873281887
9219,70043550,15163204,85206754,7,0,0,9216,5,7333570737
9220,70052889,20749450,90802339,2,0,1,2048,0,5982450767
9221,70054099,15241728,85295827,1,0,0,512,22,3831052533
9222,70065450,15299101,85364551,7,0,0,50176,5,5333682559
9223,70072130,15317005,85389135,5,0,0,2048,25,1739948067
9224,70083779,20719546,90803325,1,0,1,1536,22,6498117322
9225,70105240,20701631,90806871,9,0,1,5632,9,7665915150
9226,70106780,14951915,85058695,5,0,0,512,25,5190626508
9227,70106790,15163760,85270550,7,0,0,67584,5,3803507614
9228,70128450,15096446,85224896,7,0,0,18432,5,225967084
9229,70132100,14869093,85001193,1,0,0,512,22,6258044581
9230,70134339,20677129,90811468,1,0,1,6144,22,4953540342
9231,70141089,20670725,90811814,1,0,1,512,22,4959528105
9232,70148350,20675070,90823420,9,0,1,15360,9,623176332
9233,70160189,20667123,90827312,1,0,1,16384,22,9130615218
9234,70168960,20689561,90858521,9,0,1,32256,9,162007067
9235,70176770,20683377,90860147,9,0,1,2560,9,9788778058
9236,70179259,20681554,90860813,2,0,1,1024,0,671574873
9237,70179980,15068575,85248555,3,0,0,41984,25,10417774116
9238,70184079,20677195,90861274,1,0,1,10240,22,8131401694
9239,70189340,20681665,90871005,0,0,1,2048,9,799323006
9240,70195969,20675382,90871351,1,0,1,512,22,3696007891
9241,70197890,20708709,90906599,9,0,1,73728,9,2762550078
9242,70199820,20737594,90937414,9,0,1,61952,9,8171813705
9243,70202850,20857453,91060303,9,0,1,182784,9,2291045478
9244,70205950,15237796,85443746,3,0,0,104448,25,4009807004
9245,70208410,15086591,85295001,3,0,0,4608,25,2758870192
9246,70233570,20941789,91175359,9,0,1,177664,9,2885204394
9247,70235350,20943555,91178905,3,0,1,5632,25,1184805699
9248,70251450,15060387,85311837,5,0,0,1536,25,7121445434
9249,70261029,20919822,91180851,1,0,1,3072,22,262238643
9250,70272150,15229770,85501920,7,0,0,41472,5,7092818643
9251,70277099,20904418,91181517,1,0,1,1024,22,348795248
9252,70277700,20910896,91188596,9,0,1,23552,9,3057466675
9253,70290249,15005399,85295648,1,0,0,2048,22,8129090633
9254,70290660,20901700,91192360,9,0,1,17920,9,859961784
9255,70299780,20921584,91221364,9,0,1,15360,9,9686745449
9256,70312640,15340439,85653079,7,0,0,125440,5,3064310942
9257,70328820,15211039,85539859,7,0,0,11264,5,9493857195
9258,70351199,20874991,91226190,1,0,1,7680,22,4950829573
9259,70364270,15176921,85541191,5,0,0,512,25,6543460540
9260,70364439,20874630,91239069,5,0,1,53248,25,2956328404
9261,70373589,20879544,91253133,1,0,1,512,22,4145326920
9262,70387559,20865920,91253479,1,0,1,512,22,3608310979
9263,70390140,20958844,91348984,9,0,1,150016,9,691397978
9264,70396229,20953421,91349650,1,0,1,1024,22,7595252973
9265,70397109,20954807,91351916,1,0,1,3584,22,3418260495
9266,70406239,20946023,91352262,1,0,1,512,22,10045832251
9267,70451469,14942375,85393844,1,0,0,512,22,6215636949
9268,70464060,15089464,85553524,3,0,0,24576,25,5459940610
9269,70469369,20886119,91355488,1,0,1,5120,22,3983784420
9270,70470810,15018451,85489261,3,0,0,54784,25,7298589167
9271,70478510,15095828,85574338,1,0,0,1024,22,8418947861
9272,70482779,20873695,91356474,1,0,1,1536,22,5287438469
9273,70497720,20891631,91389351,9,0,1,80896,9,8406115468
9274,70513969,20879568,91393537,1,0,1,6656,22,41877499
9275,70516160,15017636,85533796,7,0,0,19456,5,4367229561
9276,70524779,20873188,91397967,1,0,1,16896,22,10295592710
9277,70528520,20894941,91423461,9,0,1,77312,9,6117374746
9278,70533239,14862040,85395279,1,0,0,2048,22,3265857334
9279,70543849,20879958,91423807,1,0,1,512,22,1341469312
9280,70579209,20847184,91426393,1,0,1,4096,22,5265969254
9281,70582469,20855755,91438224,1,0,1,6144,22,5815515381
9282,70589670,20851460,91441130,3,0,1,4608,25,6378643882
9283,70603510,20890372,91493882,3,0,1,45568,25,1045444726
9284,70604530,15389883,85994413,7,0,0,79360,5,10066390395
9285,70606419,20887809,91494228,1,0,1,512,22,7718290443
9286,70620780,20873807,91494587,9,0,1,9728,9,7195862800
9287,70623620,20871838,91495458,3,0,1,12288,25,7702064032
9288,70633910,20865094,91499004,3,0,1,5632,25,1528413337
9289,70638460,15107664,85746124,7,0,0,42496,5,933357938
9290,70648250,20851318,91499568,3,0,1,10752,25,3711956416
9291,70649540,20851014,91500554,9,0,1,1536,9,590040053
9292,70656200,20848361,91504561,3,0,1,15872,25,389370156
9293,70662680,15092048,85754728,7,0,0,16384,5,95894912
9294,70672339,14867855,85540194,1,0,0,1024,22,5998404527
9295,70676450,20833923,91510373,3,0,1,19456,25,1580646154
9296,70677129,20845051,91522180,1,0,1,3072,22,6395177021
9297,70698469,20824057,91522526,1,0,1,512,22,6199332314
9298,70706269,14949855,85656124,1,0,0,512,22,3958311214
9299,70708950,15192674,85901624,7,0,0,37376,5,1313547486
9300,70710600,15259564,85970164,3,0,0,86016,25,684584964
9301,70739040,14875796,85614836,3,0,0,20992,25,2224782147
9302,70750150,14755069,85505219,3,0,0,10752,25,476502611
9303,70771060,15092370,85863430,3,0,0,130048,25,2001266185
9304,70774790,14974188,85748978,7,0,0,9216,5,6323125068
9305,70782959,14966198,85749157,1,0,0,512,22,3515146817
9306,70793359,20732713,91526072,1,0,1,5632,22,1202024148
9307,70795140,20743404,91538544,9,0,1,10752,9,1536780344
9308,70797620,20784949,91582569,3,0,1,78848,25,7078193364
9309,70810429,20779591,91590020,1,0,1,6656,22,8792643537
9310,70828969,20763957,91592926,1,0,1,4608,22,2519670080
9311,70836690,14853655,85690345,7,0,0,13312,5,3328973012
9312,70853189,20740403,91593592,1,0,1,1024,22,6520009778
9313,70856900,20737998,91594898,3,0,1,2048,25,907319474
9314,70863540,20750165,91613705,9,0,1,70656,9,3807308266
9315,70878900,15011313,85890213,7,0,0,6656,5,3244686665
9316,70880159,20753584,91633743,1,0,1,9728,22,2787676754
9317,70895910,20772818,91668728,9,0,1,79360,9,5796261589
9318,70909780,20797070,91706850,3,0,1,36352,25,4634599748
9319,70916609,20795080,91711689,1,0,1,18944,22,8150900195
9320,70916760,15267754,86184514,3,0,0,74240,25,6193357619
9321,70921000,20801686,91722686,3,0,1,25600,25,4254928494
9322,70934289,20790663,91724952,1,0,1,3584,22,2552269040
9323,70947860,20784734,91732594,9,0,1,11264,9,508018371
9324,70963960,20769095,91733055,3,0,1,10240,25,5396494054
9325,70975940,20763796,91739736,3,0,1,2560,25,7834546175
9326,70980509,14720387,85700896,1,0,0,1024,22,7106012034
9327,70982859,20757133,91739992,1,0,1,9216,22,1442623097
9328,70984300,20796553,91780853,3,0,1,44544,25,4562437461
9329,70986160,20852435,91838595,3,0,1,56832,25,24685565
9330,70999540,14869795,85869335,1,0,0,512,22,3649481573
9331,71027770,15162327,86190097,1,0,0,2048,22,9455928597
9332,71053510,14993312,86046822,3,0,0,59904,25,381719778
9333,71063870,14750291,85814161,7,0,0,22528,5,8299387638
9334,71087079,14566512,85653591,1,0,0,1024,22,4251526088
9335,71100990,20749717,91850707,9,0,1,47104,9,458724230
9336,71114680,20768637,91883317,9,0,1,83456,9,6197862419
9337,71131429,20759027,91890456,1,0,1,7168,22,570873582
9338,71137630,20793496,91931126,3,0,1,60416,25,7643570090
9339,71143299,14904349,86047648,1,0,0,2048,22,9216767665
9340,71154329,14709280,85863609,1,0,0,512,22,442960528
9341,71154670,20781743,91936413,9,0,1,16896,9,8355275957
9342,71163220,14741079,85904299,7,0,0,8704,5,5625012144
9343,71174590,14734787,85909377,3,0,0,512,25,3663603697
9344,71178150,20780046,91958196,9,0,1,52224,9,7992644468
9345,71182490,20834990,92017480,9,0,1,76288,9,9564700450
9346,71200930,20822186,92023116,9,0,1,4096,9,6415992075
9347,71203350,14795298,85998648,7,0,0,13824,5,10275093360
9348,71210650,20814732,92025382,3,0,1,3584,25,1580407459
9349,71219630,14919366,86138996,7,0,0,48640,5,5389279916
9350,71232670,14522435,85755105,3,0,0,512,25,6011840460
9351,71232810,14814191,86047001,3,0,0,512,25,7091243166
9352,71251780,15092157,86343937,7,0,0,94720,5,4152251528
9353,71265460,20761014,92026474,9,0,1,12288,9,529586144
9354,71292780,20740431,92033211,9,0,1,31232,9,3239751068
9355,71302210,20737736,92039946,3,0,1,4096,25,7273473906
9356,71303850,14835637,86139487,3,0,0,1536,25,5977601764
9357,71311429,14873264,86184693,1,0,0,512,22,8364396986
9358,71340340,14783790,86124130,7,0,0,37376,5,6894462578
9359,71362010,14936250,86298260,7,0,0,84480,5,8770099071
9360,71363880,14745981,86109861,7,0,0,16384,5,8707925069
9361,71364879,20676693,92041572,7,0,1,2560,5,5853145809
9362,71375770,14629417,86005187,3,0,0,512,25,2852227942
9363,71382300,14679342,86061642,7,0,0,11776,5,4768157493
9364,71385560,14671929,86057489,7,0,0,9728,5,7858269033
9365,71386879,20656178,92043057,7,0,1,15360,5,7546142777
9366,71387410,20676193,92063603,3,0,1,2048,25,6556340610
9367,71392219,14689373,86081592,1,0,0,512,22,5212318513
9368,71400409,20664820,92065229,7,0,1,2560,5,2695928873
9369,71420339,14769080,86189419,1,0,0,1024,22,4056627361
9370,71420740,20665683,92086423,9,0,1,40448,9,2634263067
9371,71421109,20666940,92088049,7,0,1,2560,5,5755016856
9372,71423140,20667175,92090315,9,0,1,3584,9,7119404975
9373,71432660,20663199,92095859,3,0,1,26112,25,6572965130
9374,71433410,15054306,86487716,7,0,0,39936,5,10377787409
9375,71452890,20846178,92299068,3,0,1,378368,25,3153601718
9376,71456180,20862685,92318865,3,0,1,25600,25,1408751992
9377,71457670,14731414,86189084,7,0,0,14336,5,4053657558
9378,71470840,14801565,86272405,7,0,0,48640,5,4806600713
9379,71475729,20848381,92324110,3,0,1,2560,25,10357175647
9380,71524190,14851468,86375658,7,0,0,16896,5,5779126541
9381,71530140,20875517,92405657,3,0,1,123904,25,10319313232
9382,71534450,14555145,86089595,3,0,0,3072,25,9578050656
9383,71534690,14547295,86081985,3,0,0,512,25,8607083095
9384,71548730,14821757,86370487,7,0,0,51200,5,3243908239
9385,71554139,20853784,92407923,7,0,1,3584,5,5564451028
9386,71571749,20836520,92408269,7,0,1,512,5,3026500452
9387,71578650,20832385,92411035,3,0,1,29696,25,6172107294
9388,71580889,20844216,92425105,7,0,1,3072,5,1398824242
9389,71589839,20839772,92429611,7,0,1,7168,5,2807594670
9390,71590860,20839827,92430687,3,0,1,13312,25,10631777949
9391,71604779,20827214,92431993,1,0,1,2048,22,9236449605
9392,71605219,14883479,86488698,1,0,0,512,22,10719267860
9393,71614890,20837050,92451940,3,0,1,41472,25,8729182004
9394,71635859,14426118,86061977,1,0,0,1024,22,5249765473
9395,71659269,14500450,86159719,1,0,0,2560,22,4404885299
9396,71682210,20954633,92636843,3,0,1,316928,25,10072487948
9397,71725949,20915877,92641826,7,0,1,512,5,6962630653
9398,71747729,20898603,92646332,7,0,1,7168,5,10139343768
9399,71751520,20896118,92647638,6,0,1,2048,11,1831795516
9400,71752010,14855946,86607956,3,0,0,512,25,2495938739
9401,71752640,20962624,92715264,3,0,1,130560,25,1978256240
9402,71760610,14319446,86080056,3,0,0,512,25,6311001892
9403,71765909,20951301,92717210,1,0,1,3072,22,2569294945
9404,71812380,14486471,86298851,3,0,0,1536,25,6303500787
9405,71814780,14847873,86662653,7,0,0,22528,5,9281434816
9406,71841379,20880017,92721396,7,0,1,6656,5,15139551
9407,71863079,20859623,92722702,1,0,1,2048,22,4331772639
9408,71868859,20854189,92723048,1,0,1,512,22,774569339
9409,71924830,14661109,86585939,3,0,0,512,25,4030394244
9410,71931500,14813872,86745372,7,0,0,52736,5,8148451659
9411,71942980,14712538,86655518,7,0,0,79872,5,8170438074
9412,71963590,14418320,86381910,7,0,0,8192,5,5749947290
9413,71963859,20761135,92724994,7,0,1,3072,5,10497233046
9414,71973580,14578156,86551736,7,0,0,18944,5,587072331
9415,71975340,14726603,86701943,7,0,0,114688,5,717941993
9416,71987399,14554347,86541746,6,0,0,512,11,3478352908
9417,71993430,14382407,86375837,3,0,0,512,25,4886342176
9418,72003250,14743127,86746377,3,0,0,2048,25,6395898398
9419,72007429,20720471,92727900,1,0,1,4608,22,7607882942
9420,72007909,20722142,92730051,7,0,1,16384,5,4843260764
9421,72017049,20715908,92732957,1,0,1,4608,22,5308228811
9422,72034569,20699374,92733943,7,0,1,1536,5,10073987255
9423,72051740,14407805,86459545,3,0,0,3072,25,283884563
9424,72061449,14248632,86310081,1,0,0,1024,22,1785175802
9425,72068439,20669690,92738129,7,0,1,6656,5,7580786422
9426,72071909,20666988,92738897,1,0,1,11776,22,7396473725
9427,72076689,20662722,92739411,1,0,1,512,22,5409950602
9428,72082569,20659748,92742317,1,0,1,4608,22,7779664354
9429,72109749,20632914,92742663,2,0,1,512,0,1833538674
9430,72112629,20631007,92743636,2,0,1,12800,0,4792984379
9431,72133569,20622541,92756110,1,0,1,7680,22,9087090142
9432,72133949,14410890,86544839,1,0,0,1536,22,5778639475
9433,72138499,14271144,86409643,1,0,0,1024,22,6605018549
9434,72138929,20623928,92762857,1,0,1,4608,22,3524543016
9435,72143929,20657739,92801668,2,0,1,97280,0,3055371545
9436,72145609,20708247,92853856,2,0,1,84992,0,7225573026
9437,72160530,14379836,86540366,3,0,0,1024,25,10714731283
9438,72162370,14684171,86846541,7,0,0,2048,5,7811747367
9439,72172219,20681996,92854215,7,0,1,9728,5,4862257543
9440,72173190,14750011,86923201,7,0,0,17920,5,4875466662
9441,72173750,14315127,86488877,3,0,0,512,25,10243671300
9442,72174370,14411390,86585760,3,0,0,1024,25,1072429391
9443,72176770,14408655,86585425,7,0,0,71680,5,1905714769
9444,72178770,14545082,86723852,7,0,0,15872,5,7563281330
9445,72184739,20673982,92858721,7,0,1,7168,5,9865001670
9446,72248259,20638104,92886363,2,0,1,34304,0,9408272
9447,72253860,14410228,86664088,7,0,0,4608,5,3606969245
9448,72253870,14522601,86776471,7,0,0,16384,5,9616684469
9449,72281410,14442956,86724366,3,0,0,512,25,10370445399
9450,72285459,20621291,92906750,2,0,1,46080,0,5238054107
9451,72313989,14341708,86655697,1,0,0,512,22,7106508472
9452,72321100,14756751,87077851,7,0,0,64000,5,8942686756
9453,72326510,20582746,92909256,0,0,1,1536,9,9114095940
9454,72338940,14474839,86813779,7,0,0,12800,5,6137883042
9455,72338999,20597900,92936899,2,0,1,63488,0,8317688253
9456,72344829,14143690,86488519,1,0,0,2560,22,6105113493
9457,72352660,14408973,86761633,3,0,0,512,25,5665488366
9458,72354469,20600646,92955115,2,0,1,21504,0,9622197708
9459,72366510,20589911,92956421,0,0,1,2048,9,6744768830
9460,72378520,14367031,86745551,3,0,0,512,25,4324501672
9461,72380480,20579807,92960287,0,0,1,6144,9,7600681916
9462,72393680,14325290,86718970,7,0,0,55808,5,583675402
9463,72394410,20571778,92966188,0,0,1,19968,9,5803827533
9464,72416479,14172180,86588659,1,0,0,512,22,5959572892
9465,72418910,14181225,86600135,7,0,0,1536,5,6884515180
9466,72420719,20630310,93051029,2,0,1,159232,0,337506189
9467,72442990,20609345,93052335,0,0,1,2048,9,408727305
9468,72456509,20599052,93055561,2,0,1,5120,0,6258564957
9469,72485519,14260211,86745730,1,0,0,512,22,240611520
9470,72507870,14345624,86853494,3,0,0,512,25,5423021638
9471,72513719,14210468,86724187,1,0,0,1024,22,10278176344
9472,72553310,20503237,93056547,0,0,1,1536,9,7706461654
9473,72556169,20551024,93107193,2,0,1,100864,0,535276814
9474,72557679,14378216,86935895,1,0,0,512,22,700981326
9475,72572450,14735768,87308218,7,0,0,175104,5,10175158747
9476,72573650,14381735,86955385,7,0,0,61440,5,6861214585
9477,72575230,15071739,87646969,3,0,0,512,25,6699733644
9478,72586950,20521869,93108819,0,0,1,2560,9,7358758819
9479,72589560,20519925,93109485,0,0,1,1024,9,7006452171
9480,72590550,14342429,86932979,3,0,0,1024,25,8598743638
9481,72605660,20504184,93109844,0,0,1,9728,9,10551805343
9482,72607040,14348524,86955564,3,0,0,512,25,9570730401
9483,72610350,14150581,86760931,7,0,0,34304,5,5388895831
9484,72631679,13972369,86604048,1,0,0,512,22,6647486143
9485,72631880,14118576,86750456,7,0,0,13312,5,6580770438
9486,72632979,14182316,86815295,1,0,0,512,22,4145029899
9487,72659610,14249987,86909597,3,0,0,1024,25,10486988881
9488,72660999,14100423,86761422,1,0,0,1536,22,7470996491
9489,72666420,14548943,87215363,7,0,0,18944,5,4491072249
9490,72668809,14540424,87209233,1,0,0,100864,22,2095094784
9491,72684750,14244055,86928805,3,0,0,1024,25,3880058023
9492,72690720,20420769,93111489,0,0,1,1024,9,2306870338
9493,72704809,20415083,93119892,2,0,1,1536,0,4319071973
9494,72713959,20408839,93122798,2,0,1,4608,0,6470299974
9495,72718129,14500221,87218350,1,0,0,9728,22,8602658949
9496,72747839,20382899,93130738,1,0,1,2048,22,10478277563
9497,72761500,14225574,86987074,3,0,0,512,25,7551131901
9498,72786750,13977857,86764607,3,0,0,512,25,7832016382
9499,72792970,20339394,93132364,0,0,1,2560,9,8677602244
9500,72822279,20311071,93133350,2,0,1,1536,0,7577455684
9501,72829340,14675713,87505053,7,0,0,27136,5,7693509742
9502,72879439,14207037,87086476,1,0,0,4608,22,2753960928
9503,72906909,14685471,87592380,1,0,0,39424,22,10052143855
9504,72931380,20203916,93135296,0,0,1,3072,9,4463573119
9505,72948080,20187562,93135642,0,0,1,512,9,4362633602
9506,72979379,14770262,87749641,1,0,0,32768,22,3672755330
9507,73078749,14031588,87110337,1,0,0,33792,22,9805999865
9508,73136789,14195834,87332623,1,0,0,16896,22,5893645238
9509,73159979,14267966,87427945,1,0,0,122368,22,980420347
9510,73172629,13641797,86814426,1,0,0,2048,22,2956186592
9511,73239620,13969948,87209568,7,0,0,1024,5,2262723308
9512,73376689,14528038,87904727,1,0,0,45056,22,2907615931
9513,73397929,19744601,93142530,1,0,1,15360,22,1821772430
9514,73454700,13599129,87053829,7,0,0,4608,5,8670246445
9515,73473719,13427536,86901255,1,0,0,34304,22,4030922219
9516,73558039,13791219,87349258,1,0,0,23040,22,5174790205
9517,73569930,14193787,87763717,7,0,0,28672,5,1518140694
9518,73648509,19496607,93145116,2,0,1,4096,0,6973636185
9519,73654069,19494913,93148982,2,0,1,6144,0,167867272
9520,73724659,13831652,87556311,1,0,0,26112,22,2834962917
9521,73753649,13701509,87455158,1,0,0,58368,22,2051585445
9522,73770019,13368690,87138709,1,0,0,30720,22,8447272570
9523,73783989,19366619,93150608,2,0,1,2560,0,8722245662
9524,73821519,19331355,93152874,2,0,1,3584,0,3388940432
9525,73841629,13595722,87437351,1,0,0,30720,22,2568520106
9526,73857759,19297061,93154820,2,0,1,3072,0,1540502092
9527,73864810,19350540,93215350,9,0,1,110592,9,2095764947
9528,73884289,19336553,93220842,7,0,1,17920,5,10279594420
9529,73888579,14038837,87927416,1,0,0,73216,22,3272119310
9530,73909559,19324924,93234483,2,0,1,1536,0,5748275079
9531,73960829,19276560,93237389,2,0,1,4608,0,1067316714
9532,74012989,19228906,93241895,2,0,1,7168,0,818480355
9533,74022630,12986759,87009389,7,0,0,8704,5,437340236
9534,74044160,13416348,87460508,7,0,0,17408,5,9971555461
9535,74076300,13089612,87165912,7,0,0,8704,5,2736623726
9536,74095219,13564451,87659670,1,0,0,7680,22,9799504415
9537,74116290,13380472,87496762,7,0,0,20480,5,5332926422
9538,74131679,13440536,87572215,1,0,0,43008,22,6964924544
9539,74150600,13023742,87174342,7,0,0,12288,5,8931975211
9540,74187379,19054862,93242241,2,0,1,512,0,8173244757
9541,74215799,19027006,93242805,2,0,1,10752,0,3788225504
9542,74225249,19018542,93243791,2,0,1,1536,0,707068496
9543,74260879,13772528,88033407,1,0,0,34816,22,6113623229
9544,74262679,13245451,87508130,1,0,0,4096,22,9637311656
9545,74265360,13062092,87327452,7,0,0,52224,5,2866930559
9546,74278179,18967558,93245737,2,0,1,3072,0,7182222842
9547,74336299,18914827,93251126,2,0,1,17408,0,10219224628
9548,74371179,13135565,87506744,1,0,0,5120,22,7472720956
9549,74392059,18860373,93252432,7,0,1,2048,5,5298940138
9550,74394479,18861819,93256298,7,0,1,6144,5,10653615740
9551,74423939,18833442,93257381,7,0,1,512,5,1163998040
9552,74433369,13188022,87621391,1,0,0,512,22,4608467640
9553,74450419,12861098,87311517,1,0,0,10752,22,2677739625
9554,74467769,13022730,87490499,1,0,0,98304,22,8693713499
9555,74469499,18788446,93257945,2,0,1,10752,0,4097052351
9556,74492399,18766212,93258611,7,0,1,1024,5,4263082336
9557,74499969,13205899,87705868,1,0,0,9216,22,3637636579
9558,74509159,18750438,93259597,7,0,1,1536,5,969972820
9559,74536020,13353570,87889590,7,0,0,192512,5,5024582098
9560,74536929,18724768,93261697,7,0,1,11776,5,6426140300
9561,74542329,18723234,93265563,7,0,1,6144,5,4121573041
9562,74553940,13552493,88106433,7,0,0,41472,5,3458170578
9563,74585809,18682787,93268596,2,0,1,512,0,1955544568
9564,74602889,12997172,87600061,1,0,0,12288,22,3421582991
9565,74607059,13037617,87644676,1,0,0,54784,22,10425211900
9566,74618849,18651373,93270222,2,0,1,2560,0,4599020121
9567,74642199,18628369,93270568,7,0,1,512,5,6279030495
9568,74652539,18621575,93274114,7,0,1,5632,5,3821674545
9569,74660899,12887433,87548332,1,0,0,69120,22,9105242804
9570,74673470,13587255,88260725,7,0,0,60416,5,1490825704
9571,74684839,13556218,88241057,1,0,0,157184,22,8812563579
9572,74687579,18590081,93277660,1,0,1,5632,22,3914870077
9573,74735749,18547403,93283152,2,0,1,8704,0,2482456436
9574,74754109,18529709,93283818,2,0,1,1024,0,2578431590
9575,74760969,18546345,93307314,2,0,1,13824,0,7449416035
9576,74761619,18547321,93308940,2,0,1,2560,0,9166538643
9577,74768019,18552041,93320060,2,0,1,7168,0,871211221
9578,74798280,18523086,93321366,0,0,1,2048,9,6208836930
9579,74807009,18517903,93324912,7,0,1,5632,5,5248074134
9580,74808209,18517049,93325258,7,0,1,512,5,3868855304
9581,74812140,18516664,93328804,0,0,1,5632,9,4178672040
9582,74814630,13237083,88051713,7,0,0,28160,5,9193540760
9583,74818729,18511061,93329790,1,0,1,1536,22,2026674437
9584,74827759,18506857,93334616,7,0,1,7680,5,5479638345
9585,74829179,13165976,87995155,1,0,0,34816,22,2353132540
9586,74842139,18493041,93335180,7,0,1,10752,5,1255307217
9587,74853830,13037123,87890953,7,0,0,4096,5,8816929566
9588,74863060,18473106,93336166,0,0,1,1536,9,637439510
9589,74876059,13029026,87905085,1,0,0,1024,22,1866325221
9590,74878170,18458867,93337037,6,0,1,12288,11,6947881394
9591,74880629,18458994,93339623,7,0,1,4096,5,5995143660
9592,74891729,18449840,93341569,2,0,1,3072,0,3175330667
9593,74897170,18450570,93347740,0,0,1,17920,9,1284070944
9594,74926890,13069224,87996114,7,0,0,3072,5,1103094456
9595,74928139,18420587,93348726,7,0,1,1536,5,8512239013
9596,74941119,18410513,93351632,1,0,1,4608,22,10608466360
9597,74953969,18398636,93352605,1,0,1,12800,22,5455378811
9598,74965210,13419168,88384378,7,0,0,24576,5,5231846408
9599,74965809,12811981,87777790,1,0,0,20992,22,9562113860
9600,74984129,18372464,93356593,2,0,1,2048,0,9114253968
9601,74988840,13022545,88011385,7,0,0,16384,5,6963129660
9602,75014270,18342477,93356747,0,0,1,8704,9,10137884950
9603,75020189,18343816,93364005,7,0,1,5632,5,9159802003
9604,75024410,18339941,93364351,0,0,1,512,9,9682086062
9605,75036050,18328967,93365017,0,0,1,1024,9,1034893140
9606,75041399,18329110,93370509,2,0,1,8704,0,9306357167
9607,75080970,18290845,93371815,0,0,1,2048,9,9246821246
9608,75112459,18263146,93375605,7,0,1,15872,5,5119375593
9609,75122199,18255352,93377551,7,0,1,3072,5,955593230
9610,75139539,18242198,93381737,2,0,1,6656,0,1253122547
9611,75285069,18096822,93381891,7,0,1,8704,5,5778469170
9612,75292560,12883269,88175829,7,0,0,4096,5,7685860270
9613,75314399,18068577,93382976,7,0,1,512,5,8610423038
9614,75346280,12696822,88043102,7,0,0,31744,5,6055002529
9615,75369990,13157765,88527755,7,0,0,51712,5,9332585962
9616,75414079,17970843,93384922,7,0,1,3072,5,6636599161
9617,75414379,17971849,93386228,7,0,1,2048,5,4936497148
9618,75435750,12395161,87830911,7,0,0,20480,5,8962257825
9619,75448789,17941625,93390414,7,0,1,6656,5,2412574773
9620,75510280,12455806,87966086,7,0,0,20992,5,1001144960
9621,75519510,12625792,88145302,7,0,0,35840,5,9612918497
9622,75545729,17845351,93391080,7,0,1,1024,5,5895223766
9623,75649849,17741577,93391426,7,0,1,512,5,1307169986
9624,75654919,17737173,93392092,7,0,1,1024,5,3937489149
9625,75683969,17708469,93392438,7,0,1,512,5,2506310771
9626,75716659,17677405,93394064,7,0,1,2560,5,4034891849
9627,75719149,17688276,93407425,7,0,1,12288,5,796028201
9628,75723549,17686782,93410331,7,0,1,4608,5,8134712037
9629,75744339,17666338,93410677,7,0,1,512,5,655708364
9630,75776209,17637694,93413903,7,0,1,5120,5,2882968141
9631,75797079,17618207,93415286,7,0,1,14848,5,2317788093
9632,75811369,17605154,93416523,7,0,1,1536,5,1852187732
9633,75835349,17581840,93417189,7,0,1,1024,5,5412419306
9634,75842390,12487187,88329577,7,0,0,5632,5,6043803647
9635,75877529,17540006,93417535,7,0,1,512,5,9381992983
9636,75896229,17522894,93419123,7,0,1,15872,5,3854178837
9637,75901809,17534931,93436740,7,0,1,8192,5,9380554446
9638,75916809,17538854,93455663,7,0,1,31744,5,169727780
9639,75970569,17499853,93470422,7,0,1,24576,5,8907902231
9640,75976260,12291664,88267924,7,0,0,23552,5,6156322734
9641,75985480,12144250,88129730,7,0,0,51712,5,5525235833
9642,76036370,12454892,88491262,7,0,0,27648,5,8244764805
9643,76075280,12407535,88482815,7,0,0,65536,5,10333244907
9644,76085750,12228081,88313831,7,0,0,13824,5,7590692509
9645,76090059,17430300,93520359,7,0,1,74752,5,4433443896
9646,76100950,12275917,88376867,7,0,0,59392,5,9512577097
9647,76114079,17456560,93570639,7,0,1,52224,5,2647733385
9648,76141330,11943773,88085103,7,0,0,5632,5,3680018032
9649,76165610,12025140,88190750,7,0,0,2560,5,10705596028
9650,76210010,12460154,88670164,7,0,0,48128,5,3488482022
9651,76284779,17288216,93572995,7,0,1,27648,5,7829820870
9652,76329410,11800655,88130065,7,0,0,1024,5,9578658457
9653,76376470,11864766,88241236,7,0,0,512,5,5997266403
9654,76499390,11661991,88161381,7,0,0,2048,5,3805717428
9655,76506140,17067009,93573149,6,0,1,8704,11,5695390205
9656,76547639,17031412,93579051,2,0,1,20992,0,7364571651
9657,76558530,17022970,93581500,6,0,1,1536,11,3245999869
9658,76558810,11709316,88268126,7,0,0,512,5,2873626361
9659,76578530,17003636,93582166,0,0,1,11264,9,263362942
9660,76596869,17000165,93597034,2,0,1,7680,0,7360992014
9661,76601470,16996870,93598340,0,0,1,2048,9,4884290984
9662,76611909,16989337,93601246,2,0,1,4608,0,6935065712
9663,76613230,16993141,93606371,6,0,1,6144,11,5918712026
9664,76615830,17002434,93618264,0,0,1,3072,9,3238367778
9665,76625420,16998131,93623551,0,0,1,16896,9,5132870543
9666,76641260,16983917,93625177,6,0,1,2560,11,1050195078
9667,76659270,16966253,93625523,6,0,1,512,11,533791494
9668,76662830,16965599,93628429,6,0,1,4608,11,6228805295
9669,76678240,16951175,93629415,6,0,1,1536,11,10332263836
9670,76688830,11605855,88294685,7,0,0,1536,5,10696863472
9671,76689429,16943212,93632641,2,0,1,5120,0,8270163442
9672,76700830,16932477,93633307,6,0,1,1024,11,9449771851
9673,76760940,16872713,93633653,6,0,1,512,11,10719442618
9674,76762589,16872690,93635279,2,0,1,2560,0,9282840945
9675,76770090,16869375,93639465,0,0,1,6656,9,10074834926
9676,76824929,16822156,93647085,2,0,1,4608,0,1467835380
9677,76852630,16797081,93649711,6,0,1,2048,11,54091004
9678,76902970,16748367,93651337,6,0,1,2560,11,201104018
9679,76927000,16726923,93653923,6,0,1,4096,11,7700293712
9680,76932709,16721880,93654589,2,0,1,1024,0,1543898249
9681,76981149,16677946,93659095,2,0,1,7168,0,10147831601
9682,77023610,16638711,93662321,6,0,1,5120,11,7134394877
9683,77034019,16628968,93662987,2,0,1,1024,0,7138621636
9684,77046730,16621083,93667813,6,0,1,7680,11,1883605406
9685,77052690,11232951,88285641,7,0,0,512,5,7708708476
9686,77059029,16611690,93670719,2,0,1,4608,0,73536501
9687,77065280,16614042,93679322,9,0,1,23552,9,9969192695
9688,77068650,16611658,93680308,0,0,1,1536,9,2173015759
9689,77069390,16612544,93681934,0,0,1,2560,9,9220841979
9690,77075090,16608470,93683560,6,0,1,2560,11,3262720818
9691,77093930,16589784,93683714,0,0,1,8704,9,4311175527
9692,77098990,16584980,93683970,6,0,1,9216,11,10261970964
9693,77111710,11316087,88427797,7,0,0,512,5,6824646001
9694,77115450,16578141,93693591,0,0,1,10240,9,4653471116
9695,77161610,11374764,88536374,7,0,0,1024,5,9024459899
9696,77167009,16546784,93713793,7,0,1,41472,5,5732631742
9697,77169509,16547510,93717019,2,0,1,5120,0,7103998078
9698,77169859,16571383,93741242,7,0,1,32256,5,5433089689
9699,77212419,16623399,93835818,7,0,1,87040,5,1586289688
9700,77215429,16627675,93843104,2,0,1,6144,0,5145119604
9701,77225419,16618351,93843770,2,0,1,1024,0,8830367229
9702,77254860,16590536,93845396,0,0,1,2560,9,3263462954
9703,77257819,16608124,93865943,7,0,1,47104,5,6987968614
9704,77282509,16584420,93866929,2,0,1,1536,0,4487909257
9705,77294419,16574732,93869151,2,0,1,512,0,7656667180
9706,77297799,16572018,93869817,2,0,1,1024,0,26956067
9707,77328389,16544282,93872671,7,0,1,512,5,6545077596
9708,77346020,11324369,88670389,7,0,0,512,5,1396513185
9709,77355700,16519877,93875577,0,0,1,4608,9,5649606847
9710,77391000,16493574,93884574,0,0,1,11776,9,7895216478
9711,77392730,11390231,88782961,7,0,0,512,5,1388433738
9712,77413649,16478637,93892286,2,0,1,19456,0,3868049431
9713,77420550,11423779,88844329,7,0,0,3072,5,9847526838
9714,77430070,16466731,93896801,9,0,1,9216,9,966493491
9715,77453689,16444935,93898624,7,0,1,8704,5,5991505945
9716,77471760,16427210,93898970,0,0,1,512,9,9235578342
9717,77472739,16431587,93904326,2,0,1,3072,0,3302907708
9718,77476390,16437006,93913396,0,0,1,3584,9,9469016971
9719,77484809,16431493,93916302,7,0,1,4608,5,10695729074
9720,77497130,16420611,93917741,6,0,1,512,11,5794432059
9721,77500749,16421345,93922094,7,0,1,23552,5,10078454271
9722,77514459,16410123,93924582,2,0,1,2560,0,6465408909
9723,77518660,16406383,93925043,0,0,1,10240,9,6868805989
9724,77522290,11406599,88928889,7,0,0,512,5,8557419312
9725,77523709,16402000,93925709,2,0,1,1024,0,10149698347
9726,77530689,16397606,93928295,2,0,1,4096,0,5777714608
9727,77538350,16391891,93930241,6,0,1,3072,11,8614673884
9728,77543230,16404047,93947277,6,0,1,1536,11,1633899000
9729,77550960,11517217,89068177,7,0,0,512,5,297518668
9730,77553940,16397203,93951143,0,0,1,6144,9,7165538627
9731,77573080,11473089,89046169,7,0,0,512,5,9840766930
9732,77580949,16370860,93951809,2,0,1,1024,0,9597991121
9733,77596920,11276035,88872955,7,0,0,1024,5,8953538031
9734,77604179,16386255,93990434,7,0,1,102912,5,8593535007
9735,77605470,16397915,94003385,9,0,1,35328,9,10671262736
9736,77618750,16466135,94084885,9,0,1,97792,9,1585850807
9737,77648370,16452616,94100986,6,0,1,2560,11,1052149076
9738,77652080,16464241,94116321,0,0,1,29184,9,2111540202
9739,77658400,16469008,94127408,9,0,1,37376,9,8695783821
9740,77662090,16466803,94128893,9,0,1,15360,9,7436536471
9741,77670350,16484083,94154433,0,0,1,3072,9,6795763722
9742,77680100,11367598,89047698,7,0,0,3072,5,5453561736
9743,77683249,16474410,94157659,2,0,1,5120,0,3681069628
9744,77690519,16476516,94167035,2,0,1,14336,0,8998297072
9745,77706169,16461852,94168021,2,0,1,1536,0,4173336399
9746,77727960,16441496,94169456,9,0,1,23040,9,9904874567
9747,77732490,16455748,94188238,9,0,1,53760,9,5009168973
9748,77741150,16448561,94189711,6,0,1,512,11,1561928587
9749,77787700,16431105,94218805,9,0,1,52224,9,9987083431
9750,77796109,16423362,94219471,2,0,1,1024,0,8035246554
9751,77796359,16432497,94228856,2,0,1,3584,0,7998236226
9752,77800429,16429093,94229522,2,0,1,1024,0,6930806793
9753,77856500,16376888,94233388,9,0,1,6144,9,9212968382
9754,77859529,16383982,94243511,2,0,1,11776,0,8909668206
9755,77871119,16382429,94253548,2,0,1,24064,0,3040039061
9756,77871730,16422213,94293943,9,0,1,38912,9,8845181123
9757,77880230,11253598,89133828,7,0,0,512,5,4723241135
9758,77901230,16397621,94298851,9,0,1,2560,9,6410647971
9759,77905970,16413629,94319599,9,0,1,57856,9,8201207827
9760,77911339,16409886,94321225,2,0,1,2560,0,5292862048
9761,77933990,16399957,94333947,9,0,1,38912,9,732545456
9762,77938379,16405446,94343825,2,0,1,3584,0,5908865710
9763,77943289,16405362,94348651,2,0,1,7680,0,6213749902
9764,77950309,16399315,94349624,2,0,1,12800,0,6227598308
9765,77954970,16477996,94432966,9,0,1,112128,9,8276775584
9766,77960680,16487991,94448671,9,0,1,8704,9,8939328255
9767,77968250,11288590,89256840,7,0,0,1536,5,4708861590
9768,77969400,16485329,94454729,6,0,1,8192,11,5368072050
9769,77983610,16473705,94457315,6,0,1,4096,11,5783146527
9770,77989449,16470132,94459581,2,0,1,3584,0,8174338448
9771,77993509,16466431,94459940,2,0,1,9728,0,2729354339
9772,77996680,16474506,94471186,6,0,1,7168,11,2435727050
9773,78000250,16474104,94474354,6,0,1,4608,11,3320829672
9774,78011460,16471971,94483431,9,0,1,22528,9,284427612
9775,78013280,11215787,89229067,7,0,0,512,5,8457229398
9776,78013300,11329217,89342517,7,0,0,512,5,8042162395
9777,78016389,16470268,94486657,2,0,1,5120,0,4842510232
9778,78019790,16468173,94487963,6,0,1,2048,11,7591668453
9779,78022160,16467033,94489193,9,0,1,22016,9,5537745357
9780,78032229,16459730,94491959,2,0,1,18432,0,7321564874
9781,78055410,11156662,89212072,7,0,0,512,5,512804031
9782,78059419,16439316,94498735,2,0,1,4096,0,5286115359
9783,78067310,16433371,94500681,6,0,1,3072,11,4151696159
9784,78069370,16438059,94507429,6,0,1,2560,11,8066463363
9785,78071240,16440260,94511500,9,0,1,19456,9,5083216982
9786,78072720,16453424,94526144,9,0,1,13824,9,7531981284
9787,78075669,16451858,94527527,2,0,1,14848,0,7993860626
9788,78087330,16446109,94533439,9,0,1,1536,9,755780429
9789,78093440,16444270,94537710,6,0,1,5632,11,3103076657
9790,78100030,16514273,94614303,9,0,1,129024,9,4642929639
9791,78112089,16502560,94614649,2,0,1,512,0,3268753487
9792,78122670,16502426,94625096,9,0,1,36352,9,1935584966
9793,78152900,16490519,94643419,9,0,1,14848,9,1324847728
9794,78161790,16488576,94650366,9,0,1,4608,9,5478065757
9795,78179980,16471692,94651672,6,0,1,2048,11,6054113241
9796,78188560,11236465,89425025,7,0,0,512,5,9751471004
9797,78203400,16454173,94657573,9,0,1,19968,9,2497126996
9798,78223890,16484133,94708023,9,0,1,53760,9,336248806
9799,78225560,11110699,89336259,7,0,0,512,5,5607350500
9800,78230070,11176655,89406725,7,0,0,512,5,10242588799
9801,78251020,16462188,94713208,6,0,1,16384,11,233238330
9802,78258660,16463919,94722579,9,0,1,23040,9,3968347935
9803,78299020,11141399,89440419,7,0,0,512,5,8052012496
9804,78326910,11065618,89392528,7,0,0,1024,5,2546697413
9805,78335550,16403197,94738747,9,0,1,40960,9,9625666836
9806,78390970,16413371,94804341,9,0,1,150016,9,6840178723
9807,78396810,16412527,94809337,6,0,1,5120,11,504697677
9808,78425700,16385903,94811603,6,0,1,3584,11,2377058640
9809,78442680,16384831,94827511,9,0,1,54784,9,6699274257
9810,78448870,16402606,94851476,6,0,1,4096,11,6756800381
9811,78455400,16409406,94864806,9,0,1,50688,9,4967339312
9812,78455610,16417045,94872655,9,0,1,6656,9,1160051239
9813,78457450,16417151,94874601,6,0,1,3072,11,4695492082
9814,78460680,16416187,94876867,6,0,1,3584,11,9675984969
9815,78462020,16417433,94879453,6,0,1,4096,11,4354221514
9816,78483370,16401229,94884599,9,0,1,8192,9,7430577025
9817,78485910,16399035,94884945,6,0,1,512,11,5123581701
9818,78486550,11090006,89576556,7,0,0,512,5,7908476647
9819,78492220,16424608,94916828,9,0,1,87040,9,10513899765
9820,78494250,11003077,89497327,7,0,0,512,5,7701985799
9821,78518540,16413105,94931645,9,0,1,18944,9,5558697318
9822,78531350,16475050,95006400,9,0,1,130560,9,7708549421
9823,78539740,16514301,95054041,9,0,1,44032,9,5686279994
9824,78549370,16592457,95141827,9,0,1,185856,9,4469119663
9825,78555990,11118208,89674198,7,0,0,512,5,1139780745
9826,78583410,11099754,89683164,7,0,0,3584,5,2786391020
9827,78618270,16524543,95142813,6,0,1,1536,11,6775577835
9828,78636480,11018230,89654710,7,0,0,512,5,9393317086
9829,78658220,16507011,95165231,9,0,1,55296,9,10570567307
9830,78732660,16437874,95170534,6,0,1,6656,11,2706349389
9831,78780890,10932519,89713409,7,0,0,512,5,368771865
9832,78800090,11001050,89801140,7,0,0,512,5,2543389461
9833,78863240,10894580,89757820,7,0,0,2048,5,6654141351
9834,78952900,10712101,89665001,7,0,0,512,5,9786702379
9835,79024340,10768484,89792824,7,0,0,1024,5,3962188591
9836,79042970,10886674,89929644,7,0,0,512,5,6884765893
9837,79160970,10707988,89868958,7,0,0,512,5,8097323648
9838,79289720,10618858,89908578,7,0,0,3072,5,10242946774
9839,79300489,15915292,95215781,7,0,1,60928,5,1405843759
9840,79521220,10261206,89782426,7,0,0,1024,5,3732364714
9841,79600049,15618958,95219007,2,0,1,5120,0,2131124
9842,79604150,15617443,95221593,6,0,1,4096,11,5588411601
9843,79734009,15488570,95222579,2,0,1,1536,0,9669260832
9844,79744779,15478159,95222938,2,0,1,9728,0,2628605023
9845,79749819,15476345,95226164,2,0,1,5120,0,7208689714
9846,79750419,15479611,95230030,2,0,1,6144,0,9164950489
9847,79751689,15485753,95237442,2,0,1,11776,0,5206876400
9848,79764970,10080565,89845535,7,0,0,1536,5,6858336500
9849,79774750,10246114,90020864,7,0,0,1024,5,2550684070
9850,79777429,15461959,95239388,2,0,1,3072,0,10586078555
9851,79828490,10116747,89945237,7,0,0,1536,5,7960462466
9852,79894280,9933521,89827801,7,0,0,512,5,1970079072
9853,79900919,15339455,95240374,2,0,1,1536,0,3346635504
9854,79933139,15319560,95252699,2,0,1,15360,0,5701638408
9855,79951250,9939554,89890804,7,0,0,512,5,4238651519
9856,79979590,9910544,89890134,7,0,0,2048,5,1035456282
9857,79983029,15272256,95255285,2,0,1,4096,0,807843518
9858,79999010,9983936,89982946,7,0,0,1024,5,828869226
9859,80013290,9993380,90006670,7,0,0,2048,5,7206729258
9860,80018300,9966420,89984720,7,0,0,512,5,4370831440
9861,80019069,15237522,95256591,2,0,1,2048,0,4360045781
9862,80053939,15202998,95256937,2,0,1,512,0,229654560
9863,80067189,15190734,95257923,2,0,1,1536,0,10590200622
9864,80091469,15211809,95303278,2,0,1,91648,0,7878478827
9865,80102880,9927500,90030380,7,0,0,1024,5,6727510563
9866,80109790,9939751,90049541,7,0,0,512,5,4158149484
9867,80129790,15175434,95305224,6,0,1,3072,11,6433371505
9868,80142879,15163625,95306504,2,0,1,14336,0,6724870451
9869,80188649,15128518,95317167,7,0,1,15360,5,3981676709
9870,80225079,15106955,95332034,2,0,1,27136,0,9401616018
9871,80232860,9859160,90092020,7,0,0,1536,5,10163844176
9872,80241259,15110727,95351986,2,0,1,64512,0,2817351136
9873,80249349,15161895,95411244,7,0,1,84992,5,10437820148
9874,80252340,10070698,90323038,7,0,0,1024,5,10657774138
9875,80273990,9897427,90171417,7,0,0,512,5,2822437407
9876,80280969,15132861,95413830,7,0,1,4096,5,7223574893
9877,80337409,15087059,95424468,7,0,1,3584,5,4757965857
9878,80345850,9727385,90073235,7,0,0,1536,5,6062795612
9879,80351359,15085966,95437325,7,0,1,11264,5,461201245
9880,80354549,15096794,95451343,7,0,1,1024,5,9487866937
9881,80359219,15099869,95459088,2,0,1,22528,0,1900806906
9882,80361859,15097575,95459434,7,0,1,512,5,1562121057
9883,80369349,15109884,95479233,2,0,1,40448,0,6881357181
9884,80378869,15101132,95480001,2,0,1,11776,0,7484394657
9885,80394999,15088593,95483592,7,0,1,4608,5,5561912079
9886,80407759,15131018,95538777,2,0,1,104448,0,1313162867
9887,80477680,9585771,90063451,7,0,0,2048,5,543717585
9888,80483619,15107308,95590927,2,0,1,70656,0,1104126948
9889,80484620,9565638,90050258,7,0,0,512,5,2190885200
9890,80507699,15148562,95656261,2,0,1,70656,0,6055189667
9891,80546429,15110584,95657013,7,0,1,10752,5,10358504638
9892,80564239,15095578,95659817,7,0,1,16384,5,8239517089
9893,80568139,15094584,95662723,7,0,1,4608,5,4261763972
9894,80581689,15090496,95672185,7,0,1,1536,5,9619183157
9895,80611850,9528137,90139987,7,0,0,2560,5,9003797773
9896,80622270,9594903,90217173,7,0,0,2048,5,6049182038
9897,80622369,15051122,95673491,7,0,1,2048,5,8997616827
9898,80706529,14970188,95676717,7,0,1,5120,5,2176474122
9899,81023169,14713820,95736989,2,0,1,142336,0,53325857
9900,81237459,14528400,95765859,2,0,1,40448,0,4078445736
9901,81268799,9171783,90440582,6,0,0,1024,11,4575238018
9902,81316329,9007501,90323830,6,0,0,1024,11,8007010469
9903,81401009,8932800,90333809,6,0,0,1024,11,9672254922
9904,81465459,8839820,90305279,6,0,0,512,11,7185066751
9905,81526189,8739219,90265408,6,0,0,1536,11,4896199971
9906,81536850,14231275,95768125,6,0,1,3584,11,9092468099
9907,81572829,14218386,95791215,2,0,1,35840,0,4585112740
9908,81574289,14281833,95856122,2,0,1,110080,0,4635766826
9909,81576160,14283188,95859348,6,0,1,5120,11,3726696440
9910,81583120,14277534,95860654,6,0,1,2048,11,5639636192
9911,81591919,8763580,90355499,6,0,0,512,11,6712163541
9912,81597980,14263340,95861320,6,0,1,1024,11,7981427629
9913,81618719,14242947,95861666,2,0,1,512,0,2452409157
9914,81625879,8788315,90414194,6,0,0,1024,11,9902742240
9915,81643740,14220512,95864252,6,0,1,4096,11,2552509965
9916,81645059,8698573,90343632,6,0,0,1536,11,3715242775
9917,82985979,12879259,95865238,2,0,1,1536,0,5219350455
9918,82994959,12871585,95866544,2,0,1,2048,0,3785072630
9919,83002319,12869371,95871690,2,0,1,8192,0,8725551615
9920,83184279,12688077,95872356,2,0,1,11264,0,8087476701
9921,83194099,12687397,95881496,2,0,1,24064,0,10473198679
9922,83196449,12685393,95881842,2,0,1,512,0,773842980
9923,83218619,12663479,95882098,2,0,1,9216,0,8320376513
9924,83280159,12603565,95883724,2,0,1,2560,0,2484007335
9925,83315099,12570891,95885990,2,0,1,3584,0,1600414306
9926,83334399,12581779,95916178,2,0,1,45568,0,10364725682
9927,83339679,12578343,95918022,2,0,1,25088,0,9046922014
9928,83354979,12565949,95920928,2,0,1,4608,0,2467308119
9929,85095449,10832456,95927905,2,0,1,33280,0,10434492246
9930,85100319,10860380,95960699,2,0,1,33792,0,2761970702
9931,85157609,10847386,96004995,2,0,1,52224,0,8388344599
9932,85169329,10837049,96006378,2,0,1,14848,0,9674621746
9933,85231129,10792469,96023598,2,0,1,60928,0,933350940
9934,85314719,10730759,96045478,2,0,1,12800,0,6781743357
9935,85443739,10621910,96065649,2,0,1,13824,0,4616002573
9936,85469919,10600774,96070693,2,0,1,19968,0,10276011695
9937,85470529,10601701,96072230,2,0,1,23552,0,10551065982
9938,85659809,10428984,96088793,2,0,1,24576,0,9383804703
9939,85699139,10439183,96138322,2,0,1,80384,0,10504488121
9940,85718749,10444104,96162853,2,0,1,26624,0,5753378067
9941,85737209,10445385,96182594,2,0,1,28672,0,8610108719
9942,85742719,10463093,96205812,2,0,1,25600,0,7634978808
9943,85900549,10351641,96252190,2,0,1,53760,0,1559464002
9944,86014329,10279529,96293858,2,0,1,62976,0,7064280357
9945,86059479,10262851,96322330,2,0,1,77824,0,4327463790
9946,86066629,10273402,96340031,2,0,1,30720,0,3474513094
9947,86072039,10288232,96360271,2,0,1,59392,0,8630002388
9948,86094379,10280384,96374763,2,0,1,44544,0,10717430700
9949,86098829,10301295,96400124,2,0,1,74752,0,3661032705
9950,86207319,10286465,96493784,2,0,1,118784,0,1594730567
9951,86244219,10265183,96509402,2,0,1,41472,0,9223228155
9952,86247609,10263842,96511451,2,0,1,26112,0,9624082594
9953,86297599,10215030,96512629,2,0,1,13824,0,4711464881
9954,86353259,10199642,96552901,2,0,1,94208,0,10044044572
9955,86373619,10184979,96558598,2,0,1,18944,0,1617205612
9956,86955119,9669896,96625015,2,0,1,82944,0,6501038952
9957,87039919,9729178,96769097,2,0,1,290304,0,153227690
9958,87078799,9716829,96795628,2,0,1,61440,0,7264093957
9959,87122139,9678776,96800915,2,0,1,16896,0,3362801245
9960,87159559,9656746,96816305,2,0,1,5120,0,8666915544
9961,87227259,9604242,96831501,2,0,1,40448,0,7232817486
9962,87239839,9600944,96840783,2,0,1,33792,0,9109714596
9963,87343759,9497690,96841449,2,0,1,1024,0,2745444635
9964,87355949,9492080,96848029,2,0,1,28160,0,8623837576
9965,87374139,9500205,96874344,2,0,1,55808,0,9679350186
9966,87388739,9518264,96907003,2,0,1,100352,0,8175729490
9967,87423769,9529073,96952842,2,0,1,72704,0,10625558653
9968,87532509,9425159,96957668,2,0,1,7680,0,6388806373
9969,87542179,9418856,96961035,2,0,1,14848,0,7561641289
9970,87580039,9431047,97011086,2,0,1,125952,0,4706605781
9971,87683939,9334840,97018779,2,0,1,36864,0,2270533875
9972,87734839,9349576,97084415,2,0,1,83456,0,3341311448
9973,87774539,9328743,97103282,2,0,1,69120,0,5798413834
9974,87783159,9413539,97196698,2,0,1,198144,0,8372954973
9975,87797159,9401024,97198183,2,0,1,15360,0,5542024956
9976,87854199,9405746,97259945,2,0,1,119296,0,9285985467
9977,87936229,9328862,97265091,2,0,1,8192,0,4929412651
9978,87957219,9335284,97292503,2,0,1,65536,0,1297828456
9979,88030899,9269992,97300891,2,0,1,7168,0,4641773461
9980,89175249,8139954,97315203,2,0,1,41472,0,4732750775
9981,89425689,7895940,97321629,2,0,1,22528,0,5262912898
9982,89427609,7913420,97341029,2,0,1,34304,0,8371823324
9983,89442939,7918575,97361514,2,0,1,58880,0,4477637675
9984,89550889,7833947,97384836,2,0,1,38400,0,4787337991
9985,89553869,7836113,97389982,2,0,1,20480,0,10339602639
9986,89576429,7817020,97393449,2,0,1,14336,0,9122458452
9987,89670669,7766166,97436835,2,0,1,63488,0,4485547149
9988,89682369,7759971,97442340,2,0,1,17920,0,2395452015
9989,89735849,7742350,97478199,2,0,1,104960,0,6058311342
9990,89736249,7804529,97540778,2,0,1,66048,0,1335197582
9991,89760909,7792391,97553300,2,0,1,59392,0,2734125290
9992,89886129,7717690,97603819,2,0,1,112128,0,1710648083
9993,89901759,7712647,97614406,2,0,1,33792,0,9611286220
9994,89914629,7714679,97629308,2,0,1,39936,0,3283857205
9995,89918109,7733150,97651259,2,0,1,52224,0,2861297770
9996,89982839,7671006,97653845,2,0,1,4096,0,820360908
9997,90117319,7550013,97667332,2,0,1,24064,0,10418577954
9998,90149729,7530327,97680056,2,0,1,22528,0,6419476984
9999,90193379,7512711,97706090,2,0,1,72192,0,975874659
