RequestID,ArrivalTime,DelayTime,FinishTime,InitiatorID,TargetID,IOType,Size,VolumeID,Offset
0,0,186064,186064,0,0,0,148992,6,2826803937
1,1,37143,37144,8,0,1,65024,6,2238729855
2,2,38128,38130,2,0,1,1536,11,1681467090
3,3,38691,38694,1,0,1,10752,6,7892015220
4,4,39356,39360,9,0,1,11264,17,3878354618
5,5,42261,42266,7,0,1,4608,16,8392419202
6,6,48673,48679,6,0,1,30720,3,7721655584
7,7,221390,221397,5,0,0,6144,11,3245500321
8,8,50156,50164,4,0,1,15360,4,7641391286
9,9,199951,199960,3,0,0,33280,0,8908264559
10,6030,50650,56680,1,0,1,23040,6,9689303233
11,7080,49754,56834,9,0,1,8704,17,7073730664
12,7720,50740,58460,3,0,1,2560,0,10169095822
13,20160,39581,59741,4,0,1,14336,4,8982683567
14,23161,527569,550730,7,0,0,429056,16,5815751623
15,55620,6706,62326,9,0,1,4096,17,7519173586
16,57610,5062,62672,2,0,1,512,11,3751654565
17,59710,5712,65422,2,0,1,14336,11,266350989
18,74910,3422,78332,8,0,1,3584,6,2219265913
19,84130,7230,91360,7,0,1,7680,16,3604687953
20,108180,5802,113982,4,0,1,6144,4,1901005343
21,123760,62335,186095,1,0,1,60928,6,3596372219
22,144220,884152,1028372,3,0,0,256000,0,7343804079
23,149290,72122,221412,1,0,1,58880,6,409166952
24,158610,62817,221427,6,0,1,512,3,3174686668
25,169531,994651,1164182,7,0,0,221696,16,8050129098
26,170809,100308,271117,4,0,0,1536,4,7305656432
27,176790,49400,226190,9,0,1,19968,17,7275239900
28,243540,659666,903206,0,0,0,95744,6,627604428
29,255360,22950,278310,6,0,1,37888,3,8147380548
30,273220,630313,903533,9,0,0,1024,17,2100493641
31,275870,397774,673644,9,0,0,2048,17,3724677766
32,279610,12049,291659,9,0,1,19968,17,4905379558
33,286340,6702,293042,1,0,1,14848,6,9745089251
34,290950,4420,295370,8,0,1,11776,6,5221779018
35,306371,449795,756166,7,0,0,119296,16,10376720218
36,322210,1225371,1547581,0,0,0,350208,6,1034339400
37,350280,836849,1187129,5,0,0,75264,11,10665545384
38,352030,10241,362271,2,0,1,16384,11,3000614681
39,355470,10987,366457,3,0,1,6656,0,7201651691
40,359430,13338,372768,8,0,1,22016,6,9940058974
41,363300,26361,389661,4,0,1,38912,4,7331737619
42,395501,1518,397019,0,0,1,1536,6,7050826172
43,396059,272561,668620,4,0,0,1024,4,2944668608
44,405781,144964,550745,0,0,1,30720,6,2480521909
45,417590,133178,550768,4,0,1,13312,4,7658434733
46,422379,902796,1325175,4,0,0,3072,4,2812598838
47,429240,154734,583974,3,0,1,57344,0,6401888110
48,444300,144180,588480,9,0,1,7168,17,8252062528
49,463290,977517,1440807,8,0,0,232960,6,816007571
50,467150,127334,594484,3,0,1,20480,0,3881824523
51,468810,126340,595150,8,0,1,11264,6,4380622250
52,516900,89387,606287,8,0,1,45056,6,1737666186
53,526680,82513,609193,4,0,1,4608,4,9614064774
54,526720,86019,612739,4,0,1,5632,4,1438262578
55,533981,82944,616925,0,0,1,6656,6,1928763940
56,550250,68621,618871,8,0,1,3072,6,6892941459
57,553130,69287,622417,3,0,1,5632,0,10302415524
58,553360,1927903,2481263,3,0,0,210432,0,4721148198
59,579820,43903,623723,1,0,1,2048,6,1816044988
60,581639,739141,1320780,4,0,0,2048,4,2735924542
61,599200,31141,630341,9,0,1,31744,17,7031940951
62,606520,29210,635730,9,0,1,17408,17,9853650039
63,641020,3422,644442,1,0,1,3584,6,5627666499
64,657009,892015,1549024,4,0,0,4608,4,7783088293
65,662290,2946,665236,9,0,1,3072,17,3303718572
66,677590,692222,1369812,3,0,0,51712,0,569915974
67,699500,329402,1028902,9,0,0,1024,17,8632037512
68,703979,538989,1242968,4,0,0,3072,4,2638048319
69,716149,334998,1051147,4,0,0,2048,4,10653136196
70,719860,41944,761804,8,0,1,13824,6,10354209338
71,735790,451822,1187612,9,0,0,1536,17,10159489275
72,739350,23760,763110,6,0,1,2048,3,6051569401
73,742479,286096,1028575,4,0,0,512,4,2647445895
74,751280,2216517,2967797,0,0,0,140288,6,1442071528
75,752440,12908,765348,2,0,1,11264,11,1540519686
76,753529,450764,1204293,4,0,0,3072,4,1987144126
77,753590,2470239,3223829,8,0,0,301568,6,7274454442
78,754010,12324,766334,1,0,1,1536,6,6515941936
79,770510,549631,1320141,0,0,0,83456,6,6787103359
80,781410,826438,1607848,8,0,0,97792,6,3309634114
81,786250,1042,787292,1,0,1,1024,6,8853877936
82,823460,1451810,2275270,5,0,0,105472,11,8204307415
83,838041,3422,841463,0,0,1,3584,6,202603799
84,844750,13083,857833,2,0,1,22016,11,4479004169
85,851070,1039589,1890659,3,0,0,15872,0,5799061123
86,879981,26931,906912,0,0,1,9728,6,4744001517
87,920040,7230,927270,2,0,1,7680,11,4373627430
88,929050,1518,930568,3,0,1,1536,0,7221727575
89,946990,252386,1199376,9,0,0,2560,17,520474898
90,957060,84676,1041736,3,0,1,21504,0,2324499978
91,987640,54442,1042082,3,0,1,512,0,295426131
92,996190,63324,1059514,1,0,1,43008,6,3420474920
93,996810,2878253,3875063,0,0,0,420352,6,2769501374
94,1002900,62515,1065415,3,0,1,28160,0,3034763261
95,1009160,57241,1066401,3,0,1,1536,0,100416349
96,1035170,666872,1702042,0,0,0,98304,6,10485373421
97,1035471,2876448,3911919,7,0,0,64000,16,6928389078
98,1040921,29346,1070267,0,0,1,6144,6,8571392418
99,1047029,502838,1549867,4,0,0,2560,4,5641435191
100,1059889,797963,1857852,4,0,0,512,4,5782895752
101,1064331,2177649,3241980,7,0,0,59392,16,7032390255
102,1083630,1260704,2344334,5,0,0,218112,11,6057362738
103,1091240,820204,1911444,8,0,0,67072,6,3190067969
104,1116509,492446,1608955,4,0,0,3584,4,9190485378
105,1128181,62561,1190742,0,0,1,3072,6,10105726100
106,1130501,63467,1193968,0,0,1,5120,6,432474671
107,1134210,3090347,4224557,2,0,0,81920,11,2973450659
108,1162100,41187,1203287,3,0,1,25088,0,6247836779
109,1168031,42642,1210673,0,0,1,24576,6,3572571718
110,1170720,42539,1213259,2,0,1,4096,11,1759791431
111,1173600,40427,1214027,2,0,1,11776,11,10267251030
112,1187560,27453,1215013,5,0,1,1536,11,7966740227
113,1192971,2231351,3424322,7,0,0,148992,16,8929862324
114,1218761,4850,1223611,0,0,1,5120,6,3139025310
115,1273300,931390,2204690,3,0,0,82432,0,4778154021
116,1302590,3141150,4443740,2,0,0,171008,11,2436157770
117,1329530,1802352,3131882,8,0,0,74240,6,7847263973
118,1330210,1258296,2588506,8,0,0,2048,6,7106494286
119,1345550,95272,1440822,5,0,1,57856,11,345995004
120,1382900,3259439,4642339,8,0,0,270848,6,6677420976
121,1383680,166345,1550025,2,0,1,1024,11,4471633400
122,1388300,2116008,3504308,9,0,0,2048,17,7038710368
123,1395820,1318884,2714704,3,0,0,112640,0,6982598734
124,1395950,1088144,2484094,8,0,0,9216,6,8276551265
125,1400190,2491831,3892021,0,0,0,43008,6,5205069127
126,1408240,1076197,2484437,3,0,0,1024,0,9925538704
127,1416251,146783,1563034,0,0,1,22016,6,5204475015
128,1463750,1833469,3297219,9,0,0,3072,17,131109877
129,1466720,1068986,2535706,9,0,0,10240,17,6665093437
130,1482640,1268568,2751208,5,0,0,95744,11,5372935551
131,1488890,78010,1566900,2,0,1,6144,11,6806684810
132,1495851,72227,1568078,0,0,1,13824,6,947477502
133,1525691,3179624,4705315,7,0,0,108032,16,10223770030
134,1532510,132374,1664884,5,0,1,165376,11,1961685136
135,1536750,1027801,2564551,9,0,0,4608,17,1501846177
136,1542040,160017,1702057,5,0,1,92160,11,2508681308
137,1545351,1017781,2563132,7,0,0,30208,16,7203398885
138,1569089,775931,2345020,4,0,0,2048,4,1532074425
139,1570550,131522,1702072,3,0,1,12800,0,2809196840
140,1608110,93977,1702087,2,0,1,14848,11,6809561042
141,1650470,999064,2649534,9,0,0,2048,17,7748432263
142,1651500,50602,1702102,3,0,1,3584,0,9705931697
143,1697150,1093438,2790588,5,0,0,70656,11,172511827
144,1715580,44145,1759725,2,0,1,75776,11,9515314067
145,1739070,21935,1761005,1,0,1,14336,6,96153434
146,1747450,1724792,3472242,3,0,0,46080,0,4554989146
147,1747650,18642,1766292,8,0,1,16896,6,942292787
148,1752070,1601179,3353249,0,0,0,42496,6,8072197142
149,1771780,2281672,4053452,8,0,0,254464,6,9377591909
150,1773101,2470,1775571,0,0,1,2560,6,6567744796
151,1791590,3164816,4956406,3,0,0,110080,0,8674030635
152,1812560,2641143,4453703,3,0,0,32256,0,5540326878
153,1831920,5326,1837246,1,0,1,5632,6,3975412316
154,1839690,72799,1912489,5,0,1,118272,11,7944936435
155,1847400,2295666,4143066,2,0,0,157184,11,7523277313
156,1855429,2411380,4266809,4,0,0,1536,4,9989575915
157,1857140,911563,2768703,8,0,0,57344,6,9140776653
158,1861850,56028,1917878,1,0,1,25600,6,4332784246
159,1895290,2496331,4391621,0,0,0,249856,6,5860914204
160,1905631,19964,1925595,0,0,1,24064,6,1246616258
161,1908480,2636438,4544918,0,0,0,286208,6,6583292180
162,1923469,460709,2384178,4,0,0,1536,4,725372187
163,1941330,5454,1946784,1,0,1,13824,6,5646357951
164,1942261,14087,1956348,0,0,1,17408,6,1822778882
165,1994340,622948,2617288,9,0,0,512,17,6187832179
166,2024411,2470,2026881,0,0,1,2560,6,834621676
167,2027200,25704,2052904,3,0,1,46592,0,8265375143
168,2068470,3049643,5118113,2,0,0,83968,11,2068308325
169,2108680,13341,2122021,2,0,1,22528,11,9617817771
170,2115399,460531,2575930,4,0,0,512,4,4452887792
171,2126680,672347,2799027,8,0,0,27648,6,4802316276
172,2144990,12308,2157298,1,0,1,20480,6,9170647957
173,2158860,566,2159426,4,0,1,512,4,7840812548
174,2198310,11568,2209878,4,0,1,13312,4,7423812237
175,2227320,3128,2230448,4,0,1,9216,4,10431002127
176,2250360,93989,2344349,3,0,1,10240,0,2778454839
177,2280560,68656,2349216,4,0,1,11264,4,8293063302
178,2281100,75092,2356192,1,0,1,8192,6,9519550910
179,2299060,810163,3109223,5,0,0,124928,11,10163597881
180,2318270,41148,2359418,3,0,1,5120,0,4569383630
181,2332360,30924,2363284,4,0,1,6144,4,9632479124
182,2336230,55047,2391277,1,0,1,65024,6,3615847585
183,2338600,2583760,4922360,3,0,0,121344,0,1027414816
184,2349521,42627,2392148,0,0,1,12288,6,7606871777
185,2354090,942178,3296268,0,0,0,94720,6,6155422033
186,2383930,11124,2395054,3,0,1,4608,0,3022521618
187,2386780,1228280,3615060,8,0,0,29696,6,8413221217
188,2391130,4590,2395720,4,0,1,11264,4,10671240862
189,2421420,84142,2505562,4,0,1,34304,4,7094981990
190,2445580,103305,2548885,2,0,1,91648,11,906251531
191,2447450,267269,2714719,2,0,1,264192,11,9370900206
192,2477021,237721,2714742,0,0,1,5120,6,3647738975
193,2485011,1476613,3961624,7,0,0,12288,16,5272343063
194,2526100,188657,2714757,4,0,1,7168,4,8236475888
195,2539090,1729306,4268396,2,0,1,60928,11,3580043867
196,2548930,2669961,5218891,0,0,0,30208,6,7154104011
197,2565331,2983213,5548544,7,0,0,35328,16,7545318298
198,2578620,2928524,5507144,1,0,1,55808,6,8067074060
199,2590690,2914669,5505359,5,0,0,572416,11,1704175989
200,2593240,966652,3559892,2,0,0,150528,11,8780801500
201,2595510,2942084,5537594,4,0,1,20480,4,2509622957
202,2602260,3292710,5894970,1,0,1,28672,6,3305272841
203,2639520,3056606,5696126,5,0,0,166400,11,6141549382
204,2663330,1896438,4559768,2,0,0,42496,11,9994834959
205,2677670,1417465,4095135,2,0,0,136704,11,5011061709
206,2688580,3320985,6009565,4,0,1,16384,4,653927476
207,2701250,3308330,6009580,1,0,1,9216,6,1663405501
208,2708251,3301368,6009619,0,0,1,8704,6,9738772667
209,2728360,3592302,6320662,4,0,1,60416,4,4953613065
210,2789500,3104784,5894284,2,0,0,568832,11,6152648096
211,2790860,3217568,6008428,8,0,0,293888,6,399255508
212,2792070,3308471,6100541,2,0,0,66560,11,5462399274
213,2800489,1091859,3892348,4,0,0,1024,4,84107630
214,2816940,2818596,5635536,5,0,0,278016,11,9590809110
215,2849550,3480190,6329740,4,0,1,6144,4,6750360018
216,2861540,4868435,7729975,2,0,1,301056,11,4235952239
217,2867760,1048090,3915850,8,0,0,12800,6,4267053055
218,2877880,634474,3512354,9,0,0,4096,17,7476660482
219,2885661,4902716,7788377,0,0,1,19456,6,8217205284
220,2901100,977778,3878878,2,0,0,12288,11,9201799876
221,2903670,4888253,7791923,3,0,1,5632,0,3491101902
222,2917980,1752821,4670801,9,0,0,2560,17,10412907731
223,2944299,2013550,4957849,4,0,0,4608,4,4676308459
224,2949810,1596995,4546805,8,0,0,6144,6,981032504
225,2966380,5567348,8533728,2,0,1,195584,11,4570665475
226,2995650,934541,3930191,8,0,0,9216,6,1026718141
227,2998161,3045074,6043235,7,0,0,86528,16,7495904214
228,3011040,5522711,8533751,3,0,1,15872,0,4891456619
229,3034981,5498785,8533766,0,0,1,11264,6,6235293825
230,3070320,2047964,5118284,0,0,0,512,6,6868344468
231,3079590,5468729,8548319,3,0,1,9728,0,10299777124
232,3087800,1797573,4885373,2,0,0,58880,11,852405258
233,3097171,5682026,8779197,0,0,1,25600,6,10142774287
234,3100410,3220237,6320647,8,0,0,335360,6,1034988213
235,3116280,3015905,6132185,8,0,0,1024,6,6268337885
236,3119679,1746240,4865919,4,0,0,9216,4,2347272540
237,3120140,5804213,8924353,8,0,1,37888,6,8929671193
238,3146540,5908405,9054945,2,0,1,107008,11,1009762433
239,3173970,5967117,9141087,6,0,1,2048,3,7115050926
240,3177990,1491976,4669966,5,0,0,90624,11,10508138176
241,3184330,1934281,5118611,8,0,0,1024,6,7592428965
242,3228070,3228270,6456340,0,0,0,184320,6,7511685834
243,3253650,1609446,4863096,2,0,0,130048,11,4986635049
244,3275921,5869096,9145017,0,0,1,13824,6,65685352
245,3277761,3357687,6635448,7,0,0,210432,16,3510377507
246,3282530,3236295,6518825,0,0,0,124928,6,1080893523
247,3300460,5899031,9199491,4,0,1,9216,4,3139566738
248,3327060,1345316,4672376,8,0,0,5120,6,1463765583
249,3330970,3473120,6804090,3,0,0,206336,0,6928160311
250,3340470,3334039,6674509,3,0,0,71680,0,132792488
251,3361410,1865375,5226785,8,0,0,1024,6,4948924579
252,3361991,5837523,9199514,0,0,1,16896,6,8446957886
253,3365810,5833727,9199537,1,0,1,38912,6,3469635829
254,3401830,5797722,9199552,3,0,1,5632,0,781112076
255,3451830,5796214,9248044,2,0,1,180736,11,10302999789
256,3454880,5849993,9304873,4,0,1,9728,4,2634946924
257,3484760,5820136,9304896,1,0,1,2560,6,9882583617
258,3521990,5782921,9304911,6,0,1,4608,3,3848722265
259,3522030,5839600,9361630,1,0,1,27136,6,9503758634
260,3524311,5837334,9361645,0,0,1,39936,6,5338354399
261,3555700,3525725,7081425,5,0,0,26112,11,295922552
262,3560650,2084737,5645387,2,0,0,32256,11,8318809706
263,3562150,1975429,5537579,0,0,0,99840,6,3877580600
264,3566630,5795030,9361660,4,0,1,5632,4,2976069305
265,3605450,5779016,9384466,8,0,1,11264,6,2591456088
266,3611880,5772601,9384481,6,0,1,1024,3,4108283465
267,3618420,3343000,6961420,2,0,0,86528,11,2765363160
268,3634580,5817589,9452169,1,0,1,33280,6,9459235503
269,3683110,611173,4294283,8,0,0,7168,6,8684665532
270,3686100,5766084,9452184,6,0,1,1536,3,7300858856
271,3717760,5764889,9482649,1,0,1,4096,6,9577446242
272,3721070,5761594,9482664,4,0,1,1024,4,5364159863
273,3723090,5795258,9518348,2,0,1,94208,11,3784411178
274,3734099,2722436,6456535,4,0,0,512,4,7992738690
275,3759890,1280043,5039933,2,0,0,18944,11,3959790267
276,3768961,2362530,6131491,7,0,0,95744,16,5712360456
277,3770790,5747573,9518363,8,0,1,4096,6,319368533
278,3773820,5747717,9521537,3,0,1,1024,0,720637391
279,3793581,3733890,7527471,7,0,0,197120,16,3534455579
280,3796530,3480762,7277292,8,0,0,4608,6,3343967355
281,3812900,5708652,9521552,4,0,1,6144,4,4499481862
282,3814960,5706607,9521567,3,0,1,18944,0,4504469382
283,3818880,1390744,5209624,5,0,0,254464,11,410087768
284,3833681,1173270,5006951,7,0,0,68608,16,6790075583
285,3860871,5737004,9597875,0,0,1,21504,6,6778128901
286,3874800,5723421,9598221,3,0,1,512,0,835805870
287,3916760,5682229,9598989,8,0,1,11776,6,9303652671
288,3926131,2815076,6741207,7,0,0,168448,16,4020240828
289,3964770,2188522,6153292,2,0,0,16384,11,2261486509
290,3970901,1947968,5918869,7,0,0,78336,16,5076242507
291,3974660,2388323,6362983,2,0,0,109056,11,10533926739
292,3985390,6053396,10038786,2,0,1,127488,11,9416167664
293,3988330,7107692,11096022,2,0,1,147456,11,5208271130
294,3994670,1726283,5720953,2,0,0,81408,11,9836147083
295,4000630,958350,4958980,8,0,0,3584,6,9574399700
296,4004230,7734782,11739012,2,0,1,198656,11,7464176197
297,4021291,7717744,11739035,0,0,1,7680,6,1861059299
298,4032800,2902225,6935025,2,0,0,253952,11,5806337572
299,4033170,3626490,7659660,0,0,0,110592,6,9539821291
300,4033269,1504496,5537765,4,0,0,512,4,9474814896
301,4042020,7771971,11813991,2,0,1,57344,11,1538659822
302,4066240,7888337,11954577,2,0,1,154624,11,6180067251
303,4096691,7858384,11955075,0,0,1,4096,6,9474956935
304,4103930,7851160,11955090,3,0,1,1536,0,5279172370
305,4126111,7828994,11955105,0,0,1,5120,6,3815743824
306,4131720,7946502,12078222,1,0,1,49152,6,6946342462
307,4142790,1083612,5226402,2,0,0,24576,11,5841844026
308,4143239,1865360,6008599,4,0,0,512,4,9851568935
309,4153911,1353210,5507121,7,0,0,3584,16,5651235180
310,4177930,7900307,12078237,8,0,1,3584,6,6491097755
311,4223200,1857046,6080246,5,0,0,121344,11,6466400354
312,4234550,7843734,12078284,3,0,1,23552,0,6376823299
313,4259909,1246089,5505998,4,0,0,2048,4,2710861663
314,4261460,7836510,12097970,1,0,1,512,6,1374463237
315,4265030,1747256,6012286,9,0,0,8704,17,9923889934
316,4273231,7824762,12097993,0,0,1,12288,6,2824981536
317,4274830,7869580,12144410,1,0,1,31744,6,8023453696
318,4290709,953631,5244340,4,0,0,4096,4,9707594345
319,4295950,1720407,6016357,5,0,0,13312,11,5506062357
320,4319960,7833713,12153673,2,0,1,30208,11,1967326721
321,4342670,7815832,12158502,3,0,1,1536,0,9904157906
322,4345780,577063,4922843,0,0,0,1536,6,3635712109
323,4352020,7821639,12173659,6,0,1,5120,3,9093804226
324,4377960,7795714,12173674,6,0,1,3584,3,8517933275
325,4378470,7812573,12191043,6,0,1,41984,3,8372579497
326,4395680,7919259,12314939,6,0,1,20480,3,6870725952
327,4401770,1148872,5550642,9,0,0,1024,17,7511756561
328,4432211,7924418,12356629,0,0,1,11264,6,6121862959
329,4433660,1116655,5550315,8,0,0,5632,6,7225705730
330,4450580,7976287,12426867,6,0,1,1024,3,1877441527
331,4458190,7968692,12426882,6,0,1,23040,3,4545097581
332,4458731,8011157,12469888,0,0,1,9728,6,9494874674
333,4476760,8049028,12525788,8,0,1,4096,6,1229336665
334,4516950,8054468,12571418,6,0,1,30720,3,4750551874
335,4533710,8140192,12673902,1,0,1,20480,6,5652695829
336,4636100,8037825,12673925,6,0,1,1536,3,164522447
337,4662101,8011839,12673940,0,0,1,9728,6,8678168163
338,4729390,2075971,6805361,8,0,0,4096,6,4305656216
339,4730030,820783,5550813,5,0,0,512,11,3367036881
340,4770340,1559385,6329725,0,0,0,29696,6,5015778876
341,4775411,7909726,12685137,0,0,1,23552,6,1317990848
342,4784510,2286901,7071411,5,0,0,145920,11,2091671778
343,4793910,7900160,12694070,4,0,1,8704,4,1051800360
344,4825141,7889272,12714413,0,0,1,25600,6,5732350406
345,4836260,7944933,12781193,4,0,1,25088,4,128608079
346,4838821,7998672,12837493,0,0,1,18432,6,9288633946
347,4892720,7944796,12837516,6,0,1,12800,3,6036485683
348,4908840,7928691,12837531,6,0,1,512,3,4791929355
349,4909190,7928356,12837546,6,0,1,20480,3,2833788084
350,4909359,985588,5894947,4,0,0,2048,4,8263091909
351,4920230,1211604,6131834,8,0,0,1024,6,8529632790
352,4929340,7956009,12885349,8,0,1,14848,6,7670396464
353,4953090,8043820,12996910,8,0,1,10240,6,6184524460
354,5010330,8215694,13226024,3,0,1,10240,0,9151960044
355,5020509,273427,5293936,4,0,0,512,4,9814025587
356,5038920,8187119,13226039,4,0,1,1536,4,931461617
357,5043450,973390,6016840,9,0,0,1536,17,3192827146
358,5069370,8156700,13226070,6,0,1,17408,3,9909078203
359,5084970,8141123,13226093,6,0,1,4608,3,6588044041
360,5087010,8139098,13226108,6,0,1,1024,3,7926554182
361,5114610,1421767,6536377,9,0,0,512,17,1929572384
362,5129621,8122739,13252360,0,0,1,3072,6,7955391133
363,5150280,8106164,13256444,8,0,1,18432,6,5212306755
364,5150720,1067732,6218452,0,0,0,116224,6,10649166362
365,5152750,8182458,13335208,3,0,1,48128,0,901193441
366,5157710,851840,6009550,9,0,0,3072,17,9017452645
367,5159070,8330897,13489967,3,0,1,22528,0,9306595645
368,5162261,8333378,13495639,0,0,1,11776,6,7185633364
369,5190501,8310835,13501336,0,0,1,19968,6,10130427500
370,5203379,898925,6102304,4,0,0,5632,4,2886305854
371,5222421,1176317,6398738,7,0,0,117248,16,1565430261
372,5228490,8369417,13597907,4,0,1,6144,4,3939447790
373,5230000,2045849,7275849,0,0,0,104960,6,968773661
374,5241970,8466901,13708871,8,0,1,36352,6,10067329446
375,5262539,1218199,6480738,4,0,0,79360,4,8655029764
376,5281100,8429681,13710781,8,0,1,3584,6,6996314954
377,5281180,8431542,13712722,4,0,1,6144,4,6577597639
378,5291820,8574405,13866225,8,0,1,11776,6,8583174828
379,5295280,8570992,13866272,8,0,1,7168,6,289250873
380,5308421,1344225,6652646,7,0,0,53248,16,2172731235
381,5315060,8551235,13866295,3,0,1,27136,0,8796300340
382,5369250,8565949,13935199,4,0,1,4096,4,2700007815
383,5396319,2575596,7971915,4,0,0,188928,4,4923083314
384,5434199,2687243,8121442,4,0,0,309248,4,117238345
385,5453251,1535039,6988290,7,0,0,87552,16,482999832
386,5464870,1361581,6826451,0,0,0,68608,6,6769165068
387,5478740,8459469,13938209,4,0,1,15360,4,6042091476
388,5496910,2403824,7900734,2,0,0,250368,11,9229401924
389,5524560,1111839,6636399,9,0,0,3072,17,2141617962
390,5541270,612201,6153471,9,0,0,512,17,417402791
391,5550909,2677911,8228820,4,0,0,180736,4,7491954110
392,5597701,8353927,13951628,0,0,1,32768,6,1155532040
393,5619650,1381619,7001269,2,0,0,42496,11,10314603853
394,5625400,1489856,7115256,2,0,0,48128,11,3738272631
395,5642600,1162932,6805532,8,0,0,512,6,4963285875
396,5661550,8385119,14046669,3,0,1,62464,0,9152510527
397,5697381,8391213,14088594,0,0,1,6656,6,8888440705
398,5757510,8439705,14197215,8,0,1,5632,6,7004049246
399,5761510,1562399,7323909,5,0,0,101376,11,4917420643
400,5794850,8402388,14197238,8,0,1,17408,6,5211776383
401,5890710,2591936,8482646,5,0,0,227840,11,9852764922
402,5939220,1348938,7288158,5,0,0,29696,11,4739952823
403,5945741,8251512,14197253,0,0,1,6656,6,4032187752
404,5962721,2389876,8352597,7,0,0,282624,16,1291325926
405,5986430,532990,6519420,8,0,0,1024,6,6302605673
406,5986770,413387,6400157,9,0,0,4608,17,9206102429
407,5989829,2608893,8598722,4,0,0,165376,4,2725392262
408,6014680,946911,6961591,8,0,0,512,6,9647822652
409,6026750,8170526,14197276,7,0,1,3072,16,7551200604
410,6066340,2183875,8250215,5,0,0,70144,11,1346989262
411,6120010,953444,7073454,0,0,0,6656,6,5778669852
412,6136901,8060390,14197291,0,0,1,2560,6,10508508294
413,6152379,1561891,7714270,4,0,0,25088,4,5156718101
414,6164810,2248401,8413211,2,0,0,130560,11,1914035276
415,6263511,1099508,7363019,7,0,0,77312,16,8264116741
416,6271140,920725,7191865,2,0,0,85504,11,4229470100
417,6293320,2953718,9247038,5,0,0,82944,11,8644531246
418,6306190,2600942,8907132,0,0,0,419840,6,15450853
419,6339721,1349062,7688783,7,0,0,53248,16,1536658933
420,6346639,2391437,8738076,4,0,0,331776,4,1409487008
421,6394439,2746633,9141072,4,0,0,282624,4,4370786733
422,6439961,7757345,14197306,0,0,1,7680,6,10533003058
423,6459500,1454836,7914336,8,0,0,2048,6,10198831031
424,6475420,7722712,14198132,9,0,1,15360,17,2390208259
425,6508370,7689777,14198147,9,0,1,6656,17,203978191
426,6508600,7689562,14198162,9,0,1,18944,17,5725733767
427,6552401,7645776,14198177,0,0,1,5632,6,3235540949
428,6556330,560046,7116376,5,0,0,1536,11,3542090520
429,6558030,2221136,8779166,0,0,0,88064,6,3029343345
430,6589970,967163,7557133,9,0,0,6656,17,3591251495
431,6640051,7601328,14241379,0,0,1,25088,6,5124936931
432,6697990,7546862,14244852,9,0,1,9216,17,7255346329
433,6846040,1181155,8027195,2,0,0,96256,11,7912347809
434,6888611,7356497,14245108,0,0,1,9216,6,3162031013
435,6900630,1221303,8121933,8,0,0,1536,6,5249443854
436,6961041,7364352,14325393,0,0,1,33792,6,3956508114
437,6967340,7390727,14358067,9,0,1,5120,17,9704597072
438,7004080,7374921,14379001,2,0,1,7680,11,101700346
439,7022040,539757,7561797,2,0,0,12800,11,6375330242
440,7052220,1121517,8173737,9,0,0,4608,17,4686184921
441,7053480,7409235,14462715,9,0,1,27648,17,6348729121
442,7055700,7407038,14462738,2,0,1,4096,11,6008049191
443,7064369,933475,7997844,4,0,0,69632,4,4853843060
444,7067400,1855043,8922443,5,0,0,50176,11,2066292848
445,7068209,1568756,8636965,4,0,0,125440,4,4335639859
446,7076620,7386928,14463548,2,0,1,16384,11,8215637280
447,7091750,1174720,8266470,0,0,0,53248,6,5678270031
448,7095081,7368482,14463563,0,0,1,10752,6,4544545277
449,7103520,2201338,9304858,8,0,0,1024,6,1411200218
450,7158300,1870391,9028691,8,0,0,3072,6,9572722539
451,7196671,1176689,8373360,7,0,0,68096,16,6093756600
452,7210290,962028,8172318,2,0,0,26112,11,4424228984
453,7221550,751168,7972718,8,0,0,2560,6,5062206256
454,7232551,7325521,14558072,0,0,1,45568,6,7891139583
455,7236740,477701,7714441,9,0,0,512,17,5654716195
456,7247201,7314478,14561679,0,0,1,4608,6,6797152979
457,7249520,664177,7913697,5,0,0,42496,11,7806540018
458,7322580,1876896,9199476,5,0,0,178688,11,3240518508
459,7475590,1504782,8980372,2,0,0,183808,11,2276071906
460,7512941,1034256,8547197,7,0,0,44032,16,9066226782
461,7538850,994855,8533705,5,0,0,167424,11,9036648755
462,7561170,1191133,8752303,0,0,0,46592,6,2329232297
463,7608010,940294,8548304,8,0,0,3584,6,2371236063
464,7622530,1599221,9221751,5,0,0,72704,11,2668936229
465,7639141,1388599,9027740,7,0,0,53248,16,4125429562
466,7674129,1470873,9145002,4,0,0,12800,4,7639704668
467,7734971,1259472,8994443,7,0,0,46080,16,7394929901
468,7736349,1574365,9310714,4,0,0,18944,4,9482689707
469,7737930,6922053,14659983,9,0,1,16384,17,863015828
470,7764220,6899608,14663828,9,0,1,81408,17,2264454616
471,7777140,6902757,14679897,9,0,1,11264,17,8183539677
472,7787181,6939656,14726837,0,0,1,2560,6,1385186606
473,7880180,6852776,14732956,9,0,1,20992,17,10575123650
474,7916101,6823064,14739165,0,0,1,21504,6,9213264966
475,7975871,6802438,14778309,0,0,1,38912,6,8956609359
476,8022629,901709,8924338,4,0,0,6144,4,1507501185
477,8054191,6750857,14805048,0,0,1,26112,6,2699824731
478,8102890,1322393,9425283,2,0,0,132608,11,9033757789
479,8120929,1183602,9304531,4,0,0,185344,4,622805745
480,8162370,1085627,9247997,2,0,0,3072,11,7646112886
481,8190560,6667470,14858030,9,0,1,63488,17,9335801809
482,8215400,795906,9011306,0,0,0,55296,6,6521655699
483,8253370,6685789,14939159,9,0,1,42496,17,10444055216
484,8255150,756343,9011493,8,0,0,512,6,5170982128
485,8265900,6674885,14940785,3,0,1,2560,0,9948244684
486,8295521,1066094,9361615,7,0,0,162816,16,2769697276
487,8303260,6706197,15009457,9,0,1,18432,17,3227873988
488,8307660,747262,9054922,5,0,0,86016,11,9697420239
489,8326490,6682982,15009472,9,0,1,8704,17,8180593911
490,8420200,890997,9311197,2,0,0,1536,11,6270925020
491,8434100,6578521,15012621,7,0,1,32256,16,4190447356
492,8465450,1016077,9481527,8,0,0,96256,6,1019211787
493,8481790,1026645,9508435,8,0,0,84480,6,241456474
494,8485719,966419,9452138,4,0,0,88064,4,10137174888
495,8526000,1156908,9682908,8,0,0,136704,6,3536133525
496,8549140,6508511,15057651,3,0,1,19968,0,4216545290
497,8569339,815112,9384451,4,0,0,74752,4,793834015
498,8572181,6594628,15166809,0,0,1,39936,6,1790122333
499,8629510,6537314,15166824,3,0,1,9728,0,8827100183
500,8638120,880189,9518309,9,0,0,6144,17,7781272214
501,8691070,620922,9311992,2,0,0,2560,11,3954678008
502,8693880,690944,9384824,9,0,0,1024,17,4131916815
503,8703010,813404,9516414,8,0,0,26112,6,5046348319
504,8705820,1363758,10069578,0,0,0,61440,6,6304545865
505,8736730,1234787,9971517,8,0,0,216064,6,319796079
506,8887700,672079,9559779,2,0,0,3072,11,8356118170
507,8935220,1103551,10038771,5,0,0,72704,11,3853875653
508,8941330,541304,9482634,2,0,0,3584,11,10417284772
509,8943810,6256376,15200186,9,0,1,5120,17,7821928282
510,8978570,1244167,10222737,5,0,0,120832,11,5712682563
511,9021000,1215948,10236948,8,0,0,46592,6,249493803
512,9098759,1299427,10398186,4,0,0,58880,4,10598020585
513,9117740,674459,9792199,5,0,0,12800,11,1712226173
514,9122600,665505,9788105,8,0,0,101888,6,84076116
515,9126820,661456,9788276,2,0,0,512,11,4392540763
516,9163350,593696,9757046,8,0,0,43520,6,8333924787
517,9202520,319002,9521522,8,0,0,10240,6,5084710814
518,9281829,1530959,10812788,4,0,0,241152,4,8605199006
519,9286730,592081,9878811,2,0,0,1536,11,9436780366
520,9295901,447862,9743763,7,0,0,34304,16,10457971900
521,9305340,666824,9972164,9,0,0,2048,17,9934065538
522,9308400,564720,9873120,9,0,0,2560,17,3692865884
523,9311350,387823,9699173,9,0,0,512,17,10480310191
524,9316190,5931909,15248099,9,0,1,27136,17,7224427390
525,9336841,6099354,15436195,0,0,1,42496,6,3684592409
526,9349269,1224761,10574030,4,0,0,169472,4,21141190
527,9358881,1488462,10847343,7,0,0,113152,16,6296651704
528,9393340,1307799,10701139,0,0,0,160768,6,9952452921
529,9446500,1560981,11007481,8,0,0,32256,6,8494845786
530,9461081,6100380,15561461,0,0,1,3072,6,2279576837
531,9478980,1616848,11095828,0,0,0,56320,6,2087161713
532,9481350,6168104,15649454,9,0,1,22528,17,6081922414
533,9497030,651766,10148796,5,0,0,94208,11,2849022703
534,9497490,652592,10150082,2,0,0,512,11,10735104573
535,9504530,6252705,15757235,6,0,1,10240,3,484178843
536,9571530,578373,10149903,2,0,0,3584,11,5643465182
537,9603631,6210427,15814058,0,0,1,7168,6,8483368338
538,9615280,1463373,11078653,5,0,0,196608,11,2964700576
539,9665610,1242505,10908115,5,0,0,31232,11,2288056881
540,9684560,6349052,16033612,6,0,1,14848,3,5674073639
541,9733710,1400488,11134198,5,0,0,16384,11,5878367588
542,9772070,6261557,16033627,6,0,1,1536,3,2373362134
543,9787219,1761992,11549211,4,0,0,115712,4,9800932971
544,9811381,6254623,16066004,0,0,1,23040,6,9405220711
545,9855909,1657999,11513908,4,0,0,589824,4,433014787
546,9861790,1720367,11582157,0,0,0,89600,6,5682105666
547,9914150,6151869,16066019,6,0,1,4096,3,10173075945
548,9953390,6172913,16126303,6,0,1,31232,3,4551012802
549,9962960,450816,10413776,8,0,0,2560,6,1315288003
550,10051230,1060750,11111980,2,0,0,6656,11,2695053424
551,10072540,1711282,11783822,5,0,0,146944,11,4083900716
552,10141680,587905,10729585,5,0,0,39936,11,5074134619
553,10155480,5970838,16126318,6,0,1,2048,3,5753359086
554,10165611,1550689,11716300,7,0,0,274944,16,7245407474
555,10223491,5902982,16126473,0,0,1,8192,6,3209205670
556,10223959,885970,11109929,4,0,0,45568,4,3606550813
557,10300620,795387,11096007,2,0,0,512,11,9213115906
558,10302470,933647,11236117,8,0,0,186880,6,8178163902
559,10324720,683088,11007808,9,0,0,1024,17,2068229523
560,10344790,5782349,16127139,6,0,1,1024,3,2662739330
561,10346740,1563885,11910625,0,0,0,141312,6,3666764672
562,10358009,1230419,11588428,4,0,0,20480,4,7813740475
563,10377511,5750294,16127805,0,0,1,1024,6,703136510
564,10400669,1677530,12078199,4,0,0,296960,4,7651380728
565,10416810,5712301,16129111,7,0,1,2048,16,4039628761
566,10445519,1180239,11625758,4,0,0,58880,4,896053458
567,10487961,846204,11334165,7,0,0,110080,16,10732962652
568,10491730,5639967,16131697,8,0,1,4096,6,3059598178
569,10519631,5702827,16222458,0,0,1,3072,6,7501913261
570,10530811,1204715,11735526,7,0,0,17920,16,7638234108
571,10580190,5646774,16226964,7,0,1,7168,16,4805485235
572,10602010,311736,10913746,5,0,0,18432,11,3037393536
573,10614150,5616040,16230190,6,0,1,5120,3,5526791260
574,10614401,5800393,16414794,0,0,1,6144,6,9436090414
575,10618120,5798155,16416275,6,0,1,8192,3,7897049645
576,10632380,5822888,16455268,3,0,1,15360,0,10593467527
577,10641771,5815763,16457534,0,0,1,3584,6,3828392413
578,10643510,5815100,16458610,3,0,1,13312,0,6927300067
579,10651760,5946717,16598477,6,0,1,5120,3,2538866730
580,10674300,5925765,16600065,6,0,1,15872,3,7720292660
581,10695019,1449352,12144371,4,0,0,133632,4,7840687599
582,10715510,892277,11607787,8,0,0,63488,6,5512161082
583,10722770,909743,11632513,5,0,0,22016,11,5876388103
584,10740891,1043110,11784001,7,0,0,512,16,310626598
585,10744921,1556868,12301789,7,0,0,245248,16,2832772135
586,10750101,5911968,16662069,0,0,1,9728,6,2150206841
587,10750611,5912968,16663579,0,0,1,512,6,5860284234
588,10771950,5896916,16668866,3,0,1,16896,0,3309335869
589,10774350,964623,11738973,2,0,0,11264,11,3552594456
590,10777640,1649204,12426844,8,0,0,37888,6,9828062410
591,10792809,1021167,11813976,4,0,0,98304,4,2328689032
592,10815280,6023741,16839021,4,0,1,18432,4,313992427
593,10815500,361916,11177416,5,0,0,8704,11,7521862817
594,10843070,1570514,12413584,0,0,0,186880,6,5886024900
595,10853641,701201,11554842,7,0,0,18432,16,596077951
596,10912370,5926698,16839068,6,0,1,40960,3,4031341503
597,10924440,5917653,16842093,4,0,1,13312,4,5192819266
598,10933540,5908592,16842132,6,0,1,7680,3,10208295227
599,10950240,1153400,12103640,8,0,0,18432,6,6994352142
600,10975540,262480,11238020,2,0,0,6144,11,2964535108
601,11038900,5803247,16842147,4,0,1,13312,4,10353161267
602,11055720,1777827,12833547,0,0,0,155648,6,8189947008
603,11151691,578352,11730043,7,0,0,45056,16,10019582218
604,11197911,5644259,16842170,0,0,1,512,6,6384843289
605,11225680,5616505,16842185,4,0,1,512,4,8587175230
606,11302040,5540160,16842200,6,0,1,512,3,7900648178
607,11331671,5510544,16842215,0,0,1,16384,6,7808682774
608,11344320,1951977,13296297,8,0,0,57856,6,6917882828
609,11349130,605432,11954562,5,0,0,112640,11,4190710658
610,11429180,5549682,16978862,6,0,1,9216,3,2001237537
611,11451859,646096,12097955,4,0,0,64512,4,8579447461
612,11500490,814434,12314924,8,0,0,43008,6,9540033984
613,11503771,1123113,12626884,7,0,0,146944,16,8385151237
614,11539610,415450,11955060,9,0,0,1536,17,553953221
615,11542601,814005,12356606,7,0,0,136704,16,7369743560
616,11544720,870557,12415277,9,0,0,1024,17,4947873990
617,11545429,1932950,13478379,4,0,0,64512,4,6937619355
618,11579290,855727,12435017,8,0,0,26624,6,394764136
619,11601991,5395066,16997057,0,0,1,44544,6,3086282805
620,11625760,547884,12173644,5,0,0,41984,11,5355369034
621,11710090,830845,12540935,9,0,0,13824,17,6929955257
622,11731230,5265842,16997072,4,0,1,5632,4,10000726116
623,11815890,598217,12414107,9,0,0,1536,17,8162159459
624,11817740,5228346,17046086,6,0,1,21504,3,1246472745
625,11830920,5215181,17046101,6,0,1,2048,3,4528616397
626,11857850,688113,12545963,2,0,0,5120,11,5548942521
627,11874220,799635,12673855,0,0,0,154112,6,9649149723
628,11907670,5138446,17046116,4,0,1,25088,4,3450100936
629,11912780,1795117,13707897,5,0,0,262144,11,997215262
630,11952580,1816512,13769092,2,0,0,512,11,5852782330
631,11966840,5079618,17046458,6,0,1,9728,3,7602544390
632,11972480,5073993,17046473,3,0,1,10752,0,972123020
633,11994510,5051978,17046488,3,0,1,17408,0,5622514437
634,12011480,1214529,13226009,0,0,0,154112,6,5173232687
635,12011901,1053518,13065419,7,0,0,177664,16,998747572
636,12018440,396486,12414926,2,0,0,2560,11,10624714758
637,12047450,5019816,17067266,2,0,1,6656,11,2326880915
638,12071440,882791,12954231,8,0,0,63488,6,6889050246
639,12111510,564645,12676155,2,0,0,7168,11,5715954199
640,12112870,1203410,13316280,0,0,0,65536,6,3793627836
641,12127480,427869,12555349,9,0,0,1024,17,7048952035
642,12182130,494836,12676966,9,0,0,2560,17,5071672241
643,12192701,1696728,13889429,7,0,0,46080,16,8732736757
644,12196971,1163067,13360038,7,0,0,53760,16,4463243436
645,12223661,4843620,17067281,0,0,1,8704,6,5599419372
646,12229270,451611,12680881,8,0,0,12800,6,1357971351
647,12235250,4832046,17067296,4,0,1,22528,4,50652898
648,12265541,4801770,17067311,0,0,1,9728,6,6031137607
649,12299941,4767481,17067422,0,0,1,17920,6,8565868945
650,12307640,4759797,17067437,3,0,1,18432,0,2242456126
651,12311050,438760,12749810,9,0,0,1024,17,5337673032
652,12313750,4753702,17067452,6,0,1,8704,3,9424953027
653,12334710,930322,13265032,2,0,0,1536,11,2000886585
654,12335099,518408,12853507,4,0,0,8704,4,10582447752
655,12353250,4714217,17067467,4,0,1,8192,4,5320695406
656,12357771,1411134,13768905,7,0,0,184320,16,326615499
657,12362731,4820121,17182852,0,0,1,68608,6,3347332061
658,12380380,1240036,13620416,5,0,0,32768,11,7865047429
659,12386401,4796912,17183313,0,0,1,10240,6,357435047
660,12432431,4844486,17276917,0,0,1,11776,6,8732254407
661,12468620,4808663,17277283,3,0,1,8192,0,2187251220
662,12493609,1510464,14004073,4,0,0,6656,4,6565450730
663,12495520,341958,12837478,0,0,0,12800,6,9278399570
664,12528491,723840,13252331,7,0,0,86016,16,6257861384
665,12537540,363800,12901340,5,0,0,43520,11,9186757404
666,12538110,4739188,17277298,3,0,1,1536,0,1535377487
667,12543741,4761394,17305135,0,0,1,45056,6,5916715428
668,12546440,4836669,17383109,6,0,1,39936,3,8553625267
669,12564370,364421,12928791,5,0,0,72704,11,9699103774
670,12595670,776111,13371781,9,0,0,512,17,3969201574
671,12601109,1914380,14515489,4,0,0,20480,4,5047745266
672,12613830,350055,12963885,9,0,0,2560,17,10099619559
673,12614470,1097426,13711896,9,0,0,3584,17,4882122577
674,12621360,1321396,13942756,9,0,0,14848,17,4143217704
675,12627000,1308160,13935160,0,0,0,150016,6,3538914854
676,12640511,4770428,17410939,0,0,1,8192,6,5878579662
677,12652090,4805687,17457777,3,0,1,512,0,9766217456
678,12656650,1500131,14156781,0,0,0,223744,6,4863722931
679,12671720,4791464,17463184,2,0,1,22528,11,2642956280
680,12687950,4777820,17465770,4,0,1,4096,4,2871956582
681,12694470,4774191,17468661,3,0,1,4096,0,7918646493
682,12705990,1094201,13800191,5,0,0,101888,11,7762729347
683,12725950,1212228,13938178,2,0,0,9728,11,4825845960
684,12734940,4741140,17476080,6,0,1,4096,3,2330164582
685,12736440,4741177,17477617,6,0,1,23552,3,6304913026
686,12739381,437353,13176734,7,0,0,4608,16,8918979211
687,12753671,584302,13337973,7,0,0,3072,16,8582901475
688,12778790,4794328,17573118,6,0,1,33792,3,9835196491
689,12794110,1294469,14088579,0,0,0,71168,6,7128158362
690,12794490,1205341,13999831,5,0,0,107520,11,4511659395
691,12810379,1055823,13866202,4,0,0,216576,4,4435219836
692,12826181,784228,13610409,7,0,0,40960,16,2058282221
693,12827781,1935718,14763499,7,0,0,56832,16,2637264274
694,12847150,1350050,14197200,8,0,0,132608,6,2354844593
695,12863220,4710576,17573796,6,0,1,44544,3,5515590661
696,12965861,1274378,14240239,7,0,0,97792,16,9769257897
697,12992690,324549,13317239,9,0,0,3072,17,6225130838
698,13006150,4668135,17674285,3,0,1,26112,0,4416491578
699,13024930,685828,13710758,9,0,0,6144,17,3066385129
700,13081160,4623906,17705066,2,0,1,41472,11,5866106113
701,13085970,1272082,14358052,0,0,0,82944,6,8978148327
702,13149970,4556402,17706372,4,0,1,2048,4,2687094852
703,13161620,875174,14036794,5,0,0,72704,11,6491967989
704,13162220,546636,13708856,9,0,0,3072,17,4633006758
705,13165510,709856,13875366,0,0,0,29696,6,5588495171
706,13187280,1851776,15039056,0,0,0,30208,6,8193583304
707,13197150,363128,13560278,2,0,0,512,11,9556506231
708,13202110,418797,13620907,2,0,0,1536,11,1421533013
709,13301940,4422478,17724418,7,0,1,32768,16,962180446
710,13318810,4486978,17805788,4,0,1,22528,4,794578880
711,13325970,1559239,14885209,5,0,0,61952,11,4466002597
712,13327110,385581,13712691,2,0,0,2560,11,3942207930
713,13362780,116394,13479174,2,0,0,2560,11,4003910081
714,13391500,4480844,17872344,3,0,1,28672,0,9321471591
715,13405780,4466579,17872359,2,0,1,3584,11,2189881958
716,13431300,4452360,17883660,2,0,1,20480,11,8392932270
717,13431760,1228208,14659968,5,0,0,299520,11,7389532754
718,13442130,604195,14046325,8,0,0,31232,6,7248396832
719,13512810,4414568,17927378,3,0,1,9216,0,3083973493
720,13544050,4391330,17935380,3,0,1,34304,0,7571410742
721,13563090,4372305,17935395,6,0,1,1024,3,5586899057
722,13567750,4367660,17935410,4,0,1,10240,4,3275244225
723,13572010,4363431,17935441,4,0,1,50176,4,3600847952
724,13590460,4344996,17935456,6,0,1,8192,3,8481035396
725,13600160,4335311,17935471,4,0,1,11264,4,685787230
726,13602881,1171865,14774746,7,0,0,36864,16,8401603540
727,13631930,4315146,17947076,4,0,1,5120,4,1558103369
728,13646900,4300191,17947091,9,0,1,11776,17,38530011
729,13662440,4285789,17948229,2,0,1,14336,11,7943122797
730,13680250,4273862,17954112,2,0,1,3584,11,8866070206
731,13685171,1324271,15009442,7,0,0,55296,16,4957482490
732,13694770,307260,14002030,2,0,0,7168,11,8716404939
733,13709420,4253014,17962434,2,0,1,6656,11,3509029883
734,13718500,4290132,18008632,2,0,1,12288,11,9185809609
735,13723060,4288158,18011218,6,0,1,4096,3,7107459183
736,13767450,4243922,18011372,3,0,1,8704,0,10184351422
737,13784499,678177,14462676,4,0,0,207872,4,7808619624
738,13813200,1353570,15166770,8,0,0,116736,6,10000181354
739,13824370,4191828,18016198,2,0,1,7680,11,1755143693
740,13836570,4182731,18019301,2,0,1,1024,11,1908891816
741,13854051,1543068,15397119,7,0,0,263168,16,9507297255
742,13868390,411024,14279414,5,0,0,25088,11,4860206727
743,13885220,4136987,18022207,4,0,1,4608,4,8100428928
744,13887940,4146455,18034395,9,0,1,12800,17,801736138
745,13916779,462207,14378986,4,0,0,68608,4,10397405151
746,13955760,242357,14198117,9,0,0,2560,17,4260224867
747,13985250,4049811,18035061,6,0,1,11264,3,3654829893
748,13988010,4051557,18039567,3,0,1,7168,0,6537526941
749,13989990,250740,14240730,2,0,0,1536,11,9529752211
750,14018970,490264,14509234,0,0,0,83968,6,10716097288
751,14024980,4060650,18085630,2,0,1,13312,11,4940499247
752,14082750,4027885,18110635,6,0,1,9216,3,7480236469
753,14109770,555009,14664779,9,0,0,3072,17,8371576408
754,14129330,1431601,15560931,8,0,0,211456,6,10192165368
755,14136370,3974280,18110650,2,0,1,9216,11,4294761702
756,14179889,483900,14663789,4,0,0,11776,4,7583160638
757,14183630,3927083,18110713,5,0,1,15872,11,1394608205
758,14195620,3915116,18110736,3,0,1,14848,0,2986480204
759,14211209,1203085,15414294,4,0,0,56320,4,562541543
760,14223520,240013,14463533,2,0,0,2560,11,10502482278
761,14229680,3954467,18184147,2,0,1,37888,11,6257883748
762,14245050,3988474,18233524,3,0,1,60416,0,1874472468
763,14250570,409616,14660186,2,0,0,512,11,204523404
764,14307710,3927760,18235470,6,0,1,3072,3,2721178126
765,14316409,252284,14568693,4,0,0,5632,4,2192838087
766,14323060,3982981,18306041,2,0,1,51200,11,4995919414
767,14365070,3940986,18306056,4,0,1,9216,4,10445442791
768,14377730,4357235,18734965,8,0,1,25088,6,10197303468
769,14385400,4351191,18736591,2,0,1,2560,11,570453165
770,14386470,4502315,18888785,2,0,1,21504,11,4612339341
771,14388140,431846,14819986,9,0,0,4096,17,5307911765
772,14390090,385451,14775541,9,0,0,2560,17,4393211664
773,14390190,1317609,15707799,8,0,0,105984,6,633478316
774,14392860,4555702,18948562,3,0,1,10752,0,6596604557
775,14403391,302380,14705771,7,0,0,9728,16,9788959496
776,14415220,4534008,18949228,7,0,1,11264,16,363009314
777,14417190,6968685,21385875,5,0,1,207360,11,10355613027
778,14428980,292654,14721634,2,0,0,5632,11,10079434635
779,14460440,241774,14702214,2,0,0,3072,11,9363835316
780,14472810,237408,14710218,0,0,0,2560,6,8008434547
781,14486320,506259,14992579,2,0,0,512,11,9513301926
782,14486950,7096862,21583812,3,0,1,4608,0,211157020
783,14493090,1003398,15496488,9,0,0,4608,17,6803006715
784,14497000,7086827,21583827,9,0,1,1024,17,9352039623
785,14514600,501532,15016132,0,0,0,10240,6,5650392479
786,14517210,7066632,21583842,2,0,1,7168,11,4942199870
787,14534680,7549991,22084671,6,0,1,102912,3,10324870075
788,14545450,446958,14992408,8,0,0,139776,6,6104598824
789,14556280,7602116,22158396,6,0,1,4096,3,10158874803
790,14582720,7575691,22158411,3,0,1,13312,0,2495360824
791,14604970,7553456,22158426,2,0,1,1536,11,3446352111
792,14609559,870963,15480522,4,0,0,145408,4,9494232872
793,14613170,7558234,22171404,8,0,1,26112,6,4246037068
794,14636600,7574941,22211541,3,0,1,20992,0,4918083513
795,14636670,7574886,22211556,7,0,1,18944,16,2448212180
796,14647430,559824,15207254,0,0,0,21504,6,7861042837
797,14664100,8970912,23635012,5,0,1,263168,11,4828627896
798,14693300,13471428,28164728,5,0,1,363520,11,5696066456
799,14693730,426536,15120266,8,0,0,13312,6,5720136947
800,14706730,13458013,28164743,7,0,1,30720,16,7527769310
801,14713810,781259,15495069,5,0,0,47616,11,4700972807
802,14718240,928672,15646912,5,0,0,138240,11,9598005045
803,14725240,13776150,28501390,5,0,1,33792,11,2646631803
804,14743639,997763,15741402,4,0,0,110080,4,2361789058
805,14751401,1182535,15933936,7,0,0,192512,16,7735109480
806,14771950,14118565,28890515,7,0,1,56320,16,6431037526
807,14798359,636386,15434745,4,0,0,67072,4,1504712781
808,14808169,1318119,16126288,4,0,0,121344,4,340219339
809,14818000,14072530,28890530,2,0,1,3072,11,3512237924
810,14822630,14067915,28890545,8,0,1,9216,6,923415595
811,14824630,15538052,30362682,5,0,1,265728,11,2396007058
812,14851929,1134938,15986867,4,0,0,173568,4,4394812206
813,14863360,15499337,30362697,2,0,1,16384,11,3711066874
814,14898090,15464622,30362712,3,0,1,11776,0,8270705601
815,14920080,15579660,30499740,3,0,1,18432,0,5700418720
816,14958391,916850,15875241,7,0,0,89600,16,9610448465
817,14985760,15513995,30499755,2,0,1,22016,11,3088081604
818,15005590,15494180,30499770,6,0,1,5632,3,1335224568
819,15007140,587062,15594202,6,0,0,13312,3,6679721783
820,15025090,15474711,30499801,6,0,1,37888,3,6681786434
821,15026500,15547538,30574038,2,0,1,37888,11,2019971802
822,15034910,15539143,30574053,3,0,1,7680,0,2068404579
823,15036540,15562347,30598887,8,0,1,4096,6,8686422040
824,15042741,1372030,16414771,7,0,0,367104,16,10718829408
825,15044270,15554640,30598910,8,0,1,23040,6,5287187709
826,15067200,368972,15436172,2,0,0,4608,11,6633675585
827,15083340,566091,15649431,8,0,0,8192,6,7318689380
828,15083560,477878,15561438,9,0,0,1536,17,5579705527
829,15099990,714053,15814043,5,0,0,93696,11,6225444390
830,15114330,15484595,30598925,3,0,1,1024,0,9074775671
831,15118580,948866,16067446,9,0,0,4608,17,491874433
832,15140771,1698235,16839006,7,0,0,336384,16,3470750451
833,15144181,1295836,16440017,7,0,0,72704,16,10211863759
834,15151480,883730,16035210,0,0,0,5120,6,781927101
835,15173629,858385,16032014,4,0,0,147968,4,10634490161
836,15237479,846986,16084465,4,0,0,55808,4,10540075879
837,15259470,15339470,30598940,8,0,1,1536,6,5031107738
838,15277369,788620,16065989,4,0,0,100864,4,2135145006
839,15284700,15314255,30598955,2,0,1,4096,11,4069342927
840,15370990,15230335,30601325,4,0,1,2560,4,9848619489
841,15401860,15199480,30601340,5,0,1,9216,11,8085071027
842,15405270,15196085,30601355,4,0,1,21504,4,7193721165
843,15487440,15113930,30601370,3,0,1,14848,0,1096607942
844,15502610,15129441,30632051,9,0,1,21504,17,8898418225
845,15503630,15130687,30634317,9,0,1,3584,17,7156468204
846,15521040,512549,16033589,9,0,0,5120,17,2647166704
847,15543770,15092493,30636263,5,0,1,3072,11,7944649588
848,15547600,15189120,30736720,6,0,1,38912,3,3664399226
849,15558380,15178355,30736735,5,0,1,43520,11,8639986777
850,15573260,15165845,30739105,3,0,1,31744,0,3744608237
851,15586320,716568,16302888,5,0,0,127488,11,9520310417
852,15604290,15134830,30739120,9,0,1,16384,17,8771318188
853,15620100,15254155,30874255,6,0,1,61952,3,10450944398
854,15626020,15248266,30874286,3,0,1,31232,0,3251492948
855,15668200,15349808,31018008,7,0,1,24064,16,7222001464
856,15673010,15345029,31018039,8,0,1,40960,6,4978058463
857,15674471,1167428,16841899,7,0,0,9216,16,1305369247
858,15681829,1297018,16978847,4,0,0,154624,4,4388551822
859,15688120,15360260,31048380,2,0,1,56320,11,7340567657
860,15697520,15410810,31108330,6,0,1,16896,3,6616518002
861,15706680,15401665,31108345,3,0,1,2048,0,4672957971
862,15729110,15423741,31152851,6,0,1,19968,3,9404193658
863,15739370,15413520,31152890,2,0,1,6656,11,4536264204
864,15745360,15407553,31152913,6,0,1,15360,3,7504607715
865,15763100,15389836,31152936,2,0,1,13312,11,404697959
866,15766570,648863,16415433,0,0,0,2048,6,3509034285
867,15823950,15329017,31152967,5,0,1,19456,11,10239462806
868,15826490,15326492,31152982,6,0,1,6656,3,1823667106
869,15832820,15320209,31153029,3,0,1,19456,0,2942818711
870,15855790,15384452,31240242,3,0,1,512,0,1358378368
871,15866299,1058010,16924309,4,0,0,267264,4,2632850834
872,15868360,725622,16593982,8,0,0,123904,6,958941208
873,15877509,1119525,16997034,4,0,0,53760,4,4780237533
874,15897030,15343227,31240257,4,0,1,19456,4,2564548303
875,15915270,15325050,31240320,4,0,1,10240,4,6954460248
876,15920720,17008549,32929269,5,0,1,320512,11,6084538223
877,15922471,521821,16444292,7,0,0,13824,16,5494244961
878,15940010,16990032,32930042,4,0,1,5632,4,3411532996
879,15947000,16983606,32930606,4,0,1,10752,4,2066245924
880,15983430,17050287,33033717,6,0,1,10752,3,9526929333
881,16005331,1171893,17177224,7,0,0,160768,16,8164142519
882,16017920,17312552,33330472,5,0,1,10752,11,3570758705
883,16049290,882430,16931720,8,0,0,24064,6,9997666482
884,16051490,17456540,33508030,8,0,1,19968,6,1575219479
885,16073730,906730,16980460,0,0,0,4096,6,4956124121
886,16078790,17858711,33937501,7,0,1,28672,16,218054719
887,16090670,17864645,33955315,2,0,1,18944,11,4745101604
888,16090710,18087112,34177822,7,0,1,13824,16,5751037556
889,16094740,18083097,34177837,7,0,1,5120,16,1443559858
890,16104940,18134175,34239115,8,0,1,17920,6,5733535472
891,16109540,19733103,35842643,3,0,1,20480,0,2544670206
892,16109930,20726238,36836168,8,0,1,40448,6,9520864883
893,16111690,23094914,39206604,5,0,1,120320,11,10157057322
894,16111961,934110,17046071,7,0,0,160768,16,10000104055
895,16113940,302320,16416260,9,0,0,2560,17,3680600193
896,16120550,297300,16417850,2,0,0,5120,11,3775729678
897,16134240,23325690,39459930,5,0,1,27648,11,4224748117
898,16144260,23315693,39459953,8,0,1,9728,6,8613781305
899,16153890,23306086,39459976,2,0,1,11776,11,2381053830
900,16162280,23520217,39682497,4,0,1,43008,4,1906476966
901,16175360,287997,16463357,2,0,0,1024,11,8645944172
902,16198831,537660,16736491,7,0,0,134656,16,1290854313
903,16200850,23481670,39682520,3,0,1,10752,0,6004934492
904,16212421,1064481,17276902,7,0,0,179712,16,10343861018
905,16219450,826993,17046443,2,0,0,1024,11,4555966647
906,16225680,23554798,39780478,8,0,1,11264,6,4575616984
907,16232791,1441479,17674270,7,0,0,81408,16,4649877531
908,16233070,23549482,39782552,4,0,1,20480,4,3707564167
909,16233930,23572388,39806318,5,0,1,1536,11,5014655611
910,16237000,830251,17067251,8,0,0,68096,6,9050454475
911,16239030,271640,16510670,0,0,0,1024,6,2676657553
912,16244260,23638076,39882336,2,0,1,2048,11,7976420046
913,16263530,23691001,39954531,6,0,1,47104,3,5295589454
914,16277150,703481,16980631,2,0,0,512,11,4190420806
915,16316960,988160,17305120,5,0,0,38912,11,4959698757
916,16344390,23611903,39956293,8,0,1,31744,6,2573010583
917,16396120,583069,16979189,0,0,0,1024,6,5502997446
918,16401660,1040746,17442406,9,0,0,3584,17,7571016966
919,16414060,23542256,39956316,5,0,1,512,11,4290347885
920,16425480,23530859,39956339,6,0,1,1024,3,8538588845
921,16429420,1049256,17478676,2,0,0,512,11,5501453322
922,16443710,24477049,40920759,5,0,1,284672,11,617369627
923,16483150,359704,16842854,0,0,0,2048,6,8950093141
924,16504960,24415822,40920782,9,0,1,4096,17,4772475624
925,16522710,24409506,40932216,1,0,1,3584,6,1269663555
926,16525700,24651138,41176838,5,0,1,112128,11,4153051268
927,16544220,24632641,41176861,4,0,1,512,4,917385947
928,16544540,24632344,41176884,2,0,1,2560,11,3456067039
929,16550920,291158,16842078,2,0,0,512,11,6163756842
930,16557800,24619107,41176907,9,0,1,6656,17,10360018669
931,16561960,24615149,41177109,2,0,1,5632,11,3514995472
932,16563819,893943,17457762,4,0,0,11264,4,3144600352
933,16576110,24750094,41326204,5,0,1,49152,11,5059185045
934,16633710,24692525,41326235,5,0,1,10752,11,2188978773
935,16637590,24688668,41326258,6,0,1,10752,3,5504047478
936,16649450,24676831,41326281,1,0,1,20480,6,10229596023
937,16678380,24647932,41326312,5,0,1,57344,11,6514245554
938,16688360,24677841,41366201,3,0,1,6656,0,8730785848
939,16705880,24660344,41366224,8,0,1,2560,6,9727595549
940,16710070,24727180,41437250,9,0,1,22016,17,5984144398
941,16741009,552216,17293225,4,0,0,52224,4,6275328722
942,16745660,818692,17564352,8,0,0,198656,6,10181940016
943,16754810,24682463,41437273,4,0,1,15360,4,3700348303
944,16769199,410272,17179471,4,0,0,7168,4,8898017273
945,16775010,693636,17468646,9,0,0,6656,17,628871963
946,16777050,24660246,41437296,6,0,1,13312,3,3264242561
947,16796190,24641129,41437319,9,0,1,10752,17,7700470047
948,16819220,26538756,43357976,5,0,1,289280,11,8000304762
949,16830660,1096695,17927355,8,0,0,143360,6,7182806266
950,16841191,964582,17805773,7,0,0,263680,16,2848481790
951,16861280,26498642,43359922,8,0,1,3072,6,5948515634
952,16893340,26480391,43373731,5,0,1,28672,11,9987157508
953,16910040,367228,17277268,2,0,0,1024,11,4709872290
954,16929140,378468,17307608,2,0,0,2560,11,3757376127
955,16946250,26468087,43414337,9,0,1,25600,17,9712441755
956,16952230,26467643,43419873,1,0,1,4096,6,4152457583
957,16952570,26468481,43421051,4,0,1,13824,4,5601259037
958,16974850,26446765,43421615,6,0,1,10752,3,5281506203
959,16982910,1173085,18155995,5,0,0,70656,11,1866673629
960,17008190,26465642,43473832,2,0,1,39424,11,1644496553
961,17020760,26543968,43564728,5,0,1,47616,11,2389680347
962,17020910,554149,17575059,2,0,0,4096,11,1696894324
963,17024960,26920811,43945771,8,0,1,54784,6,7088321394
964,17076780,313826,17390606,0,0,0,1024,6,6321706868
965,17083130,903013,17986143,2,0,0,2048,11,3543182096
966,17090180,27039382,44129562,1,0,1,18944,6,8819427165
967,17090550,27039035,44129585,2,0,1,9216,11,5119522187
968,17103530,723848,17827378,5,0,0,67072,11,8621112091
969,17105450,27036471,44141921,8,0,1,2048,6,10693339701
970,17113790,27232560,44346350,2,0,1,33280,11,6574283395
971,17163760,409343,17573103,5,0,0,28672,11,1349786431
972,17171410,402347,17573757,9,0,0,2048,17,8957281500
973,17175070,27314112,44489182,4,0,1,58880,4,5584194764
974,17182840,1000345,18183185,2,0,0,1536,11,4085553197
975,17214680,486634,17701314,8,0,0,1536,6,8951881395
976,17215320,27273885,44489205,8,0,1,5120,6,6613647677
977,17224740,233832,17458572,9,0,0,2560,17,7184287506
978,17228510,27260718,44489228,6,0,1,2560,3,3289263171
979,17229860,652030,17881890,8,0,0,31232,6,1901574047
980,17276080,659277,17935357,8,0,0,26112,6,3162946094
981,17280530,591791,17872321,8,0,0,147456,6,7932044099
982,17312260,27176991,44489251,1,0,1,11776,6,6422076975
983,17368460,27171591,44540051,1,0,1,19968,6,4828607003
984,17375270,27181987,44557257,9,0,1,24064,17,1456400826
985,17377150,27180130,44557280,2,0,1,22016,11,6532539489
986,17378970,504675,17883645,0,0,0,5632,6,4803698511
987,17390430,416465,17806895,0,0,0,3584,6,9473654850
988,17419550,27137753,44557303,9,0,1,4096,17,3733579027
989,17427440,218354,17645794,0,0,0,3072,6,8650548241
990,17436750,27120576,44557326,8,0,1,7168,6,8644513673
991,17442130,27115554,44557684,1,0,1,31232,6,3381617726
992,17445560,27112179,44557739,8,0,1,18944,6,5801543314
993,17473710,153222,17626932,2,0,0,512,11,930128052
994,17529150,27039751,44568901,5,0,1,41472,11,9135942895
995,17533470,27038970,44572440,1,0,1,16896,6,9743950583
996,17555540,27383786,44939326,9,0,1,31744,17,46405866
997,17586670,27403090,44989760,8,0,1,1024,6,6520682561
998,17594281,516168,18110449,7,0,0,81408,16,5357461627
999,17594521,491094,18085615,7,0,0,129536,16,9127345078
1000,17594740,352305,17947045,0,0,0,37376,6,8743498385
1001,17614960,27374823,44989783,4,0,1,8704,4,2260769372
1002,17630460,580871,18211331,2,0,0,4096,11,5547012289
1003,17641150,27576281,45217431,5,0,1,252416,11,5923274002
1004,17650430,27567024,45217454,9,0,1,9728,17,9319874844
1005,17654920,455700,18110620,9,0,0,512,17,1532072196
1006,17665880,27691887,45357767,8,0,1,42496,6,2555906674
1007,17675810,259832,17935642,9,0,0,512,17,5986475464
1008,17690910,27666880,45357790,9,0,1,19968,17,10200353022
1009,17695160,27730723,45425883,5,0,1,110080,11,8445203867
1010,17699600,248614,17948214,2,0,0,3584,11,6851858143
1011,17734459,571559,18306018,4,0,0,39936,4,1711948859
1012,17734931,834042,18568973,7,0,0,125952,16,9491968461
1013,17735780,27690126,45425906,8,0,1,19968,6,2335387530
1014,17746820,467895,18214715,9,0,0,3072,17,6582376490
1015,17788990,27848161,45637151,8,0,1,62464,6,3508944054
1016,17804620,27888978,45693598,5,0,1,107008,11,401858999
1017,17807140,381433,18188573,2,0,0,6656,11,7864664161
1018,17836770,27990628,45827398,1,0,1,60416,6,1465571057
1019,17852880,440939,18293819,8,0,0,101376,6,1208543726
1020,17886550,27940871,45827421,3,0,1,6144,0,221617563
1021,17918140,28010906,45929046,5,0,1,43520,11,9906103900
1022,17919430,28009639,45929069,1,0,1,512,6,9443111481
1023,17927510,799380,18726890,8,0,0,115712,6,5563245292
1024,17975830,828787,18804617,8,0,0,161280,6,6534992655
1025,17988850,27940749,45929599,9,0,1,512,17,7417185012
1026,17993981,583098,18577079,7,0,0,25600,16,10597216758
1027,18002370,27927268,45929638,9,0,1,5632,17,2769441855
1028,18009600,27920061,45929661,8,0,1,2048,6,7119387657
1029,18044200,27973031,46017231,5,0,1,135680,11,2871375065
1030,18047420,401898,18449318,2,0,0,6144,11,2352795217
1031,18051531,1086026,19137557,7,0,0,505856,16,6243095448
1032,18052549,1212400,19264949,4,0,0,44544,4,9931344814
1033,18061109,630486,18691595,4,0,0,240128,4,2717369083
1034,18063520,1332438,19395958,0,0,0,175104,6,5061381099
1035,18080650,1125617,19206267,0,0,0,91136,6,1733229702
1036,18097690,511051,18608741,9,0,0,2560,17,3407051963
1037,18119719,612342,18732061,4,0,0,16896,4,6240347698
1038,18178400,1164183,19342583,8,0,0,39936,6,8632325838
1039,18195419,983057,19178476,4,0,0,134144,4,412070615
1040,18202130,27930757,46132887,5,0,1,197632,11,1868210344
1041,18266290,27866799,46133089,5,0,1,49152,11,8778971041
1042,18267880,953893,19221773,5,0,0,49152,11,554445957
1043,18333749,996643,19330392,4,0,0,128000,4,1379344662
1044,18411930,27721182,46133112,1,0,1,1536,6,8207412127
1045,18444290,1377112,19821402,5,0,0,62464,11,7382944960
1046,18448450,1157408,19605858,0,0,0,284672,6,10310371184
1047,18553320,932562,19485882,0,0,0,52224,6,10106475170
1048,18554150,1356016,19910166,0,0,0,111616,6,3453920075
1049,18554610,1277616,19832226,9,0,0,12288,17,10395428884
1050,18575460,27557675,46133135,1,0,1,512,6,3399757557
1051,18587309,1032332,19619641,4,0,0,45056,4,8134697564
1052,18614680,27651600,46266280,5,0,1,79360,11,6327584398
1053,18624860,27641443,46266303,5,0,1,51200,11,6396804728
1054,18637930,1421379,20059309,8,0,0,67072,6,1763536572
1055,18652550,205327,18857877,2,0,0,1536,11,8608504899
1056,18765930,27500396,46266326,4,0,1,8192,4,9158346375
1057,18773320,433454,19206774,9,0,0,1536,17,624422889
1058,18828810,1662918,20491728,0,0,0,555008,6,190865554
1059,18847219,1434803,20282022,4,0,0,160256,4,241572292
1060,18847240,27419109,46266349,5,0,1,19968,11,8857817933
1061,18864990,1143830,20008820,0,0,0,12288,6,7457600784
1062,18868850,27397522,46266372,1,0,1,9216,6,6050816827
1063,18884969,1120060,20005029,4,0,0,311296,4,1917693825
1064,18954220,1139761,20093981,5,0,0,58880,11,4197986658
1065,18971720,1340300,20312020,5,0,0,95232,11,10315094281
1066,18996360,1042442,20038802,0,0,0,96256,6,3493311726
1067,19000600,1008859,20009459,2,0,0,2048,11,8223743234
1068,19022380,27301983,46324363,5,0,1,189440,11,9914761599
1069,19103580,1559968,20663548,5,0,0,251904,11,4769121749
1070,19110560,1831904,20942464,0,0,0,35840,6,2977688897
1071,19126230,1685196,20811426,8,0,0,98816,6,6205597909
1072,19163820,658541,19822361,0,0,0,3072,6,5278536593
1073,19193940,1485887,20679827,5,0,0,53248,11,382249385
1074,19228840,1274315,20503155,0,0,0,37376,6,6756036756
1075,19246359,1472999,20719358,4,0,0,129536,4,6274202910
1076,19263460,27060926,46324386,4,0,1,9216,4,8125111263
1077,19276839,1551759,20828598,4,0,0,13824,4,1661043407
1078,19277999,1285596,20563595,4,0,0,148480,4,6136339658
1079,19286170,27050976,46337146,1,0,1,84992,6,6476806409
1080,19316910,966063,20282973,9,0,0,3072,17,4303871409
1081,19337891,1702765,21040656,7,0,0,189440,16,4784692864
1082,19343150,972473,20315623,0,0,0,11776,6,2333843292
1083,19352370,26984799,46337169,3,0,1,13312,0,10258130765
1084,19355640,26981552,46337192,1,0,1,4096,6,9721748781
1085,19357721,26979494,46337215,0,0,1,28160,6,2410766239
1086,19403790,26937839,46341629,3,0,1,36864,0,3893887526
1087,19417210,26924442,46341652,6,0,1,26112,3,6951927764
1088,19427050,1139680,20566730,8,0,0,10240,6,6534049702
1089,19429530,1615673,21045203,5,0,0,14848,11,4836086813
1090,19489930,26851745,46341675,1,0,1,7168,6,3053975458
1091,19512890,1005442,20518332,8,0,0,3584,6,6166634137
1092,19522461,26819309,46341770,0,0,1,148992,6,5623395316
1093,19541210,26800591,46341801,1,0,1,4096,6,1028754410
1094,19543940,26797884,46341824,2,0,1,19456,11,5828463060
1095,19544161,2002587,21546748,7,0,0,487936,16,7863481402
1096,19552840,1620098,21172938,5,0,0,37888,11,10662282002
1097,19565400,1003905,20569305,2,0,0,8192,11,5106078782
1098,19590530,1520387,21110917,0,0,0,88064,6,8211196588
1099,19633550,883192,20516742,0,0,0,44544,6,4334682835
1100,19640960,26700887,46341847,3,0,1,3072,0,9346120193
1101,19650390,26691480,46341870,1,0,1,36352,6,8221747796
1102,19689391,27110280,46799671,0,0,1,143872,6,146659843
1103,19768770,27192466,46961236,3,0,1,16896,0,9135340895
1104,19796490,720735,20517225,8,0,0,1536,6,7079079682
1105,19809640,27256434,47066074,1,0,1,32256,6,6221189655
1106,19867650,943947,20811597,2,0,0,512,11,4509780229
1107,19868810,27197287,47066097,1,0,1,512,6,2662238485
1108,19904840,1179222,21084062,8,0,0,127488,6,8567382876
1109,19905710,27212647,47118357,4,0,1,10240,4,870946420
1110,19908391,27412502,47320893,0,0,1,169472,6,3452575325
1111,19913649,1205723,21119372,4,0,0,27648,4,3209209473
1112,19948741,27485312,47434053,0,0,1,82944,6,7573226139
1113,19970581,1612725,21583306,7,0,0,119296,16,5913292505
1114,19972040,1615249,21587289,5,0,0,11264,11,5166194626
1115,19987460,27451445,47438905,4,0,1,7680,4,407712469
1116,20010350,1956956,21967306,0,0,0,389632,6,292213681
1117,20057600,2302783,22360383,8,0,0,145408,6,805039474
1118,20071860,1699820,21771680,5,0,0,73216,11,2379794042
1119,20103040,27338131,47441171,4,0,1,3584,4,5279800107
1120,20107301,27362398,47469699,0,0,1,57344,6,7200550805
1121,20115830,647308,20763138,2,0,0,4608,11,2584150536
1122,20129550,1554022,21683572,8,0,0,315904,6,7821810514
1123,20137220,27351296,47488516,4,0,1,16384,4,10019091660
1124,20142720,27417858,47560578,3,0,1,6656,0,3709531141
1125,20153240,27411132,47564372,1,0,1,3072,6,9756148307
1126,20251349,2300375,22551724,4,0,0,62464,4,100861476
1127,20262330,1896043,22158373,5,0,0,238080,11,7478498566
1128,20302430,1782226,22084656,5,0,0,316416,11,6787685887
1129,20355800,27210475,47566275,4,0,1,18944,4,8901709662
1130,20383251,890866,21274117,7,0,0,32256,16,3536300485
1131,20398950,27169271,47568221,7,0,1,3072,16,8231565501
1132,20453480,944585,21398065,9,0,0,3584,17,7858112683
1133,20485210,27095822,47581032,4,0,1,11264,4,6614526918
1134,20506131,2229211,22735342,7,0,0,69120,16,4303097871
1135,20508370,27073328,47581698,1,0,1,1024,6,10467492800
1136,20512690,1194461,21707151,5,0,0,77312,11,7410135536
1137,20517570,1693785,22211355,5,0,0,131072,11,6929120864
1138,20522600,27192001,47714601,7,0,1,36864,16,8051373475
1139,20531140,27183484,47714624,7,0,1,28160,16,7681322721
1140,20574010,27168185,47742195,4,0,1,42496,4,2796147261
1141,20585090,1164267,21749357,0,0,0,87552,6,2090516924
1142,20589230,686938,21276168,2,0,0,6656,11,3984768592
1143,20617860,27159848,47777708,7,0,1,32768,16,10290973052
1144,20623880,27153851,47777731,4,0,1,11776,4,1924852276
1145,20652640,27183325,47835965,1,0,1,3584,6,8158704712
1146,20670120,27165868,47835988,3,0,1,22528,0,3588132839
1147,20672790,27163221,47836011,1,0,1,9728,6,9668462926
1148,20692260,671329,21363589,8,0,0,30720,6,7946318621
1149,20757650,1230583,21988233,0,0,0,68608,6,2137252323
1150,20775199,2185017,22960216,4,0,0,95232,4,4415030296
1151,20823570,948593,21772163,9,0,0,1536,17,1251269937
1152,20834800,27001234,47836034,4,0,1,512,4,9096829179
1153,20837510,26998563,47836073,3,0,1,7680,0,9579399139
1154,20860011,1311378,22171389,7,0,0,42496,16,8595211583
1155,20909350,26926746,47836096,1,0,1,6144,6,4689030087
1156,20929930,2232613,23162543,8,0,0,182272,6,7861893306
1157,20948800,26895945,47844745,4,0,1,9728,4,1930756606
1158,20979180,26909775,47888955,4,0,1,5632,4,4457474393
1159,20988159,734467,21722626,4,0,0,50688,4,909100829
1160,21022140,26866838,47888978,4,0,1,20480,4,5163961031
1161,21040781,1253008,22293789,7,0,0,84992,16,5071662551
1162,21092850,2268166,23361016,0,0,0,70656,6,349341206
1163,21235050,348739,21583789,9,0,0,1536,17,6908866337
1164,21238440,610135,21848575,2,0,0,8704,11,1313287985
1165,21265859,1625909,22891768,4,0,0,21504,4,2038469440
1166,21279300,267627,21546927,2,0,0,512,11,2922569802
1167,21297030,26593710,47890740,3,0,1,20992,0,9687159362
1168,21305790,26584973,47890763,6,0,1,3072,3,1772410202
1169,21319021,1362957,22681978,7,0,0,100352,16,7736028864
1170,21339020,1672723,23011743,5,0,0,12800,11,4694035520
1171,21339860,874075,22213935,9,0,0,7680,17,3827401274
1172,21380549,2200535,23581084,4,0,0,468992,4,8065190932
1173,21383880,26506906,47890786,3,0,1,2048,0,447234139
1174,21407560,1161416,22568976,0,0,0,39936,6,966244742
1175,21428130,1039995,22468125,0,0,0,61952,6,4568108760
1176,21449509,1300457,22749966,4,0,0,43008,4,8091660655
1177,21475090,26415719,47890809,1,0,1,11264,6,8906762159
1178,21522500,2183716,23706216,5,0,0,144384,11,6665837594
1179,21552291,2291336,23843627,7,0,0,58880,16,7909620003
1180,21592890,26297942,47890832,1,0,1,512,6,227562326
1181,21600740,485070,22085810,2,0,0,3584,11,1654988848
1182,21621060,26274810,47895870,1,0,1,23552,6,3427189269
1183,21623630,2538274,24161904,8,0,0,182272,6,8500980279
1184,21638550,26332092,47970642,1,0,1,20992,6,3213670336
1185,21642510,1996417,23638927,6,0,0,12800,3,7534080166
1186,21655670,1142179,22797849,9,0,0,2560,17,8997949757
1187,21713650,1608610,23322260,5,0,0,296448,11,5184328113
1188,21725540,26246075,47971615,1,0,1,12800,6,4789760931
1189,21729070,482456,22211526,9,0,0,512,17,9059212334
1190,21802710,1635439,23438149,0,0,0,55808,6,5451209643
1191,21862790,1342067,23204857,8,0,0,135168,6,4789983903
1192,21904930,1434543,23339473,5,0,0,37376,11,7028194396
1193,21907230,1876034,23783264,8,0,0,33280,6,2589109937
1194,21910270,26130304,48040574,1,0,1,10752,6,4782363292
1195,21925890,1072252,22998142,5,0,0,31744,11,9383022643
1196,21954300,528720,22483020,2,0,0,1536,11,2230315942
1197,21977950,1443156,23421106,8,0,0,168448,6,7391306512
1198,22065700,1707369,23773069,5,0,0,151552,11,10290895970
1199,22124681,777907,22902588,7,0,0,23552,16,2457570247
1200,22153530,1429332,23582862,2,0,0,1536,11,1041630747
1201,22155400,1479597,23634997,8,0,0,171008,6,10636039431
1202,22156751,923449,23080200,7,0,0,19456,16,10101455019
1203,22195560,25888639,48084199,2,0,1,66048,11,4075168197
1204,22234550,318905,22553455,9,0,0,5632,17,6949919645
1205,22265950,2227705,24493655,0,0,0,285696,6,10301313566
1206,22266730,2032903,24299633,8,0,0,95232,6,3961724717
1207,22274370,597393,22871763,9,0,0,2048,17,3061411929
1208,22277691,1049732,23327423,7,0,0,16896,16,9444118488
1209,22307410,25776812,48084222,2,0,1,9216,11,4205260490
1210,22336350,25772340,48108690,1,0,1,10752,6,6147359920
1211,22340560,25783541,48124101,1,0,1,4608,6,8353319668
1212,22344060,1451099,23795159,8,0,0,38912,6,327244858
1213,22345450,870046,23215496,5,0,0,34816,11,8359661514
1214,22372180,1289538,23661718,0,0,0,74752,6,9668792579
1215,22380950,595193,22976143,2,0,0,512,11,3395376566
1216,22384320,25741727,48126047,2,0,1,25600,11,4146535594
1217,22400620,1326258,23726878,8,0,0,66560,6,9613245657
1218,22413730,914340,23328070,9,0,0,2048,17,1702043267
1219,22438309,1668044,24106353,4,0,0,103936,4,731649763
1220,22453870,1431037,23884907,9,0,0,2048,17,829089264
1221,22495929,1554915,24050844,4,0,0,163840,4,2439554234
1222,22496140,1493939,23990079,5,0,0,111616,11,8378636414
1223,22506400,25634757,48141157,7,0,1,27136,16,7333834815
1224,22679481,1584126,24263607,7,0,0,24064,16,7279546964
1225,22685870,25466024,48151894,1,0,1,4608,6,8916195946
1226,22698300,25467605,48165905,7,0,1,16896,16,2608655171
1227,22749670,25416558,48166228,2,0,1,1024,11,9804758715
1228,22811131,558636,23369767,7,0,0,28672,16,8585200344
1229,22825740,25341794,48167534,2,0,1,2048,11,5161502560
1230,22843570,1157132,24000702,5,0,0,34816,11,3037610638
1231,22847040,859535,23706575,9,0,0,1024,17,8000513109
1232,22849130,1399732,24248862,5,0,0,162304,11,6376536796
1233,22879830,283820,23163650,9,0,0,3584,17,6359471645
1234,22879870,25371886,48251756,4,0,1,69120,4,4278395445
1235,22885450,696929,23582379,2,0,0,4096,11,5622212889
1236,22929040,733161,23662201,2,0,0,1536,11,1812859511
1237,22952440,25299331,48251771,4,0,1,7680,4,6793961334
1238,22974330,25277456,48251786,2,0,1,24064,11,7956428548
1239,23032080,2054394,25086474,5,0,0,288256,11,10063900874
1240,23041510,25247544,48289054,2,0,1,1536,11,7340854023
1241,23047380,25245005,48292385,2,0,1,18432,11,3312374028
1242,23053629,1555641,24609270,4,0,0,259072,4,5525644645
1243,23060240,1301728,24361968,5,0,0,3072,11,2792852847
1244,23060811,1456759,24517570,7,0,0,78336,16,2601445459
1245,23093820,25199871,48293691,2,0,1,2048,11,350200700
1246,23149130,737862,23886992,9,0,0,2048,17,10680693504
1247,23157131,1523406,24680537,7,0,0,42496,16,10092331768
1248,23163290,25135586,48298876,2,0,1,16384,11,1016872597
1249,23181340,1347516,24528856,2,0,0,2560,11,7575588831
1250,23204220,2132642,25336862,0,0,0,375808,6,7874343434
1251,23213440,2152864,25366304,5,0,0,62976,11,9211650020
1252,23271220,1066045,24337265,0,0,0,46592,6,4031719836
1253,23325070,24993255,48318325,2,0,1,6144,11,5353712450
1254,23326980,1201073,24528053,8,0,0,34304,6,8469108054
1255,23340360,24984029,48324389,2,0,1,2560,11,6324770696
1256,23365780,2462691,25828471,5,0,0,655360,11,4295232731
1257,23367740,24987161,48354901,7,0,1,17408,16,1197102160
1258,23390849,1015727,24406576,4,0,0,41984,4,6886589889
1259,23421680,24958085,48379765,7,0,1,10752,16,7092486974
1260,23465110,1145891,24611001,9,0,0,5632,17,9680068351
1261,23472180,24907600,48379780,7,0,1,1024,16,2147767987
1262,23557541,1184567,24742108,7,0,0,41984,16,4579458233
1263,23579060,671845,24250905,9,0,0,6656,17,6712131241
1264,23594310,24785485,48379795,2,0,1,7680,11,5514485249
1265,23643790,24743714,48387504,7,0,1,5632,16,7803521749
1266,23665310,2384618,26049928,5,0,0,382976,11,2712924474
1267,23676160,2459519,26135679,9,0,0,91136,17,313757760
1268,23695000,1478595,25173595,5,0,0,64512,11,624253686
1269,23751940,24637350,48389290,7,0,1,4096,16,10708315146
1270,23760470,24629486,48389956,7,0,1,1024,16,8787236230
1271,23769540,1384384,25153924,0,0,0,30208,6,1666045337
1272,23832550,1796226,25628776,9,0,0,260608,17,152634666
1273,23891750,24505618,48397368,7,0,1,11776,16,8439145397
1274,23908420,1960782,25869202,5,0,0,133632,11,9235853536
1275,23938269,1181033,25119302,4,0,0,57344,4,578825635
1276,23994580,2292110,26286690,8,0,0,206336,6,3323467882
1277,24044570,1888591,25933161,0,0,0,20992,6,6484270075
1278,24050910,1863181,25914091,5,0,0,139264,11,3006952985
1279,24103530,2489136,26592666,0,0,0,159744,6,9765899182
1280,24110070,2260374,26370444,8,0,0,3584,6,10038696277
1281,24127040,745374,24872414,8,0,0,45568,6,1156266809
1282,24132010,24274866,48406876,7,0,1,11776,16,5857523425
1283,24156410,24272157,48428567,7,0,1,5120,16,7112202622
1284,24157880,24282211,48440091,7,0,1,17920,16,8926032111
1285,24163370,24343107,48506477,7,0,1,8192,16,532000111
1286,24179320,24327188,48506508,8,0,1,5632,6,4634088291
1287,24226930,455346,24682276,0,0,0,5632,6,10600371053
1288,24243610,2836547,27080157,9,0,0,92160,17,8868754352
1289,24251620,1244220,25495840,9,0,0,146944,17,1171211967
1290,24259780,1824483,26084263,0,0,0,112640,6,147212586
1291,24269520,24544843,48814363,5,0,1,154624,11,10014721231
1292,24275011,1232872,25507883,7,0,0,39424,16,8195630205
1293,24282470,24531908,48814378,7,0,1,3072,16,8992008847
1294,24317950,2341975,26659925,9,0,0,220672,17,8142794138
1295,24323810,2043952,26367762,9,0,0,140800,17,2946302390
1296,24357981,1749899,26107880,7,0,0,59392,16,4798825944
1297,24364489,2820983,27185472,4,0,0,121344,4,10101329260
1298,24374180,24440213,48814393,2,0,1,6144,11,662497540
1299,24395500,3069135,27464635,8,0,0,212992,6,2882729118
1300,24400110,24416089,48816199,2,0,1,4608,11,4125299127
1301,24401649,784895,25186544,4,0,0,9728,4,4044378514
1302,24413210,1122410,25535620,9,0,0,32768,17,7029779022
1303,24429310,24388195,48817505,7,0,1,2048,16,6680635739
1304,24500580,2249835,26750415,8,0,0,87040,6,2461467273
1305,24506300,873765,25380065,5,0,0,4096,11,2287294687
1306,24521170,24298601,48819771,6,0,1,3584,3,8772049557
1307,24526010,2138392,26664402,0,0,0,4608,6,2094848807
1308,24542280,3016165,27558445,0,0,0,131584,6,10317365485
1309,24555281,1953701,26508982,7,0,0,78848,16,8289431969
1310,24565130,1524623,26089753,8,0,0,12288,6,4077478354
1311,24581380,24239697,48821077,6,0,1,2048,3,6256050943
1312,24586359,2521113,27107472,4,0,0,89600,4,2966228453
1313,24606480,1821576,26428056,8,0,0,138752,6,9888892717
1314,24609840,1316910,25926750,0,0,0,41472,6,8988456665
1315,24629790,24191633,48821423,6,0,1,512,3,5567500162
1316,24637690,24239510,48877200,6,0,1,9728,3,7592958123
1317,24654270,1670553,26324823,9,0,0,102912,17,5559969695
1318,24654990,1214695,25869685,5,0,0,1536,11,7221635450
1319,24668890,24208771,48877661,7,0,1,10240,16,1755367852
1320,24672070,24253536,48925606,7,0,1,11776,16,7854864462
1321,24679250,1614186,26293436,8,0,0,17920,6,5052793619
1322,24741711,2393803,27135514,7,0,0,22528,16,8425348328
1323,24762921,2532913,27295834,7,0,0,301568,16,9079443734
1324,24787670,2264392,27052062,0,0,0,363520,6,4772109172
1325,24796270,1866689,26662959,5,0,0,7680,11,7207884836
1326,24800740,1923132,26723872,9,0,0,72192,17,6297355346
1327,24808850,1332424,26141274,5,0,0,4096,11,7972789132
1328,24827870,1258124,26085994,5,0,0,5632,11,4907350901
1329,24855690,1513647,26369337,9,0,0,5120,17,1642741511
1330,24864190,24121879,48986069,6,0,1,25600,3,5804011702
1331,24881670,24128794,49010464,6,0,1,9728,3,1175826063
1332,24893520,2995735,27889255,8,0,0,475136,6,6215120948
1333,24901069,1773119,26674188,4,0,0,6656,4,5418678735
1334,24952740,24059350,49012090,2,0,1,2560,11,94582956
1335,24957540,2246355,27203895,9,0,0,60416,17,2813023943
1336,24978900,892720,25871620,9,0,0,6144,17,1035319932
1337,24994869,1761653,26756522,4,0,0,19968,4,5731621370
1338,25009370,24017431,49026801,2,0,1,33280,11,3512563227
1339,25021400,24029746,49051146,9,0,1,1536,17,10392776477
1340,25022670,2928749,27951419,9,0,0,72704,17,8711309375
1341,25030349,2531699,27562048,4,0,0,11776,4,257191466
1342,25058310,3581134,28639444,8,0,0,280064,6,2038205127
1343,25078420,23972912,49051332,9,0,1,13312,17,5303292923
1344,25079450,23971897,49051347,2,0,1,9216,11,2802009355
1345,25101440,3063265,28164705,9,0,0,146944,17,10019463712
1346,25116260,2032225,27148485,9,0,0,42496,17,9951922134
1347,25153939,1974656,27128595,4,0,0,69120,4,7616539322
1348,25157660,3239179,28396839,9,0,0,3072,17,10450148025
1349,25329691,2637844,27967535,7,0,0,28160,16,6949815538
1350,25344160,23708151,49052311,7,0,1,4096,16,9334815685
1351,25348410,23707087,49055497,9,0,1,8704,17,6271262729
1352,25461669,3261467,28723136,4,0,0,71680,4,8179691994
1353,25467880,23592763,49060643,7,0,1,8192,16,6142876939
1354,25495700,23571645,49067345,9,0,1,4096,17,7341069575
1355,25536430,23532541,49068971,7,0,1,2560,16,488901912
1356,25682840,23399815,49082655,6,0,1,39936,3,9201844147
1357,25684950,23446633,49131583,6,0,1,60928,3,3429601293
1358,25689470,3011320,28700790,0,0,0,200704,6,6236597073
1359,25696910,23545050,49241960,9,0,1,27648,17,5162556691
1360,25698150,23543825,49241975,7,0,1,3072,16,5644016476
1361,25714860,945720,26660580,5,0,0,2048,11,8533993189
1362,25749851,23737443,49487294,0,0,1,260608,6,2077818252
1363,25751180,536773,26287953,5,0,0,4096,11,22522025
1364,25754181,2576177,28330358,7,0,0,138752,16,10305110271
1365,25814510,2137719,27952229,5,0,0,1536,11,7546207396
1366,25833511,2652973,28486484,7,0,0,80384,16,10105403637
1367,25857310,1515566,27372876,5,0,0,1024,11,4730024519
1368,25878819,2566935,28445754,4,0,0,105984,4,7609821471
1369,25934799,3118108,29052907,4,0,0,454656,4,6300905864
1370,25936990,492813,26429803,0,0,0,5632,6,4579320932
1371,26057521,2747866,28805387,7,0,0,269824,16,6855246170
1372,26083020,23417590,49500610,6,0,1,18432,3,2872178267
1373,26210970,23289655,49500625,6,0,1,2560,3,5455810137
1374,26243640,23291094,49534734,9,0,1,27648,17,682478520
1375,26260090,3056013,29316103,8,0,0,96256,6,3401305645
1376,26273620,23277857,49551477,6,0,1,18432,3,5839811691
1377,26308340,1882816,28191156,5,0,0,9728,11,2156993272
1378,26376730,23178719,49555449,9,0,1,5632,17,2219449226
1379,26386450,1541539,27927989,8,0,0,94208,6,4894429267
1380,26400411,3255115,29655526,7,0,0,154112,16,10487269893
1381,26428311,3126034,29554345,7,0,0,483840,16,6536221007
1382,26487490,2402970,28890460,9,0,0,194560,17,2897301877
1383,26528081,2602686,29130767,7,0,0,93184,16,1860773876
1384,26530300,1810065,28340365,9,0,0,32768,17,7973935869
1385,26533820,23022602,49556422,6,0,1,12800,3,6670470212
1386,26560030,2271127,28831157,9,0,0,73728,17,5179207681
1387,26596750,3172128,29768878,5,0,0,512,11,4809013207
1388,26602540,22964932,49567472,9,0,1,512,17,10179899035
1389,26615140,23136418,49751558,6,0,1,77312,3,3344188307
1390,26617040,754012,27371052,0,0,0,5120,6,3432276023
1391,26641100,23110473,49751573,6,0,1,5120,3,4079260173
1392,26662510,23089086,49751596,9,0,1,14336,17,7563468683
1393,26690110,780476,27470586,8,0,0,19456,6,7556553402
1394,26707511,3297861,30005372,7,0,0,462336,16,6161519193
1395,26723400,23029654,49753054,9,0,1,6144,17,8746577205
1396,26816260,22936809,49753069,6,0,1,4096,3,7789553398
1397,26819390,1132356,27951746,5,0,0,1024,11,2010144393
1398,26838820,3376124,30214944,9,0,0,70144,17,3914063440
1399,26906930,22846154,49753084,2,0,1,3072,11,9949543458
1400,26927700,22825399,49753099,6,0,1,1536,3,9608243283
1401,26968740,22784382,49753122,9,0,1,5120,17,1379164513
1402,26986080,3502695,30488775,0,0,0,413696,6,6470055764
1403,27000630,22752507,49753137,4,0,1,1536,4,5602162210
1404,27012220,22740932,49753152,2,0,1,4608,11,4903256416
1405,27029920,22778892,49808812,4,0,1,58880,4,2910224345
1406,27046600,3273292,30319892,9,0,0,331776,17,5520013854
1407,27111140,22697687,49808827,4,0,1,6656,4,8510609742
1408,27125240,2643467,29768707,8,0,0,158720,6,4542408167
1409,27145090,2060054,29205144,5,0,0,1536,11,516958525
1410,27160201,1942103,29102304,7,0,0,31744,16,10330015120
1411,27168520,22640346,49808866,2,0,1,9216,11,470285587
1412,27180421,2080751,29261172,7,0,0,59392,16,1606532647
1413,27236850,3280609,30517459,9,0,0,16896,17,4458166219
1414,27274340,22548570,49822910,2,0,1,16896,11,2227210789
1415,27329620,22493546,49823166,4,0,1,9216,4,4178549541
1416,27343550,22493883,49837433,9,0,1,24576,17,6650830929
1417,27352630,292041,27644671,5,0,0,5120,11,7615349369
1418,27417380,22420969,49838349,4,0,1,7680,4,5384365487
1419,27444960,484292,27929252,8,0,0,4096,6,7573098985
1420,27448699,450571,27899270,4,0,0,32768,4,7498281534
1421,27473700,22366032,49839732,2,0,1,14848,11,10459080628
1422,27483990,22402501,49886491,5,0,1,62464,11,10698777568
1423,27485770,22406614,49892384,1,0,1,1024,6,8710450785
1424,27493250,22402360,49895610,2,0,1,5120,11,2462424735
1425,27528010,22384036,49912046,2,0,1,13824,11,10583193649
1426,27531980,22438162,49970142,1,0,1,43008,6,8848246051
1427,27555241,998856,28554097,7,0,0,16896,16,1059113336
1428,27561290,708787,28270077,5,0,0,1536,11,349422543
1429,27572760,2100269,29673029,8,0,0,57344,6,3663040265
1430,27585670,22384495,49970165,4,0,1,6656,4,8964952848
1431,27592399,434433,28026832,4,0,0,55808,4,7241316783
1432,27598571,1968597,29567168,7,0,0,41984,16,9407351224
1433,27635240,22334940,49970180,1,0,1,512,6,8794076668
1434,27643340,22326855,49970195,4,0,1,9728,4,3083024196
1435,27663070,22307140,49970210,9,0,1,6656,17,9935766152
1436,27671610,22363265,50034875,5,0,1,84480,11,8753223250
1437,27673430,22385173,50058603,4,0,1,1536,4,3523477806
1438,27735830,22331798,50067628,9,0,1,24576,17,1947972506
1439,27798040,568307,28366347,9,0,0,84480,17,8570622780
1440,27804820,2794052,30598872,9,0,0,81408,17,10646871721
1441,27916180,22157634,50073814,4,0,1,9728,4,5394344495
1442,27951170,2194540,30145710,9,0,0,337408,17,7195118459
1443,28028280,1823461,29851741,8,0,0,107008,6,331841859
1444,28048410,1643362,29691772,9,0,0,61440,17,2840850822
1445,28065330,2474616,30539946,9,0,0,73728,17,8834499697
1446,28067040,2432685,30499725,0,0,0,34304,6,1172465725
1447,28125700,2236951,30362651,0,0,0,140288,6,8697979768
1448,28172610,528663,28701273,8,0,0,1536,6,212248851
1449,28188350,21962988,50151338,5,0,1,91136,11,1398959331
1450,28222990,22068155,50291145,5,0,1,112640,11,8876677429
1451,28227370,936638,29164008,5,0,0,7680,11,4694625844
1452,28261740,377883,28639623,5,0,0,512,11,7596270137
1453,28263030,22028130,50291160,4,0,1,5632,4,4695495650
1454,28297090,1478823,29775913,8,0,0,19456,6,2777714119
1455,28321569,2387501,30709070,4,0,0,67072,4,5612080705
1456,28341540,1876383,30217923,8,0,0,9728,6,8974964192
1457,28394320,964560,29358880,5,0,0,3072,11,1382549576
1458,28394500,21896675,50291175,5,0,1,5632,11,2793120118
1459,28404840,21886350,50291190,4,0,1,3584,4,5469021816
1460,28406860,21884516,50291376,9,0,1,5632,17,7995055751
1461,28422650,2314055,30736705,9,0,0,90624,17,7109488669
1462,28431680,21860038,50291718,4,0,1,5632,4,6193446559
1463,28499750,1693759,30193509,0,0,0,156672,6,7933421489
1464,28502051,590566,29092617,7,0,0,3072,16,7239302148
1465,28529120,279558,28808678,0,0,0,10752,6,1316662272
1466,28542110,21750751,50292861,9,0,1,3584,17,9821604850
1467,28542390,21754453,50296843,4,0,1,17920,4,5127695797
1468,28577941,513701,29091642,7,0,0,126976,16,5024990429
1469,28640440,21686431,50326871,1,0,1,30720,6,34863564
1470,28693780,2061115,30754895,0,0,0,44544,6,2874316140
1471,28707149,994825,29701974,4,0,0,5120,4,1023727118
1472,28749990,1468791,30218781,5,0,0,1024,11,3446761861
1473,28813370,21518647,50332017,7,0,1,8192,16,9890948104
1474,28813880,21524039,50337919,9,0,1,20992,17,3528830565
1475,28822841,2195136,31017977,7,0,0,471552,16,6489409837
1476,28828210,21515163,50343373,9,0,1,22016,17,2029098016
1477,28829291,779240,29608531,7,0,0,135680,16,3197823023
1478,28932970,767413,29700383,8,0,0,28160,6,6662222938
1479,28975690,21371549,50347239,7,0,1,6144,16,5091900203
1480,28986110,21743304,50729414,5,0,1,592896,11,8884735067
1481,29009469,1679150,30688619,4,0,0,128512,4,674375841
1482,29020330,21790592,50810922,3,0,1,32256,0,2111963253
1483,29030270,1510627,30540897,5,0,0,3072,11,9938910454
1484,29031840,21797206,50829046,9,0,1,7168,17,8165937067
1485,29056031,2052268,31108299,7,0,0,196608,16,1771617223
1486,29059820,2093016,31152836,0,0,0,145920,6,10602211735
1487,29062250,21803514,50865764,9,0,1,42496,17,2954611946
1488,29085270,21802001,50887271,9,0,1,512,17,7488004249
1489,29085410,1757763,30843173,0,0,0,160768,6,7026763780
1490,29089730,1784502,30874232,8,0,0,101888,6,183884253
1491,29142560,21882188,51024748,9,0,1,24576,17,4413187649
1492,29305900,21718863,51024763,9,0,1,2048,17,4338907530
1493,29380969,1841459,31222428,4,0,0,219136,4,10167565582
1494,29412000,1636014,31048014,0,0,0,98304,6,6821275686
1495,29426950,21597836,51024786,9,0,1,1024,17,1536537158
1496,29495280,21530020,51025300,9,0,1,49664,17,1365536919
1497,29557900,21467415,51025315,4,0,1,7680,4,9596961860
1498,29585760,1768733,31354493,8,0,0,110080,6,9180264343
1499,29597340,21428801,51026141,4,0,1,10752,4,9592059541
1500,29610849,432002,30042851,4,0,0,122880,4,4295101587
1501,29641260,21384896,51026156,9,0,1,14336,17,5449191308
1502,29736480,892094,30628574,9,0,0,12800,17,2479648249
1503,29776820,21249842,51026662,4,0,1,4608,4,9454129064
1504,29780889,437525,30218414,4,0,0,1536,4,5991700760
1505,29808310,1494967,31303277,0,0,0,105472,6,3408773574
1506,29903609,643863,30547472,4,0,0,21504,4,5891462030
1507,29914030,598266,30512296,8,0,0,40960,6,2905662349
1508,29929310,21097367,51026677,4,0,1,13312,4,8636101459
1509,29931490,21095202,51026692,4,0,1,2048,4,2890684955
1510,29942830,21083885,51026715,9,0,1,6656,17,5570208167
1511,29958000,21068770,51026770,9,0,1,7680,17,2290308055
1512,29960930,21066132,51027062,4,0,1,1024,4,5468724336
1513,29961170,21073024,51034194,5,0,1,41984,11,357399176
1514,29976400,512858,30489258,5,0,0,1536,11,7903943020
1515,29984040,1498085,31482125,0,0,0,70144,6,5795252853
1516,29986100,21056364,51042464,9,0,1,14848,17,8796753638
1517,30003060,21047599,51050659,4,0,1,30720,4,4149706591
1518,30008760,21058517,51067277,9,0,1,24576,17,3716042464
1519,30057761,516246,30574007,7,0,0,87040,16,3693040711
1520,30102300,20980595,51082895,9,0,1,13312,17,5387583818
1521,30146190,592900,30739090,8,0,0,7680,6,3691589019
1522,30154470,446840,30601310,5,0,0,7680,11,1584937376
1523,30180790,20908621,51089411,9,0,1,23040,17,4592761265
1524,30399660,20691697,51091357,4,0,1,3072,4,150083333
1525,30406320,20686574,51092894,9,0,1,23552,17,5713988547
1526,30419260,629097,31048357,5,0,0,1024,11,5944797924
1527,30475830,1137623,31613453,0,0,0,125952,6,6212862714
1528,30544001,1270504,31814505,7,0,0,153088,16,3576030281
1529,30669641,1222236,31891877,7,0,0,99840,16,2850793682
1530,30773850,20327507,51101357,4,0,1,6144,4,8203312172
1531,30820789,435665,31256454,4,0,0,37376,4,6250358285
1532,30844330,395897,31240227,8,0,0,58368,6,9773617026
1533,30848690,911325,31760015,8,0,0,234496,6,597363934
1534,30878230,953818,31832048,8,0,0,57344,6,9093007920
1535,30908990,20213209,51122199,6,0,1,41984,3,8082271313
1536,30918420,20203933,51122353,4,0,1,8704,4,3883372101
1537,30918800,1154037,32072837,8,0,0,56320,6,5813337725
1538,30925829,461867,31387696,4,0,0,37888,4,8356186922
1539,30934920,20256068,51190988,5,0,1,56320,11,7503691685
1540,30950420,20255853,51206273,5,0,1,41984,11,994841852
1541,30980710,20296239,51276949,5,0,1,108544,11,2066104434
1542,30992220,696284,31688504,0,0,0,246272,6,8984036781
1543,30995480,20283415,51278895,3,0,1,3072,0,4987136780
1544,31068690,1448931,32517621,0,0,0,176640,6,9091537147
1545,31077670,20819545,51897215,5,0,1,263168,11,6602443599
1546,31102810,20808438,51911248,3,0,1,10240,0,4298957457
1547,31109841,816270,31926111,7,0,0,49664,16,3739942963
1548,31110300,1143550,32253850,9,0,0,13312,17,2443826624
1549,31110479,1335594,32446073,4,0,0,169984,4,5508880952
1550,31118020,1345750,32463770,5,0,0,512,11,7116272591
1551,31151980,1097791,32249771,9,0,0,242688,17,2967362702
1552,31172909,1290027,32462936,4,0,0,55296,4,10335483628
1553,31174180,2156269,33330449,9,0,0,409088,17,2047396910
1554,31184370,1279205,32463575,5,0,0,2048,11,1365810723
1555,31215020,20723652,51938672,6,0,1,19456,3,982865957
1556,31233990,20726706,51960696,6,0,1,39424,3,9980492580
1557,31245200,522630,31767830,0,0,0,25600,6,1678685088
1558,31247360,21004025,52251385,5,0,1,212480,11,8327559003
1559,31264360,20987040,52251400,4,0,1,1024,4,5809660538
1560,31267340,1560225,32827565,9,0,0,340992,17,2347995878
1561,31375610,21003114,52378724,5,0,1,230912,11,4536780952
1562,31388450,20994498,52382948,6,0,1,4096,3,8912043308
1563,31434031,1447275,32881306,7,0,0,70144,16,8126239277
1564,31469411,1555852,33025263,7,0,0,105984,16,3689214697
1565,31484850,20898444,52383294,6,0,1,512,3,2490808396
1566,31501300,20886820,52388120,4,0,1,7680,4,7176495973
1567,31543699,1059818,32603517,4,0,0,132096,4,9934310055
1568,31553820,20874212,52428032,5,0,1,47104,11,9320031099
1569,31566010,20866609,52432619,4,0,1,10240,4,6760367467
1570,31589770,20878830,52468600,5,0,1,18432,11,1768093632
1571,31593080,2140145,33733225,0,0,0,354304,6,2046731542
1572,31597170,20880068,52477238,5,0,1,20480,11,8052596620
1573,31609570,20917296,52526866,6,0,1,14848,3,3696027045
1574,31621810,1886205,33508015,9,0,0,190976,17,5530668754
1575,31630811,1263834,32894645,7,0,0,31744,16,3186086355
1576,31670360,2126855,33797215,9,0,0,93184,17,2874024742
1577,31674170,20853682,52527852,6,0,1,1536,3,6697297139
1578,31727180,2197655,33924835,9,0,0,243712,17,2663053145
1579,31733190,21309385,53042575,5,0,1,204800,11,9082315529
1580,31738260,21580803,53319063,1,0,1,45056,6,7200121614
1581,31745510,1433381,33178891,9,0,0,63488,17,6371542609
1582,31764440,1755461,33519901,9,0,0,38912,17,506708508
1583,31770840,761240,32532080,5,0,0,1536,11,8348199087
1584,31771360,21548369,53319729,1,0,1,1024,6,8465447312
1585,31773439,2370798,34144237,4,0,0,413184,4,9912715336
1586,31835180,21544578,53379758,6,0,1,51712,3,7096097489
1587,31838760,21630776,53469536,6,0,1,15360,3,4952484684
1588,31858130,21612712,53470842,4,0,1,2048,4,4086699074
1589,31891310,21580198,53471508,6,0,1,1024,3,8928988805
1590,31913640,1015614,32929254,8,0,0,49152,6,1093348089
1591,31914130,774350,32688480,5,0,0,1536,11,3231210473
1592,31932840,1864938,33797778,5,0,0,1536,11,215072267
1593,31934840,21542262,53477102,1,0,1,18432,6,9042027605
1594,31952200,21739845,53692045,7,0,1,15872,16,9056262669
1595,31979920,21712156,53692076,6,0,1,13312,3,7415733292
1596,31980590,1788218,33768808,0,0,0,116736,6,6478943790
1597,31993820,833956,32827776,5,0,0,512,11,8799564123
1598,31994850,21823888,53818738,6,0,1,52736,3,1859494594
1599,32053400,21821323,53874723,1,0,1,53760,6,2260982847
1600,32055070,1777355,33832425,9,0,0,113664,17,7175904085
1601,32062940,2176152,34239092,9,0,0,27136,17,380574301
1602,32063021,970681,33033702,7,0,0,27648,16,9427401649
1603,32090410,21784328,53874738,6,0,1,3072,3,6140325347
1604,32097370,21790502,53887872,4,0,1,1536,4,2095436100
1605,32158530,21729357,53887887,1,0,1,9216,6,6587284484
1606,32189490,21698412,53887902,1,0,1,512,6,2028427468
1607,32212260,1175191,33387451,9,0,0,186880,17,7773025732
1608,32229100,21658817,53887917,1,0,1,8704,6,7503896943
1609,32234619,1288573,33523192,4,0,0,10752,4,9627042632
1610,32277420,21626603,53904023,4,0,1,23552,4,3185380710
1611,32318000,21741349,54059349,5,0,1,436224,11,9600335187
1612,32369800,827846,33197646,8,0,0,40960,6,8710784401
1613,32443830,21615534,54059364,1,0,1,5120,6,4619299115
1614,32448410,613894,33062304,9,0,0,11264,17,4534753509
1615,32460720,21598667,54059387,1,0,1,18944,6,9295473661
1616,32478480,1820689,34299169,8,0,0,10240,6,1235620435
1617,32508020,1469930,33977950,0,0,0,74240,6,8771983547
1618,32509711,573084,33082795,7,0,0,15872,16,10549202446
1619,32521780,21537694,54059474,4,0,1,4096,4,9356578207
1620,32571531,1920850,34492381,7,0,0,74240,16,4690406433
1621,32582260,1413801,33996061,8,0,0,59392,6,3474421404
1622,32594660,1360640,33955300,9,0,0,58368,17,819621702
1623,32595630,1341856,33937486,9,0,0,41472,17,5218298989
1624,32600900,21526422,54127322,5,0,1,204800,11,3490038729
1625,32621331,1609470,34230801,7,0,0,89600,16,9156158510
1626,32663440,21479749,54143189,4,0,1,24064,4,8279265223
1627,32720921,1454843,34175764,7,0,0,103424,16,6861786704
1628,32726440,832959,33559399,0,0,0,11776,6,1800558669
1629,32737100,1682266,34419366,8,0,0,299008,6,1118651344
1630,32783430,2053611,34837041,8,0,0,181248,6,6837714129
1631,32788821,1388986,34177807,7,0,0,6656,16,1647202806
1632,32797221,1528491,34325712,7,0,0,87040,16,9515565678
1633,32860500,21317648,54178148,1,0,1,22528,6,3929065952
1634,32868360,21380572,54248932,5,0,1,178176,11,4410858952
1635,32897980,1397934,34295914,9,0,0,186368,17,10216011816
1636,32951060,21325162,54276222,5,0,1,27648,11,548537012
1637,32972560,1909424,34881984,0,0,0,147456,6,7754863447
1638,33014520,1313727,34328247,9,0,0,8192,17,1800307525
1639,33021059,1760735,34781794,4,0,0,37376,4,4920276375
1640,33028470,21254317,54282787,1,0,1,3584,6,8615201816
1641,33068540,21257662,54326202,1,0,1,77312,6,4310337858
1642,33075989,1678779,34754768,4,0,0,257536,4,6965865026
1643,33084900,21243490,54328390,1,0,1,7168,6,393989249
1644,33089551,1586734,34676285,7,0,0,121344,16,1868479082
1645,33102670,1095778,34198448,0,0,0,67072,6,8277329825
1646,33131010,21198660,54329670,3,0,1,14336,0,2081807676
1647,33141490,21301119,54442609,5,0,1,131072,11,5347645783
1648,33155960,21316449,54472409,5,0,1,19968,11,6956280614
1649,33163490,1785281,34948771,8,0,0,192512,6,176273721
1650,33196690,21280605,54477295,3,0,1,19456,0,5849469654
1651,33206291,997195,34203486,7,0,0,3584,16,747030678
1652,33214390,987989,34202379,0,0,0,12800,6,205835505
1653,33251231,1919234,35170465,7,0,0,293888,16,5969196091
1654,33300690,21606202,54906892,5,0,1,489472,11,6715915499
1655,33327360,1950631,35277991,0,0,0,91136,6,3579589409
1656,33353131,1666877,35020008,7,0,0,97280,16,9079227021
1657,33408190,1783982,35192172,0,0,0,71168,6,6300373821
1658,33418260,21567956,54986216,5,0,1,177664,11,1195449377
1659,33496550,1491236,34987786,9,0,0,128000,17,870767741
1660,33512960,22268491,55781451,5,0,1,571392,11,10509067835
1661,33533650,1779216,35312866,5,0,0,3072,11,9037236851
1662,33579140,22218061,55797201,3,0,1,26624,0,8243357871
1663,33590410,964237,34554647,5,0,0,512,11,657006975
1664,33592220,905399,34497619,5,0,0,512,11,7458995955
1665,33599140,3320997,36920137,8,0,0,244736,6,6473345185
1666,33629640,1682275,35311915,8,0,0,58368,6,779671864
1667,33653541,1116850,34770391,7,0,0,51200,16,9680430311
1668,33672780,22133967,55806747,5,0,1,25600,11,4030254049
1669,33675500,2138853,35814353,0,0,0,300544,6,1428918337
1670,33684640,2519607,36204247,8,0,0,486912,6,6342526040
1671,33697409,2884136,36581545,4,0,0,148992,4,2284219174
1672,33785860,22589156,56375016,5,0,1,441856,11,10383799326
1673,33810630,22873207,56683837,5,0,1,306688,11,7349583370
1674,33836410,2415330,36251740,0,0,0,152576,6,2389234015
1675,33843700,22840495,56684195,1,0,1,20480,6,6537746586
1676,33855870,22828348,56684218,2,0,1,11264,11,4598165037
1677,33870140,22814101,56684241,5,0,1,30208,11,1414234402
1678,33870920,22813344,56684264,1,0,1,12288,6,1971943737
1679,33893000,22805974,56698974,5,0,1,42496,11,1756103389
1680,33912700,22868443,56781143,5,0,1,66048,11,6867535579
1681,33939970,22841196,56781166,1,0,1,1024,6,7074843770
1682,33942201,2504506,36446707,7,0,0,95744,16,4409950835
1683,33954220,675102,34629322,5,0,0,1536,11,6710904365
1684,33965390,1024963,34990353,5,0,0,8192,11,10650402418
1685,33989340,22791849,56781189,1,0,1,11776,6,4287165941
1686,33993530,22787682,56781212,1,0,1,512,6,5874644197
1687,34006400,1887517,35893917,0,0,0,114688,6,2868798546
1688,34042500,2267473,36309973,9,0,0,96768,17,4729884109
1689,34049550,3420786,37470336,8,0,0,132608,6,9412455937
1690,34063290,2691188,36754478,0,0,0,290304,6,4066925996
1691,34065279,1652940,35718219,4,0,0,93696,4,7444692588
1692,34070470,22710765,56781235,3,0,1,15872,0,9110040983
1693,34071200,1547927,35619127,9,0,0,8704,17,210964315
1694,34072370,22709067,56781437,3,0,1,20992,0,6859947788
1695,34080200,22701260,56781460,1,0,1,9728,6,8001696299
1696,34082950,1410819,35493769,5,0,0,11776,11,2630146630
1697,34092110,3114328,37206438,9,0,0,59904,17,2401024821
1698,34119550,22844871,56964421,5,0,1,355840,11,472625096
1699,34175740,3485294,37661034,5,0,0,72704,11,1092774462
1700,34214010,22755928,56969938,4,0,1,5632,4,7665568817
1701,34220199,1622413,35842612,4,0,0,92672,4,2220419591
1702,34258210,3605324,37863534,8,0,0,225792,6,2672636453
1703,34270480,1452278,35722758,9,0,0,14848,17,5230756837
1704,34273590,22697654,56971244,4,0,1,2048,4,5083252179
1705,34285930,4308844,38594774,9,0,0,151040,17,2432349883
1706,34305790,22726519,57032309,5,0,1,54272,11,6494930872
1707,34323900,22769672,57093572,5,0,1,74752,11,10719055787
1708,34329441,1925301,36254742,7,0,0,9216,16,2576890514
1709,34337120,2494455,36831575,8,0,0,133632,6,9439656225
1710,34353890,4074740,38428630,0,0,0,275456,6,8402079257
1711,34357930,22736410,57094340,8,0,1,11776,6,9283919648
1712,34369940,22729226,57099166,1,0,1,7680,6,704717409
1713,34379410,22758873,57138283,4,0,1,2048,4,10106841055
1714,34385879,1645780,36031659,4,0,0,1024,4,2662192581
1715,34401850,2977881,37379731,5,0,0,205312,11,2747220425
1716,34406580,3861349,38267929,9,0,0,323584,17,9986608776
1717,34435810,22705699,57141509,4,0,1,5120,4,6301670147
1718,34439599,1812312,36251911,4,0,0,512,4,9903705232
1719,34446040,22702105,57148145,8,0,1,18944,6,6436688680
1720,34451830,3576089,38027919,0,0,0,105472,6,1105100398
1721,34460709,2506861,36967570,4,0,0,7680,4,6914400647
1722,34463560,22696862,57160422,8,0,1,27648,6,10367999084
1723,34472619,3000095,37472714,4,0,0,4608,4,681573970
1724,34480879,2627838,37108717,4,0,0,2560,4,8549753414
1725,34486400,22798874,57285274,3,0,1,39424,0,7909797737
1726,34510560,22774916,57285476,3,0,1,2560,0,8977712482
1727,34516931,1132324,35649255,7,0,0,28672,16,1091256004
1728,34521820,727571,35249391,5,0,0,2560,11,805176194
1729,34554160,22738299,57292459,8,0,1,1024,6,4774487587
1730,34568930,22771401,57340331,4,0,1,41472,4,5865559224
1731,34636230,22708289,57344519,3,0,1,15360,0,2479753486
1732,34672930,22685110,57358040,4,0,1,512,4,6060428391
1733,34702240,1963771,36666011,0,0,0,131584,6,7015278121
1734,34731840,1683307,36415147,8,0,0,21504,6,9536361447
1735,34746680,22611616,57358296,3,0,1,9216,0,4302282147
1736,34747099,2269344,37016443,4,0,0,3072,4,5381272589
1737,34751759,2383675,37135434,4,0,0,2048,4,9107074571
1738,34757950,2485577,37243527,0,0,0,48128,6,5689896845
1739,34795060,3480848,38275908,0,0,0,26112,6,1762191957
1740,34803431,4182850,38986281,7,0,0,218624,16,2684422631
1741,34852230,22790277,57642507,5,0,1,145408,11,6761811625
1742,34864701,4340601,39205302,7,0,0,184320,16,8731240990
1743,34883270,22788788,57672058,4,0,1,26112,4,6064911926
1744,34906740,22766944,57673684,8,0,1,2560,6,1137455090
1745,34908380,22859892,57768272,6,0,1,29696,3,504307149
1746,34919250,2095603,37014853,9,0,0,155136,17,7579908870
1747,34935680,22832615,57768295,6,0,1,3072,3,7100828375
1748,34942501,4339369,39281870,7,0,0,32256,16,7791479124
1749,34973039,1506204,36479243,4,0,0,2560,4,6354954452
1750,34987180,22781138,57768318,4,0,1,15872,4,1575897313
1751,35004430,22763911,57768341,4,0,1,10240,4,3400899060
1752,35011970,22758757,57770727,8,0,1,22528,6,9959445112
1753,35021970,22748780,57770750,4,0,1,10752,4,258055662
1754,35040169,454083,35494252,4,0,0,1536,4,6216549936
1755,35043520,22758422,57801942,4,0,1,47616,4,6845157249
1756,35075890,2435846,37511736,5,0,0,79872,11,777525579
1757,35077331,1127555,36204886,7,0,0,2048,16,5736959341
1758,35088360,22838639,57926999,5,0,1,102912,11,6246572984
1759,35129410,22798415,57927825,3,0,1,4608,0,10214925586
1760,35134079,1071142,36205221,4,0,0,1024,4,7075210750
1761,35160320,22767528,57927848,4,0,1,25088,4,3149328535
1762,35163440,22764431,57927871,4,0,1,512,4,6073253846
1763,35174640,22753254,57927894,5,0,1,31232,11,7717196736
1764,35182789,1908029,37090818,4,0,0,3072,4,7872313181
1765,35194640,3938365,39133005,5,0,0,187392,11,3682469463
1766,35201210,1763178,36964388,5,0,0,144896,11,2827878459
1767,35220470,22707447,57927917,8,0,1,3072,6,7814813725
1768,35244300,22699574,57943874,5,0,1,84992,11,2262280224
1769,35251730,22697990,57949720,8,0,1,3584,6,873571002
1770,35264430,22687556,57951986,8,0,1,3584,6,2096453640
1771,35277860,22693151,57971011,6,0,1,14848,3,9448478668
1772,35287010,22685947,57972957,8,0,1,3072,6,10025559938
1773,35307979,1067136,36375115,4,0,0,1024,4,6735013341
1774,35329730,22645493,57975223,6,0,1,3584,3,8645447797
1775,35336580,4391226,39727806,8,0,0,147968,6,7260118396
1776,35371210,4253943,39625153,8,0,0,443904,6,492174890
1777,35382710,2047175,37429885,8,0,0,161792,6,7721485119
1778,35392110,22600529,57992639,8,0,1,24064,6,2632747149
1779,35400370,22903527,58303897,5,0,1,470016,11,243119345
1780,35408940,22895303,58304243,4,0,1,512,4,4699573611
1781,35421940,22886489,58308429,8,0,1,6656,6,2671407571
1782,35481120,22837325,58318445,3,0,1,16896,0,10621356874
1783,35484930,22835461,58320391,4,0,1,3072,4,3518599172
1784,35486990,2078782,37565772,5,0,0,116736,11,6837546839
1785,35487151,1095057,36582208,7,0,0,2048,16,8430995540
1786,35492470,22971726,58464196,5,0,1,137216,11,8229085579
1787,35508540,23015556,58524096,4,0,1,5632,4,4300928705
1788,35558520,23102297,58660817,6,0,1,71168,3,1386190306
1789,35559989,1520426,37080415,4,0,0,1536,4,5505233730
1790,35563950,23096890,58660840,8,0,1,3072,6,8889975485
1791,35593170,23117932,58711102,5,0,1,151040,11,6183891254
1792,35600040,23195171,58795211,6,0,1,18432,3,10544138138
1793,35656120,23139114,58795234,6,0,1,22016,3,4889121863
1794,35667150,23129378,58796528,6,0,1,5632,3,9090345852
1795,35692350,2279037,37971387,5,0,0,288768,11,9775713077
1796,35695050,23101501,58796551,6,0,1,4608,3,8658475653
1797,35704480,4450314,40154794,8,0,0,651264,6,692932677
1798,35715071,4239437,39954508,7,0,0,6656,16,1372644930
1799,35741330,23055244,58796574,5,0,1,4096,11,8715578506
1800,35751870,23044727,58796597,8,0,1,6656,6,4892762098
1801,35760770,23035850,58796620,8,0,1,25088,6,9329092605
1802,35772290,4179832,39952122,0,0,0,10240,6,3992514404
1803,35780900,23052249,58833149,5,0,1,115712,11,1786971287
1804,35783640,23051660,58835300,6,0,1,16384,3,7955007451
1805,35847750,22992935,58840685,6,0,1,4608,3,5365458575
1806,35850070,1815112,37665182,0,0,0,3072,6,9181895622
1807,35873820,2746740,38620560,9,0,0,15360,17,2650669973
1808,35882830,22960761,58843591,8,0,1,4608,6,7263913239
1809,35888080,22993090,58881170,8,0,1,26112,6,8925557949
1810,35933180,2380035,38313215,9,0,0,122368,17,6264896343
1811,35933630,22958495,58892125,6,0,1,27136,3,8971759165
1812,35964820,22987686,58952506,8,0,1,97280,6,778882167
1813,35968320,22985948,58954268,8,0,1,2048,6,7016567949
1814,35991210,2004558,37995768,9,0,0,74240,17,3580124612
1815,35994480,22959811,58954291,6,0,1,1024,3,6175604033
1816,36037950,22983314,59021264,5,0,1,81920,11,6473749800
1817,36051031,1192823,37243854,7,0,0,1024,16,7370197685
1818,36075000,22988369,59063369,8,0,1,49664,6,9458797090
1819,36078230,2091084,38169314,5,0,0,65536,11,3939983982
1820,36172490,23004227,59176717,5,0,1,130048,11,6102559053
1821,36208210,1666586,37874796,0,0,0,6656,6,1143938365
1822,36211480,22965260,59176740,5,0,1,4096,11,6807926054
1823,36236480,1402387,37638867,9,0,0,45568,17,3986887207
1824,36253250,22933863,59187113,6,0,1,3072,3,1925219917
1825,36306461,658754,36965215,7,0,0,2560,16,1929449238
1826,36310120,22881819,59191939,5,0,1,7680,11,6484724097
1827,36335980,22908621,59244601,8,0,1,24576,6,4238550619
1828,36342510,22902189,59244699,8,0,1,32768,6,2451074787
1829,36359311,1248326,37607637,7,0,0,512,16,8634640513
1830,36373420,22882721,59256141,8,0,1,5632,6,2871906319
1831,36393949,986625,37380574,4,0,0,2560,4,5532766787
1832,36394660,22866627,59261287,6,0,1,8192,3,5029938716
1833,36431581,1997228,38428809,7,0,0,512,16,5849263603
1834,36432830,23105904,59538734,5,0,1,244736,11,8658440954
1835,36475599,356147,36831746,4,0,0,512,4,149438474
1836,36548610,1600713,38149323,0,0,0,54784,6,523735315
1837,36555130,3726701,40281831,5,0,0,273408,11,10149167626
1838,36558390,2511273,39069663,0,0,0,108544,6,716607117
1839,36564440,1779428,38343868,0,0,0,12288,6,5103088340
1840,36579210,2078447,38657657,8,0,0,50176,6,8032906228
1841,36580849,434643,37015492,4,0,0,2048,4,7891495689
1842,36601260,23019161,59620421,5,0,1,148480,11,3010756547
1843,36618190,23136623,59754813,9,0,1,81408,17,6547724122
1844,36623250,2244870,38868120,5,0,0,168960,11,1656344501
1845,36693570,23118500,59812070,5,0,1,231424,11,2756066326
1846,36705530,23165047,59870577,8,0,1,21504,6,902475008
1847,36738210,3572917,40311127,8,0,0,18432,6,2373938011
1848,36742710,3859686,40602396,9,0,0,123392,17,8325853628
1849,36777731,2141915,38919646,7,0,0,512,16,536522371
1850,36792149,3160308,39952457,4,0,0,1024,4,2343081829
1851,36817820,653475,37471295,9,0,0,3072,17,1110151189
1852,36820810,408038,37228848,8,0,0,16384,6,7549149811
1853,36831670,23038930,59870600,8,0,1,7680,6,5773116763
1854,36833701,1618300,38452001,7,0,0,1536,16,4609695637
1855,36865790,1006963,37872753,8,0,0,30208,6,9401207673
1856,36866340,2053127,38919467,8,0,0,168448,6,321047628
1857,36879030,1159920,38038950,0,0,0,35840,6,6518098458
1858,36887669,987454,37875123,4,0,0,1024,4,4134374716
1859,36887691,23083577,59971268,0,0,1,208384,6,7378591373
1860,36906060,1067073,37973133,8,0,0,5120,6,8082295689
1861,36917060,2089064,39006124,5,0,0,65024,11,1932733289
1862,37016969,2189612,39206581,4,0,0,4096,4,8049558838
1863,37018281,23112473,60130754,0,0,1,197120,6,8878329313
1864,37041000,23140560,60181560,3,0,1,33792,0,9990463682
1865,37072879,3551006,40623885,4,0,0,2048,4,6691080537
1866,37100830,23090604,60191434,9,0,1,5632,17,2876749063
1867,37107171,864387,37971558,7,0,0,512,16,10069673455
1868,37140640,466826,37607466,0,0,0,14848,6,8720531614
1869,37254980,1082750,38337730,0,0,0,80384,6,3430287297
1870,37264160,2618153,39882313,8,0,0,249344,6,8339536537
1871,37270881,1069220,38340101,7,0,0,7680,16,9996026048
1872,37291030,22934284,60225314,5,0,1,121856,11,3136967763
1873,37312771,22943292,60256063,0,0,1,23552,6,5391266727
1874,37319680,3583093,40902773,8,0,0,354304,6,10527048960
1875,37319830,2074157,39393987,0,0,0,84992,6,1603606810
1876,37352411,3422835,40775246,7,0,0,4608,16,9051665019
1877,37356790,2422854,39779644,0,0,0,166912,6,6637396931
1878,37360560,22982802,60343362,5,0,1,67072,11,1589869703
1879,37386690,957989,38344679,5,0,0,2560,11,9690282895
1880,37411081,22932304,60343385,0,0,1,48128,6,4336659684
1881,37427930,23057745,60485675,3,0,1,90624,0,8097279750
1882,37463610,1996297,39459907,9,0,0,129536,17,9304631294
1883,37470570,1675562,39146132,5,0,0,43008,11,5937989599
1884,37479000,2469979,39948979,9,0,0,218624,17,7457240810
1885,37488891,23035909,60524800,0,0,1,37888,6,927776010
1886,37505660,1756457,39262117,8,0,0,32768,6,9197547771
1887,37528550,23009512,60538062,8,0,1,12800,6,4638185435
1888,37540430,1075427,38615857,5,0,0,69120,11,3699728326
1889,37563590,2242697,39806287,8,0,0,77824,6,7860032296
1890,37565470,23166544,60732014,5,0,1,171008,11,3615864011
1891,37636161,23781580,61417741,0,0,1,1053184,6,3104598456
1892,37648460,2916309,40564769,5,0,0,146944,11,5182859711
1893,37660800,3416675,41077475,5,0,0,476672,11,875632965
1894,37672851,23819348,61492199,0,0,1,174592,6,130200383
1895,37687970,933081,38621051,8,0,0,1536,6,9147118517
1896,37720790,1961684,39682474,9,0,0,152064,17,5190737641
1897,37741870,2214400,39956270,9,0,0,5632,17,1746426042
1898,37754441,2028088,39782529,7,0,0,6656,16,8359517485
1899,37756290,3569400,41325690,5,0,0,480768,11,5609484574
1900,37767340,3669887,41437227,8,0,0,232960,6,64269781
1901,37869441,2285844,40155285,7,0,0,1536,16,2896865875
1902,37869670,23635891,61505561,5,0,1,13824,11,10566093613
1903,37938550,2576877,40515427,9,0,0,26112,17,7449109909
1904,37953480,2433222,40386702,9,0,0,91136,17,1098865309
1905,37961440,23545427,61506867,8,0,1,2048,6,2359347865
1906,37983660,1165459,39149119,9,0,0,9728,17,5645736199
1907,38014290,3111880,41126170,0,0,0,159744,6,2517000393
1908,38029419,1653280,39682699,4,0,0,512,4,2606009399
1909,38043721,23512506,61556227,0,0,1,122368,6,9477729054
1910,38048450,23520972,61569422,5,0,1,22528,11,97088096
1911,38050280,3465756,41516036,0,0,0,240640,6,9456555517
1912,38079040,1557079,39636119,0,0,0,34816,6,2757633721
1913,38085800,3731745,41817545,0,0,0,48128,6,4639315004
1914,38104931,1312390,39417321,7,0,0,1024,16,385853868
1915,38122901,23464303,61587204,0,0,1,44544,6,7909541615
1916,38132610,23459420,61592030,8,0,1,7680,6,8328952185
1917,38136769,882993,39019762,4,0,0,1536,4,1573093376
1918,38146480,3412100,41558580,8,0,0,29696,6,5731424356
1919,38151329,3291356,41442685,4,0,0,1536,4,1463306865
1920,38208570,3805393,42013963,9,0,0,193536,17,4670474132
1921,38213530,23384659,61598189,8,0,1,6144,6,6881467796
1922,38259019,1521436,39780455,4,0,0,2560,4,5990149949
1923,38262140,2914675,41176815,8,0,0,120320,6,6765163147
1924,38357841,3084345,41442186,7,0,0,15872,16,4631662155
1925,38365271,23260129,61625400,0,0,1,69632,6,5009662310
1926,38409900,23237714,61647614,5,0,1,48640,11,4584209274
1927,38415760,23267780,61683540,8,0,1,10240,6,9399641168
1928,38486600,23196963,61683563,5,0,1,6144,11,9245934723
1929,38518829,2659551,41178380,4,0,0,4096,4,10261653402
1930,38528690,3217460,41746150,0,0,0,206848,6,10069969776
1931,38555351,1601892,40157243,7,0,0,3584,16,8323744761
1932,38578700,23104886,61683586,8,0,1,6656,6,7648877871
1933,38580330,1618166,40198496,0,0,0,88064,6,3767535119
1934,38599270,23192099,61791369,5,0,1,164864,11,10422174588
1935,38606870,23208662,61815532,8,0,1,6656,6,10119172069
1936,38608269,1549933,40158202,4,0,0,3072,4,10555532522
1937,38609409,1016079,39625488,4,0,0,1024,4,5449275034
1938,38653090,2865949,41519039,5,0,0,9728,11,9994114422
1939,38666999,1061766,39728765,4,0,0,3072,4,5354622310
1940,38720710,1786738,40507448,0,0,0,94720,6,8653351255
1941,38742040,23186162,61928202,5,0,1,198144,11,2936063814
1942,38761740,23176473,61938213,8,0,1,36352,6,5373884834
1943,38763600,23177545,61941145,8,0,1,4608,6,8927760793
1944,38780990,2858566,41639556,9,0,0,134144,17,2762869909
1945,38827630,2975228,41802858,8,0,0,99328,6,8150364178
1946,38839220,23107417,61946637,8,0,1,17920,6,4643783336
1947,38859479,1296609,40156088,4,0,0,2560,4,9159460903
1948,38876870,3344428,42221298,0,0,0,58880,6,4678229513
1949,38891890,23069934,61961824,6,0,1,19968,3,7880712513
1950,38893880,3555527,42449407,5,0,0,208896,11,5156628325
1951,38916860,23049150,61966010,8,0,1,6656,6,7678592910
1952,38926130,3154000,42080130,0,0,0,217088,6,8375684879
1953,38953650,1467326,40420976,8,0,0,24576,6,9512022001
1954,38987021,1464572,40451593,7,0,0,2048,16,4532427453
1955,39021590,1498384,40519974,5,0,0,14848,11,8641975181
1956,39026280,1905913,40932193,5,0,0,37376,11,3363760864
1957,39031900,3772527,42804427,5,0,0,106496,11,2558061344
1958,39032020,1651625,40683645,8,0,0,36864,6,10338673691
1959,39042170,1129471,40171641,9,0,0,44032,17,8181729086
1960,39054980,3954416,43009396,8,0,0,225280,6,6156537012
1961,39063211,1700730,40763941,7,0,0,3584,16,3639470363
1962,39080511,1306526,40387037,7,0,0,1024,16,5068196084
1963,39090200,2041305,41131505,8,0,0,17408,6,5278277942
1964,39098850,22906377,62005227,5,0,1,34304,11,2210260587
1965,39105670,3528524,42634194,8,0,0,146432,6,8493672529
1966,39137610,22942949,62080559,5,0,1,109568,11,4756069144
1967,39203390,22891000,62094390,5,0,1,24576,11,486011339
1968,39213510,22907340,62120850,5,0,1,25088,11,9877582168
1969,39261401,1023230,40284631,7,0,0,2048,16,410277221
1970,39306870,23157859,62464729,5,0,1,363008,11,630140009
1971,39313750,1606986,40920736,9,0,0,58880,17,1859346293
1972,39331180,3988090,43319270,9,0,0,179200,17,446517596
1973,39350320,23352588,62702908,5,0,1,229376,11,9260508340
1974,39383910,23339012,62722922,7,0,1,11264,16,3277980681
1975,39399761,23425908,62825669,0,0,1,425472,6,4085116188
1976,39402091,1367180,40769271,7,0,0,1536,16,2403932592
1977,39402319,1774767,41177086,4,0,0,512,4,10202302094
1978,39423520,23402815,62826335,5,0,1,1024,11,3492094376
1979,39485980,23356855,62842835,8,0,1,15360,6,3586378444
1980,39555580,23342268,62897848,5,0,1,122368,11,3716417924
1981,39600201,23307619,62907820,0,0,1,15872,6,9286833900
1982,39674099,1094681,40768780,4,0,0,9216,4,6099504112
1983,39697200,23287053,62984253,8,0,1,33280,6,2458964346
1984,39698550,3191574,42890124,8,0,0,113152,6,7323673396
1985,39754550,23238558,62993108,8,0,1,12288,6,1471803984
1986,39770150,23300813,63070963,8,0,1,18432,6,7744981985
1987,39808431,23435460,63243891,0,0,1,152064,6,6540533611
1988,39809670,3727790,43537460,8,0,0,62976,6,10227688160
1989,39814180,1325952,41140132,8,0,0,28160,6,4212066762
1990,39860950,1822153,41683103,9,0,0,142848,17,9595086464
1991,39884330,23377235,63261565,5,0,1,6656,11,6043587254
1992,39890831,23885570,63776401,0,0,1,366592,6,8354641839
1993,39890941,1475197,41366138,7,0,0,3072,16,3524119497
1994,39901521,23914082,63815603,0,0,1,87552,6,3916452129
1995,39983290,1381889,41365179,0,0,0,127488,6,1699885916
1996,39993599,1185584,41179183,4,0,0,2560,4,10465649042
1997,40022570,3748632,43771202,5,0,0,178688,11,6433409048
1998,40058050,23758847,63816897,5,0,1,37376,11,2559697769
1999,40063271,1262910,41326181,7,0,0,1536,16,6398484497
2000,40084760,23732168,63816928,5,0,1,22528,11,5805121679
2001,40115071,23773872,63888943,0,0,1,273408,6,4180469551
2002,40162010,2007457,42169467,9,0,0,57344,17,1847111357
2003,40193820,23697607,63891427,8,0,1,15872,6,1050237596
2004,40204100,23704883,63908983,8,0,1,17920,6,10643667917
2005,40224620,1312569,41537189,9,0,0,25600,17,3278128736
2006,40239660,4106667,44346327,8,0,0,442368,6,5866981683
2007,40242570,3821996,44064566,8,0,0,161280,6,337230168
2008,40249140,23682686,63931826,5,0,1,45056,11,5938193934
2009,40255260,1274106,41529366,9,0,0,33792,17,6881817332
2010,40264440,23669652,63934092,8,0,1,3584,6,7069098996
2011,40265550,23683738,63949288,8,0,1,48640,6,1448568624
2012,40269830,23697990,63967820,8,0,1,24064,6,9820159943
2013,40293520,23679485,63973005,4,0,1,16384,4,4817362414
2014,40338520,1204932,41543452,0,0,0,20480,6,9828878656
2015,40471110,23520112,63991222,8,0,1,64000,6,760678921
2016,40475551,1361228,41836779,7,0,0,16896,16,1744525333
2017,40482980,2606878,43089858,0,0,0,51712,6,8482475033
2018,40491010,1340598,41831608,8,0,0,46080,6,8442232548
2019,40498140,4059094,44557234,9,0,0,56320,17,3716159265
2020,40521670,2150224,42671894,9,0,0,60416,17,2510254293
2021,40545959,3359396,43905355,4,0,0,3072,4,1989926012
2022,40546931,23478931,64025862,0,0,1,83968,6,3481125832
2023,40668590,3820569,44489159,8,0,0,464384,6,1538142098
2024,40723840,3074253,43798093,0,0,0,65536,6,1022434330
2025,40816950,23230216,64047166,8,0,1,76288,6,8689803463
2026,40818580,23231499,64050079,7,0,1,512,16,2807308756
2027,40827989,1447696,42275685,4,0,0,1536,4,3217327782
2028,40835120,4281701,45116821,8,0,0,415744,6,2329089540
2029,40853670,23196563,64050233,7,0,1,8704,16,1625615445
2030,40862550,4061411,44923961,5,0,0,1065984,11,8198197308
2031,40868200,23212780,64080980,8,0,1,39424,6,4581632021
2032,40982050,2084794,43066844,0,0,0,33792,6,386315162
2033,41020840,2129276,43150116,5,0,0,87040,11,9169841513
2034,41035760,4233041,45268801,0,0,0,168448,6,6705271987
2035,41057219,1233957,42291176,4,0,0,1024,4,3214025952
2036,41163750,4391869,45555619,0,0,0,423424,6,3064569568
2037,41169050,22923272,64092322,7,0,1,30720,16,8574226895
2038,41191480,22902072,64093552,2,0,1,22016,11,4596220619
2039,41269451,1297739,42567190,7,0,0,2048,16,2270903318
2040,41289040,3893994,45183034,5,0,0,139264,11,5981324877
2041,41309330,4384066,45693396,9,0,0,90112,17,9896824364
2042,41327740,2255496,43583236,0,0,0,24576,6,3514251002
2043,41359800,1410602,42770402,9,0,0,5632,17,4489280808
2044,41366450,2759135,44125585,5,0,0,200192,11,6014567555
2045,41392830,22733256,64126086,8,0,1,20992,6,1127256737
2046,41394891,2144587,43539478,7,0,0,3072,16,1186132012
2047,41418209,1494041,42912250,4,0,0,3072,4,7382115858
2048,41425160,22711742,64136902,8,0,1,17408,6,5745168492
2049,41451280,3906464,45357744,9,0,0,291840,17,9259276901
2050,41459330,22722720,64182050,8,0,1,65536,6,5264971541
2051,41475810,3950042,45425852,5,0,0,222720,11,5402409170
2052,41490721,1831068,43321789,7,0,0,8192,16,1429366116
2053,41490790,22698920,64189710,1,0,1,31744,6,6987961205
2054,41511029,1599747,43110776,4,0,0,1536,4,3649366662
2055,41541521,1703709,43245230,7,0,0,6144,16,203137262
2056,41547999,1865601,43413600,4,0,0,512,4,8799984603
2057,41564580,2975261,44539841,0,0,0,96256,6,2965893227
2058,41574020,22626679,64200699,8,0,1,24576,6,9309433492
2059,41576380,22631540,64207920,1,0,1,25088,6,2908848389
2060,41577430,2128682,43706112,5,0,0,30720,11,3861476490
2061,41601249,2390031,43991280,4,0,0,1536,4,139478982
2062,41709880,22502866,64212746,8,0,1,7680,6,4647371535
2063,41710070,4117289,45827359,9,0,0,211456,17,3972924247
2064,41769060,4248140,46017200,0,0,0,287232,6,4799867454
2065,41785261,2360749,44146010,7,0,0,2048,16,876648088
2066,41811070,22436362,64247432,8,0,1,5632,6,9010055441
2067,41827860,3934869,45762729,5,0,0,226816,11,6924439066
2068,41829140,4214010,46043150,0,0,0,84992,6,136045027
2069,41836840,3772333,45609173,9,0,0,174592,17,5161631306
2070,41849880,2126615,43976495,8,0,0,34816,6,5886101969
2071,41921240,3984516,45905756,9,0,0,257024,17,7723033566
2072,41928890,2199682,44128572,9,0,0,9728,17,4604438514
2073,41960130,22289248,64249378,1,0,1,3072,6,8199633252
2074,42041280,1805790,43847070,8,0,0,13312,6,3464849349
2075,42042340,2111506,44153846,9,0,0,2560,17,8967824275
2076,42047591,1930019,43977610,7,0,0,3584,16,5083844422
2077,42055610,22208683,64264293,1,0,1,49152,6,8362953193
2078,42066420,22201739,64268159,7,0,1,6144,16,10504679739
2079,42093340,2417150,44510490,5,0,0,69632,11,2110354875
2080,42118210,4014654,46132864,5,0,0,32768,11,7793473795
2081,42132020,1997511,44129531,9,0,0,3072,17,9839570649
2082,42163301,1816048,43979349,7,0,0,5632,16,8430333721
2083,42173290,2174354,44347644,9,0,0,1536,17,3639241106
2084,42176130,22149032,64325162,7,0,1,77824,16,614490465
2085,42190400,22142474,64332874,7,0,1,23040,16,4074536679
2086,42227410,2987627,45215037,0,0,0,104960,6,2159295335
2087,42236600,2332246,44568846,5,0,0,36352,11,7836101633
2088,42237749,2109404,44347153,4,0,0,2560,4,6697115715
2089,42274710,22156733,64431443,5,0,1,72192,11,1878963529
2090,42289200,22146749,64435949,1,0,1,7168,6,10152916209
2091,42312520,22348702,64661222,1,0,1,31232,6,4017963
2092,42422900,22242188,64665088,1,0,1,6144,6,5876283814
2093,42426779,3617361,46044140,4,0,0,512,4,6995716986
2094,42459640,22346931,64806571,2,0,1,17920,11,9969182912
2095,42475260,22331334,64806594,1,0,1,8704,6,10280749375
2096,42527450,2411853,44939303,5,0,0,48640,11,3912756107
2097,42554960,22354273,64909233,9,0,1,10240,17,5044728507
2098,42606130,2383607,44989737,0,0,0,165376,6,4518296804
2099,42612521,1927507,44540028,7,0,0,512,16,725788156
2100,42687580,22221676,64909256,2,0,1,2048,11,3829511911
2101,42689230,3433627,46122857,5,0,0,184320,11,9261893410
2102,42705091,1852570,44557661,7,0,0,1024,16,9056835997
2103,42713791,2210661,44924452,7,0,0,1536,16,1353357820
2104,42717890,22191698,64909588,9,0,1,5120,17,9825410666
2105,42740830,22168912,64909742,1,0,1,8704,6,4727858654
2106,42746630,22173943,64920573,9,0,1,17408,17,4225571453
2107,42757510,2382422,45139932,0,0,0,75776,6,7006599141
2108,42775760,2214366,44990126,9,0,0,1024,17,10725680343
2109,42800430,22122409,64922839,2,0,1,3584,11,4612379109
2110,42822351,2535618,45357969,7,0,0,512,16,2039603048
2111,42828670,22315748,65144418,5,0,1,138240,11,8009489349
2112,42843970,3422287,46266257,0,0,0,248320,6,6199527929
2113,42854590,2701364,45555954,9,0,0,1024,17,1108851730
2114,42932650,2731824,45664474,5,0,0,89600,11,8057019022
2115,42962620,22311449,65274069,2,0,1,54784,11,2087007923
2116,42968340,22305752,65274092,2,0,1,37376,11,4654259405
2117,42968790,22341431,65310221,9,0,1,8704,17,10443345973
2118,42976810,22362676,65339486,5,0,1,32256,11,5148729499
2119,42985450,2155129,45140579,9,0,0,2048,17,3444506348
2120,42987510,22881129,65868639,5,0,1,164352,11,6346417762
2121,42989930,22878732,65868662,1,0,1,6656,6,5128830271
2122,42996900,2220508,45217408,9,0,0,7680,17,3749768595
2123,43007430,22918374,65925804,9,0,1,59392,17,8532625909
2124,43039350,2626567,45665917,9,0,0,4608,17,6963496382
2125,43060660,22865167,65925827,9,0,1,28160,17,4535904275
2126,43067020,2570108,45637128,5,0,0,91648,11,1565821279
2127,43101030,2592545,45693575,9,0,0,512,17,8836307491
2128,43106520,2320056,45426576,9,0,0,512,17,2944977387
2129,43107320,2821703,45929023,8,0,0,76288,6,1137736936
2130,43132420,2293977,45426397,9,0,0,1536,17,2766280113
2131,43135590,2627318,45762908,5,0,0,512,11,10603026091
2132,43191830,22734020,65925850,2,0,1,512,11,7413554914
2133,43227840,2962734,46190574,5,0,0,188416,11,693780837
2134,43239140,2805819,46044959,9,0,0,2560,17,1790852978
2135,43242040,22689547,65931587,5,0,1,109056,11,4205245033
2136,43310330,22695342,66005672,2,0,1,1024,11,3785509956
2137,43322770,22729280,66052050,9,0,1,3584,17,3888364223
2138,43395401,2534159,45929560,7,0,0,1536,16,8363005071
2139,43403680,22648393,66052073,2,0,1,20480,11,3757599269
2140,43421269,2622692,46043961,4,0,0,2560,4,8356334187
2141,43447640,2857599,46305239,0,0,0,127488,6,4083050005
2142,43451390,22601681,66053071,3,0,1,98816,0,2103382516
2143,43476130,2590544,46066674,8,0,0,71168,6,2742931953
2144,43504600,23925803,67430403,5,0,1,736256,11,4165478886
2145,43523740,23906686,67430426,9,0,1,49664,17,2096156498
2146,43534050,23896399,67430449,2,0,1,7680,11,1315611633
2147,43541640,23888832,67430472,2,0,1,15872,11,3291255865
2148,43570290,2754050,46324340,5,0,0,54784,11,7218539015
2149,43599750,23830753,67430503,5,0,1,182784,11,202453885
2150,43615080,23815446,67430526,9,0,1,19968,17,8858614832
2151,43640629,2666996,46307625,4,0,0,3584,4,2758815862
2152,43694680,23735869,67430549,6,0,1,6144,3,5743850037
2153,43703619,2429447,46133066,4,0,0,512,4,4165127294
2154,43709560,23721012,67430572,9,0,1,2560,17,9524470627
2155,43726650,23703945,67430595,9,0,1,5120,17,6726450818
2156,43878061,2428449,46306510,7,0,0,4096,16,1997053538
2157,43915740,2421383,46337123,5,0,0,27648,11,2691918695
2158,43921940,2419666,46341606,0,0,0,14336,6,3135829087
2159,43947890,23483219,67431109,5,0,1,67072,11,5415604915
2160,43982390,2343423,46325813,9,0,0,4608,17,9591588155
2161,43984269,2344407,46328676,4,0,0,9216,4,1573464478
2162,43989390,23441742,67431132,2,0,1,12800,11,10329629794
2163,43994450,23436705,67431155,2,0,1,5120,11,10512067942
2164,44062930,2315118,46378048,8,0,0,102400,6,9092095162
2165,44093941,2307788,46401729,7,0,0,4096,16,8953223739
2166,44152370,23278808,67431178,5,0,1,59392,11,8480190301
2167,44169600,23261601,67431201,2,0,1,14848,11,5566200306
2168,44177180,23254044,67431224,7,0,1,26624,16,3282610848
2169,44272970,2265644,46538614,5,0,0,73728,11,659327386
2170,44273179,2069822,46343001,4,0,0,3584,4,3069446721
2171,44279600,3434978,47714578,8,0,0,337920,6,9192632187
2172,44293670,2772381,47066051,5,0,0,143360,11,8789054312
2173,44317510,2643703,46961213,8,0,0,246272,6,7355961115
2174,44325790,23167691,67493481,5,0,1,136192,11,7440756469
2175,44326330,3054558,47380888,0,0,0,54784,6,2693430990
2176,44335890,2353568,46689458,0,0,0,138752,6,8304560689
2177,44362160,23159478,67521638,8,0,1,45056,6,6880211470
2178,44409880,23182518,67592398,5,0,1,174080,11,3328674538
2179,44457761,2284283,46742044,7,0,0,4096,16,1782199417
2180,44555140,23091948,67647088,2,0,1,44032,11,3410295892
2181,44567320,23080114,67647434,8,0,1,512,6,4121216759
2182,44610850,2611393,47222243,0,0,0,39936,6,10616476288
2183,44699630,2532991,47232621,9,0,0,1536,17,10703266398
2184,44701420,22947960,67649380,8,0,1,3072,6,567324840
2185,44719320,22936115,67655435,8,0,1,28672,6,721004478
2186,44772090,22965622,67737712,8,0,1,37376,6,9814125383
2187,44849300,23094429,67943729,8,0,1,78848,6,1292904858
2188,44851800,1888973,46740773,5,0,0,95744,11,5379530961
2189,44918560,2401975,47320535,0,0,0,201216,6,7669141398
2190,44920500,2968432,47888932,8,0,0,144896,6,8396831981
2191,44973500,2141691,47115191,8,0,0,155648,6,11405536
2192,44981231,1883686,46864917,7,0,0,2048,16,8542110428
2193,45003170,22999270,68002440,2,0,1,18944,11,2935650793
2194,45019650,22983354,68003004,9,0,1,10752,17,389299715
2195,45062060,23286755,68348815,5,0,1,183296,11,4543088262
2196,45062090,2325123,47387213,5,0,0,15360,11,805175564
2197,45070350,23336722,68407072,2,0,1,31232,11,4941958412
2198,45082250,23325180,68407430,2,0,1,51712,11,447734575
2199,45102270,2733672,47835942,5,0,0,190976,11,5654432491
2200,45127890,1990444,47118334,9,0,0,10240,17,4349409785
2201,45130070,1837340,46967410,9,0,0,512,17,8298400619
2202,45133400,2274794,47408194,0,0,0,44544,6,5663588776
2203,45181510,23417626,68599136,5,0,1,54784,11,7839070476
2204,45218850,23441841,68660691,5,0,1,65536,11,4152239794
2205,45221590,23475078,68696668,8,0,1,15360,6,7930145931
2206,45226080,23504330,68730410,2,0,1,9216,11,10613978795
2207,45237670,23499524,68737194,8,0,1,24576,6,10321221244
2208,45259080,2271179,47530259,5,0,0,101888,11,6669801134
2209,45327749,2414423,47742172,4,0,0,1536,4,1119141193
2210,45361191,1657580,47018771,7,0,0,512,16,6051177420
2211,45427520,2349798,47777318,5,0,0,115200,11,9481301475
2212,45456110,1938146,47394256,8,0,0,23040,6,6425985121
2213,45460030,2028463,47488493,8,0,0,58880,6,2574398226
2214,45461880,23449578,68911458,5,0,1,134144,11,5197968529
2215,45486800,2077549,47564349,9,0,0,6144,17,842305467
2216,45510480,1978371,47488851,9,0,0,1024,17,10114827435
2217,45526490,1794380,47320870,9,0,0,1024,17,9449528026
2218,45528770,23389918,68918688,2,0,1,30720,11,4229193594
2219,45529430,1447062,46976492,9,0,0,4096,17,682693420
2220,45562729,1562132,47124861,4,0,0,8704,4,3932082206
2221,45579230,23339481,68918711,8,0,1,17408,6,7969523275
2222,45620390,2157263,47777653,9,0,0,1024,17,7056133185
2223,45624090,23507906,69131996,5,0,1,68096,11,10060834056
2224,45646410,23504436,69150846,6,0,1,11776,3,7741053891
2225,45649819,1573071,47222890,4,0,0,2048,4,1051826330
2226,45659020,1810656,47469676,0,0,0,23552,6,4490724541
2227,45666330,23553893,69220223,2,0,1,15360,11,6622388804
2228,45707740,23862946,69570686,2,0,1,30208,11,10431639154
2229,45730220,1608800,47339020,9,0,0,3072,17,3889891795
2230,45750170,2186874,47937044,0,0,0,53760,6,1499588038
2231,45773440,24077020,69850460,2,0,1,20992,11,4960453566
2232,45790079,1409123,47199202,4,0,0,512,4,309447734
2233,45816430,24034061,69850491,2,0,1,5632,11,6103667998
2234,45826919,1890559,47717478,4,0,0,1536,4,5074041716
2235,45856710,23993804,69850514,2,0,1,7168,11,5139274881
2236,45879930,2371811,48251741,5,0,0,104448,11,8542461360
2237,45901600,2175377,48076977,5,0,0,60928,11,5806100499
2238,45910581,1484018,47394599,7,0,0,1024,16,9158562682
2239,45964720,24219211,70183931,8,0,1,7680,6,8434051662
2240,45966530,1775151,47741681,0,0,0,79360,6,4888385042
2241,46020310,24163644,70183954,2,0,1,14336,11,7612499746
2242,46044280,24139697,70183977,8,0,1,21504,6,2948400196
2243,46058870,24405781,70464651,5,0,1,114176,11,6706470941
2244,46068930,1503575,47572505,9,0,0,4608,17,8121239943
2245,46071130,1645857,47716987,9,0,0,7680,17,7747866482
2246,46106030,24368339,70474369,5,0,1,59392,11,9543273737
2247,46120000,1479730,47599730,9,0,0,5120,17,6646580703
2248,46121560,24716242,70837802,5,0,1,74240,11,10327626566
2249,46145929,1698793,47844722,4,0,0,512,4,9188540768
2250,46162690,24831854,70994544,8,0,1,25088,6,4646069643
2251,46204160,2015742,48219902,5,0,0,131072,11,2008148362
2252,46214700,24831678,71046378,8,0,1,5120,6,5860030208
2253,46219670,25365494,71585164,5,0,1,244736,11,1893534999
2254,46256500,1639347,47895847,8,0,0,16384,6,8591266258
2255,46327799,1562918,47890717,4,0,0,5632,4,717250318
2256,46381130,1463413,47844543,5,0,0,27648,11,5873134976
2257,46399220,25193028,71592248,8,0,1,4096,6,9128325373
2258,46422870,1863486,48286356,5,0,0,108544,11,9039356333
2259,46429200,25241972,71671172,5,0,1,38400,11,10083401534
2260,46465391,1447373,47912764,7,0,0,1536,16,2250322876
2261,46552680,1468467,48021147,8,0,0,19968,6,1429447684
2262,46565560,25124355,71689915,5,0,1,37888,11,888976501
2263,46577220,1471402,48048622,9,0,0,3584,17,8515429051
2264,46611140,25115282,71726422,8,0,1,11264,6,7110028564
2265,46688190,25138560,71826750,5,0,1,138240,11,243113610
2266,46700540,1211733,47912273,0,0,0,53760,6,7932156862
2267,46777780,1219707,47997487,0,0,0,12800,6,7579302767
2268,46796140,25038140,71834280,3,0,1,16384,0,8717290802
2269,46807140,25069205,71876345,5,0,1,74752,11,2733499847
2270,46824610,1259566,48084176,0,0,0,23552,6,7751599163
2271,46840520,25041272,71881792,8,0,1,11264,6,7302792646
2272,46866680,25966002,72832682,5,0,1,526336,11,7492085292
2273,46875040,25999344,72874384,5,0,1,22016,11,9468740792
2274,46996950,1001925,47998875,9,0,0,3072,17,1673676854
2275,47013420,25911777,72925197,5,0,1,51712,11,2564486710
2276,47023490,25983193,73006683,4,0,1,52736,4,1994046600
2277,47028350,25978999,73007349,3,0,1,1024,0,6501116368
2278,47030330,1505989,48536319,0,0,0,97792,6,8718977192
2279,47042030,1464400,48506430,5,0,0,211968,11,6629449942
2280,47069590,25974956,73044546,5,0,1,98304,11,10051047045
2281,47099160,1009139,48108299,9,0,0,6144,17,7258202175
2282,47101430,1222936,48324366,8,0,0,17408,6,8151614252
2283,47108641,1025496,48134137,7,0,0,1024,16,10353315748
2284,47124390,26136087,73260477,3,0,1,10752,0,3195933516
2285,47137460,1242290,48379750,8,0,0,37888,6,1783837718
2286,47175711,990171,48165882,7,0,0,3072,16,3661952605
2287,47178940,26081560,73260500,8,0,1,3072,6,3241286547
2288,47180750,26498097,73678847,5,0,1,282112,11,9517568568
2289,47206740,26526753,73733493,8,0,1,12288,6,1264758667
2290,47217180,1387800,48604980,5,0,0,60416,11,8916316630
2291,47227350,939694,48167044,9,0,0,1024,17,3998792628
2292,47238610,26958763,74197373,5,0,1,155648,11,8201771990
2293,47247900,26987747,74235647,4,0,1,1024,4,4275194612
2294,47259100,27183286,74442386,5,0,1,80896,11,3540298462
2295,47262191,1347458,48609649,7,0,0,512,16,5640572877
2296,47272501,1114988,48387489,7,0,0,5120,16,559440838
2297,47281600,27160809,74442409,9,0,1,16384,17,9795448127
2298,47318701,1072304,48391005,7,0,0,1536,16,1928080838
2299,47339790,1020162,48359952,5,0,0,3072,11,4278550164
2300,47340250,27149300,74489550,4,0,1,45568,4,4544327595
2301,47342521,1098375,48440896,7,0,0,512,16,759707724
2302,47354930,27138806,74493736,3,0,1,6656,0,38656203
2303,47370180,918851,48289031,0,0,0,8704,6,7194575056
2304,47441450,27071815,74513265,4,0,1,5120,4,2371863691
2305,47463660,27075335,74538995,5,0,1,30208,11,9845142688
2306,47466430,27799053,75265483,5,0,1,252416,11,4950167111
2307,47491870,1149989,48641859,9,0,0,512,17,759721562
2308,47510350,27822050,75332400,3,0,1,32256,0,893026475
2309,47524070,27822515,75346585,3,0,1,19456,0,5510286313
2310,47529900,1147153,48677053,8,0,0,60416,6,9017550693
2311,47556050,27889255,75445305,5,0,1,36352,11,3292605515
2312,47562610,28076087,75638697,5,0,1,89088,11,9929343071
2313,47572720,1240662,48813382,8,0,0,36864,6,6257601070
2314,47614290,28024430,75638720,3,0,1,25600,0,5829149214
2315,47678300,749810,48428110,2,0,0,512,11,5409464449
2316,47703790,27934953,75638743,3,0,1,27136,0,1293787577
2317,47793130,780076,48573206,0,0,0,81920,6,8597780713
2318,47804779,613265,48418044,4,0,0,3584,4,4949089013
2319,47810690,1140950,48951640,0,0,0,66048,6,6559676920
2320,47814119,863885,48678004,4,0,0,3072,4,1247212548
2321,47842060,856707,48698767,0,0,0,68096,6,776940134
2322,47852970,27785796,75638766,3,0,1,9216,0,2593759701
2323,47892680,27746109,75638789,4,0,1,3072,4,7251000518
2324,47900170,636680,48536850,2,0,0,1536,11,3983403971
2325,47969080,27669732,75638812,5,0,1,64512,11,8766267943
2326,47987910,27650925,75638835,3,0,1,10240,0,8402671807
2327,47991970,27646888,75638858,4,0,1,3584,4,892482423
2328,48023519,681871,48705390,4,0,0,3072,4,10614442902
2329,48044810,654128,48698938,2,0,0,512,11,10604058316
2330,48075010,499303,48574313,2,0,0,3584,11,973140199
2331,48084590,1416005,49500595,5,0,0,32256,11,4917771440
2332,48090661,613193,48703854,7,0,0,3072,16,2447481503
2333,48091790,887249,48979039,5,0,0,3584,11,1100217055
2334,48122840,27516041,75638881,4,0,1,13312,4,10462610195
2335,48137131,621036,48758167,7,0,0,3584,16,2251809764
2336,48177990,1063955,49241945,8,0,0,226816,6,176597754
2337,48190730,27616869,75807599,5,0,1,49152,11,8314796763
2338,48209430,636465,48845895,5,0,0,512,11,1671500178
2339,48214810,1241535,49456345,8,0,0,200704,6,5214790530
2340,48220910,27586712,75807622,4,0,1,12288,4,7070385848
2341,48250840,324744,48575584,2,0,0,4096,11,5663644644
2342,48292500,758623,49051123,8,0,0,78848,6,1503259603
2343,48303570,27504075,75807645,4,0,1,24064,4,5282219799
2344,48379890,27427778,75807668,6,0,1,1536,3,364462444
2345,48380190,27427501,75807691,4,0,1,17920,4,8810003399
2346,48380980,870271,49251251,5,0,0,1024,11,9239515879
2347,48384870,429478,48814348,2,0,0,1536,11,8287315135
2348,48419779,700287,49120066,4,0,0,2048,4,5448045083
2349,48428830,27378884,75807714,4,0,1,5632,4,8031879410
2350,48430310,27420880,75851190,5,0,1,60416,11,5809679200
2351,48430370,27420843,75851213,4,0,1,6656,4,3303849659
2352,48451000,362865,48813865,2,0,0,1536,11,485057585
2353,48453540,27397696,75851236,3,0,1,13312,0,114834755
2354,48494321,388979,48883300,7,0,0,3072,16,836756032
2355,48500930,28134436,76635366,5,0,1,214016,11,1173697554
2356,48517450,28681633,77199083,5,0,1,325632,11,5974401026
2357,48563991,514480,49078471,7,0,0,1536,16,1639349950
2358,48584140,426932,49011072,5,0,0,512,11,7867890001
2359,48584681,466636,49051317,7,0,0,512,16,1215324217
2360,48616730,28658277,77275007,5,0,1,105472,11,9774758383
2361,48634299,271687,48905986,4,0,0,512,4,9238503594
2362,48635840,606837,49242677,5,0,0,1024,11,6425055567
2363,48640340,28634690,77275030,4,0,1,3584,4,10295717622
2364,48649080,1025041,49674121,0,0,0,212480,6,4164385714
2365,48706550,462911,49169461,2,0,0,6656,11,2350190542
2366,48758930,28517238,77276168,4,0,1,78336,4,1236095139
2367,48801210,28474981,77276191,3,0,1,1024,0,440551863
2368,48833380,28645643,77479023,5,0,1,69120,11,7464996784
2369,48842519,400500,49243019,4,0,0,512,4,9167492948
2370,48870890,28674209,77545099,3,0,1,2560,0,8496642137
2371,48902119,229449,49131568,4,0,0,3072,4,7703614859
2372,48912001,330847,49242848,7,0,0,512,16,8991139973
2373,48919500,28628476,77547976,3,0,1,58880,0,8204400634
2374,48970750,313604,49284354,2,0,0,10240,11,1991706387
2375,48974820,28573179,77547999,3,0,1,5632,0,5073176012
2376,48976611,28607494,77584105,0,0,1,20992,6,8460523700
2377,48990130,580713,49570843,2,0,0,3584,11,5924787509
2378,49033270,209056,49242326,5,0,0,1024,11,7236289744
2379,49054250,28529878,77584128,4,0,1,12288,4,1019892087
2380,49083120,722003,49805123,8,0,0,170496,6,3328820015
2381,49094301,28711460,77805761,0,0,1,134656,6,6776310220
2382,49120790,630745,49751535,8,0,0,253440,6,3686724671
2383,49138120,28671827,77809947,4,0,1,6656,4,9370680482
2384,49172400,28808765,77981165,5,0,1,32768,11,1329505716
2385,49175769,358552,49534321,4,0,0,4096,4,7133865908
2386,49181980,28815422,77997402,4,0,1,20480,4,9264817037
2387,49187790,620320,49808110,0,0,0,9728,6,7626407945
2388,49202429,300318,49502747,4,0,0,512,4,5548691158
2389,49204590,28804531,78009121,4,0,1,8192,4,4673227186
2390,49208380,628867,49837247,8,0,0,37888,6,2949005317
2391,49219720,708854,49928574,8,0,0,37888,6,6358494698
2392,49225210,28793160,78018370,5,0,1,4608,11,2941387803
2393,49231420,28814808,78046228,4,0,1,49664,4,310919932
2394,49268329,405963,49674292,4,0,0,512,4,8543941082
2395,49371650,662251,50033901,8,0,0,119296,6,6862077262
2396,49409010,28637241,78046251,5,0,1,8704,11,3169425588
2397,49423510,385287,49808797,2,0,0,2048,11,9492286354
2398,49440330,28648800,78089130,5,0,1,28672,11,6553196172
2399,49443200,309823,49753023,5,0,0,4608,11,7112367520
2400,49466800,503319,49970119,0,0,0,118784,6,8475194186
2401,49506840,28585196,78092036,4,0,1,4608,4,3867576230
2402,49566850,270568,49837418,2,0,0,512,11,5554425744
2403,49603470,28526216,78129686,8,0,1,3584,6,2885012750
2404,49626850,524473,50151323,0,0,0,49664,6,5043481492
2405,49638089,442137,50080226,4,0,0,3072,4,7351056717
2406,49642160,28619863,78262023,5,0,1,56320,11,2216553465
2407,49663610,28621407,78285017,4,0,1,36864,4,8301505263
2408,49670280,831234,50501514,8,0,0,45056,6,10445636239
2409,49671150,28657915,78329065,9,0,1,2048,17,10426774517
2410,49686000,605130,50291130,8,0,0,102912,6,1616929344
2411,49704800,28823663,78528463,4,0,1,43008,4,2805587877
2412,49721700,29016771,78738471,9,0,1,18432,17,6918033779
2413,49738890,650586,50389476,0,0,0,71680,6,3940476842
2414,49753879,231180,49985059,4,0,0,9216,4,1778716683
2415,49778030,723967,50501997,2,0,0,1536,11,3094905798
2416,49798610,29064429,78863039,9,0,1,9728,17,10707746363
2417,49801170,29324505,79125675,8,0,1,53760,6,3625825100
2418,49817760,217092,50034852,2,0,0,3072,11,7223251712
2419,49886501,266181,50152682,7,0,0,2560,16,5491918705
2420,49915430,29323090,79238520,1,0,1,48640,6,8729931947
2421,49933420,397181,50330601,2,0,0,7680,11,2822674421
2422,49934530,29305066,79239596,5,0,1,13312,11,9462150815
2423,49952800,29377855,79330655,4,0,1,512,4,10709993500
2424,49969200,322161,50291361,2,0,0,512,11,7712623436
2425,49970440,29371319,79341759,3,0,1,13312,0,4603269041
2426,49989410,29354295,79343705,5,0,1,3072,11,3097399926
2427,50020759,270944,50291703,4,0,0,1024,4,1447930184
2428,50033410,29311371,79344781,3,0,1,13312,0,332549060
2429,50080250,29426908,79507158,8,0,1,49664,6,663314581
2430,50095010,29436062,79531072,4,0,1,18432,4,2472897200
2431,50164950,318168,50483118,0,0,0,151040,6,10468580524
2432,50175510,29355585,79531095,8,0,1,2048,6,6408391027
2433,50179570,29351891,79531461,4,0,1,19968,4,1205097090
2434,50206730,29324754,79531484,8,0,1,20992,6,7891296450
2435,50207370,29426059,79633429,4,0,1,10752,4,9803105377
2436,50215880,29417572,79633452,8,0,1,3584,6,9457698767
2437,50248630,29384845,79633475,8,0,1,8704,6,6978622539
2438,50339350,489681,50829031,0,0,0,51200,6,5670404494
2439,50348440,676293,51024733,0,0,0,414208,6,3320656188
2440,50362781,357838,50720619,7,0,0,2560,16,10191769655
2441,50419719,250874,50670593,4,0,0,3584,4,8960215123
2442,50428220,29205278,79633498,8,0,1,4608,6,140821307
2443,50446140,29214720,79660860,8,0,1,1024,6,3169694270
2444,50467090,29193793,79660883,8,0,1,12288,6,3709339748
2445,50510060,29150846,79660906,8,0,1,18944,6,1138033769
2446,50522730,29138199,79660929,3,0,1,10240,0,7254270219
2447,50530920,29130032,79660952,3,0,1,18944,0,10320285744
2448,50541111,484174,51025285,7,0,0,1536,16,1761346932
2449,50544080,29159054,79703134,9,0,1,37888,17,8441945654
2450,50544190,29158991,79703181,9,0,1,29184,17,806774033
2451,50579760,29126200,79705960,5,0,1,40448,11,7719360569
2452,50691140,29029631,79720771,5,0,1,9728,11,525780200
2453,50694480,29026855,79721335,8,0,1,10752,6,9212822106
2454,50696459,329651,51026110,4,0,0,2560,4,6377555712
2455,50701950,29044856,79746806,3,0,1,4608,0,4090791728
2456,50754881,271766,51026647,7,0,0,1536,16,5808218800
2457,50767080,487081,51254161,2,0,0,7680,11,5635528852
2458,50780121,408253,51188374,7,0,0,5632,16,2343423389
2459,50855710,602885,51458595,0,0,0,163840,6,2639686585
2460,50888560,28859117,79747677,9,0,1,12288,17,250633980
2461,50891509,158777,51050286,4,0,0,4608,4,5368299059
2462,50895920,28880716,79776636,5,0,1,38912,11,4798730727
2463,50919290,28990408,79909698,3,0,1,86528,0,392621552
2464,50933710,29028709,79962419,9,0,1,10240,17,2725750261
2465,50934760,29121839,80056599,8,0,1,37888,6,662246063
2466,50962730,29473092,80435822,4,0,1,32768,4,4043344456
2467,50965390,870088,51835478,0,0,0,107520,6,4057677136
2468,50992960,29444488,80437448,4,0,1,2560,4,5231943934
2469,51018790,385756,51404546,8,0,0,71680,6,8766679935
2470,51038390,29401004,80439394,8,0,1,3072,6,5239476263
2471,51057880,29492530,80550410,8,0,1,12288,6,307674429
2472,51062141,274481,51336622,7,0,0,1536,16,9295803831
2473,51066800,29866046,80932846,8,0,1,2560,6,3321283285
2474,51079910,183638,51263548,2,0,0,1024,11,4097351286
2475,51097849,169854,51267703,4,0,0,1536,4,2705300179
2476,51103470,29829399,80932869,8,0,1,2560,6,166000876
2477,51110840,29822052,80932892,5,0,1,13312,11,3262881441
2478,51115210,665269,51780479,0,0,0,162816,6,2592780743
2479,51120110,737387,51857497,1,0,0,72192,6,10210582041
2480,51122960,29812942,80935902,8,0,1,7168,6,9321253927
2481,51165950,564882,51730832,0,0,0,334848,6,1447202445
2482,51186250,29749675,80935925,4,0,1,13312,4,9545218267
2483,51186530,29761141,80947671,3,0,1,512,0,4397640694
2484,51215851,313130,51528981,7,0,0,512,16,6393160953
2485,51259930,29712826,80972756,5,0,1,10240,11,72287954
2486,51263700,981464,52245164,0,0,0,537600,6,4167994838
2487,51271800,509162,51780962,2,0,0,1536,11,3721249161
2488,51298520,29674259,80972779,5,0,1,1024,11,9353767082
2489,51326359,582841,51909200,4,0,0,512,4,2241038735
2490,51449960,29522842,80972802,3,0,1,1536,0,1169690904
2491,51483590,29521787,81005377,3,0,1,27136,0,5736732828
2492,51485470,29550926,81036396,8,0,1,2560,6,103296750
2493,51486779,553560,52040339,4,0,0,1024,4,503895330
2494,51487930,29552012,81039942,4,0,1,5632,4,2741033125
2495,51490301,406899,51897200,7,0,0,10752,16,2613554122
2496,51502070,803859,52305929,8,0,0,135168,6,9292312714
2497,51522700,29517588,81040288,8,0,1,512,6,9267112723
2498,51526650,356224,51882874,2,0,0,512,11,6116310613
2499,51531760,720443,52252203,5,0,0,2560,11,5263774497
2500,51533710,29509804,81043514,8,0,1,5120,6,2920519469
2501,51610620,639894,52250514,5,0,0,14336,11,3765746590
2502,51612930,29435103,81048033,6,0,1,18432,3,3401482004
2503,51644249,607113,52251362,4,0,0,1024,4,787557588
2504,51653390,597474,52250864,5,0,0,512,11,1181807769
2505,51656239,589884,52246123,4,0,0,3072,4,2649496454
2506,51714150,325862,52040012,0,0,0,25600,6,3296616737
2507,51744061,186985,51931046,7,0,0,512,16,9694019979
2508,51752601,288229,52040830,7,0,0,1536,16,1190649601
2509,51773851,477184,52251035,7,0,0,512,16,10668085871
2510,51804280,884926,52689206,8,0,0,202752,6,10534141749
2511,51822520,521658,52344178,0,0,0,48128,6,6809160423
2512,51850180,29332888,81183068,3,0,1,9216,0,4649595643
2513,51858980,29730566,81589546,5,0,1,101376,11,181049085
2514,51872690,30006289,81878979,5,0,1,25600,11,7466846356
2515,51885120,379578,52264698,8,0,0,40960,6,9987400745
2516,51889851,360834,52250685,7,0,0,512,16,8274161642
2517,51915140,429989,52345129,5,0,0,3072,11,8941747344
2518,51915630,29964117,81879747,4,0,1,11776,4,820221011
2519,51948491,457253,52405744,7,0,0,2048,16,6296684322
2520,51973531,520393,52493924,7,0,0,1536,16,10487594868
2521,52020050,29948292,81968342,4,0,1,53248,4,535585919
2522,52021820,29946545,81968365,5,0,1,2048,11,4265928783
2523,52039140,277357,52316497,2,0,0,4096,11,6691491858
2524,52045190,29923198,81968388,4,0,1,1024,4,5604042978
2525,52084090,29898556,81982646,3,0,1,8704,0,4135201239
2526,52121640,29865240,81986880,8,0,1,5632,6,5966492469
2527,52151610,1538050,53689660,8,0,0,682496,6,6034590735
2528,52170300,442366,52612666,8,0,0,223744,6,7428799310
2529,52179410,29827389,82006799,4,0,1,13824,4,2335052684
2530,52239710,29772235,82011945,4,0,1,8192,4,3988868998
2531,52262690,29816385,82079075,8,0,1,48640,6,5203730525
2532,52288000,1002409,53290409,8,0,0,127488,6,5633291213
2533,52288400,221820,52510220,2,0,0,4608,11,6888209246
2534,52339240,350317,52689557,2,0,0,1024,11,7097236362
2535,52347560,29760272,82107832,5,0,1,5120,11,1712878637
2536,52380210,29727645,82107855,4,0,1,5632,4,5051236989
2537,52385220,29722658,82107878,8,0,1,1536,6,5822002978
2538,52386350,29721551,82107901,7,0,1,512,16,2399627961
2539,52429521,347552,52777073,7,0,0,5632,16,2183575646
2540,52433770,29796610,82230380,3,0,1,48128,0,6951734944
2541,52448720,29787049,82235769,6,0,1,17408,3,4590805528
2542,52454831,919947,53374778,7,0,0,9728,16,3069235707
2543,52471300,29786659,82257959,4,0,1,9216,4,10587892928
2544,52505480,1308174,53813654,0,0,0,395776,6,8228794901
2545,52534330,822748,53357078,8,0,0,111616,6,2170818645
2546,52539150,1364858,53904008,0,0,0,52736,6,2495261749
2547,52546890,1686945,54233835,1,0,0,155136,6,7038767126
2548,52556801,433420,52990221,7,0,0,1024,16,2253522343
2549,52565230,793141,53358371,5,0,0,512,11,5038804359
2550,52565650,320980,52886630,8,0,0,1536,6,4201402216
2551,52569490,29707770,82277260,8,0,1,2560,6,1252730245
2552,52581430,29698532,82279962,6,0,1,15872,3,8418354818
2553,52582580,1441958,54024538,1,0,0,257536,6,807124223
2554,52604810,29682272,82287082,5,0,1,4608,11,4616645948
2555,52628279,357879,52986158,4,0,0,512,4,270306401
2556,52654130,639118,53293248,1,0,0,9216,6,2643986814
2557,52673980,1163078,53837058,1,0,0,52736,6,7740358730
2558,52704580,29582848,82287428,3,0,1,512,0,5208167464
2559,52741309,704731,53446040,4,0,0,512,4,10387973863
2560,52745890,29543804,82289694,6,0,1,3584,3,621220946
2561,52761290,29551370,82312660,3,0,1,13824,0,1107372305
2562,52767840,350298,53118138,5,0,0,3072,11,5925974517
2563,52772780,29645917,82418697,4,0,1,2048,4,10459903710
2564,52791370,1455494,54246864,5,0,0,3072,11,4709859339
2565,52792050,29627633,82419683,8,0,1,1536,6,474055178
2566,52815170,29654727,82469897,5,0,1,23552,11,242208221
2567,52815670,478373,53294043,5,0,0,2560,11,6324222514
2568,52819909,346070,53165979,4,0,0,2048,4,9412906165
2569,52847490,510710,53358200,8,0,0,512,6,10043378566
2570,52848381,970334,53818715,7,0,0,1024,16,8598179695
2571,52871010,29655758,82526768,8,0,1,47616,6,3126790952
2572,52898911,399635,53298546,7,0,0,2560,16,6151379752
2573,52903270,1041975,53945245,1,0,0,134144,6,4886691472
2574,52912390,445639,53358029,5,0,0,3072,11,3302378856
2575,52936410,29591664,82528074,5,0,1,2048,11,9322416209
2576,52963740,29666072,82629812,5,0,1,48128,11,7150963262
2577,52964340,981715,53946055,8,0,0,1024,6,5990307732
2578,52975250,29791894,82767144,5,0,1,16896,11,7767389310
2579,52979259,427116,53406375,4,0,0,1024,4,830001110
2580,53010900,29756267,82767167,3,0,1,16384,0,3626403805
2581,53027740,29739450,82767190,6,0,1,10240,3,478916855
2582,53038390,29761473,82799863,4,0,1,23040,4,5172619115
2583,53052900,29747010,82799910,5,0,1,512,11,1148889476
2584,53057770,816914,53874684,1,0,0,122368,6,4295699966
2585,53062820,964792,54027612,2,0,0,5632,11,9405107574
2586,53073650,29732935,82806585,8,0,1,25600,6,4952373163
2587,53077220,29825351,82902571,5,0,1,30208,11,680733621
2588,53085840,29816754,82902594,6,0,1,1536,3,5143007247
2589,53133930,681307,53815237,8,0,0,5120,6,5570139849
2590,53143389,693996,53837385,4,0,0,1024,4,6811988601
2591,53149230,543813,53693043,5,0,0,3072,11,3068697438
2592,53153450,538580,53692030,5,0,0,5632,11,180907946
2593,53171730,29735270,82907000,3,0,1,23552,0,4312244556
2594,53186840,1139347,54326187,0,0,0,9216,6,4064545805
2595,53187630,29897390,83085020,8,0,1,26112,6,1575757887
2596,53197570,492729,53690299,5,0,0,2048,11,1833641448
2597,53200580,617792,53818372,1,0,0,10240,6,7885891250
2598,53231440,588888,53820328,2,0,0,4096,11,7395914167
2599,53234290,584775,53819065,8,0,0,1024,6,3088457741
2600,53265670,555305,53820975,2,0,0,2048,11,3125055471
2601,53270100,29814943,83085043,8,0,1,3584,6,4749229644
2602,53292490,595367,53887857,0,0,0,43008,6,5856407279
2603,53380360,677399,54057759,0,0,0,98816,6,4029684530
2604,53421740,29663326,83085066,4,0,1,512,4,2235060937
2605,53438890,465468,53904358,5,0,0,1024,11,9431837013
2606,53443110,502618,53945728,8,0,0,1536,6,333946763
2607,53458360,29626729,83085089,4,0,1,7680,4,1124241679
2608,53465530,29619582,83085112,4,0,1,7680,4,2459599753
2609,53504851,1140472,54645323,7,0,0,9728,16,2600782606
2610,53512140,29572995,83085135,3,0,1,1536,0,8924355580
2611,53528200,29556958,83085158,5,0,1,512,11,7797331565
2612,53530830,495019,54025849,5,0,0,4096,11,478465286
2613,53532840,866613,54399453,2,0,0,1536,11,3146274571
2614,53564830,29520351,83085181,3,0,1,7168,0,6699146318
2615,53567430,666888,54234318,8,0,0,1536,6,6229618077
2616,53578660,29506544,83085204,3,0,1,1024,0,6344773018
2617,53598439,460895,54059334,4,0,0,5120,4,8327098341
2618,53632240,545893,54178133,0,0,0,51200,6,7123365492
2619,53687710,1113223,54800933,0,0,0,201728,6,7721717803
2620,53719701,415764,54135465,7,0,0,3072,16,7131907300
2621,53733350,339225,54072575,2,0,0,3072,11,5586573133
2622,53815480,29269747,83085227,2,0,1,5632,11,5223024945
2623,53821910,29437842,83259752,8,0,1,23040,6,8951145050
2624,53837550,29702659,83540209,2,0,1,9216,11,1871589150
2625,53868420,29826198,83694618,8,0,1,10240,6,6477225106
2626,53874260,29821741,83696001,5,0,1,14848,11,4397551411
2627,53879740,31243127,85122867,5,0,1,20992,11,3387752388
2628,53895420,31335016,85230436,3,0,1,40960,0,969808082
2629,53896730,31333729,85230459,3,0,1,9728,0,2007268905
2630,53918770,408695,54327465,5,0,0,4096,11,102964911
2631,53935320,378190,54313510,5,0,0,1536,11,10595132847
2632,53965219,327372,54292591,4,0,0,1536,4,6722222308
2633,54026259,452598,54478857,4,0,0,2048,4,1902057773
2634,54027160,31238921,85266081,3,0,1,27136,0,2652352771
2635,54056890,31209393,85266283,5,0,1,6656,11,8380079320
2636,54087130,31179176,85266306,1,0,1,5120,6,10320351669
2637,54094590,31171739,85266329,3,0,1,14336,0,1410502217
2638,54100380,31165972,85266352,5,0,1,7168,11,10123638377
2639,54101681,437094,54538775,7,0,0,1536,16,2080660946
2640,54102750,1040676,55143426,0,0,0,117760,6,9282977035
2641,54107630,31162862,85270492,8,0,1,2560,6,1158086936
2642,54113510,417687,54531197,1,0,0,63488,6,2594876853
2643,54119400,31157505,85276905,3,0,1,22528,0,8962416777
2644,54123810,348576,54472386,5,0,0,3072,11,9426910577
2645,54142900,349185,54492085,5,0,0,3072,11,3372505592
2646,54145650,31235096,85380746,2,0,1,11264,11,321178705
2647,54176359,420416,54596775,4,0,0,2048,4,7344418009
2648,54195690,220189,54415879,2,0,0,1536,11,503419821
2649,54214210,410181,54624391,2,0,0,1536,11,1370121796
2650,54234760,31146009,85380769,5,0,1,21504,11,10452738876
2651,54243301,234917,54478218,7,0,0,2048,16,673648505
2652,54280860,566710,54847570,0,0,0,111616,6,465083191
2653,54289950,31090842,85380792,4,0,1,10752,4,10660253703
2654,54298359,196761,54495120,4,0,0,2560,4,5141183378
2655,54308880,31193302,85502182,8,0,1,70144,6,3727246925
2656,54325141,361854,54686995,7,0,0,512,16,10674778248
2657,54334980,31216583,85551563,2,0,1,11776,11,7224900871
2658,54347710,632232,54979942,1,0,0,100864,6,390785933
2659,54358510,328314,54686824,1,0,0,77312,6,2795199822
2660,54387810,31170013,85557823,5,0,1,29696,11,2853880894
2661,54407350,31238038,85645388,1,0,1,11264,6,9813441972
2662,54443630,31201781,85645411,8,0,1,1024,6,9653140026
2663,54454010,31191424,85645434,8,0,1,11264,6,6325974801
2664,54456140,31189317,85645457,4,0,1,8192,4,4813925817
2665,54471440,31340269,85811709,1,0,1,80896,6,7031297821
2666,54476850,31435627,85912477,1,0,1,13312,6,1977962994
2667,54476960,31439063,85916023,4,0,1,5632,4,4315380593
2668,54483480,31455353,85938833,5,0,1,2048,11,4902717742
2669,54486540,381693,54868233,0,0,0,1024,6,5847702238
2670,54492780,31446084,85938864,2,0,1,35328,11,4969058188
2671,54497860,31441027,85938887,1,0,1,512,6,3984773241
2672,54511999,344050,54856049,4,0,0,1024,4,525050491
2673,54550560,846108,55396668,1,0,0,231936,6,5877748533
2674,54582350,31461517,86043867,2,0,1,24576,11,7480227686
2675,54607489,274836,54882325,4,0,0,3072,4,8808471465
2676,54638760,31433731,86072491,5,0,1,7680,11,5778215354
2677,54653550,31420221,86073771,5,0,1,14336,11,9147259000
2678,54668911,274817,54943728,7,0,0,1536,16,7595347500
2679,54705921,167188,54873109,7,0,0,3072,16,5054649504
2680,54740820,1499487,56240307,0,0,0,507392,6,3850277244
2681,54746911,488991,55235902,7,0,0,1024,16,3912443731
2682,54749450,32311104,87060554,5,0,1,22016,11,6675833410
2683,54771430,216099,54987529,2,0,0,3072,11,10725472644
2684,54784899,639199,55424098,4,0,0,5632,4,127347864
2685,54874870,33421869,88296739,2,0,1,58368,11,7624233555
2686,54885290,33424863,88310153,5,0,1,32256,11,10399032920
2687,54885559,811697,55697256,4,0,0,2560,4,1468987907
2688,54932300,760327,55692627,1,0,0,173056,6,5324599759
2689,54935550,33376818,88312368,3,0,1,11264,0,5265936419
2690,54953310,33476231,88429541,3,0,1,22528,0,4046110175
2691,54964280,730094,55694374,5,0,0,5632,11,7788016563
2692,54966580,566239,55532819,5,0,0,4096,11,21653443
2693,54970210,33460592,88430802,5,0,1,5120,11,2326334700
2694,54995720,550658,55546378,1,0,0,21504,6,4133900331
2695,55002789,756243,55759032,4,0,0,4608,4,182731916
2696,55010190,602950,55613140,5,0,0,2560,11,3732984635
2697,55021530,33575785,88597315,3,0,1,19456,0,239604285
2698,55024450,372405,55396855,5,0,0,512,11,7719056138
2699,55035470,33561868,88597338,4,0,1,32768,4,6245911249
2700,55065940,673466,55739406,2,0,0,52224,11,1119306378
2701,55066950,1377645,56444595,2,0,0,144384,11,480896123
2702,55082350,33515011,88597361,2,0,1,18944,11,2054811627
2703,55087020,1434873,56521893,1,0,0,144896,6,5744706204
2704,55146450,33450934,88597384,2,0,1,11264,11,9870948712
2705,55163820,33433587,88597407,2,0,1,8192,11,8041404790
2706,55166950,357656,55524606,8,0,0,5632,6,1422883877
2707,55180840,412403,55593243,2,0,0,8192,11,2321570940
2708,55192420,33513929,88706349,5,0,1,9216,11,3034307497
2709,55194200,522135,55716335,8,0,0,3072,6,5751966373
2710,55201470,33504902,88706372,3,0,1,9728,0,6885705476
2711,55226860,33650294,88877154,5,0,1,2048,11,7374771548
2712,55326620,386010,55712630,5,0,0,1024,11,8529153658
2713,55335190,270854,55606044,5,0,0,4608,11,9259673627
2714,55392109,302592,55694701,4,0,0,1024,4,8320127901
2715,55396960,33579943,88976903,2,0,1,26624,11,6592178302
2716,55399650,295378,55695028,8,0,0,1024,6,6013732579
2717,55447840,34175711,89623551,5,0,1,30208,11,5421824470
2718,55459489,448750,55908239,4,0,0,512,4,3615121835
2719,55473930,34375680,89849610,2,0,1,33280,11,7763861268
2720,55497280,1186199,56683479,1,0,0,358400,6,5498121885
2721,55546500,34348932,89895432,5,0,1,25600,11,5738932041
2722,55580430,791241,56371671,0,0,0,270848,6,6839875812
2723,55591530,886192,56477722,0,0,0,102400,6,216194384
2724,55593380,658182,56251562,1,0,0,36864,6,4728060262
2725,55611201,275666,55886867,7,0,0,5632,16,2009105411
2726,55639980,34255475,89895455,5,0,1,2048,11,4902369404
2727,55651970,34381255,90033225,2,0,1,78848,11,2996913414
2728,55699601,552764,56252365,7,0,0,2560,16,6327054254
2729,55713660,659906,56373566,1,0,0,6144,6,3076610045
2730,55745139,939033,56684172,4,0,0,1024,4,7173676926
2731,55774730,34258518,90033248,5,0,1,5120,11,7724599230
2732,55839330,231807,56071137,5,0,0,1024,11,7964743653
2733,55849960,525033,56374993,5,0,0,4608,11,5547628829
2734,55852090,685582,56537672,2,0,0,51712,11,174340770
2735,55908700,34157943,90066643,2,0,1,32768,11,3563334091
2736,55914810,784141,56698951,2,0,0,48128,11,4648241334
2737,55919750,34147764,90067514,3,0,1,12288,0,10307279586
2738,55923780,34172316,90096096,5,0,1,5120,11,3275235390
2739,55930280,335056,56265336,1,0,0,42496,6,3983389245
2740,55935280,845840,56781120,2,0,0,267264,11,3582912881
2741,55975230,34120889,90096119,3,0,1,1024,0,558856537
2742,55983540,34121239,90104779,1,0,1,1024,6,9517204027
2743,56029830,34207340,90237170,1,0,1,82944,6,5617198330
2744,56046481,34676650,90723131,0,0,1,32768,6,3618036265
2745,56063220,34659934,90723154,8,0,1,11776,6,1357314112
2746,56075520,34647657,90723177,5,0,1,23552,11,3221405931
2747,56108080,34643870,90751950,1,0,1,512,6,426924237
2748,56136200,34615773,90751973,1,0,1,10752,6,9840904585
2749,56144231,539583,56683814,7,0,0,1024,16,822112663
2750,56156520,34595476,90751996,7,0,1,1024,16,136341940
2751,56235790,610659,56846449,2,0,0,81920,11,10098898051
2752,56278719,538808,56817527,4,0,0,7168,4,4291760087
2753,56280910,500504,56781414,5,0,0,512,11,7004983989
2754,56303740,723375,57027115,2,0,0,97280,11,3615578477
2755,56421001,685769,57106770,7,0,0,1024,16,9967736867
2756,56469501,719746,57189247,7,0,0,1536,16,4708400778
2757,56475490,34276529,90752019,3,0,1,6656,0,1203652098
2758,56490790,34264083,90754873,1,0,1,10752,6,1386010512
2759,56500430,34313473,90813903,7,0,1,4608,16,10576000315
2760,56510420,34303506,90813926,3,0,1,24064,0,6691016109
2761,56515640,411315,56926955,5,0,0,1024,11,6087912765
2762,56519511,34359631,90879142,0,0,1,40960,6,4818940938
2763,56522501,614082,57136583,7,0,0,8192,16,8593016800
2764,56527960,34385139,90913099,3,0,1,26112,0,5046733653
2765,56534349,540418,57074767,4,0,0,6144,4,5003734413
2766,56542350,489936,57032286,1,0,0,16896,6,5508043379
2767,56543680,741571,57285251,1,0,0,104448,6,1790159479
2768,56544451,886636,57431087,7,0,0,4608,16,1887499517
2769,56558460,674707,57233167,1,0,0,131072,6,4775098955
2770,56568340,34436020,91004360,7,0,1,6144,16,4262923587
2771,56576119,512506,57088625,4,0,0,9728,4,3809086430
2772,56611720,34392663,91004383,3,0,1,10240,0,270530507
2773,56637800,457751,57095551,5,0,0,2048,11,7564469520
2774,56649500,939897,57589397,0,0,0,99840,6,9366839121
2775,56651020,34391868,91042888,3,0,1,34304,0,2240602411
2776,56666640,34432140,91098780,3,0,1,23552,0,6050082152
2777,56670670,793300,57463970,8,0,0,1024,6,9842811339
2778,56737390,1184859,57922249,1,0,0,323584,6,10522663055
2779,56739530,34367754,91107284,7,0,1,13312,16,6739743752
2780,56748400,537053,57285453,8,0,0,512,6,7702844334
2781,56756720,34351844,91108564,7,0,1,14336,16,5888723520
2782,56803090,846684,57649774,8,0,0,6144,6,3085717495
2783,56864710,903539,57768249,1,0,0,186368,6,2544566911
2784,56869790,34618931,91488721,7,0,1,6144,16,2689831103
2785,56870410,931453,57801863,1,0,0,88064,6,5282519277
2786,56873741,546429,57420170,7,0,0,512,16,100276542
2787,56877030,669967,57546997,8,0,0,9216,6,4333227480
2788,56887830,34600914,91488744,3,0,1,6144,0,736839629
2789,56890030,34598737,91488767,3,0,1,1536,0,2896773676
2790,56890921,444319,57335240,7,0,0,1024,16,8549928297
2791,56892910,782070,57674980,5,0,0,2048,11,6806073319
2792,56900939,874069,57775008,4,0,0,8192,4,5131130580
2793,56941010,603156,57544166,1,0,0,102912,6,5174769829
2794,56941590,34671284,91612874,7,0,1,47104,16,5902329175
2795,56947690,854431,57802121,5,0,0,512,11,10276256470
2796,56950079,719154,57669233,4,0,0,512,4,8223270708
2797,56974331,616493,57590824,7,0,0,4608,16,1759568471
2798,56978140,674528,57652668,8,0,0,2048,6,7782233402
2799,56983250,697564,57680814,8,0,0,2560,6,8218195262
2800,56990000,815311,57805311,1,0,0,7168,6,4517073628
2801,56992800,34620097,91612897,3,0,1,11776,0,8518389888
2802,56996000,776489,57772489,8,0,0,5632,6,6208069171
2803,57015681,912121,57927802,7,0,0,2560,16,5644816134
2804,57016180,626304,57642484,1,0,0,48128,6,6896943939
2805,57030820,739884,57770704,8,0,0,7680,6,5290632862
2806,57080340,34574404,91654744,6,0,1,1024,3,517005021
2807,57081210,34741096,91822306,7,0,1,34304,16,3345637714
2808,57083180,34970590,92053770,7,0,1,30208,16,4181591279
2809,57083370,35027096,92110466,7,0,1,10752,16,6376012754
2810,57097460,35013029,92110489,2,0,1,2560,11,1537609430
2811,57101510,35029305,92130815,1,0,1,8704,6,3698003656
2812,57110840,35251796,92362636,2,0,1,56320,11,5570094812
2813,57122000,35240659,92362659,7,0,1,3584,16,409180711
2814,57144220,35460838,92605058,7,0,1,34816,16,6617287800
2815,57158640,768336,57926976,5,0,0,15360,11,2930559819
2816,57164671,764049,57928720,7,0,0,2560,16,10678542047
2817,57169500,35435581,92605081,3,0,1,12800,0,10327220213
2818,57217530,798444,58015974,2,0,0,72704,11,1608964708
2819,57221280,35421935,92643215,7,0,1,6144,16,7755223009
2820,57307150,35528482,92835632,2,0,1,22016,11,4678200137
2821,57323140,608278,57931418,5,0,0,4096,11,3046727214
2822,57326860,607678,57934538,5,0,0,2560,11,4808452098
2823,57334140,35501539,92835679,1,0,1,46592,6,6314206463
2824,57368031,562116,57930147,7,0,0,4608,16,5683433298
2825,57459140,35478008,92937148,1,0,1,13824,6,7083777287
2826,57467820,35469351,92937171,7,0,1,1024,16,1326201151
2827,57468470,35468724,92937194,7,0,1,15872,16,7448142333
2828,57480010,35488461,92968471,3,0,1,4608,0,1187715021
2829,57485120,35483374,92968494,1,0,1,512,6,2439824554
2830,57487320,529301,58016621,8,0,0,2048,6,6532000598
2831,57511200,35457317,92968517,3,0,1,4096,0,7071683849
2832,57538900,35429640,92968540,2,0,1,3584,11,5207650257
2833,57545060,35423503,92968563,1,0,1,10752,6,557457095
2834,57554810,35413776,92968586,2,0,1,39936,11,8943776123
2835,57556140,35460571,93016711,2,0,1,58368,11,7987072757
2836,57580721,568037,58148758,7,0,0,4096,16,533009996
2837,57599810,35463980,93063790,9,0,1,49152,17,4139113014
2838,57600150,689886,58290036,5,0,0,6144,11,8214314774
2839,57602150,862023,58464173,5,0,0,512,11,7142336377
2840,57614610,35449203,93063813,1,0,1,19456,6,1395872949
2841,57618820,1063036,58681856,5,0,0,512,11,9770124323
2842,57635190,888883,58524073,1,0,0,57344,6,1074127685
2843,57637281,950185,58587466,7,0,0,4096,16,5011098764
2844,57652090,811904,58463994,2,0,0,146944,11,5285477694
2845,57671010,35392826,93063836,2,0,1,3072,11,9424579677
2846,57672680,725314,58397994,0,0,0,91648,6,1490573932
2847,57697720,525445,58223165,1,0,0,46080,6,9927861277
2848,57709670,688815,58398485,8,0,0,1536,6,9186101338
2849,57711110,643600,58354710,5,0,0,512,11,9497224349
2850,57726290,35337585,93063875,3,0,1,6144,0,4901522360
2851,57727560,480528,58208088,1,0,0,39936,6,1061464495
2852,57732450,35332563,93065013,2,0,1,15360,11,9834975633
2853,57779660,35285400,93065060,2,0,1,16384,11,9188797177
2854,57802000,469366,58271366,2,0,0,15872,11,4680946273
2855,57802510,35262573,93065083,1,0,1,5632,6,2598923786
2856,57844510,35220596,93065106,2,0,1,4608,11,8784093281
2857,57849190,35215939,93065129,7,0,1,13312,16,10430098245
2858,57861460,799334,58660794,2,0,0,68608,11,5400836347
2859,57862180,35202972,93065152,3,0,1,13312,0,7473306294
2860,57866990,928198,58795188,2,0,0,155136,11,3366719497
2861,57873780,766087,58639867,0,0,0,73728,6,8881317212
2862,57890100,35175075,93065175,2,0,1,2560,11,4168795343
2863,57893950,35178291,93072241,1,0,1,6656,6,2886629373
2864,57909540,35166179,93075719,3,0,1,13824,0,4838477260
2865,57921690,35154052,93075742,7,0,1,18944,16,6243413155
2866,57924310,638369,58562679,0,0,0,49664,6,9984389318
2867,57941690,35134075,93075765,3,0,1,16896,0,3195240375
2868,57949120,35126668,93075788,1,0,1,3072,6,8024289175
2869,57964730,35111081,93075811,3,0,1,2048,0,637285020
2870,57984890,743575,58728465,8,0,0,3584,6,8562717443
2871,57985640,35090194,93075834,2,0,1,3584,11,2382730022
2872,58028190,924293,58952483,2,0,0,64000,11,7890294302
2873,58036090,760415,58796505,5,0,0,4096,11,123843668
2874,58047250,35058426,93105676,1,0,1,4096,6,366936802
2875,58063680,809882,58873562,1,0,0,3584,6,9798712286
2876,58069240,738791,58808031,1,0,0,37376,6,9388684930
2877,58070260,35035447,93105707,7,0,1,7168,16,6926058361
2878,58106080,34999650,93105730,3,0,1,10240,0,618588780
2879,58147760,761784,58909544,8,0,0,4608,6,2740738289
2880,58172920,34932833,93105753,1,0,1,11776,6,3320282970
2881,58192181,762064,58954245,7,0,0,5632,16,1708752210
2882,58197870,34937585,93135455,3,0,1,19456,0,8712017272
2883,58211930,34923548,93135478,7,0,1,9216,16,9281879324
2884,58214640,34920861,93135501,7,0,1,2560,16,5433639043
2885,58231409,774054,59005463,4,0,0,4608,4,8763961736
2886,58232909,691658,58924567,4,0,0,512,4,3242218582
2887,58279210,897484,59176694,0,0,0,20992,6,6287125291
2888,58299130,34836394,93135524,2,0,1,4096,11,2840504496
2889,58304849,578515,58883364,4,0,0,512,4,5369680043
2890,58307980,815382,59123362,2,0,0,66560,11,5046155668
2891,58327630,34807925,93135555,2,0,1,4608,11,7820415672
2892,58342889,612049,58954938,4,0,0,2048,4,4481782486
2893,58346620,866704,59213324,0,0,0,40960,6,6766126449
2894,58362880,718392,59081272,1,0,0,5632,6,503990387
2895,58365990,34769588,93135578,1,0,1,8704,6,8570552744
2896,58389950,34754931,93144881,3,0,1,12800,0,4021791285
2897,58397290,34749537,93146827,2,0,1,3072,11,7599225828
2898,58415320,34732941,93148261,1,0,1,12800,6,999499241
2899,58441890,685183,59127073,8,0,0,512,6,10724215596
2900,58449440,864813,59314253,1,0,0,40448,6,5245110762
2901,58470730,773349,59244079,0,0,0,100864,6,8373628225
2902,58481859,678150,59160009,4,0,0,1536,4,7755369351
2903,58496790,34652457,93149247,3,0,1,1536,0,9293978366
2904,58503220,1251570,59754790,1,0,0,321536,6,1977017726
2905,58510510,34670212,93180722,1,0,1,12800,6,4525652527
2906,58532221,830702,59362923,7,0,0,5632,16,6528778596
2907,58596010,859142,59455152,1,0,0,97280,6,5063058772
2908,58605510,34580397,93185907,3,0,1,16384,0,5227077498
2909,58624120,620458,59244578,5,0,0,1536,11,3561625438
2910,58695739,766115,59461854,4,0,0,512,4,906426731
2911,58713130,34474083,93187213,1,0,1,2048,6,4340446556
2912,58734400,34490000,93224400,1,0,1,18944,6,10571347594
2913,58748130,34484307,93232437,2,0,1,26624,11,6035363134
2914,58796650,34440134,93236784,2,0,1,1024,11,8618655050
2915,58884180,735502,59619682,1,0,0,39424,6,229758833
2916,58911220,848342,59759562,8,0,0,5632,6,9323310486
2917,58922899,478913,59401812,4,0,0,2048,4,3572024868
2918,58927350,34388061,93315411,7,0,1,3584,16,6809988791
2919,58979300,397372,59376672,8,0,0,1024,6,7372462573
2920,59012120,34447959,93460079,7,0,1,4608,16,7431604725
2921,59017440,34442662,93460102,7,0,1,1536,16,222316427
2922,59048560,532071,59580631,2,0,0,43008,11,3876553171
2923,59082050,34378075,93460125,1,0,1,512,6,9114440284
2924,59154500,35812466,94966966,7,0,1,43520,16,410828228
2925,59180440,401774,59582214,8,0,0,5120,6,1603247398
2926,59187580,35913843,95101423,2,0,1,4096,11,9068864961
2927,59214610,541474,59756084,5,0,0,4096,11,5742692841
2928,59216850,36127310,95344160,1,0,1,1024,6,4089169956
2929,59223410,396763,59620173,8,0,0,1536,6,2849413748
2930,59236190,36108738,95344928,7,0,1,11776,16,8997792454
2931,59256540,388610,59645150,8,0,0,9216,6,10540984240
2932,59276651,481172,59757823,7,0,0,5632,16,7530577654
2933,59315610,36380193,95695803,1,0,1,20480,6,8320772587
2934,59369900,36325926,95695826,2,0,1,9216,11,2759216754
2935,59377100,36318749,95695849,2,0,1,3072,11,9861195276
2936,59381780,488416,59870196,1,0,0,134656,6,9669905040
2937,59387040,579044,59966084,1,0,0,40960,6,6300814111
2938,59388990,36437772,95826762,7,0,1,24064,16,10619003534
2939,59402400,468847,59871247,8,0,0,2048,6,2978938181
2940,59405650,464725,59870375,8,0,0,512,6,4537516444
2941,59407500,463054,59870554,5,0,0,512,11,888751390
2942,59428041,397947,59825988,7,0,0,3072,16,3977794600
2943,59429210,36397575,95826785,2,0,1,512,11,4435580844
2944,59453320,890019,60343339,2,0,0,117248,11,7496890920
2945,59455250,485006,59940256,8,0,0,2560,6,7621101458
2946,59473170,36353638,95826808,2,0,1,10752,11,277923476
2947,59485270,696267,60181537,2,0,0,147456,11,3185352225
2948,59505760,882149,60387909,1,0,0,16384,6,5551422369
2949,59506400,36320431,95826831,2,0,1,10752,11,4503464411
2950,59515430,37389043,96904473,7,0,1,1024,16,9974655294
2951,59534790,37421469,96956259,4,0,1,17920,4,8802922737
2952,59560090,631321,60191411,0,0,0,32256,6,993033012
2953,59574551,443649,60018200,7,0,0,1536,16,6548222430
2954,59590850,515556,60106406,5,0,0,2048,11,7418335250
2955,59626320,37855396,97481716,7,0,1,61440,16,5290872933
2956,59644920,38006076,97650996,2,0,1,18432,11,1380762070
2957,59659930,38219501,97879431,1,0,1,19968,6,1260085323
2958,59677940,580348,60258288,5,0,0,2048,11,5074874906
2959,59728660,1003331,60731991,2,0,0,310272,11,5818443848
2960,59738320,1020572,60758892,1,0,0,84992,6,310463817
2961,59769440,768599,60538039,2,0,0,35840,11,1749847473
2962,59770390,38129211,97899601,7,0,1,1536,16,1647698727
2963,59772601,747073,60519674,7,0,0,3072,16,10482110345
2964,59778980,38120644,97899624,2,0,1,2560,11,520466503
2965,59785900,38164883,97950783,2,0,1,18432,11,6906355604
2966,59786920,38321928,98108848,7,0,1,11264,16,3128024796
2967,59803100,956283,60759383,5,0,0,1536,11,9889237676
2968,59813741,756251,60569992,7,0,0,1024,16,6548060469
2969,59833540,800859,60634399,8,0,0,2048,6,3434717980
2970,59851840,881133,60732973,8,0,0,3072,6,6481082264
2971,59862830,1051597,60914427,1,0,0,81920,6,6668282104
2972,59867040,38241831,98108871,1,0,1,5120,6,9128010290
2973,59870520,1269598,61140118,2,0,0,270848,11,3224182269
2974,59883440,933672,60817112,5,0,0,5632,11,6029204893
2975,59883920,986321,60870241,1,0,0,23552,6,4321571346
2976,59968400,801934,60770334,2,0,0,35840,11,2570488171
2977,59989641,1150656,61140297,7,0,0,512,16,7182331140
2978,59999750,38109144,98108894,9,0,1,6144,17,8215681318
2979,60045230,1260405,61305635,0,0,0,129024,6,1181420979
2980,60059650,38049267,98108917,4,0,1,3584,4,2889560018
2981,60060461,1081263,61141724,7,0,0,4608,16,5640030612
2982,60082840,1183460,61266300,0,0,0,144384,6,9535444278
2983,60090720,1105863,61196583,8,0,0,1024,6,8397384079
2984,60127660,37981280,98108940,9,0,1,5632,17,2107944720
2985,60130070,37978901,98108971,4,0,1,35840,4,9097093380
2986,60139990,37969004,98108994,9,0,1,7168,17,5489133580
2987,60160020,37948997,98109017,2,0,1,12288,11,5566859846
2988,60184810,37926779,98111589,7,0,1,11776,16,4967114692
2989,60185350,1238345,61423695,1,0,0,8704,6,1155518819
2990,60192950,37955604,98148554,4,0,1,7680,4,6495762905
2991,60197881,1173332,61371213,7,0,0,5120,16,3112403878
2992,60206180,37945676,98151856,5,0,1,2560,11,2378582055
2993,60206300,1477217,61683517,0,0,0,71168,6,5136007332
2994,60260440,1637358,61897798,2,0,0,141824,11,9452833553
2995,60288490,37864992,98153482,2,0,1,2560,11,6929834876
2996,60296500,37870310,98166810,2,0,1,5632,11,3118127152
2997,60329670,37839726,98169396,9,0,1,4096,17,1165530228
2998,60335130,37845722,98180852,9,0,1,16896,17,9160739513
2999,60341490,37840847,98182337,2,0,1,15360,11,8756848828
3000,60353170,1566335,61919505,0,0,0,71168,6,5055053561
3001,60368381,1359448,61727829,7,0,0,4608,16,1531133964
3002,60368889,1583434,61952323,4,0,0,1024,4,3357887323
3003,60376850,37820819,98197669,9,0,1,6144,17,3509106100
3004,60408050,37796418,98204468,1,0,1,20992,6,9191635383
3005,60416350,1634486,62050836,1,0,0,116224,6,1847293878
3006,60442580,37764154,98206734,7,0,1,3584,16,2743526378
3007,60447410,37841813,98289223,7,0,1,17920,16,9923074621
3008,60453569,1372981,61826550,4,0,0,1536,4,9989481267
3009,60489690,37799556,98289246,9,0,1,30208,17,709728282
3010,60489980,1651376,62141356,0,0,0,29184,6,6520298202
3011,60525789,1525538,62051327,4,0,0,1536,4,8119368729
3012,60560551,1289069,61849620,7,0,0,512,16,1759264292
3013,60562170,1600561,62162731,1,0,0,30720,6,3734936155
3014,60591490,37729470,98320960,9,0,1,13312,17,7995798311
3015,60606100,37714883,98320983,2,0,1,1536,11,5651942725
3016,60615020,38131944,98746964,2,0,1,34816,11,389632322
3017,60645790,38437528,99083318,1,0,1,13824,6,1792464079
3018,60672610,2078571,62751181,2,0,0,92672,11,1152139606
3019,60695630,38412272,99107902,1,0,1,1536,6,858221021
3020,60713960,1986539,62700499,2,0,0,483328,11,7587602032
3021,60748809,1627877,62376686,4,0,0,1536,4,9083474654
3022,60753800,38357268,99111068,2,0,1,7680,11,3952949161
3023,60774771,38337123,99111894,0,0,1,14848,6,1993027316
3024,60780800,38425886,99206686,2,0,1,12800,11,3737008121
3025,60830979,1871415,62702394,4,0,0,6144,4,7636096823
3026,60831890,1261253,62093143,5,0,0,4096,11,5821543750
3027,60857850,38348859,99206709,2,0,1,2048,11,8303114176
3028,60906229,1856389,62762618,4,0,0,512,4,9051768218
3029,60913690,1809209,62722899,2,0,0,65536,11,6086850337
3030,60919090,38287642,99206732,8,0,1,14848,6,2102151326
3031,60926780,38279975,99206755,1,0,1,3584,6,4766968252
3032,60942720,38264058,99206778,2,0,1,1536,11,1388608824
3033,60956551,40393415,101349966,0,0,1,1049088,6,3791879287
3034,60968780,1734105,62702885,5,0,0,1536,11,10373725637
3035,60969931,40484792,101454723,0,0,1,88064,6,512286798
3036,60999360,1752008,62751368,8,0,0,512,6,6094978381
3037,61006030,2628132,63634162,2,0,0,450048,11,6503681584
3038,61032829,1994942,63027771,4,0,0,5120,4,3334325219
3039,61055840,2187069,63242909,0,0,0,134144,6,7813415612
3040,61074350,40380396,101454746,2,0,1,13312,11,8476945867
3041,61080841,1872854,62953695,7,0,0,2560,16,2140572607
3042,61105740,1981011,63086751,8,0,0,2048,6,948030811
3043,61122420,40332349,101454769,1,0,1,13312,6,9248793161
3044,61122781,40335530,101458311,0,0,1,54272,6,10330914188
3045,61126421,2117447,63243868,7,0,0,3072,16,10710153360
3046,61146980,40316522,101463502,9,0,1,5632,17,1816793499
3047,61148050,40324804,101472854,9,0,1,25600,17,10596312018
3048,61168260,2101284,63269544,2,0,0,26112,11,5474655068
3049,61168449,2607921,63776370,4,0,0,1024,4,1669666614
3050,61179800,2081742,63261542,2,0,0,57856,11,3961546670
3051,61187691,40517716,101705407,0,0,1,329728,6,1120019607
3052,61203520,40581186,101784706,9,0,1,10240,17,1273973750
3053,61205300,2570735,63776035,1,0,0,77312,6,4601023862
3054,61260360,2490825,63751185,2,0,0,384000,11,1297800124
3055,61274510,40596603,101871113,9,0,1,49664,17,1039148404
3056,61300540,40629956,101930496,1,0,1,15360,6,918941521
3057,61303669,2513205,63816874,4,0,0,4096,4,9744839637
3058,61317909,2434547,63752456,4,0,0,4096,4,9054367112
3059,61329510,40601009,101930519,9,0,1,4608,17,3233483170
3060,61331171,2484409,63815580,7,0,0,128512,16,3678477999
3061,61338731,41164951,102503682,0,0,1,164864,6,5311956226
3062,61377210,2455357,63832567,1,0,0,51200,6,658574330
3063,61385150,41118555,102503705,2,0,1,13824,11,9955319970
3064,61386470,41117258,102503728,1,0,1,7168,6,334985825
3065,61394060,2642529,64036589,5,0,0,1536,11,5141109040
3066,61399020,41104731,102503751,1,0,1,18432,6,434869486
3067,61419780,2762247,64182027,0,0,0,91648,6,10631197695
3068,61436530,41121422,102557952,1,0,1,28160,6,9256388492
3069,61446060,2485715,63931775,5,0,0,4608,11,7800328235
3070,61500860,41057115,102557975,2,0,1,7168,11,39431454
3071,61512349,2572383,64084732,4,0,0,512,4,8651004323
3072,61516511,2487950,64004461,7,0,0,21504,16,200678843
3073,61519410,41038588,102557998,1,0,1,512,6,1498724224
3074,61527941,41065242,102593183,0,0,1,37888,6,6693040601
3075,61543590,3011850,64555440,8,0,0,1536,6,3510964722
3076,61610740,3148541,64759281,0,0,0,200704,6,5695856095
3077,61673820,40935558,102609378,1,0,1,26112,6,515639842
3078,61680280,2848031,64528311,2,0,0,62976,11,9948506220
3079,61689390,3197481,64886871,2,0,0,215040,11,4168555747
3080,61689690,40969336,102659026,1,0,1,28160,6,8870440960
3081,61710081,41558941,103269022,0,0,1,248320,6,8035778494
3082,61729030,41540015,103269045,9,0,1,9728,17,3874260359
3083,61777050,41492018,103269068,9,0,1,18944,17,1040636991
3084,61795871,41676237,103472108,0,0,1,268288,6,4329422457
3085,61813920,41663334,103477254,1,0,1,8192,6,176957201
3086,61822780,41657726,103480506,2,0,1,5120,11,7715869369
3087,61834080,41648692,103482772,2,0,1,3584,11,5269819256
3088,61844490,41638948,103483438,9,0,1,1024,17,6093894996
3089,61865400,2583486,64448886,0,0,0,15360,6,4431488062
3090,61869079,3048668,64917747,4,0,0,4096,4,4168499040
3091,61869200,2767202,64636402,5,0,0,2048,11,565419225
3092,61892309,2867463,64759772,4,0,0,1536,4,8889026100
3093,61902301,41686194,103588495,0,0,1,138752,6,2319504054
3094,61913960,41676161,103590121,2,0,1,2560,11,5782717169
3095,61923331,2985871,64909202,7,0,0,73216,16,33792299
3096,61963420,2467931,64431351,2,0,0,1024,11,9798904490
3097,62018861,2787687,64806548,7,0,0,112640,16,2927252
3098,62070780,3090554,65161334,5,0,0,2560,11,9222110259
3099,62098500,2900851,64999351,8,0,0,3072,6,7448123343
3100,62126050,41505283,103631333,1,0,1,43008,6,2760125223
3101,62128760,41502596,103631356,9,0,1,7168,17,9200312673
3102,62202291,3328213,65530504,7,0,0,476672,16,4750935325
3103,62220040,3054006,65274046,0,0,0,200704,6,2051487030
3104,62253190,41378189,103631379,1,0,1,20480,6,7932803989
3105,62257259,2195881,64453140,4,0,0,1024,4,3306378103
3106,62304150,2517090,64821240,5,0,0,2048,11,7549134445
3107,62304791,2616094,64920885,7,0,0,512,16,3326867846
3108,62338420,41292982,103631402,9,0,1,15872,17,4918817467
3109,62346881,3197397,65544278,7,0,0,36352,16,3017273964
3110,62410201,3456052,65866253,7,0,0,356864,16,475990222
3111,62413780,2393305,64807085,5,0,0,1536,11,1185511319
3112,62435229,2659363,65094592,4,0,0,1024,4,1911257759
3113,62445040,3560601,66005641,1,0,0,129536,6,6980268111
3114,62450260,41183423,103633683,2,0,1,36352,11,9639963271
3115,62457880,41180629,103638509,9,0,1,7680,17,10497450932
3116,62466290,2625358,65091648,5,0,0,5120,11,3795270589
3117,62485400,41156335,103641735,2,0,1,5120,11,4728542516
3118,62529470,41130204,103659674,9,0,1,1536,17,9384877892
3119,62532470,41248469,103780939,2,0,1,59904,11,2358940649
3120,62533739,2418235,64951974,4,0,0,1536,4,265112763
3121,62622830,2910349,65533179,1,0,0,8704,6,7128647157
3122,62623761,2978479,65602240,7,0,0,98304,16,8918088345
3123,62643100,41137862,103780962,2,0,1,1024,11,3793781015
3124,62667190,2939129,65606319,2,0,0,13312,11,7668302586
3125,62672540,3050546,65723086,2,0,0,246784,11,795906772
3126,62673010,41107975,103780985,2,0,1,1024,11,4306016090
3127,62710351,3255799,65966150,7,0,0,50176,16,7840628476
3128,62754720,3297307,66052027,2,0,0,152064,11,7373697425
3129,62771400,2981996,65753396,1,0,0,96256,6,487520196
3130,62775280,41005728,103781008,1,0,1,8192,6,8980916373
3131,62816830,40964201,103781031,2,0,1,1536,11,4857296547
3132,62845980,40935074,103781054,4,0,1,2560,4,146319630
3133,62857689,2866356,65724045,4,0,0,3072,4,870381397
3134,62861430,40919647,103781077,1,0,1,13824,6,56255163
3135,62894750,2862748,65757498,0,0,0,11776,6,10503356477
3136,62908400,40872700,103781100,1,0,1,6656,6,2055972799
3137,62931310,2994471,65925781,1,0,0,187392,6,5644295577
3138,62951520,3308966,66260486,2,0,0,260096,11,7681183884
3139,63013010,2363770,65376780,5,0,0,1024,11,9234931892
3140,63054120,40727003,103781123,2,0,1,11264,11,10190517133
3141,63054780,3206041,66260821,8,0,0,1024,6,3098074759
3142,63147440,2606447,65753887,8,0,0,1536,6,7211006954
3143,63162789,2705827,65868616,4,0,0,7680,4,9002692445
3144,63180010,40601136,103781146,1,0,1,2560,6,9115050548
3145,63203750,40577419,103781169,2,0,1,26624,11,8697694189
3146,63209940,40571252,103781192,2,0,1,2560,11,1596266002
3147,63217450,40563765,103781215,2,0,1,1024,11,5965925399
3148,63238730,40542508,103781238,2,0,1,5632,11,9236260649
3149,63252120,3293152,66545272,1,0,0,76288,6,5042073411
3150,63273510,40507751,103781261,9,0,1,9728,17,10514737220
3151,63289640,40620094,103909734,2,0,1,23552,11,6690830908
3152,63300250,2625795,65926045,5,0,0,512,11,10397090268
3153,63308020,2745012,66053032,8,0,0,3072,6,3334906241
3154,63347311,3365115,66712426,7,0,0,153088,16,9108711465
3155,63375150,2678256,66053406,5,0,0,1024,11,3041269493
3156,63423820,2688359,66112179,2,0,0,27648,11,5538362086
3157,63469661,3755634,67225295,7,0,0,408064,16,1998182830
3158,63534620,40461304,103995924,7,0,1,27136,16,9503138871
3159,63537571,3259164,66796735,7,0,0,1536,16,5330775002
3160,63543240,3512726,67055966,0,0,0,633856,6,70888688
3161,63548250,40476448,104024698,1,0,1,10240,6,6048127303
3162,63557690,40875316,104433006,2,0,1,37888,11,2338173493
3163,63565090,40983835,104548925,2,0,1,2048,11,5003932694
3164,63634540,40918153,104552693,7,0,1,4096,16,4098803796
3165,63656350,41078334,104734684,7,0,1,20992,16,1929077250
3166,63705600,3395340,67100940,1,0,0,128000,6,8183480926
3167,63721890,41012817,104734707,1,0,1,3072,6,5639060079
3168,63736039,2978750,66714789,4,0,0,7680,4,7678650609
3169,63743500,40991230,104734730,1,0,1,3072,6,7547399539
3170,63750580,40984173,104734753,7,0,1,1024,16,538880566
3171,63751800,40982976,104734776,7,0,1,2048,16,4385151506
3172,63762730,40972069,104734799,7,0,1,1536,16,3723366018
3173,63765760,41310122,105075882,2,0,1,67072,11,435950116
3174,63865650,41222076,105087726,1,0,1,5120,6,415670553
3175,63884691,3442370,67327061,7,0,0,333312,16,4421927017
3176,63924190,41336599,105260789,2,0,1,4096,11,4726561274
3177,63952900,3477464,67430364,0,0,0,338944,6,135114691
3178,63984280,3077637,67061917,1,0,0,19456,6,9333040310
3179,63987560,41273252,105260812,7,0,1,26624,16,3920905410
3180,64020950,41296091,105317041,7,0,1,35840,16,1804911507
3181,64043990,41273074,105317064,1,0,1,1536,6,1384137887
3182,64057519,3167955,67225474,4,0,0,512,4,3111747282
3183,64073410,41346714,105420124,2,0,1,36352,11,2126428026
3184,64102710,41345883,105448593,1,0,1,48128,6,2773405123
3185,64103260,41346003,105449263,1,0,1,18432,6,8228646442
3186,64178769,3252317,67431086,4,0,0,1536,4,6238417804
3187,64210910,41238376,105449286,2,0,1,3072,11,1732933
3188,64239790,41209519,105449309,1,0,1,4096,6,7826596271
3189,64461570,41118347,105579917,1,0,1,81408,6,3943953446
3190,64465830,3524952,67990782,1,0,0,90112,6,2872308637
3191,64504120,41785936,106290056,1,0,1,27648,6,7499592449
3192,64542741,3819201,68361942,7,0,0,43008,16,3818061085
3193,64551830,2993716,67545546,5,0,0,2048,11,1386455173
3194,64573029,3599375,68172404,4,0,0,3072,4,5162635963
3195,64576060,3364659,67940719,0,0,0,25088,6,4132768352
3196,64608770,3492314,68101084,1,0,0,59904,6,1216197144
3197,64615640,41749256,106364896,1,0,1,19968,6,1956978316
3198,64673320,3733729,68407049,0,0,0,147968,6,5895463524
3199,64720110,3556672,68276782,8,0,0,512,6,2366800740
3200,64771500,3172206,67943706,1,0,0,9728,6,10718091489
3201,64773620,3575172,68348792,0,0,0,107008,6,1254479188
3202,64783350,3125031,67908381,1,0,0,217088,6,5304319753
3203,64792600,41589502,106382102,1,0,1,30208,6,4585593941
3204,64805871,3243620,68049491,7,0,0,5120,16,10063770640
3205,64815970,41618189,106434159,1,0,1,1536,6,7438589809
3206,64821480,3111572,67933052,1,0,0,80896,6,2366710894
3207,64832881,2819438,67652319,7,0,0,9216,16,78677412
3208,64851310,2926647,67777957,8,0,0,3584,6,6158636451
3209,64877330,3607210,68484540,1,0,0,235520,6,10594937950
3210,64881159,3383559,68264718,4,0,0,1024,4,8407612387
3211,64887350,41547987,106435337,3,0,1,13824,0,2199464669
3212,64901700,3694715,68596415,1,0,0,367104,6,3606037025
3213,64935360,3147045,68082405,8,0,0,512,6,3775506508
3214,64947270,3270992,68218262,5,0,0,5120,11,6199035436
3215,64953250,41528679,106481929,3,0,1,4096,0,3687381903
3216,64977320,3753067,68730387,3,0,0,110592,0,9749408947
3217,64991810,3606968,68598778,0,0,0,7680,6,8830033279
3218,65000910,3303266,68304176,8,0,0,512,6,6716289316
3219,65005230,41627935,106633165,1,0,1,70656,6,6258540934
3220,65040300,42165634,107205934,1,0,1,648704,6,9652865274
3221,65042040,3365367,68407407,5,0,0,1024,11,3893817425
3222,65042850,42370031,107412881,1,0,1,153600,6,1247410486
3223,65083200,42343950,107427150,1,0,1,90112,6,4430883673
3224,65109770,3765826,68875596,0,0,0,179712,6,5123270316
3225,65138330,42322593,107460923,9,0,1,8192,17,6999651414
3226,65153390,3462016,68615406,0,0,0,49664,6,8791494242
3227,65187390,3445675,68633065,0,0,0,57856,6,6236180973
3228,65231600,3368651,68600251,8,0,0,3584,6,124779907
3229,65247520,3449125,68696645,2,0,0,114688,11,1110426499
3230,65266700,3332413,68599113,5,0,0,1024,11,10306363266
3231,65306721,3586595,68893316,7,0,0,38400,16,7002098004
3232,65362110,3549325,68911435,0,0,0,59392,6,2875711667
3233,65378890,3254978,68633868,8,0,0,2560,6,10135846875
3234,65379720,3796489,69176209,8,0,0,2560,6,723347362
3235,65459770,3458895,68918665,0,0,0,23552,6,4430182625
3236,65476110,3632238,69108348,3,0,0,109056,0,2299495400
3237,65498661,3382932,68881593,7,0,0,16384,16,6394471428
3238,65557639,3173418,68731057,4,0,0,2048,4,4200909391
3239,65647360,3298796,68946156,3,0,0,20480,0,8970818947
3240,65648510,3483463,69131973,1,0,0,7168,6,4057399537
3241,65679870,3196708,68876578,8,0,0,1024,6,9227051861
3242,65682060,3839188,69521248,2,0,0,85504,11,6156382033
3243,65701700,41763435,107465135,6,0,1,6656,3,2739785076
3244,65767419,3727754,69495173,4,0,0,1536,4,3346104287
3245,65775110,3101133,68876243,8,0,0,2048,6,5516686457
3246,65779890,4030698,69810588,1,0,0,337408,6,9393586614
3247,65838750,3384014,69222764,5,0,0,1024,11,8087992627
3248,65878470,3172692,69051162,1,0,0,74240,6,3775460795
3249,65885040,3462336,69347376,1,0,0,34304,6,9083894460
3250,66010120,3190695,69200815,5,0,0,1536,11,5481247675
3251,66030961,3032860,69063821,7,0,0,41472,16,10597608137
3252,66076079,3032448,69108527,4,0,0,512,4,1784326394
3253,66184060,3666377,69850437,0,0,0,37888,6,7737711544
3254,66185620,2944146,69129766,0,0,0,69632,6,5282203137
3255,66200300,41265501,107465801,1,0,1,1024,6,3700701334
3256,66200350,41266757,107467107,1,0,1,2048,6,8310158376
3257,66201540,41265913,107467453,1,0,1,512,6,5625200838
3258,66226560,3612310,69838870,3,0,0,65536,0,7736941200
3259,66247840,3246842,69494682,2,0,0,27648,11,6903461088
3260,66274821,3909087,70183908,7,0,0,436224,16,9509395871
3261,66281220,3688926,69970146,2,0,0,290304,11,5974753130
3262,66298140,4166488,70464628,3,0,0,174080,0,3448699958
3263,66366340,4045225,70411565,3,0,0,623104,0,5297695245
3264,66386400,41126045,107512445,3,0,1,18944,0,379127465
3265,66392310,3426569,69818879,0,0,0,27136,6,8280949600
3266,66416830,41119335,107536165,1,0,1,11776,6,5728275539
3267,66439410,3430003,69869413,0,0,0,61952,6,1001974073
3268,66456480,3522581,69979061,3,0,0,29184,0,3989704106
3269,66471780,41066651,107538431,1,0,1,3584,6,4995167563
3270,66491690,3730000,70221690,0,0,0,34816,6,9476580552
3271,66494220,4391185,70885405,1,0,0,156160,6,2008019044
3272,66528781,4308998,70837779,7,0,0,408576,16,4481089783
3273,66533650,41007892,107541542,3,0,1,10240,0,4107663373
3274,66590350,3940514,70530864,3,0,0,185344,0,6245670400
3275,66608420,41031949,107640369,3,0,1,80384,0,7622283865
3276,66616640,41023752,107640392,1,0,1,13312,6,10234953167
3277,66660289,3890878,70551167,4,0,0,66560,4,6129388755
3278,66675990,40964425,107640415,1,0,1,13824,6,3561886651
3279,66728370,3142470,69870840,8,0,0,4608,6,975006242
3280,66767511,3706835,70474346,7,0,0,31744,16,413201186
3281,66920380,40720058,107640438,3,0,1,26112,0,10280262750
3282,66942500,40719458,107661958,3,0,1,12288,0,7526563315
3283,66970870,3658514,70629384,3,0,0,119296,0,1431085238
3284,66988730,40676454,107665184,3,0,1,5120,0,3899088851
3285,67030670,40634860,107665530,1,0,1,512,6,1595947125
3286,67044410,3510096,70554506,8,0,0,1024,6,2213314651
3287,67050340,40617136,107667476,3,0,1,3072,0,10410491238
3288,67060869,3847742,70908611,4,0,0,75264,4,648933403
3289,67077290,3115030,70192320,3,0,0,6656,0,4036577094
3290,67089160,3600230,70689390,0,0,0,2560,6,8700545255
3291,67104230,40564232,107668462,8,0,1,1536,6,1841932698
3292,67135541,40583957,107719498,0,0,1,6144,6,7685827379
3293,67143060,40576461,107719521,3,0,1,15360,0,7498553336
3294,67182271,40754249,107936520,0,0,1,88576,6,2512896358
3295,67247400,3741655,70989055,6,0,0,69632,3,8597279574
3296,67275919,4887462,72163381,4,0,0,673792,4,7980419268
3297,67295909,3861708,71157617,4,0,0,104960,4,5540417064
3298,67307550,40628993,107936543,1,0,1,6656,6,1667183201
3299,67312260,4190826,71503086,2,0,0,10240,11,7956187816
3300,67319401,4949349,72268750,7,0,0,129536,16,3002530788
3301,67338080,4451166,71789246,1,0,0,162304,6,2111912071
3302,67340670,3570772,70911442,0,0,0,9216,6,1217921435
3303,67354099,5122246,72476345,4,0,0,151040,4,3522058258
3304,67403110,3903573,71306683,8,0,0,3584,6,8651978377
3305,67422600,40555492,107978092,1,0,1,26112,6,1983199224
3306,67437990,4900544,72338534,6,0,0,184832,3,7504742766
3307,67490550,40488344,107978894,1,0,1,27136,6,4275405161
3308,67503989,3860016,71364005,4,0,0,79360,4,3889350202
3309,67535290,5184793,72720083,3,0,0,400384,0,7484657708
3310,67562910,4306470,71869380,3,0,0,11264,0,2463859830
3311,67563770,40423775,107987545,3,0,1,7168,0,4415101113
3312,67582960,3952300,71535260,0,0,0,69632,6,743851355
3313,67584869,3837396,71422265,4,0,0,23552,4,906032239
3314,67594960,40468644,108063604,1,0,1,48128,6,4403227870
3315,67597480,40476429,108073909,3,0,1,34816,0,7513809351
3316,67642780,40433480,108076260,8,0,1,3072,6,10589779318
3317,67679130,3983205,71662335,6,0,0,71680,3,7741240470
3318,67686219,4521957,72208176,4,0,0,146944,4,8763149932
3319,67695001,5134975,72829976,7,0,0,238592,16,3903046844
3320,67706570,40371316,108077886,1,0,1,2560,6,5553581282
3321,67707350,4095884,71803234,8,0,0,1024,6,4831956499
3322,67711050,40424980,108136030,1,0,1,45056,6,539204126
3323,67718240,40585978,108304218,8,0,1,36864,6,1888503016
3324,67727660,5174991,72902651,6,0,0,44544,3,6594446996
3325,67804570,5336201,73140771,0,0,0,148480,6,6774371857
3326,67828640,4400619,72229259,3,0,0,69120,0,8789356780
3327,67838670,40465571,108304241,8,0,1,3072,6,7288186045
3328,67852540,4703195,72555735,1,0,0,213504,6,9674347740
3329,67862800,40444965,108307765,8,0,1,22528,6,8420082059
3330,67894030,40413758,108307788,3,0,1,1536,0,7085243544
3331,67904620,40403191,108307811,3,0,1,14336,0,6310442334
3332,67905400,4497140,72402540,1,0,0,195072,6,4384997014
3333,67924060,40383774,108307834,8,0,1,16896,6,9971542514
3334,67930430,4345230,72275660,6,0,0,21504,3,3322885193
3335,67936341,40490134,108426475,0,0,1,132096,6,932861759
3336,67949190,5451935,73401125,0,0,0,329728,6,1501177531
3337,67954060,4315025,72269085,8,0,0,1024,6,629766207
3338,68026921,4316160,72343081,7,0,0,14848,16,4896134973
3339,68049171,4675147,72724318,7,0,0,13824,16,5650651839
3340,68062450,5483973,73546423,1,0,0,318976,6,1341660874
3341,68067420,4412224,72479644,0,0,0,10752,6,8731809246
3342,68083150,5177304,73260454,2,0,0,392704,11,1698319381
3343,68093511,4663746,72757257,7,0,0,108032,16,4933526644
3344,68106300,40323721,108430021,5,0,1,5632,11,3446987300
3345,68160040,40319307,108479347,5,0,1,59392,11,7379363005
3346,68165730,4666929,72832659,8,0,0,8704,6,5854438871
3347,68177491,4790937,72968428,7,0,0,15360,16,5608166062
3348,68188749,5111889,73300638,4,0,0,77824,4,5254400098
3349,68213780,40270659,108484439,3,0,1,10752,0,6569758173
3350,68246180,40239539,108485719,8,0,1,14336,6,9711712990
3351,68247950,4846911,73094861,1,0,0,144384,6,335766785
3352,68266810,40224336,108491146,8,0,1,25088,6,4966404998
3353,68272490,5176722,73449212,3,0,0,157696,0,9460775962
3354,68316460,4960443,73276903,0,0,0,53760,6,9411077924
3355,68327220,40178755,108505975,3,0,1,14848,0,4514820092
3356,68349440,4695919,73045359,8,0,0,512,6,347359731
3357,68370870,4724638,73095508,8,0,0,2048,6,740938084
3358,68405110,5437507,73842617,6,0,0,38912,3,5821403900
3359,68433060,5344620,73777680,3,0,0,144896,0,3519965806
3360,68452900,5225924,73678824,1,0,0,286208,6,9970990255
3361,68474000,5259470,73733470,1,0,0,179200,6,5110918647
3362,68481030,40071959,108552989,8,0,1,23552,6,3791806450
3363,68493420,5324111,73817531,1,0,0,79360,6,581152159
3364,68532450,40020562,108553012,8,0,1,13312,6,9475596458
3365,68538061,5241046,73779107,7,0,0,4608,16,6311609417
3366,68541270,40025305,108566575,8,0,1,17408,6,7860360660
3367,68542930,5899433,74442363,2,0,0,191488,11,10349953517
3368,68550890,40453684,109004574,3,0,1,9216,0,4672881494
3369,68576921,5291624,73868545,7,0,0,49152,16,7542969915
3370,68583710,5397003,73980713,3,0,0,51712,0,5792416805
3371,68594730,5506486,74101216,3,0,0,165376,0,2866135109
3372,68601970,40759394,109361364,4,0,1,33280,4,1867329379
3373,68617610,5266307,73883917,3,0,0,2048,0,2223343951
3374,68662170,5873281,74535451,8,0,0,1024,6,253431074
3375,68713990,6239647,74953637,0,0,0,721408,6,10598788517
3376,68727860,40633527,109361387,3,0,1,7680,0,1838768780
3377,68751480,40609930,109361410,3,0,1,19456,0,2836902862
3378,68788790,6209532,74998322,2,0,0,143360,11,4991043671
3379,68794030,6352748,75146778,3,0,0,294912,0,2123663853
3380,68811320,5921843,74733163,2,0,0,131584,11,5030876503
3381,68823001,5342043,74165044,7,0,0,35840,16,1380553639
3382,68830720,6123720,74954440,1,0,0,2560,6,3813822002
3383,68875650,6137827,75013477,6,0,0,49664,3,6716942268
3384,68885810,5361554,74247364,8,0,0,2560,6,3183454566
3385,68917430,40526035,109443465,8,0,1,32768,6,674554685
3386,68953290,40655696,109608986,8,0,1,19968,6,6941584730
3387,68958701,6260617,75219318,7,0,0,146944,16,4098686494
3388,68999510,5336449,74335959,0,0,0,3584,6,936530944
3389,69012010,40596999,109609009,3,0,1,9728,0,9059637566
3390,69014450,40603185,109617635,8,0,1,12288,6,6129334196
3391,69094191,6351091,75445282,7,0,0,259584,16,886768575
3392,69105960,5627850,74733810,8,0,0,2048,6,8110668672
3393,69129720,40487938,109617658,8,0,1,3072,6,3458073513
3394,69179020,5775599,74954619,8,0,0,512,6,9170200521
3395,69223330,5833569,75056899,0,0,0,121856,6,4542023974
3396,69290940,5728800,75019740,1,0,0,20480,6,10708370807
3397,69292870,6497835,75790705,1,0,0,439808,6,2023458974
3398,69320910,6317756,75638666,6,0,0,519680,3,8006782941
3399,69321140,40296541,109617681,3,0,1,11264,0,10166777474
3400,69372689,5957671,75330360,4,0,0,71680,4,9762831265
3401,69376910,6102582,75479492,0,0,0,112128,6,3963339393
3402,69377750,6521437,75899187,3,0,0,77824,0,2353047679
3403,69405460,40260949,109666409,3,0,1,44032,0,5365545525
3404,69429160,6404496,75833656,6,0,0,9216,3,3655600849
3405,69540151,6267425,75807576,7,0,0,55296,16,10010499186
3406,69559360,5806807,75366167,6,0,0,41984,3,4930345142
3407,69568840,5782556,75351396,8,0,0,2560,6,54700262
3408,69583420,6267731,75851151,2,0,0,57344,11,3564839332
3409,69589390,40078197,109667587,3,0,1,13824,0,1860350943
3410,69589840,40123074,109712914,3,0,1,13824,0,3221217964
3411,69679710,6151115,75830825,2,0,0,75776,11,1692454630
3412,69706800,6168652,75875452,3,0,0,35328,0,6225992278
3413,69752440,40006042,109758482,6,0,1,11264,3,10313345497
3414,69756290,5724005,75480295,8,0,0,2560,6,2634031705
3415,69756900,6097583,75854483,8,0,0,512,6,1507328728
3416,69757440,6178720,75936160,1,0,0,55808,6,7539353593
3417,69828560,6251314,76079874,1,0,0,92672,6,279927468
3418,69850610,6456746,76307356,6,0,0,61952,3,6410305448
3419,69852571,39907537,109760108,0,0,1,2560,6,8973775101
3420,69885110,39876624,109761734,8,0,1,2560,6,6826195704
3421,69888951,6240086,76129037,7,0,0,161280,16,4277217961
3422,69916920,6306669,76223589,3,0,0,45568,0,9480306424
3423,69950180,6733364,76683544,6,0,0,18944,3,1053880582
3424,70005940,6177191,76183131,3,0,0,27648,0,5832074761
3425,70006180,6318138,76324318,1,0,0,6656,6,95761051
3426,70010220,6956698,76966918,3,0,0,237056,0,2743318981
3427,70055820,6192396,76248216,2,0,0,18944,11,5757702345
3428,70072780,40660763,110733543,3,0,1,31232,0,4356901203
3429,70085560,6485202,76570762,0,0,0,214528,6,2017496493
3430,70092120,40703847,110795967,8,0,1,14336,6,9514377131
3431,70143641,6095298,76238939,7,0,0,49152,16,5328155684
3432,70145520,6064162,76209682,0,0,0,66048,6,6516751977
3433,70163440,6633994,76797434,1,0,0,129024,6,1745972549
3434,70163810,7698452,77862262,6,0,0,25600,3,410241540
3435,70197940,40638735,110836675,8,0,1,12288,6,9715885549
3436,70202300,40654367,110856667,9,0,1,9216,17,4423670928
3437,70219130,6979930,77199060,1,0,0,314368,6,5162499546
3438,70228520,7046269,77274789,3,0,0,228352,0,10031884014
3439,70272629,6002406,76275035,4,0,0,16384,4,2737270877
3440,70275279,6482820,76758099,4,0,0,105472,4,7504917138
3441,70291140,6288381,76579521,0,0,0,28672,6,7218949379
3442,70298700,6695541,76994241,2,0,0,89600,11,384975288
3443,70304690,6278286,76582976,1,0,0,11264,6,7020244166
3444,70364160,40653945,111018105,8,0,1,37376,6,6416327738
3445,70379790,40638338,111018128,9,0,1,1536,17,4685764018
3446,70410220,40607931,111018151,3,0,1,8192,0,7945958166
3447,70413830,7032804,77446634,0,0,0,204800,6,9612552552
3448,70415550,7168524,77584074,3,0,0,118272,0,7492161829
3449,70434600,40583574,111018174,8,0,1,13824,6,1425263581
3450,70449170,40569027,111018197,3,0,1,32256,0,8295345907
3451,70513000,40639849,111152849,7,0,1,33792,16,272520732
3452,70550340,40602532,111152872,1,0,1,5632,6,8388689545
3453,70552470,40600433,111152903,3,0,1,15872,0,171407356
3454,70572350,40678325,111250675,9,0,1,4608,17,3883418017
3455,70597979,6470096,77068075,4,0,0,214528,4,9184124627
3456,70612610,6663535,77276145,8,0,0,3584,6,9034693060
3457,70638050,6636934,77274984,8,0,0,512,6,8850634003
3458,70648970,7397235,78046205,1,0,0,57344,6,373592533
3459,70668550,40582148,111250698,1,0,1,25600,6,6553212295
3460,70668931,6333757,77002688,7,0,0,27648,16,8830712603
3461,70682200,40568521,111250721,3,0,1,7680,0,5539110556
3462,70697970,6648674,77346644,6,0,0,201216,3,7284967033
3463,70698600,40552144,111250744,8,0,1,45056,6,9037326751
3464,70722260,40559199,111281459,1,0,1,28672,6,8928097462
3465,70745030,6339952,77084982,0,0,0,10240,6,1942883547
3466,70765520,40516093,111281613,3,0,1,8704,0,10278297786
3467,70775690,6429500,77205190,0,0,0,19968,6,9590096780
3468,70781260,40672000,111453260,1,0,1,37376,6,7921904228
3469,70823380,6525783,77349163,3,0,0,8192,0,2278925188
3470,70860751,6684325,77545076,7,0,0,215040,16,9810831322
3471,70872909,6909505,77782414,4,0,0,180224,4,5419378020
3472,70907250,40546033,111453283,3,0,1,65536,0,4352226666
3473,70918501,40643402,111561903,0,0,1,45568,6,3369105875
3474,70924180,6731580,77655760,8,0,0,1536,6,8064800738
3475,70928330,6619623,77547953,8,0,0,2560,6,8515271983
3476,70945490,6732902,77678392,3,0,0,31744,0,10668727206
3477,70946390,6600760,77547150,2,0,0,6656,11,7597960514
3478,70970810,6927218,77898028,6,0,0,64512,3,2024969429
3479,70975650,7286350,78262000,1,0,0,261120,6,6747537191
3480,71021550,7146648,78168198,3,0,0,42496,0,2273769819
3481,71026660,40535266,111561926,4,0,1,6656,4,9006787360
3482,71027560,6755189,77782749,8,0,0,1024,6,107926527
3483,71036880,6894173,77931053,8,0,0,2048,6,5629263404
3484,71040361,40657267,111697628,0,0,1,134144,6,442437392
3485,71041779,7458179,78499958,4,0,0,235008,4,2999333306
3486,71069640,7358691,78428331,2,0,0,187904,11,10099248291
3487,71088630,40609021,111697651,6,0,1,18944,3,1374347819
3488,71100260,40597414,111697674,4,0,1,7680,4,1262486799
3489,71118711,6934271,78052982,7,0,0,22016,16,6021002369
3490,71140750,40556947,111697697,1,0,1,512,6,10592765655
3491,71188261,6786765,77975026,7,0,0,113152,16,4727396557
3492,71191010,7407717,78598727,1,0,0,55808,6,1992835630
3493,71204290,7057920,78262210,8,0,0,512,6,412339594
3494,71217500,40480220,111697720,1,0,1,12800,6,6085797682
3495,71248100,7067393,78315493,2,0,0,11264,11,315206764
3496,71263080,40635413,111898493,7,0,1,41472,16,1773743227
3497,71280870,7483477,78764347,0,0,0,79872,6,10441714960
3498,71282380,6692825,77975205,8,0,0,512,6,8802664335
3499,71287900,7262745,78550645,6,0,0,45056,3,4399432186
3500,71347200,7703026,79050226,2,0,0,238080,11,6098462714
3501,71354070,40720125,112074195,1,0,1,4096,6,5894205983
3502,71355050,6827367,78182417,3,0,0,46592,0,8168273331
3503,71413351,40671365,112084716,0,0,1,61440,6,1324987822
3504,71447320,40824188,112271508,7,0,1,4608,16,8730406549
3505,71522620,7335373,78857993,2,0,0,237568,11,9106070747
3506,71533770,7402840,78936610,2,0,0,93184,11,4720508500
3507,71541710,7180907,78722617,0,0,0,79872,6,1310817865
3508,71569600,40784349,112353949,7,0,1,44032,16,9921764845
3509,71600770,40756237,112357007,4,0,1,18944,4,898881543
3510,71610010,7033671,78643681,0,0,0,2560,6,8193799765
3511,71611510,6913447,78524957,8,0,0,1024,6,2603667592
3512,71649889,7135697,78785586,4,0,0,69632,4,2158158903
3513,71668839,7239356,78908195,4,0,0,131584,4,2194857138
3514,71681790,7949409,79631199,1,0,0,327168,6,5917191889
3515,71688190,7289473,78977663,3,0,0,89600,0,7828511790
3516,71711481,7385902,79097383,7,0,0,71680,16,2119676234
3517,71745080,7584125,79329205,6,0,0,236544,3,168559674
3518,71774700,40620921,112395621,6,0,1,25088,3,4865273781
3519,71787260,7703628,79490888,3,0,0,49664,0,2620079628
3520,71797831,41569179,113367010,0,0,1,168448,6,1623490546
3521,71815030,7845807,79660837,0,0,0,89600,6,2755224141
3522,71829940,6723692,78553632,3,0,0,9728,0,10607696637
3523,71874630,7348331,79222961,3,0,0,99840,0,5644461297
3524,71883409,7592324,79475733,4,0,0,350720,4,10104554090
3525,71903759,7799352,79703111,4,0,0,138240,4,7215764381
3526,71912729,6950287,78863016,4,0,0,16384,4,3914959100
3527,71927970,41468816,113396786,7,0,1,7168,16,6328857517
3528,71944850,41456442,113401292,6,0,1,7168,3,5122536133
3529,71946640,7560495,79507135,1,0,0,53248,6,10429900020
3530,71947000,41633844,113580844,7,0,1,36864,16,8050338043
3531,71948250,7110275,79058525,1,0,0,27136,6,2474123163
3532,71950790,41639616,113590406,4,0,1,23040,4,3231908522
3533,71951811,41638618,113590429,0,0,1,31232,6,9725684813
3534,71958800,7878477,79837277,3,0,0,189440,0,6634573780
3535,71982810,41607642,113590452,4,0,1,59392,4,6638231655
3536,72003590,7629816,79633406,1,0,0,7168,6,3524698847
3537,72016031,8040545,80056576,7,0,0,189952,16,2656041465
3538,72024000,41959292,113983292,1,0,1,30720,6,2186615509
3539,72049780,41933535,113983315,6,0,1,27648,3,7160376823
3540,72070040,7260592,79330632,8,0,0,4608,6,2111177128
3541,72079910,41903428,113983338,7,0,1,3584,16,725277958
3542,72108660,41898280,114006940,1,0,1,2560,6,3301967556
3543,72115490,7763473,79878963,8,0,0,5632,6,6363871531
3544,72118760,7412289,79531049,6,0,0,78336,3,8445853370
3545,72122330,41884633,114006963,1,0,1,4608,6,5161841573
3546,72125410,7406020,79531430,8,0,0,1024,6,10651102149
3547,72148661,41862500,114011161,0,0,1,24064,6,2598141346
3548,72174880,41912109,114086989,4,0,1,37376,4,9050239451
3549,72186760,7990737,80177497,6,0,0,117760,3,7921170354
3550,72209120,41884539,114093659,4,0,1,21504,4,3747077207
3551,72225959,7713482,79939441,4,0,0,3072,4,4555562628
3552,72226599,7518158,79744757,4,0,0,47104,4,10653869259
3553,72226760,41887447,114114207,4,0,1,24064,4,10428613088
3554,72244070,41938318,114182388,6,0,1,7168,3,2236064978
3555,72277410,41905001,114182411,4,0,1,11264,4,2986200294
3556,72315180,42054285,114369465,3,0,1,37888,0,5329092737
3557,72321761,7980891,80302652,7,0,0,46592,16,411093234
3558,72325570,42049245,114374815,4,0,1,41472,4,44264639
3559,72329120,7538927,79868047,8,0,0,4608,6,5300773796
3560,72348570,7584225,79932795,3,0,0,20992,0,8473886487
3561,72349789,7648159,79997948,4,0,0,71168,4,961306191
3562,72368830,42006008,114374838,7,0,1,23552,16,5921037384
3563,72375660,41999201,114374861,4,0,1,11776,4,492829271
3564,72405120,7909285,80314405,1,0,0,14336,6,3105380001
3565,72420360,8021983,80442343,0,0,0,4608,6,1108217272
3566,72436330,41938554,114374884,4,0,1,2048,4,5863801799
3567,72448350,7648093,80096443,1,0,0,33280,6,775684217
3568,72448780,8430668,80879448,0,0,0,139264,6,6404020133
3569,72449540,42062062,114511602,4,0,1,7680,4,9380464290
3570,72457140,7684454,80141594,1,0,0,68608,6,4280595435
3571,72457490,8190599,80648089,0,0,0,78848,6,4044357406
3572,72460830,42050795,114511625,7,0,1,4096,16,3540071436
3573,72487540,7632239,80119779,8,0,0,512,6,4703732703
3574,72516560,42050959,114567519,4,0,1,15360,4,1005227846
3575,72535560,42032357,114567917,4,0,1,18944,4,7157487074
3576,72541890,7434351,79976241,3,0,0,24576,0,3355696347
3577,72563001,7933182,80496183,7,0,0,134656,16,5114438002
3578,72585381,41982559,114567940,0,0,1,37888,6,5348713523
3579,72594670,8151485,80746155,1,0,0,296448,6,3639100165
3580,72643900,41924063,114567963,8,0,1,2048,6,1618016277
3581,72672150,41944851,114617001,7,0,1,59392,16,6598330761
3582,72682781,8250042,80932823,7,0,0,175104,16,7760451790
3583,72716230,41993240,114709470,8,0,1,40448,6,10055152375
3584,72753190,7628763,80381953,8,0,0,1536,6,5098145357
3585,72754460,41955033,114709493,7,0,1,20480,16,5230453495
3586,72765430,41944086,114709516,7,0,1,3584,16,8597068866
3587,72765901,7654904,80420805,7,0,0,101888,16,3483800460
3588,72777860,8194817,80972677,8,0,0,3072,6,9572847393
3589,72794180,41915359,114709539,7,0,1,7680,16,9046433375
3590,72800910,8036083,80836993,0,0,0,146944,6,439787198
3591,72829290,7962908,80792198,0,0,0,151040,6,4578996730
3592,72830210,7279787,80109997,2,0,0,1024,11,8410108303
3593,72830959,8352086,81183045,4,0,0,350720,4,2670495571
3594,72837340,41872222,114709562,7,0,1,3072,16,8479202660
3595,72872690,8063189,80935879,3,0,0,9728,0,10665487715
3596,72893430,8111843,81005273,3,0,0,106496,0,9725188268
3597,72902461,8318538,81220999,7,0,0,124416,16,2688371826
3598,72916930,8364485,81281415,3,0,0,128000,0,6150697453
3599,72919210,8028438,80947648,1,0,0,38400,6,7632773299
3600,72943020,8028698,80971718,2,0,0,78848,11,3761239829
3601,72968610,8264580,81233190,3,0,0,39936,0,6785638186
3602,72974500,41735085,114709585,7,0,1,29184,16,5846063272
3603,72997110,41713056,114710166,7,0,1,28160,16,7983490755
3604,73011230,41715988,114727218,8,0,1,4096,6,514638868
3605,73023771,8504063,81527834,7,0,0,228864,16,5680156400
3606,73033870,8385407,81419277,6,0,0,39936,3,7054740963
3607,73077341,8741199,81818540,7,0,0,135168,16,422198560
3608,73085530,41664609,114750139,4,0,1,11776,4,7771999596
3609,73094940,41692409,114787349,4,0,1,40448,4,10177581030
3610,73112540,41747006,114859546,4,0,1,12800,4,9291084671
3611,73133710,41801154,114934864,4,0,1,17408,4,8407209838
3612,73200590,8128207,81328797,8,0,0,5120,6,2232651312
3613,73224060,8079374,81303434,2,0,0,72192,11,7998009261
3614,73224730,7837289,81062019,1,0,0,19456,6,3219575183
3615,73230921,8358111,81589032,7,0,0,108544,16,322064308
3616,73244579,8311358,81555937,4,0,0,92160,4,8962131483
3617,73246420,8343103,81589523,8,0,0,1536,6,10024521645
3618,73264200,8742034,82006234,2,0,0,2048,11,196004169
3619,73287370,41647517,114934887,7,0,1,2560,16,7033992590
3620,73293970,41644395,114938365,9,0,1,8192,17,747512113
3621,73298470,41639918,114938388,4,0,1,4096,4,3110152556
3622,73302790,41635621,114938411,9,0,1,2560,17,2161137549
3623,73323220,41615214,114938434,7,0,1,12800,16,6800105079
3624,73331711,8636608,81968319,7,0,0,138752,16,6834511712
3625,73359319,8309948,81669267,4,0,0,148480,4,7045053926
3626,73394490,41543967,114938457,8,0,1,25600,6,4108051683
3627,73408180,41558247,114966427,4,0,1,13312,4,5733013897
3628,73416521,8299748,81716269,7,0,0,23552,16,8481170030
3629,73435970,8621653,82057623,1,0,0,19456,6,10265399315
3630,73480509,8228561,81709070,4,0,0,130560,4,3403450560
3631,73513430,8330561,81843991,2,0,0,83456,11,10684312510
3632,73539599,8072583,81612182,4,0,0,28672,4,7624342333
3633,73546840,41419610,114966450,4,0,1,4096,4,2757524800
3634,73552410,8217278,81769688,1,0,0,109056,6,1542320631
3635,73557940,8644554,82202494,6,0,0,113664,3,7595219323
3636,73564510,8816045,82380555,2,0,0,60416,11,6525347869
3637,73602880,41363593,114966473,8,0,1,11776,6,4781273830
3638,73607720,8500089,82107809,2,0,0,91136,11,3282168315
3639,73625540,41340956,114966496,8,0,1,25600,6,7127696708
3640,73631310,41335249,114966559,7,0,1,13312,16,858530210
3641,73636191,8523714,82159905,7,0,0,67072,16,1369925083
3642,73657890,8704234,82362124,3,0,0,81920,0,4132085053
3643,73660720,8321887,81982607,2,0,0,46592,11,5543842885
3644,73720190,41246392,114966582,8,0,1,30208,6,4310567080
3645,73722980,8906809,82629789,2,0,0,98816,11,5729244934
3646,73725929,8685369,82411298,4,0,0,59392,4,4932425788
3647,73765460,9001326,82766786,0,0,0,220672,6,5356919263
3648,73878310,41088295,114966605,4,0,1,4608,4,10326242313
3649,73928470,8974078,82902548,3,0,0,110592,0,3384112567
3650,73938730,8660928,82599658,6,0,0,98816,3,7307609454
3651,74005060,8046612,82051672,2,0,0,35328,11,3563866045
3652,74007421,8114218,82121639,7,0,0,5120,16,8981155047
3653,74025560,40952501,114978061,8,0,1,28672,6,4207418002
3654,74044790,8209054,82253844,1,0,0,27136,6,6735621472
3655,74085440,9078187,83163627,3,0,0,46592,0,3146873390
3656,74109640,40898591,115008231,4,0,1,16384,4,7001838036
3657,74122290,8962707,83084997,0,0,0,45568,6,8245358921
3658,74157620,40850634,115008254,8,0,1,6656,6,8570388006
3659,74158860,8608261,82767121,8,0,0,1024,6,3375238182
3660,74183610,8061294,82244904,6,0,0,28160,3,1233320935
3661,74200990,7938456,82139446,2,0,0,58368,11,1087153005
3662,74203100,40805177,115008277,1,0,1,13312,6,2779934472
3663,74204850,40803450,115008300,1,0,1,3072,6,7206657801
3664,74213090,8287612,82500702,8,0,0,1024,6,10127781000
3665,74270290,8199584,82469874,0,0,0,117760,6,5027158538
3666,74273650,40738432,115012082,1,0,1,21504,6,4925770240
3667,74282161,40832371,115114532,0,0,1,98304,6,8761153179
3668,74283111,40860342,115143453,0,0,1,5632,6,3222723009
3669,74320020,40892319,115212339,8,0,1,42496,6,3194949918
3670,74333801,41412578,115746379,0,0,1,273408,6,6350836826
3671,74362490,8405035,82767525,8,0,0,1024,6,4419005931
3672,74367420,8432420,82799840,0,0,0,105984,6,3693716700
3673,74381891,41465861,115847752,0,0,1,28672,6,3566163342
3674,74395030,8754378,83149408,3,0,0,95744,0,1646461862
3675,74396480,41451295,115847775,1,0,1,3584,6,5131931948
3676,74416690,8986079,83402769,3,0,0,272896,0,10041887056
3677,74466780,41399605,115866385,1,0,1,9728,6,7779352308
3678,74473560,41392848,115866408,1,0,1,29696,6,612080495
3679,74482941,41509614,115992555,0,0,1,168960,6,7293082009
3680,74496610,8574480,83071090,1,0,0,238080,6,5836183725
3681,74511470,8941600,83453070,8,0,0,2560,6,2466758219
3682,74519310,8711061,83230371,0,0,0,71168,6,5897008343
3683,74549780,7984300,82534080,8,0,0,2048,6,4150538989
3684,74605060,8366555,82971615,8,0,0,512,6,295533660
3685,74631410,41362323,115993733,1,0,1,13824,6,8073955099
3686,74642700,41355539,115998239,4,0,1,7168,4,5372981376
3687,74648420,8886494,83534914,8,0,0,1536,6,1894490236
3688,74668699,8835386,83504085,4,0,0,48640,4,4012721392
3689,74673121,41518977,116192098,0,0,1,75264,6,557664651
3690,74698360,41493761,116192121,9,0,1,20480,17,5673720377
3691,74743790,41448354,116192144,1,0,1,4096,6,4007757558
3692,74760230,8479056,83239286,2,0,0,29184,11,8812836586
3693,74805620,8646647,83452267,0,0,0,51200,6,597411642
3694,74817450,8986294,83803744,2,0,0,66048,11,9094737000
3695,74822370,8363588,83185958,2,0,0,73216,11,3510553801
3696,74830210,8467420,83297630,1,0,0,48128,6,1262795692
3697,74867820,41324347,116192167,4,0,1,12800,4,2336886140
3698,74887310,41304880,116192190,1,0,1,1536,6,4382309807
3699,74908881,9072282,83981163,7,0,0,75264,16,784294983
3700,74913190,41279023,116192213,1,0,1,1024,6,7090811319
3701,74955940,8500741,83456681,8,0,0,11776,6,8976397317
3702,74967620,7683724,82651344,8,0,0,1536,6,3559838456
3703,75001080,8668467,83669547,0,0,0,146944,6,7266779441
3704,75046480,9176166,84222646,3,0,0,311808,0,4076719092
3705,75049370,8908838,83958208,0,0,0,135680,6,6440120729
3706,75066140,41126096,116192236,1,0,1,512,6,1802055500
3707,75118970,8474587,83593557,2,0,0,65024,11,1980971316
3708,75128600,41063659,116192259,4,0,1,3584,4,7076779651
3709,75133100,41059182,116192282,1,0,1,3072,6,1110635434
3710,75248500,7957624,83206124,0,0,0,31232,6,4559928031
3711,75285850,9058134,84343984,3,0,0,8192,0,4840865315
3712,75289400,40902905,116192305,4,0,1,24064,4,2462649380
3713,75308700,40945138,116253838,1,0,1,512,6,2662506342
3714,75330570,40963314,116293884,4,0,1,52224,4,4836651933
3715,75341160,8095484,83436644,1,0,0,111104,6,6352311424
3716,75362770,9144714,84507484,2,0,0,57344,11,3664713988
3717,75390611,8630836,84021447,7,0,0,34304,16,2195842331
3718,75412589,8901737,84314326,4,0,0,79872,4,5799175735
3719,75416160,8153556,83569716,3,0,0,47104,0,1063826317
3720,75428920,7811325,83240245,8,0,0,3072,6,9317543080
3721,75446990,9114703,84561693,2,0,0,72192,11,4293179803
3722,75455280,40838627,116293907,4,0,1,8704,4,4642246598
3723,75458639,8396937,83855576,4,0,0,40960,4,9024318460
3724,75493500,40820063,116313563,5,0,1,41472,11,1830510046
3725,75541279,8544203,84085482,4,0,0,195584,4,10517210646
3726,75582591,9798132,85380723,7,0,0,209920,16,133090817
3727,75583970,9002855,84586825,2,0,0,61952,11,5750842305
3728,75591390,8825296,84416686,1,0,0,93184,6,5230742576
3729,75671380,9559033,85230413,1,0,0,234496,6,2756455631
3730,75696760,8782037,84478797,2,0,0,203776,11,1605697863
3731,75702991,8836683,84539674,7,0,0,99840,16,3363105679
3732,75705030,9417814,85122844,0,0,0,607744,6,6275477229
3733,75711140,9066894,84778034,8,0,0,512,6,3522036817
3734,75725790,40588119,116313909,4,0,1,512,4,2071607127
3735,75764169,9131773,84895942,4,0,0,113664,4,1429499700
3736,75773170,40552838,116326008,6,0,1,31744,3,751968856
3737,75799119,7881359,83680478,4,0,0,16896,4,496084200
3738,75807050,9459637,85266687,8,0,0,1024,6,10415602986
3739,75823771,9037516,84861287,7,0,0,45568,16,2721682175
3740,75851500,40482746,116334246,6,0,1,3072,3,3307687214
3741,75861161,8916694,84777855,7,0,0,87552,16,9745700376
3742,75892430,8814338,84706768,1,0,0,64512,6,6088100212
3743,75894250,40470268,116364518,6,0,1,12800,3,7297740461
3744,75928290,40441720,116370010,4,0,1,17920,4,2865347348
3745,75941760,9217166,85158926,0,0,0,118272,6,1840218419
3746,76027410,8570826,84598236,3,0,0,37376,0,6025775759
3747,76077231,8048465,84125696,7,0,0,16384,16,672272107
3748,76112230,8002354,84114584,0,0,0,60416,6,8707826822
3749,76121880,9194681,85316561,0,0,0,30208,6,727033964
3750,76125770,9519595,85645365,2,0,0,170496,11,377043194
3751,76128000,40247938,116375938,4,0,1,4608,4,8041019611
3752,76150401,9307484,85457885,7,0,0,16384,16,2887559458
3753,76172330,9093728,85266058,3,0,0,116736,0,7762824263
3754,76186510,40209148,116395658,6,0,1,17408,3,3311880018
3755,76220270,40176259,116396529,4,0,1,12288,4,8896278140
3756,76247811,9796033,86043844,7,0,0,135168,16,7087233408
3757,76264861,9935685,86200546,7,0,0,373760,16,834493638
3758,76265120,8474210,84739330,8,0,0,2048,6,53115283
3759,76270050,9226807,85496857,8,0,0,2560,6,1684197464
3760,76275730,10210567,86486297,1,0,0,463872,6,10574899694
3761,76276651,10336434,86613085,7,0,0,221696,16,3302673786
3762,76333930,40103364,116437294,4,0,1,8192,4,734071833
3763,76374270,40063047,116437317,6,0,1,13312,3,10712170876
3764,76377880,10166987,86544867,3,0,0,43520,0,1385393968
3765,76379139,9941885,86321024,4,0,0,298496,4,3996648696
3766,76424850,40028831,116453681,6,0,1,6144,3,7128188345
3767,76433290,9313647,85746937,1,0,0,24576,6,3081210393
3768,76457850,8808410,85266260,8,0,0,512,6,4027182307
3769,76474960,39988377,116463337,6,0,1,12288,3,4787229919
3770,76501820,39965383,116467203,6,0,1,6144,3,1875397907
3771,76530700,10300830,86831530,1,0,0,15360,6,7676697837
3772,76554300,39917743,116472043,6,0,1,512,3,2825695657
3773,76594990,39877207,116472197,6,0,1,8704,3,111612045
3774,76634380,40030259,116664639,4,0,1,26624,4,8335889162
3775,76703790,8612950,85316740,8,0,0,512,6,8961625466
3776,76740591,8937204,85677795,7,0,0,78336,16,9176640064
3777,76759650,9884190,86643840,0,0,0,100864,6,9549534974
3778,76767650,39898167,116665817,6,0,1,13824,3,9950073035
3779,76778009,9959039,86737048,4,0,0,115712,4,9942804253
3780,76811980,9190657,86002637,1,0,0,178176,6,8147003770
3781,76837180,39965532,116802712,7,0,1,22016,16,10558979452
3782,76848760,8565170,85413930,8,0,0,512,6,10320218100
3783,76856460,39947558,116804018,6,0,1,2048,3,6629052880
3784,76889971,9454967,86344938,7,0,0,57856,16,1819579610
3785,76897920,40016582,116914502,6,0,1,14336,3,4212155910
3786,76918200,40293166,117211366,6,0,1,16896,3,1866992999
3787,76929900,40407405,117337305,6,0,1,5632,3,9617358866
3788,76938270,8467873,85406143,0,0,0,17408,6,6718308232
3789,76943620,9587940,86531560,0,0,0,148480,6,5242660225
3790,76951790,8987020,85938810,1,0,0,47104,6,3880753352
3791,76963550,10086866,87050416,8,0,0,7680,6,9173559107
3792,76971150,9690029,86661179,0,0,0,56832,6,10410505373
3793,76991560,40345768,117337328,6,0,1,9216,3,1961701406
3794,77007580,8718069,85725649,8,0,0,5120,6,8848429128
3795,77071590,40317732,117389322,6,0,1,6656,3,4317159466
3796,77081200,40328075,117409275,7,0,1,20480,16,9390199016
3797,77104760,40306781,117411541,6,0,1,3584,3,7992267580
3798,77105760,40318485,117424245,7,0,1,1024,16,8756372589
3799,77136380,8517524,85653904,3,0,0,27648,0,9148497081
3800,77148640,8613109,85761749,3,0,0,19968,0,8479344843
3801,77153730,9779056,86932786,0,0,0,86528,6,435491657
3802,77189340,8690015,85879355,8,0,0,1536,6,9025167547
3803,77194880,40280492,117475372,7,0,1,9216,16,8460556149
3804,77212890,8468048,85680938,2,0,0,10240,11,9282323041
3805,77214600,40294751,117509351,4,0,1,9728,4,3968844897
3806,77225990,9004063,86230053,1,0,0,96768,6,2537846610
3807,77235579,10044019,87279598,4,0,0,199168,4,9889477290
3808,77240390,40306995,117547385,6,0,1,6656,3,1430960362
3809,77274730,9270784,86545514,8,0,0,2048,6,3997277742
3810,77306380,40386137,117692517,4,0,1,37888,4,2592921322
3811,77330920,9544649,86875569,3,0,0,23552,0,8411973510
3812,77348210,8576225,85924435,2,0,0,22016,11,4852445944
3813,77390050,10064052,87454102,2,0,0,147456,11,6862013981
3814,77400490,40401920,117802410,6,0,1,9216,3,5242999278
3815,77439541,10629284,88068825,7,0,0,241664,16,3913843604
3816,77449820,40352613,117802433,4,0,1,13312,4,8806377381
3817,77484980,9252247,86737227,8,0,0,512,6,5962531343
3818,77555160,10055506,87610666,1,0,0,33280,6,2308164673
3819,77577030,10318090,87895120,3,0,0,285184,0,7801105842
3820,77589629,10662604,88252233,4,0,0,231424,4,9044203986
3821,77590890,9439246,87030136,2,0,0,106496,11,1811424652
3822,77600670,9808481,87409151,2,0,0,355328,11,7613887344
3823,77630370,40172086,117802456,6,0,1,12800,3,1451706223
3824,77659190,10758285,88417475,3,0,0,275968,0,645331757
3825,77669959,8657328,86327287,4,0,0,20480,4,9556834543
3826,77726230,9125999,86852229,3,0,0,57856,0,7586024769
3827,77782779,9294517,87077296,4,0,0,9216,4,2813685002
3828,77795260,40040470,117835730,4,0,1,7168,4,870220718
3829,77795540,40060312,117855852,8,0,1,19968,6,9490433067
3830,77797270,9010789,86808059,8,0,0,1536,6,5973726367
3831,77799301,9367515,87166816,7,0,0,67072,16,6094594014
3832,77812610,40133263,117945873,4,0,1,10752,4,9853533262
3833,77845750,40102709,117948459,4,0,1,4096,4,118292374
3834,77864470,9731803,87596273,1,0,0,257536,6,2426267138
3835,77886091,10262161,88148252,7,0,0,260608,16,8500480143
3836,77898131,10398585,88296716,7,0,0,145920,16,3472824436
3837,77905670,40506837,118412507,4,0,1,9728,4,1635575887
3838,77953750,10752568,88706318,3,0,0,357376,0,9410713056
3839,77974060,9961799,87935859,1,0,0,133632,6,8191997428
3840,78019071,11224552,89243623,7,0,0,416768,16,3315064496
3841,78043740,40505889,118549629,4,0,1,20992,4,1400534759
3842,78066590,40483062,118549652,6,0,1,6656,3,10036801806
3843,78126200,40428646,118554846,6,0,1,20992,3,7712541442
3844,78153610,10007933,88161543,3,0,0,43520,0,8978970657
3845,78173930,10406179,88580109,3,0,0,237568,0,7510461120
3846,78178790,10418502,88597292,3,0,0,56320,0,1473278843
3847,78188640,10563018,88751658,0,0,0,126464,6,2951468240
3848,78207680,40347189,118554869,6,0,1,7168,3,8924583252
3849,78236360,11144309,89380669,3,0,0,154624,0,7706358178
3850,78270680,11331292,89601972,2,0,0,70144,11,5149257033
3851,78286420,9708750,87995170,2,0,0,194560,11,4517041794
3852,78327650,11227888,89555538,2,0,0,165888,11,10292054940
3853,78411209,9770481,88181690,4,0,0,66048,4,6764858265
3854,78464251,10043451,88507702,7,0,0,138752,16,3329475088
3855,78484230,11297894,89782124,0,0,0,264704,6,1395891782
3856,78584410,9845100,88429510,0,0,0,39424,6,5067116132
3857,78655030,39899862,118554892,4,0,1,3584,4,5289453535
3858,78723081,11258423,89981504,7,0,0,37888,16,6174706244
3859,78769149,11049369,89818518,4,0,0,73216,4,1500087086
3860,78770150,10178260,88948410,0,0,0,25600,6,5167220393
3861,78784310,9928793,88713103,0,0,0,22016,6,10416917900
3862,78812550,39742365,118554915,8,0,1,9216,6,10145409378
3863,78825400,39913758,118739158,6,0,1,5632,3,3776179865
3864,78826520,39912669,118739189,4,0,1,28160,4,10066641274
3865,78827230,10629518,89456748,1,0,0,183296,6,1198446687
3866,78904810,11674210,90579020,1,0,0,813056,6,5502097314
3867,78932500,11163573,90096073,0,0,0,77312,6,3742275733
3868,78972510,39766702,118739212,6,0,1,14848,3,9590431504
3869,79010549,11993788,91004337,4,0,0,122880,4,4609785136
3870,79052859,11670249,90723108,4,0,0,204800,4,4825969875
3871,79107360,39631875,118739235,6,0,1,4608,3,2102827497
3872,79113281,39724319,118837600,0,0,1,61440,6,9480812135
3873,79119220,9920288,89039508,1,0,0,86528,6,9813224049
3874,79166159,9596138,88762297,4,0,0,34816,4,5328473937
3875,79190450,9578131,88768581,8,0,0,1536,6,1692702945
3876,79191800,9725003,88916803,2,0,0,54784,11,3397355137
3877,79222950,39670458,118893408,6,0,1,56832,3,9622501340
3878,79271400,12005920,91277320,3,0,0,472064,0,2454311399
3879,79295050,12146014,91441064,3,0,0,405504,0,7959568230
3880,79345640,39547791,118893431,4,0,1,26624,4,6422486818
3881,79346460,39588981,118935441,4,0,1,7168,4,2816233478
3882,79347919,12264924,91612843,4,0,0,184320,4,726546190
3883,79348050,10805707,90153757,8,0,0,5120,6,3607436462
3884,79358950,10878197,90237147,2,0,0,156672,11,572182532
3885,79376561,40540724,119917285,0,0,1,222208,6,1884083411
3886,79390400,10505009,89895409,0,0,0,87040,6,7853464439
3887,79393530,10937731,90331261,0,0,0,308736,6,8779350170
3888,79400750,10714994,90115744,8,0,0,7168,6,6112750607
3889,79402830,12419453,91822283,3,0,0,436224,0,5055328886
3890,79424379,12423089,91847468,4,0,0,80384,4,8746693526
3891,79424730,10371457,89796187,1,0,0,46080,6,8651588319
3892,79433840,40483468,119917308,4,0,1,4608,4,6952470739
3893,79437760,10544391,89982151,8,0,0,2048,6,4512942869
3894,79451301,11190953,90642254,7,0,0,144384,16,7022436609
3895,79466631,10679722,90146353,7,0,0,31232,16,6509836676
3896,79488560,12562737,92051297,3,0,0,85504,0,3788504186
3897,79507540,40409791,119917331,4,0,1,43008,4,9545214170
3898,79534699,12435657,91970356,4,0,0,146944,4,4339147150
3899,79576059,11178791,90754850,4,0,0,9216,4,1228030000
3900,79578221,40348672,119926893,0,0,1,97280,6,60064480
3901,79626949,10971282,90598231,4,0,0,62976,4,6674651089
3902,79627291,40341013,119968304,0,0,1,49152,6,2453297292
3903,79633821,12631995,92265816,7,0,0,40448,16,5430246718
3904,79678811,10354391,90033202,7,0,0,34816,16,400825837
3905,79744000,40228490,119972490,6,0,1,6656,3,5764513260
3906,79749830,40261235,120011065,2,0,1,23552,11,6939989178
3907,79750210,40262801,120013011,4,0,1,3072,4,1264851564
3908,79760530,11728580,91489110,3,0,0,1024,0,10689816647
3909,79789839,10399549,90189388,4,0,0,87552,4,6782600362
3910,79815879,12789156,92605035,4,0,0,304128,4,2002671392
3911,79816690,40196987,120013677,4,0,1,1024,4,2696153196
3912,79822960,40211698,120034658,4,0,1,2560,4,2297654620
3913,79828350,40206667,120035017,4,0,1,9728,4,9829249279
3914,79831741,10919695,90751436,7,0,0,92672,16,5756129958
3915,79867930,40178770,120046700,2,0,1,17408,11,2708004411
3916,79870901,40478267,120349168,0,0,1,167936,6,1438669663
3917,79900600,10930385,90830985,3,0,0,55808,0,97957523
3918,79904680,40444511,120349191,2,0,1,6144,11,8508406708
3919,79919579,10894301,90813880,4,0,0,193536,4,2825505131
3920,79921360,40451433,120372793,6,0,1,32256,3,2031101350
3921,79931961,11166796,91098757,7,0,0,135680,16,1053027515
3922,79952140,40420676,120372816,6,0,1,29696,3,9665777008
3923,79970309,10690376,90660685,4,0,0,60416,4,9433741742
3924,79973680,10778247,90751927,8,0,0,1536,6,2445117463
3925,79974510,40398329,120372839,4,0,1,3072,4,10718185280
3926,79998430,40374432,120372862,2,0,1,23040,11,8651637475
3927,80012621,11303745,91316366,7,0,0,17408,16,2095218951
3928,80059350,40313535,120372885,6,0,1,12800,3,4738343569
3929,80068630,10937999,91006629,8,0,0,3072,6,880767038
3930,80107871,40834572,120942443,0,0,1,232960,6,714937385
3931,80126480,40846312,120972792,2,0,1,3072,11,6840728128
3932,80142991,12692618,92835609,7,0,0,414720,16,5665437377
3933,80176930,11311768,91488698,0,0,0,62464,6,5086303858
3934,80181370,40818017,120999387,8,0,1,6656,6,3493733790
3935,80192310,11125171,91317481,3,0,0,3584,0,6722145586
3936,80210460,11651227,91861687,0,0,0,46592,6,6268082868
3937,80229110,11327550,91556660,3,0,0,190464,0,7672930392
3938,80239019,11072020,91311039,4,0,0,110592,4,6245653832
3939,80247739,11385940,91633679,4,0,0,39424,4,2995359707
3940,80264680,40735168,120999848,6,0,1,10240,3,6806047977
3941,80283450,40749585,121033035,8,0,1,5120,6,5382562852
3942,80305259,10700395,91005654,4,0,0,4096,4,6401777112
3943,80314659,11154984,91469643,4,0,0,93696,4,7839898822
3944,80317730,40725679,121043409,4,0,1,512,4,8628560945
3945,80324471,12560683,92885154,7,0,0,162304,16,1513101911
3946,80363941,41028531,121392472,0,0,1,88064,6,7944902464
3947,80367000,41025495,121392495,8,0,1,5632,6,1907659519
3948,80383131,11542071,91925202,7,0,0,208384,16,8747136332
3949,80454000,40951177,121405177,4,0,1,6144,4,5407118740
3950,80457760,10578360,91036120,8,0,0,3072,6,5979898751
3951,80516650,40888550,121405200,4,0,1,32768,4,8795665280
3952,80540391,40977666,121518057,0,0,1,81920,6,2139800771
3953,80579351,12418118,92997469,7,0,0,94720,16,4450562303
3954,80581170,40936910,121518080,1,0,1,8704,6,4869470208
3955,80596790,11898336,92495126,0,0,0,434688,6,6046999291
3956,80602789,12469429,93072218,4,0,0,23040,4,584398723
3957,80603600,40914503,121518103,2,0,1,11264,11,8700789943
3958,80612990,40905136,121518126,4,0,1,7680,4,2489983726
3959,80667700,11463092,92130792,1,0,0,66560,6,4366954999
3960,80670440,40847709,121518149,7,0,1,12800,16,7818495236
3961,80675681,12387439,93063120,7,0,0,72192,16,3324542050
3962,80682600,40835572,121518172,4,0,1,12800,4,4613283467
3963,80689809,11563660,92253469,4,0,0,64000,4,3809158067
3964,80690220,40827975,121518195,6,0,1,1536,3,8557143271
3965,80707640,11115313,91822953,8,0,0,2048,6,1103586706
3966,80750650,11454320,92204970,0,0,0,175616,6,9405640964
3967,80775840,40742378,121518218,6,0,1,9216,3,8616408553
3968,80778550,40739691,121518241,2,0,1,26624,11,1029988524
3969,80791810,11179201,91971011,8,0,0,2048,6,8805029600
3970,80817360,40700904,121518264,7,0,1,4096,16,10515902034
3971,80835680,11089873,91925553,8,0,0,1024,6,5182943075
3972,80851090,40667197,121518287,4,0,1,15360,4,5299997650
3973,80880749,11229694,92110443,4,0,0,182784,4,2590091615
3974,80893730,11321403,92215133,0,0,0,33280,6,157101770
3975,80906310,11604923,92511233,0,0,0,52736,6,10197566338
3976,80940790,10705856,91646646,8,0,0,2048,6,1610898691
3977,80942750,11414848,92357598,0,0,0,58368,6,9770322908
3978,80956410,40561900,121518310,7,0,1,2048,16,2511646645
3979,80990290,40528043,121518333,7,0,1,16896,16,839439365
3980,80990630,12144786,93135416,1,0,0,97280,6,1831738141
3981,80992320,40552743,121545063,4,0,1,7168,4,5697653472
3982,80993381,11346402,92339783,7,0,0,242688,16,9094240325
3983,80997040,11515308,92512348,8,0,0,3584,6,4083584973
3984,81011690,40533396,121545086,2,0,1,15872,11,6287436770
3985,81059710,11302903,92362613,3,0,0,16384,0,2019749702
3986,81062450,11900827,92963277,0,0,0,85504,6,10537670267
3987,81064320,40480797,121545117,7,0,1,29696,16,7753219491
3988,81082650,40462490,121545140,6,0,1,12288,3,6356292359
3989,81090830,40454333,121545163,2,0,1,5632,11,5907094507
3990,81092100,11617126,92709226,0,0,0,216576,6,10397353255
3991,81110960,11532232,92643192,1,0,0,124928,6,4954952735
3992,81115940,40429246,121545186,7,0,1,5632,16,7605353285
3993,81134390,40410819,121545209,4,0,1,21504,4,5673595005
3994,81174510,40370722,121545232,6,0,1,10240,3,3431308533
3995,81181490,11755635,92937125,3,0,0,170496,0,3141996807
3996,81185000,40360255,121545255,1,0,1,6144,6,1722974878
3997,81188880,40356398,121545278,7,0,1,2560,16,1733137037
3998,81231999,11788791,93020790,4,0,0,13312,4,3249723674
3999,81247910,40297391,121545301,1,0,1,22528,6,4450002484
4000,81248659,12066729,93315388,4,0,0,165376,4,5565879584
4001,81267021,11749667,93016688,7,0,0,62976,16,2937633160
4002,81271040,11905277,93176317,3,0,0,67584,0,7811857532
4003,81321990,11719111,93041101,0,0,0,66560,6,9886670233
4004,81322830,40222494,121545324,7,0,1,15872,16,10526161468
4005,81378690,11686300,93064990,8,0,0,3584,6,828940883
4006,81440539,11783838,93224377,4,0,0,64000,4,10656472670
4007,81454710,11513738,92968448,1,0,0,16896,6,10525186579
4008,81463140,11642513,93105653,1,0,0,97792,6,10191652509
4009,81470460,40074887,121545347,4,0,1,7680,4,1321863171
4010,81532930,40012440,121545370,1,0,1,512,6,1673399195
4011,81543840,40001633,121545473,7,0,1,5120,16,8091928882
4012,81547280,39998216,121545496,4,0,1,14848,4,8365723746
4013,81550640,39994879,121545519,4,0,1,48640,4,2631017115
4014,81580390,39986099,121566489,7,0,1,16384,16,6866489437
4015,81592360,11471407,93063767,8,0,0,2048,6,5419636600
4016,81609210,40043966,121653176,2,0,1,10240,11,8752486729
4017,81613320,11807998,93421318,0,0,0,113664,6,807786302
4018,81619210,40034013,121653223,1,0,1,70656,6,10724700629
4019,81625070,40028176,121653246,2,0,1,24576,11,533764906
4020,81644330,40008939,121653269,2,0,1,512,11,2843732475
4021,81651570,11424126,93075696,1,0,0,11264,6,2256853767
4022,81691610,11838890,93530500,3,0,0,67584,0,6220637821
4023,81699050,39963391,121662441,2,0,1,54272,11,9522368929
4024,81735519,11707666,93443185,4,0,0,28160,4,3660910304
4025,81746720,40190609,121937329,7,0,1,7168,16,993070892
4026,81748610,40265143,122013753,1,0,1,5632,6,4628870452
4027,81762320,11697736,93460056,0,0,0,55296,6,2885592364
4028,81778430,40241634,122020064,7,0,1,22016,16,2637424015
4029,81804199,11656869,93461068,4,0,0,1024,4,6811839877
4030,81808450,11516500,93324950,1,0,0,31232,6,6910010368
4031,81814020,40379023,122193043,2,0,1,2560,11,8166732975
4032,81817861,11878057,93695918,7,0,0,122368,16,505762758
4033,81858330,11882798,93741128,3,0,0,41984,0,6974468260
4034,81865480,40672520,122538000,2,0,1,58368,11,1056977916
4035,81873710,11501775,93375485,1,0,0,7680,6,8330118764
4036,81884629,11773966,93658595,4,0,0,68096,4,8063612
4037,81934180,11703309,93637489,0,0,0,78848,6,3027802802
4038,81959120,11761781,93720901,1,0,0,81920,6,5182534428
4039,81982539,12608488,94591027,4,0,0,77824,4,8488840873
4040,82024031,12144933,94168964,7,0,0,203776,16,9158861038
4041,82070779,11174589,93245368,4,0,0,19968,4,10174978333
4042,82082200,11644542,93726742,8,0,0,512,6,3667245363
4043,82108360,12276825,94385185,6,0,0,114176,3,10666166224
4044,82144650,40393373,122538023,3,0,1,7680,0,7693473639
4045,82171190,11928797,94099987,1,0,0,110080,6,6755939177
4046,82239710,11486853,93726563,8,0,0,2560,6,5404322399
4047,82291290,11255457,93546747,3,0,0,53248,0,1725749329
4048,82294340,11604698,93899038,1,0,0,23552,6,3188494480
4049,82323230,11884601,94207831,1,0,0,127488,6,5951377061
4050,82324531,11401229,93725760,7,0,0,15872,16,3016045818
4051,82353800,11899499,94253299,3,0,0,29696,0,4149362713
4052,82376350,12492617,94868967,0,0,0,73728,6,9710463362
4053,82412850,11396620,93809470,1,0,0,512,6,1223280675
4054,82478810,11087322,93566132,3,0,0,14336,0,8666384541
4055,82520910,12168897,94689807,8,0,0,512,6,1945812703
4056,82535809,13039422,95575231,4,0,0,69632,4,1350091416
4057,82538749,11391254,93930003,4,0,0,34816,4,68255141
4058,82594900,39994181,122589081,7,0,1,17408,16,3894555954
4059,82660420,11637372,94297792,8,0,0,3072,6,2419805312
4060,82735570,11504680,94240250,0,0,0,3072,6,4792797093
4061,82793360,11417980,94211340,8,0,0,1536,6,8420182200
4062,82824811,12142132,94966943,7,0,0,190976,16,100056531
4063,82835880,39753224,122589104,9,0,1,12288,17,8304766171
4064,82854710,10987637,93842347,8,0,0,512,6,9176088145
4065,82870030,10767794,93637824,8,0,0,1024,6,2230260926
4066,82885490,10865678,93751168,0,0,0,8192,6,5315328124
4067,82891910,39697217,122589127,9,0,1,19968,17,550873291
4068,82940860,11060038,94000898,6,0,0,41472,3,4409764273
4069,82952940,12409045,95361985,8,0,0,1024,6,120014531
4070,83014410,39600503,122614913,9,0,1,6144,17,1038146093
4071,83055780,10862937,93918717,3,0,0,64512,0,2846848399
4072,83062140,39552796,122614936,9,0,1,2560,17,7665209569
4073,83071530,11479348,94550878,3,0,0,116736,0,7596540527
4074,83073490,11399667,94473157,6,0,0,34304,3,4086456547
4075,83104350,11106491,94210841,0,0,0,5120,6,7674224660
4076,83119900,39496018,122615918,9,0,1,19968,17,10636428434
4077,83122370,10846035,93968405,8,0,0,1024,6,8102691694
4078,83132290,10841331,93973621,1,0,0,10240,6,7821435160
4079,83143550,10775822,93919372,8,0,0,2048,6,5827447088
4080,83169550,11429649,94599199,3,0,0,13312,0,7066249452
4081,83178089,11870776,95048865,4,0,0,7680,4,781137400
4082,83216370,10992888,94209258,8,0,0,4608,6,1421864575
4083,83225290,11420466,94645756,6,0,0,79360,3,3100341800
4084,83247200,39369076,122616276,9,0,1,16384,17,10595625997
4085,83281070,11917846,95198916,1,0,0,39424,6,896380547
4086,83297320,11481642,94778962,0,0,0,1024,6,2118106262
4087,83298650,39444742,122743392,2,0,1,512,11,5968709771
4088,83354751,12470694,95825445,7,0,0,284672,16,6044896539
4089,83364900,39378515,122743415,9,0,1,22528,17,9284568455
4090,83488580,39254866,122743446,4,0,1,13824,4,128121114
4091,83496460,12508161,96004621,6,0,0,129536,3,1743467181
4092,83523980,10577902,94101882,8,0,0,6144,6,7717169229
4093,83532750,12803353,96336103,8,0,0,354304,6,9538699868
4094,83533970,11122573,94656543,6,0,0,35328,3,8090385207
4095,83579791,11828607,95408398,7,0,0,70144,16,15441311
4096,83592310,10803350,94395660,1,0,0,34304,6,8665752650
4097,83608610,10655585,94264195,0,0,0,512,6,4022761162
4098,83630529,11029781,94660310,4,0,0,12288,4,2264653156
4099,83711689,11162293,94873982,4,0,0,16384,4,10582826765
4100,83801969,11384912,95186881,4,0,0,160768,4,995936194
4101,83928080,10744635,94672715,0,0,0,8192,6,5157361511
4102,83943509,12565892,96509401,4,0,0,111104,4,634617491
4103,83977370,38766099,122743469,9,0,1,12800,17,3358604954
4104,83977990,38880909,122858899,7,0,1,6144,16,7602419477
4105,83979820,12687267,96667087,6,0,0,137728,3,10637389494
4106,84032970,13166661,97199631,1,0,0,347648,6,4843071964
4107,84054310,10914239,94968549,0,0,0,5120,6,5456358699
4108,84060990,10421776,94482766,1,0,0,17920,6,7337512967
4109,84061710,10489503,94551213,9,0,0,1024,17,304284908
4110,84074151,12393171,96467322,7,0,0,430592,16,7188921958
4111,84083840,11611940,95695780,6,0,0,352768,3,7823056533
4112,84092800,11645862,95738662,6,0,0,129024,3,2882937700
4113,84135360,38723562,122858922,9,0,1,12288,17,1818231334
4114,84161519,12718512,96880031,4,0,0,195584,4,9763630530
4115,84168580,38690365,122858945,9,0,1,23552,17,620703535
4116,84172220,11654519,95826739,0,0,0,1536,6,1939974933
4117,84256360,12300335,96556695,8,0,0,60928,6,7215414477
4118,84303881,11395446,95699327,7,0,0,8704,16,1555834508
4119,84335120,12132381,96467501,9,0,0,512,17,9498588030
4120,84351010,12742674,97093684,3,0,0,329728,0,5917650112
4121,84364870,11331782,95696652,0,0,0,2560,6,441853546
4122,84392920,38647852,123040772,3,0,1,10240,0,196210793
4123,84429291,12936071,97365362,7,0,0,34816,16,10445805274
4124,84430280,13143303,97573583,6,0,0,290304,3,5019108226
4125,84430950,38749194,123180144,3,0,1,3072,0,9572166625
4126,84483710,11342538,95826248,9,0,0,2560,17,10037186013
4127,84499570,39085663,123585233,9,0,1,44032,17,7346684912
4128,84571490,13360480,97931970,1,0,0,20992,6,2101223183
4129,84575370,39009886,123585256,9,0,1,512,17,5215580185
4130,84635660,12320576,96956236,1,0,0,165376,6,3383353370
4131,84678481,13137880,97816361,7,0,0,531456,16,6935961757
4132,84684560,38900719,123585279,3,0,1,13312,0,9263762557
4133,84749930,11760446,96510376,0,0,0,3072,6,9739553583
4134,84767390,38877543,123644933,9,0,1,24576,17,4356245563
4135,84775330,11275178,96050508,8,0,0,150528,6,4975682069
4136,84794180,11256507,96050687,9,0,0,512,17,1198289983
4137,84798850,38919392,123718242,3,0,1,3072,0,878411360
4138,84806740,11668786,96475526,1,0,0,13312,6,7209895056
4139,84817720,11649960,96467680,0,0,0,512,6,8958459710
4140,84834730,38883535,123718265,9,0,1,13312,17,1548054589
4141,84841240,12513156,97354396,3,0,0,254976,0,10647910297
4142,84847120,11833718,96680838,6,0,0,45056,3,970250799
4143,84852001,12356256,97208257,7,0,0,20480,16,3480833160
4144,84861050,38900846,123761896,9,0,1,27136,17,3369204584
4145,84900191,12718210,97618401,7,0,0,35328,16,2205783146
4146,84910040,38880257,123790297,3,0,1,24576,0,9261349860
4147,84911040,12968368,97879408,6,0,0,206848,3,2343822113
4148,84936811,13172014,98108825,7,0,0,145408,16,6933950639
4149,84939710,38850933,123790643,9,0,1,512,17,4894895390
4150,84961350,11510097,96471447,8,0,0,12288,6,10696449395
4151,84972469,11847947,96820416,4,0,0,34304,4,74994075
4152,84977191,12963226,97940417,7,0,0,27648,16,120741738
4153,85011260,11798681,96809941,1,0,0,160256,6,5997288158
4154,85023770,38776494,123800264,3,0,1,39424,0,951269551
4155,85047139,12852439,97899578,4,0,0,66048,4,10482454340
4156,85094101,39407733,124501834,0,0,1,502272,6,2041203971
4157,85111759,12495855,97607614,4,0,0,111616,4,287628731
4158,85123509,12940989,98064498,4,0,0,249856,4,269532686
4159,85132880,11823714,96956594,0,0,0,1024,6,7456986641
4160,85139909,12246329,97386238,4,0,0,29696,4,9133457841
4161,85207250,12009922,97217172,1,0,0,29184,6,6550508922
4162,85232770,39269087,124501857,9,0,1,20992,17,114410728
4163,85239050,39267650,124506700,9,0,1,3584,17,1353862877
4164,85259021,13747921,99006942,7,0,0,819712,16,2831227059
4165,85268241,13368983,98637224,7,0,0,196096,16,4934141297
4166,85310401,39249817,124560218,0,0,1,70656,6,3414289655
4167,85336020,13046606,98382626,6,0,0,202240,3,10359533069
4168,85353491,12095280,97448771,7,0,0,128000,16,10016830756
4169,85378411,39182667,124561078,0,0,1,14336,6,10065994302
4170,85380580,12544963,97925543,1,0,0,84992,6,7881641826
4171,85401989,12887155,98289144,4,0,0,141824,4,2104726922
4172,85416480,13160326,98576806,2,0,0,197632,11,2870241686
4173,85435040,39149425,124584465,5,0,1,11776,11,4387278153
4174,85457869,12863068,98320937,4,0,0,103936,4,4680767572
4175,85466060,13641819,99107879,3,0,0,14336,0,4585942380
4176,85471370,11730624,97201994,0,0,0,7680,6,1929582432
4177,85474940,13184459,98659399,6,0,0,72704,3,4462722788
4178,85516250,13567045,99083295,1,0,0,224256,6,2607767837
4179,85531150,11823581,97354731,9,0,0,1024,17,6899410362
4180,85544039,12406697,97950736,4,0,0,33792,4,477379496
4181,85544441,13662222,99206663,7,0,0,203264,16,10330834901
4182,85560790,39028501,124589291,5,0,1,7680,11,3424943721
4183,85579910,39011020,124590930,5,0,1,24064,11,9905221675
4184,85615190,12023866,97639056,0,0,0,1536,6,3032819544
4185,85616119,13528581,99144700,4,0,0,105472,4,6286996318
4186,85623220,12013308,97636528,8,0,0,59392,6,7978636782
4187,85627330,13884339,99511669,3,0,0,90112,0,522704027
4188,85649320,38948075,124597395,9,0,1,20480,17,4179079896
4189,85691100,38906654,124597754,5,0,1,9728,11,9799468167
4190,85714380,38886204,124600584,5,0,1,14336,11,6058622486
4191,85735850,38894953,124630803,9,0,1,51200,17,7969324650
4192,85781770,13760092,99541862,1,0,0,53248,6,10580370843
4193,85782260,38853369,124635629,2,0,1,7680,11,9605860268
4194,85790729,12197618,97988347,4,0,0,26112,4,2957852719
4195,85803150,38837766,124640916,2,0,1,16896,11,4620355827
4196,85814029,13548201,99362230,4,0,0,131584,4,1714512731
4197,85853970,38817977,124671947,2,0,1,30208,11,4033523733
4198,85867300,38809140,124676440,1,0,1,42496,6,211334153
4199,85872640,12353459,98226099,3,0,0,9216,0,4620018743
4200,85907879,13551640,99459519,4,0,0,105984,4,2438150111
4201,85909480,38767946,124677426,1,0,1,1536,6,4186673764
4202,85918340,38762312,124680652,9,0,1,5120,17,4457889449
4203,85944850,12765912,98710762,6,0,0,168448,3,1131594143
4204,85958680,38732855,124691535,2,0,1,20992,11,4131121923
4205,85985560,13029384,99014944,8,0,0,24576,6,8490440144
4206,85989389,13598220,99587609,4,0,0,150016,4,10675595391
4207,86027010,38664986,124691996,5,0,1,10240,11,3687203256
4208,86062020,13580664,99642684,8,0,0,97280,6,465703006
4209,86064130,12164237,98228367,0,0,0,1536,6,2013459487
4210,86084700,38647240,124731940,8,0,1,25600,6,5303500737
4211,86092810,12153099,98245909,6,0,0,45056,3,3579925075
4212,86103200,38628763,124731963,2,0,1,512,11,4525994392
4213,86114350,38727810,124842160,9,0,1,52736,17,4985279858
4214,86121720,13170646,99292366,1,0,0,9728,6,9802907041
4215,86132600,38806621,124939221,2,0,1,22016,11,9157762193
4216,86133920,12063726,98197646,0,0,0,1024,6,1560067454
4217,86138791,39261224,125400015,0,0,1,104448,6,8729730546
4218,86141280,39259721,125401001,1,0,1,1536,6,10287846496
4219,86184000,39227371,125411371,2,0,1,32768,11,3278302463
4220,86213420,39234120,125447540,2,0,1,5120,11,8881184431
4221,86223000,13446821,99669821,0,0,0,3584,6,9454943125
4222,86232661,39525236,125757897,0,0,1,252928,6,8387352171
4223,86241310,13080805,99322115,3,0,0,46592,0,9740306820
4224,86254091,39957142,126211233,0,0,1,398336,6,335109942
4225,86256740,13690278,99947018,6,0,0,167936,3,2149399637
4226,86279490,13147706,99427196,1,0,0,185344,6,7599860903
4227,86296000,12807488,99103488,8,0,0,63488,6,4463557684
4228,86303960,39907296,126211256,1,0,1,17920,6,5322871022
4229,86350640,12957248,99307888,6,0,0,13312,3,909967902
4230,86358281,13760851,100119132,7,0,0,267776,16,330855327
4231,86364269,13524157,99888426,4,0,0,348160,4,69770439
4232,86366210,39906913,126273123,1,0,1,7680,6,3907707207
4233,86380611,40046655,126427266,0,0,1,175104,6,5300858726
4234,86412280,12877099,99289379,3,0,0,133632,0,6424360286
4235,86434181,40231707,126665888,0,0,1,244224,6,10531319717
4236,86441011,40379225,126820236,0,0,1,253952,6,9798497105
4237,86446110,40377992,126824102,2,0,1,6144,11,7137361348
4238,86449520,12557913,99007433,0,0,0,1536,6,9997482274
4239,86471000,13716614,100187614,0,0,0,4096,6,7310497759
4240,86491600,12879101,99370701,1,0,0,27648,6,1486780986
4241,86503040,40332697,126835737,1,0,1,20480,6,2162369161
4242,86534750,12576295,99111045,9,0,0,10240,17,4490989203
4243,86572060,40271965,126844025,2,0,1,12288,11,7148472590
4244,86579581,12724228,99303809,7,0,0,37376,16,2460916514
4245,86584600,13177785,99762385,6,0,0,66560,3,1130837329
4246,86594900,40269937,126864837,2,0,1,23040,11,3121470508
4247,86596740,40280049,126876789,9,0,1,17408,17,4034269851
4248,86610720,11966733,98577453,9,0,0,2048,17,551554937
4249,86647050,12437071,99084121,0,0,0,2560,6,8830049334
4250,86650570,13533550,100184120,1,0,0,131072,6,1725201097
4251,86672330,13605759,100278089,6,0,0,22528,3,4183736053
4252,86744040,12504592,99248632,1,0,0,99840,6,718830548
4253,86745820,12738370,99484190,8,0,0,80896,6,2584736655
4254,86784890,40096792,126881682,9,0,1,10240,17,2763407605
4255,86852111,12259760,99111871,7,0,0,2560,16,6257865850
4256,86885160,40073952,126959112,5,0,1,6656,11,46970747
4257,86885470,13373645,100259115,3,0,0,148992,0,9142924012
4258,86916391,40120388,127036779,0,0,1,157184,6,825151964
4259,86920820,40116318,127037138,1,0,1,9728,6,516259581
4260,86927890,12184651,99112541,0,0,0,2048,6,7640564661
4261,86929970,12288219,99218189,8,0,0,37376,6,711381271
4262,86930420,40110584,127041004,9,0,1,6144,17,9257745948
4263,86941890,13618925,100560815,1,0,0,233472,6,870076287
4264,86964740,13957974,100922714,6,0,0,90112,3,7057833501
4265,87003160,40038100,127041260,7,0,1,9216,16,5350646871
4266,87006161,40163684,127169845,0,0,1,124928,6,6742520102
4267,87016150,14100902,101117052,6,0,0,129536,3,3332276152
4268,87054540,12841287,99895827,8,0,0,11264,6,1705489139
4269,87083940,40152498,127236438,1,0,1,36352,6,2797843433
4270,87104100,12407920,99512020,9,0,0,1024,17,9487063406
4271,87109431,40386903,127496334,0,0,1,125952,6,8936472436
4272,87117520,40378837,127496357,5,0,1,16896,11,10358104677
4273,87127130,13596328,100723458,1,0,0,275968,6,6900337525
4274,87133340,40371807,127505147,1,0,1,68096,6,4185090470
4275,87143840,12823333,99967173,6,0,0,66048,3,5812603667
4276,87148200,12377415,99525615,1,0,0,44544,6,2496672499
4277,87151410,40353760,127505170,9,0,1,1536,17,1559814301
4278,87166509,13644532,100811041,4,0,0,132608,4,2725040503
4279,87174490,40330719,127505209,2,0,1,3072,11,10630879573
4280,87177190,40331608,127508798,1,0,1,23040,6,6206661149
4281,87207430,12830091,100037521,8,0,0,125440,6,437787050
4282,87210610,14357708,101568318,3,0,0,145408,0,6067153464
4283,87219830,40308810,127528640,2,0,1,12800,11,10424899371
4284,87230370,12360858,99591228,6,0,0,11776,3,1927204900
4285,87232001,14218152,101450153,7,0,0,129536,16,3849497584
4286,87232850,40318812,127551662,9,0,1,59392,17,2015149399
4287,87243970,12646507,99890477,9,0,0,6656,17,9924248778
4288,87277470,14373087,101650557,3,0,0,85504,0,2791307220
4289,87314140,12578232,99892372,8,0,0,6144,6,3522702121
4290,87320330,40261880,127582210,2,0,1,7680,11,7489342223
4291,87330110,40252123,127582233,2,0,1,17408,11,6218060219
4292,87331899,12811771,100143670,4,0,0,79360,4,3756485152
4293,87337330,12806831,100144161,9,0,0,1536,17,5650221916
4294,87344780,40237476,127582256,9,0,1,4608,17,10212819974
4295,87360570,40224019,127584589,7,0,1,31744,16,8916723340
4296,87387400,40198674,127586074,1,0,1,15360,6,1475691065
4297,87399660,14349999,101749659,6,0,0,51712,3,7270575553
4298,87493690,14585988,102079678,1,0,0,489472,6,5383928936
4299,87529120,12446040,99975160,3,0,0,26112,0,4395868802
4300,87597510,39989890,127587400,5,0,1,10240,11,9224053636
4301,87625630,12560697,100186327,9,0,0,7168,17,6985340176
4302,87626560,39981918,127608478,5,0,1,6144,11,1993934669
4303,87670120,12449347,100119467,9,0,0,1024,17,2810437444
4304,87671960,39937082,127609042,9,0,1,10752,17,10284268345
4305,87679040,39932588,127611628,1,0,1,4096,6,10647652800
4306,87698040,12884014,100582054,1,0,0,69632,6,1359371676
4307,87706680,12692371,100399051,8,0,0,93696,6,621016499
4308,87724050,39913388,127637438,1,0,1,40960,6,258457139
4309,87744020,12449775,100193795,3,0,0,4096,0,62767585
4310,87753260,13461018,101214278,8,0,0,146944,6,2407779554
4311,87760240,12606900,100367140,0,0,0,1024,6,1628179007
4312,87769720,12971857,100741577,1,0,0,59392,6,8468574141
4313,87794790,13615872,101410662,1,0,0,112640,6,2088482077
4314,87798640,14331613,102130253,1,0,0,165888,6,4729413887
4315,87823130,39815294,127638424,5,0,1,1536,11,2615451827
4316,87841240,39800730,127641970,8,0,1,5632,6,5540590021
4317,87848950,12917142,100766092,6,0,0,80384,3,7753847910
4318,87855281,39824729,127680010,0,0,1,81408,6,10140354514
4319,87874680,12549300,100423980,0,0,0,1024,6,4980780211
4320,87915770,12921647,100837417,8,0,0,57856,6,8688678339
4321,87953220,39751378,127704598,6,0,1,1024,3,9780941810
4322,87963180,39742724,127705904,6,0,1,2048,3,3871223854
4323,87964140,13250785,101214925,3,0,0,2048,0,4782264700
4324,87992030,13068190,101060220,6,0,0,102400,3,4802082756
4325,88014910,39693260,127708170,9,0,1,3584,17,8178978146
4326,88122080,39587076,127709156,1,0,1,1536,6,10125211079
4327,88142130,14113875,102256005,8,0,0,112128,6,5872932028
4328,88147160,14233182,102380342,6,0,0,251392,3,7709385867
4329,88159050,13296522,101455572,1,0,0,2560,6,1613808883
4330,88159210,13295490,101454700,3,0,0,14848,0,4020641160
4331,88215490,14283622,102499112,8,0,0,283136,6,1241324044
4332,88217250,39495772,127713022,9,0,1,6144,17,2023765728
4333,88234619,13339338,101573957,4,0,0,18432,4,4531036911
4334,88236530,39494406,127730936,1,0,1,22016,6,9634656563
4335,88249100,13214379,101463479,3,0,0,15360,0,8654032443
4336,88250130,39485632,127735762,1,0,1,7680,6,8488071675
4337,88282900,39521754,127804654,9,0,1,83456,17,8918382269
4338,88285550,13290586,101576136,9,0,0,3584,17,7522515806
4339,88329020,13426998,101756018,9,0,0,1536,17,1257146968
4340,88338989,13316115,101655104,4,0,0,14848,4,8718943566
4341,88381170,13549303,101930473,3,0,0,71168,0,5010060964
4342,88418760,13262463,101681223,3,0,0,33792,0,10408884714
4343,88425460,14130730,102556190,8,0,0,172032,6,8924830515
4344,88459260,13411002,101870262,1,0,0,34816,6,3701429106
4345,88517511,13895310,102412821,7,0,0,106496,16,9337967980
4346,88525820,14465066,102990886,3,0,0,294912,0,4131656673
4347,88535990,39270610,127806600,9,0,1,3072,17,5113901069
4348,88556490,13164377,101720867,9,0,0,512,17,10342419319
4349,88556970,39250616,127807586,1,0,1,1536,6,6575166945
4350,88634400,39178332,127812732,6,0,1,20480,3,9950930512
4351,88659500,13644223,102303723,8,0,0,131584,6,8807641019
4352,88678510,14328623,103007133,3,0,0,53248,0,5532639968
4353,88716930,14722489,103439419,8,0,0,308224,6,6864590715
4354,88726150,14542849,103268999,3,0,0,322048,0,9217604791
4355,88737180,39081965,127819145,6,0,1,22528,3,4471055857
4356,88764740,39113534,127878274,1,0,1,17408,6,4109925615
4357,88765530,39125521,127891051,1,0,1,8704,6,2724758340
4358,88765691,14553734,103319425,7,0,0,160256,16,3572726625
4359,88773930,39181360,127955290,6,0,1,9216,3,6249603952
4360,88780000,14793883,103573883,3,0,0,75776,0,9122945691
4361,88784090,39219518,128003608,6,0,1,11264,3,3007625005
4362,88815690,14198174,103013864,6,0,0,22016,3,5961500803
4363,88823420,14727352,103550772,3,0,0,79360,0,2039721584
4364,88832950,13724979,102557929,9,0,0,5632,17,4419912958
4365,88861680,39142914,128004594,6,0,1,1536,3,6912390122
4366,88864570,13929781,102794351,3,0,0,35840,0,974231251
4367,88871509,13632150,102503659,4,0,0,14848,4,5430329694
4368,88895090,14736220,103631310,8,0,0,115712,6,345123268
4369,88934230,39070620,128004850,1,0,1,9216,6,2170746184
4370,88935970,14844938,103780908,8,0,0,368640,6,5727641075
4371,88942030,13927471,102869501,9,0,0,4096,17,473058016
4372,89017570,13838551,102856121,9,0,0,512,17,1935328506
4373,89025590,15344842,104370432,3,0,0,63488,0,4612315080
4374,89037400,14298105,103335505,3,0,0,51712,0,6114517726
4375,89038970,14789738,103828708,6,0,0,155648,3,2576446457
4376,89058929,15489973,104548902,4,0,0,53248,4,10015250155
4377,89227851,14979111,104206962,7,0,0,62464,16,466218502
4378,89306420,38699416,128005836,2,0,1,1536,11,6935271271
4379,89311340,38850475,128161815,2,0,1,27136,11,7174969487
4380,89345380,38820226,128165606,2,0,1,9216,11,3883929843
4381,89358219,14637682,103995901,4,0,0,226304,4,4244873482
4382,89368620,15444265,104812885,8,0,0,139776,6,3058036487
4383,89376090,13664816,103040906,3,0,0,29184,0,4576849556
4384,89376600,38823375,128199975,6,0,1,4096,3,1169003028
4385,89403730,38842959,128246689,2,0,1,13312,11,7492909054
4386,89416940,13625081,103042021,3,0,0,3584,0,5056954298
4387,89439510,38843735,128283245,1,0,1,512,6,1088777100
4388,89449190,38834311,128283501,1,0,1,9216,6,3474055779
4389,89480220,14656123,104136343,1,0,0,131584,6,5872344226
4390,89484740,38827751,128312491,1,0,1,5632,6,5141026584
4391,89505580,38969326,128474906,1,0,1,18944,6,8165709474
4392,89550989,15359124,104910113,4,0,0,45056,4,8688418293
4393,89600710,13839512,103440222,9,0,0,2560,17,9072857938
4394,89634940,38878138,128513078,2,0,1,15360,11,6805004008
4395,89637450,13803731,103441181,9,0,0,3072,17,6115480493
4396,89641380,38982068,128623448,1,0,1,19968,6,54480719
4397,89646010,39128240,128774250,4,0,1,16896,4,4294126638
4398,89652470,39125726,128778196,2,0,1,13824,11,711227232
4399,89652650,14177845,103830495,8,0,0,5632,6,8834511826
4400,89653490,14209037,103862527,8,0,0,26624,6,375686420
4401,89662110,15108124,104770234,1,0,0,116224,6,4449098005
4402,89666990,39111229,128778219,2,0,1,3072,11,4563283453
4403,89684630,39212086,128896716,6,0,1,30720,3,8395414990
4404,89734170,14501363,104235533,3,0,0,93696,0,9188467667
4405,89737630,15158732,104896362,1,0,0,34816,6,8107648838
4406,89750560,15510206,105260766,3,0,0,422912,0,1635790007
4407,89751290,15335762,105087052,0,0,0,512,6,5592465732
4408,89801120,15618981,105420101,6,0,0,301568,3,599158297
4409,89817271,14897711,104714982,7,0,0,203776,16,3228041578
4410,89831050,39065697,128896747,2,0,1,5120,11,5503982847
4411,89854091,14465894,104319985,7,0,0,12288,16,8626058554
4412,89875510,14777361,104652871,8,0,0,246784,6,87828415
4413,89878670,15081573,104960243,6,0,0,56832,3,5464065637
4414,89884190,39292800,129176990,1,0,1,13312,6,1852471021
4415,89919169,15726973,105646142,4,0,0,120832,4,3021627398
4416,89944889,15503681,105448570,4,0,0,12288,4,4906695977
4417,89982400,39194613,129177013,6,0,1,14848,3,10704560835
4418,90045160,14897736,104942896,8,0,0,107520,6,3447189732
4419,90058440,40014319,130072759,2,0,1,88576,11,3845721361
4420,90112900,40062834,130175734,2,0,1,512,11,236118526
4421,90162240,14865524,105027764,0,0,0,3072,6,8650831331
4422,90196130,14665098,104861228,6,0,0,43520,3,2883076753
4423,90223950,39952770,130176720,4,0,1,1536,4,939133993
4424,90250030,39927356,130177386,2,0,1,1024,11,10453623815
4425,90269360,39942293,130211653,1,0,1,22528,6,4265741179
4426,90289550,39922126,130211676,2,0,1,3584,11,4217151613
4427,90308630,14823257,105131887,3,0,0,86016,0,8843655360
4428,90308989,15557950,105866939,4,0,0,158208,4,8322294154
4429,90312990,15232516,105545506,8,0,0,183296,6,284025022
4430,90319140,14996607,105315747,8,0,0,180224,6,4855288251
4431,90353190,39858509,130211699,4,0,1,6656,4,5729839998
4432,90380260,14946663,105326923,3,0,0,32256,0,6032146160
4433,90408891,15064941,105473832,7,0,0,80384,16,6289360609
4434,90421460,14095841,104517301,3,0,0,17408,0,764462655
4435,90435260,14299401,104734661,8,0,0,64512,6,655376961
4436,90435520,39796295,130231815,4,0,1,6144,4,3337145169
4437,90480490,39755511,130236001,1,0,1,6656,6,5021045486
4438,90518800,39779306,130298106,2,0,1,32768,11,2064295587
4439,90555520,39746772,130302292,6,0,1,6656,3,6550967890
4440,90556429,14324166,104880595,4,0,0,63488,4,4838665004
4441,90591840,14857400,105449240,9,0,0,2048,17,4422581854
4442,90615461,14701557,105317018,7,0,0,4096,16,4891170794
4443,90647280,14428579,105075859,3,0,0,42496,0,4228846797
4444,90651470,14793333,105444803,6,0,0,80896,3,2144902610
4445,90698760,39605798,130304558,2,0,1,3584,11,2006094606
4446,90708350,39597834,130306184,4,0,1,2560,4,9901894994
4447,90711020,39850918,130561938,6,0,1,48128,3,5471233141
4448,90738760,15142970,105881730,9,0,0,2560,17,8510592524
4449,90747940,15443432,106191372,1,0,0,352256,6,1761552795
4450,90766110,39854998,130621108,6,0,1,44032,3,3675400693
4451,90785250,39835881,130621131,2,0,1,512,11,9994275483
4452,90787330,39833824,130621154,2,0,1,3072,11,5500323591
4453,90790901,14698710,105489611,7,0,0,51712,16,9717402308
4454,90795221,15569636,106364857,7,0,0,160768,16,8361393382
4455,90812480,39808705,130621185,2,0,1,12800,11,872374034
4456,90815481,14991953,105807434,7,0,0,227328,16,3512491179
4457,90860510,14141692,105002202,9,0,0,512,17,5317953653
4458,90879640,39741568,130621208,6,0,1,5632,3,9957275061
4459,90893240,39730510,130623750,6,0,1,34304,3,3264974837
4460,90895710,14973280,105868990,9,0,0,6656,17,9717053718
4461,90930790,39692983,130623773,1,0,1,1024,6,8654116577
4462,90952180,39671616,130623796,6,0,1,14336,3,4852162408
4463,90953760,39670059,130623819,2,0,1,6144,11,6968861059
4464,90979099,14349095,105328194,4,0,0,4096,4,2751051239
4465,90988860,14557153,105546013,0,0,0,1536,6,5976597200
4466,90996220,14822157,105818377,8,0,0,35840,6,1604284135
4467,91005370,14976388,105981758,3,0,0,40448,0,10166366192
4468,91009800,39614042,130623842,1,0,1,14848,6,9291249345
4469,91049830,39574035,130623865,1,0,1,17408,6,2882958340
4470,91052989,14598636,105651625,4,0,0,17920,4,6796498892
4471,91065050,39558838,130623888,2,0,1,18432,11,2237118713
4472,91065180,39558731,130623911,2,0,1,2048,11,9929935168
4473,91080760,39544718,130625478,6,0,1,23040,3,10298910444
4474,91090840,14566580,105657420,8,0,0,18944,6,2444813656
4475,91107950,39517989,130625939,4,0,1,10240,4,9355781814
4476,91124301,15191206,106315507,7,0,0,83456,16,1169859300
4477,91127989,15090238,106218227,4,0,0,88064,4,3871838783
4478,91155380,39566932,130722312,4,0,1,47616,4,241636660
4479,91155740,14714677,105870417,9,0,0,4608,17,8813816188
4480,91156941,15133092,106290033,7,0,0,231936,16,1840574468
4481,91214340,15418802,106633142,3,0,0,261120,0,5124124499
4482,91227260,15154819,106382079,3,0,0,56320,0,1063782153
4483,91243820,14574892,105818712,9,0,0,1024,17,8512705722
4484,91252209,15301171,106553380,4,0,0,135168,4,3195574213
4485,91262790,39461971,130724761,1,0,1,10752,6,9890323764
4486,91270420,15521646,106792066,6,0,0,405504,3,5258008743
4487,91281830,15548704,106830534,1,0,0,86016,6,370027998
4488,91289600,39443853,130733453,1,0,1,13824,6,5485132048
4489,91392360,39345599,130737959,1,0,1,7168,6,7359276762
4490,91396210,39364232,130760442,6,0,1,1024,3,5939158085
4491,91410060,14460536,105870596,9,0,0,512,17,628152344
4492,91431080,15020540,106451620,8,0,0,16384,6,3755365314
4493,91451190,39311838,130763028,7,0,1,4096,16,5812536739
4494,91465150,14405953,105871103,9,0,0,1536,17,570320820
4495,91478480,15576951,107055431,1,0,0,84480,6,3934652253
4496,91526600,39236774,130763374,4,0,1,512,4,9531589055
4497,91528780,39241911,130770691,4,0,1,13312,4,3334544007
4498,91597880,15431788,107029668,1,0,0,491520,6,3607915991
4499,91642350,39146176,130788526,7,0,1,36352,16,2851306945
4500,91645920,15022571,106668491,3,0,0,88576,0,8821703686
4501,91652930,39137542,130790472,6,0,1,3072,3,4658022682
4502,91658220,14561122,106219342,0,0,0,3584,6,45088713
4503,91810550,14505292,106315842,0,0,0,1024,6,6513902529
4504,91831900,38985360,130817260,4,0,1,41472,4,2903195573
4505,91839180,15004683,106843863,0,0,0,512,6,5246177567
4506,91873370,38962534,130835904,4,0,1,3072,4,8401167432
4507,91892481,15230879,107123360,7,0,0,188928,16,3408664998
4508,91905150,38931625,130836775,7,0,1,12288,16,4829119102
4509,91913550,38936114,130849664,1,0,1,512,6,4411140836
4510,91918260,38931750,130850010,4,0,1,512,4,4484822538
4511,91925390,14878913,106804303,0,0,0,512,6,251650788
4512,91947770,38903418,130851188,4,0,1,13824,4,9944829431
4513,91984680,38892569,130877249,7,0,1,14336,16,7345571788
4514,91986010,14818114,106804124,1,0,0,38912,6,5551521174
4515,92000640,14640832,106641472,8,0,0,27136,6,8490726574
4516,92023570,14808703,106832273,9,0,0,5632,17,2654417107
4517,92119240,38893631,131012871,6,0,1,35328,3,9911906833
4518,92131440,14993199,107124639,0,0,0,4096,6,9182729988
4519,92144770,39247757,131392527,6,0,1,34304,3,10269569580
4520,92161440,39284048,131445488,1,0,1,53248,6,7608128266
4521,92181891,14661793,106843684,7,0,0,37376,16,2617759291
4522,92187880,14604365,106792245,0,0,0,512,6,4569948070
4523,92196760,14356799,106553559,9,0,0,512,17,9478033742
4524,92200471,39573130,131773601,0,0,1,100864,6,6877217937
4525,92215091,39641196,131856287,0,0,1,135168,6,5421831603
4526,92251470,39670116,131921586,7,0,1,81408,16,5831873116
4527,92283651,39653114,131936765,0,0,1,51200,6,9933398073
4528,92288630,14776340,107064970,3,0,0,31232,0,8320841124
4529,92292710,39681800,131974510,8,0,1,50176,6,4746037610
4530,92294400,39680133,131974533,6,0,1,12800,3,9278352284
4531,92312200,39701605,132013805,1,0,1,20992,6,6319261535
4532,92317980,14890148,107208128,9,0,0,1024,17,6096755988
4533,92320821,15087935,107408756,7,0,0,498176,16,6996714854
4534,92321349,14824709,107146058,4,0,0,23040,4,3664866188
4535,92326190,39732166,132058356,6,0,1,29184,3,1177077880
4536,92377770,15036850,107414620,0,0,0,5632,6,605229824
4537,92401740,14785814,107187554,3,0,0,10240,0,2273212688
4538,92406300,14723385,107129685,0,0,0,3584,6,2839571999
4539,92414341,40032592,132446933,0,0,1,301568,6,5401256953
4540,92421470,40025486,132446956,6,0,1,3584,3,8094559129
4541,92428760,14637013,107065773,9,0,0,2560,17,5744732937
4542,92453910,14674660,107128570,8,0,0,12800,6,3457077635
4543,92519710,39927269,132446979,1,0,1,9216,6,464487340
4544,92551520,14861338,107412858,8,0,0,12800,6,8045744377
4545,92568861,40043115,132611976,0,0,1,136192,6,4873932393
4546,92621200,14833126,107454326,3,0,0,87040,0,1681430762
4547,92631741,15008605,107640346,7,0,0,208384,16,10037955035
4548,92647770,14761165,107408935,9,0,0,512,17,10175522044
4549,92656840,14881016,107537856,0,0,0,5120,6,2216690515
4550,92657050,15181937,107838987,1,0,0,18432,6,1946139196
4551,92676150,39935849,132611999,1,0,1,13824,6,9086523180
4552,92678430,14815921,107494351,8,0,0,3584,6,6287975951
4553,92681760,15015540,107697300,3,0,0,57344,0,47949341
4554,92710010,39902012,132612022,6,0,1,45568,3,6652288352
4555,92720860,39891185,132612045,1,0,1,2560,6,5502308336
4556,92749850,15225856,107975706,3,0,0,100864,0,7752663734
4557,92782170,15474555,108256725,1,0,0,390656,6,4352565617
4558,92807720,39817176,132624896,6,0,1,62464,3,4928000054
4559,92841760,39784762,132626522,1,0,1,2560,6,7584358976
4560,92849860,39832059,132681919,7,0,1,25088,16,1161092412
4561,92887270,39794672,132681942,7,0,1,3584,16,9818984935
4562,92892040,14827435,107719475,1,0,0,72704,6,7653850862
4563,92894230,39787735,132681965,6,0,1,4096,3,8039718248
4564,92937050,14896298,107833348,1,0,0,88576,6,9164991816
4565,92987580,39755833,132743413,7,0,1,47104,16,3774179029
4566,92994540,15342699,108337239,3,0,0,28672,0,6191706161
4567,93035330,14942739,107978069,9,0,0,7680,17,6712533958
4568,93083489,14853008,107936497,4,0,0,79872,4,10471450143
4569,93092771,40000136,133092907,0,0,1,89600,6,5118618430
4570,93123699,15180496,108304195,4,0,0,154112,4,6913246236
4571,93166510,39926420,133092930,7,0,1,3584,16,7134516977
4572,93197240,14872399,108069639,0,0,0,4608,6,2634866500
4573,93201570,15055646,108257216,0,0,0,1536,6,241086897
4574,93209790,14832878,108042668,0,0,0,9216,6,10185194911
4575,93212550,39880403,133092953,6,0,1,512,3,4860834817
4576,93254749,14829109,108083858,4,0,0,7168,4,3199054255
4577,93293760,39799216,133092976,6,0,1,7680,3,2526767489
4578,93313180,39779819,133092999,1,0,1,4096,6,2602102124
4579,93316930,14788876,108105806,9,0,0,3584,17,6903889545
4580,93338180,14770024,108108204,3,0,0,7168,0,3240067521
4581,93340849,15064061,108404910,4,0,0,70656,4,3787745534
4582,93344920,15334832,108679752,1,0,0,37888,6,2655884879
4583,93350600,14956027,108306627,0,0,0,6144,6,5098263484
4584,93351950,39741072,133093022,1,0,1,14336,6,10705107706
4585,93359990,39733055,133093045,6,0,1,13824,3,9915159498
4586,93401181,39704710,133105891,0,0,1,120832,6,9216391206
4587,93437440,39668474,133105914,6,0,1,8192,3,8631642835
4588,93489410,15063556,108552966,8,0,0,96768,6,8106931398
4589,93528751,39747909,133276660,0,0,1,311296,6,7678174028
4590,93540561,39877677,133418238,0,0,1,146432,6,8377735299
4591,93549810,39869094,133418904,6,0,1,1024,3,7406675448
4592,93571780,39851630,133423410,2,0,1,7168,11,378651505
4593,93577900,14760142,108338042,9,0,0,2560,17,9049543086
4594,93581140,14723592,108304732,9,0,0,1536,17,9793776457
4595,93591680,39832716,133424396,1,0,1,1536,6,1085775863
4596,93594029,14713713,108307742,4,0,0,3584,4,8338067329
4597,93595000,15330116,108925116,1,0,0,135168,6,5828253456
4598,93595360,39830662,133426022,6,0,1,2560,3,10475183527
4599,93597410,39856842,133454252,7,0,1,46592,16,7847461083
4600,93618010,39837830,133455840,6,0,1,15872,3,7654367117
4601,93621611,40533145,134154756,0,0,1,921088,6,9166930674
4602,93622660,40538152,134160812,6,0,1,28672,3,6855919258
4603,93650290,15958673,109608963,8,0,0,54784,6,7482796085
4604,93654651,40526711,134181362,0,0,1,29184,6,3801988595
4605,93656250,15282457,108938707,9,0,0,1024,17,1880873808
4606,93665520,15135992,108801512,0,0,0,6656,6,9134759469
4607,93666881,40735882,134402763,0,0,1,422400,6,6589200413
4608,93704870,40760514,134465384,1,0,1,19456,6,1695069151
4609,93715300,15366015,109081315,3,0,0,146432,0,3875545555
4610,93715449,15645892,109361341,4,0,0,666112,4,3822370555
4611,93717431,15287120,109004551,7,0,0,55808,16,1528387613
4612,93728550,40740496,134469046,7,0,1,17408,16,2307445637
4613,93731001,40743191,134474192,0,0,1,8192,6,6913769492
4614,93778409,15100747,108879156,4,0,0,11776,4,4072997533
4615,93781140,15300354,109081494,9,0,0,512,17,10088249433
4616,93796060,40685507,134481567,9,0,1,29696,17,7734232200
4617,93816540,14894918,108711458,9,0,0,4608,17,2009665312
4618,93818300,15625142,109443442,3,0,0,176128,0,1848650925
4619,93835690,14999558,108835248,9,0,0,1536,17,2703797320
4620,93865180,40633068,134498248,7,0,1,55808,16,4491633903
4621,93880800,15759579,109640379,9,0,0,5120,17,8298018057
4622,93886220,40629957,134516177,6,0,1,23552,3,5756829465
4623,93914230,15676747,109590977,0,0,0,4608,6,9660783009
4624,93948240,15510692,109458932,9,0,0,50688,17,8411018899
4625,93971480,40554824,134526304,7,0,1,35840,16,8563963714
4626,93973220,15391801,109365021,8,0,0,11776,6,849492598
4627,93976790,15487860,109464650,9,0,0,3584,17,10480421207
4628,94036409,15705641,109742050,4,0,0,38400,4,8223656249
4629,94066300,40467416,134533716,6,0,1,11776,3,2192439159
4630,94109690,15272982,109382672,9,0,0,57856,17,1611479031
4631,94138580,15450970,109589550,1,0,0,353280,6,1564808788
4632,94165379,15835163,110000542,4,0,0,265728,4,9346562659
4633,94179789,15437823,109617612,4,0,0,28160,4,7016386028
4634,94230431,40790753,135021184,0,0,1,521216,6,7323975002
4635,94231310,15407454,109638764,3,0,0,69120,0,9098561973
4636,94259280,40763530,135022810,7,0,1,2560,16,9478382880
4637,94265480,15117387,109382867,0,0,0,512,6,8888074591
4638,94271459,15380313,109651772,4,0,0,7680,4,1770546534
4639,94280130,15312118,109592248,0,0,0,4096,6,9204388316
4640,94283810,16258711,110542521,8,0,0,202240,6,75791773
4641,94307110,40733826,135040936,7,0,1,25088,16,2763341358
4642,94325089,15762741,110087830,4,0,0,61952,4,256258340
4643,94333300,40766469,135099769,9,0,1,3072,17,5411211099
4644,94355381,15928175,110283556,7,0,0,62976,16,9490499841
4645,94400801,16332719,110733520,7,0,0,226816,16,4839416396
4646,94401640,40698152,135099792,9,0,1,5632,17,4481374904
4647,94467560,15589838,110057398,1,0,0,123392,6,6024377054
4648,94470280,40629535,135099815,4,0,1,17920,4,4612603166
4649,94500960,16516319,111017279,1,0,0,515584,6,6194470185
4650,94505610,15975268,110480878,9,0,0,109568,17,5520864882
4651,94521620,40596547,135118167,6,0,1,56320,3,4879372234
4652,94543079,16601924,111145003,4,0,0,109568,4,425842277
4653,94559050,40570466,135129516,4,0,1,512,4,8275199768
4654,94567730,16682914,111250644,9,0,0,314368,17,8457973286
4655,94589450,15953406,110542856,0,0,0,1024,6,1120291953
4656,94601250,40531172,135132422,9,0,1,4608,17,648815980
4657,94602991,40537101,135140092,0,0,1,16896,6,8157688103
4658,94635800,40530359,135166159,6,0,1,37376,3,2839271633
4659,94640811,40661441,135302252,0,0,1,135168,6,7379504440
4660,94657309,16877404,111534713,4,0,0,226304,4,8755496298
4661,94665550,40641208,135306758,7,0,1,7168,16,8273503398
4662,94692630,16760607,111453237,9,0,0,276992,17,6906559642
4663,94705190,17193280,111898470,9,0,0,468992,17,8278488727
4664,94718721,40861798,135580519,0,0,1,414720,6,1802271954
4665,94733311,16864408,111597719,7,0,0,46080,16,1569386210
4666,94736180,40844595,135580775,4,0,1,9216,4,14077863
4667,94746400,40850673,135597073,9,0,1,30208,17,5959079094
4668,94749790,16361806,111111596,1,0,0,272384,6,1964421996
4669,94755660,40854059,135609719,4,0,1,1024,4,2590236928
4670,94780300,40829442,135609742,7,0,1,1024,16,4434946263
4671,94852631,40873752,135726383,0,0,1,82432,6,7022213109
4672,94869391,16499427,111368818,7,0,0,58368,16,134757662
4673,94912390,16750716,111663106,8,0,0,214528,6,8696187880
4674,94925570,16227256,111152826,1,0,0,25600,6,602123364
4675,94930950,17143222,112074172,8,0,0,576512,6,9544062760
4676,94932519,15880238,110812757,4,0,0,22016,4,8350909394
4677,94958930,40767476,135726406,4,0,1,4096,4,5124095449
4678,94986240,40750757,135736997,9,0,1,34304,17,8291795673
4679,95039320,15978762,111018082,0,0,0,2560,6,4341754550
4680,95192471,40663845,135856316,0,0,1,214528,6,3214906797
4681,95212700,40645101,135857801,7,0,1,15360,16,6197206815
4682,95264831,40843136,136107967,0,0,1,43520,6,9822241047
4683,95323730,16373875,111697605,8,0,0,113152,6,6466936125
4684,95334671,41082356,136417027,0,0,1,94720,6,9211878215
4685,95373440,16782497,112155937,9,0,0,37376,17,7705876469
4686,95379561,16192216,111571777,7,0,0,32256,16,4463780384
4687,95386130,16698563,112084693,3,0,0,15360,0,1130160892
4688,95398180,41018870,136417050,7,0,1,5120,16,6920318454
4689,95423371,16138509,111561880,7,0,0,89088,16,8321370974
4690,95436330,40980743,136417073,7,0,1,12800,16,4672782795
4691,95468781,41050063,136518844,0,0,1,143360,6,4122886529
4692,95483560,16238633,111722193,8,0,0,39936,6,2226495811
4693,95501850,41056786,136558636,7,0,1,5632,16,5216568380
4694,95510890,41047769,136558659,7,0,1,9728,16,24562607
4695,95542460,41095473,136637933,7,0,1,50176,16,8833833411
4696,95554171,41733131,137287302,0,0,1,215552,6,6566816081
4697,95562151,41898319,137460470,0,0,1,215552,6,3906765355
4698,95571710,41893111,137464821,7,0,1,10752,16,1588284550
4699,95573561,16010095,111583656,7,0,0,38912,16,7187945566
4700,95593340,41888183,137481523,7,0,1,4608,16,6213034677
4701,95614990,16465000,112079990,8,0,0,18944,6,319750420
4702,95626591,17005819,112632410,7,0,0,318976,16,1108643359
4703,95629580,41856769,137486349,7,0,1,7680,16,858977634
4704,95636510,41852131,137488641,7,0,1,13824,16,7302434215
4705,95668250,41826395,137494645,7,0,1,20480,16,8857694130
4706,95687831,42149348,137837179,0,0,1,204288,6,2591014939
4707,95759620,16357427,112117047,8,0,0,105984,6,4677445784
4708,95762039,16488831,112250870,4,0,0,242176,4,2255058824
4709,95803910,16467575,112271485,8,0,0,67584,6,5635456569
4710,95826011,42209260,138035271,0,0,1,243712,6,9333699650
4711,95845950,42189344,138035294,7,0,1,4096,16,2118324045
4712,95946010,16198516,112144526,8,0,0,90112,6,3174312324
4713,95976011,16692653,112668664,7,0,0,54272,16,2445439547
4714,95980360,16933926,112914286,9,0,0,148480,17,1101738200
4715,96003580,16313363,112316943,8,0,0,148992,6,1112374441
4716,96012450,16163806,112176256,9,0,0,66560,17,8816831998
4717,96057011,16296915,112353926,7,0,0,85504,16,5994462463
4718,96089450,16984504,113073954,0,0,0,1536,6,6396046412
4719,96095401,16384605,112480006,7,0,0,152064,16,398182311
4720,96126810,16234754,112361564,0,0,0,3584,6,1265325209
4721,96132090,16044969,112177059,0,0,0,2560,6,8994812958
4722,96150760,16570756,112721516,3,0,0,20480,0,8472769268
4723,96212770,41822547,138035317,7,0,1,17920,16,10045832199
4724,96236710,41808637,138045347,7,0,1,22528,16,1458476158
4725,96255411,41824556,138079967,0,0,1,58368,6,7867059725
4726,96259680,16737309,112996989,9,0,0,271360,17,5343198377
4727,96274530,41889832,138164362,7,0,1,1536,16,2145388585
4728,96302081,42167894,138469975,0,0,1,384512,6,3004749986
4729,96302630,17041797,113344427,8,0,0,110592,6,5766421124
4730,96327210,42172385,138499595,7,0,1,2560,16,10195102231
4731,96333160,16739968,113073128,9,0,0,156672,17,6657775220
4732,96335140,16791484,113126624,3,0,0,52224,0,3351337868
4733,96341981,42255171,138597152,0,0,1,113152,6,439268166
4734,96347910,17232911,113580821,3,0,0,497152,0,82511809
4735,96353090,17237293,113590383,8,0,0,31232,6,3450723277
4736,96356510,17369264,113725774,8,0,0,128512,6,8607969955
4737,96361521,42682429,139043950,0,0,1,494592,6,2365001942
4738,96369100,17317471,113686571,3,0,0,315392,0,10180876261
4739,96372750,42677099,139049849,3,0,1,7168,0,8364207219
4740,96387370,16398634,112786004,3,0,0,129024,0,2265387722
4741,96422381,17347128,113769509,7,0,0,70656,16,1065718062
4742,96436801,42668424,139105225,0,0,1,104448,6,9226471390
4743,96450200,16623263,113073463,0,0,0,1024,6,821890110
4744,96477341,42694212,139171553,0,0,1,101888,6,4797117726
4745,96499870,17483399,113983269,3,0,0,278528,0,9051161064
4746,96549630,17752998,114302628,3,0,0,377344,0,8304075882
4747,96555781,17247821,113803602,7,0,0,81920,16,7405816730
4748,96583830,42589669,139173499,9,0,1,3072,17,8338180180
4749,96602440,16782901,113385341,8,0,0,16896,6,2070324527
4750,96618071,16650152,113268223,7,0,0,8192,16,2176858725
4751,96670370,42503385,139173755,6,0,1,9216,3,8283877122
4752,96674491,42622670,139297161,0,0,1,84480,6,4834108094
4753,96721550,42575634,139297184,3,0,1,11264,0,6864525385
4754,96726720,16514587,113241307,1,0,0,512,6,8451291229
4755,96751710,42545497,139297207,7,0,1,45568,16,192990122
4756,96751770,42545460,139297230,7,0,1,11776,16,8617576655
4757,96766190,42532727,139298917,3,0,1,32768,0,1520769278
4758,96776190,17593252,114369442,8,0,0,216576,6,3959982857
4759,96804340,17707239,114511579,3,0,0,448512,0,3725702835
4760,96825501,17356864,114182365,7,0,0,86528,16,6372241634
4761,96832450,42470333,139302783,7,0,1,6144,16,1306330772
4762,96843900,42470649,139314549,7,0,1,512,16,6151948931
4763,96852130,17292025,114144155,9,0,0,66048,17,5436236032
4764,96860880,42454233,139315113,9,0,1,10752,17,10132994774
4765,96866191,17701305,114567496,7,0,0,183296,16,10715962712
4766,96872689,17836758,114709447,4,0,0,91136,4,6247552454
4767,96882730,42435289,139318019,7,0,1,4608,16,3378822895
4768,96890931,42483033,139373964,0,0,1,67584,6,1124919792
4769,96900850,17106067,114006917,8,0,0,77312,6,66077669
4770,96919399,17697579,114616978,4,0,0,160768,4,5946044958
4771,96935481,42619209,139554690,0,0,1,252416,6,4397525681
4772,96967360,42611884,139579244,7,0,1,14336,16,3494622594
4773,96973690,42636257,139609947,3,0,1,23552,0,78905515
4774,96987960,17386832,114374792,9,0,0,17408,17,3095670122
4775,96997241,42612729,139609970,0,0,1,9216,6,559830660
4776,97000820,17148974,114149794,3,0,0,18432,0,5281871270
4777,97054530,17686319,114740849,8,0,0,43008,6,2973308838
4778,97077951,42695344,139773295,0,0,1,295424,6,4204748132
4779,97081960,17221471,114303431,0,0,0,2560,6,7588769424
4780,97089910,17477984,114567894,8,0,0,1024,6,7153327733
4781,97092100,17589540,114681640,9,0,0,211968,17,9270176723
4782,97134259,17725264,114859523,4,0,0,208896,4,7027733218
4783,97194121,42580480,139774601,0,0,1,2048,6,9705279682
4784,97202180,42575007,139777187,3,0,1,4096,0,1967868745
4785,97214040,42571199,139785239,2,0,1,24064,11,689850071
4786,97219540,17715301,114934841,1,0,0,246784,6,7290991401
4787,97239081,42547503,139786584,0,0,1,11264,6,1086633949
4788,97244490,42546135,139790625,3,0,1,14848,0,10177100198
4789,97255030,42536261,139791291,4,0,1,1024,4,9546666231
4790,97275470,42521108,139796578,3,0,1,16896,0,9162592440
4791,97277441,42535084,139812525,0,0,1,36352,6,9107891978
4792,97283480,42535423,139818903,3,0,1,5632,0,2463416200
4793,97283920,42535342,139819262,3,0,1,9728,0,3812163562
4794,97306350,42513578,139819928,4,0,1,1024,4,415006917
4795,97326050,42538667,139864717,7,0,1,78336,16,1435270835
4796,97386120,42483782,139869902,4,0,1,16384,4,10551358984
4797,97406730,42466398,139873128,7,0,1,5120,16,514795896
4798,97427940,42467686,139895626,2,0,1,27648,11,2444557898
4799,97462580,17247340,114709920,1,0,0,1024,6,6698258622
4800,97486170,17488756,114974926,9,0,0,17408,17,9769340915
4801,97553500,17384842,114938342,8,0,0,11264,6,7679738889
4802,97564030,42333542,139897572,9,0,1,3072,17,1737269361
4803,97585560,17380844,114966404,3,0,0,91648,0,10343548274
4804,97622440,17440491,115062931,0,0,0,512,6,7632362266
4805,97683250,17324958,115008208,1,0,0,51200,6,2982490412
4806,97687690,42267763,139955453,2,0,1,58368,11,3743004461
4807,97697881,42434887,140132768,0,0,1,230912,6,828826500
4808,97718540,42431716,140150256,9,0,1,21504,17,2181092701
4809,97733921,42566376,140300297,0,0,1,187392,6,10197774025
4810,97756080,42573962,140330042,9,0,1,26112,17,2211819222
4811,97765111,42625293,140390404,0,0,1,95232,6,6216137788
4812,97784930,42608534,140393464,4,0,1,13312,4,2529878806
4813,97799200,17741132,115540332,3,0,0,53760,0,10316556574
4814,97813340,42654317,140467657,2,0,1,26624,11,5484360446
4815,97824760,42642920,140467680,4,0,1,13312,4,8870168158
4816,97844500,42623203,140467703,7,0,1,5120,16,3314581642
4817,97881471,42586255,140467726,0,0,1,23552,6,3957866710
4818,97905240,42566456,140471696,3,0,1,5632,0,8159527976
4819,97911330,42563915,140475245,7,0,1,33280,16,8572945039
4820,97927030,18015057,115942087,3,0,0,102912,0,3507837516
4821,97952260,42542584,140494844,4,0,1,15360,4,9775497397
4822,97992520,17358778,115351298,1,0,0,214528,6,595841031
4823,97992830,42513920,140506750,2,0,1,7680,11,10433989502
4824,98004360,42513569,140517929,2,0,1,44544,11,1744938592
4825,98017380,42506821,140524201,7,0,1,7680,16,5339024709
4826,98021740,17450391,115472131,9,0,0,145408,17,3453580273
4827,98024630,17530389,115555019,8,0,0,48128,6,4915946212
4828,98032750,42509549,140542299,7,0,1,1536,16,568043312
4829,98059561,17589828,115649389,7,0,0,97792,16,2362201340
4830,98063690,17670186,115733876,8,0,0,90624,6,3309959819
4831,98067540,42502654,140570194,2,0,1,42496,11,3352021424
4832,98084200,42493969,140578169,4,0,1,21504,4,76339166
4833,98084510,42494544,140579054,4,0,1,1024,4,1133602753
4834,98114180,42465860,140580040,4,0,1,1536,4,6950684981
4835,98129601,18050283,116179884,7,0,0,151040,16,6052474644
4836,98135040,17263735,115398775,0,0,0,1024,6,4109983550
4837,98163060,42420411,140583471,3,0,1,18432,0,6531978911
4838,98168790,42415245,140584035,3,0,1,10752,0,3815098293
4839,98186400,17661329,115847729,8,0,0,185856,6,1734725463
4840,98231860,17155453,115387313,9,0,0,32768,17,9914289021
4841,98268461,42453486,140721947,0,0,1,216064,6,10079604576
4842,98269930,42455243,140725173,2,0,1,5120,11,5742535191
4843,98276570,42452469,140729039,9,0,1,6144,17,2133076664
4844,98289790,17382098,115671888,9,0,0,16384,17,3995711391
4845,98294740,17571622,115866362,8,0,0,60928,6,543106567
4846,98298190,17174811,115473001,0,0,0,1536,6,7162406466
4847,98335420,42427879,140763299,3,0,1,20480,0,8012053294
4848,98336260,42799914,141136174,4,0,1,4608,4,8097410447
4849,98346790,17907025,116253815,8,0,0,42496,6,7211172948
4850,98364880,42771317,141136197,9,0,1,5120,17,1745778744
4851,98375071,17758770,116133841,7,0,0,337920,16,3148574026
4852,98377251,43019746,141396997,0,0,1,76800,6,5052660244
4853,98386470,43011091,141397561,9,0,1,10752,17,1521278113
4854,98389120,17505726,115894846,0,0,0,1024,6,7156188912
4855,98397511,43014551,141412062,0,0,1,9728,6,5851380338
4856,98404950,43012501,141417451,4,0,1,17408,4,2954370255
4857,98405240,43028538,141433778,4,0,1,13824,4,8358693166
4858,98431330,43024094,141455424,7,0,1,16384,16,9390395528
4859,98439570,43055312,141494882,4,0,1,3072,4,8270175611
4860,98448630,17324131,115772761,9,0,0,28672,17,2503156646
4861,98459180,43035856,141495036,9,0,1,8704,17,483943638
4862,98480270,43047263,141527533,2,0,1,12288,11,3421798861
4863,98483800,43043764,141527564,7,0,1,33280,16,759669342
4864,98498070,43373891,141871961,2,0,1,7168,11,4187390853
4865,98528230,43343754,141871984,9,0,1,1024,17,6808027583
4866,98544530,17696314,116240844,8,0,0,159232,6,9054910494
4867,98556920,43327590,141884510,7,0,1,21504,16,7836634133
4868,98563560,17628515,116192075,1,0,0,39936,6,10363172986
4869,98566120,17727741,116293861,9,0,0,131072,17,1736453077
4870,98602710,43281823,141884533,7,0,1,11776,16,10524783159
4871,98609640,43274916,141884556,4,0,1,8192,4,297089806
4872,98624860,18033469,116658329,8,0,0,295424,6,7962302251
4873,98665850,43218729,141884579,2,0,1,19968,11,10410347749
4874,98729870,17707401,116437271,3,0,0,22528,0,794347784
4875,98731960,43152642,141884602,7,0,1,4608,16,7565203979
4876,98733420,43151205,141884625,9,0,1,11776,17,1298766760
4877,98736870,43147778,141884648,4,0,1,3584,4,203098080
4878,98748220,43136451,141884671,4,0,1,30720,4,1154473515
4879,98759680,17545948,116305628,8,0,0,18432,6,670014151
4880,98765940,18346129,117112069,3,0,0,24064,0,1758292947
4881,98792240,43092454,141884694,9,0,1,20992,17,10314848534
4882,98803460,43086272,141889732,9,0,1,32256,17,2730592984
4883,98808850,43080905,141889755,9,0,1,6656,17,4726387902
4884,98817110,43141643,141958753,9,0,1,17920,17,6469838780
4885,98818621,43140155,141958776,0,0,1,3072,6,9683665420
4886,98821310,43137489,141958799,2,0,1,3072,11,9352872500
4887,98904590,43054232,141958822,4,0,1,3072,4,8803711862
4888,98930600,43028245,141958845,3,0,1,47616,0,976293231
4889,98966880,17843166,116810046,3,0,0,18432,0,2398134303
4890,98971050,18362933,117333983,8,0,0,358912,6,6813002489
4891,98971780,18714763,117686543,8,0,0,216576,6,4416510674
4892,98979540,18125174,117104714,8,0,0,196096,6,5123732564
4893,98983470,17980582,116964052,1,0,0,12288,6,5173813419
4894,98999460,42959424,141958884,3,0,1,19456,0,3335677121
4895,99045740,17641012,116686752,0,0,0,3072,6,3596738099
4896,99046660,42912335,141958995,4,0,1,27136,4,1623918489
4897,99052520,18783187,117835707,3,0,0,109056,0,4234577823
4898,99058940,42900078,141959018,4,0,1,6656,4,1490829584
4899,99091851,18414818,117506669,7,0,0,38912,16,1090593277
4900,99092100,42866941,141959041,7,0,1,8192,16,1489442870
4901,99093880,42865184,141959064,4,0,1,9728,4,3184115678
4902,99110800,18278499,117389299,8,0,0,170496,6,9807162712
4903,99143900,42815187,141959087,7,0,1,27648,16,6681366501
4904,99160760,18632712,117793472,9,0,0,331264,17,9127359454
4905,99164750,42890323,142055073,2,0,1,14336,11,3714452710
4906,99166140,42888956,142055096,3,0,1,1024,0,9026065995
4907,99217900,18329462,117547362,1,0,0,110080,6,5341678386
4908,99218020,42837099,142055119,2,0,1,1536,11,7669852996
4909,99237901,42817241,142055142,0,0,1,4608,6,3823740913
4910,99269840,42806456,142076296,7,0,1,4096,16,10538196623
4911,99308090,42768237,142076327,7,0,1,65024,16,6292381494
4912,99316600,42759750,142076350,4,0,1,1536,4,1030099833
4913,99332521,42743852,142076373,0,0,1,42496,6,3865402503
4914,99360260,18260272,117620532,3,0,0,205312,0,3892927425
4915,99376710,18691289,118067999,3,0,0,229376,0,4192749507
4916,99384440,42728327,142112767,4,0,1,3072,4,10311091856
4917,99388650,18303844,117692494,8,0,0,19456,6,7599766725
4918,99430210,19043316,118473526,9,0,0,200192,17,10493140757
4919,99454240,18887233,118341473,2,0,0,662016,11,8514057692
4920,99489290,42623500,142112790,7,0,1,4096,16,5906416151
4921,99494630,42618255,142112885,1,0,1,53248,6,1331749927
4922,99516051,17821231,117337282,7,0,0,10752,16,8752131227
4923,99524530,42588378,142112908,4,0,1,13312,4,7168798226
4924,99560270,42604187,142164457,3,0,1,17920,0,7222823904
4925,99587981,19151154,118739135,7,0,0,267264,16,6206744709
4926,99617361,18185026,117802387,7,0,0,29184,16,9074699141
4927,99656330,42550221,142206551,7,0,1,37888,16,2938398047
4928,99663550,42547187,142210737,6,0,1,6656,3,3492501266
4929,99691380,18721096,118412476,3,0,0,232960,0,7271544300
4930,99698041,18851557,118549598,7,0,0,57344,16,4422740868
4931,99733810,18377107,118110917,1,0,0,71680,6,3224635729
4932,99751561,18762704,118514265,7,0,0,133632,16,6560339484
4933,99765160,42448277,142213437,4,0,1,2560,4,4141166289
4934,99769880,42477740,142247620,4,0,1,41984,4,7862371653
4935,99803620,42458904,142262524,4,0,1,11776,4,10547101263
4936,99867070,42400280,142267350,3,0,1,7680,0,3580486149
4937,99928210,18729259,118657469,8,0,0,107520,6,3587065786
4938,99941170,18590933,118532103,1,0,0,10240,6,6884029695
4939,99960861,18824105,118784966,7,0,0,150016,16,2245232530
4940,100001320,42286647,142287967,4,0,1,16384,4,10012480440
4941,100019770,42400453,142420223,4,0,1,4608,4,1625440916
4942,100037140,42383106,142420246,7,0,1,1024,16,9955147963
4943,100083050,18852368,118935418,1,0,0,137728,6,10219195491
4944,100097910,18739667,118837577,8,0,0,172544,6,3384374746
4945,100102670,18786628,118889298,8,0,0,148992,6,3982336831
4946,100107680,18421280,118528960,9,0,0,48128,17,1090066755
4947,100109600,42310669,142420269,3,0,1,8192,0,7672786588
4948,100130920,18423903,118554823,1,0,0,16896,6,953540346
4949,100148070,42272222,142420292,4,0,1,3072,4,9410880821
4950,100155170,18469508,118624678,9,0,0,228864,17,7011074833
4951,100197630,18646249,118843879,3,0,0,20480,0,3678415350
4952,100202791,18690586,118893377,7,0,0,13312,16,7651019801
4953,100226640,18431008,118657648,0,0,0,512,6,9869458555
4954,100245640,42174675,142420315,7,0,1,3584,16,3144594101
4955,100266000,42157325,142423325,3,0,1,19456,0,9596802332
4956,100268491,18716589,118985080,7,0,0,162816,16,8418503116
4957,100380340,18999730,119380070,9,0,0,31232,17,3302136541
4958,100384300,42039048,142423348,3,0,1,13824,0,513267233
4959,100387550,42035821,142423371,4,0,1,3072,4,907482714
4960,100387680,42035714,142423394,4,0,1,10752,4,4409676262
4961,100419771,19232147,119651918,7,0,0,80384,16,8252842269
4962,100465110,41958307,142423417,7,0,1,1536,16,6410687317
4963,100468330,18718570,119186900,3,0,0,83968,0,3821868478
4964,100537930,41885510,142423440,5,0,1,1536,11,6103642645
4965,100571290,41906795,142478085,1,0,1,32768,6,1230170828
4966,100601290,18417556,119018846,8,0,0,88064,6,2175351255
4967,100610800,41941263,142552063,7,0,1,9216,16,789065525
4968,100626810,41972155,142598965,4,0,1,36352,4,10073724910
4969,100655820,42092430,142748250,7,0,1,76288,16,168377165
4970,100686150,18826716,119512866,1,0,0,232448,6,9125598262
4971,100705110,18439508,119144618,9,0,0,63488,17,3016924740
4972,100705790,42045914,142751704,4,0,1,3584,4,8248059863
4973,100717861,18345449,119063310,7,0,0,24576,16,3491398300
4974,100723800,42029530,142753330,3,0,1,2560,0,5534756578
4975,100820310,41933686,142753996,4,0,1,1024,4,3113805410
4976,100821390,41934194,142755584,1,0,1,15872,6,5128236465
4977,100857290,41899920,142757210,8,0,1,2560,6,614831091
4978,100862721,19010035,119872756,7,0,0,361984,16,8628962173
4979,100863540,18736998,119600538,8,0,0,22528,6,5627453109
4980,100866290,18282678,119148968,0,0,0,1024,6,2648304710
4981,100899030,41971563,142870593,8,0,1,49664,6,2534532804
4982,100902950,41967666,142870616,4,0,1,2560,4,7282450743
4983,100949401,18657556,119606957,7,0,0,20992,16,3324362924
4984,100975250,19251678,120226928,1,0,0,586240,6,3969679287
4985,100989350,18743711,119733061,3,0,0,266240,0,9411509954
4986,100995850,41874789,142870639,1,0,1,25088,6,3703629966
4987,101026910,18886117,119913027,9,0,0,132096,17,3696506146
4988,101034100,18556526,119590626,0,0,0,5120,6,1661407213
4989,101053250,41817412,142870662,7,0,1,28160,16,4464848439
4990,101055030,18908751,119963781,0,0,0,2048,6,8688090265
4991,101055080,41815605,142870685,7,0,1,3584,16,1608818128
4992,101064241,18853021,119917262,7,0,0,13824,16,551183963
4993,101100520,19198347,120298867,8,0,0,236032,6,1836249370
4994,101145071,18781799,119926870,7,0,0,31232,16,8742467593
4995,101162200,19210570,120372770,3,0,0,77312,0,8923429170
4996,101163520,41707188,142870708,3,0,1,1536,0,8262808070
4997,101165410,41705321,142870731,3,0,1,9216,0,7352647522
4998,101182320,41688434,142870754,4,0,1,4608,4,1458602731
4999,101182810,19166335,120349145,3,0,0,65024,0,797265887
5000,101188020,41682916,142870936,7,0,1,512,16,6646375228
5001,101235550,41636257,142871807,1,0,1,12288,6,1549984998
5002,101241450,41665540,142906990,8,0,1,6144,6,3712888749
5003,101264670,41664816,142929486,7,0,1,3072,16,1977157115
5004,101292241,18657378,119949619,7,0,0,13824,16,7429648317
5005,101293150,19036160,120329310,8,0,0,99840,6,6283156811
5006,101346220,41588655,142934875,1,0,1,17408,6,1405009452
5007,101365750,19253809,120619559,8,0,0,19456,6,10568966510
5008,101374091,19077494,120451585,7,0,0,17408,16,9726768583
5009,101375740,41590270,142966010,4,0,1,35840,4,3469347016
5010,101390140,41579385,142969525,8,0,1,14848,6,8861805790
5011,101417280,41575084,142992364,3,0,1,26112,0,3828527205
5012,101422520,41570830,142993350,3,0,1,1536,0,1593237404
5013,101429780,41576603,143006383,4,0,1,13824,4,7607529658
5014,101475481,18992663,120468144,7,0,0,54272,16,1558492974
5015,101480830,41538496,143019326,4,0,1,16384,4,3122184469
5016,101510000,41533708,143043708,3,0,1,22016,0,2962694040
5017,101546530,41498484,143045014,7,0,1,2048,16,6649110929
5018,101550370,41592410,143142780,7,0,1,32768,16,423976610
5019,101562730,19730301,121293031,3,0,0,664064,0,7558665876
5020,101581570,19289555,120871125,9,0,0,94208,17,5356294719
5021,101595140,41547663,143142803,1,0,1,6656,6,7370597693
5022,101605750,41537076,143142826,3,0,1,17408,0,9250743281
5023,101608160,19784289,121392449,3,0,0,140288,0,7817724814
5024,101615770,19316913,120932683,0,0,0,104448,6,9871580759
5025,101621800,41521049,143142849,4,0,1,7168,4,8001502444
5026,101629730,41513142,143142872,8,0,1,7680,6,5230263863
5027,101637320,41505575,143142895,7,0,1,3072,16,4518798775
5028,101672920,41491597,143164517,3,0,1,5120,0,5168830210
5029,101740200,41460251,143200451,8,0,1,45056,6,1925092170
5030,101742790,41457684,143200474,8,0,1,10240,6,3148566303
5031,101758900,19759134,121518034,3,0,0,317440,0,9951849448
5032,101806140,19847013,121653153,8,0,0,195072,6,6805572464
5033,101812900,41457584,143270484,8,0,1,10752,6,9721020689
5034,101813781,19062671,120876452,7,0,0,17408,16,9226537846
5035,101820840,19528842,121349682,3,0,0,185856,0,7322624978
5036,101842130,41480520,143322650,8,0,1,5120,6,3477353559
5037,101865530,19679502,121545032,8,0,0,87552,6,617269319
5038,101876800,41553069,143429869,7,0,1,22016,16,7246325382
5039,101886010,41543890,143429900,7,0,1,6144,16,623455136
5040,101947710,19473581,121421291,3,0,0,52736,0,10138109700
5041,101966800,19438354,121405154,9,0,0,41472,17,8654748990
5042,101970240,41459683,143429923,4,0,1,3072,4,10501277589
5043,101982410,19611284,121593694,3,0,0,20480,0,1475517402
5044,102021870,41408076,143429946,8,0,1,5632,6,809609199
5045,102021911,41479709,143501620,0,0,1,7680,6,4490279836
5046,102035021,41505705,143540726,0,0,1,15872,6,8445936453
5047,102076640,19860666,121937306,8,0,0,65536,6,8201194773
5048,102078860,19812728,121891588,9,0,0,11776,17,5475539431
5049,102089230,41451855,143541085,8,0,1,9728,6,1974227549
5050,102104760,19857650,121962410,0,0,0,53760,6,1722170404
5051,102167700,20672121,122839821,3,0,0,254464,0,8943918997
5052,102177770,20359248,122537018,9,0,0,439808,17,10072164802
5053,102218080,20370978,122589058,8,0,0,167424,6,1000070604
5054,102224520,19605805,121830325,0,0,0,18432,6,2342348145
5055,102253590,41289083,143542673,3,0,1,15872,0,10119273228
5056,102286210,41263363,143549573,4,0,1,14336,4,10655540323
5057,102290630,41262489,143553119,4,0,1,5632,4,1721958236
5058,102290930,41282576,143573506,3,0,1,26112,0,5981543505
5059,102302110,41321199,143623309,1,0,1,48640,6,4360466853
5060,102311750,20390833,122702583,8,0,0,283136,6,2938320350
5061,102324260,20414086,122738346,9,0,0,117248,17,3055557488
5062,102328470,41315130,143643600,1,0,1,17408,6,4164839199
5063,102341940,41303043,143644983,1,0,1,14848,6,9013891647
5064,102372290,20371071,122743361,9,0,0,16384,17,4422639628
5065,102377920,41305999,143683919,4,0,1,6656,4,4956707379
5066,102547130,41146491,143693621,3,0,1,40448,0,4936932778
5067,102573880,20042373,122616253,9,0,0,1024,17,96776550
5068,102578390,41137569,143715959,4,0,1,12288,4,3803286472
5069,102599390,41117235,143716625,4,0,1,1024,4,9564167379
5070,102628580,20266447,122895027,8,0,0,115712,6,6478942440
5071,102667440,41064332,143731772,3,0,1,37376,0,5662570212
5072,102702190,41038897,143741087,4,0,1,3584,4,6730703187
5073,102731410,19883480,122614890,9,0,0,84480,17,9673695599
5074,102751180,40992342,143743522,3,0,1,1536,0,2029545750
5075,102822740,40921858,143744598,3,0,1,13312,0,6341437818
5076,102900540,19958336,122858876,0,0,0,62464,6,3175154187
5077,103008700,40741640,143750340,5,0,1,3584,11,8502131906
5078,103038020,40712986,143751006,9,0,1,1024,17,1553671458
5079,103067790,20111684,123179474,3,0,0,244736,0,1399411837
5080,103109250,19837171,122946421,8,0,0,165376,6,6676506640
5081,103159650,40592124,143751774,4,0,1,11776,4,6567233272
5082,103160270,40641084,143801354,3,0,1,60416,0,216837520
5083,103164801,19038066,122202867,7,0,0,11776,16,3292149029
5084,103227210,40574605,143801815,4,0,1,10240,4,1472762447
5085,103231480,40571641,143803121,3,0,1,2048,0,10355126888
5086,103243770,40560017,143803787,3,0,1,11264,0,607442685
5087,103247190,40583138,143830328,9,0,1,32768,17,8232443044
5088,103248880,40624018,143872898,3,0,1,32768,0,439106160
5089,103265780,19758402,123024182,0,0,0,40448,6,10454026901
5090,103288360,40585844,143874204,9,0,1,2048,17,10679255981
5091,103377950,19518060,122896010,0,0,0,3072,6,2611042217
5092,103430260,40746519,144176779,9,0,1,46592,17,8423710808
5093,103453350,19871546,123324896,3,0,0,327680,0,1414167441
5094,103555461,18608519,122163980,7,0,0,26112,16,9728024396
5095,103557250,40806457,144363707,3,0,1,55808,0,1916305439
5096,103581890,40785607,144367497,6,0,1,15872,3,4295909481
5097,103589650,40826112,144415762,4,0,1,1536,4,5198752546
5098,103655880,40759905,144415785,6,0,1,31744,3,4118273053
5099,103663691,18874286,122537977,7,0,0,3072,16,7038098190
5100,103712640,40846571,144559211,3,0,1,16896,0,5771642853
5101,103763430,18603236,122366666,8,0,0,4608,6,5186329288
5102,103777200,19617482,123394682,8,0,0,26624,6,8993048834
5103,103786361,18829534,122615895,7,0,0,3072,16,379758666
5104,103915810,19729084,123644894,0,0,0,195584,6,9037495230
5105,103987080,40572154,144559234,3,0,1,8704,0,10237923065
5106,104016250,40543007,144559257,3,0,1,20480,0,8773525195
5107,104023780,40535500,144559280,6,0,1,24576,3,2993583873
5108,104132630,18908111,123040741,3,0,0,54272,0,3276517298
5109,104150930,19567289,123718219,3,0,0,196608,0,1839912753
5110,104175930,40401072,144577002,4,0,1,15360,4,6088518035
5111,104187010,19199529,123386539,3,0,0,202240,0,1234256451
5112,104224580,40357248,144581828,7,0,1,7680,16,2277696228
5113,104227030,19534718,123761748,3,0,0,91648,0,6952916998
5114,104285840,40326909,144612749,4,0,1,36864,4,519641170
5115,104317091,18863030,123180121,7,0,0,2048,16,8255921202
5116,104414120,18592938,123007058,3,0,0,21504,0,6231812000
5117,104452610,19120401,123573011,0,0,0,195072,6,10077522732
5118,104453920,40198992,144652912,4,0,1,28160,4,7555227335
5119,104487150,18700349,123187499,0,0,0,24064,6,5809265314
5120,104487910,19025642,123513552,3,0,0,148992,0,3238462573
5121,104603131,18256617,122859748,7,0,0,2560,16,8510498612
5122,104631280,40022708,144653988,4,0,1,13312,4,4907932129
5123,104648130,19356410,124004540,0,0,0,135680,6,4535357049
5124,104695700,19557342,124253042,3,0,0,297984,0,8548571008
5125,104709420,39959865,144669285,3,0,1,20992,0,1110986232
5126,104763251,19246426,124009677,7,0,0,4096,16,5280356072
5127,104774701,19718499,124493200,7,0,0,177152,16,7440657895
5128,104784300,19166335,123950635,0,0,0,308736,6,4092725520
5129,104894630,19068531,123963161,0,0,0,38400,6,9909501049
5130,104938630,39731961,144670591,4,0,1,2048,4,6113420408
5131,104978140,18607070,123585210,0,0,0,39936,6,8265923258
5132,105004220,19131202,124135422,0,0,0,4096,6,1764480284
5133,105076610,39611983,144688593,3,0,1,10240,0,8253982470
5134,105082330,39632613,144714943,4,0,1,15360,4,767788404
5135,105134860,19163969,124298829,0,0,0,52736,6,6466628535
5136,105148610,39577005,144725615,3,0,1,27136,0,5309508538
5137,105169590,19269611,124439201,3,0,0,182272,0,314543315
5138,105193900,39669428,144863328,4,0,1,22528,4,5629130976
5139,105196750,39679963,144876713,6,0,1,17408,3,3850520297
5140,105205880,39729870,144935750,3,0,1,7680,0,10544334272
5141,105208700,18910794,124119494,8,0,0,20992,6,7158489789
5142,105224680,39713976,144938656,4,0,1,4608,4,2461878026
5143,105251620,39701715,144953335,6,0,1,10240,3,7284837890
5144,105308480,39678828,144987308,2,0,1,12288,11,1618769683
5145,105337770,39652124,144989894,4,0,1,4096,4,9176274946
5146,105355680,39731457,145087137,6,0,1,1024,3,10701873751
5147,105391860,39736082,145127942,4,0,1,12288,4,9136817385
5148,105418820,39926828,145345648,6,0,1,67072,3,4065119597
5149,105477320,39868351,145345671,4,0,1,3584,4,6906919164
5150,105506720,18444718,123951438,0,0,0,2560,6,1185490805
5151,105518550,19041645,124560195,8,0,0,117760,6,3055385097
5152,105607720,19124197,124731917,0,0,0,59904,6,5266234783
5153,105643970,39701724,145345694,4,0,1,9728,4,9263641889
5154,105647090,39777534,145424624,4,0,1,31744,4,8170352225
5155,105673720,39753810,145427530,3,0,1,4608,0,10175418566
5156,105726360,18945564,124671924,8,0,0,82944,6,3800264124
5157,105769720,19044002,124813722,0,0,0,113664,6,10305136178
5158,105777640,39655655,145433295,6,0,1,4096,3,8172164403
5159,105786880,39646438,145433318,2,0,1,512,11,8753670415
5160,105818620,39706362,145524982,3,0,1,22016,0,7600857660
5161,105846070,39724167,145570237,4,0,1,73216,4,3431268825
5162,105894180,39695177,145589357,4,0,1,12288,4,8534789233
5163,105900470,39701429,145601899,3,0,1,2560,0,4280155989
5164,105950081,18892056,124842137,7,0,0,93184,16,9352081404
5165,105959990,39868353,145828343,5,0,1,89088,11,8571792336
5166,105960630,39867736,145828366,2,0,1,12288,11,9579006555
5167,105974590,39853799,145828389,4,0,1,23040,4,7896875588
5168,106050660,18210228,124260888,8,0,0,13824,6,1334481748
5169,106092880,18163773,124256653,8,0,0,11776,6,4788788525
5170,106103450,39724962,145828412,4,0,1,64000,4,5436818281
5171,106154130,18183841,124337971,8,0,0,11264,6,4574447299
5172,106161780,39674478,145836258,4,0,1,15360,4,667308848
5173,106169541,18332262,124501803,7,0,0,28160,16,8902180748
5174,106173360,39662921,145836281,6,0,1,15360,3,2745733092
5175,106199500,39636820,145836320,6,0,1,6144,3,9950932346
5176,106218350,39620983,145839333,2,0,1,16896,11,8212167115
5177,106241060,39603603,145844663,2,0,1,2560,11,7504258427
5178,106247750,39642138,145889888,2,0,1,34816,11,5727186406
5179,106314530,39577406,145891936,4,0,1,26112,4,4195605511
5180,106322160,18886414,125208574,8,0,0,86016,6,1352816863
5181,106342560,18874617,125217177,3,0,0,28160,0,7359047288
5182,106362440,18609703,124972143,8,0,0,12800,6,6841264966
5183,106384650,18865318,125249968,8,0,0,107520,6,4443230146
5184,106434620,39488564,145923184,6,0,1,13824,3,7875011019
5185,106488730,18669714,125158444,3,0,0,281088,0,2483221486
5186,106506400,39419370,145925770,3,0,1,4096,0,8898142193
5187,106563600,39367559,145931159,8,0,1,17408,6,9823614451
5188,106591510,18259097,124850607,0,0,0,27648,6,9678927434
5189,106621390,39311357,145932747,3,0,1,15872,0,10137380471
5190,106634040,18706954,125340994,3,0,0,92672,0,4958118889
5191,106647680,39330755,145978435,2,0,1,17408,11,4766278344
5192,106660070,39318388,145978458,9,0,1,1536,17,10312229068
5193,106661711,18411066,125072777,7,0,0,60416,16,8936828271
5194,106665800,18986060,125651860,8,0,0,637952,6,1414494471
5195,106667500,18514843,125182343,8,0,0,78336,6,1390701514
5196,106671230,39307251,145978481,1,0,1,1536,6,6671524586
5197,106675940,39302564,145978504,8,0,1,2560,6,2162683598
5198,106724071,18945440,125669511,7,0,0,57856,16,1174070543
5199,106738020,39240507,145978527,2,0,1,10752,11,9820359164
5200,106744560,39233990,145978550,3,0,1,8704,0,2401184338
5201,106745780,39238394,145984174,8,0,1,46592,6,7899624484
5202,106762340,39221988,145984328,3,0,1,8704,0,10145663614
5203,106768080,18679437,125447517,8,0,0,11264,6,9143725096
5204,106852790,18406101,125258891,3,0,0,29184,0,8949574577
5205,106877870,39115387,145993257,8,0,1,8192,6,821152913
5206,106889851,18782803,125672654,7,0,0,10240,16,9684931884
5207,106905100,39099025,146004125,3,0,1,12288,0,4207857846
5208,106974500,39040962,146015462,1,0,1,22528,6,295733739
5209,107051960,38971978,146023938,2,0,1,9216,11,7181763860
5210,107053430,39480261,146533691,8,0,1,43008,6,10109443262
5211,107091410,39505000,146596410,3,0,1,6656,0,751013265
5212,107097480,18660394,125757874,3,0,0,134144,0,968941608
5213,107115340,39481093,146596433,8,0,1,14336,6,10578778218
5214,107204540,39444519,146649059,6,0,1,4096,3,3669925559
5215,107205190,18508716,125713906,3,0,0,60416,0,1819365330
5216,107220841,39448564,146669405,0,0,1,18432,6,1171886122
5217,107221210,18797088,126018298,8,0,0,200192,6,9881980950
5218,107221730,18811590,126033320,0,0,0,37376,6,7714909214
5219,107225681,18796228,126021909,7,0,0,11776,16,2647864828
5220,107246200,18426945,125673145,3,0,0,1536,0,2260585924
5221,107256040,39446524,146702564,3,0,1,6656,0,7471768563
5222,107265551,18617754,125883305,7,0,0,112128,16,6070057437
5223,107291650,39411260,146702910,3,0,1,512,0,2451648941
5224,107298020,18858403,126156423,0,0,0,167936,6,7818878077
5225,107299191,18806041,126105232,7,0,0,126464,16,1333864486
5226,107316131,18895071,126211202,7,0,0,179712,16,2356601234
5227,107327890,39937688,147265578,6,0,1,90624,3,9147186949
5228,107360720,39924591,147285311,6,0,1,1536,3,2893592543
5229,107376950,18965119,126342069,0,0,0,89600,6,3575740011
5230,107382320,39913980,147296300,6,0,1,17920,3,4768811152
5231,107384180,18930566,126314746,0,0,0,101376,6,7343385404
5232,107388070,18848196,126236266,0,0,0,5120,6,2367737025
5233,107470240,18957003,126427243,0,0,0,91648,6,8550931632
5234,107471170,39904337,147375507,6,0,1,62976,3,9003024446
5235,107472780,19066011,126538791,0,0,0,80384,6,397235208
5236,107475680,39937524,147413204,3,0,1,17408,0,10383231541
5237,107487380,19102396,126589776,3,0,0,149504,0,5216255078
5238,107488080,39971034,147459114,3,0,1,57344,0,928167080
5239,107508300,19214218,126722518,2,0,0,125952,11,4293069092
5240,107542620,39948060,147490680,6,0,1,1024,3,951133603
5241,107549570,39951920,147501490,1,0,1,25088,6,1315136866
5242,107556440,39945073,147501513,5,0,1,6656,11,1724057792
5243,107603460,39934603,147538063,6,0,1,7168,3,3241748732
5244,107635050,19324031,126959081,3,0,0,253952,0,5878101598
5245,107640010,39898076,147538086,6,0,1,45056,3,452453957
5246,107653750,39884367,147538117,1,0,1,3584,6,1274282469
5247,107682601,19199058,126881659,7,0,0,14848,16,7059115375
5248,107728540,39809600,147538140,1,0,1,63488,6,9894684759
5249,107753421,19452820,127206241,7,0,0,112128,16,2024401786
5250,107763530,39788883,147552413,6,0,1,11264,3,2485066054
5251,107777690,39774778,147552468,6,0,1,38400,3,6240924442
5252,107820520,39757289,147577809,8,0,1,10240,6,6271254758
5253,107839840,39738016,147577856,1,0,1,40960,6,2577131824
5254,107859890,39718005,147577895,6,0,1,24576,3,8531418376
5255,107874960,19614597,127489557,8,0,0,393216,6,7075898677
5256,107881760,19137657,127019417,3,0,0,1536,0,8178114641
5257,107901340,39747535,147648875,8,0,1,10752,6,5657517063
5258,107906070,19599046,127505116,8,0,0,28672,6,6171932633
5259,107913210,19668977,127582187,0,0,0,91136,6,463052418
5260,108004931,19289008,127293939,7,0,0,44032,16,480561377
5261,108016770,39890160,147906930,1,0,1,22016,6,4303434368
5262,108059170,39848746,147907916,1,0,1,1536,6,6475266295
5263,108068980,39839922,147908902,8,0,1,1536,6,7919569497
5264,108073740,19422571,127496311,0,0,0,20992,6,2920364700
5265,108145120,39764768,147909888,6,0,1,1536,3,2749756095
5266,108156870,19333022,127489892,3,0,0,1024,0,10672016727
5267,108177090,39735704,147912794,1,0,1,4608,6,4918234255
5268,108188900,39787180,147976080,4,0,1,24576,4,936682150
5269,108214340,19792374,128006714,3,0,0,2048,0,10405719976
5270,108215760,39929175,148144935,8,0,1,71168,6,10388121047
5271,108233630,39952309,148185939,8,0,1,14336,6,9485677112
5272,108279070,20105228,128384298,8,0,0,130048,6,1239520270
5273,108348970,39949382,148298352,1,0,1,9216,6,452578690
5274,108356741,19889925,128246666,7,0,0,86528,16,8880294868
5275,108378641,20297260,128675901,7,0,0,89600,16,1335195878
5276,108452850,19249053,127701903,8,0,0,7680,6,790810057
5277,108473790,39824593,148298383,1,0,1,51200,6,82408640
5278,108566131,19593313,128159444,7,0,0,33280,16,7582675845
5279,108626011,19256905,127882916,7,0,0,10240,16,206343339
5280,108628091,20268602,128896693,7,0,0,65536,16,1931971683
5281,108666451,19956974,128623425,7,0,0,141824,16,8483284837
5282,108675580,39622826,148298406,5,0,1,512,11,9537305007
5283,108734191,19539854,128274045,7,0,0,71168,16,8106353429
5284,108774500,39523929,148298429,8,0,1,6656,6,10149311095
5285,108815391,39515064,148330455,0,0,1,5120,6,8264003159
5286,108966951,39383885,148350836,0,0,1,26112,6,2322829929
5287,108992820,39358039,148350859,1,0,1,2048,6,6904314861
5288,109020361,19454522,128474883,7,0,0,179712,16,4800202900
5289,109172180,19614174,128786354,8,0,0,26624,6,9955503449
5290,109259310,19494458,128753768,0,0,0,255488,6,8083520989
5291,109263520,19969313,129232833,8,0,0,18432,6,3871749228
5292,109273101,39077781,148350882,0,0,1,1024,6,4148574528
5293,109274121,19500106,128774227,7,0,0,67072,16,9886647544
5294,109276630,39074275,148350905,8,0,1,3584,6,8007665533
5295,109313551,18607345,127920896,7,0,0,79360,16,1407211909
5296,109318930,39060257,148379187,3,0,1,4608,0,1666107293
5297,109323740,39055494,148379234,1,0,1,46080,6,2321655551
5298,109402330,39012986,148415316,3,0,1,2048,0,4926952748
5299,109457851,38957488,148415339,0,0,1,8192,6,1670427755
5300,109472601,38942769,148415370,0,0,1,6144,6,5099471909
5301,109527290,19699904,129227194,0,0,0,53248,6,9058680025
5302,109556030,19584246,129140276,0,0,0,296448,6,700615351
5303,109559380,38867892,148427272,4,0,1,25088,4,7646180382
5304,109621081,19404793,129025874,7,0,0,126464,16,9749047085
5305,109646760,38787830,148434590,4,0,1,37888,4,579781408
5306,109650530,38793366,148443896,4,0,1,28160,4,858233032
5307,109652460,38905740,148558200,4,0,1,18944,4,9703242522
5308,109694100,38866366,148560466,3,0,1,3584,0,6917713488
5309,109762490,38864660,148627150,4,0,1,38400,4,7355447479
5310,109787920,18600908,128388828,0,0,0,7680,6,2656125662
5311,109812650,38897169,148709819,4,0,1,24064,4,5794135072
5312,109818441,38957392,148775833,0,0,1,25600,6,3927567599
5313,109828400,38956129,148784529,4,0,1,18944,4,4761279365
5314,109833831,19739635,129573466,7,0,0,345600,16,8750948455
5315,109866551,19439153,129305704,7,0,0,17408,16,4720813800
5316,109957420,39035701,148993121,4,0,1,40960,4,5118515555
5317,109960590,39032554,148993144,3,0,1,9216,0,9184390004
5318,110063670,38929497,148993167,3,0,1,19456,0,8221909630
5319,110129140,38915862,149045002,3,0,1,25088,0,10032441973
5320,110130850,19748667,129879517,0,0,0,241664,6,6728126094
5321,110178440,18599733,128778173,0,0,0,12800,6,6445435735
5322,110204080,38861663,149065743,3,0,1,1024,0,5709332410
5323,110280580,38786789,149067369,3,0,1,2560,0,7558679810
5324,110298610,18878357,129176967,8,0,0,120320,6,9884859287
5325,110371100,18873060,129244160,8,0,0,13824,6,9264111377
5326,110522490,18354212,128876702,8,0,0,86016,6,5765445572
5327,110587331,19120202,129707533,7,0,0,102400,16,9943125070
5328,110597420,19614210,130211630,8,0,0,57856,6,5070992074
5329,110780320,19214283,129994603,0,0,0,13312,6,6510643150
5330,110824710,18225211,129049921,0,0,0,78848,6,2416836488
5331,110919470,18673831,129593301,0,0,0,65024,6,5327553938
5332,110975411,17929159,128904570,7,0,0,25600,16,1146048961
5333,111110060,18866635,129976695,2,0,0,176640,11,7590864459
5334,111128510,19392198,130520708,8,0,0,516608,6,2759227625
5335,111130310,18975427,130105737,8,0,0,9216,6,4557415828
5336,111175230,18501080,129676310,2,0,0,83968,11,10358949105
5337,111293690,18309306,129602996,0,0,0,31744,6,646614047
5338,111300330,18978163,130278493,2,0,0,78848,11,1885792136
5339,111335530,37769005,149104535,6,0,1,6144,3,5876027933
5340,111363410,37773610,149137020,6,0,1,4608,3,4213721475
5341,111377630,17818126,129195756,8,0,0,61440,6,5736607825
5342,111378550,37758493,149137043,6,0,1,11776,3,1647293237
5343,111384680,37752386,149137066,3,0,1,512,0,9475428562
5344,111421060,37716029,149137089,3,0,1,1536,0,6602400857
5345,111452330,37778001,149230331,3,0,1,46080,0,5822678763
5346,111463780,19494030,130957810,8,0,0,169472,6,3005237452
5347,111500850,19511998,131012848,0,0,0,107008,6,7809346450
5348,111530290,37705187,149235477,3,0,1,8192,0,4378952043
5349,111558550,37779505,149338055,6,0,1,25088,3,6750050123
5350,111560090,19981473,131541563,2,0,0,209408,11,5497360781
5351,111574221,18515759,130089980,7,0,0,37888,16,9718409701
5352,111583000,20190578,131773578,8,0,0,535040,6,8483425149
5353,111608050,19607112,131215162,8,0,0,301056,6,3396707824
5354,111625310,37713571,149338881,3,0,1,26112,0,1724915681
5355,111694080,19698424,131392504,0,0,0,246784,6,2163645474
5356,111882330,18679585,130561915,0,0,0,135168,6,2124059316
5357,111966370,37418802,149385172,3,0,1,22528,0,3991662839
5358,111986290,18713295,130699585,2,0,0,15872,11,9862261709
5359,112040400,18580685,130621085,0,0,0,194048,6,7067104353
5360,112042540,19756512,131799052,2,0,0,83456,11,7582112749
5361,112075170,18066646,130141816,9,0,0,64512,17,7941917074
5362,112105940,37280218,149386158,6,0,1,1536,3,4169238781
5363,112108940,37280444,149389384,3,0,1,5120,0,7113246471
5364,112116731,37333665,149450396,0,0,1,31232,6,6591575422
5365,112125840,37343166,149469006,3,0,1,33792,0,194837670
5366,112126500,37386731,149513231,9,0,1,36352,17,10374421378
5367,112144251,37369003,149513254,0,0,1,5120,6,2826416831
5368,112154410,37358867,149513277,1,0,1,2560,6,4625173880
5369,112204411,18419316,130623727,7,0,0,8192,16,309436745
5370,112276110,37237190,149513300,3,0,1,3584,0,1847173368
5371,112316430,19605133,131921563,2,0,0,113152,11,7415603083
5372,112341490,37176174,149517664,1,0,1,16384,6,3852048065
5373,112347430,37174740,149522170,3,0,1,7168,0,8174407021
5374,112350440,19505816,131856256,8,0,0,107008,6,6395702222
5375,112367380,37160282,149527662,3,0,1,8704,0,9543529811
5376,112381740,37226111,149607851,5,0,1,16896,11,5022622499
5377,112415371,37192503,149607874,0,0,1,17920,6,2958898369
5378,112522270,37156045,149678315,9,0,1,7680,17,909058048
5379,112530880,18742076,131272956,2,0,0,11776,11,8608991494
5380,112538000,19436487,131974487,8,0,0,46592,6,6988098487
5381,112601730,37076608,149678338,9,0,1,11776,17,4666600299
5382,112647530,37030831,149678361,1,0,1,3072,6,3353353673
5383,112662280,37016104,149678384,3,0,1,1024,0,9513183012
5384,112669051,18025675,130694726,7,0,0,123392,16,9855144478
5385,112683931,36994476,149678407,0,0,1,512,6,7305224630
5386,112760551,18321639,131082190,7,0,0,66560,16,6694949484
5387,112781600,18663857,131445457,8,0,0,110080,6,857623206
5388,112831521,19381776,132213297,7,0,0,62464,16,2488867242
5389,112898070,36780360,149678430,9,0,1,26112,17,2421208157
5390,112900530,36777923,149678453,1,0,1,1536,6,5096292023
5391,112924040,36754436,149678476,9,0,1,8192,17,1260159682
5392,112930460,36753742,149684202,9,0,1,29184,17,7993148800
5393,112979100,19149147,132128247,0,0,0,177664,6,10173355155
5394,112991130,18263966,131255096,0,0,0,17920,6,7494806957
5395,113040840,36682295,149723135,3,0,1,512,0,5020543078
5396,113070790,17803979,130874769,8,0,0,2048,6,9697395232
5397,113115860,18128653,131244513,0,0,0,96256,6,8861566403
5398,113152921,36643028,149795949,0,0,1,15872,6,1492431556
5399,113168110,18845672,132013782,0,0,0,87552,6,2392173879
5400,113207501,18379949,131587450,7,0,0,150528,16,1168014846
5401,113209400,36586572,149795972,3,0,1,3072,0,1063342438
5402,113260350,36535645,149795995,9,0,1,9728,17,2777896991
5403,113262790,37499106,150761896,9,0,1,16384,17,3229502571
5404,113264980,37504416,150769396,3,0,1,8192,0,5529107563
5405,113280741,37488686,150769427,0,0,1,1024,6,6757205736
5406,113305030,37464420,150769450,2,0,1,1024,11,40687957
5407,113346780,37625865,150972645,9,0,1,36352,17,6167612299
5408,113349420,38044880,151394300,1,0,1,82432,6,5435834052
5409,113389080,38005886,151394966,1,0,1,11264,6,279569640
5410,113434490,18865264,132299754,0,0,0,75776,6,1071473746
5411,113452200,19131338,132583538,0,0,0,423936,6,9611869675
5412,113497390,37933585,151430975,3,0,1,2048,0,8137803205
5413,113533900,37897098,151430998,1,0,1,13824,6,6898951834
5414,113536430,37912808,151449238,1,0,1,8192,6,13771031
5415,113587420,37863124,151450544,4,0,1,2048,4,7224235368
5416,113602720,37848080,151450800,2,0,1,9216,11,921388751
5417,113615790,37877947,151493737,1,0,1,26624,6,1837047565
5418,113631091,17780803,131411894,7,0,0,63488,16,4921237371
5419,113676950,17926131,131603081,8,0,0,51200,6,7516065173
5420,113702500,38131592,151834092,2,0,1,46592,11,8976690167
5421,113705430,38128685,151834115,3,0,1,24064,0,4520622934
5422,113742830,18939066,132681896,8,0,0,165888,6,8880373787
5423,113768440,38065698,151834138,2,0,1,9216,11,9918935740
5424,113848280,37985881,151834161,1,0,1,14336,6,7676920807
5425,113867700,38056433,151924133,3,0,1,55808,0,6590917758
5426,113879330,38044826,151924156,3,0,1,14336,0,6749731395
5427,113891300,38116861,152008161,4,0,1,48640,4,9190317590
5428,113910090,17907549,131817639,8,0,0,60928,6,2719944993
5429,113933710,38111313,152045023,2,0,1,13824,11,5044617339
5430,113939450,17884163,131823613,8,0,0,6144,6,2742836667
5431,113958160,38086886,152045046,1,0,1,13312,6,3710188438
5432,113960940,38084129,152045069,9,0,1,36352,17,2176873262
5433,113969610,38075482,152045092,3,0,1,4096,0,1741686448
5434,113970761,17906989,131877750,7,0,0,36352,16,7870912282
5435,113980991,17840727,131821718,7,0,0,13312,16,9566704230
5436,114021921,18764633,132786554,7,0,0,104960,16,10292147473
5437,114061690,37983441,152045131,2,0,1,18432,11,2442150779
5438,114131200,38046421,152177621,1,0,1,11264,6,3597816038
5439,114224530,38005108,152229638,1,0,1,28160,6,1875257134
5440,114234390,37995279,152229669,3,0,1,3072,0,867452984
5441,114252580,37991042,152243622,3,0,1,57344,0,3350584004
5442,114271640,37972005,152243645,2,0,1,8704,11,5014841724
5443,114299200,17686562,131985762,0,0,0,10240,6,3858801323
5444,114330720,37912948,152243668,3,0,1,2048,0,8438812057
5445,114347371,18618795,132966166,7,0,0,86016,16,1223997602
5446,114349820,17689989,132039809,0,0,0,20992,6,5246537777
5447,114374760,18072150,132446910,8,0,0,314880,6,9921604052
5448,114380770,37908987,152289757,1,0,1,20480,6,2693193399
5449,114382800,37907479,152290279,3,0,1,3584,0,1167837650
5450,114385360,37993255,152378615,3,0,1,16896,0,7096874306
5451,114396330,38793233,153189563,1,0,1,48640,6,5918865904
5452,114419530,38773485,153193015,4,0,1,4608,4,4534678522
5453,114434660,38764167,153198827,1,0,1,9216,6,7242869720
5454,114450870,38838770,153289640,3,0,1,25088,0,6586622287
5455,114487981,18123972,132611953,7,0,0,93184,16,10031311532
5456,114493600,38796296,153289896,2,0,1,9216,11,6757478433
5457,114500050,38984549,153484599,9,0,1,45056,17,9072602365
5458,114510861,18595007,133105868,7,0,0,41984,16,3459885550
5459,114517860,39013193,153531053,2,0,1,38400,11,1815193162
5460,114570240,38980553,153550793,9,0,1,10752,17,10441315738
5461,114576880,38983534,153560414,2,0,1,3072,11,8243056834
5462,114599650,38961635,153561285,4,0,1,12288,4,4453694885
5463,114620470,38946673,153567143,1,0,1,3584,6,10263934582
5464,114632821,18457076,133089897,7,0,0,406016,16,5898559399
5465,114652510,38915619,153568129,2,0,1,1536,11,2412617608
5466,114667620,18075770,132743390,8,0,0,169984,6,4155036823
5467,114681280,38914729,153596009,9,0,1,27136,17,8427303828
5468,114686180,38946223,153632403,7,0,1,10240,16,10638647017
5469,114728720,38981581,153710301,7,0,1,29184,16,8597682922
5470,114747740,39184100,153931840,9,0,1,71168,17,5010984479
5471,114853940,39077923,153931863,9,0,1,1024,17,908388916
5472,114855300,39076586,153931886,5,0,1,14336,11,10736374562
5473,114863150,39070670,153933820,7,0,1,3584,16,6655845600
5474,114869730,18272603,133142333,0,0,0,119296,6,634959330
5475,114880120,18212764,133092884,0,0,0,9728,6,8817063584
5476,114918550,39016549,153935099,3,0,1,2048,0,439061998
5477,114983870,38952100,153935970,1,0,1,12288,6,3743984251
5478,114991270,18164822,133156092,8,0,0,32256,6,6876533969
5479,115002940,39019689,154022629,7,0,1,27136,16,4974027734
5480,115022830,39004828,154027658,5,0,1,8192,11,6736344986
5481,115047170,38983113,154030283,2,0,1,3584,11,5542401605
5482,115054130,39045241,154099371,1,0,1,6656,6,3813354125
5483,115140900,39210815,154351715,7,0,1,14848,16,3155207750
5484,115148600,39205228,154353828,7,0,1,32768,16,5403609434
5485,115148900,39205910,154354810,1,0,1,28160,6,7613751861
5486,115184350,39170483,154354833,5,0,1,14848,11,3204212665
5487,115204170,39150686,154354856,4,0,1,2560,4,311212803
5488,115213990,18315568,133529558,8,0,0,16896,6,5534963360
5489,115223950,39130929,154354879,2,0,1,3072,11,4747095810
5490,115325090,39032175,154357265,2,0,1,20992,11,5425748848
5491,115329430,18165696,133495126,0,0,0,95232,6,7983596429
5492,115331480,17945157,133276637,2,0,0,32256,11,4522578272
5493,115347070,39061721,154408791,2,0,1,3584,11,7548018589
5494,115347870,18043162,133391032,8,0,0,141824,6,4603193165
5495,115349480,39059334,154408814,4,0,1,11776,4,2371538842
5496,115370510,39050876,154421386,2,0,1,55808,11,2518094231
5497,115392430,39028979,154421409,3,0,1,2560,0,3333473973
5498,115400950,18176190,133577140,2,0,0,20480,11,715507978
5499,115427990,18319413,133747403,0,0,0,174080,6,6468129008
5500,115436601,18342181,133778782,7,0,0,102912,16,764942446
5501,115478250,39039636,154517886,7,0,1,51200,16,218482655
5502,115498920,39018989,154517909,2,0,1,12800,11,10247593236
5503,115518711,18490101,134008812,7,0,0,75776,16,10723288802
5504,115524390,39027029,154551419,1,0,1,37376,6,3535307506
5505,115537250,18410007,133947257,2,0,0,178176,11,8565669878
5506,115544080,39043788,154587868,3,0,1,28672,0,9734133232
5507,115607940,38979959,154587899,5,0,1,17408,11,884490535
5508,115616060,38990472,154606532,7,0,1,36864,16,10006895507
5509,115640500,39001178,154641678,5,0,1,36352,11,1526856361
5510,115691860,38949873,154641733,3,0,1,19456,0,2851011946
5511,115692930,38948826,154641756,2,0,1,32768,11,1895309850
5512,115697480,38998615,154696095,7,0,1,4096,16,4430993351
5513,115746940,18494083,134241023,2,0,0,73728,11,4636019520
5514,115747480,18651047,134398527,8,0,0,48640,6,8028903115
5515,115757050,38939076,154696126,5,0,1,6144,11,818641002
5516,115821230,38914805,154736035,5,0,1,28672,11,8625325682
5517,115862180,18597378,134459558,2,0,0,3584,11,9452659917
5518,115864231,18707628,134571859,7,0,0,116736,16,3410178280
5519,115896771,18988308,134885079,7,0,0,253440,16,5014039843
5520,115912610,38825051,154737661,5,0,1,2560,11,6396355298
5521,115952160,18825033,134777193,0,0,0,33280,6,8442815649
5522,115969890,38872473,154842363,4,0,1,53760,4,5194600191
5523,115971580,38991274,154962854,4,0,1,38912,4,3854293218
5524,116021510,19093269,135114779,2,0,0,22528,11,9929702822
5525,116028840,19070906,135099746,0,0,0,126976,6,6260833401
5526,116072810,18719779,134792589,8,0,0,8192,6,9652761713
5527,116081140,38882175,154963315,5,0,1,10240,11,6861112668
5528,116082340,39143189,155225529,3,0,1,16896,0,4567398289
5529,116128540,39168959,155297499,4,0,1,32768,4,9585121052
5530,116190830,19078741,135269571,8,0,0,252416,6,2184175807
5531,116196690,19300525,135497215,2,0,0,121856,11,4688754352
5532,116201850,19076636,135278486,8,0,0,29184,6,7203166582
5533,116203050,18989443,135192493,2,0,0,63488,11,1683485597
5534,116218890,39078632,155297522,3,0,1,10752,0,6636952942
5535,116224220,39073325,155297545,3,0,1,2048,0,5071901901
5536,116240850,39056718,155297568,5,0,1,2560,11,9878499856
5537,116250790,19577389,135828179,2,0,0,86016,11,4361842524
5538,116260610,39039833,155300443,3,0,1,10752,0,9284970920
5539,116285790,19440570,135726360,8,0,0,148992,6,8554903085
5540,116309510,38992879,155302389,3,0,1,3072,0,8528751238
5541,116370780,39018388,155389168,3,0,1,3072,0,7124480798
5542,116400010,38989181,155389191,3,0,1,21504,0,8814460235
5543,116409630,19392318,135801948,0,0,0,28160,6,2334824113
5544,116418800,38970414,155389214,4,0,1,10752,4,5218282205
5545,116469841,19107866,135577707,7,0,0,91648,16,1402207231
5546,116518340,38917408,155435748,3,0,1,4096,0,7931373909
5547,116526450,18927982,135454432,8,0,0,25088,6,3045469123
5548,116552971,19056725,135609696,7,0,0,40448,16,6424401077
5549,116557490,38878281,155435771,9,0,1,2048,17,2755899532
5550,116568400,38867394,155435794,3,0,1,6656,0,1924600402
5551,116618110,38817707,155435817,3,0,1,6656,0,3199406417
5552,116676640,38759200,155435840,3,0,1,4096,0,3072663279
5553,116682500,19051417,135733917,2,0,0,24576,11,3246821210
5554,116683221,19193980,135877201,7,0,0,4608,16,822612390
5555,116710391,19602603,136312994,7,0,0,89600,16,488161771
5556,116712180,19395764,136107944,0,0,0,313344,6,2200242448
5557,116716070,38800959,155517029,3,0,1,31232,0,3667143083
5558,116821430,38695654,155517084,3,0,1,5120,0,7215294748
5559,116899580,19463558,136363138,2,0,0,126976,11,9418518119
5560,116968000,19448357,136416357,2,0,0,174592,11,6729151342
5561,116984400,19489439,136473839,2,0,0,79872,11,9036355996
5562,116989231,19569374,136558605,7,0,0,129536,16,8277795558
5563,117017811,19252488,136270299,7,0,0,48640,16,7105212192
5564,117019920,19728291,136748211,2,0,0,201216,11,1171785169
5565,117030200,19488613,136518813,8,0,0,99328,6,439913720
5566,117039310,19753754,136793064,8,0,0,48640,6,2528186153
5567,117040020,19727558,136767578,2,0,0,63488,11,3680465859
5568,117061220,19427306,136488526,2,0,0,48128,11,2560338274
5569,117063860,38453247,155517107,3,0,1,10240,0,9530819539
5570,117076520,19340484,136417004,8,0,0,2048,6,3994759823
5571,117104710,19669755,136774465,8,0,0,22528,6,8600755500
5572,117124600,19795034,136919634,0,0,0,74752,6,8466254077
5573,117157610,19480300,136637910,2,0,0,35840,11,3600249168
5574,117266240,19838611,137104851,0,0,0,199680,6,2810466151
5575,117326720,19644417,136971137,0,0,0,168960,6,3158088805
5576,117386350,20000479,137386829,0,0,0,280576,6,9969768386
5577,117427301,38089829,155517130,0,0,1,18432,6,7602678442
5578,117497710,38019443,155517153,3,0,1,5120,0,7356665980
5579,117551660,37965556,155517216,3,0,1,1536,0,8211147642
5580,117671751,19183926,136855677,7,0,0,3072,16,5005280488
5581,117704940,37812299,155517239,3,0,1,7168,0,2452821662
5582,117786600,19334810,137121410,0,0,0,54272,6,4599088342
5583,117808150,19897328,137705478,2,0,0,329216,11,5141432746
5584,117951090,37566172,155517262,3,0,1,8192,0,2073310913
5585,118055410,19742137,137797547,8,0,0,37888,6,7449331463
5586,118059150,19680827,137739977,0,0,0,113152,6,2779469990
5587,118101671,19157141,137258812,7,0,0,5120,16,3796468064
5588,118161800,37355485,155517285,3,0,1,4096,0,7733795207
5589,118182760,37334548,155517308,4,0,1,5120,4,8993815031
5590,118242391,19594765,137837156,7,0,0,124416,16,7330863832
5591,118327221,19594221,137921442,7,0,0,276480,16,3910245696
5592,118372610,37144721,155517331,1,0,1,27136,6,2284522706
5593,118438811,19596437,138035248,7,0,0,210944,16,1627417456
5594,118539280,37056719,155595999,1,0,1,35840,6,1273602524
5595,118609630,18691688,137301318,0,0,0,33792,6,1944619872
5596,118773140,36822922,155596062,3,0,1,19456,0,7282203006
5597,118774010,36822075,155596085,3,0,1,3584,0,10644656225
5598,118810871,19134946,137945817,7,0,0,79872,16,7923548002
5599,118849640,36774744,155624384,5,0,1,58368,11,6069326001
5600,118850801,19536275,138387076,7,0,0,197120,16,2950462541
5601,118918640,19245699,138164339,8,0,0,239104,6,3354610634
5602,118968440,36655967,155624407,1,0,1,5632,6,6718030246
5603,119025190,36599240,155624430,1,0,1,7168,6,1587015885
5604,119029470,36594983,155624453,1,0,1,6144,6,5278020329
5605,119049460,36575016,155624476,3,0,1,1536,0,7934834732
5606,119074391,18970933,138045324,7,0,0,32768,16,5496551078
5607,119094510,36546547,155641057,3,0,1,27136,0,3757226019
5608,119164860,36488112,155652972,1,0,1,30208,6,2008681622
5609,119287570,36366120,155653690,3,0,1,19456,0,2116972558
5610,119326230,36328446,155654676,3,0,1,1536,0,6151135609
5611,119363820,18873070,138236890,2,0,0,48128,11,8429419247
5612,119382340,36324440,155706780,5,0,1,56320,11,4825346784
5613,119384780,36355451,155740231,3,0,1,81920,0,10730332151
5614,119434460,18836305,138270765,2,0,0,111104,11,9558254865
5615,119435031,19125232,138560263,7,0,0,143360,16,10708362273
5616,119439421,19365938,138805359,7,0,0,233472,16,8766686981
5617,119466510,19173792,138640302,0,0,0,15360,6,9211835169
5618,119469550,36290634,155760184,1,0,1,42496,6,8195341242
5619,119501390,18895849,138397239,2,0,0,33280,11,6704742726
5620,119501420,36258787,155760207,3,0,1,3584,0,6104250236
5621,119505290,36272825,155778115,4,0,1,28672,4,2021998817
5622,119548620,19284842,138833462,0,0,0,92160,6,3662028587
5623,119562860,19357705,138920565,2,0,0,22528,11,5214961002
5624,119594310,19002819,138597129,8,0,0,111104,6,1904940537
5625,119600130,36290656,155890786,1,0,1,76288,6,244944411
5626,119641820,19463382,139105202,8,0,0,77312,6,9402727168
5627,119644120,36249892,155894012,3,0,1,5120,0,1721986121
5628,119647490,36248788,155896278,5,0,1,3584,11,8239433692
5629,119670531,19206174,138876705,7,0,0,141824,16,10397664549
5630,119671040,36238782,155909822,3,0,1,35328,0,10377947889
5631,119688700,36249606,155938306,5,0,1,13312,11,1432330473
5632,119691581,19605557,139297138,7,0,0,190976,16,8639962775
5633,119694150,19679791,139373941,2,0,0,118272,11,5318936793
5634,119720940,36217712,155938652,1,0,1,512,6,6163278496
5635,119731270,36279289,156010559,3,0,1,6144,0,2240784255
5636,119740870,19684434,139425304,2,0,0,114688,11,6549584950
5637,119769740,36240842,156010582,3,0,1,1024,0,10522188041
5638,119774010,36236595,156010605,5,0,1,11776,11,5998689787
5639,119785120,19702290,139487410,8,0,0,85504,6,8962664859
5640,119879900,36131063,156010963,5,0,1,15872,11,2904128740
5641,119894601,19715323,139609924,7,0,0,98304,16,2123134359
5642,119917840,36093146,156010986,5,0,1,10752,11,3964131481
5643,119919270,36091747,156011017,1,0,1,11264,6,811786257
5644,119922370,36088670,156011040,7,0,1,13312,16,1993534633
5645,120034510,35976553,156011063,8,0,1,4608,6,4794931657
5646,120084400,35932759,156017159,1,0,1,23040,6,8378076007
5647,120146111,19534701,139680812,7,0,0,108032,16,541527957
5648,120192910,35852877,156045787,1,0,1,9216,6,8625276475
5649,120215610,35842025,156057635,8,0,1,16896,6,7436000484
5650,120222440,35843720,156066160,3,0,1,29184,0,5603266529
5651,120234130,35883321,156117451,7,0,1,59904,16,1073352684
5652,120263480,35856237,156119717,3,0,1,3584,0,5587155303
5653,120276680,35843805,156120485,1,0,1,11776,6,8048815997
5654,120277120,35847231,156124351,2,0,1,6144,11,10375771175
5655,120282440,35924031,156206471,1,0,1,86016,6,9648551327
5656,120340270,35867481,156207751,7,0,1,14336,16,9995189427
5657,120352280,35890716,156242996,7,0,1,6656,16,2303572822
5658,120390000,35862399,156252399,5,0,1,8192,11,360089747
5659,120390770,19421732,139812502,8,0,0,43008,6,3059602314
5660,120396220,35864591,156260811,5,0,1,20480,11,147565234
5661,120411980,35852790,156264770,5,0,1,23040,11,4367571076
5662,120413850,35859464,156273314,8,0,1,15360,6,6892690877
5663,120418830,35862343,156281173,5,0,1,13312,11,7053595841
5664,120465620,35826888,156292508,5,0,1,3072,11,131670015
5665,120469421,19576372,140045793,7,0,0,115712,16,1968756592
5666,120489730,35803124,156292854,3,0,1,512,0,5628866419
5667,120592650,35700358,156293008,1,0,1,8704,6,4549648155
5668,120594970,19705304,140300274,8,0,0,16896,6,5769852918
5669,120624450,35670184,156294634,7,0,1,2560,16,4947022980
5670,120624670,35729211,156353881,7,0,1,59392,16,9527153801
5671,120652621,19404251,140056872,7,0,0,13824,16,5659864957
5672,120659760,35694144,156353904,3,0,1,18944,0,4240355075
5673,120661980,35691947,156353927,5,0,1,28672,11,9858159145
5674,120667330,19800304,140467634,2,0,0,169472,11,6836546562
5675,120667360,35705242,156372602,3,0,1,26624,0,7834179320
5676,120680520,35767750,156448270,3,0,1,23552,0,9724862943
5677,120684630,35869133,156553763,7,0,1,49152,16,4405812168
5678,120697570,19566545,140264115,0,0,0,142336,6,8375758206
5679,120704100,19572830,140276930,8,0,0,41984,6,5853519082
5680,120727900,35828717,156556617,9,0,1,38400,17,537263184
5681,120769700,35786940,156556640,8,0,1,1024,6,9519567354
5682,120791280,19570038,140361318,2,0,0,57344,11,10030328691
5683,120800900,35774797,156575697,9,0,1,5120,17,10088373938
5684,120817170,35787518,156604688,9,0,1,52224,17,4979567202
5685,120826540,19544693,140371233,2,0,0,18944,11,4454518062
5686,120827520,19644129,140471649,2,0,0,12800,11,939628916
5687,120842450,35766744,156609194,9,0,1,7168,17,1415300721
5688,120853901,19832965,140686866,7,0,0,146944,16,10221908579
5689,120863830,35764194,156628024,1,0,1,13824,6,7569308773
5690,120875150,35752897,156628047,3,0,1,5632,0,1496276253
5691,120876230,35755493,156631723,9,0,1,18944,17,10608076373
5692,120924360,35722457,156646817,3,0,1,10240,0,7652132053
5693,120925750,35723013,156648763,9,0,1,3072,17,569980209
5694,120939060,35713889,156652949,7,0,1,6656,16,8217113688
5695,120967640,35743392,156711032,5,0,1,30720,11,5863012197
5696,120978300,35748596,156726896,9,0,1,5120,17,4428927433
5697,120989281,19977112,140966393,7,0,0,136192,16,2049612127
5698,121002131,20149824,141151955,7,0,0,33280,16,7235462055
5699,121080331,20225914,141306245,7,0,0,232448,16,5103999765
5700,121090990,35641756,156732746,3,0,1,27648,0,6372155033
5701,121101960,35631961,156733921,7,0,1,10752,16,1149437915
5702,121162040,35576879,156738919,3,0,1,7680,0,2590050446
5703,121176270,19959881,141136151,8,0,0,129024,6,9240987068
5704,121176850,35573529,156750379,7,0,1,16896,16,509844405
5705,121244340,35517875,156762215,5,0,1,5632,11,2119258786
5706,121249520,20709210,141958730,8,0,0,226304,6,4154612338
5707,121297650,35465641,156763291,7,0,1,13312,16,1877823716
5708,121302001,19886731,141188732,7,0,0,15872,16,7513450379
5709,121337740,20300955,141638695,0,0,0,174080,6,4329252172
5710,121426260,35338017,156764277,9,0,1,1536,17,5587074638
5711,121472701,20399237,141871938,7,0,0,765440,16,5028530884
5712,121499690,19812350,141312040,2,0,0,18944,11,6178525691
5713,121506910,35257931,156764841,3,0,1,10752,0,9036612834
5714,121534680,35234347,156769027,3,0,1,6656,0,5750549004
5715,121557890,35255139,156813029,7,0,1,73216,16,2293444718
5716,121559050,19655479,141214529,2,0,0,14336,11,2217232666
5717,121613550,20441500,142055050,2,0,0,314880,11,716064817
5718,121632560,35224513,156857073,4,0,1,43520,4,9075268395
5719,121728950,35130069,156859019,3,0,1,3072,0,7838702056
5720,121740780,35127158,156867938,7,0,1,20992,16,4767904327
5721,121767590,35104214,156871804,7,0,1,6144,16,2079291920
5722,121777711,19749799,141527510,7,0,0,89088,16,4795234506
5723,121810450,35103306,156913756,4,0,1,44032,4,2756547819
5724,121826520,35088862,156915382,5,0,1,2560,11,8889177377
5725,121910240,35035836,156946076,7,0,1,25088,16,6276762381
5726,121941400,35006622,156948022,9,0,1,3072,17,10075786575
5727,121951370,34997318,156948688,7,0,1,1024,16,4788585236
5728,121957130,34992326,156949456,4,0,1,11776,4,5046484869
5729,121959730,35001554,156961284,5,0,1,6144,11,5446869683
5730,121970630,19913857,141884487,2,0,0,40960,11,641861494
5731,121985830,35023458,157009288,4,0,1,61952,4,4987159494
5732,121993340,35049682,157043022,7,0,1,32256,16,9527663784
5733,122000060,35046017,157046077,5,0,1,22528,11,6854280501
5734,122029800,19859909,141889709,2,0,0,16384,11,3545523135
5735,122035670,35011380,157047050,4,0,1,12800,4,7774508419
5736,122044491,20031782,142076273,7,0,0,69120,16,3573706088
5737,122049250,35004618,157053868,9,0,1,29696,17,10679870592
5738,122060320,35000960,157061280,9,0,1,13824,17,306719869
5739,122079920,35004342,157084262,5,0,1,3584,11,6322367517
5740,122097170,35047614,157144784,7,0,1,45056,16,8200709099
5741,122098610,35079834,157178444,5,0,1,19968,11,8377479603
5742,122107311,20005433,142112744,7,0,0,119296,16,3681521970
5743,122112280,35133423,157245703,5,0,1,123904,11,5541022237
5744,122211961,20091632,142303593,7,0,0,45056,16,3009768324
5745,122224930,35040684,157265614,7,0,1,7168,16,7616010789
5746,122258800,35006837,157265637,4,0,1,10240,4,3630036164
5747,122267810,34997850,157265660,5,0,1,17920,11,1975625069
5748,122279481,20140719,142420200,7,0,0,374272,16,6957196803
5749,122295690,34976017,157271707,9,0,1,2560,17,9179529229
5750,122435800,19745189,142180989,8,0,0,6144,6,1003463738
5751,122439180,34833193,157272373,3,0,1,1024,0,3641267628
5752,122453060,34825081,157278141,4,0,1,22016,4,2102687584
5753,122473891,34822281,157296172,0,0,1,11264,6,5542295307
5754,122497700,34799520,157297220,7,0,1,1024,16,1657170227
5755,122499480,34803680,157303160,3,0,1,18944,0,3140034523
5756,122519250,34843059,157362309,4,0,1,44544,4,3703945729
5757,122527640,34853859,157381499,4,0,1,11776,4,4473486313
5758,122546490,34885736,157432226,7,0,1,60928,16,9125684194
5759,122575880,34857012,157432892,9,0,1,1024,17,10244348988
5760,122580930,34853268,157434198,9,0,1,2048,17,2843888974
5761,122582500,34852364,157434864,9,0,1,1024,17,5901488417
5762,122586760,34848565,157435325,9,0,1,10240,17,6942749139
5763,122607800,34831391,157439191,5,0,1,6144,11,3975031749
5764,122613120,34866015,157479135,4,0,1,37888,4,4921391700
5765,122624510,34884629,157509139,7,0,1,67584,16,8393968502
5766,122626111,34889845,157515956,0,0,1,19968,6,9274410674
5767,122651781,34958344,157610125,0,0,1,5120,6,3156346184
5768,122671381,20014433,142685814,7,0,0,134656,16,3081476123
5769,122686631,34925440,157612071,0,0,1,3072,6,9885677820
5770,122724641,20145929,142870570,7,0,0,301568,16,7394470853
5771,122728960,34887246,157616206,9,0,1,4608,17,6668251193
5772,122755260,34866744,157622004,4,0,1,5632,4,4665306991
5773,122781620,34861029,157642649,3,0,1,22528,0,1356802141
5774,122787801,34902857,157690658,0,0,1,4608,6,5510714783
5775,122813510,34916415,157729925,3,0,1,51712,0,7905264623
5776,122848600,19574702,142423302,8,0,0,9728,6,4813543599
5777,122852730,34908206,157760936,7,0,1,5120,16,8523653276
5778,122884520,19760243,142644763,8,0,0,143872,6,5444960153
5779,122919321,19549338,142468659,7,0,0,93184,16,2335400659
5780,122945720,19768673,142714393,8,0,0,93696,6,9412923455
5781,122960071,34810433,157770504,0,0,1,4096,6,3592478081
5782,123008260,34762590,157770850,9,0,1,512,17,5440073445
5783,123014790,34761552,157776342,4,0,1,17920,4,4469611925
5784,123028230,34748458,157776688,1,0,1,512,6,5540980572
5785,123040320,34778076,157818396,9,0,1,15360,17,7221494662
5786,123051740,34768039,157819779,3,0,1,14848,0,7051923798
5787,123070770,34751595,157822365,4,0,1,4096,4,2025280619
5788,123096410,34726301,157822711,7,0,1,512,16,1625363798
5789,123137190,34716765,157853955,9,0,1,14336,17,9937994800
5790,123200220,34653758,157853978,7,0,1,8704,16,5466780019
5791,123209510,34663977,157873487,5,0,1,32256,11,10512410346
5792,123267770,34606281,157874051,7,0,1,10752,16,9876855425
5793,123292241,19427167,142719408,7,0,0,16384,16,8437750549
5794,123295470,34579145,157874615,3,0,1,10752,0,4880458133
5795,123302130,34582569,157884699,3,0,1,14848,0,4596600085
5796,123305760,34673246,157979006,1,0,1,23552,6,5455809317
5797,123334680,34644349,157979029,6,0,1,2048,3,1151702061
5798,123337280,20065399,143402679,2,0,0,35840,11,2772209480
5799,123373080,34778701,158151781,3,0,1,50688,0,4915642247
5800,123379091,19763666,143142757,7,0,0,183296,16,1416088933
5801,123384930,34767866,158152796,9,0,1,2560,17,4399130111
5802,123390100,34788727,158178827,4,0,1,7168,4,10122671313
5803,123401740,34778470,158180210,1,0,1,14848,6,9035377756
5804,123403700,34951778,158355478,7,0,1,25088,16,7905748797
5805,123443220,35004989,158448209,7,0,1,20480,16,2074056884
5806,123446850,35001539,158448389,4,0,1,16896,4,5669694711
5807,123474380,35112200,158586580,1,0,1,4608,6,870963694
5808,123478710,35107893,158586603,6,0,1,6144,3,10039000323
5809,123515320,35108015,158623335,3,0,1,1536,0,4124163562
5810,123532040,35230724,158762764,4,0,1,44544,4,8346586434
5811,123554910,35207877,158762787,1,0,1,10240,6,5428325338
5812,123560531,19603915,143164446,7,0,0,70656,16,2733413635
5813,123569910,35237539,158807449,3,0,1,8704,0,9993350485
5814,123574451,19625969,143200420,7,0,0,117760,16,2687706995
5815,123583400,35224072,158807472,7,0,1,17920,16,3605583460
5816,123594880,35212623,158807503,3,0,1,7168,0,5907592902
5817,123604070,35332709,158936779,9,0,1,49152,17,5224562408
5818,123607660,35329142,158936802,4,0,1,4608,4,2275430149
5819,123632030,19690581,143322611,2,0,0,171008,11,8854863828
5820,123644070,35292763,158936833,3,0,1,6656,0,6631517542
5821,123648560,35302228,158950788,3,0,1,16384,0,3858900639
5822,123659620,35405571,159065191,7,0,1,2048,16,6280041388
5823,123700580,35364634,159065214,6,0,1,12288,3,1593951108
5824,123723960,35408465,159132425,7,0,1,34816,16,10702946568
5825,123738310,19601211,143339521,2,0,0,55296,11,1218474781
5826,123791280,35594930,159386210,7,0,1,33280,16,9884574561
5827,123827530,35558703,159386233,6,0,1,4608,3,5109654199
5828,123832290,19597556,143429846,2,0,0,89088,11,5451204025
5829,123900020,35486883,159386903,7,0,1,22016,16,6223967388
5830,123998660,35388266,159386926,9,0,1,512,17,6157086760
5831,123999470,19270991,143270461,2,0,0,116224,11,8600955610
5832,124015610,35371339,159386949,7,0,1,21504,16,6479831994
5833,124043720,35343252,159386972,7,0,1,512,16,9719633628
5834,124086890,35300105,159386995,3,0,1,6144,0,240774253
5835,124139820,35247198,159387018,5,0,1,4096,11,5532170375
5836,124182130,35204919,159387049,7,0,1,2048,16,7196329122
5837,124198650,35197291,159395941,4,0,1,17408,4,10345189672
5838,124215260,35183690,159398950,3,0,1,17408,0,3292244986
5839,124233270,19832792,144066062,2,0,0,582656,11,3826370196
5840,124282670,35119186,159401856,7,0,1,4608,16,3559209353
5841,124289490,19060238,143349728,2,0,0,19456,11,6616233166
5842,124291680,35131211,159422891,4,0,1,9728,4,5439063594
5843,124295620,35129217,159424837,4,0,1,3072,4,2008640970
5844,124313360,19802177,144115537,2,0,0,162304,11,2905640504
5845,124396830,35047785,159444615,1,0,1,11264,6,67515667
5846,124465060,34980938,159445998,7,0,1,14848,16,5095155841
5847,124569011,19568755,144137766,7,0,0,53248,16,1038830061
5848,124569160,34994928,159564088,3,0,1,13824,0,6804273725
5849,124637790,34926321,159564111,1,0,1,18432,6,8600874171
5850,124720200,34847123,159567323,5,0,1,14336,11,363836105
5851,124723340,34844006,159567346,3,0,1,512,0,5453133096
5852,124728290,34839079,159567369,7,0,1,5632,16,10325215391
5853,124732820,34834572,159567392,1,0,1,9728,6,3738288812
5854,124737650,34829765,159567415,3,0,1,3072,0,3631862515
5855,124749430,34818008,159567438,1,0,1,4608,6,10713792272
5856,124787730,34795822,159583552,3,0,1,24576,0,3635757059
5857,124823330,34760245,159583575,7,0,1,3072,16,8600700859
5858,124883710,34699888,159583598,1,0,1,10240,6,7238253986
5859,124906470,34677159,159583629,4,0,1,37888,4,1914782361
5860,124983520,34609521,159593041,7,0,1,23040,16,4275067380
5861,125023601,19269820,144293421,7,0,0,64000,16,1331722635
5862,125040850,34587172,159628022,1,0,1,43520,6,3147608913
5863,125042880,34607070,159649950,1,0,1,24064,6,146767552
5864,125054260,34600530,159654790,3,0,1,10752,0,7800874666
5865,125070990,34605815,159676805,4,0,1,15872,4,6237708007
5866,125132780,34608751,159741531,4,0,1,73728,4,9619651288
5867,125174830,34566724,159741554,6,0,1,14336,3,8813412269
5868,125178130,34572988,159751118,4,0,1,28160,4,5122887053
5869,125184160,34585495,159769655,7,0,1,5120,16,8916574758
5870,125198980,19254168,144453148,2,0,0,89088,11,2454555252
5871,125253871,18862469,144116340,7,0,0,2560,16,4586579084
5872,125261710,34524946,159786656,7,0,1,21504,16,7929617249
5873,125262310,34538257,159800567,7,0,1,512,16,852307884
5874,125323670,34478843,159802513,4,0,1,3072,4,2884200519
5875,125344581,19214607,144559188,7,0,0,82432,16,2825814762
5876,125359890,34452403,159812293,6,0,1,25088,3,2180697403
5877,125447381,18674138,144121519,7,0,0,16896,16,7887377151
5878,125452410,19410895,144863305,2,0,0,387584,11,7425903227
5879,125502461,19362762,144865223,7,0,0,6144,16,4460415940
5880,125598820,34246255,159845075,3,0,1,18944,0,9862215349
5881,125601531,19931274,145532805,7,0,0,25600,16,4099643314
5882,125671860,34200587,159872447,3,0,1,11776,0,1052687041
5883,125719090,34154023,159873113,3,0,1,1024,0,7452950871
5884,125731971,19315777,145047748,7,0,0,143872,16,773894514
5885,125750300,34153211,159903511,6,0,1,30720,3,3274093074
5886,125767610,34351989,160119599,4,0,1,36352,4,4177816665
5887,125787380,34337711,160125091,7,0,1,17920,16,1784311986
5888,125875850,18658199,144534049,2,0,0,222720,11,613920592
5889,125882201,34293961,160176162,0,0,1,15872,6,6119237087
5890,125964511,19122595,145087106,7,0,0,72704,16,7448114005
5891,125964660,34274753,160239413,3,0,1,34816,0,1374668689
5892,126005670,34236761,160242431,8,0,1,11776,6,617887713
5893,126019421,18396318,144415739,7,0,0,122368,16,8033837611
5894,126030290,19263044,145293334,2,0,0,263168,11,1937727462
5895,126036990,34230139,160267129,4,0,1,6656,4,3184978093
5896,126037100,34320922,160358022,6,0,1,17920,3,3681522851
5897,126113000,34245045,160358045,4,0,1,7168,4,9866276051
5898,126144220,34213848,160358068,3,0,1,5632,0,9592482168
5899,126170180,34279646,160449826,4,0,1,60928,4,3396723449
5900,126172840,34323988,160496828,4,0,1,19968,4,5158131201
5901,126179770,34317097,160496867,4,0,1,99328,4,4181067942
5902,126193350,34303540,160496890,3,0,1,10240,0,3743962269
5903,126248590,19289854,145538444,2,0,0,18432,11,3832650466
5904,126259320,34239818,160499138,4,0,1,5120,4,1364267716
5905,126303061,34209375,160512436,0,0,1,22528,6,9248823670
5906,126397171,34122691,160519862,0,0,1,11264,6,3519581751
5907,126416970,18271600,144688570,2,0,0,51200,11,2528879533
5908,126679671,19120546,145800217,7,0,0,320000,16,10502457048
5909,126726110,33831316,160557426,9,0,1,5632,17,4862441055
5910,126911420,19066992,145978412,2,0,0,93696,11,455591364
5911,126944360,33613097,160557457,3,0,1,2560,0,7399927756
5912,127011891,17966781,144978672,7,0,0,78848,16,1708050480
5913,127116200,33441280,160557480,9,0,1,22528,17,9139424962
5914,127118630,17800718,144919348,9,0,0,91648,17,2109743210
5915,127134500,33423003,160557503,9,0,1,4608,17,1936835249
5916,127150411,17914520,145064931,7,0,0,56320,16,2436403349
5917,127166341,33391185,160557526,0,0,1,33280,6,3115910320
5918,127169090,33391310,160560400,9,0,1,16896,17,6206439759
5919,127261631,18263328,145524959,7,0,0,268800,16,10236235813
5920,127285480,17803404,145088884,2,0,0,5632,11,10288376692
5921,127321301,33243311,160564612,0,0,1,6656,6,8668856692
5922,127362870,33248619,160611489,3,0,1,50688,0,9975136443
5923,127379730,33232732,160612462,3,0,1,12800,0,1986766160
5924,127400610,17945007,145345617,2,0,0,171520,11,3454467211
5925,127424321,17951172,145375493,7,0,0,76800,16,4931827267
5926,127426600,18835540,146262140,2,0,0,216064,11,9309101485
5927,127436991,33196733,160633724,0,0,1,44032,6,8654465129
5928,127483131,18106203,145589334,7,0,0,60416,16,10331293924
5929,127639920,17760847,145400767,9,0,0,47616,17,6561653481
5930,127655770,17777502,145433272,9,0,0,16384,17,6411343531
5931,127694270,17651915,145346185,5,0,0,1536,11,7311588160
5932,127771600,32864070,160635670,9,0,1,3072,17,3162339422
5933,127780620,17765819,145546439,9,0,0,26112,17,9344016096
5934,127788350,32911921,160700271,3,0,1,63488,0,8501236658
5935,127808850,18019470,145828320,2,0,0,92160,11,9829045990
5936,127815120,32889990,160705110,9,0,1,18944,17,8967589872
5937,127853500,32923035,160776535,3,0,1,17408,0,9004945696
5938,127878190,32901891,160780081,3,0,1,5632,0,7501884489
5939,127903740,32880207,160783947,4,0,1,6144,4,8434188498
5940,127946841,32854861,160801702,0,0,1,34304,6,5010872656
5941,127987451,32823444,160810895,0,0,1,5632,6,7389613861
5942,127990890,32820991,160811881,3,0,1,1536,0,1695385253
5943,128060890,32822532,160883422,4,0,1,27648,4,6675155377
5944,128097020,32805085,160902105,3,0,1,5120,0,8916736268
5945,128103291,32840788,160944079,0,0,1,27136,6,4461730190
5946,128121031,32823071,160944102,0,0,1,3584,6,8783871195
5947,128125650,17476210,145601860,9,0,0,40960,17,10253502756
5948,128168850,18167720,146336570,9,0,0,30720,17,4488706986
5949,128195571,32768782,160964353,0,0,1,26624,6,2832195397
5950,128195670,17473651,145669321,9,0,0,51712,17,7699813293
5951,128205800,17650498,145856298,5,0,0,3072,11,10146130941
5952,128227681,18368706,146596387,7,0,0,174592,16,10275413736
5953,128232611,32735389,160968000,0,0,1,4608,6,6889615564
5954,128237251,32757763,160995014,0,0,1,12800,6,1408870128
5955,128248800,32746982,160995782,4,0,1,11776,4,9416617651
5956,128294410,17541825,145836235,2,0,0,25600,11,2913852308
5957,128301400,32792003,161093403,3,0,1,40448,0,3757607050
5958,128372040,17480078,145852118,9,0,0,8704,17,10057333917
5959,128379500,32777129,161156629,3,0,1,9216,0,3813452431
5960,128405880,32750772,161156652,8,0,1,4096,6,9359570249
5961,128439660,32725626,161165286,4,0,1,78848,4,10556917951
5962,128448331,17836296,146284627,7,0,0,73728,16,7940758861
5963,128500240,32665069,161165309,8,0,1,26112,6,606517485
5964,128502780,32662552,161165332,8,0,1,18432,6,10144558118
5965,128508260,32657119,161165379,4,0,1,1536,4,10366781666
5966,128514970,32665169,161180139,8,0,1,1024,6,9545437879
5967,128622980,17431801,146054781,5,0,0,1024,11,9506073044
5968,128670320,18608549,147278869,9,0,0,43520,17,9827820519
5969,128682690,17607957,146290647,5,0,0,512,11,7849715898
5970,128709700,18315116,147024816,2,0,0,100864,11,1775476807
5971,128709930,17939098,146649028,6,0,0,172544,3,10155022462
5972,128713340,32471824,161185164,8,0,1,13824,6,3042254478
5973,128753310,32475911,161229221,8,0,1,26624,6,2108213937
5974,128759190,32479917,161239107,8,0,1,6144,6,7000158432
5975,128810890,32471767,161282657,9,0,1,17408,17,5577944362
5976,128898290,32384390,161282680,8,0,1,3072,6,9456930895
5977,128922770,18054888,146977658,2,0,0,484864,11,1341595122
5978,128941560,18323987,147265547,9,0,0,790016,17,5708443122
5979,128955511,17428529,146384040,7,0,0,113664,16,2595870657
5980,128977771,18318506,147296277,7,0,0,16896,16,9115900383
5981,128999701,32313575,161313276,0,0,1,58368,6,7575656595
5982,129004751,32308548,161313299,0,0,1,7680,6,7363240548
5983,129013410,32299912,161313322,4,0,1,6656,4,4053839721
5984,129015410,32297935,161313345,8,0,1,12288,6,2217572199
5985,129026791,18315419,147342210,7,0,0,147968,16,6586860343
5986,129044760,18493280,147538040,2,0,0,119808,11,2304140462
5987,129086590,32226778,161313368,4,0,1,2560,4,9278415713
5988,129118251,18293939,147412190,7,0,0,120320,16,7614591458
5989,129128680,32184711,161313391,8,0,1,512,6,3156567800
5990,129129340,18244561,147373901,9,0,0,103936,17,2639257696
5991,129202800,18088306,147291106,2,0,0,18944,11,9199171784
5992,129213300,17780761,146994061,9,0,0,53760,17,1812956931
5993,129296390,32040157,161336547,4,0,1,25088,4,6999755760
5994,129327681,32012412,161340093,0,0,1,5632,6,2903598457
5995,129328830,32013004,161341834,4,0,1,24576,4,1367363298
5996,129344070,32009014,161353084,8,0,1,19968,6,3594791145
5997,129351771,32089811,161441582,0,0,1,13824,6,7188429125
5998,129382930,32058675,161441605,4,0,1,9216,4,9217855207
5999,129401721,17883567,147285288,7,0,0,20992,16,6644144767
6000,129482910,31958718,161441628,8,0,1,512,6,5657776957
6001,129513620,31928031,161441651,8,0,1,3072,6,7013931289
6002,129603971,31957302,161561273,0,0,1,49152,6,2530481838
6003,129616450,32241071,161857521,8,0,1,19968,6,3272546499
6004,129639780,32217764,161857544,4,0,1,10240,4,4261436973
6005,129689250,32168317,161857567,8,0,1,14336,6,10476484839
6006,129697830,17761261,147459091,2,0,0,150528,11,5686359924
6007,129736831,32120759,161857590,0,0,1,1024,6,3019164738
6008,129767501,32090112,161857613,0,0,1,6656,6,10641533487
6009,129792420,17583064,147375484,5,0,0,5120,11,6592779237
6010,129813660,17738730,147552390,2,0,0,43008,11,349454767
6011,129823681,17666968,147490649,7,0,0,103424,16,6693269875
6012,129827280,17585869,147413149,5,0,0,3072,11,10474919629
6013,129879940,17621527,147501467,9,0,0,35328,17,9269808522
6014,129884510,17693276,147577786,2,0,0,81408,11,8756603819
6015,130001090,17296013,147297103,5,0,0,2560,11,8573297043
6016,130062200,17477063,147539263,5,0,0,3584,11,4489883805
6017,130069110,31794945,161864055,8,0,1,38912,6,2490345134
6018,130089390,31777590,161866980,4,0,1,1536,4,7486152878
6019,130104960,17447999,147552959,5,0,0,1536,11,990066748
6020,130146680,17609225,147755905,9,0,0,18944,17,8841995364
6021,130190011,17659782,147849793,7,0,0,101888,16,1580884306
6022,130228140,31687085,161915225,4,0,1,16896,4,7778185070
6023,130232071,31697270,161929341,0,0,1,8192,6,9633188917
6024,130237481,17894242,148131723,7,0,0,193024,16,9570215986
6025,130301200,31629524,161930724,8,0,1,14848,6,6400101305
6026,130308560,31632452,161941012,8,0,1,4608,6,1367591085
6027,130444130,17290823,147734953,2,0,0,71168,11,443273987
6028,130448901,17439358,147888259,7,0,0,33792,16,7727187832
6029,130456760,17884794,148341554,2,0,0,36352,11,1580384870
6030,130460871,17611526,148072397,7,0,0,244736,16,718485816
6031,130473350,31475113,161948463,1,0,1,19968,6,2344518655
6032,130637930,17692502,148330432,2,0,0,104960,11,2272433278
6033,130656110,31353083,162009193,1,0,1,28672,6,5823981606
6034,130679170,17461320,148140490,9,0,0,28672,17,1974683821
6035,130714200,31295016,162009216,1,0,1,7680,6,2020586988
6036,130717211,17581118,148298329,7,0,0,144384,16,3193885876
6037,130730611,31281010,162011621,0,0,1,29696,6,6358645448
6038,130804960,31220224,162025184,1,0,1,20480,6,10295751334
6039,130826100,31205359,162031459,1,0,1,2560,6,8104125260
6040,130890180,17254724,148144904,5,0,0,4096,11,4117588496
6041,130919850,31111955,162031805,2,0,1,512,11,8591318514
6042,130928920,31216047,162144967,1,0,1,18944,6,407673769
6043,130929200,17214433,148143633,5,0,0,10240,11,1410627546
6044,130930590,17142298,148072888,5,0,0,1536,11,151347146
6045,130933210,17321104,148254314,2,0,0,208384,11,3413044805
6046,131001061,31143929,162144990,0,0,1,7680,6,9494986152
6047,131076331,17302833,148379164,7,0,0,92672,16,2003375363
6048,131083500,31061513,162145013,1,0,1,21504,6,4209001689
6049,131119070,17066846,148185916,9,0,0,102912,17,7820353976
6050,131135081,31009955,162145036,0,0,1,10752,6,9352685001
6051,131176590,30968469,162145059,1,0,1,17920,6,6522593194
6052,131270790,30874292,162145082,1,0,1,2048,6,4449284548
6053,131375760,16778777,148154537,5,0,0,2560,11,733190646
6054,131391981,30753124,162145105,0,0,1,512,6,3269214629
6055,131442800,16743630,148186430,5,0,0,1536,11,7582904570
6056,131460580,30684548,162145128,1,0,1,1536,6,3077218230
6057,131486171,30658980,162145151,0,0,1,20992,6,3815595262
6058,131506520,16908773,148415293,9,0,0,118272,17,6433871136
6059,131531351,30621045,162152396,0,0,1,13824,6,6975397952
6060,131575990,30650811,162226801,1,0,1,25088,6,460295053
6061,131579600,30687315,162266915,1,0,1,4608,6,10136818446
6062,131606720,30660226,162266946,1,0,1,10240,6,3931302858
6063,131631361,30635608,162266969,0,0,1,1536,6,2591047200
6064,131641680,16709133,148350813,9,0,0,30208,17,2698214029
6065,131656870,30610122,162266992,1,0,1,6656,6,5492477085
6066,131666260,30638827,162305087,1,0,1,1024,6,6898155927
6067,131692281,16734968,148427249,7,0,0,38912,16,2355623166
6068,131700201,30604909,162305110,0,0,1,10240,6,110835772
6069,131917490,30418755,162336245,1,0,1,25088,6,3562348386
6070,131943401,16799833,148743234,7,0,0,54272,16,9443458035
6071,131950111,30405541,162355652,0,0,1,18944,6,5045307759
6072,131976471,30385691,162362162,0,0,1,14336,6,6217217944
6073,132047310,30410989,162458299,1,0,1,60928,6,2490176645
6074,132106240,30488470,162594710,2,0,1,107008,11,1146432657
6075,132119691,30475360,162595051,0,0,1,10240,6,1086842285
6076,132131101,16578695,148709796,7,0,0,268288,16,9545444987
6077,132317021,30297914,162614935,0,0,1,1024,6,5950627635
6078,132366490,30249213,162615703,1,0,1,11776,6,6688831994
6079,132390191,30226280,162616471,0,0,1,11776,6,6398311833
6080,132392441,30279519,162671960,0,0,1,3072,6,1140157151
6081,132395761,30276222,162671983,0,0,1,6144,6,5193851936
6082,132399090,16593049,148992139,5,0,0,330752,11,7139683572
6083,132443230,30228776,162672006,1,0,1,4608,6,6788783021
6084,132502640,16306139,148808779,5,0,0,3072,11,6971190856
6085,132589050,17078455,149667505,5,0,0,195584,11,753499673
6086,132681261,29990768,162672029,0,0,1,8704,6,10670929474
6087,132689281,16483673,149172954,7,0,0,62976,16,7465498274
6088,132727310,29944742,162672052,1,0,1,16384,6,78819176
6089,132826990,29845085,162672075,1,0,1,5120,6,7335116338
6090,132884761,16453271,149338032,7,0,0,180736,16,5465413312
6091,132959730,16509253,149468983,5,0,0,60928,11,10418248456
6092,133017871,16265070,149282941,7,0,0,109056,16,3439291197
6093,133166140,16438678,149604818,9,0,0,228352,17,3131030929
6094,133169580,29563350,162732930,1,0,1,38400,6,7093088591
6095,133284051,15709047,148993098,7,0,0,3072,16,3900727733
6096,133418011,29579021,162997032,0,0,1,73216,6,6962177652
6097,133469751,15959213,149428964,7,0,0,10240,16,3027508224
6098,133484710,15652287,149136997,5,0,0,90112,11,4955998426
6099,133521080,29475975,162997055,2,0,1,22528,11,2504366553
6100,133524750,15981883,149506633,5,0,0,123392,11,8304519684
6101,133547170,29449916,162997086,6,0,1,47616,3,9485083764
6102,133561631,29451333,163012964,0,0,1,4608,6,2636745082
6103,133596030,29419200,163015230,4,0,1,3584,4,7918013319
6104,133705661,29311515,163017176,0,0,1,3072,6,6797073576
6105,133762700,29328445,163091145,6,0,1,19456,3,6461599260
6106,133803100,15335416,149138516,5,0,0,4608,11,107954998
6107,133878851,15296622,149175473,7,0,0,8192,16,9681392735
6108,133952290,15498083,149450373,9,0,0,68096,17,9831462187
6109,134166241,15187951,149354192,7,0,0,50176,16,5587388109
6110,134200610,15833456,150034066,5,0,0,144896,11,5779042211
6111,134232860,28858308,163091168,2,0,1,5120,11,2861691157
6112,134291901,15221578,149513479,7,0,0,512,16,6198456634
6113,134301940,28789251,163091191,9,0,1,17408,17,6415841984
6114,134391900,14854238,149246138,9,0,0,512,17,89507910
6115,134474740,15755340,150230080,9,0,0,76288,17,10455014089
6116,134546291,14849145,149395436,7,0,0,1024,16,2495779352
6117,134601141,14737717,149338858,7,0,0,2560,16,1698144109
6118,134638370,14874838,149513208,5,0,0,21504,11,2866294255
6119,134687050,28404164,163091214,9,0,1,28672,17,3560637864
6120,134833921,28257316,163091237,0,0,1,22528,6,2564995702
6121,134841361,28313527,163154888,0,0,1,27136,6,5081327102
6122,134883910,28272121,163156031,5,0,1,12288,11,5742184214
6123,134924430,14798682,149723112,9,0,0,17920,17,2443062522
6124,134928861,28301583,163230444,0,0,1,8704,6,4397356121
6125,134958850,15409049,150367899,5,0,0,62976,11,1182202346
6126,134973681,28301581,163275262,0,0,1,33792,6,7035511452
6127,135013581,28261704,163275285,0,0,1,6144,6,7834190158
6128,135035010,15876328,150911338,9,0,0,153600,17,898851239
6129,135082311,28192997,163275308,0,0,1,5120,6,7615666193
6130,135094250,14584042,149678292,5,0,0,35328,11,10230211085
6131,135113320,15302114,150415434,5,0,0,56320,11,6089164057
6132,135117610,15439811,150557421,9,0,0,21504,17,2427940560
6133,135152080,28123251,163275331,9,0,1,5120,17,6528072970
6134,135179761,14630864,149810625,7,0,0,2048,16,6123601028
6135,135289521,14225237,149514758,7,0,0,4096,16,3680912355
6136,135357601,14247552,149605153,7,0,0,1024,16,3024472678
6137,135393661,27881709,163275370,0,0,1,2560,6,2308155603
6138,135421300,27854093,163275393,9,0,1,12800,17,1330075743
6139,135486171,27789245,163275416,0,0,1,5632,6,5658105416
6140,135636120,14473218,150109338,9,0,0,11776,17,745882617
6141,135664200,13943628,149607828,5,0,0,8704,11,9871984781
6142,135697510,27577929,163275439,2,0,1,19968,11,7952866788
6143,135707691,27574048,163281739,0,0,1,31232,6,7253637792
6144,135771930,14023996,149795926,5,0,0,86528,11,7894973492
6145,135772081,15025949,150798030,7,0,0,4096,16,8847620624
6146,135781930,14304641,150086571,9,0,0,62464,17,1274243720
6147,135828510,27502887,163331397,2,0,1,19968,11,6306959950
6148,135833051,14397208,150230259,7,0,0,512,16,5395438935
6149,135876730,15554222,151430952,5,0,0,80896,11,9705104759
6150,135878010,15411866,151289876,9,0,0,206336,17,4760644587
6151,135897310,15329184,151226494,5,0,0,525312,11,2407300986
6152,135902890,27525479,163428369,9,0,1,33280,17,8355941062
6153,135903840,27524888,163428728,2,0,1,9728,11,7181970078
6154,135947430,13910883,149858313,9,0,0,35328,17,7730501298
6155,135962560,15871509,151834069,9,0,0,499712,17,6511745133
6156,136026890,27479526,163506416,9,0,1,9216,17,3450954967
6157,136085720,14572691,150658411,5,0,0,107520,11,6844571488
6158,136121021,27397122,163518143,0,0,1,12800,6,2780119273
6159,136136971,27381518,163518489,0,0,1,512,6,4338734731
6160,136168760,13865641,150034401,9,0,0,1024,17,5726958505
6161,136191620,14157068,150348688,5,0,0,87552,11,9767523118
6162,136206720,15352027,151558747,5,0,0,117248,11,6570338429
6163,136219750,16047653,152267403,5,0,0,77824,11,5330207598
6164,136243380,15680706,151924086,9,0,0,201216,17,1055665445
6165,136358870,27163485,163522355,2,0,1,6144,11,4578263336
6166,136393610,14956426,151350036,9,0,0,48640,17,1774463606
6167,136402710,27140512,163543222,2,0,1,33792,11,4023836823
6168,136498731,14270642,150769373,7,0,0,6656,16,958521638
6169,136600910,15739687,152340597,5,0,0,123904,11,824007970
6170,136631331,26912557,163543888,0,0,1,1024,6,1788598799
6171,136683610,13863336,150546946,5,0,0,137216,11,4439972028
6172,136953461,13860241,150813702,7,0,0,5120,16,492538625
6173,137146210,13826412,150972622,5,0,0,165888,11,10646187190
6174,137170820,14837139,152007959,5,0,0,274944,11,4538494560
6175,137335720,14841878,152177598,5,0,0,434688,11,4335579762
6176,137347820,13879165,151226985,5,0,0,1536,11,7588422555
6177,137397671,13958531,151356202,7,0,0,1536,16,8417631901
6178,137475901,14083025,151558926,7,0,0,512,16,7214838832
6179,137482430,13583978,151066408,5,0,0,13824,11,7225911760
6180,137502750,26057422,163560172,9,0,1,23552,17,9636950412
6181,137551910,14310198,151862108,9,0,0,91648,17,4386680953
6182,137596891,14077019,151673910,7,0,0,8704,16,5274230586
6183,137666000,13101322,150767322,9,0,0,5120,17,5769540203
6184,137689480,14901711,152591191,5,0,0,515584,11,2148643317
6185,137691071,25969413,163660484,0,0,1,4608,6,2653661485
6186,137753101,25907989,163661090,0,0,1,2560,6,1896114319
6187,137792921,13881168,151674089,7,0,0,512,16,7746050338
6188,137796720,14901884,152698604,5,0,0,245248,11,4467349110
6189,137847430,13777561,151624991,5,0,0,11776,11,1847612214
6190,137875811,14367788,152243599,7,0,0,2048,16,32462406
6191,137899161,14692989,152592150,7,0,0,3072,16,7257705747
6192,137918920,14936523,152855443,9,0,0,120320,17,935985474
6193,137959470,25702286,163661756,9,0,1,1024,17,6561352788
6194,138046480,25615430,163661910,9,0,1,8704,17,5988818239
6195,138050510,25611554,163662064,9,0,1,8704,17,619149028
6196,138115980,13269610,151385590,5,0,0,12288,11,5701646743
6197,138194720,25487379,163682099,9,0,1,2048,17,5032713401
6198,138283060,14760657,153043717,5,0,0,71680,11,2329582228
6199,138298981,14065594,152364575,7,0,0,4096,16,4402813866
6200,138364230,13926018,152290248,9,0,0,1536,17,6159709482
6201,138369660,14802823,153172483,5,0,0,74752,11,5316331473
6202,138398890,13830725,152229615,5,0,0,161792,11,4739284469
6203,138478450,25203672,163682122,9,0,1,12800,17,10332228698
6204,138507390,14840695,153348085,5,0,0,140800,11,3429075648
6205,138827460,13462274,152289734,5,0,0,73216,11,2160097709
6206,138958010,13086990,152045000,5,0,0,120832,11,2880772023
6207,138965850,24716295,163682145,9,0,1,5120,17,24633696
6208,138985680,24734679,163720359,9,0,1,12800,17,9833265504
6209,139016311,12846444,151862755,7,0,0,2048,16,5795383445
6210,139026920,24704336,163731256,1,0,1,16896,6,116038176
6211,139058420,24723202,163781622,9,0,1,15360,17,3457553548
6212,139080020,13543821,152623841,5,0,0,103936,11,381762101
6213,139111290,13131662,152242952,9,0,0,43520,17,99482712
6214,139145770,24670680,163816450,9,0,1,33792,17,3503920212
6215,139230030,24601050,163831080,8,0,1,8192,6,6520013283
6216,139301260,24534570,163835830,9,0,1,17408,17,8674863751
6217,139333820,24507911,163841731,9,0,1,19968,17,8584535075
6218,139352290,24491387,163843677,8,0,1,3072,6,6264621213
6219,139371390,24476153,163847543,9,0,1,6144,17,8740626268
6220,139399371,12780925,152180296,7,0,0,8704,16,10589756565
6221,139406440,24443049,163849489,8,0,1,3072,6,8503288098
6222,139432200,12870614,152302814,5,0,0,40960,11,8981165348
6223,139472360,24442115,163914475,8,0,1,2560,6,4336788103
6224,139485220,24482185,163967405,9,0,1,5632,17,7279877732
6225,139497321,12510817,152008138,7,0,0,512,16,7335604957
6226,139520980,24446448,163967428,9,0,1,4608,17,9681646589
6227,139528810,12872581,152401391,9,0,0,59392,17,6578241968
6228,139540960,24426491,163967451,8,0,1,18432,6,10011831858
6229,139644880,13987500,153632380,5,0,0,119296,11,137164187
6230,139757830,24209644,163967474,9,0,1,6656,17,4848830719
6231,139821930,24145567,163967497,9,0,1,20480,17,4611545232
6232,139869300,14061090,153930390,5,0,0,418304,11,8374638756
6233,139891811,13023043,152914854,7,0,0,1024,16,1685337634
6234,139903660,13627370,153531030,5,0,0,72704,11,48960898
6235,139936880,12797772,152734652,9,0,0,29184,17,10081438560
6236,139985470,23982058,163967528,8,0,1,1536,6,8481645494
6237,140001040,12913479,152914519,9,0,0,41984,17,1944392641
6238,140008990,23984732,163993722,9,0,1,58880,17,4285549452
6239,140083770,12905177,152988947,5,0,0,102912,11,5514747519
6240,140147100,12906780,153053880,5,0,0,33280,11,2796150948
6241,140169201,13426785,153595986,7,0,0,1024,16,10047956743
6242,140172330,23827204,163999534,8,0,1,9216,6,4801113788
6243,140177750,14128344,154306094,9,0,0,678400,17,6249965634
6244,140217910,12902661,153120571,5,0,0,3072,11,4815260774
6245,140225171,12564802,152789973,7,0,0,3584,16,6936509141
6246,140245520,14163248,154408768,9,0,0,168960,17,2037542571
6247,140292010,23710750,164002760,8,0,1,5120,6,5544652028
6248,140369530,12779071,153148601,5,0,0,76288,11,6872003439
6249,140460720,23902165,164362885,8,0,1,17920,6,3085705
6250,140486851,12249061,152735912,7,0,0,3072,16,8660845460
6251,140536380,13216921,153753301,5,0,0,44544,11,9328756271
6252,140559850,23807195,164367045,5,0,1,11264,11,6536162257
6253,140571930,23842671,164414601,4,0,1,6656,4,5548993016
6254,140582730,23840633,164423363,9,0,1,11776,17,10487039258
6255,140591711,12264379,152856090,7,0,0,2048,16,7264253358
6256,140644230,23962061,164606291,6,0,1,26112,3,5994635697
6257,140655440,23962468,164617908,4,0,1,2048,4,7064716927
6258,140714610,12995660,153710270,9,0,0,255488,17,507842052
6259,140724030,23894442,164618472,8,0,1,10752,6,6856630577
6260,140769150,12700573,153469723,9,0,0,251904,17,8476811057
6261,140825200,12258176,153083376,5,0,0,49664,11,7417440768
6262,140903320,23987146,164890466,7,0,1,10240,16,2885156525
6263,140944430,23946075,164890505,5,0,1,12800,11,3219726625
6264,140962630,23927898,164890528,9,0,1,7168,17,4269571440
6265,140998230,23892321,164890551,7,0,1,5632,16,3151347784
6266,141022370,23868204,164890574,5,0,1,8192,11,375721764
6267,141029880,23892096,164921976,5,0,1,7168,11,10577188868
6268,141074600,23847399,164921999,7,0,1,1024,16,8006206399
6269,141165200,12227748,153392948,5,0,0,115200,11,4718197430
6270,141182431,12751350,153933781,7,0,0,6144,16,1517783768
6271,141195020,23727002,164922022,4,0,1,30208,4,3703364225
6272,141216740,13288932,154505672,5,0,0,276480,11,217796924
6273,141301620,23621852,164923472,8,0,1,7168,6,7320066243
6274,141365670,23557825,164923495,7,0,1,16896,16,6732008805
6275,141372610,23550908,164923518,9,0,1,8704,17,513612794
6276,141424560,23614912,165039472,7,0,1,30208,16,8627982746
6277,141453660,23585931,165039591,8,0,1,54784,6,9374887009
6278,141510701,12030686,153541387,7,0,0,1536,16,7503589937
6279,141522960,23516654,165039614,8,0,1,25600,6,3211888520
6280,141531020,12064631,153595651,9,0,0,82944,17,5455572698
6281,141531190,23624378,165155568,8,0,1,18944,6,2453633139
6282,141536570,23619021,165155591,9,0,1,13312,17,337772457
6283,141539510,23616104,165155614,7,0,1,7168,16,4448276468
6284,141611900,23543737,165155637,7,0,1,1536,16,8310449169
6285,141641941,11828920,153470861,7,0,0,1536,16,9943643336
6286,141705461,12646231,154351692,7,0,0,512,16,7858840829
6287,141747330,23408338,165155668,8,0,1,22528,6,536093996
6288,141820691,11649679,153470370,7,0,0,2048,16,484165591
6289,141898960,12123646,154022606,9,0,0,56320,17,9837440025
6290,141939621,11992196,153931817,7,0,0,4608,16,1863762138
6291,141945190,23210501,165155691,8,0,1,1024,6,6052529435
6292,141984830,23170884,165155714,8,0,1,24064,6,2329542254
6293,142073110,12026238,154099348,9,0,0,216576,17,3696281461
6294,142153070,12453260,154606330,9,0,0,60416,17,9960123814
6295,142185070,12166443,154351513,9,0,0,148992,17,6848310032
6296,142258360,22897377,165155737,6,0,1,2048,3,7675029496
6297,142263120,22892640,165155760,6,0,1,17920,3,3041271849
6298,142330770,22825013,165155783,7,0,1,7168,16,4877416718
6299,142332731,12022056,154354787,7,0,0,3072,16,8462554245
6300,142406830,12234825,154641655,9,0,0,115200,17,5094124539
6301,142487290,22668516,165155806,6,0,1,3072,3,7008475896
6302,142522890,22632939,165155829,8,0,1,48128,6,5082854070
6303,142523910,12063927,154587837,9,0,0,85504,17,4526196282
6304,142614701,11739088,154353789,7,0,0,4608,16,3205155499
6305,142804860,11891212,154696072,9,0,0,173056,17,1394075709
6306,142899541,11510076,154409617,7,0,0,2560,16,158917843
6307,143106110,22049758,165155868,8,0,1,6144,6,10647945629
6308,143111110,22085832,165196942,6,0,1,19968,3,7282845211
6309,143125201,11227161,154352362,7,0,0,2048,16,9797713124
6310,143178831,22018134,165196965,0,0,1,512,6,9743133990
6311,143296230,21926421,165222651,6,0,1,17408,3,7752258908
6312,143398350,10958892,154357242,3,0,0,7680,0,2881154748
6313,143536801,11288625,154825426,7,0,0,6656,16,9497243835
6314,143591300,10830063,154421363,3,0,0,26112,0,5010237210
6315,143740790,21481884,165222674,6,0,1,22528,3,8781133961
6316,143907300,10506084,154413384,9,0,0,12288,17,4200285031
6317,143914961,10691548,154606509,7,0,0,512,16,8442789862
6318,143938190,21289317,165227507,6,0,1,7168,3,6259885491
6319,144092640,21146158,165238798,6,0,1,37376,3,793061367
6320,144132440,21158382,165290822,6,0,1,5120,3,7905511846
6321,144141910,10409422,154551332,3,0,0,109568,0,2757602399
6322,144184830,10333033,154517863,9,0,0,39936,17,8090339895
6323,144189760,10372002,154561762,9,0,0,33792,17,1125724501
6324,144448830,20878125,165326955,4,0,1,26112,4,1790127337
6325,144456100,20872367,165328467,9,0,1,15360,17,8640788850
6326,144515201,10299354,154814555,7,0,0,5120,16,3846820884
6327,144549740,10520456,155070196,3,0,0,345088,0,8026180486
6328,144568780,10136456,154705236,3,0,0,20992,0,791023951
6329,144597470,20743975,165341445,9,0,1,3072,17,8006659061
6330,144627930,20831067,165458997,9,0,1,12800,17,4212331604
6331,144679430,10546076,155225506,9,0,0,309248,17,7146108354
6332,144702250,21137481,165839731,9,0,1,17920,17,6382773674
6333,144797530,21308685,166106215,2,0,1,37888,11,6470536578
6334,144806180,21375896,166182076,9,0,1,18432,17,1343254630
6335,144857520,21324579,166182099,5,0,1,23552,11,6484519589
6336,144858100,21360998,166219098,9,0,1,11776,17,7484484048
6337,144860300,21358821,166219121,4,0,1,29184,4,3272313456
6338,144886610,21421530,166308140,7,0,1,21504,16,5153963385
6339,144888300,21419863,166308163,6,0,1,1536,3,10646882759
6340,144892020,21416166,166308186,2,0,1,9728,11,10159309859
6341,144897960,21413860,166311820,6,0,1,29696,3,3074310569
6342,144902280,21409563,166311843,9,0,1,5632,17,5935774138
6343,145028960,10268508,155297468,9,0,0,236032,17,1125055159
6344,145031380,21280486,166311866,6,0,1,4096,3,5835073151
6345,145056060,21352292,166408352,4,0,1,7168,4,8275534847
6346,145060151,10010232,155070383,7,0,0,512,16,7160171343
6347,145121820,10226118,155347938,9,0,0,124416,17,1610779356
6348,145159220,9916646,155075866,9,0,0,17920,17,6261287105
6349,145191620,21216779,166408399,4,0,1,30208,4,9901105091
6350,145207300,21201122,166408422,4,0,1,9216,4,7984859361
6351,145238600,21180476,166419076,4,0,1,3584,4,8810866379
6352,145258630,21160469,166419099,9,0,1,2560,17,4091343228
6353,145299560,10089585,155389145,9,0,0,135168,17,709581617
6354,145315410,10184101,155499511,9,0,0,208896,17,3510002974
6355,145323980,21095142,166419122,6,0,1,3072,3,2639939369
6356,145327541,9494549,154822090,7,0,0,1536,16,2019483559
6357,145352130,21133182,166485312,8,0,1,10240,6,1187633736
6358,145399010,10117996,155517006,9,0,0,57344,17,10452304262
6359,145399310,21086025,166485335,2,0,1,4096,11,2333641960
6360,145419160,21066198,166485358,4,0,1,12800,4,930771665
6361,145431640,21053741,166485381,6,0,1,1536,3,6415639293
6362,145492740,10103236,155595976,9,0,0,177664,17,5810057340
6363,145493010,20992394,166485404,6,0,1,6144,3,4596825228
6364,145535620,9555714,155091334,3,0,0,30208,0,5521275327
6365,145536920,9898805,155435725,3,0,0,152576,0,7458732244
6366,145557960,20927467,166485427,4,0,1,13312,4,4629004447
6367,145563370,20922088,166485458,6,0,1,14848,3,6210462234
6368,145587700,20897781,166485481,9,0,1,6144,17,5785358340
6369,145595230,20890274,166485504,6,0,1,2560,3,3151977696
6370,145629950,20855577,166485527,6,0,1,4608,3,2186139403
6371,145643350,20842200,166485550,4,0,1,4096,4,8470585492
6372,145654500,20831073,166485573,6,0,1,4608,3,5722559784
6373,145668350,20817246,166485596,6,0,1,8192,3,1684694847
6374,145802020,20705150,166507170,4,0,1,19968,4,9348173726
6375,145892430,20614763,166507193,7,0,1,28160,16,2541012153
6376,145894410,20612806,166507216,7,0,1,1024,16,5067779653
6377,145901550,9722811,155624361,9,0,0,71168,17,10325393461
6378,145925581,20581696,166507277,0,0,1,4608,6,5557193386
6379,145930000,20606434,166536434,7,0,1,14848,16,8184452804
6380,145938400,20663589,166601989,4,0,1,53760,4,4391314081
6381,145942950,20680217,166623167,6,0,1,10752,3,3101848792
6382,145955180,9721331,155676511,9,0,0,17408,17,8424203950
6383,145956210,20671111,166627321,7,0,1,20992,16,3945967868
6384,145969300,20658789,166628089,2,0,1,11776,11,7541713892
6385,145990781,9606263,155597044,7,0,0,3072,16,10347561719
6386,146035390,20625781,166661171,2,0,1,22016,11,2062206777
6387,146038231,9559772,155598003,7,0,0,3072,16,2066149337
6388,146058410,20645339,166703749,4,0,1,27648,4,6272511229
6389,146091001,9507493,155598494,7,0,0,1536,16,7632825039
6390,146093181,9534813,155627994,7,0,0,1536,16,580207944
6391,146126010,20597586,166723596,2,0,1,17920,11,8150244584
6392,146133620,20589999,166723619,4,0,1,2048,4,1659174793
6393,146163280,20566318,166729598,7,0,1,21504,16,10484204001
6394,146168940,20565956,166734896,4,0,1,7680,4,3913124739
6395,146171540,20564124,166735664,4,0,1,11776,4,3419813541
6396,146188620,20591592,166780212,1,0,1,38400,6,4007400580
6397,146189591,9492392,155681983,7,0,0,5120,16,8840989654
6398,146191770,20592881,166784651,6,0,1,10752,3,7863136819
6399,146208910,20586737,166795647,6,0,1,14848,3,8532818481
6400,146216610,20668507,166885117,7,0,1,32256,16,9026526878
6401,146226210,20658930,166885140,1,0,1,3584,6,8559288126
6402,146233671,20651492,166885163,0,0,1,7168,6,8199140742
6403,146235980,20649206,166885186,4,0,1,12800,4,8094563905
6404,146251190,20634019,166885209,7,0,1,23040,16,6222347494
6405,146273280,20674172,166947452,1,0,1,6656,6,361864415
6406,146312181,20635294,166947475,0,0,1,5120,6,10566970028
6407,146331580,20617345,166948925,4,0,1,2560,4,1835129680
6408,146342580,20606368,166948948,7,0,1,5120,16,1729267533
6409,146343930,20629775,166973705,7,0,1,53760,16,7441677158
6410,146346150,20637349,166983499,1,0,1,7680,6,4067293541
6411,146354830,20632420,166987250,1,0,1,18944,6,5428163552
6412,146361960,9398201,155760161,3,0,0,44544,0,8980275741
6413,146386290,20622093,167008383,2,0,1,17408,11,5278437592
6414,146408700,20638362,167047062,4,0,1,36352,4,405104994
6415,146436570,20613398,167049968,2,0,1,4608,11,5641795876
6416,146438921,9572019,156010940,7,0,0,1024,16,213199063
6417,146489460,20590227,167079687,6,0,1,27648,3,5702544072
6418,146500740,20707390,167208130,6,0,1,16896,3,3773305727
6419,146503800,20769581,167273381,1,0,1,43008,6,4764943657
6420,146513701,20771993,167285694,0,0,1,14336,6,1627367691
6421,146530130,9455423,155985553,2,0,0,118784,11,1324885279
6422,146538411,9161232,155699643,7,0,0,1536,16,3503112162
6423,146546370,20837035,167383405,6,0,1,6144,3,230148704
6424,146566811,9174652,155741463,7,0,0,1536,16,6834246042
6425,146571870,20811558,167383428,7,0,1,32256,16,1408191975
6426,146571960,20849000,167420960,8,0,1,11264,6,4976939342
6427,146579250,20909423,167488673,7,0,1,52224,16,1999805268
6428,146581340,21014791,167596131,2,0,1,13312,11,10388534876
6429,146603910,9406626,156010536,9,0,0,81920,17,2688861387
6430,146616390,20979764,167596154,6,0,1,3072,3,3051687710
6431,146649370,20946807,167596177,4,0,1,8192,4,4724013658
6432,146661120,20935080,167596200,8,0,1,4096,6,10692600428
6433,146673180,20969583,167642763,2,0,1,32256,11,3029009314
6434,146699400,9346364,156045764,9,0,0,67072,17,1397458111
6435,146713760,20929026,167642786,8,0,1,22528,6,3075683955
6436,146768060,20874749,167642809,1,0,1,8192,6,6897513058
6437,146786790,20872188,167658978,8,0,1,21504,6,556720847
6438,146822160,20862212,167684372,7,0,1,512,16,4392271444
6439,146825081,20859314,167684395,0,0,1,5632,6,4780668959
6440,146855360,20974003,167829363,2,0,1,29696,11,10642814161
6441,146859301,9014964,155874265,7,0,0,3584,16,4488532650
6442,146869650,20987434,167857084,2,0,1,9728,11,6805359385
6443,146876670,20982360,167859030,7,0,1,3072,16,9475855941
6444,146888570,21011320,167899890,8,0,1,6656,6,7495511144
6445,146899200,9454658,156353858,3,0,0,162816,0,2558536069
6446,146915330,20984628,167899958,4,0,1,17920,4,4590131013
6447,146923560,20977704,167901264,6,0,1,2048,3,735410505
6448,146934830,20968719,167903549,7,0,1,25600,16,10038489404
6449,146964130,20961037,167925167,7,0,1,5632,16,8852981903
6450,146968570,20965800,167934370,7,0,1,7680,16,1504984376
6451,146975330,20960346,167935676,7,0,1,2048,16,6489197187
6452,146991500,20982879,167974379,2,0,1,35840,11,4691690415
6453,147001630,21067196,168068826,2,0,1,26112,11,3153646095
6454,147050090,21018759,168068849,1,0,1,10240,6,9080233314
6455,147069160,21166503,168235663,2,0,1,22016,11,1216416101
6456,147192660,21061272,168253932,8,0,1,8704,6,2678424175
6457,147242970,21013548,168256518,7,0,1,4096,16,1047071410
6458,147272200,21012590,168284790,8,0,1,3584,6,6038935706
6459,147299460,20995203,168294663,8,0,1,17408,6,6245100744
6460,147307100,20987909,168295009,7,0,1,512,16,6987548984
6461,147340690,20954985,168295675,8,0,1,1024,6,3281648912
6462,147352820,20955603,168308423,8,0,1,10752,6,1764590966
6463,147381270,20942069,168323339,4,0,1,2048,4,9040034202
6464,147395380,20945079,168340459,4,0,1,12288,4,3754682353
6465,147402471,21005963,168408434,0,0,1,17408,6,4915913883
6466,147426720,9125882,156552602,3,0,0,298496,0,1027324535
6467,147435660,21014636,168450296,8,0,1,30208,6,5008951721
6468,147457280,20993039,168450319,1,0,1,512,6,6672433353
6469,147463550,20986792,168450342,8,0,1,10752,6,9856177512
6470,147476690,20973675,168450365,1,0,1,8704,6,663532051
6471,147504391,9048858,156553249,7,0,0,2048,16,2725790531
6472,147506291,9047449,156553740,7,0,0,1536,16,8019094705
6473,147538280,20912108,168450388,4,0,1,1536,4,9961527249
6474,147614750,20835661,168450411,8,0,1,2560,6,10051951005
6475,147615850,9054018,156669868,3,0,0,6656,0,6592090309
6476,147701340,20749094,168450434,7,0,1,20992,16,6999201552
6477,147763590,20686867,168450457,8,0,1,16384,6,5592897488
6478,147784330,8843671,156628001,9,0,0,50688,17,8616798705
6479,147824660,20625820,168450480,1,0,1,7680,6,4956153250
6480,147848130,20603179,168451309,8,0,1,3072,6,4065272288
6481,147882191,20572664,168454855,0,0,1,5632,6,1511850845
6482,147891880,20566613,168458493,8,0,1,2048,6,2303169810
6483,147954601,8611563,156566164,7,0,0,3584,16,10661615114
6484,147999770,20577546,168577316,7,0,1,10752,16,10669341778
6485,148002671,8554336,156557007,7,0,0,1024,16,6067537236
6486,148014800,8541794,156556594,9,0,0,9216,17,1637822314
6487,148092510,20484821,168577331,1,0,1,3584,6,8488736617
6488,148095310,20482036,168577346,7,0,1,4608,16,7947709694
6489,148098290,20479071,168577361,4,0,1,512,4,5920534483
6490,148124730,20452646,168577376,8,0,1,512,6,2578928280
6491,148145870,20431521,168577391,8,0,1,22528,6,3330576416
6492,148166810,20410596,168577406,1,0,1,4608,6,6700554048
6493,148216620,20367836,168584456,1,0,1,20992,6,4182719173
6494,148236361,8486685,156723046,7,0,0,3584,16,8181847812
6495,148272230,20312241,168584471,7,0,1,52224,16,4520268486
6496,148364060,20222498,168586558,8,0,1,23552,6,10346483302
6497,148368210,20218707,168586917,1,0,1,9728,6,4062390961
6498,148406001,20184782,168590783,0,0,1,18432,6,2678325379
6499,148415440,20272821,168688261,4,0,1,51712,4,1895163861
6500,148417280,20304058,168721338,8,0,1,24576,6,10243561061
6501,148456150,8574018,157030168,3,0,0,15872,0,2631236288
6502,148483820,8559171,157042991,9,0,0,41984,17,10327002187
6503,148500330,20496646,168996976,1,0,1,38912,6,8193548717
6504,148519460,20479142,168998602,1,0,1,2560,6,9606044765
6505,148530230,20525547,169055777,5,0,1,1024,11,8630175286
6506,148575370,20665163,169240533,1,0,1,29696,6,2310706189
6507,148579681,8326095,156905776,7,0,0,512,16,7893722245
6508,148580461,8511752,157092213,7,0,0,512,16,5943464882
6509,148600761,20639795,169240556,0,0,1,22528,6,10261191742
6510,148602981,20753676,169356657,0,0,1,28160,6,9389572340
6511,148605120,8573301,157178421,9,0,0,87040,17,9707443981
6512,148606260,20937822,169544082,8,0,1,10240,6,5343761755
6513,148625700,8639891,157265591,9,0,0,55808,17,8016859984
6514,148632740,20911373,169544113,8,0,1,11776,6,1951799456
6515,148638160,20910071,169548231,7,0,1,52736,16,4027076162
6516,148684960,8368885,157053845,9,0,0,21504,17,4870102058
6517,148685340,20889613,169574953,3,0,1,9728,0,298160083
6518,148703960,8321349,157025309,3,0,0,28672,0,7379910684
6519,148738090,20836886,169574976,7,0,1,5120,16,1751721737
6520,148746051,20828948,169574999,0,0,1,13312,6,2993131115
6521,148772350,20802672,169575022,5,0,1,2560,11,6362781296
6522,148793440,20827024,169620464,1,0,1,6144,6,4964861996
6523,148799481,20821006,169620487,0,0,1,5632,6,3802196185
6524,148808300,20812210,169620510,5,0,1,9728,11,1488223834
6525,148816250,20804283,169620533,8,0,1,15360,6,5822367460
6526,148837420,20783136,169620556,9,0,1,12288,17,6592037619
6527,148863510,20757069,169620579,7,0,1,7168,16,136167414
6528,148865391,8409454,157274845,7,0,0,1536,16,3742186258
6529,148895790,20724812,169620602,1,0,1,3072,6,5569499092
6530,148906310,20714307,169620617,5,0,1,16384,11,467692083
6531,148914700,20705932,169620632,5,0,1,4096,11,4202749377
6532,148920720,20699943,169620663,5,0,1,36352,11,2524467415
6533,148931421,20689329,169620750,0,0,1,8704,6,5819776076
6534,148958280,20662493,169620773,7,0,1,7680,16,9804228839
6535,148978240,20642548,169620788,8,0,1,512,6,9983279511
6536,149022210,20700647,169722857,5,0,1,34304,11,7441828614
6537,149022770,20700102,169722872,1,0,1,17408,6,3098815718
6538,149076840,20654230,169731070,8,0,1,14336,6,3423628453
6539,149080171,8349457,157429628,7,0,0,512,16,7394615566
6540,149098181,8006057,157104238,7,0,0,1024,16,7691893310
6541,149118100,20612985,169731085,8,0,1,7168,6,6939062829
6542,149132340,20598760,169731100,8,0,1,46080,6,701163418
6543,149145540,20585591,169731131,7,0,1,4096,16,1734857046
6544,149178691,20552455,169731146,0,0,1,9728,6,9929159601
6545,149181140,8509495,157690635,3,0,0,150528,0,7484638188
6546,149184120,8243888,157428008,9,0,0,117760,17,5528755420
6547,149204110,20527051,169731161,8,0,1,32256,6,5079293963
6548,149222151,20511885,169734036,0,0,1,28672,6,102337977
6549,149248670,20491948,169740618,7,0,1,14848,16,6749528977
6550,149251400,8727583,157978983,3,0,0,282624,0,8668515172
6551,149252041,20493723,169745764,0,0,1,8192,6,10603303264
6552,149314531,20464410,169778941,0,0,1,5120,6,2804933829
6553,149316781,20521604,169838385,0,0,1,24064,6,6437865391
6554,149320900,20519786,169840686,7,0,1,3584,16,3953172746
6555,149347280,20494037,169841317,7,0,1,11264,16,7532774108
6556,149401500,20447974,169849474,8,0,1,11264,6,9185498498
6557,149434900,8600921,158035821,9,0,0,79872,17,5717450379
6558,149436541,8254608,157691149,7,0,0,1536,16,8263454746
6559,149437380,20415570,169852950,1,0,1,2560,6,3567904261
6560,149451921,20491140,169943061,0,0,1,35328,6,8560100982
6561,149502871,20443416,169946287,0,0,1,5120,6,8318319750
6562,149565330,20395279,169960609,8,0,1,6656,6,10628517411
6563,149585490,20399234,169984724,1,0,1,13312,6,7757484184
6564,149587720,8266212,157853932,3,0,0,90112,0,8923118251
6565,149593310,8193978,157787288,9,0,0,20480,17,6701142265
6566,149597610,8116340,157713950,3,0,0,12800,0,6979485444
6567,149613270,20416411,170029681,1,0,1,3072,6,9509976029
6568,149633490,20396206,170029696,1,0,1,2048,6,9746200292
6569,149635200,20394511,170029711,8,0,1,13312,6,236613730
6570,149646950,20382776,170029726,7,0,1,6144,16,1742946937
6571,149648140,8236536,157884676,9,0,0,29696,17,2251345100
6572,149655500,20374241,170029741,1,0,1,1536,6,2198888547
6573,149697840,20466482,170164322,8,0,1,35328,6,1642405129
6574,149780090,8371668,158151758,9,0,0,221696,17,1749553719
6575,149782190,8573257,158355447,9,0,0,38912,17,8415713425
6576,149782280,20382057,170164337,7,0,1,8704,16,665067060
6577,149797580,20378175,170175755,8,0,1,14336,6,8236609685
6578,149889321,20286449,170175770,0,0,1,5120,6,8929069605
6579,149920690,20255095,170175785,1,0,1,11264,6,286074247
6580,149940180,20235636,170175816,7,0,1,22528,16,28662252
6581,149958040,20217791,170175831,7,0,1,6656,16,9499795025
6582,150009180,8334388,158343568,9,0,0,191488,17,3175846400
6583,150025300,8422886,158448186,9,0,0,112128,17,576292660
6584,150096260,8465150,158561410,9,0,0,355840,17,9254058890
6585,150099360,20077974,170177334,7,0,1,67584,16,2043888187
6586,150111750,8474799,158586549,3,0,0,82432,0,1665593580
6587,150124310,20066625,170190935,7,0,1,29696,16,6269929220
6588,150134630,20058277,170192907,7,0,1,3072,16,147534911
6589,150137490,20078891,170216381,8,0,1,20480,6,630574937
6590,150186030,8576711,158762741,3,0,0,150528,0,1269759736
6591,150204440,20014988,170219428,1,0,1,14336,6,1320259384
6592,150222640,20011475,170234115,1,0,1,20992,6,3415025060
6593,150248281,8027708,158275989,7,0,0,1024,16,952964980
6594,150274391,8602500,158876891,7,0,0,3584,16,967811199
6595,150323330,19914971,170238301,1,0,1,6656,6,4721928177
6596,150456460,8260394,158716854,9,0,0,76288,17,7585721063
6597,150494570,8348365,158842935,3,0,0,96768,0,7310181012
6598,150516400,19730422,170246822,1,0,1,15360,6,10502562922
6599,150542860,19726083,170268943,7,0,1,4608,16,3736377918
6600,150546440,8388421,158934861,9,0,0,170496,17,4887341640
6601,150591090,19682782,170273872,1,0,1,25088,6,4239501705
6602,150600470,8450323,159050793,3,0,0,228352,0,6074615340
6603,150645210,19645425,170290635,1,0,1,19968,6,8454361269
6604,150649100,19781236,170430336,6,0,1,6656,3,2287113970
6605,150673970,19756381,170430351,8,0,1,1024,6,7588687385
6606,150708720,19721646,170430366,8,0,1,7168,6,10380512850
6607,150745241,8112714,158857955,7,0,0,2048,16,2037796317
6608,150782240,8282928,159065168,3,0,0,47104,0,9760184054
6609,150847300,7960126,158807426,9,0,0,146432,17,7817218310
6610,150872070,19576077,170448147,1,0,1,17920,6,6437841649
6611,150886350,19571590,170457940,1,0,1,24064,6,10083096282
6612,150948860,19871872,170820732,1,0,1,512,6,5876574916
6613,150966350,19854397,170820747,8,0,1,1024,6,9640435648
6614,150992770,8310152,159302922,3,0,0,403456,0,6745588840
6615,151079560,7857196,158936756,3,0,0,6144,0,2832753770
6616,151089800,7881699,158971499,9,0,0,51200,17,8320590733
6617,151115210,19705552,170820762,6,0,1,3072,3,2602406705
6618,151132370,19688423,170820793,1,0,1,4096,6,9256483578
6619,151180400,19640408,170820808,1,0,1,9728,6,7665320809
6620,151182350,7977436,159159786,9,0,0,24576,17,10714304796
6621,151190160,7913974,159104134,9,0,0,14336,17,5815181741
6622,151255731,7716267,158971998,7,0,0,1536,16,2198557644
6623,151297921,7787974,159085895,7,0,0,11776,16,5090718032
6624,151320030,19536424,170856454,8,0,1,3584,6,7777439006
6625,151322631,7772458,159095089,7,0,0,1024,16,1557242100
6626,151338780,19592588,170931368,3,0,1,15872,0,6880723778
6627,151374590,19687232,171061822,8,0,1,15872,6,1653930448
6628,151389310,19672551,171061861,9,0,1,14848,17,3050691181
6629,151392670,19669246,171061916,7,0,1,32768,16,7238209547
6630,151397361,7735041,159132402,7,0,0,5120,16,2307617531
6631,151401700,7984479,159386179,9,0,0,206848,17,7913362535
6632,151426760,19635171,171061931,9,0,1,5120,17,9885401278
6633,151439850,19777360,171217210,1,0,1,53248,6,3616060848
6634,151455950,8108107,159564057,3,0,0,385536,0,3210716434
6635,151459691,7927189,159386880,7,0,0,2048,16,4308429286
6636,151469510,19861892,171331402,3,0,1,20992,0,9669957212
6637,151478170,19865922,171344092,1,0,1,31232,6,4646592578
6638,151521550,19823848,171345398,1,0,1,2048,6,3947283640
6639,151539870,19932237,171472107,1,0,1,9728,6,7593890385
6640,151587911,7735221,159323132,7,0,0,1536,16,6666102301
6641,151593370,19878752,171472122,1,0,1,7680,6,10433902675
6642,151635410,19836727,171472137,3,0,1,17408,0,3824467849
6643,151639430,19832722,171472152,8,0,1,14336,6,5385043665
6644,151645651,7658230,159303881,7,0,0,3072,16,2317589838
6645,151653580,7929949,159583529,3,0,0,52736,0,4586201541
6646,151654151,7782704,159436855,7,0,0,5120,16,5587258489
6647,151674581,7892719,159567300,7,0,0,1536,16,3342993165
6648,151694800,19777367,171472167,8,0,1,29696,6,9620870632
6649,151722150,19750032,171472182,6,0,1,4608,3,3854425704
6650,151738530,19734046,171472576,3,0,1,2048,0,7338162285
6651,151755240,19926333,171681573,3,0,1,8704,0,1063691887
6652,151813581,7750709,159564290,7,0,0,512,16,4036195227
6653,151821550,19905320,171726870,1,0,1,6656,6,3226951845
6654,151829620,20174310,172003930,1,0,1,6656,6,10121357133
6655,151867990,20193113,172061103,3,0,1,74752,0,8065340588
6656,151870481,7737660,159608141,7,0,0,3584,16,7604565827
6657,151888980,20295996,172184976,8,0,1,67584,6,9230838564
6658,151896860,20288131,172184991,8,0,1,2560,6,2358940232
6659,151993900,7747117,159741017,3,0,0,124928,0,2314485681
6660,152084290,20100716,172185006,1,0,1,512,6,8278331671
6661,152093730,20096938,172190668,8,0,1,9216,6,346595188
6662,152178631,7388178,159566809,7,0,0,8192,16,6074140107
6663,152196900,19993981,172190881,3,0,1,3584,0,3433626148
6664,152258041,7483467,159741508,7,0,0,1536,16,2765687236
6665,152266360,19928067,172194427,1,0,1,5632,6,10037205195
6666,152268020,7575388,159843408,9,0,0,49152,17,8949129942
6667,152273091,7644124,159917215,7,0,0,1536,16,7535634396
6668,152300301,7665887,159966188,7,0,0,14336,16,2312226759
6669,152343560,19889351,172232911,3,0,1,3072,0,848897179
6670,152354510,7720751,160075261,3,0,0,25088,0,4462430909
6671,152385160,19852257,172237417,8,0,1,7168,6,3397509378
6672,152399760,19839283,172239043,8,0,1,2560,6,148413057
6673,152400180,19840143,172240323,8,0,1,14336,6,618209347
6674,152406870,19926252,172333122,3,0,1,1024,0,5895904751
6675,152408830,7552320,159961150,9,0,0,96768,17,5569337418
6676,152465560,19867577,172333137,8,0,1,6656,6,4048908501
6677,152477250,19855902,172333152,1,0,1,6656,6,4607054763
6678,152478210,7879789,160357999,9,0,0,263168,17,8366778415
6679,152505741,19861449,172367190,0,0,1,46080,6,3291712847
6680,152507140,19860073,172367213,7,0,1,4096,16,9470396654
6681,152585970,19781258,172367228,8,0,1,4608,6,1803503228
6682,152597040,19770203,172367243,8,0,1,11264,6,2240381567
6683,152663611,19715399,172379010,0,0,1,512,6,3009132298
6684,152675831,7285966,159961797,7,0,0,2048,16,212728490
6685,152679620,19824145,172503765,8,0,1,46592,6,2172112296
6686,152711450,19844915,172556365,8,0,1,55296,6,3689308008
6687,152765821,19847500,172613321,0,0,1,22016,6,4375990344
6688,152843290,19829661,172672951,8,0,1,16896,6,10010137622
6689,152850611,7317045,160167656,7,0,0,3584,16,9629162030
6690,152868500,19804482,172672982,3,0,1,32256,0,3683054802
6691,152893840,7532376,160426216,3,0,0,207872,0,5423857733
6692,153025860,7101610,160127470,3,0,0,5120,0,8817155477
6693,153049891,19624492,172674383,0,0,1,8704,6,1263758008
6694,153107760,19584144,172691904,8,0,1,29696,6,194583744
6695,153148360,19543559,172691919,6,0,1,1024,3,1966334650
6696,153151270,7345535,160496805,3,0,0,154112,0,10474852638
6697,153169551,19522383,172691934,0,0,1,29184,6,10663461021
6698,153309680,19428579,172738259,3,0,1,35328,0,9827830111
6699,153347981,6754719,160102700,7,0,0,1024,16,9529106144
6700,153616120,19124102,172740222,8,0,1,24576,6,4919654946
6701,153622330,19129857,172752187,8,0,1,2560,6,10729220953
6702,153640910,6808893,160449803,9,0,0,77312,17,8084155321
6703,153749350,6488829,160238179,9,0,0,31232,17,8030578598
6704,153774610,6782793,160557403,9,0,0,115712,17,7003911080
6705,153817160,6400691,160217851,9,0,0,33280,17,2340449801
6706,153869730,18892975,172762705,4,0,1,19968,4,509472064
6707,153878371,6480835,160359206,7,0,0,512,16,5524774921
6708,153901470,18911575,172813045,5,0,1,9216,11,5545590854
6709,154056510,18756550,172813060,8,0,1,16896,6,4115759331
6710,154070160,18742915,172813075,8,0,1,6144,6,4667986440
6711,154084530,18754467,172838997,8,0,1,52736,6,6139537673
6712,154133030,18755658,172888688,5,0,1,12800,11,3878716947
6713,154168270,18747626,172915896,8,0,1,47616,6,8842661457
6714,154207880,18727674,172935554,5,0,1,13824,11,10435320854
6715,154215451,6143576,160359027,7,0,0,3072,16,9175183603
6716,154254150,18700237,172954387,8,0,1,9728,6,8722355290
6717,154268151,6094666,160362817,7,0,0,11776,16,8645291677
6718,154296640,18722259,173018899,5,0,1,27136,11,4722810045
6719,154504060,18514854,173018914,5,0,1,33792,11,4983191818
6720,154519210,18499727,173018937,6,0,1,18432,3,5584624322
6721,154552160,18502808,173054968,5,0,1,49664,11,6540788066
6722,154642830,18438327,173081157,8,0,1,2048,6,2200105525
6723,154734740,18346432,173081172,8,0,1,2048,6,216479636
6724,154795380,18285807,173081187,5,0,1,10240,11,9756935454
6725,154814110,18267092,173081202,6,0,1,1024,3,2339854177
6726,154830610,18251389,173081999,8,0,1,3072,6,1999944508
6727,154833820,18250765,173084585,6,0,1,4096,3,4125562706
6728,154909930,18176921,173086851,8,0,1,3584,6,2973829693
6729,154953750,6202856,161156606,9,0,0,207360,17,1615739014
6730,155012520,18075304,173087824,8,0,1,12800,6,8548768593
6731,155016520,18112199,173128719,6,0,1,41472,3,5762731381
6732,155096180,18088510,173184690,8,0,1,21504,6,1429999533
6733,155130490,18059750,173190240,8,0,1,37376,6,5510297396
6734,155137330,18104410,173241740,5,0,1,35328,11,9755609011
6735,155163900,18089382,173253282,8,0,1,7168,6,3136336771
6736,155244741,5609291,160854032,7,0,0,2560,16,4865166048
6737,155281530,17974836,173256366,8,0,1,4608,6,1233788039
6738,155287610,17971022,173258632,9,0,1,3584,17,6609333421
6739,155380480,5902154,161282634,9,0,0,98304,17,8035733804
6740,155382430,17893729,173276159,5,0,1,35840,11,9332803751
6741,155453350,17823795,173277145,5,0,1,1536,11,2679613170
6742,155612690,17665121,173277811,8,0,1,1024,6,7338767642
6743,155617900,5326156,160944056,9,0,0,76800,17,2832850891
6744,155645600,17633517,173279117,8,0,1,2048,6,8478355146
6745,155647220,17635763,173282983,5,0,1,6144,11,8775060643
6746,155652350,17632259,173284609,8,0,1,2560,6,3826931605
6747,155696730,17590145,173286875,6,0,1,3584,3,4541982865
6748,155732741,5140813,160873554,7,0,0,2560,16,45015108
6749,155772580,17518164,173290744,8,0,1,3072,6,4394440939
6750,155794550,5370705,161165255,9,0,0,28160,17,9799563216
6751,155820290,17484871,173305161,6,0,1,9216,3,2238609241
6752,155820340,17486127,173306467,5,0,1,2048,11,4099351721
6753,155836200,17472533,173308733,5,0,1,3584,11,5954517285
6754,155841760,5251620,161093380,9,0,0,215552,17,516587190
6755,155926720,17387852,173314572,5,0,1,13312,11,3082706966
6756,155948711,5062290,161011001,7,0,0,11776,16,8446508229
6757,155983820,17342548,173326368,5,0,1,23552,11,8664596126
6758,156042030,17286758,173328788,8,0,1,12288,6,7763031724
6759,156047510,17286424,173333934,5,0,1,8192,11,8440454175
6760,156094420,17268515,173362935,8,0,1,24576,6,9822178124
6761,156104490,17259111,173363601,8,0,1,11264,6,10202777615
6762,156124450,17248976,173373426,5,0,1,17408,11,9257497569
6763,156193410,5248149,161441559,9,0,0,160256,17,4237810291
6764,156252150,17145336,173397486,8,0,1,48128,6,5244511266
6765,156277330,17126733,173404063,8,0,1,14848,6,535413193
6766,156314110,17114081,173428191,8,0,1,17920,6,8650796175
6767,156415350,17053043,173468393,8,0,1,9216,6,1666312528
6768,156416210,17053259,173469469,8,0,1,13312,6,3055069151
6769,156418030,4895223,161313253,9,0,0,94720,17,2241309779
6770,156436000,17067423,173503423,5,0,1,19968,11,5723901083
6771,156437190,17070419,173507609,8,0,1,6656,6,600241675
6772,156458300,17050935,173509235,5,0,1,2560,11,4289828707
6773,156523490,16987385,173510875,8,0,1,24064,6,3885957157
6774,156537030,16991281,173528311,6,0,1,10752,3,2210145680
6775,156540020,16990237,173530257,8,0,1,3072,6,3821257000
6776,156771110,5086209,161857319,9,0,0,435200,17,2991925068
6777,156868080,16677906,173545986,8,0,1,8192,6,2105098955
6778,156869370,16680596,173549966,6,0,1,15872,3,7525405932
6779,156889580,16880387,173769967,6,0,1,40960,3,1216936666
6780,156930200,16839782,173769982,8,0,1,4096,6,7968323779
6781,156965891,5043279,162009170,7,0,0,2560,16,7066714062
6782,157046371,16723626,173769997,0,0,1,8704,6,8145489217
6783,157085881,4781028,161866909,7,0,0,5632,16,10313369011
6784,157090910,16679102,173770012,8,0,1,5120,6,7410198521
6785,157105280,16664747,173770027,6,0,1,6656,3,7742613895
6786,157137360,16632682,173770042,6,0,1,12288,3,1436146293
6787,157177161,4680337,161857498,7,0,0,512,16,3158628814
6788,157202331,4292671,161495002,7,0,0,3072,16,10599584015
6789,157241901,4623269,161865170,7,0,0,3584,16,1469984575
6790,157278900,16491157,173770057,8,0,1,8704,6,10565416151
6791,157327760,16475563,173803323,8,0,1,3584,6,10029309505
6792,157391510,16411836,173803346,8,0,1,1536,6,10064590939
6793,157418790,16384571,173803361,8,0,1,1536,6,899232500
6794,157479581,4665363,162144944,7,0,0,5120,16,4711698237
6795,157562150,4353044,161915194,9,0,0,84480,17,5207865548
6796,157626730,16176646,173803376,8,0,1,7168,6,9127620528
6797,157708540,16094851,173803391,6,0,1,5120,3,7134936306
6798,157749340,4393997,162143337,9,0,0,355840,17,10377481341
6799,157767860,16035546,173803406,2,0,1,11776,11,5423566372
6800,157864001,3802295,161666296,7,0,0,1536,16,8255506590
6801,157864600,15938821,173803421,2,0,1,14848,11,5639134126
6802,157906120,15897316,173803436,4,0,1,6656,4,1410960109
6803,157939030,4069337,162008367,9,0,0,176128,17,8177653554
6804,157960170,15843281,173803451,6,0,1,9216,3,1652725385
6805,157982130,3881902,161864032,9,0,0,20992,17,3127407440
6806,158008010,4258882,162266892,9,0,0,116736,17,3191094601
6807,158083920,15926542,174010462,6,0,1,28160,3,10022848182
6808,158128580,15939988,174068568,6,0,1,15360,3,5352084591
6809,158133420,15993646,174127066,8,0,1,23552,6,5860263267
6810,158145621,3771187,161916808,7,0,0,5120,16,163004131
6811,158148550,16031693,174180243,6,0,1,4608,3,9735067840
6812,158166010,16014248,174180258,6,0,1,3584,3,7813444318
6813,158240440,15939833,174180273,6,0,1,5120,3,2038928158
6814,158246540,15976101,174222641,8,0,1,29184,6,6690471767
6815,158246900,15979651,174226551,2,0,1,1536,11,5768782951
6816,158257560,16103430,174360990,7,0,1,58880,16,512501048
6817,158404410,4144400,162548810,9,0,0,124928,17,5939359334
6818,158408620,15952385,174361005,9,0,1,10240,17,3355253497
6819,158436790,3868274,162305064,9,0,0,90112,17,2025517538
6820,158493960,4100719,162594679,9,0,0,67072,17,5415060171
6821,158515670,15854101,174369771,6,0,1,12800,3,6288935708
6822,158579941,3436926,162016867,7,0,0,1536,16,10176147209
6823,158603090,15789971,174393061,8,0,1,6144,6,10588166054
6824,158617580,15775496,174393076,6,0,1,13824,3,3457531066
6825,158624040,3834236,162458276,9,0,0,217088,17,1682947438
6826,158700910,15692189,174393099,8,0,1,16896,6,5637510136
6827,158701910,3653719,162355629,2,0,0,55296,11,10674365700
6828,158702270,15698254,174400524,6,0,1,512,3,3244925008
6829,158735321,3284300,162019621,7,0,0,3072,16,1594589346
6830,158742010,15664006,174406016,6,0,1,17920,3,7728952472
6831,158808620,15659954,174468574,6,0,1,6144,3,3946933817
6832,158872780,15601652,174474432,2,0,1,30208,11,7304534366
6833,158883790,3582020,162465810,9,0,0,24576,17,4611300942
6834,158941080,3380143,162321223,2,0,0,2048,11,3473380995
6835,158987650,15563177,174550827,7,0,1,29696,16,6400449462
6836,159025560,15535710,174561270,2,0,1,8192,11,4607439713
6837,159040320,15522333,174562653,7,0,1,14848,16,118043932
6838,159047890,15533342,174581232,7,0,1,18944,16,2601979885
6839,159054090,15619924,174674014,3,0,1,26112,0,6129308010
6840,159122540,15551497,174674037,2,0,1,73216,11,3807019203
6841,159142941,3246641,162389582,7,0,0,4608,16,8984860767
6842,159236150,15445337,174681487,4,0,1,36352,4,10109584468
6843,159246081,3328139,162574220,7,0,0,512,16,6998154949
6844,159289090,3382839,162671929,2,0,0,159744,11,6966633690
6845,159294270,15394800,174689070,8,0,1,9728,6,8589112289
6846,159338570,15353086,174691656,2,0,1,4096,11,7458109329
6847,159341400,15357405,174698805,7,0,1,2560,16,3595436491
6848,159405260,15333161,174738421,2,0,1,63488,11,3516611721
6849,159408120,15438987,174847107,2,0,1,17920,11,3074014108
6850,159434060,15413078,174847138,8,0,1,49664,6,1148306920
6851,159480110,15367043,174847153,8,0,1,8192,6,2108998041
6852,159503110,15348140,174851250,2,0,1,9728,11,6993208076
6853,159521460,15336664,174858124,8,0,1,13824,6,1365994474
6854,159561200,15299830,174861030,2,0,1,4608,11,9426619934
6855,159566580,15301838,174868418,8,0,1,16384,6,9636202073
6856,159622860,15258597,174881457,8,0,1,2560,6,6998264673
6857,159694610,15194541,174889151,8,0,1,36864,6,488446742
6858,159717130,15278826,174995956,2,0,1,35840,11,1527962167
6859,159731870,15402935,175134805,2,0,1,43520,11,4713261045
6860,159743230,3211168,162954398,2,0,0,223232,11,2002428451
6861,159759660,15404059,175163719,7,0,1,24576,16,8275018515
6862,159785760,15404509,175190269,2,0,1,6144,11,6445876727
6863,159800740,15389544,175190284,2,0,1,30208,11,1274614710
6864,159845860,15440646,175286506,2,0,1,65536,11,8722068641
6865,159862910,15438276,175301186,8,0,1,15360,6,2051135041
6866,159873570,3217552,163091122,2,0,0,229888,11,8903479737
6867,159903530,15752900,175656430,4,0,1,114176,4,7915656006
6868,159904400,15753656,175658056,7,0,1,2560,16,2287789565
6869,159915490,15743232,175658722,1,0,1,11264,6,10292585669
6870,159919330,3077679,162997009,9,0,0,139776,17,6863877040
6871,159964930,15738762,175703692,2,0,1,15872,11,10249542066
6872,159969500,15734207,175703707,2,0,1,4096,11,5928420625
6873,160022361,15681361,175703722,0,0,1,5120,6,4358878566
6874,160035011,15690043,175725054,0,0,1,17920,6,7314492688
6875,160060911,15666835,175727746,0,0,1,10752,6,5257102792
6876,160086110,15642942,175729052,1,0,1,2048,6,5037106722
6877,160104300,15699079,175803379,3,0,1,30720,0,4474300428
6878,160117380,15704268,175821648,3,0,1,41984,0,3443621313
6879,160153910,3121329,163275239,9,0,0,146944,17,5505992389
6880,160190850,15646531,175837381,2,0,1,16896,11,1861249119
6881,160239440,15644194,175883634,2,0,1,41472,11,1453127155
6882,160282920,3019770,163302690,2,0,0,37376,11,1142320413
6883,160306040,15580500,175886540,3,0,1,4608,0,2538500331
6884,160322280,15569804,175892084,3,0,1,26112,0,2526021132
6885,160323060,15580464,175903524,2,0,1,6656,11,3055707444
6886,160370440,2859981,163230421,2,0,0,173568,11,4321524858
6887,160397300,15508810,175906110,2,0,1,4096,11,5507847116
6888,160398890,15638257,176037147,8,0,1,6144,6,4451123579
6889,160467460,15569702,176037162,2,0,1,24064,11,1999865244
6890,160506580,3153881,163660461,2,0,0,111616,11,2262547212
6891,160506970,2916724,163423694,2,0,0,82944,11,1406030215
6892,160513760,15523417,176037177,3,0,1,23552,0,9214373487
6893,160526420,2943618,163470038,9,0,0,73728,17,7000078692
6894,160536050,15501142,176037192,2,0,1,35328,11,6724611822
6895,160581061,15456146,176037207,0,0,1,16384,6,6278723549
6896,160583140,3098936,163682076,2,0,0,61440,11,5412190867
6897,160591970,15445252,176037222,2,0,1,14848,11,5924199088
6898,160604210,3363172,163967382,2,0,0,173568,11,6575987048
6899,160624900,15453068,176077968,8,0,1,26112,6,6071172247
6900,160730540,15359166,176089706,5,0,1,512,11,6203198978
6901,160741520,3172932,163914452,9,0,0,208384,17,6661226320
6902,160793480,15296241,176089721,3,0,1,1024,0,2179481567
6903,160826640,15263096,176089736,8,0,1,5632,6,5523488248
6904,160856110,15233641,176089751,3,0,1,6656,0,3145095875
6905,160898750,3315455,164214205,9,0,0,142848,17,1575471466
6906,160903490,2890948,163794438,9,0,0,32768,17,4644889909
6907,160953920,15163106,176117026,3,0,1,43008,0,6879050825
6908,161012450,3045289,164057739,2,0,0,132096,11,2082771646
6909,161024520,15123268,176147788,8,0,1,23040,6,9942081333
6910,161026020,15121783,176147803,5,0,1,3584,11,4269907345
6911,161050630,15097188,176147818,5,0,1,1024,11,8671285076
6912,161053570,15114418,176167988,2,0,1,15872,11,8761067750
6913,161076910,15093885,176170795,3,0,1,6144,0,535201774
6914,161097020,15093435,176190455,7,0,1,30720,16,1189785586
6915,161123150,15106898,176230048,3,0,1,50176,0,10375304448
6916,161129040,15102954,176231994,8,0,1,3072,6,7895078833
6917,161141030,15094190,176235220,2,0,1,5120,11,426811706
6918,161161710,15089166,176250876,7,0,1,7168,16,928673299
6919,161187110,15066992,176254102,2,0,1,5120,11,10610089536
6920,161207450,15049878,176257328,5,0,1,5120,11,3191962373
6921,161212700,15046574,176259274,1,0,1,3072,6,5751353797
6922,161218990,15044790,176263780,5,0,1,7168,11,6511089519
6923,161224020,15041105,176265125,5,0,1,11264,11,10263635048
6924,161238570,15026811,176265381,3,0,1,9216,0,1407215116
6925,161252111,15037907,176290018,0,0,1,12800,6,9666492605
6926,161285730,15004303,176290033,1,0,1,1536,6,9891379328
6927,161348990,14941058,176290048,8,0,1,1024,6,7289750829
6928,161359140,2712998,164072138,2,0,0,47104,11,9769150010
6929,161376610,14925792,176302402,8,0,1,7168,6,10543390767
6930,161388820,14913597,176302417,1,0,1,7680,6,8989199625
6931,161389631,14914328,176303959,0,0,1,4608,6,795442225
6932,161404280,14963944,176368224,9,0,1,75264,17,2415710585
6933,161418000,14960059,176378059,1,0,1,22528,6,8486358075
6934,161420300,2942562,164362862,2,0,0,148992,11,1378652134
6935,161469370,14913454,176382824,1,0,1,7680,6,2974129182
6936,161496750,2634698,164131448,2,0,0,152064,11,9343515537
6937,161513840,14869650,176383490,3,0,1,1024,0,8669628677
6938,161523890,14861546,176385436,5,0,1,3072,11,536439300
6939,161556520,3333923,164890443,9,0,0,810496,17,10218302422
6940,161566150,14827879,176394029,1,0,1,12800,6,4503707206
6941,161574250,14824925,176399175,3,0,1,8192,0,5767662853
6942,161575220,3346733,164921953,9,0,0,102912,17,8193909829
6943,161595790,14812950,176408740,7,0,1,5120,16,8342767043
6944,161608010,14854513,176462523,7,0,1,47104,16,6970007381
6945,161632280,3523265,165155545,2,0,0,380416,11,3418604467
6946,161633511,14829027,176462538,0,0,1,10240,6,5599456554
6947,161661930,14800623,176462553,2,0,1,10240,11,284841106
6948,161682980,14800506,176483486,7,0,1,2048,16,6461952946
6949,161711920,14773192,176485112,7,0,1,2560,16,1513004333
6950,161726430,3313019,165039449,9,0,0,380416,17,3871901341
6951,161756200,14734558,176490758,1,0,1,26624,6,3833349195
6952,161782960,14907052,176690012,3,0,1,90624,0,6968597144
6953,161834650,14859538,176694188,1,0,1,15872,6,7359480473
6954,161838080,14859134,176697214,5,0,1,10240,11,3506430084
6955,161842210,3081239,164923449,2,0,0,4608,11,6250552950
6956,161853170,15020085,176873255,5,0,1,6656,11,5540350751
6957,161937500,14935770,176873270,7,0,1,14336,16,6321334771
6958,161952260,14921025,176873285,1,0,1,11776,6,2649105383
6959,162014040,14877762,176891802,8,0,1,66048,6,1185711723
6960,162023441,14868376,176891817,0,0,1,2560,6,4131426220
6961,162092850,14798982,176891832,1,0,1,25088,6,9821602548
6962,162140550,14751297,176891847,7,0,1,3584,16,852138708
6963,162173610,3023309,165196919,9,0,0,134656,17,9983672155
6964,162264010,14627860,176891870,1,0,1,15360,6,7338128388
6965,162306400,14585517,176891917,1,0,1,47616,6,10584089607
6966,162328571,14563361,176891932,0,0,1,4096,6,4034482872
6967,162357770,14534177,176891947,7,0,1,3584,16,5357839840
6968,162361400,14570240,176931640,7,0,1,37376,16,10612931827
6969,162375870,15008425,177384295,8,0,1,423424,6,8165405211
6970,162464390,15217248,177681638,8,0,1,130048,6,7064417689
6971,162506340,15175313,177681653,1,0,1,512,6,9056294145
6972,162523000,15158668,177681668,3,0,1,1024,0,9213896753
6973,162528751,15152932,177681683,0,0,1,3584,6,5099808895
6974,162550061,15131637,177681698,0,0,1,22016,6,592243288
6975,162565120,15116601,177681721,7,0,1,8192,16,9384939042
6976,162600230,15081506,177681736,8,0,1,10752,6,10679382882
6977,162621500,15124522,177746022,8,0,1,71680,6,4894354694
6978,162656360,2802614,165458974,2,0,0,256512,11,2283645667
6979,162673510,15077545,177751055,1,0,1,7168,6,6949723636
6980,162757590,14993926,177751516,7,0,1,10240,16,9617360580
6981,162784550,14991139,177775689,3,0,1,11264,0,201294392
6982,162792030,2430598,165222628,6,0,0,83968,3,2200223646
6983,162887840,14984199,177872039,1,0,1,92672,6,3836118581
6984,162963600,14908454,177872054,9,0,1,9728,17,1958758505
6985,162967850,14904219,177872069,3,0,1,512,0,9502363478
6986,162978550,14893534,177872084,7,0,1,5120,16,9326649430
6987,162987400,2549556,165536956,6,0,0,198144,3,10081954361
6988,162992560,14879539,177872099,7,0,1,37888,16,8538913726
6989,163108190,14765331,177873521,7,0,1,7680,16,3791508071
6990,163111010,14783950,177894960,1,0,1,37888,6,2591747727
6991,163153890,2659431,165813321,2,0,0,332288,11,9180697828
6992,163173330,14733552,177906882,9,0,1,23552,17,6736025528
6993,163201810,14720164,177921974,3,0,1,38912,0,5184685960
6994,163301910,14645160,177947070,7,0,1,5632,16,7451282919
6995,163361650,2820403,166182053,6,0,0,241152,3,1877840257
6996,163362741,14584995,177947736,0,0,1,11264,6,7031284544
6997,163524710,2314998,165839708,6,0,0,86528,3,5328452186
6998,163531670,14420572,177952242,3,0,1,7168,0,2175837157
6999,163596990,2660108,166257098,6,0,0,102400,3,1667499551
7000,163604170,1948427,165552597,6,0,0,51200,3,168850710
7001,163633170,14320148,177953318,4,0,1,13312,4,8414266171
7002,163676670,14293005,177969675,4,0,1,17920,4,8947370243
7003,163714570,2693727,166408297,9,0,0,316416,17,8968007081
7004,163716800,2389392,166106192,6,0,0,324096,3,9342289534
7005,163722030,14330312,178052342,9,0,1,31744,17,10023208577
7006,163742950,14309407,178052357,4,0,1,1024,4,3842180592
7007,163804660,14247720,178052380,9,0,1,6656,17,6690787653
7008,163857640,14194911,178052551,3,0,1,17920,0,3427143410
7009,163868930,14193018,178061948,4,0,1,23040,4,2267762171
7010,163877900,14186993,178064893,3,0,1,13824,0,9449928564
7011,163893010,14184697,178077707,3,0,1,20480,0,4165805174
7012,163925160,14172124,178097284,4,0,1,2560,4,3045422350
7013,163938140,14184441,178122581,3,0,1,27136,0,4062003763
7014,163957140,14169973,178127113,3,0,1,7168,0,8082145467
7015,163973990,2334127,166308117,9,0,0,104448,17,7180905115
7016,164003430,2215645,166219075,6,0,0,105472,3,1353898000
7017,164012310,2472979,166485289,9,0,0,217088,17,10514350206
7018,164098120,14034165,178132285,4,0,1,18432,4,1909785866
7019,164187850,13944999,178132849,7,0,1,10752,16,10702734298
7020,164293050,1576366,165869416,9,0,0,25088,17,1998861888
7021,164302910,13842208,178145118,4,0,1,7680,4,5366116450
7022,164322640,2096413,166419053,2,0,0,34816,11,106774543
7023,164339900,13806524,178146424,4,0,1,2048,4,1356151893
7024,164348690,1963107,166311797,2,0,0,11776,11,6849260362
7025,164413120,13742433,178155553,7,0,1,15872,16,5928216721
7026,164439990,13749753,178189743,7,0,1,24576,16,1098883839
7027,164499060,2250968,166750028,2,0,0,3072,11,2156798480
7028,164510860,2212713,166723573,6,0,0,58368,3,7032741309
7029,164512470,13677288,178189758,9,0,1,1024,17,10541946373
7030,164576940,13612841,178189781,9,0,1,5632,17,9041970582
7031,164585350,1921797,166507147,9,0,0,70656,17,3245783268
7032,164608290,13594671,178202961,8,0,1,44544,6,8126216432
7033,164646160,1976984,166623144,6,0,0,59392,3,2880696280
7034,164677790,13543848,178221638,2,0,1,11264,11,9008144659
7035,164687270,13540377,178227647,6,0,1,10240,3,1274707720
7036,164738900,13553271,178292171,5,0,1,22528,11,7647499910
7037,164755320,13544506,178299826,9,0,1,512,17,8502756081
7038,164769700,13784687,178554387,8,0,1,52224,6,3719473604
7039,164803780,13751478,178555258,9,0,1,12288,17,10198434199
7040,164811350,14293405,179104755,8,0,1,219648,6,2597799550
7041,164811880,2073214,166885094,9,0,0,203264,17,4466289179
7042,164842420,1915980,166758400,9,0,0,9216,17,1452264183
7043,164866400,14238370,179104770,7,0,1,13312,16,2855315931
7044,164876270,14228515,179104785,4,0,1,2048,4,2278441395
7045,164886550,14218266,179104816,6,0,1,23040,3,5675616495
7046,164892410,14374188,179266598,9,0,1,94208,17,10679628051
7047,164897360,14369253,179266613,6,0,1,512,3,316366868
7048,164914680,14351948,179266628,9,0,1,20480,17,6155594345
7049,164916560,2344662,167261222,6,0,0,77824,3,1260221802
7050,164929050,14372411,179301461,8,0,1,42496,6,3821866971
7051,164984790,14316686,179301476,9,0,1,29696,17,6341702332
7052,165011780,14289727,179301507,6,0,1,5632,3,8912218661
7053,165028310,14273212,179301522,6,0,1,6656,3,10438694012
7054,165029370,14552090,179581460,8,0,1,414720,6,7609875018
7055,165061420,14546510,179607930,4,0,1,3584,4,1448188801
7056,165083330,14785361,179868691,8,0,1,103936,6,2635739310
7057,165132760,14735946,179868706,6,0,1,9728,3,1178113526
7058,165139360,14735820,179875180,6,0,1,16896,3,1012682115
7059,165238690,14643229,179881919,4,0,1,14848,4,834601157
7060,165250090,14634735,179884825,9,0,1,4608,17,6373649195
7061,165275660,1673242,166948902,9,0,0,4608,17,4640753434
7062,165309940,14696301,180006241,6,0,1,52224,3,741884495
7063,165331530,14739460,180070990,6,0,1,23552,3,360165108
7064,165359720,14717786,180077506,7,0,1,23040,16,2080703340
7065,165370900,14753987,180124887,6,0,1,20992,3,9572362832
7066,165405520,14722273,180127793,7,0,1,4608,16,8136479501
7067,165438320,1509109,166947429,6,0,0,174080,3,2325382715
7068,165447960,14796622,180244582,4,0,1,5632,4,8658626599
7069,165469460,1738647,167208107,2,0,0,51712,11,7651262239
7070,165469960,1913422,167383382,2,0,0,317440,11,8074761739
7071,165528670,1702218,167230888,6,0,0,26624,3,10188993956
7072,165569250,14675347,180244597,9,0,1,4096,17,490906846
7073,165619900,14624712,180244612,3,0,1,27136,0,2135307897
7074,165621380,14714764,180336144,3,0,1,32768,0,8957071739
7075,165627410,14883274,180510684,9,0,1,14336,17,10580467292
7076,165629570,14931178,180560748,6,0,1,2048,3,7867647192
7077,165635500,15080116,180715616,4,0,1,6656,4,10590282512
7078,165647830,15648823,181296653,8,0,1,231936,6,2856329996
7079,165655270,15641406,181296676,9,0,1,17408,17,1719396346
7080,165663860,15632831,181296691,3,0,1,7680,0,8443496212
7081,165700010,16469009,182169019,8,0,1,299520,6,6772563504
7082,165705880,16683801,182389681,3,0,1,61440,0,9660833868
7083,165754820,1645658,167400478,9,0,0,46592,17,9382646959
7084,165759840,1661097,167420937,6,0,0,67072,3,8710131471
7085,165759980,16633394,182393374,6,0,1,27136,3,9803168518
7086,165788150,1854590,167642740,6,0,0,77824,3,4213425188
7087,165793890,16632168,182426058,4,0,1,7168,4,2453877627
7088,165800300,16625773,182426073,3,0,1,512,0,1775648635
7089,165845830,16580258,182426088,4,0,1,512,4,2116121689
7090,165861010,16618533,182479543,9,0,1,29696,17,250267056
7091,165895330,1583964,167479294,2,0,0,37888,11,10278817815
7092,165912030,16588791,182500821,3,0,1,6656,0,4068626129
7093,165914710,16591257,182505967,3,0,1,8192,0,9583539111
7094,165923900,1511438,167435338,6,0,0,11776,3,1326327172
7095,165927260,1458999,167386259,9,0,0,9216,17,2156964764
7096,165932460,1572514,167504974,2,0,0,11264,11,3741718880
7097,165934830,16606570,182541400,9,0,1,12800,17,9192319525
7098,165939660,16632244,182571904,3,0,1,12288,0,5872102609
7099,165958350,16691534,182649884,4,0,1,15360,4,9796243424
7100,165961090,16734935,182696025,7,0,1,33280,16,10138441096
7101,165966240,16729800,182696040,6,0,1,6144,3,9059812443
7102,165983200,16712855,182696055,3,0,1,2560,0,2578544938
7103,165987080,16885368,182872448,3,0,1,9728,0,630132473
7104,166023390,1572718,167596108,2,0,0,197632,11,6969474722
7105,166029530,16842941,182872471,3,0,1,13312,0,2265586733
7106,166109770,1697520,167807290,9,0,0,309248,17,9030291407
7107,166192260,16680226,182872486,9,0,1,8192,17,2729122639
7108,166202050,16730892,182932942,7,0,1,35840,16,2930725078
7109,166207700,1476649,167684349,9,0,0,34304,17,5054880930
7110,166220960,16733400,182954360,3,0,1,8704,0,6146578799
7111,166235990,16718385,182954375,7,0,1,7680,16,10730839648
7112,166269390,16685000,182954390,9,0,1,6144,17,821222274
7113,166330140,16624265,182954405,3,0,1,9216,0,8306334944
7114,166354960,16599460,182954420,6,0,1,3584,3,7328946743
7115,166406010,16704696,183110706,3,0,1,74240,0,7422075286
7116,166417400,16693329,183110729,6,0,1,23040,3,4261411034
7117,166509620,1390247,167899867,9,0,0,120832,17,5333310
7118,166528430,1300902,167829332,2,0,0,54784,11,7566751977
7119,166580770,16529974,183110744,9,0,1,1536,17,3178066533
7120,166580820,1487983,168068803,6,0,0,190976,3,7324607881
7121,166595160,1217457,167812617,6,0,0,17408,3,9754979481
7122,166600450,16548411,183148861,9,0,1,17408,17,9623503304
7123,166733320,940554,167673874,6,0,0,3072,3,4596025081
7124,166863100,16300946,183164046,7,0,1,12800,16,6143633812
7125,166901650,16367562,183269212,7,0,1,27648,16,4374501293
7126,166945140,16454667,183399807,4,0,1,15360,4,5976082824
7127,166972260,16427562,183399822,4,0,1,10752,4,745579729
7128,166980330,16466634,183446964,9,0,1,18432,17,3359796707
7129,166984740,1250900,168235640,9,0,0,104960,17,779418126
7130,167019560,1388779,168408339,6,0,0,195584,3,7987096924
7131,167029610,1255157,168284767,6,0,0,88064,3,6421950256
7132,167030480,16416499,183446979,6,0,1,10752,3,10201664641
7133,167073770,895908,167969678,9,0,0,3584,17,8030981640
7134,167076750,916508,167993258,2,0,0,12288,11,1635241711
7135,167109380,16531792,183641172,9,0,1,72704,17,9276193149
7136,167115710,1461583,168577293,6,0,0,350720,3,8982030684
7137,167191660,16449527,183641187,7,0,1,9216,16,3598551304
7138,167200770,16440432,183641202,9,0,1,3584,17,9313899373
7139,167233170,1217095,168450265,9,0,0,137216,17,1808734228
7140,167240150,1047627,168287777,9,0,0,9728,17,9901038773
7141,167253350,16387867,183641217,6,0,1,23040,3,2703515844
7142,167323640,16340071,183663711,9,0,1,29184,17,7413297957
7143,167343820,16319914,183663734,9,0,1,2048,17,9688319808
7144,167369270,16297070,183666340,4,0,1,29696,4,5990842634
7145,167377050,16313569,183690619,6,0,1,27136,3,2656644338
7146,167377500,860994,168238494,6,0,0,9216,3,3773255168
7147,167394740,16297505,183692245,7,0,1,2560,16,4758199273
7148,167416310,16276191,183692501,7,0,1,9216,16,4559976734
7149,167420560,16309171,183729731,9,0,1,512,17,5353127019
7150,167424950,16308007,183732957,6,0,1,5120,3,7664341109
7151,167456250,16278333,183734583,4,0,1,2560,4,46143753
7152,167457570,1126871,168584441,9,0,0,23040,17,5712128434
7153,167490070,16246459,183736529,7,0,1,3072,16,9558444774
7154,167539540,16315337,183854877,3,0,1,30720,0,4306699
7155,167543610,16317284,183860894,7,0,1,20480,16,6827702789
7156,167605220,16259220,183864440,7,0,1,5632,16,1858459428
7157,167647680,16345300,183992980,3,0,1,61952,0,4799097990
7158,167653500,17003550,184657050,8,0,1,333824,6,313161643
7159,167672190,16984875,184657065,3,0,1,14336,0,4921612537
7160,167680620,17041551,184722171,4,0,1,16384,4,5650584644
7161,167727840,1721504,169449344,2,0,0,304128,11,1556216298
7162,167728910,16993292,184722202,1,0,1,36864,6,8910647991
7163,167752840,17078953,184831793,8,0,1,309760,6,1696433026
7164,167767260,17076047,184843307,4,0,1,1024,4,4397954979
7165,167771130,17081417,184852547,3,0,1,1536,0,3029895387
7166,167811890,17040672,184852562,9,0,1,15360,17,4971969660
7167,167837740,1306380,169144120,9,0,0,278528,17,3053186728
7168,167852880,17010948,184863828,3,0,1,38400,0,3700527029
7169,167855730,17009084,184864814,9,0,1,1536,17,6198697119
7170,167892790,17056247,184949037,8,0,1,133632,6,7269281739
7171,167981200,16980592,184961792,9,0,1,7168,17,998147426
7172,168007240,16955730,184962970,3,0,1,13824,0,1500840277
7173,168024230,1273850,169298080,2,0,0,176640,11,4863706733
7174,168049170,16922864,184972034,4,0,1,33792,4,6585816804
7175,168108090,1512351,169620441,2,0,0,148992,11,10002195031
7176,168129550,16845194,184974744,4,0,1,12288,4,1292604366
7177,168198100,16893520,185091620,8,0,1,73728,6,10654545786
7178,168221800,16877489,185099289,4,0,1,32256,4,5857629187
7179,168224990,1319069,169544059,9,0,0,310784,17,2584231149
7180,168239100,16861815,185100915,9,0,1,2560,17,1876546851
7181,168275620,16830828,185106448,4,0,1,13312,4,4763357689
7182,168285400,1437442,169722842,2,0,0,260096,11,3404329238
7183,168302840,937670,169240510,6,0,0,53760,3,833418201
7184,168311610,16830697,185142307,1,0,1,15872,6,10643338298
7185,168315700,16916362,185232062,4,0,1,23040,4,3615447741
7186,168337980,16894543,185232523,4,0,1,10240,4,2889352252
7187,168354900,982359,169337259,6,0,0,128512,3,4376527010
7188,168383690,16894413,185278103,3,0,1,44032,0,5749963663
7189,168463820,1111110,169574930,6,0,0,87552,3,3990955263
7190,168471180,16847147,185318327,7,0,1,19456,16,6191035591
7191,168478070,534842,169012912,2,0,0,9216,11,5518645407
7192,168478610,16840383,185318993,7,0,1,1024,16,3228703514
7193,168494530,16868088,185362618,1,0,1,37888,6,1616366025
7194,168496590,16871283,185367873,9,0,1,6144,17,9041647238
7195,168498330,858296,169356626,2,0,0,63488,11,6070340393
7196,168517640,17163397,185681037,8,0,1,408064,6,7847327515
7197,168527170,17177251,185704421,9,0,1,39424,17,2394180988
7198,168538270,17168737,185707007,7,0,1,4096,16,4511165725
7199,168538450,17361860,185900310,8,0,1,292864,6,7251403326
7200,168550670,17360822,185911492,3,0,1,8192,0,120850237
7201,168587490,17353300,185940790,4,0,1,14848,4,9353804896
7202,168588280,17352525,185940805,9,0,1,10240,17,3067138756
7203,168601710,17339118,185940828,4,0,1,31232,4,10124335961
7204,168618490,929718,169548208,6,0,0,13312,3,3094305425
7205,168663930,17282171,185946101,1,0,1,3584,6,4937927891
7206,168668100,17279627,185947727,3,0,1,2560,0,7569603022
7207,168723870,18266510,186990380,3,0,1,41984,0,6405869772
7208,168812430,18779025,187591455,4,0,1,31744,4,5885429861
7209,168851590,791989,169643579,9,0,0,74752,17,8298880505
7210,168851830,18739640,187591470,7,0,1,2048,16,7260137278
7211,168880670,19164127,188044797,7,0,1,13824,16,8026978499
7212,168887750,19157201,188044951,4,0,1,8704,4,4891940716
7213,168895350,19807927,188703277,4,0,1,1536,4,2219112979
7214,168916960,19865633,188782593,3,0,1,10240,0,722501879
7215,168917230,813769,169730999,9,0,0,26624,17,2674008938
7216,168996800,843871,169840671,9,0,0,2048,17,8270478060
7217,168996970,20385165,189382135,8,0,1,78848,6,3565918961
7218,168998880,1146692,170145572,2,0,0,353280,11,5080288724
7219,169024890,20380014,189404904,3,0,1,4608,0,5210128215
7220,169088180,20416925,189505105,9,0,1,59904,17,10733729308
7221,169106990,20479958,189586948,7,0,1,2048,16,10103546372
7222,169141990,20734902,189876892,9,0,1,68096,17,1119372743
7223,169155150,20721757,189876907,4,0,1,1024,4,6860899692
7224,169185610,844056,170029666,6,0,0,104448,3,4527347194
7225,169214900,21381420,190596320,9,0,1,176128,17,1241728290
7226,169285210,21398696,190683906,4,0,1,6144,4,9165347233
7227,169295870,698236,169994106,9,0,0,10240,17,7955287134
7228,169310180,21388740,190698920,7,0,1,512,16,7478264361
7229,169313010,21504388,190817398,8,0,1,50688,6,832999333
7230,169341540,21516146,190857686,4,0,1,44544,4,3099443328
7231,169364540,672562,170037102,2,0,0,7168,11,6054886204
7232,169408290,21449778,190858068,4,0,1,1024,4,3760978071
7233,169437960,726347,170164307,2,0,0,61440,11,899197142
7234,169535880,639860,170175740,6,0,0,37376,3,3861363422
7235,169549290,24416999,193966289,9,0,1,816128,17,8627990702
7236,169560010,24494801,194054811,4,0,1,39936,4,6179585506
7237,169560660,25010924,194571584,9,0,1,242688,17,779555792
7238,169580760,24990839,194571599,7,0,1,9216,16,9950034685
7239,169617080,25065090,194682170,4,0,1,145920,4,8992041634
7240,169617490,25068226,194685716,4,0,1,17920,4,1962502308
7241,169627180,1038929,170666109,6,0,0,195584,3,10369894733
7242,169629240,1059512,170688752,9,0,0,74240,17,220499737
7243,169657530,25156925,194814455,9,0,1,98816,17,5197388942
7244,169665070,25149400,194814470,8,0,1,25088,6,7803429088
7245,169690330,739991,170430321,6,0,0,109568,3,7697633719
7246,169690420,1130281,170820701,9,0,0,212480,17,6468869376
7247,169747610,25070235,194817845,9,0,1,43520,17,5693900281
7248,169751070,25072536,194823606,7,0,1,18944,16,5831058622
7249,169792850,25032638,194825488,7,0,1,11776,16,6747741592
7250,169848450,1462999,171311449,2,0,0,309248,11,3376929176
7251,169979620,951725,170931345,6,0,0,10240,3,1658180957
7252,170055311,24771817,194827128,0,0,1,24064,6,6868367208
7253,170085640,976167,171061807,9,0,0,386048,17,7042593400
7254,170102410,1114785,171217195,3,0,0,162816,0,1426862966
7255,170113160,24755743,194868903,5,0,1,48640,11,6565774981
7256,170126100,24879224,195005324,8,0,1,34816,6,6607367126
7257,170179260,1262241,171441501,2,0,0,246784,11,3085522020
7258,170218630,25319669,195538299,9,0,1,129536,17,4147923876
7259,170300240,25453922,195754162,8,0,1,174080,6,9673065436
7260,170316280,850711,171166991,9,0,0,31744,17,5397433987
7261,170347480,809824,171157304,2,0,0,67072,11,10444852048
7262,170357480,25488924,195846404,5,0,1,37376,11,10087153740
7263,170374080,25489849,195863929,9,0,1,12800,17,1097312466
7264,170430980,25432964,195863944,9,0,1,44032,17,7306253341
7265,170452950,870582,171323532,6,0,0,39424,3,6574410605
7266,170554180,777207,171331387,2,0,0,25600,11,6253527381
7267,170613860,301824,170915684,9,0,0,512,17,10157675243
7268,170706390,25350433,196056823,9,0,1,86528,17,8289287294
7269,170757200,25342140,196099340,8,0,1,140800,6,8090251071
7270,170758330,713762,171472092,9,0,0,100352,17,7312920744
7271,170780790,25318565,196099355,3,0,1,512,0,7291597909
7272,170784610,862241,171646851,9,0,0,333312,17,9011330232
7273,170811260,25305761,196117021,4,0,1,21504,4,7380621341
7274,170881940,25235096,196117036,8,0,1,16384,6,2469606414
7275,170928400,437894,171366294,2,0,0,8192,11,309605954
7276,170943980,953372,171897352,9,0,0,138752,17,3532132006
7277,170960970,708079,171669049,6,0,0,31744,3,10633242690
7278,170990630,25218277,196208907,8,0,1,154112,6,476480620
7279,170991040,25385125,196376165,8,0,1,188416,6,5459241880
7280,171027030,494772,171521802,6,0,0,7168,3,6885069119
7281,171027820,631526,171659346,6,0,0,40960,3,4104938158
7282,171047370,1013718,172061088,6,0,0,54272,3,7890082151
7283,171050810,622006,171672816,2,0,0,12288,11,5345123307
7284,171053630,26694049,197747679,9,0,1,303616,17,9323206585
7285,171078050,26673495,197751545,9,0,1,6144,17,3138862596
7286,171114660,27595543,198710203,9,0,1,236032,17,2192183269
7287,171160000,1173107,172333107,2,0,0,282112,11,1612632422
7288,171186910,996788,172183698,2,0,0,99840,11,6355268728
7289,171202490,842039,172044529,9,0,0,133120,17,10637134977
7290,171235280,27557290,198792570,8,0,1,124416,6,684955284
7291,171239080,859834,172098914,2,0,0,121856,11,2074377180
7292,171303600,700315,172003915,6,0,0,349696,3,1532261261
7293,171314440,483587,171798027,9,0,0,5632,17,622328097
7294,171531310,27272530,198803840,6,0,1,37376,3,9073954815
7295,171583760,606877,172190637,6,0,0,18432,3,1821077363
7296,171591390,525191,172116581,6,0,0,57856,3,8541671571
7297,171616480,887246,172503726,2,0,0,191488,11,7958522231
7298,171649730,27154125,198803855,6,0,1,1536,3,3531636776
7299,171670071,27133799,198803870,0,0,1,5120,6,9891798897
7300,171692210,980726,172672936,6,0,0,195584,3,9934073295
7301,171771810,595365,172367175,2,0,0,111616,11,2096193095
7302,171790470,27017346,198807816,3,0,1,3584,0,3015923685
7303,171823911,361050,172184961,7,0,0,4096,16,901261632
7304,171874110,26933729,198807839,6,0,1,33280,3,246880597
7305,171900180,26907674,198807854,3,0,1,4096,0,4702357203
7306,171926680,686610,172613290,6,0,0,180736,3,9140710116
7307,171942110,26865759,198807869,3,0,1,12800,0,10545356609
7308,172003460,912421,172915881,6,0,0,61952,3,9856592790
7309,172041300,404067,172445367,9,0,0,103424,17,7468212231
7310,172068960,26738924,198807884,6,0,1,3584,3,5173928722
7311,172069350,743680,172813030,6,0,0,143360,3,45293276
7312,172083370,779327,172862697,2,0,0,53760,11,3094716325
7313,172094240,26726779,198821019,3,0,1,49664,0,4891348747
7314,172141840,26679743,198821583,3,0,1,10752,0,9317815782
7315,172181830,26671461,198853291,3,0,1,32768,0,2480368551
7316,172186460,26666846,198853306,3,0,1,7168,0,8011839770
7317,172336940,383341,172720281,2,0,0,62464,11,4375531230
7318,172389060,302829,172691889,6,0,0,45056,3,8346157379
7319,172447740,26492938,198940678,7,0,1,13312,16,5200158331
7320,172453480,26487213,198940693,6,0,1,8704,3,682672056
7321,172494950,26648586,199143536,7,0,1,63488,16,6647632400
7322,172542190,26640146,199182336,2,0,1,512,11,2733608922
7323,172558640,26623850,199182490,7,0,1,8704,16,10690027299
7324,172574130,26611586,199185716,2,0,1,5120,11,3623432371
7325,172583260,497882,173081142,9,0,0,41984,17,4358651248
7326,172672680,346204,173018884,2,0,0,160768,11,2547262513
7327,172690000,26520154,199210154,3,0,1,15360,0,5383941962
7328,172692890,26518250,199211140,6,0,1,1536,3,748563492
7329,172718920,26492988,199211908,3,0,1,11776,0,6883562787
7330,172760600,368096,173128696,9,0,0,11776,17,1034882920
7331,172795710,315312,173111022,9,0,0,32256,17,5234034273
7332,172855910,26375489,199231399,2,0,1,43008,11,3422932553
7333,172869840,255245,173125085,2,0,0,46080,11,5972880297
7334,172869970,26395655,199265625,3,0,1,16384,0,4062176479
7335,172877740,26403961,199281701,6,0,1,20992,3,3512737717
7336,172879970,26510735,199390705,3,0,1,5120,0,7277487158
7337,172894140,26496580,199390720,3,0,1,1024,0,6425069691
7338,172925650,26465085,199390735,6,0,1,5120,3,7610513463
7339,172940300,244375,173184675,6,0,0,30720,3,7016993814
7340,172953760,400342,173354102,6,0,0,22016,3,5214733820
7341,172958620,205219,173163839,2,0,0,17920,11,1674625707
7342,173012280,26378494,199390774,2,0,1,17408,11,3563411114
7343,173094940,26349940,199444880,7,0,1,20480,16,6638790331
7344,173099600,26345295,199444895,6,0,1,4608,3,1162061683
7345,173122250,26323611,199445861,7,0,1,512,16,7406178701
7346,173150390,26295486,199445876,7,0,1,8192,16,4971672479
7347,173158880,26623209,199782089,7,0,1,59392,16,5310744652
7348,173169660,26614487,199784147,6,0,1,7168,3,1364527228
7349,173212550,243132,173455682,2,0,0,50688,11,9637891301
7350,173224770,26638108,199862878,6,0,1,52224,3,218447135
7351,173249500,553800,173803300,6,0,0,109056,3,2421985499
7352,173267310,389271,173656581,9,0,0,84992,17,10360644974
7353,173267510,502442,173769952,6,0,0,272384,3,6739086622
7354,173267620,26601240,199868860,2,0,1,24064,11,8707445716
7355,173346240,26522643,199868883,2,0,1,38400,11,6994300730
7356,173423970,26444928,199868898,2,0,1,7168,11,8166736308
7357,173437870,26431051,199868921,2,0,1,26112,11,6302197852
7358,173455400,905575,174360975,6,0,0,365568,3,1934193198
7359,173461960,26406984,199868944,2,0,1,23040,11,7060906742
7360,173524980,655248,174180228,2,0,0,131072,11,8395004097
7361,173525540,448988,173974528,9,0,0,115712,17,8795992210
7362,173529870,529465,174059335,6,0,0,9216,3,6269594658
7363,173547260,579791,174127051,6,0,0,70144,3,10250843159
7364,173551170,26317797,199868967,6,0,1,22016,3,5652915658
7365,173582900,967912,174550812,6,0,0,179712,3,6993114561
7366,173680860,712186,174393046,2,0,0,76288,11,5754013938
7367,173750930,26118052,199868982,2,0,1,8704,11,1844158965
7368,173753010,920981,174673991,9,0,0,217600,17,9697938996
7369,173775180,26093817,199868997,2,0,1,14336,11,1385191038
7370,173872840,496916,174369756,2,0,0,28672,11,177677755
7371,173958010,889074,174847084,2,0,0,323072,11,7033588997
7372,174042940,409480,174452420,2,0,0,69120,11,9341018260
7373,174101790,497478,174599268,6,0,0,40960,3,8757497481
7374,174139330,25740355,199879685,2,0,1,13824,11,9849087722
7375,174195050,25702089,199897139,1,0,1,4608,6,10056385484
7376,174200830,25700815,199901645,1,0,1,7168,6,3961851768
7377,174304670,25610533,199915203,1,0,1,20480,6,1881403912
7378,174310990,765723,175076713,6,0,0,153088,3,4983232007
7379,174394070,25574276,199968346,2,0,1,80384,11,6661474417
7380,174398630,25576009,199974639,1,0,1,10240,6,1336129137
7381,174425140,25550805,199975945,6,0,1,2048,3,925481411
7382,174492760,670936,175163696,6,0,0,94720,3,9191130336
7383,174548750,25431179,199979929,1,0,1,5632,6,5443079427
7384,174559120,25421577,199980697,1,0,1,11776,6,8348574456
7385,174568450,25518962,200087412,1,0,1,29696,6,3322198441
7386,174594000,829388,175423388,2,0,0,152064,11,6214429548
7387,174601380,532459,175133839,6,0,0,109056,3,581933787
7388,174609250,525540,175134790,6,0,0,3072,3,4981499214
7389,174637510,463086,175100596,9,0,0,78336,17,465296453
7390,174653300,342641,174995941,2,0,0,76800,11,4864843997
7391,174671920,518334,175190254,2,0,0,87040,11,10090638974
7392,174682930,25404497,200087427,2,0,1,10240,11,4590462282
7393,174721200,558458,175279658,2,0,0,69632,11,10453125638
7394,174776490,25313183,200089673,2,0,1,15360,11,2266486632
7395,174787620,546043,175333663,9,0,0,33280,17,5575797091
7396,174813020,25276668,200089688,3,0,1,1024,0,5098305378
7397,174900790,25229044,200129834,2,0,1,4096,11,1936254171
7398,174901140,25228741,200129881,2,0,1,23040,11,6972361340
7399,174907260,309254,175216514,2,0,0,33792,11,9306322963
7400,174908770,660508,175569278,6,0,0,171008,3,1061477690
7401,175002660,25127236,200129896,8,0,1,26112,6,5641543252
7402,175102130,601547,175703677,9,0,0,102400,17,6483942811
7403,175108020,695328,175803348,9,0,0,239104,17,10120374304
7404,175118450,25011469,200129919,1,0,1,25088,6,2541694598
7405,175182390,854718,176037108,6,0,0,407040,3,3763817784
7406,175185790,24947435,200133225,2,0,1,5632,11,4517242370
7407,175215600,24917640,200133240,2,0,1,3072,11,3275606758
7408,175226000,586754,175812754,9,0,0,30720,17,2222011754
7409,175250700,24883688,200134388,6,0,1,5120,3,6549893052
7410,175265580,812373,176077953,9,0,0,133632,17,328811231
7411,175275000,24866516,200141516,8,0,1,10240,6,5603423954
7412,175293800,25025627,200319427,2,0,1,71680,11,8781988339
7413,175394210,24956219,200350429,2,0,1,18432,11,2131576316
7414,175419010,670681,176089691,6,0,0,38400,3,3545446487
7415,175517650,24867418,200385068,6,0,1,70656,3,4205860497
7416,175538090,24874192,200412282,6,0,1,4608,3,6742574061
7417,175567210,24845418,200412628,2,0,1,512,11,4115835150
7418,175568760,25038869,200607629,8,0,1,114176,6,8801384221
7419,175574730,573043,176147773,6,0,0,100864,3,2581936552
7420,175591440,25016204,200607644,6,0,1,13824,3,2621854930
7421,175592710,575247,176167957,6,0,0,66048,3,7035072068
7422,175728210,388801,176117011,2,0,0,33280,11,6125427858
7423,175751820,550567,176302387,9,0,0,40448,17,7828178593
7424,175769860,24837807,200607667,6,0,1,3584,3,5521415424
7425,175854630,25200744,201055374,8,0,1,192000,6,3226314995
7426,175868960,421043,176290003,6,0,0,51200,3,3003667808
7427,175879300,583208,176462508,9,0,0,97280,17,2482803055
7428,175893450,467680,176361130,6,0,0,17408,3,10521988561
7429,176047580,25007809,201055389,2,0,1,1536,11,6496409878
7430,176068350,24987054,201055404,7,0,1,512,16,3910391976
7431,176072960,25021872,201094832,6,0,1,21504,3,9325813145
7432,176092000,25007018,201099018,6,0,1,6656,3,8513370349
7433,176152020,721220,176873240,9,0,0,506880,17,5927454491
7434,176152620,225424,176378044,6,0,0,9216,3,6490889645
7435,176200140,24899864,201100004,8,0,1,1536,6,4814201752
7436,176245310,24854848,201100158,6,0,1,8704,3,5412128896
7437,176347020,26550015,202897035,8,0,1,517632,6,9796988804
7438,176354010,26708061,203062071,8,0,1,249344,6,10551863641
7439,176401160,26825324,203226484,8,0,1,116736,6,5420988452
7440,176418360,27387005,203805365,8,0,1,466944,6,5028407082
7441,176444790,446981,176891771,6,0,0,12800,3,2043370953
7442,176469580,418276,176887856,2,0,0,47616,11,2498385808
7443,176547720,543965,177091685,9,0,0,1536,17,6804362965
7444,176564760,27240628,203805388,6,0,1,20992,3,4829836287
7445,176632910,27172493,203805403,6,0,1,25600,3,7784460930
7446,176633890,930432,177564322,6,0,0,29696,3,9115825463
7447,176664600,719672,177384272,2,0,0,73216,11,9204430480
7448,176740770,27064648,203805418,6,0,1,22016,3,5461014168
7449,176824380,605266,177429646,9,0,0,92160,17,4858976836
7450,176825420,677249,177502669,6,0,0,239616,3,8315796915
7451,176859880,502069,177361949,9,0,0,242688,17,4733607492
7452,176864060,26942189,203806249,6,0,1,6144,3,4060309841
7453,176955730,26857304,203813034,8,0,1,16384,6,15288639
7454,176979850,701773,177681623,9,0,0,280064,17,3177880279
7455,177050860,26762520,203813380,6,0,1,512,3,1594659169
7456,177071770,26766930,203838700,6,0,1,28160,3,2247301829
7457,177158420,26681253,203839673,6,0,1,12800,3,4686208959
7458,177186200,26654779,203840979,6,0,1,2048,3,7913612146
7459,177206160,26639325,203845485,8,0,1,19456,6,6740030337
7460,177359810,446367,177806177,2,0,0,23552,11,7642707444
7461,177379160,332714,177711874,9,0,0,10752,17,9896904383
7462,177385720,509225,177894945,9,0,0,31744,17,10155354652
7463,177386610,458551,177845161,6,0,0,115712,3,4134118555
7464,177393880,26459669,203853549,8,0,1,17408,6,2708815392
7465,177452930,419078,177872008,9,0,0,88064,17,8160176409
7466,177487541,26392013,203879554,0,0,1,4096,6,300794425
7467,177547040,26334460,203881500,8,0,1,3072,6,4338337295
7468,177557330,26325041,203882371,3,0,1,12288,0,2627287573
7469,177573340,468816,178042156,2,0,0,124416,11,10619202991
7470,177648930,403389,178052319,9,0,0,33280,17,9987940998
7471,177778200,26127041,203905241,6,0,1,21504,3,2890487932
7472,177801421,26103835,203905256,0,0,1,1536,6,439529016
7473,177831440,26108607,203940047,8,0,1,62464,6,4604942531
7474,177845790,26207190,204052980,7,0,1,50688,16,6713557483
7475,177898930,290798,178189728,0,0,0,74752,6,10071304991
7476,177976750,389993,178366743,1,0,0,53248,6,3027802497
7477,178016510,933116,178949626,6,0,0,439296,3,884374706
7478,178033820,26019506,204053326,7,0,1,512,16,1957012166
7479,178037690,254466,178292156,0,0,0,142848,6,2305832677
7480,178095580,409904,178505484,0,0,0,5632,6,10369447762
7481,178122440,428074,178550514,6,0,0,15360,3,1354871310
7482,178154620,950112,179104732,2,0,0,187904,11,4228375921
7483,178170250,26003060,204173310,2,0,1,43008,11,1905537185
7484,178182940,860113,179043053,1,0,0,176640,6,6263699612
7485,178242110,1148050,179390160,2,0,0,290304,11,7304195538
7486,178318970,929026,179247996,0,0,0,246272,6,7188943130
7487,178397191,25777397,204174588,0,0,1,9728,6,3306257000
7488,178431030,835553,179266583,2,0,0,60928,11,5795664037
7489,178460570,502019,178962589,6,0,0,42496,3,2841073955
7490,178514320,787373,179301693,0,0,0,512,6,5980063976
7491,178517210,617348,179134558,9,0,0,50176,17,8627362378
7492,178562040,730811,179292851,6,0,0,86016,3,1394100205
7493,178635981,25552048,204188029,0,0,1,28672,6,7271752070
7494,178792871,25400906,204193777,0,0,1,27136,6,603200830
7495,178914000,25526110,204440110,1,0,1,121856,6,4055012430
7496,178932511,25643390,204575901,0,0,1,45056,6,9303801208
7497,178948901,25630866,204579767,0,0,1,6144,6,8835473004
7498,178961680,157575,179119255,1,0,0,10752,6,293283946
7499,178996690,304756,179301446,1,0,0,28160,6,4337245291
7500,179011830,25576771,204588601,6,0,1,26112,3,10117492898
7501,179038830,358061,179396891,1,0,0,22016,6,1345477900
7502,179064170,616132,179680302,2,0,0,156672,11,6973243389
7503,179096380,25581846,204678226,4,0,1,5120,4,2123599801
7504,179100490,25577751,204678241,4,0,1,7680,4,6355290969
7505,179158890,758767,179917657,0,0,0,34304,6,10594708938
7506,179159781,25518475,204678256,0,0,1,12288,6,3076906903
7507,179176490,768103,179944593,6,0,0,11776,3,1316326791
7508,179240840,765029,180005869,6,0,0,93184,3,5899114721
7509,179240850,627826,179868676,1,0,0,225792,6,10451503787
7510,179326750,650712,179977462,0,0,0,96256,6,6019368981
7511,179428511,25249768,204678279,0,0,1,6144,6,5833133484
7512,179429550,25248744,204678294,4,0,1,4096,4,6640014510
7513,179431860,812707,180244567,0,0,0,351744,6,7580946907
7514,179486440,550523,180036963,1,0,0,81920,6,183115839
7515,179495850,840271,180336121,2,0,0,247808,11,9397265877
7516,179564881,25113428,204678309,0,0,1,1024,6,3792379374
7517,179570090,25108234,204678324,4,0,1,10752,4,4849091761
7518,179573880,25104459,204678339,4,0,1,5120,4,313358044
7519,179597320,1118281,180715601,0,0,0,124928,6,7081405506
7520,179613890,749584,180363474,0,0,0,71680,6,10346215097
7521,179653161,25025193,204678354,0,0,1,19968,6,6312675237
7522,179655220,603915,180259135,2,0,0,47616,11,9908694141
7523,179663921,25089927,204753848,0,0,1,57344,6,7102934066
7524,179673120,938269,180611389,9,0,0,39936,17,1272027974
7525,179701610,25261874,204963484,8,0,1,306176,6,6273183967
7526,179720440,926200,180646640,6,0,0,92672,3,2648987916
7527,179730510,755636,180486146,1,0,0,202240,6,3991665878
7528,179745790,25233980,204979770,4,0,1,19456,4,7091159061
7529,179749701,25235356,204985057,0,0,1,16896,6,5205336312
7530,179781920,590492,180372412,2,0,0,19968,11,4399217499
7531,179908741,25079222,204987963,0,0,1,4608,6,3946732511
7532,179913811,25074511,204988322,0,0,1,9728,6,633909670
7533,179935240,406379,180341619,1,0,0,17920,6,7886133653
7534,180010960,1285343,181296303,1,0,0,669696,6,4636253357
7535,180063630,996815,181060445,6,0,0,233984,3,8239855907
7536,180084360,1484807,181569167,0,0,0,438784,6,9637924028
7537,180089231,24900679,204989910,0,0,1,15872,6,5412443030
7538,180219750,607341,180827091,1,0,0,2048,6,9150031282
7539,180239790,24756380,204996170,3,0,1,29696,0,599239837
7540,180245980,24755085,205001065,4,0,1,6656,4,3403303404
7541,180286860,24718391,205005251,4,0,1,6656,4,7097971050
7542,180412020,535611,180947631,2,0,0,29696,11,1543599323
7543,180433221,24574616,205007837,0,0,1,4096,6,3342558665
7544,180458590,386033,180844623,0,0,0,3584,6,1177761872
7545,180460240,836390,181296630,0,0,0,1024,6,6159182421
7546,180568000,1414219,181982219,2,0,0,217088,11,6647365002
7547,180573570,1072122,181645692,9,0,0,67584,17,5654489225
7548,180627020,24387896,205014916,1,0,1,33792,6,5455201754
7549,180646690,978371,181625061,2,0,0,167424,11,5497713646
7550,180654190,1514814,182169004,2,0,0,181760,11,2221290397
7551,180762940,1060599,181823539,2,0,0,60928,11,2898704514
7552,180812510,24263820,205076330,1,0,1,57856,6,8539039693
7553,180827570,24346362,205173932,1,0,1,35840,6,1986499836
7554,180842861,24332556,205175417,0,0,1,15360,6,72487985
7555,180845830,513436,181359266,6,0,0,84992,3,6096131085
7556,180848310,1194062,182042372,9,0,0,95744,17,4884083982
7557,180850300,24373501,205223801,4,0,1,20480,4,6163635686
7558,180890490,1437916,182328406,6,0,0,199680,3,3143308029
7559,180903690,1437835,182341525,1,0,0,43008,6,17681170
7560,180961250,453402,181414652,9,0,0,23552,17,9229298884
7561,180991250,1434793,182426043,2,0,0,24576,11,5583686977
7562,180997880,1874553,182872433,1,0,0,572416,6,7687857536
7563,181002580,571446,181574026,6,0,0,15872,3,1475215393
7564,181005931,24219816,205225747,0,0,1,3072,6,6757273214
7565,181010170,24220851,205231021,1,0,1,11264,6,10347485748
7566,181022311,24228109,205250420,0,0,1,31744,6,779362041
7567,181033440,267026,181300466,2,0,0,12288,11,8698060919
7568,181147850,2000817,183148667,2,0,0,124416,11,405647882
7569,181167570,920117,182087687,0,0,0,126464,6,8061939692
7570,181225990,561340,181787330,9,0,0,37888,17,6549519588
7571,181239590,946292,182185882,1,0,0,55296,6,3794840305
7572,181305940,1758825,183064765,9,0,0,187392,17,3439993426
7573,181318150,1612882,182931032,0,0,0,124928,6,7612260626
7574,181337900,1643835,182981735,0,0,0,89600,6,4925267162
7575,181348060,1898152,183246212,8,0,0,58368,6,4866690143
7576,181369920,871457,182241377,2,0,0,171008,11,5517313520
7577,181426030,1466907,182892937,6,0,0,67072,3,169824125
7578,181450800,23827143,205277943,1,0,1,22528,6,2958943712
7579,181472590,513248,181985838,2,0,0,11776,11,6134532103
7580,181578500,1821292,183399792,0,0,0,122880,6,5310637140
7581,181616800,628188,182244988,9,0,0,11776,17,1679224231
7582,181652340,1988809,183641149,1,0,0,60416,6,9019230868
7583,181656740,23722790,205379530,1,0,1,29696,6,1521851296
7584,181737620,23641925,205379545,1,0,1,512,6,3127739415
7585,181745380,23715994,205461374,1,0,1,57856,6,8256847750
7586,181777590,23683839,205461429,1,0,1,10752,6,6459314692
7587,181791550,1162795,182954345,1,0,0,70144,6,1857557317
7588,181809650,23651802,205461452,1,0,1,4096,6,8310780925
7589,181832020,1614929,183446949,9,0,0,154624,17,6847806932
7590,181855181,23606286,205461467,0,0,1,20480,6,9076825463
7591,181856810,786337,182643147,0,0,0,11776,6,1349563169
7592,181861740,777796,182639536,6,0,0,58368,3,6357923512
7593,181878820,574296,182453116,1,0,0,58368,6,7640878199
7594,181920030,23541452,205461482,1,0,1,512,6,8475881132
7595,181966900,1752300,183719200,6,0,0,70656,3,2433108948
7596,181974520,23486985,205461505,1,0,1,1536,6,4296288623
7597,181976570,1274801,183251371,2,0,0,10752,11,6710831703
7598,181995860,1626866,183622726,1,0,0,250368,6,6903398874
7599,182058310,1052373,183110683,0,0,0,33792,6,1101132723
7600,182059561,23401959,205461520,0,0,1,10240,6,2112845898
7601,182083491,23378044,205461535,0,0,1,19968,6,4332349772
7602,182209770,23253043,205462813,1,0,1,23552,6,8951651337
7603,182224900,471110,182696010,1,0,0,119808,6,7874844671
7604,182270581,23192247,205462828,0,0,1,1536,6,6848883695
7605,182350750,23112093,205462843,1,0,1,14848,6,6882099736
7606,182389230,1405648,183794878,0,0,0,86016,6,4738149484
7607,182417990,1245706,183663696,1,0,0,73728,6,5433745664
7608,182433490,715348,183148838,1,0,0,512,6,1907585982
7609,182456000,23023214,205479214,1,0,1,14848,6,8234636279
7610,182456330,551324,183007654,9,0,0,84992,17,7971520637
7611,182510180,23045603,205555783,8,0,1,121856,6,6214379955
7612,182510550,23045248,205555798,1,0,1,9728,6,4211868222
7613,182587390,916618,183504008,2,0,0,28160,11,3380667491
7614,182603110,23009820,205612930,8,0,1,89088,6,4672285139
7615,182633880,299047,182932927,9,0,0,6144,17,9854781895
7616,182688860,411504,183100364,2,0,0,116736,11,4462664357
7617,182734790,1448553,184183343,1,0,0,276992,6,3784681226
7618,182772120,1220837,183992957,1,0,0,202752,6,2309779037
7619,182794520,431188,183225708,1,0,0,38400,6,7855938723
7620,182821080,22836268,205657348,8,0,1,76800,6,8842107712
7621,182836750,651501,183488251,2,0,0,19968,11,8685022834
7622,182847350,699077,183546427,9,0,0,74752,17,709400556
7623,182961280,22712581,205673861,8,0,1,20480,6,4304728998
7624,182961890,1042345,184004235,9,0,0,36864,17,10054952948
7625,183013420,331062,183344482,2,0,0,8192,11,1166056015
7626,183034770,23188442,206223212,8,0,1,534016,6,6645830266
7627,183181050,1173620,184354670,6,0,0,96256,3,6954504550
7628,183212790,309180,183521970,2,0,0,58368,11,9100306811
7629,183271630,575447,183847077,9,0,0,66560,17,2053138588
7630,183282410,1128425,184410835,1,0,0,53248,6,4430496204
7631,183289990,23231685,206521675,8,0,1,527360,6,8120271687
7632,183302650,23223877,206526527,1,0,1,7680,6,6430910328
7633,183330900,23301206,206632106,8,0,1,108032,6,332298759
7634,183364430,438895,183803325,9,0,0,27648,17,3596481791
7635,183385940,23308692,206694632,1,0,1,1024,6,5666795486
7636,183431520,380416,183811936,0,0,0,28160,6,8277676645
7637,183467260,23227387,206694647,1,0,1,6656,6,4788838320
7638,183508160,760921,184269081,1,0,0,182272,6,10122247437
7639,183548670,963283,184511953,2,0,0,121856,11,8358583318
7640,183650330,409831,184060161,1,0,0,27648,6,778619774
7641,183661840,663487,184325327,0,0,0,66560,6,3761767202
7642,183664970,23299932,206964902,8,0,1,219648,6,4334788292
7643,183755650,23209267,206964917,2,0,1,26112,11,5150411743
7644,183772640,23231996,207004636,2,0,1,48128,11,8129051800
7645,183791210,865817,184657027,1,0,0,359936,6,3233169554
7646,183832020,23173922,207005942,2,0,1,2048,11,9450985972
7647,183837530,23201673,207039203,1,0,1,30720,6,5387125054
7648,183866060,887504,184753564,1,0,0,62976,6,5993607551
7649,183871780,410484,184282264,5,0,0,43008,11,4296245161
7650,183884610,837530,184722140,2,0,0,213504,11,7078904139
7651,183886660,581127,184467787,6,0,0,78848,3,4389658622
7652,183937530,23116165,207053695,1,0,1,48128,6,8471802346
7653,183950790,23107885,207058675,1,0,1,16384,6,7079774990
7654,183968980,23093049,207062029,1,0,1,15872,6,10209887620
7655,183969850,23093165,207063015,7,0,1,1536,16,2083485740
7656,184021510,23045051,207066561,2,0,1,5632,11,5565507935
7657,184118760,22988594,207107354,8,0,1,99328,6,3314618369
7658,184119140,23113128,207232268,8,0,1,62464,6,7522234909
7659,184145800,23086483,207232283,2,0,1,4096,11,9914896547
7660,184154790,23077508,207232298,2,0,1,23552,11,3356384317
7661,184157260,23075053,207232313,8,0,1,37888,6,2210028173
7662,184198260,23034068,207232328,2,0,1,1536,11,6586690006
7663,184222770,23009573,207232343,7,0,1,8192,16,5127862593
7664,184222790,23009568,207232358,2,0,1,512,11,9479889346
7665,184224131,23008242,207232373,0,0,1,11776,6,1249077937
7666,184240440,22991948,207232388,6,0,1,7168,3,32758676
7667,184247380,605152,184852532,1,0,0,21504,6,2523034583
7668,184257560,674563,184932123,0,0,0,73728,6,6506765765
7669,184262410,22969993,207232403,2,0,1,23040,11,8965303129
7670,184275670,22956748,207232418,1,0,1,17408,6,4241844668
7671,184304830,22927603,207232433,8,0,1,34816,6,9265131426
7672,184394620,328432,184723052,9,0,0,512,17,6712581205
7673,184399251,22833197,207232448,0,0,1,9216,6,853404938
7674,184432060,22826211,207258271,6,0,1,13824,3,1812647496
7675,184445550,22816267,207261817,2,0,1,5632,11,6159148572
7676,184476390,22788653,207265043,7,0,1,5120,16,3952550112
7677,184486170,22786308,207272478,7,0,1,20480,16,3193852809
7678,184503390,219451,184722841,9,0,0,2048,17,1555743877
7679,184508171,22792022,207300193,0,0,1,23040,6,4678871921
7680,184508490,22800490,207308980,7,0,1,7168,16,7557235011
7681,184510981,22802505,207313486,0,0,1,7168,6,3825737336
7682,184515341,290741,184806082,7,0,0,9728,16,2869233247
7683,184520391,22862349,207382740,0,0,1,27136,6,2995631233
7684,184532280,22869768,207402048,1,0,1,512,6,7301628459
7685,184545751,22857923,207403674,0,0,1,2560,6,2865595626
7686,184569170,22858514,207427684,7,0,1,54272,16,4892538067
7687,184583821,22890908,207474729,0,0,1,59904,6,7438377296
7688,184603630,22873365,207476995,2,0,1,3584,11,1547515639
7689,184607560,22876961,207484521,2,0,1,14848,11,5376070901
7690,184618641,22872711,207491352,0,0,1,12800,6,8600644633
7691,184626010,369155,184995165,6,0,0,47616,3,3317050298
7692,184687720,454572,185142292,9,0,0,512,17,10561473771
7693,184688030,22826744,207514774,2,0,1,13824,11,6283493856
7694,184696620,22830686,207527306,7,0,1,34304,16,5587087776
7695,184765160,172905,184938065,0,0,0,10752,6,750939740
7696,184802000,22880819,207682819,8,0,1,264192,6,5085619446
7697,184823260,22974456,207797716,2,0,1,36864,11,8053619904
7698,184831430,22966309,207797739,7,0,1,20480,16,309924214
7699,184858810,389144,185247954,2,0,0,39936,11,4220107156
7700,184872540,269581,185142121,8,0,0,42496,6,4006893147
7701,184878390,325243,185203633,6,0,0,125440,3,624013930
7702,184881511,22916243,207797754,0,0,1,8704,6,6860744990
7703,184885220,22912573,207797793,8,0,1,138240,6,9637175441
7704,184896070,22901746,207797816,2,0,1,3072,11,6816446991
7705,184896830,22931690,207828520,6,0,1,55296,3,9034256472
7706,184897200,542355,185439555,6,0,0,182272,3,2198836056
7707,184912130,364781,185276911,8,0,0,85504,6,9287101521
7708,184925831,22911829,207837660,0,0,1,24064,6,4829851898
7709,184973690,22864316,207838006,2,0,1,512,11,9727543999
7710,184997160,22846365,207843525,6,0,1,15872,3,96253669
7711,185028900,249410,185278310,9,0,0,512,17,9059323861
7712,185103990,497880,185601870,1,0,0,136704,6,1755847975
7713,185106351,22738800,207845151,0,0,1,2560,6,3249124764
7714,185166680,317080,185483760,2,0,0,26624,11,6575131340
7715,185186410,417526,185603936,9,0,0,5120,17,1196314102
7716,185189380,421111,185610491,0,0,0,5632,6,8891365568
7717,185220470,88092,185308562,9,0,0,512,17,2071606811
7718,185225431,22624892,207850323,0,0,1,8192,6,5078858487
7719,185235300,22831825,208067125,8,0,1,358912,6,9367885991
7720,185243201,434107,185677308,7,0,0,512,16,5551288234
7721,185247340,22821091,208068431,2,0,1,2048,11,3783499357
7722,185292700,648067,185940767,2,0,0,68096,11,4670361384
7723,185309550,364949,185674499,9,0,0,2560,17,6018758034
7724,185321541,280812,185602353,7,0,0,1536,16,4271350080
7725,185328450,22897102,208225552,8,0,1,278016,6,6949540129
7726,185343830,22884628,208228458,7,0,1,4608,16,4961556530
7727,185375720,725281,186101001,1,0,0,46592,6,4103186186
7728,185429880,22805097,208234977,7,0,1,26112,16,2703193951
7729,185430390,353306,185783696,2,0,0,86528,11,7728819875
7730,185484150,22781760,208265910,9,0,1,24576,17,9709346797
7731,185493670,22782509,208276179,9,0,1,43008,17,206787553
7732,185551930,533251,186085181,2,0,0,71680,11,8507208659
7733,185557630,22729918,208287548,2,0,1,2048,11,7590752454
7734,185580640,1505142,187085782,1,0,0,61440,6,6127264465
7735,185593000,1396087,186989087,6,0,0,335872,3,10428543522
7736,185634500,874551,186509051,0,0,0,68096,6,1249907770
7737,185645960,296131,185942091,9,0,0,4096,17,8138802283
7738,185680160,22627503,208307663,2,0,1,23552,11,6881076914
7739,185704220,1176388,186880608,2,0,0,4096,11,7534094778
7740,185721830,1345161,187066991,8,0,0,251392,6,9101037402
7741,185723940,1661636,187385576,8,0,0,467968,6,4659796096
7742,185734700,1129953,186864653,1,0,0,523264,6,5703917386
7743,185737000,1759311,187496311,1,0,0,174592,6,4381345751
7744,185786230,1204135,186990365,9,0,0,3584,17,920427279
7745,185791570,22726311,208517881,9,0,1,303616,17,10383454544
7746,185803850,1787590,187591440,6,0,0,87552,3,5434401455
7747,185809460,1956074,187765534,6,0,0,118272,3,10332972529
7748,185860930,1564059,187424989,8,0,0,38400,6,6963995653
7749,185869131,656249,186525380,7,0,0,1024,16,8010638472
7750,185876960,22689935,208566895,9,0,1,111104,17,9148947580
7751,185921060,22657987,208579047,6,0,1,2560,3,2354470302
7752,185927670,1466829,187394499,1,0,0,29184,6,10717417
7753,185955200,1609541,187564741,6,0,0,103936,3,5655459264
7754,185955990,22624683,208580673,2,0,1,2560,11,9231491867
7755,185962130,22618799,208580929,2,0,1,9216,11,3117251875
7756,185969600,1671212,187640812,8,0,0,93184,6,9925301679
7757,185974661,1862855,187837516,7,0,0,512,16,780248409
7758,185981030,22601282,208582312,2,0,1,14848,11,9230682070
7759,185998680,632086,186630766,9,0,0,1536,17,3222117835
7760,186001310,1441790,187443100,0,0,0,59392,6,7206775699
7761,186020410,1651953,187672363,2,0,0,103424,11,3069792570
7762,186047730,1038395,187086125,9,0,0,1024,17,7524614636
7763,186056880,1356394,187413274,1,0,0,61440,6,6679802543
7764,186068110,22538223,208606333,9,0,1,51712,17,343307602
7765,186107361,758103,186865464,7,0,0,2560,16,7386015900
7766,186170510,22459300,208629810,2,0,1,4096,11,2495744415
7767,186172950,2262024,188434974,0,0,0,221696,6,2523459167
7768,186194431,794827,186989258,7,0,0,512,16,5894021370
7769,186203400,22687948,208891348,9,0,1,167424,17,7194416916
7770,186203790,1329220,187533010,8,0,0,120320,6,2463306560
7771,186224160,2345027,188569187,6,0,0,166912,3,1807847908
7772,186229400,22661971,208891371,2,0,1,9216,11,1161554378
7773,186236580,632519,186869099,8,0,0,11776,6,10049002912
7774,186247620,22696549,208944169,6,0,1,3584,3,10197210634
7775,186317540,22635580,208953120,6,0,1,6656,3,4239172668
7776,186331820,1698425,188030245,6,0,0,82432,3,6729069715
7777,186353100,22739839,209092939,9,0,1,172032,17,8553370560
7778,186358520,22734434,209092954,6,0,1,5120,3,2706386711
7779,186439700,22653269,209092969,9,0,1,31744,17,6965372528
7780,186453240,1551874,188005114,8,0,0,95744,6,727169169
7781,186453800,22651905,209105705,2,0,1,18432,11,7794519351
7782,186472490,22648279,209120769,6,0,1,2560,3,5101042383
7783,186474480,750238,187224718,9,0,0,512,17,3803323091
7784,186514070,1299318,187813388,1,0,0,52736,6,2671479006
7785,186515100,1097305,187612405,1,0,0,68608,6,2934427653
7786,186527211,22594941,209122152,0,0,1,14848,6,5426825558
7787,186534260,2197900,188732160,6,0,0,94720,3,7068700904
7788,186543661,1569232,188112893,7,0,0,4096,16,5160117053
7789,186564120,1130271,187694391,0,0,0,27648,6,212136073
7790,186568800,1361306,187930106,6,0,0,41472,3,1401936854
7791,186592640,1118826,187711466,9,0,0,2560,17,2867899157
7792,186689980,1421323,188111303,6,0,0,110080,3,8749959954
7793,186708780,22418133,209126913,6,0,1,9216,3,6255498571
7794,186746670,2294092,189040762,8,0,0,259584,6,7406733394
7795,186769220,22362562,209131782,6,0,1,6656,3,6109585312
7796,186782340,22353462,209135802,6,0,1,14848,3,4558952274
7797,186837230,1657934,188495164,2,0,0,153088,11,6858313528
7798,186849740,1475973,188325713,6,0,0,197632,3,8562531083
7799,186860350,1507061,188367411,1,0,0,101376,6,10125415658
7800,186908290,2177617,189085907,1,0,0,38912,6,4643250082
7801,186915970,1682412,188598382,2,0,0,95744,11,9660730471
7802,186941250,22213903,209155153,6,0,1,30720,3,7767192225
7803,186961271,711747,187673018,7,0,0,2048,16,3354570207
7804,186976761,862291,187839052,7,0,0,512,16,3533309781
7805,186980481,1659153,188639634,7,0,0,1024,16,280697355
7806,187004360,2069676,189074036,6,0,0,102400,3,4893698732
7807,187026940,2330673,189357613,1,0,0,248320,6,5624406903
7808,187049210,22118292,209167502,6,0,1,11776,3,3521572316
7809,187062370,22149950,209212320,8,0,1,90112,6,4530557572
7810,187087690,1425461,188513151,0,0,0,58880,6,5500130544
7811,187105750,2086633,189192383,0,0,0,41984,6,3776274120
7812,187148280,1188212,188336492,1,0,0,35328,6,8815979124
7813,187173290,1466017,188639307,1,0,0,72704,6,6365968166
7814,187216070,22052678,209268748,8,0,1,78848,6,9033540326
7815,187239500,836410,188075910,6,0,0,23040,3,5596097095
7816,187265700,1351432,188617132,6,0,0,60416,3,2812924991
7817,187273430,540129,187813559,9,0,0,512,17,8249290634
7818,187282941,1315768,188598709,7,0,0,1024,16,4285524136
7819,187287800,1415454,188703254,2,0,0,185856,11,3906821029
7820,187296120,934740,188230860,9,0,0,512,17,3556725435
7821,187310570,2270544,189581114,2,0,0,192000,11,7414397093
7822,187328110,2176142,189504252,6,0,0,154112,3,6022772745
7823,187374460,840403,188214863,1,0,0,24576,6,8956464099
7824,187394480,21885839,209280319,6,0,1,25600,3,5228145352
7825,187414570,21883276,209297846,6,0,1,3584,3,7997633795
7826,187443720,1735848,189179568,8,0,0,153088,6,506016300
7827,187469310,642320,188111630,9,0,0,1024,17,2465843523
7828,187474481,2171667,189646148,7,0,0,1024,16,2268434157
7829,187480450,1481189,188961639,6,0,0,112640,3,7208450751
7830,187503670,1601596,189105266,8,0,0,63488,6,8215113293
7831,187551600,21748397,209299997,8,0,1,26624,6,146421477
7832,187566071,2110160,189676231,7,0,0,60928,16,1477893383
7833,187601340,2275529,189876869,6,0,0,163840,3,6072977487
7834,187609510,21696082,209305592,6,0,1,34304,3,7712145452
7835,187654440,2399002,190053442,2,0,0,232448,11,8309163047
7836,187694990,1704320,189399310,2,0,0,56320,11,6633073146
7837,187714260,2112674,189826934,1,0,0,144896,6,3458561469
7838,187730670,2430840,190161510,1,0,0,59392,6,10271938254
7839,187752590,1380319,189132909,6,0,0,90624,3,4251953728
7840,187764581,1437957,189202538,7,0,0,33280,16,4127779954
7841,187778870,1148434,188927304,8,0,0,49152,6,5682774380
7842,187816090,2280891,190096981,8,0,0,142848,6,225471533
7843,187828750,21534164,209362914,8,0,1,115712,6,9056401793
7844,187896550,21641693,209538243,8,0,1,207360,6,8816175477
7845,187943050,1099771,189042821,9,0,0,6656,17,7765691389
7846,187968610,1488671,189457281,6,0,0,25600,3,1014080216
7847,188013670,21526008,209539678,9,0,1,18944,17,10188440039
7848,188041780,1651314,189693094,8,0,0,55296,6,9872914491
7849,188123051,1825053,189948104,7,0,0,152064,16,8180111113
7850,188133970,21580890,209714860,9,0,1,254976,17,1612654935
7851,188143491,2126724,190270215,7,0,0,129024,16,5648959585
7852,188171450,21563055,209734505,6,0,1,40448,3,815432464
7853,188175560,1945468,190121028,0,0,0,78848,6,8637407226
7854,188190590,2269986,190460576,6,0,0,96768,3,3074842358
7855,188206191,1175929,189382120,7,0,0,80384,16,7982776915
7856,188215790,1766813,189982603,8,0,0,113152,6,6695734753
7857,188284690,1999595,190284285,1,0,0,44544,6,4326880337
7858,188316840,1114677,189431517,9,0,0,2048,17,1741535694
7859,188405350,2260836,190666186,2,0,0,181248,11,8459068891
7860,188410490,1294007,189704497,1,0,0,37376,6,9657372501
7861,188451500,1691883,190143383,8,0,0,73216,6,9157116131
7862,188458410,21282589,209740999,6,0,1,10752,3,2924907105
7863,188465900,1965177,190431077,0,0,0,114176,6,4712217613
7864,188469490,2388157,190857647,6,0,0,39936,3,4619326363
7865,188486581,1842912,190329493,7,0,0,19456,16,3126105865
7866,188513550,21359824,209873374,8,0,1,103424,6,10003342752
7867,188522930,2018296,190541226,2,0,0,20992,11,2703962133
7868,188581760,21352969,209934729,3,0,1,35328,0,2099994055
7869,188609880,2518582,191128462,8,0,0,90112,6,10063335149
7870,188620180,21339266,209959446,1,0,1,14336,6,10119565752
7871,188668181,2312447,190980628,7,0,0,18944,16,233807318
7872,188674530,2008386,190682916,2,0,0,15360,11,8028350095
7873,188733150,1428687,190161837,9,0,0,1024,17,6779457333
7874,188747791,2515402,191263193,7,0,0,157696,16,3100642901
7875,188752290,2010860,190763150,1,0,0,106496,6,9722499619
7876,188777710,21207683,209985393,8,0,1,30208,6,4259628278
7877,188846360,1641555,190487915,2,0,0,89600,11,2313038315
7878,188897631,2100432,190998063,7,0,0,27136,16,2953280369
7879,188923270,2266775,191190045,2,0,0,81408,11,4200477881
7880,188931250,2560345,191491595,2,0,0,215552,11,5543859022
7881,188963860,1735037,190698897,0,0,0,49152,6,7449462853
7882,188975990,21086443,210062433,8,0,1,52224,6,10611614314
7883,189018620,568297,189586917,2,0,0,18944,11,10421326166
7884,189119820,1203722,190323542,0,0,0,105472,6,1965972368
7885,189151170,21145106,210296276,8,0,1,200704,6,1327791355
7886,189187461,2540516,191727977,7,0,0,435712,16,6859671011
7887,189253250,21043041,210296291,5,0,1,2560,11,2945959670
7888,189260170,21231717,210491887,9,0,1,273920,17,5355994280
7889,189269470,21222440,210491910,5,0,1,3584,11,6494489934
7890,189271370,21220555,210491925,5,0,1,10752,11,5993251380
7891,189279511,21212429,210491940,0,0,1,2048,6,4396248452
7892,189309500,1368721,190678221,2,0,0,39424,11,3693084276
7893,189340700,2525205,191865905,6,0,0,125952,3,5634691893
7894,189345700,21174972,210520672,6,0,1,41472,3,9316449889
7895,189362530,21346315,210708845,9,0,1,256000,17,6120618969
7896,189373710,896988,190270698,9,0,0,1536,17,1810569034
7897,189378850,402269,189781119,6,0,0,1024,3,7828039330
7898,189415051,1968464,191383515,7,0,0,245248,16,9690214301
7899,189424810,1676181,191100991,2,0,0,21504,11,4555971408
7900,189434950,21274561,210709511,6,0,1,11264,3,2114147496
7901,189444501,1323546,190768047,7,0,0,9728,16,6883869148
7902,189473330,21241007,210714337,5,0,1,7680,11,312331899
7903,189512410,1571547,191083957,1,0,0,98816,6,7333529054
7904,189527281,1237779,190765060,7,0,0,3072,16,10245742453
7905,189529571,21187672,210717243,0,0,1,4608,6,7107298888
7906,189566360,21373125,210939485,9,0,1,222720,17,10330757080
7907,189574790,21561544,211136334,8,0,1,240640,6,3373454039
7908,189583421,21553579,211137000,0,0,1,1024,6,4381072089
7909,189593620,1715148,191308768,6,0,0,149504,3,9970058170
7910,189606040,21557267,211163307,5,0,1,41472,11,9424686073
7911,189617990,1107168,190725158,0,0,0,61440,6,1431640878
7912,189626531,1348310,190974841,7,0,0,165888,16,6061311541
7913,189645130,21608586,211253716,9,0,1,78336,17,3460039439
7914,189694430,21559301,211253731,3,0,1,9728,0,7276259210
7915,189704401,21549345,211253746,0,0,1,11264,6,2292281395
7916,189721420,1373004,191094424,2,0,0,34304,11,10215552366
7917,189819730,21434031,211253761,6,0,1,5632,3,6743519821
7918,189867180,21410791,211277971,8,0,1,57856,6,4083023118
7919,189908530,636452,190544982,9,0,0,3072,17,8895368196
7920,189957320,21320666,211277986,8,0,1,75776,6,3870522821
7921,189993180,21297569,211290749,5,0,1,11264,11,1489619561
7922,190031110,1769322,191800432,2,0,0,237568,11,10354795445
7923,190037111,1489802,191526913,7,0,0,112128,16,5106448633
7924,190047450,284866,190332316,1,0,0,9216,6,3502940492
7925,190084351,1983478,192067829,7,0,0,439808,16,8134583509
7926,190141680,21157736,211299416,4,0,1,38912,4,8609214665
7927,190177590,21163952,211341542,5,0,1,25088,11,2411310228
7928,190192180,1707498,191899678,2,0,0,96768,11,5104639133
7929,190198940,565161,190764101,9,0,0,3072,17,9415697322
7930,190205510,1932534,192138044,2,0,0,230400,11,1731913527
7931,190280010,21121432,211401442,8,0,1,48640,6,348354020
7932,190299170,1911849,192211019,1,0,0,45568,6,1417829075
7933,190326530,357361,190683891,2,0,0,3072,11,501071267
7934,190331090,21174567,211505657,8,0,1,174592,6,8487495763
7935,190374740,21132223,211506963,6,0,1,2048,3,8721427467
7936,190416040,1780425,192196465,1,0,0,140288,6,5302410562
7937,190420410,21109195,211529605,3,0,1,27648,0,7062158332
7938,190448310,21095299,211543609,4,0,1,16896,4,1711647111
7939,190480680,21078409,211559089,4,0,1,14848,4,6443796289
7940,190530140,21058109,211588249,3,0,1,2560,0,3643491218
7941,190545880,21042555,211588435,8,0,1,31744,6,2055522904
7942,190579070,21023059,211602129,8,0,1,39936,6,10377701403
7943,190584890,21028418,211613308,4,0,1,36352,4,7684304448
7944,190596100,896634,191492734,9,0,0,3584,17,5255723136
7945,190618100,1648822,192266922,1,0,0,183296,6,5850677991
7946,190624210,1203280,191827490,6,0,0,30720,3,10626265199
7947,190630061,1523645,192153706,7,0,0,46080,16,1465159652
7948,190637830,21081731,211719561,8,0,1,157696,6,9071248755
7949,190662130,474974,191137104,9,0,0,1536,17,5209081957
7950,190683880,1647718,192331598,0,0,0,58368,6,4114273836
7951,190697500,686342,191383842,2,0,0,1024,11,4993710186
7952,190728540,1141607,191870147,1,0,0,13312,6,3916017409
7953,190757980,20966292,211724272,5,0,1,20480,11,1494190306
7954,190760620,20998590,211759210,4,0,1,6144,4,9282351933
7955,190798240,1019835,191818075,0,0,0,57856,6,3532416365
7956,190816930,20942295,211759225,4,0,1,38912,4,2942535809
7957,190829180,20930060,211759240,3,0,1,9216,0,9905483419
7958,190846630,1571797,192418427,6,0,0,173056,3,5609043962
7959,190854140,1989757,192843897,6,0,0,738304,3,1188738975
7960,190854950,20904305,211759255,3,0,1,4608,0,2004407749
7961,190966160,899916,191866076,2,0,0,512,11,9806109680
7962,190974240,1339543,192313783,6,0,0,40448,3,7723683175
7963,190984440,1212664,192197104,1,0,0,2048,6,8286945616
7964,191097370,20721535,211818905,8,0,1,63488,6,10155106774
7965,191124430,20698981,211823411,5,0,1,7168,11,8452392765
7966,191139460,1226208,192365668,0,0,0,80896,6,3623285093
7967,191183870,20658184,211842054,2,0,1,8192,11,4891044361
7968,191208260,1660612,192868872,0,0,0,81920,6,5264968645
7969,191215480,1751631,192967111,6,0,0,163328,3,3962989587
7970,191257910,1009347,192267257,9,0,0,1024,17,2695982054
7971,191314010,20537256,211851266,5,0,1,18432,11,9627958491
7972,191318520,20598772,211917292,3,0,1,37376,0,670996268
7973,191350520,20597156,211947676,3,0,1,19968,0,8756740502
7974,191357590,20676549,212034139,8,0,1,100864,6,9003277540
7975,191376810,20676183,212052993,2,0,1,22528,11,9999747122
7976,191378380,20675074,212053454,5,0,1,10240,11,6028546214
7977,191407200,732443,192139643,2,0,0,5120,11,8313583192
7978,191431640,20663376,212095016,2,0,1,22016,11,7819159112
7979,191433700,1457214,192890914,0,0,0,69120,6,1181074054
7980,191483780,20788688,212272468,3,0,1,41472,0,2733176622
7981,191488030,1583079,193071109,6,0,0,123392,3,6450187547
7982,191520590,20920831,212441421,8,0,1,144896,6,6263338487
7983,191546370,21003104,212549474,5,0,1,12288,11,35948279
7984,191547240,793765,192341005,1,0,0,30720,6,5053059770
7985,191579800,721636,192301436,6,0,0,112128,3,3385053669
7986,191597910,20951579,212549489,2,0,1,512,11,5749711712
7987,191602610,20946894,212549504,5,0,1,1536,11,9669762259
7988,191614100,20935419,212549519,3,0,1,1536,0,1546581641
7989,191618190,20931344,212549534,8,0,1,16384,6,868958243
7990,191631400,927529,192558929,0,0,0,8192,6,4609677745
7991,191641620,20907929,212549549,3,0,1,5120,0,7114662575
7992,191645390,776032,192421422,2,0,0,9728,11,5769726868
7993,191759660,1273774,193033434,1,0,0,217600,6,9574858065
7994,191793520,20756044,212549564,2,0,1,51712,11,3900574090
7995,191797400,20752179,212549579,8,0,1,9728,6,7677202343
7996,191827770,20721824,212549594,2,0,1,29184,11,164160386
7997,191865360,575889,192441249,1,0,0,65024,6,10152978764
7998,191871671,1279512,193151183,7,0,0,259584,16,149088406
7999,191951740,1330013,193281753,0,0,0,165376,6,8287211038
8000,191952220,965104,192917324,1,0,0,85504,6,4121402740
8001,191981260,1243624,193224884,9,0,0,1024,17,7452029356
8002,192004940,864891,192869831,9,0,0,3072,17,7431743363
8003,192042010,1317922,193359932,1,0,0,131584,6,10501563382
8004,192066590,20483658,212550248,2,0,1,9216,11,6084164096
8005,192117520,20465238,212582758,7,0,1,11264,16,361571423
8006,192119220,323044,192442264,2,0,0,3072,11,5022719634
8007,192131450,1093099,193224549,6,0,0,177152,3,7758027632
8008,192146390,20482869,212629259,8,0,1,3584,6,1704771643
8009,192150750,20545095,212695845,8,0,1,18944,6,2277881511
8010,192172930,20523101,212696031,8,0,1,24064,6,6760687386
8011,192181850,1044141,193225991,2,0,0,3584,11,10519934124
8012,192203620,20498651,212702271,5,0,1,18432,11,3235611605
8013,192228410,20482881,212711291,2,0,1,18944,11,573628349
8014,192289090,20426067,212715157,5,0,1,6144,11,5786563296
8015,192303640,866902,193170542,1,0,0,63488,6,10580099383
8016,192325660,20425352,212751012,2,0,1,12288,11,4193352786
8017,192331250,988551,193319801,9,0,0,512,17,41017787
8018,192348400,20420376,212768776,8,0,1,30208,6,5389605149
8019,192373260,698816,193072076,2,0,0,3072,11,8064857450
8020,192377790,941293,193319083,6,0,0,90624,3,9214592541
8021,192390470,20387036,212777506,2,0,1,6656,11,67787093
8022,192420560,20357292,212777852,8,0,1,512,6,2359848487
8023,192427870,993091,193420961,9,0,0,2560,17,2781836965
8024,192435860,20343938,212779798,8,0,1,3072,6,376514793
8025,192442400,448841,192891241,2,0,0,1024,11,10059879374
8026,192452410,839038,193291448,0,0,0,31744,6,10178618087
8027,192527990,703344,193231334,1,0,0,17408,6,3687417248
8028,192617761,975987,193593748,7,0,0,422400,16,6587986128
8029,192687730,991701,193679431,1,0,0,281088,6,1579837408
8030,192745800,20097029,212842829,2,0,1,23552,11,8143278611
8031,192772391,630896,193403287,7,0,0,72192,16,3411427839
8032,192774511,963802,193738313,7,0,0,188416,16,1593292841
8033,192778320,1018921,193797241,9,0,0,512,17,3999351707
8034,192786970,532604,193319574,9,0,0,1536,17,6857920702
8035,192804900,555275,193360175,2,0,0,512,11,3910619890
8036,192813530,1015154,193828684,6,0,0,31744,3,9676481225
8037,192834540,20094604,212929144,2,0,1,39424,11,3731347993
8038,192843070,954000,193797070,9,0,0,5120,17,2660672349
8039,192855790,564360,193420150,6,0,0,55296,3,4613924867
8040,192893340,20035827,212929167,8,0,1,32256,6,3357303909
8041,192903360,777522,193680882,2,0,0,4608,11,4172334183
8042,192914440,20014750,212929190,2,0,1,2560,11,3146507486
8043,192931410,863594,193795004,0,0,0,185856,6,7320168687
8044,192984621,1356161,194340782,7,0,0,164864,16,1136293029
8045,192997401,1071058,194068459,7,0,0,7680,16,9152805356
8046,193003931,1228964,194232895,7,0,0,386048,16,10097876913
8047,193022500,19906705,212929205,2,0,1,512,11,8903711456
8048,193075190,788297,193863487,9,0,0,7680,17,7402122720
8049,193085220,19844000,212929220,8,0,1,23040,6,6297898757
8050,193117040,19812203,212929243,8,0,1,17408,6,4623187277
8051,193159210,19770048,212929258,8,0,1,1024,6,2707672051
8052,193168860,1173817,194342677,9,0,0,6144,17,9479265748
8053,193188270,19741003,212929273,8,0,1,7168,6,7326334724
8054,193192690,19774224,212966914,2,0,1,48640,11,3685947023
8055,193200050,19774245,212974295,8,0,1,11776,6,3106002073
8056,193266060,1117188,194383248,1,0,0,26112,6,9683366477
8057,193272840,712321,193985161,6,0,0,37888,3,3620132837
8058,193285510,948492,194234002,2,0,0,3584,11,4598553282
8059,193286360,1097995,194384355,9,0,0,3584,17,6356411619
8060,193300831,1270535,194571366,7,0,0,311296,16,1793850491
8061,193316510,641326,193957836,9,0,0,1024,17,606153685
8062,193325990,1323855,194649845,9,0,0,512,17,5749289184
8063,193345690,449797,193795487,9,0,0,1536,17,195022578
8064,193394510,510183,193904693,9,0,0,2048,17,8817360597
8065,193401680,505599,193907279,9,0,0,1024,17,4011503546
8066,193438380,19602686,213041066,2,0,1,9728,11,7479145438
8067,193501241,490019,193991260,7,0,0,19968,16,10312012076
8068,193518650,1099918,194618568,2,0,0,512,11,5106831326
8069,193541410,749125,194290535,2,0,0,2048,11,8766577029
8070,193589480,19451601,213041081,2,0,1,10240,11,4894998463
8071,193605101,19523899,213129000,0,0,1,84992,6,7371873486
8072,193624310,1119130,194743440,6,0,0,115712,3,6006323225
8073,193638291,1176141,194814432,7,0,0,187392,16,1187991215
8074,193655271,634625,194289896,7,0,0,92160,16,8070870823
8075,193667311,19467092,213134403,0,0,1,26624,6,2641216183
8076,193679740,1776546,195456286,6,0,0,48640,3,4778625975
8077,193694680,1160216,194854896,2,0,0,1536,11,9097245956
8078,193708981,1365767,195074748,7,0,0,66560,16,1120464278
8079,193722860,1539148,195262008,6,0,0,23552,3,4381263868
8080,193750710,820827,194571537,0,0,0,512,6,6135945799
8081,193762561,827583,194590144,7,0,0,48128,16,3840207207
8082,193793891,1172941,194966832,7,0,0,275968,16,6547280717
8083,193794151,19354919,213149070,0,0,1,9728,6,1198476400
8084,193802661,19350964,213153625,0,0,1,6144,6,5207521747
8085,193803060,542151,194345211,0,0,0,2048,6,351526726
8086,193964560,1591100,195555660,0,0,0,2048,6,9132862960
8087,194001860,342712,194344572,2,0,0,6144,11,8907492915
8088,194010920,974039,194984959,1,0,0,59392,6,7303539179
8089,194078711,570963,194649674,7,0,0,35840,16,391616838
8090,194213490,777038,194990528,2,0,0,4608,11,10201937406
8091,194237900,881788,195119688,1,0,0,52736,6,787977927
8092,194286150,847152,195133302,2,0,0,512,11,615277280
8093,194321690,496116,194817806,2,0,0,1536,11,5379365440
8094,194368080,449243,194817323,2,0,0,4096,11,7382825721
8095,194396400,266048,194662448,9,0,0,1024,17,5110332298
8096,194508880,307180,194816060,2,0,0,3072,11,2991390932
8097,194520730,362003,194882733,2,0,0,3584,11,5117239340
8098,194521100,607906,195129006,9,0,0,1536,17,5998329578
8099,194533011,1220932,195753943,7,0,0,111104,16,708071716
8100,194562220,435790,194998010,2,0,0,1024,11,2794665560
8101,194576401,18577378,213153779,0,0,1,8704,6,290176964
8102,194586470,228639,194815109,0,0,0,2048,6,6038600210
8103,194603131,18556596,213159727,0,0,1,12800,6,1879085423
8104,194621901,804231,195426132,7,0,0,400896,16,8304691796
8105,194657400,784043,195441443,6,0,0,50176,3,6510100545
8106,194683830,488010,195171840,9,0,0,4096,17,165189275
8107,194694580,597004,195291584,1,0,0,22528,6,8625579243
8108,194760580,857533,195618113,1,0,0,81408,6,5558398350
8109,194791300,1265508,196056808,6,0,0,481792,3,9137649449
8110,194796480,752101,195548581,0,0,0,2048,6,9126781387
8111,194798090,397722,195195812,0,0,0,5632,6,3700423684
8112,194822090,1308073,196130163,1,0,0,43008,6,7754959039
8113,194894820,561801,195456621,2,0,0,1024,11,8990217933
8114,194899050,947339,195846389,0,0,0,265216,6,2066525284
8115,194990020,467552,195457572,9,0,0,3072,17,3285473275
8116,195022151,841763,195863914,7,0,0,43008,16,7458052644
8117,195031451,18131502,213162953,0,0,1,5120,6,1214905225
8118,195086110,591592,195677702,6,0,0,36352,3,4507069639
8119,195152321,18030869,213183190,0,0,1,6656,6,8706831605
8120,195176750,701561,195878311,6,0,0,47104,3,1637945007
8121,195179371,18042214,213221585,0,0,1,60416,6,4069838013
8122,195193020,1012578,196205598,1,0,0,114176,6,9500182935
8123,195194511,18045246,213239757,0,0,1,10240,6,1824320431
8124,195195461,655334,195850795,7,0,0,14336,16,435941021
8125,195272540,185203,195457743,9,0,0,512,17,8729464472
8126,195343471,17898872,213242343,0,0,1,4096,6,4077957473
8127,195406430,692879,196099309,0,0,0,110592,6,5503524894
8128,195475090,769208,196244298,0,0,0,79872,6,5026755770
8129,195490451,17757281,213247732,0,0,1,17408,6,1866059070
8130,195491030,17788797,213279827,8,0,1,2560,6,6417332768
8131,195539091,903604,196442695,7,0,0,41984,16,9950953157
8132,195546560,17738414,213284974,8,0,1,25088,6,9237517700
8133,195558100,17736177,213294277,8,0,1,28160,6,10636053248
8134,195586960,734157,196321117,6,0,0,32256,3,445453813
8135,195607000,509998,196116998,0,0,0,57856,6,4961769928
8136,195628981,436593,196065574,7,0,0,28672,16,4939436528
8137,195661210,17644690,213305900,8,0,1,7680,6,6185286552
8138,195680661,17651165,213331826,0,0,1,22528,6,3497720710
8139,195726610,438170,196164780,1,0,0,72192,6,6508771140
8140,195731150,855587,196586737,6,0,0,125440,3,5789549791
8141,195732440,17795700,213528140,9,0,1,81408,17,6104617589
8142,195769750,561336,196331086,9,0,0,3584,17,9563032999
8143,195883010,17666718,213549728,8,0,1,5632,6,5590546073
8144,195936400,950100,196886500,8,0,0,400384,6,2402791373
8145,195954790,289843,196244633,2,0,0,1024,11,10294126827
8146,195975461,17575752,213551213,0,0,1,15360,6,5862757404
8147,195983871,780622,196764493,7,0,0,91648,16,8573939122
8148,196026961,17525238,213552199,0,0,1,1536,6,9352073097
8149,196083980,572021,196656001,9,0,0,1536,17,1468647797
8150,196105760,360269,196466029,2,0,0,4096,11,8688842536
8151,196106810,1049045,197155855,2,0,0,1536,11,5053544474
8152,196162990,424714,196587704,6,0,0,3072,3,7498781190
8153,196166430,17390954,213557384,1,0,1,16384,6,5226322514
8154,196208180,17445891,213654071,1,0,1,48128,6,63395539
8155,196226970,366529,196593499,6,0,0,18944,3,9584278616
8156,196252451,17401643,213654094,0,0,1,14336,6,6237841177
8157,196254730,448144,196702874,2,0,0,1536,11,5432331173
8158,196255561,17398548,213654109,0,0,1,1536,6,5667707711
8159,196274091,833191,197107282,7,0,0,70656,16,9467060592
8160,196282140,17371984,213654124,1,0,1,15360,6,1768234734
8161,196338010,17348398,213686408,1,0,1,45056,6,308680027
8162,196349860,1271880,197621740,6,0,0,92160,3,10112128618
8163,196351150,17409008,213760158,5,0,1,7680,11,4741424982
8164,196355240,17404941,213760181,5,0,1,16384,11,1026113416
8165,196410100,1658311,198068411,0,0,0,222720,6,405362041
8166,196415240,472071,196887311,9,0,0,2560,17,4248382262
8167,196428801,17340801,213769602,0,0,1,40960,6,1174298318
8168,196435280,17373884,213809164,1,0,1,4096,6,3157435764
8169,196439460,17370050,213809510,4,0,1,512,4,4677625959
8170,196443480,917006,197360486,0,0,0,82432,6,5651675659
8171,196454571,760055,197214626,7,0,0,143872,16,5553362378
8172,196470450,17419780,213890230,5,0,1,23040,11,5510583093
8173,196471150,17445630,213916780,1,0,1,13312,6,4565050567
8174,196474880,17441915,213916795,5,0,1,11264,11,3769641981
8175,196487880,17437369,213925249,5,0,1,25088,11,1284790566
8176,196493660,1385643,197879303,1,0,0,264704,6,2093782222
8177,196505020,1759393,198264413,1,0,0,315392,6,9172803864
8178,196548520,875536,197424056,2,0,0,3584,11,819632299
8179,196552720,808405,197361125,9,0,0,2048,17,8178439571
8180,196574321,983277,197557598,7,0,0,214016,16,9328511867
8181,196614231,17311033,213925264,0,0,1,6144,6,3836361953
8182,196622030,17324831,213946861,3,0,1,53248,0,193416770
8183,196679750,1875147,198554897,6,0,0,426496,3,2197169007
8184,196729190,659556,197388746,6,0,0,55296,3,10003634204
8185,196732990,741010,197474000,0,0,0,26112,6,4772634860
8186,196765861,17181023,213946884,0,0,1,8192,6,10347120054
8187,196778780,1218954,197997734,6,0,0,101376,3,7646765556
8188,196825130,1297305,198122435,9,0,0,1024,17,7910744190
8189,196836061,1775307,198611368,7,0,0,149504,16,8166224243
8190,196838390,1850676,198689066,6,0,0,252928,3,5386659418
8191,196842780,523424,197366204,2,0,0,512,11,1974219478
8192,196849701,1055039,197904740,7,0,0,29184,16,8705465607
8193,196859530,855592,197715122,6,0,0,110592,3,5405695199
8194,196923250,964032,197887282,6,0,0,26112,3,5496783393
8195,196940401,17006498,213946899,0,0,1,2048,6,10526563312
8196,197010471,16965653,213976124,0,0,1,36864,6,7810821001
8197,197010560,940445,197951005,0,0,0,120320,6,6529689226
8198,197036090,1271238,198307328,1,0,0,140800,6,8137606715
8199,197054960,667128,197722088,2,0,0,512,11,1372930695
8200,197068121,16934446,214002567,0,0,1,24064,6,9219407267
8201,197071620,16999034,214070654,3,0,1,33280,0,8647039545
8202,197078280,1714259,198792539,0,0,0,162304,6,973806657
8203,197106251,16964434,214070685,0,0,1,18432,6,5547091814
8204,197113640,16966518,214080158,3,0,1,43520,0,5688833701
8205,197145281,16955980,214101261,0,0,1,23040,6,1888188097
8206,197183620,16958255,214141875,6,0,1,31232,3,4112517289
8207,197184960,1668308,198853268,0,0,0,100864,6,552037647
8208,197197640,243150,197440790,1,0,0,2048,6,4331880480
8209,197216421,1208513,198424934,7,0,0,225792,16,6600266147
8210,197222571,16919970,214142541,0,0,1,1024,6,3437516546
8211,197239130,16904523,214143653,3,0,1,12800,0,6979434221
8212,197254570,1302877,198557447,2,0,0,7168,11,9234926890
8213,197264760,865478,198130238,2,0,0,1536,11,1890999293
8214,197294400,16854606,214149006,1,0,1,8704,6,1583523732
8215,197313760,16837192,214150952,3,0,1,3072,0,9098446339
8216,197355571,16806970,214162541,0,0,1,41984,6,10273754111
8217,197383030,16783528,214166558,1,0,1,4096,6,1548761007
8218,197386840,683006,198069846,2,0,0,4608,11,6557753757
8219,197399401,1744120,199143521,7,0,0,33280,16,405457263
8220,197452370,669738,198122108,6,0,0,26624,3,4608047781
8221,197462970,16726195,214189165,1,0,1,18944,6,8575973676
8222,197486051,16703780,214189831,0,0,1,1024,6,7952514638
8223,197500020,16711749,214211769,3,0,1,19456,0,2414493147
8224,197515910,16706456,214222366,1,0,1,9216,6,73524565
8225,197524690,1415957,198940647,1,0,0,150016,6,3867260033
8226,197540241,16683111,214223352,0,0,1,1536,6,8035328673
8227,197632280,510330,198142610,2,0,0,2048,11,4037955242
8228,197640261,1163564,198803825,7,0,0,36864,16,9007191432
8229,197640400,16584258,214224658,1,0,1,2048,6,3133071749
8230,197647660,662515,198310175,2,0,0,9216,11,8416465906
8231,197656110,1067220,198723330,6,0,0,43008,3,9635938285
8232,197686230,450068,198136298,2,0,0,512,11,7523658125
8233,197695650,916225,198611875,9,0,0,1536,17,3145798353
8234,197698130,16641487,214339617,1,0,1,48640,6,8191810537
8235,197704800,246384,197951184,2,0,0,512,11,2830287249
8236,197723820,1666379,199390199,0,0,0,287232,6,10044101057
8237,197727340,1524321,199251661,9,0,0,5120,17,2533687969
8238,197741550,1001506,198743056,0,0,0,45568,6,6658162634
8239,197754740,1249803,199004543,6,0,0,208384,3,4089523456
8240,197801050,764743,198565793,9,0,0,3072,17,9298145148
8241,197845120,719682,198564802,6,0,0,24064,3,9904496768
8242,197853851,16523469,214377320,0,0,1,512,6,8359938716
8243,197857560,16524906,214382466,1,0,1,8192,6,10224744742
8244,197896591,16486541,214383132,0,0,1,11264,6,3236156322
8245,197904140,16518786,214422926,1,0,1,22016,6,10611827423
8246,197919900,1021128,198941028,2,0,0,1024,11,8912491541
8247,197953410,16511529,214464939,2,0,1,13824,11,8658440013
8248,197956591,16630834,214587425,0,0,1,59392,6,486298199
8249,197960141,847644,198807785,7,0,0,12800,16,5789914914
8250,197985030,325636,198310666,9,0,0,1536,17,10156585769
8251,197993480,16598912,214592392,3,0,1,14848,0,6692548542
8252,198018080,537144,198555224,2,0,0,1024,11,1825563692
8253,198021910,688254,198710164,1,0,0,67584,6,9875359484
8254,198035300,16676247,214711547,3,0,1,19456,0,7157540460
8255,198036140,858776,198894916,0,0,0,133120,6,5223789105
8256,198042431,16669131,214711562,0,0,1,8192,6,2166359902
8257,198056551,672590,198729141,7,0,0,18944,16,810224717
8258,198119340,16682703,214802043,7,0,1,36864,16,3733451329
8259,198153721,16648337,214802058,0,0,1,11776,6,2819357584
8260,198154470,16647603,214802073,4,0,1,512,4,6232261693
8261,198156320,16645776,214802096,7,0,1,9728,16,8053698893
8262,198195971,16607015,214802986,0,0,1,2560,6,7261147562
8263,198221310,16773492,214994802,4,0,1,45056,4,2477205845
8264,198259140,16735677,214994817,1,0,1,4096,6,3568234615
8265,198296050,16698782,214994832,1,0,1,4096,6,389132302
8266,198309380,380169,198689549,9,0,0,1536,17,3937946937
8267,198331530,16663317,214994847,7,0,1,10752,16,9300392604
8268,198363900,16630962,214994862,7,0,1,1024,16,7808832742
8269,198367421,16627464,214994885,0,0,1,13824,6,2377448963
8270,198377360,16617540,214994900,1,0,1,20992,6,8064479978
8271,198404280,16590635,214994915,3,0,1,5120,0,2419483483
8272,198427180,16567750,214994930,7,0,1,6656,16,1966174133
8273,198430510,1162220,199592730,0,0,0,315904,6,3629428519
8274,198437041,16557904,214994945,0,0,1,2048,6,10069958661
8275,198439560,16555400,214994960,3,0,1,4096,0,4668254310
8276,198455360,608253,199063613,2,0,0,2560,11,6158597097
8277,198468020,16531505,214999525,1,0,1,25088,6,8095502115
8278,198492780,16627542,215120322,4,0,1,65536,4,1253928599
8279,198522230,16598115,215120345,5,0,1,7680,11,5711117402
8280,198524500,16595860,215120360,1,0,1,2560,6,7701207362
8281,198540950,689367,199230317,1,0,0,13824,6,1263374087
8282,198555450,16564933,215120383,4,0,1,18432,4,789801867
8283,198566740,823950,199390690,9,0,0,1536,17,8248660954
8284,198575630,1153303,199728933,1,0,0,446976,6,3148458124
8285,198583910,16536488,215120398,3,0,1,24576,0,2716182093
8286,198585081,17652953,216238034,0,0,1,46080,6,1705608315
8287,198596660,17876599,216473259,7,0,1,8192,16,5484844390
8288,198621000,17852274,216473274,1,0,1,512,6,8242994047
8289,198664510,17812165,216476675,1,0,1,27136,6,6550175184
8290,198666270,801101,199467371,6,0,0,33792,3,5198862530
8291,198686320,757594,199443914,1,0,0,98304,6,9491607994
8292,198702820,17773886,216476706,9,0,1,13824,17,6375029788
8293,198706250,17770487,216476737,3,0,1,12800,0,3293849268
8294,198721280,17755480,216476760,4,0,1,13824,4,7129471748
8295,198760691,17718446,216479137,0,0,1,5120,6,10685300487
8296,198795060,956352,199751412,6,0,0,73728,3,1424606641
8297,198800620,644245,199444865,2,0,0,3072,11,4477161919
8298,198812790,17667115,216479905,4,0,1,11776,4,4458373938
8299,198858850,356796,199215646,9,0,0,5120,17,5192337222
8300,198860490,18093109,216953599,9,0,1,106496,17,2105151938
8301,198875010,570836,199445846,9,0,0,3072,17,3331733055
8302,198913550,372316,199285866,2,0,0,512,11,1924958423
8303,198933050,18026515,216959565,1,0,1,12800,6,2612556903
8304,198935930,555729,199491659,1,0,0,28160,6,223515238
8305,198947110,18208160,217155270,8,0,1,29696,6,7164134696
8306,198947970,913918,199861888,6,0,0,253952,3,3190188527
8307,198954611,18966833,217921444,0,0,1,26112,6,4061203891
8308,198959270,800457,199759727,1,0,0,27136,6,8824815830
8309,199010830,18974191,217985021,3,0,1,17408,0,2756426893
8310,199010861,18974175,217985036,0,0,1,21504,6,1943916835
8311,199026000,18959059,217985059,4,0,1,14848,4,4755700315
8312,199028400,753674,199782074,1,0,0,73216,6,5601014074
8313,199028910,19058022,218086932,1,0,1,1024,6,3252084920
8314,199038920,823927,199862847,9,0,0,3072,17,8891386615
8315,199049400,19144891,218194291,4,0,1,5632,4,3011074338
8316,199069290,20482016,219551306,9,0,1,271360,17,4176033623
8317,199124690,962683,200087373,1,0,0,308224,6,4967788241
8318,199146610,722235,199868845,1,0,0,19456,6,5914806438
8319,199173510,610808,199784318,2,0,0,512,11,1845960376
8320,199176510,607622,199784132,2,0,0,6656,11,8603700242
8321,199252600,20352833,219605433,1,0,1,24576,6,4394189522
8322,199271170,20344582,219615752,4,0,1,11264,4,763801900
8323,199299960,20321386,219621346,3,0,1,18432,0,3238215569
8324,199327190,20393133,219720323,1,0,1,5632,6,6237978950
8325,199362550,20415012,219777562,4,0,1,15360,4,4878051270
8326,199365550,20412985,219778535,1,0,1,12800,6,8425805437
8327,199367320,417169,199784489,2,0,0,512,11,4697649631
8328,199458280,20413073,219871353,7,0,1,9216,16,6536745923
8329,199473480,20767723,220241203,7,0,1,48128,16,9452785195
8330,199527270,20803309,220330579,4,0,1,14848,4,8065771593
8331,199533740,596055,200129795,6,0,0,131584,3,7913204506
8332,199574890,363598,199938488,9,0,0,9728,17,5909705349
8333,199577970,511664,200089634,0,0,0,7168,6,3813236897
8334,199592010,20738600,220330610,1,0,1,14848,6,9473258496
8335,199596510,575414,200171924,0,0,0,16896,6,2128489471
8336,199608130,21356863,220964993,8,0,1,28160,6,884056684
8337,199665860,21635850,221301710,9,0,1,108544,17,5078624234
8338,199688650,21664710,221353360,6,0,1,1024,3,5052757262
8339,199750810,21602896,221353706,4,0,1,512,4,3125926194
8340,199760820,735442,200496262,6,0,0,94720,3,7696691062
8341,199819210,21626496,221445706,7,0,1,49664,16,6992320135
8342,199833270,721569,200554839,9,0,0,2048,17,3238936454
8343,199856350,21635049,221491399,6,0,1,17408,3,6408711078
8344,199862270,21822534,221684804,6,0,1,43008,3,8654972679
8345,199870160,21923419,221793579,3,0,1,5120,0,9248359786
8346,199874800,507201,200382001,0,0,0,68096,6,3362597783
8347,199875850,21917744,221793594,7,0,1,4608,16,1785443996
8348,199882720,724894,200607614,6,0,0,173056,3,1985346264
8349,199884050,22275447,222159497,9,0,1,114176,17,4786971748
8350,199887730,442410,200330140,2,0,0,2560,11,5298180063
8351,199900960,653232,200554192,0,0,0,183808,6,4382260064
8352,199901780,358707,200260487,2,0,0,2048,11,1110372412
8353,199904670,593487,200498157,9,0,0,6144,17,241691421
8354,199906140,313993,200220133,9,0,0,512,17,3973904717
8355,199906260,22254863,222161123,3,0,1,2560,0,414663996
8356,199913000,22250955,222163955,3,0,1,12800,0,2216288039
8357,199915200,218010,200133210,1,0,0,10752,6,8989342237
8358,199918400,328655,200247055,2,0,0,2048,11,2075463764
8359,199949360,22221462,222170822,3,0,1,11264,0,6097169800
8360,199986640,22185488,222172128,3,0,1,2048,0,8577480863
8361,200012630,22169512,222182142,6,0,1,14848,3,4853241348
8362,200012710,22216373,222229083,7,0,1,14848,16,1939733285
8363,200016600,22212498,222229098,1,0,1,11776,6,7626028371
8364,200044760,619167,200663927,0,0,0,103424,6,4717540148
8365,200053920,22177551,222231471,4,0,1,10752,4,7008297721
8366,200059070,22173477,222232547,6,0,1,13312,3,9488731698
8367,200084170,22425291,222509461,3,0,1,13312,0,8173500902
8368,200094270,755537,200849807,0,0,0,60928,6,10253383041
8369,200125010,889650,201014660,6,0,0,279040,3,2995208628
8370,200159390,23687106,223846496,9,0,1,539136,17,5933239442
8371,200175250,23738847,223914097,6,0,1,50688,3,1124694135
8372,200186430,585782,200772212,1,0,0,115712,6,1745234668
8373,200202720,23757115,223959835,4,0,1,39424,4,8593372630
8374,200224160,23735698,223959858,3,0,1,6144,0,7993854851
8375,200275060,23716512,223991572,4,0,1,20480,4,10458631263
8376,200292140,23724454,224016594,9,0,1,61952,17,9241280511
8377,200302890,23713719,224016609,6,0,1,9216,3,10498569764
8378,200312640,23704024,224016664,1,0,1,17408,6,5319267853
8379,200324720,730639,201055359,6,0,0,62464,3,9220046993
8380,200332510,926481,201258991,0,0,0,196608,6,5572445337
8381,200418860,23678954,224097814,7,0,1,1024,16,2384454743
8382,200423960,591659,201015619,2,0,0,3072,11,1602765335
8383,200429100,840857,201269957,0,0,0,32256,6,1949716757
8384,200430890,23806993,224237883,7,0,1,58880,16,609927818
8385,200468990,547580,201016570,2,0,0,3072,11,4593899781
8386,200480350,23953155,224433505,9,0,1,162816,17,4765960378
8387,200494990,229998,200724988,0,0,0,10240,6,8321172009
8388,200511490,369310,200880800,9,0,0,1024,17,7664811798
8389,200520310,23913210,224433520,4,0,1,4096,4,8595647106
8390,200523540,736558,201260098,2,0,0,3584,11,5042841589
8391,200544260,944003,201488263,6,0,0,63488,3,5807032588
8392,200549020,23884523,224433543,1,0,1,35328,6,8624376777
8393,200571060,23862498,224433558,9,0,1,31744,17,4977492107
8394,200572210,460155,201032365,6,0,0,51712,3,5785402297
8395,200613550,809799,201423349,0,0,0,8704,6,1794102172
8396,200619640,551026,201170666,0,0,0,113664,6,6959954361
8397,200635590,420468,201056058,2,0,0,1024,11,10524623068
8398,200653690,711351,201365041,0,0,0,194560,6,6682055480
8399,200700090,24060507,224760597,9,0,1,238592,17,5364937852
8400,200710170,24050442,224760612,3,0,1,1536,0,901821191
8401,200711710,24048917,224760627,7,0,1,8192,16,2016179970
8402,200723870,331861,201055731,9,0,0,1024,17,2540485748
8403,200774780,24345827,225120607,9,0,1,165376,17,1372440569
8404,200780040,24374988,225155028,7,0,1,38400,16,429948399
8405,200792440,590400,201382840,0,0,0,58368,6,6049233112
8406,200795200,622815,201418015,1,0,0,84992,6,9034261697
8407,200805880,869337,201675217,0,0,0,126464,6,5310586938
8408,200806610,252097,201058707,2,0,0,512,11,3209533782
8409,200833180,302831,201136011,0,0,0,42496,6,2655501141
8410,200848280,24394693,225242973,4,0,1,65024,4,2523807379
8411,200856750,24386238,225242988,6,0,1,1536,3,3124740485
8412,200860400,24382603,225243003,7,0,1,12288,16,5550369621
8413,200867160,720668,201587828,1,0,0,46592,6,5028537985
8414,200874950,24368068,225243018,4,0,1,30720,4,8800145959
8415,200875150,24392117,225267267,7,0,1,37888,16,6507273934
8416,200892590,24379834,225272424,3,0,1,6144,0,8596411291
8417,200893920,811420,201705340,6,0,0,98816,3,3437742574
8418,200913550,24365339,225278889,3,0,1,30720,0,4834347513
8419,200924680,24355592,225280272,6,0,1,14848,3,3616055060
8420,200929530,342322,201271852,9,0,0,6144,17,159816543
8421,200938050,24350827,225288877,4,0,1,12288,4,8779300703
8422,200979910,24328585,225308495,7,0,1,18432,16,8909593906
8423,200997740,24349222,225346962,6,0,1,7680,3,6681019982
8424,201000360,24348449,225348809,9,0,1,67584,17,760748955
8425,201051420,24337402,225388822,9,0,1,66560,17,6035083740
8426,201055860,24362038,225417898,4,0,1,25600,4,4237848500
8427,201082290,24337554,225419844,6,0,1,3072,3,6841755096
8428,201103760,24345430,225449190,4,0,1,33280,4,9624793399
8429,201107630,881288,201988918,1,0,0,482304,6,2116451910
8430,201117080,24333096,225450176,4,0,1,1536,4,3402034877
8431,201132980,287702,201420682,2,0,0,8704,11,4816529912
8432,201142630,677849,201820479,6,0,0,110592,3,3438526634
8433,201143760,567791,201711551,6,0,0,17408,3,8329761087
8434,201178650,441896,201620546,9,0,0,6656,17,1950707656
8435,201224030,24393334,225617364,9,0,1,217600,17,10179371289
8436,201232220,524839,201757059,0,0,0,54784,6,3471929159
8437,201241190,24447068,225688258,7,0,1,22016,16,3114909374
8438,201254890,24433383,225688273,4,0,1,3584,4,2589625155
8439,201285350,1114950,202400300,6,0,0,158208,3,1550662774
8440,201289790,430027,201719817,1,0,0,8192,6,3163146980
8441,201304630,24404577,225709207,4,0,1,23040,4,2967892279
8442,201311110,807413,202118523,1,0,0,108544,6,4406361483
8443,201325370,24387482,225712852,6,0,1,81920,3,223905136
8444,201332170,24384868,225717038,4,0,1,6656,4,10510053113
8445,201403850,948223,202352073,1,0,0,314368,6,6892288637
8446,201412270,24306074,225718344,4,0,1,2048,4,10402883942
8447,201427490,584484,202011974,9,0,0,1536,17,3815807616
8448,201487040,24236450,225723490,6,0,1,8192,3,2143953440
8449,201491310,24239285,225730595,6,0,1,21504,3,14416858
8450,201508840,24263688,225772528,6,0,1,11264,3,6814502732
8451,201514580,682442,202197022,2,0,0,3584,11,7087144718
8452,201529970,1056379,202586349,1,0,0,245760,6,26660644
8453,201594960,24177583,225772543,4,0,1,16384,4,6195700659
8454,201605960,1291012,202896972,1,0,0,240640,6,4069401774
8455,201611710,1102909,202714619,0,0,0,281088,6,5188716474
8456,201681980,348138,202030118,9,0,0,5632,17,3521467266
8457,201684120,794166,202478286,2,0,0,512,11,6859435862
8458,201694030,1215983,202910013,6,0,0,37376,3,3024390398
8459,201767410,659537,202426947,9,0,0,512,17,7108073022
8460,201768800,1050423,202819223,6,0,0,99840,3,6032384806
8461,201775660,23996898,225772558,8,0,1,34304,6,6905209294
8462,201798750,830202,202628952,6,0,0,139776,3,9496445414
8463,201799620,1178080,202977700,6,0,0,139776,3,1031257853
8464,201860580,927881,202788461,1,0,0,239104,6,9599593754
8465,201918070,1307416,203225486,1,0,0,236032,6,5418695075
8466,202077580,821030,202898610,2,0,0,5120,11,9950453476
8467,202149660,251287,202400947,0,0,0,2048,6,6937197693
8468,202205290,23567283,225772573,2,0,1,1536,11,5486064913
8469,202218660,23554732,225773392,3,0,1,4096,0,9669381524
8470,202220760,23560275,225781035,4,0,1,21504,4,8535534402
8471,202233740,23555897,225789637,4,0,1,512,4,6985313583
8472,202287010,532696,202819706,2,0,0,1536,11,9197120127
8473,202320180,590200,202910380,9,0,0,1024,17,10209406406
8474,202367020,421768,202788788,9,0,0,1024,17,3607044005
8475,202403920,311674,202715594,2,0,0,3072,11,5393579030
8476,202405780,23383872,225789652,4,0,1,512,4,7870230913
8477,202415780,562247,202978027,9,0,0,1024,17,421736755
8478,202459250,23330417,225789667,3,0,1,5632,0,6411632455
8479,202460070,23330786,225790856,3,0,1,3584,0,2727644015
8480,202477600,651266,203128866,6,0,0,133632,3,8445067961
8481,202481770,341859,202823629,9,0,0,12800,17,7173561962
8482,202509410,569866,203079276,1,0,0,47616,6,2173109611
8483,202523930,805786,203329716,0,0,0,211968,6,4554133890
8484,202550920,23241524,225792444,4,0,1,15872,4,10550742868
8485,202586190,23211864,225798054,4,0,1,8192,4,8318781353
8486,202617910,23194918,225812828,3,0,1,24064,0,10287596794
8487,202690441,23134614,225825055,0,0,1,7680,6,496262782
8488,202699380,907306,203606686,6,0,0,35840,3,8611092351
8489,202710600,652851,203363451,6,0,0,110592,3,5094270597
8490,202715380,23126909,225842289,4,0,1,22016,4,10296797597
8491,202719300,23124615,225843915,2,0,1,2560,11,6054195366
8492,202817080,23165408,225982488,4,0,1,32256,4,10165190307
8493,202844080,23146714,225990794,3,0,1,3584,0,8567092847
8494,202853470,23137347,225990817,2,0,1,3584,11,4124575662
8495,202857110,853916,203711026,6,0,0,55296,3,740413403
8496,202911521,23079311,225990832,0,0,1,1024,6,5552559058
8497,202914860,315703,203230563,9,0,0,3072,17,10078689189
8498,202941940,284505,203226445,2,0,0,3072,11,4614409156
8499,202944601,23046246,225990847,0,0,1,10752,6,5019287206
8500,202959870,23191206,226151076,9,0,1,222720,17,855142947
8501,202976380,23174719,226151099,3,0,1,6656,0,3298153637
8502,203002040,23149082,226151122,3,0,1,27648,0,10142452105
8503,203007020,588715,203595735,1,0,0,46080,6,1141211790
8504,203035110,630395,203665505,2,0,0,1024,11,4682034708
8505,203054770,23096367,226151137,2,0,1,14336,11,5127063679
8506,203062550,519130,203581680,1,0,0,280064,6,3190215921
8507,203082770,23068398,226151168,2,0,1,36864,11,664236853
8508,203104060,23047123,226151183,2,0,1,7680,11,4748578605
8509,203114690,687486,203802176,9,0,0,1024,17,6940739534
8510,203137630,23013568,226151198,1,0,1,512,6,8478376007
8511,203143820,658013,203801833,1,0,0,297984,6,9200301082
8512,203165540,22985673,226151213,1,0,1,1536,6,3903621520
8513,203177500,22973736,226151236,2,0,1,13312,11,2589700094
8514,203191590,22959661,226151251,4,0,1,2048,4,10195491435
8515,203199150,22952116,226151266,3,0,1,19456,0,2935389141
8516,203236080,566267,203802347,9,0,0,512,17,5070037711
8517,203290640,22860641,226151281,7,0,1,1024,16,1837055245
8518,203296670,22854626,226151296,3,0,1,3584,0,4054849249
8519,203307590,22852627,226160217,1,0,1,22528,6,6921872403
8520,203323990,22836381,226160371,2,0,1,8704,11,8525262852
8521,203422290,22741243,226163533,2,0,1,13824,11,10671829321
8522,203448301,22723477,226171778,0,0,1,6656,6,296528106
8523,203482800,22695289,226178089,3,0,1,22016,0,7032622604
8524,203486991,22727117,226214108,0,0,1,39424,6,6595413906
8525,203552600,738020,204290620,1,0,0,107520,6,5643494933
8526,203557310,377731,203935041,1,0,0,83968,6,9526293537
8527,203625380,547915,204173295,1,0,0,236544,6,3676583153
8528,203657570,147772,203805342,2,0,0,9728,11,1268450115
8529,203674280,22540174,226214454,4,0,1,512,4,2301187786
8530,203676520,228706,203905226,1,0,0,54272,6,9590959592
8531,203699330,475243,204174573,2,0,0,4096,11,2120495228
8532,203723550,716545,204440095,1,0,0,268288,6,4854566431
8533,203749220,426007,204175227,9,0,0,2048,17,1413159739
8534,203755410,543509,204298919,6,0,0,27136,3,6515364873
8535,203761910,691958,204453868,1,0,0,44544,6,6556031170
8536,203768851,22446986,226215837,0,0,1,14848,6,2626725746
8537,203925300,897812,204823112,6,0,0,121856,3,6053305924
8538,203992310,685901,204678211,9,0,0,195584,17,1845637807
8539,204005270,480155,204485425,2,0,0,2560,11,4556404397
8540,204042930,710732,204753662,9,0,0,207872,17,1249761750
8541,204165320,274961,204440281,2,0,0,512,11,7263100922
8542,204261030,21988868,226249898,4,0,1,26624,4,5800072784
8543,204262990,660008,204922998,9,0,0,277504,17,138539438
8544,204281521,21969248,226250769,0,0,1,12288,6,2537692639
8545,204291600,21961435,226253035,2,0,1,3584,11,5407871446
8546,204351120,574117,204925237,6,0,0,7168,3,6457061608
8547,204494660,259173,204753833,2,0,0,512,11,2097588541
8548,204542921,21714620,226257541,0,0,1,7168,6,1976415853
8549,204615150,764365,205379515,1,0,0,264704,6,9788515215
8550,204633880,21953166,226587046,9,0,1,218112,17,7307621024
8551,204705361,21890014,226595375,0,0,1,14336,6,9727595324
8552,204758040,703319,205461359,9,0,0,236544,17,5250912320
8553,204791870,21808891,226600761,2,0,1,7168,11,8616756524
8554,204858280,21743467,226601747,2,0,1,1536,11,149548695
8555,204871330,591468,205462798,6,0,0,4096,3,9631773254
8556,204891281,21744638,226635919,0,0,1,20992,6,1677496258
8557,204914460,21743712,226658172,2,0,1,10752,11,7909322381
8558,204916610,472662,205389272,1,0,0,31744,6,6664226368
8559,204927070,628698,205555768,6,0,0,159744,3,206734818
8560,205006950,21657533,226664483,3,0,1,22016,0,9994048071
8561,205051571,21731729,226783300,0,0,1,2048,6,7777753970
8562,205055170,21729112,226784282,2,0,1,26112,11,5500036742
8563,205099030,21685291,226784321,3,0,1,33280,0,9937283811
8564,205129000,21655336,226784336,3,0,1,5632,0,3608724581
8565,205157050,21627301,226784351,3,0,1,6656,0,5576625177
8566,205224470,373789,205598259,9,0,0,11264,17,5081374169
8567,205233790,21550576,226784366,3,0,1,15360,0,7079439964
8568,205243731,21540837,226784568,0,0,1,6656,6,8973999356
8569,205304860,21479723,226784583,3,0,1,14848,0,8938677153
8570,205306370,21527740,226834110,3,0,1,49664,0,8544316958
8571,205321910,21516715,226838625,3,0,1,24576,0,6499951371
8572,205336270,21525986,226862256,3,0,1,4096,0,10196994487
8573,205340280,21525202,226865482,3,0,1,5120,0,6377455472
8574,205389680,249392,205639072,2,0,0,512,11,5441115740
8575,205400901,21475052,226875953,0,0,1,15872,6,754989377
8576,205469530,21549477,227019007,2,0,1,2560,11,496230156
8577,205471370,123410,205594780,2,0,0,1024,11,6775827266
8578,205475930,354486,205830416,2,0,0,1536,11,3908647713
8579,205505250,507295,206012545,6,0,0,275456,3,6389573834
8580,205592690,595383,206188073,9,0,0,331776,17,973725094
8581,205595550,712661,206308211,0,0,0,7168,6,4870457842
8582,205654340,21364690,227019030,3,0,1,1536,0,3609077444
8583,205744400,21719278,227463678,9,0,1,237056,17,8616890978
8584,205768560,21695133,227463693,3,0,1,5632,0,2148614925
8585,205840470,21626405,227466875,2,0,1,67584,11,3849336320
8586,205913210,21612555,227525765,8,0,1,36352,6,3148322178
8587,205976270,21549510,227525780,2,0,1,5632,11,8052373828
8588,206002330,21523465,227525795,3,0,1,4608,0,8303893043
8589,206009140,21516670,227525810,3,0,1,22528,0,179194065
8590,206045630,21520826,227566456,8,0,1,51712,6,2995861252
8591,206048310,257702,206306012,9,0,0,86016,17,7308041628
8592,206071060,21591635,227662695,8,0,1,34304,6,10583808940
8593,206080510,21582208,227662718,2,0,1,24064,11,1335003558
8594,206125220,21537840,227663060,2,0,1,37888,11,7888542678
8595,206139040,21524035,227663075,3,0,1,26112,0,10024308143
8596,206257850,114608,206372458,2,0,0,2048,11,1883855659
8597,206284660,680227,206964887,9,0,0,236032,17,10558315612
8598,206351140,21311950,227663090,2,0,1,16896,11,6046677105
8599,206357770,336847,206694617,9,0,0,180224,17,9690982251
8600,206452550,21210555,227663105,2,0,1,5120,11,9182100169
8601,206529190,703063,207232253,6,0,0,299008,3,5880704737
8602,206621420,21048168,227669588,3,0,1,7680,0,9661034378
8603,206721010,20951484,227672494,3,0,1,4608,0,533812547
8604,206768850,312993,207081843,2,0,0,2560,11,2736629317
8605,206951520,846181,207797701,9,0,0,375808,17,2277933927
8606,206973040,20703000,227676040,3,0,1,5632,0,10273557771
8607,206979040,20710433,227689473,3,0,1,39936,0,3455578965
8608,207043450,356203,207399653,2,0,0,2048,11,6390402336
8609,207124420,334884,207459304,2,0,0,10752,11,8753924830
8610,207126790,20563861,227690651,4,0,1,13824,4,4311156797
8611,207258570,420646,207679216,2,0,0,2560,11,9256613883
8612,207282490,182351,207464841,6,0,0,5120,3,2022304705
8613,207298770,20407113,227705883,7,0,1,4608,16,10360235537
8614,207331610,224279,207555889,2,0,0,3584,11,421500310
8615,207376240,20344270,227720510,9,0,1,26624,17,7146529109
8616,207378450,20361414,227739864,3,0,1,34304,0,77263882
8617,207399700,208302,207608002,2,0,0,3584,11,5232194864
8618,207429010,20311200,227740210,3,0,1,512,0,9759920328
8619,207447040,20325867,227772907,2,0,1,32256,11,3649457984
8620,207452680,74279,207526959,2,0,0,2048,11,3824152095
8621,207476810,20297680,227774490,2,0,1,8704,11,6786683026
8622,207476980,20300736,227777716,7,0,1,5120,16,4895529953
8623,207495980,434350,207930330,9,0,0,79360,17,1165017371
8624,207500320,20282440,227782760,7,0,1,19968,16,547642228
8625,207501670,20301285,227802955,3,0,1,20480,0,5044464794
8626,207521540,20285921,227807461,9,0,1,7168,17,9240896370
8627,207579170,20243645,227822815,7,0,1,24576,16,3432523573
8628,207584720,20278334,227863054,2,0,1,32768,11,4228709594
8629,207628110,20266227,227894337,7,0,1,28672,16,1014382652
8630,207646620,20254330,227900950,7,0,1,16896,16,1291598400
8631,207649860,20259309,227909169,3,0,1,18432,0,1001342329
8632,207709080,20277615,227986695,9,0,1,63488,17,755938935
8633,207717390,222133,207939523,2,0,0,512,11,6215232915
8634,207774190,180322,207954512,2,0,0,512,11,9831694549
8635,207788260,20262292,228050552,2,0,1,32256,11,1793010494
8636,207885130,20165445,228050575,5,0,1,19968,11,4577668849
8637,207912870,20143039,228055909,2,0,1,37376,11,99558925
8638,207946960,20208574,228155534,9,0,1,163840,17,8693371063
8639,207948920,338613,208287533,9,0,0,8704,17,8135632181
8640,207977330,307287,208284617,6,0,0,5120,3,5212387531
8641,208020410,20181727,228202137,3,0,1,34304,0,3358386692
8642,208028060,358887,208386947,6,0,0,107008,3,6012960715
8643,208046990,446045,208493035,6,0,0,98816,3,9975093668
8644,208111890,20090503,228202393,5,0,1,9216,11,9257595213
8645,208261090,19946360,228207450,7,0,1,18944,16,5652410257
8646,208265010,19950689,228215699,3,0,1,8704,0,9157543217
8647,208278260,606935,208885195,6,0,0,407552,3,7187869925
8648,208279440,19942570,228222010,5,0,1,22016,11,6705816776
8649,208288100,804800,209092900,6,0,0,83456,3,9362108947
8650,208288620,19944754,228233374,2,0,1,27136,11,10726009610
8651,208290100,21378170,229668270,9,0,1,537600,17,101609272
8652,208290530,21377755,229668285,5,0,1,7680,11,2348000839
8653,208320910,21348365,229669275,3,0,1,32768,0,9321253062
8654,208339040,552293,208891333,6,0,0,18432,3,9175948056
8655,208350600,21318690,229669290,2,0,1,5120,11,3326769565
8656,208384090,21285215,229669305,1,0,1,3072,6,2953982544
8657,208394510,21274866,229669376,9,0,1,114176,17,2924587562
8658,208400230,21269169,229669399,2,0,1,7680,11,9360735760
8659,208423280,21246142,229669422,3,0,1,16896,0,8834999278
8660,208424140,21245297,229669437,7,0,1,4096,16,886468649
8661,208433120,452558,208885678,2,0,0,1536,11,8257426241
8662,208442140,21227312,229669452,3,0,1,6656,0,8768447570
8663,208447680,21221958,229669638,5,0,1,7168,11,7014280212
8664,208453180,21216473,229669653,3,0,1,16896,0,2884141886
8665,208488540,21181128,229669668,1,0,1,3584,6,3776311604
8666,208532230,21137453,229669683,3,0,1,5120,0,2517114447
8667,208549910,21119788,229669698,2,0,1,512,11,9854713951
8668,208555000,496818,209051818,6,0,0,261632,3,2900261188
8669,208633480,21036233,229669713,1,0,1,2048,6,2026258779
8670,208639160,428273,209067433,6,0,0,51200,3,1027788939
8671,208685360,20984392,229669752,3,0,1,28672,0,8110284303
8672,208726420,20943600,229670020,7,0,1,2048,16,936748419
8673,208737450,21418338,230155788,9,0,1,271872,17,5553358266
8674,208764170,21415454,230179624,3,0,1,16896,0,3200454132
8675,208784900,21396990,230181890,2,0,1,3584,11,6244221195
8676,208796130,456293,209252423,2,0,0,5632,11,1262046888
8677,208855410,21431385,230286795,7,0,1,3072,16,5935814762
8678,208871680,21518917,230390597,2,0,1,34304,11,6261873307
8679,208935440,21778594,230714034,9,0,1,359936,17,7204069803
8680,208943200,416443,209359643,2,0,0,1024,11,2405456187
8681,208946180,22180916,231127096,9,0,1,382464,17,5188346257
8682,208997210,22135903,231133113,7,0,1,20480,16,10182567243
8683,209060950,22072509,231133459,3,0,1,512,0,5175324472
8684,209092180,22046668,231138848,3,0,1,17408,0,6779747468
8685,209094180,411606,209505786,9,0,0,82432,17,2887712121
8686,209107270,22097601,231204871,9,0,1,107520,17,322472701
8687,209169920,22040097,231210017,1,0,1,8192,6,6385196354
8688,209176580,22063139,231239719,2,0,1,7168,11,7165244121
8689,209208080,359329,209567409,2,0,0,512,11,6673765100
8690,209214910,196761,209411671,2,0,0,512,11,4923711564
8691,209238980,22001457,231240437,2,0,1,19456,11,8432086729
8692,209267780,89883,209357663,2,0,0,4608,11,6392908320
8693,209268440,21977427,231245867,3,0,1,8192,0,10009348055
8694,209268480,21977848,231246328,7,0,1,10240,16,9195124743
8695,209289920,22027788,231317708,5,0,1,44032,11,8808527148
8696,209345691,192537,209538228,7,0,0,16384,16,766653557
8697,209345960,21971771,231317731,3,0,1,10752,0,2816009984
8698,209373210,21944544,231317754,7,0,1,10240,16,3261023076
8699,209376490,338339,209714829,6,0,0,107520,3,2240233828
8700,209389980,21927797,231317777,1,0,1,16384,6,2775317970
8701,209392140,323359,209715499,2,0,0,2048,11,4330900633
8702,209415200,21902600,231317800,4,0,1,15872,4,10094503951
8703,209447070,21870753,231317823,1,0,1,13312,6,6021594907
8704,209452760,21875286,231328046,3,0,1,512,0,1554939434
8705,209459990,21899960,231359950,9,0,1,75264,17,6389357744
8706,209485250,21893178,231378428,3,0,1,11776,0,1141775780
8707,209508270,21905247,231413517,7,0,1,18944,16,1626487563
8708,209550100,512310,210062410,9,0,0,153600,17,10545995190
8709,209593480,376053,209969533,2,0,0,3072,11,9125857360
8710,209614680,21801423,231416103,3,0,1,4096,0,945867843
8711,209625820,670441,210296261,6,0,0,379392,3,121289208
8712,209667520,21750325,231417845,3,0,1,24576,0,8041831905
8713,209680130,21779750,231459880,3,0,1,27136,0,4792102219
8714,209685110,21830971,231516081,7,0,1,29184,16,6463812469
8715,209700130,21816777,231516907,7,0,1,33792,16,2527769142
8716,209721160,21829755,231550915,3,0,1,30208,0,7686776918
8717,209725580,184444,209910024,2,0,0,512,11,8102010458
8718,209726280,21833230,231559510,1,0,1,4096,6,4649652793
8719,209751560,21809889,231561449,1,0,1,512,6,9903109536
8720,209753520,21808185,231561705,1,0,1,9216,6,8970084232
8721,209814740,320726,210135466,9,0,0,58880,17,3750538795
8722,209849940,485873,210335813,6,0,0,31232,3,8038455485
8723,209897620,428646,210326266,6,0,0,98304,3,3916816875
8724,209945350,391102,210336452,2,0,0,2048,11,4825608838
8725,209953060,508365,210461425,6,0,0,228864,3,2885781468
8726,209998080,493792,210491872,6,0,0,70656,3,8017836184
8727,210033990,632252,210666242,6,0,0,102400,3,7695313837
8728,210108240,710359,210818599,2,0,0,2560,11,8879297817
8729,210211330,21351348,231562678,9,0,1,12800,17,4789654815
8730,210269230,21294434,231563664,7,0,1,1536,16,2285951059
8731,210335990,603480,210939470,9,0,0,172032,17,6530128907
8732,210370800,21233992,231604792,3,0,1,25088,0,10695279554
8733,210373620,21234853,231608473,3,0,1,8704,0,9745103022
8734,210384950,210885,210595835,2,0,0,1536,11,7729707714
8735,210386220,867481,211253701,9,0,0,177152,17,8837203119
8736,210393560,21215259,231608819,7,0,1,512,16,9635086600
8737,210406600,411196,210817796,6,0,0,10752,3,2906273067
8738,210454830,21155935,231610765,7,0,1,3072,16,4408811737
8739,210466010,21145421,231611431,3,0,1,1024,0,4431872503
8740,210485220,21133595,231618815,3,0,1,8192,0,315106693
8741,210509650,289032,210798682,9,0,0,41472,17,1415989454
8742,210522090,21177218,231699308,3,0,1,41472,0,1911250640
8743,210568570,529583,211098153,2,0,0,1024,11,1642415420
8744,210582190,515636,211097826,1,0,0,120320,6,9447737969
8745,210589880,396524,210986404,9,0,0,29696,17,4003605862
8746,210606920,21092403,231699323,5,0,1,17920,11,3505401024
8747,210640150,637806,211277956,9,0,0,79360,17,582791738
8748,210647390,21051948,231699338,7,0,1,4608,16,2796396367
8749,210672480,21031568,231704048,7,0,1,5120,16,2579603834
8750,210681520,21031421,231712941,3,0,1,34304,0,555085888
8751,210706490,327593,211034083,2,0,0,2560,11,6649354137
8752,210814650,291334,211105984,6,0,0,25600,3,7541406792
8753,210935970,20777842,231713812,3,0,1,12288,0,3156876752
8754,210980460,420967,211401427,9,0,0,135680,17,5086681955
8755,211033910,427428,211461338,6,0,0,69632,3,2518084750
8756,211059910,237568,211297478,2,0,0,1024,11,4195465402
8757,211083470,211097,211294567,2,0,0,7680,11,8638445801
8758,211085760,502474,211588234,9,0,0,92672,17,6462947833
8759,211164160,424260,211588420,2,0,0,512,11,6929266446
8760,211295480,20422255,231717735,3,0,1,2560,0,1356662527
8761,211302960,20433029,231735989,3,0,1,23040,0,6503525057
8762,211419660,788594,212208254,6,0,0,125440,3,3866247076
8763,211460880,486773,211947653,9,0,0,45056,17,2395311717
8764,211471560,547596,212019156,1,0,0,38400,6,4544633188
8765,211485600,217039,211702639,1,0,0,6144,6,9909370378
8766,211492250,266945,211759195,9,0,0,111104,17,8901862273
8767,211532730,20207815,231740545,3,0,1,18432,0,8444981506
8768,211568920,601099,212170019,9,0,0,41984,17,2644848853
8769,211569490,702955,212272445,6,0,0,194560,3,10194316797
8770,211664260,480984,212145244,2,0,0,2560,11,1896916955
8771,211711800,291166,212002966,2,0,0,512,11,2298764242
8772,211716160,566486,212282646,1,0,0,29696,6,1891401547
8773,211768170,19976379,231744549,9,0,1,11776,17,6336451116
8774,211805700,19959252,231764952,9,0,1,9728,17,970516854
8775,211823750,725709,212549459,9,0,0,292864,17,2444787987
8776,211823900,449675,212273575,1,0,0,3584,6,7284050718
8777,211940120,19825396,231765516,5,0,1,10752,11,3271502430
8778,211958960,736870,212695830,9,0,0,158720,17,7191111761
8779,211991130,559103,212550233,2,0,0,2048,11,9099943497
8780,212047090,905910,212953000,6,0,0,77824,3,7504569333
8781,212110020,313379,212423399,9,0,0,40448,17,9721752641
8782,212121240,19664361,231785601,5,0,1,3072,11,5904506439
8783,212139590,789539,212929129,1,0,0,266752,6,1099408324
8784,212144650,967582,213112232,6,0,0,233472,3,5160787818
8785,212146380,19645079,231791459,9,0,1,9728,17,1040379194
8786,212191270,19600650,231791920,5,0,1,10240,11,7493274402
8787,212214990,481026,212696016,2,0,0,512,11,5516106917
8788,212253800,19623562,231877362,3,0,1,64512,0,8573112858
8789,212360520,19570553,231931073,5,0,1,11776,11,4314923659
8790,212374180,592719,212966899,1,0,0,45568,6,6057225808
8791,212381210,19553409,231934619,5,0,1,5632,11,7032429421
8792,212422480,414820,212837300,6,0,0,5632,3,7112078930
8793,212437170,894641,213331811,6,0,0,84992,3,3093853755
8794,212537110,19420173,231957283,5,0,1,6144,11,8315346775
8795,212552400,488651,213041051,1,0,0,198656,6,5982404501
8796,212618790,510195,213128985,6,0,0,46592,3,2289620888
8797,212726190,776624,213502814,6,0,0,120320,3,5912926916
8798,212816610,297985,213114595,9,0,0,7680,17,1924468322
8799,212818040,296726,213114766,2,0,0,512,11,10341056969
8800,212831950,351225,213183175,9,0,0,44032,17,7595112798
8801,212856110,423702,213279812,9,0,0,55296,17,7636808267
8802,212872640,433245,213305885,9,0,0,34304,17,6103742946
8803,212897430,231897,213129327,2,0,0,1024,11,4688316921
8804,213045730,608318,213654048,9,0,0,162816,17,10555574227
8805,213074040,686103,213760143,9,0,0,217088,17,9510930944
8806,213139180,751035,213890215,1,0,0,186368,6,3517250008
8807,213168540,601031,213769571,1,0,0,18944,6,6082865866
8808,213191700,18817993,232009693,4,0,1,30208,4,94646468
8809,213239700,677065,213916765,9,0,0,87040,17,601614670
8810,213373470,404882,213778352,2,0,0,1536,11,4665061613
8811,213401540,545306,213946846,9,0,0,68608,17,2325253746
8812,213429790,495444,213925234,6,0,0,27648,3,1493032364
8813,213445520,625103,214070623,6,0,0,198144,3,3246449188
8814,213448490,18597374,232045864,4,0,1,1536,4,6022777882
8815,213480800,351540,213832340,6,0,0,13312,3,8419189428
8816,213495640,268144,213763784,1,0,0,11776,6,3386740643
8817,213534000,18591130,232125130,4,0,1,33792,4,8255533993
8818,213569900,18555576,232125476,4,0,1,512,4,4866644242
8819,213602760,18536184,232138944,4,0,1,16896,4,4622981930
8820,213611560,18536224,232147784,1,0,1,5632,6,8817986841
8821,213612220,338364,213950584,6,0,0,6144,3,8477993213
8822,213664970,260941,213925911,2,0,0,2048,11,4739322311
8823,213710940,18451624,232162564,2,0,1,23552,11,4353447988
8824,213743010,368319,214111329,2,0,0,6144,11,7760645138
8825,213746370,397268,214143638,2,0,0,512,11,10021310425
8826,213760400,188297,213948697,2,0,0,3072,11,2766823231
8827,213774720,325156,214099876,6,0,0,62976,3,9736651342
8828,213776160,405701,214181861,6,0,0,14336,3,2796464375
8829,213796970,321965,214118935,2,0,0,2048,11,5632151921
8830,213813590,261322,214074912,9,0,0,13824,17,9761108415
8831,213884300,703078,214587378,1,0,0,96768,6,8775600879
8832,213901210,644766,214545976,6,0,0,195584,3,2336579627
8833,213913950,348226,214262176,2,0,0,512,11,7797524059
8834,213934510,313858,214248368,6,0,0,20480,3,9238595274
8835,213983410,18203416,232186826,1,0,1,23552,6,6706482
8836,214011530,18227947,232239477,8,0,1,11264,6,5175523408
8837,214033190,18206727,232239917,4,0,1,4608,4,8349293078
8838,214045170,666354,214711524,9,0,0,272384,17,6528922554
8839,214049880,507991,214557871,9,0,0,38912,17,4427642472
8840,214134750,860021,214994771,1,0,0,323584,6,3172328905
8841,214187210,18059223,232246433,7,0,1,23040,16,1340409454
8842,214207710,18067169,232274879,7,0,1,27136,16,9587935330
8843,214223420,578592,214802012,9,0,0,202240,17,1566028377
8844,214316570,17964830,232281400,4,0,1,9728,4,4326325345
8845,214364230,367634,214731864,2,0,0,1024,11,4077045022
8846,214374420,498633,214873053,2,0,0,512,11,8086051636
8847,214431450,775747,215207197,9,0,0,88576,17,10732308328
8848,214439040,681259,215120299,9,0,0,202752,17,5727195220
8849,214473420,17820774,232294194,1,0,1,13824,6,10730103138
8850,214488990,17806177,232295167,4,0,1,12800,4,3737206144
8851,214489360,313571,214802931,2,0,0,2560,11,1886213614
8852,214499880,17816263,232316143,1,0,1,6656,6,140686315
8853,214534780,595773,215130553,1,0,0,33280,6,3780306070
8854,214541220,497106,215038326,2,0,0,89600,11,3340850331
8855,214543290,17930674,232473964,1,0,1,58368,6,628773367
8856,214580330,17919895,232500225,7,0,1,44032,16,3382585424
8857,214587770,737861,215325631,9,0,0,17408,17,8620682217
8858,214620250,251735,214871985,1,0,0,2048,6,2691007032
8859,214638461,17861779,232500240,0,0,1,7168,6,8592628727
8860,214691480,17808799,232500279,1,0,1,39424,6,9781477827
8861,214739811,17767343,232507154,0,0,1,23552,6,7618238271
8862,214745330,1263263,216008593,1,0,0,72192,6,5596541237
8863,214748250,591444,215339694,9,0,0,46080,17,2528531261
8864,214766840,17740980,232507820,5,0,1,11264,11,4660019399
8865,214775310,1077531,215852841,9,0,0,68096,17,9369351936
8866,214775910,743731,215519641,2,0,0,78336,11,8178856884
8867,214789910,17724783,232514693,4,0,1,2048,4,10639546997
8868,214793681,17725723,232519404,0,0,1,20480,6,10582166737
8869,214796021,17726289,232522310,0,0,1,4608,6,438590228
8870,214799810,672983,215472793,1,0,0,111104,6,7914994836
8871,214816821,17711186,232528007,0,0,1,18944,6,7836338022
8872,214831940,476519,215308459,2,0,0,56832,11,8085768930
8873,214838660,17730220,232568880,5,0,1,10752,11,6319165616
8874,214843400,1307950,216151350,1,0,0,222720,6,4664944301
8875,214855330,17743395,232598725,7,0,1,10752,16,2271286097
8876,214858640,620564,215479204,2,0,0,20992,11,3645571066
8877,214870660,1098018,215968678,2,0,0,5632,11,7283279235
8878,214886800,856623,215743423,6,0,0,100864,3,7029776021
8879,214923390,1549830,216473220,2,0,0,649216,11,1980038126
8880,214939300,1336089,216275389,9,0,0,89088,17,10186710124
8881,214948110,17650630,232598740,2,0,1,22528,11,3574035762
8882,214982650,849404,215832054,2,0,0,290816,11,8069702812
8883,215001670,1763450,216765120,1,0,0,519168,6,9844260151
8884,215040989,319729,215360718,4,0,0,11776,4,8118801524
8885,215044620,17554135,232598755,2,0,1,16896,11,2934760127
8886,215051640,17552221,232603861,2,0,1,36864,11,5970823135
8887,215061650,17552004,232613654,8,0,1,16384,6,1793653366
8888,215079450,17536038,232615488,7,0,1,9216,16,374136566
8889,215092790,17541113,232633903,1,0,1,4096,6,8135958522
8890,215102350,17544743,232647093,4,0,1,25600,4,834882656
8891,215109180,17551388,232660568,1,0,1,11776,6,1015576913
8892,215161990,1312283,216474273,6,0,0,3072,3,126763173
8893,215199680,17464114,232663794,8,0,1,5120,6,8549252124
8894,215219170,17449361,232668531,7,0,1,18432,16,755323176
8895,215231480,17477321,232708801,8,0,1,37888,6,7490600855
8896,215265231,17444876,232710107,0,0,1,2048,6,7142794196
8897,215289060,1762747,217051807,9,0,0,113152,17,9005264065
8898,215315990,17397983,232713973,4,0,1,6144,4,6582411337
8899,215320620,1696696,217017316,9,0,0,189440,17,5767694791
8900,215340460,17380925,232721385,5,0,1,11776,11,3513916470
8901,215341991,17389021,232731012,0,0,1,32256,6,2408569101
8902,215343800,17410328,232754128,5,0,1,17408,11,3692038241
8903,215347690,17409344,232757034,1,0,1,4608,6,7018208040
8904,215352920,17409503,232762423,1,0,1,17408,6,2837059804
8905,215369401,17393893,232763294,0,0,1,12288,6,5822981406
8906,215379000,17572707,232951707,2,0,1,12288,11,1708161290
8907,215385841,17642501,233028342,0,0,1,29696,6,5048267915
8908,215400600,837185,216237785,6,0,0,33792,3,10036845605
8909,215406460,17621905,233028365,2,0,1,5632,11,4284400950
8910,215428640,1401477,216830117,2,0,0,192000,11,4365721003
8911,215435820,17592560,233028380,7,0,1,6144,16,410798355
8912,215454220,17574175,233028395,8,0,1,3584,6,5348534892
8913,215461290,1492246,216953536,1,0,0,404992,6,7977192294
8914,215486010,1622146,217108156,9,0,0,74752,17,1059382541
8915,215510170,17518240,233028410,8,0,1,512,6,5349953479
8916,215534720,17496063,233030783,2,0,1,14848,11,6342986593
8917,215583060,17449349,233032409,5,0,1,2560,11,2389503860
8918,215642151,17392524,233034675,0,0,1,3584,6,4369342325
8919,215645180,17390801,233035981,7,0,1,2048,16,1437243229
8920,215668570,17370740,233039310,5,0,1,17920,11,9530125727
8921,215672830,17366826,233039656,8,0,1,512,6,2129878874
8922,215678620,1663250,217341870,2,0,0,248832,11,4530197084
8923,215710071,17334705,233044776,0,0,1,15872,6,2553454346
8924,215717001,17355302,233072303,0,0,1,10752,6,2577958055
8925,215772160,1807669,217579829,1,0,0,202240,6,813471934
8926,215786410,17288799,233075209,8,0,1,4608,6,4270443495
8927,215823660,652976,216476636,1,0,0,7680,6,3114370005
8928,215840610,17330437,233171047,5,0,1,33792,11,1656309422
8929,215886750,17287779,233174529,7,0,1,14336,16,4596409396
8930,215963760,1121565,217085325,1,0,0,52224,6,5004364207
8931,215991340,17607130,233598470,4,0,1,51200,4,5497099488
8932,216002830,17595655,233598485,5,0,1,1536,11,2884508298
8933,216012641,17585859,233598500,0,0,1,10752,6,6145884187
8934,216019760,1339129,217358889,2,0,0,55808,11,3715042527
8935,216098260,17500255,233598515,2,0,1,2048,11,5807386259
8936,216157450,17441080,233598530,4,0,1,5632,4,6239428078
8937,216161650,1083826,217245476,2,0,0,113152,11,5559930842
8938,216164460,607126,216771586,2,0,0,8704,11,10637506639
8939,216182311,17416234,233598545,0,0,1,8192,6,6646524703
8940,216182680,17415880,233598560,4,0,1,4608,4,9903366807
8941,216185120,774430,216959550,2,0,0,19456,11,6604808783
8942,216201550,17523081,233724631,4,0,1,26624,4,6542128046
8943,216237810,17487807,233725617,2,0,1,1536,11,1008239350
8944,216241400,527503,216768903,1,0,0,12288,6,8712037176
8945,216251330,17474543,233725873,5,0,1,9216,11,10073278021
8946,216280581,17446265,233726846,0,0,1,12800,6,10412860351
8947,216287410,781964,217069374,9,0,0,57344,17,6855637504
8948,216296680,17533348,233830028,8,0,1,6144,6,519385557
8949,216298091,17531952,233830043,0,0,1,512,6,4415802386
8950,216310110,17519948,233830058,2,0,1,11264,11,5903732836
8951,216310560,1297708,217608268,9,0,0,93184,17,5832293169
8952,216311470,17520646,233832116,1,0,1,12800,6,1792525590
8953,216315651,17516480,233832131,0,0,1,18944,6,513966838
8954,216371090,17581580,233952670,1,0,1,50688,6,4071959209
8955,216377820,17607128,233984948,4,0,1,3584,4,10688540720
8956,216381700,17663433,234045133,1,0,1,13312,6,3073554993
8957,216385010,17660146,234045156,1,0,1,15360,6,6705662688
8958,216392790,17657544,234050334,4,0,1,46080,4,2887687685
8959,216421440,17628917,234050357,8,0,1,3072,6,9635942827
8960,216441861,18512749,234954610,0,0,1,84480,6,2635359407
8961,216448700,18766427,235215127,8,0,1,29696,6,9175357486
8962,216469281,18891357,235360638,0,0,1,28672,6,10731008795
8963,216474610,1043584,217518194,9,0,0,220672,17,7114164605
8964,216509091,19193601,235702692,0,0,1,3584,6,9242314890
8965,216519230,19183477,235702707,5,0,1,1536,11,7921903172
8966,216556950,19145772,235702722,1,0,1,10752,6,9505186079
8967,216558500,1135338,217693838,1,0,0,189952,6,10546192997
8968,216570920,1168805,217739725,2,0,0,150528,11,7916788052
8969,216579870,19122867,235702737,1,0,1,6656,6,6289756012
8970,216606240,19147891,235754131,5,0,1,7168,11,1674100890
8971,216606280,19280917,235887197,7,0,1,21504,16,8696950767
8972,216607810,1185571,217793381,1,0,0,86528,6,9806708465
8973,216630070,19257150,235887220,2,0,1,8192,11,8778124040
8974,216667230,1254191,217921421,6,0,0,269312,3,9706512508
8975,216668550,1281785,217950335,1,0,0,94720,6,10170515747
8976,216694570,1313809,218008379,9,0,0,69632,17,2596917931
8977,216696130,1639013,218335143,6,0,0,206336,3,2699535749
8978,216720310,19204404,235924714,1,0,1,3072,6,9202291229
8979,216773600,19151129,235924729,5,0,1,20992,11,1833553238
8980,216779140,19174643,235953783,7,0,1,512,16,4755714692
8981,216781590,19172232,235953822,2,0,1,25088,11,4491638810
8982,216790160,822827,217612987,6,0,0,15360,3,5522436215
8983,216793110,19293267,236086377,7,0,1,1024,16,7791250655
8984,216851770,1133228,217984998,6,0,0,113664,3,5720023276
8985,216867320,957203,217824523,2,0,0,59904,11,4946408573
8986,216899390,1266263,218165653,0,0,0,67072,6,5109013880
8987,216902790,1144916,218047706,2,0,0,129024,11,396923880
8988,216910990,1175927,218086917,1,0,0,128512,6,4313013430
8989,216916700,19169700,236086400,1,0,1,14848,6,6637795066
8990,216933980,19158394,236092374,4,0,1,2048,4,10020082595
8991,216947280,1269616,218216896,9,0,0,64512,17,9556956421
8992,217005300,19087089,236092389,4,0,1,7168,4,9372258726
8993,217038300,19104133,236142433,5,0,1,1024,11,9260543048
8994,217039380,703980,217743360,0,0,0,11776,6,9173058252
8995,217068401,19074047,236142448,0,0,1,34816,6,5095475915
8996,217088280,1577679,218665959,9,0,0,261120,17,6737677034
8997,217104120,19058734,236162854,2,0,1,15360,11,590276762
8998,217107490,19227619,236335109,5,0,1,8192,11,1266309827
8999,217108680,723658,217832338,1,0,0,25600,6,1537342028
9000,217162700,19172424,236335124,5,0,1,8192,11,8886627561
9001,217184990,1268671,218453661,6,0,0,74752,3,8123531411
9002,217224520,1789255,219013775,9,0,0,93696,17,10349678330
9003,217225680,19174408,236400088,7,0,1,19968,16,7508904588
9004,217244410,1125008,218369418,2,0,0,82432,11,10675426376
9005,217249190,19150921,236400111,7,0,1,8704,16,8595455565
9006,217377390,1920769,219298159,6,0,0,221184,3,6927921019
9007,217390140,19009994,236400134,4,0,1,33280,4,2455469507
9008,217415631,18984518,236400149,0,0,1,14336,6,2955349751
9009,217420930,1048849,218469779,6,0,0,16896,3,5184419199
9010,217489510,18917089,236406599,9,0,1,2048,17,7700386426
9011,217491640,18914982,236406622,2,0,1,80384,11,9434378207
9012,217506190,18900447,236406637,2,0,1,1536,11,1924314678
9013,217512000,2039291,219551291,0,0,0,189440,6,1533930973
9014,217600320,1761143,219361463,6,0,0,94720,3,8822446541
9015,217608150,1419680,219027830,0,0,0,46080,6,803799806
9016,217644270,18762398,236406668,5,0,1,23040,11,591563036
9017,217663101,18743582,236406683,0,0,1,8704,6,1940131818
9018,217666070,1086207,218752277,0,0,0,98816,6,8946126488
9019,217697950,18725563,236423513,5,0,1,1024,11,9554410355
9020,217709151,18773153,236482304,0,0,1,39936,6,5816692538
9021,217740861,18749526,236490387,0,0,1,14336,6,2730414712
9022,217741700,1450029,219191729,9,0,0,313856,17,4680772690
9023,217765750,1317490,219083240,2,0,0,129024,11,9500572730
9024,217768270,18732905,236501175,7,0,1,17920,16,8751062217
9025,217791920,480340,218272260,6,0,0,28672,3,321788228
9026,217804051,18763000,236567051,0,0,1,6144,6,6956749062
9027,217843020,1387732,219230752,2,0,0,128000,11,9591844537
9028,217858860,18708206,236567066,5,0,1,20992,11,2162234703
9029,217865130,645238,218510368,9,0,0,37376,17,2551599348
9030,217872120,1460444,219332564,2,0,0,13824,11,316034190
9031,217882130,18716821,236598951,7,0,1,7680,16,4536059040
9032,217888791,18710175,236598966,0,0,1,11264,6,5085111593
9033,217925230,1748899,219674129,9,0,0,41984,17,3526338232
9034,217959900,1409450,219369350,2,0,0,25600,11,2040608151
9035,217960050,18672133,236632183,5,0,1,59904,11,6333187291
9036,217990110,682336,218672446,1,0,0,3584,6,5335408187
9037,218015270,18654203,236669473,5,0,1,7168,11,8171432862
9038,218018960,18653099,236672059,7,0,1,4096,16,3101818353
9039,218022790,18748843,236771633,2,0,1,33792,11,10513230063
9040,218038171,18755855,236794026,0,0,1,14848,6,7018213167
9041,218051940,18892888,236944828,5,0,1,65024,11,5603137617
9042,218105690,806737,218912427,0,0,0,4096,6,5513981658
9043,218111340,18844677,236956017,5,0,1,12288,11,6151961410
9044,218120740,1584916,219705656,1,0,0,103424,6,1907255359
9045,218121350,968465,219089815,6,0,0,21504,3,8090321415
9046,218213850,1361550,219575400,1,0,0,41472,6,7774786437
9047,218216240,18819990,237036230,5,0,1,27136,11,7740900607
9048,218241520,1759219,220000739,6,0,0,141824,3,1121942913
9049,218285500,1038906,219324406,2,0,0,86016,11,2848929871
9050,218324080,1774381,220098461,6,0,0,242688,3,8714488156
9051,218328361,18826156,237154517,0,0,1,33792,6,10274670656
9052,218328520,1234221,219562741,1,0,0,37376,6,4223043859
9053,218334550,709363,219043913,6,0,0,52736,3,7389941448
9054,218386260,18768288,237154548,5,0,1,14336,11,6862110635
9055,218415020,1456318,219871338,2,0,0,57344,11,5270986586
9056,218417110,18737453,237154563,6,0,1,4608,3,7345859592
9057,218423870,978411,219402281,8,0,0,108032,6,4340074867
9058,218446830,1510658,219957488,1,0,0,282624,6,2612089872
9059,218482140,1526906,220009046,0,0,0,27136,6,10562166190
9060,218484850,2059401,220544251,9,0,0,47104,17,3538801298
9061,218495830,1860870,220356700,0,0,0,77824,6,3969489626
9062,218502060,826269,219328329,9,0,0,12800,17,3160530273
9063,218516861,18637725,237154586,0,0,1,8704,6,5304992058
9064,218546230,924790,219471020,9,0,0,92672,17,8016947448
9065,218567920,1662377,220230297,0,0,0,112640,6,7651908886
9066,218596960,1000050,219597010,2,0,0,11776,11,9570715672
9067,218659300,1056667,219715967,6,0,0,33792,3,5735524909
9068,218735460,1888825,220624285,2,0,0,260096,11,4682792360
9069,218743730,18437498,237181228,5,0,1,10752,11,5436278999
9070,218743840,1543185,220287025,1,0,0,88064,6,10244422906
9071,218797271,18392009,237189280,0,0,1,12800,6,3541927190
9072,218851020,18485215,237336235,9,0,1,29184,17,1699298779
9073,218868710,18467556,237336266,4,0,1,29696,4,227787478
9074,218916711,18424141,237340852,0,0,1,2560,6,9072960744
9075,219044030,1794768,220838798,6,0,0,337408,3,1359928387
9076,219104540,1821181,220925721,8,0,0,285184,6,766740086
9077,219121000,2157495,221278495,0,0,0,97792,6,8727642284
9078,219130740,18237364,237368104,5,0,1,29184,11,5273903397
9079,219155880,18212239,237368119,5,0,1,5120,11,9651609581
9080,219165110,18223981,237389091,1,0,1,12800,6,2807955529
9081,219183400,18242132,237425532,1,0,1,36864,6,9582018337
9082,219197550,1844256,221041806,2,0,0,164864,11,10344776812
9083,219202121,18223565,237425686,0,0,1,8704,6,3416119433
9084,219291490,18158303,237449793,1,0,1,8704,6,8593626666
9085,219312110,1313602,220625712,8,0,0,4608,6,490231269
9086,219312410,1020563,220332973,1,0,0,7680,6,7299066863
9087,219329060,1635902,220964962,6,0,0,44544,3,8372261261
9088,219371040,1767433,221138473,2,0,0,78336,11,8824918356
9089,219417560,913004,220330564,0,0,0,142848,6,6525886956
9090,219465920,1979771,221445691,8,0,0,58368,6,4482103986
9091,219500780,2133606,221634386,6,0,0,176640,3,110801020
9092,219501140,748368,220249508,6,0,0,24576,3,1549523222
9093,219501790,1200845,220702635,1,0,0,252416,6,4234527916
9094,219502910,1018183,220521093,8,0,0,71680,6,5938917774
9095,219511480,1979896,221491376,8,0,0,116736,6,3935733096
9096,219584820,941436,220526256,2,0,0,16896,11,8787526502
9097,219637790,2155587,221793377,0,0,0,237568,6,1966749571
9098,219709250,17797752,237507002,1,0,1,3584,6,8563054582
9099,219721640,636011,220357651,0,0,0,3072,6,2664037198
9100,219725310,1010669,220735979,6,0,0,25600,3,2272858315
9101,219752660,17754357,237507017,1,0,1,13312,6,10306262229
9102,219786310,1641582,221427892,0,0,0,161792,6,7493265564
9103,219826320,17680720,237507040,1,0,1,6144,6,7422407315
9104,219861040,17661756,237522796,5,0,1,58880,11,8198510649
9105,219865640,1124812,220990452,6,0,0,83456,3,3725327261
9106,219869730,1056794,220926524,0,0,0,2560,6,8576297275
9107,219917240,17610316,237527556,5,0,1,4608,11,1006719995
9108,219921850,1609308,221531158,0,0,0,512,6,4415640514
9109,219933960,1153918,221087878,6,0,0,49152,3,7500724313
9110,219957480,503806,220461286,8,0,0,37376,6,8950235665
9111,219968440,17560742,237529182,5,0,1,2560,11,9852137998
9112,219979080,272947,220252027,8,0,0,8192,6,1540825444
9113,219998390,528505,220526895,0,0,0,2048,6,3838460531
9114,220000820,2550207,222551027,1,0,0,73216,6,1182087225
9115,220016780,1474790,221491570,0,0,0,512,6,9044589829
9116,220019580,1159000,221178580,2,0,0,131584,11,7201040654
9117,220023750,1886381,221910131,8,0,0,70144,6,5720753810
9118,220066520,1164001,221230521,2,0,0,10752,11,4599613977
9119,220092840,1938990,222031830,1,0,0,94208,6,9336841303
9120,220093840,950212,221044052,0,0,0,6656,6,636079378
9121,220105600,845751,220951351,1,0,0,81408,6,8162889380
9122,220122310,2387120,222509430,6,0,0,607744,3,3099695423
9123,220223670,17333022,237556692,5,0,1,18432,11,4466003783
9124,220246890,17332556,237579446,5,0,1,1024,11,1047118421
9125,220274670,1905280,222179950,8,0,0,21504,6,847508688
9126,220278450,17343025,237621475,5,0,1,56832,11,9944477689
9127,220297660,17352263,237649923,5,0,1,27648,11,9007918128
9128,220383770,2242037,222625807,8,0,0,78848,6,9769151553
9129,220404340,17309185,237713525,1,0,1,17920,6,6800199740
9130,220434180,1567352,222001532,2,0,0,54784,11,5303852983
9131,220436360,17277180,237713540,1,0,1,14336,6,8323589914
9132,220438010,1392020,221830030,6,0,0,76800,3,10293214843
9133,220438890,748489,221187379,6,0,0,28672,3,9079622300
9134,220470780,17262577,237733357,9,0,1,15360,17,10464474597
9135,220483030,508529,220991559,0,0,0,3584,6,3956700500
9136,220494220,547773,221041993,0,0,0,512,6,5914393094
9137,220515440,1169349,221684789,8,0,0,165376,6,2186778371
9138,220526670,17207558,237734228,7,0,1,12288,16,6059252699
9139,220577340,480621,221057961,1,0,0,6144,6,3546842993
9140,220632450,2083700,222716150,8,0,0,65536,6,10697497969
9141,220656360,1572700,222229060,6,0,0,70656,3,163219705
9142,220685900,17051724,237737624,5,0,1,4608,11,1322066410
9143,220749540,2177553,222927093,6,0,0,108544,3,4410163764
9144,220777940,1015616,221793556,0,0,0,512,6,5380608912
9145,220837400,16900890,237738290,5,0,1,1024,11,3566445337
9146,220846940,17001265,237848205,6,0,1,32768,3,8473550058
9147,220855090,16994421,237849511,6,0,1,2048,3,3106900984
9148,220877670,814013,221691683,6,0,0,22528,3,1061542391
9149,220889120,2170160,223059280,8,0,0,141824,6,10404714642
9150,220937360,1047465,221984825,8,0,0,52224,6,741394438
9151,220981720,337639,221319359,0,0,0,4096,6,5809727666
9152,220990320,16990780,237981100,1,0,1,46080,6,3401223938
9153,221031730,910778,221942508,0,0,0,65536,6,4426285870
9154,221032070,2120060,223152130,6,0,0,52224,3,10178946453
9155,221044010,16937105,237981115,1,0,1,6144,6,5666047684
9156,221054060,2333429,223387489,0,0,0,150016,6,3570749714
9157,221122200,1194115,222316315,2,0,0,69632,11,324458444
9158,221133590,2344149,223477739,5,0,0,6656,11,5227889325
9159,221145090,16998817,238143907,1,0,1,20480,6,6952896844
9160,221156800,1821611,222978411,0,0,0,81408,6,8463402203
9161,221169870,16974052,238143922,1,0,1,2048,6,5936295270
9162,221170680,325757,221496437,1,0,0,15872,6,59407954
9163,221178970,517260,221696230,6,0,0,14848,3,9927756669
9164,221203670,17128531,238332201,5,0,1,38912,11,8719493753
9165,221230710,322244,221552954,2,0,0,22528,11,1459833617
9166,221263170,251054,221514224,2,0,0,10240,11,8308593567
9167,221267760,17112250,238380010,1,0,1,15360,6,4761768519
9168,221320110,17069774,238389884,1,0,1,9216,6,6796957871
9169,221336990,510371,221847361,2,0,0,56832,11,5340320737
9170,221355260,2604560,223959820,6,0,0,150016,3,4096419352
9171,221423640,2413598,223837238,6,0,0,539136,3,6752905202
9172,221428800,16962070,238390870,1,0,1,1536,6,7287016724
9173,221431860,2689213,224121073,2,0,0,76288,11,2058445234
9174,221443910,2572661,224016571,1,0,0,81920,6,3664202135
9175,221464330,2448021,223912351,8,0,0,216064,6,113016781
9176,221483700,16907426,238391126,6,0,1,9216,3,5959009498
9177,221486060,645304,222131364,2,0,0,78848,11,5518601382
9178,221494460,16956807,238451267,9,0,1,9216,17,5252405461
9179,221556920,17029003,238585923,1,0,1,23552,6,3684246147
9180,221575350,17010620,238585970,6,0,1,26624,3,4207515112
9181,221650410,1041085,222691495,2,0,0,10752,11,6732275372
9182,221711600,16890929,238602529,6,0,1,9728,3,9342579953
9183,221712100,16892695,238604795,1,0,1,3584,6,1924653133
9184,221737650,16895735,238633385,1,0,1,1536,6,723699933
9185,221761510,16882361,238643871,9,0,1,512,17,7859737900
9186,221814160,446766,222260926,6,0,0,12800,3,458756826
9187,221844590,16800907,238645497,6,0,1,2560,3,8998693187
9188,221875600,379815,222255415,1,0,0,31744,6,10067648467
9189,221891020,2344649,224235669,1,0,0,11776,6,2794853836
9190,221902410,16744675,238647085,1,0,1,15872,6,10295193308
9191,221931770,596902,222528672,1,0,0,62976,6,5654158478
9192,221935390,2433080,224368470,1,0,0,428544,6,404652215
9193,221966250,16797426,238763676,6,0,1,512,3,3459392949
9194,221976830,791748,222768578,8,0,0,76288,6,4437620559
9195,222016790,775135,222791925,1,0,0,19968,6,5988665320
9196,222054160,583518,222637678,1,0,0,38912,6,3258092309
9197,222059660,16704031,238763691,9,0,1,9728,17,1835163130
9198,222119170,16683797,238802967,9,0,1,32256,17,8294147494
9199,222129210,16682263,238811473,6,0,1,4608,3,3644144995
9200,222168910,16713821,238882731,1,0,1,19456,6,4998113152
9201,222177300,16727311,238904611,1,0,1,27648,6,7793307745
9202,222181230,16751929,238933159,1,0,1,16896,6,8469372076
9203,222184190,16844252,239028442,1,0,1,41472,6,7941695480
9204,222216950,16842909,239059859,9,0,1,33792,17,4490615250
9205,222234390,16825492,239059882,9,0,1,1536,17,7042965423
9206,222239710,16820187,239059897,5,0,1,17920,11,8980213294
9207,222275750,2157740,224433490,2,0,0,69632,11,7946221540
9208,222284770,2149442,224434212,1,0,0,512,6,4405223136
9209,222302650,16769297,239071947,9,0,1,21504,17,10211210154
9210,222344290,16826719,239171009,5,0,1,4096,11,2641999296
9211,222368780,16802244,239171024,9,0,1,1536,17,3210075619
9212,222402640,937707,223340347,8,0,0,177152,6,4543166654
9213,222436200,16734839,239171039,9,0,1,512,17,5545047524
9214,222436860,2087891,224524751,6,0,0,193536,3,9559276600
9215,222456010,533375,222989385,6,0,0,34304,3,6749417710
9216,222464520,16706534,239171054,5,0,1,3072,11,371241285
9217,222500510,2260072,224760582,2,0,0,237056,11,7893052277
9218,222524270,454632,222978902,1,0,0,1536,6,155272020
9219,222639210,1352339,223991549,8,0,0,103936,6,259803638
9220,222647980,16523097,239171077,5,0,1,5632,11,66507823
9221,222697890,16473210,239171100,1,0,1,15360,6,4257892799
9222,222714160,1383639,224097799,6,0,0,266240,3,9837281652
9223,222724080,16464686,239188766,6,0,1,2560,3,24594939
9224,222747660,2076516,224824176,6,0,0,1024,3,1368722674
9225,222756020,16529362,239285382,9,0,1,54272,17,4135002169
9226,222790300,16496158,239286458,5,0,1,13312,11,8453993056
9227,222803780,16491017,239294797,5,0,1,9216,11,9831914039
9228,222806110,430104,223236214,6,0,0,512,3,7306139307
9229,222819440,16534283,239353723,5,0,1,16384,11,5368960806
9230,222856650,16497088,239353738,5,0,1,5120,11,8511516529
9231,222862210,16491543,239353753,5,0,1,18944,11,989076834
9232,222880690,16473078,239353768,5,0,1,1024,11,146869480
9233,222884450,16545460,239429910,1,0,1,35840,6,7691697639
9234,222958010,888455,223846465,2,0,0,30208,11,1215422244
9235,222964990,422670,223387660,6,0,0,512,3,4287984554
9236,222970400,587445,223557845,1,0,0,44032,6,10180580376
9237,222988580,16675888,239664468,9,0,1,8192,17,6999252394
9238,222992950,217039,223209989,6,0,0,3584,3,8691819337
9239,223000870,1934181,224935051,8,0,0,9728,6,1995207903
9240,223015720,385083,223400803,1,0,0,43008,6,7843723819
9241,223050500,16616874,239667374,1,0,1,4608,6,2634174255
9242,223089460,414965,223504425,8,0,0,28160,6,1604072921
9243,223089700,252066,223341766,6,0,0,4608,3,6517460861
9244,223093621,16790825,239884446,0,0,1,63488,6,654011792
9245,223099140,16785329,239884469,9,0,1,7168,17,6107251800
9246,223108600,16775884,239884484,5,0,1,512,11,6703487106
9247,223112300,481280,223593580,2,0,0,76288,11,1221866491
9248,223169580,16715969,239885549,9,0,1,5120,17,7271757605
9249,223170410,16715485,239885895,1,0,1,512,6,371269975
9250,223174240,1056243,224230483,8,0,0,288768,6,1052940855
9251,223179000,1277387,224456387,2,0,0,72704,11,4805286917
9252,223181450,16708631,239890081,1,0,1,6656,6,8950267917
9253,223219120,2023782,225242902,2,0,0,277504,11,10321357142
9254,223226151,16684898,239911049,0,0,1,5120,6,4062221695
9255,223263490,16648430,239911920,9,0,1,12288,17,318169703
9256,223271980,2074959,225346939,8,0,0,84992,6,8030810247
9257,223319430,16652409,239971839,6,0,1,14848,3,2009403337
9258,223329470,16644955,239974425,9,0,1,4096,17,4176774139
9259,223344000,16633344,239977344,1,0,1,15872,6,3607058809
9260,223460720,681756,224142476,2,0,0,70144,11,8900729536
9261,223465220,16531799,239997019,6,0,1,12800,3,422458375
9262,223470140,767728,224237868,1,0,0,7168,6,1524840785
9263,223475160,16580345,240055505,1,0,1,1024,6,3579395532
9264,223485891,16600080,240085971,0,0,1,4096,6,6177923339
9265,223497100,16588886,240085986,6,0,1,1536,3,6795253411
9266,223513760,400322,223914082,1,0,0,5632,6,2432455802
9267,223519260,2253253,225772513,2,0,0,100864,11,1172927700
9268,223566250,1952199,225518449,2,0,0,154624,11,9474927567
9269,223624020,608038,224232058,6,0,0,5120,3,5065598392
9270,223660841,16433943,240094784,0,0,1,17920,6,6053860254
9271,223663640,720780,224384420,8,0,0,51200,6,4429107022
9272,223674010,991588,224665598,2,0,0,30208,11,2672743219
9273,223707050,16430417,240137467,5,0,1,22528,11,7190651794
9274,223710660,658137,224368797,6,0,0,1024,3,3278430103
9275,223737000,675227,224412227,1,0,0,91136,6,7537693124
9276,223844060,16295033,240139093,1,0,1,2560,6,2249143221
9277,223858310,575731,224434041,6,0,0,1536,3,1914928106
9278,223896470,16244889,240141359,5,0,1,3584,11,6712058991
9279,223918101,16228404,240146505,0,0,1,8192,6,4815149773
9280,223919220,16415105,240334325,3,0,1,13312,0,10114926954
9281,223981700,981318,224963018,8,0,0,26112,6,8274911798
9282,223991361,16653324,240644685,0,0,1,42496,6,313633425
9283,224019560,1962913,225982473,8,0,0,428544,6,816732737
9284,224038460,1116553,225155013,8,0,0,104448,6,865794586
9285,224053160,473182,224526342,6,0,0,5120,3,8697748347
9286,224130850,16558544,240689394,5,0,1,14848,11,251918731
9287,224198910,802901,225001811,2,0,0,35840,11,3337714497
9288,224204001,16494928,240698929,0,0,1,4608,6,9023978439
9289,224214461,16485134,240699595,0,0,1,1024,6,652155016
9290,224219590,558646,224778236,6,0,0,512,3,2585003559
9291,224236480,16609550,240846030,1,0,1,13824,6,10591739971
9292,224250460,16642726,240893186,1,0,1,28160,6,4607377245
9293,224255570,863759,225119329,8,0,0,73216,6,4524791237
9294,224294831,16779033,241073864,0,0,1,23552,6,2186711482
9295,224348510,553526,224902036,2,0,0,199680,11,2501439478
9296,224353390,16818316,241171706,1,0,1,12800,6,9303638455
9297,224382980,737612,225120592,6,0,0,4096,3,84350384
9298,224427410,16744311,241171721,3,0,1,2048,0,4361082398
9299,224494790,1652728,226147518,2,0,0,514048,11,6731245501
9300,224606821,16606315,241213136,0,0,1,41472,6,5240847719
9301,224674901,16538306,241213207,0,0,1,9216,6,5584134538
9302,224729940,16483306,241213246,3,0,1,15360,0,5404175276
9303,224735310,268958,225004268,6,0,0,3072,3,8324151755
9304,224810921,16462126,241273047,0,0,1,10752,6,6024302168
9305,224836090,322245,225158335,1,0,0,10752,6,10326910056
9306,224875300,16418845,241294145,1,0,1,1536,6,9879904855
9307,224890620,16403540,241294160,9,0,1,6656,17,8026434849
9308,224949130,16345069,241294199,1,0,1,11776,6,5583346366
9309,225081070,16267058,241348128,1,0,1,9216,6,4548443400
9310,225121550,566693,225688243,2,0,0,218624,11,8314028812
9311,225131290,16529520,241660810,1,0,1,19968,6,1857487965
9312,225137950,16523526,241661476,1,0,1,11264,6,10420595456
9313,225150991,16658843,241809834,0,0,1,2560,6,6642528463
9314,225154890,16658438,241813328,1,0,1,1024,6,2984916047
9315,225156440,16754886,241911326,1,0,1,9728,6,6722242368
9316,225168400,16743892,241912292,1,0,1,14336,6,3713725036
9317,225175380,16736927,241912307,9,0,1,8704,17,7972005250
9318,225248970,16663360,241912330,1,0,1,2048,6,10186285084
9319,225276700,287138,225563838,6,0,0,2560,3,8905939020
9320,225301100,16831228,242132328,1,0,1,19456,6,2121864113
9321,225322340,16810027,242132367,3,0,1,17920,0,8291842306
9322,225365260,16767122,242132382,9,0,1,512,17,3390127149
9323,225371380,16761025,242132405,3,0,1,1536,0,6949073094
9324,225396560,16735860,242132420,9,0,1,17408,17,2378729975
9325,225410231,16952393,242362624,0,0,1,86016,6,6519368695
9326,225427730,361892,225789622,2,0,0,27648,11,10542007257
9327,225438910,270282,225709192,2,0,0,68608,11,10393791807
9328,225473490,16947257,242420747,1,0,1,28160,6,3435698219
9329,225523530,328009,225851539,1,0,0,1536,6,10714179673
9330,225595381,16825520,242420901,0,0,1,8704,6,4816152767
9331,225602470,388309,225990779,1,0,0,27136,6,4362779135
9332,225657321,16793103,242450424,0,0,1,8192,6,6852842043
9333,225720560,16782573,242503133,1,0,1,1536,6,10209278118
9334,225727900,16817313,242545213,3,0,1,15360,0,1784063636
9335,225731411,16821214,242552625,0,0,1,11776,6,6657652947
9336,225808820,342201,226151021,1,0,0,11264,6,8155980409
9337,225857390,16712716,242570106,5,0,1,24064,11,5932011419
9338,225871020,16720066,242591086,1,0,1,12288,6,276318639
9339,225890800,16704583,242595383,5,0,1,8704,11,10463805439
9340,225931470,16666499,242597969,3,0,1,4096,0,7773750715
9341,225945380,538400,226483780,8,0,0,68608,6,7005054661
9342,225964610,16635625,242600235,5,0,1,3584,11,2046430890
9343,225989780,594443,226584223,1,0,0,14336,6,6991433224
9344,225992180,16641987,242634167,5,0,1,6144,11,1044543334
9345,226020790,763747,226784537,6,0,0,512,3,4319446954
9346,226025420,16676765,242702185,5,0,1,8704,11,4008048403
9347,226027670,16674530,242702200,2,0,1,9216,11,2628287207
9348,226044160,739117,226783277,2,0,0,314880,11,6204009096
9349,226048250,736009,226784259,6,0,0,3072,3,416282071
9350,226052920,16649303,242702223,5,0,1,12288,11,1470822686
9351,226065430,16688771,242754201,5,0,1,7680,11,9525044960
9352,226071770,16682470,242754240,1,0,1,22528,6,1708531707
9353,226075910,463137,226539047,1,0,0,84992,6,5769929875
9354,226098110,16658252,242756362,9,0,1,71168,17,1435621291
9355,226125760,16637376,242763136,3,0,1,7680,0,4652610697
9356,226132220,16632222,242764442,1,0,1,2048,6,1801396954
9357,226134070,16686860,242820930,1,0,1,14336,6,5607859682
9358,226141130,690282,226831412,8,0,0,115200,6,2510248222
9359,226166730,852230,227018960,8,0,0,290304,6,5660351468
9360,226183941,16637028,242820969,0,0,1,17408,6,506704163
9361,226184760,16636224,242820984,9,0,1,4096,17,10176661268
9362,226216781,16604218,242820999,0,0,1,9216,6,3155045087
9363,226265310,16620147,242885457,3,0,1,1536,0,6674087802
9364,226286231,16599241,242885472,0,0,1,11264,6,8754799598
9365,226304670,16580817,242885487,3,0,1,19456,0,3757458997
9366,226323840,16603255,242927095,3,0,1,9728,0,682796817
9367,226343571,16703410,243046981,0,0,1,23552,6,3499538881
9368,226376620,16670384,243047004,1,0,1,5632,6,9149172444
9369,226431780,16615722,243047502,3,0,1,7168,0,431192220
9370,226456700,750409,227207109,1,0,0,23040,6,1516835763
9371,226468310,16579207,243047517,1,0,1,14336,6,7791346965
9372,226490171,16577428,243067599,0,0,1,8704,6,3290212679
9373,226491250,136907,226628157,6,0,0,3584,3,3688664164
9374,226544340,914276,227458616,8,0,0,456704,6,6211288281
9375,226547880,16565987,243113867,5,0,1,26112,11,1903875215
9376,226561791,16553382,243115173,0,0,1,2048,6,7937950450
9377,226567350,266745,226834095,2,0,0,8704,11,9357605550
9378,226582680,16535630,243118310,4,0,1,15872,4,5407904599
9379,226595320,16526536,243121856,9,0,1,5632,17,3726158053
9380,226614610,585448,227200058,8,0,0,232448,6,9610014221
9381,226625130,16502414,243127544,3,0,1,2048,0,9513649240
9382,226640220,16510932,243151152,9,0,1,2560,17,8558213319
9383,226645140,818515,227463655,1,0,0,16384,6,6470343645
9384,226658771,16512223,243170994,0,0,1,20992,6,10664607671
9385,226672640,16498369,243171009,1,0,1,29696,6,9687954971
9386,226684561,16492573,243177134,0,0,1,14848,6,5293173627
9387,226688280,609332,227297612,8,0,0,89600,6,4865225598
9388,226691100,16504480,243195580,3,0,1,20480,0,8819174865
9389,226695850,16504165,243200015,5,0,1,1536,11,8557945531
9390,226723640,802086,227525726,1,0,0,143360,6,3606777798
9391,226729900,16472381,243202281,5,0,1,3584,11,10063388877
9392,226732120,16471032,243203152,4,0,1,12288,4,10369272414
9393,226772400,16590401,243362801,9,0,1,18432,17,8550946501
9394,226774491,16761342,243535833,0,0,1,27136,6,6428039351
9395,226799680,16759824,243559504,3,0,1,2560,0,9309958264
9396,226817300,16811899,243629199,5,0,1,24064,11,291845645
9397,226841650,466117,227307767,8,0,0,33280,6,4333785661
9398,226870870,16760275,243631145,5,0,1,3072,11,9914457542
9399,226888850,16830482,243719332,3,0,1,2560,0,10040535091
9400,226911380,16914309,243825689,9,0,1,20992,17,3400410220
9401,226923580,16902132,243825712,4,0,1,2560,4,1224976413
9402,226928460,16998623,243927083,1,0,1,21504,6,3789156106
9403,226937050,16992358,243929408,3,0,1,12800,0,1872486368
9404,226937770,17206062,244143832,1,0,1,3072,6,6982849148
9405,226957670,17186193,244143863,9,0,1,19456,17,89228673
9406,226960200,17183678,244143878,1,0,1,1024,6,4656979575
9407,226970460,17247860,244218320,4,0,1,25088,4,8136887557
9408,226972190,336060,227308250,6,0,0,1536,3,2433868927
9409,226987760,666013,227653773,1,0,0,243712,6,6547408097
9410,226991740,17226603,244218343,5,0,1,6656,11,1104897671
9411,227001320,17217070,244218390,7,0,1,8704,16,7836956687
9412,227007470,17218936,244226406,3,0,1,15872,0,8460299306
9413,227028320,17265556,244293876,5,0,1,67072,11,340203307
9414,227086730,575950,227662680,8,0,0,29184,6,3230464726
9415,227099480,17200266,244299746,3,0,1,10240,0,9604659735
9416,227116210,17190000,244306210,5,0,1,22528,11,10308014954
9417,227136550,17367308,244503858,5,0,1,15872,11,7095108651
9418,227163440,499605,227663045,6,0,0,1024,3,8909453823
9419,227182770,17321103,244503873,9,0,1,23552,17,8794682658
9420,227205751,17298137,244503888,0,0,1,22016,6,1488989455
9421,227228421,17275482,244503903,0,0,1,11264,6,4094465221
9422,227232540,17289365,244521905,8,0,1,27648,6,1723651566
9423,227257620,17264300,244521920,7,0,1,16896,16,7885807360
9424,227326170,17195765,244521935,6,0,1,1536,3,10690270639
9425,227335530,17217650,244553180,7,0,1,24064,16,4947537437
9426,227368600,17210366,244578966,1,0,1,6144,6,5931816087
9427,227381260,17197737,244578997,9,0,1,19968,17,7541022045
9428,227391600,17232960,244624560,1,0,1,24576,6,7398343230
9429,227457590,17192072,244649662,9,0,1,10240,17,7114333700
9430,227471840,17181845,244653685,1,0,1,2560,6,8906894872
9431,227477070,17176769,244653839,6,0,1,8704,3,5952769340
9432,227482250,573644,228055894,3,0,0,17408,0,597316348
9433,227527740,17129717,244657457,5,0,1,512,11,9132966229
9434,227532800,330231,227863031,8,0,0,86016,6,8251960021
9435,227543930,17115793,244659723,9,0,1,3584,17,9351555713
9436,227554630,215020,227769650,6,0,0,6656,3,5461249631
9437,227568020,17110909,244678929,1,0,1,2048,6,3480366900
9438,227578190,17100754,244678944,9,0,1,2560,17,2851582807
9439,227592620,457917,228050537,8,0,0,184832,6,5014466024
9440,227669080,17029402,244698482,6,0,1,13824,3,1967542315
9441,227669980,17028517,244698497,1,0,1,7168,6,8849623502
9442,227676080,17036066,244712146,6,0,1,16384,3,2764946784
9443,227677560,17034932,244712492,5,0,1,512,11,4214201080
9444,227771870,16951602,244723472,1,0,1,13824,6,7700027820
9445,227820900,235648,228056548,6,0,0,2048,3,7317496573
9446,227846310,426968,228273278,2,0,0,87040,11,2266786058
9447,227907480,16819538,244727018,6,0,1,5632,3,4809496585
9448,227918300,398673,228316973,8,0,0,143360,6,6667075811
9449,227945780,16781392,244727172,5,0,1,8704,11,2066795329
9450,227953090,566592,228519682,2,0,0,30720,11,5563061202
9451,227970870,16760837,244731707,1,0,1,6656,6,6801670270
9452,227991350,1434903,229426253,8,0,0,1181696,6,8357848646
9453,227993740,16962343,244956083,1,0,1,6656,6,9065890287
9454,228002850,16954859,244957709,9,0,1,2560,17,6678648281
9455,228074590,16972798,245047388,9,0,1,39936,17,701970044
9456,228078750,17134767,245213517,5,0,1,33280,11,4996472313
9457,228106740,17137188,245243928,1,0,1,9728,6,1001156106
9458,228164630,1418395,229583025,1,0,0,2560,6,1632050784
9459,228196780,1365076,229561856,1,0,0,444928,6,1776914129
9460,228207510,17092704,245300214,9,0,1,20480,17,2876548217
9461,228225510,17074719,245300229,6,0,1,2560,3,1390970403
9462,228226830,334202,228561032,6,0,0,1024,3,4685678441
9463,228228860,827490,229056350,1,0,0,2560,6,3687396359
9464,228273900,17026344,245300244,9,0,1,7680,17,5865910076
9465,228274420,17025839,245300259,6,0,1,4096,3,2127703982
9466,228340550,381699,228722249,8,0,0,53760,6,6171773811
9467,228380090,16920184,245300274,4,0,1,10752,4,6289044382
9468,228386240,16935582,245321822,4,0,1,16896,4,2063905928
9469,228387270,1280985,229668255,6,0,0,512,3,2874479296
9470,228394530,16933931,245328461,5,0,1,12288,11,4231521611
9471,228470900,590085,229060985,6,0,0,512,3,6601166820
9472,228475350,455897,228931247,6,0,0,2560,3,4342855592
9473,228538550,16855332,245393882,9,0,1,13824,17,8103155856
9474,228547450,334063,228881513,6,0,0,1024,3,5493732969
9475,228551820,449801,229001621,6,0,0,512,3,9157200797
9476,228555801,17015506,245571307,0,0,1,20480,6,9963683273
9477,228565130,467590,229032720,1,0,0,15872,6,2944776700
9478,228588171,16983151,245571322,0,0,1,7680,6,4836851684
9479,228611691,17044742,245656433,0,0,1,20480,6,2926984816
9480,228623690,17034965,245658655,6,0,1,8704,3,5100324112
9481,228656920,945487,229602407,6,0,0,1536,3,5079620804
9482,228671730,16986940,245658670,8,0,1,3072,6,7357507914
9483,228680740,900319,229581059,2,0,0,62976,11,392199250
9484,228695660,16963025,245658685,5,0,1,512,11,6185557011
9485,228703740,357074,229060814,2,0,0,14336,11,10574021572
9486,228709940,1092548,229802488,2,0,0,302080,11,1666137446
9487,228718131,16940569,245658700,0,0,1,4096,6,10045903667
9488,228730570,16979687,245710257,8,0,1,49664,6,2671024640
9489,228736500,845714,229582214,6,0,0,3584,3,7145507547
9490,228741400,16968880,245710280,4,0,1,4096,4,7291403229
9491,228745670,856254,229601924,8,0,0,61952,6,1978909790
9492,228775980,16945570,245721550,8,0,1,24064,6,10107077277
9493,228777410,863584,229640994,1,0,0,126464,6,4553009283
9494,228784180,16937385,245721565,6,0,1,29696,3,10278497841
9495,228815031,16906557,245721588,0,0,1,5632,6,10549109126
9496,228840531,16881080,245721611,0,0,1,2560,6,4974833775
9497,228843310,173899,229017209,6,0,0,512,3,127534443
9498,228875080,16846546,245721626,5,0,1,26112,11,7722401596
9499,228889300,16832341,245721641,8,0,1,5120,6,6078982314
9500,228915410,752275,229667685,1,0,0,87552,6,9524650463
9501,228943060,16778604,245721664,4,0,1,47616,4,6202254213
9502,228961320,851042,229812362,2,0,0,27136,11,9559192313
9503,229004671,16717016,245721687,0,0,1,7680,6,271653080
9504,229017910,650118,229668028,6,0,0,1024,3,7180429614
9505,229036980,632280,229669260,6,0,0,3072,3,8789273068
9506,229069730,599893,229669623,6,0,0,512,3,2714378088
9507,229078711,16642999,245721710,0,0,1,1536,6,7332425609
9508,229097530,16624195,245721725,5,0,1,5632,11,3553721497
9509,229113030,16608710,245721740,7,0,1,17920,16,2500320149
9510,229113730,861205,229974935,6,0,0,1536,3,10273305104
9511,229123250,1267300,230390550,1,0,0,340480,6,4379696377
9512,229181001,16540754,245721755,0,0,1,3072,6,265101637
9513,229182750,755438,229938188,8,0,0,76288,6,6925191759
9514,229196470,16525300,245721770,8,0,1,6144,6,7640452871
9515,229204800,16517001,245721801,6,0,1,29184,3,1266893096
9516,229210770,593293,229804063,6,0,0,5120,3,10097031016
9517,229223660,16498156,245721816,6,0,1,12800,3,9830850213
9518,229246440,1233463,230479903,2,0,0,257536,11,3734478545
9519,229258390,656539,229914929,8,0,0,52736,6,1872214534
9520,229279370,1007410,230286780,2,0,0,67072,11,8301627648
9521,229290250,16431581,245721831,8,0,1,6656,6,1465600534
9522,229337450,16384396,245721846,6,0,1,12800,3,2400338622
9523,229365370,16356499,245721869,5,0,1,23552,11,7566573033
9524,229386900,16334984,245721884,8,0,1,7168,6,2661931857
9525,229423770,16298129,245721899,6,0,1,11776,3,655796896
9526,229428220,16293710,245721930,8,0,1,5632,6,1705387961
9527,229429430,16292515,245721945,7,0,1,10752,16,3656263106
9528,229460551,16261409,245721960,0,0,1,10240,6,4387911533
9529,229473621,16251042,245724663,0,0,1,7168,6,9050240975
9530,229523650,1116137,230639787,1,0,0,255488,6,8525064171
9531,229535210,16194842,245730052,6,0,1,17408,3,2275768013
9532,229540410,16209070,245749480,6,0,1,17408,3,4509456327
9533,229618300,16131526,245749826,8,0,1,512,6,3141339846
9534,229620800,16135850,245756650,8,0,1,8704,6,1768441845
9535,229691710,870210,230561920,1,0,0,2560,6,10534910842
9536,229709900,851185,230561085,1,0,0,264192,6,6360778084
9537,229741570,738980,230480550,6,0,0,2048,3,4763192232
9538,229758320,16000276,245758596,6,0,1,3072,3,8702264653
9539,229770470,943533,230714003,2,0,0,50176,11,7683780416
9540,229841790,15921314,245763104,5,0,1,24576,11,8653506625
9541,229850050,376138,230226188,6,0,0,512,3,9347631335
9542,229865550,15944771,245810321,7,0,1,14336,16,6455235625
9543,229913240,15908015,245821255,2,0,1,27648,11,2542811649
9544,229921450,15921146,245842596,6,0,1,6656,3,6815985859
9545,229929130,15973874,245903004,2,0,1,44544,11,7007648828
9546,229930500,15973946,245904446,7,0,1,12800,16,2342051990
9547,229930910,767774,230698684,2,0,0,58880,11,9491470921
9548,229935310,15971307,245906617,9,0,1,7680,17,8452010685
9549,229970170,15961932,245932102,8,0,1,14336,6,2722375597
9550,229985870,15966476,245952346,8,0,1,11264,6,3657382169
9551,230019130,958214,230977344,1,0,0,69120,6,1317159108
9552,230030140,649770,230679910,1,0,0,131584,6,8981012685
9553,230055590,15897957,245953547,2,0,1,13312,11,5400935037
9554,230071180,15901833,245973013,7,0,1,512,16,8919085918
9555,230084700,15888672,245973372,5,0,1,9728,11,4600897438
9556,230110290,15882558,245992848,9,0,1,8192,17,3948748218
9557,230128040,827075,230955115,1,0,0,71168,6,981477358
9558,230142380,15954090,246096470,8,0,1,67072,6,3759916200
9559,230146860,15953476,246100336,9,0,1,6144,17,7201606089
9560,230152881,15948441,246101322,0,0,1,1536,6,8291208334
9561,230180120,15925064,246105184,2,0,1,12800,11,7820462549
9562,230189440,15950462,246139902,5,0,1,7168,11,5851438877
9563,230212301,15927616,246139917,0,0,1,1536,6,2035103362
9564,230218290,898329,231116619,1,0,0,149504,6,7081123657
9565,230238750,717324,230956074,6,0,0,3072,3,4867631960
9566,230242170,15926839,246169009,6,0,1,20992,3,4780048609
9567,230280700,741299,231021999,8,0,0,146432,6,1070172789
9568,230289760,15879595,246169355,5,0,1,512,11,4063408029
9569,230295030,827696,231122726,1,0,0,19968,6,10012771865
9570,230295251,15879916,246175167,0,0,1,9216,6,4485770390
9571,230328590,15901184,246229774,2,0,1,18432,11,1364735253
9572,230333530,15941642,246275172,5,0,1,20992,11,9965315397
9573,230335730,597678,230933408,2,0,0,123392,11,4619446505
9574,230338070,15994060,246332130,8,0,1,18432,6,912751647
9575,230339730,340983,230680713,6,0,0,2560,3,7534301753
9576,230375100,15966805,246341905,1,0,1,23040,6,10696004510
9577,230385990,15956261,246342251,2,0,1,512,11,2223448920
9578,230386080,15965284,246351364,7,0,1,9728,16,906658740
9579,230415340,15998410,246413750,8,0,1,17920,6,8345037152
9580,230441630,794449,231236079,2,0,0,84992,11,9542414644
9581,230442550,16029102,246471652,1,0,1,35328,6,2044609471
9582,230452080,16049684,246501764,7,0,1,10752,16,5727409684
9583,230471540,16048675,246520215,2,0,1,15360,11,10099521446
9584,230496340,459913,230956253,6,0,0,512,3,6714822811
9585,230510480,16022210,246532690,8,0,1,16384,6,1147411892
9586,230516040,801645,231317685,2,0,0,119808,11,8692522105
9587,230562950,15971726,246534676,6,0,1,3072,3,8326776472
9588,230580030,15998522,246578552,5,0,1,5120,11,5822949107
9589,230586270,16006516,246592786,1,0,1,36352,6,3150098792
9590,230592640,16000374,246593014,2,0,1,25088,11,7709001611
9591,230601970,16004270,246606240,8,0,1,12288,6,3520188972
9592,230615370,1083915,231699285,2,0,0,158720,11,6006064232
9593,230640910,15966636,246607546,6,0,1,2048,3,4956610315
9594,230661740,15969826,246631566,7,0,1,45568,16,973190200
9595,230675360,703045,231378405,2,0,0,31744,11,10513759298
9596,230689550,720646,231410196,8,0,0,3072,6,5166124385
9597,230705120,16009557,246714677,1,0,1,74752,6,1470534286
9598,230717801,16022205,246740006,0,0,1,1024,6,184430914
9599,230749360,15990661,246740021,7,0,1,1536,16,6314072473
9600,230754850,761208,231516058,2,0,0,137728,11,5669250602
9601,230799720,15940316,246740036,6,0,1,5120,3,4763514733
9602,230811490,15928784,246740274,6,0,1,3072,3,1645883354
9603,230813260,704606,231517866,8,0,0,3072,6,3331690285
9604,230827540,15932921,246760461,1,0,1,8192,6,453942581
9605,230833160,15929030,246762190,2,0,1,15360,11,6163570368
9606,230865790,15903070,246768860,6,0,1,21504,3,2469250839
9607,230872120,15896996,246769116,8,0,1,9216,6,7184231136
9608,230883591,15885884,246769475,0,0,1,9728,6,8552546295
9609,230944820,649470,231594290,8,0,0,1024,6,2303709176
9610,230951730,15825284,246777014,2,0,1,4608,11,3566712614
9611,230959130,15825047,246784177,1,0,1,7680,6,10444283123
9612,230960481,15841704,246802185,0,0,1,17920,6,2782103425
9613,231005620,571196,231576816,8,0,0,24576,6,6029450581
9614,231062010,15745859,246807869,6,0,1,20992,3,9962686657
9615,231065980,15752434,246818414,8,0,1,1536,6,1194455965
9616,231122820,394064,231516884,6,0,0,2560,3,1723084667
9617,231142530,15892319,247034849,6,0,1,86016,3,2014389821
9618,231169531,15866765,247036296,0,0,1,11776,6,191041629
9619,231180510,15875705,247056215,1,0,1,1024,6,9141910769
9620,231206940,15853141,247060081,1,0,1,6144,6,6372645163
9621,231214290,353242,231567532,2,0,0,3072,11,9029742030
9622,231227200,865824,232093024,1,0,0,112640,6,5653755141
9623,231265290,520296,231785586,8,0,0,55808,6,10193730782
9624,231268210,609137,231877347,2,0,0,22016,11,4634455893
9625,231287320,340676,231627996,6,0,0,2560,3,9165821363
9626,231325870,15734365,247060235,8,0,1,8704,6,8744314658
9627,231337950,15722631,247060581,2,0,1,512,11,10731079650
9628,231376650,862804,232239454,8,0,0,171520,6,7743151973
9629,231383450,320583,231704033,6,0,0,15360,3,1975677345
9630,231434270,15627617,247061887,2,0,1,2048,11,2646960534
9631,231472130,15590833,247062963,8,0,1,13312,6,8950068641
9632,231481150,15744187,247225337,6,0,1,51712,3,10427714176
9633,231512040,15715838,247227878,8,0,1,42496,6,2709822015
9634,231529530,15698363,247227893,1,0,1,512,6,5693898836
9635,231539550,469503,232009053,1,0,0,32768,6,7824443261
9636,231551320,319304,231870624,2,0,0,101888,11,1313934195
9637,231629390,844551,232473941,8,0,0,369152,6,5256723593
9638,231659020,909837,232568857,1,0,0,107520,6,10104743222
9639,231703340,612780,232316120,6,0,0,37376,3,4432808234
9640,231730230,15543089,247273319,7,0,1,29696,16,9071506799
9641,231734460,15539365,247273825,6,0,1,39424,3,4509227809
9642,231753270,15520570,247273840,7,0,1,11264,16,5803480727
9643,231774600,15499263,247273863,2,0,1,512,11,4235530028
9644,231818880,15491573,247310453,7,0,1,17920,16,5729549643
9645,231855620,15454848,247310468,2,0,1,4096,11,360967896
9646,231860100,640110,232500210,8,0,0,56832,6,3379359883
9647,231901850,15408641,247310491,2,0,1,7168,11,10466215817
9648,231905480,15405026,247310506,7,0,1,61440,16,8073803901
9649,231925920,15413480,247339400,7,0,1,26624,16,1509856743
9650,231998630,360550,232359180,8,0,0,91136,6,4819157021
9651,232082530,15267160,247349690,7,0,1,23040,16,8397760593
9652,232117860,15233008,247350868,1,0,1,13824,6,3600923363
9653,232142090,340789,232482879,6,0,0,29184,3,6054870216
9654,232188130,15201191,247389321,7,0,1,40448,16,9706138515
9655,232226790,371912,232598702,2,0,0,94208,11,2512553032
9656,232297680,15110675,247408355,7,0,1,24576,16,1717017881
9657,232298210,15110401,247408611,4,0,1,9216,4,2294577308
9658,232336700,15093952,247430652,1,0,1,24576,6,2831062717
9659,232360180,668131,233028311,8,0,0,192512,6,4948803875
9660,232373300,15063913,247437213,1,0,1,4608,6,7269745532
9661,232458720,14994343,247453063,1,0,1,20480,6,9577675064
9662,232486150,14972392,247458542,4,0,1,19968,4,2010159334
9663,232530690,1036058,233566748,2,0,0,480256,11,4167017494
9664,232531150,14933524,247464674,7,0,1,9728,16,10183957106
9665,232550300,126665,232676965,1,0,0,1024,6,5333118002
9666,232573510,14894710,247468220,4,0,1,5632,4,6112496260
9667,232595830,14874656,247470486,4,0,1,3584,4,8050785593
9668,232621050,14854608,247475658,7,0,1,8192,16,314341246
9669,232625510,1194496,233820006,8,0,0,190976,6,4605057847
9670,232633280,1603641,234236921,8,0,0,124416,6,6878925938
9671,232643600,1542687,234186287,2,0,0,292864,11,1389767809
9672,232645800,969155,233614955,1,0,0,53760,6,4674401280
9673,232659480,625306,233284786,8,0,0,60416,6,2521592533
9674,232675120,591243,233266363,8,0,0,110080,6,3145164287
9675,232765860,1123708,233889568,6,0,0,56832,3,623423806
9676,232810020,14689547,247499567,7,0,1,16896,16,4872090339
9677,232862300,736139,233598439,8,0,0,103936,6,977201811
9678,232976950,14540744,247517694,4,0,1,52736,4,2839663465
9679,232977820,653667,233631487,1,0,0,512,6,2251526187
9680,232999120,14521480,247520600,7,0,1,4608,16,1306948992
9681,233014960,937663,233952623,8,0,0,206848,6,3537847288
9682,233029440,800573,233830013,2,0,0,32768,11,9273186914
9683,233078360,14475023,247553383,1,0,1,20992,6,6165001054
9684,233086240,14479363,247565603,1,0,1,29696,6,5062159145
9685,233106470,990554,234097024,1,0,0,153088,6,1600861886
9686,233112260,14454329,247566589,4,0,1,1536,4,441024975
9687,233115440,646363,233761803,2,0,0,111616,11,6546234132
9688,233118400,753837,233872237,2,0,0,69632,11,1151111797
9689,233156530,14414681,247571211,7,0,1,18944,16,9794480785
9690,233162350,1187824,234350174,1,0,0,108544,6,9324582599
9691,233254550,14328524,247583074,1,0,1,9216,6,5026016300
9692,233255680,14343122,247598802,7,0,1,7680,16,9650395992
9693,233274630,14335941,247610571,7,0,1,3584,16,4606552015
9694,233276300,14338137,247614437,4,0,1,6144,4,9651983723
9695,233315390,14299713,247615103,7,0,1,1024,16,5740242972
9696,233335480,496621,233832101,6,0,0,6656,3,3711479002
9697,233365780,684539,234050319,6,0,0,16896,3,6728597954
9698,233381730,14234039,247615769,4,0,1,1024,4,1803908162
9699,233401730,14214385,247616115,1,0,1,512,6,8113799808
9700,233444340,600778,234045118,8,0,0,188416,6,6918021003
9701,233477410,839677,234317087,6,0,0,114176,3,3186415720
9702,233489420,932245,234421665,2,0,0,35840,11,1816181473
9703,233597520,996363,234593883,6,0,0,35328,3,3448772613
9704,233612680,1240085,234852765,6,0,0,173056,3,1744963301
9705,233704880,13920325,247625205,1,0,1,31744,6,9060635921
9706,233747170,817907,234565077,6,0,0,260096,3,8411404423
9707,233841170,644636,234485806,1,0,0,21504,6,7223466022
9708,233864710,487535,234352245,8,0,0,4608,6,2439951909
9709,233867870,13767438,247635308,1,0,1,1024,6,5518871510
9710,233878630,811988,234690618,8,0,0,72192,6,9570253689
9711,233915360,1198762,235114122,2,0,0,194560,11,10454026210
9712,233915890,1282090,235197980,1,0,0,113664,6,6206372318
9713,233997790,1693944,235691734,2,0,0,717824,11,10455685739
9714,234034070,543682,234577752,2,0,0,41472,11,6137871320
9715,234035680,834013,234869693,2,0,0,19456,11,5093348283
9716,234057090,1106195,235163285,8,0,0,161280,6,7388492758
9717,234070110,1705876,235775986,8,0,0,71680,6,156051176
9718,234137370,1223245,235360615,2,0,0,267776,11,5491451506
9719,234146250,13492499,247638749,1,0,1,13824,6,541195412
9720,234157360,13517856,247675216,7,0,1,11264,16,6562350527
9721,234171400,13503831,247675231,1,0,1,2560,6,3840783963
9722,234213150,754875,234968025,6,0,0,14336,3,7976118642
9723,234276800,1193342,235470142,2,0,0,40960,11,5296137132
9724,234277950,13400119,247678069,1,0,1,4608,6,5029476694
9725,234318730,1767608,236086338,6,0,0,433152,3,8952541961
9726,234327650,13350434,247678084,1,0,1,7680,6,5682877013
9727,234327870,1625890,235953760,2,0,0,95232,11,1503079054
9728,234413230,1340854,235754084,8,0,0,168448,6,1335918698
9729,234458690,13219417,247678107,7,0,1,6656,16,8494129701
9730,234458820,13232249,247691069,7,0,1,36352,16,935057472
9731,234479190,13215105,247694295,1,0,1,5120,6,1520974063
9732,234479820,13217381,247697201,7,0,1,4608,16,9201177895
9733,234490900,13209538,247700438,7,0,1,11776,16,9654657612
9734,234504510,13196274,247700784,3,0,1,512,0,8165864406
9735,234580210,1253278,235833488,8,0,0,4096,6,6291418164
9736,234588530,851265,235439795,6,0,0,46592,3,3511685917
9737,234619040,13093725,247712765,7,0,1,39424,16,4261925504
9738,234666040,1166129,235832169,1,0,0,184320,6,4881144140
9739,234689110,13025723,247714833,3,0,1,9728,0,9909783586
9740,234705340,13018609,247723949,7,0,1,1024,16,2527303228
9741,234742110,655879,235397989,1,0,0,41472,6,4981173876
9742,234743820,12981000,247724820,1,0,1,12288,6,9209169654
9743,234744450,1382501,236126951,6,0,0,56320,3,2725802013
9744,234758220,12970760,247728980,1,0,1,512,6,7883695979
9745,234777820,1146879,235924699,8,0,0,122880,6,5295179320
9746,234780890,12951316,247732206,7,0,1,5120,16,9339585977
9747,234797280,12935272,247732552,8,0,1,512,6,2332262605
9748,234804610,898059,235702669,8,0,0,35840,6,3380740234
9749,234835690,12902008,247737698,3,0,1,8192,0,7944268708
9750,234837220,388559,235225779,2,0,0,2560,11,1144120873
9751,234843750,12894921,247738671,7,0,1,12800,16,2270854417
9752,234854070,12903645,247757715,9,0,1,27648,17,3111072055
9753,234881760,12908230,247789990,3,0,1,4608,0,7935653570
9754,234983280,870503,235853783,8,0,0,66560,6,4825474082
9755,235030370,856812,235887182,8,0,0,109568,6,8257898388
9756,235057280,12734336,247791616,7,0,1,2560,16,764884116
9757,235104820,1189379,236294199,6,0,0,403968,3,1025324557
9758,235112930,12684639,247797569,7,0,1,28160,16,465078496
9759,235123490,12709781,247833271,9,0,1,14336,17,4043297544
9760,235127690,12712494,247840184,7,0,1,27648,16,9070219627
9761,235138160,12710319,247848479,3,0,1,20480,0,4471618399
9762,235159980,1220407,236380387,2,0,0,148480,11,1245186874
9763,235167920,12680905,247848825,7,0,1,512,16,4523232118
9764,235279870,12575573,247855443,3,0,1,23552,0,4757923116
9765,235300380,791979,236092359,8,0,0,19456,6,3094005144
9766,235374340,12481769,247856109,3,0,1,11264,0,3290306784
9767,235408300,12451995,247860295,7,0,1,6656,16,8783993868
9768,235443400,891694,236335094,1,0,0,134144,6,4670283121
9769,235549060,857524,236406584,6,0,0,20992,3,10459646933
9770,235566030,576388,236142418,6,0,0,50688,3,9624979935
9771,235627310,482426,236109736,8,0,0,56832,6,10687852117
9772,235635070,12226531,247861601,3,0,1,2048,0,4668281836
9773,235654890,912146,236567036,1,0,0,213504,6,9102701059
9774,235658140,12209888,247868028,1,0,1,27136,6,8790255626
9775,235694990,12184827,247879817,1,0,1,27136,6,2916163469
9776,235731480,668593,236400073,2,0,0,47616,11,5968804538
9777,235736630,12148074,247884704,2,0,1,6144,11,7110899673
9778,235768550,12125731,247894281,7,0,1,25600,16,10569423854
9779,235768570,12126057,247894627,7,0,1,512,16,6988580904
9780,235835610,12096103,247931713,3,0,1,24064,0,9505421921
9781,235887200,12046459,247933659,7,0,1,3072,16,5384764800
9782,235892200,12125438,248017638,3,0,1,13312,0,6460091980
9783,235908080,477470,236385550,1,0,0,16896,6,10412635514
9784,235974860,12047604,248022464,7,0,1,7680,16,8393351179
9785,235982900,12044692,248027592,1,0,1,17408,6,8471483336
9786,235992600,12041622,248034222,3,0,1,7680,0,10509292309
9787,236002880,454537,236457417,8,0,0,71680,6,4752512314
9788,236002910,12100355,248103265,7,0,1,14848,16,1059255176
9789,236035130,12068289,248103419,3,0,1,8704,0,5973117824
9790,236081420,727260,236808680,6,0,0,41472,3,5299621929
9791,236087690,486255,236573945,2,0,0,22528,11,175180808
9792,236110900,12022717,248133617,2,0,1,512,11,5373878662
9793,236114020,604085,236718105,2,0,0,128512,11,2278240252
9794,236158910,440026,236598936,8,0,0,81920,6,743939847
9795,236170970,244181,236415151,2,0,0,16384,11,2060358900
9796,236181500,11953423,248134923,3,0,1,2048,0,8476404152
9797,236204400,402389,236606789,1,0,0,25600,6,3738091056
9798,236224170,771620,236995790,1,0,0,104960,6,8256746864
9799,236243100,11919017,248162117,1,0,1,15872,6,7597264404
9800,236251080,784911,237035991,1,0,0,106496,6,6323234804
9801,236296320,787574,237083894,2,0,0,91648,11,1286645796
9802,236344300,11870385,248214685,2,0,1,10752,11,5754067060
9803,236377700,490584,236868284,1,0,0,75776,6,3344059605
9804,236395560,338012,236733572,1,0,0,50688,6,4814125564
9805,236526670,731832,237258502,6,0,0,217600,3,4282125814
9806,236546720,11670551,248217271,2,0,1,4096,11,10472828855
9807,236646320,11573537,248219857,7,0,1,4096,16,4213230475
9808,236694280,460222,237154502,1,0,0,212480,6,5763971160
9809,236698430,11526840,248225270,4,0,1,15872,4,10633569538
9810,236753300,11472636,248225936,2,0,1,1024,11,5319974634
9811,236767640,568580,237336220,1,0,0,198656,6,6432173442
9812,236861240,506849,237368089,1,0,0,76800,6,2730167292
9813,236884910,390767,237275677,8,0,0,56320,6,1696758115
9814,236950000,11357787,248307787,3,0,1,93696,0,1294780507
9815,236957480,11355453,248312933,2,0,1,8192,11,5868711008
9816,236991450,11333125,248324575,7,0,1,4096,16,5269011099
9817,236995520,11891132,248886652,2,0,1,63488,11,3799323562
9818,237011620,12120621,249132241,7,0,1,4608,16,5727812994
9819,237073570,433417,237506987,6,0,0,148992,3,2308478214
9820,237110450,400817,237511267,1,0,0,13824,6,6835504026
9821,237112000,12408227,249520227,2,0,1,3072,11,2796339447
9822,237127850,212987,237340837,2,0,0,14848,11,6865864770
9823,237165150,12526876,249692026,7,0,1,10752,16,3348634088
9824,237189931,12502110,249692041,0,0,1,10752,6,441041904
9825,237271611,12444039,249715650,0,0,1,17408,6,5659543055
9826,237274430,501338,237775768,5,0,0,44544,11,2072878029
9827,237297030,305838,237602868,6,0,0,51712,3,4198746757
9828,237306610,12440537,249747147,3,0,1,13312,0,829350343
9829,237322640,637830,237960470,5,0,0,166400,11,5451536190
9830,237323250,390260,237713510,5,0,0,97280,11,5570044913
9831,237358701,12510342,249869043,0,0,1,32768,6,7352539852
9832,237407920,12461154,249869074,2,0,1,17408,11,2358503829
9833,237417290,12495832,249913122,2,0,1,35328,11,3683923603
9834,237444360,12477718,249922078,3,0,1,7168,0,6460317919
9835,237448570,532507,237981077,8,0,0,67584,6,5004329150
9836,237456400,872963,238329363,5,0,0,194048,11,5034632233
9837,237459531,12569597,250029128,0,0,1,47104,6,3767280112
9838,237478190,524312,238002502,2,0,0,70144,11,10325316711
9839,237510570,665979,238176549,6,0,0,107008,3,9622033064
9840,237550470,593414,238143884,6,0,0,162304,3,2283497164
9841,237573250,12455893,250029143,7,0,1,15360,16,8864356803
9842,237708070,523874,238231944,0,0,0,181760,6,6985101919
9843,237736641,12492524,250229165,0,0,1,21504,6,7646008
9844,237755680,12528943,250284623,3,0,1,32256,0,6006359568
9845,237774060,811848,238585908,2,0,0,118784,11,1348106855
9846,237783250,596745,238379995,2,0,0,48128,11,8475298765
9847,237797550,653702,238451252,1,0,0,76800,6,1783911144
9848,237797821,12486817,250284638,0,0,1,1024,6,4968725799
9849,237813911,12470742,250284653,0,0,1,10752,6,5956699432
9850,237817720,12466948,250284668,3,0,1,8192,0,9179825622
9851,237822880,940773,238763653,1,0,0,234496,6,3210537132
9852,237827450,12460212,250287662,3,0,1,1536,0,2804631904
9853,237856600,12431077,250287677,2,0,1,34304,11,10157289726
9854,237899460,12388232,250287692,7,0,1,26112,16,1175995977
9855,237915701,12410085,250325786,0,0,1,2048,6,2678778174
9856,237969780,12356192,250325972,7,0,1,25088,16,159584932
9857,237969910,579759,238549669,1,0,0,120832,6,3911622377
9858,237970670,825656,238796326,5,0,0,107008,11,6048115150
9859,238015390,12310784,250326174,7,0,1,1536,16,1268772575
9860,238017621,12308568,250326189,0,0,1,10240,6,7392275110
9861,238024650,12301554,250326204,3,0,1,2048,0,4352050187
9862,238035081,12291138,250326219,0,0,1,1024,6,8253107658
9863,238050070,282116,238332186,0,0,0,9216,6,6457117534
9864,238067150,625032,238692182,6,0,0,92160,3,8936657230
9865,238098860,834284,238933144,5,0,0,50176,11,1436282678
9866,238127750,12198484,250326234,3,0,1,15360,0,623696154
9867,238140520,1066053,239206573,6,0,0,58368,3,4120412366
9868,238143310,12228818,250372128,2,0,1,8192,11,7256087019
9869,238169640,1001354,239170994,6,0,0,307200,3,3581902265
9870,238175180,1178520,239353700,6,0,0,192512,3,7260978739
9871,238178030,881806,239059836,2,0,0,73216,11,7842373758
9872,238186780,885144,239071924,2,0,0,19456,11,1971078971
9873,238202141,12170002,250372143,0,0,1,12288,6,8208641262
9874,238202870,12169296,250372166,5,0,1,4096,11,6023344403
9875,238207270,697318,238904588,0,0,0,29184,6,1270787637
9876,238208830,12163351,250372181,3,0,1,1536,0,9123094700
9877,238215170,12157034,250372204,2,0,1,17920,11,9439989198
9878,238220591,12156011,250376602,0,0,1,15360,6,4295115617
9879,238221000,816505,239037505,2,0,0,29696,11,1938050683
9880,238245570,1005894,239251464,6,0,0,19456,3,9244853071
9881,238326151,12050466,250376617,0,0,1,3072,6,10259194381
9882,238326470,701957,239028427,2,0,0,97280,11,5967785754
9883,238334320,12042312,250376632,2,0,1,3584,11,7173170660
9884,238381811,11994836,250376647,0,0,1,12288,6,9160555802
9885,238388581,11988081,250376662,0,0,1,10752,6,6139501502
9886,238398941,11977744,250376685,0,0,1,14848,6,6186075373
9887,238468350,489683,238958033,1,0,0,78336,6,867874754
9888,238496540,11880168,250376708,5,0,1,28672,11,2799186485
9889,238515640,11861083,250376723,7,0,1,4096,16,8185405320
9890,238533001,11843737,250376738,0,0,1,512,6,2216045138
9891,238541150,11835603,250376753,7,0,1,2560,16,5606090435
9892,238544241,11832543,250376784,0,0,1,43008,6,7394430863
9893,238579200,906650,239485850,2,0,0,65536,11,7220012578
9894,238585120,11791679,250376799,5,0,1,23040,11,1011076646
9895,238594940,11781874,250376814,7,0,1,14336,16,10688449762
9896,238624841,11751988,250376829,0,0,1,16384,6,5971919292
9897,238674640,11702204,250376844,2,0,1,15872,11,8354375354
9898,238697640,491111,239188751,0,0,0,57856,6,3955781129
9899,238705790,11684945,250390735,7,0,1,15360,16,9793262272
9900,238713970,11677124,250391094,5,0,1,9728,11,7374077401
9901,238729370,688022,239417392,5,0,0,164864,11,1578195972
9902,238745130,11652988,250398118,5,0,1,12288,11,9720161490
9903,238752640,11668428,250421068,7,0,1,41984,16,9312006190
9904,238765770,11688402,250454172,5,0,1,15872,11,146003719
9905,238830310,599585,239429895,2,0,0,40960,11,1340529108
9906,238847690,518624,239366314,6,0,0,2048,3,4336601960
9907,238855940,11598796,250454736,2,0,1,10752,11,148903111
9908,238899600,11581381,250480981,5,0,1,20992,11,7247893408
9909,238909800,890100,239799900,2,0,0,1024,11,7732611944
9910,238916570,328951,239245521,6,0,0,87040,3,3839530201
9911,238951271,11532296,250483567,0,0,1,4096,6,4032510243
9912,238961520,676076,239637596,0,0,0,23040,6,4560678465
9913,238969510,11514518,250484028,5,0,1,10240,11,6927628574
9914,238972000,1083490,240055490,6,0,0,120832,3,6359543429
9915,238994020,11515209,250509229,2,0,1,19456,11,318361012
9916,239015481,11647534,250663015,0,0,1,27136,6,6487789340
9917,239028440,11634598,250663038,2,0,1,6656,11,7814032987
9918,239063551,11599502,250663053,0,0,1,2048,6,7393003576
9919,239073510,11595868,250669378,5,0,1,5120,11,8290106285
9920,239085450,12004897,251090347,2,0,1,13312,11,2549987080
9921,239100760,698813,239799573,6,0,0,385536,3,2949171678
9922,239104650,779781,239884431,5,0,0,90112,11,9448858969
9923,239135630,535667,239671297,1,0,0,512,6,1711337146
9924,239173310,1161000,240334310,1,0,0,315904,6,8748369729
9925,239181730,756875,239938605,2,0,0,13312,11,2425617387
9926,239187770,12587675,251775445,5,0,1,13824,11,1053510476
9927,239229320,960903,240190223,0,0,0,76800,6,3728938046
9928,239235300,12939289,252174589,6,0,1,169472,3,7484491422
9929,239306480,12880514,252186994,5,0,1,15872,11,8871141952
9930,239343310,13121222,252464532,5,0,1,50688,11,8754980452
9931,239347191,13143649,252490840,0,0,1,23040,6,32454031
9932,239372200,974608,240346808,2,0,0,19968,11,1068625985
9933,239420700,665256,240085956,5,0,0,99840,11,79420865
9934,239422281,13068574,252490855,0,0,1,6144,6,108179930
9935,239439100,237426,239676526,2,0,0,13824,11,2273066785
9936,239452250,1050289,240502539,6,0,0,226304,3,9808479687
9937,239458750,13032120,252490870,7,0,1,4608,16,6761941867
9938,239507360,460935,239968295,6,0,0,31232,3,6004627578
9939,239523710,12967175,252490885,5,0,1,3072,11,976262030
9940,239554080,1090558,240644638,6,0,0,204800,3,10034211400
9941,239566140,13085302,252651442,6,0,1,96768,3,8923120129
9942,239597980,370954,239968934,5,0,0,2048,11,8209022230
9943,239623420,471333,240094753,0,0,0,28672,6,10424453284
9944,239638870,699846,240338716,6,0,0,14336,3,8512062819
9945,239657330,13039816,252697146,3,0,1,18432,0,3964347520
9946,239677300,277617,239954917,5,0,0,1536,11,2943902890
9947,239740010,841550,240581560,1,0,0,127488,6,4914073314
9948,239744450,493593,240238043,0,0,0,87552,6,5103142497
9949,239767870,1305979,241073849,6,0,0,367104,3,2642215991
9950,239787650,12962785,252750435,1,0,1,8704,6,459522802
9951,239814540,13033583,252848123,1,0,1,7168,6,7964236151
9952,239852450,12995688,252848138,7,0,1,20480,16,6575065776
9953,239881940,13191504,253073444,1,0,1,40448,6,4784156405
9954,239889260,653433,240542693,1,0,0,34816,6,6801164824
9955,239890430,641616,240532046,1,0,0,96768,6,9198193796
9956,239892100,13227272,253119372,6,0,1,64000,3,806727419
9957,239922000,813339,240735339,1,0,0,35328,6,5930853405
9958,239953150,429873,240383023,0,0,0,16896,6,4444340368
9959,239970570,13266053,253236623,6,0,1,60928,3,8795206427
9960,239984620,597595,240582215,6,0,0,2048,3,2018200804
9961,240015600,820572,240836172,2,0,0,114176,11,6576604648
9962,240030460,815555,240846015,2,0,0,32256,11,7290221491
9963,240035490,13201156,253236646,6,0,1,9216,3,10321017566
9964,240056450,13186934,253243384,6,0,1,512,3,10603216355
9965,240063740,1137027,241200767,0,0,0,83456,6,10045454323
9966,240077890,1184043,241261933,2,0,0,159744,11,1026129832
9967,240125700,13117699,253243399,7,0,1,4608,16,9420636500
9968,240156070,1237344,241393414,6,0,0,78336,3,1985185749
9969,240160470,1011221,241171691,0,0,0,321024,6,6480533615
9970,240210940,1083190,241294130,2,0,0,69120,11,1000007447
9971,240228940,629363,240858303,1,0,0,20480,6,1919825332
9972,240268030,506810,240774840,2,0,0,22528,11,5970012933
9973,240268410,938924,241207334,6,0,0,21504,3,6052524505
9974,240277780,995244,241273024,2,0,0,36352,11,5572823234
9975,240281220,13158061,253439281,6,0,1,117760,3,3985057832
9976,240282640,13203479,253486119,1,0,1,13312,6,6062826303
9977,240305320,1064211,241369531,1,0,0,70144,6,8875877180
9978,240323640,638342,240961982,1,0,0,8704,6,1228664572
9979,240331090,1017007,241348097,5,0,0,1536,11,37880017
9980,240344370,1156447,241500817,1,0,0,63488,6,1245724627
9981,240351380,13134754,253486134,7,0,1,7680,16,5210108685
9982,240394330,953284,241347614,1,0,0,175104,6,6141038489
9983,240438480,13047669,253486149,7,0,1,20992,16,1299115720
9984,240477580,735541,241213121,1,0,0,18944,6,964445643
9985,240485850,916939,241402789,2,0,0,30720,11,8649666435
9986,240496540,12989632,253486172,7,0,1,14336,16,4961086411
9987,240517090,658234,241175324,1,0,0,11776,6,3468047179
9988,240547730,13952836,254500566,6,0,1,972800,3,7197964282
9989,240584560,1326751,241911311,1,0,0,321536,6,1456922248
9990,240592860,1612310,242205170,6,0,0,225280,3,9893666637
9991,240620730,1113680,241734410,1,0,0,161280,6,1537872136
9992,240645720,1167577,241813297,5,0,0,11264,11,7904798861
9993,240665230,13839578,254504808,7,0,1,5120,16,4210376845
9994,240691030,1376014,242067044,0,0,0,322560,6,2552991993
9995,240738890,13765933,254504823,1,0,1,5120,6,8233747899
9996,240746710,13758128,254504838,1,0,1,16896,6,3386682029
9997,240754440,14031462,254785902,6,0,1,203776,3,10402483704
9998,240758230,1051581,241809811,2,0,0,131072,11,8017273830
9999,240846660,913817,241760477,2,0,0,85504,11,4842746083
10000,240865760,14049477,254915237,6,0,1,20480,3,8139524778
10001,240901320,14355565,255256885,6,0,1,157184,3,10503569580
10002,240925990,843870,241769860,2,0,0,30720,11,864424056
10003,240942350,14640552,255582902,9,0,1,22528,17,9380437399
10004,240943520,14822750,255766270,6,0,1,46592,3,3870539334
10005,240954590,15117464,256072054,6,0,1,221696,3,2456966309
10006,240964430,536714,241501144,2,0,0,1024,11,3968409557
10007,241031480,15063684,256095164,1,0,1,32768,6,183949130
10008,241033180,15065530,256098710,7,0,1,5632,16,7506196517
10009,241051450,15192388,256243838,6,0,1,137216,3,5167089225
10010,241098460,978606,242077066,0,0,0,25088,6,4964097672
10011,241102790,486962,241589752,0,0,0,16896,6,4166487998
10012,241107680,804597,241912277,5,0,0,3072,11,1503170817
10013,241128670,1003643,242132313,0,0,0,181248,6,3433087739
10014,241149871,15102023,256251894,0,0,1,33280,6,5369356441
10015,241164960,1196675,242361635,6,0,0,249344,3,9775290919
10016,241175430,15138549,256313979,1,0,1,7680,6,10482589247
10017,241176730,15137264,256313994,1,0,1,5120,6,10498409632
10018,241274100,15040084,256314184,7,0,1,9728,16,744063915
10019,241294930,1407224,242702154,6,0,0,185344,3,1000146486
10020,241313580,972068,242285648,6,0,0,84992,3,3598812500
10021,241347350,14967295,256314645,1,0,1,10240,6,2591054026
10022,241348850,15075907,256424757,1,0,1,47104,6,2043692746
10023,241362060,15214411,256576471,1,0,1,18944,6,3034591959
10024,241364810,1042345,242407155,5,0,0,2560,11,4916890188
10025,241427380,15186717,256614097,1,0,1,7680,6,2943020453
10026,241461170,15152950,256614120,7,0,1,6656,16,9273961173
10027,241504760,871607,242376367,0,0,0,45056,6,584440499
10028,241531560,681449,242213009,6,0,0,25600,3,6391122978
10029,241565610,657586,242223196,1,0,0,33280,6,10712108754
10030,241590330,15023805,256614135,5,0,1,8704,11,6977111315
10031,241592050,15022100,256614150,7,0,1,7680,16,2489785674
10032,241596290,473117,242069407,1,0,0,7680,6,3632719132
10033,241600450,15013723,256614173,1,0,1,4608,6,883666609
10034,241646110,14968078,256614188,5,0,1,13312,11,2838156321
10035,241675140,15007125,256682265,1,0,1,42496,6,6922360821
10036,241695720,15048444,256744164,6,0,1,201728,3,4207421676
10037,241715640,785567,242501207,1,0,0,131072,6,9818003686
10038,241762120,600310,242362430,5,0,0,2560,11,6454245115
10039,241780180,1026212,242806392,6,0,0,133120,3,6456589686
10040,241783950,721275,242505225,5,0,0,2560,11,8236733249
10041,241840130,1169037,243009167,0,0,0,116736,6,4271075483
10042,241943890,810296,242754186,0,0,0,170496,6,8746448752
10043,241953700,408901,242362601,5,0,0,512,11,6362165376
10044,241983000,902442,242885442,1,0,0,211456,6,4649374136
10045,242006630,14737549,256744179,1,0,1,512,6,8275078725
10046,242079150,14665044,256744194,7,0,1,2048,16,6816744043
10047,242083540,975203,243058743,5,0,0,2048,11,5607501391
10048,242119090,14656670,256775760,3,0,1,39424,0,3908508709
10049,242151880,351214,242503094,5,0,0,6144,11,3218999055
10050,242163410,14612373,256775783,3,0,1,10752,0,1560452857
10051,242168560,14607238,256775798,5,0,1,11776,11,6978645121
10052,242181720,449066,242630786,5,0,0,4608,11,10085018688
10053,242206570,766966,242973536,0,0,0,128000,6,3099593009
10054,242243640,14532189,256775829,3,0,1,4608,0,2993540682
10055,242253695,14522149,256775844,3,0,1,1024,0,6554723760
10056,242303220,14472639,256775859,3,0,1,1536,0,1759155299
10057,242356350,14419524,256775874,7,0,1,3584,16,8876156960
10058,242356580,14419309,256775889,7,0,1,1024,16,97078858
10059,242371800,382923,242754723,5,0,0,1536,11,7782177582
10060,242389160,14386744,256775904,5,0,1,10752,11,2304917796
10061,242409960,14369163,256779123,6,0,1,9728,3,2568156562
10062,242423750,14358279,256782029,7,0,1,4608,16,9397310690
10063,242425891,395024,242820915,7,0,0,47616,16,9884640794
10064,242440450,14451020,256891470,6,0,1,72192,3,5254856785
10065,242477270,454786,242932056,2,0,0,2048,11,9142102202
10066,242483350,563616,243046966,0,0,0,123904,6,7432302696
10067,242488210,662927,243151137,6,0,0,77312,3,5860918798
10068,242545480,771899,243317379,0,0,0,309248,6,5213980003
10069,242565710,654342,243220052,6,0,0,32768,3,7643048014
10070,242565950,14325535,256891485,5,0,1,5120,11,1902823486
10071,242602470,14503739,257106209,6,0,1,150528,3,1460849394
10072,242632100,14752339,257384439,6,0,1,42496,3,6462762855
10073,242654070,516909,243170979,0,0,0,65024,6,855364791
10074,242674830,15176035,257850865,6,0,1,58880,3,9826953612
10075,242691100,356387,243047487,5,0,0,1536,11,6031635921
10076,242753660,15690442,258444102,6,0,1,421888,3,6346435210
10077,242762380,446048,243208428,5,0,0,2560,11,4020918649
10078,242800060,734807,243534867,6,0,0,198656,3,8620205091
10079,242854550,15638747,258493297,6,0,1,103936,3,2068447082
10080,242870310,1056758,243927068,1,0,0,100352,6,2962128130
10081,242920290,615528,243535818,5,0,0,3072,11,8237252493
10082,242920860,467778,243388638,5,0,0,3072,11,2627754613
10083,242951131,15551933,258503064,0,0,1,26112,6,3265832696
10084,242956060,518264,243474324,0,0,0,56320,6,2894450525
10085,242965910,243001,243208911,5,0,0,1536,11,9131351034
10086,242970500,15536750,258507250,6,0,1,6656,3,2995157688
10087,243021570,804080,243825650,6,0,0,328192,3,7255578980
10088,243089650,15733095,258822745,6,0,1,379904,3,6696166333
10089,243160600,980626,244141226,6,0,0,560128,3,10306571867
10090,243289620,15533140,258822760,6,0,1,10752,3,10305034753
10091,243343200,800609,244143809,1,0,0,8192,6,5683012976
10092,243373800,844505,244218305,1,0,0,244224,6,2996963445
10093,243374250,1081359,244455609,2,0,0,359424,11,4416613886
10094,243406560,853947,244260507,0,0,0,60928,6,8548151669
10095,243410330,15549360,258959690,6,0,1,153088,3,2859561843
10096,243561370,396291,243957661,5,0,0,512,11,5801435068
10097,243575170,15464771,259039941,6,0,1,78848,3,2401168939
10098,243607200,971735,244578935,2,0,0,84480,11,10219905180
10099,243613090,348296,243961386,5,0,0,1536,11,883711571
10100,243644440,15395524,259039964,6,0,1,1024,3,1539918070
10101,243651810,945157,244596967,6,0,0,58368,3,869064911
10102,243696120,530271,244226391,5,0,0,512,11,1312034130
10103,243704120,799396,244503516,2,0,0,157184,11,531714340
10104,243712950,507951,244220901,5,0,0,8192,11,10062420666
10105,243728400,16399169,260127569,6,0,1,515072,3,8486429851
10106,243728950,497270,244226220,1,0,0,17408,6,4073818457
10107,243730070,16397530,260127600,3,0,1,13824,0,6883295739
10108,243809450,498663,244308113,6,0,0,2048,3,8254883140
10109,243838480,16289135,260127615,9,0,1,28672,17,5261281455
10110,243843000,781749,244624749,6,0,0,512,3,4587346390
10111,243851720,846739,244698459,0,0,0,64000,6,3868123327
10112,243861720,16265910,260127630,3,0,1,2560,0,4692452476
10113,243863780,815134,244678914,0,0,0,31232,6,1185196530
10114,243911720,610154,244521874,0,0,0,58880,6,87956102
10115,243953470,598900,244552370,0,0,0,99840,6,648172024
10116,243973200,835527,244808727,2,0,0,215040,11,5786005624
10117,243988850,16138803,260127653,3,0,1,5632,0,4074637592
10118,244022290,530875,244553165,6,0,0,2560,3,8267676827
10119,244072930,16054738,260127668,3,0,1,2048,0,9197104028
10120,244076320,427523,244503843,5,0,0,1024,11,3790345501
10121,244120240,16007443,260127683,5,0,1,9216,11,4883615249
10122,244243380,1056819,245300199,2,0,0,109568,11,8396753552
10123,244260980,881677,245142657,0,0,0,62464,6,8411163267
10124,244268650,719120,244987770,1,0,0,9216,6,4255048961
10125,244278370,16169738,260448108,6,0,1,212992,3,3166620239
10126,244294870,16174264,260469134,6,0,1,34304,3,10134687962
10127,244340650,16224894,260565544,6,0,1,114688,3,1210533896
10128,244445390,717882,245163272,0,0,0,67584,6,9866926513
10129,244463620,347774,244811394,0,0,0,8704,6,8387438544
10130,244484800,326765,244811565,5,0,0,512,11,859213394
10131,244484980,1114749,245599729,0,0,0,93184,6,7594571929
10132,244550910,507486,245058396,6,0,0,1024,3,2936630345
10133,244552940,1017393,245570333,0,0,0,579072,6,9220039481
10134,244558280,605163,245163443,6,0,0,512,3,3671575904
10135,244565941,16005717,260571658,0,0,1,3584,6,2654103742
10136,244569150,824717,245393867,2,0,0,194560,11,4609407550
10137,244602270,1054140,245656410,1,0,0,154624,6,7091275362
10138,244633991,15940748,260574739,0,0,1,6656,6,10673742846
10139,244644740,1062819,245707559,2,0,0,160256,11,7698951151
10140,244674780,934324,245609104,2,0,0,30720,11,7487248797
10141,244693350,631991,245325341,5,0,0,1536,11,7401259505
10142,244816600,904935,245721535,0,0,0,36864,6,871308752
10143,244929200,392607,245321807,1,0,0,46592,6,4064650780
10144,244983980,726246,245710226,5,0,0,8704,11,1057958772
10145,245055000,15522645,260577645,2,0,1,4608,11,8905570875
10146,245111470,459822,245571292,6,0,0,3072,3,8579172747
10147,245125190,533450,245658640,6,0,0,7168,3,823174621
10148,245174830,15413621,260588451,2,0,1,3072,11,9308973936
10149,245194520,15394187,260588707,2,0,1,9216,11,4285780501
10150,245204041,15419608,260623649,0,0,1,52736,6,2828570850
10151,245226880,15448477,260675357,4,0,1,10240,4,385930719
10152,245329110,280165,245609275,6,0,0,512,3,3209661654
10153,245330890,15344482,260675372,2,0,1,7680,11,1331305080
10154,245353830,549143,245902973,2,0,0,189952,11,9225164231
10155,245410820,818939,246229759,2,0,0,56320,11,10265889248
10156,245416410,488021,245904431,6,0,0,4608,3,10528786055
10157,245437810,553136,245990946,1,0,0,47616,6,983269968
10158,245482560,15246818,260729378,4,0,1,6656,4,2753055508
10159,245485730,15243663,260729393,7,0,1,5120,16,5397061800
10160,245495870,969980,246465850,1,0,0,123392,6,8339487974
10161,245507560,1409656,246917216,1,0,0,160256,6,7215003684
10162,245517920,474913,245992833,0,0,0,6144,6,3049395759
10163,245540071,15189337,260729408,0,0,1,1024,6,1698235803
10164,245559320,580559,246139879,1,0,0,83968,6,4352349410
10165,245563190,15166233,260729423,2,0,1,13824,11,8192724639
10166,245581920,996617,246578537,2,0,0,92672,11,9529344216
10167,245601070,15128368,260729438,2,0,1,11264,11,2395921353
10168,245608570,340171,245948741,6,0,0,1536,3,970808177
10169,245688560,15040893,260729453,4,0,1,7168,4,871374300
10170,245709460,15020008,260729468,4,0,1,11776,4,9896387129
10171,245733481,15015737,260749218,0,0,1,3584,6,1565091095
10172,245741890,285997,246027887,5,0,0,3072,11,4173310062
10173,245749190,447461,246196651,1,0,0,51200,6,6762841792
10174,245773400,15066068,260839468,4,0,1,29696,4,8452729863
10175,245874080,538844,246412924,2,0,0,177664,11,10565126108
10176,245874420,14965063,260839483,4,0,1,13824,4,7345387130
10177,245897900,573737,246471637,2,0,0,18944,11,10472316953
10178,245905100,332573,246237673,6,0,0,512,3,4753653262
10179,245905301,14934197,260839498,0,0,1,5632,6,2736817276
10180,245979730,1028137,247007867,1,0,0,222720,6,10169458153
10181,245999440,14840073,260839513,4,0,1,3584,4,1906673647
10182,246031640,307391,246339031,5,0,0,2560,11,1880039519
10183,246048761,14831186,260879947,0,0,1,16896,6,4400254717
10184,246069970,522793,246592763,1,0,0,46592,6,426496790
10185,246081980,14797982,260879962,9,0,1,3584,17,1717853632
10186,246120840,747533,246868373,0,0,0,92160,6,8241145600
10187,246135650,604341,246739991,0,0,0,39936,6,900725440
10188,246161810,251925,246413735,6,0,0,2560,3,3392727751
10189,246272870,440653,246713523,6,0,0,1024,3,6923792047
10190,246290040,329996,246620036,6,0,0,1024,3,2213548634
10191,246297620,14582357,260879977,4,0,1,20992,4,686059313
10192,246343360,14536632,260879992,2,0,1,3584,11,5034454838
10193,246382380,14497627,260880007,4,0,1,32768,4,1332391007
10194,246386790,14493232,260880022,4,0,1,20480,4,1312268869
10195,246472920,200128,246673048,1,0,0,512,6,9944824715
10196,246482610,335789,246818399,2,0,0,8192,11,9176727728
10197,246514640,588036,247102676,2,0,0,41984,11,2159433728
10198,246516320,14370440,260886760,2,0,1,15872,11,1409567321
10199,246586780,190537,246777317,5,0,0,512,11,2004698546
10200,246631650,593664,247225314,0,0,0,342528,6,311497812
10201,246656010,617294,247273304,2,0,0,148992,11,7354594000
10202,246713400,14177410,260890810,2,0,1,28672,11,3842920253
10203,246726810,14165626,260892436,2,0,1,2560,11,196542405
10204,246759230,14133462,260892692,4,0,1,9216,4,3958203197
10205,246805630,14092762,260898392,9,0,1,6144,17,1541547180
10206,246806390,467420,247273810,6,0,0,1536,3,2358639408
10207,246839220,169622,247008842,6,0,0,3072,3,3530280096
10208,246859600,450838,247310438,1,0,0,87552,6,8462922780
10209,246904430,321858,247226288,5,0,0,3072,11,7536796184
10210,246918290,13984114,260902404,2,0,1,17408,11,4023376416
10211,246928450,13974300,260902750,2,0,1,512,11,7513725699
10212,246949580,13992633,260942213,4,0,1,24576,4,9336784115
10213,246958850,13983927,260942777,4,0,1,10752,4,5050684162
10214,246970790,340279,247311069,6,0,0,1024,3,798067274
10215,246991990,13955191,260947181,2,0,1,18944,11,3129542340
10216,246992010,235853,247227863,6,0,0,5120,3,2668177777
10217,247070880,13928437,260999317,2,0,1,13824,11,3388461516
10218,247078460,13920872,260999332,2,0,1,18944,11,2035850733
10219,247133320,404804,247538124,1,0,0,42496,6,6452572153
10220,247256100,13743247,260999347,6,0,1,18944,3,4926943969
10221,247277130,13722403,260999533,2,0,1,11264,11,5654456736
10222,247279210,481019,247760229,6,0,0,6144,3,2985637849
10223,247288230,386963,247675193,2,0,0,80896,11,1714813631
10224,247357110,102583,247459693,5,0,0,1536,11,7839020940
10225,247377680,13694901,261072581,2,0,1,64512,11,4550172193
10226,247425700,252354,247678054,0,0,0,9216,6,3721684798
10227,247437170,13662601,261099771,4,0,1,60416,4,6177129476
10228,247490270,13615812,261106082,2,0,1,23040,11,2158275056
10229,247493340,13637762,261131102,4,0,1,37376,4,5035406671
10230,247640900,880440,248521340,0,0,0,458752,6,10120952933
10231,247641940,13491164,261133104,2,0,1,512,11,10735559129
10232,247643570,83759,247727329,6,0,0,1536,3,5883397185
10233,247645350,168590,247813940,5,0,0,1024,11,8036186071
10234,247652510,158202,247810712,6,0,0,512,3,3723783872
10235,247672090,13465956,261138046,9,0,1,19456,17,9933476450
10236,247683330,13459261,261142591,4,0,1,16384,4,6736576906
10237,247697470,13451893,261149363,9,0,1,10752,17,4623930291
10238,247729150,13456225,261185375,9,0,1,12800,17,7335512586
10239,247736930,105468,247842398,9,0,0,2560,17,151480781
10240,247743310,150097,247893407,6,0,0,512,3,1542972758
10241,247747270,13438771,261186041,2,0,1,1024,11,1386026217
10242,247762180,13427087,261189267,4,0,1,5120,4,9878351163
10243,247789640,13402533,261192173,9,0,1,4608,17,2892819942
10244,247793270,13403409,261196679,2,0,1,7168,11,9350906337
10245,247857410,1015950,248873360,1,0,0,34816,6,5130157366
10246,247882980,730103,248613083,2,0,0,301056,11,1249421964
10247,247908730,13289127,261197857,4,0,1,13824,4,5730425522
10248,247926590,178720,248105310,6,0,0,1536,3,1111638435
10249,247943241,773171,248716412,7,0,0,83456,16,9584931435
10250,247962920,13236013,261198933,2,0,1,13312,11,6287139028
10251,247983180,879541,248862721,0,0,0,188928,6,384540704
10252,248099320,13104145,261203465,2,0,1,7168,11,3200556407
10253,248111160,13092651,261203811,2,0,1,512,11,12438603
10254,248113900,1278261,249392161,2,0,0,507392,11,2490645760
10255,248117470,13087327,261204797,2,0,1,1536,11,4373963125
10256,248123571,906742,249030313,7,0,0,103424,16,6121342030
10257,248164440,450438,248614878,6,0,0,5632,3,8360632312
10258,248183680,948546,249132226,2,0,0,272384,11,1201818385
10259,248195840,1002301,249198141,0,0,0,45568,6,4620988121
10260,248232050,446928,248678978,6,0,0,6656,3,4539121099
10261,248300661,1170972,249471633,7,0,0,87040,16,6160528357
10262,248348391,829885,249178276,7,0,0,151040,16,3747795640
10263,248412040,12798044,261210084,2,0,1,16896,11,3475140410
10264,248419320,1279912,249699232,1,0,0,23552,6,4265480301
10265,248425191,1307478,249732669,7,0,0,55808,16,8511225038
10266,248435271,1255789,249691060,7,0,0,107520,16,8288190841
10267,248453040,12763157,261216197,2,0,1,6656,11,2047065751
10268,248459270,12757913,261217183,9,0,1,1536,17,1590484600
10269,248524131,920959,249445090,7,0,0,8192,16,7962830808
10270,248573970,1084315,249658285,1,0,0,409600,6,7875456318
10271,248695140,486591,249181731,1,0,0,11264,6,3141052450
10272,248707440,476802,249184242,1,0,0,8192,6,2123674370
10273,248783990,658589,249442579,2,0,0,105984,11,1792191409
10274,248793850,616422,249410272,0,0,0,59392,6,1905036947
10275,248800930,1428220,250229150,2,0,0,656384,11,7596486182
10276,248804910,1117153,249922063,1,0,0,28672,6,5239163638
10277,248819140,1049405,249868545,0,0,0,19456,6,4977143478
10278,248828650,12393679,261222329,2,0,1,8192,11,2244438735
10279,248852170,1010432,249862602,0,0,0,65536,6,6758246845
10280,248863290,1462481,250325771,0,0,0,124928,6,2360067355
10281,248905171,841961,249747132,7,0,0,15360,16,3996547299
10282,248913290,12325553,261238843,4,0,1,19968,4,4174818568
10283,248920840,771171,249692011,6,0,0,3072,3,720473779
10284,248929400,962039,249891439,2,0,0,32256,11,300733809
10285,248929921,785714,249715635,7,0,0,53760,16,3226151849
10286,248947880,1336704,250284584,0,0,0,181760,6,8173930825
10287,248990210,12250429,261240639,4,0,1,9728,4,6787775493
10288,248993040,12253500,261246540,4,0,1,3072,4,8917691375
10289,249040630,988483,250029113,0,0,0,145408,6,5652113484
10290,249094611,692957,249787568,7,0,0,19456,16,8312557350
10291,249190590,1135367,250325957,6,0,0,512,3,7807339478
10292,249380101,996486,250376587,7,0,0,14336,16,3505876402
10293,249453350,11798119,261251469,7,0,1,20480,16,3169601908
10294,249469930,399098,249869028,6,0,0,1536,3,8647893264
10295,249616180,671467,250287647,0,0,0,9728,6,9804839208
10296,249857950,514163,250372113,2,0,0,150528,11,1542127012
10297,249865530,460629,250326159,6,0,0,512,3,3687521271
10298,249880000,11771619,261651619,6,0,1,481792,3,8855446788
10299,249883510,779490,250663000,2,0,0,75776,11,7273863048
10300,249922330,11804108,261726438,6,0,1,118784,3,9452837855
10301,250003940,505274,250509214,1,0,0,76288,6,6407604801
10302,250031750,370971,250402721,6,0,0,1024,3,8297238392
10303,250042780,364200,250406980,6,0,0,512,3,4206021973
10304,250043660,1152485,251196145,1,0,0,346624,6,5286634808
10305,250157940,932392,251090332,1,0,0,371712,6,128752277
10306,250163450,1146023,251309473,1,0,0,103424,6,514044959
10307,250218660,467487,250686147,1,0,0,1536,6,10446956334
10308,250284830,519050,250803880,6,0,0,1536,3,1425108870
10309,250292300,1563235,251855535,2,0,0,249856,11,6068294946
10310,250304830,11464894,261769724,6,0,1,94208,3,6556035635
10311,250338000,570394,250908394,6,0,0,2560,3,3510985905
10312,250415000,1300583,251715583,2,0,0,589312,11,4004927864
10313,250458880,210483,250669363,1,0,0,18432,6,4417440999
10314,250460011,1984747,252444758,7,0,0,299520,16,6849249737
10315,250473700,804246,251277946,2,0,0,187904,11,4378906522
10316,250478120,612398,251090518,6,0,0,512,3,5829325712
10317,250505160,1240733,251745893,2,0,0,66560,11,557918130
10318,250559660,2039512,252599172,6,0,0,2560,3,10723146916
10319,250572460,1153122,251725582,0,0,0,32768,6,2088736792
10320,250584640,1906185,252490825,6,0,0,1024,3,7611977381
10321,250607950,11164348,261772298,7,0,1,17408,16,8995800829
10322,250660870,2084948,252745818,0,0,0,18944,6,5046188424
10323,250673351,1106033,251779384,7,0,0,12800,16,8514167603
10324,250712620,2253380,252966000,2,0,0,125440,11,7674258087
10325,250727920,1736525,252464445,2,0,0,64512,11,10655177823
10326,250766820,1008610,251775430,1,0,0,90112,6,9495495770
10327,250826280,1091985,251918265,1,0,0,90112,6,2459456965
10328,250830050,1226651,252056701,0,0,0,36864,6,927802097
10329,250838470,1110287,251948757,1,0,0,66048,6,3701364654
10330,250858720,1268703,252127423,6,0,0,3584,3,6699693508
10331,250881990,10891934,261773924,2,0,1,2560,11,5409517825
10332,250935470,812489,251747959,6,0,0,2560,3,2344543884
10333,250935670,591023,251526693,6,0,0,7168,3,6124412192
10334,250945390,1180902,252126292,1,0,0,228352,6,8449739050
10335,250973960,979163,251953123,6,0,0,512,3,7481535465
10336,251137841,1215642,252353483,7,0,0,284160,16,9681001759
10337,251313960,10463510,261777470,7,0,1,5632,16,8603041884
10338,251358740,1789643,253148383,0,0,0,86528,6,7704141456
10339,251389480,877408,252266888,1,0,0,88064,6,1952360455
10340,251409060,1077015,252486075,2,0,0,70656,11,4591796091
10341,251443010,304146,251747156,1,0,0,4096,6,6726541540
10342,251519670,10350359,261870029,1,0,1,15360,6,6119213349
10343,251558101,932373,252490474,7,0,0,14336,16,1624901368
10344,251566160,1360204,252926364,2,0,0,16384,11,9635728765
10345,251632381,1797079,253429460,7,0,0,344064,16,6653894732
10346,251701060,1829253,253530313,0,0,0,3072,6,6451558063
10347,251715650,1132450,252848100,2,0,0,180736,11,2366903062
10348,251726720,10143324,261870044,1,0,1,1536,6,10277473473
10349,251768750,1299204,253067954,0,0,0,238592,6,7044129954
10350,251891870,1431736,253323606,2,0,0,263168,11,3008203309
10351,251898641,1096578,252995219,7,0,0,95744,16,8405851548
10352,251919760,1316513,253236273,2,0,0,245248,11,9520838219
10353,251930730,9939337,261870067,1,0,1,5120,6,3781139319
10354,252007920,9862162,261870082,1,0,1,1536,6,8381372618
10355,252036370,9955399,261991769,6,0,1,167936,3,1766847774
10356,252048680,9943104,261991784,8,0,1,20480,6,10142578321
10357,252073630,1044889,253118519,1,0,0,56832,6,6289372351
10358,252074480,1162120,253236600,6,0,0,1024,3,7266550461
10359,252124400,9867399,261991799,1,0,1,2048,6,8330721933
10360,252127800,9864022,261991822,1,0,1,3584,6,8653768209
10361,252134100,1304423,253438523,2,0,0,29696,11,8343886197
10362,252143510,504035,252647545,6,0,0,2560,3,8774444289
10363,252145411,949944,253095355,7,0,0,71680,16,10701835998
10364,252187300,9804537,261991837,8,0,1,3584,6,758192532
10365,252190430,708082,252898512,2,0,0,14848,11,5265922200
10366,252223730,437550,252661280,1,0,0,16896,6,2348022025
10367,252238000,9753852,261991852,1,0,1,15360,6,1627294929
10368,252280140,9725458,262005598,8,0,1,38400,6,8886147147
10369,252281820,9724342,262006162,6,0,1,10752,3,6000930432
10370,252308200,1398521,253706721,0,0,0,198144,6,10649230496
10371,252319350,9729319,262048669,6,0,1,71168,3,7595833391
10372,252335300,738129,253073429,1,0,0,17920,6,9187927052
10373,252335350,9717185,262052535,5,0,1,6144,11,6640151019
10374,252358350,1171004,253529354,0,0,0,27136,6,3819038617
10375,252386770,1256423,253643193,2,0,0,59392,11,1724910164
10376,252387200,9671032,262058232,6,0,1,18944,3,3942820342
10377,252393160,931429,253324589,6,0,0,3072,3,5337346502
10378,252409770,1076334,253486104,1,0,0,153600,6,8793202129
10379,252486390,9572815,262059205,8,0,1,12800,6,3024250457
10380,252516940,9543238,262060178,7,0,1,12800,16,294577008
10381,252525160,9617043,262142203,6,0,1,182272,3,9482085298
10382,252544060,9620735,262164795,3,0,1,42496,0,4911356179
10383,252546560,974455,253521015,2,0,0,114176,11,2627151489
10384,252557300,9609830,262167130,1,0,1,10240,6,7971498267
10385,252596360,9572153,262168513,1,0,1,14848,6,7068067676
10386,252623890,9895769,262519659,6,0,1,256000,3,5243241165
10387,252654560,9867685,262522245,3,0,1,4096,0,1816705765
10388,252703811,457723,253161534,7,0,0,43008,16,2375480638
10389,252709020,9814531,262523551,8,0,1,2048,6,915086685
10390,252774880,9749951,262524831,1,0,1,14336,6,2412050304
10391,252776540,9750237,262526777,3,0,1,3072,0,2625272901
10392,252786220,9744423,262530643,3,0,1,6144,0,3114582627
10393,252819780,9758976,262578756,3,0,1,39936,0,4553399716
10394,252844680,9734091,262578771,8,0,1,5120,6,1276519778
10395,252853740,9725046,262578786,8,0,1,10240,6,377507386
10396,252887730,9759726,262647456,1,0,1,14336,6,7811752122
10397,252898860,9789629,262688489,6,0,1,137728,3,6303656595
10398,252900590,538604,253439194,6,0,0,2048,3,640819505
10399,252911680,9998642,262910322,6,0,1,152576,3,2553418704
10400,252925140,318229,253243369,2,0,0,22016,11,1332341072
10401,252932600,942886,253875486,0,0,0,168448,6,9534517061
10402,252954620,9959332,262913952,1,0,1,1536,6,6689003964
10403,252958650,9955763,262914413,1,0,1,10240,6,1875611110
10404,253013360,10073522,263086882,3,0,1,23040,0,6746343624
10405,253047540,10185723,263233263,7,0,1,44032,16,9022270011
10406,253049110,10184176,263233286,1,0,1,25600,6,10660985491
10407,253051200,772931,253824131,2,0,0,150528,11,6814818516
10408,253053260,571822,253625082,2,0,0,59904,11,3190066899
10409,253084000,463107,253547107,6,0,0,2048,3,2011437708
10410,253094210,10139091,263233301,7,0,1,9728,16,431553928
10411,253095160,10138156,263233316,3,0,1,8704,0,6705797046
10412,253096970,630267,253727237,6,0,0,1024,3,3365324055
10413,253105960,889709,253995669,1,0,0,194048,6,1645301654
10414,253134510,802020,253936530,1,0,0,43008,6,2506609491
10415,253167830,10124466,263292296,1,0,1,69632,6,10520008994
10416,253214560,10123036,263337596,1,0,1,17920,6,8417911452
10417,253227980,10309128,263537108,9,0,1,50176,17,4833674324
10418,253231060,10408548,263639608,8,0,1,9728,6,6789763299
10419,253233200,10414342,263647542,3,0,1,6144,0,8255388010
10420,253233920,824894,254058814,6,0,0,2048,3,7271466411
10421,253241880,10411923,263653803,8,0,1,1536,6,2937591904
10422,253267200,10415446,263682646,9,0,1,29184,17,541960670
10423,253272110,10694070,263966180,6,0,1,176640,3,7111732196
10424,253281140,10722242,264003382,7,0,1,1024,16,222423625
10425,253287030,10716367,264003397,8,0,1,1536,6,7440295701
10426,253304820,10702671,264007491,1,0,1,7168,6,9356766752
10427,253345440,10662598,264008038,9,0,1,3584,17,5930063162
10428,253360390,10647802,264008192,7,0,1,8704,16,5507777323
10429,253373860,10635638,264009498,1,0,1,2048,6,1090772666
10430,253387560,10633124,264020684,9,0,1,4608,17,5958066009
10431,253392180,10686669,264078849,3,0,1,27648,0,6318408055
10432,253419850,10664900,264084750,3,0,1,19968,0,2979513381
10433,253457730,10633519,264091249,7,0,1,7680,16,6228133180
10434,253469790,10641574,264111364,7,0,1,13312,16,9857976660
10435,253489920,396525,253886445,1,0,0,35840,6,5182475888
10436,253529960,10581419,264111379,8,0,1,10240,6,5493867376
10437,253534340,10716116,264250456,1,0,1,25088,6,4760546619
10438,253549770,11220730,264770500,6,0,1,280064,3,10064837363
10439,253563920,11250358,264814278,9,0,1,27136,17,9088682318
10440,253570910,11268436,264839346,7,0,1,2560,16,6780355479
10441,253577881,438567,254016448,7,0,0,68096,16,6119011548
10442,253578960,486889,254065849,0,0,0,23040,6,1938999173
10443,253617520,508400,254125920,6,0,0,3584,3,2019140488
10444,253679380,11159981,264839361,9,0,1,32256,17,6613742639
10445,253685160,11289865,264975025,6,0,1,154112,3,2752947117
10446,253699010,486269,254185279,0,0,0,64512,6,1349706239
10447,253764210,11210830,264975040,7,0,1,41984,16,6962282294
10448,253788400,11186655,264975055,7,0,1,18944,16,1400116979
10449,253809710,655834,254465544,2,0,0,193024,11,8931638983
10450,253867561,371865,254239426,7,0,0,177664,16,1855767453
10451,253869530,373359,254242889,2,0,0,11264,11,10686919821
10452,253905330,11074828,264980158,9,0,1,22528,17,10646160462
10453,253913870,778792,254692662,1,0,0,32768,6,4246975232
10454,253983090,10999654,264982744,8,0,1,4096,6,6835862590
10455,253985310,10999700,264985010,8,0,1,3584,6,3309174527
10456,254000830,10989774,264990604,6,0,1,18432,3,10708423399
10457,254002350,965786,254968136,1,0,0,173568,6,8013242617
10458,254047260,453259,254500519,2,0,0,114688,11,4080841811
10459,254060480,11036590,265097070,6,0,1,138752,3,7233245174
10460,254071140,433653,254504793,2,0,0,13824,11,1120929467
10461,254071391,843831,254915222,7,0,0,259072,16,6340243835
10462,254114670,606925,254721595,1,0,0,39936,6,3602081514
10463,254151880,10945213,265097093,8,0,1,3072,6,1663729220
10464,254168930,360615,254529545,2,0,0,24064,11,8697959112
10465,254181480,10915628,265097108,6,0,1,58880,3,10058905152
10466,254291530,10909903,265201433,8,0,1,12288,6,4694113969
10467,254322570,10905912,265228482,6,0,1,167936,3,3355094180
10468,254347900,816104,255164004,1,0,0,225792,6,5612514517
10469,254364410,10864418,265228828,7,0,1,512,16,1548555300
10470,254383760,10849600,265233360,9,0,1,7168,17,10375245521
10471,254389950,10844396,265234346,9,0,1,1536,17,1444759259
10472,254408490,10900133,265308623,6,0,1,113664,3,5569933830
10473,254427950,10880688,265308638,7,0,1,6656,16,3042115942
10474,254432260,650221,255082481,0,0,0,84992,6,1619607813
10475,254461840,10846813,265308653,9,0,1,6144,17,7651040866
10476,254501290,733786,255235076,1,0,0,133632,6,5827324222
10477,254514300,542262,255056562,1,0,0,151552,6,5883681834
10478,254527700,10794334,265322034,9,0,1,45568,17,2673102658
10479,254536681,631238,255167919,7,0,0,12800,16,2632775923
10480,254609260,10801438,265410698,6,0,1,118272,3,558171142
10481,254618170,10848567,265466737,6,0,1,103936,3,5051086201
10482,254620900,814427,255435327,0,0,0,135680,6,2620256626
10483,254715430,10763951,265479381,7,0,1,57344,16,6607563167
10484,254730670,10774913,265505583,9,0,1,4096,17,1120010742
10485,254734750,459571,255194321,2,0,0,9216,11,2908409886
10486,254749510,441980,255191490,2,0,0,77312,11,7221759151
10487,254754150,905403,255659553,1,0,0,220160,6,9475211545
10488,254762910,10744619,265507529,7,0,1,3072,16,6110834960
10489,254783210,10784273,265567483,8,0,1,75264,6,7378704868
10490,254888910,693961,255582871,2,0,0,285696,11,9622736505
10491,254897550,598250,255495800,2,0,0,117248,11,2285085262
10492,254909400,985798,255895198,2,0,0,181760,11,7448901023
10493,254915340,10662702,265578042,9,0,1,16384,17,10398296605
10494,254927930,1102805,256030735,2,0,0,48640,11,8349509487
10495,254937380,828867,255766247,0,0,0,142848,6,3367938259
10496,255000090,10589758,265589848,9,0,1,8192,17,5945391385
10497,255026060,696648,255722708,6,0,0,5632,3,8592924902
10498,255040920,294611,255335531,6,0,0,3584,3,7257148734
10499,255041300,1272664,256313964,1,0,0,106496,6,7697279829
10500,255094061,353154,255447215,7,0,0,7168,16,3888318039
10501,255111190,1132625,256243815,0,0,0,189952,6,3058198479
10502,255145430,10446044,265591474,7,0,1,2560,16,7478171483
10503,255147750,10448896,265596646,7,0,1,8192,16,8751591416
10504,255171260,1405188,256576448,2,0,0,480768,11,8139775434
10505,255199170,618825,255817995,6,0,0,512,3,4331488945
10506,255272370,1452498,256724868,1,0,0,139776,6,581413559
10507,255327350,1289817,256617167,0,0,0,9728,6,7989460947
10508,255361140,405769,255766909,6,0,0,2048,3,1355003391
10509,255396190,10217393,265613583,8,0,1,12800,6,4685225165
10510,255448420,10169989,265618409,8,0,1,19968,6,1421686037
10511,255460060,10175194,265635254,8,0,1,6656,6,2988330706
10512,255521340,1160902,256682242,1,0,0,213504,6,7457268461
10513,255558470,10076799,265635269,8,0,1,20480,6,1190326993
10514,255619210,994872,256614082,1,0,0,123392,6,5845558392
10515,255647400,1084698,256732098,2,0,0,9216,11,5945314760
10516,255661510,719614,256381124,6,0,0,1024,3,771201063
10517,255723560,1020581,256744141,1,0,0,39424,6,4281644388
10518,255771890,9863394,265635284,9,0,1,3072,17,2794636242
10519,255798400,9836899,265635299,8,0,1,4608,6,7396263637
10520,255925310,9726549,265651859,8,0,1,47104,6,5018331073
10521,255945820,9709391,265655211,8,0,1,20480,6,7235721548
10522,255964780,9741941,265706721,8,0,1,91648,6,9024378414
10523,255990860,900595,256891455,2,0,0,269312,11,8901276423
10524,256001590,907086,256908676,0,0,0,56320,6,974538543
10525,256091790,9616237,265708027,2,0,1,2048,11,643216191
10526,256107230,9601770,265709000,8,0,1,12800,6,57975544
10527,256146190,9563427,265709617,7,0,1,9216,16,10368174568
10528,256186590,9529464,265716054,2,0,1,7168,11,4602743503
10529,256223190,9494490,265717680,8,0,1,2560,6,1425121670
10530,256246250,9473018,265719268,2,0,1,15872,11,915331383
10531,256256950,518771,256775721,1,0,0,103424,6,2482143483
10532,256316520,412755,256729275,1,0,0,14336,6,6089971572
10533,256329750,9429892,265759642,2,0,1,11776,11,636182221
10534,256346720,9414228,265760948,2,0,1,2048,11,4579361218
10535,256392410,383665,256776075,6,0,0,512,3,2502178052
10536,256447930,590537,257038467,0,0,0,28672,6,8399810394
10537,256480550,903874,257384424,0,0,0,150016,6,1422295665
10538,256496990,721171,257218161,2,0,0,17408,11,629523863
10539,256529190,1015397,257544587,1,0,0,331264,6,6025047682
10540,256533590,9231570,265765160,8,0,1,6656,6,214203061
10541,256601001,539661,257140662,7,0,0,37376,16,827789623
10542,256613380,527609,257140989,6,0,0,1024,3,4061067967
10543,256614180,9156126,265770306,8,0,1,8192,6,3125962469
10544,256666400,9104252,265770652,8,0,1,512,6,5742197012
10545,256708871,903779,257612650,7,0,0,223232,16,7143978691
10546,256725230,9050568,265775798,2,0,1,8192,11,4329392205
10547,256746920,1020736,257767656,1,0,0,241664,6,1019787612
10548,256757830,580871,257338701,2,0,0,223232,11,4577650590
10549,256762500,637020,257399520,6,0,0,3584,3,6671127884
10550,256786320,8995072,265781392,2,0,1,26624,11,7203263143
10551,256861510,790538,257652048,1,0,0,115712,6,2610375157
10552,256862790,8929147,265791937,2,0,1,23552,11,7732712386
10553,256891190,8916121,265807311,2,0,1,14848,11,4180532674
10554,256933349,917501,257850850,4,0,0,56832,4,9347184613
10555,256971390,444527,257415917,2,0,0,11264,11,3580187488
10556,257014000,819503,257833503,2,0,0,216064,11,532474518
10557,257097590,781370,257878960,0,0,0,92160,6,4904020788
10558,257141090,869686,258010776,1,0,0,168960,6,10310806744
10559,257175500,8669320,265844820,8,0,1,41472,6,2053599005
10560,257205780,410941,257616721,0,0,0,13312,6,10555139426
10561,257298100,8568799,265866899,8,0,1,17408,6,7310029938
10562,257339290,812544,258151834,1,0,0,59392,6,1555972271
10563,257343870,872251,258216121,0,0,0,210944,6,4089838601
10564,257352900,8516905,265869805,1,0,1,4608,6,328870091
10565,257363990,986279,258350269,2,0,0,381952,11,9643181145
10566,257371011,695932,258066943,7,0,0,8192,16,376349407
10567,257382320,8491031,265873351,2,0,1,5632,11,4385295667
10568,257401480,1152325,258553805,0,0,0,70656,6,1633815800
10569,257473560,8401417,265874977,8,0,1,2560,6,6932632078
10570,257481550,745248,258226798,6,0,0,3584,3,3881795005
10571,257508471,8367492,265875963,0,0,1,1536,6,3161164885
10572,257509261,624462,258133723,7,0,0,66048,16,3373953199
10573,257532120,8364520,265896640,2,0,1,31744,11,386241386
10574,257549320,8357539,265906859,8,0,1,3584,6,5563906295
10575,257567200,784020,258351220,1,0,0,3072,6,6152560376
10576,257572280,8336064,265908344,1,0,1,15360,6,9761709319
10577,257578210,372730,257950940,6,0,0,1024,3,612916442
10578,257622930,8315304,265938234,1,0,1,26112,6,4755652186
10579,257626070,591938,258218008,1,0,0,6144,6,3355243468
10580,257627041,1195665,258822706,7,0,0,71680,16,3707500993
10581,257629180,8310040,265939220,2,0,1,1536,11,1339790149
10582,257655680,8284872,265940552,8,0,1,12288,6,9422978246
10583,257658020,8287038,265945058,8,0,1,7168,6,10610177464
10584,257685970,8327836,266013806,2,0,1,40448,11,8917416723
10585,257751600,8262221,266013821,1,0,1,26624,6,9546446187
10586,257755180,8258664,266013844,2,0,1,15872,11,2071409392
10587,257836650,8268162,266104812,6,0,1,78336,3,1517622568
10588,257842370,509185,258351555,6,0,0,1024,3,1175350451
10589,257861941,363742,258225683,7,0,0,25088,16,6554720922
10590,257886440,8230430,266116870,2,0,1,22016,11,6597184673
10591,257973790,378100,258351890,6,0,0,1024,3,1197320951
10592,257976391,963159,258939550,7,0,0,227328,16,9880534964
10593,258047150,8094426,266141576,2,0,1,10240,11,8929128014
10594,258094810,8053551,266148361,2,0,1,5632,11,7122582867
10595,258140380,8008340,266148720,8,0,1,9728,6,6857019827
10596,258145860,338981,258484841,1,0,0,5632,6,5768074497
10597,258179460,273646,258453106,2,0,0,4608,11,573532756
10598,258201710,7947983,266149693,1,0,1,12800,6,9156708019
10599,258224750,8000080,266224830,7,0,1,22016,16,310430683
10600,258245250,7987446,266232696,2,0,1,19456,11,9491141903
10601,258272840,7962596,266235436,6,0,1,12800,3,8209337291
10602,258332220,304781,258637001,2,0,0,42496,11,7223075687
10603,258347911,452940,258800851,7,0,0,176128,16,2816510684
10604,258349240,169600,258518840,6,0,0,1536,3,5430395020
10605,258357130,7885104,266242234,2,0,1,19968,11,10222222296
10606,258383200,145093,258528293,6,0,0,2048,3,2860424771
10607,258506970,7959841,266466811,6,0,1,171520,3,5055346532
10608,258520950,8008814,266529764,1,0,1,7680,6,8060628700
10609,258525021,331834,258856855,7,0,0,79872,16,7221626367
10610,258559600,7982789,266542389,2,0,1,8192,11,2685541267
10611,258590300,449626,259039926,2,0,0,133120,11,5138289413
10612,258657190,607386,259264576,2,0,0,50688,11,10479112569
10613,258694151,526184,259220335,7,0,0,157184,16,9733664775
10614,258788140,332673,259120813,6,0,0,3072,3,2957656844
10615,258789511,815409,259604920,7,0,0,135168,16,776946838
10616,258797780,578051,259375831,6,0,0,1024,3,5593820199
10617,258867030,1260524,260127554,2,0,0,230912,11,5482135455
10618,258890060,7949151,266839211,6,0,1,194048,3,4922729107
10619,258893330,7946227,266839557,1,0,1,512,6,8789379942
10620,258901180,1155979,260057159,6,0,0,601600,3,7844447989
10621,258913121,1448074,260361195,7,0,0,180224,16,7070033751
10622,258956440,1292318,260248758,6,0,0,384000,3,8246677271
10623,258957840,1348404,260306244,6,0,0,86528,3,6478061365
10624,258977890,1429129,260407019,6,0,0,65024,3,1695932425
10625,259000600,1434054,260434654,2,0,0,90624,11,6147584972
10626,259090811,1403408,260494219,7,0,0,47616,16,229640291
10627,259122990,1442539,260565529,6,0,0,48640,3,7161214794
10628,259147360,7697382,266844742,1,0,1,16384,6,10272181076
10629,259266970,529159,259796129,6,0,0,12288,3,1263215321
10630,259305200,7540003,266845203,1,0,1,10240,6,4487067415
10631,259358230,7646374,267004604,9,0,1,25088,17,9920561903
10632,259372261,991797,260364058,7,0,0,9216,16,1269885238
10633,259401380,8122147,267523527,6,0,1,222720,3,1478184569
10634,259419390,1309973,260729363,6,0,0,177152,3,107855982
10635,259424850,8335183,267760033,8,0,1,4608,6,1776863141
10636,259428840,8368257,267797097,8,0,1,53248,6,2986833341
10637,259482440,797393,260279833,2,0,0,101888,11,8545962628
10638,259489670,8307450,267797120,8,0,1,6144,6,6893384242
10639,259600450,8196685,267797135,8,0,1,5632,6,5783564772
10640,259652400,1022942,260675342,2,0,0,58880,11,9866191201
10641,259669450,8263346,267932796,6,0,1,256512,3,6193826782
10642,259706390,8346203,268052593,6,0,1,102912,3,1285858224
10643,259724910,1114543,260839453,2,0,0,274944,11,6472329602
10644,259741440,8311168,268052608,6,0,1,1536,3,7928115827
10645,259741470,8311153,268052623,6,0,1,4096,3,4592511177
10646,259747450,8305188,268052638,3,0,1,3584,0,2114968745
10647,259754020,8324420,268078440,1,0,1,50176,6,6527311848
10648,259763820,8320419,268084239,8,0,1,19456,6,5042663537
10649,259784510,602682,260387192,6,0,0,28160,3,423139085
10650,259790590,8294635,268085225,6,0,1,1536,3,3838598358
10651,259889720,558373,260448093,6,0,0,44032,3,1812160153
10652,259914600,8170779,268085379,6,0,1,8704,3,8309030913
10653,260029120,8093232,268122352,8,0,1,12800,6,7494224706
10654,260085610,8088377,268173987,8,0,1,33280,6,6501505331
10655,260132170,8095402,268227572,6,0,1,11776,3,296677059
10656,260153620,8116408,268270028,8,0,1,12288,6,10263741117
10657,260157591,414052,260571643,7,0,0,19968,16,1899226681
10658,260179791,350496,260530287,7,0,0,7168,16,5848728533
10659,260182400,460152,260642552,0,0,0,45568,6,4775593216
10660,260215970,441417,260657387,6,0,0,48640,3,5255598503
10661,260256000,8014043,268270043,6,0,1,4608,3,9264818481
10662,260287890,7982168,268270058,6,0,1,9216,3,6882366057
10663,260307761,423602,260731363,7,0,0,6144,16,4183136990
10664,260312160,567772,260879932,6,0,0,132608,3,3012575098
10665,260327211,8032458,268359669,0,0,1,43520,6,3291926433
10666,260329090,8068538,268397628,8,0,1,22528,6,3266607379
10667,260393850,8006684,268400534,6,0,1,4608,3,3897652893
10668,260446730,8016178,268462908,7,0,1,48128,16,4130358542
10669,260473900,412845,260886745,6,0,0,22016,3,308889185
10670,260541530,457772,260999302,6,0,0,102400,3,696219270
10671,260713521,285997,260999518,7,0,0,512,16,5663095990
10672,260749880,7718590,268468470,8,0,1,2048,6,1231647054
10673,261214900,7259062,268473962,8,0,1,17920,6,7551536489
10674,261237370,258684,261496054,6,0,0,14848,3,7246061937
10675,261254300,380168,261634468,6,0,0,241152,3,9326538117
10676,261258720,7313624,268572344,3,0,1,5120,0,2170634262
10677,261277240,7295119,268572359,3,0,1,512,0,8893464296
10678,261371100,7201282,268572382,8,0,1,36864,6,9413378292
10679,261377220,7195185,268572405,3,0,1,3072,0,430232576
10680,261428890,441124,261870014,6,0,0,182272,3,6087949985
10681,261535810,455944,261991754,6,0,0,129536,3,8690389729
10682,261599591,6973624,268573215,0,0,1,26112,6,2332505681
10683,261600180,480753,262080933,6,0,0,14848,3,572884651
10684,261600541,6985199,268585740,0,0,1,22016,6,1777279347
10685,261696290,7014490,268710780,3,0,1,47616,0,5844577674
10686,261739910,6970885,268710795,8,0,1,1536,6,10014667590
10687,261742870,6967940,268710810,8,0,1,15360,6,9505820894
10688,261785661,279776,262065437,7,0,0,512,16,3478412749
10689,261824580,573522,262398102,6,0,0,129024,3,7015836025
10690,261868930,6841895,268710825,5,0,1,5632,11,8182220449
10691,261969401,6741439,268710840,0,0,1,512,6,1188994391
10692,262009040,638401,262647441,6,0,0,225280,3,4710459355
10693,262016330,489439,262505769,6,0,0,78848,3,4554746455
10694,262137971,294436,262432407,7,0,0,512,16,814212605
10695,262163150,415583,262578733,6,0,0,146432,3,1247845171
10696,262164001,6546854,268710855,0,0,1,3584,6,3510040636
10697,262175990,6534880,268710870,5,0,1,6144,11,3791883396
10698,262199620,6511265,268710885,8,0,1,1536,6,4567172829
10699,262298280,551179,262849459,6,0,0,231936,3,4147916774
10700,262318330,6392570,268710900,5,0,1,8192,11,4171454562
10701,262378710,6332532,268711242,5,0,1,32768,11,7886892214
10702,262412709,725055,263137764,4,0,0,51200,4,6809180870
10703,262422949,663894,263086843,4,0,0,126464,4,2039538729
10704,262434660,6276597,268711257,5,0,1,15872,11,6156651534
10705,262462550,770698,263233248,6,0,0,203264,3,6635618221
10706,262485760,6225512,268711272,5,0,1,13312,11,7234449912
10707,262533831,6177456,268711287,0,0,1,2048,6,1115956686
10708,262537390,1102171,263639561,6,0,0,291328,3,2306648515
10709,262657580,677802,263335382,6,0,0,138752,3,4454437771
10710,262688570,6037603,268726173,8,0,1,24064,6,5231029750
10711,262698170,747687,263445857,6,0,0,74752,3,1157397350
10712,262717080,6009964,268727044,4,0,1,12288,4,5821507253
10713,262741880,795205,263537085,6,0,0,242176,3,5208607542
10714,262769650,1147184,263916834,6,0,0,122368,3,1842922735
10715,262784561,865173,263649734,7,0,0,4608,16,9889715153
10716,262803780,5926490,268730270,4,0,1,5120,4,7483270972
10717,262826830,5911007,268737837,5,0,1,1024,11,2836793555
10718,262826989,1737039,264564028,4,0,0,416768,4,2749029265
10719,262838090,5902642,268740732,5,0,1,14848,11,9142524710
10720,262901620,5841378,268742998,8,0,1,3584,6,5765022451
10721,262921030,5830686,268751716,4,0,1,31232,4,1019530221
10722,262983410,5771532,268754942,8,0,1,5120,6,4638470872
10723,262989809,548874,263538683,4,0,0,5120,4,4712443314
10724,263005050,5758904,268763954,5,0,1,14336,11,143471088
10725,263009040,5758140,268767180,4,0,1,5120,4,9830605790
10726,263020221,5750505,268770726,0,0,1,5632,6,2913252677
10727,263040161,315486,263355647,7,0,0,6656,16,9078465233
10728,263057619,949849,264007468,4,0,0,13312,4,2752987683
10729,263058270,1192171,264250441,6,0,0,370688,3,10657256733
10730,263060351,277230,263337581,7,0,0,7168,16,2152994982
10731,263079001,5789031,268868032,0,0,1,33280,6,6634132738
10732,263118320,1176353,264294673,6,0,0,14336,3,5350260436
10733,263157989,845362,264003351,4,0,0,82944,4,8089814873
10734,263206030,5662025,268868055,5,0,1,4096,11,6525837805
10735,263333191,318866,263652057,7,0,0,512,16,7223966014
10736,263357399,932540,264289939,4,0,0,129536,4,1071974036
10737,263370500,502615,263873115,6,0,0,1536,3,10406843183
10738,263448979,1313323,264762302,4,0,0,235008,4,186547893
10739,263462561,5405509,268868070,0,0,1,512,6,9908607716
10740,263473240,5394845,268868085,4,0,1,3072,4,7921296349
10741,263497141,5370959,268868100,0,0,1,4096,6,7143129151
10742,263564029,573445,264137474,4,0,0,41472,4,7999468934
10743,263581181,5326673,268907854,0,0,1,56320,6,7480774011
10744,263582831,5326329,268909160,0,0,1,2048,6,885767148
10745,263611530,5299256,268910786,1,0,1,2560,6,9711940786
10746,263644220,5270518,268914738,8,0,1,20992,6,7034411175
10747,263700339,411010,264111349,4,0,0,62464,4,10733118508
10748,263702020,349569,264051589,6,0,0,27648,3,6526807343
10749,263717471,5279895,268997366,0,0,1,8192,6,9163386608
10750,263750411,539855,264290266,7,0,0,1024,16,10635138186
10751,263777600,5220752,268998352,4,0,1,1536,4,5300020370
10752,263832721,5169177,269001898,0,0,1,5632,6,6709739698
10753,263932791,5072973,269005764,0,0,1,6144,6,9442183381
10754,263971111,5035831,269006942,0,0,1,13824,6,3678176339
10755,263987550,5053071,269040621,4,0,1,16384,4,1929506135
10756,263991870,847461,264839331,6,0,0,78336,3,8999478399
10757,264017239,673436,264690675,4,0,0,196096,4,5355966744
10758,264019020,945944,264964964,6,0,0,412160,3,8105321593
10759,264110690,4948994,269059684,8,0,1,6144,6,1559240724
10760,264125139,1076279,265201418,4,0,0,303616,4,9282274810
10761,264160751,4899292,269060043,0,0,1,9728,6,8521691367
10762,264179211,4904684,269083895,0,0,1,19456,6,5762095170
10763,264194730,902317,265097047,6,0,0,240640,3,10570105400
10764,264377481,399419,264776900,7,0,0,7168,16,871329916
10765,264380570,4710102,269090672,4,0,1,2048,4,3924104647
10766,264386640,4704903,269091543,8,0,1,12288,6,4589840150
10767,264483790,4613130,269096920,8,0,1,19456,6,8940960580
10768,264485291,4611783,269097074,0,0,1,8704,6,3648342328
10769,264541450,433552,264975002,6,0,0,30208,3,779009889
10770,264565080,4538549,269103629,8,0,1,4608,6,10614575746
10771,264573911,188578,264762489,7,0,0,512,16,1292452447
10772,264574711,224830,264799541,7,0,0,6656,16,9218820274
10773,264585011,380756,264965767,7,0,0,2560,16,2045326018
10774,264664661,4443154,269107815,0,0,1,6656,6,5511840992
10775,264740669,547928,265288597,4,0,0,120320,4,7935444392
10776,264742090,4374097,269116187,4,0,1,13312,4,8854222928
10777,264747530,4424820,269172350,8,0,1,33280,6,5973665795
10778,264776991,4410217,269187208,0,0,1,17408,6,10422682484
10779,264836721,4404813,269241534,0,0,1,51712,6,5111270225
10780,264874951,4372811,269247762,0,0,1,36352,6,4094544314
10781,264885410,423190,265308600,6,0,0,47104,3,6605843183
10782,264916340,4335288,269251628,4,0,1,6144,4,5093599152
10783,265027371,345561,265372932,7,0,0,1024,16,4273931318
10784,265070650,429201,265499851,6,0,0,24064,3,1949632097
10785,265128601,4124103,269252704,0,0,1,13312,6,1099896388
10786,265198181,4090399,269288580,0,0,1,30208,6,8521470470
10787,265248499,443350,265691849,4,0,0,117248,4,6466224842
10788,265257710,4038001,269295711,8,0,1,19456,6,6524518743
10789,265282320,352919,265635239,6,0,0,51712,3,8811914890
10790,265294260,598037,265892297,6,0,0,24576,3,578694400
10791,265330030,3971734,269301764,2,0,1,16384,11,6866530575
10792,265348390,3956600,269304990,8,0,1,5120,6,856588474
10793,265361450,3944846,269306296,5,0,1,2048,11,7171141835
10794,265379390,3928532,269307922,7,0,1,2560,16,727421845
10795,265484579,529212,266013791,4,0,0,180224,4,8713101389
10796,265556911,3756157,269313068,0,0,1,8192,6,5554576621
10797,265616720,239308,265856028,3,0,0,8704,0,10440585303
10798,265675120,454585,266129705,6,0,0,30208,3,9245523201
10799,265724761,152153,265876914,7,0,0,512,16,9811205988
10800,265788871,271798,266060669,7,0,0,2560,16,6967186643
10801,265790660,432252,266222912,3,0,0,173568,0,1046835496
10802,265814400,410407,266224807,6,0,0,6144,3,9429224143
10803,265832780,3555409,269388189,8,0,1,58880,6,3922370705
10804,265853539,613257,266466796,4,0,0,246272,4,6473881004
10805,265900790,459400,266360190,6,0,0,91648,3,8866868712
10806,266009609,520140,266529749,4,0,0,14336,4,5323902396
10807,266032250,765842,266798092,6,0,0,161792,3,696995354
10808,266078120,3310084,269388204,5,0,1,7680,11,5742303438
10809,266088580,493722,266582302,3,0,0,74752,0,1071507187
10810,266095200,3293027,269388227,1,0,1,11776,6,1567528153
10811,266104120,431547,266535667,6,0,0,4096,3,4245255531
10812,266148419,470589,266619008,4,0,0,90112,4,9879053532
10813,266150361,3246925,269397286,0,0,1,23552,6,3212685886
10814,266151791,378456,266530247,7,0,0,1536,16,2792342674
10815,266195071,3290839,269485910,0,0,1,23552,6,10529730471
10816,266217580,785550,267003130,3,0,0,445440,0,3810890313
10817,266268040,801984,267070024,6,0,0,4608,3,7749113487
10818,266288711,351377,266640088,7,0,0,3584,16,3506930960
10819,266311941,3179652,269491593,0,0,1,14848,6,5636690677
10820,266511281,2985630,269496911,0,0,1,8192,6,3855287408
10821,266537721,466836,267004557,7,0,0,4608,16,2974285129
10822,266567491,2939072,269506563,0,0,1,26624,6,5585687061
10823,266588550,837281,267425831,3,0,0,459264,0,7837143869
10824,266597090,2945970,269543060,7,0,1,20480,16,9713588027
10825,266660031,2884335,269544366,0,0,1,2048,6,2736877731
10826,266730081,350839,267080920,7,0,0,1536,16,7343884535
10827,266789501,2756812,269546313,0,0,1,25600,6,7361942824
10828,266819620,672058,267491678,6,0,0,216064,3,10375712194
10829,266820569,1232009,268052578,4,0,0,208384,4,6106785500
10830,266820880,939138,267760018,3,0,0,501760,0,5472569137
10831,266830511,2735532,269566043,0,0,1,38912,6,2820377552
10832,266870570,925530,267796100,6,0,0,118272,3,1554466163
10833,266898930,2669059,269567989,5,0,1,3072,11,5228487781
10834,266900721,895870,267796591,7,0,0,1536,16,5516781233
10835,266906830,2752547,269659377,5,0,1,10752,11,4960633134
10836,266923260,2788501,269711761,5,0,1,8704,11,1890286109
10837,266964690,3560233,270524923,8,0,1,8704,6,4404130819
10838,266995231,3826398,270821629,0,0,1,5120,6,7549317390
10839,267018090,834649,267852739,6,0,0,103936,3,2936131846
10840,267039530,821828,267861358,6,0,0,28160,3,1794552170
10841,267047480,3955929,271003409,5,0,1,14336,11,5383780370
10842,267126700,862371,267989071,6,0,0,184320,3,6621163141
10843,267161671,636735,267798406,7,0,0,4096,16,8640167261
10844,267179651,722487,267902138,7,0,0,5120,16,10308453793
10845,267212720,608336,267821056,3,0,0,73216,0,8333848482
10846,267258771,3771882,271030653,0,0,1,4096,6,1929633219
10847,267380441,416633,267797074,7,0,0,1536,16,34427605
10848,267526201,272532,267798733,7,0,0,1024,16,1997020943
10849,267543990,3490849,271034839,2,0,1,6656,11,3223626489
10850,267581499,646058,268227557,4,0,0,117248,4,858233082
10851,267616150,681223,268297373,3,0,0,89600,0,8399276284
10852,267618040,3520974,271139014,2,0,1,5632,11,804406229
10853,267626370,643643,268270013,6,0,0,114176,3,2272135019
10854,267657179,915150,268572329,4,0,0,310784,4,7169242913
10855,267669191,3605273,271274464,0,0,1,31744,6,7220778335
10856,267688301,3661283,271349584,0,0,1,23040,6,2686846624
10857,267736160,891754,268627914,3,0,0,88064,0,8422398281
10858,267755130,3594469,271349599,2,0,1,4608,11,9959664158
10859,267847040,567807,268414847,3,0,0,38912,0,3645914043
10860,267860449,850316,268710765,4,0,0,271872,4,4671911618
10861,267923981,808609,268732590,7,0,0,3584,16,7665838132
10862,267998630,3357007,271355637,2,0,1,46592,11,5027943354
10863,268078429,507296,268585725,4,0,0,37888,4,10623372699
10864,268126051,447149,268573200,7,0,0,2560,16,5483936413
10865,268233931,340235,268574166,7,0,0,3072,16,2363328152
10866,268272850,3136681,271409531,2,0,1,1024,11,1181282371
10867,268273370,3180805,271454175,2,0,1,25088,11,6914817745
10868,268293680,574337,268868017,3,0,0,82432,0,8657620159
10869,268344729,256314,268601043,4,0,0,50176,4,1279716175
10870,268359611,351616,268711227,7,0,0,1024,16,1075003543
10871,268385230,3068960,271454190,2,0,1,9728,11,8653733576
10872,268433670,3024457,271458127,2,0,1,25600,11,5189170070
10873,268443150,3126148,271569298,5,0,1,60416,11,5296690167
10874,268485909,411225,268897134,4,0,0,91136,4,5097088035
10875,268516340,3054264,271570604,5,0,1,2048,11,1162458735
10876,268561890,679621,269241511,3,0,0,178176,0,10542255964
10877,268588000,584335,269172335,3,0,0,157696,0,84215266
10878,268705539,481654,269187193,4,0,0,48640,4,3957887568
10879,268723410,2854961,271578371,1,0,1,16896,6,7718806951
10880,268857550,621608,269479158,3,0,0,133120,0,1092903210
10881,268867481,520693,269388174,7,0,0,4608,16,8299432785
10882,268902690,2719248,271621938,2,0,1,27648,11,6805477444
10883,268912910,473837,269386747,3,0,0,38912,0,4831455750
10884,268923750,2822098,271745848,2,0,1,10240,11,2510903499
10885,268947260,427616,269374876,6,0,0,108032,3,5923401137
10886,268975580,2773582,271749162,5,0,1,31744,11,4941745166
10887,269116540,2678378,271794918,5,0,1,49152,11,9990827771
10888,269135711,259098,269394809,7,0,0,2560,16,6540556607
10889,269165670,2703071,271868741,2,0,1,37376,11,1672698245
10890,269205511,274286,269479797,7,0,0,2048,16,3772571158
10891,269222351,63114,269285465,7,0,0,512,16,941411208
10892,269252711,161193,269413904,7,0,0,1024,16,8675587563
10893,269254359,266493,269520852,4,0,0,41984,4,5960746163
10894,269267600,2601156,271868756,5,0,1,3072,11,4122318290
10895,269314100,2554671,271868771,5,0,1,3584,11,9015903959
10896,269355910,994693,270350603,6,0,0,265728,3,10494937211
10897,269373380,826917,270200297,3,0,0,538112,0,6615762826
10898,269379890,997131,270377021,6,0,0,31232,3,4716827280
10899,269395811,804689,270200500,7,0,0,512,16,335307921
10900,269484659,1267152,270751811,4,0,0,469504,4,2264844933
10901,269563960,2304826,271868786,5,0,1,24576,11,1360755742
10902,269601590,1270457,270872047,3,0,0,157184,0,5843484148
10903,269623060,646556,270269616,3,0,0,70144,0,153294666
10904,269633269,1188313,270821582,4,0,0,228864,4,4074069721
10905,269635081,2233720,271868801,0,0,1,5120,6,8832062620
10906,269641571,2231058,271872629,0,0,1,18944,6,8151779036
10907,269672160,1331234,271003394,3,0,0,261632,0,8230488126
10908,269682409,1456255,271138664,4,0,0,275968,4,6215924462
10909,269698751,2174954,271873705,0,0,1,13312,6,7812824593
10910,269716790,1755006,271471796,6,0,0,17920,3,29788350
10911,269719790,1590881,271310671,3,0,0,118784,0,6935313953
10912,269745191,2137491,271882682,0,0,1,16896,6,9913642041
10913,269748740,1497378,271246118,6,0,0,320000,3,4610054161
10914,269823479,596493,270419972,4,0,0,19456,4,10108818387
10915,269857050,1888775,271745825,3,0,0,364544,0,144635491
10916,269896530,1993070,271889600,5,0,1,2048,11,377203602
10917,269916310,1973751,271890061,5,0,1,10240,11,2167852992
10918,269922170,1996171,271918341,5,0,1,31232,11,8931705459
10919,269928880,1087492,271016372,3,0,0,42496,0,6508933269
10920,269938199,1930511,271868710,4,0,0,230400,4,6705358543
10921,269960060,2073961,272034021,5,0,1,14848,11,2199204117
10922,270050671,1983365,272034036,0,0,1,2048,6,6497772646
10923,270066540,1970802,272037342,5,0,1,13824,11,2998265071
10924,270099969,1466767,271566736,4,0,0,49664,4,3650689397
10925,270112121,712019,270824140,7,0,0,8192,16,295343679
10926,270212011,1825346,272037357,0,0,1,10240,6,5540896133
10927,270245349,1788657,272034006,4,0,0,335872,4,6345919418
10928,270248581,1809866,272058447,0,0,1,16896,6,8729824693
10929,270351209,1443694,271794903,4,0,0,32256,4,5211020825
10930,270379770,1074390,271454160,6,0,0,145920,3,4842324162
10931,270399150,950419,271349569,3,0,0,124928,0,4453294927
10932,270447490,1700126,272147616,5,0,1,96256,11,561476779
10933,270484391,532776,271017167,7,0,0,2560,16,4239092900
10934,270539071,772411,271311482,7,0,0,2560,16,8573836765
10935,270552901,1596164,272149065,0,0,1,21504,6,939017129
10936,270636520,637881,271274401,6,0,0,92672,3,8038169163
10937,270638890,1548121,272187011,3,0,1,46080,0,6745093948
10938,270639400,1547723,272187123,5,0,1,11776,11,4219856729
10939,270682079,1465498,272147577,4,0,0,131584,4,1845315751
10940,270736589,1370857,272107446,4,0,0,160768,4,1878562784
10941,270804600,1383509,272188109,3,0,1,1536,0,9951392676
10942,270819859,668656,271488515,4,0,0,54272,4,6787876497
10943,270839601,299398,271138999,7,0,0,1024,16,6833122993
10944,270848360,1420864,272269224,6,0,0,79872,3,2876268942
10945,270866290,1323765,272190055,4,0,1,3072,4,3349920928
10946,270905740,1286261,272192001,3,0,1,3072,0,3005383390
10947,270943460,1267587,272211047,1,0,1,18944,6,7537523226
10948,270950630,1262690,272213320,5,0,1,14848,11,126233415
10949,270960010,1311259,272271269,8,0,1,23552,6,4619004472
10950,271008641,1140409,272149050,7,0,0,4096,16,3639626160
10951,271008730,1264165,272272895,5,0,1,2560,11,1431810722
10952,271067361,291963,271359324,7,0,0,1024,16,7768610879
10953,271158921,354836,271513757,7,0,0,512,16,2233129847
10954,271162200,1361077,272523277,3,0,0,236544,0,4671039934
10955,271192811,1088753,272281564,0,0,1,13824,6,3081907034
10956,271222201,1088897,272311098,0,0,1,55296,6,2837608920
10957,271232230,258642,271490872,6,0,0,5632,3,114214563
10958,271239270,1080861,272320131,5,0,1,9728,11,7807958513
10959,271239560,1085717,272325277,3,0,1,8192,0,6422383202
10960,271247410,501729,271749139,6,0,0,10752,3,4261843899
10961,271280090,1372858,272652948,3,0,0,37888,0,4801293005
10962,271332830,1024695,272357525,3,0,1,27648,0,2981355353
10963,271347830,710602,272058432,3,0,0,69120,0,1800909436
10964,271434370,940455,272374825,3,0,1,38400,0,6811885085
10965,271476740,921177,272397917,4,0,1,38912,4,9191326650
10966,271486270,915513,272401783,3,0,1,6144,0,5618316754
10967,271492360,694628,272186988,3,0,0,124416,0,239158163
10968,271493120,734889,272228009,6,0,0,512,3,9196653579
10969,271495871,907756,272403627,0,0,1,25088,6,887343500
10970,271539250,498077,272037327,6,0,0,10752,3,3183598266
10971,271561879,649153,272211032,4,0,0,21504,4,2651564002
10972,271585481,562306,272147787,7,0,0,512,16,1687666174
10973,271653550,796503,272450053,3,0,1,19968,0,2862411606
10974,271669450,781725,272451175,1,0,1,19456,6,6716373179
10975,271746070,705120,272451190,3,0,1,16384,0,6527452479
10976,271789741,733551,272523292,0,0,1,12288,6,4859464705
10977,271807191,716116,272523307,0,0,1,17920,6,4584761875
10978,271815321,708001,272523322,0,0,1,7168,6,5448049211
10979,271867730,582308,272450038,3,0,0,138240,0,5016661137
10980,272070400,452937,272523337,5,0,1,7168,11,2901424953
10981,272071240,452120,272523360,6,0,1,30208,3,9197046472
10982,272076880,374280,272451160,6,0,0,3584,3,7004899668
10983,272112790,410585,272523375,4,0,1,14336,4,7227768128
10984,272194640,328750,272523390,5,0,1,24576,11,7727986116
10985,272395020,128385,272523405,5,0,1,4608,11,6766306208
10986,272452830,468515,272921345,6,0,0,512,3,4336066563
10987,272530140,242197,272772337,3,0,0,53248,0,3823938243
10988,272568401,84874,272653275,7,0,0,1024,16,10613917830
10989,272711380,3387,272714767,1,0,1,9728,6,7280462545
10990,272724690,203402,272928092,6,0,0,2560,3,7231990559
10991,272748370,149572,272897942,6,0,0,512,3,4205084981
10992,272823080,201487,273024567,6,0,0,2560,3,4879806423
10993,272836071,80906,272916977,7,0,0,1536,16,6221594362
10994,272934450,13512,272947962,9,0,1,26112,17,4875326455
10995,273062180,23466,273085646,9,0,1,38912,17,5053619250
10996,273137851,253111,273390962,7,0,0,1024,16,2656107656
10997,273183300,4420,273187720,9,0,1,11776,17,1116309483
10998,273195790,4850,273200640,9,0,1,5120,17,332850398
10999,273207669,353120,273560789,4,0,0,253440,4,4860410707
11000,273221180,13512,273234692,9,0,1,26112,17,8669857364
11001,273242660,5712,273248372,9,0,1,14336,17,2054050714
11002,273256039,402289,273658328,4,0,0,34816,4,4815092901
11003,273283020,131006,273414026,6,0,0,6144,3,411516294
11004,273305359,280267,273585626,4,0,0,54784,4,3886291222
11005,273321720,452870,273774590,3,0,0,188416,0,5801880479
11006,273327471,233645,273561116,7,0,0,1024,16,1602088596
11007,273414280,201440,273615720,6,0,0,1024,3,7597443003
11008,273440400,4937,273445337,9,0,1,12800,17,849799674
11009,273466060,3904,273469964,2,0,1,10752,11,4771128251
11010,273466131,127827,273593958,7,0,0,4096,16,9315536528
11011,273575670,45536,273621206,2,0,1,62464,11,2637999249
11012,273579150,248527,273827677,6,0,0,2048,3,8237709928
11013,273601750,20442,273622192,2,0,1,1536,11,10401620105
11014,273629230,3904,273633134,9,0,1,10752,17,8446159564
11015,273646551,67481,273714032,7,0,0,4608,16,5940321281
11016,273653040,10992,273664032,1,0,1,14336,6,8064695970
11017,273747481,453186,274200667,7,0,0,2560,16,9868446370
11018,273786530,413342,274199872,3,0,0,219136,0,3522159679
11019,273798191,316862,274115053,7,0,0,7168,16,5474943056
11020,273802949,489225,274292174,4,0,0,241152,4,2631540990
11021,273863130,4374,273867504,3,0,1,4608,0,6430349162
11022,273888120,330563,274218683,3,0,0,29184,0,2062037839
11023,273918840,289798,274208638,3,0,0,26112,0,5655417500
11024,273960341,248624,274208965,7,0,0,1024,16,5331398610
11025,274016221,106785,274123006,7,0,0,1024,16,8567028118
11026,274032770,5712,274038482,9,0,1,14336,17,3042068089
11027,274083590,13858,274097448,9,0,1,23552,17,3213600476
11028,274112639,370224,274482863,4,0,0,173568,4,4354681321
11029,274124571,85189,274209760,7,0,0,2560,16,4047022982
11030,274198740,128447,274327187,9,0,1,61440,17,8535282325
11031,274200460,332586,274533046,6,0,0,5120,3,2849502461
11032,274212109,578006,274790115,4,0,0,242176,4,5238637938
11033,274286799,380502,274667301,4,0,0,67072,4,64956315
11034,274302790,30708,274333498,9,0,1,30208,17,5787644195
11035,274312700,21669,274334369,1,0,1,12288,6,9656766807
11036,274319430,15925,274335355,4,0,1,1536,4,9177705150
11037,274495840,12995,274508835,2,0,1,25088,11,5283787354
11038,274514830,10241,274525071,4,0,1,16384,4,5067066891
11039,274521870,372171,274894041,3,0,0,188928,0,10647862518
11040,274534140,11274,274545414,9,0,1,18432,17,10317624415
11041,274610899,451234,275062133,4,0,0,25088,4,10390077051
11042,274632520,34796,274667316,9,0,1,29184,17,701212052
11043,274659760,19873,274679633,4,0,1,20480,4,3948362742
11044,274665700,15111,274680811,2,0,1,13824,11,1711438671
11045,274690300,2946,274693246,4,0,1,3072,4,6965500881
11046,274702180,87950,274790130,4,0,1,33280,4,9985300923
11047,274785449,269025,275054474,4,0,0,105984,4,7139431239
11048,274795730,3128,274798858,2,0,1,9216,11,8081845641
11049,274924410,147463,275071873,6,0,0,1024,3,1150624639
11050,274949280,3645,274952925,8,0,1,10240,6,9404429938
11051,274951259,433507,275384766,4,0,0,377856,4,4390558699
11052,275021720,40436,275062156,4,0,1,17408,4,555152700
11053,275031080,36499,275067579,4,0,1,13824,4,6122373375
11054,275073700,312657,275386357,6,0,0,5120,3,2843723956
11055,275215720,6229,275221949,4,0,1,15360,4,4856048019
11056,275248020,453651,275701671,3,0,0,419328,0,1017120286
11057,275274130,441479,275715609,6,0,0,1536,3,3039987995
11058,275287749,529534,275817283,4,0,0,235520,4,10039457073
11059,275333600,56213,275389813,4,0,1,3584,4,1485595014
11060,275365510,27685,275393195,4,0,1,14336,4,5386935097
11061,275374040,30548,275404588,9,0,1,24576,17,4896911592
11062,275391340,13709,275405049,9,0,1,10240,17,7078414973
11063,275397070,27645,275424715,9,0,1,36352,17,176285739
11064,275433080,282046,275715126,3,0,0,44032,0,4681027791
11065,275440360,112355,275552715,6,0,0,1024,3,226242646
11066,275486290,341319,275827609,3,0,0,33792,0,9709316508
11067,275488869,233003,275721872,4,0,0,20480,4,10244572010
11068,275542860,6754,275549614,9,0,1,7168,17,8420237487
11069,275571740,1042,275572782,7,0,1,1024,16,157872172
11070,275603610,293716,275897326,6,0,0,1536,3,5059208017
11071,275606260,222004,275828264,6,0,0,2048,3,7037947798
11072,275666930,54957,275721887,7,0,1,512,16,1163851918
11073,275718570,98728,275817298,7,0,1,69120,16,9191591558
11074,275722010,156109,275878119,6,0,0,4096,3,8929257874
11075,275781879,338099,276119978,4,0,0,118272,4,9009828009
11076,275815730,405235,276220965,3,0,0,180224,0,5657268953
11077,275907370,213583,276120953,6,0,0,3072,3,9431909397
11078,275961870,4374,275966244,7,0,1,4608,16,427524440
11079,276003120,240855,276243975,6,0,0,2560,3,6976867303
11080,276092129,188131,276280260,4,0,0,100352,4,8346393549
11081,276094440,293601,276388041,3,0,0,82944,0,6723538568
11082,276096609,130619,276227228,4,0,0,20480,4,9159830056
11083,276199040,32309,276231349,7,0,1,11264,16,9107440341
11084,276240340,54884,276295224,6,0,0,1024,3,10022069201
11085,276247340,32935,276280275,7,0,1,2560,16,3359606806
11086,276309110,48980,276358090,6,0,0,2048,3,5694895570
11087,276323680,305846,276629526,3,0,0,302592,0,5173079203
11088,276495880,25962,276521842,7,0,1,47104,16,6410716769
11089,276505810,19578,276525388,7,0,1,5632,16,8971915855
11090,276518660,231575,276750235,3,0,0,96256,0,1554066858
11091,276551660,130378,276682038,6,0,0,3584,3,5595701437
11092,276567800,614688,277182488,3,0,0,474112,0,256511761
11093,276603650,697074,277300724,3,0,0,58368,0,3992918111
11094,276631989,1058325,277690314,4,0,0,410624,4,9550898569
11095,276681230,719134,277400364,3,0,0,295936,0,8124914851
11096,276704530,247904,276952434,6,0,0,1536,3,3999976143
11097,276733099,453476,277186575,4,0,0,13312,4,3232132638
11098,276765010,794702,277559712,3,0,0,196608,0,1585634652
11099,276829900,435369,277265269,3,0,0,109568,0,687450524
11100,276836150,3422,276839572,4,0,1,3584,4,7997029023
11101,276934930,4162,276939092,7,0,1,11264,16,3484140835
11102,276982050,566,276982616,1,0,1,512,6,7283103088
11103,277032410,154180,277186590,7,0,1,52736,16,3045463748
11104,277052860,137618,277190478,7,0,1,10752,16,6400514164
11105,277057640,673904,277731544,3,0,0,129536,0,10719703695
11106,277142480,48344,277190824,7,0,1,512,16,910185839
11107,277204060,487993,277692053,6,0,0,5632,3,3189223932
11108,277221370,546397,277767767,3,0,0,118784,0,2717743950
11109,277238521,30402,277268923,0,0,1,10240,6,7731892672
11110,277247190,28438,277275628,1,0,1,7680,6,4705971780
11111,277275169,290018,277565187,4,0,0,17920,4,2747465951
11112,277275691,3645,277279336,0,0,1,10240,6,10390749634
11113,277292121,13532,277305653,0,0,1,12800,6,710495083
11114,277347260,421302,277768562,6,0,0,2560,3,10527267613
11115,277348980,65276,277414256,2,0,1,23552,11,5748989537
11116,277353460,77064,277430524,2,0,1,37888,11,9932441743
11117,277416871,19964,277436835,0,0,1,22016,6,3252877961
11118,277496320,3128,277499448,1,0,1,9216,6,9078385378
11119,277519040,252401,277771441,1,0,1,8704,6,4817580641
11120,277533410,235519,277768929,6,0,0,1024,3,6396464337
11121,277604670,170000,277774670,7,0,1,3584,16,9768347503
11122,277612509,364432,277976941,4,0,0,159232,4,1777889729
11123,277668621,116035,277784656,0,0,1,20480,6,8307311646
11124,277669251,115661,277784912,0,0,1,9216,6,4846669298
11125,277716110,101890,277818000,2,0,1,64512,11,4346353662
11126,277780960,43351,277824311,7,0,1,22016,16,8684781329
11127,277830900,10757,277841657,1,0,1,17408,6,9195450112
11128,277871910,13512,277885422,2,0,1,26112,11,3145953876
11129,277874190,11578,277885768,6,0,1,512,3,8544439972
11130,277932839,396906,278329745,4,0,0,97792,4,6611150897
11131,278001440,10499,278011939,2,0,1,16896,11,9792967886
11132,278021310,43904,278065214,6,0,0,512,3,7664675210
11133,278057119,150932,278208051,4,0,0,29696,4,39153475
11134,278090830,13341,278104171,1,0,1,22528,6,2079925073
11135,278132489,269093,278401582,4,0,0,34304,4,10336806850
11136,278309020,36830,278345850,6,0,1,31232,3,6557603820
11137,278327780,22256,278350036,6,0,1,6656,3,7872056441
11138,278334190,154077,278488267,3,0,0,26624,0,9692818425
11139,278356590,32816,278389406,6,0,1,53760,3,2664403754
11140,278401460,26076,278427536,2,0,1,47104,11,5311674981
11141,278487321,1504,278488825,0,0,1,512,6,4612570766
11142,278490520,80951,278571471,6,0,0,2048,3,7384520038
11143,278675470,14804,278690274,2,0,1,28672,11,7812648612
11144,278694889,145514,278840403,4,0,0,55296,4,2320475520
11145,278719801,5326,278725127,0,0,1,5632,6,63433062
11146,278797739,214524,279012263,4,0,0,158720,4,10239337931
11147,278801620,49448,278851068,6,0,0,3584,3,1527274813
11148,278825751,30498,278856249,0,0,1,30720,6,2481060978
11149,278834820,28810,278863630,2,0,1,23552,11,6142712739
11150,278913790,23378,278937168,2,0,1,41984,11,594686218
11151,278966130,52471,279018601,1,0,1,15360,6,8500219979
11152,278968340,50607,279018947,2,0,1,512,11,6435815145
11153,278977640,44894,279022534,1,0,1,5632,6,4023333175
11154,278979300,51157,279030457,1,0,1,18944,6,3353881390
11155,278984551,49772,279034323,0,0,1,6144,6,7255278490
11156,279005880,29621,279035501,1,0,1,13824,6,8276229688
11157,279045601,5971,279051572,0,0,1,14848,6,9424640480
11158,279078930,3898,279082828,9,0,1,4096,17,9085894457
11159,279150910,15321,279166231,9,0,1,29696,17,3487239715
11160,279162790,6347,279169137,9,0,1,4608,17,7938051274
11161,279222121,11016,279233137,0,0,1,17920,6,9913133940
11162,279274640,227660,279502300,3,0,0,20480,0,2788222097
11163,279313291,11274,279324565,0,0,1,18432,6,10604614827
11164,279316470,14277,279330747,1,0,1,19456,6,7734085386
11165,279329389,166656,279496045,4,0,0,134656,4,4243447673
11166,279350251,2470,279352721,0,0,1,2560,6,4372194760
11167,279374760,15062,279389822,9,0,1,29184,17,470822264
11168,279375031,15252,279390283,0,0,1,10240,6,5273002523
11169,279511330,14117,279525447,1,0,1,24064,6,7151736608
11170,279515310,15629,279530939,9,0,1,17920,17,7681971502
11171,279546470,5971,279552441,9,0,1,14848,17,1362246004
11172,279561520,4374,279565894,3,0,1,4608,0,9278487601
11173,279582040,1042,279583082,1,0,1,1024,6,8993081546
11174,279634499,375195,280009694,4,0,0,304128,4,10409916847
11175,279635671,6278,279641949,0,0,1,6656,6,577206345
11176,279641530,414511,280056041,3,0,0,152064,0,565043454
11177,279688190,20366,279708556,1,0,1,32768,6,9368258638
11178,279757069,347261,280104330,4,0,0,156160,4,8220618869
11179,279758761,10241,279769002,0,0,1,16384,6,10399769101
11180,279783400,273303,280056703,6,0,0,2048,3,2795429213
11181,279786121,2946,279789067,0,0,1,3072,6,342721636
11182,279830030,6754,279836784,2,0,1,7168,11,10562531155
11183,279864090,11791,279875881,2,0,1,19456,11,5400115211
11184,279895401,160655,280056056,0,0,1,59392,6,3153886103
11185,279916500,189421,280105921,6,0,0,5120,3,9946034955
11186,279940309,628660,280568969,4,0,0,416256,4,1567314622
11187,279977460,136126,280113586,3,0,1,8192,0,2977351965
11188,279995410,126307,280121717,3,0,1,22528,0,3655894574
11189,279996601,128982,280125583,0,0,1,6144,6,6069039343
11190,279999129,183122,280182251,4,0,0,30720,4,7020225065
11191,280036280,366064,280402344,3,0,0,33792,0,7689748755
11192,280039430,386037,280425467,3,0,0,48128,0,794483811
11193,280176340,13133,280189473,1,0,1,7680,6,2522288209
11194,280185930,14545,280200475,1,0,1,28160,6,10016533969
11195,280345190,11533,280356723,3,0,1,18944,0,5556153433
11196,280345870,11826,280357696,9,0,1,12800,17,10154950114
11197,280372840,4420,280377260,3,0,1,11776,0,799134150
11198,280399530,9294,280408824,9,0,1,15872,17,7982426399
11199,280424600,144384,280568984,3,0,1,38912,0,4643433918
11200,280431300,137699,280568999,3,0,1,20480,0,3418687049
11201,280534590,50380,280584970,3,0,1,30720,0,6126395913
11202,280535750,50098,280585848,3,0,1,12288,0,2322484342
11203,280545550,160495,280706045,6,0,0,1024,3,6264004076
11204,280551171,39816,280590987,0,0,1,8192,6,7107623678
11205,280552460,136215,280688675,3,0,0,5632,0,6712143124
11206,280563910,29023,280592933,1,0,1,3072,6,1398995332
11207,280564110,301820,280865930,3,0,0,165376,0,3212702515
11208,280574200,25146,280599346,1,0,1,22528,6,4560140705
11209,280575770,30211,280605981,3,0,1,22528,0,29162257
11210,280575951,37065,280613016,0,0,1,26112,6,1857244451
11211,280589849,310131,280899980,4,0,0,49152,4,9209319977
11212,280629870,6278,280636148,9,0,1,6656,17,10502984215
11213,280634810,33075,280667885,1,0,1,54272,6,2826187258
11214,280635540,109166,280744706,6,0,0,5120,3,6916367079
11215,280641700,28451,280670151,3,0,1,3584,0,5945225916
11216,280654430,18627,280673057,1,0,1,4608,6,8295708414
11217,280762780,4162,280766942,3,0,1,11264,0,3065501060
11218,280783911,4937,280788848,0,0,1,12800,6,6547654501
11219,280829599,269030,281098629,4,0,0,12800,4,8488365604
11220,280954480,14545,280969025,9,0,1,28160,17,8906517486
11221,280976109,297412,281273521,4,0,0,228352,4,2516159573
11222,281001221,6229,281007450,0,0,1,15360,6,9059312199
11223,281036810,4937,281041747,3,0,1,12800,0,2850041344
11224,281047170,288086,281335256,3,0,0,75776,0,743908336
11225,281063340,25962,281089302,1,0,1,47104,6,9678353516
11226,281084789,261105,281345894,4,0,0,34816,4,4035957313
11227,281160970,112730,281273700,6,0,0,512,3,2934161391
11228,281166470,3904,281170374,9,0,1,10752,17,9649137456
11229,281171500,3645,281175145,1,0,1,10240,6,9745816738
11230,281204220,73601,281277821,7,0,1,11264,16,5200855061
11231,281275380,6180,281281560,3,0,1,11776,0,7603655666
11232,281291640,245671,281537311,3,0,0,136192,0,4342977446
11233,281302360,32911,281335271,3,0,1,27136,0,7390150565
11234,281366980,3422,281370402,1,0,1,3584,6,2585082365
11235,281430450,2870,281433320,7,0,1,8704,16,2110354498
11236,281434980,6754,281441734,3,0,1,7168,0,4558645482
11237,281444360,223044,281667404,3,0,0,141312,0,240188735
11238,281610370,3898,281614268,9,0,1,4096,17,1956325157
11239,281627650,72062,281699712,9,0,1,52736,17,8514512624
11240,281645340,112948,281758288,6,0,0,1024,3,7048780542
11241,281783410,201086,281984496,3,0,0,63488,0,1546803935
11242,281839700,7230,281846930,9,0,1,7680,17,6997941787
11243,281880250,3898,281884148,1,0,1,4096,6,2124068000
11244,281918560,14029,281932589,3,0,1,27136,0,8586190642
11245,281920530,14965,281935495,9,0,1,4608,17,644726952
11246,281931400,10776,281942176,1,0,1,17408,6,10553373716
11247,281931410,15592,281947002,9,0,1,7680,17,677514725
11248,281988010,45596,282033606,6,0,0,1024,3,9060602462
11249,282039370,5196,282044566,3,0,1,13312,0,7582055135
11250,282144649,89744,282234393,4,0,0,14848,4,5601705730
11251,282152040,7230,282159270,9,0,1,7680,17,4858326078
11252,282189609,152401,282342010,4,0,0,54272,4,3513988203
11253,282218750,59132,282277882,6,0,0,5120,3,8404889993
11254,282236069,217150,282453219,4,0,0,61952,4,3886266438
11255,282265120,1042,282266162,9,0,1,1024,17,5720558212
11256,282332030,93752,282425782,3,0,0,20480,0,205582575
11257,282338040,49583,282387623,6,0,0,1024,3,4907325904
11258,282397360,64061,282461421,6,0,0,2048,3,9731805809
11259,282448050,10963,282459013,9,0,1,6144,17,7473614357
11260,282462820,173295,282636115,6,0,0,1024,3,2905254613
11261,282464569,171211,282635780,4,0,0,91648,4,9633024353
11262,282466710,141123,282607833,3,0,0,29184,0,9296138144
11263,282495250,14029,282509279,3,0,1,27136,0,3951522026
11264,282566400,76389,282642789,6,0,0,512,3,10298620008
11265,282573100,4374,282577474,3,0,1,4608,0,4519649805
11266,282600630,38496,282639126,9,0,1,9728,17,551121706
11267,282626570,17976,282644546,9,0,1,6144,17,1759079887
11268,282641880,6532,282648412,3,0,1,6144,0,4133805150
11269,282742600,5802,282748402,9,0,1,6144,17,717182899
11270,282826730,45596,282872326,6,0,0,1024,3,6727173760
11271,282842631,14545,282857176,0,0,1,28160,6,7230637781
11272,282851690,23120,282874810,9,0,1,41472,17,4436231008
11273,282864009,107241,282971250,4,0,0,40960,4,465509336
11274,282872519,152012,283024531,4,0,0,58368,4,5585476984
11275,282930160,6488,282936648,2,0,1,15872,11,4215205664
11276,282957850,13423,282971273,2,0,1,15872,11,2692476260
11277,282958070,17070,282975140,2,0,1,4096,11,2340653100
11278,282972980,5066,282978046,2,0,1,4608,11,2207299563
11279,282988570,127749,283116319,3,0,0,29696,0,9708430562
11280,283050990,5712,283056702,3,0,1,14336,0,7673891132
11281,283054610,4358,283058968,9,0,1,3584,17,5768132721
11282,283119131,1518,283120649,0,0,1,1536,6,1305682000
11283,283127770,5712,283133482,2,0,1,14336,11,10499847019
11284,283160720,67592,283228312,3,0,0,7680,0,5941357387
11285,283199310,4162,283203472,4,0,1,11264,4,8465213220
11286,283214351,2946,283217297,0,0,1,3072,6,7543701772
11287,283228020,6562,283234582,2,0,1,6656,11,1784206623
11288,283233329,229083,283462412,4,0,0,151552,4,6600228035
11289,283273340,100798,283374138,3,0,0,2048,0,4544683556
11290,283288760,175235,283463995,6,0,0,5120,3,6327200093
11291,283309161,6754,283315915,0,0,1,7168,6,10635262713
11292,283314920,13083,283328003,9,0,1,22016,17,4789081072
11293,283429651,39499,283469150,0,0,1,13312,6,3934189493
11294,283497820,91148,283588968,3,0,0,19456,0,2865989973
11295,283524050,4679,283528729,9,0,1,12288,17,3723929160
11296,283530761,4420,283535181,0,0,1,11776,6,4462650464
11297,283551471,14287,283565758,0,0,1,27648,6,9756072868
11298,283629720,4850,283634570,4,0,1,5120,4,8450544377
11299,283662581,1994,283664575,0,0,1,2048,6,5815191398
11300,283692090,50672,283742762,6,0,0,2560,3,8261546629
11301,283701800,13253,283715053,9,0,1,25600,17,8035960261
11302,283722970,15837,283738807,2,0,1,30720,11,7445270999
11303,283728630,11048,283739678,4,0,1,12288,4,7160408975
11304,283758299,82816,283841115,4,0,0,19456,4,8736509545
11305,283782540,1042,283783582,9,0,1,1024,17,9869463416
11306,283792879,245806,284038685,4,0,0,25088,4,9260467231
11307,283794670,48980,283843650,6,0,0,2048,3,1484978209
11308,283817530,12566,283830096,4,0,1,20992,4,199513533
11309,283818380,27253,283845633,9,0,1,35328,17,2693489807
11310,283836699,126010,283962709,4,0,0,52736,4,1337524557
11311,283837311,12188,283849499,0,0,1,6144,6,5272505272
11312,283852259,146562,283998821,4,0,0,40448,4,7208859150
11313,283936050,114662,284050712,3,0,0,39424,0,7951545186
11314,283957800,9321,283967121,5,0,1,11776,11,3207378504
11315,283980360,18476,283998836,4,0,1,15360,4,1792364249
11316,283982330,16521,283998851,5,0,1,12288,11,368801933
11317,283992240,31807,284024047,5,0,1,45568,11,1734031993
11318,283993820,30586,284024406,6,0,1,9728,3,9947422358
11319,284055760,2470,284058230,5,0,1,2560,11,8428958401
11320,284076760,10757,284087517,5,0,1,17408,11,9425158572
11321,284113050,14029,284127079,3,0,1,27136,0,3736216188
11322,284127710,6278,284133988,4,0,1,6656,4,561119036
11323,284147601,16613,284164214,0,0,1,32256,6,1401501877
11324,284174830,5196,284180026,5,0,1,13312,11,7754324179
11325,284197770,5802,284203572,8,0,1,6144,6,10214403623
11326,284215240,238592,284453832,3,0,0,25600,0,2334608163
11327,284216601,4679,284221280,0,0,1,12288,6,355265917
11328,284220530,327946,284548476,3,0,0,240128,0,10623631032
11329,284287950,24242,284312192,5,0,1,40448,11,1157539965
11330,284497530,99762,284597292,6,0,0,1536,3,4407437298
11331,284500980,58287,284559267,4,0,1,17408,4,3435244163
11332,284514030,50063,284564093,9,0,1,7680,17,9425507466
11333,284553780,11389,284565169,4,0,1,13312,4,2504666102
11334,284611141,3422,284614563,0,0,1,3584,6,9765396
11335,284738600,288884,285027484,3,0,0,325632,0,3556346062
11336,284745300,12995,284758295,2,0,1,25088,11,7403614617
11337,284748380,161745,284910125,6,0,0,3072,3,2313669011
11338,284770970,3128,284774098,4,0,1,9216,4,10295251478
11339,284869839,192448,285062287,4,0,0,114176,4,8369990283
11340,285074200,3387,285077587,4,0,1,9728,4,7747241869
11341,285108450,2870,285111320,4,0,1,8704,4,2593060550
11342,285132570,300302,285432872,3,0,0,296448,0,10012219536
11343,285148279,291012,285439291,4,0,0,20992,4,4744438364
11344,285156160,13600,285169760,9,0,1,23040,17,2622344440
11345,285296430,10499,285306929,6,0,1,16896,3,1616730281
11346,285363200,82538,285445738,9,0,1,15872,17,4964532461
11347,285498140,2946,285501086,5,0,1,3072,11,5072307441
11348,285601220,12308,285613528,6,0,1,20480,3,4589956623
11349,285655640,269611,285925251,3,0,0,76800,0,467479583
11350,285699139,202689,285901828,4,0,0,147968,4,8599275877
11351,285729720,229749,285959469,3,0,0,110080,0,8446530702
11352,285768240,32987,285801227,1,0,1,57344,6,5765953846
11353,285774990,36759,285811749,9,0,1,33792,17,2982220986
11354,285808400,3695,285812095,9,0,1,512,17,8826461509
11355,285836490,89424,285925914,3,0,0,2048,0,6536874626
11356,285868080,91428,285959508,5,0,1,14848,11,2427628666
11357,285893400,68923,285962323,1,0,1,8704,6,5201778090
11358,285908720,60139,285968859,9,0,1,7168,17,7630907436
11359,285922930,477975,286400905,3,0,0,165888,0,9947519585
11360,285993600,356746,286350346,3,0,0,318464,0,5859801639
11361,286035510,368085,286403595,6,0,0,6656,3,10417388874
11362,286078540,12049,286090589,5,0,1,19968,11,6024800325
11363,286153840,12737,286166577,5,0,1,24576,11,7666010107
11364,286165330,236222,286401552,6,0,0,2048,3,4155329407
11365,286278970,203002,286481972,6,0,0,512,3,8454823573
11366,286338500,71667,286410167,6,0,1,15872,3,3827251315
11367,286365580,49689,286415269,7,0,1,7168,16,7955995485
11368,286366250,142791,286509041,3,0,0,46080,0,6253969588
11369,286378490,196114,286574604,6,0,0,1536,3,5823407470
11370,286386060,123620,286509680,6,0,0,2048,3,2220271854
11371,286430080,169442,286599522,6,0,0,1536,3,743874659
11372,286506220,4494,286510714,6,0,1,1024,3,8641392481
11373,286526350,3387,286529737,5,0,1,9728,11,10232622166
11374,286527380,22607,286549987,6,0,1,33280,3,5154352917
11375,286583330,16354,286599684,7,0,1,31744,16,4497630912
11376,286604290,50484,286654774,6,0,0,512,3,7345289043
11377,286661269,102752,286764021,4,0,0,37376,4,5264273354
11378,286662040,7230,286669270,7,0,1,7680,16,5813443279
11379,286665800,101980,286767780,3,0,0,12288,0,5477329766
11380,286670060,4679,286674739,7,0,1,12288,16,1889015723
11381,286671570,99345,286770915,6,0,0,10240,3,4232510650
11382,286672660,7972,286680632,6,0,1,7168,3,7426491935
11383,286705500,118937,286824437,6,0,0,1536,3,8652084329
11384,286706399,199020,286905419,4,0,0,34304,4,3878020290
11385,286709710,1518,286711228,5,0,1,1536,11,8877218359
11386,286777149,141233,286918382,4,0,0,42496,4,4265069133
11387,286789979,329987,287119966,4,0,0,39936,4,2504402292
11388,286808820,1518,286810338,5,0,1,1536,11,3420489873
11389,286814630,105951,286920581,6,0,0,7168,3,2268572548
11390,286822160,12566,286834726,5,0,1,20992,11,1517738146
11391,286922000,124956,287046956,6,0,0,3072,3,8897540040
11392,286945440,132335,287077775,3,0,0,88576,0,4394916732
11393,286948790,33503,286982293,6,0,1,58368,3,9158004999
11394,286992720,175739,287168459,6,0,0,3072,3,3520766545
11395,286994330,32987,287027317,6,0,1,57344,3,2573603320
11396,287082450,48980,287131430,6,0,0,2048,3,7770819286
11397,287083250,5802,287089052,7,0,1,6144,16,2781709849
11398,287151040,336748,287487788,3,0,0,331776,0,10519401185
11399,287154739,385015,287539754,4,0,0,156160,4,6623026040
11400,287156620,20366,287176986,5,0,1,32768,11,5169345105
11401,287196430,4374,287200804,6,0,1,4608,3,9001516704
11402,287213230,3128,287216358,9,0,1,9216,17,8791627652
11403,287224139,323647,287547786,4,0,0,14336,4,8276476747
11404,287237520,305867,287543387,3,0,0,11776,0,2576624443
11405,287250560,14287,287264847,9,0,1,27648,17,3978003103
11406,287392150,97666,287489816,7,0,1,2048,16,5625181047
11407,287402670,137099,287539769,7,0,1,25600,16,5141457077
11408,287464480,75304,287539784,7,0,1,8704,16,1904113422
11409,287516589,394207,287910796,4,0,0,122368,4,4594016272
11410,287536470,14170,287550640,5,0,1,8704,11,7095465317
11411,287540820,284838,287825658,3,0,0,223232,0,5672185242
11412,287571680,256208,287827888,6,0,0,7168,3,3909806838
11413,287576209,291050,287867259,4,0,0,86528,4,1307497724
11414,287582390,480791,288063181,3,0,0,110080,0,1589858866
11415,287603430,505318,288108748,3,0,0,149504,0,4806019287
11416,287636330,1518,287637848,5,0,1,1536,11,2144875838
11417,287646789,325728,287972517,4,0,0,22528,4,1497658744
11418,287648940,3422,287652362,9,0,1,3584,17,758318068
11419,287712670,23637,287736307,9,0,1,42496,17,7124247682
11420,287717240,19733,287736973,7,0,1,1024,16,2080478668
11421,287746630,384217,288130847,3,0,0,38400,0,2063137990
11422,287756550,69123,287825673,5,0,1,26624,11,465354052
11423,287788249,528124,288316373,4,0,0,288256,4,6500603076
11424,287796879,136629,287933508,4,0,0,9216,4,9898053887
11425,287838400,28874,287867274,5,0,1,13312,11,6401742041
11426,287892410,22293,287914703,9,0,1,4096,17,7953385769
11427,287909230,8794,287918024,9,0,1,14848,17,3787119333
11428,287925040,3387,287928427,9,0,1,9728,17,5915146463
11429,287930760,223345,288154105,6,0,0,4608,3,3918786693
11430,287954770,181563,288136333,6,0,0,5120,3,10246311264
11431,288012490,13341,288025831,5,0,1,22528,11,9495473533
11432,288041710,89152,288130862,9,0,1,18944,17,5266361593
11433,288070500,60377,288130877,7,0,1,11264,16,1084984327
11434,288123740,222288,288346028,3,0,0,97280,0,8069131296
11435,288131920,1042,288132962,7,0,1,1024,16,2212868890
11436,288448370,3645,288452015,3,0,1,10240,0,7422462819
11437,288518240,22862,288541102,5,0,1,40960,11,9878649944
11438,288562700,4850,288567550,3,0,1,5120,0,3253944558
11439,288610100,33591,288643691,7,0,1,55296,16,3942744761
11440,288651700,566,288652266,7,0,1,512,16,1137376547
11441,288667530,5802,288673332,3,0,1,6144,0,9230880229
11442,288676620,6754,288683374,9,0,1,7168,17,8487648133
11443,288752689,253797,289006486,4,0,0,75264,4,3701941985
11444,288825800,62384,288888184,3,0,0,10752,0,1825998902
11445,288859769,91016,288950785,4,0,0,24064,4,7033753250
11446,288906980,20366,288927346,3,0,1,32768,0,8991209996
11447,288912220,16112,288928332,3,0,1,1536,0,9347729013
11448,288918390,12208,288930598,7,0,1,3584,16,1243666701
11449,288922890,12214,288935104,7,0,1,7168,16,1280222347
11450,289000360,115266,289115626,3,0,0,58368,0,1454136196
11451,289032520,2870,289035390,3,0,1,8704,0,9375716901
11452,289050950,2946,289053896,3,0,1,3072,0,689924702
11453,289055120,101504,289156624,3,0,0,33280,0,1230691640
11454,289066519,133407,289199926,4,0,0,23040,4,126133864
11455,289117159,278804,289395963,4,0,0,159232,4,7757131808
11456,289146029,189245,289335274,4,0,0,94208,4,1967447919
11457,289168929,254193,289423122,4,0,0,89088,4,1148572708
11458,289199470,3870,289203340,3,0,1,3584,0,10430740314
11459,289217839,216663,289434502,4,0,0,6144,4,2575391736
11460,289235360,33075,289268435,7,0,1,54272,16,9356994712
11461,289247370,26352,289273722,3,0,1,16896,0,8074727561
11462,289255150,308506,289563656,3,0,0,212480,0,1417115982
11463,289261780,22260,289284040,7,0,1,32768,16,418991185
11464,289311200,24649,289335849,3,0,1,512,0,2806952048
11465,289319670,103483,289423153,7,0,1,108544,16,1244597956
11466,289344070,114123,289458193,7,0,1,61440,16,10049345847
11467,289399370,69960,289469330,3,0,1,36864,0,7511970550
11468,289491470,168211,289659681,6,0,0,4096,3,5852911925
11469,289523290,52924,289576214,3,0,1,20992,0,1236872798
11470,289645700,5712,289651412,3,0,1,14336,0,5213579954
11471,289661960,6278,289668238,3,0,1,6656,0,6107930382
11472,289683800,3128,289686928,3,0,1,9216,0,1407716822
11473,289841670,3898,289845568,3,0,1,4096,0,3242194513
11474,289901230,292526,290193756,3,0,0,168960,0,5435637194
11475,290001760,270818,290272578,3,0,0,199680,0,5302120034
11476,290087460,2470,290089930,3,0,1,2560,0,9768459525
11477,290094970,2470,290097440,3,0,1,2560,0,2993376850
11478,290121070,3898,290124968,6,0,1,4096,3,2326786451
11479,290146000,346432,290492432,3,0,0,111616,0,535381249
11480,290200830,769992,290970822,3,0,0,870912,0,3844938791
11481,290306460,354432,290660892,6,0,0,1024,3,446446136
11482,290331450,6488,290337938,3,0,1,15872,0,1008780148
11483,290504609,619139,291123748,4,0,0,424960,4,8178850147
11484,290507509,486744,290994253,4,0,0,76800,4,5633160520
11485,290796691,357719,291154410,0,0,1,7680,6,8273281719
11486,290878660,275703,291154363,3,0,0,100352,0,8534378420
11487,291008770,158685,291167455,6,0,1,22016,3,3623152416
11488,291058920,112081,291171001,2,0,1,5632,11,6393922370
11489,291083380,90847,291174227,2,0,1,5120,11,8146319432
11490,291120100,60438,291180538,2,0,1,22016,11,6745573637
11491,291134830,76798,291211628,6,0,0,1536,3,2410579819
11492,291143890,63636,291207526,6,0,0,512,3,7860446931
11493,291202050,5491,291207541,2,0,1,5632,11,5891682783
11494,291230680,130581,291361261,3,0,0,27136,0,9392339016
11495,291253721,22174,291275895,0,0,1,36352,6,8062279968
11496,291299860,100724,291400584,3,0,0,30720,0,1722373014
11497,291326610,56539,291383149,6,0,0,512,3,5766440311
11498,291348589,256017,291604606,4,0,0,77824,4,6466801617
11499,291360910,23463,291384373,2,0,1,41472,11,2146189744
11500,291406900,266037,291672937,3,0,0,36352,0,6234177458
11501,291436230,5196,291441426,2,0,1,13312,11,494858256
11502,291466980,12049,291479029,2,0,1,19968,11,6624851693
11503,291500760,127417,291628177,3,0,0,77312,0,7626649992
11504,291602281,32117,291634398,0,0,1,15360,6,9272791737
11505,291636011,6488,291642499,0,0,1,15872,6,676150377
11506,291664910,466479,292131389,3,0,0,68608,0,9461076874
11507,291671029,340975,292012004,4,0,0,93696,4,6267786923
11508,291689530,13253,291702783,1,0,1,25600,6,8496489334
11509,291725040,384947,292109987,0,0,0,321536,6,2153878036
11510,291733940,3422,291737362,1,0,1,3584,6,8599806910
11511,291738290,81720,291820010,1,0,0,4096,6,5079217220
11512,291758860,63037,291821897,6,0,0,6144,3,7219618019
11513,291804080,4679,291808759,6,0,1,12288,3,9095606035
11514,291821639,310077,292131716,4,0,0,1024,4,9211346697
11515,291841809,268661,292110470,4,0,0,1536,4,966023602
11516,291907430,1042,291908472,6,0,1,1024,3,4841750500
11517,291920251,3387,291923638,0,0,1,9728,6,8391929579
11518,291946339,185548,292131887,4,0,0,512,4,5110191594
11519,291961710,5196,291966906,1,0,1,13312,6,3643467472
11520,291965350,5315,291970665,6,0,1,5120,3,6467203313
11521,292154180,75037,292229217,7,0,1,125952,16,6477028341
11522,292193460,47611,292241071,6,0,1,40448,3,2884190200
11523,292239399,76888,292316287,4,0,0,3072,4,7394915203
11524,292285700,3898,292289598,1,0,1,4096,6,4265946356
11525,292394120,109460,292503580,3,0,0,59392,0,10260609537
11526,292450560,285764,292736324,3,0,0,315392,0,1173742986
11527,292453100,4937,292458037,6,0,1,12800,3,1838082814
11528,292484921,18674,292503595,0,0,1,7680,6,5618378479
11529,292497350,461978,292959328,7,0,1,737280,16,6016921592
11530,292512400,395833,292908233,6,0,0,11264,3,5384094750
11531,292562720,523619,293086339,6,0,0,9728,3,6261372242
11532,292578670,562230,293140900,3,0,0,147456,0,9613493866
11533,292607440,352247,292959687,7,0,1,9728,16,6552767313
11534,292628770,341439,292970209,1,0,1,41984,6,2476614513
11535,292637530,333345,292970875,7,0,1,11264,16,2643224457
11536,292697860,154821,292852681,6,0,0,512,3,3064588673
11537,292734950,239791,292974741,6,0,1,6144,3,5009575818
11538,292737931,240676,292978607,0,0,1,6144,6,10720055237
11539,292796180,226815,293022995,6,0,0,512,3,3587880450
11540,292816570,162293,292978863,6,0,1,9216,3,789596060
11541,292828441,151408,292979849,0,0,1,1536,6,7120155088
11542,292848790,136346,292985136,6,0,1,25088,3,5911946453
11543,292858630,131332,292989962,7,0,1,7680,16,9630450679
11544,292890920,203434,293094354,6,0,0,512,3,6149810699
11545,292892660,97968,292990628,6,0,1,1024,3,6951541019
11546,292913930,78004,292991934,7,0,1,2048,16,7480531644
11547,292914091,89185,293003276,0,0,1,46080,6,9154993446
11548,292918080,323125,293241205,3,0,0,99840,0,2202654624
11549,292985030,24557,293009587,2,0,1,30208,11,5999780475
11550,293068970,179045,293248015,6,0,0,5120,3,2778348741
11551,293093530,47385,293140915,2,0,1,12800,11,8149281028
11552,293106460,174836,293281296,6,0,0,1536,3,4160133040
11553,293116260,25756,293142016,7,0,1,1024,16,3951834081
11554,293126260,19705,293145965,7,0,1,12288,16,5092262922
11555,293128161,28918,293157079,0,0,1,19968,6,7240571626
11556,293156810,6754,293163564,7,0,1,7168,16,6683738474
11557,293166579,152595,293319174,4,0,0,13824,4,2323390255
11558,293222000,232863,293454863,6,0,0,2560,3,6581998953
11559,293240910,1354,293242264,6,0,1,1024,3,10663614540
11560,293260290,158947,293419237,3,0,0,13312,0,4189062689
11561,293287230,96631,293383861,6,0,0,3072,3,7109370052
11562,293295780,3387,293299167,6,0,1,9728,3,10382427992
11563,293299510,1994,293301504,7,0,1,2048,16,1510481195
11564,293314020,5169,293319189,6,0,1,3584,3,8013355478
11565,293390620,45596,293436216,6,0,0,1024,3,8609534708
11566,293406550,14545,293421095,6,0,1,28160,3,2618574570
11567,293407560,24752,293432312,1,0,1,22016,6,9006432441
11568,293422760,52797,293475557,6,0,0,1024,3,7325672737
11569,293425100,8185,293433285,2,0,1,12800,11,10000636071
11570,293494419,43904,293538323,4,0,0,512,4,866315692
11571,293499169,123678,293622847,4,0,0,4096,4,8129376815
11572,293532890,3645,293536535,1,0,1,10240,6,7346003494
11573,293535520,5218,293540738,1,0,1,12288,6,4644910233
11574,293543640,5454,293549094,4,0,1,13824,4,1343028367
11575,293590020,14545,293604565,7,0,1,28160,16,3473686618
11576,293620359,72134,293692493,4,0,0,2048,4,2239328604
11577,293698530,45596,293744126,6,0,0,1024,3,8752654258
11578,293704090,6754,293710844,2,0,1,7168,11,4980558712
11579,293736090,3645,293739735,1,0,1,10240,6,10691111678
11580,293745290,14117,293759407,1,0,1,24064,6,395767218
11581,293812940,12825,293825765,1,0,1,21504,6,4976975077
11582,293824949,90152,293915101,4,0,0,7680,4,10371513588
11583,293828800,4679,293833479,6,0,1,12288,3,7609513097
11584,293832500,5419,293837919,6,0,1,5632,3,7256972439
11585,293837180,93311,293930491,6,0,0,6656,3,6008734488
11586,293843130,3422,293846552,6,0,1,3584,3,3053213553
11587,293854480,4374,293858854,2,0,1,4608,11,3282309805
11588,293860150,92065,293952215,6,0,0,5632,3,4811470810
11589,293896980,10757,293907737,7,0,1,17408,16,2567660207
11590,293897480,10821,293908301,9,0,1,10752,17,5671625255
11591,293897750,18117,293915867,7,0,1,16384,16,7562953534
11592,293907590,10543,293918133,7,0,1,3584,16,9453097008
11593,293929480,3473,293932953,1,0,1,2560,6,2276843182
11594,294007160,11791,294018951,9,0,1,19456,17,6934670607
11595,294047940,571892,294619832,3,0,0,408576,0,5010579
11596,294061820,23208,294085028,8,0,1,38400,6,4153419088
11597,294064140,391705,294455845,3,0,0,275968,0,9656187763
11598,294142280,14287,294156567,6,0,1,27648,3,8905866721
11599,294161420,4374,294165794,6,0,1,4608,3,10241384365
11600,294203200,430101,294633301,3,0,0,43520,0,7576379503
11601,294203659,416367,294620026,4,0,0,512,4,10388961958
11602,294206299,249748,294456047,4,0,0,512,4,3417408806
11603,294206520,20366,294226886,3,0,1,32768,0,7043426249
11604,294258690,6229,294264919,1,0,1,15360,6,5267195815
11605,294271190,5712,294276902,2,0,1,14336,11,9635619011
11606,294283350,5971,294289321,6,0,1,14848,3,8339867202
11607,294318630,35571,294354201,3,0,1,62464,0,2108907439
11608,294361200,5326,294366526,2,0,1,5632,11,10584668229
11609,294371100,84768,294455868,3,0,1,23040,0,1409427231
11610,294381089,252383,294633472,4,0,0,512,4,9035337793
11611,294407910,50616,294458526,2,0,1,2560,11,5413253735
11612,294418480,254610,294673090,3,0,0,61952,0,10163259080
11613,294424320,45857,294470177,2,0,1,22528,11,8279512346
11614,294458360,13405,294471765,2,0,1,15872,11,2586632196
11615,294484660,2470,294487130,3,0,1,2560,0,3137465578
11616,294492790,2470,294495260,2,0,1,2560,11,7387736072
11617,294494020,125835,294619855,1,0,1,11776,6,6243468303
11618,294497620,138306,294635926,9,0,1,2560,17,1165001726
11619,294588070,85035,294673105,2,0,1,49152,11,3197973119
11620,294642190,30930,294673120,9,0,1,1024,17,6188408827
11621,294710490,65834,294776324,6,0,0,512,3,5809210065
11622,294743160,3898,294747058,2,0,1,4096,11,9868372569
11623,294786060,176613,294962673,3,0,0,53760,0,855474751
11624,294841420,11016,294852436,3,0,1,17920,0,5470601081
11625,294843660,10722,294854382,9,0,1,3072,17,8463665887
11626,294858780,44110,294902890,6,0,0,512,3,1453800940
11627,294883280,2470,294885750,1,0,1,2560,6,5038018308
11628,294908449,54707,294963156,4,0,0,1536,4,784454534
11629,294930370,3645,294934015,3,0,1,10240,0,6884475587
11630,294940060,136990,295077050,3,0,0,92672,0,6489776594
11631,294960960,7038,294967998,7,0,1,5120,16,3032221884
11632,295026570,50511,295077081,4,0,1,78848,4,4809316744
11633,295051330,31199,295082529,2,0,1,13824,11,5442382475
11634,295056670,27770,295084440,2,0,1,9216,11,4928453198
11635,295077060,11739,295088799,2,0,1,12288,11,2444307934
11636,295099280,15837,295115117,4,0,1,30720,4,7617885034
11637,295124630,23466,295148096,4,0,1,38912,4,7208810261
11638,295193510,119868,295313378,6,0,0,5120,3,6132402920
11639,295212040,57440,295269480,6,0,0,4608,3,6458554847
11640,295279150,4850,295284000,9,0,1,5120,17,3720438489
11641,295375980,192464,295568444,3,0,0,170496,0,7266221486
11642,295404620,21658,295426278,4,0,1,35328,4,10714075810
11643,295453270,4937,295458207,2,0,1,12800,11,9367968719
11644,295463470,566,295464036,9,0,1,512,17,6972559970
11645,295473270,1518,295474788,4,0,1,1536,4,2613048535
11646,295489490,21916,295511406,9,0,1,35840,17,4371950853
11647,295503500,309639,295813139,3,0,0,165888,0,3464330905
11648,295564200,26152,295590352,4,0,1,35840,4,2371835922
11649,295574360,16658,295591018,9,0,1,1024,17,797943206
11650,295576960,19652,295596612,5,0,1,26624,11,3224145011
11651,295603530,59167,295662697,6,0,0,3584,3,41386263
11652,295616090,7706,295623796,4,0,1,8192,4,9684070068
11653,295633340,12049,295645389,2,0,1,19968,11,9418174506
11654,295700240,566,295700806,4,0,1,512,4,3429940969
11655,295701859,136524,295838383,4,0,0,1024,4,1822449318
11656,295740070,1518,295741588,5,0,1,1536,11,4179720483
11657,295771970,53794,295825764,2,0,1,20992,11,2783204316
11658,295778040,54379,295832419,2,0,1,21504,11,2347878666
11659,295783210,69674,295852884,9,0,1,48640,17,8636837611
11660,295786900,68250,295855150,7,0,1,3584,16,4277432351
11661,295845950,31783,295877733,9,0,1,51712,17,866753462
11662,295850870,30729,295881599,7,0,1,6144,16,2033589978
11663,295857889,66834,295924723,4,0,0,1536,4,7183080349
11664,295862500,20405,295882905,2,0,1,2048,11,6002697935
11665,295871040,32987,295904027,2,0,1,57344,11,7626283985
11666,295901699,43904,295945603,4,0,0,512,4,699600278
11667,295908220,371563,296279783,3,0,0,241152,0,3600994173
11668,295926259,171262,296097521,4,0,0,1536,4,1996610155
11669,295952060,20624,295972684,5,0,1,33280,11,4465184668
11670,295969500,4490,295973990,2,0,1,2048,11,6311204988
11671,296009070,26221,296035291,9,0,1,47616,17,10617218235
11672,296012480,25077,296037557,4,0,1,3584,4,4552041412
11673,296050860,14117,296064977,3,0,1,24064,0,4025640957
11674,296060669,86209,296146878,4,0,0,1024,4,8239943319
11675,296077100,239704,296316804,6,0,0,3072,3,10518226094
11676,296111110,427226,296538336,3,0,0,111104,0,7171567724
11677,296115940,271996,296387936,3,0,0,164352,0,9730075200
11678,296116550,3422,296119972,4,0,1,3584,4,5922407213
11679,296119890,27003,296146893,7,0,1,48640,16,9355353428
11680,296146980,2470,296149450,9,0,1,2560,17,5685586189
11681,296151050,239553,296390603,3,0,0,8704,0,3179504087
11682,296152609,127533,296280142,4,0,0,1024,4,3153336903
11683,296173650,5802,296179452,4,0,1,6144,4,10634915702
11684,296180050,12049,296192099,2,0,1,19968,11,2705790189
11685,296186310,6455,296192765,9,0,1,1024,17,1108221436
11686,296197530,4850,296202380,2,0,1,5120,11,7426713650
11687,296226030,58445,296284475,9,0,1,4608,17,4451447383
11688,296227370,57522,296284892,4,0,1,9728,4,715600719
11689,296246690,39297,296285987,9,0,1,1536,17,10476887677
11690,296251150,47904,296299054,4,0,1,24064,4,7468348583
11691,296288030,28789,296316819,5,0,1,43008,11,6838440060
11692,296292610,357531,296650141,3,0,0,191488,0,1499375690
11693,296329370,341090,296670460,0,0,0,66560,6,8585946781
11694,296344780,67798,296412578,9,0,1,35840,17,7346218613
11695,296352730,60309,296413039,9,0,1,10240,17,5301143933
11696,296354910,58385,296413295,4,0,1,9216,4,3722848770
11697,296374260,208146,296582406,6,0,0,2560,3,823674326
11698,296397960,16411,296414371,5,0,1,13312,11,5655243208
11699,296399980,42401,296442381,7,0,1,49664,16,5777625647
11700,296447420,5454,296452874,9,0,1,13824,17,8029224580
11701,296457250,15321,296472571,2,0,1,29696,11,9647748194
11702,296481781,6229,296488010,0,0,1,15360,6,8146578046
11703,296568520,381984,296950504,0,0,0,78848,6,3892277822
11704,296582699,88096,296670795,4,0,0,1024,4,8963348174
11705,296586280,1994,296588274,7,0,1,2048,16,10342134807
11706,296604440,79749,296684189,7,0,1,26624,16,8046456019
11707,296613090,279739,296892829,3,0,0,126976,0,1460048731
11708,296620580,330251,296950831,6,0,0,1024,3,3544467572
11709,296676030,250435,296926465,0,0,0,14336,6,9594622204
11710,296678550,8865,296687415,9,0,1,5120,17,5186263884
11711,296682870,80442,296763312,6,0,0,512,3,4672148090
11712,296718570,3898,296722468,5,0,1,4096,11,9942782917
11713,296722160,312966,297035126,3,0,0,81408,0,4310299974
11714,296724321,1042,296725363,0,0,1,1024,6,3332504871
11715,296737831,4850,296742681,0,0,1,5120,6,1655825342
11716,296786650,3898,296790548,5,0,1,4096,11,5236887411
11717,296795620,2870,296798490,4,0,1,8704,4,2573335079
11718,296795860,8690,296804550,7,0,1,15360,16,10609356300
11719,296804890,4850,296809740,2,0,1,5120,11,5635261741
11720,296855510,42253,296897763,2,0,1,5120,11,6367381195
11721,296861780,37630,296899410,4,0,1,12800,4,212151950
11722,296866610,33146,296899756,9,0,1,512,17,3294450390
11723,296869941,81396,296951337,0,0,1,86016,6,1784112309
11724,296878980,73023,296952003,4,0,1,1024,4,1766496945
11725,296928830,32750,296961580,4,0,1,17408,4,2116057105
11726,296988390,214418,297202808,5,0,0,1024,11,6403054802
11727,297006260,28881,297035141,9,0,1,5632,17,4132854508
11728,297007191,27965,297035156,0,0,1,2048,6,3451263587
11729,297082490,13858,297096348,9,0,1,23552,17,7667477678
11730,297095740,21916,297117656,2,0,1,35840,11,6878386527
11731,297102390,16751,297119141,9,0,1,15360,17,1056789974
11732,297107610,83492,297191102,6,0,0,1536,3,2920109444
11733,297112960,68182,297181142,6,0,0,6656,3,5273861829
11734,297116130,164387,297280517,6,0,0,1024,3,5328989768
11735,297123400,236270,297359670,0,0,0,20480,6,3839008861
11736,297136470,4374,297140844,2,0,1,4608,11,8390391084
11737,297139680,3128,297142808,9,0,1,9216,17,2614593954
11738,297147350,12825,297160175,4,0,1,21504,4,568660253
11739,297177690,172260,297349950,3,0,0,56320,0,5554386093
11740,297185750,527111,297712861,0,0,0,41984,6,6484976083
11741,297188901,10499,297199400,0,0,1,16896,6,7290402001
11742,297203340,12308,297215648,8,0,1,20480,6,6865849083
11743,297225370,4420,297229790,6,0,1,11776,3,3689507874
11744,297273320,15321,297288641,2,0,1,29696,11,2694199590
11745,297309470,1518,297310988,9,0,1,1536,17,1096790889
11746,297313010,269526,297582536,6,0,0,7168,3,6023750189
11747,297317200,10499,297327699,8,0,1,16896,6,9913861637
11748,297317489,63068,297380557,4,0,0,1024,4,4200948830
11749,297321450,300236,297621686,6,0,0,1024,3,21943961
11750,297329490,20483,297349973,8,0,1,27136,6,2195930541
11751,297339410,20275,297359685,6,0,1,7168,3,7185526386
11752,297349290,17148,297366438,5,0,1,27648,11,607138485
11753,297351109,64261,297415370,4,0,0,512,4,8365828416
11754,297370990,1518,297372508,2,0,1,1536,11,8534574539
11755,297374500,566,297375066,9,0,1,512,17,9967918209
11756,297399270,300776,297700046,3,0,0,164864,0,5298386471
11757,297408320,1994,297410314,5,0,1,2048,11,1330238740
11758,297425049,182429,297607478,4,0,0,8192,4,855969357
11759,297441900,5196,297447096,8,0,1,13312,6,3654708693
11760,297458750,1518,297460268,6,0,1,1536,3,8279717544
11761,297460250,4860,297465110,2,0,1,5120,11,9508327509
11762,297505380,69692,297575072,6,0,0,1536,3,3801973498
11763,297568751,3898,297572649,0,0,1,4096,6,7872085727
11764,297612070,1994,297614064,6,0,1,2048,3,579702946
11765,297651550,65690,297717240,6,0,1,11776,3,10689693195
11766,297707030,13573,297720603,6,0,1,11264,3,10213309300
11767,297756801,14804,297771605,0,0,1,28672,6,10671318048
11768,297763010,10541,297773551,8,0,1,3072,6,3399900103
11769,297763290,15986,297779276,5,0,1,24576,11,7656775795
11770,297785361,3128,297788489,0,0,1,9216,6,6432938840
11771,297816110,2470,297818580,5,0,1,2560,11,1035236792
11772,297916410,24242,297940652,9,0,1,40448,17,3238210503
11773,297950371,3422,297953793,0,0,1,3584,6,9633583872
11774,297963220,54056,298017276,6,0,0,3584,3,3136202669
11775,297968060,14545,297982605,5,0,1,28160,11,5922956299
11776,297973330,55723,298029053,6,0,0,3072,3,4775122344
11777,297981469,54893,298036362,4,0,0,4608,4,1887703260
11778,297986100,11791,297997891,8,0,1,19456,6,8017185980
11779,298006630,224007,298230637,0,0,0,209920,6,9776159510
11780,298038760,10241,298049001,4,0,1,16384,4,6477019234
11781,298047221,14804,298062025,0,0,1,28672,6,3625962878
11782,298062669,365076,298427745,4,0,0,2048,4,9429805160
11783,298119860,515624,298635484,3,0,0,475648,0,3196125251
11784,298134570,1042,298135612,4,0,1,1024,4,7801949170
11785,298142720,87940,298230660,8,0,1,52736,6,7017400881
11786,298165380,65295,298230675,4,0,1,12288,4,4716504243
11787,298167440,323105,298490545,0,0,0,25600,6,4013171509
11788,298181900,457343,298639243,0,0,0,12288,6,7580097923
11789,298187380,58703,298246083,5,0,1,29696,11,8444092691
11790,298197550,442504,298640054,6,0,0,2560,3,6995275789
11791,298203340,218417,298421757,6,0,0,2560,3,774282086
11792,298213950,33311,298247261,8,0,1,13824,6,7153117802
11793,298246600,26221,298272821,8,0,1,47616,6,4687389677
11794,298276211,24670,298300881,0,0,1,44544,6,6935158026
11795,298281610,22177,298303787,9,0,1,4608,17,3447895052
11796,298339760,301269,298641029,5,0,0,3072,11,10586092378
11797,298361110,12308,298373418,5,0,1,20480,11,4013552585
11798,298366080,10564,298376644,8,0,1,5120,6,3164137909
11799,298376741,5454,298382195,0,0,1,13824,6,455043161
11800,298379989,319707,298699696,4,0,0,1024,4,6017751060
11801,298410811,1518,298412329,0,0,1,1536,6,928853698
11802,298472570,528511,299001081,0,0,0,222720,6,6612352181
11803,298474290,209249,298683539,3,0,0,47616,0,2433678779
11804,298477850,237207,298715057,3,0,0,13824,0,4570620292
11805,298563050,120504,298683554,5,0,1,60416,11,9907979727
11806,298567180,273736,298840916,0,0,0,64512,6,6831494166
11807,298574450,109119,298683569,8,0,1,32256,6,9834447427
11808,298580750,102834,298683584,1,0,1,1024,6,7246770793
11809,298581580,351626,298933206,3,0,0,118272,0,8060377283
11810,298594440,89982,298684422,9,0,1,15360,17,10281967145
11811,298719540,81889,298801429,6,0,0,512,3,682556320
11812,298749270,253706,299002976,3,0,0,6144,0,5197203741
11813,298787580,21658,298809238,1,0,1,35328,6,9145735036
11814,298788670,22834,298811504,1,0,1,3584,6,2669263472
11815,298789850,23600,298813450,9,0,1,3072,17,7156945200
11816,298800340,40591,298840931,1,0,1,60928,6,6910675615
11817,298835810,8535,298844345,8,0,1,3584,6,2438194414
11818,298863240,566,298863806,9,0,1,512,17,1543481256
11819,298885990,2470,298888460,2,0,1,2560,11,10699518251
11820,298888751,2946,298891697,0,0,1,3072,6,2620015916
11821,298920470,95390,299015860,9,0,1,21504,17,652122294
11822,298961030,59656,299020686,8,0,1,7680,6,7477232828
11823,298961890,64800,299026690,1,0,1,20480,6,6136558299
11824,298971440,75482,299046922,6,0,0,512,3,4588157117
11825,298971901,57375,299029276,0,0,1,4096,6,3442207549
11826,299008470,26195,299034665,8,0,1,25600,6,182126353
11827,299052070,14804,299066874,9,0,1,28672,17,807295704
11828,299053800,333589,299387389,1,0,0,48128,6,4227005230
11829,299118630,357145,299475775,0,0,0,215552,6,5542000586
11830,299120900,5196,299126096,1,0,1,13312,6,5980020918
11831,299121380,78273,299199653,6,0,0,2048,3,10051910664
11832,299157300,4850,299162150,9,0,1,5120,17,9404229293
11833,299172259,90019,299262278,4,0,0,1536,4,7320242672
11834,299199160,2003,299201163,2,0,1,1536,11,6693663749
11835,299200650,298742,299499392,3,0,0,75264,0,1312133495
11836,299205040,156642,299361682,6,0,0,3072,3,980106775
11837,299241940,5326,299247266,1,0,1,5632,6,8101486498
11838,299250080,3898,299253978,8,0,1,4096,6,8142219800
11839,299270129,232803,299502932,4,0,0,512,4,3143504539
11840,299300190,200005,299500195,6,0,0,2560,3,10204172417
11841,299300270,200096,299500366,6,0,0,512,3,10483248763
11842,299318000,248866,299566866,0,0,0,96768,6,1784697400
11843,299327439,175306,299502745,4,0,0,7680,4,9266182155
11844,299328880,1042,299329922,2,0,1,1024,11,8154732147
11845,299329750,285907,299615657,0,0,0,98304,6,9329237333
11846,299341100,4162,299345262,2,0,1,11264,11,5122767267
11847,299356700,119737,299476437,6,0,0,2048,3,2925923012
11848,299360500,4850,299365350,2,0,1,5120,11,9102173588
11849,299381600,7775,299389375,7,0,1,2048,16,3075318138
11850,299406250,69548,299475798,2,0,1,21504,11,4849173216
11851,299410910,94290,299505200,2,0,1,5120,11,4644439704
11852,299430631,76475,299507106,0,0,1,13312,6,2498076745
11853,299459160,52584,299511744,7,0,1,14336,16,9420597889
11854,299475469,201710,299677179,4,0,0,2048,4,2658576730
11855,299484620,33494,299518114,8,0,1,8192,6,5152582273
11856,299485340,38838,299524178,9,0,1,18432,17,3620548054
11857,299556250,259337,299815587,3,0,0,20992,0,9394264686
11858,299564490,226860,299791350,0,0,0,12288,6,1316938973
11859,299579589,153002,299732591,4,0,0,1536,4,4885617842
11860,299595910,188804,299784714,0,0,0,95744,6,6562161132
11861,299597280,19962,299617242,1,0,1,1536,6,7945008262
11862,299601600,29654,299631254,2,0,1,29184,11,9470899026
11863,299610941,24179,299635120,0,0,1,6144,6,3471033056
11864,299615720,25711,299641431,9,0,1,22016,17,1001659444
11865,299644060,143531,299787591,0,0,0,9216,6,1542907559
11866,299673719,72895,299746614,4,0,0,512,4,3573643508
11867,299708590,12308,299720898,7,0,1,20480,16,7512662950
11868,299717420,67317,299784737,2,0,1,72704,11,9909661697
11869,299727570,57182,299784752,7,0,1,48640,16,6730825060
11870,299743090,225118,299968208,3,0,0,13312,0,5242784819
11871,299761610,31217,299792827,1,0,1,1536,6,7724943683
11872,299774470,111237,299885707,3,0,0,20480,0,212397613
11873,299776609,187528,299964137,4,0,0,10240,4,10447108493
11874,299857200,21141,299878341,1,0,1,34304,6,9656906062
11875,299883470,5175,299888645,7,0,1,3072,16,3795389949
11876,299905590,1042,299906632,8,0,1,1024,6,2297003001
11877,299940600,1994,299942594,7,0,1,2048,16,3364918013
11878,300035670,2946,300038616,1,0,1,3072,6,1244355315
11879,300057400,3387,300060787,9,0,1,9728,17,6682294384
11880,300068800,122273,300191073,3,0,0,57344,0,557540234
11881,300098770,12566,300111336,9,0,1,20992,17,5871333315
11882,300112951,78153,300191104,0,0,1,118784,6,7126277649
11883,300130690,60437,300191127,1,0,1,5120,6,10665044648
11884,300158830,277136,300435966,3,0,0,143360,0,141644883
11885,300163610,36045,300199655,9,0,1,41472,17,2261344222
11886,300170110,30531,300200641,8,0,1,1536,6,5135304105
11887,300177650,28790,300206440,1,0,1,19456,6,6889451697
11888,300187660,19126,300206786,1,0,1,512,6,8256450867
11889,300210600,5326,300215926,2,0,1,5632,11,1409571536
11890,300217270,12825,300230095,1,0,1,21504,6,1829362096
11891,300245490,3422,300248912,1,0,1,3584,6,179987495
11892,300257020,6754,300263774,1,0,1,7168,6,1039338349
11893,300277490,4937,300282427,2,0,1,12800,11,335674328
11894,300282170,287810,300569980,3,0,0,99840,0,4900811370
11895,300297220,25446,300322666,9,0,1,46080,17,2017278932
11896,300314401,12131,300326532,0,0,1,6144,6,9949642157
11897,300342000,233118,300575118,6,0,0,1024,3,7181442688
11898,300344850,1518,300346368,7,0,1,1536,16,8542327600
11899,300348640,274898,300623538,0,0,0,66048,6,10512808247
11900,300359820,303746,300663566,3,0,0,29696,0,8200982767
11901,300362741,4420,300367161,0,0,1,11776,6,1567563678
11902,300385990,264083,300650073,2,0,0,87040,11,4988038718
11903,300396770,42176,300438946,9,0,1,3072,17,6063453403
11904,300416650,183054,300599704,0,0,0,3584,6,4178660395
11905,300417200,157504,300574704,3,0,0,12800,0,5987442712
11906,300444991,13341,300458332,0,0,1,22528,6,4181316863
11907,300448511,10077,300458588,0,0,1,9216,6,4605422880
11908,300472669,179291,300651960,4,0,0,6144,4,2758947212
11909,300481980,184631,300666611,6,0,0,4096,3,7548489450
11910,300504000,4374,300508374,2,0,1,4608,11,464390382
11911,300529770,124709,300654479,1,0,0,8192,6,4061458900
11912,300555910,113427,300669337,0,0,0,5120,6,3716685193
11913,300578950,13341,300592291,2,0,1,22528,11,5730908614
11914,300612670,50927,300663597,9,0,1,4608,17,4067182892
11915,300614520,54832,300669352,3,0,1,6144,0,10113983214
11916,300644520,26753,300671273,9,0,1,3072,17,6745098024
11917,300659060,51485,300710545,7,0,1,72192,16,10530908644
11918,300683310,62769,300746079,6,0,0,4608,3,4603734229
11919,300689800,22371,300712171,7,0,1,2560,16,6548659287
11920,300713680,282577,300996257,1,0,0,19968,6,2901759987
11921,300717869,211467,300929336,4,0,0,1024,4,9821524822
11922,300753400,330638,301084038,3,0,0,24576,0,1755752770
11923,300755520,2946,300758466,9,0,1,3072,17,2820559710
11924,300781210,147799,300929009,1,0,0,73728,6,5048605168
11925,300809370,10499,300819869,1,0,1,16896,6,5613886241
11926,300821010,389910,301210920,0,0,0,182784,6,8341676015
11927,300831710,97641,300929351,2,0,1,132608,11,820766450
11928,300877020,108605,300985625,0,0,0,45568,6,2913044650
11929,300929730,4850,300934580,7,0,1,5120,16,7170211086
11930,300945900,322817,301268717,1,0,0,122368,6,3274841954
11931,301017380,194031,301211411,6,0,0,1536,3,3334881688
11932,301051390,308083,301359473,0,0,0,70144,6,425240915
11933,301162370,259336,301421706,0,0,0,35840,6,4128056597
11934,301188550,25723,301214273,7,0,1,8704,16,7028718679
11935,301240240,297213,301537453,1,0,0,186880,6,2032028438
11936,301261279,100511,301361790,4,0,0,512,4,3928729887
11937,301264770,193637,301458407,6,0,0,512,3,1844783185
11938,301285829,336882,301622711,4,0,0,8192,4,821986107
11939,301306010,11791,301317801,7,0,1,19456,16,8117998789
11940,301323599,229938,301553537,4,0,0,2560,4,7399984986
11941,301346060,17796,301363856,7,0,1,4608,16,4866354131
11942,301356790,378895,301735685,0,0,0,310784,6,9526070446
11943,301384570,351442,301736012,6,0,0,1024,3,3625042397
11944,301449750,14545,301464295,2,0,1,28160,11,2960624884
11945,301529470,80983,301610453,3,0,0,5632,0,10436977258
11946,301644480,94061,301738541,7,0,1,2560,16,3257539812
11947,301671070,69685,301740755,2,0,1,10752,11,9114868361
11948,301690670,194445,301885115,3,0,0,101376,0,1083979247
11949,301716729,70022,301786751,4,0,0,2560,4,2556073485
11950,301742040,4937,301746977,2,0,1,12800,11,5321437830
11951,301832880,175197,302008077,1,0,0,109568,6,9384847086
11952,301843880,174064,302017944,1,0,0,32256,6,4794891669
11953,301847410,37720,301885130,8,0,1,22016,6,4333700857
11954,301898090,4850,301902940,8,0,1,5120,6,10331150727
11955,301935340,6278,301941618,7,0,1,6656,16,2598182067
11956,301937330,12912,301950242,2,0,1,21504,11,4511748393
11957,301937900,15568,301953468,2,0,1,5120,11,3398931371
11958,301975030,452865,302427895,1,0,0,226304,6,8590927737
11959,301979570,611152,302590722,1,0,0,401920,6,425921445
11960,301995820,26933,302022753,5,0,1,5120,11,10191956431
11961,302071439,259694,302331133,4,0,0,5632,4,3872897942
11962,302077620,350446,302428066,6,0,0,512,3,7269550968
11963,302090120,6229,302096349,5,0,1,15360,11,7887612129
11964,302113500,354747,302468247,3,0,0,47616,0,7916989055
11965,302123399,216646,302340045,4,0,0,1024,4,2413596388
11966,302142820,473689,302616509,0,0,0,84480,6,8537610327
11967,302167570,13253,302180823,7,0,1,25600,16,7354964755
11968,302214200,11274,302225474,8,0,1,18432,6,5234820203
11969,302220060,10599,302230659,2,0,1,16384,11,6793816752
11970,302350610,578334,302928944,1,0,0,514048,6,1422303375
11971,302395100,35921,302431021,2,0,1,3072,11,4348983631
11972,302421000,18252,302439252,4,0,1,16384,4,7790983775
11973,302438570,4162,302442732,2,0,1,11264,11,7880263995
11974,302466480,152984,302619464,5,0,1,3072,11,72715161
11975,302467010,650154,303117164,3,0,0,348160,0,459067788
11976,302505360,435900,302941260,3,0,0,1536,0,4945904750
11977,302522830,101854,302624684,7,0,1,7680,16,10001007887
11978,302543890,449368,302993258,1,0,0,169472,6,8634165349
11979,302579260,45988,302625248,8,0,1,10752,6,3089056908
11980,302650529,278610,302929139,4,0,0,512,4,4053815377
11981,302697570,32558,302730128,8,0,1,53248,6,2877230588
11982,302807809,309846,303117655,4,0,0,1536,4,9921822422
11983,302865500,64640,302930140,8,0,1,1024,6,9035044868
11984,302883060,250877,303133937,6,0,0,3584,3,10011539638
11985,302964630,35125,302999755,7,0,1,15872,16,8022513877
11986,302984420,152107,303136527,5,0,0,7168,11,2185259340
11987,302995050,6489,303001539,5,0,1,9728,11,3742282644
11988,302998440,131578,303130018,3,0,0,40448,0,4852021537
11989,303011630,382500,303394130,1,0,0,38400,6,609380498
11990,303042350,90197,303132547,2,0,1,2560,11,3655710546
11991,303086380,51707,303138087,7,0,1,7680,16,10323614656
11992,303090060,216049,303306109,5,0,0,1024,11,5085262146
11993,303095030,46283,303141313,3,0,1,5120,0,77013919
11994,303097550,284865,303382415,3,0,0,223744,0,10152531898
11995,303111010,35449,303146459,2,0,1,8192,11,8816336249
11996,303116950,30815,303147765,5,0,1,2048,11,5787610056
11997,303161730,145895,303307625,5,0,0,4608,11,2235416840
11998,303187350,313126,303500476,1,0,0,34816,6,1597012932
11999,303229090,12737,303241827,5,0,1,24576,11,7725939391
12000,303236740,15579,303252319,7,0,1,30208,16,547677830
12001,303265670,7706,303273376,7,0,1,8192,16,4319599446
12002,303324320,96657,303420977,3,0,1,48640,0,10288848083
12003,303327460,96743,303424203,3,0,1,5120,0,8397344753
12004,303351550,77799,303429349,5,0,1,8192,11,674821664
12005,303365050,165276,303530326,5,0,0,5632,11,2123868399
12006,303367600,239196,303606796,3,0,0,58880,0,460442598
12007,303370650,262065,303632715,1,0,0,84992,6,1813045766
12008,303396129,130019,303526148,4,0,0,2048,4,4297476245
12009,303455789,100351,303556140,4,0,0,3584,4,7920319572
12010,303485020,175806,303660826,3,0,0,92160,0,5140250409
12011,303525320,135856,303661176,6,0,0,1024,3,8373361052
12012,303586480,1518,303587998,3,0,1,1536,0,1074566900
12013,303592220,68629,303660849,7,0,1,2048,16,6220059888
12014,303619970,48521,303668491,7,0,1,8192,16,1398625286
12015,303694820,6488,303701308,3,0,1,15872,0,9894829869
12016,303710860,69612,303780472,5,0,0,2560,11,4432012364
12017,303731210,64496,303795706,5,0,0,1024,11,3424364930
12018,303745070,5802,303750872,3,0,1,6144,0,572286901
12019,303809170,4374,303813544,7,0,1,4608,16,7925098396
12020,303819010,159993,303979003,1,0,0,74752,6,277519343
12021,303820800,4937,303825737,7,0,1,12800,16,4034511030
12022,303864380,21658,303886038,7,0,1,35328,16,1406716323
12023,303915660,14117,303929777,3,0,1,24064,0,8133762620
12024,303919790,10653,303930443,3,0,1,1024,0,8081293719
12025,303989420,12825,304002245,5,0,1,21504,11,9724449982
12026,304028020,85539,304113559,6,0,0,3072,3,4299865626
12027,304092620,3898,304096518,5,0,1,4096,11,3309283324
12028,304104360,6754,304111114,3,0,1,7168,0,3797007018
12029,304124280,43904,304168184,6,0,0,512,3,2393275471
12030,304152180,22174,304174354,1,0,1,36352,6,5217442640
12031,304178700,1994,304180694,3,0,1,2048,0,8052359619
12032,304192590,15321,304207911,1,0,1,29696,6,5867911619
12033,304242790,103220,304346010,3,0,0,38912,0,3824971925
12034,304262230,129812,304392042,1,0,0,28672,6,1724974774
12035,304316070,5454,304321524,5,0,1,13824,11,7455951692
12036,304354250,55748,304409998,6,0,0,4096,3,1866289936
12037,304369980,4374,304374354,3,0,1,4608,0,250764257
12038,304377260,191143,304568403,3,0,0,134656,0,8288298064
12039,304415240,3387,304418627,8,0,1,9728,6,5052743836
12040,304431529,169720,304601249,4,0,0,8704,4,3191926246
12041,304438070,3387,304441457,5,0,1,9728,11,121593054
12042,304438690,24309,304462999,1,0,1,35840,6,4773088223
12043,304446930,18975,304465905,3,0,1,4608,0,191150655
12044,304465160,141868,304607028,6,0,0,512,3,663201312
12045,304471310,101331,304572641,6,0,0,512,3,6138944229
12046,304481580,89643,304571223,6,0,0,512,3,273920774
12047,304495580,164299,304659879,6,0,0,3584,3,4119312399
12048,304559340,15543,304574883,5,0,1,15872,11,1504992900
12049,304593520,7744,304601264,7,0,1,13312,16,9304770767
12050,304607250,485843,305093093,3,0,0,437760,0,4434976812
12051,304624980,5454,304630434,7,0,1,13824,16,7038893634
12052,304650890,6278,304657168,8,0,1,6656,6,9616760282
12053,304655280,3194,304658474,5,0,1,2048,11,1503514510
12054,304677709,209733,304887442,4,0,0,2048,4,6481986700
12055,304680070,10757,304690827,7,0,1,17408,16,376998272
12056,304680740,12033,304692773,1,0,1,3072,6,5362275787
12057,304686930,8109,304695039,8,0,1,3584,6,1820596638
12058,304703410,4850,304708260,3,0,1,5120,0,8567123925
12059,304709020,3422,304712442,8,0,1,3584,6,8645737307
12060,304725210,6754,304731964,1,0,1,7168,6,10192657340
12061,304729049,147644,304876693,4,0,0,512,4,3051515750
12062,304764170,386995,305151165,3,0,0,74240,0,8661530357
12063,304768410,566,304768976,7,0,1,512,16,6392997142
12064,304768870,14117,304782987,5,0,1,24064,11,8078132106
12065,304775940,468291,305244231,6,0,0,512,3,4413274445
12066,304785460,4850,304790310,7,0,1,5120,16,10385941232
12067,304797600,13253,304810853,1,0,1,25600,6,10050874742
12068,304800820,597999,305398819,1,0,0,152576,6,6148727114
12069,304803420,438854,305242274,1,0,0,233472,6,8027995119
12070,304806050,5469,304811519,1,0,1,11264,6,7827823600
12071,304846440,14117,304860557,3,0,1,24064,0,2332547471
12072,304850710,501598,305352308,3,0,0,205312,0,4249698888
12073,304969280,140276,305109556,7,0,1,31744,16,6361957331
12074,305025020,218853,305243873,6,0,0,5120,3,1987787497
12075,305031890,78537,305110427,7,0,1,12288,16,3872704523
12076,305051650,63283,305114933,1,0,1,7168,6,10541079991
12077,305055000,60804,305115804,4,0,1,12288,4,2687463886
12078,305086079,157981,305244060,4,0,0,512,4,1401938454
12079,305119580,566,305120146,3,0,1,512,0,9305412066
12080,305179250,71719,305250969,9,0,1,7168,17,4471563463
12081,305194840,283973,305478813,5,0,0,512,11,3238519312
12082,305197410,60263,305257673,5,0,1,18432,11,3818905634
12083,305214620,269215,305483835,5,0,0,9216,11,10480017856
12084,305220580,258054,305478634,1,0,0,134144,6,6063915780
12085,305241280,157882,305399162,5,0,0,1024,11,7815514922
12086,305298380,182632,305481012,6,0,0,7168,3,3714138461
12087,305304620,95067,305399687,1,0,1,512,6,3507683752
12088,305374141,37873,305412014,0,0,1,24576,6,5183064783
12089,305423240,61726,305484966,6,0,0,3584,3,6702297880
12090,305435071,566,305435637,0,0,1,512,6,5130047144
12091,305441880,47935,305489815,8,0,1,14848,6,4622736126
12092,305465220,209738,305674958,1,0,0,116736,6,6218736845
12093,305472580,20646,305493226,7,0,1,5120,16,2666543689
12094,305485640,27465,305513105,8,0,1,41472,6,244454193
12095,305494440,210698,305705138,1,0,0,40960,6,4761616211
12096,305495350,424013,305919363,1,0,0,129024,6,8042945035
12097,305499370,251956,305751326,3,0,0,31232,0,1386814023
12098,305568650,372746,305941396,6,0,0,6144,3,215593149
12099,305578870,441198,306020068,3,0,0,190464,0,8839601023
12100,305595970,234681,305830651,5,0,0,512,11,8064476970
12101,305622220,504414,306126634,1,0,0,307200,6,1480171853
12102,305633380,41609,305674989,8,0,1,53760,6,2228706737
12103,305659250,20662,305679912,8,0,1,12800,6,9372542012
12104,305662910,477520,306140430,1,0,0,40448,6,3099974631
12105,305698320,14040,305712360,8,0,1,7680,6,10707187833
12106,305708080,419193,306127273,5,0,0,2048,11,6049719133
12107,305744710,397333,306142043,6,0,0,2048,3,7988822751
12108,305748040,380036,306128076,5,0,0,2560,11,6679631860
12109,305808581,54270,305862851,0,0,1,92160,6,5169228746
12110,305859120,12825,305871945,7,0,1,21504,16,6618702399
12111,305859740,18314,305878054,8,0,1,20480,6,384944327
12112,305863321,56057,305919378,0,0,1,3584,6,10196257334
12113,305873290,148252,306021542,5,0,0,1536,11,1821989132
12114,305894749,126286,306021035,4,0,0,3072,4,1908388781
12115,305915390,5047,305920437,7,0,1,1024,16,2432931810
12116,305941080,2778,305943858,7,0,1,2560,16,6767703474
12117,305962760,63211,306025971,8,0,1,11776,6,2275374669
12118,305973320,154771,306128091,8,0,1,43008,6,10609363733
12119,305980109,162901,306143010,4,0,0,3072,4,3810895469
12120,305989560,177281,306166841,5,0,0,3072,11,9731973151
12121,305991660,149744,306141404,5,0,0,3072,11,282296094
12122,306000590,139855,306140445,9,0,1,7680,17,8112332570
12123,306016960,383041,306400001,3,0,0,163328,0,1121000822
12124,306037840,112359,306150199,8,0,1,7680,6,4083702313
12125,306083130,234045,306317175,6,0,0,2560,3,4231692097
12126,306108220,61268,306169488,7,0,1,43520,16,9619096734
12127,306119090,366890,306485980,1,0,0,104960,6,3030203787
12128,306136809,265406,306402215,4,0,0,4096,4,2981375851
12129,306162740,21658,306184398,7,0,1,35328,16,9432310379
12130,306177401,7765,306185166,0,0,1,11776,6,7608543907
12131,306308410,92542,306400952,6,0,0,3072,3,1807650294
12132,306321181,5712,306326893,0,0,1,14336,6,3104959479
12133,306331630,250696,306582326,3,0,0,13312,0,8895791569
12134,306333010,101833,306434843,3,0,0,19456,0,8392832852
12135,306334200,224681,306558881,3,0,0,33280,0,3406191541
12136,306336349,99601,306435950,4,0,0,3584,4,1125783550
12137,306403330,114988,306518318,3,0,0,59392,0,666676264
12138,306408190,77969,306486159,5,0,0,512,11,9579370019
12139,306446260,328603,306774863,3,0,0,92160,0,5915107959
12140,306464191,24797,306488988,0,0,1,8704,6,5450575118
12141,306543630,203138,306746768,1,0,0,141312,6,2246597687
12142,306586720,11274,306597994,4,0,1,18432,4,3737814100
12143,306589760,8695,306598455,4,0,1,10240,4,5319912834
12144,306594090,44405,306638495,8,0,1,70144,6,8687875906
12145,306624239,73953,306698192,4,0,0,2048,4,6571993740
12146,306655880,6754,306662634,8,0,1,7168,6,765506761
12147,306673730,197721,306871451,5,0,0,3072,11,5984189145
12148,306673809,101225,306775034,4,0,0,512,4,10153486676
12149,306691950,262535,306954485,3,0,0,47616,0,5799301513
12150,306805930,1994,306807924,8,0,1,2048,6,7532237951
12151,306961089,45596,307006685,4,0,0,1024,4,1411707766
12152,306995850,43904,307039754,5,0,0,512,11,9384063009
12153,307091579,79436,307171015,4,0,0,11264,4,10363564865
12154,307128349,113204,307241553,4,0,0,71680,4,10611882930
12155,307175600,3422,307179022,8,0,1,3584,6,9823596892
12156,307208049,117948,307325997,4,0,0,49152,4,824086290
12157,307212870,2946,307215816,8,0,1,3072,6,116253581
12158,307274110,13083,307287193,8,0,1,22016,6,5213809410
12159,307357860,148243,307506103,1,0,0,14336,6,1922009339
12160,307391240,97448,307488688,5,0,0,19968,11,477146656
12161,307393200,188908,307582108,3,0,0,58880,0,1359376444
12162,307404100,55960,307460060,6,0,0,3072,3,5580813792
12163,307412900,211766,307624666,3,0,0,87040,0,1313004323
12164,307449840,373510,307823350,5,0,0,300032,11,7360903201
12165,307478350,377003,307855353,3,0,0,104960,0,389899356
12166,307479630,12995,307492625,4,0,1,25088,4,9438900193
12167,307494120,371091,307865211,1,0,0,5120,6,10111964741
12168,307599180,264456,307863636,3,0,0,27136,0,2763133053
12169,307676309,205461,307881770,4,0,0,54272,4,9327072439
12170,307732610,182906,307915516,2,0,1,58880,11,6401970989
12171,307783010,190405,307973415,5,0,0,55296,11,7035863381
12172,307806610,109572,307916182,2,0,1,1024,11,572427888
12173,307864840,251106,308115946,1,0,0,132608,6,5475846786
12174,308003530,138014,308141544,1,0,0,59392,6,1216881540
12175,308071940,44021,308115961,2,0,1,26624,11,6948871119
12176,308086250,55309,308141559,8,0,1,25600,6,5206608328
12177,308088880,175122,308264002,5,0,0,105984,11,9214233094
12178,308092700,48874,308141574,4,0,1,18944,4,2618613835
12179,308148070,4420,308152490,8,0,1,11776,6,6514242310
12180,308223920,40097,308264017,2,0,1,19968,11,5351533544
12181,308241919,438887,308680806,4,0,0,257024,4,4806910614
12182,308242960,33811,308276771,8,0,1,24576,6,2650478038
12183,308314860,101660,308416520,1,0,0,33792,6,7231516779
12184,308336250,147893,308484143,6,0,0,2048,3,2124151529
12185,308351240,100568,308451808,2,0,0,30208,11,6175129901
12186,308366530,1042,308367572,8,0,1,1024,6,3670686064
12187,308432120,325025,308757145,5,0,0,10240,11,8304129850
12188,308451370,21571,308472941,8,0,1,34304,6,7289490709
12189,308475580,269039,308744619,5,0,0,160256,11,9834954560
12190,308510700,34108,308544808,8,0,1,56320,6,3976690742
12191,308542090,4344,308546434,8,0,1,2560,6,292877260
12192,308567080,406769,308973849,6,0,0,3584,3,10087160774
12193,308587040,166970,308754010,1,0,0,30720,6,1266809090
12194,308595130,326165,308921295,1,0,0,218624,6,6471664726
12195,308605380,350453,308955833,1,0,0,113152,6,3671148620
12196,308638120,334622,308972742,3,0,0,39424,0,5447751849
12197,308676880,309663,308986543,5,0,0,34816,11,2906808939
12198,308702270,56352,308758622,8,0,1,1536,6,4613708172
12199,308728900,53859,308782759,2,0,1,45568,11,9920551705
12200,308755870,201070,308956940,6,0,0,3584,3,2015443478
12201,308757320,29305,308786625,2,0,1,6144,11,1371604658
12202,308767239,193476,308960715,4,0,0,12288,4,4557477199
12203,308846080,75238,308921318,8,0,1,21504,6,4907554444
12204,308857480,116400,308973880,2,0,1,23552,11,390732419
12205,308861600,112295,308973895,2,0,1,11264,11,9423523424
12206,308871489,341593,309213082,4,0,0,230912,4,7724905202
12207,308877240,376088,309253328,5,0,0,49152,11,9277905204
12208,308963520,135252,309098772,3,0,0,12800,0,5163317958
12209,308969710,16848,308986558,2,0,1,8192,11,2553523201
12210,308999650,7230,309006880,2,0,1,7680,11,405665441
12211,309026060,3645,309029705,2,0,1,10240,11,8223071894
12212,309076970,22433,309099403,8,0,1,36864,6,3390312737
12213,309117040,3904,309120944,2,0,1,10752,11,5173572547
12214,309181650,34888,309216538,8,0,1,3584,6,131956959
12215,309190940,217631,309408571,3,0,0,23552,0,5179436668
12216,309199200,149591,309348791,8,0,1,218624,6,5843668303
12217,309281039,383167,309664206,4,0,0,143872,4,9667797114
12218,309390770,5802,309396572,2,0,1,6144,11,4409923797
12219,309401300,263857,309665157,6,0,0,3072,3,3855239549
12220,309462630,255379,309718009,5,0,0,35840,11,5394776504
12221,309472360,7230,309479590,2,0,1,7680,11,6688791777
12222,309483040,236076,309719116,1,0,0,3584,6,9382740188
12223,309546220,184330,309730550,1,0,0,14848,6,5560010142
12224,309554489,262143,309816632,4,0,0,185344,4,2639488830
12225,309560490,104838,309665328,1,0,0,512,6,3061516957
12226,309566000,1518,309567518,2,0,1,1536,11,10310653480
12227,309599310,95545,309694855,8,0,1,159232,6,6771386617
12228,309725220,93479,309818699,5,0,0,6656,11,936039120
12229,309748230,286622,310034852,3,0,0,27648,0,9854882002
12230,309759549,252011,310011560,4,0,0,72192,4,9176647905
12231,309773200,344534,310117734,8,0,0,141312,6,8912002029
12232,309786330,520542,310306872,3,0,0,211456,0,2378835278
12233,309788140,622562,310410702,1,0,0,203264,6,1129702250
12234,309892860,708440,310601300,3,0,0,122880,0,4098148692
12235,309905480,521205,310426685,8,0,0,52224,6,5092829650
12236,309942219,570059,310512278,4,0,0,162304,4,5124168772
12237,309974330,337237,310311567,3,0,0,15360,0,6637450613
12238,310077860,551231,310629091,8,0,0,91136,6,6163120297
12239,310090670,900090,310990760,3,0,0,289792,0,2615710572
12240,310106050,429904,310535954,6,0,0,3072,3,6600664631
12241,310162420,637607,310800027,6,0,0,2560,3,3350819490
12242,310170929,957476,311128405,4,0,0,322048,4,996178377
12243,310205000,307325,310512325,8,0,1,492032,6,6141072097
12244,310240160,389102,310629262,6,0,0,512,3,887265849
12245,310241230,1203522,311444752,5,0,0,153600,11,7633658139
12246,310244380,1031319,311275699,5,0,0,214528,11,5473569419
12247,310250320,1378117,311628437,3,0,0,91136,0,276193908
12248,310273860,447141,310721001,5,0,0,8192,11,827132303
12249,310300320,840588,311140908,1,0,0,40960,6,709594183
12250,310301960,1221743,311523703,1,0,0,259072,6,10321829609
12251,310474160,369894,310844054,6,0,0,2048,3,8519264330
12252,310493940,502385,310996325,8,0,0,5120,6,2784927292
12253,310494550,1278683,311773233,5,0,0,57344,11,6031627665
12254,310506410,635761,311142171,6,0,0,4096,3,1917146888
12255,310521189,1079434,311600623,4,0,0,165376,4,5646270252
12256,310525230,639264,311164494,3,0,0,73216,0,9734460234
12257,310542709,1212858,311755567,4,0,0,36864,4,4221535799
12258,310546780,1370655,311917435,5,0,0,226304,11,2154801676
12259,310568190,1422782,311990972,5,0,0,122880,11,10113125279
12260,310609200,557844,311167044,6,0,0,3584,3,3657922165
12261,310640379,1199706,311840085,4,0,0,114176,4,1549916777
12262,310686289,1244013,311930302,4,0,0,39936,4,8484215347
12263,310690170,475743,311165913,8,0,0,4608,6,2127140412
12264,310709030,825319,311534349,6,0,0,1024,3,5930546354
12265,310734470,1009850,311744320,1,0,0,265728,6,3760104521
12266,310740659,253088,310993747,4,0,0,9728,4,8603421800
12267,310744650,2470,310747120,4,0,1,2560,4,5847364244
12268,310754910,6754,310761664,4,0,1,7168,4,9075086623
12269,310772680,1068536,311841216,6,0,0,3584,3,1181199658
12270,310782039,1237340,312019379,4,0,0,93184,4,8247384054
12271,310815940,960912,311776852,3,0,0,11776,0,2369355870
12272,310823340,932406,311755746,6,0,0,512,3,7720222065
12273,310863300,939931,311803231,3,0,0,86528,0,6505847956
12274,310865099,668923,311534022,4,0,0,33792,4,10601372953
12275,310886440,1199185,312085625,5,0,0,29696,11,8273196917
12276,310948210,1277413,312225623,5,0,0,69632,11,1347611480
12277,310993770,1165274,312159044,6,0,0,1536,3,747263628
12278,311015910,566,311016476,4,0,1,512,4,9677124315
12279,311040380,160804,311201184,4,0,1,61952,4,10229399877
12280,311132800,709070,311841870,6,0,0,1536,3,5113888812
12281,311134770,783349,311918119,6,0,0,2048,3,7582168911
12282,311152480,989335,312141815,8,0,0,184320,6,4716619239
12283,311177640,1100153,312277793,5,0,0,65024,11,4788823640
12284,311238861,39717,311278578,0,0,1,8704,6,6360052303
12285,311259640,693877,311953517,8,0,0,41472,6,502824404
12286,311290629,1120099,312410728,4,0,0,80384,4,3482506277
12287,311290720,879998,312170718,8,0,0,3072,6,8288146477
12288,311307420,3387,311310807,4,0,1,9728,4,3775167535
12289,311317560,702006,312019566,6,0,0,512,3,6245536192
12290,311369380,20366,311389746,4,0,1,32768,4,2094808990
12291,311414680,390602,311805282,6,0,0,6656,3,10294430533
12292,311492150,986157,312478307,3,0,0,24576,0,6935185009
12293,311519891,21229,311541120,0,0,1,7168,6,2939568637
12294,311548181,52457,311600638,0,0,1,25088,6,6935317761
12295,311566470,453267,312019737,3,0,0,512,0,7744972560
12296,311580030,806183,312386213,8,0,0,224256,6,870677763
12297,311615160,226227,311841387,6,0,0,512,3,5579953603
12298,311670930,1222913,312893843,8,0,0,413184,6,8141977180
12299,311693730,464823,312158553,5,0,0,51712,11,1868622180
12300,311699940,217510,311917450,8,0,1,70144,6,7332262769
12301,311751580,165885,311917465,5,0,1,8192,11,5222245366
12302,311770430,455536,312225966,6,0,0,1024,3,2700678578
12303,311771400,146080,311917480,7,0,1,1024,16,6128831081
12304,311792900,349882,312142782,3,0,0,3072,0,7762834531
12305,311794270,271209,312065479,3,0,0,1536,0,5425404424
12306,311905480,276146,312181626,3,0,0,3584,0,7067384877
12307,311971070,1086366,313057436,8,0,0,236032,6,2236402505
12308,311975250,718865,312694115,1,0,0,56832,6,2231529776
12309,312036170,7230,312043400,3,0,1,7680,0,9940070869
12310,312074340,11300,312085640,4,0,1,3584,4,1490135047
12311,312088660,672547,312761207,5,0,0,115712,11,2692536186
12312,312092171,82153,312174324,0,0,1,29696,6,8590603511
12313,312136970,350343,312487313,6,0,0,512,3,5747321866
12314,312165690,498041,312663731,5,0,0,17408,11,4435103242
12315,312197690,764579,312962269,8,0,0,45056,6,10057864566
12316,312204510,29146,312233656,4,0,1,8192,4,9032418602
12317,312213681,26814,312240495,0,0,1,19968,6,1413854865
12318,312223770,218905,312442675,6,0,0,3072,3,3661119407
12319,312230990,11771,312242761,6,0,1,3584,3,700723521
12320,312233430,281852,312515282,8,0,0,17408,6,9916028199
12321,312278500,3904,312282404,4,0,1,10752,4,5077669626
12322,312283300,5326,312288626,6,0,1,5632,3,1101747103
12323,312286619,658196,312944815,4,0,0,101888,4,4368122952
12324,312303081,2946,312306027,0,0,1,3072,6,3139255493
12325,312357290,66392,312423682,6,0,1,25088,3,4427276601
12326,312423310,5454,312428764,7,0,1,13824,16,5560839639
12327,312436670,22950,312459620,4,0,1,37888,4,2412630133
12328,312456000,675370,313131370,8,0,0,182272,6,1555802873
12329,312477700,132991,312610691,5,0,0,1024,11,3812072727
12330,312482780,430976,312913756,1,0,0,53248,6,1830730152
12331,312503360,394141,312897501,1,0,0,11776,6,10552887999
12332,312509030,771479,313280509,1,0,0,150528,6,6921898993
12333,312522960,552835,313075795,6,0,0,59904,3,1046356503
12334,312537170,697437,313234607,1,0,0,222208,6,5075487200
12335,312539310,6754,312546064,6,0,1,7168,3,5813617619
12336,312606680,7230,312613910,4,0,1,7680,4,1849011455
12337,312614361,10241,312624602,0,0,1,16384,6,3975020394
12338,312618240,14245,312632485,4,0,1,22016,4,6668164998
12339,312695980,470908,313166888,6,0,0,109056,3,4568946903
12340,312703870,5712,312709582,6,0,1,14336,3,1579424665
12341,312722530,568150,313290680,6,0,0,33280,3,10334984577
12342,312743850,150008,312893858,5,0,1,7680,11,7320564566
12343,312772671,189613,312962284,0,0,1,11264,6,6314340081
12344,312776400,1063019,313839419,1,0,0,64512,6,4062524757
12345,312777310,184989,312962299,7,0,1,4096,16,2570447001
12346,312785370,176944,312962314,4,0,1,16384,4,3771589838
12347,312788120,175001,312963121,7,0,1,5120,16,8220753382
12348,312795200,170507,312965707,5,0,1,4096,11,9260325481
12349,312796210,187748,312983958,5,0,1,48128,11,7029989755
12350,312831750,152554,312984304,6,0,1,512,3,3197912117
12351,312832100,557567,313389667,8,0,0,73216,6,6096812881
12352,312832250,225225,313057475,6,0,1,18432,3,1272244510
12353,312833400,661215,313494615,5,0,0,70656,11,7839443641
12354,312843530,213960,313057490,7,0,1,12288,16,4715289971
12355,312849949,484529,313334478,4,0,0,56832,4,764598470
12356,312873410,184095,313057505,2,0,1,12288,11,5568432725
12357,312881780,435343,313317123,8,0,0,86528,6,1161198131
12358,312895440,1038481,313933921,1,0,0,55296,6,631122475
12359,312927909,960673,313888582,4,0,0,161280,4,638804019
12360,312927989,426505,313354494,4,0,0,20992,4,8790427093
12361,312935330,122190,313057520,5,0,1,5120,11,2067899551
12362,312969390,495458,313464848,8,0,0,56320,6,6187400443
12363,312973690,814102,313787792,5,0,0,90624,11,8401398362
12364,312988921,142472,313131393,0,0,1,12800,6,8375756706
12365,312994959,505763,313500722,4,0,0,19968,4,824936279
12366,313037450,585876,313623326,5,0,0,106496,11,307177634
12367,313058329,984583,314042912,4,0,0,290816,4,10419439857
12368,313077530,651606,313729136,8,0,0,134656,6,9487870308
12369,313109310,840694,313950004,8,0,0,52736,6,7030090927
12370,313133320,101302,313234622,6,0,1,7168,3,8953915297
12371,313158480,176045,313334525,1,0,1,3072,6,4146020185
12372,313174660,159896,313334556,7,0,1,11264,16,9583395538
12373,313181520,1044476,314225996,1,0,0,77824,6,132000123
12374,313214401,143244,313357645,0,0,1,38400,6,8162058686
12375,313220700,852709,314073409,5,0,0,97792,11,9957168326
12376,313230310,128820,313359130,9,0,1,15360,17,3010796928
12377,313240100,579648,313819748,8,0,0,77312,6,4737152280
12378,313243020,121295,313364315,4,0,1,24576,4,9827388279
12379,313249950,654903,313904853,1,0,0,53248,6,7553970907
12380,313265611,99063,313364674,0,0,1,9728,6,2271368975
12381,313275410,901990,314177400,1,0,0,53760,6,8225699710
12382,313277990,831540,314109530,1,0,0,60416,6,1016922710
12383,313317069,1132685,314449754,4,0,0,95232,4,4639894371
12384,313318269,878361,314196630,4,0,0,58880,4,8669154249
12385,313328710,60980,313389690,9,0,1,33792,17,5228915643
12386,313360709,728783,314089492,4,0,0,52736,4,9518058501
12387,313371790,20815,313392605,1,0,1,3072,6,9878462058
12388,313393170,566,313393736,9,0,1,512,17,10650756711
12389,313408470,5802,313414272,7,0,1,6144,16,4316190672
12390,313442950,3387,313446337,9,0,1,9728,17,7469896092
12391,313446770,18101,313464871,9,0,1,29184,17,1796668667
12392,313448690,22904,313471594,1,0,1,7168,6,1367490632
12393,313479321,24782,313504103,0,0,1,3584,6,7589083471
12394,313506690,985828,314492518,6,0,0,100352,3,2564836097
12395,313506800,6754,313513554,6,0,1,7168,3,6084074748
12396,313525170,14117,313539287,9,0,1,24064,17,622354380
12397,313530480,9473,313539953,1,0,1,1024,6,5037227217
12398,313558550,485040,314043590,3,0,0,2048,0,4380748415
12399,313562990,6278,313569268,5,0,1,6656,11,5355360534
12400,313563950,194854,313758804,3,0,0,1536,0,10085904175
12401,313576570,4850,313581420,7,0,1,5120,16,8099255424
12402,313588520,502555,314091075,5,0,0,5120,11,115497256
12403,313590620,1123158,314713778,8,0,0,142848,6,3497774746
12404,313591001,37710,313628711,0,0,1,5632,6,3567308294
12405,313608590,20787,313629377,9,0,1,1024,17,887893975
12406,313610720,48284,313659004,6,0,1,55296,3,10461507032
12407,313619560,985754,314605314,8,0,0,132608,6,7789360803
12408,313636610,23060,313659670,6,0,1,1024,3,6108588972
12409,313642470,18071,313660541,1,0,1,12288,6,2856329805
12410,313646901,35054,313681955,0,0,1,61440,6,3213420062
12411,313647300,38201,313685501,6,0,1,5632,3,161158819
12412,313655050,30912,313685962,1,0,1,10240,6,5316489558
12413,313665810,1323656,314989466,6,0,0,253952,3,73519118
12414,313667160,20108,313687268,6,0,1,2048,3,10204657605
12415,313707420,33516,313740936,5,0,1,19456,11,2103856895
12416,313718421,23181,313741602,0,0,1,1024,6,3682925781
12417,313768020,24138,313792158,1,0,1,4608,6,1217154241
12418,313788250,1272055,315060305,1,0,0,232448,6,10011769644
12419,313821730,463064,314284794,6,0,0,25600,3,10570170139
12420,313832210,76500,313908710,9,0,1,4096,17,4227151648
12421,313858110,603817,314461927,8,0,0,3072,6,7455537512
12422,313863010,1401280,315264290,1,0,0,311808,6,5104779023
12423,313874990,36007,313910997,9,0,1,12800,17,7227624994
12424,313904630,11075,313915705,1,0,1,14336,6,9180277839
12425,313931990,470945,314402935,3,0,0,1024,0,3075579256
12426,313945850,97077,314042927,7,0,1,8192,16,9387686059
12427,313972520,161431,314133951,2,0,1,44032,11,5085512838
12428,313972550,164307,314136857,5,0,1,4608,11,10391839175
12429,313975620,161583,314137203,6,0,1,512,3,4584955340
12430,313984100,154179,314138279,2,0,1,13312,11,2103370607
12431,314007650,137145,314144795,7,0,1,23040,16,5018221952
12432,314012990,133111,314146101,5,0,1,2048,11,5066919056
12433,314013671,134696,314148367,0,0,1,3584,6,8451831633
12434,314024420,129746,314154166,7,0,1,27648,16,6972381910
12435,314025470,151945,314177415,2,0,1,48128,11,6955975705
12436,314041320,155341,314196661,2,0,1,59392,11,6134245559
12437,314041509,1101811,315143320,4,0,0,272384,4,1444627287
12438,314091599,1454661,315546260,4,0,0,525312,4,1371409448
12439,314138930,87081,314226011,5,0,1,6656,11,4925018482
12440,314149800,1511389,315661189,8,0,0,104960,6,8494529395
12441,314150069,1472506,315622575,4,0,0,250368,4,10347202204
12442,314179220,46814,314226034,6,0,1,43008,3,135551466
12443,314197890,1425480,315623370,3,0,0,2560,0,567551682
12444,314200130,1784513,315984643,6,0,0,109568,3,10279446575
12445,314236580,5802,314242382,3,0,1,6144,0,10371074
12446,314237121,5722,314242843,0,0,1,10240,6,7938408947
12447,314304780,1994,314306774,7,0,1,2048,16,1594810128
12448,314341560,1518,314343078,6,0,1,1536,3,2266119862
12449,314349320,1936325,316285645,5,0,0,385536,11,10425574894
12450,314354890,790365,315145255,5,0,0,6144,11,6047384653
12451,314355810,4420,314360230,7,0,1,11776,16,6900355203
12452,314378040,11791,314389831,7,0,1,19456,16,3818936405
12453,314396640,1227221,315623861,3,0,0,1536,0,2953948842
12454,314404601,6229,314410830,0,0,1,15360,6,1485833406
12455,314406020,8160,314414180,2,0,1,5120,11,4622396053
12456,314417640,889640,315307280,1,0,0,1536,6,3554163873
12457,314431060,1338020,315769080,1,0,0,2048,6,5503626809
12458,314441400,10365,314451765,2,0,1,2048,11,1150267801
12459,314457630,1298345,315755975,1,0,0,214528,6,8282239022
12460,314476000,1381666,315857666,1,0,0,122368,6,5578041241
12461,314487230,10155,314497385,5,0,1,5120,11,5468961685
12462,314510070,14287,314524357,9,0,1,27648,17,8839516486
12463,314536829,1887098,316423927,4,0,0,354304,4,6177111627
12464,314552440,4679,314557119,9,0,1,12288,17,4415474495
12465,314585380,23365,314608745,1,0,1,3584,6,8866784052
12466,314601060,11326,314612386,6,0,1,14848,3,6979576528
12467,314624981,1994,314626975,0,0,1,2048,6,5653996823
12468,314633930,5326,314639256,2,0,1,5632,11,4228963318
12469,314648460,11016,314659476,2,0,1,17920,11,6685176257
12470,314656440,1969027,316625467,5,0,0,146432,11,6604090883
12471,314673070,47045,314720115,7,0,1,6656,16,4425392086
12472,314680050,57731,314737781,6,0,1,35840,3,6638184224
12473,314688230,65034,314753264,2,0,1,48128,11,1030702090
12474,314703951,54702,314758653,0,0,1,17408,6,3860802699
12475,314769570,5326,314774896,7,0,1,5632,16,4215369890
12476,314788770,978772,315767542,6,0,0,37888,3,4585445974
12477,314802410,1767499,316569909,6,0,0,472064,3,5701056527
12478,314806761,4850,314811611,0,0,1,5120,6,5247931477
12479,314846790,1463230,316310020,5,0,0,79872,11,9464110313
12480,314850250,1575796,316426046,3,0,0,4608,0,9757619107
12481,314862380,31266,314893646,7,0,1,50688,16,2569363648
12482,314862620,941807,315804427,8,0,0,2048,6,9354174568
12483,314984051,161291,315145342,0,0,1,1024,6,1862822491
12484,314996111,150746,315146857,0,0,1,1536,6,443081321
12485,315000710,155854,315156564,7,0,1,17408,16,5891653161
12486,315012801,152855,315165656,0,0,1,28160,6,10645681946
12487,315030630,1280388,316311018,5,0,0,2048,11,5488682554
12488,315032680,231633,315264313,1,0,1,18432,6,8686665588
12489,315087350,1490406,316577756,8,0,0,25600,6,9037722417
12490,315118110,1901461,317019571,1,0,0,583168,6,2984125118
12491,315123750,140578,315264328,7,0,1,3072,16,7177280051
12492,315133590,130753,315264343,6,0,1,7168,3,1850996138
12493,315140790,123568,315264358,5,0,1,1536,11,1512186645
12494,315147380,1694484,316841864,6,0,0,99328,3,6685343837
12495,315169500,100418,315269918,9,0,1,5632,17,3666901134
12496,315180510,98535,315279045,7,0,1,24576,16,6620899964
12497,315181020,1468360,316649380,8,0,0,78336,6,7746212917
12498,315187750,108908,315296658,1,0,1,40960,6,7664038199
12499,315189450,108514,315297964,7,0,1,2048,16,411590470
12500,315197770,104700,315302470,1,0,1,7168,6,4803830557
12501,315204580,103791,315308371,7,0,1,19968,16,8179137867
12502,315207940,101097,315309037,9,0,1,11264,17,5854441006
12503,315214140,96843,315310983,6,0,1,3072,3,5444966232
12504,315215030,108497,315323527,7,0,1,39936,16,825722351
12505,315238030,90643,315328673,7,0,1,8192,16,3450337185
12506,315256070,78812,315334882,9,0,1,29696,17,743757691
12507,315264521,71232,315335753,0,0,1,12288,6,3334810231
12508,315280300,1461614,316741914,3,0,0,1024,0,9292978719
12509,315291900,1784899,317076799,6,0,0,142336,3,10212617617
12510,315318911,16996,315335907,0,0,1,8704,6,3831033379
12511,315354641,2470,315357111,0,0,1,2560,6,489501363
12512,315389890,1735752,317125642,1,0,0,160256,6,5856821451
12513,315403890,1393742,316797632,6,0,0,23552,3,6971076981
12514,315455250,205954,315661204,1,0,1,13824,6,4421840967
12515,315517360,792987,316310347,3,0,0,1024,0,7834573755
12516,315519840,141379,315661219,1,0,1,14848,6,1301793689
12517,315529590,1777152,317306742,8,0,0,45568,6,3467254516
12518,315568040,93194,315661234,1,0,1,25088,6,3250453213
12519,315589140,1444244,317033384,6,0,0,33280,3,8830319332
12520,315597970,1091876,316689846,3,0,0,1536,0,1598173224
12521,315608440,1048329,316656769,3,0,0,1024,0,7172457846
12522,315620260,40989,315661249,9,0,1,28672,17,1124721895
12523,315620910,51913,315672823,7,0,1,42496,16,4046578969
12524,315621720,1921323,317543043,6,0,0,97792,3,7526016979
12525,315629550,43939,315673489,7,0,1,11264,16,9854911355
12526,315639730,1526410,317166140,6,0,0,127488,3,5959679597
12527,315640260,38414,315678674,7,0,1,16384,16,2223104706
12528,315678630,1520586,317199216,5,0,0,107520,11,3186959445
12529,315730100,847999,316578099,8,0,0,1024,6,5670073600
12530,315773089,2090025,317863114,4,0,0,356864,4,1629681794
12531,315801680,10499,315812179,7,0,1,16896,16,10363624380
12532,315851200,10832,315862032,1,0,1,4608,6,9342863994
12533,315892900,1549790,317442690,6,0,0,113664,3,2079534074
12534,315907430,4162,315911592,1,0,1,11264,6,8674678153
12535,315925911,3422,315929333,0,0,1,3584,6,6528825204
12536,315934150,2470,315936620,1,0,1,2560,6,9357873764
12537,315960160,37745,315997905,6,0,1,25600,3,9617395100
12538,315978720,2319034,318297754,1,0,0,561152,6,764617935
12539,316011620,16096,316027716,9,0,1,31232,17,3616921641
12540,316076120,1897268,317973388,5,0,0,52224,11,1721628960
12541,316076631,2946,316079577,0,0,1,3072,6,1517845472
12542,316086571,11791,316098362,0,0,1,19456,6,3489610342
12543,316132080,1794364,317926444,1,0,0,69632,6,9074532882
12544,316136910,2467237,318604147,6,0,0,274944,3,3088447559
12545,316149500,275066,316424566,3,0,0,2048,0,10323632457
12546,316157240,1994,316159234,1,0,1,2048,6,4845039441
12547,316190860,1705855,317896715,6,0,0,68608,3,7614405101
12548,316203520,818250,317021770,6,0,0,7168,3,9343966211
12549,316215680,208901,316424581,6,0,1,6656,3,4691615714
12550,316243800,180804,316424604,1,0,1,7680,6,6756129727
12551,316264790,159829,316424619,7,0,1,15360,16,2428196553
12552,316268580,2076362,318344942,6,0,0,144896,3,8046417414
12553,316271640,1418532,317690172,6,0,0,16896,3,6893114328
12554,316294260,2330329,318624589,1,0,0,9728,6,4819451772
12555,316301819,2198561,318500380,4,0,0,506880,4,488713503
12556,316314230,2440857,318755087,1,0,0,219648,6,4788758459
12557,316354600,2714294,319068894,1,0,0,238592,6,6328976478
12558,316369650,1505975,317875625,1,0,0,40960,6,7245934493
12559,316370810,254672,316625482,1,0,1,32768,6,9339503268
12560,316421810,1453986,317875796,3,0,0,512,0,9839151876
12561,316444190,1506155,317950345,8,0,0,69120,6,9788255358
12562,316451880,173617,316625497,1,0,1,14848,6,29677423
12563,316467920,1614551,318082471,3,0,0,2560,0,401455358
12564,316499410,149993,316649403,1,0,1,28672,6,9885908306
12565,316512170,511027,317023197,1,0,0,4608,6,846492329
12566,316522129,1990169,318512298,4,0,0,36864,4,7968868988
12567,316539200,110218,316649418,1,0,1,13312,6,7427143695
12568,316562810,1783083,318345893,3,0,0,3072,0,5965335995
12569,316566100,1954245,318520345,1,0,0,23040,6,5012125879
12570,316591400,58646,316650046,6,0,1,512,3,8287735381
12571,316603200,563127,317166327,1,0,0,512,6,1259434997
12572,316623220,2660810,319284030,5,0,0,193536,11,2118286713
12573,316630880,28997,316659877,1,0,1,16384,6,5381143496
12574,316645100,2003068,318648168,8,0,0,77312,6,74197877
12575,316653739,1954347,318608086,4,0,0,12800,4,3644179617
12576,316662020,2638919,319300939,6,0,0,12288,3,9768165851
12577,316664159,2468737,319132896,4,0,0,81920,4,8000030331
12578,316675849,2004657,318680506,4,0,0,75776,4,8770670101
12579,316690330,6754,316697084,6,0,1,7168,3,1534678207
12580,316700280,2803980,319504260,6,0,0,189440,3,3841675079
12581,316706020,1807267,318513287,3,0,0,512,0,1772626161
12582,316710400,6488,316716888,6,0,1,15872,3,2859461475
12583,316711780,5454,316717234,6,0,1,512,3,229001140
12584,316716810,1904785,318621595,8,0,0,30720,6,9843576556
12585,316735429,2111686,318847115,4,0,0,194048,4,3095308225
12586,316768440,5802,316774242,6,0,1,6144,3,5213232347
12587,316785290,1315804,318101094,1,0,0,1536,6,6339929018
12588,316824020,303261,317127281,8,0,0,5120,6,10318186853
12589,316864720,456604,317321324,1,0,0,2560,6,1694348380
12590,316876560,289798,317166358,6,0,1,16384,3,6214914142
12591,316886200,280173,317166373,6,0,1,11776,3,2921087384
12592,316907600,1392384,318299984,3,0,0,5632,0,8694293766
12593,316932190,1366047,318298237,1,0,0,1536,6,5712560982
12594,316956090,210298,317166388,6,0,1,3584,3,10140989618
12595,316961940,204463,317166403,9,0,1,19968,17,4186186530
12596,316966870,199556,317166426,6,0,1,4608,3,53905047
12597,316967720,198721,317166441,1,0,1,19456,6,9135373893
12598,317021660,177571,317199231,7,0,1,5632,16,10610261278
12599,317052970,490400,317543370,3,0,0,1024,0,9318257959
12600,317101289,1510868,318612157,4,0,0,13312,4,2505371122
12601,317103390,242412,317345802,1,0,0,1536,6,10148023638
12602,317121090,2268526,319389616,6,0,0,91136,3,4680865909
12603,317132969,769416,317902385,4,0,0,9728,4,5407993217
12604,317203880,1308433,318512313,8,0,1,381440,6,3587779924
12605,317210420,1302890,318513310,7,0,1,8192,16,7507249193
12606,317238500,1281860,318520360,5,0,1,19968,11,6017151677
12607,317248900,2267707,319516607,5,0,0,40448,11,8264190691
12608,317319050,1293122,318612172,5,0,1,25600,11,1007723271
12609,317332860,1288750,318621610,1,0,1,18432,6,2805152060
12610,317352450,2049389,319401839,8,0,0,39936,6,1822242589
12611,317362090,685712,318047802,3,0,0,3072,0,7733432753
12612,317363830,1284353,318648183,6,0,1,11264,3,263717914
12613,317384130,3033691,320417821,8,0,1,216576,6,8801319576
12614,317385830,3036177,320422007,6,0,1,6656,3,221445310
12615,317455581,2985775,320441356,0,0,1,3584,6,4564803631
12616,317466941,2979907,320446848,0,0,1,17920,6,7549953369
12617,317485150,2073443,319558593,3,0,0,1536,0,9790474895
12618,317542810,970306,318513116,3,0,0,2560,0,8855706324
12619,317577880,3175199,320753079,8,0,1,61952,6,5459949074
12620,317595100,3157994,320753094,7,0,1,1536,16,8090857995
12621,317608360,3144944,320753304,1,0,1,6144,6,123681300
12622,317631140,3136234,320767374,7,0,1,16896,16,10044796527
12623,317635390,1119868,318755258,1,0,0,512,6,5543022702
12624,317668360,3409533,321077893,8,0,1,139776,6,10643914507
12625,317673220,2179944,319853164,6,0,0,157696,3,1325150782
12626,317708490,1652844,319361334,8,0,0,198144,6,5366075758
12627,317729039,1704405,319433444,4,0,0,31232,4,6742357165
12628,317763600,737419,318501019,3,0,0,2048,0,7847058870
12629,317811580,3511492,321323072,7,0,1,70656,16,1122527286
12630,317875281,3447822,321323103,0,0,1,27648,6,217910160
12631,317879270,3852931,321732201,8,0,1,280576,6,3264241952
12632,317882340,1541565,319423905,5,0,0,71168,11,6217108046
12633,317988680,3878468,321867148,7,0,1,26112,16,1703114986
12634,317992980,307799,318300779,1,0,0,2560,6,1422163161
12635,318040380,828972,318869352,5,0,0,13312,11,10351613784
12636,318050430,3867779,321918209,1,0,1,14336,6,8898105918
12637,318075680,4262272,322337952,7,0,1,2560,16,4496559491
12638,318106470,1659441,319765911,6,0,0,40448,3,5971365748
12639,318120830,1618828,319739658,6,0,0,360448,3,3972316181
12640,318126550,4212273,322338823,6,0,1,12288,3,9417437218
12641,318159700,1791530,319951230,5,0,0,202752,11,10012391352
12642,318162260,1059496,319221756,5,0,0,131072,11,848217184
12643,318211670,1888225,320099895,6,0,0,110080,3,2314381133
12644,318221420,2037658,320259078,6,0,0,408064,3,3434599550
12645,318248890,696493,318945383,8,0,0,13824,6,3208572424
12646,318262190,1357818,319620008,8,0,0,54272,6,9497229566
12647,318298290,2029198,320327488,3,0,0,4608,0,3072533470
12648,318300020,1766296,320066316,6,0,0,209920,3,9791449260
12649,318331190,821260,319152450,1,0,0,1024,6,9642304581
12650,318335499,961673,319297172,4,0,0,30720,4,1667394679
12651,318345930,4155466,322501396,8,0,1,5120,6,3528793266
12652,318367590,4634278,323001868,8,0,1,89600,6,1776424625
12653,318404249,1921804,320326053,4,0,0,99840,4,3282367550
12654,318411170,950647,319361817,1,0,0,1536,6,4098273321
12655,318440380,4836090,323276470,6,0,1,3072,3,6030966945
12656,318459190,4817295,323276485,7,0,1,1536,16,2854115843
12657,318506370,439184,318945554,1,0,0,512,6,7745420352
12658,318539430,748367,319287797,6,0,0,12288,3,6270490855
12659,318548599,1717054,320265653,4,0,0,21504,4,1129019859
12660,318567080,1032832,319599912,5,0,0,49152,11,3878482351
12661,318601890,4674610,323276500,7,0,1,10240,16,2410948948
12662,318622070,602977,319225047,6,0,0,10752,3,9774757903
12663,318629430,4647101,323276531,7,0,1,23040,16,8139725079
12664,318644940,2035679,320680619,5,0,0,348160,11,8453450411
12665,318654420,7589622,326244042,8,0,1,211968,6,9557730046
12666,318668640,1071969,319740609,3,0,0,3072,0,7194273692
12667,318686700,8775622,327462322,8,0,1,238080,6,1372590254
12668,318731200,8731145,327462345,6,0,1,3072,3,8958230565
12669,318741230,8919303,327660533,8,0,1,120320,6,5825068619
12670,318760580,8933843,327694423,7,0,1,11264,16,2437476690
12671,318764620,637554,319402174,3,0,0,1024,0,79995094
12672,318815110,805069,319620179,1,0,0,512,6,7166057297
12673,318860499,1892557,320753056,4,0,0,235008,4,8469217893
12674,318882880,1006559,319889439,8,0,0,71680,6,10155475017
12675,318917670,835902,319753572,8,0,0,42496,6,9294676924
12676,318967789,1957865,320925654,4,0,0,216064,4,7385717879
12677,319001240,8693198,327694438,6,0,1,18944,3,10555932180
12678,319022429,2036946,321059375,4,0,0,198144,4,2217377503
12679,319022620,8933381,327956001,8,0,1,189952,6,10595530569
12680,319026140,8929876,327956016,7,0,1,1024,16,7812210487
12681,319026710,924691,319951401,3,0,0,512,0,3709304055
12682,319035350,1646087,320681437,1,0,0,2048,6,7183221145
12683,319049780,716458,319766238,1,0,0,1024,6,7320342877
12684,319071460,8884571,327956031,8,0,1,14336,6,4265420248
12685,319091180,9463673,328554853,7,0,1,39424,16,7391892032
12686,319150060,2172973,321323033,8,0,0,216064,6,3359303462
12687,319159080,9505613,328664693,6,0,1,12800,3,2731161067
12688,319214990,10250370,329465360,8,0,1,41472,6,8087385005
12689,319243330,10222045,329465375,7,0,1,13312,16,7294056817
12690,319254820,10387240,329642060,7,0,1,25088,16,1357578029
12691,319271570,524144,319795714,1,0,0,512,6,2685221720
12692,319295300,10408590,329703890,6,0,1,13312,3,9665385545
12693,319305069,1640108,320945177,4,0,0,64000,4,7491471633
12694,319319051,10388621,329707672,0,0,1,7680,6,3879146348
12695,319348690,1225826,320574516,5,0,0,199680,11,9968757993
12696,319382970,10325631,329708601,6,0,1,45568,3,2756344656
12697,319398080,10446045,329844125,6,0,1,5632,3,3285466895
12698,319434060,10410080,329844140,2,0,1,3072,11,3135205106
12699,319436240,561351,319997591,3,0,0,2560,0,9423382407
12700,319452970,10391185,329844155,2,0,1,3584,11,8318996566
12701,319490560,1356499,320847059,6,0,0,70656,3,6674861746
12702,319506710,1261303,320768013,1,0,0,2048,6,10535238456
12703,319520920,10409104,329930024,7,0,1,7680,16,2152011798
12704,319528680,10418706,329947386,9,0,1,4096,17,9711140298
12705,319554720,10773067,330327787,8,0,1,150016,6,2894641985
12706,319555750,1211609,320767359,6,0,0,46080,3,7638942895
12707,319591939,1840948,321432887,4,0,0,312832,4,9940479158
12708,319592850,10734952,330327802,7,0,1,8704,16,43250924
12709,319606760,12673573,332280333,8,0,1,380928,6,9895789502
12710,319644610,12635746,332280356,6,0,1,14336,3,1362225393
12711,319684270,1767905,321452175,6,0,0,29696,3,8410805991
12712,319728019,547501,320275520,4,0,0,32256,4,1151985025
12713,319731310,12646146,332377456,6,0,1,4608,3,5799596097
12714,319791780,1940398,321732178,5,0,0,268800,11,5688633379
12715,319817630,1944686,321762316,8,0,0,38912,6,6815517092
12716,319949540,1019536,320969076,3,0,0,1024,0,5583055947
12717,319992880,1261483,321254363,6,0,0,280576,3,6117555924
12718,320003580,821319,320824899,6,0,0,51200,3,2219052344
12719,320024160,729105,320753265,1,0,0,512,6,1737884082
12720,320032529,2173967,322206496,4,0,0,148480,4,4810891223
12721,320051510,1949024,322000534,5,0,0,159232,11,5738599656
12722,320057829,907019,320964848,4,0,0,64512,4,4410758622
12723,320100490,977348,321077838,6,0,0,60416,3,1708799887
12724,320131010,311207,320442217,6,0,0,2048,3,5338544725
12725,320140080,540710,320680790,3,0,0,512,0,6904002466
12726,320168440,922526,321090966,6,0,0,34816,3,4424490358
12727,320184931,12192711,332377642,0,0,1,1536,6,6656543545
12728,320197700,12179957,332377657,2,0,1,16896,11,7788377107
12729,320223529,1296447,321519976,4,0,0,128000,4,9511402392
12730,320223691,12153981,332377672,0,0,1,2048,6,2209019097
12731,320248150,1079804,321327954,6,0,0,15872,3,1653595104
12732,320255980,12203637,332459617,8,0,1,39936,6,1906251532
12733,320257520,1215574,321473094,5,0,0,68608,11,7663650046
12734,320270320,986866,321257186,5,0,0,9216,11,10389371719
12735,320281230,12246407,332527637,8,0,1,49664,6,7520903817
12736,320283560,1158257,321441817,6,0,0,28672,3,2099075873
12737,320297690,12229962,332527652,6,0,1,2560,3,2735522792
12738,320319590,12245974,332565564,9,0,1,10752,17,2171151054
12739,320360460,12216446,332576906,6,0,1,30720,3,4731803313
12740,320366470,1107287,321473757,1,0,0,2048,6,1191692868
12741,320369230,12931386,333300616,8,0,1,347136,6,2993701052
12742,320456650,1938504,322395154,6,0,0,181760,3,3763236856
12743,320470590,12834558,333305148,6,0,1,7168,3,1151980661
12744,320490420,12985712,333476132,8,0,1,73216,6,9656622030
12745,320501950,12986412,333488362,6,0,1,19456,3,10469828726
12746,320506180,829901,321336081,6,0,0,26624,3,539830810
12747,320556490,1030968,321587458,5,0,0,20992,11,1742537208
12748,320626410,12946395,333572805,8,0,1,33280,6,5665784005
12749,320655990,1905965,322561955,8,0,0,198656,6,9631215251
12750,320682140,856899,321539039,5,0,0,62464,11,8807481126
12751,320697749,1047044,321744793,4,0,0,39424,4,7172687046
12752,320822610,514898,321337508,3,0,0,4608,0,4660539363
12753,320864350,12819926,333684276,2,0,1,49664,11,3349535221
12754,320991819,1031818,322023637,4,0,0,70144,4,6559451326
12755,321003020,12722575,333725595,6,0,1,24576,3,3389023886
12756,321021180,12807577,333828757,6,0,1,16896,3,1759566825
12757,321037410,543629,321581039,8,0,0,34304,6,2473588559
12758,321043260,584195,321627455,8,0,0,27136,6,6159227461
12759,321045470,13287208,334332678,8,0,1,204288,6,9431681791
12760,321055300,13282884,334338184,6,0,1,5120,3,9653382248
12761,321065330,13272869,334338199,2,0,1,8704,11,1293853335
12762,321091440,351656,321443096,1,0,0,4096,6,5184294077
12763,321135240,13252260,334387500,8,0,1,141312,6,3649181980
12764,321143390,289668,321433058,1,0,0,512,6,4590544677
12765,321157250,716865,321874115,6,0,0,7680,3,3085727549
12766,321172170,1732114,322904284,5,0,0,246272,11,9367423341
12767,321175640,1419013,322594653,3,0,0,3584,0,8783884820
12768,321215140,13220060,334435200,6,0,1,28160,3,6548687643
12769,321216620,13261674,334478294,8,0,1,17920,6,9909847935
12770,321273330,971554,322244884,8,0,0,113152,6,8306239265
12771,321304450,13173859,334478309,2,0,1,512,11,749522002
12772,321317810,1170546,322488356,6,0,0,169984,3,3646615996
12773,321320570,1681283,323001853,8,0,0,235520,6,4361506116
12774,321327700,1108849,322436549,8,0,0,133632,6,6746053542
12775,321337990,1155389,322493379,5,0,0,16384,11,6711968745
12776,321358030,1143343,322501373,1,0,0,2560,6,489046126
12777,321378740,1897715,323276455,8,0,0,354304,6,4099165779
12778,321424030,13054302,334478332,2,0,1,55808,11,101838844
12779,321451130,1142384,322593514,5,0,0,103424,11,3890736280
12780,321460900,1703469,323164369,6,0,0,25600,3,8255312043
12781,321476870,13001477,334478347,6,0,1,512,3,5684572865
12782,321504200,12974162,334478362,6,0,1,6144,3,5657496239
12783,321573570,1339816,322913386,1,0,0,2048,6,6714725656
12784,321597290,462847,322060137,3,0,0,1024,0,3363989111
12785,321600690,899880,322500570,6,0,0,23552,3,3406945313
12786,321608160,12870217,334478377,8,0,1,14336,6,6079558079
12787,321651820,1651134,323302954,5,0,0,25600,11,9796785323
12788,321710040,2005853,323715893,5,0,0,89088,11,4305808048
12789,321733650,956692,322690342,8,0,0,94720,6,2501279920
12790,321795350,12683042,334478392,6,0,1,5120,3,10175114939
12791,321831490,1935282,323766772,5,0,0,166912,11,9573938642
12792,321842050,2243329,324085379,5,0,0,589824,11,2818766523
12793,321899810,1463556,323363366,6,0,0,133120,3,2567650103
12794,321915810,1980998,323896808,3,0,0,10240,0,9539488487
12795,321921720,12556687,334478407,6,0,1,3072,3,10645746804
12796,321928400,12656847,334585247,6,0,1,77824,3,8566069932
12797,321929679,2259266,324188945,4,0,0,263168,4,6642176576
12798,321937130,1517593,323454723,8,0,0,116224,6,6325256889
12799,321968970,12616337,334585307,2,0,1,5120,11,9613801110
12800,321978620,12972330,334950950,8,0,1,184832,6,104054597
12801,321990340,759886,322750226,3,0,0,2560,0,10664622998
12802,322005380,13014015,335019395,8,0,1,97792,6,6438632669
12803,322009900,13012081,335021981,2,0,1,4096,11,8733138565
12804,322023759,888972,322912731,4,0,0,27648,4,2040847389
12805,322089210,2407190,324496400,3,0,0,184832,0,7392226017
12806,322097400,1269921,323367321,5,0,0,12800,11,10572331229
12807,322115460,12932264,335047724,1,0,1,23040,6,3439390424
12808,322137530,13029226,335166756,6,0,1,47616,3,3291864211
12809,322159860,2576939,324736799,3,0,0,298496,0,7568669156
12810,322190030,2063070,324253100,6,0,0,113664,3,6364130757
12811,322265150,484281,322749431,3,0,0,46080,0,9720622428
12812,322334880,12831891,335166771,8,0,1,8704,6,381871429
12813,322341380,12825406,335166786,6,0,1,11264,3,4084998331
12814,322347150,12832778,335179928,2,0,1,10752,11,2807060213
12815,322357840,12822103,335179943,2,0,1,2560,11,6412245728
12816,322358500,2796733,325155233,6,0,0,347648,3,3683362003
12817,322370490,12809476,335179966,2,0,1,17408,11,5459053424
12818,322383590,12796391,335179981,6,0,1,14848,3,3943255005
12819,322425240,2014502,324439742,5,0,0,44544,11,6718735829
12820,322426950,12753046,335179996,2,0,1,8704,11,589647837
12821,322458400,12855170,335313570,1,0,1,9216,6,5225148327
12822,322474860,12838733,335313593,8,0,1,7168,6,3045599244
12823,322482920,2985639,325468559,5,0,0,44032,11,10140446111
12824,322496980,12816628,335313608,1,0,1,3072,6,3102691965
12825,322505110,12808513,335313623,1,0,1,8192,6,4103556690
12826,322548860,12764778,335313638,8,0,1,4096,6,10578619903
12827,322578140,2948523,325526663,1,0,0,3072,6,2527009240
12828,322600310,2178188,324778498,3,0,0,136704,0,2528168886
12829,322615910,12697743,335313653,8,0,1,8192,6,8241744079
12830,322691120,983949,323675069,6,0,0,23040,3,8733417471
12831,322694370,1391688,324086058,8,0,0,1024,6,2090332513
12832,322712850,2601074,325313924,3,0,0,520704,0,335597010
12833,322788270,1429393,324217663,1,0,0,7168,6,9191877133
12834,322854710,12458958,335313668,1,0,1,13312,6,651180640
12835,322868760,12444923,335313683,1,0,1,8192,6,722880239
12836,322875009,1467036,324342045,4,0,0,8192,4,1518756946
12837,322886290,12439287,335325577,2,0,1,19456,11,6330507771
12838,322886790,2496140,325382930,8,0,0,116224,6,9550361232
12839,322898220,12427372,335325592,8,0,1,18432,6,2520192515
12840,322924480,1871061,324795541,8,0,0,55808,6,1438260227
12841,322924680,845235,323769915,6,0,0,10240,3,5355930039
12842,322938239,1678269,324616508,4,0,0,64000,4,573013971
12843,322948610,12376997,335325607,8,0,1,23552,6,9994782277
12844,322979720,596740,323576460,1,0,0,512,6,1548120939
12845,322995480,2435881,325431361,5,0,0,158720,11,4512210023
12846,323082200,1809326,324891526,5,0,0,43008,11,8786744332
12847,323119410,12247419,335366829,7,0,1,18432,16,2005286785
12848,323129540,1310529,324440069,1,0,0,1024,6,8790347888
12849,323133500,12235915,335369415,1,0,1,4096,6,7073971731
12850,323147080,12320324,335467404,7,0,1,13824,16,6320096040
12851,323149620,2376092,325525712,6,0,0,158720,3,5585171578
12852,323209550,2649266,325858816,8,0,0,359936,6,7000302292
12853,323214110,12253309,335467419,7,0,1,2048,16,4032927152
12854,323249520,12221829,335471349,7,0,1,26112,16,3596506740
12855,323258900,12256382,335515282,1,0,1,5120,6,9634168926
12856,323292280,1586127,324878407,8,0,0,33792,6,7989791242
12857,323305600,2310847,325616447,5,0,0,53248,11,10193006976
12858,323310410,12206178,335516588,1,0,1,2048,6,10221859333
12859,323313240,12295342,335608582,1,0,1,54272,6,9067410699
12860,323322569,971591,324294160,4,0,0,16384,4,5326759349
12861,323348880,12314219,335663099,7,0,1,5120,16,4517291194
12862,323349440,2752074,326101514,8,0,0,587264,6,8418494525
12863,323351080,12312992,335664072,4,0,1,12800,4,3104774392
12864,323359560,12328575,335688135,1,0,1,13312,6,1994617083
12865,323375309,3136686,326511995,4,0,0,16896,4,6137297863
12866,323429890,12267975,335697865,7,0,1,32768,16,10315210702
12867,323469590,12230472,335700062,4,0,1,22528,4,1937553704
12868,323474940,12330306,335805246,8,0,1,11776,6,3608498907
12869,323483430,3505105,326988535,5,0,0,499712,11,4631356256
12870,323495130,12310131,335805261,1,0,1,2560,6,6384213837
12871,323508720,12360851,335869571,7,0,1,36864,16,6496066687
12872,323549490,12320096,335869586,7,0,1,512,16,112596503
12873,323594120,619479,324213599,3,0,0,10240,0,3553725386
12874,323674200,2057391,325731591,8,0,0,216064,6,9562598572
12875,323690020,12179581,335869601,1,0,1,2560,6,1149644729
12876,323699050,12170566,335869616,7,0,1,32768,16,8416064580
12877,323720180,12149451,335869631,4,0,1,3072,4,4164578083
12878,323740130,12129524,335869654,4,0,1,32768,4,3604516984
12879,323750570,12119099,335869669,1,0,1,9216,6,261453499
12880,323761390,1693714,325455104,8,0,0,77824,6,1361048405
12881,323779400,2515085,326294485,3,0,0,165376,0,3849584286
12882,323781600,12088084,335869684,7,0,1,9728,16,2517928248
12883,323813090,758009,324571099,6,0,0,3072,3,5821680539
12884,323817340,2426687,326244027,8,0,0,282624,6,7793184803
12885,323837320,12032379,335869699,8,0,1,22016,6,10261498581
12886,323856570,12013144,335869714,7,0,1,14848,16,6610067520
12887,323899940,11969789,335869729,4,0,1,19968,4,2531408580
12888,323905990,1441505,325347495,6,0,0,110080,3,10476167680
12889,323979679,955764,324935443,4,0,0,87552,4,3524962848
12890,323986970,11882774,335869744,7,0,1,7168,16,9407869087
12891,324009460,11860307,335869767,7,0,1,28672,16,5911158191
12892,324030680,11839102,335869782,4,0,1,12288,4,4046382589
12893,324043560,11826237,335869797,1,0,1,15872,6,6424093073
12894,324050911,11818901,335869812,0,0,1,3072,6,2191711588
12895,324098350,2272426,326370776,5,0,0,53248,11,8945356426
12896,324113400,1363825,325477225,8,0,0,20480,6,3599752870
12897,324145160,11724667,335869827,7,0,1,34816,16,4002505361
12898,324150890,2007002,326157892,8,0,0,104960,6,2594229854
12899,324171460,2918809,327090269,6,0,0,179200,3,9759395762
12900,324174600,11699195,335873795,1,0,1,16896,6,8315400739
12901,324224290,11687433,335911723,7,0,1,32768,16,6953056950
12902,324261240,11655759,335916999,8,0,1,4608,6,870757008
12903,324264180,11656045,335920225,4,0,1,5120,4,5570946808
12904,324308520,11617517,335926037,7,0,1,9216,16,98158772
12905,324318700,2173570,326492270,6,0,0,244224,3,9220666866
12906,324335070,1330658,325665728,6,0,0,113152,3,1525455620
12907,324373190,11553833,335927023,8,0,1,1536,6,6987624657
12908,324395130,11534799,335929929,8,0,1,4608,6,5969946570
12909,324431919,2953293,327385212,4,0,0,728064,4,1255514922
12910,324434810,11536829,335971639,4,0,1,55296,4,2445821121
12911,324438220,508505,324946725,9,0,0,2048,17,6584036674
12912,324444050,1304264,325748314,9,0,0,54784,17,502735647
12913,324467420,1658469,326125889,8,0,0,79872,6,6995011085
12914,324479580,11500111,335979691,4,0,1,12800,4,4135336302
12915,324480050,11513198,335993248,4,0,1,29696,4,2812250608
12916,324517340,11479774,335997114,2,0,1,6144,11,2023386463
12917,324530930,11489909,336020839,7,0,1,33280,16,7381930581
12918,324549770,921160,325470930,1,0,0,7680,6,3948738064
12919,324560870,11470053,336030923,8,0,1,11264,6,1902301624
12920,324578140,11471032,336049172,2,0,1,7168,11,9459263929
12921,324591670,1786867,326378537,5,0,0,18432,11,1492950063
12922,324595380,1272913,325868293,3,0,0,25600,0,3103287806
12923,324595940,1758098,326354038,8,0,0,83456,6,7163813633
12924,324652880,11398878,336051758,2,0,1,4096,11,6562336545
12925,324656830,1898765,326555595,3,0,0,79872,0,1455344384
12926,324677510,11391070,336068580,4,0,1,21504,4,3126307031
12927,324730960,11338081,336069041,8,0,1,10240,6,5943795175
12928,324772380,2390985,327163365,8,0,0,104448,6,3120022208
12929,324781190,11300200,336081390,8,0,1,27648,6,3436171327
12930,324835940,2735736,327571676,3,0,0,181760,0,5777484576
12931,324839660,1455200,326294860,1,0,0,1024,6,10360495521
12932,324848140,11234223,336082363,8,0,1,12800,6,1258112443
12933,324850820,11233489,336084309,7,0,1,3072,16,623277658
12934,324870580,989671,325860251,1,0,0,4608,6,4406622642
12935,324899840,1930005,326829845,6,0,0,188928,3,924323373
12936,324928460,2765948,327694408,6,0,0,111104,3,8889035098
12937,325023070,726055,325749125,1,0,0,2560,6,1054953431
12938,325031790,11053185,336084975,2,0,1,11264,11,9671031268
12939,325053360,828415,325881775,1,0,0,1024,6,2759467695
12940,325054410,2742138,327796548,6,0,0,162816,3,6434215048
12941,325064850,1441974,326506824,6,0,0,24576,3,312838247
12942,325099969,1736287,326836256,4,0,0,20992,4,6995566358
12943,325100810,2811629,327912439,5,0,0,50688,11,1132758525
12944,325121450,11078919,336200369,7,0,1,55296,16,4233347607
12945,325145750,11070541,336216291,4,0,1,27648,4,5898365012
12946,325163520,11063273,336226793,8,0,1,29696,6,10135288022
12947,325173320,11095139,336268459,4,0,1,9216,4,883271129
12948,325191299,439310,325630609,4,0,0,1536,4,8821793049
12949,325210580,1824231,327034811,5,0,0,95744,11,70566862
12950,325223990,1298800,326522790,5,0,0,35328,11,2154628931
12951,325246190,1759410,327005600,6,0,0,17408,3,10098289752
12952,325274930,11008617,336283547,7,0,1,6144,16,9452151996
12953,325289150,1083249,326372399,1,0,0,5120,6,6364479524
12954,325297640,1030939,326328579,8,0,0,110592,6,1520330959
12955,325298030,10993915,336291945,2,0,1,22528,11,9798254681
12956,325313570,604199,325917769,1,0,0,4096,6,2860077581
12957,325316760,10978446,336295206,9,0,1,4096,17,711258034
12958,325326540,11001470,336328010,7,0,1,36352,16,5988947665
12959,325351581,11004465,336356046,0,0,1,22016,6,2230758552
12960,325355831,11058911,336414742,0,0,1,72704,6,3723180750
12961,325357080,2389821,327746901,5,0,0,172032,11,2860522853
12962,325359000,501470,325860470,3,0,0,512,0,5305378978
12963,325368910,2123722,327492632,3,0,0,99328,0,8184635554
12964,325370730,11109630,336480360,9,0,1,5120,17,684017627
12965,325370860,11109515,336480375,2,0,1,15360,11,3827085806
12966,325376630,11421420,336798050,8,0,1,11264,6,9321642222
12967,325377100,11513767,336890867,9,0,1,55808,17,3018651564
12968,325400480,11543644,336944124,7,0,1,15872,16,9728366275
12969,325430770,2031529,327462299,6,0,0,252928,3,8816155565
12970,325446410,1109824,326556234,1,0,0,2048,6,314916466
12971,325455610,898911,326354521,1,0,0,1536,6,1717731662
12972,325469800,11474339,336944139,9,0,1,1536,17,7222299473
12973,325505400,1530222,327035622,1,0,0,2560,6,2182776290
12974,325529200,11418544,336947744,4,0,1,21504,4,4659219657
12975,325547320,11402690,336950010,7,0,1,3584,16,9969009199
12976,325552650,11401226,336953876,7,0,1,6144,16,8551480641
12977,325571960,2059323,327631283,3,0,0,195584,0,4113519819
12978,325572000,11403571,336975571,9,0,1,1024,17,8706103290
12979,325604461,11387616,336992077,0,0,1,17920,6,7349142398
12980,325605510,2054960,327660470,3,0,0,95744,0,297147420
12981,325616430,11391549,337007979,4,0,1,26112,4,1398291868
12982,325621150,11418024,337039174,9,0,1,6656,17,4375629232
12983,325634931,11584964,337219895,0,0,1,24576,6,4782684588
12984,325642560,11599532,337242092,8,0,1,4096,6,3328007481
12985,325656160,11585971,337242131,9,0,1,41472,17,458649874
12986,325656201,11656193,337312394,0,0,1,39424,6,7693737706
12987,325729070,11583355,337312425,8,0,1,12288,6,1359978337
12988,325737330,2261351,327998681,3,0,0,134656,0,2727388452
12989,325750270,11562170,337312440,9,0,1,2560,17,5510308332
12990,325754611,11592341,337346952,0,0,1,21504,6,1700156428
12991,325767390,11627090,337394480,4,0,1,3072,4,472796540
12992,325802250,11596416,337398666,2,0,1,6656,11,3392157272
12993,325834549,664764,326499313,4,0,0,23040,4,10072376475
12994,325875670,497236,326372906,1,0,0,1536,6,1250889856
12995,325905549,1188019,327093568,4,0,0,10752,4,10435468234
12996,325905760,11497732,337403492,9,0,1,7680,17,1860095848
12997,325924610,2031368,327955978,8,0,0,142848,6,8423762090
12998,325928410,11478347,337406757,9,0,1,14336,17,1787589485
12999,325929440,11481823,337411263,8,0,1,7168,6,2672281572
13000,325954470,11458739,337413209,8,0,1,3072,6,4169372269
13001,325966160,11489469,337455629,4,0,1,29696,4,5205705013
13002,326000990,988504,326989494,5,0,0,3072,11,1442052889
13003,326046900,11409391,337456291,2,0,1,20480,11,3468991668
13004,326051411,11449053,337500464,0,0,1,3072,6,5101800690
13005,326060870,1455411,327516281,3,0,0,74752,0,8059451067
13006,326079110,2004474,328083584,3,0,0,278528,0,6631087503
13007,326156220,11346510,337502730,8,0,1,3584,6,9609283048
13008,326165840,11338836,337504676,4,0,1,25600,4,2637348203
13009,326190890,11448661,337639551,9,0,1,51200,17,9706179514
13010,326200260,1696688,327896948,3,0,0,35328,0,5102624311
13011,326205679,794602,327000281,4,0,0,35328,4,8303709803
13012,326249849,1615853,327865702,4,0,0,73216,4,1965996856
13013,326250480,11395163,337645643,8,0,1,7168,6,8087565078
13014,326301020,11350524,337651544,8,0,1,19968,6,6062369807
13015,326334959,1898612,328233571,4,0,0,166912,4,8200867689
13016,326337880,11368814,337706694,9,0,1,18432,17,376110935
13017,326338280,11386360,337724640,2,0,1,7168,11,1952160445
13018,326390040,11338906,337728946,9,0,1,21504,17,5514610343
13019,326416050,2085367,328501417,5,0,0,611328,11,209321721
13020,326456420,11279416,337735836,2,0,1,1024,11,181376734
13021,326465960,2048919,328514879,5,0,0,39936,11,960910477
13022,326470090,1022737,327492827,1,0,0,512,6,7603592168
13023,326474450,11351590,337826040,9,0,1,24064,17,8343681184
13024,326556390,11269665,337826055,4,0,1,10752,4,229489695
13025,326562580,11263490,337826070,9,0,1,3072,17,554753836
13026,326582860,11243233,337826093,8,0,1,60416,6,9340467077
13027,326613710,11212398,337826108,9,0,1,2560,17,2497771417
13028,326682850,11159824,337842674,9,0,1,3072,17,6651240699
13029,326711110,11319560,338030670,4,0,1,19968,4,1968150680
13030,326716650,1455401,328172051,5,0,0,217600,11,3588734500
13031,326792760,11318841,338111601,8,0,1,14336,6,1809921518
13032,326821720,11358656,338180376,2,0,1,15872,11,954892430
13033,326904560,11325294,338229854,9,0,1,12800,17,9251580654
13034,326912460,1347541,328260001,1,0,0,512,6,1392623662
13035,326935600,11295637,338231237,4,0,1,14848,4,5123697242
13036,326951320,892059,327843379,3,0,0,153600,0,1998205423
13037,326969110,11345297,338314407,9,0,1,51712,17,9452530256
13038,327000990,492484,327493474,1,0,0,2048,6,10683663275
13039,327077390,808763,327886153,5,0,0,67072,11,3156721177
13040,327091060,11257687,338348747,2,0,1,5120,11,9376810647
13041,327130670,11252861,338383531,4,0,1,12288,4,10300564176
13042,327190110,11198913,338389023,8,0,1,17920,6,1225976346
13043,327283000,11224680,338507680,9,0,1,76800,17,9992737781
13044,327288680,1375982,328664662,5,0,0,59904,11,2251156907
13045,327304149,951933,328256082,4,0,0,73728,4,2655317709
13046,327335430,11172596,338508026,9,0,1,512,17,6270740668
13047,327373999,583639,327957638,4,0,0,5120,4,8388228340
13048,327419599,1135231,328554830,4,0,0,131072,4,1507344919
13049,327455030,11056862,338511892,9,0,1,6144,17,8060479142
13050,327490850,11117847,338608697,9,0,1,34304,17,3821688709
13051,327507879,1138476,328646355,4,0,0,260608,4,7510286409
13052,327512500,1445287,328957787,1,0,0,1536,6,2338932483
13053,327523050,11228285,338751335,4,0,1,18944,4,4818042473
13054,327529580,1282620,328812200,3,0,0,86016,0,3183606093
13055,327578570,513517,328092087,8,0,0,27648,6,3164065322
13056,327593540,2353831,329947371,5,0,0,56832,11,3306064218
13057,327647890,1425999,329073889,8,0,0,353280,6,7798472883
13058,327651150,1077881,328729031,5,0,0,170496,11,6350665989
13059,327658090,1300744,328958834,1,0,0,1536,6,740151498
13060,327682360,11128791,338811151,3,0,1,40448,0,7709194354
13061,327699140,11112026,338811166,8,0,1,12800,6,7388487683
13062,327759199,1882814,329642013,4,0,0,483840,4,609542522
13063,327764340,1701005,329465345,3,0,0,287744,0,3534237290
13064,327789699,777237,328566936,4,0,0,39424,4,4749399418
13065,327797330,11161302,338958632,3,0,1,50176,0,3557026980
13066,327827530,1294989,329122519,1,0,0,7680,6,1487216668
13067,327860210,1214030,329074240,1,0,0,1024,6,10674930668
13068,327893870,11145155,339039025,8,0,1,33280,6,9336723343
13069,327893930,952532,328846462,3,0,0,10752,0,3728438707
13070,327952220,11086828,339039048,9,0,1,15360,17,9493012042
13071,327955150,547538,328502688,1,0,0,4096,6,6220413700
13072,327988469,1715390,329703859,4,0,0,202752,4,3689015843
13073,327991980,11047083,339039063,3,0,1,5120,0,8340655435
13074,328029190,11059736,339088926,8,0,1,53248,6,2334662063
13075,328045710,11149812,339195522,3,0,1,8192,0,7598880175
13076,328049790,11145747,339195537,9,0,1,6144,17,6344634871
13077,328052869,1114291,329167160,4,0,0,3584,4,1883580881
13078,328054580,11140972,339195552,8,0,1,2560,6,7308906650
13079,328075800,11119767,339195567,2,0,1,12288,11,9896747728
13080,328097640,11097950,339195590,3,0,1,4608,0,8759985922
13081,328152930,11077790,339230720,8,0,1,15872,6,3176992706
13082,328161520,11069215,339230735,3,0,1,10752,0,3160980475
13083,328163390,11067368,339230758,3,0,1,1536,0,2149057165
13084,328171410,11132609,339304019,3,0,1,13312,0,5969861992
13085,328180990,1663096,329844086,3,0,0,427008,0,2292399518
13086,328196620,11107414,339304034,8,0,1,5632,6,2230689596
13087,328203910,1726091,329930001,8,0,0,260608,6,358761781
13088,328209190,1797678,330006868,8,0,0,194560,6,9259974995
13089,328321520,1853917,330175437,3,0,0,57344,0,114330089
13090,328343861,10960196,339304057,0,0,1,7168,6,9194332756
13091,328379330,10961729,339341059,8,0,1,15872,6,10174902602
13092,328411159,1083403,329494562,4,0,0,95744,4,3800186935
13093,328412140,11760983,340173123,4,0,1,9728,4,7900717456
13094,328428630,11883975,340312605,8,0,1,13312,6,1479815273
13095,328438350,1619952,330058302,5,0,0,165376,11,291140415
13096,328447510,11873277,340320787,8,0,1,12288,6,4676577516
13097,328484690,1753982,330238672,8,0,0,207360,6,1501369608
13098,328553300,1604103,330157403,8,0,0,292864,6,7141542464
13099,328556720,1874308,330431028,5,0,0,267776,11,3000848852
13100,328581940,1125717,329707657,3,0,0,12288,0,5324827169
13101,328613890,2012360,330626250,5,0,0,226816,11,2972438038
13102,328614100,11706702,340320802,9,0,1,11776,17,2796535167
13103,328639300,1822522,330461822,5,0,0,98816,11,1486957615
13104,328641920,12225204,340867124,8,0,1,12288,6,4914793154
13105,328750690,12116489,340867179,9,0,1,6656,17,9925975474
13106,328780310,12354104,341134414,5,0,1,27648,11,6882748748
13107,328816670,1511070,330327740,3,0,0,37376,0,7537635433
13108,328834500,12299929,341134429,9,0,1,7168,17,3187396600
13109,328838289,1934991,330773280,4,0,0,128512,4,9130716542
13110,328853190,12423480,341276670,8,0,1,3584,6,10729731708
13111,328858950,12417735,341276685,5,0,1,2048,11,4006262955
13112,328891350,12385350,341276700,8,0,1,2560,6,372114705
13113,328931610,12705689,341637299,5,0,1,57344,11,9521788099
13114,328961930,12676246,341638176,8,0,1,512,6,3584532710
13115,328986600,12654482,341641082,5,0,1,4608,11,3803576751
13116,328989550,12656358,341645908,9,0,1,7680,17,5397528133
13117,328991740,716323,329708063,1,0,0,1024,6,9073918621
13118,329011740,12669199,341680939,9,0,1,7168,17,2509622137
13119,329033630,12743035,341776665,5,0,1,14848,11,1016425913
13120,329107519,960565,330068084,4,0,0,31232,4,2116864060
13121,329159990,12618941,341778931,8,0,1,3584,6,1281608947
13122,329214929,1067462,330282391,4,0,0,143360,4,5632093476
13123,329233260,12642156,341875416,8,0,1,10240,6,130238922
13124,329283860,724015,330007875,5,0,0,3072,11,10064856360
13125,329286790,12867381,342154171,5,0,1,30720,11,5298483678
13126,329312310,13330777,342643087,9,0,1,4608,17,487559577
13127,329321320,387242,329708562,1,0,0,1536,6,3228803
13128,329340520,510062,329850582,8,0,0,20992,6,3213359087
13129,329359110,588447,329947557,1,0,0,512,6,10128315966
13130,329371820,966925,330338745,5,0,0,35840,11,1163274931
13131,329372180,1089845,330462025,5,0,0,512,11,7655986523
13132,329462880,1344779,330807659,1,0,0,4096,6,2276851459
13133,329465520,13238663,342704183,1,0,1,36864,6,6087848370
13134,329479401,13349165,342828566,0,0,1,19968,6,8126785970
13135,329510400,13318205,342828605,9,0,1,7680,17,1509412346
13136,329529310,773884,330303194,5,0,0,68096,11,9523861410
13137,329533140,1491634,331024774,5,0,0,434688,11,7874438326
13138,329553340,604554,330157894,5,0,0,1536,11,6413613960
13139,329553700,762613,330316313,8,0,0,43008,6,5384572675
13140,329555070,13273550,342828620,1,0,1,5632,6,10146916808
13141,329608350,13220285,342828635,5,0,1,512,11,10039709257
13142,329609980,448549,330058529,1,0,0,512,6,5703444749
13143,329616219,1669683,331285902,4,0,0,249856,4,7169123127
13144,329621970,1223551,330845521,1,0,0,4096,6,3653785948
13145,329641630,13254874,342896504,2,0,1,1536,11,9410016159
13146,329665010,13231509,342896519,9,0,1,8192,17,7894172539
13147,329686100,13219809,342905909,2,0,1,2048,11,8763141361
13148,329691170,13223942,342915112,5,0,1,40960,11,6323122205
13149,329722990,13205958,342928948,1,0,1,10240,6,3826259774
13150,329726470,13262161,342988631,7,0,1,18944,16,10432674838
13151,329742410,747585,330489995,5,0,0,47616,11,3654281703
13152,329753420,13477875,343231295,2,0,1,6656,11,8281194823
13153,329755420,13477821,343233241,9,0,1,3072,17,5315390918
13154,329766780,13558460,343325240,2,0,1,15360,11,3427123076
13155,329781270,1058029,330839299,8,0,0,26624,6,6652257736
13156,329809990,13551160,343361150,1,0,1,3584,6,5932071217
13157,329831620,1060671,330892291,3,0,0,59392,0,7507930817
13158,329850680,13510485,343361165,2,0,1,8704,11,5488967349
13159,329850840,13510380,343361220,7,0,1,9728,16,6377951248
13160,329861900,13499335,343361235,5,0,1,3072,11,5466729821
13161,329866720,13589281,343456001,2,0,1,47616,11,149960946
13162,329875580,13800361,343675941,1,0,1,32768,6,7746970028
13163,329876960,1163532,331040492,3,0,0,49664,0,6099912441
13164,329883830,13837010,343720840,2,0,1,12800,11,1205755520
13165,329887300,13833563,343720863,7,0,1,2560,16,4972724574
13166,329906460,13814418,343720878,1,0,1,15360,6,3438073650
13167,329917120,13952998,343870118,1,0,1,58368,6,965301512
13168,329938350,14199738,344138088,9,0,1,6144,17,2628814530
13169,329981860,1112829,331094689,8,0,0,173056,6,1622629972
13170,329996790,14229478,344226268,5,0,1,18944,11,5005741107
13171,330005920,1526744,331532664,3,0,0,357888,0,3890321957
13172,330006750,424917,330431667,1,0,0,2048,6,10194218384
13173,330023940,14211944,344235884,3,0,1,8192,0,4683257367
13174,330056030,14342932,344398962,1,0,1,40960,6,7098176240
13175,330066169,1055367,331121536,4,0,0,88064,4,2607901801
13176,330078890,1587638,331666528,3,0,0,67072,0,9402015365
13177,330083250,14316210,344399460,8,0,1,7680,6,2901899640
13178,330104330,14329876,344434206,7,0,1,2560,16,1267658208
13179,330194130,1611316,331805446,3,0,0,407040,0,3930107051
13180,330220730,14213491,344434221,9,0,1,8704,17,1032224073
13181,330221919,1703510,331925429,4,0,0,76288,4,8910792539
13182,330234350,1364824,331599174,3,0,0,216064,0,5036352864
13183,330237050,14423763,344660813,7,0,1,8704,16,9363426843
13184,330244520,14418559,344663079,8,0,1,3584,6,251680319
13185,330266590,14997439,345264029,5,0,1,25088,11,4924952013
13186,330267310,1634852,331902162,5,0,0,261632,11,4848271083
13187,330273160,752161,331025321,1,0,0,1536,6,4568383459
13188,330286550,15707843,345994393,7,0,1,12800,16,1937968232
13189,330369220,1681016,332050236,8,0,0,17408,6,10163139531
13190,330379260,15619959,345999219,7,0,1,7680,16,1537965924
13191,330394310,15664993,346059303,8,0,1,1024,6,8626753331
13192,330414860,748325,331163185,5,0,0,34304,11,4856050983
13193,330425560,15634307,346059867,9,0,1,10752,17,2456545486
13194,330431760,16508912,346940672,9,0,1,28672,17,6319253160
13195,330457760,1188293,331646053,3,0,0,153600,0,5870922258
13196,330488990,16451697,346940687,5,0,1,3072,11,9256932985
13197,330493750,16446952,346940702,7,0,1,7680,16,7723529886
13198,330495230,2016605,332511835,8,0,0,47616,6,5322591331
13199,330523230,1606110,332129340,5,0,0,115712,11,3613259812
13200,330534780,16519608,347054388,7,0,1,7168,16,7990166992
13201,330535450,1145953,331681403,5,0,0,48640,11,8583001336
13202,330544810,16509593,347054403,7,0,1,1024,16,8162486106
13203,330555260,1725058,332280318,3,0,0,163328,0,7027692694
13204,330566850,1624475,332191325,9,0,0,34304,17,9033037341
13205,330578780,16485013,347063793,2,0,1,6656,11,2171704423
13206,330607110,16456706,347063816,2,0,1,4096,11,5787532507
13207,330608250,16455581,347063831,8,0,1,1536,6,7080007858
13208,330613400,16590009,347203409,1,0,1,17920,6,8529549534
13209,330622090,16865660,347487750,1,0,1,66560,6,6152006353
13210,330635059,1834753,332469812,4,0,0,33280,4,2189420686
13211,330641290,16846483,347487773,2,0,1,9728,11,2294079357
13212,330642290,16899410,347541700,9,0,1,7680,17,8805788432
13213,330660470,16943036,347603506,1,0,1,7168,6,4337773782
13214,330704960,1753847,332458807,5,0,0,266240,11,1931050816
13215,330737430,17272416,348009846,8,0,1,51712,6,6177136731
13216,330754240,17255621,348009861,9,0,1,3072,17,9974055281
13217,330759100,17250776,348009876,1,0,1,5632,6,6344681016
13218,330790310,17219581,348009891,2,0,1,14848,11,2722844145
13219,330829290,17222692,348051982,7,0,1,11264,16,5008533931
13220,330834550,287781,331122331,1,0,0,2560,6,8623132437
13221,330851060,682243,331533303,1,0,0,2048,6,5657567088
13222,330851990,17345421,348197411,1,0,1,30720,6,1315678189
13223,330858600,17338834,348197434,9,0,1,2560,17,4811595789
13224,330859960,17642282,348502242,1,0,1,85504,6,6127718337
13225,330865030,17755708,348620738,2,0,1,9728,11,5415003370
13226,330869690,1311160,332180850,5,0,0,77824,11,1310518505
13227,330871990,17748803,348620793,8,0,1,11776,6,3366933723
13228,330908910,17773689,348682599,7,0,1,25088,16,2156055957
13229,330912120,17770494,348682614,2,0,1,4096,11,1594261388
13230,330923029,1604593,332527622,4,0,0,51712,4,9098491743
13231,330923740,1695897,332619637,8,0,0,133120,6,8198738486
13232,330936980,17745665,348682645,1,0,1,4096,6,6783828803
13233,330940201,17742459,348682660,0,0,1,5120,6,8075460012
13234,330953160,17868260,348821420,7,0,1,8704,16,6680995184
13235,330974420,1390971,332365391,3,0,0,279040,0,8553841813
13236,330986140,17835295,348821435,1,0,1,1024,6,10498358060
13237,331000191,17821259,348821450,0,0,1,12288,6,3284113853
13238,331146329,779622,331925951,4,0,0,512,4,10099504681
13239,331149580,17708934,348858514,9,0,1,7680,17,8813073902
13240,331155360,17703169,348858529,9,0,1,4096,17,4213779988
13241,331166050,1211383,332377433,1,0,0,3072,6,505900539
13242,331190730,17667814,348858544,1,0,1,4608,6,3068870036
13243,331251330,1500666,332751996,5,0,0,191488,11,13664273
13244,331264970,764550,332029520,8,0,0,54272,6,340276015
13245,331326020,1051607,332377627,1,0,0,512,6,3524224299
13246,331331040,18349269,349680309,1,0,1,216576,6,6010164383
13247,331363740,18316584,349680324,9,0,1,13824,17,4411435860
13248,331365370,1579942,332945312,5,0,0,238080,11,9527269552
13249,331382750,993732,332376482,3,0,0,36352,0,134895877
13250,331400590,18279757,349680347,9,0,1,512,17,4183231559
13251,331449449,707674,332157123,4,0,0,91136,4,7647502855
13252,331464320,18216042,349680362,8,0,1,10240,6,1273103815
13253,331470980,18328593,349799573,7,0,1,41984,16,9146625015
13254,331507660,18317220,349824880,2,0,1,19968,11,3367211135
13255,331513110,18850863,350363973,1,0,1,175616,6,658736334
13256,331538450,18825538,350363988,7,0,1,10752,16,1593113196
13257,331558940,366824,331925764,1,0,0,1024,6,7319747421
13258,331565620,19101854,350667474,1,0,1,22016,6,4707784967
13259,331574880,616780,332191660,1,0,0,1024,6,8578676657
13260,331597930,19207750,350805680,9,0,1,35840,17,2357863939
13261,331601661,19315129,350916790,0,0,1,10240,6,5659501264
13262,331609200,19307605,350916805,9,0,1,16896,17,4525617656
13263,331636010,19574751,351210761,1,0,1,24576,6,8834158263
13264,331706500,20108528,351815028,8,0,1,45568,6,4276821969
13265,331724230,20125627,351849857,9,0,1,7168,17,4604770814
13266,331748330,1032401,332780731,1,0,0,94208,6,1986118143
13267,331816080,643522,332459602,3,0,0,2560,0,4624126323
13268,331850620,20017663,351868283,1,0,1,17920,6,2760515501
13269,331874340,20036819,351911159,7,0,1,10752,16,3363631993
13270,331878770,1235979,333114749,1,0,0,226304,6,3146513007
13271,331942770,750867,332693637,1,0,0,4608,6,10429365748
13272,332009961,20076238,352086199,0,0,1,12288,6,8392656374
13273,332011770,21182384,353194154,7,0,1,39936,16,2950068242
13274,332045320,1103000,333148320,8,0,0,110080,6,4739456615
13275,332051989,640221,332692210,4,0,0,132608,4,9740350296
13276,332116000,864115,332980115,1,0,0,114176,6,9615427327
13277,332149510,21044659,353194169,3,0,1,14848,0,3038216514
13278,332228481,21244910,353473391,0,0,1,13824,6,6278942708
13279,332231769,296374,332528143,4,0,0,1536,4,9049116784
13280,332262540,931191,333193731,3,0,0,148992,0,7075424926
13281,332299150,21328726,353627876,7,0,1,20992,16,6649255413
13282,332320089,911893,333231982,4,0,0,125440,4,896317925
13283,332332720,21295171,353627891,7,0,1,4608,16,2483259390
13284,332333769,1247007,333580776,4,0,0,26112,4,335270689
13285,332355760,655578,333011338,8,0,0,102400,6,464315347
13286,332399990,1076127,333476117,8,0,0,351232,6,8859297426
13287,332502150,1117555,333619705,1,0,0,55808,6,8005273777
13288,332506889,1065901,333572790,4,0,0,191488,4,8373864713
13289,332518010,807023,333325033,1,0,0,18944,6,6810324784
13290,332658160,1104229,333762389,5,0,0,72192,11,4028816021
13291,332691740,20936166,353627906,7,0,1,4096,16,125960898
13292,332710570,20917359,353627929,7,0,1,9728,16,6375600627
13293,332832950,1083057,333916007,5,0,0,93184,11,5515740947
13294,332848080,836181,333684261,1,0,0,34304,6,1482339166
13295,332859640,20899264,353758904,9,0,1,34304,17,2956136604
13296,332879450,1470676,334350126,8,0,0,38912,6,9387074861
13297,332938890,20820029,353758919,9,0,1,6144,17,9960904690
13298,332962460,20796498,353758958,7,0,1,17408,16,441443088
13299,333005370,1218491,334223861,5,0,0,556032,11,7961620398
13300,333028610,459721,333488331,5,0,0,39936,11,9450275282
13301,333049400,765573,333814973,1,0,0,83456,6,6548844763
13302,333050580,814538,333865118,1,0,0,512,6,747776894
13303,333087930,20671059,353758989,9,0,1,36352,17,2718552559
13304,333114830,20644174,353759004,9,0,1,1536,17,2320286008
13305,333139270,20619749,353759019,2,0,1,2048,11,4645285361
13306,333149830,1182833,334332663,5,0,0,301568,11,319327328
13307,333198950,827790,334026740,3,0,0,66048,0,2775028592
13308,333231479,1319312,334550791,4,0,0,60416,4,5954321074
13309,333253840,20505202,353759042,7,0,1,4096,16,1360120684
13310,333285059,500000,333785059,4,0,0,32768,4,2108241917
13311,333289561,20469683,353759244,0,0,1,5120,6,7316171888
13312,333313850,1121335,334435185,8,0,0,155136,6,7199050757
13313,333362870,877878,334240748,8,0,0,55296,6,9720958283
13314,333382670,475249,333857919,5,0,0,13312,11,6024946517
13315,333394740,1223988,334618728,1,0,0,2560,6,7043610629
13316,333434570,20324689,353759259,8,0,1,10240,6,7193569375
13317,333465220,20358832,353824052,9,0,1,1024,17,4775434333
13318,333511920,20473053,353984973,7,0,1,34816,16,5877036578
13319,333618080,1116418,334734498,3,0,0,149504,0,4090133036
13320,333669620,668541,334338161,8,0,0,17920,6,579740253
13321,333742650,871266,334613916,8,0,0,5120,6,4790104926
13322,333775310,20281461,354056771,9,0,1,46592,17,6521786100
13323,333785100,1131925,334917025,8,0,0,94208,6,8653817056
13324,333785889,692390,334478279,4,0,0,141312,4,6111284788
13325,333867770,20189351,354057121,9,0,1,8192,17,7289054744
13326,333869840,20188738,354058578,9,0,1,18944,17,1159143581
13327,333895050,1241256,335136306,8,0,0,225792,6,6666921737
13328,333976420,778537,334754957,8,0,0,67072,6,894330224
13329,334063820,20052999,354116819,9,0,1,28672,17,4369634401
13330,334089900,20178943,354268843,9,0,1,19456,17,2427406460
13331,334104050,883033,334987083,3,0,0,66048,0,3622036819
13332,334108000,20160866,354268866,2,0,1,11264,11,3649646032
13333,334122510,484336,334606846,3,0,0,47616,0,4595855002
13334,334171830,1141725,335313555,3,0,0,438272,0,6215353561
13335,334181500,350868,334532368,5,0,0,5632,11,1357248321
13336,334215890,348311,334564201,1,0,0,1024,6,10725285321
13337,334221420,605086,334826506,5,0,0,72192,11,645505749
13338,334223270,943471,335166741,5,0,0,99840,11,6789017426
13339,334228500,20040381,354268881,9,0,1,15872,17,8320804149
13340,334302280,282952,334585232,5,0,0,43520,11,4638551403
13341,334308600,19962651,354271251,9,0,1,5120,17,57073673
13342,334335700,223623,334559323,1,0,0,512,6,9115593623
13343,334346360,19926060,354272420,9,0,1,27648,17,6505326155
13344,334353630,19919296,354272926,9,0,1,9216,17,4887615977
13345,334411120,19861821,354272941,9,0,1,6656,17,6489116980
13346,334535720,452314,334988034,1,0,0,3072,6,2858587464
13347,334588280,19684676,354272956,9,0,1,4096,17,8992545959
13348,334654210,19618761,354272971,9,0,1,11776,17,10482935442
13349,334663530,19616973,354280503,9,0,1,37376,17,5488009352
13350,334692340,487573,335179913,5,0,0,43008,11,7258371515
13351,334755110,256901,335012011,1,0,0,1536,6,3514488848
13352,334773340,20094179,354867519,1,0,1,379904,6,6730386906
13353,334790800,20082989,354873789,9,0,1,18432,17,3770609334
13354,334804290,663099,335467389,3,0,0,300544,0,9039578278
13355,334810500,515054,335325554,5,0,0,38912,11,6179684880
13356,334820270,651064,335471334,8,0,0,12800,6,7755518147
13357,334836090,195351,335031441,1,0,0,512,6,4885035944
13358,334964590,904958,335869548,3,0,0,210944,0,788433500
13359,335083730,457289,335541019,1,0,0,1024,6,1167394399
13360,335120310,19753494,354873804,5,0,1,1024,11,6948723304
13361,335165340,639891,335805231,3,0,0,339968,0,3401706550
13362,335246860,903015,336149875,8,0,0,115712,6,8863768374
13363,335363240,222306,335585546,1,0,0,512,6,3563867931
13364,335512220,166167,335678387,1,0,0,2560,6,1361590691
13365,335584429,316754,335901183,4,0,0,57856,4,6243889374
13366,335676850,19196977,354873827,6,0,1,20992,3,2326731535
13367,335681620,339204,336020824,5,0,0,25088,11,1312174459
13368,335684490,468996,336153486,3,0,0,11776,0,2498865521
13369,335699040,284739,335983779,1,0,0,3584,6,10266174643
13370,335720920,19152922,354873842,9,0,1,15872,17,10207136123
13371,335757119,723226,336480345,4,0,0,210944,4,5690992583
13372,335817490,812460,336629950,8,0,0,34304,6,10030239095
13373,335878839,632143,336510982,4,0,0,100352,4,9761678689
13374,335916790,686986,336603776,5,0,0,220160,11,7628504861
13375,336022929,504602,336527531,4,0,0,8704,4,5329909471
13376,336057670,18835621,354893291,9,0,1,3072,17,3462448836
13377,336067170,306519,336373689,1,0,0,1024,6,9597098753
13378,336070010,809423,336879433,3,0,0,240128,0,6118867847
13379,336131260,486883,336618143,5,0,0,47104,11,8218133918
13380,336150450,647577,336798027,3,0,0,195584,0,5659013279
13381,336192319,698533,336890852,4,0,0,37376,4,9025189207
13382,336201580,18692479,354894059,9,0,1,11776,17,2418139426
13383,336229769,1225845,337455614,4,0,0,113152,4,4648784785
13384,336229850,18706893,354936743,9,0,1,63488,17,9424571799
13385,336267920,971022,337238942,3,0,0,62464,0,10364924194
13386,336290040,643274,336933314,8,0,0,139264,6,4233650201
13387,336291220,928660,337219880,5,0,0,451072,11,5320869449
13388,336310430,18638090,354948520,9,0,1,512,17,3541841706
13389,336371100,941279,337312379,3,0,0,60416,0,6851249325
13390,336388810,1207645,337596455,3,0,0,101888,0,5641980957
13391,336409950,884006,337293956,8,0,0,89600,6,1852772944
13392,336457050,18496655,354953705,3,0,1,16384,0,7205651027
13393,336468830,196632,336665462,1,0,0,3072,6,6808041175
13394,336494510,18470291,354964801,9,0,1,3584,17,9495605018
13395,336512650,431459,336944109,5,0,0,35328,11,3624237209
13396,336552480,18413307,354965787,9,0,1,1536,17,4153613631
13397,336565930,890338,337456268,1,0,0,2048,6,8686021285
13398,336621869,926193,337548062,4,0,0,61440,4,9746751817
13399,336715709,549236,337264945,4,0,0,69632,4,4858368713
13400,336740680,503034,337243714,3,0,0,5120,0,2156652755
13401,336803539,1022486,337826025,4,0,0,288768,4,7380465601
13402,336803840,438237,337242077,8,0,0,10240,6,3124092015
13403,336809030,607079,337416109,1,0,0,1536,6,194045398
13404,336816060,18150598,354966658,7,0,1,12288,16,6192669494
13405,336891369,1058499,337949868,4,0,0,300544,4,9458092386
13406,337062759,1030020,338092779,4,0,0,29184,4,1123524247
13407,337164070,341774,337505844,1,0,0,512,6,168603933
13408,337164719,363482,337528201,4,0,0,27136,4,10567738609
13409,337173500,17906926,355080426,5,0,1,45056,11,3589723689
13410,337215520,627139,337842659,8,0,0,54272,6,8102125794
13411,337284809,678030,337962839,4,0,0,42496,4,3081863144
13412,337288969,1019769,338308738,4,0,0,206336,4,5741594452
13413,337326290,831304,338157594,1,0,0,1536,6,10270377634
13414,337360800,17719649,355080449,7,0,1,21504,16,4504154466
13415,337363510,951544,338315054,1,0,0,2048,6,413757123
13416,337396951,17692960,355089911,0,0,1,47616,6,2700240751
13417,337397110,17701038,355098148,7,0,1,10240,16,5663517223
13418,337417030,228332,337645362,1,0,0,3584,6,4312593837
13419,337430519,1320777,338751296,4,0,0,467968,4,46058634
13420,337464180,977254,338441434,3,0,0,155648,0,10682895230
13421,337500470,188575,337689045,1,0,0,512,6,9186402199
13422,337531559,794610,338326169,4,0,0,14336,4,9671466448
13423,337587370,1328815,338916185,5,0,0,344576,11,8958684849
13424,337687470,17531822,355219292,8,0,1,6656,6,1433647573
13425,337688861,17531737,355220598,0,0,1,2048,6,6200211532
13426,337719260,594961,338314221,5,0,0,17920,11,2360075700
13427,337725290,883384,338608674,3,0,0,131072,0,1774120913
13428,337788470,17441539,355230009,7,0,1,16384,16,6224054369
13429,337816770,17706853,355523623,7,0,1,19968,16,5101168313
13430,337823170,554657,338377827,1,0,0,4608,6,10661297145
13431,337848881,17674757,355523638,0,0,1,512,6,7615625554
13432,337864129,947007,338811136,4,0,0,37888,4,5860873734
13433,337948410,821348,338769758,8,0,0,60416,6,575652995
13434,337952230,17571423,355523653,7,0,1,512,16,2315885095
13435,338012880,301512,338314392,1,0,0,512,6,8867799010
13436,338067999,890586,338958585,4,0,0,5632,4,7543603639
13437,338079390,17444278,355523668,7,0,1,512,16,2631270435
13438,338111391,17412292,355523683,0,0,1,16384,6,3822292042
13439,338113389,686188,338799577,4,0,0,97792,4,3167168143
13440,338116160,1114545,339230705,3,0,0,115200,0,3832439967
13441,338154670,802176,338956846,5,0,0,64000,11,1460053968
13442,338185811,17354389,355540200,0,0,1,27648,6,191902183
13443,338187240,17422055,355609295,8,0,1,33792,6,9281985800
13444,338226260,711055,338937315,5,0,0,40960,11,5966304220
13445,338239210,87130,338326340,1,0,0,512,6,4519560339
13446,338239249,329474,338568723,4,0,0,47616,4,9128539934
13447,338249580,1091464,339341044,5,0,0,121344,11,2545045667
13448,338295310,17325045,355620355,8,0,1,24064,6,10724222360
13449,338371379,667631,339039010,4,0,0,124928,4,6759713031
13450,338436951,17222335,355659286,0,0,1,22016,6,1511776188
13451,338476910,718597,339195507,8,0,0,247296,6,8930166290
13452,338481370,17198599,355679969,8,0,1,6144,6,6954781605
13453,338485680,1032005,339517685,3,0,0,138752,0,3644265624
13454,338510820,413984,338924804,3,0,0,28160,0,3776954862
13455,338511870,17204892,355716762,8,0,1,15360,6,5072147076
13456,338539850,764154,339304004,5,0,0,145408,11,9369333845
13457,338553569,1230852,339784421,4,0,0,83968,4,1428126745
13458,338568170,1436973,340005143,5,0,0,101888,11,309140363
13459,338595259,758927,339354186,4,0,0,43008,4,5378546502
13460,338599460,1078687,339678147,8,0,0,223744,6,6073363506
13461,338605150,628167,339233317,1,0,0,8192,6,6500665787
13462,338652280,1106542,339758822,8,0,0,57856,6,4832337321
13463,338717021,17056871,355773892,0,0,1,35328,6,4944566497
13464,338733400,17044806,355778206,8,0,1,17408,6,3473694664
13465,338743710,954132,339697842,3,0,0,64512,0,774126371
13466,338747900,706460,339454360,3,0,0,56320,0,10062421604
13467,338754240,1046591,339800831,0,0,0,9216,6,10006038138
13468,338769440,17011672,355781112,4,0,1,4608,4,5973101650
13469,338787099,1010909,339798008,4,0,0,44544,4,2122121916
13470,338816790,891551,339708341,1,0,0,1024,6,10315189276
13471,338842150,595027,339437177,5,0,0,35840,11,3685094375
13472,338868510,16936407,355804917,8,0,1,10240,6,2664960850
13473,338922370,16885665,355808035,4,0,1,14336,4,5591698217
13474,338937960,16874581,355812541,4,0,1,7168,4,2699902199
13475,338940310,16907999,355848309,8,0,1,35840,6,10107065737
13476,338981690,372667,339354357,1,0,0,512,6,7032128445
13477,338999480,16886511,355885991,8,0,1,23040,6,3748301157
13478,339020960,849768,339870728,1,0,0,4608,6,1613185179
13479,339063880,899519,339963399,3,0,0,48640,0,7633744057
13480,339067120,1245470,340312590,8,0,0,397824,6,3688416105
13481,339082821,16908979,355991800,0,0,1,13824,6,3693943563
13482,339082999,1784110,340867109,4,0,0,335360,4,8781550588
13483,339088210,1412990,340501200,8,0,0,355328,6,8132498812
13484,339090220,455035,339545255,0,0,0,16384,6,4131169319
13485,339098010,17020492,356118502,4,0,1,24576,4,2470551739
13486,339129750,16989469,356119219,8,0,1,24064,6,3395142743
13487,339169390,16949844,356119234,8,0,1,14336,6,5313545489
13488,339177551,17073478,356251029,0,0,1,73216,6,60833640
13489,339180820,17070224,356251044,8,0,1,29184,6,3318187099
13490,339195260,17055799,356251059,8,0,1,2560,6,1791557020
13491,339209530,1461128,340670658,8,0,0,355840,6,5541019757
13492,339213390,1756501,340969891,5,0,0,169984,11,4811403653
13493,339227291,17037214,356264505,0,0,1,23552,6,9431709434
13494,339229250,17035270,356264520,8,0,1,1536,6,1363549034
13495,339248340,1509460,340757800,3,0,0,285184,0,4145512052
13496,339311590,1249388,340560978,5,0,0,157184,11,9927430852
13497,339368730,1690339,341059069,3,0,0,83456,0,4411031955
13498,339386720,1747663,341134383,8,0,0,220160,6,8016193600
13499,339393300,2213635,341606935,8,0,0,285184,6,9006799682
13500,339414371,16850164,356264535,0,0,1,11776,6,10526622685
13501,339427130,16837420,356264550,4,0,1,10752,4,884110434
13502,339428080,16836485,356264565,4,0,1,7168,4,1094213825
13503,339465780,854968,340320748,0,0,0,26624,6,9003767466
13504,339481239,1867998,341349237,4,0,0,130560,4,9211639947
13505,339526040,1238850,340764890,3,0,0,22016,0,4516882603
13506,339541461,16723119,356264580,0,0,1,1536,6,6931649075
13507,339549520,817099,340366619,1,0,0,5120,6,871191976
13508,339617140,16647455,356264595,8,0,1,1024,6,2757705406
13509,339627659,1783204,341410863,4,0,0,195584,4,5119978791
13510,339631990,16632791,356264781,8,0,1,3584,6,2803652779
13511,339652460,2028464,341680924,3,0,0,110592,0,6283397977
13512,339690960,16573836,356264796,6,0,1,24064,3,3100287089
13513,339712610,1997260,341709870,5,0,0,94720,11,9205362884
13514,339738140,1140770,340878910,3,0,0,38400,0,4000384187
13515,339740030,16524781,356264811,8,0,1,34816,6,6640612104
13516,339834430,16445648,356280078,4,0,1,10752,4,3749249259
13517,339835030,1802254,341637284,5,0,0,18432,11,7427823339
13518,339853720,817165,340670885,1,0,0,512,6,9424172865
13519,339882410,1860775,341743185,0,0,0,109056,6,4345725219
13520,339929321,16352289,356281610,0,0,1,4096,6,2543145465
13521,339936690,16345586,356282276,8,0,1,11264,6,8862882977
13522,339944940,1907350,341852290,1,0,0,3584,6,7150811085
13523,340001740,2322620,342324360,5,0,0,359424,11,6829580561
13524,340022410,16264647,356287057,8,0,1,4608,6,2656936204
13525,340043890,1232765,341276655,0,0,0,96256,6,7285240242
13526,340044280,1996925,342041205,8,0,0,12800,6,9845067719
13527,340081600,16223958,356305558,4,0,1,31744,4,5620541527
13528,340091650,666517,340758167,1,0,0,1024,6,3436551922
13529,340100950,1810253,341911203,3,0,0,40960,0,1533368311
13530,340111770,1135542,341247312,8,0,0,165888,6,3817362003
13531,340121880,16203866,356325746,4,0,1,16384,4,9859646034
13532,340131930,16205890,356337820,4,0,1,6144,4,3182893557
13533,340190729,2140770,342331499,4,0,0,23040,4,4597693924
13534,340201849,2740329,342942178,4,0,0,23040,4,7444222675
13535,340203230,16135896,356339126,4,0,1,2048,4,6251459111
13536,340249420,2579123,342828543,8,0,0,50688,6,3215565019
13537,340261200,2517465,342778665,0,0,0,242688,6,972351399
13538,340279990,16060122,356340112,4,0,1,1536,4,10655057576
13539,340300060,1330642,341630702,0,0,0,77824,6,468804839
13540,340325490,16014776,356340266,5,0,1,8704,11,2544205194
13541,340334620,16007638,356342258,8,0,1,1024,6,6507571139
13542,340341370,2179121,342520491,3,0,0,100352,0,8431173534
13543,340465820,560058,341025878,1,0,0,2048,6,10458109825
13544,340467189,1014310,341481499,4,0,0,34816,4,2841851941
13545,340525440,15817484,356342924,4,0,1,1024,4,531531916
13546,340541790,1089863,341631653,1,0,0,3072,6,10227320888
13547,340568980,15787504,356356484,8,0,1,43008,6,4116537323
13548,340584230,15776671,356360901,8,0,1,17920,6,8866727601
13549,340588360,15809780,356398140,8,0,1,30720,6,713197196
13550,340592350,15854530,356446880,4,0,1,53760,4,2405147373
13551,340593890,2501846,343095736,0,0,0,137728,6,4347509167
13552,340607110,15865522,356472632,7,0,1,15360,16,4807108903
13553,340614540,562675,341177215,0,0,0,81920,6,316160433
13554,340647710,348779,340996489,1,0,0,4096,6,6134508826
13555,340684670,15807139,356491809,8,0,1,27648,6,5139691541
13556,340689110,1765580,342454690,5,0,0,100864,11,7198295989
13557,340731230,15786300,356517530,8,0,1,31744,6,5846517768
13558,340760480,15783552,356544032,8,0,1,27648,6,9630401420
13559,340798300,2562835,343361135,5,0,0,117760,11,2233465974
13560,340827200,2765752,343592952,3,0,0,302080,0,7721137607
13561,340846219,2829707,343675926,4,0,0,38912,4,8986061791
13562,340848450,1366351,342214801,3,0,0,126976,0,7197724733
13563,340854970,15699173,356554143,4,0,1,25600,4,8320413441
13564,340877220,15701574,356578794,8,0,1,23040,6,1622162474
13565,340883580,1759492,342643072,8,0,0,131072,6,2942891961
13566,340911570,1057056,341968626,5,0,0,188416,11,3201213219
13567,340938020,812520,341750540,0,0,0,24064,6,10609286642
13568,340969680,905713,341875393,8,0,0,75776,6,8296820246
13569,340988229,2916443,343904672,4,0,0,92672,4,5811820982
13570,341024340,1446433,342470773,5,0,0,52736,11,10281002546
13571,341041120,710371,341751491,1,0,0,3072,6,4791200119
13572,341051230,15552165,356603395,4,0,1,19456,4,7055435339
13573,341065120,15548732,356613852,4,0,1,14848,4,1258199344
13574,341076380,3119364,344195744,3,0,0,2048,0,5487619578
13575,341078819,3000303,344079122,4,0,0,109568,4,3252485172
13576,341236160,3249481,344485641,0,0,0,62976,6,8548355022
13577,341285010,2510475,343795485,0,0,0,11776,6,3018293568
13578,341333570,755120,342088690,3,0,0,56320,0,8755210866
13579,341365010,15272859,356637869,8,0,1,41984,6,8651121591
13580,341439800,3327031,344766831,8,0,0,273920,6,6371569372
13581,341484510,1175440,342659950,5,0,0,55296,11,892726554
13582,341530540,511616,342042156,1,0,0,3072,6,7227856456
13583,341535120,310180,341845300,1,0,0,2560,6,2331249329
13584,341549410,1610621,343160031,0,0,0,210944,6,682093672
13585,341565380,405165,341970545,3,0,0,6144,0,134189547
13586,341580040,3345016,344925056,8,0,0,238080,6,10132571146
13587,341607440,211570,341819010,5,0,0,14848,11,8015014478
13588,341608980,752642,342361622,3,0,0,98816,0,3035979546
13589,341643890,14995619,356639509,3,0,1,24064,0,4643989289
13590,341650440,14992720,356643160,8,0,1,10240,6,3211422023
13591,341651590,15010911,356662501,6,0,1,16896,3,7602162246
13592,341653870,15058370,356712240,4,0,1,43520,4,60030544
13593,341654740,15080261,356735001,3,0,1,20480,0,2552607417
13594,341660080,15078787,356738867,4,0,1,6144,4,5287370812
13595,341663980,15142514,356806494,8,0,1,30208,6,9588549037
13596,341666750,1145367,342812117,8,0,0,68096,6,6457797115
13597,341675360,15134520,356809880,9,0,1,19456,17,3310605158
13598,341686720,15134412,356821132,6,0,1,29184,3,8406798835
13599,341704080,15149705,356853785,3,0,1,512,0,8735492956
13600,341727569,976599,342704168,4,0,0,96256,4,6129600830
13601,341753550,15172671,356926221,8,0,1,32768,6,5806229312
13602,341761620,1532390,343294010,8,0,0,124928,6,5050636090
13603,341761720,1563505,343325225,3,0,0,102400,0,7197575066
13604,341780860,15163011,356943871,8,0,1,11776,6,4972065514
13605,341785710,15161067,356946777,3,0,1,4608,0,8034786665
13606,341789800,1395256,343185056,1,0,0,1536,6,8261479331
13607,341797650,15152353,356950003,8,0,1,5120,6,3970060578
13608,341806270,984125,342790395,0,0,0,37376,6,4471104524
13609,341816180,15196942,357013122,9,0,1,20480,17,5872988786
13610,341844640,15172699,357017339,4,0,1,9216,4,5661980029
13611,341862830,15199114,357061944,9,0,1,8704,17,5525980210
13612,341892510,1003979,342896489,8,0,0,109568,6,5840743511
13613,341908820,15153790,357062610,6,0,1,1024,3,9790042364
13614,341926730,1526854,343453584,0,0,0,269824,6,1105634404
13615,341941489,733304,342674793,4,0,0,48640,4,8143888787
13616,341957160,15133112,357090272,3,0,1,16384,0,1918556520
13617,341976630,3094749,345071379,0,0,0,152064,6,9521102755
13618,341983170,1192683,343175853,1,0,0,1536,6,8618285356
13619,342021950,15072188,357094138,6,0,1,6144,3,7381303826
13620,342048650,1425724,343474374,0,0,0,44544,6,8774470814
13621,342060110,2338837,344398947,3,0,0,18432,0,10225022215
13622,342068930,15030495,357099425,3,0,1,16896,0,7081718812
13623,342089400,1084562,343173962,8,0,0,45568,6,5352494348
13624,342089890,15212289,357302179,3,0,1,11264,0,1827631666
13625,342096330,15207232,357303562,9,0,1,14848,17,6430199422
13626,342099730,679262,342778992,1,0,0,1024,6,2910945026
13627,342101130,15214676,357315806,6,0,1,512,3,8523920188
13628,342141730,15174422,357316152,6,0,1,512,3,8031400943
13629,342182230,2361273,344543503,1,0,0,2560,6,2435626263
13630,342187330,15130128,357317458,5,0,1,2048,11,383086083
13631,342191440,15171425,357362865,3,0,1,4096,0,3730134163
13632,342191470,1464989,343656459,1,0,0,1536,6,7685328561
13633,342229920,15151260,357381180,3,0,1,5120,0,6693669473
13634,342234560,15146635,357381195,8,0,1,6656,6,7249190956
13635,342246680,15443844,357690524,7,0,1,21504,16,2128584283
13636,342249870,15440910,357690780,8,0,1,9216,6,7016172325
13637,342265190,640704,342905894,0,0,0,30720,6,8987816512
13638,342272690,540378,342813068,5,0,0,3072,11,1535373051
13639,342281930,509424,342791354,1,0,0,3072,6,6339909199
13640,342300820,911122,343211942,8,0,0,16896,6,4021290352
13641,342305420,15399904,357705324,7,0,1,6656,16,1125352977
13642,342307790,2956224,345264014,5,0,0,224256,11,6710121211
13643,342315480,15391470,357706950,4,0,1,2560,4,5220011961
13644,342407080,15305259,357712339,7,0,1,17408,16,9107785655
13645,342463270,15297339,357760609,7,0,1,19456,16,5013369689
13646,342485080,15287798,357772878,8,0,1,1536,6,4578290716
13647,342485870,15357092,357842962,7,0,1,24576,16,1296790064
13648,342514750,1112904,343627654,8,0,0,5120,6,3457887830
13649,342523090,15420567,357943657,4,0,1,9216,4,8567593813
13650,342526910,15416762,357943672,6,0,1,512,3,1993695646
13651,342542890,2824350,345367240,0,0,0,66048,6,6725258968
13652,342587370,15378587,357965957,4,0,1,41472,4,8310296465
13653,342612200,1108625,343720825,8,0,0,14336,6,2113375852
13654,342631220,15335711,357966931,4,0,1,25088,4,7628842195
13655,342634180,1503893,344138073,8,0,0,169472,6,3881162191
13656,342647140,1363632,344010772,8,0,0,4096,6,9460690118
13657,342663769,2900913,345564682,4,0,0,138240,4,10667144197
13658,342680220,15286726,357966946,7,0,1,10240,16,2553979462
13659,342732740,15235835,357968575,8,0,1,6656,6,3396189190
13660,342754200,15392986,358147186,4,0,1,15872,4,2106592384
13661,342783640,2724797,345508437,8,0,0,7168,6,6806986513
13662,342788500,3031169,345819669,8,0,0,46080,6,10482122998
13663,342800960,15377362,358178322,7,0,1,15360,16,4497832144
13664,342801000,1195983,343996983,5,0,0,214528,11,4370173952
13665,342907460,1096870,344004330,0,0,0,24064,6,9641313106
13666,342907530,15270823,358178353,4,0,1,1024,4,10615686545
13667,342923130,15255254,358178384,4,0,1,42496,4,9135965357
13668,342947010,679061,343626071,3,0,0,108544,0,9433588337
13669,342972280,15206135,358178415,6,0,1,4096,3,4226441093
13670,342990670,15187800,358178470,6,0,1,49152,3,473893482
13671,343000620,15177865,358178485,8,0,1,2560,6,5911031283
13672,343000730,15177778,358178508,6,0,1,1024,3,5261285682
13673,343015389,3119394,346134783,4,0,0,239616,4,10447175918
13674,343020700,15157823,358178523,8,0,1,1536,6,9047230113
13675,343021350,15206054,358227404,8,0,1,42496,6,6772974819
13676,343048340,15179079,358227419,4,0,1,1536,4,9730443453
13677,343060019,15167471,358227490,8,0,1,22016,6,7586621423
13678,343060260,395087,343455347,0,0,0,5632,6,8330583484
13679,343094459,15133054,358227513,8,0,1,1536,6,3545682932
13680,343107430,15120098,358227528,9,0,1,1536,17,7013721257
13681,343132830,15094713,358227543,3,0,1,1536,0,7494199186
13682,343157189,989994,344147183,4,0,0,29696,4,3364809775
13683,343174440,15261899,358436339,6,0,1,6656,3,9223639185
13684,343183730,15252624,358436354,9,0,1,8704,17,9209502379
13685,343197810,1169895,344367705,3,0,0,311808,0,10636459530
13686,343199380,810121,344009501,8,0,0,16896,6,8807985656
13687,343202500,575403,343777903,0,0,0,7168,6,3624072962
13688,343214530,15430799,358645329,6,0,1,16384,3,4722784356
13689,343238240,217746,343455986,8,0,0,2048,6,7288824113
13690,343249940,15395404,358645344,4,0,1,1536,4,6528511628
13691,343311080,15538848,358849928,8,0,1,61952,6,1891295637
13692,343316730,15544951,358861681,9,0,1,4608,17,8898017046
13693,343317740,15543956,358861696,6,0,1,5632,3,793807302
13694,343341810,15519901,358861711,8,0,1,512,6,3078334771
13695,343349270,15512456,358861726,8,0,1,4608,6,747255777
13696,343378130,15561938,358940068,8,0,1,3072,6,9768497177
13697,343389660,15550431,358940091,4,0,1,17920,4,6598146081
13698,343399060,15541685,358940745,3,0,1,4096,0,262043546
13699,343399300,15542887,358942187,8,0,1,46080,6,2191293093
13700,343430900,15511302,358942202,9,0,1,2048,17,8566368333
13701,343444100,2824900,346269000,0,0,0,77312,6,2380513470
13702,343448710,479753,343928463,0,0,0,14848,6,2159128479
13703,343451830,15498842,358950672,9,0,1,20992,17,1463291813
13704,343457010,15591834,359048844,6,0,1,12800,3,6954506972
13705,343468890,15612709,359081599,7,0,1,1536,16,3019281380
13706,343476719,1133602,344610321,4,0,0,90624,4,376347910
13707,343499740,1041221,344540961,0,0,0,95232,6,5976702947
13708,343538780,15559252,359098032,8,0,1,20480,6,3768344733
13709,343561360,633745,344195105,0,0,0,34816,6,7418125734
13710,343561730,622752,344184482,0,0,0,43008,6,1201378820
13711,343570410,863781,344434191,8,0,0,70144,6,10494621690
13712,343626680,15606852,359233532,4,0,1,49664,4,134529921
13713,343629440,15664218,359293658,6,0,1,15360,3,2875266743
13714,343634830,2956856,346591686,3,0,0,70656,0,4266158494
13715,343649170,1001759,344650929,3,0,0,79360,0,8146606814
13716,343656330,886378,344542708,3,0,0,5632,0,1084223054
13717,343661920,15640211,359302131,6,0,1,5632,3,871318778
13718,343662890,15651656,359314546,8,0,1,18944,6,9707297221
13719,343670919,1180199,344851118,4,0,0,276480,4,7231009663
13720,343703169,1979490,345682659,4,0,0,280064,4,7580238626
13721,343717230,15598302,359315532,9,0,1,1536,17,5351535346
13722,343760350,15577823,359338173,6,0,1,13824,3,9449029845
13723,343780010,15649676,359429686,7,0,1,25088,16,3299671759
13724,343788900,15659708,359448608,3,0,1,58880,0,8847761924
13725,343831230,1308586,345139816,0,0,0,5632,6,3384002304
13726,343841671,15658911,359500582,0,0,1,25600,6,4469180717
13727,343847300,15653948,359501248,6,0,1,1024,3,5708815684
13728,343867920,15633994,359501914,7,0,1,11264,16,6588877818
13729,343868360,15670866,359539226,9,0,1,25088,17,6362024603
13730,343871640,1266437,345138077,0,0,0,133120,6,4565620563
13731,343872269,15669863,359542132,8,0,1,4608,6,9073494477
13732,343892059,1124773,345016832,4,0,0,102400,4,10178315039
13733,343924430,15620442,359544872,3,0,1,12800,0,5916240822
13734,343927229,1643704,345570933,4,0,0,7168,4,9565250913
13735,343938480,1840755,345779235,0,0,0,135168,6,3582133886
13736,343944660,15600878,359545538,8,0,1,1024,6,4323155822
13737,343955279,1142191,345097470,4,0,0,85504,4,7825767322
13738,343980200,1410667,345390867,8,0,0,37376,6,1914805618
13739,344009579,1140860,345150439,4,0,0,34816,4,6338976053
13740,344011390,1184273,345195663,5,0,0,89600,11,5140779278
13741,344011960,15534884,359546844,6,0,1,2048,3,7773300365
13742,344023210,603516,344626726,0,0,0,26624,6,8287151780
13743,344030509,15517001,359547510,8,0,1,11264,6,10535397375
13744,344100510,751935,344852445,3,0,0,4096,0,818758398
13745,344112260,2662804,346775064,3,0,0,222720,0,3566677815
13746,344113661,15551072,359664733,0,0,1,7680,6,302768715
13747,344119181,15563225,359682406,0,0,1,28160,6,461517194
13748,344138730,3064664,347203394,5,0,0,434176,11,1168898804
13749,344152380,15530041,359682421,9,0,1,512,17,1203845642
13750,344198340,2785597,346983937,0,0,0,141824,6,5743282522
13751,344203660,15478776,359682436,8,0,1,5632,6,2533404096
13752,344265480,15416971,359682451,8,0,1,12288,6,3848243517
13753,344315080,15474658,359789738,4,0,1,45568,4,6314721197
13754,344321820,15467933,359789753,4,0,1,16896,4,4847811195
13755,344339200,2929167,347268367,8,0,0,39424,6,3297769647
13756,344341250,15450577,359791827,7,0,1,1536,16,7306189852
13757,344367450,15424392,359791842,9,0,1,10240,17,6129382198
13758,344434210,15357655,359791865,3,0,1,1536,0,4463194525
13759,344440570,15351310,359791880,4,0,1,1024,4,1027316404
13760,344462220,15336718,359798938,9,0,1,60928,17,9818857722
13761,344473010,15325943,359798953,6,0,1,1536,3,6100383647
13762,344483920,15315048,359798968,6,0,1,1536,3,6048250141
13763,344484320,15314663,359798983,3,0,1,3072,0,652581494
13764,344487370,3116121,347603491,8,0,0,202752,6,3590543392
13765,344519310,2968425,347487735,0,0,0,460800,6,3823588214
13766,344520330,15286195,359806525,6,0,1,16384,3,3442759492
13767,344538060,15273784,359811844,8,0,1,17408,6,4996611701
13768,344538841,15306021,359844862,0,0,1,38400,6,9125257309
13769,344542490,15305432,359847922,4,0,1,13312,4,7443716244
13770,344552250,1759473,346311723,5,0,0,63488,11,6478606460
13771,344563310,15288014,359851324,8,0,1,13312,6,9704218428
13772,344598320,15293540,359891860,7,0,1,15872,16,3527846329
13773,344621350,15270525,359891875,9,0,1,2560,17,10498425963
13774,344643730,1916891,346560621,0,0,0,168448,6,3114241450
13775,344672570,3222535,347895105,0,0,0,164864,6,7134435770
13776,344719280,15172610,359891890,4,0,1,2048,4,1829043643
13777,344724710,15167195,359891905,7,0,1,6656,16,9342181833
13778,344728040,15163880,359891920,7,0,1,11264,16,6977576613
13779,344733250,15189574,359922824,4,0,1,37888,4,4668288556
13780,344747050,1565640,346312690,0,0,0,3072,6,2904885305
13781,344768830,15154009,359922839,8,0,1,3584,6,4713049041
13782,344786571,15136283,359922854,0,0,1,512,6,3026131171
13783,344794539,3017973,347812512,4,0,0,145920,4,3038232675
13784,344807250,2064861,346872111,8,0,0,318464,6,1945480539
13785,344811749,1847956,346659705,4,0,0,171008,4,9828009558
13786,344821720,15101149,359922869,9,0,1,3072,17,7756686976
13787,344826570,661498,345488068,3,0,0,45056,0,3941148527
13788,344832980,15103613,359936593,7,0,1,18432,16,2008266346
13789,344838150,15110806,359948956,7,0,1,26624,16,4708992762
13790,344841701,15131799,359973500,0,0,1,12288,6,5889227162
13791,344861180,15116826,359978006,8,0,1,7168,6,3708434857
13792,344861930,15126231,359988161,7,0,1,19968,16,2556891707
13793,344903721,15148836,360052557,0,0,1,56832,6,9447541586
13794,344903919,2159859,347063778,4,0,0,30720,4,5208118816
13795,344918290,887324,345805614,8,0,0,86528,6,689344609
13796,344933081,15119630,360052711,0,0,1,8704,6,4724209473
13797,344963240,618344,345581584,0,0,0,1024,6,7068156144
13798,344965840,15089777,360055617,7,0,1,4608,16,1388038711
13799,344994421,15067508,360061929,0,0,1,37888,6,3782931014
13800,345003001,15059082,360062083,0,0,1,8704,6,5294482944
13801,345011270,962029,345973299,5,0,0,32256,11,7067557112
13802,345011670,15057510,360069180,8,0,1,12800,6,3984834304
13803,345018650,1972649,346991299,8,0,0,23552,6,3168139879
13804,345036770,15036268,360073038,6,0,1,14848,3,4630444300
13805,345045570,1199859,346245429,8,0,0,56832,6,1542898922
13806,345054240,2694095,347748335,5,0,0,345600,11,10073588021
13807,345058720,15053720,360112440,9,0,1,18944,17,8610050687
13808,345085520,1183963,346269483,0,0,0,1536,6,5542726669
13809,345108989,1498090,346607079,4,0,0,40960,4,569839055
13810,345129830,1548679,346678509,0,0,0,2048,6,819592713
13811,345144950,14971356,360116306,8,0,1,6144,6,237398985
13812,345159210,14961808,360121018,6,0,1,11264,3,7943971723
13813,345159710,1780939,346940649,5,0,0,188416,11,10301024088
13814,345164770,14957324,360122094,8,0,1,13312,6,2533693659
13815,345176820,14949460,360126280,7,0,1,6656,16,2855811501
13816,345180020,963514,346143534,5,0,0,28672,11,6399569093
13817,345253730,14875776,360129506,6,0,1,5120,3,3838835331
13818,345264650,1744800,347009450,8,0,0,59392,6,3001018050
13819,345281000,681318,345962318,0,0,0,1536,6,2624810570
13820,345302470,14864804,360167274,7,0,1,23552,16,3937899989
13821,345347059,1536167,346883226,4,0,0,36352,4,7568311488
13822,345351789,2658042,348009831,4,0,0,138240,4,708795131
13823,345374210,2138117,347512327,3,0,0,79360,0,9950583032
13824,345374510,1679863,347054373,8,0,0,138240,6,2004652909
13825,345403590,2218347,347621937,8,0,0,60416,6,8381187319
13826,345413630,14754105,360167735,6,0,1,10240,3,10674538421
13827,345439249,2328788,347768037,4,0,0,47104,4,4299884073
13828,345445379,1882834,347328213,4,0,0,98304,4,509791746
13829,345460670,14870109,360330779,4,0,1,26624,4,8791032944
13830,345472430,14859939,360332369,9,0,1,29696,17,687321936
13831,345480999,1775325,347256324,4,0,0,173568,4,7621882122
13832,345497240,890136,346387376,5,0,0,2560,11,1769115090
13833,345503580,1156772,346660352,0,0,0,2048,6,3248740867
13834,345507620,14824764,360332384,7,0,1,7168,16,9559661434
13835,345551600,14780799,360332399,8,0,1,1024,6,4853689495
13836,345571140,14761274,360332414,8,0,1,6144,6,1512219130
13837,345575100,14757329,360332429,4,0,1,31232,4,2409867387
13838,345596640,2248210,347844850,3,0,0,75264,0,5199061512
13839,345612530,2565031,348177561,3,0,0,163328,0,5909064040
13840,345638500,14693968,360332468,8,0,1,17920,6,1092320595
13841,345639520,14693897,360333417,8,0,1,7680,6,3917268938
13842,345648850,1864272,347513122,0,0,0,2560,6,9987989611
13843,345681860,1859825,347541685,3,0,0,93696,0,2932405918
13844,345791030,14556956,360347986,8,0,1,29184,6,9456045779
13845,345810629,2687495,348498124,4,0,0,603136,4,1233264373
13846,345835980,1917690,347753670,5,0,0,17408,11,3694671428
13847,345837990,830337,346668327,0,0,0,2560,6,4978693002
13848,345842930,14507117,360350047,4,0,1,9216,4,6292311551
13849,345852490,14498863,360351353,4,0,1,2048,4,3178330953
13850,345882680,14471899,360354579,9,0,1,5120,17,6776863807
13851,345916320,2172839,348089159,8,0,0,84992,6,4287318900
13852,345957320,1026788,346984108,0,0,0,512,6,7892751384
13853,345962561,14416036,360378597,0,0,1,15360,6,5725761970
13854,345985040,14393580,360378620,8,0,1,5632,6,1874661430
13855,346007200,1897756,347904956,5,0,0,32256,11,6686746935
13856,346028100,14353624,360381724,4,0,1,13824,4,1100502826
13857,346044040,1444060,347488100,0,0,0,1024,6,1920973508
13858,346048110,14335347,360383457,4,0,1,8704,4,5565841285
13859,346086281,14305147,360391428,0,0,1,20992,6,6131300463
13860,346095460,14299336,360394796,7,0,1,3584,16,5141855804
13861,346106630,2153965,348260595,8,0,0,77312,6,1411055644
13862,346108910,484300,346593210,0,0,0,2048,6,151311525
13863,346141560,14256271,360397831,4,0,1,4096,4,7794386362
13864,346146220,2435449,348581669,5,0,0,260608,11,4286356151
13865,346163580,14242252,360405832,4,0,1,38400,4,1379690228
13866,346190059,1745659,347935718,4,0,0,21504,4,7841345119
13867,346196960,2485624,348682584,8,0,0,202752,6,8980548812
13868,346219230,1423790,347643020,8,0,0,69120,6,1955116723
13869,346259270,14290509,360549779,4,0,1,86016,4,902486780
13870,346301540,2417639,348719179,5,0,0,119808,11,3781630686
13871,346308070,14246855,360554925,4,0,1,8192,4,7277382109
13872,346339400,14219391,360558791,9,0,1,6144,17,3674764106
13873,346343259,1699883,348043142,4,0,0,109056,4,4534410338
13874,346363870,1833526,348197396,3,0,0,65024,0,7521889865
13875,346405839,2414459,348820298,4,0,0,331776,4,3688362797
13876,346412210,14148118,360560328,9,0,1,23552,17,2953437166
13877,346431830,1872221,348304051,3,0,0,79360,0,8560072305
13878,346492740,14087235,360579975,9,0,1,13824,17,6904222781
13879,346498540,2324961,348823501,0,0,0,6656,6,6144105790
13880,346582650,14000551,360583201,8,0,1,5120,6,5999556462
13881,346628020,13960036,360588056,9,0,1,10240,17,3562551828
13882,346761170,13830846,360592016,8,0,1,4608,6,5999255291
13883,346797520,2060971,348858491,3,0,0,49152,0,252386600
13884,346799749,1820974,348620723,4,0,0,58368,4,4012976302
13885,346842920,13749762,360592682,8,0,1,11264,6,3862234731
13886,346934190,13688660,360622850,7,0,1,32768,16,3467936245
13887,346956540,13681077,360637617,8,0,1,39424,6,2224410810
13888,346962240,1640660,348602900,8,0,0,69632,6,4510400824
13889,346966950,302524,347269474,0,0,0,3584,6,5723923049
13890,346982771,13655832,360638603,0,0,1,1536,6,7783812712
13891,346983880,13659549,360643429,5,0,1,7680,11,4171726136
13892,346984699,1989237,348973936,4,0,0,283136,4,8152231412
13893,347017240,2027426,349044666,0,0,0,48128,6,4004047705
13894,347083191,13564540,360647731,0,0,1,18432,6,9608844306
13895,347125490,13522907,360648397,8,0,1,1024,6,2654238506
13896,347140449,1889506,349029955,4,0,0,183808,4,4085859582
13897,347176380,1951995,349128375,8,0,0,48640,6,8657970552
13898,347230690,1825379,349056069,3,0,0,37376,0,1795680764
13899,347249521,13400182,360649703,0,0,1,2048,6,8267279386
13900,347258250,563645,347821895,5,0,0,30720,11,3503919541
13901,347279560,1833980,349113540,5,0,0,97280,11,3661433573
13902,347286631,13369207,360655838,0,0,1,4096,6,2384606678
13903,347337270,1164933,348502203,3,0,0,13312,0,4396162349
13904,347338329,590822,347929151,4,0,0,79360,4,6105658253
13905,347350180,1493320,348843500,5,0,0,65536,11,8621383290
13906,347383020,1816468,349199488,3,0,0,58880,0,7257724700
13907,347388889,1498756,348887645,4,0,0,17408,4,6813762988
13908,347391260,13285304,360676564,8,0,1,7168,6,659182974
13909,347407360,2130576,349537936,8,0,0,227840,6,8552781000
13910,347483730,2148110,349631840,3,0,0,51200,0,750261513
13911,347607420,1467103,349074523,3,0,0,21504,0,9986573512
13912,347609311,13075945,360685256,0,0,1,13824,6,1227444144
13913,347638900,1923083,349561983,8,0,0,78848,6,4056280879
13914,347682900,1612582,349295482,0,0,0,115712,6,1385962414
13915,347808801,12882587,360691388,0,0,1,9728,6,8888911443
13916,347893799,1404662,349298461,4,0,0,9728,4,6852795085
13917,347895140,12796607,360691747,5,0,1,9728,11,2040164665
13918,347920461,12779018,360699479,0,0,1,12288,6,2812494130
13919,347938490,1741804,349680294,0,0,0,134144,6,4086828948
13920,347993541,12710444,360703985,0,0,1,7168,6,6839862307
13921,348081760,1386733,349468493,0,0,0,196096,6,3457424579
13922,348110160,12594593,360704753,9,0,1,11776,17,9193893366
13923,348112040,770286,348882326,5,0,0,59904,11,1457668908
13924,348128011,12594696,360722707,0,0,1,25088,6,446935099
13925,348165991,12559942,360725933,0,0,1,5120,6,6749114722
13926,348213369,854579,349067948,4,0,0,38912,4,2127067088
13927,348288930,1609758,349898688,8,0,0,219648,6,3676927508
13928,348317101,12462924,360780025,0,0,1,27136,6,5587151480
13929,348335460,12445231,360780691,7,0,1,1024,16,7766971918
13930,348351479,469926,348821405,4,0,0,3584,4,8455800628
13931,348376460,1543459,349919919,5,0,0,69632,11,7266057257
13932,348393110,12402664,360795774,6,0,1,28672,3,7974106111
13933,348466839,1533628,350000467,4,0,0,9728,4,9253697083
13934,348477140,386895,348864035,3,0,0,17920,0,7545940162
13935,348493741,12316859,360810600,0,0,1,7680,6,4892684144
13936,348498470,910260,349408730,0,0,0,116224,6,3901463463
13937,348535410,12278736,360814146,6,0,1,5632,3,9787188389
13938,348600310,989308,349589618,8,0,0,90624,6,9863411740
13939,348615130,1545506,350160636,3,0,0,184832,0,1264569889
13940,348681360,1014476,349695836,0,0,0,1024,6,9582448387
13941,348697020,12118432,360815452,5,0,1,2048,11,9233331812
13942,348707780,1656178,350363958,3,0,0,331776,0,5970720792
13943,348770249,864414,349634663,4,0,0,9216,4,10104742114
13944,348784240,911269,349695509,8,0,0,49664,6,8750614146
13945,348805740,12017511,360823251,3,0,1,6656,0,2705888272
13946,348827559,372568,349200127,4,0,0,2048,4,10276971056
13947,348828120,1169352,349997472,0,0,0,133120,6,7869475518
13948,348872030,11968756,360840786,4,0,1,20480,4,7901390083
13949,348881920,1184226,350066146,5,0,0,45568,11,4110517815
13950,348888569,930508,349819077,4,0,0,1536,4,6374829849
13951,348893890,808997,349702887,8,0,0,23040,6,2349069360
13952,348982630,1069601,350052231,0,0,0,145920,6,2750324161
13953,349124749,672271,349797020,4,0,0,6144,4,5851500765
13954,349180549,741601,349922150,4,0,0,7168,4,6004122068
13955,349191830,11650262,360842092,9,0,1,2048,17,1182934625
13956,349206140,11640458,360846598,9,0,1,7168,17,8184020669
13957,349237230,11626285,360863515,9,0,1,1536,17,2673027933
13958,349271330,1263826,350535156,3,0,0,343040,0,2767955161
13959,349281489,1328757,350610246,4,0,0,3584,4,7247522118
13960,349284710,1307783,350592493,5,0,0,154624,11,1516931107
13961,349397190,559707,349956897,0,0,0,8192,6,882106047
13962,349449110,1432846,350881956,3,0,0,223744,0,7597906093
13963,349496349,504601,350000950,4,0,0,1536,4,4704451915
13964,349554070,11309460,360863530,8,0,1,8704,6,5445772831
13965,349580979,495501,350076480,4,0,0,5120,4,9488385032
13966,349652290,536153,350188443,3,0,0,91136,0,976071896
13967,349675130,870212,350545342,3,0,0,31232,0,557181213
13968,349681019,854784,350535803,4,0,0,2048,4,8448204142
13969,349696100,703635,350399735,3,0,0,117248,0,6837579738
13970,349772230,11125362,360897592,9,0,1,4608,17,5068368673
13971,349791510,11121406,360912916,9,0,1,33280,17,3709217719
13972,349822900,943523,350766423,5,0,0,5120,11,968306326
13973,349863330,1187316,351050646,5,0,0,257024,11,6015094622
13974,349872020,11064455,360936475,9,0,1,1024,17,7605939476
13975,349882950,820644,350703594,0,0,0,27648,6,1167635490
13976,349886630,537620,350424250,3,0,0,80384,0,8738709280
13977,349914870,1243978,351158848,8,0,0,150528,6,6583039191
13978,349962790,11162835,361125625,7,0,1,33792,16,985974530
13979,349974700,942067,350916767,0,0,0,114176,6,8969274633
13980,350016830,1096107,351112937,0,0,0,204288,6,2525367602
13981,350029610,1491640,351521250,5,0,0,564224,11,1525036320
13982,350059079,533937,350593016,4,0,0,1536,4,5020328958
13983,350085640,1637885,351723525,3,0,0,54784,0,6885234809
13984,350123870,1545056,351668926,0,0,0,87040,6,5675039413
13985,350140140,1502227,351642367,8,0,0,358400,6,9297815016
13986,350144860,10980780,361125640,9,0,1,14336,17,4393894510
13987,350161220,10964435,361125655,9,0,1,10752,17,8574514762
13988,350225230,10900440,361125670,4,0,1,28160,4,7687547590
13989,350258150,1430557,351688707,0,0,0,41984,6,1479867608
13990,350302869,366315,350669184,4,0,0,2560,4,9590011555
13991,350362790,10762895,361125685,2,0,1,23040,11,3523859362
13992,350382200,10743500,361125700,9,0,1,1536,17,10715139082
13993,350385169,1557963,351943132,4,0,0,3584,4,10457227891
13994,350439840,836638,351276478,3,0,0,30208,0,5894150399
13995,350475140,10658433,361133573,2,0,1,22016,11,6962252690
13996,350487850,1598334,352086184,8,0,0,337920,6,1367888132
13997,350498730,10637468,361136198,4,0,1,13312,4,8453971733
13998,350519240,10668105,361187345,9,0,1,25600,17,3426538920
13999,350534050,1738782,352272832,5,0,0,4608,11,5204480881
14000,350546640,10655629,361202269,2,0,1,14336,11,9381626211
14001,350577660,10626875,361204535,6,0,1,3584,3,1158580356
14002,350602019,1795415,352397434,4,0,0,4096,4,5603132283
14003,350610210,921515,351531725,3,0,0,34304,0,3967224809
14004,350622950,721945,351344895,8,0,0,37376,6,9325037681
14005,350662440,10544041,361206481,4,0,1,3072,4,3268792355
14006,350685000,10528697,361213697,2,0,1,18432,11,951814422
14007,350721280,985538,351706818,8,0,0,59392,6,9883366406
14008,350724780,1906679,352631459,0,0,0,158720,6,3004951104
14009,350731870,2298853,353030723,6,0,0,355328,3,10279581630
14010,350753929,916572,351670501,4,0,0,5120,4,4174008292
14011,350766950,1960724,352727674,3,0,0,22016,0,10631331419
14012,350784710,10448684,361233394,6,0,1,15360,3,1299691731
14013,350818680,1102726,351921406,3,0,0,25088,0,6308284154
14014,350838140,10443528,361281668,2,0,1,93184,11,7168570777
14015,350882520,10437590,361320110,2,0,1,11264,11,3387921721
14016,350917880,757980,351675860,0,0,0,17408,6,7132404996
14017,350917959,336019,351253978,4,0,0,3584,4,3168205528
14018,350936590,2407042,353343632,5,0,0,490496,11,1608197020
14019,350946940,10377886,361324826,2,0,1,3584,11,1389806604
14020,350962000,2404907,353366907,3,0,0,76288,0,8586197192
14021,350974560,10369074,361343634,4,0,1,1536,4,4315426742
14022,351011440,10334140,361345580,6,0,1,3072,3,3440375752
14023,351019560,708824,351728384,8,0,0,15872,6,10698049200
14024,351023890,10338300,361362190,2,0,1,39936,11,5942430359
14025,351069619,463525,351533144,4,0,0,4608,4,8003769018
14026,351159300,10224543,361383843,2,0,1,41472,11,3623960204
14027,351247800,10153900,361401700,6,0,1,30720,3,5843335793
14028,351272070,828808,352100878,8,0,0,48128,6,179623307
14029,351293510,2334351,353627861,3,0,0,469504,0,7955119979
14030,351300790,1109647,352410437,3,0,0,41472,0,9733105093
14031,351305980,1277096,352583076,8,0,0,215040,6,2613470281
14032,351308030,10103034,361411064,2,0,1,16896,11,8742091597
14033,351316610,10095120,361411730,6,0,1,1024,3,6341738113
14034,351328520,10087384,361415904,6,0,1,19968,3,9580717565
14035,351396580,1311446,352708026,8,0,0,59392,6,5776253415
14036,351469010,2226520,353695530,0,0,0,200192,6,1838047423
14037,351472300,10004399,361476699,6,0,1,34816,3,6772555114
14038,351478740,10021656,361500396,6,0,1,3072,3,2855354686
14039,351521429,1165619,352687048,4,0,0,512,4,10462120212
14040,351572400,9929072,361501472,6,0,1,13312,3,4946764350
14041,351585219,297853,351883072,4,0,0,3072,4,10320273502
14042,351597279,262576,351859855,4,0,0,512,4,5560182263
14043,351617680,1576459,353194139,3,0,0,195584,0,4349350937
14044,351621660,1851700,353473360,5,0,0,202240,11,6424536596
14045,351649000,1485532,353134532,8,0,0,54784,6,10088222103
14046,351650899,981675,352632574,4,0,0,3584,4,4375143382
14047,351674920,1442889,353117809,5,0,0,283648,11,3204147156
14048,351680250,1731475,353411725,8,0,0,144896,6,951401052
14049,351695730,9846594,361542324,4,0,1,26112,4,2144742917
14050,351716410,1205551,352921961,8,0,0,296448,6,4824061892
14051,351745970,963007,352708977,0,0,0,3072,6,2763109411
14052,351763560,9788909,361552469,4,0,1,13312,4,4108300210
14053,351817480,9738215,361555695,6,0,1,5120,3,3922536756
14054,351847110,2113153,353960263,0,0,0,446976,6,2790058224
14055,351893010,9667537,361560547,4,0,1,17920,4,4640361160
14056,351909219,1458335,353367554,4,0,0,2048,4,5945422678
14057,351912280,1846609,353758889,5,0,0,207872,11,4077554962
14058,351950400,9646996,361597396,6,0,1,20992,3,6190596125
14059,351974599,947845,352922444,4,0,0,1536,4,748729064
14060,352072920,2105409,354178329,5,0,0,136704,11,3819457623
14061,352077610,9519801,361597411,4,0,1,29184,4,9602083141
14062,352146660,1338134,353484794,8,0,0,37376,6,7421970875
14063,352209430,9399064,361608494,4,0,1,13312,4,8499846156
14064,352238050,9370598,361608648,4,0,1,8704,4,5153386004
14065,352249819,781543,353031362,4,0,0,2048,4,7428236595
14066,352276050,1780698,354056748,0,0,0,235520,6,7700504443
14067,352290360,9319445,361609805,6,0,1,1024,3,4065865455
14068,352327950,1459100,353787050,8,0,0,91136,6,317750617
14069,352349330,1635604,353984934,8,0,0,80896,6,9568344860
14070,352418010,9243184,361661194,4,0,1,22528,4,9525581892
14071,352419350,1849478,354268828,0,0,0,106496,6,6031419047
14072,352424949,1632967,354057916,4,0,0,2560,4,6726769779
14073,352517250,1115842,353633092,5,0,0,16896,11,1978157269
14074,352526339,1532216,354058555,4,0,0,2048,4,2548784750
14075,352567979,1066532,353634511,4,0,0,4608,4,1081705929
14076,352617710,9059925,361677635,6,0,1,37888,3,2101636606
14077,352674700,9012755,361687455,4,0,1,33280,4,443559227
14078,352779460,8921703,361701163,6,0,1,14336,3,7934273874
14079,352785040,8920949,361705989,4,0,1,7680,4,9931553473
14080,352791920,1344726,354136646,8,0,0,65024,6,4670480812
14081,352797449,1259649,354057098,4,0,0,1024,4,2783875349
14082,352830050,9077745,361907795,1,0,1,306176,6,1503928955
14083,352872280,1221733,354094013,8,0,0,116224,6,8985332454
14084,353006190,8909187,361915377,2,0,1,20480,11,7650071411
14085,353018620,1216794,354235414,0,0,0,59904,6,6831637998
14086,353098220,1018584,354116804,3,0,0,74752,0,2242035834
14087,353131700,692337,353824037,5,0,0,121344,11,5850606589
14088,353152550,8776485,361929035,8,0,1,4608,6,5796037738
14089,353201020,558193,353759213,8,0,0,512,6,9872196760
14090,353216190,1367701,354583891,5,0,0,335872,11,2453576379
14091,353310810,904255,354215065,5,0,0,116224,11,7759654939
14092,353345219,870189,354215408,4,0,0,1024,4,808601299
14093,353424430,974343,354398773,5,0,0,280576,11,2554839414
14094,353428039,808326,354236365,4,0,0,3072,4,3385214743
14095,353428770,844133,354272903,5,0,0,1536,11,6135142680
14096,353466820,712818,354179638,8,0,0,512,6,3100169123
14097,353514139,703000,354217139,4,0,0,5632,4,2363980895
14098,353536210,1092771,354628981,3,0,0,60928,0,5167665913
14099,353555700,8378280,361933980,8,0,1,2560,6,1217833703
14100,353575460,1245025,354820485,5,0,0,126464,11,1985809759
14101,353616670,562158,354178828,8,0,0,1536,6,7311538420
14102,353652669,526798,354179467,4,0,0,2048,4,7005899719
14103,353711440,559796,354271236,3,0,0,7680,0,7436802470
14104,353746150,525280,354271430,8,0,0,512,6,3504860240
14105,353769840,502541,354272381,8,0,0,3072,6,8034566050
14106,353793550,606065,354399615,8,0,0,2048,6,5393430611
14107,353845960,759037,354604997,8,0,0,4096,6,4077055293
14108,353897909,707259,354605168,4,0,0,512,4,3715413562
14109,353909580,746455,354656035,0,0,0,30208,6,8719713059
14110,353947440,1132963,355080403,3,0,0,205824,0,6207685693
14111,353955320,648398,354603718,5,0,0,65024,11,101989307
14112,353964400,434560,354398960,8,0,0,512,6,4872572290
14113,353978531,7961043,361939574,0,0,1,18432,6,2781651597
14114,354044330,566064,354610394,8,0,0,4608,6,2509776113
14115,354049591,7894532,361944123,0,0,1,4608,6,9910688281
14116,354073470,707658,354781128,5,0,0,220160,11,8438846299
14117,354149200,718256,354867456,0,0,0,154112,6,10034775916
14118,354201230,7748795,361950025,4,0,1,20992,4,8178598434
14119,354205639,224801,354430440,4,0,0,512,4,1693230754
14120,354245330,363645,354608975,5,0,0,12288,11,5464848598
14121,354318860,7631831,361950691,4,0,1,1024,4,2142111444
14122,354329830,7751193,362081023,1,0,1,276992,6,9510055788
14123,354353509,428429,354781938,4,0,0,1024,4,6763617729
14124,354385090,396521,354781611,8,0,0,1536,6,1231150547
14125,354398711,7688799,362087510,0,0,1,6144,6,6353708629
14126,354456140,8075878,362532018,1,0,1,453120,6,2663111259
14127,354485100,1104931,355590031,5,0,0,139776,11,3174393155
14128,354521180,8141896,362663076,1,0,1,262144,6,5996311150
14129,354538211,8145954,362684165,0,0,1,23552,6,7271283472
14130,354546270,915382,355461652,0,0,0,73728,6,3226142200
14131,354554910,318864,354873774,3,0,0,20480,0,971506413
14132,354562580,342224,354904804,8,0,0,512,6,6487122787
14133,354571030,8117347,362688377,4,0,1,6656,4,9471102199
14134,354606960,8087626,362694586,5,0,1,21504,11,20704977
14135,354649460,1342325,355991785,3,0,0,185344,0,10305092115
14136,354674250,701496,355375746,2,0,0,146944,11,6912292566
14137,354714410,808091,355522501,0,0,0,142336,6,3069889625
14138,354735229,911713,355646942,4,0,0,6656,4,4427638589
14139,354770200,668973,355439173,3,0,0,52736,0,3514243428
14140,354864690,7929703,362794393,2,0,1,75776,11,10487374711
14141,354893250,862572,355755822,3,0,0,48128,0,3054085613
14142,354903610,403565,355307175,8,0,0,3072,6,4762610842
14143,354909710,7888657,362798367,4,0,1,16384,4,3557610631
14144,354929340,460276,355389616,8,0,0,1024,6,5193365240
14145,354954670,507933,355462603,8,0,0,3072,6,732620589
14146,354977330,7822023,362799353,2,0,1,1536,11,1321263871
14147,354988589,609912,355598501,4,0,0,512,4,1631220671
14148,354994099,472248,355466347,4,0,0,1024,4,5521731925
14149,355000380,311503,355311883,3,0,0,4096,0,5083631454
14150,355016220,7811726,362827946,9,0,1,17920,17,4216827152
14151,355029310,1089177,356118487,5,0,0,415744,11,8497515858
14152,355035649,427782,355463431,4,0,0,1536,4,6209900878
14153,355056410,412258,355468668,8,0,0,512,6,3366190982
14154,355079690,387598,355467288,8,0,0,1024,6,64830858
14155,355135480,7852112,362987592,4,0,1,41984,4,4988551649
14156,355148259,375349,355523608,4,0,0,3584,4,5346644471
14157,355158670,776628,355935298,0,0,0,141824,6,8353401515
14158,355164450,433864,355598314,3,0,0,27136,0,9074176677
14159,355180160,7811196,362991356,4,0,1,59904,4,680620857
14160,355192610,416670,355609280,5,0,0,35328,11,9527651977
14161,355205370,642924,355848294,3,0,0,105984,0,6930392758
14162,355221190,7782839,363004029,2,0,1,5632,11,9716162738
14163,355268800,447460,355716260,3,0,0,27136,0,4324122321
14164,355280730,7739225,363019955,2,0,1,20480,11,8176108264
14165,355336260,7910855,363247115,4,0,1,143360,4,6418783047
14166,355367539,416563,355784102,4,0,0,4096,4,7208807787
14167,355371910,761691,356133601,3,0,0,47104,0,5746606905
14168,355386590,7862353,363248943,2,0,1,3072,11,1602340421
14169,355470750,759765,356230515,3,0,0,123904,0,1320721448
14170,355496190,7842865,363339055,2,0,1,32768,11,8755239051
14171,355535600,350376,355885976,3,0,0,14336,0,1694775155
14172,355543569,313885,355857454,4,0,0,4608,4,2643344681
14173,355544880,304380,355849260,8,0,0,3072,6,1875464020
14174,355552770,7786300,363339070,4,0,1,512,4,1342412517
14175,355555550,336521,355892071,0,0,0,8704,6,5733290243
14176,355577920,7761165,363339085,2,0,1,13824,11,5020810346
14177,355658560,605930,356264490,3,0,0,44032,0,7098993736
14178,355705420,545586,356251006,3,0,0,67072,0,521074113
14179,355728820,463928,356192748,3,0,0,194048,0,7842282882
14180,355762009,356976,356118985,4,0,0,1536,4,221991455
14181,355848670,7490430,363339100,9,0,1,7680,17,6104426968
14182,355855839,263317,356119156,4,0,0,512,4,5056103141
14183,356000520,422151,356422671,3,0,0,25600,0,9521488084
14184,356001660,7408777,363410437,4,0,1,63488,4,7242033780
14185,356014850,265213,356280063,8,0,0,4608,6,627442487
14186,356037030,7408987,363446017,4,0,1,117760,4,4483493798
14187,356037250,7436533,363473783,4,0,1,47616,4,7162099937
14188,356040280,224486,356264766,8,0,0,512,6,1944367629
14189,356063420,7411029,363474449,4,0,1,1024,4,7263379888
14190,356132239,280614,356412853,4,0,0,1024,4,4786884593
14191,356142670,234152,356376822,8,0,0,1024,6,4749533329
14192,356237510,688696,356926206,0,0,0,33280,6,9134749821
14193,356318880,185370,356504250,8,0,0,1024,6,6836106527
14194,356349580,7228772,363578352,1,0,1,148480,6,10547138965
14195,356359440,7261614,363621054,4,0,1,60928,4,5325373404
14196,356362889,446311,356809200,4,0,0,1536,4,8859688376
14197,356396160,316048,356712208,5,0,0,31232,11,8969256926
14198,356408920,397559,356806479,3,0,0,108544,0,7559259408
14199,356421220,7221543,363642763,6,0,1,14848,3,9029343654
14200,356423030,493021,356916051,5,0,0,132608,11,3842800256
14201,356437220,7234763,363671983,1,0,1,54272,6,3654669482
14202,356501629,329014,356830643,4,0,0,2048,4,8118256724
14203,356506539,252252,356758791,4,0,0,4608,4,9451180494
14204,356509010,504097,357013107,0,0,0,128512,6,5091004838
14205,356509729,350120,356859849,4,0,0,1536,4,418008057
14206,356516260,7170154,363686414,9,0,1,13824,17,2883513840
14207,356587540,7100052,363687592,4,0,1,13824,4,5739534875
14208,356608360,7079628,363687988,6,0,1,9728,3,7287421904
14209,356661810,539273,357201083,3,0,0,25600,0,6929425396
14210,356663280,529317,357192597,3,0,0,303104,0,3952159581
14211,356686840,1256319,357943159,0,0,0,322048,6,6270256402
14212,356693630,687535,357381165,5,0,0,53248,11,8208137912
14213,356745740,7017911,363763651,1,0,1,40960,6,6322539367
14214,356759159,434109,357193268,4,0,0,2048,4,4377464190
14215,356790150,411416,357201566,5,0,0,1536,11,3691154168
14216,356815020,6980650,363795670,5,0,1,2560,11,2237228074
14217,356837730,734103,357571833,0,0,0,261632,6,10454496419
14218,356846880,7170257,364017137,1,0,1,254976,6,10295439672
14219,356858159,761032,357619191,4,0,0,2560,4,9647283154
14220,356918360,1104269,358022629,5,0,0,134144,11,8023131059
14221,356922880,837714,357760594,5,0,0,101376,11,7794863813
14222,356924100,7096289,364020389,5,0,1,5120,11,10616076020
14223,356935480,7285518,364220998,1,0,1,320512,6,1133830363
14224,356936480,7291034,364227514,5,0,1,23040,11,5944655435
14225,356956370,618145,357574515,8,0,0,3584,6,2825431532
14226,357009390,7237020,364246410,9,0,1,7680,17,3178119347
14227,357009730,833217,357842947,5,0,0,226816,11,7444290503
14228,357021320,7228150,364249470,1,0,1,13312,6,2811923630
14229,357034890,642459,357677349,0,0,0,95744,6,1357000789
14230,357052320,7208723,364261043,4,0,1,9216,4,5720605038
14231,357055450,789570,357845020,8,0,0,4608,6,9704361949
14232,357077130,496278,357573408,0,0,0,5120,6,1186692662
14233,357081970,7276755,364358725,1,0,1,103936,6,1828524525
14234,357090570,1136492,358227062,5,0,0,159232,11,4825090443
14235,357099990,864985,357964975,5,0,0,69632,11,4229084269
14236,357112769,854139,357966908,4,0,0,3072,4,920436865
14237,357113700,7261144,364374844,1,0,1,19456,6,1238336596
14238,357146010,1002143,358148153,0,0,0,3072,6,3912708548
14239,357165030,7232023,364397053,9,0,1,4096,17,910087495
14240,357183950,961630,358145580,3,0,0,403456,0,8029255703
14241,357190760,1046478,358237238,5,0,0,31744,11,584603849
14242,357236740,7161901,364398641,9,0,1,15872,17,2276797759
14243,357249560,928412,358177972,3,0,0,97792,0,1437962343
14244,357250090,715852,357965942,3,0,0,3072,0,448321938
14245,357273300,7210355,364483655,9,0,1,37376,17,2581105526
14246,357277690,402646,357680336,8,0,0,9728,6,3958779575
14247,357283000,7200686,364483686,9,0,1,22016,17,5956995090
14248,357320600,7201493,364522093,9,0,1,50176,17,572890161
14249,357334070,7283674,364617744,9,0,1,29184,17,1693912782
14250,357346810,7290173,364636983,9,0,1,28672,17,2873907437
14251,357348820,7290762,364639582,9,0,1,15360,17,10250804994
14252,357364099,814200,358178299,4,0,0,1024,4,588030420
14253,357373360,7321858,364695218,9,0,1,46592,17,5189180199
14254,357399850,443751,357843601,0,0,0,2048,6,419014093
14255,357428859,514783,357943642,4,0,0,1536,4,10391818204
14256,357553040,7237750,364790790,1,0,1,137216,6,7421336856
14257,357606630,7184928,364791558,9,0,1,11776,17,5423768063
14258,357610860,663041,358273901,5,0,0,50176,11,7286576984
14259,357627890,353852,357981742,3,0,0,30720,0,3048131082
14260,357636060,7158438,364794498,8,0,1,3072,6,7270644945
14261,357639320,7201431,364840751,1,0,1,80384,6,1382971614
14262,357645240,7808351,365453591,1,0,1,131072,6,3262793025
14263,357676250,470905,358147155,0,0,0,5120,6,224299503
14264,357686010,8063358,365749368,1,0,1,132096,6,1141512175
14265,357694430,272711,357967141,0,0,0,512,6,3306297476
14266,357699910,8647657,366347567,1,0,1,310784,6,6135220234
14267,357736930,8638384,366375314,3,0,1,9728,0,7759966740
14268,357778810,8596519,366375329,9,0,1,2560,17,2556913029
14269,357782269,575679,358357948,4,0,0,6656,4,9073709645
14270,357805020,1390707,359195727,5,0,0,109056,11,518724576
14271,357858239,369150,358227389,4,0,0,1024,4,4510718795
14272,357861090,8514254,366375344,3,0,1,18944,0,1517131275
14273,357862919,848426,358711345,4,0,0,1536,4,9969245255
14274,357875170,789751,358664921,5,0,0,55296,11,5537952792
14275,357884440,551884,358436324,3,0,0,25088,0,2588380715
14276,357892590,752724,358645314,5,0,0,336384,11,8965299801
14277,357894480,955433,358849913,3,0,0,317952,0,2508781502
14278,357934800,1005930,358940730,0,0,0,2048,6,303377504
14279,357972540,969624,358942164,8,0,0,4608,6,1644799195
14280,357992030,8384997,366377027,8,0,1,3584,6,6413197274
14281,357992830,8441654,366434484,3,0,1,36864,0,8311824244
14282,358001230,515274,358516504,0,0,0,512,6,9663931724
14283,358016710,923343,358940053,3,0,0,257024,0,8570937681
14284,358018060,832047,358850107,0,0,0,512,6,8327989028
14285,358025300,836366,358861666,3,0,0,37888,0,9310004586
14286,358052550,8381949,366434499,3,0,1,2560,0,5232357233
14287,358069970,8391688,366461658,3,0,1,32768,0,8607266943
14288,358078440,654691,358733131,8,0,0,1536,6,3246875905
14289,358084630,1077846,359162476,3,0,0,175104,0,4254236619
14290,358104310,8374375,366478685,8,0,1,25088,6,8728366495
14291,358110670,8387498,366498168,8,0,1,27136,6,6416006804
14292,358120330,8378184,366498514,9,0,1,512,17,2038907117
14293,358122190,8380190,366502380,8,0,1,6144,6,345166774
14294,358135160,8367886,366503046,8,0,1,1024,6,477309609
14295,358157430,8347242,366504672,9,0,1,2560,17,3869151509
14296,358166509,479186,358645695,4,0,0,1024,4,4739234988
14297,358202680,1226991,359429671,5,0,0,228864,11,9452208843
14298,358250000,8256940,366506940,3,0,1,9728,0,8647615907
14299,358259590,440555,358700145,8,0,0,3584,6,6508916782
14300,358285160,362898,358648058,3,0,0,7680,0,8536210278
14301,358346670,8160616,366507286,3,0,1,512,0,7290604822
14302,358410200,8097547,366507747,8,0,1,10240,6,281333675
14303,358454220,8075105,366529325,9,0,1,15872,17,1753580188
14304,358454889,993688,359448577,4,0,0,61952,4,157695871
14305,358507670,753653,359261323,5,0,0,91136,11,1347566509
14306,358537890,412759,358950649,3,0,0,27648,0,6913454248
14307,358574700,7983459,366558159,3,0,1,66048,0,4771199963
14308,358599640,7987749,366587389,3,0,1,16384,0,77912766
14309,358610230,1033405,359643635,5,0,0,265216,11,2229132309
14310,358625800,7965135,366590935,9,0,1,5632,17,2034458087
14311,358648230,7948248,366596478,3,0,1,26112,0,5075707485
14312,358652350,7950600,366602950,8,0,1,13312,6,88778158
14313,358652620,8032467,366685087,3,0,1,13312,0,9249889766
14314,358652910,8032987,366685897,9,0,1,30720,17,8976232110
14315,358654829,1054469,359709298,4,0,0,88064,4,8167133125
14316,358673090,8012822,366685912,3,0,1,8192,0,8047061865
14317,358680179,553167,359233346,4,0,0,123392,4,7902535705
14318,358686640,832997,359519637,0,0,0,4608,6,6910114023
14319,358687620,599934,359287554,5,0,0,86016,11,5273188277
14320,358699710,7986217,366685927,8,0,1,28672,6,6677389784
14321,358736940,496577,359233517,0,0,0,512,6,1790645714
14322,358763330,919061,359682391,3,0,0,56320,0,5192416222
14323,358836069,953654,359789723,4,0,0,192000,4,1963497239
14324,358881690,7804252,366685942,8,0,1,14848,6,6035875101
14325,358910310,820407,359730717,3,0,0,70144,0,7528951797
14326,358931620,356885,359288505,3,0,0,3072,0,945690169
14327,358988260,7814691,366802951,8,0,1,27136,6,2583449443
14328,358996620,7810276,366806896,3,0,1,13312,0,3884300746
14329,359066220,7740707,366806927,3,0,1,26624,0,1993234661
14330,359112090,552620,359664710,3,0,0,69120,0,10135020477
14331,359163600,501616,359665216,0,0,0,1536,6,660517224
14332,359214800,591710,359806510,0,0,0,2048,6,2696050887
14333,359230200,95567,359325767,8,0,0,512,6,8455668919
14334,359273130,618707,359891837,5,0,0,91648,11,9585222172
14335,359304820,7502122,366806942,3,0,1,6144,0,10314341002
14336,359357010,7449947,366806957,3,0,1,15360,0,3343937744
14337,359408740,322468,359731208,0,0,0,1536,6,9051830770
14338,359409590,389325,359798915,3,0,0,23040,0,5149102382
14339,359531060,260744,359791804,0,0,0,6656,6,5923081282
14340,359547639,375170,359922809,4,0,0,47104,4,372914115
14341,359567690,7239282,366806972,3,0,1,6656,0,10238024006
14342,359638740,7171850,366810590,8,0,1,6656,6,451231398
14343,359658680,265764,359924444,8,0,0,5120,6,6335324205
14344,359665310,7145295,366810605,3,0,1,8704,0,5540966840
14345,359683760,314917,359998677,3,0,0,10240,0,6882394378
14346,359705860,7104784,366810644,3,0,1,19456,0,10083905046
14347,359757820,7052839,366810659,8,0,1,23040,6,1835256145
14348,359832130,6978739,366810869,3,0,1,12288,0,7793729931
14349,359865020,464793,360329813,5,0,0,274432,11,4046388012
14350,359907830,245120,360152950,8,0,0,2048,6,4145786196
14351,359944859,433723,360378582,4,0,0,62464,4,1442095109
14352,359959550,371214,360330764,3,0,0,3072,0,4041103378
14353,359965810,6869638,366835448,3,0,1,9216,0,2022157268
14354,359967870,6876897,366844767,8,0,1,12800,6,9744370596
14355,359989130,343224,360332354,8,0,0,5120,6,5637797683
14356,360162630,310353,360472983,8,0,0,1024,6,254450974
14357,360179479,364560,360544039,4,0,0,171008,4,10666066196
14358,360192370,6699788,366892158,6,0,1,53248,3,2402156996
14359,360195340,6790283,366985623,1,0,1,81408,6,8391826630
14360,360195860,7010106,367205966,3,0,1,231424,0,1913499523
14361,360210460,7083082,367293542,3,0,1,111104,0,1729906519
14362,360214560,441263,360655823,5,0,0,15872,11,2710809683
14363,360247570,7045987,367293557,7,0,1,14848,16,8817144830
14364,360333280,6960292,367293572,6,0,1,6144,3,3408238401
14365,360440100,6926156,367366256,3,0,1,155648,0,350626692
14366,360461510,6911099,367372609,7,0,1,2048,16,6504627270
14367,360467690,366255,360833945,0,0,0,512,6,8394098389
14368,360492540,492722,360985262,3,0,0,108032,0,7778939355
14369,360524280,339220,360863500,5,0,0,51712,11,9089205428
14370,360527610,554585,361082195,5,0,0,95232,11,8346211081
14371,360540050,585528,361125578,3,0,0,142336,0,5316433574
14372,360541860,6831005,367372865,7,0,1,9216,16,1140636412
14373,360565680,7334465,367900145,3,0,1,382976,0,3091805419
14374,360576480,595327,361171807,3,0,0,70144,0,9441277409
14375,360649690,340579,360990269,3,0,0,16384,0,5018465795
14376,360656690,7379213,368035903,3,0,1,94208,0,2412842741
14377,360676730,7359188,368035918,6,0,1,12288,3,518772943
14378,360680580,7378118,368058698,7,0,1,27136,16,4429751348
14379,360693090,505881,361198971,3,0,0,34816,0,7732476183
14380,360743389,267646,361011035,4,0,0,6656,4,3788748247
14381,360805340,7359958,368165298,3,0,1,110080,0,10022457102
14382,360832270,7338019,368170289,6,0,1,39936,3,2234292189
14383,360866570,385909,361252479,5,0,0,56320,11,6163308041
14384,360886490,104270,360990760,0,0,0,1536,6,3691978269
14385,360945580,99066,361044646,8,0,0,1024,6,5672428434
14386,360967410,7203545,368170955,7,0,1,1024,16,6745065229
14387,361066140,595039,361661179,3,0,0,98816,0,8625289336
14388,361069150,7191584,368260734,7,0,1,143360,16,1538244000
14389,361069790,268200,361337990,8,0,0,4608,6,6427111032
14390,361080700,7236804,368317504,6,0,1,11264,3,9132295730
14391,361130040,410815,361540855,8,0,0,3584,6,4716712730
14392,361132500,7718860,368851360,7,0,1,171008,16,9504016065
14393,361138510,7712873,368851383,7,0,1,47104,16,4971474962
14394,361140830,7711207,368852037,7,0,1,29184,16,3820150179
14395,361180959,540048,361721007,4,0,0,8192,4,1590222360
14396,361200440,209485,361409925,8,0,0,512,6,157551192
14397,361286960,310421,361597381,5,0,0,116224,11,5031246840
14398,361295080,382524,361677604,5,0,0,33792,11,1567135018
14399,361310579,356714,361667293,4,0,0,19968,4,9258205833
14400,361352610,353925,361706535,0,0,0,1024,6,7891226667
14401,361402891,7449161,368852052,0,0,1,2560,6,1350316728
14402,361414490,184709,361599199,8,0,0,5120,6,5123510569
14403,361422380,7516882,368939262,7,0,1,182272,16,6319464692
14404,361492830,228348,361721178,0,0,0,512,6,5996830021
14405,361524360,228895,361753255,8,0,0,1024,6,7603285677
14406,361526140,212011,361738151,3,0,0,512,0,478703714
14407,361540590,239586,361780176,8,0,0,1024,6,204862228
14408,361543630,7400018,368943648,2,0,1,7680,11,10051683828
14409,361596040,7363290,368959330,6,0,1,45056,3,9315097553
14410,361597490,7364426,368961916,6,0,1,4096,3,1967143633
14411,361606620,7539796,369146416,7,0,1,177152,16,3060656026
14412,361609500,213352,361822852,0,0,0,512,6,10667653366
14413,361612080,7534351,369146431,2,0,1,31744,11,1859820248
14414,361619200,213523,361832723,3,0,0,1536,0,4891433933
14415,361794250,348850,362143100,3,0,0,2048,0,4426218621
14416,361898270,281756,362180026,0,0,0,1536,6,7393751860
14417,361904210,487838,362392048,5,0,0,225792,11,9588101534
14418,361908500,384841,362293341,3,0,0,2560,0,10534530132
14419,361986220,523433,362509653,5,0,0,243712,11,3076304666
14420,361989550,128761,362118311,0,0,0,1024,6,8974009592
14421,362025340,241044,362266384,0,0,0,2048,6,5461558028
14422,362050260,342115,362392375,0,0,0,1024,6,917602116
14423,362065031,7081415,369146446,0,0,1,1024,6,2239712378
14424,362067170,208178,362275348,0,0,0,4096,6,3823166081
14425,362153300,375252,362528552,5,0,0,61952,11,9781658017
14426,362158090,274526,362432616,3,0,0,2560,0,1950811275
14427,362164020,149969,362313989,3,0,0,1536,0,5642781100
14428,362205530,202642,362408172,3,0,0,5632,0,9462281030
14429,362247340,283099,362530439,2,0,0,6144,11,2703247979
14430,362251010,413772,362664782,3,0,0,4608,0,6718553927
14431,362305010,6872466,369177476,3,0,1,109568,0,9485056006
14432,362370870,6819523,369190393,2,0,1,28672,11,8112978956
14433,362390860,6800301,369191161,2,0,1,11776,11,3529740646
14434,362406600,6787467,369194067,6,0,1,4608,3,6001463108
14435,362422320,6772413,369194733,2,0,1,1024,11,362039272
14436,362438059,549510,362987569,4,0,0,327168,4,9354756731
14437,362502400,595695,363098095,5,0,0,59904,11,3799420957
14438,362518079,820945,363339024,4,0,0,237568,4,3714566855
14439,362540460,153281,362693741,8,0,0,3584,6,2551687786
14440,362547170,6651583,369198753,2,0,1,14848,11,10702561674
14441,362615780,6613339,369229119,2,0,1,48128,11,8338278389
14442,362616450,6620672,369237122,9,0,1,8192,17,5410013064
14443,362663739,447327,363111066,4,0,0,42496,4,1149681993
14444,362669430,6577486,369246916,9,0,1,5120,17,1720346846
14445,362685130,729105,363414235,8,0,0,9216,6,3821561986
14446,362692160,365151,363057311,2,0,0,7168,11,9197105570
14447,362695570,6551603,369247173,9,0,1,11264,17,7531570251
14448,362723470,300761,363024231,8,0,0,1024,6,8614751590
14449,362727560,6522098,369249658,2,0,1,2048,11,4827398631
14450,362801430,186489,362987919,8,0,0,1024,6,2741778161
14451,362816550,295623,363112173,8,0,0,3584,6,5884574743
14452,362855410,6394812,369250222,8,0,1,10752,6,1830408722
14453,362865099,539224,363404323,4,0,0,214016,4,2895658181
14454,362922099,324993,363247092,4,0,0,56832,4,1956870718
14455,363036490,374906,363411396,8,0,0,3072,6,5931749505
14456,363060420,362760,363423180,3,0,0,2560,0,10693189764
14457,363087670,334715,363422385,8,0,0,1536,6,5211452518
14458,363116680,305222,363421902,5,0,0,25088,11,1147740911
14459,363140479,269943,363410422,4,0,0,19968,4,731272892
14460,363149720,295791,363445511,2,0,0,73216,11,6295741688
14461,363182210,263792,363446002,8,0,0,1536,6,4206555470
14462,363218390,6033138,369251528,6,0,1,2048,3,5532314564
14463,363234520,6021182,369255702,9,0,1,19968,17,7833263038
14464,363270030,304031,363574061,5,0,0,47104,11,3854626560
14465,363272260,5983903,369256163,6,0,1,10240,3,3578183594
14466,363344670,553689,363898359,2,0,0,265216,11,4037596135
14467,363357390,599955,363957345,2,0,0,136704,11,4631255392
14468,363406600,5850639,369257239,6,0,1,13312,3,2161648413
14469,363425720,5836104,369261824,9,0,1,3584,17,6308652884
14470,363437160,463257,363900417,5,0,0,6144,11,6081799173
14471,363440540,464580,363905120,5,0,0,15360,11,7252505987
14472,363480470,418060,363898530,3,0,0,512,0,189146723
14473,363618930,354594,363973524,8,0,0,512,6,8490121061
14474,363641690,316146,363957836,8,0,0,1536,6,10730847507
14475,363644990,5620188,369265178,6,0,1,15872,3,8007150149
14476,363698271,5594503,369292774,0,0,1,20480,6,10419860196
14477,363752320,5545017,369297337,9,0,1,1024,17,5570322607
14478,363762380,196407,363958787,3,0,0,3072,0,7817149873
14479,363865059,462153,364327212,4,0,0,154112,4,4535708929
14480,363892549,591091,364483640,4,0,0,155136,4,3902052772
14481,363923749,686118,364609867,4,0,0,268800,4,954126580
14482,363954580,5399212,369353792,1,0,1,102400,6,7717550063
14483,363996510,330889,364327399,3,0,0,512,0,9566052028
14484,364019180,5769867,369789047,1,0,1,608256,6,1894345894
14485,364021270,5783702,369804972,1,0,1,43008,6,2701020059
14486,364041350,5765888,369807238,5,0,1,3584,11,9900268509
14487,364061899,620942,364682841,4,0,0,131584,4,1020806421
14488,364067219,547507,364614726,4,0,0,15872,4,3377988815
14489,364093460,390553,364484013,8,0,0,1024,6,493039577
14490,364175420,5637105,369812525,9,0,1,16896,17,5751062666
14491,364188801,5629625,369818426,0,0,1,19968,6,6725651443
14492,364261080,160185,364421265,0,0,0,3584,6,4823617358
14493,364281460,5540192,369821652,6,0,1,5120,3,667147491
14494,364307100,388095,364695195,3,0,0,512,0,2108877225
14495,364321070,5502733,369823803,9,0,1,26624,17,1749240165
14496,364340589,354435,364695024,4,0,0,39936,4,4609044196
14497,364348170,269543,364617713,2,0,0,9728,11,10092221242
14498,364444160,5384149,369828309,9,0,1,7168,17,10125747511
14499,364452760,624460,365077220,2,0,0,281600,11,10572827866
14500,364562280,630290,365192570,2,0,0,109568,11,10305874325
14501,364575240,5254094,369829334,6,0,1,20992,3,303551533
14502,364595400,858168,365453568,9,0,0,502784,17,8467730029
14503,364664270,415469,365079739,0,0,0,8192,6,5643025809
14504,364691150,843403,365534553,5,0,0,135168,11,6425768583
14505,364766580,5228967,369995547,1,0,1,296448,6,10567037655
14506,364783630,411763,365195393,9,0,0,9216,17,4561105078
14507,364798690,682060,365480750,9,0,0,89088,17,5136228624
14508,364874780,874565,365749345,5,0,0,74240,11,9523759866
14509,364892680,834030,365726710,9,0,0,53248,17,3534348363
14510,364919370,653085,365572455,9,0,0,88064,17,1306172438
14511,364949350,878561,365827911,2,0,0,142848,11,3880657994
14512,364962570,5056183,370018753,1,0,1,28160,6,2192361953
14513,364964260,5060450,370024710,9,0,1,5120,17,9010533630
14514,364993160,717287,365710447,5,0,0,241152,11,7073033197
14515,365034870,1205066,366239936,9,0,0,389120,17,5997735477
14516,365039240,4988696,370027936,1,0,1,5120,6,7987784976
14517,365058110,771407,365829517,8,0,0,3072,6,10150566705
14518,365122830,4927817,370050647,8,0,1,6656,6,8002883792
14519,365138660,891669,366030329,8,0,0,5120,6,4675433895
14520,365210750,4840461,370051211,9,0,1,10752,17,5054301104
14521,365233420,383841,365617261,0,0,0,2560,6,479830460
14522,365286181,4765798,370051979,0,0,1,11776,6,1350887006
14523,365290040,489868,365779908,3,0,0,2560,0,2605140336
14524,365294420,4809988,370104408,1,0,1,22016,6,5292446299
14525,365296470,4808604,370105074,1,0,1,1024,6,4883086455
14526,365384570,4724029,370108599,9,0,1,13824,17,3205181645
14527,365390480,4722945,370113425,9,0,1,7680,17,8868780426
14528,365422091,4696519,370118610,0,0,1,16384,6,4259374601
14529,365433620,568537,366002157,9,0,0,17920,17,5024694168
14530,365522941,4608445,370131386,0,0,1,60928,6,7664877348
14531,365530550,498204,366028754,2,0,0,51712,11,7288684334
14532,365538111,4607537,370145648,0,0,1,8704,6,10265806055
14533,365556159,694876,366251035,4,0,0,36352,4,6243697275
14534,365558789,334524,365893313,4,0,0,74240,4,434445284
14535,365565470,4600022,370165492,9,0,1,16384,17,528402264
14536,365572290,709834,366282124,9,0,0,99328,17,3733655861
14537,365579700,4617370,370197070,1,0,1,48128,6,9816705526
14538,365583230,702349,366285579,9,0,0,11264,17,9993772850
14539,365595530,4620927,370216457,1,0,1,4096,6,4035959755
14540,365596971,4621432,370218403,0,0,1,3072,6,5218951939
14541,365604821,4617199,370222020,0,0,1,5632,6,8273712519
14542,365609211,4613475,370222686,0,0,1,1024,6,2186123438
14543,365609930,218620,365828550,3,0,0,2048,0,9694439794
14544,365630439,802767,366433206,4,0,0,147968,4,9920938958
14545,365640810,4582235,370223045,4,0,1,9728,4,8915849926
14546,365653571,4570460,370224031,0,0,1,1536,6,10408618651
14547,365660480,4568377,370228857,9,0,1,19968,17,542509028
14548,365689940,4540863,370230803,1,0,1,3072,6,6033458867
14549,365710550,541295,366251845,0,0,0,512,6,9245813588
14550,365722680,4512309,370234989,1,0,1,6656,6,4863678629
14551,365746970,938094,366685064,9,0,0,155136,17,9996790557
14552,365747740,4560475,370308215,1,0,1,26112,6,2135234369
14553,365747790,4562054,370309844,1,0,1,40448,6,4665624278
14554,365787530,4522329,370309859,9,0,1,1024,17,2564269295
14555,365789340,4520534,370309874,1,0,1,2048,6,10454861222
14556,365818209,984719,366802928,4,0,0,361472,4,1717003505
14557,365818280,556224,366374504,9,0,0,82432,17,5573477706
14558,365824760,985815,366810575,5,0,0,11776,11,1783404077
14559,365829100,808042,366637142,9,0,0,74752,17,560376699
14560,365839799,411875,366251674,4,0,0,2048,4,4560932137
14561,365877470,417060,366294530,8,0,0,14336,6,4157580433
14562,365881581,4428308,370309889,0,0,1,10752,6,9493261725
14563,365891161,4418743,370309904,0,0,1,4608,6,3168937168
14564,365892340,455212,366347552,5,0,0,21504,11,4164291251
14565,365928051,4421093,370349144,0,0,1,51712,6,4819845693
14566,365946540,4404550,370351090,9,0,1,3072,17,2181153081
14567,365955550,637233,366592783,8,0,0,3584,6,3082535017
14568,365985390,389909,366375299,8,0,0,2560,6,2940153407
14569,365987910,4383533,370371443,9,0,1,22016,17,5562215319
14570,365994281,4378788,370373069,0,0,1,2560,6,2131451895
14571,366011221,4362514,370373735,0,0,1,1024,6,7869990518
14572,366024480,661402,366685882,0,0,0,2560,6,878158456
14573,366025550,4405195,370430745,9,0,1,10752,17,878452049
14574,366047850,239206,366287056,0,0,0,1536,6,8605988903
14575,366052200,335907,366388107,3,0,0,5120,0,5336804610
14576,366056550,229988,366286538,3,0,0,3072,0,8151103267
14577,366071230,4361752,370432982,3,0,1,48640,0,6158332491
14578,366074670,442016,366516686,8,0,0,2048,6,5029660546
14579,366076269,612340,366688609,4,0,0,8704,4,1983884138
14580,366079840,4377884,370457724,9,0,1,19456,17,5500519042
14581,366125960,308509,366434469,3,0,0,4096,0,216191938
14582,366215469,591412,366806881,4,0,0,11264,4,3998313451
14583,366280460,4248729,370529189,7,0,1,131072,16,1348617914
14584,366298370,800399,367098769,9,0,0,35840,17,8801795938
14585,366306151,4227544,370533695,0,0,1,7168,6,8924746620
14586,366306800,271871,366578671,3,0,0,6144,0,4677160161
14587,366307810,674748,366982558,5,0,0,128000,11,9967806943
14588,366313210,128312,366441522,8,0,0,3072,6,8454667501
14589,366315560,4219365,370534925,7,0,1,22016,16,5083385640
14590,366321760,316021,366637781,8,0,0,2048,6,4362210558
14591,366380040,756484,367136524,5,0,0,59392,11,4291310619
14592,366382870,4225374,370608244,7,0,1,148992,16,9985085944
14593,366389340,4414608,370803948,3,0,1,295936,0,10555346382
14594,366418811,4408023,370826834,0,0,1,20480,6,5097569119
14595,366477450,803114,367280564,9,0,0,231936,17,571024063
14596,366501150,378736,366879886,0,0,0,512,6,5376390373
14597,366541410,301882,366843292,0,0,0,3584,6,6525149641
14598,366545900,257534,366803434,8,0,0,1536,6,5687272908
14599,366557420,253434,366810854,8,0,0,512,6,724931303
14600,366614250,369111,366983361,9,0,0,2560,17,103418496
14601,366634530,539812,367174342,5,0,0,109568,11,677141067
14602,366711970,4115210,370827180,6,0,1,512,3,10557993643
14603,366735951,4094135,370830086,0,0,1,4608,6,7583789215
14604,366746549,546978,367293527,4,0,0,42496,4,8431877599
14605,366781690,4087538,370869228,7,0,1,111616,16,4134790889
14606,366782821,4110502,370893323,0,0,1,58368,6,7168015994
14607,366785250,314002,367099252,8,0,0,1536,6,8875963476
14608,366796831,4113935,370910766,0,0,1,10752,6,1698902522
14609,366874990,427177,367302167,5,0,0,28160,11,8555916252
14610,366890330,4097261,370987591,7,0,1,153088,16,7147532965
14611,366944391,4057873,371002264,0,0,1,20992,6,6947457347
14612,366961150,234535,367195685,0,0,0,512,6,10432340864
14613,366979320,323174,367302494,3,0,0,1024,0,9607470586
14614,366983380,408673,367392053,5,0,0,25088,11,1490240818
14615,366984550,4420930,371405480,7,0,1,471552,16,4907273810
14616,366990561,4416545,371407106,0,0,1,2560,6,4933986605
14617,367036141,4372591,371408732,0,0,1,2560,6,5041270585
14618,367042451,4367267,371409718,0,0,1,1536,6,1162388188
14619,367079139,573853,367652992,4,0,0,30208,4,7686313653
14620,367110010,598808,367708818,8,0,0,2560,6,2299579446
14621,367116330,370020,367486350,8,0,0,9216,6,5009382086
14622,367129210,303458,367432668,8,0,0,512,6,8145469910
14623,367159340,4550010,371709350,7,0,1,564736,16,8539966390
14624,367161419,733745,367895164,4,0,0,600064,4,8364094641
14625,367177830,447284,367625114,0,0,0,2048,6,6155172709
14626,367187130,712813,367899943,9,0,0,1024,17,1939938174
14627,367188031,4521334,371709365,0,0,1,11264,6,2787421137
14628,367188780,4520600,371709380,8,0,1,17920,6,6041338406
14629,367215560,701291,367916851,5,0,0,21504,11,5263604022
14630,367244860,419591,367664451,0,0,0,4608,6,614474670
14631,367262490,635364,367897854,3,0,0,3584,0,5132318453
14632,367294910,603583,367898493,0,0,0,2048,6,8323149007
14633,367304530,4775272,372079802,7,0,1,705024,16,5827719397
14634,367306260,593854,367900114,3,0,0,512,0,7513419308
14635,367307530,350829,367658359,3,0,0,2560,0,7876801042
14636,367330739,566008,367896747,4,0,0,5120,4,8342480877
14637,367351921,4732067,372083988,0,0,1,6656,6,7922839528
14638,367435650,4661601,372097251,8,0,1,38400,6,8596088665
14639,367444010,455590,367899600,9,0,0,3584,17,6789742937
14640,367458730,475263,367933993,0,0,0,1024,6,6312631335
14641,367476779,558314,368035093,4,0,0,171520,4,3909423610
14642,367501231,4596366,372097597,0,0,1,512,6,10125121056
14643,367514111,4585752,372099863,0,0,1,3584,6,9124174427
14644,367516110,519778,368035888,8,0,0,2560,6,6102160601
14645,367526870,638373,368165243,5,0,0,249344,11,7241418096
14646,367617161,4490171,372107332,0,0,1,3584,6,2157778565
14647,367625570,4484988,372110558,8,0,1,5120,6,1797027818
14648,367698640,557382,368256022,5,0,0,97792,11,7109069321
14649,367725640,822282,368547922,5,0,0,161280,11,5651472876
14650,367753410,4369857,372123267,7,0,1,23552,16,8954092807
14651,367766480,4619249,372385729,7,0,1,160256,16,636216912
14652,367798840,4720929,372519769,8,0,1,37888,6,9452265707
14653,367836060,4832919,372668979,7,0,1,229376,16,2825854635
14654,367869230,296403,368165633,0,0,0,1024,6,4460353929
14655,367871510,4918311,372789821,7,0,1,95744,16,2519644739
14656,367871660,423705,368295365,0,0,0,512,6,441987600
14657,367924770,4925435,372850205,6,0,1,56320,3,7407185171
14658,367929611,4929798,372859409,0,0,1,27648,6,1458476946
14659,367962289,316389,368278678,4,0,0,15872,4,2008346911
14660,367971201,4889514,372860715,0,0,1,2048,6,2126720206
14661,367982280,343704,368325984,5,0,0,27648,11,10718026643
14662,367987390,791065,368778455,5,0,0,172544,11,8749345441
14663,367993191,4868190,372861381,0,0,1,1024,6,3916898636
14664,368018061,4868988,372887049,0,0,1,55808,6,5749995317
14665,368025579,825275,368850854,4,0,0,237568,4,7914077638
14666,368031590,135785,368167375,8,0,0,1536,6,2340177002
14667,368043371,4845304,372888675,0,0,1,2560,6,7914274066
14668,368043430,148928,368192358,8,0,0,3584,6,7961223379
14669,368047310,804027,368851337,0,0,0,1536,6,9285715461
14670,368051510,960645,369012155,5,0,0,105984,11,6987886225
14671,368074769,1071600,369146369,4,0,0,288256,4,6049395886
14672,368094569,389310,368483879,4,0,0,68608,4,3191300517
14673,368110390,4783764,372894154,6,0,1,19968,3,10573452237
14674,368111870,462921,368574791,0,0,0,1024,6,10081532843
14675,368117550,594491,368712041,9,0,0,1536,17,2758529810
14676,368149541,4765096,372914637,0,0,1,11264,6,2655554902
14677,368217610,675813,368893423,8,0,0,2560,6,8745179054
14678,368224880,4690789,372915669,6,0,1,13312,3,1918115678
14679,368253760,598262,368852022,3,0,0,2048,0,10433668041
14680,368269940,910543,369180483,0,0,0,2560,6,9487664058
14681,368271950,4682915,372954865,4,0,1,23552,4,6998118402
14682,368372730,566517,368939247,5,0,0,73216,11,858988904
14683,368375380,176589,368551969,0,0,0,1024,6,3394684448
14684,368450040,403127,368853167,0,0,0,3584,6,337529389
14685,368474480,4649107,373123587,3,0,1,138240,0,1348846285
14686,368481771,4647685,373129456,0,0,1,28160,6,3849608570
14687,368572140,309055,368881195,0,0,0,512,6,7484157585
14688,368631040,382542,369013582,9,0,0,4608,17,2131912774
14689,368681310,4449325,373130635,1,0,1,512,6,8785851250
14690,368711710,229079,368940789,9,0,0,1536,17,9338432987
14691,368720330,4513748,373234078,2,0,1,21504,11,2879438573
14692,368739530,489823,369229353,9,0,0,512,17,1088708549
14693,368761330,394547,369155877,9,0,0,3584,17,719791548
14694,368831000,183533,369014533,3,0,0,3072,0,7438822610
14695,368850540,4383569,373234109,6,0,1,9216,3,10536857419
14696,368889700,4344424,373234124,6,0,1,14848,3,831348631
14697,368900530,140329,369040859,3,0,0,512,0,1990380909
14698,368906201,4327938,373234139,0,0,1,29184,6,1775783573
14699,368913980,272727,369186707,0,0,0,512,6,5884046664
14700,368944160,271771,369215931,5,0,0,28160,11,5633595289
14701,368997931,4267954,373265885,0,0,1,36352,6,6733284134
14702,369017640,326248,369343888,8,0,0,8192,6,7290962344
14703,369039250,443830,369483080,3,0,0,7168,0,8520637743
14704,369044501,4231818,373276319,0,0,1,7680,6,9099250048
14705,369050760,4282160,373332920,7,0,1,46592,16,7055342683
14706,369055760,205690,369261450,3,0,0,1536,0,1384896602
14707,369064370,4322259,373386629,6,0,1,5632,3,8933527843
14708,369084420,243165,369327585,5,0,0,40448,11,6444261674
14709,369088120,4439162,373527282,7,0,1,253440,16,446699472
14710,369113430,133471,369246901,9,0,0,3584,17,10006482600
14711,369150390,361077,369511467,9,0,0,3072,17,8257981088
14712,369170880,4377801,373548681,3,0,1,4096,0,4285624453
14713,369184970,273771,369458741,8,0,0,512,6,1890337360
14714,369207170,233626,369440796,3,0,0,4096,0,8007965151
14715,369240650,4315160,373555810,8,0,1,4096,6,10289636758
14716,369264410,411528,369675938,9,0,0,191488,17,461577911
14717,369270220,4287856,373558076,6,0,1,3584,3,10427905441
14718,369281910,394199,369676109,8,0,0,512,6,3113363436
14719,369334570,365876,369700446,3,0,0,2048,0,6774802788
14720,369341260,220884,369562144,8,0,0,1024,6,9085748270
14721,369410740,4201812,373612552,7,0,1,24576,16,4738543243
14722,369430550,97163,369527713,0,0,0,1536,6,2850469783
14723,369435390,4177177,373612567,8,0,1,2048,6,10096108316
14724,369506680,4122424,373629104,7,0,1,120832,16,583283146
14725,369541951,4100479,373642430,0,0,1,3584,6,1045553022
14726,369549850,4167081,373716931,7,0,1,168448,16,10498891914
14727,369579950,332155,369912105,3,0,0,7680,0,1706058052
14728,369601970,225145,369827115,0,0,0,512,6,3442284735
14729,369605580,4271287,373876867,7,0,1,236032,16,3242347888
14730,369605990,241188,369847178,8,0,0,3584,6,5763250766
14731,369610940,4278947,373889887,2,0,1,40448,11,5741763636
14732,369648290,4243223,373891513,6,0,1,2560,3,8919148449
14733,369694710,4200029,373894739,2,0,1,5120,11,4810724964
14734,369708300,4236007,373944307,7,0,1,92160,16,4456496289
14735,369744680,4199642,373944322,6,0,1,13312,3,2839262629
14736,369799000,4164837,373963837,2,0,1,20480,11,7677522391
14737,369829110,166422,369995532,3,0,0,7680,0,999218891
14738,369845520,462680,370308200,9,0,0,228352,17,5899330264
14739,369879270,510573,370389843,9,0,0,40960,17,1515394750
14740,369893030,330852,370223882,0,0,0,1024,6,3113377239
14741,369901790,295265,370197055,9,0,0,15360,17,2914519009
14742,369918900,511830,370430730,5,0,0,134144,11,8166460398
14743,369941300,368529,370309829,3,0,0,512,0,6996965211
14744,370003391,3961214,373964605,0,0,1,11776,6,1342289252
14745,370029180,403787,370432967,3,0,0,6144,0,7622890743
14746,370030240,279410,370309650,3,0,0,4608,0,4216492910
14747,370032960,4136006,374168966,7,0,1,248320,16,9964740293
14748,370049630,308096,370357726,8,0,0,512,6,2598550529
14749,370066610,4107541,374174151,2,0,1,16384,11,10351444845
14750,370067400,4127086,374194486,6,0,1,11776,3,10334740722
14751,370183050,4071053,374254103,2,0,1,47616,11,6902521428
14752,370197040,237870,370434910,0,0,0,2048,6,8304604385
14753,370207080,4075106,374282186,6,0,1,28672,3,9598614010
14754,370257511,4028051,374285562,0,0,1,25600,6,8646129286
14755,370272340,390037,370662377,5,0,0,61952,11,8731568764
14756,370280860,4005368,374286228,2,0,1,1024,11,3385564733
14757,370306850,4065684,374372534,7,0,1,75264,16,9328225237
14758,370317380,113692,370431072,8,0,0,1024,6,8701528963
14759,370323300,4050220,374373520,7,0,1,1536,16,10192398064
14760,370326941,4050445,374377386,0,0,1,6144,6,5264834671
14761,370334300,4049696,374383996,2,0,1,512,11,7659505555
14762,370402710,3998334,374401044,5,0,1,28672,11,2731226217
14763,370451510,79557,370531067,0,0,0,1024,6,2654835724
14764,370475370,4176550,374651920,7,0,1,477184,16,9690089430
14765,370477820,4183764,374661584,4,0,1,11264,4,7601875384
14766,370507360,349080,370856440,8,0,0,1024,6,6994245851
14767,370524990,541945,371066935,8,0,0,2048,6,4628814506
14768,370540850,4153630,374694480,5,0,1,22528,11,5408846326
14769,370542800,4157313,374700113,7,0,1,17408,16,9668807483
14770,370543290,4209424,374752714,7,0,1,139264,16,9325074456
14771,370599880,256233,370856113,5,0,0,18432,11,1345616797
14772,370620310,4178560,374798870,7,0,1,126464,16,9272483651
14773,370630001,4170162,374800163,0,0,1,10240,6,2744671324
14774,370640700,4178755,374819455,2,0,1,21504,11,7054417804
14775,370674890,420375,371095265,0,0,0,1024,6,3443789287
14776,370690270,4138950,374829220,7,0,1,22016,16,3179296239
14777,370693600,549360,371242960,5,0,0,25088,11,2813343311
14778,370711210,179025,370890235,0,0,0,3584,6,5884118609
14779,370721170,302329,371023499,5,0,0,51712,11,2267694299
14780,370722250,267387,370989637,3,0,0,1024,0,40313108
14781,370754140,4079939,374834079,1,0,1,17408,6,3312667913
14782,370768350,183842,370952192,0,0,0,4096,6,7171017278
14783,370772890,4062572,374835462,3,0,1,14848,0,5611163866
14784,370791100,4045130,374836230,5,0,1,11776,11,3822381008
14785,370795540,264939,371060479,0,0,0,1024,6,121044663
14786,370815820,412930,371228750,9,0,0,97280,17,5061598882
14787,370820510,568422,371388932,9,0,0,49152,17,9566156003
14788,370870670,378038,371248708,8,0,0,512,6,185023362
14789,370872071,3972030,374844101,0,0,1,3584,6,6740732305
14790,370876450,160063,371036513,3,0,0,2560,0,8709525551
14791,370877090,3967882,374844972,2,0,1,12288,11,365602467
14792,370885720,3999355,374885075,7,0,1,84992,16,3457936982
14793,370901010,3985691,374886701,4,0,1,2560,4,2134411976
14794,370907730,3979739,374887469,2,0,1,11776,11,2609771681
14795,370957770,748898,371706668,9,0,0,266240,17,1585793933
14796,370990290,3902671,374892961,6,0,1,17920,3,6552061622
14797,371031170,3862150,374893320,5,0,1,9728,11,5059415676
14798,371046020,201932,371247952,0,0,0,3072,6,1288788608
14799,371049600,669535,371719135,3,0,0,4096,0,8709205325
14800,371103840,3877901,374981741,7,0,1,115200,16,3792505067
14801,371126580,3869418,374995998,7,0,1,44032,16,1550361904
14802,371180990,3852730,375033720,7,0,1,18432,16,8721831047
14803,371216730,3887110,375103840,2,0,1,8704,11,2933611824
14804,371392840,338407,371731247,8,0,0,4096,6,6212828963
14805,371396300,3707555,375103855,2,0,1,4096,11,9236853478
14806,371428040,281295,371709335,5,0,0,8704,11,954826584
14807,371515870,368868,371884738,5,0,0,109056,11,1897834980
14808,371594730,357286,371952016,5,0,0,101888,11,6789867834
14809,371719290,3384580,375103870,2,0,1,3584,11,2906431230
14810,371767340,3340319,375107659,2,0,1,39424,11,1451180750
14811,371817700,669747,372487447,9,0,0,320512,17,9193673745
14812,371817770,843021,372660791,9,0,0,178176,17,8587532534
14813,371882420,260532,372142952,8,0,0,512,6,6490969576
14814,371903160,616594,372519754,5,0,0,105984,11,251473941
14815,371918900,3194101,375113001,2,0,1,23552,11,2651885889
14816,371987680,532931,372520611,8,0,0,1024,6,4504528918
14817,372003940,1203276,373207216,9,0,0,240128,17,6776704614
14818,372010510,3106037,375116547,5,0,1,5632,11,3624712111
14819,372021660,3095348,375117008,5,0,1,10240,11,7335677429
14820,372040690,796795,372837485,3,0,0,2048,0,7299303165
14821,372084640,238345,372322985,8,0,0,6656,6,577250948
14822,372089340,3040490,375129830,2,0,1,19968,11,2021257604
14823,372137880,382380,372520260,0,0,0,1536,6,2536284221
14824,372206040,478617,372684657,3,0,0,4608,0,7724047416
14825,372240870,280076,372520946,3,0,0,1024,0,4657414247
14826,372273400,396062,372669462,8,0,0,1536,6,9710778939
14827,372280550,387923,372668473,5,0,0,24576,11,8433134828
14828,372288240,536052,372824292,5,0,0,89600,11,5009084218
14829,372318550,1068064,373386614,9,0,0,167936,17,9800121336
14830,372381590,279372,372660962,8,0,0,512,6,2143993981
14831,372431420,274084,372705504,3,0,0,1024,0,2791291053
14832,372439450,2690395,375129845,2,0,1,4608,11,1537222962
14833,372443350,225606,372668956,3,0,0,1536,0,1677642381
14834,372452440,671132,373123572,9,0,0,168448,17,9724681570
14835,372492530,741533,373234063,9,0,0,88064,17,4462959364
14836,372509030,316057,372825087,3,0,0,2560,0,7200033433
14837,372509600,405022,372914622,8,0,0,4096,6,9244873660
14838,372578220,2573588,375151808,2,0,1,3584,11,7539190267
14839,372578560,908514,373487074,9,0,0,117248,17,1280871357
14840,372638170,406237,373044407,8,0,0,3072,6,10286273868
14841,372648700,2513405,375162105,2,0,1,18432,11,4962873600
14842,372672520,260295,372932815,0,0,0,1536,6,4926967405
14843,372724320,2442291,375166611,2,0,1,7168,11,3166801324
14844,372769150,2397807,375166957,2,0,1,512,11,9638051541
14845,372790200,247498,373037698,5,0,0,9216,11,9063654192
14846,372822130,2346773,375168903,2,0,1,3072,11,1332185681
14847,372855750,2318919,375174669,6,0,1,15872,3,1236217452
14848,372856970,2319005,375175975,6,0,1,2048,3,656539619
14849,372875690,457199,373332889,5,0,0,112128,11,8999143767
14850,372905220,707317,373612537,5,0,0,168960,11,1622155370
14851,372912190,486274,373398464,0,0,0,2048,6,1392787513
14852,372912360,1031916,373944276,5,0,0,123904,11,8568458189
14853,372973400,741310,373714710,5,0,0,64000,11,9058873364
14854,373007050,328381,373335431,3,0,0,8192,0,3375081396
14855,373007340,813659,373820999,5,0,0,83456,11,7944786838
14856,373058780,429401,373488181,8,0,0,3584,6,6945794177
14857,373141610,275333,373416943,5,0,0,5632,11,9678559469
14858,373142270,2035011,375177281,6,0,1,2048,3,3063869557
14859,373290400,260040,373550440,0,0,0,512,6,567167456
14860,373300030,1884023,375184053,6,0,1,10752,3,10335093549
14861,373310390,1877529,375187919,2,0,1,6144,11,10329519569
14862,373363280,1829465,375192745,6,0,1,7680,3,4556594001
14863,373379910,638773,374018683,9,0,0,53248,17,10092970315
14864,373484040,1712891,375196931,2,0,1,6656,11,4872142668
14865,373619630,1579567,375199197,6,0,1,3584,3,8608556382
14866,373622140,1582741,375204881,2,0,1,20992,11,1945164242
14867,373648240,386279,374034519,9,0,0,26624,17,1294447032
14868,373653290,480923,374134213,9,0,0,148992,17,4493126292
14869,373685940,527033,374212973,8,0,0,512,6,10270356150
14870,373686850,134320,373821170,3,0,0,512,0,10645882732
14871,373705530,429790,374135320,8,0,0,3584,6,5284650748
14872,373777740,1438448,375216188,4,0,1,32768,4,7408338687
14873,373819920,1416695,375236615,6,0,1,38912,3,8937018907
14874,373858000,280634,374138634,0,0,0,2560,6,4674676971
14875,373863090,1387353,375250443,6,0,1,17920,3,9845435044
14876,373887760,455475,374343235,9,0,0,170496,17,6346119598
14877,373894110,243729,374137839,3,0,0,8192,0,10555752964
14878,373918230,1351285,375269515,6,0,1,59904,3,9708147488
14879,373942290,274417,374216707,3,0,0,2048,0,7035928869
14880,373943940,416798,374360738,9,0,0,57344,17,4546843210
14881,373968670,244132,374212802,5,0,0,37888,11,4759253663
14882,373970500,393108,374363608,9,0,0,5632,17,6049663974
14883,373973800,412822,374386622,0,0,0,2560,6,8325421760
14884,374062120,157347,374219467,3,0,0,1024,0,3264917543
14885,374108370,1171560,375279930,6,0,1,25600,3,5548642250
14886,374131880,1202695,375334575,3,0,1,80384,0,6171027805
14887,374144760,442402,374587162,9,0,0,57856,17,4832863079
14888,374238300,263259,374501559,0,0,0,5632,6,10376293725
14889,374308620,1031101,375339721,6,0,1,8192,3,2426904216
14890,374329830,103886,374433716,0,0,0,512,6,10033106656
14891,374348300,999421,375347721,2,0,1,4096,11,7089741999
14892,374361940,996543,375358483,6,0,1,28160,3,9363828157
14893,374368630,263649,374632279,8,0,0,3584,6,4618417499
14894,374374830,357026,374731856,3,0,0,3584,0,1409407341
14895,374398040,253865,374651905,3,0,0,5632,0,4201239404
14896,374406270,976046,375382316,2,0,1,39424,11,2395167552
14897,374414140,997611,375411751,2,0,1,58880,11,9514983476
14898,374443760,361761,374805521,8,0,0,12288,6,7267945693
14899,374465140,129906,374595046,3,0,0,7680,0,2920028000
14900,374549090,866093,375415183,2,0,1,21504,11,4910629357
14901,374608090,811443,375419533,6,0,1,3072,3,4181569598
14902,374669440,764855,375434295,5,0,1,22528,11,4214737570
14903,374693350,324260,375017610,3,0,0,1536,0,8404202802
14904,374702890,732788,375435678,4,0,1,14848,4,8358445018
14905,374724210,381079,375105289,3,0,0,4608,0,4773074999
14906,374730730,709517,375440247,4,0,1,3584,4,5102095384
14907,374732040,708668,375440708,5,0,1,10240,11,1935188882
14908,374742830,360995,375103825,5,0,0,203776,11,6039040167
14909,374784030,345785,375129815,5,0,0,36352,11,6877268773
14910,374799500,308144,375107644,0,0,0,7680,6,7353519690
14911,374864530,581375,375445905,6,0,1,15872,3,8944338613
14912,374871380,626055,375497435,5,0,1,38400,11,5958806915
14913,374884980,614606,375499586,6,0,1,26624,3,4819410658
14914,374914770,439516,375354286,0,0,0,2560,6,8530130837
14915,374927670,596002,375523672,6,0,1,4608,3,7721659225
14916,374952950,574908,375527858,6,0,1,6656,3,10129567498
14917,375104170,328842,375433012,8,0,0,4608,6,10078070557
14918,375130910,278929,375409839,9,0,0,40960,17,10599698864
14919,375154700,421082,375575782,4,0,1,38912,4,7945035999
14920,375179830,145343,375325173,0,0,0,1536,6,8684306749
14921,375226340,585002,375811342,5,0,0,186880,11,8855578480
14922,375256820,356458,375613278,6,0,1,20480,3,7335866016
14923,375290230,686779,375977009,5,0,0,237568,11,9114640766
14924,375302060,371966,375674026,4,0,1,4096,4,7099479945
14925,375326900,347111,375674011,9,0,0,100864,17,3370319692
14926,375329950,376023,375705973,9,0,0,15360,17,2524954436
14927,375340350,333691,375674041,6,0,1,17408,3,10316300757
14928,375346880,398261,375745141,3,0,0,2048,0,8691219492
14929,375386700,297459,375684159,4,0,1,1024,4,10215234654
14930,375397020,288765,375685785,6,0,1,2560,3,2605876580
14931,375428080,383285,375811365,6,0,1,80384,3,3123927210
14932,375461270,350110,375811380,6,0,1,12288,3,2520147136
14933,375465020,346375,375811395,6,0,1,37376,3,9856960934
14934,375565430,497419,376062849,5,0,0,129536,11,2805755142
14935,375588690,388716,375977406,3,0,0,512,0,10371075397
14936,375591110,575029,376166139,5,0,0,237056,11,7493373886
14937,375613270,407676,376020946,0,0,0,1536,6,3514063006
14938,375680990,319556,376000546,8,0,0,512,6,1979595248
14939,375685960,291275,375977235,3,0,0,512,0,2406499404
14940,375703900,468197,376172097,9,0,0,7168,17,10352316983
14941,375737050,432848,376169898,8,0,0,12288,6,4013927661
14942,375750390,226674,375977064,3,0,1,102912,0,2861854947
14943,375775391,224361,375999752,0,0,1,41984,6,1937775102
14944,375802810,383775,376186585,0,0,0,1024,6,1737776024
14945,375838950,164668,376003618,4,0,1,6144,4,7866463421
14946,375842060,220804,376062864,4,0,1,14848,4,3194673149
14947,375905000,329945,376234945,9,0,0,36352,17,10528811424
14948,375910710,292192,376202902,3,0,1,281600,0,8348212095
14949,375913800,290408,376204208,4,0,1,2048,4,819645043
14950,375925321,280193,376205514,0,0,1,2048,6,646183982
14951,375938280,329957,376268237,5,0,0,11264,11,10062337707
14952,375966690,206997,376173687,8,0,0,4608,6,9600095971
14953,375977100,229694,376206794,1,0,1,14336,6,8829104089
14954,376012681,224042,376236723,0,0,1,3584,6,3048376358
14955,376016760,155508,376172268,3,0,0,512,0,4597902307
14956,376026860,277672,376304532,3,0,0,2048,0,9779468473
14957,376082570,265924,376348494,5,0,0,6656,11,4237780622
14958,376271800,408506,376680306,3,0,0,512,0,7276028319
14959,376292300,246322,376538622,8,0,0,1536,6,3279469497
14960,376301550,3898,376305448,4,0,1,4096,4,8986369494
14961,376313931,4374,376318305,0,0,1,4608,6,3441398718
14962,376320120,627188,376947308,9,0,0,183808,17,7172645067
14963,376331651,40874,376372525,0,0,1,66048,6,10271679116
14964,376333920,42151,376376071,4,0,1,5632,4,7327652559
14965,376339281,37136,376376417,0,0,1,512,6,970883863
14966,376371680,5723,376377403,4,0,1,1536,4,8351076216
14967,376416590,3904,376420494,4,0,1,10752,4,3362680944
14968,376442230,712339,377154569,9,0,0,311296,17,439190258
14969,376473871,1518,376475389,0,0,1,1536,6,548944308
14970,376513920,252948,376766868,9,0,0,3584,17,6567056010
14971,376564160,383475,376947635,8,0,0,1024,6,5516323428
14972,376580570,11274,376591844,4,0,1,18432,4,5685071959
14973,376587500,376077,376963577,0,0,0,3072,6,444943090
14974,376615270,233902,376849172,9,0,0,23040,17,5560116232
14975,376723280,239346,376962626,9,0,0,49152,17,10192527950
14976,376757890,6754,376764644,6,0,1,7168,3,10135636024
14977,376783710,2470,376786180,1,0,1,2560,6,416877120
14978,376812860,408827,377221687,9,0,0,219648,17,7349795580
14979,376846491,5619,376852110,0,0,1,3072,6,5001348294
14980,376873070,4850,376877920,6,0,1,5120,3,1196674173
14981,376876190,6754,376882944,6,0,1,7168,3,8917760988
14982,377030870,123870,377154740,0,0,0,512,6,3592649712
14983,377088340,158438,377246778,3,0,0,1536,0,940767912
14984,377137110,107611,377244721,6,0,1,37888,3,3421342378
14985,377169460,210491,377379951,3,0,0,1536,0,8672148061
14986,377183980,442802,377626782,9,0,0,358400,17,668707490
14987,377199450,159327,377358777,5,0,0,13824,11,4487761758
14988,377200950,227766,377428716,3,0,0,1024,0,6587968732
14989,377284891,13770,377298661,0,0,1,26624,6,623016371
14990,377309760,185300,377495060,3,0,0,1024,0,8884258307
14991,377391370,5454,377396824,3,0,1,13824,0,4283596709
14992,377420940,206793,377627733,3,0,0,3072,0,2579728768
14993,377442150,247667,377689817,0,0,0,5120,6,551463101
14994,377442730,590170,378032900,3,0,1,926208,0,6655924684
14995,377466360,641027,378107387,0,0,0,3072,6,9309551651
14996,377487480,460211,377947691,0,0,0,3072,6,5236276387
14997,377571420,276432,377847852,3,0,0,512,0,5364301894
14998,377599971,432944,378032915,0,0,1,9216,6,10163311037
14999,377631170,401715,378032885,5,0,0,115712,11,10111376863
15000,377634480,656743,378291223,5,0,0,154112,11,8794067245
15001,377683840,401442,378085282,7,0,1,240128,16,8106188034
15002,377708210,379658,378087868,3,0,1,4096,0,5420922572
15003,377744190,784225,378528415,5,0,0,26112,11,1899865335
15004,377758940,642826,378401766,3,0,0,7168,0,5858375349
15005,377788150,557688,378345838,5,0,0,179200,11,8750957534
15006,377788700,367103,378155803,0,0,0,2048,6,4849352955
15007,377873120,472897,378346017,0,0,0,512,6,5668814677
15008,377884770,213723,378098493,3,0,1,34304,0,1332710856
15009,377931460,424101,378355561,3,0,0,3072,0,1994793453
15010,377953760,560351,378514111,9,0,0,134144,17,3919154811
15011,377976240,1016366,378992606,9,0,0,168960,17,7414179564
15012,378070460,275572,378346032,3,0,1,373248,0,3648044508
15013,378135151,210896,378346047,0,0,1,28672,6,7510197549
15014,378138221,207841,378346062,0,0,1,25600,6,7564906834
15015,378173970,458512,378632482,9,0,0,36352,17,1986313548
15016,378174410,489697,378664107,0,0,0,3584,6,1963671491
15017,378184591,161494,378346085,0,0,1,17920,6,9757373779
15018,378206360,636262,378842622,5,0,0,173056,11,4447781706
15019,378208910,227569,378436479,0,0,0,512,6,388078175
15020,378250201,101655,378351856,0,0,1,6144,6,1086927502
15021,378313381,38821,378352202,0,0,1,512,6,2074733695
15022,378370830,5802,378376632,2,0,1,6144,11,5488919459
15023,378375880,337600,378713480,3,0,1,547328,0,8549234965
15024,378391510,868841,379260351,5,0,0,268288,11,3866120948
15025,378401160,441633,378842793,3,0,0,512,0,10024777970
15026,378410040,861128,379271168,5,0,0,27136,11,765854538
15027,378437330,305254,378742584,3,0,0,5120,0,8707242573
15028,378564410,538632,379103042,9,0,0,232448,17,9075507596
15029,378611590,381663,378993253,3,0,0,2048,0,10539085190
15030,378614090,380114,378994204,3,0,0,3072,0,738784436
15031,378616060,512525,379128585,5,0,0,80896,11,1326252917
15032,378653560,60791,378714351,8,0,1,12288,6,1261685982
15033,378656280,58737,378715017,3,0,1,11264,0,9675454153
15034,378693170,32779,378725949,3,0,1,35840,0,4918042579
15035,378828240,31250,378859490,2,0,1,32256,11,6749225661
15036,378829330,32426,378861756,1,0,1,3584,6,6646965267
15037,378831260,440095,379271355,0,0,0,512,6,1014296429
15038,378831390,39020,378870410,8,0,1,32256,6,6064032836
15039,378839750,592269,379432019,5,0,0,23040,11,313862965
15040,378869480,391354,379260834,3,0,0,1536,0,10633106128
15041,378879600,5971,378885571,3,0,1,14848,0,10192258152
15042,378891701,2946,378894647,0,0,1,3072,6,6274966863
15043,378906140,1994,378908134,8,0,1,2048,6,7779378983
15044,378910160,13858,378924018,8,0,1,23552,6,35339557
15045,378914040,490099,379404139,9,0,0,136704,17,8564136105
15046,378927530,406934,379334464,9,0,0,103424,17,3882062116
15047,378941980,65436,379007416,2,0,1,25600,11,8349392197
15048,378999760,335187,379334947,0,0,0,1536,6,5531784113
15049,379017490,245395,379262885,0,0,0,6656,6,9913024992
15050,379017930,2470,379020400,3,0,1,2560,0,2656186598
15051,379025170,77895,379103065,3,0,1,21504,0,6831827805
15052,379032350,324847,379357197,0,0,0,3584,6,1862146634
15053,379061210,67390,379128600,8,0,1,2048,6,5922063622
15054,379066420,345376,379411796,3,0,0,2048,0,2323367697
15055,379092040,36583,379128623,3,0,1,25088,0,4546993082
15056,379101510,494957,379596467,9,0,0,240128,17,7571649248
15057,379103511,30044,379133555,0,0,1,12800,6,2770569037
15058,379128590,14169,379142759,8,0,1,16384,6,6190479725
15059,379172050,527395,379699445,0,0,0,512,6,9563511155
15060,379194231,88641,379282872,0,0,1,18944,6,9206319803
15061,379234560,53906,379288466,2,0,1,18432,11,10541492129
15062,379241220,166135,379407355,3,0,1,205824,0,1804427524
15063,379256200,198325,379454525,3,0,1,160256,0,5411790032
15064,379298030,161680,379459710,8,0,1,24576,6,9523218410
15065,379323380,646357,379969737,0,0,0,1536,6,7258896641
15066,379327390,133396,379460786,8,0,1,13312,6,8386489897
15067,379332300,698401,380030701,5,0,0,117248,11,4864773999
15068,379378520,225220,379603740,3,0,0,512,0,10553928158
15069,379401050,64882,379465932,2,0,1,8192,11,2746038535
15070,379404160,98983,379503143,3,0,1,129024,0,9120846503
15071,379414050,631673,380045723,5,0,0,6144,11,4625643493
15072,379431350,83032,379514382,7,0,1,45568,16,9890099393
15073,379515210,81304,379596514,7,0,1,124416,16,7329164703
15074,379523500,568615,380092115,3,0,0,2048,0,2136749898
15075,379565180,53270,379618450,2,0,1,35840,11,3809359618
15076,379567580,52496,379620076,2,0,1,2560,11,2793508721
15077,379574010,273812,379847822,3,0,0,3072,0,510252905
15078,379600850,492380,380093230,3,0,0,3584,0,309190175
15079,379627510,1994,379629504,2,0,1,2048,11,3169710370
15080,379637011,26479,379663490,0,0,1,48128,6,6016178629
15081,379694930,3422,379698352,8,0,1,3584,6,9710134626
15082,379706180,16096,379722276,8,0,1,31232,6,8148438024
15083,379706280,385166,380091446,9,0,0,150016,17,7041104766
15084,379743490,2870,379746360,8,0,1,8704,6,3732507598
15085,379775720,6278,379781998,2,0,1,6656,11,705354467
15086,379794060,2470,379796530,1,0,1,2560,6,6727085148
15087,379797780,20882,379818662,8,0,1,33792,6,4558049980
15088,379811310,531124,380342434,0,0,0,1024,6,1026757868
15089,379823070,326525,380149595,5,0,0,59392,11,10319610846
15090,379824380,305037,380129417,5,0,0,47616,11,9976936596
15091,379896200,4937,379901137,8,0,1,12800,6,495597964
15092,379921370,337443,380258813,9,0,0,66048,17,5698082709
15093,379936210,489819,380426029,5,0,0,66560,11,3368577382
15094,379968620,1518,379970138,2,0,1,1536,11,1907003310
15095,379982020,109441,380091461,7,0,1,100352,16,761639347
15096,379994330,97146,380091476,8,0,1,8704,6,2798740608
15097,380069060,220316,380289376,0,0,0,7680,6,4116087812
15098,380104150,3898,380108048,8,0,1,4096,6,3822365217
15099,380105280,55988,380161268,7,0,1,95232,16,8294833924
15100,380161780,382551,380544331,3,0,0,2048,0,6617466707
15101,380199380,1518,380200898,2,0,1,1536,11,8981397515
15102,380211990,23208,380235198,2,0,1,38400,11,247055082
15103,380230510,28318,380258828,8,0,1,16896,6,163257879
15104,380274560,182364,380456924,9,0,0,19456,17,8215186625
15105,380281171,1042,380282213,0,0,1,1024,6,10200777220
15106,380303060,13253,380316313,2,0,1,25600,11,10393210487
15107,380312500,408374,380720874,0,0,0,2560,6,716241237
15108,380318910,654165,380973075,9,0,0,573952,17,1678442339
15109,380334190,1994,380336184,2,0,1,2048,11,4647203667
15110,380418040,319524,380737564,3,0,0,4608,0,6747951392
15111,380440950,536078,380977028,9,0,0,5120,17,9219140326
15112,380468250,6488,380474738,4,0,1,15872,4,2248368931
15113,380482110,5971,380488081,8,0,1,14848,6,3623588961
15114,380499340,478523,380977863,3,0,0,2560,0,2304710379
15115,380501000,14117,380515117,2,0,1,24064,11,7810812226
15116,380504660,287134,380791794,0,0,0,2048,6,3176640725
15117,380552480,421242,380973722,3,0,0,2048,0,8563456918
15118,380625120,350333,380975453,0,0,0,5632,6,6067062457
15119,380652860,412190,381065050,5,0,0,86528,11,1932888416
15120,380679310,1042,380680352,2,0,1,1024,11,7567945551
15121,380684570,1994,380686564,8,0,1,2048,6,9007350706
15122,380799070,594117,381393187,5,0,0,150016,11,6025035464
15123,380838050,153939,380991989,8,0,1,24064,6,3953441696
15124,380840370,374887,381215257,5,0,0,54272,11,7458355954
15125,380850950,401173,381252123,5,0,0,8704,11,5625966745
15126,380885730,106413,380992143,2,0,1,8704,11,8985865609
15127,380902680,396895,381299575,3,0,0,4096,0,7782898252
15128,380943010,55112,380998122,4,0,1,16384,4,2521566773
15129,380969010,55904,381024914,8,0,1,52224,6,10699316230
15130,380977390,238038,381215428,0,0,0,512,6,8889328969
15131,381112740,4937,381117677,8,0,1,12800,6,6101678732
15132,381114750,6789,381121539,6,0,1,5120,3,8766774050
15133,381137130,100461,381237591,9,0,0,21504,17,6777200551
15134,381194600,20843,381215443,6,0,1,24576,3,4495977602
15135,381233790,19114,381252904,2,0,1,29696,11,9557802719
15136,381394020,261694,381655714,5,0,0,166400,11,686091418
15137,381427490,1042,381428532,4,0,1,1024,4,609602012
15138,381433850,7230,381441080,2,0,1,7680,11,671143992
15139,381490550,3645,381494195,2,0,1,10240,11,8891874379
15140,381528810,7706,381536516,2,0,1,8192,11,1656464711
15141,381550020,566,381550586,4,0,1,512,4,9769924636
15142,381621870,39548,381661418,8,0,1,14336,6,10358977567
15143,381656010,6394,381662404,1,0,1,1536,6,8741789037
15144,381673970,4679,381678649,4,0,1,12288,4,7386535767
15145,381676330,96773,381773103,3,0,0,3584,0,3124930284
15146,381695560,59151,381754711,0,0,0,2048,6,8758710111
15147,381700820,327404,382028224,5,0,0,237568,11,7284899707
15148,381745100,1518,381746618,1,0,1,1536,6,2935089434
15149,381766400,10499,381776899,9,0,1,16896,17,8774428383
15150,381782970,11274,381794244,1,0,1,18432,6,9510159206
15151,381790910,11016,381801926,9,0,1,17920,17,8667104129
15152,381808090,566,381808656,4,0,1,512,4,9082434771
15153,381816980,123683,381940663,7,0,1,200704,16,4920545110
15154,381895740,50210,381945950,7,0,1,25088,16,430229417
15155,381993510,47701,382041211,4,0,1,25088,4,4249193773
15156,382028760,31836,382060596,4,0,1,44544,4,8823159359
15157,382031270,49644,382080914,3,0,0,512,0,1572285429
15158,382043650,18534,382062184,9,0,1,15872,17,4050729291
15159,382090430,11016,382101446,2,0,1,17920,11,8398725124
15160,382094490,11142,382105632,8,0,1,6656,6,5632808955
15161,382172300,3387,382175687,9,0,1,9728,17,2472565145
15162,382183730,11016,382194746,2,0,1,17920,11,2286088193
15163,382184200,20893,382205093,8,0,1,30720,6,7841920393
15164,382187900,45268,382233168,0,0,0,512,6,10221101288
15165,382207750,23895,382231645,7,0,1,43008,16,10573205673
15166,382225750,115279,382341029,7,0,1,190976,16,287107510
15167,382229430,114185,382343615,4,0,1,4096,4,2126652106
15168,382329190,288835,382618025,5,0,0,43520,11,2264801078
15169,382330980,226076,382557056,9,0,0,61440,17,3581326514
15170,382334270,15554,382349824,1,0,1,21504,6,1467274688
15171,382335350,372173,382707523,9,0,0,93696,17,2718592814
15172,382378230,22691,382400921,1,0,1,37376,6,5790209467
15173,382378560,28160,382406720,1,0,1,19456,6,1917535375
15174,382394890,12701,382407591,8,0,1,12288,6,2529675361
15175,382411620,13858,382425478,6,0,1,23552,3,8726471489
15176,382443820,81074,382524894,0,0,0,4608,6,1466272147
15177,382450910,7706,382458616,4,0,1,8192,4,2161424810
15178,382467520,16096,382483616,4,0,1,31232,4,702709385
15179,382469740,19022,382488762,6,0,1,8192,3,5039576261
15180,382472710,21441,382494151,2,0,1,25600,11,10351940551
15181,382497300,3898,382501198,1,0,1,4096,6,6126283219
15182,382500190,10499,382510689,9,0,1,16896,17,7932456529
15183,382515670,3387,382519057,1,0,1,9728,6,3648096071
15184,382517520,4585,382522105,1,0,1,3584,6,7616261055
15185,382550570,234519,382785089,0,0,0,4608,6,2243160028
15186,382613650,15124,382628774,4,0,1,17408,4,5984637616
15187,382670789,36749,382707538,8,0,1,22016,6,10613798518
15188,382725090,89711,382814801,9,0,0,4096,17,9088992865
15189,382748390,251228,382999618,5,0,0,43520,11,985704050
15190,382767540,55748,382823288,0,0,0,4096,6,7086923280
15191,382805170,566,382805736,1,0,1,512,6,3661625947
15192,382809110,3645,382812755,1,0,1,10240,6,3401347801
15193,382843460,313579,383157039,9,0,0,207872,17,8894850501
15194,382846050,509637,383355687,7,0,1,828928,16,9398035943
15195,382858360,1056708,383915068,5,0,0,444928,11,284846483
15196,382889140,596885,383486025,0,0,0,5632,6,2506659920
15197,382906590,452003,383358593,7,0,1,4608,16,7266253071
15198,382972460,392854,383365314,1,0,1,24064,6,10668027243
15199,383013300,667802,383681102,3,0,0,2048,0,4737422005
15200,383015070,276528,383291598,0,0,0,1536,6,4074309396
15201,383108940,429854,383538794,3,0,0,1024,0,7925696927
15202,383218600,147175,383365775,9,0,1,10240,17,5264782008
15203,383269730,458043,383727773,3,0,0,3072,0,6261747201
15204,383289340,328466,383617806,9,0,0,3072,17,10705214978
15205,383335830,390947,383726777,9,0,0,104448,17,547808754
15206,383357570,42424,383399994,7,0,1,69120,16,2764351856
15207,383373601,28659,383402260,0,0,1,3584,6,7605384554
15208,383377590,284739,383662329,0,0,0,512,6,10311843811
15209,383379550,582075,383961625,9,0,0,152576,17,1103463879
15210,383385650,22819,383408469,1,0,1,21504,6,971407803
15211,383416370,548234,383964604,5,0,0,9728,11,1065516978
15212,383420990,104466,383525456,3,0,1,169984,0,1731305617
15213,383443250,82974,383526224,9,0,1,11776,17,2474488401
15214,383479390,114000,383593390,0,0,0,3072,6,7981622317
15215,383505330,477073,383982403,9,0,0,58368,17,3461627186
15216,383509020,18792,383527812,9,0,1,15872,17,4107994138
15217,383565380,1994,383567374,9,0,1,2048,17,369965132
15218,383610360,402092,384012452,3,0,0,1024,0,6496465869
15219,383642880,83912,383726792,7,0,1,95744,16,5668953558
15220,383650720,76087,383726807,9,0,1,46592,17,4113999158
15221,383654470,72352,383726822,1,0,1,17408,6,5212581660
15222,383668370,246729,383915099,7,0,1,221696,16,2380043245
15223,383676360,306230,383982590,3,0,0,512,0,10356869566
15224,383680680,234434,383915114,9,0,1,1536,17,4737647624
15225,383695680,406860,384102540,3,0,0,512,0,6259109560
15226,383795840,191459,383987299,1,0,1,12800,6,7213361185
15227,383797240,427484,384224724,0,0,0,1024,6,3361905018
15228,383830320,584129,384414449,0,0,0,1536,6,1497403531
15229,383933680,993124,384926804,9,0,0,318976,17,8894577977
15230,383949190,47421,383996611,1,0,1,16384,6,5136979217
15231,383963040,182897,384145937,7,0,1,250880,16,7370639558
15232,383970620,845740,384816360,9,0,0,348160,17,5212614856
15233,384001470,170798,384172268,3,0,1,93184,0,7575336803
15234,384013860,175395,384189255,9,0,1,56832,17,6616090372
15235,384051860,955043,385006903,3,0,0,1536,0,4107884889
15236,384067410,122409,384189819,9,0,1,10752,17,7346514907
15237,384070060,131203,384201263,1,0,1,38400,6,2367172734
15238,384099550,314416,384413966,9,0,0,15872,17,8687573317
15239,384113070,93787,384206857,1,0,1,18432,6,8476088683
15240,384114790,92631,384207421,1,0,1,10752,6,1986511028
15241,384153480,55529,384209009,1,0,1,15872,6,1450906687
15242,384159690,305360,384465050,0,0,0,2048,6,9923491702
15243,384171390,523727,384695117,3,0,0,1536,0,5125997355
15244,384173290,51784,384225074,1,0,1,52224,6,9569429746
15245,384174040,381070,384555110,0,0,0,1024,6,9485663180
15246,384199850,30370,384230220,9,0,1,8192,17,4731830278
15247,384211390,19496,384230886,9,0,1,1024,17,4413736009
15248,384224790,340340,384565130,5,0,0,8704,11,3311755699
15249,384229480,930453,385159933,9,0,0,265728,17,2185519791
15250,384232800,426441,384659241,3,0,0,4608,0,8088158719
15251,384271240,91499,384362739,7,0,1,147968,16,7189416451
15252,384274860,114108,384388968,7,0,1,92672,16,907032552
15253,384276840,137624,384414464,7,0,1,73728,16,751235214
15254,384283800,247815,384531615,3,0,0,2560,0,9028050935
15255,384340250,593041,384933291,5,0,0,20992,11,2520465874
15256,384348270,329370,384677640,0,0,0,9728,6,4233179886
15257,384479400,447427,384926827,7,0,1,600064,16,2545008937
15258,384484870,703470,385188340,9,0,0,93184,17,1680390513
15259,384516270,417431,384933701,3,0,0,1024,0,4896467559
15260,384531500,395342,384926842,9,0,1,37888,17,8884427035
15261,384554960,371897,384926857,1,0,1,1024,6,10490492907
15262,384561960,364912,384926872,1,0,1,8192,6,1666604321
15263,384564040,369266,384933306,1,0,1,51712,6,322864895
15264,384623700,309621,384933321,1,0,1,57344,6,5478340316
15265,384625580,307756,384933336,1,0,1,25600,6,906500337
15266,384648000,285351,384933351,9,0,1,4608,17,8217335345
15267,384661280,272094,384933374,9,0,1,2048,17,517191566
15268,384741580,575897,385317477,9,0,0,103424,17,6698080203
15269,384758500,187239,384945739,0,0,0,6656,6,6575742063
15270,384769120,261009,385030129,3,0,0,1024,0,8422986067
15271,384769700,684387,385454087,5,0,0,34816,11,3950144177
15272,384772340,496073,385268413,0,0,0,3584,6,8227884042
15273,384788690,654275,385442965,5,0,0,257536,11,1239045568
15274,384834440,105191,384939631,9,0,1,14848,17,1817831359
15275,384873860,392540,385266400,3,0,0,3584,0,1519080561
15276,384904820,422859,385327679,5,0,0,15872,11,7616728905
15277,384927790,409213,385337003,0,0,0,6144,6,8764627288
15278,385042530,145833,385188363,7,0,1,144896,16,4538523092
15279,385095020,348444,385443464,3,0,0,1536,0,4189744973
15280,385142380,56784,385199164,9,0,1,17408,17,646708852
15281,385148290,51540,385199830,2,0,1,1024,11,1432793251
15282,385167820,32676,385200496,4,0,1,1024,4,6083388456
15283,385205800,22862,385228662,4,0,1,40960,4,7262810650
15284,385221670,9258,385230928,2,0,1,3584,11,9507627932
15285,385239180,458599,385697779,9,0,0,351232,17,1201774606
15286,385246040,6754,385252794,9,0,1,7168,17,5800256124
15287,385269480,48020,385317500,4,0,1,54784,4,1955906646
15288,385297400,33064,385330464,7,0,1,25088,16,10594767046
15289,385342170,3422,385345592,2,0,1,3584,11,6921603472
15290,385387350,69166,385456516,7,0,1,2560,16,4494889145
15291,385400470,58312,385458782,9,0,1,3584,17,8065938288
15292,385474110,1518,385475628,2,0,1,1536,11,9621818779
15293,385558470,4374,385562844,2,0,1,4608,11,1415340117
15294,385584550,113884,385698434,3,0,0,2048,0,1483411643
15295,385602450,502078,386104528,3,0,0,2048,0,10011299318
15296,385635290,67477,385702767,9,0,1,4608,17,767551587
15297,385711060,356937,386067997,0,0,0,3584,6,1495239547
15298,385717680,406606,386124286,3,0,0,2560,0,4967837389
15299,385722830,363145,386085975,5,0,0,56832,11,5164710581
15300,385724610,405390,386130000,0,0,0,6656,6,5240237419
15301,385737720,7230,385744950,9,0,1,7680,17,9137981269
15302,385739330,327077,386066407,9,0,0,230400,17,3854106670
15303,385758160,308730,386066890,3,0,0,1536,0,84822
15304,385763740,23983,385787723,4,0,1,39936,4,9547560704
15305,385772070,87499,385859569,7,0,1,139264,16,486428569
15306,385797770,86000,385883770,3,0,0,1024,0,1127104408
15307,385834000,26440,385860440,7,0,1,12288,16,5190129650
15308,385851530,10216,385861746,2,0,1,2048,11,5871940439
15309,385876210,2946,385879156,4,0,1,3072,4,9870852848
15310,385893360,536065,386429425,9,0,0,386048,17,3299291154
15311,385900060,3645,385903705,4,0,1,10240,4,5957057889
15312,385918410,566,385918976,9,0,1,512,17,6606722489
15313,385925020,615825,386540845,9,0,0,284672,17,4653518140
15314,385937100,131536,386068636,3,0,0,2048,0,424471110
15315,385952980,14029,385967009,5,0,1,27136,11,7163781755
15316,385962010,31524,385993534,7,0,1,51200,16,1156870289
15317,386043540,47244,386090784,2,0,1,5120,11,8749931936
15318,386088070,2870,386090940,2,0,1,8704,11,10560928613
15319,386096330,1994,386098324,9,0,1,2048,17,9135289749
15320,386096900,6381,386103281,7,0,1,6656,16,1973978135
15321,386105240,11016,386116256,9,0,1,17920,17,1429959193
15322,386112221,317999,386430220,3,0,0,2560,0,5179392222
15323,386118660,1042,386119702,2,0,1,1024,11,3256721416
15324,386164130,405346,386569476,0,0,0,4608,6,10498366610
15325,386223720,594685,386818405,9,0,0,132608,17,5587564064
15326,386244910,30749,386275659,9,0,1,49664,17,3054343742
15327,386245830,295545,386541375,0,0,0,1536,6,6488153779
15328,386258200,381514,386639714,9,0,0,165376,17,8388295474
15329,386285280,150461,386435741,9,0,0,1536,17,6645881233
15330,386354030,803397,387157427,5,0,0,421376,11,705505190
15331,386362270,281710,386643980,9,0,0,13824,17,586507204
15332,386376360,66656,386443016,2,0,1,24576,11,7092101573
15333,386394670,311171,386705841,3,0,0,2048,0,7786548030
15334,386450880,90012,386540892,4,0,1,21504,4,6638807880
15335,386453070,444584,386897654,0,0,0,512,6,1317580828
15336,386458240,417894,386876134,9,0,0,37888,17,2798606963
15337,386460150,416311,386876461,5,0,0,1024,11,1592957899
15338,386462290,363922,386826212,0,0,0,4096,6,4826490387
15339,386506860,520121,387026981,5,0,0,124928,11,10076665779
15340,386520390,223628,386744018,0,0,0,7680,6,4716688391
15341,386563820,10757,386574577,4,0,1,17408,4,9936038708
15342,386588370,51375,386639745,2,0,1,53248,11,4003277394
15343,386604290,50406,386654696,2,0,1,17408,11,8796501486
15344,386607620,421404,387029024,3,0,0,6656,0,7459997818
15345,386626130,279871,386906001,0,0,0,7680,6,8640652519
15346,386642690,13082,386655772,4,0,1,13312,4,8588877263
15347,386655600,518566,387174166,9,0,0,54784,17,4468578629
15348,386775230,469330,387244560,5,0,0,230912,11,6261431136
15349,386880000,14287,386894287,4,0,1,27648,4,10736916665
15350,386904930,269259,387174189,4,0,1,322560,4,3821573526
15351,386934160,754335,387688495,5,0,0,97280,11,654796101
15352,386995630,253851,387249481,5,0,1,12800,11,71282649
15353,387030810,309625,387340435,0,0,0,6656,6,10715205177
15354,387054730,399451,387454181,9,0,0,184832,17,2901398393
15355,387070600,325857,387396457,9,0,0,23040,17,3275727142
15356,387110450,150477,387260927,4,0,1,20480,4,10224393919
15357,387160530,388853,387549383,4,0,1,476672,4,3138376747
15358,387164060,589325,387753385,9,0,0,72192,17,5924882273
15359,387171550,378294,387549844,5,0,1,10240,11,1223456493
15360,387177050,446141,387623191,4,0,1,244736,4,10599537330
15361,387177830,449547,387627377,4,0,1,6656,4,8142517476
15362,387178850,464490,387643340,4,0,1,51712,4,2809782550
15363,387201710,441976,387643686,5,0,1,512,11,7140815253
15364,387245280,745085,387990365,9,0,0,51200,17,2627273586
15365,387285090,1091748,388376838,5,0,0,126464,11,9810842998
15366,387294740,889041,388183781,9,0,0,109568,17,6619545808
15367,387299500,850842,388150342,9,0,0,494592,17,470995103
15368,387300660,452740,387753400,4,0,1,309248,4,3693120107
15369,387325500,545567,387871067,3,0,0,3584,0,3973744845
15370,387369980,383435,387753415,5,0,1,5120,11,9252264922
15371,387501740,251690,387753430,5,0,1,6144,11,9261611756
15372,387506060,1290129,388796189,5,0,0,117760,11,3390815052
15373,387514360,239085,387753445,4,0,1,12288,4,8415555898
15374,387516410,237050,387753460,9,0,1,28672,17,4960048555
15375,387538190,215285,387753475,9,0,1,12800,17,1065180588
15376,387570070,198599,387768669,0,0,0,1536,6,6452818981
15377,387593550,175634,387769184,4,0,1,56320,4,7962563092
15378,387626900,201342,387828242,3,0,0,1536,0,10515359053
15379,387666030,109567,387775597,4,0,1,30720,4,9675767676
15380,387669730,775193,388444923,5,0,0,93696,11,10681014629
15381,387675130,102413,387777543,9,0,1,3072,17,7901969735
15382,387683730,551648,388235378,5,0,0,168960,11,7899577846
15383,387761470,422334,388183804,4,0,1,630272,4,4582991610
15384,387778290,405569,388183859,1,0,1,8192,6,8685255390
15385,387894370,691334,388585704,9,0,0,219136,17,10110377287
15386,387912000,782676,388694676,5,0,0,96256,11,4477230263
15387,387937710,297691,388235401,4,0,1,189440,4,9858020565
15388,387938980,656575,388595555,5,0,0,32256,11,7231247767
15389,387943900,291516,388235416,1,0,1,57856,6,3697201464
15390,387945050,290381,388235431,5,0,1,23040,11,10416063596
15391,388014620,221152,388235772,1,0,1,2560,6,8184957042
15392,388059480,177675,388237155,9,0,1,14848,17,8420229917
15393,388074870,162951,388237821,9,0,1,11264,17,3206205340
15394,388096680,183281,388279961,7,0,1,136192,16,9682799209
15395,388116480,167667,388284147,6,0,1,6656,3,1151780753
15396,388144710,141063,388285773,6,0,1,2560,3,2433467795
15397,388161660,125419,388287079,1,0,1,2048,6,155817068
15398,388162250,131345,388293595,5,0,1,23040,11,2143131847
15399,388163630,213247,388376877,4,0,1,128512,4,8589837147
15400,388203010,178987,388381997,1,0,1,5632,6,3181563577
15401,388247420,218738,388466158,4,0,1,61952,4,8941910720
15402,388290950,208475,388499425,0,0,0,4096,6,9231185196
15403,388333600,514263,388847863,9,0,0,169472,17,370552010
15404,388339470,256100,388595570,4,0,1,185856,4,10548403088
15405,388343660,251949,388595609,1,0,1,22528,6,8474189603
15406,388353010,242614,388595624,1,0,1,1536,6,9546086128
15407,388401820,193835,388595655,9,0,1,15872,17,8774371402
15408,388441750,203633,388645383,4,0,1,91648,4,5847288762
15409,388461130,203501,388664631,6,0,1,1536,3,3802034224
15410,388465290,244798,388710088,6,0,1,75776,3,93000630
15411,388498040,213994,388712034,6,0,1,3072,3,4756129103
15412,388514340,539207,389053547,5,0,0,129536,11,6855191949
15413,388531170,189058,388720228,1,0,1,3584,6,7518282488
15414,388564740,156052,388720792,6,0,1,10752,3,3982667667
15415,388565280,163564,388728844,1,0,1,12800,6,3283259632
15416,388567790,624786,389192576,9,0,0,66560,17,5729346564
15417,388588650,380459,388969109,5,0,0,80384,11,4625819299
15418,388599270,131840,388731110,5,0,1,3584,11,1946325076
15419,388614570,118806,388733376,9,0,1,3584,17,8825547508
15420,388648120,85717,388733837,9,0,1,10240,17,812256962
15421,388690160,48183,388738343,6,0,1,7168,3,4895213624
15422,388701620,37594,388739214,5,0,1,12288,11,10620302614
15423,388727890,730625,389458515,5,0,0,177664,11,5620601403
15424,388728930,67282,388796212,5,0,1,6656,11,3765113354
15425,388761520,563703,389325223,9,0,0,140288,17,9740036813
15426,388802760,48584,388851344,6,0,1,3584,3,3946705539
15427,388810700,54410,388865110,9,0,1,31232,17,1813745604
15428,388838260,355298,389193558,3,0,0,1024,0,3823519174
15429,388841200,42259,388883459,1,0,1,45056,6,7764140175
15430,388871360,321855,389193215,0,0,0,2048,6,3029299850
15431,388872060,257980,389130040,4,0,1,287744,4,1846066788
15432,388891950,331344,389223294,2,0,1,73216,11,8541729310
15433,388903660,254665,389158325,0,0,0,3072,6,3657746027
15434,388913170,315975,389229145,6,0,1,27648,3,10315038459
15435,388935090,294311,389229401,5,0,1,9216,11,7675629608
15436,388943510,291435,389234945,4,0,1,26112,4,5160665758
15437,388980110,751070,389731180,5,0,0,133120,11,3563104170
15438,389040130,520284,389560414,5,0,0,293888,11,3325071153
15439,389060680,745073,389805753,5,0,0,141312,11,3344589351
15440,389116420,867325,389983745,9,0,0,114176,17,707442972
15441,389158720,185586,389344306,4,0,1,79360,4,9251955750
15442,389186980,157480,389344460,5,0,1,8704,11,9278610786
15443,389190270,200300,389390570,9,0,1,45568,17,4236472662
15444,389196490,365709,389562199,0,0,0,1024,6,7162306830
15445,389202770,255760,389458530,5,0,1,3584,11,2515681662
15446,389253400,205145,389458545,4,0,1,27136,4,3490957745
15447,389276880,547635,389824515,5,0,0,31744,11,6206732406
15448,389286190,276583,389562773,3,0,0,1024,0,9199260179
15449,389299240,262624,389561864,3,0,0,4608,0,9531007453
15450,389309610,148950,389458560,1,0,1,3584,6,7622724675
15451,389322190,136385,389458575,1,0,1,16896,6,6459097354
15452,389329980,128618,389458598,5,0,1,5632,11,8849994189
15453,389398480,550135,389948615,5,0,0,111104,11,2165334288
15454,389402970,328693,389731663,3,0,0,1536,0,6725511706
15455,389441840,17769,389459609,5,0,1,1024,11,6445021388
15456,389470030,90399,389560429,6,0,1,4608,3,4174203794
15457,389487860,115342,389603202,4,0,1,65024,4,5351201552
15458,389501220,123364,389624584,6,0,1,25088,3,1823678111
15459,389527190,105766,389632956,4,0,1,13312,4,2901095637
15460,389543730,187948,389731678,4,0,1,165888,4,6372131686
15461,389562630,169063,389731693,6,0,1,6656,3,1464540560
15462,389579270,432125,390011395,9,0,0,90624,17,8959767022
15463,389583920,171262,389755182,1,0,1,5120,6,2309181432
15464,389596970,159838,389756808,6,0,1,2560,3,10543607508
15465,389604130,153344,389757474,5,0,1,1024,11,8558820194
15466,389728310,647188,390375498,9,0,0,310784,17,6086661877
15467,389738990,209952,389948942,3,0,0,1024,0,8095606740
15468,389767310,42614,389809924,9,0,1,11264,17,10196670127
15469,389791520,656521,390448041,5,0,0,137728,11,5230364246
15470,389835570,566259,390401829,9,0,0,11264,17,5175695974
15471,389841420,11791,389853211,6,0,1,19456,3,7521358309
15472,389853820,129948,389983768,4,0,1,191488,4,5293388815
15473,389861750,149660,390011410,9,0,1,16384,17,3568845733
15474,389945630,76238,390021868,6,0,1,16896,3,4017769988
15475,390077240,7230,390084470,4,0,1,7680,4,8485540073
15476,390140750,2870,390143620,5,0,1,8704,11,2549460199
15477,390149720,14117,390163837,6,0,1,24064,3,8383966431
15478,390165950,74350,390240300,7,0,1,121344,16,3052156810
15479,390173920,66726,390240646,4,0,1,512,4,2517725291
15480,390201230,45727,390246957,4,0,1,22016,4,1132099658
15481,390218590,49053,390267643,4,0,1,66048,4,4661419214
15482,390219800,229737,390449537,3,0,0,4608,0,1386841549
15483,390224341,44480,390268821,0,0,1,13824,6,6313501189
15484,390243300,154159,390397459,1,0,0,512,6,4607587047
15485,390248671,20918,390269589,0,0,1,11776,6,6186694250
15486,390260519,15176,390275695,8,0,1,20992,6,1586663297
15487,390272690,5196,390277886,1,0,1,13312,6,2617643969
15488,390276950,3128,390280078,9,0,1,9216,17,7233720937
15489,390279431,96090,390375521,0,0,1,27648,6,10166665938
15490,390283350,97411,390380761,6,0,1,13312,3,8093781665
15491,390296670,151410,390448080,9,0,1,57344,17,2055523748
15492,390297150,150945,390448095,9,0,1,14848,17,4673204152
15493,390360919,87191,390448110,8,0,1,24064,6,9479298396
15494,390378540,94447,390472987,8,0,1,38912,6,895914928
15495,390407840,67413,390475253,8,0,1,3584,6,675112295
15496,390409751,70328,390480079,0,0,1,7680,6,9939189314
15497,390422300,63066,390485366,8,0,1,16896,6,5650608968
15498,390441470,44357,390485827,6,0,1,10240,3,2115976065
15499,390454050,353238,390807288,5,0,0,59392,11,5804424380
15500,390476640,15498,390492138,1,0,1,22016,6,2259956709
15501,390491600,161057,390652657,3,0,0,8192,0,10532622289
15502,390499689,6278,390505967,8,0,1,6656,6,44524163
15503,390520030,14029,390534059,1,0,1,27136,6,9122832907
15504,390521180,60421,390581601,4,0,1,90112,4,2065691171
15505,390522169,64258,390586427,8,0,1,7680,6,8036934806
15506,390532140,58153,390590293,1,0,1,6144,6,6159309398
15507,390542990,51809,390594799,1,0,1,7168,6,9920888044
15508,390549760,234500,390784260,3,0,0,3584,0,3538480478
15509,390556559,40506,390597065,8,0,1,3584,6,1142515815
15510,390585030,17732,390602762,1,0,1,18944,6,9216497658
15511,390585490,158684,390744174,9,0,0,24576,17,6127007088
15512,390607261,5196,390612457,0,0,1,13312,6,9797757932
15513,390615730,355230,390970960,9,0,0,124416,17,8274501069
15514,390620610,1042,390621652,6,0,1,1024,3,6291230590
15515,390669080,13512,390682592,8,0,1,26112,6,3056643293
15516,390691200,432362,391123562,5,0,0,113152,11,1801514308
15517,390693020,2470,390695490,1,0,1,2560,6,9610630664
15518,390693530,16932,390710462,1,0,1,32256,6,2179508825
15519,390710040,414488,391124528,3,0,0,2560,0,8963008263
15520,390755290,291592,391046882,5,0,0,11776,11,10043143180
15521,390819089,3387,390822476,8,0,1,9728,6,9648204595
15522,390821290,416621,391237911,9,0,0,40448,17,4823458224
15523,390834260,318037,391152297,4,0,1,519168,4,4951171706
15524,390852850,501998,391354848,3,0,0,2560,0,4267538435
15525,390855390,268343,391123733,3,0,0,512,0,8488362385
15526,390880410,273372,391153782,9,0,1,15360,17,9232978758
15527,390888280,923481,391811761,5,0,0,6144,11,6625367414
15528,390890730,814454,391705184,9,0,0,402432,17,9781089463
15529,390937890,216968,391154858,9,0,1,13312,17,1038693773
15530,390941940,213891,391155831,4,0,1,12800,4,5532086341
15531,390954670,579125,391533795,9,0,0,159232,17,6010456467
15532,390962250,195527,391157777,9,0,1,3072,17,1611967212
15533,390967560,196221,391163781,1,0,1,28672,6,9601381395
15534,390971290,197637,391168927,5,0,1,8192,11,10672884428
15535,391019690,149493,391169183,5,0,1,9216,11,6019939464
15536,391069400,740412,391809812,5,0,0,171520,11,3051175529
15537,391078940,93149,391172089,5,0,1,4608,11,10198607425
15538,391125600,57421,391183021,4,0,1,35840,4,887568584
15539,391162600,21804,391184404,1,0,1,14848,6,7791056818
15540,391165790,18768,391184558,5,0,1,8704,11,2701969059
15541,391189980,567525,391757505,9,0,0,81920,17,5206707141
15542,391213080,518795,391731875,5,0,0,87552,11,7513417157
15543,391229500,11366,391240866,4,0,1,3072,4,3375668418
15544,391235420,6432,391241852,5,0,1,1536,11,5032759008
15545,391245070,487460,391732530,3,0,0,2048,0,472382642
15546,391245110,2947,391248057,8,0,1,3072,6,2593682575
15547,391276371,3898,391280269,0,0,1,4096,6,4147814785
15548,391286230,3904,391290134,6,0,1,10752,3,8123308070
15549,391384571,11274,391395845,0,0,1,18432,6,1429559352
15550,391386070,79461,391465531,3,0,1,126464,0,1329755082
15551,391429860,40958,391470818,8,0,1,16896,6,4535569116
15552,391474390,59420,391533810,8,0,1,28672,6,1460477016
15553,391494700,52631,391547331,6,0,1,26112,3,4231021423
15554,391529630,26003,391555633,1,0,1,23552,6,1686438710
15555,391598250,211609,391809859,6,0,1,48128,3,8790288961
15556,391644450,165424,391809874,1,0,1,5120,6,2012434026
15557,391735820,411487,392147307,9,0,0,230912,17,10471508236
15558,391745360,71666,391817026,9,0,1,7680,17,2124142712
15559,391755200,62492,391817692,8,0,1,1024,6,3050287126
15560,391758530,270609,392029139,3,0,1,351744,0,847574356
15561,391770310,274280,392044590,3,0,1,57344,0,4045250965
15562,391812440,248829,392061269,4,0,1,63488,4,3260248795
15563,391854770,294791,392149561,3,0,1,204288,0,4500036550
15564,391877231,272345,392149576,0,0,1,6144,6,5847945636
15565,391917029,232562,392149591,8,0,1,15872,6,1107253959
15566,391930350,219180,392149530,5,0,0,7168,11,121254278
15567,391941139,208467,392149606,8,0,1,1024,6,8882331420
15568,391971820,343595,392315415,5,0,0,18432,11,5768392310
15569,391972260,189470,392161730,3,0,1,99840,0,7481308630
15570,391977610,389952,392367562,5,0,0,148992,11,8381514522
15571,391983369,183853,392167222,8,0,1,17920,6,9612925207
15572,392018440,170082,392188522,4,0,1,69120,4,9205625297
15573,392026050,653045,392679095,9,0,0,45056,17,9828883282
15574,392037390,157136,392194526,9,0,1,20480,17,2558569447
15575,392081390,321161,392402551,5,0,0,7680,11,9906387389
15576,392102400,373413,392475813,5,0,0,29184,11,5999889114
15577,392121320,74512,392195832,9,0,1,2048,17,8949714219
15578,392177130,29122,392206252,9,0,1,33280,17,2189062152
15579,392181630,420788,392602418,3,0,0,6656,0,603294679
15580,392223509,12566,392236075,8,0,1,20992,6,4326739061
15581,392245079,3128,392248207,8,0,1,9216,6,6233532387
15582,392269149,6229,392275378,8,0,1,15360,6,1598455643
15583,392354330,144928,392499258,3,0,0,512,0,874415039
15584,392412341,2946,392415287,0,0,1,3072,6,5083629261
15585,392415760,139218,392554978,3,0,0,512,0,7933138739
15586,392433180,347554,392780734,5,0,0,38912,11,8099892943
15587,392458111,6488,392464599,0,0,1,15872,6,683377709
15588,392462300,263860,392726160,9,0,0,16384,17,1174167695
15589,392475739,4916,392480655,8,0,1,5120,6,749494816
15590,392549580,401135,392950715,9,0,0,199680,17,9643923956
15591,392617290,255928,392873218,3,0,0,1024,0,2165434232
15592,392714829,36604,392751433,8,0,1,64512,6,2777378172
15593,392734000,22720,392756720,1,0,1,16896,6,6005281357
15594,392773330,7962,392781292,9,0,1,512,17,5260889679
15595,392900520,285007,393185527,9,0,0,13312,17,2720030838
15596,392939650,131078,393070728,9,0,0,11776,17,6022236581
15597,392976721,12049,392988770,0,0,1,19968,6,2531777782
15598,393058420,290017,393348437,5,0,0,21504,11,1526910936
15599,393062080,164020,393226100,5,0,0,66560,11,9267597558
15600,393165020,410811,393575831,5,0,0,81920,11,5328263207
15601,393187240,316184,393503424,9,0,0,104960,17,6638087727
15602,393199990,161700,393361690,5,0,0,37888,11,9410752833
15603,393207719,22747,393230466,8,0,1,4608,6,8557079702
15604,393242579,2946,393245525,8,0,1,3072,6,6918762618
15605,393300221,4162,393304383,0,0,1,11264,6,10180112066
15606,393313970,290378,393604348,3,0,0,1024,0,812946
15607,393340100,564764,393904864,5,0,0,526336,11,6010981204
15608,393343370,19176,393362546,9,0,1,24064,17,8799533259
15609,393522930,417885,393940815,9,0,0,117760,17,217712669
15610,393533450,42396,393575846,7,0,1,61952,16,313714220
15611,393573410,8399,393581809,9,0,1,14848,17,4027869009
15612,393585140,401871,393987011,9,0,0,31744,17,7197010438
15613,393624370,1994,393626364,9,0,1,2048,17,9883728948
15614,393637940,15579,393653519,9,0,1,30208,17,8421089633
15615,393697719,3645,393701364,8,0,1,10240,6,10169353921
15616,393724619,4374,393728993,8,0,1,4608,6,3953453392
15617,393731830,5326,393737156,9,0,1,5632,17,3875410389
15618,393768820,172595,393941415,5,0,1,512,11,4914600221
15619,393783900,180571,393964471,7,0,1,38912,16,3196675283
15620,393785880,586098,394371978,4,0,1,679424,4,4534897767
15621,393812340,174998,393987338,3,0,0,1024,0,10667464001
15622,393822549,549993,394372542,8,0,1,10752,6,747634721
15623,393848830,539572,394388402,5,0,1,51200,11,9349348786
15624,393863700,159329,394023029,3,0,0,7680,0,5114349090
15625,393885360,374928,394260288,5,0,0,100352,11,10669971072
15626,393890500,503291,394393791,1,0,1,17408,6,7218790342
15627,393894070,505520,394399590,5,0,1,19456,11,3049901245
15628,393963660,620917,394584577,9,0,0,83456,17,512995825
15629,393976690,644372,394621062,9,0,0,3072,17,3976772552
15630,393996570,436909,394433479,5,0,0,8704,11,3197122005
15631,394004569,400922,394405491,8,0,1,19968,6,9210210440
15632,394027410,383470,394410880,5,0,1,25600,11,9037785164
15633,394032670,378466,394411136,5,0,1,9216,11,1820016656
15634,394036690,390716,394427406,7,0,1,53248,16,7215463723
15635,394045010,384662,394429672,5,0,1,3584,11,8762723304
15636,394065920,368578,394434498,5,0,1,7680,11,1414367892
15637,394092910,465139,394558049,7,0,1,402944,16,917161294
15638,394115380,469212,394584592,5,0,1,13824,11,9592726981
15639,394121960,225532,394347492,3,0,0,3072,0,472286167
15640,394156420,651968,394808388,9,0,0,169984,17,512214527
15641,394189650,394957,394584607,9,0,1,10752,17,6902169860
15642,394193149,391473,394584622,8,0,1,63488,6,2281173963
15643,394236159,396826,394632985,8,0,1,188416,6,9906538873
15644,394319969,355463,394675432,8,0,1,145920,6,5785564273
15645,394320850,360483,394681333,5,0,1,19968,11,865089262
15646,394384739,423664,394808403,8,0,1,283648,6,5127182019
15647,394411990,396428,394808418,7,0,1,29184,16,2807970861
15648,394457540,350893,394808433,9,0,1,4096,17,7221527942
15649,394499390,309058,394808448,5,0,1,21504,11,9804277249
15650,394658200,540559,395198759,5,0,0,251392,11,7745679112
15651,394666530,397097,395063627,3,0,0,512,0,5675238505
15652,394710250,98213,394808463,9,0,1,18944,17,2408584568
15653,394725150,357129,395082279,3,0,0,4096,0,256616274
15654,394792710,204290,394997000,9,0,0,1536,17,2461441999
15655,394805050,556623,395361673,5,0,0,136192,11,6775889395
15656,394841800,13858,394855658,5,0,1,23552,11,5736411698
15657,394921970,558090,395480060,9,0,0,109056,17,4751503814
15658,394945500,11791,394957291,9,0,1,19456,17,4920051513
15659,394957250,146170,395103420,7,0,1,241152,16,232402581
15660,394964580,139826,395104406,5,0,1,1536,11,3513910981
15661,394972870,134122,395106992,9,0,1,4096,17,8310479730
15662,395029880,869484,395899364,9,0,0,37376,17,9423873169
15663,395033270,561508,395594778,9,0,0,40448,17,10589351000
15664,395042090,76448,395118538,9,0,1,38912,17,9599390272
15665,395055740,737504,395793244,5,0,0,125440,11,2741920961
15666,395075040,670883,395745923,9,0,0,408064,17,4969323423
15667,395081660,117154,395198814,7,0,1,133120,16,2490883103
15668,395083430,325507,395408937,3,0,0,512,0,4366064904
15669,395086960,128295,395215255,9,0,1,31744,17,6448276983
15670,395099480,499500,395598980,5,0,0,3072,11,2493529775
15671,395107670,263277,395370947,7,0,1,262656,16,7353508357
15672,395160740,216211,395376951,5,0,1,20480,11,7934348904
15673,395182570,200590,395383160,5,0,1,29696,11,4577348974
15674,395194290,204321,395398611,5,0,1,57344,11,1570619208
15675,395213570,190840,395404410,5,0,1,19456,11,7470287779
15676,395217700,656522,395874222,5,0,0,133632,11,3710593462
15677,395244070,690409,395934479,5,0,0,115200,11,3818581706
15678,395283890,471119,395755009,3,0,0,1024,0,4290324258
15679,395334120,499371,395833491,9,0,0,46080,17,660602709
15680,395339640,66255,395405895,5,0,1,15360,11,6467475765
15681,395401050,353632,395754682,9,0,0,28672,17,565704468
15682,395417480,386707,395804187,9,0,0,35840,17,6934461662
15683,395437430,1099381,396536811,5,0,0,197120,11,7994842898
15684,395438970,367260,395806230,9,0,0,6656,17,1912021754
15685,395452490,882787,396335277,9,0,0,144896,17,9308729087
15686,395456800,28473,395485273,5,0,1,13312,11,3017446408
15687,395488530,470717,395959247,3,0,0,6144,0,10177127896
15688,395514470,596295,396110765,5,0,0,78848,11,10468675922
15689,395527240,6229,395533469,9,0,1,15360,17,6477292186
15690,395573620,510016,396083636,5,0,0,45056,11,5008558634
15691,395612630,811644,396424274,5,0,0,163840,11,10712079491
15692,395640450,168332,395808782,5,0,1,30208,11,3461815400
15693,395766920,607224,396374144,5,0,0,127488,11,2907306673
15694,395771090,661959,396433049,9,0,0,28672,17,8782032348
15695,395874910,286969,396161879,9,0,0,59904,17,7635435646
15696,395958210,15316,395973526,9,0,1,27648,17,8192890953
15697,395969400,15321,395984721,9,0,1,29696,17,4394986785
15698,396022500,453443,396475943,3,0,0,4096,0,2479961838
15699,396072380,370676,396443056,5,0,0,32768,11,5432477871
15700,396072690,38090,396110780,9,0,1,7680,17,7720677872
15701,396083810,26993,396110803,5,0,1,24064,11,3622754903
15702,396088870,52393,396141263,6,0,1,49152,3,4300897761
15703,396129840,244491,396374331,3,0,0,512,0,701457632
15704,396210150,500153,396710303,5,0,0,135680,11,410576960
15705,396267880,20366,396288246,6,0,1,32768,3,5068773743
15706,396277070,315627,396592697,5,0,0,23040,11,9039125613
15707,396297470,239988,396537458,3,0,0,2048,0,8128404409
15708,396318220,124859,396443079,5,0,1,12800,11,1666424646
15709,396325110,568551,396893661,9,0,0,118784,17,7246832970
15710,396335260,375378,396710638,3,0,0,1024,0,9611931843
15711,396361460,420040,396781500,5,0,0,75776,11,9919449104
15712,396365930,476584,396842514,5,0,0,43008,11,5854064138
15713,396410740,190165,396600905,5,0,0,4608,11,5207967631
15714,396415980,320512,396736492,9,0,0,512,17,1741697517
15715,396435080,9043,396444123,5,0,1,1024,11,7227959577
15716,396467440,247813,396715253,3,0,0,2560,0,8136455108
15717,396477130,82228,396559358,5,0,1,35840,11,3917385542
15718,396498970,63294,396562264,5,0,1,4608,11,7171803935
15719,396559780,3645,396563425,6,0,1,10240,3,4197532329
15720,396638440,2946,396641386,5,0,1,3072,11,6389130443
15721,396642440,5454,396647894,5,0,1,13824,11,3145284290
15722,396682000,212308,396894308,8,0,0,2048,6,7411571587
15723,396806540,186551,396993091,3,0,0,4096,0,3355752770
15724,396869490,26295,396895785,2,0,1,1536,11,461742779
15725,396973590,155907,397129497,9,0,0,15872,17,1047719492
15726,396992980,1621,396994601,2,0,1,1536,11,1937150953
15727,396994440,88905,397083345,3,0,0,512,0,6521190583
15728,396998050,2470,397000520,5,0,1,2560,11,3545611073
15729,397149340,30491,397179831,5,0,1,49152,11,516995841
15730,397163740,17397,397181137,2,0,1,2048,11,1928177692
15731,397176990,285302,397462292,3,0,0,3072,0,2931971030
15732,397178080,25446,397203526,6,0,1,46080,3,893086350
15733,397224370,107328,397331698,3,0,0,4608,0,2343488870
15734,397315130,4374,397319504,6,0,1,4608,3,4255812961
15735,397340880,351023,397691903,5,0,0,133632,11,4111388617
15736,397373500,7706,397381206,6,0,1,8192,3,1471819253
15737,397405460,3387,397408847,5,0,1,9728,11,6610282910
15738,397473900,107945,397581845,5,0,0,13312,11,9477097236
15739,397480300,124567,397604867,3,0,0,2048,0,854422333
15740,397491330,13341,397504671,5,0,1,22528,11,1088460550
15741,397492700,12739,397505439,5,0,1,11776,11,7197062250
15742,397494750,11777,397506527,6,0,1,12288,3,374714064
15743,397515740,182589,397698329,9,0,0,20992,17,3506110806
15744,397549310,1042,397550352,5,0,1,1024,11,4280672479
15745,397555010,2470,397557480,2,0,1,2560,11,7978617545
15746,397567840,192552,397760392,5,0,0,72192,11,829270443
15747,397628890,63028,397691918,4,0,1,55296,4,2527114339
15748,397704650,21141,397725791,4,0,1,34304,4,5898414980
15749,397763350,147616,397910966,9,0,0,100352,17,6386832535
15750,397765490,205458,397970948,4,0,1,333312,4,2841562508
15751,397775830,199944,397975774,9,0,1,7680,17,3401849319
15752,397783820,192620,397976440,2,0,1,1024,11,7272048524
15753,397874930,108231,397983161,5,0,1,24064,11,7022812072
15754,397876290,371603,398247893,9,0,0,38400,17,616547467
15755,397887300,102582,397989882,2,0,1,24064,11,6949778456
15756,397895640,100451,397996091,5,0,1,21504,11,2387476978
15757,397985780,13537,397999317,5,0,1,5120,11,8097697137
15758,398007840,228338,398236178,9,0,0,115712,17,6077100304
15759,398011130,4420,398015550,5,0,1,11776,11,1850494588
15760,398060150,1042,398061192,5,0,1,1024,11,8191205769
15761,398090680,15579,398106259,4,0,1,30208,4,4728956823
15762,398105380,15321,398120701,5,0,1,29696,11,3963890700
15763,398106920,280954,398387874,5,0,0,68608,11,8835097677
15764,398145170,5196,398150366,5,0,1,13312,11,7527802951
15765,398290180,3387,398293567,2,0,1,9728,11,5696114372
15766,398300380,34020,398334400,2,0,1,59392,11,2310232582
15767,398321680,331933,398653613,9,0,0,321536,17,7481748579
15768,398348890,6488,398355378,4,0,1,15872,4,2995465037
15769,398350360,37529,398387889,5,0,1,23040,11,3612603718
15770,398379330,307230,398686560,9,0,0,64000,17,1580525992
15771,398397640,33850,398431490,5,0,1,55808,11,2923791012
15772,398402830,360223,398763053,9,0,0,60928,17,7524704225
15773,398427950,4846,398432796,2,0,1,2048,11,10694849220
15774,398490579,5802,398496381,8,0,1,6144,6,10432259920
15775,398504780,454701,398959481,9,0,0,73216,17,4116894444
15776,398508270,592877,399101147,9,0,0,305152,17,1439344145
15777,398513900,1518,398515418,5,0,1,1536,11,2739495547
15778,398537910,14287,398552197,5,0,1,27648,11,407936608
15779,398545050,8427,398553477,5,0,1,14336,11,4376602801
15780,398559810,543536,399103346,5,0,0,7168,11,3963321928
15781,398577920,423531,399001451,9,0,0,80896,17,6744340737
15782,398601700,517432,399119132,5,0,0,51200,11,6641167629
15783,398607180,52344,398659524,5,0,1,6144,11,4063694390
15784,398635680,25150,398660830,4,0,1,2048,4,3167292287
15785,398637120,24069,398661189,2,0,1,9728,11,688403296
15786,398669810,18736,398688546,5,0,1,2048,11,7157412607
15787,398704400,299094,399003494,3,0,0,6656,0,8895787429
15788,398706430,56638,398763068,4,0,1,78848,4,10122843525
15789,398763350,206367,398969717,3,0,0,5632,0,8410868579
15790,398769750,3898,398773648,5,0,1,4096,11,10573385778
15791,398789170,139177,398928347,3,0,0,2048,0,1046597053
15792,398807380,97354,398904734,4,0,1,162816,4,1805646272
15793,398819700,91652,398911352,2,0,1,23552,11,7273012122
15794,398832459,82439,398914898,8,0,1,5632,6,6976915046
15795,398865500,55709,398921209,2,0,1,22016,11,538572029
15796,398867490,65470,398932960,4,0,1,39936,4,8327013522
15797,398873540,957783,399831323,4,0,1,1536000,4,9333784123
15798,398877809,964548,399842357,8,0,1,36352,6,6130004268
15799,398882230,221287,399103517,3,0,0,512,0,2709850793
15800,398910630,942761,399853391,5,0,1,44544,11,317307110
15801,398919770,944143,399863913,5,0,1,33792,11,6594924062
15802,398991299,924405,399915704,8,0,1,165888,6,530908250
15803,398999130,919480,399918610,4,0,1,4608,4,2768312844
15804,399009760,774989,399784749,9,0,0,15360,17,6984474661
15805,399016440,989752,400006192,5,0,0,67584,11,4630201305
15806,399045490,675201,399720691,9,0,0,66560,17,7237134895
15807,399071910,679847,399751757,9,0,0,33280,17,4387741767
15808,399110280,1098048,400208328,4,0,1,931328,4,3229418078
15809,399150060,329105,399479165,3,0,0,1024,0,6231648845
15810,399162680,558650,399721330,5,0,0,2048,11,7862634741
15811,399171840,762625,399934465,9,0,0,19456,17,9522023708
15812,399189069,1048371,400237440,8,0,1,78848,6,6015422675
15813,399220510,1024817,400245327,2,0,1,32256,11,184251366
15814,399224020,600197,399824217,3,0,0,5632,0,2156954334
15815,399238360,462036,399700396,9,0,0,144896,17,2832489917
15816,399277879,1085500,400363379,8,0,1,378368,6,9587497875
15817,399302059,1120775,400422834,8,0,1,192512,6,6741756908
15818,399303180,420037,399723217,5,0,0,6144,11,5520090720
15819,399323490,463470,399786960,3,0,0,2048,0,4725559004
15820,399356590,395650,399752240,3,0,0,1536,0,2008531231
15821,399366140,1059280,400425420,5,0,1,4096,11,1402206889
15822,399385260,999139,400384399,3,0,0,1536,0,6996175926
15823,399391860,1105229,400497089,4,0,1,111104,4,9427492231
15824,399447960,1049635,400497595,4,0,1,66048,4,4857912300
15825,399504960,635742,400140702,3,0,0,2560,0,7313293175
15826,399537449,1017648,400555097,8,0,1,244736,6,4410754537
15827,399616330,654668,400270998,3,0,0,3072,0,4946172113
15828,399640630,965279,400605909,4,0,1,165376,4,7352610948
15829,399662030,425586,400087616,3,0,0,512,0,4192135115
15830,399727100,881395,400608495,9,0,1,4096,17,13775643
15831,399780600,833704,400614304,4,0,1,8192,4,3789861938
15832,399810179,1024631,400834810,8,0,1,425984,6,3045035735
15833,399818760,313638,400132398,3,0,0,512,0,2916915298
15834,399863060,633843,400496903,5,0,0,134144,11,10281111000
15835,399894510,209800,400104310,3,0,0,2560,0,6551893812
15836,399894739,967183,400861922,8,0,1,123392,6,10680065450
15837,399901070,1028004,400929074,2,0,1,49664,11,901737760
15838,399939280,895515,400834795,9,0,0,184320,17,4244621275
15839,399956630,973110,400929740,2,0,1,11264,11,5270188394
15840,399987840,1266707,401254547,5,0,0,203264,11,9707616571
15841,399995260,1102307,401097567,7,0,1,142848,16,8052023116
15842,399999570,1103591,401103161,5,0,1,18432,11,8835969999
15843,400038240,459332,400497572,9,0,0,1536,17,7373389063
15844,400045380,1071573,401116953,5,0,1,10240,11,1683348099
15845,400172050,325024,400497074,3,0,0,512,0,4383006450
15846,400175040,963471,401138511,5,0,1,16384,11,994131764
15847,400229310,806353,401035663,9,0,0,87040,17,8618996183
15848,400240979,898505,401139484,8,0,1,12800,6,9706327129
15849,400248950,383039,400631989,3,0,0,1024,0,6234293818
15850,400272910,341379,400614289,3,0,0,2560,0,10034770506
15851,400285499,865780,401151279,8,0,1,43008,6,10557040771
15852,400310050,457921,400767971,9,0,0,117760,17,4952224454
15853,400427160,225333,400652493,5,0,0,10752,11,6688104099
15854,400469530,704152,401173682,5,0,1,32256,11,4957374133
15855,400500510,334791,400835301,3,0,0,1536,0,5260067241
15856,400514030,659998,401174028,5,0,1,512,11,3593272768
15857,400536860,640714,401177574,5,0,1,5632,11,6160517023
15858,400578670,896067,401474737,9,0,0,162304,17,5595060218
15859,400585880,599724,401185604,5,0,1,13824,11,1631029749
15860,400627950,886902,401514852,5,0,0,131584,11,314880345
15861,400630300,308288,400938588,9,0,0,7680,17,837525928
15862,400637639,548311,401185950,8,0,1,512,6,2797578055
15863,400696600,839795,401536395,5,0,0,70656,11,2149605137
15864,400711299,543271,401254570,8,0,1,21504,6,7259635951
15865,400730260,344977,401075237,9,0,0,42496,17,9191532374
15866,400785559,469026,401254585,8,0,1,7168,6,6751419436
15867,400820320,464430,401284750,4,0,1,98304,4,2718113444
15868,400840580,578806,401419386,3,0,0,2048,0,7445548304
15869,400864629,421747,401286376,8,0,1,2560,6,2505362404
15870,400875000,413962,401288962,5,0,1,4096,11,4887559311
15871,400949900,339728,401289628,5,0,1,1024,11,134511723
15872,400951389,339865,401291254,8,0,1,2560,6,8132733046
15873,400963820,408886,401372706,9,0,0,29184,17,5726174543
15874,400984820,310620,401295440,5,0,1,6656,11,2963567948
15875,400990680,386367,401377047,3,0,0,512,0,2634032097
15876,401004719,311821,401316540,8,0,1,33792,6,1573262823
15877,401071220,245305,401316525,3,0,0,4096,0,10618230909
15878,401113160,203868,401317028,5,0,1,19968,11,8712613128
15879,401114169,222654,401336823,8,0,1,22528,6,3203051936
15880,401208670,164051,401372721,5,0,1,3584,11,2218413546
15881,401247799,124937,401372736,8,0,1,512,6,10303767881
15882,401260880,111871,401372751,5,0,1,512,11,1422467157
15883,401297960,483173,401781133,5,0,0,20992,11,825144326
15884,401345400,599740,401945140,5,0,0,300032,11,2098338083
15885,401346350,428372,401774722,9,0,0,94720,17,8387049645
15886,401461090,670337,402131427,9,0,0,182784,17,4708673336
15887,401498620,473523,401972143,9,0,0,88576,17,1842890631
15888,401499250,43133,401542383,5,0,1,14848,11,8948195622
15889,401578950,559550,402138500,5,0,0,17920,11,2310620452
15890,401584020,491700,402075720,5,0,0,120832,11,1300265799
15891,401685280,616085,402301365,5,0,0,154112,11,1783930912
15892,401703020,672427,402375447,3,0,0,2048,0,4120603199
15893,401764530,470835,402235365,5,0,0,98816,11,5069907067
15894,401841690,291335,402133025,3,0,0,5120,0,3225106041
15895,401884640,470036,402354676,5,0,0,9216,11,9192879485
15896,401902590,266589,402169179,5,0,0,32768,11,4369257459
15897,401949440,85936,402035376,1,0,1,102912,6,10549992042
15898,401990600,329656,402320256,5,0,0,61952,11,2715413369
15899,402025890,495537,402521427,9,0,0,226816,17,8643084241
15900,402038660,92782,402131442,5,0,1,3072,11,8825420856
15901,402049229,94080,402143309,8,0,1,5120,6,7414146015
15902,402148700,249817,402398517,3,0,0,1024,0,8665962314
15903,402149010,20184,402169194,5,0,1,20480,11,5034505018
15904,402204000,31380,402235380,5,0,1,15872,11,592221844
15905,402247380,1518,402248898,5,0,1,1536,11,47845844
15906,402329050,279037,402608087,9,0,0,38912,17,9711943904
15907,402333480,1994,402335474,5,0,1,2048,11,2850576814
15908,402344030,1994,402346024,5,0,1,2048,11,8439276839
15909,402475680,46322,402522002,5,0,1,512,11,1247208781
15910,402519720,121358,402641078,5,0,0,5632,11,9426070539
15911,402597220,17613,402614833,5,0,1,7168,11,5292834578
15912,402630630,270734,402901364,3,0,0,6144,0,817743932
15913,402675940,392820,403068760,9,0,0,133632,17,9276943447
15914,402697880,266473,402964353,5,0,0,42496,11,7455437263
15915,402742570,6278,402748848,9,0,1,6656,17,4108364913
15916,402917900,11016,402928916,5,0,1,17920,11,6429416503
15917,402947350,214486,403161836,5,0,0,12288,11,10664272412
15918,402957120,14455,402971575,5,0,1,7680,11,2641727901
15919,403053470,20736,403074206,9,0,1,13824,17,957172193
15920,403073010,10502,403083512,9,0,1,16896,17,2001896286
15921,403087280,171789,403259069,5,0,0,30720,11,6340755040
15922,403145880,5326,403151206,9,0,1,5632,17,7439992988
15923,403172110,151892,403324002,5,0,0,76288,11,8980562907
15924,403328890,148075,403476965,9,0,0,51200,17,7161750859
15925,403343640,235844,403579484,5,0,0,57856,11,5357974619
15926,403355400,83612,403439012,7,0,1,139264,16,6457285441
15927,403401950,75030,403476980,4,0,1,121856,4,6269320997
15928,403402210,200350,403602560,4,0,1,264704,4,2508346912
15929,403433320,172466,403605786,9,0,1,5120,17,8949080943
15930,403457990,325427,403783417,5,0,0,55296,11,2848111774
15931,403479380,163105,403642485,7,0,1,118272,16,1102516757
15932,403513180,130931,403644111,9,0,1,2560,17,4305703097
15933,403519670,127987,403647657,9,0,1,5632,17,530449419
15934,403613480,407441,404020921,4,0,1,659968,4,9737598481
15935,403615050,248063,403863113,3,0,0,1536,0,1518044563
15936,403672370,472833,404145203,3,0,0,2048,0,8327721798
15937,403674500,313838,403988338,5,0,0,51200,11,522453169
15938,403730010,369391,404099401,4,0,1,252928,4,3467107624
15939,403751000,406144,404157144,4,0,1,186368,4,9251381033
15940,403757470,423894,404181364,3,0,0,512,0,10032527369
15941,403779990,247761,404027751,3,0,0,1024,0,5690922985
15942,403787180,371590,404158770,9,0,1,2560,17,4773961726
15943,403821260,338816,404160076,9,0,1,2048,17,4233881314
15944,403858970,486102,404345072,9,0,0,98816,17,179043679
15945,403976310,184944,404161254,7,0,1,13824,16,9478717758
15946,403984250,202925,404187175,4,0,1,82944,4,442044743
15947,403988310,201771,404190081,9,0,1,4608,17,7796884110
15948,404048130,147750,404195880,5,0,1,19456,11,4962031562
15949,404049830,156368,404206198,4,0,1,32768,4,765323371
15950,404102620,400542,404503162,3,0,0,2048,0,8265469595
15951,404116640,596791,404713431,5,0,0,237056,11,1934652686
15952,404149700,68249,404217949,4,0,1,48128,4,8553591752
15953,404151410,489778,404641188,9,0,0,80384,17,1897225368
15954,404160350,184737,404345087,4,0,1,249344,4,8917616093
15955,404211230,205071,404416301,7,0,1,288768,16,10075665456
15956,404354480,92671,404447151,7,0,1,106496,16,5105443459
15957,404363290,363682,404726972,3,0,0,4096,0,10719805767
15958,404383020,95493,404478513,4,0,1,109056,4,1888199727
15959,404385410,95369,404480779,7,0,1,3584,16,6692719494
15960,404388200,330579,404718779,7,0,1,482304,16,4049465052
15961,404391480,343671,404735151,4,0,1,53760,4,2155792933
15962,404426030,587671,405013701,5,0,0,31744,11,9416046349
15963,404439650,296167,404735817,4,0,1,1024,4,6398490786
15964,404474950,266564,404741514,9,0,1,18944,17,2620280858
15965,404476420,267360,404743780,9,0,1,3584,17,8026655757
15966,404550440,235992,404786432,4,0,1,146944,4,818243405
15967,404628711,159667,404788378,0,0,1,3072,6,5018888136
15968,404684310,109765,404794075,6,0,1,18944,3,5367608152
15969,404693280,513166,405206446,5,0,0,140800,11,2943628426
15970,404705110,94866,404799976,6,0,1,19968,3,713544218
15971,404739870,80792,404820662,4,0,1,66048,4,4655082461
15972,404769260,624136,405393396,5,0,0,193024,11,8448184613
15973,404949980,293180,405243160,3,0,0,3072,0,7600497559
15974,404959940,249488,405209428,7,0,1,409088,16,231422954
15975,404962010,253831,405215841,6,0,1,22528,3,9901760454
15976,404993051,466602,405459653,7,0,0,4608,16,10702065079
15977,405016610,201497,405218107,4,0,1,3584,4,2915680541
15978,405044040,195879,405239919,4,0,1,71680,4,9069492037
15979,405047010,346401,405393411,4,0,1,410624,4,4832798559
15980,405072420,321006,405393426,6,0,1,25600,3,5382502454
15981,405093680,519401,405613081,3,0,0,1024,0,4574224245
15982,405097920,514834,405612754,9,0,0,75776,17,5995144189
15983,405120670,272771,405393441,7,0,1,14336,16,5608973326
15984,405121910,677103,405799013,5,0,0,80896,11,1024754549
15985,405126120,352697,405478817,9,0,0,5120,17,1532798397
15986,405130520,296031,405426551,4,0,1,172032,4,4805162554
15987,405158400,483893,405642293,7,0,1,547328,16,1066005047
15988,405166210,465203,405631413,3,0,0,1536,0,6191969327
15989,405180950,471968,405652918,4,0,1,34304,4,7910656386
15990,405182750,496294,405679044,7,0,1,92160,16,1425753429
15991,405200550,219141,405419691,9,0,0,3072,17,2326108180
15992,405268720,587978,405856698,7,0,1,570368,16,3470463712
15993,405270400,623054,405893454,7,0,1,124928,16,185449949
15994,405296280,614778,405911058,7,0,1,75264,16,5535467561
15995,405310180,638402,405948582,4,0,1,136704,4,6524173380
15996,405349870,643342,405993212,4,0,1,145920,4,7991701524
15997,405385450,607916,405993366,6,0,1,8704,3,1645365869
15998,405417050,600500,406017550,7,0,1,82944,16,4546006979
15999,405435960,586762,406022722,6,0,1,18432,3,4690274864
16000,405458511,243649,405702160,7,0,0,1536,16,5142848440
16001,405507370,515608,406022978,6,0,1,9216,3,10134438120
16002,405533320,478084,406011404,3,0,0,1024,0,6425953880
16003,405583720,510161,406093881,4,0,1,203264,4,9398161426
16004,405605750,630123,406235873,3,0,1,227328,0,10577180222
16005,405625400,749730,406375130,5,0,0,42496,11,1601293850
16006,405697740,538148,406235888,3,0,1,19456,0,7378047530
16007,405730640,523867,406254507,3,0,1,58880,0,2189589271
16008,405739440,367439,406106879,3,0,0,1536,0,6510472994
16009,405743020,545768,406288788,4,0,1,47104,4,3833529622
16010,405751060,484798,406235858,5,0,0,74240,11,3705715188
16011,405775720,550513,406326233,6,0,1,32256,3,9044568973
16012,405856231,232572,406088803,7,0,0,3072,16,5917361037
16013,405870991,444353,406315344,7,0,0,8192,16,5576139508
16014,405895080,443251,406338331,2,0,1,35840,11,2638158174
16015,405934210,318443,406252653,3,0,0,512,0,9526370224
16016,405934520,224411,406158931,9,0,0,512,17,10337319264
16017,405950711,393397,406344108,7,0,0,1024,16,7537852042
16018,406039670,310870,406350540,4,0,1,23552,4,8825002380
16019,406048220,309412,406357632,4,0,1,11264,4,1767328785
16020,406086650,207474,406294124,3,0,0,4608,0,8682372181
16021,406156100,202518,406358618,6,0,1,1536,3,5218533293
16022,406156470,202814,406359284,4,0,1,11264,4,3026501670
16023,406157360,715438,406872798,5,0,0,269312,11,193768064
16024,406205640,154003,406359643,4,0,1,9728,4,6833487466
16025,406231990,284786,406516776,7,0,1,271872,16,4896674056
16026,406337820,289368,406627188,9,0,0,2560,17,2889708035
16027,406365481,276193,406641674,7,0,0,3072,16,2798838601
16028,406394580,593502,406988082,5,0,0,146432,11,9982685919
16029,406465270,408971,406874241,9,0,0,4608,17,10307992838
16030,406494620,154048,406648668,7,0,1,174592,16,4225371430
16031,406519300,129714,406649014,2,0,1,512,11,9272500290
16032,406573340,301110,406874450,3,0,0,512,0,5303214789
16033,406584870,101775,406686645,3,0,1,77824,0,5778166034
16034,406586890,287366,406874256,7,0,1,282624,16,864496447
16035,406614500,663953,407278453,5,0,0,218624,11,6876044279
16036,406671320,202951,406874271,9,0,1,16896,17,5983941191
16037,406686760,632919,407319679,5,0,0,125952,11,7357185142
16038,406702150,703438,407405588,5,0,0,197120,11,10283736962
16039,406704530,324994,407029524,9,0,0,2048,17,1313546593
16040,406705421,287545,406992966,7,0,0,8704,16,9843328684
16041,406718500,269597,406988097,3,0,1,258560,0,767085421
16042,406718700,998270,407716970,5,0,0,344576,11,3541084715
16043,406719000,600850,407319850,9,0,0,512,17,4837950332
16044,406751300,236812,406988112,3,0,1,10240,0,8321740587
16045,406836281,569790,407406071,7,0,0,1536,16,8328348432
16046,406867660,241169,407108829,7,0,1,139776,16,8380167346
16047,406878651,401089,407279740,7,0,0,4096,16,4614678788
16048,406884561,437035,407321596,7,0,0,5120,16,4371671955
16049,406918570,401451,407320021,3,0,0,512,0,6092230002
16050,406987330,750270,407737600,5,0,0,53760,11,689776458
16051,407022380,392094,407414474,7,0,1,235008,16,5580044617
16052,407195300,546268,407741568,9,0,0,4096,17,10350972090
16053,407200840,371785,407572625,5,0,0,20992,11,5188636905
16054,407207470,219893,407427363,4,0,1,15360,4,3361552922
16055,407215360,375723,407591083,9,0,0,3072,17,7004813134
16056,407225291,523154,407748445,7,0,0,9216,16,10592201337
16057,407226471,513834,407740305,7,0,0,6144,16,7163849304
16058,407243560,477645,407721205,5,0,0,13824,11,699108872
16059,407266220,226672,407492892,6,0,1,1536,3,8210625407
16060,407276610,237394,407514004,7,0,1,33792,16,3199442552
16061,407279740,458507,407738247,0,0,0,2048,6,6069727068
16062,407313700,517110,407830810,3,0,1,449024,0,10001439159
16063,407328510,533631,407862141,3,0,1,34816,0,4396057346
16064,407331140,549152,407880292,7,0,1,52224,16,7843161337
16065,407364860,373558,407738418,3,0,0,512,0,4627021921
16066,407379620,568392,407948012,5,0,0,188928,11,1526099470
16067,407423240,524787,407948027,7,0,1,20480,16,4667194403
16068,407461930,283685,407745615,3,0,0,6656,0,2491086187
16069,407529810,483961,408013771,9,0,0,512,17,5582810119
16070,407558170,434170,407992340,9,0,0,4096,17,9800901183
16071,407563581,384773,407948354,7,0,0,1024,16,7505997905
16072,407621400,340563,407961963,3,0,0,512,0,6053854558
16073,407666720,579602,408246322,5,0,0,178176,11,338151240
16074,407730960,304279,408035239,7,0,1,294400,16,3681436394
16075,407817010,249947,408066957,3,0,1,69120,0,10180394167
16076,407843861,457813,408301674,7,0,0,4608,16,5969820278
16077,407850820,229374,408080194,3,0,1,29184,0,3771352050
16078,407978660,321595,408300255,5,0,0,5632,11,5941277082
16079,407999270,179412,408178682,3,0,1,163328,0,1100903966
16080,408040750,205587,408246337,3,0,1,13312,0,1838904624
16081,408072680,206670,408279350,7,0,1,89088,16,4316320793
16082,408141290,382714,408524004,5,0,0,19456,11,6202903928
16083,408153650,133242,408286892,4,0,1,18432,4,5276790784
16084,408231690,56278,408287968,4,0,1,13312,4,9090300840
16085,408281520,79611,408361131,7,0,1,114688,16,9927908651
16086,408288390,81216,408369606,7,0,1,18432,16,3855164041
16087,408365040,65170,408430210,7,0,1,110080,16,1711273903
16088,408366900,276232,408643132,5,0,0,1536,11,6584481132
16089,408380040,55457,408435497,4,0,1,25088,4,8831148855
16090,408435790,3387,408439177,4,0,1,9728,4,10612241051
16091,408467180,3422,408470602,4,0,1,3584,4,2571580966
16092,408485881,76098,408561979,7,0,0,1024,16,2122936814
16093,408518300,15937,408534237,4,0,1,16384,4,157169468
16094,408554041,223172,408777213,7,0,0,3584,16,1564988827
16095,408626851,238969,408865820,7,0,0,4608,16,3709930731
16096,408682510,5971,408688481,4,0,1,14848,4,10401536437
16097,408722920,11791,408734711,3,0,1,19456,0,1563947142
16098,408766050,5454,408771504,3,0,1,13824,0,6136304019
16099,408776859,437826,409214685,4,0,0,143360,4,4545420819
16100,408797051,129505,408926556,7,0,0,1536,16,3693443666
16101,408810160,800089,409610249,5,0,0,263168,11,4738514175
16102,408818661,82977,408901638,7,0,0,1536,16,1708501849
16103,408844340,42683,408887023,7,0,1,69632,16,2613825245
16104,408847210,40786,408887996,4,0,1,12800,4,4395685981
16105,408855440,32902,408888342,4,0,1,512,4,10349757791
16106,408874550,14765,408889315,5,0,1,12800,11,458182591
16107,408923560,3645,408927205,6,0,1,10240,3,6971851686
16108,408935140,429927,409365067,5,0,0,52736,11,9709248034
16109,408963050,251650,409214700,7,0,1,402432,16,696312133
16110,408965070,249645,409214715,7,0,1,5120,16,8770030387
16111,408972720,281209,409253929,7,0,1,141312,16,6677727643
16112,408977380,283167,409260547,5,0,1,31744,11,279769050
16113,409055810,194858,409250668,5,0,0,2048,11,607672170
16114,409058710,206663,409265373,5,0,1,7680,11,7245782247
16115,409086480,194958,409281438,3,0,1,60416,0,6007571237
16116,409138610,226480,409365090,7,0,1,264704,16,6062993459
16117,409187849,813844,410001693,4,0,0,89088,4,3001621683
16118,409262739,711787,409974526,4,0,0,320512,4,9415841122
16119,409323410,44906,409368316,5,0,1,6656,11,81666996
16120,409333490,45758,409379248,3,0,1,35840,0,7013821319
16121,409339480,45465,409384945,9,0,1,18944,17,6169383317
16122,409361689,470831,409832520,4,0,0,72704,4,2947529212
16123,409374540,11391,409385931,4,0,1,1536,4,8856273475
16124,409416751,376970,409793721,7,0,0,1024,16,3572975730
16125,409431500,25704,409457204,3,0,1,46592,0,329771690
16126,409465300,15321,409480621,5,0,1,29696,11,9044305762
16127,409499550,13858,409513408,3,0,1,23552,0,4058433700
16128,409513099,297254,409810353,4,0,0,10240,4,2940454483
16129,409535510,75389,409610899,9,0,1,512,17,7231102632
16130,409551340,513827,410065167,5,0,0,129536,11,4922947581
16131,409584281,200706,409784987,7,0,0,1536,16,4847464096
16132,409601260,15458,409616718,9,0,1,15360,17,8809405168
16133,409606520,10544,409617064,4,0,1,512,4,6063811326
16134,409618060,5326,409623386,3,0,1,5632,0,571753409
16135,409620420,6192,409626612,9,0,1,5120,17,6821438553
16136,409641800,5712,409647512,4,0,1,14336,4,466449734
16137,409660380,32558,409692938,4,0,1,53248,4,1128468690
16138,409710160,2470,409712630,4,0,1,2560,4,2641466574
16139,409714340,294872,410009212,5,0,0,24576,11,689892492
16140,409739160,3645,409742805,5,0,1,10240,11,4398842304
16141,409812050,57325,409869375,3,0,1,65024,0,3806800995
16142,409877800,137859,410015659,4,0,1,15872,4,1507589160
16143,409899160,120649,410019809,5,0,1,6144,11,935576706
16144,409943920,145962,410089882,3,0,1,123904,0,9990206566
16145,410025829,281289,410307118,4,0,0,14336,4,663005904
16146,410030310,60238,410090548,9,0,1,1024,17,9197331448
16147,410047860,44276,410092136,3,0,1,15872,0,7612200963
16148,410051300,41707,410093007,5,0,1,12288,11,10478418070
16149,410083000,11633,410094633,5,0,1,2560,11,6550384339
16150,410103820,538125,410641945,5,0,0,335360,11,3727336946
16151,410129280,4420,410133700,9,0,1,11776,17,133534356
16152,410178309,480351,410658660,4,0,0,54784,4,136062364
16153,410179530,36604,410216134,3,0,1,64512,0,4618882116
16154,410184489,564456,410748945,4,0,0,259584,4,10420250373
16155,410188510,29570,410218080,9,0,1,3072,17,9054111763
16156,410255200,6229,410261429,9,0,1,15360,17,6778406618
16157,410267519,579942,410847461,4,0,0,45056,4,9456039701
16158,410325830,13341,410339171,3,0,1,22528,0,1115587783
16159,410361620,6229,410367849,5,0,1,15360,11,1890350548
16160,410400460,25187,410425647,4,0,1,45568,4,883520252
16161,410556929,266025,410822954,4,0,0,24064,4,6078232508
16162,410598440,150520,410748960,5,0,1,23040,11,10248019116
16163,410643510,147374,410790884,3,0,1,206848,0,7115352935
16164,410655610,137540,410793150,5,0,1,3584,11,5819552113
16165,410657641,297257,410954898,7,0,0,1024,16,5516046402
16166,410667130,551402,411218532,5,0,0,156672,11,6734586870
16167,410693851,101565,410795416,0,0,1,3584,6,5889895419
16168,410727970,71632,410799602,5,0,1,6656,11,1374291881
16169,410732870,69958,410802828,4,0,1,5120,4,7548336182
16170,410751230,57807,410809037,9,0,1,21504,17,9710589117
16171,410779869,373252,411153121,4,0,0,86528,4,10155612323
16172,410784680,29644,410814324,9,0,1,16896,17,778471445
16173,410792680,30289,410822969,9,0,1,3584,17,2447638089
16174,410861759,374892,411236651,4,0,0,59392,4,9711584642
16175,410880270,6488,410886758,9,0,1,15872,17,2461047686
16176,410897030,1042,410898072,5,0,1,1024,11,10552873674
16177,410957910,5802,410963712,9,0,1,6144,17,550695130
16178,411044520,276349,411320869,5,0,0,83968,11,2492127480
16179,411093960,184642,411278602,5,0,0,9728,11,6908010937
16180,411128669,199514,411328183,4,0,0,19968,4,7660657550
16181,411160980,4850,411165830,4,0,1,5120,4,6500094330
16182,411179020,61519,411240539,4,0,1,10752,4,3387064977
16183,411197820,139187,411337007,3,0,1,162304,0,843359421
16184,411246570,247014,411493584,5,0,0,78336,11,10013898207
16185,411272680,64788,411337468,9,0,1,10240,17,2596200510
16186,411281231,57598,411338829,7,0,0,1536,16,2873333521
16187,411308501,140751,411449252,7,0,0,512,16,198950120
16188,411342300,375535,411717835,5,0,0,163328,11,8217641089
16189,411378211,402778,411780989,7,0,0,2048,16,1953610017
16190,411580840,316723,411897563,5,0,0,156672,11,337232924
16191,411584481,133853,411718334,7,0,0,1536,16,6172596492
16192,411616180,373116,411989296,5,0,0,162816,11,2049821887
16193,411685850,35865,411721715,9,0,1,3584,17,4815958132
16194,411706709,232964,411939673,4,0,0,51200,4,6561323220
16195,411741850,276804,412018654,5,0,0,96256,11,3152997378
16196,411747640,7230,411754870,9,0,1,7680,17,4319395840
16197,411756780,4850,411761630,4,0,1,5120,4,677561672
16198,411766610,2946,411769556,4,0,1,3072,4,904114403
16199,411798079,335506,412133585,4,0,0,103424,4,88866300
16200,411822559,605314,412427873,4,0,0,446976,4,2281158179
16201,411831081,596963,412428044,7,0,0,512,16,3048722232
16202,411850060,52758,411902818,5,0,1,13312,11,4995723257
16203,411860200,43924,411904124,9,0,1,2048,17,510107248
16204,411867880,50518,411918398,5,0,1,31232,11,10229412626
16205,411887970,30787,411918757,5,0,1,9728,11,2968143315
16206,411913690,6353,411920043,2,0,1,13312,11,4867619907
16207,411918670,70641,411989311,2,0,1,31232,11,3401853731
16208,411964060,487102,412451162,5,0,0,73728,11,5515831809
16209,411979070,43040,412022110,5,0,1,3584,11,1466110730
16210,411996840,497269,412494109,5,0,0,140800,11,6385027314
16211,412091510,1994,412093504,9,0,1,2048,17,10302720601
16212,412092190,41410,412133600,5,0,1,37888,11,6442476598
16213,412134659,387857,412522516,4,0,0,93184,4,7153874648
16214,412230341,198342,412428683,7,0,0,2048,16,3170312296
16215,412249690,12049,412261739,9,0,1,19968,17,3571667049
16216,412320821,352792,412673613,7,0,0,5120,16,4775593205
16217,412325899,457478,412783377,4,0,0,123392,4,6254952660
16218,412343751,304107,412647858,7,0,0,2048,16,2761196407
16219,412351840,176631,412528471,2,0,1,14848,11,9976440484
16220,412449080,91852,412540932,9,0,1,23552,17,10545374486
16221,412452190,89510,412541700,2,0,1,11776,11,6819397959
16222,412490200,208839,412699039,5,0,0,53248,11,5787128524
16223,412574561,211483,412786044,7,0,0,8704,16,10047098381
16224,412579091,130377,412709468,7,0,0,5632,16,1549771594
16225,412602400,7706,412610106,2,0,1,8192,11,10402376721
16226,412610440,1518,412611958,9,0,1,1536,17,10355064372
16227,412657280,1042,412658322,2,0,1,1024,11,2422179940
16228,412676390,2946,412679336,2,0,1,3072,11,4443721914
16229,412776129,16202,412792331,8,0,1,6656,6,7270405931
16230,412779430,13567,412792997,2,0,1,1024,11,7726801296
16231,412798529,418185,413216714,4,0,0,422912,4,5369270793
16232,412862889,566,412863455,8,0,1,512,6,6292559677
16233,412954839,23637,412978476,8,0,1,42496,6,3797007717
16234,412969911,9231,412979142,0,0,1,1024,6,8286298947
16235,413004880,13512,413018392,9,0,1,26112,17,10417876459
16236,413030889,199276,413230165,4,0,0,44032,4,3918307979
16237,413032389,11274,413043663,8,0,1,18432,6,1405874402
16238,413065330,225856,413291186,5,0,0,107008,11,3391155427
16239,413088760,152380,413241140,7,0,1,17920,16,3368240254
16240,413283700,94966,413378666,7,0,1,146944,16,3404746836
16241,413320241,214021,413534262,7,0,0,9728,16,5476807695
16242,413339899,292784,413632683,4,0,0,183296,4,3958688004
16243,413341420,38117,413379537,7,0,1,12288,16,955513487
16244,413451691,121733,413573424,7,0,0,1024,16,9736499869
16245,413464239,11791,413476030,8,0,1,19456,6,6937483403
16246,413480070,5802,413485872,6,0,1,6144,3,2919514899
16247,413495140,137574,413632714,7,0,1,191488,16,9448699328
16248,413502689,130725,413633414,4,0,0,2048,4,288820212
16249,413514700,118029,413632729,2,0,1,23552,11,8388423913
16250,413516749,115995,413632744,8,0,1,22016,6,1148850054
16251,413546999,85776,413632775,8,0,1,32256,6,2345915141
16252,413551599,84220,413635819,8,0,1,26112,6,3300679922
16253,413600760,430484,414031244,5,0,0,215552,11,8941539715
16254,413604260,32758,413637018,9,0,1,10240,17,131461198
16255,413625699,710372,414336071,4,0,0,406528,4,2862393507
16256,413627120,93350,413720470,3,0,0,3072,0,10627705969
16257,413682750,20366,413703116,6,0,1,32768,3,8632686223
16258,413703140,64483,413767623,7,0,1,105472,16,6645448599
16259,413708950,61259,413770209,9,0,1,4096,17,3534750084
16260,413736769,628973,414365742,4,0,0,97280,4,4016159978
16261,413742240,317760,414060000,5,0,0,13824,11,6652740476
16262,413826300,31266,413857566,7,0,1,50688,16,6848028604
16263,413833261,240983,414074244,7,0,0,5120,16,3987577745
16264,413841010,340081,414181091,3,0,0,5632,0,3353513519
16265,413895391,192984,414088375,7,0,0,1536,16,2258630132
16266,413937999,722295,414660294,4,0,0,196096,4,8062430107
16267,413941310,21658,413962968,9,0,1,35328,17,5220892613
16268,413965070,66189,414031259,2,0,1,17408,11,3696085
16269,413976090,403738,414379828,5,0,0,45568,11,1977638424
16270,413979090,230265,414209355,3,0,0,512,0,4074141273
16271,414028050,8101,414036151,6,0,1,5120,3,2750042906
16272,414037379,26479,414063858,8,0,1,48128,6,8434674541
16273,414044571,148340,414192911,7,0,0,4096,16,7961650485
16274,414082201,112200,414194401,7,0,0,512,16,5459394931
16275,414085540,294319,414379859,7,0,1,394752,16,8710123301
16276,414093659,286215,414379874,8,0,1,27136,6,9884047247
16277,414094760,285145,414379905,6,0,1,25088,3,9991461816
16278,414135470,244450,414379920,2,0,1,8192,11,2142353990
16279,414162140,427620,414589760,5,0,0,195072,11,9869084907
16280,414164680,215263,414379943,2,0,1,7168,11,3611682426
16281,414172280,207678,414379958,2,0,1,16384,11,4925271343
16282,414204300,161621,414365921,5,0,0,512,11,3404679232
16283,414211250,172501,414383751,6,0,1,4096,3,7734853637
16284,414263370,129005,414392375,7,0,1,18432,16,2473218465
16285,414298950,94296,414393246,1,0,1,12288,6,6946899591
16286,414309710,85482,414395192,6,0,1,3072,3,10435475676
16287,414321650,78368,414400018,6,0,1,7680,3,8853349579
16288,414326430,74664,414401094,6,0,1,13312,3,10273900615
16289,414345730,494169,414839899,5,0,0,278016,11,5061281643
16290,414387850,16790,414404640,7,0,1,5632,16,10584592239
16291,414414930,3904,414418834,9,0,1,10752,17,10527173329
16292,414494929,394923,414889852,4,0,0,84992,4,3846379750
16293,414508840,5196,414514036,9,0,1,13312,17,3102383639
16294,414548750,111559,414660309,2,0,1,25088,11,10233271088
16295,414584110,76222,414660332,9,0,1,18944,17,681342134
16296,414600440,60427,414660867,2,0,1,512,11,643662260
16297,414661900,178342,414840242,3,0,0,1024,0,1182159603
16298,414695720,11533,414707253,2,0,1,18944,11,3727094518
16299,414696970,14149,414711119,9,0,1,6144,17,7398621730
16300,414715101,220719,414935820,7,0,0,4096,16,5093190444
16301,414731060,3422,414734482,7,0,1,3584,16,5214139498
16302,414736930,226412,414963342,3,0,0,2560,0,799898927
16303,414738020,16354,414754374,7,0,1,31744,16,6259694349
16304,414773250,89926,414863176,2,0,1,37888,11,1468221937
16305,414775090,88752,414863842,7,0,1,1024,16,10360758500
16306,414800521,150103,414950624,7,0,0,1024,16,7212557707
16307,414870250,31660,414901910,9,0,1,19968,17,8190925323
16308,414889310,20664,414909974,2,0,1,27136,11,3849804518
16309,414925710,13770,414939480,6,0,1,26624,3,6363968510
16310,415057139,237361,415294500,4,0,0,30720,4,4328493042
16311,415169390,4420,415173810,7,0,1,11776,16,1852671503
16312,415209710,12995,415222705,2,0,1,25088,11,3526601508
16313,415210900,15351,415226251,9,0,1,5632,17,1363593911
16314,415223871,136293,415360164,7,0,0,6656,16,8480464242
16315,415233830,395962,415629792,5,0,0,102912,11,5750757236
16316,415248440,303346,415551786,3,0,0,9728,0,5886082075
16317,415273400,21115,415294515,7,0,1,23040,16,6975368284
16318,415282570,426158,415708728,5,0,0,165376,11,5699063191
16319,415350619,764198,416114817,4,0,0,441344,4,1297529868
16320,415361899,388403,415750302,4,0,0,114176,4,9179575880
16321,415366770,844071,416210841,5,0,0,151552,11,7206996827
16322,415382050,11533,415393583,2,0,1,18944,11,6113600191
16323,415386330,13332,415399662,7,0,1,19456,16,3230018263
16324,415400820,714324,416115144,3,0,0,1024,0,2147144153
16325,415405400,413567,415818967,5,0,0,24064,11,4294462744
16326,415445940,13858,415459798,3,0,1,23552,0,7839742288
16327,415458219,686276,416144495,4,0,0,96256,4,2624100915
16328,415460080,10757,415470837,9,0,1,17408,17,1945124390
16329,415467060,241707,415708767,3,0,1,385536,0,3513616568
16330,415488060,725456,416213516,3,0,0,8704,0,4386905778
16331,415530680,178102,415708782,9,0,1,27648,17,1087838428
16332,415552750,162165,415714915,2,0,1,22016,11,3180138040
16333,415568679,181646,415750325,8,0,1,84992,6,2496715174
16334,415569210,181138,415750348,9,0,1,30208,17,7240381407
16335,415585130,243972,415829102,5,0,0,11776,11,8840595297
16336,415592000,171520,415763520,5,0,1,59904,11,7504210252
16337,415598260,566390,416164650,5,0,0,66048,11,6179016271
16338,415629589,256938,415886527,4,0,0,84480,4,817833897
16339,415665990,98836,415764826,2,0,1,2048,11,1329255867
16340,415676790,108927,415785717,3,0,1,75264,0,518022506
16341,415690160,101458,415791618,9,0,1,19968,17,7176284732
16342,415711791,96199,415807990,0,0,1,61952,6,857692073
16343,415745300,64175,415809475,7,0,1,15360,16,2777196339
16344,415783179,26642,415809821,8,0,1,512,6,4918066149
16345,415805380,13602,415818982,1,0,1,5632,6,10495383900
16346,415894010,1042,415895052,2,0,1,1024,11,6749062814
16347,415923460,310269,416233729,3,0,0,3584,0,10412078652
16348,415943730,2470,415946200,7,0,1,2560,16,10712153281
16349,416001730,475448,416477178,3,0,1,435200,0,9921021900
16350,416019469,468129,416487598,8,0,1,33280,6,6043038851
16351,416027420,461561,416488981,7,0,1,14848,16,803234587
16352,416161611,330276,416491887,0,0,1,4608,6,10260906602
16353,416202619,291534,416494153,8,0,1,3584,6,5552435537
16354,416237550,259829,416497379,2,0,1,5120,11,7056392726
16355,416253911,249369,416503280,0,0,1,19968,6,223847640
16356,416296650,212224,416508874,7,0,1,18432,16,3012958614
16357,416316070,195390,416511460,9,0,1,4096,17,6681256858
16358,416341429,175177,416516606,8,0,1,8192,6,10562463173
16359,416358239,468683,416826922,4,0,0,35328,4,10649249982
16360,416407070,183447,416590517,5,0,0,15360,11,3377257700
16361,416415400,101872,416517272,2,0,1,1024,11,3624691760
16362,416460061,192284,416652345,7,0,0,2048,16,3731903806
16363,416492170,64137,416556307,3,0,1,108032,0,2337916031
16364,416492840,442282,416935122,5,0,0,18944,11,9762821062
16365,416519839,322622,416842461,4,0,0,25600,4,10481196200
16366,416532910,259521,416792431,3,0,0,8704,0,5856787261
16367,416559870,162632,416722502,3,0,1,263168,0,394252760
16368,416562000,162448,416724448,9,0,1,3072,17,6721992933
16369,416645090,84184,416729274,9,0,1,7680,17,10445149145
16370,416646959,82661,416729620,8,0,1,512,6,10726644448
16371,416648149,457455,417105604,4,0,0,194048,4,1791855412
16372,416735330,13083,416748413,2,0,1,22016,11,4708669792
16373,416747730,168093,416915823,3,0,0,512,0,5823648138
16374,416830930,14287,416845217,2,0,1,27648,11,6995720071
16375,416842401,267951,417110352,7,0,0,5632,16,315662006
16376,416842669,5454,416848123,8,0,1,4608,6,2034550853
16377,416866409,2470,416868879,8,0,1,2560,6,5853823223
16378,416895090,71810,416966900,3,0,0,4096,0,9405189922
16379,416901821,1042,416902863,0,0,1,1024,6,8340358640
16380,416907909,285286,417193195,4,0,0,44032,4,6243755599
16381,416909510,205240,417114750,5,0,0,14336,11,8975278056
16382,416921190,187431,417108621,3,0,1,273920,0,9660217795
16383,416925821,180890,417106711,7,0,0,3584,16,665423552
16384,416933990,244199,417178189,3,0,0,2048,0,8160741662
16385,416955310,155057,417110367,2,0,1,4096,11,4938909760
16386,416991060,123705,417114765,3,0,1,47616,0,4066801030
16387,416992900,115698,417108598,3,0,0,6144,0,9328675027
16388,417002001,177763,417179764,7,0,0,5120,16,3057979640
16389,417010370,104410,417114780,7,0,1,24064,16,10345793357
16390,417010480,183666,417194146,3,0,0,3072,0,24006520
16391,417019540,95263,417114803,7,0,1,2048,16,7912635236
16392,417026689,293975,417320664,4,0,0,162816,4,4562311375
16393,417034169,80649,417114818,8,0,1,11264,6,8275953047
16394,417082011,34246,417116257,0,0,1,1536,6,2310951453
16395,417134569,623691,417758260,4,0,0,296448,4,9302408333
16396,417158629,4937,417163566,8,0,1,12800,6,5535507802
16397,417220241,151332,417371573,7,0,0,1024,16,4410297971
16398,417223800,22950,417246750,7,0,1,37888,16,10605986199
16399,417226209,25828,417252037,8,0,1,25088,6,10573757005
16400,417267010,53669,417320679,7,0,1,12800,16,7746826959
16401,417276331,240582,417516913,7,0,0,1024,16,852587191
16402,417285780,38111,417323891,7,0,1,9216,16,3044634703
16403,417305860,155195,417461055,5,0,0,2560,11,8231235518
16404,417319201,9696,417328897,0,0,1,5632,6,3547612702
16405,417319290,339824,417659114,5,0,0,102400,11,961585844
16406,417320800,101818,417422618,3,0,0,2560,0,3136088870
16407,417328449,6278,417334727,8,0,1,6656,6,3430241161
16408,417338501,421490,417759991,7,0,0,5632,16,2962155430
16409,417357910,5802,417363712,7,0,1,6144,16,4294389466
16410,417372700,11016,417383716,7,0,1,17920,16,160037215
16411,417443290,1518,417444808,7,0,1,1536,16,4485554175
16412,417489110,5802,417494912,7,0,1,6144,16,2803290350
16413,417506980,4850,417511830,9,0,1,5120,17,10398649855
16414,417516799,263837,417780636,4,0,0,64512,4,1790030073
16415,417549661,15321,417564982,0,0,1,29696,6,2005111232
16416,417551810,209147,417760957,3,0,0,3072,0,1668457600
16417,417591201,191354,417782555,7,0,0,6144,16,10216269593
16418,417621161,37968,417659129,0,0,1,31744,6,10365895208
16419,417652899,11951,417664850,8,0,1,14336,6,2107153411
16420,417658071,101935,417760006,0,0,1,26112,6,743230364
16421,417720821,61773,417782594,0,0,1,512,6,6312800827
16422,417741121,64255,417805376,0,0,1,40960,6,3513261319
16423,417746929,59318,417806247,8,0,1,12288,6,9839389440
16424,417752461,68451,417820912,0,0,1,36352,6,5592551530
16425,417788330,531281,418319611,6,0,0,519680,3,10071400350
16426,417789711,31765,417821476,0,0,1,10752,6,8195352920
16427,417809821,27375,417837196,0,0,1,39936,6,3688028370
16428,417833939,511614,418345553,4,0,0,33792,4,1957853323
16429,417869780,202842,418072622,6,0,0,1536,3,2941611971
16430,417899130,16613,417915743,2,0,1,32256,11,1424943161
16431,417912810,695358,418608168,6,0,0,225280,3,10558292521
16432,417971519,363715,418335234,4,0,0,51200,4,4347022417
16433,417972350,472276,418444626,5,0,0,77824,11,3581708168
16434,418030210,600913,418631123,6,0,0,75264,3,5617423990
16435,418098590,15062,418113652,5,0,1,29184,11,4095445921
16436,418129060,647087,418776147,5,0,0,296448,11,8343880718
16437,418150430,535378,418685808,6,0,0,94720,3,2897003260
16438,418244240,553325,418797565,6,0,0,68096,3,9426912763
16439,418269500,539780,418809280,5,0,0,38400,11,4370124966
16440,418312741,35750,418348491,0,0,1,3072,6,9061533355
16441,418409620,445406,418855026,5,0,0,76800,11,3968315511
16442,418440000,391611,418831611,5,0,0,73216,11,3858674062
16443,418590601,186201,418776802,7,0,0,2048,16,8712284588
16444,418663029,560163,419223192,4,0,0,332800,4,8142429250
16445,418668320,453457,419121777,6,0,0,203264,3,5153342898
16446,418773380,82171,418855551,6,0,1,512,3,5134098716
16447,418851759,396610,419248369,4,0,0,59904,4,5949906754
16448,418994690,235412,419230102,5,0,0,18944,11,9440538559
16449,419006430,3898,419010328,6,0,1,4096,3,6926204391
16450,419017821,206486,419224307,7,0,0,3584,16,3556852150
16451,419021700,5326,419027026,6,0,1,5632,3,4041780797
16452,419030710,13600,419044310,6,0,1,23040,3,1194430043
16453,419076240,192540,419268780,9,0,0,1024,17,8737809934
16454,419103630,341016,419444646,5,0,0,254464,11,3952141836
16455,419163650,282609,419446259,3,0,0,3584,0,5521520836
16456,419210730,234422,419445152,9,0,0,1536,17,960046152
16457,419217370,617713,419835083,6,0,0,216576,3,7489288251
16458,419272349,496560,419768909,4,0,0,37376,4,5046412314
16459,419272530,12995,419285525,6,0,1,25088,3,7238626653
16460,419275920,17556,419293476,6,0,1,25600,3,9712391356
16461,419301200,1042,419302242,6,0,1,1024,3,2426293991
16462,419307049,370870,419677919,4,0,0,228864,4,8057459618
16463,419341681,337189,419678870,7,0,0,3072,16,7823647406
16464,419344799,591037,419935836,4,0,0,192512,4,7322015817
16465,419358840,85829,419444669,5,0,1,35840,11,8426321356
16466,419362080,490490,419852570,5,0,0,57344,11,10300995711
16467,419405799,456466,419862265,4,0,0,31744,4,2310069633
16468,419410700,566257,419976957,6,0,0,14848,3,972337864
16469,419471640,12308,419483948,5,0,1,20480,11,2091226488
16470,419515730,213071,419728801,9,0,0,3072,17,8610756335
16471,419596690,172390,419769080,3,0,0,512,0,1275694583
16472,419653849,318545,419972394,4,0,0,119296,4,7883627385
16473,419689261,246746,419936007,7,0,0,512,16,6203509231
16474,419793961,510176,420304137,7,0,0,6656,16,403696083
16475,419824540,44013,419868553,2,0,1,15360,11,5206998822
16476,419835520,34659,419870179,5,0,1,2560,11,7664347754
16477,419838900,281503,420120403,5,0,0,101376,11,6197898933
16478,419852169,344385,420196554,4,0,0,249856,4,4739272295
16479,419884560,482927,420367487,6,0,0,194048,3,8664253101
16480,419889000,89631,419978631,2,0,1,6656,11,5425664747
16481,419897450,92252,419989702,5,0,1,29696,11,7660099536
16482,419941680,49328,419991008,1,0,1,2048,6,9325350209
16483,419950090,513677,420463767,6,0,0,237056,3,2179455247
16484,419969510,24084,419993594,2,0,1,4096,11,10380880403
16485,420025930,1042,420026972,1,0,1,1024,6,9444827926
16486,420028800,1994,420030794,2,0,1,2048,11,2474823228
16487,420035400,3128,420038528,2,0,1,9216,11,3215464736
16488,420075910,292885,420368795,3,0,0,1536,0,3497770453
16489,420107800,357574,420465374,3,0,0,5120,0,4871686402
16490,420127009,356008,420483017,4,0,0,57856,4,8868538321
16491,420176630,24120,420200750,1,0,1,11264,6,928468717
16492,420195980,289602,420485582,3,0,0,1024,0,6263160783
16493,420200820,6488,420207308,1,0,1,15872,6,7280752554
16494,420206570,278677,420485247,6,0,0,7168,3,5567546823
16495,420221521,147445,420368966,7,0,0,512,16,10202334088
16496,420237730,5802,420243532,5,0,1,6144,11,2840192145
16497,420251410,327288,420578698,3,0,0,4096,0,6735136478
16498,420284230,84082,420368312,9,0,0,2560,17,5874585705
16499,420285630,10757,420296387,7,0,1,17408,16,9818129713
16500,420287260,80242,420367502,5,0,1,56320,11,7596853707
16501,420302970,64547,420367517,7,0,1,10752,16,4867870340
16502,420385089,314382,420699471,4,0,0,187392,4,4373851911
16503,420389940,93092,420483032,7,0,1,77312,16,646808624
16504,420394701,305877,420700578,7,0,0,3584,16,4225483127
16505,420417600,80601,420498201,5,0,1,25088,11,1293193151
16506,420427520,294899,420722419,5,0,0,35328,11,9342949423
16507,420430601,271084,420701685,7,0,0,3584,16,4782325022
16508,420449740,54651,420504391,2,0,1,18944,11,7919996193
16509,420450390,54987,420505377,7,0,1,1536,16,9997097279
16510,420507930,11016,420518946,1,0,1,17920,6,7365079376
16511,420526630,7230,420533860,2,0,1,7680,11,2907775677
16512,420562881,140075,420702956,7,0,0,4096,16,1571719453
16513,420625840,288983,420914823,3,0,0,3072,0,9765712648
16514,420628060,4162,420632222,5,0,1,11264,11,2856227471
16515,420678270,44164,420722434,1,0,1,26112,6,439953134
16516,420742309,292097,421034406,4,0,0,176640,4,1074489697
16517,420752890,425489,421178379,5,0,0,245760,11,8716233038
16518,420768100,267741,421035841,9,0,0,4608,17,10494677398
16519,420810650,4679,420815329,1,0,1,12288,6,2555010978
16520,420812140,13319,420825459,1,0,1,17920,6,5109911846
16521,420820790,424122,421244912,5,0,0,215040,11,8212832248
16522,420830440,10757,420841197,5,0,1,17408,11,9644343089
16523,420861010,318343,421179353,3,0,0,3072,0,9198814487
16524,420864930,14287,420879217,2,0,1,27648,11,5203273824
16525,420887320,1042,420888362,1,0,1,1024,6,1446256717
16526,420888220,5196,420893416,7,0,1,13312,16,771683426
16527,420888570,172386,421060956,3,0,0,512,0,5107843832
16528,420986289,438963,421425252,4,0,0,141824,4,4681456326
16529,420990210,60419,421050629,7,0,1,28672,16,10192614356
16530,421015230,443140,421458370,6,0,0,94208,3,2382300145
16531,421064921,197575,421262496,7,0,0,1536,16,6845846439
16532,421070010,241009,421311019,6,0,0,47616,3,3071078124
16533,421076109,305916,421382025,4,0,0,53760,4,8580033120
16534,421084890,13083,421097973,2,0,1,22016,11,4221313515
16535,421092730,7189,421099919,1,0,1,3072,6,10097371794
16536,421093450,84952,421178402,5,0,1,30208,11,9586081184
16537,421105970,145389,421251359,7,0,1,15872,16,5915265084
16538,421142390,110704,421253094,1,0,1,9728,6,7087292865
16539,421156231,269348,421425579,7,0,0,1024,16,8075563711
16540,421164561,146941,421311502,7,0,0,1536,16,6759159344
16541,421180610,245920,421426530,3,0,0,3072,0,3842565256
16542,421192731,100689,421293420,0,0,1,65536,6,8282568943
16543,421200700,110825,421311525,5,0,1,34304,11,7698094555
16544,421207940,127956,421335896,3,0,0,2048,0,5277091822
16545,421214070,350831,421564901,5,0,0,28160,11,3013007628
16546,421261729,49811,421311540,8,0,1,5632,6,9182432282
16547,421274020,37535,421311555,1,0,1,2560,6,6518480747
16548,421290240,29499,421319739,5,0,1,33792,11,4311041177
16549,421294230,31103,421325333,1,0,1,18432,6,126587869
16550,421325519,320509,421646028,4,0,0,185344,4,7472426825
16551,421329680,1042,421330722,1,0,1,1024,6,5958069857
16552,421452980,5948,421458928,1,0,1,512,6,7797202356
16553,421469670,4162,421473832,5,0,1,11264,11,10022498629
16554,421470970,117375,421588345,3,0,0,4096,0,3780158875
16555,421487610,177144,421664754,5,0,0,4608,11,7487313585
16556,421520800,3422,421524222,1,0,1,3584,6,6421457743
16557,421547420,99154,421646574,3,0,0,512,0,7747260884
16558,421551430,94925,421646355,5,0,0,1024,11,9465385950
16559,421556090,266006,421822096,6,0,0,153600,3,6956381549
16560,421597420,60412,421657832,2,0,1,18432,11,4727219123
16561,421601830,56463,421658293,2,0,1,10240,11,7410235679
16562,421607240,71004,421678244,1,0,1,37888,6,9298378168
16563,421607650,75881,421683531,5,0,1,16896,11,7244254385
16564,421615540,79128,421694668,5,0,1,36864,11,6537476448
16565,421634660,64834,421699494,1,0,1,7680,6,8517520598
16566,421640970,61110,421702080,6,0,1,4096,3,9958353019
16567,421704889,3904,421708793,8,0,1,10752,6,8781896564
16568,421711350,3645,421714995,2,0,1,10240,11,5299340013
16569,421717659,253900,421971559,4,0,0,75264,4,6703852415
16570,421728000,5802,421733802,2,0,1,6144,11,9466959875
16571,421748149,200016,421948165,4,0,0,4608,4,2657992144
16572,421772400,49711,421822111,1,0,1,10240,6,7625049046
16573,421776950,48540,421825490,1,0,1,9728,6,4236404266
16574,421923660,6278,421929938,2,0,1,6656,11,7630649478
16575,421937239,4850,421942089,8,0,1,5120,6,4046013486
16576,421975750,1042,421976792,5,0,1,1024,11,4999013222
16577,421998201,114480,422112681,7,0,0,65536,16,674480159
16578,422024131,212834,422236965,7,0,0,88064,16,9463046794
16579,422025379,157317,422182696,4,0,0,40960,4,3246979159
16580,422032020,43904,422075924,9,0,0,512,17,6307683073
16581,422045240,2470,422047710,2,0,1,2560,11,782633577
16582,422104399,39040,422143439,8,0,1,49664,6,2039039113
16583,422110460,38983,422149443,5,0,1,20480,11,1338282431
16584,422173889,25412,422199301,8,0,1,32256,6,3039896545
16585,422208310,28670,422236980,1,0,1,27648,6,6432467650
16586,422229071,301314,422530385,7,0,0,248832,16,3744398117
16587,422230300,22018,422252318,1,0,1,29696,6,9041929838
16588,422253579,3904,422257483,8,0,1,10752,6,5922531837
16589,422284660,3422,422288082,9,0,1,3584,17,5714925655
16590,422294649,787130,423081779,4,0,0,8192,4,3289690405
16591,422311260,737363,423048623,5,0,0,550400,11,7499451163
16592,422348280,280667,422628947,3,0,0,1536,0,2123002249
16593,422350940,529937,422880877,6,0,0,151552,3,4954478417
16594,422353330,3904,422357234,9,0,1,10752,17,2339953100
16595,422386870,728004,423114874,5,0,0,108544,11,4990569421
16596,422390799,20624,422411423,8,0,1,33280,6,3378680698
16597,422481429,54291,422535720,8,0,1,5632,6,1275665179
16598,422519540,18766,422538306,1,0,1,4096,6,3623734501
16599,422545760,533508,423079268,5,0,0,14848,11,157032827
16600,422552681,521705,423074386,7,0,0,84480,16,302877791
16601,422577870,205648,422783518,9,0,0,512,17,2387356900
16602,422604210,511545,423115755,9,0,0,512,17,132475381
16603,422605780,468949,423074729,9,0,0,1024,17,7210380859
16604,422673591,450783,423124374,7,0,0,28160,16,2308538054
16605,422686610,3898,422690508,1,0,1,4096,6,269621100
16606,422698440,23983,422722423,1,0,1,39936,6,498242789
16607,422744780,10757,422755537,1,0,1,17408,6,4296159578
16608,422748150,35486,422783636,1,0,1,58368,6,7616623052
16609,422776080,13765,422789845,5,0,1,21504,11,8870816914
16610,422787531,16613,422804144,0,0,1,32256,6,859320394
16611,422822609,58299,422880908,8,0,1,36864,6,9230701369
16612,422835790,279287,423115077,3,0,0,512,0,3165081857
16613,422844120,271464,423115584,3,0,0,1536,0,5083674738
16614,422863040,261397,423124437,2,0,1,12288,11,8374175491
16615,422864730,578553,423443283,6,0,0,90624,3,4600602770
16616,422866740,268487,423135227,9,0,0,5632,17,2312975922
16617,422902650,512390,423415040,9,0,0,1536,17,1021850465
16618,422910160,218877,423129037,2,0,1,12288,11,4015401304
16619,422915060,217204,423132264,2,0,1,11264,11,4466998121
16620,422961860,175476,423137336,5,0,1,6144,11,3423140418
16621,422969421,687461,423656882,7,0,0,66560,16,6867772139
16622,422976800,635250,423612050,5,0,0,243712,11,9129463658
16623,422977289,878253,423855542,4,0,0,206336,4,1478751609
16624,423005619,682337,423687956,4,0,0,26112,4,1266703218
16625,423044080,104130,423148210,2,0,1,28672,11,7257763363
16626,423074920,113951,423188871,5,0,1,80896,11,10425628374
16627,423101851,578134,423679985,7,0,0,75776,16,7149063286
16628,423124129,763985,423888114,4,0,0,52736,4,3333615021
16629,423127271,64826,423192097,0,0,1,5120,6,8092481067
16630,423141320,54963,423196283,5,0,1,6656,11,4883579887
16631,423144410,58389,423202799,2,0,1,31232,11,8599606785
16632,423172080,31705,423203785,5,0,1,1536,11,9265641433
16633,423204180,945402,424149582,9,0,0,1024,17,1818768186
16634,423212501,580111,423792612,7,0,0,199168,16,3401463986
16635,423214389,398167,423612556,4,0,0,1536,4,2904657922
16636,423226200,6754,423232954,2,0,1,7168,11,5998915406
16637,423242670,613583,423856253,9,0,0,2048,17,5871540951
16638,423267631,881141,424148772,7,0,0,503808,16,2939118345
16639,423269831,937088,424206919,7,0,0,128000,16,5352443482
16640,423290040,572500,423862540,5,0,0,20480,11,2148345013
16641,423308560,4850,423313410,1,0,1,5120,6,10367285421
16642,423319221,5326,423324547,0,0,1,5632,6,9475106769
16643,423324830,12825,423337655,2,0,1,21504,11,8066115167
16644,423336160,2481,423338641,2,0,1,1536,11,5490119377
16645,423336190,831714,424167904,9,0,0,512,17,919900924
16646,423368789,1518,423370307,8,0,1,1536,6,3313077329
16647,423381020,3128,423384148,5,0,1,9216,11,1297300107
16648,423382200,321143,423703343,3,0,0,1024,0,7704276392
16649,423383390,589563,423972953,9,0,0,2560,17,10252773625
16650,423404600,566,423405166,5,0,1,512,11,7206672008
16651,423447640,761518,424209158,9,0,0,7168,17,5174571675
16652,423466330,682925,424149255,9,0,0,1536,17,1676042486
16653,423487260,31007,423518267,1,0,1,50176,6,1993795694
16654,423494391,673302,424167693,7,0,0,59392,16,3815005753
16655,423495421,33368,423528789,0,0,1,33792,6,797308786
16656,423531220,836875,424368095,5,0,0,358400,11,7780245189
16657,423536200,75865,423612065,2,0,1,2560,11,365707459
16658,423565340,661610,424226950,9,0,0,2048,17,1935923277
16659,423634250,1518,423635768,1,0,1,1536,6,6902610912
16660,423705570,861815,424567385,5,0,0,113664,11,2652700372
16661,423712450,658632,424371082,3,0,0,9728,0,6814922903
16662,423731420,61223,423792643,1,0,1,9216,6,8350168923
16663,423733799,652247,424386046,4,0,0,12800,4,850524203
16664,423734021,128582,423862603,0,0,1,2560,6,6370548123
16665,423749629,713245,424462874,4,0,0,198656,4,4711727654
16666,423750440,112194,423862634,5,0,1,10752,11,10179650529
16667,423764740,99277,423864017,2,0,1,1536,11,5008020216
16668,423770501,124765,423895266,0,0,1,52736,6,10412727537
16669,423779921,126994,423906915,0,0,1,39424,6,7923954856
16670,423788120,119768,423907888,1,0,1,12800,6,4140162076
16671,423788710,124363,423913073,5,0,1,16384,11,6175850458
16672,423792039,122020,423914059,8,0,1,1536,6,8440288043
16673,423792690,1209284,425001974,5,0,0,143360,11,1133505411
16674,423804920,405189,424210109,9,0,0,3072,17,4840542317
16675,423817139,556766,424373905,4,0,0,9216,4,10324155249
16676,423822830,95415,423918245,2,0,1,6656,11,4392151948
16677,423828061,788522,424616583,7,0,0,136192,16,2697647293
16678,423856251,1371776,425228027,7,0,0,164352,16,6830272291
16679,423907630,12881,423920511,2,0,1,3584,11,10314485458
16680,423920760,3898,423924658,2,0,1,4096,11,10600389418
16681,423940160,7230,423947390,5,0,1,7680,11,4323408460
16682,423941380,9556,423950936,1,0,1,5632,6,3838237605
16683,423960290,14545,423974835,5,0,1,28160,11,9507155067
16684,424046800,163380,424210180,1,0,1,512,6,753735838
16685,424055240,585301,424640541,5,0,0,67072,11,7790437568
16686,424088800,1187941,425276741,5,0,0,96256,11,5989701151
16687,424099749,520341,424620090,4,0,0,7680,4,948494329
16688,424102630,361888,424464518,3,0,0,5120,0,6901204625
16689,424131850,83022,424214872,1,0,1,12288,6,588236082
16690,424135411,951576,425086987,7,0,0,258048,16,1850180747
16691,424169320,77433,424246753,1,0,1,53760,6,1576565247
16692,424174331,1274323,425448654,7,0,0,326144,16,6118994086
16693,424185450,62481,424247931,2,0,1,13824,11,3752491134
16694,424187230,60855,424248085,1,0,1,8704,6,7261723819
16695,424188060,61203,424249263,2,0,1,13824,11,8254318925
16696,424191731,456937,424648668,7,0,0,26624,16,9957047062
16697,424194160,423560,424617720,9,0,0,3584,17,5536107552
16698,424232260,17259,424249519,4,0,1,9216,4,10622243426
16699,424233560,23297,424256857,5,0,1,20992,11,10461466459
16700,424259640,847546,425107186,9,0,0,2560,17,4973526731
16701,424294980,82907,424377887,5,0,1,4096,11,6196325686
16702,424331539,67852,424399391,8,0,1,43520,6,3736882795
16703,424334080,128809,424462889,2,0,1,44032,11,382788654
16704,424346710,116194,424462904,4,0,1,4608,4,8474933028
16705,424361740,101195,424462935,1,0,1,41984,6,9380961241
16706,424377910,98900,424476810,1,0,1,20480,6,8011809978
16707,424404210,168414,424572624,3,0,1,164864,0,3476082194
16708,424427540,147350,424574890,4,0,1,3584,4,5459425388
16709,424440039,176559,424616598,8,0,1,6656,6,4077643239
16710,424466440,150173,424616613,2,0,1,11264,11,3035347348
16711,424473809,143926,424617735,8,0,1,17920,6,6965115780
16712,424488020,251147,424739167,3,0,1,334336,0,9343355467
16713,424489010,254663,424743673,5,0,1,7168,11,49605539
16714,424494520,252699,424747219,2,0,1,5632,11,440587546
16715,424507139,599237,425106376,4,0,0,63488,4,1101108463
16716,424533260,215905,424749165,2,0,1,3072,11,1321627858
16717,424539880,462109,425001989,2,0,1,506368,11,7199210122
16718,424568210,433794,425002004,7,0,1,5120,16,7169272687
16719,424570440,431579,425002019,5,0,1,13824,11,427577177
16720,424573349,428685,425002034,8,0,1,25088,6,2361139519
16721,424575040,753052,425328092,9,0,0,4096,17,8590688040
16722,424576600,651754,425228354,9,0,0,1024,17,7215189446
16723,424639980,447022,425087002,2,0,1,143872,11,9081571806
16724,424643330,443687,425087017,7,0,1,6656,16,929030461
16725,424646070,460321,425106391,2,0,1,134656,11,8030472189
16726,424681599,425602,425107201,8,0,1,115712,6,7911478747
16727,424713110,394106,425107216,5,0,1,512,11,10258406906
16728,424720080,387151,425107231,7,0,1,11264,16,8529257206
16729,424731930,441892,425173822,5,0,0,117248,11,4844214350
16730,424781361,672300,425453661,7,0,0,16384,16,79878610
16731,424781651,800450,425582101,7,0,0,159744,16,6140668092
16732,424796050,311196,425107246,9,0,1,1024,17,8344980556
16733,424798000,655684,425453684,3,0,1,602112,0,2624189711
16734,424831859,494970,425326829,4,0,0,99328,4,5035538172
16735,424881730,578427,425460157,7,0,1,65024,16,2855617286
16736,424917390,990719,425908109,5,0,0,214528,11,9679033656
16737,424920870,661246,425582116,2,0,1,130048,11,8895396821
16738,424923429,662154,425585583,8,0,1,14848,6,755192167
16739,424927340,532802,425460142,3,0,0,3584,0,218382091
16740,424928240,706757,425634997,5,0,1,1024,11,572860519
16741,424938410,702488,425640898,1,0,1,19968,6,1531233391
16742,424939140,1002643,425941783,2,0,1,66560,11,6179566298
16743,424980170,982815,425962985,2,0,1,19968,11,8892310770
16744,424991180,1018024,426009204,7,0,1,57344,16,7649318369
16745,424992069,1023487,426015556,8,0,1,8704,6,2604064407
16746,425011580,1020098,426031678,9,0,1,15360,17,10497642721
16747,425024280,1010624,426034904,9,0,1,5120,17,8543413557
16748,425034280,1126504,426160784,1,0,1,10752,6,1658817491
16749,425048370,1112429,426160799,7,0,1,8704,16,392623604
16750,425055070,1105776,426160846,5,0,1,10240,11,9827855179
16751,425060771,1327980,426388751,7,0,0,142336,16,10022041342
16752,425073099,1087762,426160861,8,0,1,6656,6,7122313505
16753,425086250,1083365,426169615,4,0,1,29184,4,3132314782
16754,425086920,755810,425842730,5,0,0,145920,11,8442587115
16755,425104831,1073012,426177843,0,0,1,17408,6,550633399
16756,425105400,1073416,426178816,1,0,1,12800,6,8474441213
16757,425115480,1223547,426339027,7,0,1,71168,16,821456981
16758,425136480,317539,425454019,3,0,0,1024,0,9564676537
16759,425149189,1250380,426399569,8,0,1,512,6,3734100416
16760,425160300,1239308,426399608,4,0,1,26112,4,4862885028
16761,425179090,729190,425908280,5,0,0,512,11,1355836688
16762,425203850,1763013,426966863,7,0,1,124416,16,3821063287
16763,425205059,1820409,427025468,8,0,1,25600,6,6486049237
16764,425219100,690770,425909870,9,0,0,3072,17,6777152885
16765,425234960,673959,425908919,3,0,0,2048,0,4412585961
16766,425240060,2087848,427327908,7,0,1,98304,16,9368644380
16767,425256389,2071534,427327923,8,0,1,12800,6,7178764272
16768,425280320,214002,425494322,5,0,0,2048,11,899509446
16769,425294889,1364564,426659453,4,0,0,475136,4,6996341777
16770,425300180,898211,426198391,9,0,0,3584,17,6419251929
16771,425319239,433371,425752610,4,0,0,5632,4,3495924168
16772,425320659,840110,426160769,4,0,0,272384,4,8022583252
16773,425336889,999908,426336797,4,0,0,198656,4,10212990481
16774,425401890,2122006,427523896,9,0,1,26624,17,8644478966
16775,425436430,2767993,428204423,3,0,1,205824,0,7615711023
16776,425444930,2761489,428206419,9,0,1,5632,17,6593517056
16777,425450130,710910,426161040,3,0,0,512,0,5038495775
16778,425455460,1016605,426472065,9,0,0,3072,17,7457749327
16779,425457790,2769462,428227252,9,0,1,14336,17,1314579190
16780,425464940,707753,426172693,9,0,0,1024,17,5568052202
16781,425467990,2760030,428228020,1,0,1,11776,6,2245463168
16782,425506880,923079,426429959,5,0,0,12288,11,4524191735
16783,425517551,908641,426426192,7,0,0,67584,16,6303352477
16784,425561630,778207,426339837,9,0,0,512,17,6194800788
16785,425602640,3544396,429147036,7,0,1,591360,16,3843774917
16786,425624080,3605417,429229497,3,0,1,193536,0,1926507729
16787,425649281,750273,426399554,7,0,0,35328,16,2396685851
16788,425654140,3643695,429297835,7,0,1,102400,16,8276361913
16789,425655250,3668324,429323574,1,0,1,25600,6,5778913435
16790,425678310,3645828,429324138,5,0,1,10752,11,9420921808
16791,425679690,3644807,429324497,5,0,1,9728,11,9128302665
16792,425682670,3648308,429330978,5,0,1,7680,11,718647000
16793,425714950,3727718,429442668,3,0,1,84480,0,5905355196
16794,425732150,3710533,429442683,5,0,1,4608,11,2934691386
16795,425793500,3649369,429442869,3,0,1,87552,0,2616758606
16796,425805801,1160855,426966656,7,0,0,155136,16,2721192549
16797,425812600,3630284,429442884,5,0,1,13824,11,5330331786
16798,425815329,3652586,429467915,8,0,1,22528,6,9134183808
16799,425860430,3641435,429501865,3,0,1,90624,0,6762773308
16800,425879610,459386,426338996,3,0,0,7168,0,1657985645
16801,425886470,779169,426665639,3,0,0,6656,0,7888273549
16802,425896179,767345,426663524,4,0,0,13312,4,8765813842
16803,425906180,3603938,429510118,4,0,1,10752,4,10622725680
16804,425928560,3722729,429651289,3,0,1,226816,0,2573083380
16805,425968259,951114,426919373,4,0,0,302592,4,2251698096
16806,425989350,3661954,429651304,4,0,1,8192,4,6339080308
16807,426006890,3644429,429651319,1,0,1,11776,6,6575917213
16808,426023680,3627654,429651334,4,0,1,3072,4,3780569651
16809,426028471,3625996,429654467,0,0,1,21504,6,1113633172
16810,426034610,3638059,429672669,7,0,1,28160,16,1759238845
16811,426051661,1758185,427809846,7,0,0,547328,16,6074412172
16812,426063430,3612650,429676080,7,0,1,19968,16,8307548373
16813,426086090,1039413,427125503,9,0,0,27136,17,302350212
16814,426092461,1809283,427901744,7,0,0,93184,16,6219862152
16815,426097201,1285153,427382354,7,0,0,178176,16,9049153893
16816,426098550,1339762,427438312,9,0,0,182784,17,10312009791
16817,426120340,3617585,429737925,3,0,1,69632,0,2190811990
16818,426147849,918755,427066604,4,0,0,33280,4,6553044207
16819,426165690,3605269,429770959,1,0,1,1536,6,10717503481
16820,426199730,139936,426339666,5,0,0,2048,11,5045131905
16821,426204050,3568535,429772585,4,0,1,2560,4,30766296
16822,426211920,954773,427166693,9,0,0,25088,17,169011611
16823,426218869,789866,427008735,4,0,0,16896,4,6005724351
16824,426219460,3559614,429779074,4,0,1,17920,4,1097011219
16825,426232311,966746,427199057,7,0,0,60416,16,2117308665
16826,426246649,1081244,427327893,4,0,0,418816,4,10204328999
16827,426290120,3491310,429781430,1,0,1,27648,6,1400809447
16828,426295370,1282941,427578311,9,0,0,107008,17,6476972700
16829,426349850,3455377,429805227,7,0,1,2048,16,8060346362
16830,426350100,3455281,429805381,9,0,1,8704,17,3260796579
16831,426360741,1688116,428048857,7,0,0,125952,16,1907065148
16832,426392770,807394,427200164,5,0,0,3584,11,9877899278
16833,426403240,1408080,427811320,3,0,0,512,0,3042936579
16834,426418910,3394008,429812918,9,0,1,1024,17,2639207343
16835,426424630,727675,427152305,5,0,0,3072,11,2156536213
16836,426439681,1698968,428138649,7,0,0,111104,16,4471894915
16837,426453210,3359964,429813174,1,0,1,9216,6,3143583883
16838,426453530,3429122,429882652,4,0,1,38912,4,121031463
16839,426472301,3410366,429882667,0,0,1,3072,6,5156129158
16840,426491020,3540627,430031647,2,0,1,320000,11,8262179929
16841,426509130,1301979,427811109,3,0,0,4096,0,3952586996
16842,426515730,3528575,430044305,7,0,1,22528,16,2393612131
16843,426518150,3575997,430094147,9,0,1,54784,17,6862818994
16844,426536510,3585875,430122385,7,0,1,87040,16,4072240647
16845,426544880,3584535,430129415,9,0,1,1024,17,4302075921
16846,426569920,3560775,430130695,9,0,1,14336,17,9417317753
16847,426583449,3578640,430162089,8,0,1,4096,6,5643056806
16848,426623620,3693118,430316738,3,0,1,275968,0,4859631453
16849,426635270,3823024,430458294,4,0,1,279552,4,6637796988
16850,426638930,3820030,430458960,7,0,1,1024,16,7180629398
16851,426652981,3813558,430466539,0,0,1,30720,6,9209936069
16852,426653551,3819402,430472953,0,0,1,23552,6,6635808398
16853,426659250,1351216,428010466,5,0,0,5632,11,7266835668
16854,426659601,3841054,430500655,0,0,1,24064,6,8421353504
16855,426669611,3833310,430502921,0,0,1,3584,6,6667120964
16856,426674931,2217658,428892589,7,0,0,612864,16,10328837838
16857,426691691,3845418,430537109,0,0,1,45056,6,4061235792
16858,426696460,939984,427636444,3,0,0,1024,0,2184112486
16859,426720250,3817320,430537570,1,0,1,10240,6,2365762433
16860,426730320,3822395,430552715,7,0,1,4608,16,8118523389
16861,426737190,645415,427382605,5,0,0,512,11,10172005834
16862,426764600,3788461,430553061,1,0,1,512,6,598026178
16863,426794810,644664,427439474,8,0,0,512,6,2052437058
16864,426801000,3753546,430554546,7,0,1,15360,16,2231810973
16865,426805600,3754335,430559935,1,0,1,17408,6,49502331
16866,426820420,618843,427439263,8,0,0,3072,6,9593782187
16867,426825670,3739369,430565039,7,0,1,5632,16,8765582247
16868,426826580,3742005,430568585,3,0,1,5632,0,4032412676
16869,426835230,743268,427578498,5,0,0,512,11,5765360149
16870,426855450,3748044,430603494,3,0,1,78848,0,9407850043
16871,426855749,1110863,427966612,4,0,0,3584,4,695646569
16872,426874081,2197355,429071436,7,0,0,328192,16,2322951411
16873,426878160,3725719,430603879,3,0,1,19456,0,9871684762
16874,426887700,3717165,430604865,3,0,1,1536,0,8844397642
16875,426897660,1605729,428503389,9,0,0,164864,17,3575638491
16876,426916330,896261,427812591,8,0,0,4096,6,635624023
16877,426921470,3725534,430647004,3,0,1,101376,0,7551547731
16878,426931740,3718490,430650230,7,0,1,5120,16,10680073046
16879,426946600,3706255,430652855,4,0,1,13312,4,6467800458
16880,426973710,1345573,428319283,5,0,0,512,11,7642369194
16881,426985770,520613,427506383,9,0,0,32256,17,836532062
16882,427006910,3719065,430725975,3,0,1,130048,0,4626371613
16883,427031089,3700705,430731794,8,0,1,11776,6,7020381084
16884,427057130,4024937,431082067,3,0,1,511488,0,9130258030
16885,427066110,4017545,431083655,9,0,1,15872,17,8010681122
16886,427076080,2073490,429149570,5,0,0,4096,11,8351399294
16887,427077141,4036951,431114092,0,0,1,8192,6,7930529019
16888,427085261,2061752,429147013,7,0,0,167424,16,8909633805
16889,427091461,992214,428083675,7,0,0,56320,16,7476496000
16890,427094360,4023918,431118278,1,0,1,6656,6,1045284399
16891,427104790,2091930,429196720,5,0,0,6144,11,9393807887
16892,427176120,3942504,431118624,9,0,1,512,17,5782291991
16893,427182491,3937439,431119930,0,0,1,2048,6,8767842197
16894,427183421,825314,428008735,7,0,0,84992,16,10183731110
16895,427200080,964265,428164345,3,0,0,15360,0,6841642412
16896,427215321,2082499,429297820,7,0,0,116224,16,906124702
16897,427222260,3901536,431123796,9,0,1,6144,17,5396954331
16898,427225041,1715426,428940467,7,0,0,67072,16,8562013707
16899,427226889,1967936,429194825,4,0,0,148480,4,8558254424
16900,427251740,814760,428066500,9,0,0,57856,17,6532525895
16901,427261280,3872578,431133858,1,0,1,28672,6,9469021359
16902,427311830,3822694,431134524,9,0,1,1024,17,2778251534
16903,427321121,3819983,431141104,0,0,1,19968,6,982338268
16904,427328820,3842112,431170932,3,0,1,82432,0,2720092620
16905,427332431,489075,427821506,7,0,0,29184,16,5736198322
16906,427360500,3815578,431176078,1,0,1,8192,6,991540674
16907,427372720,3813881,431186601,9,0,1,34816,17,8039359303
16908,427438080,766328,428204408,9,0,0,97792,17,7134170942
16909,427440670,515418,427956088,5,0,0,512,11,3897446373
16910,427457300,3730377,431187677,9,0,1,13312,17,7140737017
16911,427507320,3686307,431193627,9,0,1,512,17,2125400803
16912,427522690,3683397,431206087,1,0,1,24576,6,6677905436
16913,427529431,3684395,431213826,0,0,1,24064,6,9225522151
16914,427533050,3681237,431214287,3,0,1,10240,0,1954237411
16915,427535921,3690689,431226610,0,0,1,4608,6,9480921324
16916,427536790,3690806,431227596,9,0,1,1536,17,5307772309
16917,427554500,1517195,429071695,3,0,0,512,0,536418748
16918,427558320,835688,428394008,9,0,0,128000,17,7145704197
16919,427632420,3701943,431334363,4,0,1,211968,4,8880460006
16920,427641770,3786435,431428205,4,0,1,250368,4,3136844950
16921,427669960,3779988,431449948,3,0,1,34304,0,10096526299
16922,427706199,539308,428245507,4,0,0,53760,4,3157486765
16923,427731640,251184,427982824,3,0,0,2560,0,8985118966
16924,427734890,3912378,431647268,4,0,1,417792,4,2018892920
16925,427785650,3867328,431652978,1,0,1,18944,6,5999662605
16926,427801271,1641382,429442653,7,0,0,100864,16,7055047851
16927,427812701,3959493,431772194,0,0,1,67072,6,593380645
16928,427816431,728625,428545056,7,0,0,136704,16,4874448358
16929,427833950,714167,428548117,5,0,0,1024,11,2111595898
16930,427837440,4152846,431990286,4,0,1,167424,4,2950840488
16931,427923291,4067018,431990309,0,0,1,5632,6,1460258289
16932,427931800,4058524,431990324,1,0,1,2048,6,5426793153
16933,427938791,1637293,429576084,7,0,0,214016,16,9679963520
16934,427941860,4048479,431990339,9,0,1,24064,17,733209431
16935,427988860,4956989,432945849,4,0,1,312320,4,638738225
16936,428013990,4944999,432958989,1,0,1,6144,6,3430844354
16937,428056640,514859,428571499,5,0,0,1024,11,1863082610
16938,428110201,4849761,432959962,0,0,1,12800,6,8690893139
16939,428146160,4836230,432982390,9,0,1,4096,17,393502652
16940,428152580,399635,428552215,8,0,0,7680,6,1878052653
16941,428158850,4888467,433047317,4,0,1,78848,4,4766491300
16942,428160460,809046,428969506,9,0,0,95232,17,4344555967
16943,428170680,5181193,433351873,3,0,1,345600,0,7615277945
16944,428195831,724185,428920016,7,0,0,89600,16,1307952279
16945,428218030,5138210,433356240,9,0,1,12800,17,5470946047
16946,428237650,350217,428587867,5,0,0,2048,11,2588495847
16947,428248331,5117298,433365629,0,0,1,8192,6,6086649899
16948,428253380,5416519,433669899,4,0,1,151552,4,2582808112
16949,428271120,5425188,433696308,9,0,1,41984,17,5971258689
16950,428281170,5441403,433722573,3,0,1,76800,0,10257927424
16951,428367970,603423,428971393,5,0,0,6144,11,7606927135
16952,428381270,5842379,434223649,4,0,1,711168,4,131166558
16953,428394760,5868127,434262887,4,0,1,44544,4,10114230007
16954,428399150,1252052,429651202,9,0,0,84480,17,1008600597
16955,428441540,654390,429095930,9,0,0,79360,17,6431914755
16956,428443510,5875514,434319024,3,0,1,99328,0,2480287855
16957,428470640,5900210,434370850,3,0,1,135680,0,3185355999
16958,428515790,632517,429148307,5,0,0,4096,11,3834035234
16959,428525581,5851142,434376723,0,0,1,5632,6,8616223977
16960,428553680,704051,429257731,5,0,0,2048,11,4076014508
16961,428565000,663136,429228136,9,0,0,96256,17,4146772629
16962,428612940,5776508,434389448,1,0,1,37888,6,6976044089
16963,428624110,5910835,434534945,4,0,1,207872,4,514318961
16964,428645890,552903,429198793,8,0,0,2560,6,9288899335
16965,428647210,5954282,434601492,3,0,1,115712,0,3549603282
16966,428662811,5939667,434602478,0,0,1,1536,6,8611645146
16967,428677250,5983639,434660889,4,0,1,115712,4,4336265108
16968,428686530,542245,429228775,3,0,0,2048,0,4224899714
16969,428709520,487839,429197359,5,0,0,2048,11,303054904
16970,428778240,6071584,434849824,4,0,1,391680,4,5124706733
16971,428820930,6035540,434856470,9,0,1,11776,17,8591881898
16972,428832900,6033065,434865965,4,0,1,22016,4,3972592959
16973,428835540,408615,429244155,5,0,0,512,11,2226603846
16974,428854660,6011651,434866311,3,0,1,512,0,7420566516
16975,428870850,6025124,434895974,4,0,1,28672,4,1857207254
16976,428885200,312798,429197998,3,0,0,2048,0,4870490799
16977,428890690,552164,429442854,8,0,0,512,6,9964196973
16978,428912770,570622,429483392,3,0,0,3584,0,2776044246
16979,428928850,647561,429576411,5,0,0,1024,11,3500747803
16980,428929310,5984098,434913408,9,0,1,22528,17,5464779055
16981,428934200,738454,429672654,9,0,0,15360,17,925917911
16982,428944720,6197294,435142014,4,0,1,193536,4,5869465466
16983,428957980,917443,429875423,9,0,0,155136,17,10404240670
16984,428966240,656356,429622596,5,0,0,1024,11,10550986816
16985,428990770,743487,429734257,5,0,0,1536,11,7783142276
16986,428992740,6149297,435142037,9,0,1,20480,17,7895172540
16987,429025980,6116072,435142052,6,0,1,6144,3,91498772
16988,429035220,6566358,435601578,4,0,1,513536,4,6735771589
16989,429066500,6535539,435602039,9,0,1,10240,17,9266352791
16990,429109310,655551,429764861,3,0,0,5120,0,5645024811
16991,429141240,6582722,435723962,2,0,1,157184,11,9279692898
16992,429190920,6593992,435784912,3,0,1,36352,0,9736307648
16993,429201900,609827,429811727,8,0,0,2048,6,9768915806
16994,429273990,6615293,435889283,3,0,1,231936,0,2826340249
16995,429276990,6659995,435936985,9,0,1,20992,17,6351246223
16996,429335290,612475,429947765,3,0,0,512,0,8536515254
16997,429358000,524637,429882637,5,0,0,2048,11,568291238
16998,429358850,523140,429881990,9,0,0,21504,17,4238136192
16999,429381260,6579711,435960971,6,0,1,1536,3,8176043097
17000,429418510,577220,429995730,5,0,0,2048,11,8683985133
17001,429422020,6636828,436058848,3,0,1,194048,0,7324661341
17002,429424271,6649182,436073453,0,0,1,25088,6,6471540315
17003,429442211,719863,430162074,7,0,0,80384,16,1365374532
17004,429449230,6633973,436083203,3,0,1,30208,0,10260070035
17005,429478051,602261,430080312,7,0,0,45056,16,10669162368
17006,429489290,6594899,436084189,6,0,1,1536,3,5761832622
17007,429496051,6589124,436085175,0,0,1,1536,6,6203724702
17008,429542999,6555751,436098750,8,0,1,12800,6,3015097140
17009,429543880,6555741,436099621,6,0,1,12288,3,3903933528
17010,429586540,6656705,436243245,3,0,1,131072,0,4206856802
17011,429607920,6644929,436252849,9,0,1,15872,17,7099049482
17012,429609070,6677144,436286214,9,0,1,10240,17,1502524572
17013,429630940,397633,430028573,3,0,0,4096,0,9297569674
17014,429639680,6649453,436289133,6,0,1,15872,3,3884657638
17015,429667550,454656,430122206,5,0,0,3072,11,3787238392
17016,429669210,6692233,436361443,3,0,1,106496,0,7780443896
17017,429693550,6667908,436361458,4,0,1,50176,4,8916720260
17018,429704650,6769623,436474273,3,0,1,217600,0,6939683011
17019,429722970,6752481,436475451,6,0,1,13824,3,7945799481
17020,429787140,385037,430172177,5,0,0,2048,11,6396586238
17021,429789670,6692361,436482031,9,0,1,19968,17,3515651611
17022,429791790,6709831,436501621,6,0,1,30720,3,5827591080
17023,429805590,6701177,436506767,9,0,1,8192,17,6669066695
17024,429831829,6677844,436509673,8,0,1,4608,6,2959874695
17025,429854159,6665049,436519208,8,0,1,20992,6,6909394475
17026,429866530,350728,430217258,9,0,0,8704,17,4704168824
17027,429919160,373876,430293036,8,0,0,512,6,3959624977
17028,429927720,275939,430203659,8,0,0,3584,6,9714118490
17029,429961379,6561055,436522434,8,0,1,5120,6,9293798073
17030,429985881,6537219,436523100,0,0,1,11264,6,1910585155
17031,430044390,367746,430412136,8,0,0,512,6,2224037740
17032,430046160,256924,430303084,5,0,0,512,11,5915581521
17033,430077680,158396,430236076,8,0,0,1024,6,1694007783
17034,430090729,6462723,436553452,8,0,1,21504,6,7101589177
17035,430110241,6443234,436553475,0,0,1,20992,6,2500624344
17036,430165130,6388368,436553498,9,0,1,26624,17,2246060404
17037,430176240,6401222,436577462,9,0,1,30720,17,10442264805
17038,430178970,437745,430616715,8,0,0,512,6,2971501149
17039,430182480,6438311,436620791,9,0,1,58880,17,2377478452
17040,430184021,6439433,436623454,0,0,1,29184,6,5068108992
17041,430189469,6454193,436643662,8,0,1,38912,6,9227782978
17042,430197971,6446357,436644328,0,0,1,11264,6,1991651733
17043,430208050,395421,430603471,9,0,0,93184,17,9191984360
17044,430210820,6476144,436686964,3,0,1,86016,0,1789422876
17045,430230219,6472619,436702838,8,0,1,24064,6,9098192727
17046,430251901,6454028,436705929,0,0,1,22016,6,9976989601
17047,430262160,6465583,436727743,9,0,1,19456,17,8366150561
17048,430264091,6464318,436728409,0,0,1,1024,6,4448410610
17049,430362850,6374830,436737680,9,0,1,31232,17,6612062809
17050,430379230,6368025,436747255,6,0,1,32256,3,6686415403
17051,430383761,6379898,436763659,0,0,1,25088,6,10174084637
17052,430401240,6528410,436929650,3,0,1,288768,0,1520503254
17053,430471730,210546,430682276,8,0,0,512,6,8430446479
17054,430487290,296807,430784097,3,0,0,3584,0,2579777924
17055,430501590,250869,430752459,3,0,0,11776,0,6796573573
17056,430522320,6411312,436933632,3,0,1,17920,0,2801408485
17057,430553809,6413203,436967012,8,0,1,5120,6,10418716185
17058,430572660,445917,431018577,6,0,0,40448,3,1264550470
17059,430594290,6374028,436968318,6,0,1,2048,3,1791881340
17060,430600691,6368293,436968984,0,0,1,11264,6,8338183932
17061,430683000,382236,431065236,9,0,0,153088,17,7876052391
17062,430714160,6260295,436974455,6,0,1,5120,3,4447052112
17063,430738171,6242416,436980587,0,0,1,9728,6,7736559766
17064,430748700,6242832,436991532,5,0,1,27648,11,808077882
17065,430753131,6242267,436995398,0,0,1,6144,6,8266853274
17066,430772170,320257,431092427,3,0,0,6656,0,6471302643
17067,430774790,6259892,437034682,3,0,1,70656,0,1332970758
17068,430789660,6247276,437036936,5,0,1,16896,11,7094219006
17069,430803330,6237472,437040802,5,0,1,6144,11,6102912421
17070,430815320,259807,431075127,9,0,0,3072,17,4553483842
17071,430821340,244403,431065743,5,0,0,1536,11,6733602516
17072,430832821,244973,431077794,7,0,0,8704,16,7641978086
17073,430903591,6149578,437053169,0,0,1,10752,6,1266796842
17074,430908701,6144483,437053184,0,0,1,1024,6,1979735357
17075,430976140,6104872,437081012,9,0,1,45056,17,6368496898
17076,431002370,6101742,437104112,9,0,1,13824,17,2191965113
17077,431014070,293838,431307908,3,0,0,1024,0,78327657
17078,431030220,6074878,437105098,9,0,1,1536,17,1963449933
17079,431040190,480948,431521138,3,0,0,1024,0,10246345430
17080,431113090,236696,431349786,8,0,0,1024,6,3695735895
17081,431132081,5973581,437105662,0,0,1,10752,6,2765451103
17082,431133300,316633,431449933,9,0,0,41984,17,3447039764
17083,431180340,5977097,437157437,9,0,1,8192,17,4306840315
17084,431182011,5975441,437157452,0,0,1,2560,6,9089779659
17085,431245550,5911925,437157475,9,0,1,18944,17,10643224434
17086,431257860,5914481,437172341,6,0,1,22016,3,3435148955
17087,431284110,237787,431521897,5,0,0,1536,11,3706440419
17088,431314270,156712,431470982,5,0,0,2560,11,7855020414
17089,431352430,387674,431740104,8,0,0,1024,6,663149491
17090,431365330,5807997,437173327,5,0,1,1536,11,505302517
17091,431381960,608303,431990263,3,0,0,3584,0,1271385281
17092,431416760,572396,431989156,9,0,0,409600,17,9273508324
17093,431440500,5736053,437176553,9,0,1,5120,17,1790932101
17094,431440830,5744436,437185266,9,0,1,20480,17,7053299237
17095,431454770,5730842,437185612,5,0,1,512,11,5829191418
17096,431485451,875117,432360568,7,0,0,20992,16,3627371511
17097,431503911,5696820,437200731,0,0,1,26624,6,1847467607
17098,431526590,5677047,437203637,9,0,1,4608,17,2039664533
17099,431557531,5647182,437204713,0,0,1,13312,6,3671126132
17100,431569740,5643347,437213087,5,0,1,23040,11,6456950228
17101,431589490,230865,431820355,3,0,0,4096,0,2890389287
17102,431595460,431730,432027190,6,0,0,94720,3,9375114699
17103,431617140,559441,432176581,9,0,0,151552,17,1028689738
17104,431622521,602701,432225222,7,0,0,92672,16,10276903964
17105,431629040,231709,431860749,3,0,0,512,0,9059362998
17106,431634710,5618292,437253002,6,0,1,11264,3,3410906636
17107,431656940,5601861,437258801,9,0,1,19456,17,7429735575
17108,431693021,1031794,432724815,7,0,0,192000,16,2676146247
17109,431711350,534355,432245705,6,0,0,29184,3,1693014642
17110,431726050,5565002,437291052,6,0,1,11264,3,9853172810
17111,431728370,892628,432620998,9,0,0,390656,17,4832081429
17112,431732831,891926,432624757,7,0,0,12288,16,8375438585
17113,431753930,1165209,432919139,6,0,0,208384,3,1170704187
17114,431762660,5529672,437292332,1,0,1,14336,6,9624669781
17115,431778610,5549547,437328157,9,0,1,4096,17,1663466356
17116,431783240,5588878,437372118,6,0,1,31744,3,6054249611
17117,431801441,990598,432792039,7,0,0,207872,16,7814497458
17118,431815510,376973,432192483,5,0,0,1024,11,10696638695
17119,431846720,5526820,437373540,9,0,1,13824,17,2185696805
17120,431852600,454943,432307543,3,0,0,512,0,9060676908
17121,431891040,775252,432666292,6,0,0,136192,3,1529649431
17122,431912780,1069408,432982188,9,0,0,70144,17,10488635624
17123,432046251,5371263,437417514,0,0,1,13312,6,6588784553
17124,432129650,1050510,433180160,6,0,0,253440,3,9857676731
17125,432137180,669765,432806945,5,0,0,512,11,6050387190
17126,432150541,5378178,437528719,0,0,1,66560,6,6947272699
17127,432182170,745643,432927813,8,0,0,512,6,9931142211
17128,432189770,616948,432806718,9,0,0,48128,17,5974925757
17129,432249691,1018568,433268259,7,0,0,43008,16,9794397242
17130,432334360,5194374,437528734,5,0,1,11264,11,1996695015
17131,432348101,5180648,437528749,0,0,1,7168,6,6529495932
17132,432348421,507211,432855632,7,0,0,159744,16,7305009132
17133,432350211,743707,433093918,7,0,0,41472,16,161326697
17134,432362530,5166266,437528796,3,0,1,7168,0,10496458299
17135,432368040,614319,432982359,8,0,0,512,6,9151226847
17136,432383740,851675,433235415,9,0,0,181248,17,8076805797
17137,432402750,852382,433255132,6,0,0,61952,3,5610018999
17138,432421820,5106991,437528811,9,0,1,9216,17,5497258526
17139,432568820,4966648,437535468,9,0,1,7680,17,9632813862
17140,432582450,4977679,437560129,5,0,1,29184,11,7508974895
17141,432585890,5000014,437585904,9,0,1,37376,17,6861915785
17142,432619430,616811,433236241,5,0,0,512,11,7805766142
17143,432629310,4966886,437596196,9,0,1,7680,17,5647932508
17144,432651460,4950433,437601893,3,0,1,18944,0,5490204182
17145,432704880,5061964,437766844,3,0,1,168448,0,4440590634
17146,432713830,5053029,437766859,9,0,1,512,17,7446681626
17147,432731020,325852,433056872,0,0,0,1536,6,7412799155
17148,432739020,5027854,437766874,5,0,1,6144,11,8539378926
17149,432758300,604541,433362841,8,0,0,512,6,1452904087
17150,432799060,535487,433334547,8,0,0,6144,6,10114650125
17151,432812390,4954523,437766913,5,0,1,7168,11,6881209467
17152,432829640,4937296,437766936,3,0,1,37376,0,9938122751
17153,432832810,837058,433669868,6,0,0,68608,3,3461792284
17154,432841160,394910,433236070,0,0,0,2048,6,8541440518
17155,432870340,584531,433454871,9,0,0,160768,17,6789713583
17156,432881500,426754,433308254,3,0,0,1024,0,6053055184
17157,432899900,4920230,437820130,9,0,1,70144,17,1451858314
17158,432904150,493247,433397397,6,0,0,70144,3,9223628930
17159,432925770,552742,433478512,6,0,0,35328,3,3576103786
17160,432933920,4886364,437820284,5,0,1,8704,11,4280313556
17161,432951170,372433,433323603,9,0,0,30720,17,10159350502
17162,432964960,502749,433467709,9,0,0,40448,17,983655903
17163,432966280,4895449,437861729,5,0,1,16384,11,9229217995
17164,432984770,4887180,437871950,9,0,1,1024,17,5281877299
17165,433009000,446354,433455354,3,0,0,1536,0,5733530295
17166,433041500,4856354,437897854,9,0,1,10240,17,674096081
17167,433066690,416096,433482786,3,0,0,7168,0,7219076990
17168,433082570,241204,433323774,8,0,0,512,6,5526744307
17169,433094361,554588,433648949,7,0,0,212480,16,7110595727
17170,433116690,4781510,437898200,9,0,1,512,17,1677473232
17171,433117240,4781626,437898866,9,0,1,1024,17,7414159398
17172,433144710,552097,433696807,3,0,0,1536,0,8319547872
17173,433156210,4746522,437902732,2,0,1,6144,11,1645416265
17174,433173130,522524,433695654,6,0,0,84480,3,8302410805
17175,433214870,282738,433497608,0,0,0,512,6,7903701434
17176,433255860,440433,433696293,3,0,0,2048,0,10517420502
17177,433258150,4677485,437935635,9,0,1,9216,17,2975352183
17178,433293810,4649570,437943380,9,0,1,22528,17,8493325558
17179,433344930,135657,433480587,0,0,0,6656,6,5636565071
17180,433347570,4636071,437983641,2,0,1,69120,11,6112654960
17181,433349530,445985,433795515,0,0,0,1536,6,965865957
17182,433412270,285176,433697446,8,0,0,2048,6,4650326416
17183,433413340,4721102,438134442,9,0,1,24064,17,8178556667
17184,433426560,539846,433966406,6,0,0,10240,3,3744558384
17185,433432490,4701967,438134457,9,0,1,19968,17,2247044499
17186,433437021,622452,434059473,7,0,0,112128,16,264460005
17187,433456751,623641,434080392,7,0,0,68608,16,3980422370
17188,433459310,4675242,438134552,2,0,1,30720,11,8601330572
17189,433488020,4646555,438134575,9,0,1,7168,17,795527683
17190,433499070,4651906,438150976,9,0,1,46592,17,1239754166
17191,433503190,326192,433829382,3,0,0,1536,0,5159936972
17192,433541300,253724,433795024,9,0,0,55296,17,2457530287
17193,433542590,420681,433963271,8,0,0,2048,6,9126633294
17194,433552830,4653438,438206268,2,0,1,57856,11,2061775155
17195,433554440,408176,433962616,9,0,0,145408,17,4762937932
17196,433560470,346727,433907197,0,0,0,2560,6,5622099921
17197,433598960,395786,433994746,3,0,0,3584,0,6771240846
17198,433599890,384291,433984181,3,0,0,1024,0,1977944924
17199,433645060,4561223,438206283,3,0,1,9216,0,9064088976
17200,433649650,4614968,438264618,2,0,1,125440,11,7240290623
17201,433684370,396201,434080571,3,0,0,512,0,4848079122
17202,433766100,443641,434209741,9,0,0,117760,17,7494116975
17203,433779870,301052,434080922,3,0,0,1024,0,8833067448
17204,433797870,4469639,438267509,9,0,1,15360,17,6285444026
17205,433809520,4583091,438392611,2,0,1,238080,11,4764831532
17206,433840990,4656227,438497217,3,0,1,58368,0,2508213733
17207,433851140,4686372,438537512,3,0,1,39936,0,3761945458
17208,433853220,4719119,438572339,2,0,1,16384,11,10230607810
17209,433885750,216197,434101947,8,0,0,3072,6,1422589567
17210,433911860,4855994,438767854,2,0,1,92672,11,8387734917
17211,433933530,192867,434126397,8,0,0,1536,6,3364507520
17212,433937080,4832840,438769920,9,0,1,8704,17,1609705687
17213,434009400,4761174,438770574,9,0,1,2048,17,6853260154
17214,434019120,192040,434211160,3,0,0,4608,0,5183214628
17215,434036770,5114268,439151038,9,0,1,204288,17,7529735522
17216,434061850,5126993,439188843,3,0,1,21504,0,4640802955
17217,434077520,432631,434510151,6,0,0,92160,3,1978810255
17218,434124700,187785,434312485,8,0,0,2560,6,1513526063
17219,434151240,243939,434395179,3,0,0,512,0,544781120
17220,434222180,74522,434296702,8,0,0,4096,6,10015082697
17221,434223270,254582,434477852,0,0,0,1024,6,9262456968
17222,434243770,5020978,439264748,3,0,1,75776,0,7660959552
17223,434278030,255428,434533458,8,0,0,512,6,1709507300
17224,434317900,376231,434694131,0,0,0,512,6,10366950889
17225,434327480,366480,434693960,9,0,0,40960,17,3593845494
17226,434338880,5014635,439353515,3,0,1,56832,0,4870431615
17227,434346200,5279314,439625514,2,0,1,175104,11,9362022524
17228,434402860,203311,434606171,8,0,0,512,6,9403247283
17229,434433100,373427,434806527,0,0,0,2560,6,916921394
17230,434449450,198947,434648397,8,0,0,1024,6,5522858567
17231,434476900,301169,434778069,0,0,0,1024,6,8467114015
17232,434493040,147904,434640944,0,0,0,3072,6,1655185345
17233,434493990,259675,434753665,8,0,0,4096,6,9377848575
17234,434512950,5114973,439627923,3,0,1,98304,0,7097020539
17235,434549950,343895,434893845,1,0,0,10752,6,7015252472
17236,434585050,328343,434913393,6,0,0,19456,3,8711777217
17237,434585560,5111451,439697011,3,0,1,250368,0,2643714320
17238,434611810,533836,435145646,3,0,0,512,0,2090683084
17239,434613480,317900,434931380,0,0,0,6656,6,4481067917
17240,434623950,518041,435141991,6,0,0,222720,3,7802832988
17241,434627780,286267,434914047,0,0,0,2048,6,4571126405
17242,434693401,671756,435365157,7,0,0,17920,16,10157703862
17243,434743500,411070,435154570,0,0,0,6656,6,6164556717
17244,434749490,256234,435005724,8,0,0,512,6,9900385008
17245,434754780,389471,435144251,0,0,0,7168,6,10591235080
17246,434780730,272310,435053040,1,0,0,4096,6,1016704254
17247,434794300,669452,435463752,9,0,0,57344,17,6210140418
17248,434798310,202997,435001307,3,0,0,8192,0,10587386906
17249,434817141,605782,435422923,7,0,0,12800,16,4594233872
17250,434836310,717468,435553778,9,0,0,46080,17,3695620050
17251,434836891,91882,434928773,7,0,0,3584,16,5976318033
17252,434880310,162422,435042732,1,0,0,512,6,4081580552
17253,434887131,676194,435563325,7,0,0,31232,16,3695271099
17254,434941811,645085,435586896,7,0,0,77312,16,2206412062
17255,434944990,4780325,439725315,3,0,1,50176,0,5301070856
17256,434951481,467511,435418992,7,0,0,176640,16,5254669358
17257,434972550,690035,435662585,9,0,0,100864,17,10475730606
17258,435032580,413685,435446265,6,0,0,18944,3,6348320748
17259,435073099,4657362,439730461,8,0,1,8192,6,44240693
17260,435078920,509731,435588651,0,0,0,5632,6,1973982769
17261,435104640,4747581,439852221,3,0,1,266752,0,1761100214
17262,435145249,4739411,439884660,8,0,1,25088,6,149953646
17263,435176280,706815,435883095,9,0,0,101376,17,3730566335
17264,435180410,506370,435686780,6,0,0,79360,3,4005100371
17265,435183040,304354,435487394,1,0,0,7168,6,2315606078
17266,435201090,4771348,439972438,4,0,1,95232,4,3049170247
17267,435216181,207865,435424046,7,0,0,3584,16,9214643240
17268,435250720,213203,435463923,3,0,0,512,0,8547280741
17269,435261200,458625,435719825,9,0,0,104960,17,10278426235
17270,435265080,484546,435749626,1,0,0,3072,6,4434544140
17271,435280490,407085,435687575,3,0,0,2560,0,145457494
17272,435282049,4699268,439981317,8,0,1,16384,6,1555793476
17273,435283440,212540,435495980,3,0,0,3072,0,8651629240
17274,435314369,4689528,440003897,8,0,1,59904,6,10185310544
17275,435330970,4728283,440059253,3,0,1,109056,0,979949117
17276,435374231,442793,435817024,7,0,0,21504,16,8103851239
17277,435377770,4693466,440071236,3,0,1,7168,0,54858362
17278,435387700,496205,435883905,0,0,0,512,6,2177846403
17279,435389690,4753446,440143136,3,0,1,138240,0,1063669063
17280,435501340,4754475,440255815,3,0,1,54784,0,901782508
17281,435513840,4858587,440372427,4,0,1,79360,4,122425517
17282,435524270,5054375,440578645,3,0,1,254464,0,182050207
17283,435541990,238154,435780144,0,0,0,1536,6,3813385101
17284,435546100,258671,435804771,8,0,0,5632,6,3824400318
17285,435549360,496876,436046236,6,0,0,12288,3,5036486549
17286,435550300,450401,436000701,6,0,0,74752,3,2223008883
17287,435566560,489755,436056315,3,0,0,4096,0,4333334971
17288,435577750,331340,435909090,1,0,0,3072,6,2770069211
17289,435612189,4966471,440578660,8,0,1,3584,6,1956939704
17290,435646030,237704,435883734,3,0,0,2048,0,4629364868
17291,435694290,404027,436098317,6,0,0,36352,3,6467649312
17292,435763799,4814876,440578675,8,0,1,26624,6,9796051336
17293,435787381,251895,436039276,7,0,0,34816,16,3842459763
17294,435793571,566267,436359838,7,0,0,208384,16,516792517
17295,435817950,4842162,440660112,6,0,1,32256,3,7871049883
17296,435880980,380717,436261697,8,0,0,2560,6,7457099331
17297,435899230,308580,436207810,1,0,0,1024,6,4691472359
17298,435931289,4728838,440660127,8,0,1,8192,6,4834907191
17299,435965889,4694269,440660158,8,0,1,24064,6,5265828425
17300,435972299,4701166,440673465,8,0,1,39936,6,1377882229
17301,436020779,4652701,440673480,8,0,1,512,6,6319456990
17302,436032650,236125,436268775,8,0,0,5632,6,8045825697
17303,436041120,319045,436360165,1,0,0,1024,6,261576894
17304,436133930,4569402,440703332,3,0,1,30720,0,5205876959
17305,436212350,149078,436361428,0,0,0,4096,6,6204478803
17306,436221181,332248,436553429,7,0,0,93696,16,898190669
17307,436221610,481213,436702823,6,0,0,36864,3,2066336123
17308,436227980,817105,437045085,8,0,0,2048,6,2308689208
17309,436247800,4466415,440714215,3,0,1,36352,0,8946895524
17310,436371251,432197,436803448,7,0,0,36352,16,7997133709
17311,436440270,456460,436896730,0,0,0,5120,6,5404464282
17312,436464001,431154,436895155,7,0,0,49664,16,2116149280
17313,436492510,464262,436956772,8,0,0,11264,6,816271243
17314,436501550,4217491,440719041,3,0,1,7680,0,7276237255
17315,436528610,314117,436842727,3,0,0,6144,0,9712130326
17316,436532680,148757,436681437,8,0,0,512,6,7724898410
17317,436546680,4174934,440721614,3,0,1,22528,0,1571201061
17318,436608321,549101,437157422,7,0,0,125952,16,9419332999
17319,436638450,193357,436831807,8,0,0,3072,6,10718279240
17320,436659250,393904,437053154,9,0,0,18944,17,8121332463
17321,436778650,549492,437328142,6,0,0,105984,3,10520879195
17322,436810090,578371,437388461,6,0,0,24064,3,553726454
17323,436811560,443452,437255012,0,0,0,3072,6,9809019485
17324,436839590,318524,437158114,8,0,0,2048,6,301637058
17325,436845810,3913295,440759105,6,0,1,18944,3,4490523456
17326,436890740,548898,437439638,8,0,0,1024,6,5183963294
17327,436906230,303315,437209545,0,0,0,1024,6,7741157712
17328,436935320,3906226,440841546,3,0,1,182272,0,8365536825
17329,436940980,611569,437552549,3,0,0,512,0,3173290739
17330,436966420,562284,437528704,6,0,0,263680,3,10575254503
17331,436968640,251525,437220165,8,0,0,5632,6,6420939319
17332,436978790,3889125,440867915,3,0,1,66560,0,5637527653
17333,436979130,291596,437270726,0,0,0,1536,6,2077251999
17334,436990200,3982696,440972896,3,0,1,205824,0,338533190
17335,437022500,744329,437766829,6,0,0,268288,3,4305712425
17336,437032889,3955182,440988071,8,0,1,6656,6,8786413281
17337,437049590,3982451,441032041,3,0,1,46080,0,4028764712
17338,437069310,4027705,441097015,2,0,1,121856,11,5916119430
17339,437109650,422237,437531887,3,0,0,1536,0,7372527053
17340,437163240,4204984,441368224,3,0,1,174592,0,804702427
17341,437170620,4231391,441402011,3,0,1,160768,0,10110605779
17342,437211740,340638,437552378,9,0,0,38912,17,2840241713
17343,437328440,4373518,441701958,3,0,1,507392,0,7383563028
17344,437350040,4479285,441829325,3,0,1,168448,0,9597368139
17345,437358500,768112,438126612,9,0,0,368128,17,6941022154
17346,437432880,523063,437955943,1,0,0,1024,6,8431386550
17347,437487651,4352270,441839921,0,0,1,8704,6,7505904831
17348,437505590,371162,437876752,8,0,0,4608,6,6412030783
17349,437510470,302211,437812681,9,0,0,21504,17,10180217404
17350,437519730,4427049,441946779,3,0,1,145408,0,3711650124
17351,437527410,678843,438206253,6,0,0,143872,3,9629109420
17352,437584440,550945,438135385,1,0,0,1024,6,8760543703
17353,437668470,4422682,442091152,3,0,1,208896,0,5228938577
17354,437690070,4463008,442153078,2,0,1,66560,11,2017656853
17355,437697050,536336,438233386,8,0,0,1536,6,6692455520
17356,437732790,4501805,442234595,2,0,1,175616,11,6556169389
17357,437752580,4492888,442245468,3,0,1,26624,0,10671443170
17358,437759220,4502402,442261622,3,0,1,10752,0,8021015397
17359,437776770,379975,438156745,0,0,0,3072,6,3411667151
17360,437789151,4481426,442270577,0,0,1,4096,6,9010598733
17361,437789670,345388,438135058,8,0,0,1536,6,5258589885
17362,437802630,331797,438134427,6,0,0,25600,3,9647733763
17363,437814671,538473,438353144,7,0,0,50688,16,2125909480
17364,437821710,314314,438136024,3,0,0,2048,0,5061153461
17365,437827710,4444493,442272203,3,0,1,2560,0,2263918494
17366,437839640,4514084,442353724,2,0,1,62976,11,8350624190
17367,437851510,381345,438232855,6,0,0,66048,3,7412546961
17368,437868800,121286,437990086,3,0,0,1536,0,8637956920
17369,437904260,4872729,442776989,2,0,1,549888,11,2966700085
17370,437915351,4901605,442816956,0,0,1,54784,6,9590703864
17371,437921601,800150,438721751,7,0,0,16384,16,10077905838
17372,437925880,4913338,442839218,1,0,1,44032,6,4418404536
17373,437959111,355513,438314624,7,0,0,512,16,6946816883
17374,437987021,445791,438432812,7,0,0,24576,16,8996537548
17375,438023611,4849563,442873174,0,0,1,35840,6,9474278629
17376,438067020,430118,438497138,9,0,0,123904,17,9556659090
17377,438079410,331136,438410546,1,0,0,1024,6,5006731073
17378,438080580,4792609,442873189,3,0,1,15872,0,820634789
17379,438082300,4829615,442911915,2,0,1,89600,11,4781548780
17380,438101190,4817082,442918272,5,0,1,15360,11,8052295315
17381,438119160,180344,438299504,3,0,0,6144,0,1198993072
17382,438151490,4916532,443068022,2,0,1,290816,11,4896547396
17383,438182270,4960487,443142757,2,0,1,145408,11,4035507477
17384,438183170,5006516,443189686,3,0,1,47616,0,2250059593
17385,438192911,5002818,443195729,0,0,1,19456,6,3482370426
17386,438211691,556148,438767839,7,0,0,144384,16,3079903209
17387,438217621,499123,438716744,7,0,0,223232,16,10695909775
17388,438252350,5000727,443253077,2,0,1,118784,11,1744582250
17389,438284201,4981591,443265792,0,0,1,7680,6,1699790860
17390,438307490,462407,438769897,8,0,0,6656,6,2724467811
17391,438312470,573268,438885738,0,0,0,2048,6,10223177508
17392,438366290,4972101,443338391,2,0,1,144896,11,4580262126
17393,438382340,4960237,443342577,3,0,1,6656,0,2175281479
17394,438388020,4956823,443344843,5,0,1,3584,11,1788229494
17395,438392401,796256,439188657,7,0,0,114688,16,1150742132
17396,438432500,921000,439353500,3,0,0,1024,0,4602688704
17397,438453020,269058,438722078,1,0,0,1024,6,3236446420
17398,438461210,262614,438723824,3,0,0,2048,0,4499784565
17399,438474230,248955,438723185,0,0,0,3584,6,9577112322
17400,438475180,4885986,443361166,3,0,1,50688,0,432329759
17401,438475660,422990,438898650,0,0,0,4096,6,4747156766
17402,438487040,865003,439352043,6,0,0,276480,3,3225867898
17403,438501100,1056641,439557741,6,0,0,332288,3,3484142734
17404,438520300,4846038,443366338,1,0,1,8192,6,7071339023
17405,438538380,4832784,443371164,3,0,1,7680,0,5582828679
17406,438549320,871290,439420610,6,0,0,220160,3,6876676414
17407,438559410,494395,439053805,3,0,0,512,0,2983111853
17408,438560620,4821564,443382184,2,0,1,32768,11,7655115552
17409,438564260,4821470,443385730,3,0,1,5632,0,4287503023
17410,438598911,545876,439144787,7,0,0,71168,16,6773546777
17411,438622120,148439,438770559,0,0,0,2048,6,4326693251
17412,438638870,576942,439215812,8,0,0,3584,6,1039073167
17413,438681210,463748,439144958,0,0,0,512,6,7215140715
17414,438713150,726032,439439182,9,0,0,26624,17,6924085653
17415,438729041,4659915,443388956,0,0,1,5120,6,5444703052
17416,438730370,4659042,443389412,3,0,1,9728,0,1243147502
17417,438742160,446668,439188828,3,0,0,512,0,6962408957
17418,438766510,585860,439352370,6,0,0,1024,3,7737988914
17419,438766570,656395,439422965,8,0,0,7680,6,7244310837
17420,438775141,792755,439567896,7,0,0,33280,16,2312352727
17421,438784560,4664375,443448935,2,0,1,115712,11,2613560045
17422,438784770,4665151,443449921,3,0,1,1536,0,6096810083
17423,438852101,775799,439627900,7,0,0,5120,16,9200119509
17424,438909150,4547287,443456437,7,0,1,23040,16,250525103
17425,438909990,4558469,443468459,3,0,1,4096,0,9002622853
17426,438933930,258734,439192664,1,0,0,512,6,1000462285
17427,438939150,4537956,443477106,3,0,1,3584,0,4906168575
17428,438947920,678397,439626317,0,0,0,2560,6,4041474430
17429,438988910,364255,439353165,3,0,0,2560,0,625064347
17430,439021420,604063,439625483,6,0,0,188928,3,2761049149
17431,439072250,560227,439632477,6,0,0,12800,3,727877293
17432,439113760,4364524,443478284,2,0,1,13824,11,3783330212
17433,439117340,306928,439424268,1,0,0,4096,6,1632967061
17434,439226260,406396,439632656,5,0,0,512,11,293896878
17435,439263260,4216100,443479360,3,0,1,13312,0,231061622
17436,439291850,155448,439447298,8,0,0,1536,6,3996134335
17437,439356450,300245,439656695,8,0,0,4608,6,8109498409
17438,439359461,4197881,443557342,0,0,1,7680,6,1479874294
17439,439387440,241122,439628562,1,0,0,2048,6,2844559816
17440,439394800,4162557,443557357,7,0,1,10752,16,4593963791
17441,439398360,4170419,443568779,3,0,1,34816,0,7097127074
17442,439418269,4151816,443570085,8,0,1,2048,6,3732408
17443,439431090,267150,439698240,3,0,0,512,0,3358392195
17444,439439470,299755,439739225,1,0,0,4096,6,4118038962
17445,439461810,4109581,443571391,7,0,1,2048,16,5409808496
17446,439495270,4076787,443572057,7,0,1,1024,16,5098240857
17447,439504880,379765,439884645,8,0,0,2560,6,2232058706
17448,439517280,366570,439883850,6,0,0,65024,3,8627888091
17449,439529950,4042978,443572928,3,0,1,12288,0,9802198354
17450,439586770,403068,439989838,1,0,0,6656,6,8903158024
17451,439605870,305084,439910954,9,0,0,65536,17,7766326177
17452,439611980,306953,439918933,0,0,0,5632,6,4444904879
17453,439615740,331219,439946959,9,0,0,6144,17,4616919417
17454,439624890,3961140,443586030,2,0,1,10240,11,9789417369
17455,439640509,3950027,443590536,8,0,1,7168,6,8669283659
17456,439652200,3938900,443591100,3,0,1,10752,0,1621608477
17457,439656210,164728,439820938,1,0,0,512,6,7977468056
17458,439669660,268442,439938102,0,0,0,512,6,4875587789
17459,439675680,3919647,443595327,3,0,1,28160,0,2310588545
17460,439684560,3912393,443596953,5,0,1,2560,11,1428031732
17461,439695530,3902755,443598285,3,0,1,12288,0,173953822
17462,439702230,4463283,444165513,2,0,1,841216,11,5392399101
17463,439762710,609702,440372412,8,0,0,3072,6,6784479190
17464,439786740,652908,440439648,6,0,0,190464,3,6203259798
17465,439786810,4442914,444229724,2,0,1,93184,11,7707238131
17466,439813770,878541,440692311,3,0,0,2048,0,9043811233
17467,439825480,548210,440373690,8,0,0,4096,6,6367331481
17468,439835380,4428038,444263418,3,0,1,41984,0,5203537059
17469,439840630,490021,440330651,6,0,0,30720,3,552195595
17470,439862030,308860,440170890,0,0,0,512,6,6629010052
17471,439898840,432138,440330978,0,0,0,1024,6,5567748921
17472,439903770,467691,440371461,9,0,0,119808,17,1636656718
17473,439919710,244444,440164154,8,0,0,2560,6,1263068620
17474,439920480,550750,440471230,6,0,0,98816,3,9529341651
17475,439940470,4378728,444319198,2,0,1,140288,11,1216618471
17476,439940960,4418216,444359176,2,0,1,55296,11,133110717
17477,439948010,4418037,444366047,3,0,1,18432,0,1564116658
17478,439966250,4410255,444376505,7,0,1,25600,16,3507307096
17479,439985020,4404078,444389098,7,0,1,7168,16,2625528954
17480,439997310,382650,440379960,6,0,0,16384,3,2953359187
17481,440006230,4386530,444392760,3,0,1,17408,0,4826899332
17482,440009080,569550,440578630,6,0,0,72704,3,6415615480
17483,440028320,4374573,444402893,2,0,1,24576,11,2235516289
17484,440028840,4399107,444427947,2,0,1,43008,11,369654124
17485,440044600,4489959,444534559,7,0,1,52224,16,2554418134
17486,440071130,369945,440441075,0,0,0,4608,6,929041585
17487,440073730,4476967,444550697,2,0,1,25600,11,10296860914
17488,440079100,434310,440513410,8,0,0,512,6,2642989114
17489,440105140,4491097,444596237,2,0,1,95744,11,8261085348
17490,440133320,241633,440374953,3,0,0,4096,0,6798478055
17491,440134200,4485801,444620001,3,0,1,14848,0,9457064363
17492,440139790,4482477,444622267,7,0,1,3584,16,10416582212
17493,440177830,729878,440907708,6,0,0,45056,3,4500112816
17494,440182459,4442714,444625173,8,0,1,4608,6,2462130504
17495,440208990,451339,440660329,3,0,0,512,0,2584364689
17496,440232260,427837,440660097,9,0,0,188416,17,3363461206
17497,440234389,4414360,444648749,8,0,1,35328,6,5556708003
17498,440271110,316445,440587555,3,0,0,2048,0,830982506
17499,440304779,4343985,444648764,8,0,1,1024,6,6535209365
17500,440315250,347917,440663167,0,0,0,1024,6,2680906789
17501,440325770,337070,440662840,6,0,0,8192,3,816527974
17502,440381320,292130,440673450,8,0,0,7168,6,10055798401
17503,440394870,4253909,444648779,7,0,1,6656,16,8069090926
17504,440420830,4273887,444694717,2,0,1,102400,11,2070098637
17505,440423399,4273584,444696983,8,0,1,3584,6,9512241479
17506,440426300,304825,440731125,3,0,0,2048,0,4135274452
17507,440434610,4265599,444700209,3,0,1,5120,0,1456601098
17508,440440780,4289194,444729974,2,0,1,44544,11,5212579324
17509,440480450,4299659,444780109,3,0,1,52736,0,8667180043
17510,440480810,4305588,444786398,3,0,1,4096,0,1120118552
17511,440487880,4310170,444798050,7,0,1,20480,16,9676505340
17512,440548910,4769012,445317922,2,0,1,235008,11,5830672305
17513,440552160,4765785,445317945,3,0,1,4096,0,322654179
17514,440595230,4749366,445344596,3,0,1,21504,0,266968200
17515,440655190,4695133,445350323,7,0,1,13312,16,7056396076
17516,440660130,137609,440797739,1,0,0,1024,6,8357796334
17517,440661340,4701896,445363236,7,0,1,13312,16,3996943593
17518,440705130,661310,441366440,6,0,0,152064,3,10468313571
17519,440727059,4636523,445363582,8,0,1,512,6,1644168943
17520,440743420,65744,440809164,8,0,0,2048,6,6354391027
17521,440776550,776607,441553157,1,0,0,10752,6,9141669329
17522,440790300,700294,441490594,6,0,0,178688,3,9929989445
17523,440814940,553269,441368209,3,0,0,2560,0,9697362839
17524,440815500,606442,441421942,6,0,0,20992,3,261033457
17525,440824970,424681,441249651,6,0,0,74752,3,5616691546
17526,440836330,4529198,445365528,7,0,1,3072,16,3574120064
17527,440840910,205188,441046098,8,0,0,1024,6,7606961909
17528,440919670,400096,441319766,9,0,0,113664,17,1290433154
17529,440927649,4459230,445386879,8,0,1,16384,6,4033224142
17530,440980130,4417446,445397576,7,0,1,9728,16,441447341
17531,440986860,333233,441320093,1,0,0,1024,6,8926732243
17532,440990200,551231,441541431,0,0,0,1024,6,6344652970
17533,440995550,373321,441368871,0,0,0,2048,6,5929331122
17534,441004080,366218,441370298,1,0,0,4608,6,6646516311
17535,441005440,361639,441367079,3,0,0,2048,0,9033101508
17536,441022310,4375522,445397832,7,0,1,9216,16,7468568133
17537,441031040,336366,441367406,3,0,0,1024,0,936370821
17538,441044420,351206,441395626,6,0,0,10240,3,2040104169
17539,441080370,4317718,445398088,3,0,1,9216,0,5088436996
17540,441085519,4314883,445400402,8,0,1,14848,6,4039492856
17541,441094990,4386407,445481397,7,0,1,8192,16,3877506856
17542,441106289,4375123,445481412,8,0,1,6656,6,2037098660
17543,441131040,4384223,445515263,7,0,1,61952,16,5772732293
17544,441157179,4359390,445516569,8,0,1,2048,6,8800001461
17545,441176900,330774,441507674,1,0,0,1024,6,2650797833
17546,441259150,288285,441547435,1,0,0,7168,6,10580730905
17547,441322200,472119,441794319,6,0,0,182784,3,1917120448
17548,441349400,219109,441568509,1,0,0,3072,6,3652161649
17549,441349910,445204,441795114,3,0,0,2560,0,1050815296
17550,441376340,4141356,445517696,3,0,1,11264,0,2553821387
17551,441402379,4115676,445518055,8,0,1,9728,6,4600899380
17552,441418040,559064,441977104,9,0,0,89600,17,7152370087
17553,441483180,322014,441805194,1,0,0,4608,6,3412518887
17554,441537661,371108,441908769,7,0,0,119296,16,7755576531
17555,441550190,548799,442098989,6,0,0,13824,3,10734697327
17556,441573990,3972520,445546510,3,0,1,27136,0,3471372352
17557,441581230,502724,442083954,0,0,0,9728,6,4910990063
17558,441588720,564343,442153063,6,0,0,137216,3,7503872274
17559,441620480,307333,441927813,3,0,0,1024,0,9432338
17560,441929120,485616,442414736,6,0,0,40448,3,6624363002
17561,441946450,700600,442647050,6,0,0,334848,3,4809719966
17562,441987590,476898,442464488,3,0,0,1024,0,1203681425
17563,442001841,302431,442304272,7,0,0,5120,16,2774189630
17564,442146409,3410358,445556767,8,0,1,512,6,9468494172
17565,442147611,592119,442739730,7,0,0,262656,16,9192099024
17566,442222520,424709,442647229,1,0,0,512,6,629007960
17567,442291250,148542,442439792,0,0,0,1024,6,2833056065
17568,442310010,233367,442543377,3,0,0,2048,0,7710997871
17569,442424340,317775,442742115,3,0,0,4096,0,6519404871
17570,442439270,301255,442740525,1,0,0,2560,6,6807606503
17571,442444760,428399,442873159,6,0,0,96256,3,6256920286
17572,442501990,270083,442772073,9,0,0,44032,17,1954278347
17573,442507530,233322,442740852,0,0,0,1024,6,5397439726
17574,442513329,3046121,445559450,8,0,1,23040,6,4774982412
17575,442531899,3168307,445700206,8,0,1,6144,6,2139569990
17576,442593050,502794,443095844,6,0,0,75264,3,820833476
17577,442698970,348840,443047810,0,0,0,2048,6,10262977192
17578,442700060,433984,443134044,3,0,0,4608,0,3292953014
17579,442702801,2997420,445700221,0,0,1,16384,6,9901309145
17580,442758070,374555,443132625,9,0,0,23552,17,170683120
17581,442774739,2938008,445712747,8,0,1,6656,6,915760395
17582,442914210,248448,443162658,1,0,0,512,6,725145430
17583,442919800,275687,443195487,9,0,0,17920,17,3101391815
17584,442932180,358159,443290339,3,0,0,4096,0,7831961803
17585,442963320,366172,443329492,1,0,0,6144,6,5822237359
17586,442992270,301677,443293947,0,0,0,1024,6,1884658835
17587,443021340,179769,443201109,3,0,0,3584,0,2665381973
17588,443049140,2663622,445712762,6,0,1,10240,3,8648064505
17589,443051060,2662044,445713104,7,0,1,3584,16,2795855044
17590,443053860,201846,443255706,0,0,0,3072,6,1941544284
17591,443080599,2632520,445713119,8,0,1,3584,6,2408214902
17592,443097150,212662,443309812,0,0,0,2048,6,10691109811
17593,443143470,484452,443627922,9,0,0,28160,17,10424494063
17594,443152810,2560348,445713158,7,0,1,5632,16,1318551969
17595,443165049,2548132,445713181,8,0,1,18432,6,4911686028
17596,443201530,542289,443743819,6,0,0,139264,3,3085583068
17597,443226800,330527,443557327,9,0,0,80384,17,10438879163
17598,443280960,489431,443770391,0,0,0,1024,6,5808121945
17599,443309390,720906,444030296,6,0,0,51200,3,9119028922
17600,443314820,645471,443960291,9,0,0,41472,17,9003438237
17601,443317660,135993,443453653,6,0,0,2048,3,4874142639
17602,443338530,564926,443903456,9,0,0,69120,17,6265158876
17603,443375450,368564,443744014,1,0,0,512,6,8763936341
17604,443402349,2312469,445714818,8,0,1,14848,6,1501777098
17605,443408840,598339,444007179,6,0,0,60416,3,7850174542
17606,443462489,2252344,445714833,8,0,1,2560,6,7026304552
17607,443482450,581529,444063979,3,0,0,512,0,6017247440
17608,443527510,313065,443840575,6,0,0,91136,3,3062946157
17609,443543219,2171629,445714848,8,0,1,9728,6,87168274
17610,443575150,2139713,445714863,3,0,1,11776,0,2294370075
17611,443576529,2140032,445716561,8,0,1,4096,6,5761416324
17612,443610519,2119934,445730453,8,0,1,6144,6,7760982038
17613,443615940,561624,444177564,1,0,0,6656,6,2599835636
17614,443640250,2167145,445807395,4,0,1,26624,4,1249581212
17615,443688890,412845,444101735,1,0,0,2560,6,2939878546
17616,443696650,207601,443904251,0,0,0,2560,6,4936265063
17617,443705689,2101721,445807410,8,0,1,10240,6,6662153150
17618,443718170,444770,444162940,0,0,0,1024,6,1737248671
17619,443742550,2064875,445807425,7,0,1,2560,16,9240280500
17620,443751460,2143043,445894503,3,0,1,1536,0,1524063497
17621,443791630,370983,444162613,6,0,0,96256,3,1103215040
17622,443810470,353109,444163579,0,0,0,2048,6,2965703624
17623,443842600,401801,444244401,1,0,0,2560,6,9600885630
17624,443874110,339532,444213642,0,0,0,5120,6,9945054877
17625,443895540,198047,444093587,0,0,0,1024,6,3480071068
17626,443925029,1970144,445895173,8,0,1,4096,6,6174832067
17627,443941891,409528,444351419,7,0,0,65536,16,6778812820
17628,443955691,1939497,445895188,0,0,1,4096,6,10434785742
17629,443996600,1898603,445895203,3,0,1,26112,0,4416657672
17630,444009240,305722,444314962,0,0,0,2560,6,3995878942
17631,444053889,1841329,445895218,8,0,1,7168,6,4490057519
17632,444100871,1794362,445895233,0,0,1,4608,6,6418777627
17633,444140710,281315,444422025,1,0,0,512,6,9988680191
17634,444157379,1737869,445895248,8,0,1,9216,6,5316820190
17635,444186290,461329,444647619,9,0,0,65536,17,6442045756
17636,444188070,346466,444534536,9,0,0,175616,17,6706552462
17637,444197910,352764,444550674,6,0,0,52736,3,4666800780
17638,444199350,1705805,445905155,3,0,1,39424,0,10273605266
17639,444211949,1783768,445995717,8,0,1,31744,6,8801069167
17640,444270910,497645,444768555,3,0,0,512,0,4241439142
17641,444312110,117649,444429759,1,0,0,512,6,8517137097
17642,444354140,320956,444675096,0,0,0,3584,6,9818311171
17643,444381870,318900,444700770,1,0,0,1024,6,5355353107
17644,444383690,265036,444648726,0,0,0,3584,6,10221659379
17645,444407950,1587798,445995748,3,0,1,12288,0,251750860
17646,444457150,542730,444999880,6,0,0,210432,3,7756057397
17647,444482819,1512944,445995763,8,0,1,18944,6,2850779638
17648,444492040,276344,444768384,6,0,0,26112,3,1355689607
17649,444515600,542006,445057606,3,0,0,512,0,3608404295
17650,444526971,971174,445498145,7,0,0,26112,16,10591808523
17651,444528771,788325,445317096,7,0,0,148992,16,743820088
17652,444636800,783973,445420773,6,0,0,512,3,4060991193
17653,444647471,833911,445481382,7,0,0,119296,16,821853023
17654,444649150,1063574,445712724,9,0,0,40960,17,6989856550
17655,444660980,1233508,445894488,9,0,0,285696,17,1935100042
17656,444672621,1027562,445700183,7,0,0,456192,16,2557992244
17657,444707250,1289019,445996269,3,0,1,3072,0,9717813734
17658,444767810,1228474,445996284,3,0,1,7168,0,2137630652
17659,444836051,1160248,445996299,0,0,1,12800,6,4620872549
17660,444917530,400369,445317899,6,0,0,2560,3,4940114606
17661,444925590,437546,445363136,0,0,0,512,6,2661762055
17662,444926140,228912,445155052,0,0,0,512,6,5224999816
17663,444936849,1059465,445996314,8,0,1,1024,6,7117757222
17664,444949360,1051748,446001108,3,0,1,12800,0,2407842232
17665,444950090,481133,445431223,6,0,0,512,3,4626535528
17666,444968860,1026842,445995702,9,0,0,82944,17,379384422
17667,444970261,560856,445531117,7,0,0,4608,16,2038678629
17668,444978419,1023457,446001876,8,0,1,11776,6,3936336098
17669,444996960,323954,445320914,6,0,0,3072,3,2351990263
17670,445002680,804684,445807364,9,0,0,205824,17,7162308101
17671,445016920,517869,445534789,6,0,0,1536,3,8560814198
17672,445035290,974291,446009581,3,0,1,5632,0,8182034518
17673,445109430,928293,446037723,3,0,1,43008,0,2763657776
17674,445123330,376078,445499408,1,0,0,4096,6,5828763503
17675,445124800,991206,446116006,9,0,0,36352,17,2068029319
17676,445129220,922433,446051653,3,0,1,37376,0,1550069439
17677,445172179,879489,446051668,8,0,1,5632,6,7041967703
17678,445174120,539856,445713976,6,0,0,2560,3,4751184270
17679,445208079,858888,446066967,8,0,1,25600,6,9141094871
17680,445233160,661990,445895150,0,0,0,2048,6,9872599988
17681,445249230,819043,446068273,7,0,1,2048,16,5428555052
17682,445279070,434019,445713089,1,0,0,1024,6,3602952177
17683,445294580,910144,446204724,3,0,1,62464,0,1072754581
17684,445303421,733952,446037373,7,0,0,76800,16,2371356586
17685,445314860,891810,446206670,3,0,1,3072,0,7729259045
17686,445336020,378767,445714787,1,0,0,2560,6,9600563170
17687,445351710,866089,446217799,3,0,1,512,0,7633084669
17688,445373729,844685,446218414,8,0,1,18944,6,2340001708
17689,445383501,586914,445970415,7,0,0,174080,16,3493560401
17690,445404950,814450,446219400,3,0,1,1536,0,4425379882
17691,445434079,787267,446221346,8,0,1,3072,6,5392992426
17692,445471901,774815,446246716,7,0,0,60928,16,5088228415
17693,445506391,545239,446051630,7,0,0,45568,16,7377636982
17694,445566789,706173,446272962,8,0,1,34304,6,2959542008
17695,445576850,773695,446350545,3,0,1,53248,0,9229706833
17696,445595650,300261,445895911,1,0,0,2048,6,9982416428
17697,445635880,361229,445997109,3,0,0,2560,0,5429573089
17698,445636889,743142,446380031,8,0,1,7680,6,6589122164
17699,445638550,636611,446275161,9,0,0,7168,17,5529005361
17700,445645480,737457,446382937,7,0,1,4608,16,929485795
17701,445673880,322366,445996246,3,0,0,1536,0,8662869182
17702,445676741,835921,446512662,7,0,0,36864,16,6415633791
17703,445716280,321420,446037700,3,0,0,1024,0,8951008456
17704,445746951,525988,446272939,7,0,0,86016,16,9208635601
17705,445785720,701087,446486807,9,0,1,129536,17,4442392573
17706,445791760,371511,446163271,0,0,0,1536,6,2859018752
17707,445844801,1100086,446944887,7,0,0,273920,16,2980838089
17708,445848620,150064,445998684,0,0,0,5120,6,538228746
17709,445858679,679907,446538586,8,0,1,29184,6,2478759377
17710,445885970,265705,446151675,3,0,0,2048,0,7034367477
17711,445919890,1296771,447216661,9,0,0,265216,17,3811550957
17712,445922600,701043,446623643,9,0,0,172544,17,4757384377
17713,445964760,164062,446128822,1,0,0,512,6,3003793979
17714,445998850,1026047,447024897,1,0,0,1024,6,4952147082
17715,446025660,278434,446304094,3,0,0,2560,0,1264077383
17716,446031929,595334,446627263,8,0,1,43520,6,2100585115
17717,446128610,344361,446472971,0,0,0,512,6,9408086249
17718,446154430,475995,446630425,3,0,1,13824,0,1250516727
17719,446161789,472822,446634611,8,0,1,6656,6,3529384534
17720,446174260,1117076,447291336,9,0,0,174080,17,7772391672
17721,446222740,298829,446521569,9,0,0,29184,17,6444778682
17722,446238260,386342,446624602,0,0,0,3072,6,6512031747
17723,446270230,356259,446626489,0,0,0,6144,6,8821105087
17724,446272990,365960,446638950,3,0,1,512,0,8334243428
17725,446348069,294107,446642176,8,0,1,5120,6,4048401046
17726,446375760,409023,446784783,4,0,1,74752,4,1634553128
17727,446377520,568543,446946063,6,0,0,3584,3,3583286943
17728,446383189,401940,446785129,8,0,1,512,6,6138726248
17729,446405340,539562,446944902,3,0,1,81408,0,3740326350
17730,446412720,532213,446944933,3,0,1,27648,0,6632851824
17731,446424610,709873,447134483,9,0,0,241664,17,8235068111
17732,446468170,392140,446860310,0,0,0,2048,6,6722616028
17733,446509080,235871,446744951,3,0,0,512,0,9472029918
17734,446521619,423329,446944948,8,0,1,1536,6,7865189478
17735,446528180,869965,447398145,9,0,0,272384,17,6801611217
17736,446545050,497185,447042235,5,0,1,70656,11,6558132763
17737,446555961,850951,447406912,7,0,0,28672,16,6061891948
17738,446570490,192675,446763165,1,0,0,2560,6,5792640360
17739,446573490,477117,447050607,5,0,1,13312,11,8795840817
17740,446612431,825072,447437503,7,0,0,100352,16,947263702
17741,446615929,518577,447134506,8,0,1,2048,6,6574198797
17742,446729070,405451,447134521,3,0,1,28160,0,4739675552
17743,446732511,403281,447135792,7,0,0,4096,16,7278229726
17744,446770760,230957,447001717,3,0,0,1536,0,649641557
17745,446792561,444137,447236698,7,0,0,52224,16,2479265047
17746,446795180,443101,447238281,1,0,0,5120,6,7741956203
17747,446803579,332228,447135807,8,0,1,17408,6,3671318159
17748,446861371,452942,447314313,7,0,0,75264,16,649481627
17749,446877070,605181,447482251,9,0,0,26112,17,8638325903
17750,446878500,436608,447315108,0,0,0,2560,6,3252502444
17751,446906660,310694,447217354,3,0,0,2048,0,9480360678
17752,446951450,184372,447135822,5,0,1,8704,11,738138540
17753,446956410,260282,447216692,3,0,1,30208,0,362567442
17754,446977559,239156,447216715,8,0,1,81408,6,1488618909
17755,446991380,447885,447439265,1,0,0,2560,6,5454289349
17756,446995980,221389,447217369,3,0,1,18944,0,6464197392
17757,446998329,219055,447217384,8,0,1,1024,6,5651100300
17758,447026391,483034,447509425,7,0,0,40960,16,4916871847
17759,447032920,405550,447438470,3,0,0,3072,0,4150246473
17760,447044981,429299,447474280,7,0,0,71680,16,5658488269
17761,447046850,244501,447291351,5,0,1,10752,11,10028985043
17762,447062670,228696,447291366,3,0,1,4096,0,2951536862
17763,447079230,360230,447439460,3,0,0,512,0,4321679023
17764,447113660,201463,447315123,5,0,1,3584,11,2958918805
17765,447115770,542385,447658155,9,0,0,176640,17,2733551458
17766,447172810,347570,447520380,1,0,0,1024,6,8332584880
17767,447210760,104378,447315138,5,0,1,10752,11,4693684680
17768,447224420,467291,447691711,9,0,0,41472,17,7215624579
17769,447280181,550416,447830597,7,0,0,54272,16,337137623
17770,447302870,148195,447451065,3,0,1,19456,0,1135431592
17771,447350480,131786,447482266,5,0,1,51712,11,1275142445
17772,447352030,523663,447875693,9,0,0,40960,17,7240304529
17773,447393480,310465,447703945,1,0,0,2048,6,6345931436
17774,447394320,88497,447482817,5,0,1,19456,11,8471124395
17775,447419469,63912,447483381,8,0,1,10752,6,8139374175
17776,447506060,281260,447787320,1,0,0,4096,6,8255080190
17777,447515950,238138,447754088,0,0,0,2560,6,1002131593
17778,447544179,6278,447550457,8,0,1,6656,6,2013440966
17779,447555060,5454,447560514,6,0,1,13824,3,7015545206
17780,447555409,9731,447565140,8,0,1,6144,6,9196749477
17781,447557010,288343,447845353,3,0,0,9216,0,9205575669
17782,447584950,15837,447600787,6,0,1,30720,3,8639072986
17783,447600070,58100,447658170,6,0,1,8192,3,919808544
17784,447610530,119256,447729786,3,0,1,115712,0,7429650466
17785,447617410,663158,448280568,9,0,0,248832,17,287512479
17786,447617731,455668,448073399,7,0,0,87040,16,9468997832
17787,447618240,114772,447733012,6,0,1,5120,3,5270257204
17788,447647040,101525,447748565,3,0,1,57856,0,16181901
17789,447653190,106614,447759804,5,0,1,45568,11,10615791814
17790,447674850,338148,448012998,3,0,0,4096,0,71207271
17791,447744870,769838,448514708,1,0,0,8192,6,8517456125
17792,447769270,150529,447919799,1,0,0,3072,6,289394093
17793,447769300,33602,447802902,3,0,1,55296,0,621262343
17794,447795390,12697,447808087,3,0,1,16384,0,8965222758
17795,447799210,31402,447830612,6,0,1,23040,3,5445982477
17796,447814870,747227,448562097,1,0,0,7680,6,6528698361
17797,447843570,4903,447848473,3,0,1,9216,0,3995814653
17798,447870960,159274,448030234,0,0,0,1536,6,592009610
17799,447912571,419596,448332167,7,0,0,19968,16,7057488956
17800,447915780,4420,447920200,3,0,1,11776,0,2320953404
17801,447920260,282955,448203215,3,0,0,3584,0,10027697605
17802,447926731,382744,448309475,7,0,0,94720,16,5431232495
17803,447942470,52549,447995019,6,0,1,85504,3,5952040078
17804,447958820,36660,447995480,5,0,1,10240,11,5736240990
17805,447981400,14426,447995826,5,0,1,512,11,10699108675
17806,447984930,11767,447996697,6,0,1,12288,3,7161986425
17807,447988010,174198,448162208,0,0,0,3584,6,10405784505
17808,448005530,305848,448311378,1,0,0,6144,6,4632321662
17809,448051121,461076,448512197,7,0,0,211456,16,7934310437
17810,448058520,20698,448079218,5,0,1,6144,11,4290896166
17811,448079650,1042,448080692,5,0,1,1024,11,4749643297
17812,448139590,1119077,449258667,2,0,0,390144,11,3422123474
17813,448147571,894616,449042187,7,0,0,428544,16,3712857943
17814,448151630,580057,448731687,1,0,0,3584,6,7326403576
17815,448178540,336495,448515035,0,0,0,1024,6,9434912880
17816,448180300,509180,448689480,9,0,0,77824,17,3204859764
17817,448220020,104645,448324665,3,0,1,25600,0,8247496399
17818,448224290,915474,449139764,2,0,0,175104,11,4219266591
17819,448225660,1033646,449259306,0,0,0,2048,6,2674525708
17820,448229041,1126439,449355480,7,0,0,87040,16,2419889331
17821,448234310,1614692,449849002,3,0,0,7168,0,2186724690
17822,448235881,1343963,449579844,7,0,0,209920,16,5964408138
17823,448257521,1482239,449739760,7,0,0,204288,16,5118312709
17824,448265990,1223150,449489140,9,0,0,165376,17,5554661103
17825,448279810,763048,449042858,3,0,0,2048,0,9488286553
17826,448352860,969812,449322672,9,0,0,205824,17,10537838590
17827,448376730,6754,448383484,6,0,1,7168,3,2228614742
17828,448381641,1814641,450196282,7,0,0,122880,16,5288178062
17829,448415320,7230,448422550,5,0,1,7680,11,6257817269
17830,448433060,106962,448540022,2,0,1,178176,11,9210036487
17831,448471710,72498,448544208,5,0,1,6656,11,3110890978
17832,448518360,27026,448545386,5,0,1,13824,11,5334885637
17833,448538210,819313,449357523,1,0,0,6656,6,3890020434
17834,448565460,7706,448573166,5,0,1,8192,11,4548096602
17835,448577810,2870,448580680,5,0,1,8704,11,2640238895
17836,448586301,492668,449078969,7,0,0,15360,16,8168054343
17837,448595150,2870,448598020,6,0,1,8704,3,363550963
17838,448611410,1004257,449615667,2,0,0,68608,11,3538663940
17839,448640140,2870,448643010,5,0,1,8704,11,9065313097
17840,448654280,605665,449259945,0,0,0,2048,6,4729249713
17841,448680240,15986,448696226,5,0,1,7168,11,4429895349
17842,448713770,6278,448720048,6,0,1,6656,3,6982845586
17843,448740960,585525,449326485,0,0,0,3584,6,3181982826
17844,448765070,560308,449325378,9,0,0,7168,17,10473913947
17845,448816130,5326,448821456,5,0,1,5632,11,9370680347
17846,448826860,12825,448839685,5,0,1,21504,11,9848151520
17847,448874340,889319,449763659,9,0,0,78336,17,703851830
17848,448885460,628655,449514115,9,0,0,81920,17,2285162348
17849,448910430,604800,449515230,3,0,0,3584,0,10494413976
17850,448915320,134135,449049455,5,0,1,15872,11,4016960776
17851,448915980,599889,449515869,1,0,0,2048,6,5707861426
17852,448925921,1420058,450345979,7,0,0,61440,16,1240106036
17853,448935160,114961,449050121,5,0,1,1024,11,6799601539
17854,448986680,594325,449581005,0,0,0,512,6,478482733
17855,448990930,332241,449323171,1,0,0,1536,6,1342180139
17856,448996891,1643488,450640379,7,0,0,238592,16,4463726742
17857,449000360,580474,449580834,1,0,0,1024,6,10575095298
17858,449029141,299543,449328684,7,0,0,7168,16,10059158248
17859,449040620,385070,449425690,0,0,0,1024,6,3684627309
17860,449044680,7707,449052387,5,0,1,3584,11,4523008630
17861,449047360,547388,449594748,9,0,0,45056,17,5708153138
17862,449055800,780573,449836373,3,0,0,5120,0,6809998177
17863,449087200,530362,449617562,0,0,0,6144,6,6168345100
17864,449100480,480019,449580499,1,0,0,2048,6,6620758995
17865,449157340,470571,449627911,9,0,0,29184,17,1638123921
17866,449176980,674989,449851969,0,0,0,5632,6,259606536
17867,449263500,354265,449617765,3,0,0,512,0,8192834826
17868,449360571,409031,449769602,7,0,0,19456,16,455541254
17869,449372340,470912,449843252,9,0,0,22528,17,7707108900
17870,449382430,261966,449644396,0,0,0,2048,6,5640093105
17871,449387350,582188,449969538,1,0,0,1024,6,8167197699
17872,449443420,525791,449969211,9,0,0,153088,17,5135409086
17873,449451260,176666,449627926,5,0,1,7168,11,2100484932
17874,449453341,381449,449834790,7,0,0,32768,16,8344512977
17875,449486470,660876,450147346,2,0,0,103424,11,4573798319
17876,449559990,72760,449632750,6,0,1,25088,3,5028938848
17877,449571220,68495,449639715,5,0,1,20480,11,8802614196
17878,449598240,401668,449999908,2,0,0,49152,11,4736097149
17879,449637750,214702,449852452,1,0,0,1536,6,7708855404
17880,449651370,1022798,450674168,9,0,0,23552,17,10049680716
17881,449697830,501429,450199259,3,0,0,512,0,7842119975
17882,449708670,64313,449772983,5,0,1,3584,11,5864496452
17883,449747040,661354,450408394,2,0,0,204800,11,4065066953
17884,449755930,20279,449776209,6,0,1,5120,3,8095482063
17885,449799390,266848,450066238,0,0,0,3584,6,10550089924
17886,449807970,2870,449810840,6,0,1,8704,3,10324059106
17887,449825560,742100,450567660,2,0,0,209920,11,417595927
17888,449852890,379279,450232169,1,0,0,1536,6,808746041
17889,449915370,508514,450423884,0,0,0,1536,6,8800822216
17890,449933360,490041,450423401,9,0,0,49152,17,7195858072
17891,449952970,310057,450263027,1,0,0,2048,6,8841076745
17892,449957670,792064,450749734,2,0,0,244736,11,10458774810
17893,449969630,256551,450226181,3,0,0,2048,0,4273689901
17894,449997270,643592,450640862,3,0,0,1536,0,6761477412
17895,450044080,10757,450054837,6,0,1,17408,3,5947802197
17896,450074760,592177,450666937,2,0,0,85504,11,10342616890
17897,450082170,3645,450085815,5,0,1,10240,11,8760272971
17898,450093740,53629,450147369,5,0,1,58368,11,10056991380
17899,450112140,35244,450147384,1,0,1,2048,6,2159538069
17900,450120480,37365,450157845,6,0,1,16896,3,6726125906
17901,450164940,86896,450251836,9,0,1,94720,17,6876292518
17902,450245040,430087,450675127,0,0,0,3072,6,2747586650
17903,450248800,5454,450254254,5,0,1,13824,11,6504431122
17904,450282580,5712,450288292,6,0,1,14336,3,381113207
17905,450283480,25708,450309188,9,0,1,36352,17,10075622145
17906,450285970,28364,450314334,6,0,1,8192,3,5604302881
17907,450349030,75379,450424409,5,0,1,512,11,1668060357
17908,450377360,51965,450429325,1,0,1,5632,6,10318489634
17909,450443620,26738,450470358,6,0,1,48640,3,8931850229
17910,450475920,25446,450501366,9,0,1,46080,17,9765026614
17911,450513310,236463,450749773,9,0,1,81920,17,8215377469
17912,450537000,528792,451065792,2,0,0,52736,11,1971472767
17913,450567740,342620,450910360,0,0,0,1536,6,10522686183
17914,450571030,441665,451012695,2,0,0,76800,11,10335406141
17915,450588130,175075,450763205,1,0,1,26112,6,3870898368
17916,450593001,495761,451088762,7,0,0,75264,16,3561984875
17917,450619480,243954,450863434,9,0,0,90624,17,10645255760
17918,450642340,300688,450943028,9,0,0,5120,17,232444218
17919,450655990,107676,450763666,6,0,1,10240,3,8099030566
17920,450665909,571081,451236990,4,0,0,64000,4,7394519251
17921,450667300,448184,451115484,9,0,0,87552,17,8285418386
17922,450753240,205957,450959197,9,0,1,326144,17,656042986
17923,450852420,277824,451130244,0,0,0,2048,6,9587173697
17924,450873570,531778,451405348,2,0,0,320000,11,8603254632
17925,450875840,83716,450959556,1,0,1,9728,6,4999394304
17926,450882960,129750,451012710,9,0,1,165376,17,9177844909
17927,450892780,155984,451048764,4,0,1,130560,4,1609810471
17928,450914510,517085,451431595,2,0,0,86016,11,2505267959
17929,450920730,525435,451446165,2,0,0,47104,11,6718496002
17930,450925070,506696,451431766,2,0,0,512,11,8129998274
17931,450943890,121925,451065815,6,0,1,16896,3,2416823475
17932,451014130,74655,451088785,6,0,1,20992,3,4385274614
17933,451019020,185994,451205014,1,0,0,1024,6,6431807425
17934,451052630,477568,451530198,2,0,0,14336,11,10092397423
17935,451058910,70587,451129497,1,0,1,27136,6,10146854787
17936,451061080,469445,451530525,3,0,0,1024,0,1786028356
17937,451084210,53863,451138073,4,0,1,27648,4,3735925677
17938,451093850,352798,451446648,0,0,0,1536,6,8347836754
17939,451098800,741843,451840643,9,0,0,39936,17,10232490013
17940,451119320,22939,451142259,1,0,1,6656,6,3248120575
17941,451139540,124628,451264168,9,0,1,205824,17,450239291
17942,451175140,272623,451447763,0,0,0,3584,6,1491049203
17943,451203640,96920,451300560,4,0,1,124928,4,10433719265
17944,451215321,735377,451950698,7,0,0,244736,16,7992456481
17945,451315780,341126,451656906,9,0,0,70144,17,2826356961
17946,451340680,481780,451822460,9,0,0,26624,17,7022068990
17947,451347890,99904,451447794,6,0,1,13312,3,9464646001
17948,451379520,73656,451453176,6,0,1,13824,3,9517240680
17949,451385190,71594,451456784,1,0,1,5120,6,9627165247
17950,451399030,290318,451689348,1,0,0,4608,6,9085193416
17951,451415801,44189,451459990,0,0,1,15872,6,1090339239
17952,451458310,7323,451465633,3,0,1,7680,0,2813555256
17953,451473410,300263,451773673,3,0,0,2560,0,10059097251
17954,451480320,712186,452192506,9,0,0,202752,17,6593982771
17955,451481450,329533,451810983,3,0,0,1024,0,10247763086
17956,451490890,4162,451495052,6,0,1,11264,3,3050475641
17957,451496110,265350,451761460,0,0,0,1024,6,8989897670
17958,451578590,372927,451951517,3,0,0,2560,0,1819737638
17959,451584350,3898,451588248,6,0,1,4096,3,1653788237
17960,451617890,566,451618456,1,0,1,512,6,5382927437
17961,451640760,373733,452014493,0,0,0,4096,6,2498052039
17962,451667110,122808,451789918,1,0,0,2560,6,3285969095
17963,451710730,414113,452124843,2,0,0,2560,11,3917842913
17964,451739680,3387,451743067,1,0,1,9728,6,1620805100
17965,451742360,4231,451746591,6,0,1,4096,3,10337695788
17966,451783970,566,451784536,6,0,1,512,3,6512779748
17967,451786110,407503,452193613,0,0,0,3584,6,4104502194
17968,451795590,155942,451951532,9,0,1,237568,17,5668564974
17969,451802360,727645,452530005,2,0,0,435200,11,4450427972
17970,451835930,359246,452195176,3,0,0,3072,0,6784527306
17971,451884110,310046,452194156,1,0,0,1536,6,2515575852
17972,451888370,763158,452651528,1,0,0,1024,6,3065187057
17973,451898040,59729,451957769,6,0,1,6656,3,1973335256
17974,451954820,1196694,453151514,2,0,0,324096,11,8808654142
17975,451964140,568868,452533008,0,0,0,9728,6,196294375
17976,452015200,5454,452020654,1,0,1,13824,6,818579282
17977,452019690,3387,452023077,1,0,1,9728,6,10369792032
17978,452024980,168648,452193628,9,0,1,218624,17,2179524857
17979,452035580,498535,452534115,3,0,0,3584,0,6406425803
17980,452036361,1298301,453334662,7,0,0,273920,16,5600596356
17981,452037420,156223,452193643,6,0,1,16896,3,2006291783
17982,452041690,151968,452193658,6,0,1,32768,3,4012130950
17983,452089350,104323,452193673,9,0,1,19968,17,4398257805
17984,452098520,229997,452328517,9,0,1,352768,17,6614657767
17985,452119020,215296,452334316,9,0,1,27648,17,1127165919
17986,452151290,215207,452366497,9,0,1,113152,17,1816601465
17987,452174540,360581,452535121,1,0,0,3072,6,37909191
17988,452289871,600588,452890459,7,0,0,172544,16,3052697624
17989,452307440,230208,452537648,1,0,0,8192,6,884733477
17990,452341320,30003,452371323,6,0,1,7680,3,4313754303
17991,452352170,181960,452534130,9,0,1,173056,17,1144278741
17992,452355010,223988,452578998,9,0,1,67072,17,7380307625
17993,452408720,175424,452584144,1,0,1,8192,6,10645982016
17994,452421370,254516,452675886,3,0,0,2048,0,9313282463
17995,452457640,438294,452895934,3,0,0,17920,0,6605613431
17996,452470560,154072,452624632,2,0,0,10240,11,9908496968
17997,452482590,464718,452947308,1,0,0,4608,6,10636111711
17998,452491400,454489,452945889,9,0,0,71680,17,3539239032
17999,452492430,102339,452594769,6,0,1,34304,3,1930674618
18000,452504050,94905,452598955,6,0,1,6656,3,4566133891
18001,452510069,104439,452614508,8,0,1,57856,6,1820108213
18002,452535680,78982,452614662,6,0,1,8704,3,3332818630
18003,452573870,146688,452720558,2,0,1,203264,11,8447547929
18004,452614820,189089,452803909,2,0,0,8704,11,8471669112
18005,452633390,89216,452722606,6,0,1,26112,3,8789683168
18006,452635910,264890,452900800,9,0,0,15872,17,836259582
18007,452671730,720323,453392053,9,0,0,112128,17,1961501915
18008,452695290,37634,452732924,4,0,1,40960,4,5521156577
18009,452696501,508911,453205412,7,0,0,175104,16,326078826
18010,452752360,55304,452807664,9,0,1,94208,17,1747957347
18011,452808980,343033,453152013,1,0,0,1536,6,5778850841
18012,452824880,71069,452895949,1,0,1,39424,6,6819831632
18013,452835280,499397,453334677,1,0,1,654336,6,8413668511
18014,452839250,741240,453580490,9,0,0,67072,17,9404222712
18015,452861210,473653,453334863,2,0,1,48128,11,8684593158
18016,452867670,568003,453435673,3,0,0,13312,0,6175931981
18017,452933990,400888,453334878,2,0,1,9216,11,4924688715
18018,453044750,515289,453560039,9,0,0,135168,17,1432999330
18019,453052380,282513,453334893,6,0,1,36352,3,2663015670
18020,453087660,633997,453721657,3,0,0,150016,0,1547115719
18021,453096260,324050,453420310,0,0,0,3072,6,4417637919
18022,453099690,235158,453334848,1,0,0,512,6,9480486869
18023,453128490,625003,453753493,3,0,0,93184,0,3189846792
18024,453144140,475084,453619224,3,0,0,41472,0,9178690507
18025,453149020,186999,453336019,1,0,1,18432,6,2288607859
18026,453215491,382798,453598289,7,0,0,14848,16,6177820078
18027,453232861,188205,453421066,7,0,0,512,16,7451896891
18028,453237360,516148,453753508,9,0,1,335360,17,5477295173
18029,453240970,878940,454119910,2,0,0,247296,11,439328592
18030,453315170,508303,453823473,4,0,1,61440,4,493126604
18031,453338040,262745,453600785,2,0,0,5632,11,6332101622
18032,453350760,691276,454042036,9,0,0,178176,17,2682051119
18033,453371420,616313,453987733,2,0,0,12800,11,9540919345
18034,453380570,739355,454119925,2,0,1,267776,11,7024177961
18035,453400280,764803,454165083,3,0,0,78848,0,974198015
18036,453404340,557335,453961675,3,0,0,64512,0,6601309727
18037,453421690,1027499,454449189,9,0,1,229888,17,542235523
18038,453466210,1074076,454540286,1,0,1,48128,6,8858530657
18039,453505320,478316,453983636,0,0,0,3072,6,3868315072
18040,453511540,1028761,454540301,5,0,1,43008,11,7442000610
18041,453520240,524307,454044547,1,0,0,8192,6,6307692842
18042,453531770,1330565,454862335,1,0,1,115712,6,595013101
18043,453535560,1878603,455414163,1,0,1,230912,6,254777690
18044,453551900,4085008,457636908,9,0,1,521728,17,1795137416
18045,453566750,415935,453982685,0,0,0,50176,6,5188334768
18046,453569090,4082044,457651134,6,0,1,1024,3,4816221945
18047,453594900,1267388,454862288,9,0,0,18944,17,2661142338
18048,453612420,8006124,461618544,9,0,1,638976,17,8114903526
18049,453636590,8493561,462130151,1,0,1,128000,6,8487385686
18050,453661390,8677158,462338548,9,0,1,67072,17,9782379537
18051,453695800,9039820,462735620,9,0,1,299520,17,2124511913
18052,453711830,9069372,462781202,9,0,1,36864,17,3619391047
18053,453713051,1143378,454856429,7,0,0,410112,16,6960296041
18054,453759570,780701,454540271,0,0,0,218624,6,10605859566
18055,453780560,1105714,454886274,1,0,0,512,6,8094748278
18056,453794980,8991368,462786348,6,0,1,8192,3,8771495890
18057,453815160,9124593,462939753,9,0,1,63488,17,1569267320
18058,453843861,9095915,462939776,0,0,1,5120,6,3758633708
18059,453858100,394608,454252708,3,0,0,73728,0,8989768726
18060,453875501,826598,454702099,7,0,0,17920,16,4793862570
18061,453957240,9061791,463019031,6,0,1,26112,3,3947904620
18062,453990020,11877005,465867025,9,0,1,837632,17,1388342562
18063,454023040,12002835,466025875,9,0,1,113152,17,9872630942
18064,454046350,1326279,455372629,3,0,0,20480,0,902200074
18065,454087230,13875608,467962838,9,0,1,68096,17,215101737
18066,454099330,991319,455090649,3,0,0,175104,0,1600628222
18067,454197430,1161089,455358519,9,0,0,559104,17,1345719039
18068,454228140,655395,454883535,3,0,0,15360,0,7667129073
18069,454237330,18684734,472922064,2,0,1,329216,11,9806587732
18070,454243390,203694,454447084,2,0,0,8704,11,5727582029
18071,454246770,348820,454595590,3,0,0,62464,0,4918759591
18072,454299460,18791959,473091419,9,0,1,42496,17,5221156001
18073,454302960,1585466,455888426,9,0,0,39936,17,2097984800
18074,454312460,18817604,473130064,6,0,1,7680,3,9351289718
18075,454332000,1795262,456127262,9,0,0,84480,17,4310656668
18076,454333820,19169986,473503806,9,0,1,88064,17,5954648582
18077,454399961,19103860,473503821,0,0,1,7680,6,6476923395
18078,454432360,19071476,473503836,6,0,1,14848,3,584526402
18079,454444310,1186994,455631304,2,0,0,254464,11,2416445346
18080,454466370,19070206,473536576,7,0,1,23552,16,5511273660
18081,454494870,1429256,455924126,3,0,0,50176,0,5242537695
18082,454497740,1356575,455854315,2,0,0,216576,11,7709250313
18083,454515570,1418498,455934068,1,0,0,1024,6,10597305852
18084,454518220,19018854,473537074,7,0,1,7680,16,4470584805
18085,454519721,940603,455460324,7,0,0,52224,16,9685217433
18086,454538200,18998889,473537089,7,0,1,512,16,10254712154
18087,454552900,18984204,473537104,7,0,1,5120,16,1813190267
18088,454605600,354252,454959852,1,0,0,1536,6,5775381193
18089,454619680,1130246,455749926,9,0,0,155136,17,3033654483
18090,454631121,783027,455414148,7,0,0,136192,16,8234902411
18091,454667700,18901625,473569325,6,0,1,10240,3,7805710800
18092,454694470,777019,455471489,9,0,0,31744,17,4980278175
18093,454713120,18858151,473571271,7,0,1,3072,16,4786515364
18094,454724350,1270256,455994606,3,0,0,45056,0,6616960055
18095,454757620,945023,455702643,3,0,0,233984,0,1737110089
18096,454761991,1530799,456292790,7,0,0,437248,16,5989899044
18097,454768181,18969485,473737666,0,0,1,21504,6,5441312002
18098,454793890,572468,455366358,2,0,0,25600,11,8507147681
18099,454798211,18941677,473739888,0,0,1,4608,6,9554594746
18100,454805490,18934413,473739903,7,0,1,20992,16,8226704631
18101,454832230,18907688,473739918,7,0,1,21504,16,10672874530
18102,454836850,1059793,455896643,1,0,0,2560,6,1189338255
18103,454852600,1445065,456297665,2,0,0,15872,11,4199529230
18104,454853000,18886933,473739933,6,0,1,8704,3,5184964894
18105,454860290,893091,455753381,3,0,0,11264,0,1964808543
18106,454892890,18994715,473887605,7,0,1,69632,16,3771919318
18107,454922600,19083684,474006284,6,0,1,12288,3,10382627079
18108,454948370,1520532,456468902,0,0,0,175104,6,449341610
18109,454957410,19048889,474006299,9,0,1,11776,17,6402288818
18110,454964740,19041574,474006314,7,0,1,33792,16,7055282580
18111,454966080,19163216,474129296,7,0,1,24576,16,2195972016
18112,455001200,19413798,474414998,9,0,1,124928,17,7746026066
18113,455086710,19445558,474532268,9,0,1,179200,17,5332872035
18114,455124360,1282388,456406748,9,0,0,99328,17,7944776441
18115,455138180,19394103,474532283,7,0,1,1536,16,1818693825
18116,455157010,1141638,456298648,1,0,0,3072,6,2776716888
18117,455159210,19373088,474532298,6,0,1,2560,3,199460924
18118,455183280,19349033,474532313,7,0,1,2048,16,5120154751
18119,455197691,19334637,474532328,0,0,1,2048,6,6191658346
18120,455211530,1398257,456609787,9,0,0,145408,17,4845828732
18121,455217800,19314543,474532343,7,0,1,16384,16,8568040754
18122,455259500,494068,455753568,1,0,0,512,6,3376062283
18123,455266620,19265738,474532358,6,0,1,1024,3,10250843133
18124,455292860,1528308,456821168,2,0,0,282624,11,10106669215
18125,455361140,663450,456024590,3,0,0,86016,0,1727590187
18126,455428700,326623,455755323,1,0,0,5632,6,2205336372
18127,455447160,19085221,474532381,1,0,1,31744,6,4671884785
18128,455529130,19145063,474674193,1,0,1,200192,6,528468539
18129,455532340,19289410,474821750,1,0,1,224256,6,73727447
18130,455551960,1691083,457243043,0,0,0,246272,6,3160770794
18131,455602810,1094055,456696865,3,0,0,74240,0,9254762392
18132,455603430,1355615,456959045,9,0,0,26112,17,6291242845
18133,455649760,688394,456338154,9,0,0,51200,17,5399454785
18134,455677260,19181960,474859220,1,0,1,86016,6,2408845477
18135,455702680,19156555,474859235,6,0,1,17920,3,6902281328
18136,455716450,1132221,456848671,9,0,0,90112,17,7464899908
18137,455722020,19137230,474859250,6,0,1,9216,3,4256504290
18138,455777360,19087140,474864500,7,0,1,17920,16,285099254
18139,455780040,1379366,457159406,0,0,0,112128,6,10002877009
18140,455800310,1054367,456854677,1,0,0,4608,6,10147261160
18141,455827750,19072270,474900020,1,0,1,101888,6,2667959956
18142,455845120,1873757,457718877,9,0,0,222208,17,8735957871
18143,455847470,1501200,457348670,0,0,0,346624,6,5670006657
18144,455889920,1479965,457369885,0,0,0,38912,6,8929860937
18145,455902590,19006130,474908720,6,0,1,1536,3,1748447497
18146,455909800,1665934,457575734,2,0,0,472064,11,4300762354
18147,455930960,1653057,457584017,0,0,0,27136,6,5115326994
18148,455937150,1130231,457067381,9,0,0,81408,17,4383495263
18149,455942490,19039967,474982457,1,0,1,53248,6,6791934559
18150,455948170,2158477,458106647,9,0,0,276480,17,3880228665
18151,455948400,19035850,474984250,7,0,1,1024,16,6714351625
18152,455976590,946320,456922910,0,0,0,16384,6,6190766241
18153,456014980,893500,456908480,1,0,0,512,6,6259194691
18154,456033590,1382110,457415700,0,0,0,8192,6,7009596419
18155,456033750,18950846,474984596,7,0,1,512,16,1707730831
18156,456035220,18952922,474988142,6,0,1,5632,3,2739318331
18157,456050750,1362439,457413189,3,0,0,25088,0,7483900548
18158,456082680,18966682,475049362,1,0,1,111104,6,7924186253
18159,456104620,19040887,475145507,1,0,1,93696,6,5009468308
18160,456121840,19178849,475300689,1,0,1,55808,6,7895698775
18161,456130090,1224625,457354715,9,0,0,1024,17,4931638847
18162,456154350,698876,456853226,0,0,0,14848,6,8388690689
18163,456173890,935332,457109222,1,0,0,512,6,5382782120
18164,456208180,1194668,457402848,3,0,0,108032,0,9362309720
18165,456212110,1415392,457627502,9,0,0,37376,17,8027698822
18166,456221540,19123180,475344720,7,0,1,2560,16,4701009019
18167,456255871,1360156,457616027,7,0,0,92672,16,4973240973
18168,456351050,1378020,457729070,2,0,0,28160,11,8162487947
18169,456352411,1298708,457651119,7,0,0,46592,16,7484437551
18170,456443750,18900993,475344743,6,0,1,8192,3,5946558416
18171,456461850,18882908,475344758,7,0,1,8192,16,6960753237
18172,456481270,18863503,475344773,6,0,1,3072,3,8447417047
18173,456500950,852799,457353749,0,0,0,16384,6,5530044105
18174,456501540,19280764,475782304,1,0,1,227328,6,1670027255
18175,456501610,19280717,475782327,7,0,1,17408,16,7256020809
18176,456503720,19278630,475782350,6,0,1,22528,3,2126201378
18177,456532740,632927,457165667,2,0,0,4608,11,2480223892
18178,456532870,872333,457405203,2,0,0,7680,11,7271208287
18179,456567080,19378673,475945753,1,0,1,253440,6,2926326767
18180,456574770,1955301,458530071,2,0,0,348672,11,5326521165
18181,456581170,1207262,457788432,0,0,0,126464,6,8042090604
18182,456585930,422921,457008851,0,0,0,24064,6,2636601390
18183,456602670,19345389,475948059,6,0,1,1024,3,10578470055
18184,456612370,19340515,475952885,6,0,1,7680,3,3362828716
18185,456614420,19340818,475955238,7,0,1,13312,16,10141267561
18186,456638250,19321480,475959730,1,0,1,13824,6,5157013001
18187,456659990,19302630,475962620,7,0,1,26112,16,7422655145
18188,456692050,19305202,475997252,3,0,1,39424,0,3297937107
18189,456699180,19300338,475999518,3,0,1,3584,0,8529375218
18190,456702440,384675,457087115,9,0,0,8704,17,2248112927
18191,456708570,19292254,476000824,6,0,1,2048,3,3626360567
18192,456711390,1078773,457790163,0,0,0,5632,6,4076561148
18193,456727370,19290962,476018332,1,0,1,55296,6,7641353154
18194,456735440,618948,457354388,3,0,0,2048,0,6415914531
18195,456738600,19332218,476070818,3,0,1,1536,0,5634138307
18196,456740340,1275672,458016012,0,0,0,60416,6,10280047218
18197,456743280,19327553,476070833,3,0,1,13824,0,8159534525
18198,456786960,19283888,476070848,4,0,1,23552,4,2083541983
18199,456794790,1791395,458586185,2,0,0,57344,11,3838816370
18200,456812730,19258133,476070863,6,0,1,12288,3,755618425
18201,456820790,19286083,476106873,3,0,1,70656,0,9155907910
18202,456895700,19463829,476359529,1,0,1,184320,6,814509260
18203,456915080,721813,457636893,3,0,0,30720,0,5815626023
18204,456916820,19443231,476360051,1,0,1,56320,6,4133998507
18205,456933120,19426946,476360066,6,0,1,7680,3,2592227172
18206,456948410,19411671,476360081,6,0,1,14848,3,8464983552
18207,456961360,444170,457405530,1,0,0,1024,6,10208702252
18208,456969470,19390626,476360096,1,0,1,3072,6,5911549480
18209,456970470,19389641,476360111,7,0,1,2048,16,4824399669
18210,457004170,19375627,476379797,1,0,1,56320,6,6633378120
18211,457007850,19384767,476392617,4,0,1,35328,4,282140904
18212,457032091,325923,457358014,7,0,0,10752,16,7485840884
18213,457045790,19350053,476395843,6,0,1,5120,3,6918441293
18214,457051330,1140956,458192286,9,0,0,7680,17,5959030661
18215,457058440,19340949,476399389,6,0,1,5632,3,6890361751
18216,457074831,512945,457587776,7,0,0,12288,16,3756286244
18217,457084660,896049,457980709,2,0,0,93696,11,3852011972
18218,457110480,1215796,458326276,2,0,0,73728,11,8140451998
18219,457147581,979993,458127574,7,0,0,68608,16,10572349303
18220,457164140,630718,457794858,3,0,0,15360,0,4271641696
18221,457204390,514822,457719212,1,0,0,1024,6,4003215362
18222,457205840,650936,457856776,2,0,0,8192,11,5338430712
18223,457206730,19196205,476402935,3,0,1,5632,0,8622445456
18224,457208820,19245365,476454185,7,0,1,43520,16,9792178962
18225,457223601,1336985,458560586,7,0,0,99840,16,3790633215
18226,457224180,496295,457720475,1,0,0,4096,6,4049461701
18227,457245220,19208980,476454200,6,0,1,512,3,2058942324
18228,457248800,959167,458207967,3,0,0,2048,0,5427029785
18229,457252890,19719063,476971953,4,0,1,475648,4,1381538561
18230,457305630,1501565,458807195,9,0,0,90624,17,2683737199
18231,457413971,573461,457987432,7,0,0,22016,16,9105505422
18232,457433730,990090,458423820,3,0,0,111104,0,10702261126
18233,457452950,19519018,476971968,6,0,1,17408,3,5023751196
18234,457453180,1115473,458568653,9,0,0,26112,17,677329577
18235,457454851,429909,457884760,7,0,0,8192,16,2116845252
18236,457458900,2135726,459594626,2,0,0,78848,11,185771073
18237,457479350,19923935,477403285,1,0,1,167424,6,2045889178
18238,457507430,19895870,477403300,3,0,1,9216,0,8113523753
18239,457512641,315250,457827891,7,0,0,2048,16,1837888280
18240,457542410,19941504,477483914,1,0,1,95232,6,9986616629
18241,457581330,1420431,459001761,9,0,0,75264,17,10348075197
18242,457685140,19937384,477622524,4,0,1,147968,4,7959406323
18243,457694430,1512338,459206768,9,0,0,130048,17,9776236555
18244,457715590,19930257,477645847,1,0,1,84992,6,4727654121
18245,457725070,456812,458181882,3,0,0,49152,0,2785361225
18246,457743501,2411975,460155476,7,0,0,297984,16,1001408446
18247,457750580,19911174,477661754,1,0,1,49152,6,9629633729
18248,457818091,1068844,458886935,7,0,0,55296,16,6812898746
18249,457822220,19872686,477694906,6,0,1,31744,3,8172536491
18250,457827490,1562260,459389750,0,0,0,492544,6,5723198487
18251,457831821,2406497,460238318,7,0,0,39424,16,2615432669
18252,457838170,19880818,477718988,4,0,1,82432,4,9163871970
18253,457912440,2692244,460604684,2,0,0,529920,11,7261630111
18254,457931190,19843548,477774738,4,0,1,49664,4,7649483412
18255,457945970,19929724,477875694,1,0,1,243712,6,9584711758
18256,457959740,19940970,477900710,4,0,1,74240,4,7875357203
18257,457986431,793137,458779568,7,0,0,118784,16,8226791109
18258,457992120,847982,458840102,9,0,0,23552,17,6665557228
18259,458001550,1108279,459109829,0,0,0,84992,6,4344503426
18260,458017100,19911119,477928219,7,0,1,51200,16,7934320366
18261,458038990,20081349,478120339,4,0,1,423936,4,3412044488
18262,458091600,887214,458978814,3,0,0,129536,0,6202141788
18263,458170490,20092272,478262762,4,0,1,211968,4,2669129726
18264,458191080,20087239,478278319,7,0,1,3584,16,8114992360
18265,458207281,2465653,460672934,7,0,0,41984,16,5732161166
18266,458236150,20222157,478458307,1,0,1,307712,6,10667809925
18267,458242610,20228818,478471428,7,0,1,26624,16,10221124233
18268,458271460,1209565,459481025,2,0,0,156672,11,4436573173
18269,458284370,20298530,478582900,2,0,1,268800,11,7461824372
18270,458286571,2738989,461025560,7,0,0,3072,16,5669784276
18271,458294410,1253725,459548135,2,0,0,105472,11,8075016946
18272,458294830,20297887,478592717,7,0,1,22016,16,9124784406
18273,458342780,20283161,478625941,1,0,1,83456,6,7042824452
18274,458405070,2751716,461156786,9,0,0,104960,17,2177154468
18275,458408710,20225923,478634633,7,0,1,13824,16,789303347
18276,458418160,20223591,478641751,4,0,1,20480,4,2230630332
18277,458448330,566141,459014471,1,0,0,1024,6,6318891378
18278,458492270,20156416,478648686,4,0,1,32768,4,5665999804
18279,458493560,20155382,478648942,7,0,1,9216,16,3897089724
18280,458502180,20213315,478715495,1,0,1,145920,6,10504219848
18281,458522900,993084,459515984,2,0,0,114688,11,7569648
18282,458528710,862367,459391077,1,0,0,4096,6,239105983
18283,458530270,20362943,478893213,1,0,1,309248,6,6577897360
18284,458543800,20349428,478893228,7,0,1,25600,16,555051035
18285,458558251,1187596,459745847,7,0,0,152576,16,3892232297
18286,458622941,2901334,461524275,7,0,0,521216,16,2042129698
18287,458642920,20313233,478956153,1,0,1,120320,6,10230373446
18288,458681880,20356329,479038209,1,0,1,177152,6,10202210782
18289,458684390,20379624,479064014,7,0,1,6144,16,10636297075
18290,458753970,1189490,459943460,2,0,0,135168,11,645446989
18291,458760890,20463478,479224368,1,0,1,276992,6,1854941355
18292,458817650,1622271,460439921,9,0,0,415744,17,5065337733
18293,458820510,20415855,479236365,7,0,1,36864,16,1816398900
18294,458857010,3045080,461902090,9,0,0,362496,17,6928820182
18295,458870080,20381265,479251345,4,0,1,33792,4,5997383253
18296,458871780,1335363,460207143,3,0,0,169472,0,3163222889
18297,458902310,646012,459548322,1,0,0,512,6,2543003387
18298,458940311,1687476,460627787,7,0,0,75776,16,8686340450
18299,458945310,20461133,479406443,1,0,1,220160,6,352164187
18300,458945760,20472255,479418015,1,0,1,19456,6,2640749049
18301,458961080,3031077,461992157,3,0,0,128512,0,10407434469
18302,458968711,20483201,479451912,0,0,1,19456,6,9992355936
18303,458981360,3250598,462231958,2,0,0,147968,11,8850822088
18304,458983210,20473208,479456418,7,0,1,7168,16,8348863044
18305,459061430,3068052,462129482,0,0,0,230400,6,3011247161
18306,459072650,3390257,462462907,2,0,0,168960,11,3524895941
18307,459115120,1672525,460787645,0,0,0,133120,6,5031536856
18308,459139750,20555251,479695001,1,0,1,329216,6,8173618231
18309,459155450,20634390,479789840,1,0,1,264192,6,8138481708
18310,459156520,20642282,479798802,7,0,1,3584,16,4023084951
18311,459159640,3416002,462575642,3,0,0,148480,0,344039493
18312,459165080,3515731,462680811,0,0,0,237568,6,1220714295
18313,459179200,2439158,461618358,9,0,0,308736,17,4762165098
18314,459219121,2511056,461730177,7,0,0,76800,16,8584754052
18315,459227021,1466486,460693507,7,0,0,25088,16,8169561689
18316,459261100,20543091,479804191,7,0,1,17408,16,5249155274
18317,459275940,1164340,460440280,9,0,0,1024,17,9580933970
18318,459347540,2597303,461944843,9,0,0,99328,17,6143720038
18319,459351171,20490215,479841386,0,0,1,20480,6,3042864928
18320,459351900,1437164,460789064,1,0,0,4608,6,8750577747
18321,459355540,3549045,462904585,0,0,0,286208,6,2838302923
18322,459388041,20453704,479841745,0,0,1,9728,6,1698582392
18323,459414960,1213014,460627974,1,0,0,512,6,1332731473
18324,459502490,1309791,460812281,1,0,0,1024,6,3757884790
18325,459520660,20337664,479858324,3,0,1,55296,0,9103360863
18326,459524150,20560017,480084167,1,0,1,394752,6,2893304015
18327,459548871,20553744,480102615,0,0,1,54784,6,7922812922
18328,459644610,20476643,480121253,3,0,1,6656,0,7103304182
18329,459742810,1046425,460789235,1,0,0,512,6,758870397
18330,459760110,20378702,480138812,1,0,1,41984,6,8701166670
18331,459760740,1970256,461730996,1,0,0,2560,6,1669738405
18332,459781080,3219981,463001061,3,0,0,160768,0,8091421754
18333,459806140,1432873,461239013,3,0,0,269824,0,556547390
18334,459819270,2488541,462307811,0,0,0,27136,6,10507123911
18335,459866850,20273038,480139888,1,0,1,13312,6,5207655477
18336,459886361,20258673,480145034,0,0,1,8192,6,4294850821
18337,459933330,2561104,462494434,3,0,0,103424,0,10590524569
18338,459970800,1735751,461706551,3,0,0,288768,0,8080000323
18339,459980410,1811177,461791587,9,0,0,198656,17,891049215
18340,460076980,1982287,462059267,3,0,0,219648,0,1898386707
18341,460087120,1531409,461618529,1,0,0,512,6,8274606731
18342,460106020,1600702,461706722,1,0,0,512,6,1123125038
18343,460138810,1775738,461914548,3,0,0,8704,0,2577735173
18344,460183620,3132059,463315679,3,0,0,304128,0,3500862327
18345,460191430,1048433,461239863,1,0,0,512,6,9321033307
18346,460204131,19944726,480148857,0,0,1,13312,6,6070147482
18347,460223610,1016082,461239692,8,0,0,2048,6,465540421
18348,460224460,19927087,480151547,5,0,1,4096,11,9216870931
18349,460232020,19945614,480177634,5,0,1,33280,11,3335760479
18350,460316750,1636236,461952986,3,0,0,26624,0,3578406252
18351,460332541,19845439,480177980,0,0,1,512,6,4644619349
18352,460344560,924435,461268995,9,0,0,5632,17,10666569392
18353,460359490,19895745,480255235,1,0,1,156672,6,3857286099
18354,460476501,19801619,480278120,0,0,1,49664,6,6090306280
18355,460508671,19772995,480281666,0,0,1,5632,6,3995004785
18356,460563630,19779814,480343444,1,0,1,150016,6,5108923841
18357,460577970,2811607,463389577,0,0,0,126976,6,6377769902
18358,460619210,19856783,480475993,1,0,1,245760,6,1164978678
18359,460642660,20042424,480685084,1,0,1,168960,6,8819939430
18360,460734890,1176943,461911833,3,0,0,31744,0,9431079512
18361,460749411,19935688,480685099,0,0,1,5120,6,596628862
18362,460770910,1567140,462338050,3,0,0,36352,0,6087134232
18363,460821171,19863943,480685114,0,0,1,1024,6,9776076293
18364,460898630,19786499,480685129,5,0,1,3584,11,1235052209
18365,460907120,19937609,480844729,1,0,1,314368,6,2253567611
18366,460917070,1075258,461992328,1,0,0,512,6,4617122328
18367,460948030,19928894,480876924,1,0,1,36864,6,1856780417
18368,460948600,20041639,480990239,9,0,1,239616,17,3951693537
18369,460960140,1169669,462129809,1,0,0,1024,6,3462850962
18370,461007220,20008220,481015440,5,0,1,42496,11,4956109263
18371,461038601,19979105,481017706,0,0,1,3584,6,10304541710
18372,461052730,1077406,462130136,1,0,0,1024,6,7403430460
18373,461064910,20052410,481117320,9,0,1,188416,17,6040367699
18374,461107170,20011226,481118396,5,0,1,13312,11,8155321199
18375,461116290,1623192,462739482,1,0,0,7168,6,2461529592
18376,461143730,1590612,462734342,9,0,0,175616,17,5636015891
18377,461153630,2502632,463656262,3,0,0,500736,0,6460086863
18378,461183380,1003479,462186859,3,0,0,33280,0,2614935260
18379,461252720,979409,462232129,1,0,0,512,6,9430247309
18380,461259110,19866221,481125331,1,0,1,30720,6,10638358173
18381,461300540,19923289,481223829,9,0,1,147968,17,7483797844
18382,461314250,1883283,463197533,0,0,0,294912,6,2358208334
18383,461324980,19905980,481230960,5,0,1,19456,11,5453473534
18384,461334490,841982,462176472,0,0,0,104448,6,2975840115
18385,461398060,19833668,481231728,5,0,1,11776,11,6109027807
18386,461448920,19801623,481250543,5,0,1,21504,11,8446717296
18387,461451890,938872,462390762,0,0,0,9728,6,8716040661
18388,461462320,1034937,462497257,1,0,0,9216,6,8406594140
18389,461463320,19794507,481257827,5,0,1,43008,11,7676491975
18390,461471030,19837782,481308812,9,0,1,94720,17,8271633572
18391,461509630,1097735,462607365,0,0,0,87552,6,700055087
18392,461521810,20329281,481851091,1,0,1,451072,6,3136331607
18393,461537320,2234508,463771828,9,0,0,132096,17,9003112615
18394,461571160,20300873,481872033,1,0,1,44544,6,433989620
18395,461578990,1195771,462774761,0,0,0,115712,6,6107188607
18396,461584641,20287407,481872048,0,0,1,8192,6,3795046315
18397,461620300,20640671,482260971,9,0,1,278016,17,10336233377
18398,461642910,1464744,463107654,3,0,0,290816,0,1545710990
18399,461695501,20565829,482261330,0,0,1,9728,6,7088914869
18400,461711150,20590266,482301416,9,0,1,25600,17,1864957582
18401,461754940,20838499,482593439,4,0,1,148992,4,5247924869
18402,461774080,564453,462338533,1,0,0,1536,6,2621228156
18403,461794280,21019897,482814177,9,0,1,282112,17,4794375362
18404,461800911,21013281,482814192,0,0,1,1024,6,3916846980
18405,461824890,20989317,482814207,5,0,1,10752,11,5168038217
18406,461835541,20978681,482814222,0,0,1,19456,6,7092920920
18407,461838420,21079620,482918040,4,0,1,80896,4,6235102694
18408,461852490,21090072,482942562,4,0,1,61440,4,5146946136
18409,461857030,21162256,483019286,5,0,1,22528,11,7216508691
18410,461874280,21145877,483020157,5,0,1,12288,11,1403236019
18411,461874500,21172977,483047477,5,0,1,22016,11,6264359867
18412,461904561,21145182,483049743,0,0,1,3584,6,10093179608
18413,461911240,21192123,483103363,5,0,1,26112,11,371691835
18414,461929581,21173797,483103378,0,0,1,1536,6,4160747135
18415,461932620,21279594,483212214,4,0,1,240640,4,6817187867
18416,461939360,668956,462608316,1,0,0,3072,6,6393203322
18417,461949870,21273196,483223066,9,0,1,39424,17,7313363787
18418,461953640,1065376,463019016,9,0,0,58880,17,5811971058
18419,461959080,1263920,463223000,0,0,0,83456,6,911666644
18420,461975400,21296427,483271827,4,0,1,45056,4,6334215913
18421,461983610,956120,462939730,0,0,0,113664,6,4745374743
18422,461988120,1926382,463914502,9,0,0,100864,17,765452388
18423,461992880,742725,462735605,1,0,0,4096,6,2950011500
18424,461995840,21370644,483366484,5,0,1,2560,11,4544748344
18425,462000411,21436165,483436576,0,0,1,34816,6,3338394706
18426,462004650,21447030,483451680,4,0,1,28672,4,7447177608
18427,462047850,21444213,483492063,9,0,1,56320,17,100292911
18428,462049560,2119768,464169328,3,0,0,225280,0,3871344819
18429,462058940,21665945,483724885,1,0,1,213504,6,1489273158
18430,462075640,661555,462737195,0,0,0,5120,6,9211273073
18431,462076870,21760271,483837141,5,0,1,69120,11,5973524609
18432,462124121,21713035,483837156,0,0,1,2560,6,5085108446
18433,462126670,778086,462904756,1,0,0,512,6,9794150791
18434,462176780,21660391,483837171,5,0,1,4608,11,8071348695
18435,462185531,21651655,483837186,0,0,1,8704,6,7021509969
18436,462267100,1132991,463400091,3,0,0,33792,0,3392600582
18437,462268310,21568923,483837233,4,0,1,57856,4,3664035570
18438,462285290,21557777,483843067,9,0,1,40448,17,7912737107
18439,462321740,21616062,483937802,9,0,1,135680,17,8340187657
18440,462342700,562383,462905083,6,0,0,1024,3,2236055609
18441,462503170,959515,463462685,3,0,0,30208,0,1576391977
18442,462536460,1777234,464313694,0,0,0,214016,6,7716109000
18443,462537970,946564,463484534,0,0,0,48640,6,1792728036
18444,462543811,21449923,483993734,0,0,1,74240,6,3005426793
18445,462546070,402034,462948104,1,0,0,2560,6,10398726815
18446,462597030,21407840,484004870,5,0,1,19968,11,4895695637
18447,462600300,21421524,484021824,5,0,1,29696,11,3952198586
18448,462606361,21418369,484024730,0,0,1,4608,6,1011977086
18449,462613880,1241033,463854913,0,0,0,51200,6,10152204915
18450,462636360,714458,463350818,3,0,0,115200,0,2223822717
18451,462643670,1193421,463837091,3,0,0,214016,0,976759273
18452,462646839,21382717,484029556,8,0,1,7680,6,2607142016
18453,462657359,21377023,484034382,8,0,1,7680,6,818997697
18454,462673480,1885453,464558933,1,0,0,233472,6,4234198628
18455,462680610,21395206,484075816,5,0,1,21504,11,761107397
18456,462688291,21387540,484075831,0,0,1,6656,6,183380475
18457,462714530,1016947,463731477,1,0,0,246784,6,9239713137
18458,462740360,21335486,484075846,4,0,1,12288,4,3556275068
18459,462753591,21324508,484078099,0,0,1,17920,6,5098965766
18460,462771720,681738,463453458,1,0,0,175104,6,10670072438
18461,462798670,21372469,484171139,4,0,1,84480,4,5409047023
18462,462871890,517866,463389756,1,0,0,512,6,4060113287
18463,462905390,1093425,463998815,3,0,0,155136,0,2068137487
18464,463095849,21075305,484171154,8,0,1,4096,6,5834965546
18465,463108040,1259029,464367069,1,0,0,175104,6,37330192
18466,463120390,21052066,484172456,4,0,1,47616,4,10273658076
18467,463140460,1552003,464692463,1,0,0,171520,6,4161507922
18468,463168830,1215258,464384088,1,0,0,55808,6,7664877864
18469,463173520,1028591,464202111,0,0,0,107520,6,5598119963
18470,463279909,20892562,484172471,8,0,1,4608,6,6006339804
18471,463285850,21047556,484333406,4,0,1,299008,4,2348257190
18472,463329140,21063156,484392296,4,0,1,109568,4,3077090687
18473,463330340,1675456,465005796,0,0,0,404992,6,8002801479
18474,463331720,720470,464052190,9,0,0,175104,17,5471023265
18475,463332820,506470,463839290,1,0,0,7168,6,10682040465
18476,463336130,21145963,484482093,4,0,1,108544,4,7233655981
18477,463400870,1362368,464763238,0,0,0,14336,6,2232082105
18478,463480600,572261,464052861,9,0,0,2048,17,4403834107
18479,463485241,21007733,484492974,0,0,1,17408,6,346760567
18480,463488161,21008039,484496200,0,0,1,5120,6,5388221567
18481,463503100,21602868,485105968,4,0,1,279040,4,4906606418
18482,463546620,1733317,465279937,9,0,0,94720,17,5579815605
18483,463572980,2534558,466107538,1,0,0,35328,6,9024212937
18484,463580850,21564740,485145590,5,0,1,12288,11,1508585390
18485,463636941,21512195,485149136,0,0,1,5632,6,1079941445
18486,463650100,742303,464392403,3,0,0,27136,0,9321364353
18487,463665580,1850544,465516124,9,0,0,331264,17,10046547178
18488,463682960,1870619,465553579,3,0,0,122880,0,5641370230
18489,463762650,21650820,485413470,6,0,1,21504,3,839713207
18490,463782950,1932273,465715223,3,0,0,125440,0,9492069524
18491,463829890,585856,464415746,9,0,0,23040,17,6034522602
18492,463834500,21586800,485421300,5,0,1,16896,11,4281152916
18493,463856460,21565806,485422266,5,0,1,7680,11,771090692
18494,463915220,21527745,485442965,5,0,1,35328,11,8625088928
18495,463921940,792906,464714846,9,0,0,49664,17,6308186556
18496,463944050,661357,464605407,0,0,0,32256,6,2958698582
18497,463945650,21497338,485442988,5,0,1,7168,11,5460129057
18498,463969840,832505,464802345,0,0,0,62464,6,748769121
18499,463995530,21447473,485443003,5,0,1,23040,11,9785281372
18500,464002400,21442544,485444944,5,0,1,47616,11,456591812
18501,464013950,21503112,485517062,6,0,1,22528,3,448012819
18502,464014590,21502495,485517085,5,0,1,11776,11,3507742174
18503,464037570,21479538,485517108,6,0,1,24576,3,7628826099
18504,464054220,800568,464854788,3,0,0,50176,0,5220611118
18505,464088950,2269070,466358020,9,0,0,281600,17,478993225
18506,464096690,21447460,485544150,5,0,1,66560,11,1016578935
18507,464115850,919305,465035155,0,0,0,96256,6,834610820
18508,464159120,21385069,485544189,6,0,1,8704,3,8451006823
18509,464228850,1009001,465237851,9,0,0,28160,17,3487846025
18510,464233400,21310812,485544212,5,0,1,36864,11,4331128127
18511,464255010,2222656,466477666,3,0,0,99840,0,2829151844
18512,464302301,21241942,485544243,0,0,1,13312,6,8727100874
18513,464309580,878314,465187894,1,0,0,92160,6,1080509993
18514,464311330,1344107,465655437,9,0,0,231936,17,9683400101
18515,464319760,21224498,485544258,5,0,1,4608,11,6026132938
18516,464337440,2339266,466676706,0,0,0,138240,6,6524656743
18517,464346840,1583509,465930349,9,0,0,122880,17,5375941273
18518,464386270,1177012,465563282,0,0,0,31744,6,2900781710
18519,464392911,21151378,485544289,0,0,1,4096,6,2079246878
18520,464406550,2691006,467097556,1,0,0,245248,6,3184663888
18521,464428960,1660626,466089586,1,0,0,43008,6,1101754728
18522,464489830,2348543,466838373,9,0,0,77312,17,8928619910
18523,464533390,21046633,485580023,4,0,1,89088,4,530763586
18524,464545050,684198,465229248,9,0,0,97280,17,1761871643
18525,464549920,21035288,485585208,5,0,1,16384,11,6432403291
18526,464552681,21034153,485586834,0,0,1,2560,6,7929773326
18527,464589590,2041526,466631116,1,0,0,167424,6,9958792208
18528,464609950,20982030,485591980,5,0,1,8192,11,9004282882
18529,464612220,1234726,465846946,9,0,0,9216,17,3329715929
18530,464629500,1047480,465676980,3,0,0,70656,0,10230781984
18531,464657261,20975738,485632999,0,0,1,25088,6,10518680521
18532,464669301,20963713,485633014,0,0,1,17408,6,2952426869
18533,464726210,1117889,465844099,0,0,0,159744,6,2086142886
18534,464735250,2079544,466814794,0,0,0,33792,6,1470489573
18535,464764411,20878435,485642846,0,0,1,32256,6,3929664132
18536,464887521,20759511,485647032,0,0,1,6656,6,6021117438
18537,464893320,1553911,466447231,1,0,0,71680,6,2882858417
18538,464982690,20664688,485647378,5,0,1,512,11,6958825829
18539,465057700,524193,465581893,0,0,0,60928,6,9634121763
18540,465090650,2270175,467360825,0,0,0,40448,6,298587523
18541,465100460,2488167,467588627,9,0,0,232448,17,5902374720
18542,465133670,20520506,485654176,5,0,1,19968,11,963902173
18543,465153510,20526817,485680327,5,0,1,55296,11,10331296594
18544,465199440,1435131,466634571,1,0,0,11264,6,8224553133
18545,465214660,20466128,485680788,9,0,1,10240,17,6588250499
18546,465240320,20440622,485680942,6,0,1,8704,3,6752279710
18547,465253431,20442775,485696206,0,0,1,6144,6,9785027395
18548,465260520,2702255,467962775,2,0,0,409600,11,7606271573
18549,465266310,2471050,467737360,3,0,0,199680,0,3665929595
18550,465298350,1804689,467103039,3,0,0,17920,0,5156912996
18551,465377070,557514,465934584,0,0,0,13824,6,10620263313
18552,465384530,1293143,466677673,0,0,0,3072,6,624139749
18553,465422260,20286484,485708744,5,0,1,48128,11,5296062100
18554,465456879,20294329,485751208,8,0,1,49664,6,10101079379
18555,465459701,20300851,485760552,0,0,1,512,6,5652236523
18556,465465830,1653572,467119402,1,0,0,12288,6,6816153329
18557,465488300,20599618,486087918,9,0,1,431104,17,8287245235
18558,465496720,628461,466125181,3,0,0,57856,0,4819414598
18559,465525911,20565873,486091784,0,0,1,6144,6,10054640433
18560,465529870,1023132,466553002,0,0,0,171008,6,139311642
18561,465555700,20537390,486093090,6,0,1,2048,3,9962058813
18562,465561920,1004373,466566293,2,0,0,43520,11,814550865
18563,465583781,20513436,486097217,0,0,1,1024,6,2510439807
18564,465589541,20516279,486105820,0,0,1,23552,6,4622649273
18565,465668530,20455419,486123949,9,0,1,55296,17,1606248745
18566,465689510,20446008,486135518,5,0,1,4096,11,6908677801
18567,465712680,2414298,468126978,2,0,0,391680,11,10731701674
18568,465721560,1051232,466772792,9,0,0,51200,17,6163061272
18569,465722050,20423877,486145927,6,0,1,2048,3,6536923418
18570,465738690,2465226,468203916,0,0,0,183296,6,9677103140
18571,465773460,20375373,486148833,6,0,1,4608,3,10386584068
18572,465793380,20364440,486157820,5,0,1,27648,11,3415901392
18573,465794210,20363866,486158076,5,0,1,9216,11,1726245991
18574,465796711,20388696,486185407,0,0,1,13824,6,2232729612
18575,465812270,20373701,486185971,6,0,1,10752,3,4201412701
18576,465833880,20357583,486191463,5,0,1,17920,11,484583441
18577,465835320,1106582,466941902,2,0,0,10240,11,2980981846
18578,465858780,2436909,468295689,1,0,0,245248,6,2547911320
18579,465888540,915935,466804475,0,0,0,103936,6,6816665957
18580,465897049,20346224,486243273,8,0,1,50688,6,9097794682
18581,465903620,1772885,467676505,0,0,0,111104,6,5743302279
18582,465926480,20325368,486251848,6,0,1,26112,3,10454706262
18583,465942850,20313184,486256034,6,0,1,18944,3,4654111989
18584,465950680,20482463,486433143,2,0,1,234496,11,985651119
18585,465954710,20534074,486488784,9,0,1,69120,17,8472050810
18586,465956240,2922802,468879042,1,0,0,370176,6,9219810580
18587,465984211,20521415,486505626,0,0,1,15360,6,4986358017
18588,465996330,20512842,486509172,6,0,1,5632,3,10451702370
18589,465998010,3412382,469410392,9,0,0,333824,17,10272826534
18590,466015800,2658905,468674705,3,0,0,32768,0,7810871357
18591,466018200,3134490,469152690,2,0,0,81408,11,246252873
18592,466021350,20489768,486511118,6,0,1,3072,3,6201361858
18593,466024780,20497205,486521985,6,0,1,22528,3,9770653036
18594,466026840,20499323,486526163,5,0,1,15360,11,7083743513
18595,466028380,2661255,468689635,9,0,0,4096,17,5026049938
18596,466030610,2579793,468610403,2,0,0,421376,11,1500466055
18597,466031510,20571051,486602561,6,0,1,25600,3,9180357359
18598,466070380,20532196,486602576,9,0,1,48640,17,10269594967
18599,466084550,20560645,486645195,9,0,1,94720,17,3610408617
18600,466084960,1421067,467506027,3,0,0,24064,0,331952949
18601,466090461,20592116,486682577,0,0,1,30720,6,8420338190
18602,466095231,20592165,486687396,0,0,1,3072,6,3833819850
18603,466106719,20582623,486689342,8,0,1,3072,6,9012595747
18604,466106790,3201803,469308593,1,0,0,292864,6,8754919253
18605,466132129,20611201,486743330,8,0,1,6144,6,5780500229
18606,466177420,828909,467006329,0,0,0,38400,6,8196320296
18607,466194040,20549305,486743345,5,0,1,6656,11,6804487311
18608,466201720,20561235,486762955,9,0,1,50176,17,737693859
18609,466206970,20605188,486812158,9,0,1,57856,17,1716859320
18610,466230929,20588663,486819592,8,0,1,16896,6,7816974597
18611,466250090,2414616,468664706,1,0,0,178176,6,9714044358
18612,466295100,20545413,486840513,5,0,1,16384,11,7351914402
18613,466301730,3315214,469616944,2,0,0,368640,11,2848132279
18614,466332600,20591844,486924444,9,0,1,75776,17,449145225
18615,466337959,20586500,486924459,8,0,1,6144,6,10460495861
18616,466358781,20565693,486924474,0,0,1,25088,6,1340190812
18617,466361211,20567860,486929071,0,0,1,11264,6,282167344
18618,466370870,20644202,487015072,9,0,1,157184,17,4727165305
18619,466376730,20673444,487050174,6,0,1,37376,3,4736736549
18620,466379670,20676508,487056178,9,0,1,20480,17,8514083307
18621,466398701,20664054,487062755,0,0,1,2560,6,7877583007
18622,466402530,2079470,468482000,1,0,0,111104,6,4835107375
18623,466445900,1552132,467998032,1,0,0,109568,6,5990763937
18624,466446410,20630287,487076697,6,0,1,10752,3,8593643197
18625,466476521,20609795,487086316,0,0,1,13312,6,8447020824
18626,466503910,20590036,487093946,5,0,1,23040,11,10387576083
18627,466508780,20590635,487099415,6,0,1,3072,3,319518091
18628,466591010,20513220,487104230,5,0,1,15872,11,5212274321
18629,466635470,863210,467498680,3,0,0,45568,0,295069385
18630,466672510,1543901,468216411,9,0,0,40960,17,5697763770
18631,466682580,1615308,468297888,9,0,0,7168,17,1801737706
18632,466752870,1695263,468448133,9,0,0,176640,17,1737257749
18633,466767580,20466783,487234363,9,0,1,259072,17,9671185936
18634,466823200,20417615,487240815,6,0,1,10240,3,2665508953
18635,466851730,1112863,467964593,2,0,0,5632,11,798960350
18636,466859770,2191208,469050978,3,0,0,26624,0,8820282692
18637,466876300,20368637,487244937,3,0,1,15360,0,3360541293
18638,466896430,2056883,468953313,1,0,0,243712,6,3225677947
18639,466909220,20350197,487259417,9,0,1,49152,17,1856570133
18640,466912370,20347406,487259776,5,0,1,9728,11,1636417337
18641,466949089,2916074,469865163,4,0,0,373760,4,5724685543
18642,466950470,2925848,469876318,3,0,0,36352,0,2253228734
18643,466967640,20321955,487289595,9,0,1,59904,17,2398073167
18644,466967850,2511868,469479718,0,0,0,101376,6,5056352929
18645,467015009,765981,467780990,4,0,0,7168,4,10587394877
18646,467020960,1127093,468148053,9,0,0,69120,17,10215952243
18647,467093950,20203505,487297455,9,0,1,22016,17,3261794459
18648,467161840,1059110,468220950,2,0,0,14848,11,2171346010
18649,467164920,1229378,468394298,2,0,0,104960,11,9644271275
18650,467165170,20279117,487444287,9,0,1,233984,17,9294545132
18651,467170170,1872657,469042827,0,0,0,100864,6,8418522089
18652,467196700,1536950,468733650,0,0,0,144384,6,8171745832
18653,467213680,20237986,487451666,2,0,1,34816,11,518606676
18654,467239690,2511546,469751236,0,0,0,102912,6,10275052907
18655,467242100,2736672,469978772,0,0,0,58368,6,3319181924
18656,467266130,2845118,470111248,0,0,0,155136,6,1419146381
18657,467314100,2190485,469504585,0,0,0,81408,6,9195626589
18658,467316200,1372092,468688292,0,0,0,44544,6,5285515454
18659,467333300,2724510,470057810,2,0,0,144896,11,5348914775
18660,467333990,1793881,469127871,2,0,0,97280,11,1704337278
18661,467352290,20106859,487459149,2,0,1,11264,11,9648097447
18662,467376470,20089451,487465921,6,0,1,10752,3,3248347951
18663,467411959,1686257,469098216,4,0,0,25600,4,6464292738
18664,467466110,20565367,488031477,2,0,1,439808,11,5783609333
18665,467476310,20973199,488449509,2,0,1,136704,11,7261445738
18666,467498600,2687981,470186581,3,0,0,13312,0,7368308833
18667,467530200,20944250,488474450,6,0,1,15360,3,6897532083
18668,467533300,21228042,488761342,2,0,1,269312,11,2628628699
18669,467548230,21262930,488811160,2,0,1,77824,11,8101654452
18670,467563780,21247395,488811175,6,0,1,4096,3,6666200136
18671,467585140,21226058,488811198,5,0,1,45056,11,2377481140
18672,467587230,2476735,470063965,2,0,0,19968,11,7030832038
18673,467603360,2644967,470248327,9,0,0,38400,17,8045693203
18674,467668790,1070039,468738829,0,0,0,16896,6,10526811267
18675,467670240,2531943,470202183,9,0,0,40448,17,2727419405
18676,467672840,1417465,469090305,0,0,0,129024,6,8309039727
18677,467676930,21229891,488906821,9,0,1,114176,17,2474328048
18678,467681499,2755630,470437129,4,0,0,102400,4,3259998663
18679,467694870,1317178,469012048,2,0,0,192512,11,7946944811
18680,467739690,21279028,489018718,9,0,1,102400,17,10350481050
18681,467778260,21240489,489018749,5,0,1,24064,11,8962386646
18682,467837260,21181504,489018764,5,0,1,7168,11,1103575642
18683,467838310,21209048,489047358,9,0,1,90624,17,9803504534
18684,467840930,1870472,469711402,1,0,0,77824,6,3935893764
18685,467853600,21202611,489056211,9,0,1,62464,17,4141850379
18686,467857670,21199002,489056672,6,0,1,10240,3,2130450858
18687,467859070,21252645,489111715,5,0,1,68608,11,9454958559
18688,467878580,1809095,469687675,2,0,0,231936,11,146766415
18689,467881560,21376895,489258455,9,0,1,226816,17,1384696079
18690,467893130,21369831,489262961,5,0,1,7168,11,1204783404
18691,467903379,1545420,469448799,4,0,0,125952,4,6835807783
18692,467904990,21417675,489322665,9,0,1,156160,17,7992904841
18693,467915290,21495778,489411068,1,0,1,177664,6,4509117880
18694,467916360,21567096,489483456,6,0,1,30720,3,260007764
18695,467946410,2714826,470661236,2,0,0,281088,11,7979184041
18696,467991250,2897014,470888264,1,0,0,71168,6,7734000647
18697,467994580,2815114,470809694,2,0,0,258048,11,9138863235
18698,467998260,21658252,489656512,2,0,1,253952,11,2846184776
18699,468028220,21635729,489663949,6,0,1,26112,3,5180645766
18700,468048860,21660967,489709827,9,0,1,35328,17,6321272061
18701,468064110,21650863,489714973,5,0,1,8192,11,1939450586
18702,468067560,21849740,489917300,2,0,1,366080,11,5318137497
18703,468072130,2309338,470381468,0,0,0,155648,6,5241050457
18704,468106640,3165042,471271682,3,0,0,216576,0,4557259657
18705,468110900,1902683,470013583,9,0,0,114176,17,5573096822
18706,468119400,21805384,489924784,6,0,1,32256,3,2448397154
18707,468124329,21822185,489946514,8,0,1,22016,6,10235466751
18708,468145640,1574225,469719865,9,0,0,27648,17,3786611824
18709,468173680,21788148,489961828,5,0,1,7168,11,10098053855
18710,468189200,1961946,470151146,0,0,0,48640,6,7669127864
18711,468193860,2360789,470554649,9,0,0,123904,17,9959736131
18712,468194100,21776783,489970883,6,0,1,35840,3,1481970195
18713,468223610,1737283,469960893,2,0,0,277504,11,4761136255
18714,468252420,21748653,490001073,9,0,1,40448,17,1440940866
18715,468308890,21763954,490072844,6,0,1,5632,3,2419461212
18716,468321370,21751497,490072867,5,0,1,55808,11,9612556027
18717,468405299,21667583,490072882,8,0,1,2048,6,5742341234
18718,468409969,21662928,490072897,8,0,1,19456,6,3607647147
18719,468422170,21655980,490078150,5,0,1,28160,11,5678578826
18720,468426190,21662618,490088808,6,0,1,25088,3,3364479710
18721,468427250,2905146,471332396,1,0,0,193536,6,4116978713
18722,468474550,2609379,471083929,2,0,0,226304,11,4372473979
18723,468509269,21592031,490101300,8,0,1,5120,6,285890371
18724,468583340,2088847,470672187,2,0,0,35840,11,9718931395
18725,468607399,21495181,490102580,8,0,1,14336,6,8416162863
18726,468649900,2214315,470864215,0,0,0,128000,6,9398779965
18727,468662850,2162342,470825192,2,0,0,45568,11,10360356335
18728,468689610,2777078,471466688,9,0,0,326144,17,4049529710
18729,468694849,21420887,490115736,8,0,1,30208,6,8172777812
18730,468702260,21460573,490162833,9,0,1,61952,17,2671933839
18731,468713000,21493063,490206063,2,0,1,47616,11,1951108346
18732,468743920,21601223,490345143,2,0,1,280064,11,39019765
18733,468781800,21575756,490357556,2,0,1,18944,11,4917345825
18734,468784440,21579888,490364328,3,0,1,32256,0,7670444892
18735,468811980,1369381,470181361,9,0,0,50688,17,10385926481
18736,468812459,2286149,471098608,4,0,0,48128,4,9729376402
18737,468855760,21518569,490374329,6,0,1,5632,3,3007947551
18738,468867080,21517470,490384550,3,0,1,18432,0,432145880
18739,468887950,2695180,471583130,1,0,0,157696,6,7169894325
18740,468893080,1243143,470136223,0,0,0,81920,6,1806237192
18741,468902790,21502154,490404944,2,0,1,59904,11,3648513342
18742,468922920,3079532,472002452,3,0,0,134144,0,5088479914
18743,468947920,21517562,490465482,2,0,1,114688,11,10527491826
18744,468963280,2920750,471884030,2,0,0,306176,11,3019907235
18745,468999530,3087487,472087017,9,0,0,146432,17,4607056191
18746,469012739,2690744,471703483,4,0,0,207360,4,386341625
18747,469031200,21470517,490501717,9,0,1,71168,17,1160998929
18748,469033730,3118752,472152482,3,0,0,36864,0,5917290320
18749,469091280,21413343,490504623,3,0,1,4608,0,3490482803
18750,469091390,3271691,472363081,1,0,0,113152,6,2753105938
18751,469115290,21396833,490512123,2,0,1,34304,11,10601591949
18752,469146279,21368357,490514636,8,0,1,12288,6,4220896215
18753,469156609,21377864,490534473,8,0,1,20480,6,9200883695
18754,469160890,2767506,471928396,2,0,0,128000,11,2505980277
18755,469174790,21363549,490538339,3,0,1,6144,0,8570848514
18756,469180890,3091142,472272032,1,0,0,23552,6,1007406447
18757,469198350,21340655,490539005,6,0,1,1024,3,7544038658
18758,469248810,21472251,490721061,2,0,1,209920,11,5014919961
18759,469265859,21457315,490723174,8,0,1,14336,6,6769044055
18760,469298620,21617171,490915791,9,0,1,196096,17,7532579980
18761,469299230,21625480,490924710,3,0,1,39936,0,227020139
18762,469374329,1315057,470689386,4,0,0,56320,4,437811668
18763,469449210,21599135,491048345,2,0,1,68608,11,9335137231
18764,469452590,21595770,491048360,2,0,1,51712,11,10476078849
18765,469456840,2674816,472131656,0,0,0,146432,6,1181602804
18766,469460900,21587483,491048383,3,0,1,1536,0,2323248013
18767,469480050,3010201,472490251,3,0,0,136192,0,9527810890
18768,469496099,664890,470160989,4,0,0,32256,4,209108518
18769,469498650,3217697,472716347,2,0,0,104448,11,1532789094
18770,469526760,21521638,491048398,2,0,1,12800,11,3320744844
18771,469562310,21486103,491048413,9,0,1,27136,17,2872078949
18772,469589919,21458509,491048428,8,0,1,16896,6,1284324586
18773,469598190,21469305,491067495,3,0,1,23040,0,7103281425
18774,469638610,21434172,491072782,3,0,1,16896,0,3816966224
18775,469649400,21427888,491077288,5,0,1,7168,11,2449492865
18776,469651050,915626,470566676,3,0,0,39424,0,1779134071
18777,469677900,21547859,491225759,2,0,1,177152,11,7313514801
18778,469705130,21520644,491225774,5,0,1,17408,11,3728819511
18779,469718260,2842486,472560746,1,0,0,33280,6,10036079250
18780,469730100,21495689,491225789,6,0,1,10752,3,2979387909
18781,469744610,2874215,472618825,3,0,0,163840,0,1726592764
18782,469756570,21469242,491225812,9,0,1,43008,17,4813965603
18783,469765999,21493435,491259434,8,0,1,19456,6,8543124805
18784,469786850,21473250,491260100,6,0,1,1024,3,2026183575
18785,469812049,2872459,472684508,4,0,0,155648,4,3634070722
18786,469839110,21428377,491267487,5,0,1,35328,11,9822058838
18787,469866230,2358041,472224271,0,0,0,126976,6,9456896006
18788,469900660,21369276,491269936,5,0,1,1024,11,3371435787
18789,469908980,21465083,491374063,4,0,1,252928,4,6953423738
18790,469932780,21443097,491375877,9,0,1,13312,17,7899012917
18791,469961700,21418104,491379804,9,0,1,2048,17,5086080924
18792,469975030,21406080,491381110,6,0,1,2048,3,6521651655
18793,470064020,1409140,471473160,3,0,0,18944,0,8804935419
18794,470079340,2732941,472812281,0,0,0,94720,6,9340623558
18795,470085250,2836791,472922041,0,0,0,249344,6,4812380814
18796,470086200,21327944,491414144,9,0,1,31232,17,8163772379
18797,470087089,481318,470568407,4,0,0,5632,4,9877379832
18798,470112880,21325375,491438255,6,0,1,47104,3,8498322181
18799,470203880,21236001,491439881,5,0,1,2560,11,2095742035
18800,470231790,21590236,491822026,2,0,1,569856,11,6091879664
18801,470298610,1590771,471889381,1,0,0,17408,6,2366284449
18802,470300850,21521191,491822041,6,0,1,3584,3,8156787062
18803,470307329,21514727,491822056,8,0,1,8704,6,3275091062
18804,470322119,2689496,473011615,4,0,0,280064,4,1288499065
18805,470323290,21506061,491829351,6,0,1,16896,3,3397466117
18806,470369250,1257204,471626454,2,0,0,77312,11,1998586770
18807,470372590,21575593,491948183,2,0,1,137216,11,4876959053
18808,470380490,21881851,492262341,2,0,1,234496,11,3156473864
18809,470386300,21919031,492305331,9,0,1,32256,17,8683699139
18810,470396880,414413,470811293,9,0,0,5120,17,1065169508
18811,470406820,21900137,492306957,2,0,1,2560,11,2235607935
18812,470448930,824483,471273413,0,0,0,5632,6,6918778237
18813,470464710,662173,471126883,3,0,0,92672,0,6296216829
18814,470487460,21824643,492312103,9,0,1,20480,17,251357476
18815,470495900,21823982,492319882,2,0,1,15360,11,7579694035
18816,470526540,2489630,473016170,9,0,0,14848,17,3804514541
18817,470554330,1937536,472491866,9,0,0,5120,17,10318165265
18818,470583700,2523934,473107634,2,0,0,23040,11,9441277310
18819,470587309,21766355,492353664,8,0,1,4096,6,3304122287
18820,470597309,2641983,473239292,4,0,0,56320,4,9783350217
18821,470606820,2801894,473408714,2,0,0,81920,11,5662494027
18822,470637050,21784552,492421602,5,0,1,26624,11,7167338931
18823,470661359,2842416,473503775,4,0,0,89088,4,10729358829
18824,470678920,21742697,492421617,6,0,1,12800,3,8430249889
18825,470698140,21855194,492553334,9,0,1,6144,17,4184428532
18826,470702290,2552125,473254415,2,0,0,27648,11,9945426263
18827,470707839,1838330,472546169,4,0,0,178176,4,523959724
18828,470716439,3021212,473737651,4,0,0,266240,4,5125155479
18829,470720930,21832419,492553349,5,0,1,12288,11,5843442493
18830,470738120,21817443,492555563,6,0,1,3072,3,1630777143
18831,470747200,2909308,473656508,3,0,0,270848,0,3814088466
18832,470748730,21806848,492555578,9,0,1,4608,17,3214296554
18833,470786590,21957590,492744180,2,0,1,147456,11,8820589142
18834,470819020,2657580,473476600,3,0,0,92160,0,4489871037
18835,470821970,1726726,472548696,2,0,0,8192,11,3337593352
18836,470831980,21912215,492744195,5,0,1,6656,11,9176156092
18837,470893529,2934699,473828228,4,0,0,20992,4,7516047475
18838,470897500,21846726,492744226,2,0,1,51712,11,7044583359
18839,470937600,21806641,492744241,6,0,1,3072,3,1015245635
18840,470988170,21756086,492744256,6,0,1,10240,3,5404512197
18841,471012459,2360680,473373139,4,0,0,69632,4,1219695744
18842,471048120,1330584,472378704,9,0,0,51200,17,9143337705
18843,471052520,989850,472042370,1,0,0,79360,6,4926890132
18844,471055820,21712499,492768319,9,0,1,24064,17,8996297666
18845,471107780,21667260,492775040,5,0,1,24064,11,4118584557
18846,471130030,21645996,492776026,5,0,1,1536,11,6227292011
18847,471132080,21749292,492881372,1,0,1,76800,6,6008772383
18848,471142470,1268503,472410973,3,0,0,37888,0,5175108545
18849,471148750,1020619,472169369,3,0,0,55296,0,10168321930
18850,471157340,2379221,473536561,9,0,0,60416,17,1145202846
18851,471176269,1607137,472783406,4,0,0,31744,4,2153717912
18852,471195830,21728040,492923870,1,0,1,167936,6,8283343234
18853,471217930,21711637,492929567,9,0,1,18944,17,9632284425
18854,471237990,521412,471759402,3,0,0,29696,0,2485523231
18855,471280430,21727179,493007609,2,0,1,227840,11,7687891038
18856,471306800,21706400,493013200,5,0,1,4608,11,7440986264
18857,471326680,814531,472141211,1,0,0,31232,6,2158982085
18858,471328110,21694076,493022186,6,0,1,10240,3,4261036015
18859,471333230,955938,472289168,3,0,0,9216,0,8522808952
18860,471334010,1300812,472634822,3,0,0,31232,0,3686062405
18861,471343370,2211672,473555042,2,0,0,24064,11,3707259271
18862,471366910,2611420,473978330,9,0,0,61440,17,10380281455
18863,471379240,3100060,474479300,1,0,0,197632,6,5422239471
18864,471399140,21624429,493023569,5,0,1,14848,11,724054832
18865,471403290,21628418,493031708,5,0,1,512,11,3150647350
18866,471406460,21655241,493061701,2,0,1,67072,11,3044180200
18867,471415759,2713522,474129281,4,0,0,403456,4,642527714
18868,471448090,21622970,493071060,9,0,1,36352,17,2149253143
18869,471467430,21631508,493098938,2,0,1,61952,11,3177069558
18870,471514179,2885258,474399437,4,0,0,281600,4,1444359771
18871,471515060,21603631,493118691,2,0,1,35840,11,3576211526
18872,471523350,2758886,474282236,1,0,0,427008,6,948999573
18873,471546900,21625632,493172532,1,0,1,98816,6,6596200649
18874,471567560,21819566,493387126,1,0,1,268288,6,9248530904
18875,471610510,1647991,473258501,1,0,0,11776,6,2238020078
18876,471633980,21781207,493415187,5,0,1,28160,11,7841311405
18877,471638100,21967112,493605212,1,0,1,289792,6,9779230195
18878,471642040,21967038,493609078,2,0,1,6144,11,7686300041
18879,471673000,1424686,473097686,9,0,0,1024,17,139165943
18880,471677250,873341,472550591,1,0,0,6144,6,2592252659
18881,471680100,2472017,474152117,2,0,0,62464,11,1953873983
18882,471693869,2725200,474419069,4,0,0,13312,4,4458162649
18883,471730069,2090609,473820678,4,0,0,77312,4,7223065040
18884,471765010,21848677,493613687,8,0,1,19968,6,7848786451
18885,471788570,21829303,493617873,6,0,1,6656,3,5004415914
18886,471804550,1212431,473016981,1,0,0,2560,6,599507511
18887,471887410,1036237,472923647,1,0,0,5120,6,4976927908
18888,471898470,861236,472759706,1,0,0,3072,6,4248931580
18889,471899800,21722155,493621955,9,0,1,2048,17,1356187475
18890,471903320,21724741,493628061,5,0,1,20992,11,7769693069
18891,471907470,1541035,473448505,2,0,0,18432,11,10504530893
18892,471908420,21817096,493725516,2,0,1,123904,11,5210814264
18893,471924819,2708829,474633648,4,0,0,332288,4,465912211
18894,471928810,21798610,493727420,9,0,1,6144,17,4109667713
18895,471947640,1923500,473871140,3,0,0,32768,0,3574977587
18896,471977920,21768161,493746081,9,0,1,9216,17,3716010755
18897,471997600,21757296,493754896,1,0,1,16384,6,4529593336
18898,471998269,1798814,473797083,4,0,0,13824,4,1748098056
18899,472010870,1526189,473537059,1,0,0,1536,6,2583401172
18900,472025619,2648543,474674162,4,0,0,70144,4,1352409449
18901,472031570,21774418,493805988,2,0,1,105472,11,7396069533
18902,472068760,21776537,493845297,2,0,1,66048,11,7016456916
18903,472073570,850560,472924130,9,0,0,1536,17,4472344646
18904,472081789,2570978,474652767,4,0,0,62464,4,4773095885
18905,472087640,725280,472812920,1,0,0,2048,6,3274940236
18906,472092520,1031932,473124452,9,0,0,2048,17,2165535470
18907,472112200,21900458,494012658,2,0,1,205312,11,3590735235
18908,472137890,2587422,474725312,9,0,0,2560,17,3589650658
18909,472168390,1624450,473792840,2,0,0,173568,11,6575577291
18910,472171070,21857752,494028822,9,0,1,6144,17,7036707618
18911,472203369,1929701,474133070,4,0,0,10752,4,4221272445
18912,472203570,21826878,494030448,9,0,1,2560,17,1220797158
18913,472220710,21824716,494045426,1,0,1,40448,6,2562555102
18914,472226740,21819352,494046092,9,0,1,11264,17,3538552718
18915,472248940,21989424,494238364,1,0,1,54272,6,481378688
18916,472262270,22051607,494313877,1,0,1,162304,6,9476308538
18917,472267340,2132268,474399608,1,0,0,512,6,620886182
18918,472349010,21972432,494321442,5,0,1,4608,11,7728250334
18919,472377759,2443976,474821735,4,0,0,316416,4,10625263959
18920,472387640,21954208,494341848,5,0,1,46080,11,4190224042
18921,472403460,22058857,494462317,2,0,1,133120,11,6697905710
18922,472413170,2446035,474859205,3,0,0,122880,0,8821756707
18923,472441230,22172379,494613609,4,0,1,388608,4,4789283396
18924,472451620,1678159,474129779,1,0,0,1536,6,2446023838
18925,472464120,790778,473254898,2,0,0,1536,11,1316787484
18926,472467300,22171970,494639270,4,0,1,52224,4,3446956353
18927,472505870,22166736,494672606,4,0,1,48640,4,7703098525
18928,472543420,1196445,473739865,1,0,0,7168,6,4585733258
18929,472664190,22025453,494689643,2,0,1,53248,11,3277438193
18930,472673390,22091297,494764687,4,0,1,173056,4,10132991887
18931,472678510,1143283,473821793,1,0,0,3584,6,9129099696
18932,472721890,22046343,494768233,5,0,1,5632,11,2043635953
18933,472726170,22073075,494799245,5,0,1,57344,11,2084940478
18934,472759390,22070229,494829619,4,0,1,81408,4,2210242523
18935,472810119,1604792,474414911,4,0,0,50176,4,6531793262
18936,472849030,2216194,475065224,2,0,0,21504,11,9232076763
18937,472905520,1615330,474520850,2,0,0,49664,11,452946589
18938,472926550,2343412,475269962,2,0,0,142848,11,3426906190
18939,472944680,21906895,494851575,4,0,1,15360,4,425456445
18940,472972390,22003866,494976256,2,0,1,249856,11,6865494231
18941,472983970,22041492,495025462,4,0,1,96256,4,8766703667
18942,473017460,2511557,475529017,3,0,0,153600,0,1886829307
18943,473024960,22026477,495051437,5,0,1,49152,11,8897759876
18944,473040390,22145128,495185518,2,0,1,310272,11,906484143
18945,473062140,22187088,495249228,2,0,1,112640,11,2486714704
18946,473069260,22259202,495328462,2,0,1,161792,11,5019636988
18947,473085300,22356895,495442195,2,0,1,241664,11,10444693287
18948,473132030,1181592,474313622,2,0,0,66560,11,285506034
18949,473143150,22312628,495455778,4,0,1,38912,4,3483524796
18950,473194180,812089,474006269,3,0,0,91648,0,80098735
18951,473224839,1476669,474701508,4,0,0,89600,4,7125247493
18952,473237590,22241844,495479434,4,0,1,28672,4,6791668023
18953,473240420,1052907,474293327,2,0,0,36352,11,3269325354
18954,473265320,610705,473876025,1,0,0,4096,6,5704988218
18955,473339880,22182739,495522619,4,0,1,92160,4,4295644849
18956,473353520,2306982,475660502,3,0,0,33792,0,3870662898
18957,473428460,22160183,495588643,2,0,1,175616,11,10493936568
18958,473444340,22195235,495639575,2,0,1,97792,11,7575477916
18959,473565340,2216949,475782289,1,0,0,5632,6,921337818
18960,473639970,22099665,495739635,4,0,1,240128,4,9084534014
18961,473687490,22065741,495753231,4,0,1,37888,4,1658990880
18962,473696450,22119801,495816251,1,0,1,159232,6,1011128783
18963,473732529,991178,474723707,4,0,0,72704,4,1174085639
18964,473755339,750348,474505687,4,0,0,86528,4,2052954855
18965,473765509,22067969,495833478,8,0,1,38400,6,3593560116
18966,473789090,743163,474532253,2,0,0,37376,11,7919287272
18967,473794610,22114267,495908877,4,0,1,163840,4,3470285775
18968,473831270,22082753,495914023,4,0,1,8192,4,10613571872
18969,473837170,22215446,496052616,2,0,1,316416,11,6400324170
18970,473879830,844687,474724517,6,0,0,512,3,7072131752
18971,473885800,22353583,496239383,1,0,1,275968,6,8362392019
18972,474012200,880863,474893063,2,0,0,93696,11,7072015475
18973,474015180,22246188,496261368,1,0,1,65024,6,9226267014
18974,474037380,862094,474899474,3,0,0,20992,0,4092413147
18975,474072420,827553,474899973,6,0,0,1536,3,7736473818
18976,474093260,22340564,496433824,1,0,1,374272,6,2871140371
18977,474093380,22344310,496437690,4,0,1,6144,4,2221620587
18978,474125900,738585,474864485,3,0,0,16896,0,3764570972
18979,474132580,22314545,496447125,6,0,1,44032,3,9088194338
18980,474133620,590726,474724346,1,0,0,2048,6,9861638084
18981,474285850,22166834,496452684,4,0,1,512,4,2496115611
18982,474326330,655465,474981795,2,0,0,149504,11,4631787070
18983,474328420,22127490,496455910,6,0,1,5120,3,7522141099
18984,474394809,811148,475205957,4,0,0,193536,4,4156280529
18985,474399260,22073022,496472282,4,0,1,25088,4,3818226398
18986,474418080,721215,475139295,1,0,0,3072,6,6888383749
18987,474426580,555854,474982434,6,0,0,2048,3,7280420004
18988,474435650,909055,475344705,2,0,0,113152,11,8538635916
18989,474515960,21956988,496472948,6,0,1,11264,3,6435467221
18990,474522980,518425,475041405,6,0,0,512,3,4212627472
18991,474572290,21912229,496484519,6,0,1,16384,3,8087763936
18992,474574470,1371268,475945738,3,0,0,87040,0,1451876297
18993,474589990,623806,475213796,2,0,0,25600,11,10447375147
18994,474596730,21908258,496504988,4,0,1,5120,4,3970143184
18995,474660690,702389,475363079,1,0,0,5632,6,2769629330
18996,474695729,1663777,476359506,4,0,0,395776,4,1063033182
18997,474702410,21802924,496505334,6,0,1,512,3,6083699576
18998,474737570,477193,475214763,6,0,0,3072,3,551899033
18999,474738450,622882,475361332,3,0,0,54272,0,7849520145
19000,474791090,21728435,496519525,6,0,1,46592,3,4907253291
19001,474834610,436155,475270765,6,0,0,2560,3,4910669675
19002,474846690,1227464,476074154,6,0,0,10752,3,8493767628
19003,474852400,519935,475372335,6,0,0,1536,3,1760358118
19004,474886540,555681,475442221,2,0,0,41472,11,7169709612
19005,474926199,21599125,496525324,8,0,1,19456,6,534992281
19006,474960949,21565681,496526630,8,0,1,2048,6,7527037680
19007,474979119,21548817,496527936,8,0,1,2048,6,10338414389
19008,475047100,859608,475906708,6,0,0,2048,3,6567825188
19009,475065700,416502,475482202,3,0,0,26624,0,2382972550
19010,475149640,1304530,476454170,2,0,0,113152,11,259160056
19011,475166389,366231,475532620,4,0,0,11776,4,8110459550
19012,475173559,21382192,496555751,8,0,1,33792,6,1899525611
19013,475210670,641424,475852094,3,0,0,167936,0,2035436180
19014,475233649,21366128,496599777,8,0,1,55808,6,10603950345
19015,475245789,534769,475780558,4,0,0,195072,4,10284467662
19016,475306010,1304440,476610450,2,0,0,60928,11,4059242901
19017,475316589,21289714,496606303,8,0,1,20992,6,5465922259
19018,475328679,21368944,496697623,8,0,1,71168,6,8160403524
19019,475453379,21251656,496705035,8,0,1,11776,6,4783358004
19020,475459370,394931,475854301,6,0,0,7168,3,543273625
19021,475661941,21060828,496722769,0,0,1,43008,6,2617808520
19022,475677319,21046423,496723742,8,0,1,12800,6,2722902899
19023,475687960,382843,476070803,2,0,0,88576,11,7361405270
19024,475746880,284892,476031772,6,0,0,1536,3,5623207103
19025,475778390,443668,476222058,2,0,0,105984,11,3334541216
19026,475804250,343686,476147936,1,0,0,512,6,5957209366
19027,475824790,993023,476817813,3,0,0,89600,0,2965909630
19028,476008750,372487,476381237,1,0,0,3072,6,7384944294
19029,476012660,347360,476360020,6,0,0,1536,3,3559890797
19030,476022269,20810661,496832930,8,0,1,45056,6,10560530087
19031,476042860,336922,476379782,2,0,0,64512,11,9294949977
19032,476156609,762517,476919126,4,0,0,218624,4,2722485119
19033,476216669,635479,476852148,4,0,0,112640,4,10015502155
19034,476243780,728150,476971930,3,0,0,63488,0,6426204956
19035,476261350,455780,476717130,2,0,0,38400,11,5307246567
19036,476274679,20558266,496832945,8,0,1,4608,6,3267373709
19037,476292930,627942,476920872,6,0,0,1024,3,4538649778
19038,476367030,423468,476790498,2,0,0,110592,11,5898006232
19039,476389769,20443191,496832960,8,0,1,1536,6,10422122396
19040,476417839,534732,476952571,4,0,0,103936,4,4192513628
19041,476449290,1120422,477569712,2,0,0,216576,11,891769257
19042,476465569,523114,476988683,4,0,0,54784,4,2503669071
19043,476473900,378591,476852491,1,0,0,1024,6,870375054
19044,476543289,940283,477483572,4,0,0,105984,4,2671628786
19045,476583510,798202,477381712,3,0,0,117248,0,1405877797
19046,476642249,414615,477056864,4,0,0,165888,4,6528532601
19047,476658809,590979,477249788,4,0,0,51712,4,10390035492
19048,476666230,254315,476920545,1,0,0,4608,6,2396784896
19049,476694320,699263,477393583,2,0,0,38912,11,7176728814
19050,476786210,988513,477774723,2,0,0,157696,11,1130685825
19051,476793340,481462,477274802,6,0,0,2048,3,8482373913
19052,476813940,419136,477233076,2,0,0,12288,11,7241315062
19053,476845000,416820,477261820,6,0,0,1024,3,9367855276
19054,476867770,629836,477497606,1,0,0,5632,6,6097753843
19055,476933659,407895,477341554,4,0,0,512,4,8710208713
19056,476951720,451550,477403270,2,0,0,31744,11,10358465140
19057,476989530,631989,477621519,3,0,0,169984,0,1712335898
19058,476994559,627934,477622493,4,0,0,2560,4,5922341907
19059,477022930,19810045,496832975,5,0,1,12800,11,9728625208
19060,477037190,213865,477251055,1,0,0,1024,6,9990621310
19061,477068680,423379,477492059,6,0,0,1024,3,832672555
19062,477078000,19754990,496832990,8,0,1,3072,6,2214258007
19063,477137329,484369,477621698,4,0,0,512,4,2599424394
19064,477145559,19687454,496833013,8,0,1,29696,6,1257486132
19065,477150270,19682758,496833028,3,0,1,13312,0,2317201277
19066,477191169,19641874,496833043,8,0,1,6144,6,7448541990
19067,477202860,281039,477483899,1,0,0,1024,6,5328406351
19068,477482870,216836,477699706,6,0,0,9728,3,2800122349
19069,477542220,264778,477806998,2,0,0,6656,11,1453079262
19070,477553720,448432,478002152,6,0,0,3584,3,2650582743
19071,477584980,295235,477880215,1,0,0,512,6,9209097771
19072,477597300,311152,477908452,6,0,0,4096,3,7142781055
19073,477638690,266599,477905289,6,0,0,1024,3,853769771
19074,477677920,185947,477863867,1,0,0,3072,6,6307936193
19075,477829390,545834,478375224,2,0,0,101888,11,3303244866
19076,477876220,353360,478229580,2,0,0,121856,11,1062595738
19077,477939040,207760,478146800,1,0,0,6656,6,9320364837
19078,477946640,364146,478310786,1,0,0,2560,6,7958489900
19079,477956490,349317,478305807,6,0,0,4096,3,2182971144
19080,478019780,284764,478304544,2,0,0,31232,11,7903795616
19081,478024690,350861,478375551,6,0,0,1024,3,10568639608
19082,478100100,18733441,496833541,1,0,1,50688,6,4585140475
19083,478143160,303854,478447014,1,0,0,512,6,3375337431
19084,478174420,18788032,496962452,1,0,1,300032,6,165352942
19085,478191550,306762,478498312,1,0,0,2048,6,4097106306
19086,478259840,371141,478630981,1,0,0,2560,6,8455246424
19087,478315860,336877,478652737,6,0,0,2560,3,401749708
19088,478386020,225241,478611261,2,0,0,512,11,8014223333
19089,478424070,351272,478775342,2,0,0,34304,11,10701307890
19090,478459440,403714,478863154,2,0,0,17408,11,6356781134
19091,478472659,266230,478738889,4,0,0,512,4,6946292232
19092,478511879,297017,478808896,4,0,0,8192,4,9589348023
19093,478523540,369658,478893198,2,0,0,59904,11,7524615919
19094,478553080,134960,478688040,1,0,0,3072,6,9273579532
19095,478598010,147491,478745501,6,0,0,2048,3,7083160329
19096,478633859,305575,478939434,4,0,0,4608,4,5658176069
19097,478653140,18478661,497131801,1,0,1,161792,6,1459719496
19098,478708160,218172,478926332,1,0,0,7168,6,2745866909
19099,478719530,400503,479120033,2,0,0,131072,11,9725002792
19100,478770250,18391878,497162128,1,0,1,62464,6,7244475759
19101,478913660,18388508,497302168,1,0,1,279040,6,10329610588
19102,478946890,18399926,497346816,1,0,1,65024,6,2526892835
19103,478956140,738822,479694962,2,0,0,306688,11,8842487543
19104,478961160,338051,479299211,1,0,0,7168,6,8101531540
19105,479013390,507245,479520635,6,0,0,512,3,8084676592
19106,479047509,488801,479536310,4,0,0,6144,4,9062406025
19107,479161060,18186422,497347482,4,0,1,11264,4,4539434660
19108,479163190,300285,479463475,1,0,0,3072,6,3580804877
19109,479228920,305503,479534423,1,0,0,1024,6,7852801076
19110,479236670,18112758,497349428,5,0,1,3072,11,3608205337
19111,479256720,18093067,497349787,4,0,1,9728,4,3447886740
19112,479300910,18071105,497372015,8,0,1,17920,6,157157055
19113,479309049,284293,479593342,4,0,0,2048,4,1501267579
19114,479325929,176700,479502629,4,0,0,6656,4,2040727235
19115,479354189,233165,479587354,4,0,0,2560,4,6545242207
19116,479357190,154617,479511807,1,0,0,1024,6,3209363022
19117,479402250,17971269,497373519,8,0,1,14848,6,150016397
19118,479429610,17951706,497381316,4,0,1,20480,4,9709779126
19119,479487950,301867,479789817,2,0,0,132096,11,9656515544
19120,479570310,17812594,497382904,6,0,1,15872,3,2883916125
19121,479574009,217079,479791088,4,0,0,2048,4,9536753748
19122,479577520,17811337,497388857,6,0,1,28160,3,890221340
19123,479595780,17800024,497395804,4,0,1,10240,4,4209685545
19124,479608310,17803654,497411964,4,0,1,22016,4,7367992729
19125,479611810,286616,479898426,2,0,0,2048,11,9518890824
19126,479615000,439763,480054763,0,0,0,88576,6,3962560280
19127,479629790,17783480,497413270,4,0,1,2048,4,1152320716
19128,479682950,17730666,497413616,4,0,1,512,4,5529212444
19129,479688980,137885,479826865,1,0,0,1024,6,7776594639
19130,479717980,17696404,497414384,4,0,1,11776,4,7854166302
19131,479754529,234284,479988813,4,0,0,2048,4,7882725749
19132,479801700,309406,480111106,1,0,0,4096,6,10559671258
19133,479835120,17588916,497424036,4,0,1,15360,4,8922802126
19134,479851560,17577968,497429528,6,0,1,17920,3,5113005072
19135,479891960,17579636,497471596,6,0,1,31744,3,6468959984
19136,479934570,320650,480255220,0,0,0,60416,6,8051738569
19137,479998600,17478614,497477214,6,0,1,22528,3,7990432201
19138,480070600,234294,480304894,0,0,0,10752,6,1475216462
19139,480093920,591149,480685069,0,0,0,286208,6,8764309721
19140,480134330,196686,480331016,6,0,0,512,3,10622141685
19141,480143430,17351553,497494983,4,0,1,16384,4,7526778536
19142,480150690,17348479,497499169,4,0,1,6656,4,8383290954
19143,480155050,17350791,497505841,4,0,1,17408,4,6170005870
19144,480203020,274117,480477137,1,0,0,1536,6,9412423363
19145,480212380,17297736,497510116,4,0,1,11264,4,9730439112
19146,480226850,543490,480770340,0,0,0,32256,6,4681204570
19147,480278920,505160,480784080,1,0,0,3072,6,5591378912
19148,480297279,404476,480701755,4,0,0,2560,4,1554526803
19149,480329950,208366,480538316,6,0,0,3584,3,4408086985
19150,480403810,291490,480695300,0,0,0,33280,6,2270773437
19151,480432020,487741,480919761,0,0,0,75776,6,6139867157
19152,480481090,455028,480936118,2,0,0,42496,11,6240284306
19153,480483070,349953,480833023,1,0,0,5120,6,442233314
19154,480558440,170681,480729121,1,0,0,512,6,2413233998
19155,480589020,130170,480719190,6,0,0,1024,3,7159092247
19156,480597570,266823,480864393,1,0,0,2048,6,4793083722
19157,480652969,233373,480886342,4,0,0,1536,4,1755805940
19158,480666660,16849908,497516568,6,0,1,10240,3,8960514803
19159,480691030,259578,480950608,6,0,0,1536,3,4683600032
19160,480707020,16827151,497534171,4,0,1,60928,4,8440319531
19161,480872600,542776,481415376,0,0,0,139264,6,5042476276
19162,480904520,225586,481130106,1,0,0,2048,6,10129894088
19163,480974420,16570076,497544496,4,0,1,5632,4,6497355117
19164,481028440,595840,481624280,2,0,0,69120,11,8165998714
19165,481035660,797593,481833253,0,0,0,83456,6,4636915445
19166,481078880,383200,481462080,1,0,0,1536,6,7110752267
19167,481093170,393956,481487126,2,0,0,13312,11,3339576801
19168,481106540,701254,481807794,2,0,0,113664,11,4884159852
19169,481126700,16417950,497544650,6,0,1,8704,3,10525895618
19170,481132000,640492,481772492,6,0,0,394240,3,419119508
19171,481231510,619542,481851052,2,0,0,58368,11,4891046469
19172,481244290,627720,481872010,6,0,0,68608,3,1922606015
19173,481259910,16285406,497545316,4,0,1,11264,4,697316772
19174,481284540,16275756,497560296,4,0,1,23040,4,8724795490
19175,481392330,769911,482162241,0,0,0,88576,6,372505895
19176,481406180,729058,482135238,0,0,0,205824,6,4530608548
19177,481486849,286282,481773131,4,0,0,2048,4,10600898109
19178,481547350,437257,481984607,0,0,0,103936,6,7410384933
19179,481567740,766571,482334311,0,0,0,28672,6,2512812576
19180,481636800,620028,482256828,6,0,0,54272,3,9705379801
19181,481655600,641001,482296601,0,0,0,60928,6,9333920063
19182,481659980,907799,482567779,2,0,0,121344,11,7081140981
19183,481720960,809832,482530792,2,0,0,68608,11,9628589653
19184,481728330,1085661,482813991,2,0,0,74240,11,2566749731
19185,481786750,413462,482200212,1,0,0,1536,6,2550404961
19186,481801249,604370,482405619,4,0,0,1024,4,7837367244
19187,481802240,695426,482497666,0,0,0,293888,6,3546735269
19188,481850900,15713303,497564203,6,0,1,14336,3,2507684998
19189,481865620,1076927,482942547,0,0,0,80384,6,460659954
19190,481876010,15688539,497564549,4,0,1,512,4,9440579112
19191,481897050,612823,482509873,2,0,0,39936,11,1682950137
19192,481902380,15667456,497569836,4,0,1,16896,4,9579789717
19193,481913680,824357,482738037,2,0,0,32768,11,2143013426
19194,481929240,15679201,497608441,6,0,1,65536,3,422692546
19195,481961340,631757,482593097,0,0,0,17920,6,8199245770
19196,481961660,305554,482267214,1,0,0,1536,6,893640457
19197,481976470,15639384,497615854,6,0,1,26624,3,8333146567
19198,482022250,384241,482406491,1,0,0,2048,6,4424444308
19199,482027510,15863424,497890934,1,0,1,450560,6,5826914309
19200,482103330,812964,482916294,6,0,0,108544,3,4795755760
19201,482105050,482572,482587622,0,0,0,65024,6,180918782
19202,482106840,486584,482593424,0,0,0,1024,6,6649447371
19203,482211010,400211,482611221,1,0,0,4096,6,1555751304
19204,482262880,655145,482918025,1,0,0,5632,6,3130947151
19205,482279049,464207,482743256,4,0,0,7680,4,4921900800
19206,482285950,472889,482758839,0,0,0,50688,6,520841757
19207,482302640,15606630,497909270,5,0,1,6144,11,6235862343
19208,482317830,15601063,497918893,5,0,1,22528,11,5746151818
19209,482354910,15597299,497952209,4,0,1,14336,4,8264476914
19210,482366560,15601021,497967581,5,0,1,31232,11,8728143190
19211,482374330,729018,483103348,6,0,0,149504,3,9170086127
19212,482391910,15596570,497988480,4,0,1,8192,4,4962620812
19213,482411540,471667,482883207,6,0,0,77312,3,5858576967
19214,482413640,410917,482824557,1,0,0,3072,6,9959555922
19215,482417700,1118919,483536619,5,0,0,512,11,8606779713
19216,482467870,528797,482996667,2,0,0,39424,11,5264575008
19217,482489300,324862,482814162,5,0,0,512,11,5224305711
19218,482568220,895370,483463590,5,0,0,1024,11,1354708305
19219,482568290,15436945,498005235,4,0,1,15360,4,8952722946
19220,482593500,15456116,498049616,4,0,1,49152,4,739938344
19221,482604550,15446346,498050896,5,0,1,14336,11,1040339191
19222,482634650,678904,483313554,6,0,0,117248,3,10540845336
19223,482686540,15372865,498059405,5,0,1,2048,11,81580490
19224,482787560,317549,483105109,5,0,0,5632,11,8451096030
19225,482831220,15259618,498090838,4,0,1,43520,4,204991604
19226,482941560,889108,483830668,2,0,0,347136,11,6371226686
19227,482957700,15135315,498093015,5,0,1,14336,11,6708557349
19228,482973250,572428,483545678,1,0,0,6144,6,6182437656
19229,482984450,348627,483333077,6,0,0,64000,3,1003144684
19230,483008709,430656,483439365,4,0,0,1536,4,5584257421
19231,483043190,799830,483843020,6,0,0,18944,3,8279819577
19232,483046200,947487,483993687,2,0,0,125952,11,39450769
19233,483065670,346137,483411807,5,0,0,4608,11,3457494089
19234,483132710,14961688,498094398,4,0,1,14848,4,3511633597
19235,483160010,14937934,498097944,4,0,1,5632,4,6381961943
19236,483174120,550750,483724870,2,0,0,225792,11,4365343713
19237,483205840,14897186,498103026,1,0,1,16896,6,1343096913
19238,483236640,600127,483836767,2,0,0,19968,11,6568028810
19239,483253800,14851172,498104972,4,0,1,3072,4,5829019535
19240,483260980,14890530,498151510,5,0,1,80896,11,4659966755
19241,483267650,15070447,498338097,1,0,1,284160,6,8159346699
19242,483373210,797914,484171124,6,0,0,199680,3,8903749793
19243,483417880,793222,484211102,2,0,0,102912,11,944782624
19244,483430800,14935693,498366493,5,0,1,36352,11,10444102559
19245,483483680,353414,483837094,1,0,0,1024,6,5107146042
19246,483487300,588501,484075801,2,0,0,91648,11,5006953805
19247,483536570,14908299,498444869,1,0,1,116736,6,9749803583
19248,483544380,14901475,498445855,5,0,1,1536,11,6631394714
19249,483561640,14891192,498452832,5,0,1,41472,11,6679905195
19250,483562820,15122800,498685620,1,0,1,416256,6,7938724161
19251,483577920,15119337,498697257,1,0,1,26624,6,4824298191
19252,483591939,581951,484173890,4,0,0,4608,4,804263898
19253,483603240,474649,484077889,6,0,0,6656,3,6852780873
19254,483647560,524857,484172417,5,0,0,4096,11,7447133824
19255,483732940,14980537,498713477,2,0,1,45568,11,9367196658
19256,483736250,14985925,498722175,5,0,1,9216,11,3594947415
19257,483763920,487077,484250997,1,0,0,9728,6,1282748516
19258,483774460,14948556,498723016,5,0,1,6656,11,829862494
19259,483894340,144212,484038552,1,0,0,1024,6,4167179448
19260,483919110,14827518,498746628,5,0,1,24576,11,7630822236
19261,483929930,441472,484371402,2,0,0,33792,11,10416096472
19262,483955360,317222,484272582,1,0,0,512,6,9079396383
19263,483956569,283056,484239625,4,0,0,4096,4,4207207060
19264,483982560,14906024,498888584,1,0,1,316928,6,8746355341
19265,483985300,14916971,498902271,5,0,1,15360,11,4322915557
19266,484007800,14930245,498938045,5,0,1,22528,11,10035954795
19267,484027020,14917336,498944356,6,0,1,22016,3,4590640819
19268,484027640,403678,484431318,6,0,0,75264,3,7742171604
19269,484028830,15001066,499029896,1,0,1,24064,6,2161577760
19270,484042630,14991798,499034428,4,0,1,7168,4,9719172758
19271,484043590,263698,484307288,5,0,0,2048,11,829671811
19272,484052710,15052488,499105198,6,0,1,20480,3,2105156040
19273,484053870,15066308,499120178,4,0,1,37888,4,3962244385
19274,484066860,246880,484313740,6,0,0,6656,3,6781527901
19275,484100449,483745,484584194,4,0,0,512,4,10728900257
19276,484104540,230063,484334603,1,0,0,512,6,2015933650
19277,484146210,14992300,499138510,5,0,1,4096,11,10547533131
19278,484218250,14921566,499139816,5,0,1,2048,11,3304242537
19279,484242500,451185,484693685,2,0,0,263680,11,1566490535
19280,484251720,14891843,499143563,5,0,1,10752,11,10129059544
19281,484254989,288264,484543253,4,0,0,1024,4,7638511647
19282,484283080,14863095,499146175,5,0,1,13312,11,1841381538
19283,484314610,284048,484598658,5,0,0,1536,11,6527665907
19284,484362010,613932,484975942,2,0,0,341504,11,6322754853
19285,484384550,14782026,499166576,5,0,1,6656,11,2386107868
19286,484412870,14813468,499226338,5,0,1,42496,11,2811522399
19287,484435840,14888872,499324712,4,0,1,15360,4,8770919218
19288,484489950,14834785,499324735,5,0,1,2560,11,4841014382
19289,484524720,888735,485413455,2,0,0,644096,11,7709620574
19290,484530380,454009,484984389,2,0,0,27648,11,7444544094
19291,484544550,14780200,499324750,4,0,1,41984,4,7258400539
19292,484550660,14774105,499324765,4,0,1,1024,4,7224269166
19293,484581490,14743290,499324780,5,0,1,7680,11,5260223032
19294,484593800,923247,485517047,2,0,0,236544,11,4193979268
19295,484629890,550978,485180868,1,0,0,2048,6,9147427136
19296,484637330,14693010,499330340,4,0,1,27136,4,8025356374
19297,484648260,793115,485441375,5,0,0,6656,11,2391489078
19298,484650250,566942,485217192,2,0,0,51712,11,536529306
19299,484697350,723935,485421285,2,0,0,25600,11,1704213682
19300,484704470,717781,485422251,5,0,0,3072,11,9097106302
19301,484713060,920593,485633653,5,0,0,2048,11,1288391419
19302,484719100,14612866,499331966,5,0,1,2560,11,10048310249
19303,484739600,703350,485442950,5,0,0,5120,11,4947239159
19304,484785410,758717,485544127,6,0,0,88576,3,3109141386
19305,484842870,596454,485439324,2,0,0,53760,11,9358631997
19306,484859060,14473892,499332952,4,0,1,1536,4,6528937225
19307,484880620,14453638,499334258,8,0,1,2048,6,10536169710
19308,484976420,587327,485563747,2,0,0,16896,11,9416740770
19309,485024020,14310699,499334719,4,0,1,10240,4,9892373143
19310,485037689,406757,485444446,4,0,0,4608,4,6772152678
19311,485064860,568124,485632984,2,0,0,123392,11,7195789082
19312,485126099,296814,485422913,4,0,0,2048,4,6329067025
19313,485130020,14306400,499436420,6,0,1,3072,3,9267319652
19314,485168370,276559,485444929,5,0,0,1536,11,8883151269
19315,485174080,14262355,499436435,6,0,1,4096,3,8132580688
19316,485240630,14195820,499436450,4,0,1,2048,4,9684009535
19317,485271410,599089,485870499,2,0,0,63488,11,9449086573
19318,485272040,536956,485808996,2,0,0,36864,11,7162493549
19319,485289510,542412,485831922,1,0,0,5120,6,8555751032
19320,485337320,303479,485640799,1,0,0,2048,6,1807594068
19321,485348999,524026,485873025,4,0,0,512,4,4816999194
19322,485361240,14130932,499492172,4,0,1,2048,4,244936508
19323,485361320,14130867,499492187,8,0,1,9728,6,5853227934
19324,485380180,14112022,499492202,4,0,1,8704,4,5732136849
19325,485388660,315472,485704132,1,0,0,3584,6,6708789008
19326,485403920,14088297,499492217,6,0,1,12800,3,3332314041
19327,485416549,247164,485663713,4,0,0,512,4,5955002961
19328,485417970,14074262,499492232,4,0,1,4608,4,4436280884
19329,485434879,307141,485742020,4,0,0,2048,4,3826735358
19330,485458550,14400001,499858551,6,0,1,553984,3,2884956981
19331,485482890,152026,485634916,1,0,0,4096,6,6505248281
19332,485486220,386634,485872854,5,0,0,7680,11,10584926021
19333,485580570,661877,486242447,6,0,0,142336,3,3288050740
19334,485634580,14245450,499880030,5,0,1,16896,11,6752409056
19335,485680650,14275155,499955805,5,0,1,1536,11,3595757445
19336,485682870,342791,486025661,6,0,0,129536,3,299939490
19337,485765630,14190198,499955828,5,0,1,4096,11,9507753119
19338,485790710,14165133,499955843,8,0,1,4608,6,4443163827
19339,485806370,14149496,499955866,6,0,1,65024,3,6079036363
19340,485845890,336034,486181924,2,0,0,43008,11,9273444663
19341,485858980,323115,486182095,1,0,0,512,6,4453790799
19342,485882780,14549369,500432149,6,0,1,559616,3,3114458866
19343,485883570,359672,486243242,5,0,0,2560,11,7651949276
19344,485922110,14514973,500437083,6,0,1,11776,3,6223002290
19345,485959060,643486,486602546,2,0,0,244736,11,640505786
19346,485970580,297802,486268382,6,0,0,29184,3,6682034133
19347,486003540,240157,486243697,5,0,0,512,11,7850287449
19348,486018680,14425233,500443913,5,0,1,11776,11,5126430809
19349,486152400,14293101,500445501,6,0,1,15872,3,4266307260
19350,486162780,14308396,500471176,5,0,1,21504,11,9053977571
19351,486181840,14303766,500485606,5,0,1,11264,11,8295585966
19352,486234490,453573,486688063,5,0,0,512,11,5079694651
19353,486236340,428830,486665170,1,0,0,4096,6,2731103070
19354,486282450,181929,486464379,5,0,0,3072,11,7772342021
19355,486313280,430035,486743315,2,0,0,171008,11,2855145779
19356,486319980,14342560,500662540,6,0,1,211968,3,1270587428
19357,486323740,14339056,500662796,5,0,1,9216,11,1143726110
19358,486354440,569981,486924421,6,0,0,185344,3,2427435298
19359,486359440,14835487,501194927,6,0,1,394752,3,1474966623
19360,486388620,432932,486821552,5,0,0,1536,11,2728659623
19361,486390540,14821763,501212303,5,0,1,8192,11,1121010707
19362,486453500,345514,486799014,2,0,0,4608,11,8541800762
19363,486457160,220190,486677350,5,0,0,1536,11,7610940831
19364,486506930,14706244,501213174,5,0,1,12288,11,10309918614
19365,486518510,14698579,501217089,5,0,1,4096,11,2856479304
19366,486583160,14871304,501454464,6,0,1,207360,3,1245907938
19367,486614840,321044,486935884,2,0,0,10240,11,9606587400
19368,486627850,418886,487046736,2,0,0,48128,11,5105657390
19369,486641910,226024,486867934,1,0,0,13312,6,9452577276
19370,486686160,158805,486844965,6,0,0,2048,3,10605635921
19371,486884900,14599710,501484610,6,0,1,49664,3,1218743097
19372,487020420,377445,487397865,5,0,0,7168,11,9580727393
19373,487054480,576039,487630519,6,0,0,134656,3,9522364513
19374,487071740,14636359,501708099,6,0,1,268288,3,6263713432
19375,487119640,14589269,501708909,5,0,1,20992,11,9167308669
19376,487164350,600434,487764784,1,0,0,75776,6,1884396401
19377,487170260,14538664,501708924,5,0,1,24064,11,6259619176
19378,487173690,199329,487373019,6,0,0,21504,3,4909421101
19379,487202610,386187,487588797,2,0,0,38400,11,6382293077
19380,487264160,415256,487679416,1,0,0,15360,6,5767877633
19381,487274160,14443585,501717745,5,0,1,26112,11,4599295328
19382,487283140,14522183,501805323,6,0,1,158720,3,779996402
19383,487312400,388003,487700403,5,0,0,3072,11,6892231745
19384,487360760,1030125,488390885,6,0,0,346112,3,5087267157
19385,487387740,566937,487954677,6,0,0,233984,3,4710134716
19386,487511950,337157,487849107,5,0,0,2048,11,1274247885
19387,487532870,422150,487955020,5,0,0,1024,11,828571829
19388,487624740,476518,488101258,1,0,0,86528,6,4664071624
19389,487631520,817958,488449478,2,0,0,31232,11,3096837661
19390,487632450,391331,488023781,5,0,0,5632,11,10555676949
19391,487650000,635390,488285390,6,0,0,261632,3,9521606946
19392,487663820,14144089,501807909,5,0,1,4096,11,5315511582
19393,487694490,697222,488391712,5,0,0,2560,11,4452924155
19394,487744140,429084,488173224,2,0,0,3072,11,7434350078
19395,487781450,658489,488439939,1,0,0,158208,6,1902329243
19396,487788480,840078,488628558,6,0,0,105472,3,8778227788
19397,487795580,702967,488498547,1,0,0,44032,6,1696197012
19398,487822760,278825,488101585,5,0,0,1024,11,10328253044
19399,487846260,682366,488528626,6,0,0,5632,3,2573433418
19400,487883820,13924653,501808473,5,0,1,10752,11,6488835547
19401,487893540,13919222,501812762,5,0,1,19456,11,6482290112
19402,487951400,229195,488180595,1,0,0,1024,6,3596190843
19403,487951760,859361,488811121,6,0,0,163328,3,8859625495
19404,487971490,13867471,501838961,5,0,1,33792,11,6066102402
19405,488008600,545486,488554086,2,0,0,66560,11,2636913799
19406,488014460,1004243,489018703,1,0,0,349696,6,5983767615
19407,488059300,702019,488761319,1,0,0,107008,6,2524770376
19408,488102650,13843869,501946519,6,0,1,214016,3,5922960314
19409,488208610,13754959,501963569,6,0,1,36352,3,998079771
19410,488209270,697536,488906806,2,0,0,104448,11,7004813926
19411,488244630,13808366,502052996,6,0,1,185344,3,4618204179
19412,488254540,383773,488638313,5,0,0,1024,11,1203754716
19413,488282810,13776097,502058907,5,0,1,3584,11,8157288647
19414,488325080,13783158,502108238,6,0,1,127488,3,7398810905
19415,488359430,13851695,502211125,6,0,1,214528,3,3334519957
19416,488388800,422569,488811369,1,0,0,512,6,5718205279
19417,488487190,560137,489047327,2,0,0,93696,11,9300631393
19418,488526220,14307063,502833283,6,0,1,544768,3,10080430048
19419,488531360,380780,488912140,6,0,0,17408,3,1654802213
19420,488533840,14302029,502835869,6,0,1,4096,3,7210815708
19421,488721050,14281237,503002287,6,0,1,39424,3,10184565381
19422,488738520,14657230,503395750,6,0,1,151040,3,5172476615
19423,488747990,476963,489224953,2,0,0,126464,11,7465149580
19424,488785980,14832081,503618061,6,0,1,238592,3,151300735
19425,488835360,15022091,503857451,6,0,1,616448,3,8334780615
19426,488893060,588650,489481710,2,0,0,96256,11,8126446323
19427,489001790,227168,489228958,5,0,0,2560,11,2231143584
19428,489063410,420031,489483441,1,0,0,5632,6,4681189265
19429,489122390,487283,489609673,6,0,0,80384,3,7269239671
19430,489183720,14712334,503896054,2,0,1,74240,11,999474287
19431,489205770,14720204,503925974,6,0,1,53760,3,8772735066
19432,489207030,566220,489773250,6,0,0,512,3,10368161002
19433,489258280,225503,489483783,5,0,0,1024,11,3698307021
19434,489283610,371156,489654766,6,0,0,22528,3,4039807790
19435,489298260,246092,489544352,5,0,0,512,11,8755075855
19436,489316330,756499,490072829,6,0,0,224256,3,9247238713
19437,489322680,488283,489810963,1,0,0,512,6,1918115762
19438,489342630,313867,489656497,1,0,0,5632,6,6333764546
19439,489407850,145809,489553659,5,0,0,512,11,3409991974
19440,489439340,14561611,504000951,6,0,1,155136,3,9247911434
19441,489447670,756327,490203997,2,0,0,126976,11,8866574907
19442,489461790,263882,489725672,1,0,0,1536,6,620896476
19443,489499600,14507895,504007495,1,0,1,18944,6,1411368903
19444,489579640,220463,489800103,5,0,0,1536,11,8035131856
19445,489607250,14405891,504013141,8,0,1,26624,6,1318754912
19446,489632610,329203,489961813,5,0,0,6144,11,8840307703
19447,489667040,14378882,504045922,6,0,1,55296,3,3177429434
19448,489678990,245779,489924769,1,0,0,1536,6,8913942874
19449,489690170,515878,490206048,1,0,0,6656,6,1867012287
19450,489755350,318342,490073692,5,0,0,2560,11,9595565898
19451,489759140,14294649,504053789,6,0,1,7168,3,1810751471
19452,489777100,14279275,504056375,6,0,1,4096,3,999648979
19453,489785070,556554,490341624,2,0,0,154624,11,7021786373
19454,489816700,180441,489997141,2,0,0,7168,11,6869345868
19455,489920290,14470865,504391155,6,0,1,245760,3,7669523255
19456,489942190,411597,490353787,5,0,0,7168,11,9857826416
19457,490016100,14411408,504427508,6,0,1,34304,3,8603914306
19458,490067210,14591838,504659048,6,0,1,163328,3,10383128965
19459,490146420,195702,490342122,1,0,0,1024,6,3869237761
19460,490156120,185675,490341795,1,0,0,512,6,5854515734
19461,490167810,187396,490355206,1,0,0,4608,6,9303125177
19462,490205670,14473258,504678928,6,0,1,130560,3,7877373355
19463,490248240,14430703,504678943,6,0,1,3072,3,7784155549
19464,490249530,14429436,504678966,5,0,1,23552,11,2474304667
19465,490259440,14419541,504678981,5,0,1,2560,11,2653998309
19466,490272110,14421450,504693560,6,0,1,53760,3,9087637286
19467,490278950,768741,491047691,2,0,0,336896,11,6784437145
19468,490337460,352799,490690259,5,0,0,1536,11,8494384224
19469,490381640,14363593,504745233,6,0,1,42496,3,255861187
19470,490395570,14349678,504745248,6,0,1,9728,3,834442112
19471,490399350,14345913,504745263,5,0,1,22528,11,8346532034
19472,490460430,733467,491193897,6,0,0,135680,3,2294014153
19473,490474900,677642,491152542,2,0,0,66048,11,7115942195
19474,490524620,237493,490762113,1,0,0,512,6,8525189422
19475,490560530,362629,490923159,5,0,0,512,11,2971618098
19476,490561630,14258345,504819975,6,0,1,120320,3,7069926702
19477,490625940,14194050,504819990,5,0,1,12288,11,1889096128
19478,490644830,403500,491048330,5,0,0,2048,11,6730118652
19479,490652490,14167515,504820005,5,0,1,20992,11,869572908
19480,490688120,537624,491225744,6,0,0,104448,3,3847110766
19481,490717830,183871,490901701,5,0,0,1024,11,664308232
19482,490735550,189145,490924695,5,0,0,512,11,7504501288
19483,490867320,13959235,504826555,5,0,1,11264,11,2274004032
19484,490873820,13953811,504827631,2,0,1,13312,11,4157817336
19485,490893320,165961,491059281,1,0,0,1536,6,9182237322
19486,491018370,13824181,504842551,5,0,1,36352,11,10235261225
19487,491062800,205757,491268557,5,0,0,1024,11,659163219
19488,491069890,13868089,504937979,6,0,1,154624,3,2152909081
19489,491102420,381591,491484011,6,0,0,61952,3,8173684229
19490,491148840,516849,491665689,5,0,0,3072,11,8120819465
19491,491205910,616101,491822011,2,0,0,58368,11,5369394224
19492,491246130,214289,491460419,1,0,0,1536,6,5918209680
19493,491259450,457924,491717374,6,0,0,131584,3,8791223903
19494,491335180,13625732,504960912,5,0,1,27136,11,7486879645
19495,491339530,13644349,504983879,6,0,1,13824,3,2180942046
19496,491375620,359925,491735545,1,0,0,2560,6,9876764765
19497,491378270,13619575,504997845,5,0,1,18944,11,6587005979
19498,491430730,287291,491718021,1,0,0,2048,6,6087844777
19499,491451960,373043,491825003,5,0,0,512,11,7978753607
19500,491495760,452408,491948168,2,0,0,114688,11,1523584089
19501,491660870,128398,491789268,1,0,0,4096,6,6729153919
19502,491695000,601588,492296588,5,0,0,5120,11,9931069475
19503,491714270,13284343,504998613,6,0,1,11776,3,6341753620
19504,491729120,305946,492035066,1,0,0,512,6,2671803874
19505,491736550,682511,492419061,6,0,0,211456,3,56526656
19506,491752050,499123,492251173,5,0,0,2048,11,10553029583
19507,491767930,784906,492552836,6,0,0,430592,3,9384612811
19508,491819690,601897,492421587,2,0,0,6144,11,3039273803
19509,491885890,221866,492107756,1,0,0,1024,6,272131822
19510,491911190,644358,492555548,1,0,0,7168,6,3395477641
19511,491976950,442750,492419700,1,0,0,2048,6,6923650985
19512,491988280,13023533,505011813,5,0,1,32768,11,811284032
19513,491994840,617693,492612533,2,0,0,186880,11,9810973941
19514,492032400,848949,492881349,6,0,0,287744,3,4736630723
19515,492156100,397219,492553319,5,0,0,1536,11,2649855784
19516,492161170,452314,492613484,5,0,0,3072,11,3195840253
19517,492220170,445807,492665977,2,0,0,14336,11,5131465699
19518,492233420,385134,492618554,5,0,0,1024,11,6396146104
19519,492261640,412773,492674413,6,0,0,11776,3,8109298635
19520,492288340,455825,492744165,2,0,0,194048,11,1909785365
19521,492336750,12684125,505020875,5,0,1,22016,11,4251338886
19522,492353260,270053,492623313,5,0,0,512,11,512535490
19523,492408110,338501,492746611,5,0,0,7680,11,9214722325
19524,492597540,164371,492761911,5,0,0,512,11,10067852689
19525,492633630,12424161,505057791,5,0,1,61952,11,684902253
19526,492658640,222903,492881543,5,0,0,512,11,5520891758
19527,492716370,165947,492882317,5,0,0,1536,11,9278799333
19528,492719820,539820,493259640,6,0,0,117760,3,8174497079
19529,492819610,150863,492970473,5,0,0,1536,11,2266679360
19530,492851480,464572,493316052,2,0,0,51200,11,6659795672
19531,492874720,12183737,505058457,5,0,1,11264,11,7394289501
19532,492878190,297198,493175388,1,0,0,2560,6,7475822548
19533,492912500,492162,493404662,6,0,0,40448,3,5400052193
19534,492937870,12126635,505064505,5,0,1,17920,11,144247860
19535,492942540,357897,493300437,2,0,0,68096,11,8300481645
19536,493005090,12059761,505064851,5,0,1,512,11,5442520990
19537,493034710,476375,493511085,2,0,0,115200,11,10206702672
19538,493148670,278703,493427373,5,0,0,512,11,3268574603
19539,493242500,163027,493405527,1,0,0,512,6,10534684543
19540,493260010,287718,493547728,2,0,0,3584,11,8748417540
19541,493311880,11753317,505065197,5,0,1,512,11,7344585583
19542,493317320,210956,493528276,2,0,0,5632,11,8882046489
19543,493332670,281463,493614133,5,0,0,512,11,9127478357
19544,493391580,261013,493652593,5,0,0,2048,11,10221520925
19545,493413920,311573,493725493,6,0,0,120832,3,2184545312
19546,493479790,490721,493970511,2,0,0,4608,11,4163219901
19547,493485570,483522,493969092,6,0,0,82432,3,8296023080
19548,493509420,231760,493741180,2,0,0,1536,11,10690941459
19549,493561400,211967,493773367,2,0,0,4608,11,5925756850
19550,493623370,315011,493938381,2,0,0,512,11,3099796713
19551,493630910,277660,493908570,6,0,0,71168,3,8452830948
19552,493667490,539792,494207282,6,0,0,179712,3,5674003828
19553,493707800,530541,494238341,6,0,0,101888,3,6846445858
19554,493788700,673602,494462302,6,0,0,201216,3,3977941482
19555,493826110,819108,494645218,2,0,0,1024,11,5822275470
19556,493932250,207543,494139793,2,0,0,2048,11,2372827090
19557,493966670,289314,494255984,2,0,0,2560,11,6956991128
19558,494015360,328729,494344089,6,0,0,5632,3,3242175308
19559,494046040,416456,494462496,5,0,0,512,11,6650691378
19560,494052650,11012893,505065543,5,0,1,512,11,4427720717
19561,494057820,217605,494275425,5,0,0,5120,11,8307773379
19562,494068250,492374,494560624,2,0,0,4096,11,7724566267
19563,494071030,466212,494537242,1,0,0,4096,6,7161169643
19564,494120830,342001,494462831,1,0,0,1024,6,6661698302
19565,494145090,180699,494325789,2,0,0,1024,11,2517494340
19566,494170870,591529,494762399,6,0,0,61440,3,8558037061
19567,494211210,315458,494526668,1,0,0,1024,6,6599797257
19568,494348630,257701,494606331,2,0,0,3072,11,7314760725
19569,494425280,284319,494709599,1,0,0,4096,6,8696031039
19570,494434020,217200,494651220,5,0,0,512,11,7524586721
19571,494474910,323782,494798692,5,0,0,1024,11,4673923397
19572,494532060,10572415,505104475,8,0,1,38912,6,10447161616
19573,494591940,10512550,505104490,8,0,1,38912,6,9493549320
19574,494603210,159516,494762726,1,0,0,1024,6,6902420277
19575,494614100,244369,494858469,5,0,0,2560,11,6045619273
19576,494694730,258509,494953239,5,0,0,1024,11,2768000291
19577,494729150,215134,494944284,2,0,0,512,11,7111879358
19578,494796450,327992,495124442,5,0,0,512,11,7625197106
19579,494805820,10298685,505104505,8,0,1,6144,6,7090355384
19580,494823910,240574,495064484,5,0,0,1024,11,814042269
19581,494828170,252239,495080409,2,0,0,1024,11,8727675988
19582,494849560,347809,495197369,1,0,0,3072,6,3945234535
19583,494881759,10230410,505112169,8,0,1,39936,6,6812902612
19584,494905790,194367,495100157,2,0,0,8192,11,2640403617
19585,494932359,10183996,505116355,8,0,1,6656,6,1889935601
19586,494969150,10840698,505809848,5,0,1,763392,11,7912591898
19587,494986930,469844,495456774,1,0,0,2560,6,591409476
19588,495026380,318386,495344766,5,0,0,3584,11,2003709788
19589,495059219,10863497,505922716,8,0,1,19456,6,7829121441
19590,495085180,10993473,506078653,5,0,1,54272,11,2373455504
19591,495159200,11070865,506230065,5,0,1,16384,11,4707565039
19592,495170170,102698,495272868,5,0,0,1536,11,9710524772
19593,495221020,212881,495433901,2,0,0,1024,11,10632753830
19594,495223359,11039282,506262641,8,0,1,6656,6,9788914970
19595,495271829,10994998,506266827,8,0,1,6656,6,9499194188
19596,495345499,10928139,506273638,8,0,1,18944,6,1917467323
19597,495346030,144663,495490693,1,0,0,512,6,7112424424
19598,495358109,10922740,506280849,8,0,1,9728,6,8557689779
19599,495531810,125484,495657294,2,0,0,512,11,8253523838
19600,495551680,341299,495892979,6,0,0,10752,3,3631832955
19601,495594690,422454,496017144,5,0,0,7168,11,8888740922
19602,495698190,230568,495928758,6,0,0,8704,3,10268097294
19603,495736970,243859,495980829,5,0,0,1024,11,9773210152
19604,495757940,661688,496419628,6,0,0,59392,3,7714791374
19605,495786330,363010,496149340,6,0,0,68608,3,6311940727
19606,495795710,11047953,506843663,5,0,1,279040,11,3396029626
19607,495894200,10976809,506871009,2,0,1,81920,11,5926889249
19608,495925430,10984601,506910031,5,0,1,53760,11,7801483317
19609,496060190,10903833,506964023,5,0,1,65024,11,1246773051
19610,496089510,190880,496280390,6,0,0,2048,3,6731334855
19611,496127570,267420,496394990,6,0,0,15872,3,6754934288
19612,496137370,322744,496460114,6,0,0,2560,3,5379166410
19613,496212370,117607,496329977,2,0,0,512,11,10145015635
19614,496222530,609902,496832432,6,0,0,284160,3,7805997372
19615,496226000,10819828,507045828,6,0,1,131584,3,9425880295
19616,496243630,305645,496549275,2,0,0,4608,11,9712773154
19617,496461580,371335,496832915,1,0,0,1536,6,6144618471
19618,496513220,10532623,507045843,5,0,1,22016,11,9442657667
19619,496569550,10561100,507130650,5,0,1,100864,11,7310827518
19620,496617350,10513339,507130689,5,0,1,17408,11,7485705860
19621,496670880,162646,496833526,2,0,0,1536,11,8118855248
19622,496678190,10452514,507130704,5,0,1,19968,11,5551305982
19623,496710560,421210,497131770,6,0,0,236544,3,2125859532
19624,496745610,312079,497057689,5,0,0,512,11,1845209019
19625,496773430,370398,497143828,6,0,0,39424,3,2992136715
19626,496839020,390284,497229304,5,0,0,37376,11,9488068973
19627,496900770,471230,497372000,6,0,0,18432,3,1340862336
19628,497053600,309816,497363416,6,0,0,32768,3,1341562364
19629,497061120,410453,497471573,5,0,0,44544,11,5441279889
19630,497063860,340447,497404307,6,0,0,19456,3,10111899637
19631,497170020,310087,497480107,1,0,0,5120,6,3717611746
19632,497234050,9896669,507130719,5,0,1,26624,11,2180715109
19633,497466149,9687595,507153744,8,0,1,7680,6,5962961930
19634,497470260,245464,497715724,5,0,0,6656,11,3757139847
19635,497492070,398849,497890919,6,0,0,121344,3,6504678898
19636,497528560,439006,497967566,6,0,0,48128,3,9678675913
19637,497600300,647936,498248236,5,0,0,201216,11,10473359904
19638,497761700,385541,498147241,5,0,0,9216,11,6668167545
19639,497790660,377467,498168127,1,0,0,1024,6,10580026212
19640,497815450,187121,498002571,2,0,0,5120,11,4638806598
19641,497893180,355539,498248719,1,0,0,1536,6,8497822466
19642,497914730,516581,498431311,5,0,0,113664,11,3590785983
19643,497945970,9314368,507260338,1,0,1,137728,6,8711560382
19644,497975600,538494,498514094,6,0,0,60416,3,5008351396
19645,497997340,350499,498347839,2,0,0,1024,11,4797339622
19646,498119220,185913,498305133,6,0,0,47104,3,8073652421
19647,498144970,299697,498444667,2,0,0,1536,11,3872210690
19648,498180030,623340,498803370,6,0,0,48640,3,2912646902
19649,498258799,9001554,507260353,8,0,1,15360,6,10175350222
19650,498260210,227705,498487915,2,0,0,4608,11,4219490096
19651,498279260,261268,498540528,1,0,0,512,6,9994377479
19652,498316650,8943718,507260368,5,0,1,25600,11,1217467372
19653,498339130,521354,498860484,2,0,0,3072,11,9711627796
19654,498349340,310508,498659848,1,0,0,512,6,4663512388
19655,498385059,8875324,507260383,8,0,1,14336,6,4682412854
19656,498407950,250830,498658780,1,0,0,2048,6,6307036503
19657,498408850,313310,498722160,5,0,0,19456,11,8254942036
19658,498430960,222300,498653260,5,0,0,4096,11,2236744020
19659,498476620,8783778,507260398,8,0,1,1536,6,10590427479
19660,498540749,8719664,507260413,8,0,1,3072,6,7862473760
19661,498553759,8706669,507260428,8,0,1,6144,6,4827023297
19662,498583310,270010,498853320,1,0,0,14848,6,3506402812
19663,498607370,717327,499324697,6,0,0,315904,3,10290622836
19664,498680489,8584232,507264721,8,0,1,17408,6,4877839785
19665,498760630,675775,499436405,1,0,0,295936,6,9255473590
19666,498795620,696537,499492157,1,0,0,182784,6,5777563892
19667,498890620,8379336,507269956,8,0,1,26112,6,4965435136
19668,498917340,664166,499581506,1,0,0,84480,6,2546910408
19669,498995970,559781,499555751,1,0,0,83456,6,9576139380
19670,499063250,676643,499739893,5,0,0,111104,11,1365672905
19671,499112150,380721,499492871,2,0,0,2048,11,440756993
19672,499175880,8163060,507338940,8,0,1,71168,6,3435001150
19673,499204770,549079,499753849,2,0,0,1536,11,5183450645
19674,499259730,696060,499955790,1,0,0,248320,6,10053964557
19675,499330970,8007985,507338955,8,0,1,512,6,3682809088
19676,499607870,582472,500190342,1,0,0,94208,6,6692906755
19677,499610980,406389,500017369,1,0,0,159744,6,6749237779
19678,499757070,309091,500066161,1,0,0,17408,6,7413950743
19679,499787470,325172,500112642,2,0,0,512,11,3261783100
19680,499834170,316962,500151132,1,0,0,51712,6,1526257263
19681,499845350,563337,500408687,1,0,0,276992,6,3982942367
19682,499881270,550832,500432102,6,0,0,76800,3,10085644077
19683,499919020,295081,500214101,1,0,0,33792,6,4712261589
19684,500022560,7326721,507349281,5,0,1,86528,11,619480631
19685,500106280,431759,500538039,6,0,0,130560,3,160215615
19686,500110740,7571080,507681820,5,0,1,349184,11,9343230054
19687,500120140,501229,500621369,1,0,0,22016,6,9796871288
19688,500203750,380306,500584056,2,0,0,4096,11,3042104241
19689,500254160,7427683,507681843,5,0,1,53248,11,4168671554
19690,500287950,534591,500822541,5,0,0,140288,11,2827221817
19691,500291120,7674751,507965871,1,0,1,360448,6,83017780
19692,500292190,661365,500953555,1,0,0,106496,6,6458647962
19693,500298140,607719,500905859,5,0,0,27136,11,120742378
19694,500328190,849784,501177974,1,0,0,286208,6,2913431328
19695,500343790,401278,500745068,6,0,0,38912,3,4999285212
19696,500460260,437316,500897576,1,0,0,137728,6,9947554998
19697,500520920,670991,501191911,2,0,0,3072,11,10528994196
19698,500551920,478532,501030452,2,0,0,512,11,9438182937
19699,500573670,830529,501404199,5,0,0,261632,11,4788398008
19700,500625950,565002,501190952,5,0,0,38400,11,10199864962
19701,500724410,680451,501404861,2,0,0,1024,11,8777428476
19702,500766690,7487837,508254527,5,0,1,135168,11,7161026897
19703,500848150,331087,501179237,6,0,0,4096,3,6703690742
19704,500920310,484224,501404534,2,0,0,1024,11,6202524020
19705,500947520,376451,501323971,1,0,0,4608,6,568130179
19706,500969660,263211,501232871,2,0,0,10240,11,7908367454
19707,500993630,288657,501282287,2,0,0,1024,11,4616996190
19708,501027220,564049,501591269,1,0,0,155136,6,3487226426
19709,501059860,481804,501541664,5,0,0,97280,11,6132243752
19710,501151050,442262,501593312,2,0,0,6656,11,6483271755
19711,501186590,325419,501512009,6,0,0,56320,3,8067134667
19712,501302810,322399,501625209,5,0,0,36352,11,1992523460
19713,501312490,230601,501543091,2,0,0,4608,11,2075292577
19714,501340380,367704,501708084,5,0,0,79360,11,713484819
19715,501494290,214604,501708894,2,0,0,2560,11,4567214692
19716,501500060,240415,501740475,2,0,0,2048,11,5838571013
19717,501602730,206891,501809621,2,0,0,512,11,6517310801
19718,501625080,306943,501932023,2,0,0,1024,11,7225107585
19719,501649360,6790761,508440121,5,0,1,9728,11,2671538299
19720,501666760,564607,502231367,6,0,0,65536,3,4804215754
19721,501766160,468777,502234937,2,0,0,512,11,2337670907
19722,501791900,7386630,509178530,2,0,1,446464,11,1182882442
19723,501813230,7463535,509276765,5,0,1,83456,11,799074441
19724,501825580,603172,502428752,5,0,0,176128,11,3091407920
19725,501827600,215038,502042638,2,0,0,512,11,5869346970
19726,501828760,600631,502429391,2,0,0,2048,11,6417903375
19727,501863740,7850417,509714157,2,0,1,518656,11,2060392503
19728,501874520,7877279,509751799,2,0,1,86016,11,5469254726
19729,501971010,7787839,509758849,5,0,1,73728,11,3286037843
19730,501981080,8771163,510752243,2,0,1,883712,11,9666699277
19731,502001600,462762,502464362,6,0,0,65024,3,44005975
19732,502024070,498177,502522247,2,0,0,512,11,4257125671
19733,502099630,1170776,503270406,5,0,0,492544,11,6268962092
19734,502103780,431358,502535138,6,0,0,25088,3,7779332999
19735,502111680,410396,502522076,5,0,0,147456,11,990124755
19736,502159820,849617,503009437,2,0,0,1024,11,6951591720
19737,502186700,743183,502929883,2,0,0,4608,11,1852563094
19738,502231610,1101367,503332977,5,0,0,205312,11,9276813741
19739,502291000,8687228,510978228,2,0,1,123904,11,4119994161
19740,502291200,8840656,511131856,2,0,1,181248,11,3852011752
19741,502300450,1094794,503395244,5,0,0,204288,11,4921703123
19742,502360610,1117717,503478327,6,0,0,269824,3,2081624217
19743,502368610,8867008,511235618,2,0,1,115200,11,1958669439
19744,502397840,9076549,511474389,5,0,1,265216,11,3296989026
19745,502435320,9039084,511474404,2,0,1,35840,11,2363486361
19746,502467050,928871,503395921,2,0,0,512,11,1171700375
19747,502485490,525327,503010817,2,0,0,512,11,5528678202
19748,502598360,8876059,511474419,2,0,1,61440,11,3910380722
19749,502658980,912673,503571653,6,0,0,240128,3,9407874687
19750,502766050,851996,503618046,5,0,0,141312,11,8944338925
19751,502789900,605827,503395727,2,0,0,1536,11,9291008933
19752,502858140,8637057,511495197,5,0,1,33280,11,7486604860
19753,502912300,586174,503498474,6,0,0,66048,3,1386711469
19754,502982040,8656875,511638915,2,0,1,119296,11,7937438023
19755,502984510,590457,503574967,6,0,0,8192,3,2932447051
19756,502997490,700653,503698143,6,0,0,260608,3,5446511233
19757,503013470,382622,503396092,2,0,0,512,11,2048137357
19758,503033480,538976,503572456,2,0,0,2560,11,2302308238
19759,503063430,8790291,511853721,2,0,1,118272,11,6755571779
19760,503081220,8811391,511892611,2,0,1,204800,11,4152839771
19761,503120240,498460,503618700,2,0,0,2048,11,1966569204
19762,503245710,452620,503698330,2,0,0,512,11,9883264977
19763,503305120,8629402,511934522,2,0,1,93696,11,10428189777
19764,503352880,360174,503713054,2,0,0,1024,11,1871417830
19765,503507540,8472538,511980078,2,0,1,71168,11,1616038499
19766,503579070,8402852,511981922,2,0,1,25088,11,1480606179
19767,503584730,240565,503825295,6,0,0,66560,3,6640251505
19768,503638020,8378093,512016113,2,0,1,122368,11,10039482751
19769,503705430,324354,504029784,2,0,0,2048,11,2584594343
19770,503750100,801247,504551347,6,0,0,285696,3,1324434612
19771,503776230,902683,504678913,5,0,0,56320,11,2169056889
19772,503827940,8282467,512110407,2,0,1,216064,11,10711269671
19773,503921680,714234,504635914,5,0,0,277504,11,1471864509
19774,504000360,744858,504745218,5,0,0,107520,11,10570729164
19775,504128250,691710,504819960,6,0,0,119808,3,5013271290
19776,504168690,490343,504659033,5,0,0,75776,11,3001765911
19777,504193630,8168785,512362415,2,0,1,176128,11,3745855005
19778,504231140,430598,504661738,6,0,0,512,3,1236151107
19779,504328810,332749,504661559,5,0,0,8192,11,8347679820
19780,504456850,313595,504770445,2,0,0,1536,11,4880024386
19781,504457700,426516,504884216,6,0,0,12800,3,8447458127
19782,504495270,609190,505104460,5,0,0,97280,11,3886039927
19783,504521470,261159,504782629,2,0,0,512,11,5381210108
19784,504605910,7908082,512513992,2,0,1,91648,11,9532668218
19785,504673080,304059,504977139,5,0,0,9728,11,4180184887
19786,504691370,306376,504997746,5,0,0,12288,11,1803162701
19787,504778520,7808510,512587030,2,0,1,75264,11,9645525191
19788,504850020,217323,505067343,2,0,0,512,11,4357832824
19789,504900640,693140,505593780,5,0,0,7168,11,5002726563
19790,504913950,530194,505444144,5,0,0,48640,11,1500748444
19791,504952990,409343,505362333,6,0,0,14336,3,9672595372
19792,504992660,289811,505282471,6,0,0,20992,3,8039030670
19793,504999820,2193406,507193226,6,0,0,99840,3,4573131170
19794,505023100,7563945,512587045,2,0,1,22528,11,9217631346
19795,505072580,7635677,512708257,2,0,1,243712,11,7927090467
19796,505094940,7613332,512708272,2,0,1,24576,11,2783425406
19797,505180470,7527817,512708287,2,0,1,13312,11,10210930511
19798,505202290,740514,505942804,5,0,0,49664,11,528967824
19799,505209520,820984,506030504,6,0,0,182272,3,3964841937
19800,505227530,1470360,506697890,2,0,0,371200,11,5198916824
19801,505228960,7502911,512731871,2,0,1,45568,11,8804912225
19802,505232910,214560,505447470,2,0,0,4608,11,2970697582
19803,505252920,1711088,506964008,5,0,0,146944,11,1347138430
19804,505267710,478408,505746118,5,0,0,40448,11,3422116273
19805,505268190,2070735,507338925,2,0,0,207360,11,1820455934
19806,505329360,326989,505656349,2,0,0,5632,11,1309388280
19807,505499130,1326548,506825678,6,0,0,142848,3,5137565952
19808,505515360,7412328,512927688,2,0,1,87040,11,2377279445
19809,505601730,1981094,507582824,5,0,0,614400,11,4003666872
19810,505612470,2044188,507656658,6,0,0,234496,3,626007874
19811,505622320,1129592,506751912,5,0,0,162304,11,7523467316
19812,505665640,769599,506435239,6,0,0,56832,3,8596469112
19813,505712670,7383826,513096496,6,0,1,151552,3,2282321797
19814,505736980,1096669,506833649,5,0,0,26112,11,5340274543
19815,505810770,7528166,513338936,2,0,1,467968,11,447452498
19816,505865010,837427,506702437,6,0,0,14848,3,5617587210
19817,505866150,7600752,513466902,6,0,1,262144,3,10461684279
19818,505937470,955931,506893401,2,0,0,35840,11,2748027598
19819,505938860,7597990,513536850,2,0,1,96768,11,627286142
19820,505947760,895888,506843648,2,0,0,32768,11,8661007836
19821,505977650,1152985,507130635,5,0,0,125952,11,10594331391
19822,505995870,875108,506870978,2,0,0,89600,11,9815758928
19823,506059150,7522954,513582104,6,0,1,49664,3,7936504048
19824,506084370,1175953,507260323,2,0,0,215552,11,501161457
19825,506317010,744990,507062000,2,0,0,47104,11,10304906718
19826,506413950,7194108,513608058,6,0,1,35328,3,2904883937
19827,506473500,572313,507045813,5,0,0,81920,11,6569639481
19828,506543030,428028,506971058,2,0,0,23040,11,8740045179
19829,506602250,7075970,513678220,6,0,1,67072,3,8400751681
19830,506669080,7170171,513839251,6,0,1,250368,3,5501783554
19831,506708490,973299,507681789,2,0,0,82432,11,4759496616
19832,506732020,7147181,513879201,6,0,1,85504,3,5534215287
19833,506749360,7173233,513922593,6,0,1,84480,3,359965896
19834,506987690,6949492,513937182,6,0,1,63488,3,6501161596
19835,506989840,7068559,514058399,2,0,1,207360,11,8502863209
19836,506999080,7124803,514123883,6,0,1,123392,3,5242323586
19837,507018120,567075,507585195,5,0,0,7680,11,10642761596
19838,507048330,7078461,514126791,2,0,1,7680,11,5037813358
19839,507101230,7025920,514127150,6,0,1,9728,3,6242480961
19840,507132630,7003108,514135738,2,0,1,40960,11,1120259650
19841,507170300,573178,507743478,5,0,0,202240,11,4140817984
19842,507357940,6870409,514228349,6,0,1,148992,3,3019488314
19843,507388460,652151,508040611,6,0,0,6144,3,5261243261
19844,507394900,1045206,508440106,5,0,0,524288,11,5373402244
19845,507542400,1301766,508844166,5,0,0,254976,11,3131709888
19846,507551580,1037570,508589150,5,0,0,203264,11,304431934
19847,507579450,671636,508251086,6,0,0,47616,3,8477844556
19848,507699050,828153,508527203,2,0,0,87552,11,7671288387
19849,507702120,6619482,514321602,6,0,1,200704,3,6629377531
19850,507709070,966501,508675571,6,0,0,253440,3,1417189809
19851,507829440,6797355,514626795,6,0,1,517120,3,5145382670
19852,507867190,6764111,514631301,6,0,1,7168,3,1398264523
19853,507900380,1278127,509178507,6,0,0,326656,3,9770438893
19854,507908440,983500,508891940,2,0,0,25600,11,7494716792
19855,507928890,6805805,514734695,6,0,1,193536,3,1975913907
19856,507957490,1426306,509383796,2,0,0,351232,11,9117843542
19857,508019730,864387,508884117,5,0,0,131072,11,1798617886
19858,508192130,563897,508756027,2,0,0,7680,11,1620357538
19859,508216750,460240,508676990,5,0,0,4608,11,8542569725
19860,508309950,1322120,509632070,2,0,0,636928,11,1802886344
19861,508421280,1277488,509698768,2,0,0,133632,11,425502294
19862,508570840,849319,509420159,6,0,0,119296,3,10287824232
19863,508742550,534200,509276750,2,0,0,53760,11,249230763
19864,508839940,863999,509703939,5,0,0,16896,11,9556707578
19865,508958860,699121,509657981,2,0,0,84992,11,2885518273
19866,508966990,5770832,514737822,2,0,1,63488,11,3631138569
19867,509022030,729754,509751784,6,0,0,123392,3,1679241662
19868,509037180,5796975,514834155,2,0,1,228864,11,7267329176
19869,509094700,5853652,514948352,2,0,1,238592,11,2119605636
19870,509205780,508330,509714110,5,0,0,33280,11,3027541721
19871,509232460,6003167,515235627,2,0,1,673280,11,5276271029
19872,509234420,6018266,515252686,5,0,1,55296,11,4218042279
19873,509309920,674001,509983921,6,0,0,11264,3,2589955584
19874,509314390,5944871,515259261,5,0,1,7680,11,4792918096
19875,509342930,6105245,515448175,5,0,1,315904,11,785764527
19876,509348540,982547,510331087,5,0,0,87040,11,7110590026
19877,509366320,1054482,510420802,5,0,0,294400,11,6751385625
19878,509377470,783174,510160644,5,0,0,131584,11,7589191258
19879,509448450,654224,510102674,5,0,0,167424,11,7856424092
19880,509516020,5932170,515448190,2,0,1,39936,11,4586932103
19881,509576060,532557,510108617,5,0,0,19456,11,1918924222
19882,509620750,854502,510475252,5,0,0,72192,11,4307566687
19883,509648370,1483471,511131841,6,0,0,166912,3,8637757550
19884,509658180,1140123,510798303,5,0,0,124416,11,1975977817
19885,509693130,898278,510591408,6,0,0,13312,3,9994049177
19886,509815280,637961,510453241,5,0,0,88576,11,10173037658
19887,509830580,720117,510550697,5,0,0,30720,11,425850622
19888,509841140,5644229,515485369,5,0,1,96768,11,8648430504
19889,509854120,787689,510641809,2,0,0,153088,11,9942231768
19890,509895110,5831249,515726359,5,0,1,210944,11,6274763446
19891,509964330,1271265,511235595,5,0,0,198144,11,3765420908
19892,510011200,1025273,511036473,6,0,0,95232,3,8957676400
19893,510123320,5603054,515726374,5,0,1,5120,11,481614573
19894,510128140,1224665,511352805,5,0,0,9728,11,5154070169
19895,510217360,760853,510978213,6,0,0,92672,3,1647176346
19896,510223250,332298,510555548,6,0,0,15872,3,5519302428
19897,510347860,1126506,511474366,5,0,0,351232,11,8368156546
19898,510357340,518172,510875512,6,0,0,2048,3,83478534
19899,510522460,5203929,515726389,5,0,1,83456,11,5515098552
19900,510830170,778746,511608916,5,0,0,298496,11,4577518236
19901,510840850,317531,511158381,6,0,0,3072,3,10703358042
19902,511014010,4857631,515871641,5,0,1,345600,11,3633975485
19903,511046190,4844193,515890383,5,0,1,46080,11,1653802579
19904,511066940,786758,511853698,5,0,0,409600,11,10428798972
19905,511100940,4795294,515896234,5,0,1,27648,11,3511499679
19906,511141310,4856741,515998051,5,0,1,198144,11,4628857822
19907,511202970,292212,511495182,5,0,0,68096,11,3802452971
19908,511269880,4752903,516022783,5,0,1,90112,11,4601113251
19909,511283740,4813119,516096859,5,0,1,146432,11,7871076246
19910,511326450,4808374,516134824,5,0,1,64000,11,7095585615
19911,511410120,482460,511892580,5,0,0,127488,11,5234227154
19912,511746450,481742,512228192,5,0,0,54272,11,5498455412
19913,511874540,443160,512317700,6,0,0,104960,3,6406047161
19914,511880690,461361,512342051,6,0,0,79872,3,751163557
19915,511952150,435451,512387601,5,0,0,512,11,3393294223
19916,511952320,561641,512513961,5,0,0,185344,11,2334120913
19917,511953320,402474,512355794,5,0,0,45056,11,159328630
19918,512002150,584865,512587015,6,0,0,239616,3,920504292
19919,512100410,4283617,516384027,6,0,1,465408,3,5680883975
19920,512127420,580822,512708242,6,0,0,94208,3,1665151110
19921,512459110,637355,513096465,5,0,0,367616,11,561098327
19922,512461630,967784,513429414,5,0,0,123392,11,3971645590
19923,512616450,722439,513338889,5,0,0,197632,11,8529341408
19924,512844350,719287,513563637,6,0,0,77824,3,5036597644
19925,512999650,3399707,516399357,6,0,1,57344,3,7133575749
19926,513001500,837736,513839236,6,0,0,52736,3,1723912096
19927,513068170,450074,513518244,5,0,0,111616,11,8717720611
19928,513090930,3426338,516517268,6,0,1,197120,3,7166199315
19929,513165580,939077,514104657,6,0,0,110080,3,7537449485
19930,513240220,3310433,516550653,6,0,1,156672,3,1725440231
19931,513265680,3399525,516665205,6,0,1,288768,3,3387866073
19932,513282520,3398854,516681374,6,0,1,53248,3,4764158661
19933,513293400,3428084,516721484,6,0,1,70144,3,2522785084
19934,513295050,627528,513922578,6,0,0,62976,3,10582462461
19935,513326450,402305,513728755,5,0,0,100864,11,7949830542
19936,513407320,549828,513957148,5,0,0,42496,11,9062155770
19937,513448630,280304,513728934,6,0,0,512,3,6660697259
19938,513715460,3068752,516784212,6,0,1,179712,3,6350485207
19939,513747830,376038,514123868,5,0,0,62976,11,9910829801
19940,513796840,453008,514249848,5,0,0,8704,11,15332983
19941,513846080,375035,514221115,5,0,0,39424,11,1666058701
19942,513877140,495799,514372939,6,0,0,2048,3,8024855191
19943,513949190,2957190,516906380,6,0,1,286720,3,9716970659
19944,514097930,2901498,516999428,6,0,1,222720,3,3724459289
19945,514104620,327668,514432288,5,0,0,86016,11,5506972495
19946,514135350,3038717,517174067,6,0,1,418304,3,9610246515
19947,514138030,596650,514734680,5,0,0,61440,11,9944879948
19948,514164100,3150638,517314738,6,0,1,341504,3,9995584961
19949,514171610,301874,514473484,5,0,0,59904,11,1332278970
19950,514172560,260999,514433559,6,0,0,4096,3,3099967968
19951,514383170,366986,514750156,5,0,0,28160,11,2789416912
19952,514542920,379806,514922726,5,0,0,74752,11,6777819365
19953,514727740,2588304,517316044,6,0,1,2048,3,624225928
19954,514828700,2532372,517361072,6,0,1,121344,3,4413270590
19955,514898710,2609174,517507884,6,0,1,357376,3,6084416257
19956,515041070,407090,515448160,5,0,0,122368,11,102987023
19957,515171590,554754,515726344,5,0,0,294400,11,5564255267
19958,515195940,2329306,517525246,6,0,1,40448,3,6906690098
19959,515267410,2272495,517539905,6,0,1,52224,3,8520030335
19960,515343840,2333720,517677560,6,0,1,281088,3,1291518911
19961,515483620,247004,515730624,5,0,0,13824,11,7574638261
19962,515485180,2369119,517854299,6,0,1,386560,3,5596966817
19963,515576000,2280956,517856956,6,0,1,2048,3,3029233852
19964,515694810,153210,515848020,6,0,0,1536,3,6905952809
19965,515701930,397782,516099712,6,0,0,1536,3,2381643489
19966,515827880,251166,516079046,6,0,0,2560,3,7641735591
19967,515878120,639133,516517253,5,0,0,159744,11,9709368601
19968,515879160,2080856,517960016,6,0,1,226304,3,6972076421
19969,515896790,2082480,517979270,6,0,1,59904,3,4434534256
19970,516426170,1554125,517980295,6,0,1,20992,3,8413589158
19971,516562180,210823,516773003,6,0,0,4096,3,7997399245
19972,516600720,222473,516823193,6,0,0,1536,3,5461994086
19973,516630520,1365823,517996343,6,0,1,11776,3,7058340499
19974,516711130,298765,517009895,5,0,0,28672,11,3789287867
19975,516782600,270366,517052966,6,0,0,1536,3,4741692860
19976,516941550,1111025,518052575,6,0,1,135168,3,8169078883
19977,517213460,863626,518077086,6,0,1,72704,3,319812935
19978,517235040,288708,517523748,5,0,0,1024,11,10359330830
19979,517245010,389185,517634195,5,0,0,24576,11,3775525413
19980,517257240,230981,517488221,6,0,0,2560,3,8661973681
19981,517386260,988141,518374401,6,0,1,616448,3,9327135397
19982,517429960,967436,518397396,6,0,1,66560,3,2034287606
19983,517464420,342705,517807125,6,0,0,2048,3,4580418092
19984,517521460,300086,517821546,6,0,0,2560,3,9044631773
19985,517547430,208489,517755919,6,0,0,2560,3,2022539413
19986,517554990,466806,518021796,6,0,0,1536,3,942806015
19987,518083890,391662,518475552,5,0,0,231936,11,6041377256
19988,518128320,347559,518475879,6,0,0,1024,3,6752773020
19989,518150520,593625,518744145,5,0,0,93696,11,174127270
19990,518183430,317630,518501060,6,0,0,5120,3,9596835644
19991,518228500,435134,518663634,5,0,0,38400,11,9450220482
19992,518483000,388255,518871255,5,0,0,84992,11,10052540880
19993,518511130,233342,518744472,6,0,0,1024,3,7450466864
19994,518669820,379941,519049761,5,0,0,195072,11,5027224214
19995,518761090,313929,519075019,6,0,0,4096,3,2409794006
19996,519138290,450296,519588586,6,0,0,403968,3,7437949295
19997,519140160,210316,519350476,6,0,0,12288,3,1483781000
19998,519369010,320698,519689708,5,0,0,48128,11,8699440416
19999,519448170,355791,519803961,5,0,0,273408,11,1678456345
