RequestID,ArrivalTime,DelayTime,FinishTime,InitiatorID,TargetID,IOType,Size,VolumeID,Offset
0,0,2751,2751,0,0,1,2560,25,685893151
1,1,4964,4965,8,0,1,10752,26,1086886107
2,2,44016,44018,7,0,0,512,18,2513634398
3,3,7280,7283,6,0,1,3072,8,2534909015
4,4,7945,7949,5,0,1,1024,15,8285929732
5,5,45705,45710,4,0,0,1024,14,7504523612
6,6,10209,10215,3,0,1,3584,29,3295552731
7,7,94452,94459,2,0,0,19456,9,2307251169
8,8,10668,10676,1,0,1,10240,2,3919821844
9,9,94933,94942,9,0,0,1536,17,6851770099
10,8620,2402,11022,3,0,1,512,29,4501658102
11,9239,69956,79195,6,0,0,8192,8,2915719775
12,9830,75188,85018,9,0,0,512,17,7663205710
13,29310,2470,31780,3,0,1,2560,29,4068544089
14,31690,5454,37144,0,0,1,13824,25,2943815144
15,38601,3128,41729,4,0,1,9216,14,3809006864
16,53570,5454,59024,6,0,1,13824,8,1778186198
17,74350,161933,236283,2,0,0,31744,9,5648227752
18,96190,566,96756,3,0,1,512,29,9788310465
19,106230,12049,118279,6,0,1,19968,8,3553856019
20,110980,12445,123425,1,0,1,8192,2,2250912792
21,111610,44682,156292,7,0,0,512,18,9705556600
22,124560,2870,127430,5,0,1,8704,15,7451339068
23,124730,3590,128320,8,0,1,1024,26,654655957
24,126830,3230,130060,0,0,1,2560,25,7135040234
25,134589,155838,290427,6,0,0,48128,8,837063355
26,145660,5326,150986,5,0,1,5632,15,2575523948
27,146160,50710,196870,2,0,0,2560,9,4440116829
28,147520,5732,153252,3,0,1,3584,29,2022005766
29,155060,228348,383408,2,0,0,62464,9,4499121851
30,170750,1518,172268,0,0,1,1536,25,9998219219
31,175090,2870,177960,8,0,1,8704,26,9243501906
32,176020,2337,178357,5,0,1,512,15,10290562684
33,178850,60779,239629,4,0,0,512,14,10019588233
34,185429,282109,467538,6,0,0,9216,8,5459259338
35,187509,566,188075,7,0,1,512,18,4056525650
36,196739,11914,208653,7,0,1,19456,18,12806534
37,197481,12158,209639,4,0,1,1536,14,10528231469
38,197691,243613,441304,0,0,0,30720,25,2541523377
39,205590,150966,356556,4,0,0,512,14,9298936946
40,219320,16986,236306,0,0,1,22528,25,7917995636
41,220231,16090,236321,4,0,1,1024,14,453445130
42,228960,183668,412628,4,0,0,1024,14,930933078
43,233860,6830,240690,0,0,1,4608,25,7951776027
44,240620,224095,464715,2,0,0,18432,9,4957845034
45,250530,3898,254428,8,0,1,4096,26,4428115882
46,255561,566,256127,4,0,1,512,14,1198613156
47,262321,2946,265267,4,0,1,3072,14,3789016337
48,266230,69284,335514,2,0,0,8192,9,2508061029
49,279311,218923,498234,2,0,0,58880,9,9235543855
50,295520,4420,299940,1,0,1,11776,2,9367562633
51,308820,3645,312465,6,0,1,10240,8,7854973202
52,310560,244866,555426,2,0,0,17408,9,2329954154
53,313890,566,314456,0,0,1,512,25,4785640772
54,315809,4374,320183,7,0,1,4608,18,5129630505
55,321400,5802,327202,0,0,1,6144,25,1465947343
56,340239,77103,417342,6,0,0,5120,8,1543726506
57,363599,160140,523739,6,0,0,14848,8,1546896361
58,372270,14258,386528,6,0,1,9216,8,1566482749
59,383930,5197,389127,6,0,1,8704,8,3882371034
60,411280,56845,468125,9,0,0,512,17,2209876720
61,411680,170332,582012,7,0,0,1024,18,10724371543
62,423340,566,423906,8,0,1,512,26,8337751546
63,427940,3422,431362,5,0,1,3584,15,10279065590
64,428691,12628,441319,4,0,1,1024,14,1187056511
65,432220,9657,441877,8,0,1,512,26,107518026
66,443810,232445,676255,2,0,0,38400,9,9224757224
67,445409,1042,446451,7,0,1,1024,18,10614592900
68,449790,99739,549529,9,0,0,2048,17,1520862462
69,464059,7369,471428,7,0,1,4096,18,1332312493
70,469990,93642,563632,7,0,0,1536,18,10173108085
71,475370,115940,591310,4,0,0,512,14,5054080863
72,475759,22490,498249,9,0,1,8192,17,2441223379
73,508910,1042,509952,5,0,1,1024,15,1564209056
74,512590,4420,517010,3,0,1,11776,29,5640264818
75,515150,8604,523754,1,0,1,5120,2,4288488531
76,519090,66618,585708,2,0,0,3072,9,10606568025
77,528540,1042,529582,1,0,1,1024,2,5747825831
78,550050,5399,555449,3,0,1,4608,29,6910078279
79,550070,9213,559283,5,0,1,4096,15,2147678522
80,558010,2870,560880,5,0,1,8704,15,5737734343
81,571980,10499,582479,1,0,1,16896,2,5714782558
82,573070,132893,705963,7,0,0,512,18,7364190324
83,573699,9446,583145,7,0,1,1024,18,9243022872
84,576440,7371,583811,0,0,1,1024,25,7330194307
85,579330,7067,586397,3,0,1,4096,29,8191570368
86,582220,99445,681665,9,0,0,512,17,5128959694
87,589949,2870,592819,7,0,1,8704,18,3765191299
88,591180,2988,594168,3,0,1,1536,29,10620555955
89,619410,194631,814041,9,0,0,512,17,8131190142
90,625209,4162,629371,7,0,1,11264,18,4996866668
91,637500,271941,909441,2,0,0,26624,9,4553175138
92,644190,10757,654947,5,0,1,17408,15,2300847712
93,647951,318139,966090,0,0,0,101888,25,9939273590
94,657840,233982,891822,9,0,0,19456,17,10180971646
95,665330,14356,679686,3,0,1,3584,29,1590075271
96,668430,152603,821033,7,0,0,512,18,6655238948
97,676950,6184,683134,5,0,1,14336,15,9218349919
98,677240,7840,685080,1,0,1,3072,2,5181071436
99,680610,334099,1014709,9,0,0,15872,17,6213995419
100,707320,3898,711218,0,0,1,4096,25,7960703692
101,707540,5624,713164,0,0,1,3072,25,3251441704
102,715201,294657,1009858,0,0,0,25088,25,4802052169
103,720440,491379,1211819,2,0,0,124928,9,8507583726
104,733639,2470,736109,7,0,1,2560,18,5273162663
105,733939,4436,738375,7,0,1,3584,18,10051571047
106,735660,369134,1104794,9,0,0,67072,17,8059685587
107,737509,5326,742835,7,0,1,5632,18,9429270973
108,760929,5454,766383,7,0,1,13824,18,8214296366
109,761670,253389,1015059,4,0,0,512,14,10081756216
110,773111,337322,1110433,0,0,0,18432,25,2226524100
111,783760,182829,966589,7,0,0,1536,18,9761251796
112,797580,186351,983931,9,0,0,27648,17,3662586340
113,804200,369540,1173740,2,0,0,55296,9,937862936
114,811789,6278,818067,9,0,1,6656,17,4217561434
115,812310,6103,818413,3,0,1,512,29,1646159186
116,824360,3422,827782,3,0,1,3584,29,9300647042
117,837991,378835,1216826,0,0,0,16384,25,3892775599
118,840590,88573,929163,4,0,0,512,14,1429921498
119,860310,2946,863256,5,0,1,3072,15,8850225296
120,864060,3898,867958,3,0,1,4096,29,1771525832
121,871080,6754,877834,5,0,1,7168,15,46785254
122,873950,8070,882020,5,0,1,6656,15,1401099788
123,889080,125808,1014888,4,0,0,512,14,3344214183
124,897460,372041,1269501,9,0,0,87040,17,1544041800
125,909710,2470,912180,5,0,1,2560,15,6616442916
126,915590,1994,917584,3,0,1,2048,29,7316463990
127,935820,393839,1329659,9,0,0,18432,17,9922952505
128,936341,339454,1275795,0,0,0,20480,25,8725896961
129,942460,274545,1217005,7,0,0,512,18,289660357
130,958890,8758,967648,5,0,1,1024,15,4531288549
131,970180,3128,973308,3,0,1,9216,29,6219197823
132,988651,415612,1404263,0,0,0,32768,25,6656650782
133,999370,346408,1345778,9,0,0,3072,17,3798405697
134,1010600,320189,1330789,4,0,0,2048,14,6413202907
135,1025790,259083,1284873,4,0,0,512,14,81116451
136,1031500,1518,1033018,3,0,1,1536,29,2322875788
137,1035439,2946,1038385,7,0,1,3072,18,345086351
138,1050050,273776,1323826,2,0,0,102400,9,6528163982
139,1069310,1518,1070828,5,0,1,1536,15,186150475
140,1073430,256720,1330150,2,0,0,1536,9,3062321224
141,1080861,254661,1335522,0,0,0,14336,25,7542903946
142,1081490,249649,1331139,4,0,0,512,14,5636455272
143,1085780,27558,1113338,3,0,1,3072,29,8387214170
144,1109430,182986,1292416,2,0,0,24576,9,9643295342
145,1112460,180143,1292603,7,0,0,512,18,4338559727
146,1118321,124645,1242966,0,0,0,4096,25,821386454
147,1152900,131802,1284702,2,0,0,29184,9,9272082379
148,1188770,279409,1468179,9,0,0,68096,17,12162890
149,1197880,22779,1220659,3,0,1,10240,29,8568743728
150,1210430,11698,1222128,8,0,1,2048,26,601644193
151,1220490,8048,1228538,8,0,1,8192,26,300923175
152,1220750,103263,1324013,7,0,0,512,18,5373285806
153,1236560,94408,1330968,4,0,0,512,14,147358205
154,1241070,28454,1269524,8,0,1,4096,26,3694778450
155,1244430,263256,1507686,2,0,0,10240,9,9391530274
156,1247060,115306,1362366,7,0,0,512,18,6600779728
157,1251480,217525,1469005,4,0,0,1536,14,9328491222
158,1255600,218558,1474158,4,0,0,1024,14,7025698618
159,1257661,213425,1471086,0,0,0,1024,25,10219020340
160,1257730,66298,1324028,0,0,1,17408,25,3714996286
161,1258591,295030,1553621,0,0,0,103424,25,5411588307
162,1261751,356352,1618103,0,0,0,56832,25,8615868200
163,1265400,70137,1335537,8,0,1,6656,26,1464002347
164,1274020,61532,1335552,5,0,1,4096,15,6798283467
165,1310350,337859,1648209,9,0,0,15360,17,797726572
166,1317640,150874,1468514,4,0,0,1024,14,3988489074
167,1338270,3904,1342174,3,0,1,10752,29,10591668013
168,1338360,4480,1342840,3,0,1,1024,29,4512776673
169,1346560,1518,1348078,8,0,1,1536,26,7115374942
170,1349510,4374,1353884,5,0,1,4608,15,1691867316
171,1350009,5501,1355510,7,0,1,2560,18,8397619317
172,1360141,227660,1587801,0,0,0,9216,25,7825094357
173,1360610,114096,1474706,4,0,0,512,14,7996403267
174,1392730,205531,1598261,9,0,0,18432,17,9039971021
175,1399919,8251,1408170,7,0,1,4096,18,3520241653
176,1401170,69396,1470566,7,0,0,512,18,5663406347
177,1442930,110862,1553792,4,0,0,512,14,7504307234
178,1449271,21310,1470581,4,0,1,1536,14,5534917476
179,1458590,276576,1735166,7,0,0,2048,18,10098929536
180,1475940,78023,1553963,7,0,0,512,18,56189212
181,1478271,149912,1628183,2,0,0,4608,9,1895075553
182,1483281,4420,1487701,4,0,1,11776,14,10427514621
183,1495999,7706,1503705,7,0,1,8192,18,9037536633
184,1506261,228258,1734519,2,0,0,70656,9,2414941254
185,1509720,6278,1515998,8,0,1,6656,26,9375900343
186,1549260,6230,1555490,0,0,1,1536,25,1565115731
187,1553580,3856,1557436,0,0,1,3072,25,800250596
188,1588869,11274,1600143,7,0,1,18432,18,88873238
189,1608811,247211,1856022,0,0,0,87040,25,7331870563
190,1615381,301518,1916899,2,0,0,67584,9,5124993296
191,1616490,6029,1622519,0,0,1,4608,25,9808743705
192,1639550,96099,1735649,4,0,0,1536,14,10344471126
193,1650440,3898,1654338,0,0,1,4096,25,1077055206
194,1677620,147321,1824941,2,0,0,21504,9,303998133
195,1678740,265781,1944521,4,0,0,1536,14,8774517612
196,1689440,3422,1692862,3,0,1,3584,29,6220989021
197,1717830,93845,1811675,9,0,0,2048,17,9592890804
198,1733511,196383,1929894,2,0,0,42496,9,5021887700
199,1758961,375199,2134160,0,0,0,80896,25,2238235795
200,1762551,256549,2019100,2,0,0,25600,9,5325990168
201,1770219,2870,1773089,9,0,1,8704,17,1774044036
202,1787970,12308,1800278,0,0,1,20480,25,5708768727
203,1795950,181305,1977255,7,0,0,512,18,7914490094
204,1796451,214655,2011106,2,0,0,51200,9,526544771
205,1801300,3904,1805204,1,0,1,10752,2,5665395318
206,1803410,135465,1938875,9,0,0,24064,17,570270382
207,1811489,5632,1817121,9,0,1,13824,17,2870984146
208,1841670,133962,1975632,7,0,0,512,18,4245810064
209,1845221,328755,2173976,2,0,0,7680,9,3002992083
210,1868020,90530,1958550,7,0,0,1024,18,8829698485
211,1868740,3898,1872638,1,0,1,4096,2,1496528052
212,1877259,2946,1880205,9,0,1,3072,17,9240312812
213,1893120,296003,2189123,9,0,0,49664,17,972081608
214,1896720,34175,1930895,0,0,1,1024,25,3027272851
215,1897981,543337,2441318,0,0,0,100352,25,8805822622
216,1898820,322822,2221642,4,0,0,1536,14,1576925424
217,1901659,37231,1938890,9,0,1,1536,17,4823113081
218,1924070,130688,2054758,4,0,0,512,14,618456811
219,1926570,84707,2011277,4,0,0,512,14,9370396050
220,1929259,9654,1938913,9,0,1,10752,17,8007253098
221,1931440,10879,1942319,1,0,1,9728,2,43894878
222,1934760,12938,1947698,0,0,1,6144,25,4868631706
223,1938840,122144,2060984,7,0,0,2048,18,4744629465
224,1947541,272457,2219998,0,0,0,11264,25,7169028851
225,1947760,3128,1950888,1,0,1,9216,2,2995949050
226,1998590,22939,2021529,0,0,1,2560,25,5142566918
227,2026041,302034,2328075,2,0,0,47616,9,10131453971
228,2033591,262475,2296066,0,0,0,84480,25,4670391182
229,2040509,3128,2043637,9,0,1,9216,17,2887035610
230,2042881,207451,2250332,0,0,0,11264,25,714981071
231,2071250,5712,2076962,0,0,1,14336,25,6446793438
232,2077160,235209,2312369,9,0,0,31232,17,212921622
233,2080100,2470,2082570,1,0,1,2560,2,774144661
234,2090410,5802,2096212,1,0,1,6144,2,5835391373
235,2101611,4162,2105773,2,0,1,11264,9,7299913191
236,2105391,1518,2106909,2,0,1,1536,9,1024242246
237,2108741,382877,2491618,2,0,0,138752,9,9359855419
238,2124900,187640,2312540,7,0,0,512,18,2300773379
239,2135820,1994,2137814,1,0,1,2048,2,1742436560
240,2140181,448282,2588463,2,0,0,25600,9,5657014570
241,2142070,306922,2448992,9,0,0,24064,17,2924359504
242,2191490,3898,2195388,0,0,1,4096,25,2643827694
243,2196690,1994,2198684,1,0,1,2048,2,9610644643
244,2198241,3422,2201663,2,0,1,3584,9,8279180748
245,2211941,351327,2563268,0,0,0,6656,25,1178526689
246,2213781,322673,2536454,0,0,0,32256,25,6549730442
247,2228761,294253,2523014,2,0,0,48640,9,6673942417
248,2239160,3904,2243064,5,0,1,10752,15,2328545422
249,2240691,298445,2539136,2,0,0,1024,9,4424656702
250,2246720,3645,2250365,1,0,1,10240,2,4558400888
251,2247100,357257,2604357,4,0,0,1024,14,9949716815
252,2274881,23739,2298620,2,0,1,2560,9,2762039892
253,2280820,18146,2298966,0,0,1,512,25,1675848490
254,2282290,30289,2312579,6,0,1,22528,8,3503718794
255,2286250,26443,2312693,0,0,1,3584,25,7413470495
256,2295560,197384,2492944,4,0,0,3584,14,3937060491
257,2301281,26809,2328090,2,0,1,2560,9,4962853916
258,2304341,190178,2494519,2,0,0,5120,9,9929435235
259,2306700,142619,2449319,7,0,0,1024,18,3979680048
260,2317401,13593,2330994,2,0,1,8704,9,7399902374
261,2318381,20101,2338482,2,0,1,8192,9,6707744346
262,2327411,304364,2631775,2,0,0,9216,9,2004456252
263,2338150,185191,2523341,4,0,0,1024,14,5218992011
264,2341191,5326,2346517,2,0,1,5632,9,2789939630
265,2347410,94235,2441645,4,0,0,1024,14,7575530936
266,2354401,4374,2358775,2,0,1,4608,9,8863513652
267,2366010,125803,2491813,4,0,0,512,14,5799882528
268,2377040,1518,2378558,3,0,1,1536,29,4904096236
269,2377680,1224,2378904,0,0,1,512,25,5051467702
270,2378760,5196,2383956,1,0,1,13312,2,2933709583
271,2380460,7367,2387827,0,0,1,12800,25,6542421209
272,2380590,176873,2557463,7,0,0,1024,18,4919868846
273,2390600,148209,2538809,9,0,0,7680,17,9872829343
274,2400211,227727,2627938,0,0,0,54272,25,8328989749
275,2400330,301137,2701467,7,0,0,1024,18,6205323337
276,2404801,2470,2407271,2,0,1,2560,9,1652971522
277,2425170,210397,2635567,7,0,0,5120,18,9834327922
278,2434350,194586,2628936,9,0,0,3072,17,9248896459
279,2438570,57451,2496021,5,0,1,1536,15,5068535026
280,2439440,116822,2556262,4,0,0,512,14,7200764429
281,2460230,524888,2985118,9,0,0,102912,17,10536180967
282,2463630,184610,2648240,7,0,0,2560,18,6617953556
283,2467390,29297,2496687,0,0,1,1024,25,5725239851
284,2479241,315905,2795146,2,0,0,91648,9,1518336039
285,2493969,4344,2498313,7,0,1,2560,18,6420510164
286,2497690,307494,2805184,4,0,0,512,14,6406461783
287,2517221,294585,2811806,2,0,0,2560,9,6451896170
288,2538710,1460,2540170,5,0,1,1024,15,10479904622
289,2543631,261374,2805005,2,0,0,32256,9,878013024
290,2549911,332190,2882101,2,0,0,7680,9,9539036708
291,2562760,6212,2568972,0,0,1,14336,25,8139037841
292,2563999,7840,2571839,9,0,1,11264,17,5390552043
293,2567900,4605,2572505,1,0,1,1024,2,5906428548
294,2569090,236469,2805559,7,0,0,1024,18,8676769651
295,2575070,13416,2588486,1,0,1,8192,2,1983517255
296,2576951,142367,2719318,0,0,0,4096,25,6873547144
297,2577320,428966,3006286,4,0,0,512,14,2824057992
298,2580711,425902,3006613,2,0,0,1024,9,8345924745
299,2593190,2470,2595660,1,0,1,2560,2,10733541859
300,2598400,566,2598966,5,0,1,512,15,6349887600
301,2606381,21580,2627961,2,0,1,5632,9,1279189908
302,2611511,438219,3049730,2,0,0,19968,9,8057308513
303,2615330,20319,2635649,0,0,1,7168,25,2124854900
304,2618570,107189,2725759,7,0,0,2048,18,9163612464
305,2621580,16975,2638555,5,0,1,4608,15,2918015610
306,2636910,4231,2641141,5,0,1,4096,15,4777792979
307,2647671,4723,2652394,2,0,1,11264,9,172806534
308,2651210,266537,2917747,9,0,0,67584,17,5729136292
309,2673570,246228,2919798,9,0,0,6656,17,9147072161
310,2676291,329816,3006107,2,0,0,34816,9,1530120983
311,2690051,349679,3039730,2,0,0,98304,9,8685286663
312,2697890,3645,2701535,6,0,1,10240,8,3508852534
313,2699301,295676,2994977,2,0,0,32256,9,2056182618
314,2701009,7305,2708314,7,0,1,7680,18,4763053194
315,2705310,4950,2710260,5,0,1,3072,15,4270923962
316,2709000,6278,2715278,0,0,1,6656,25,4419109905
317,2711370,7963,2719333,0,0,1,4608,25,680795817
318,2712010,393794,3105804,9,0,0,121344,17,7567036057
319,2770331,38810,2809141,2,0,1,4096,9,4806019956
320,2772100,37387,2809487,0,0,1,512,25,5531686804
321,2778570,374646,3153216,7,0,0,1024,18,8835448497
322,2782580,257321,3039901,4,0,0,512,14,7742539060
323,2787269,26404,2813673,7,0,1,6656,18,6070462636
324,2790611,219137,3009748,2,0,0,10240,9,6508104696
325,2791131,27368,2818499,2,0,1,7680,9,6171138161
326,2804651,318811,3123462,2,0,0,47104,9,5077165457
327,2821621,220191,3041812,0,0,0,6144,25,789243061
328,2829780,1518,2831298,5,0,1,1536,15,8390800476
329,2850400,566,2850966,0,0,1,512,25,2251782219
330,2852700,2470,2855170,5,0,1,2560,15,3716358467
331,2856029,5196,2861225,7,0,1,13312,18,3751712092
332,2871611,433354,3304965,0,0,0,107008,25,7318304432
333,2873619,1042,2874661,7,0,1,1024,18,4940521156
334,2876960,118500,2995460,4,0,0,1536,14,10698801596
335,2916229,7902,2924131,7,0,1,4608,18,469962036
336,2923770,4850,2928620,0,0,1,5120,25,9028485782
337,2938910,1042,2939952,0,0,1,1024,25,772844046
338,2940621,216846,3157467,0,0,0,7168,25,2073746266
339,2944339,1042,2945381,7,0,1,1024,18,185190598
340,2977319,32444,3009763,7,0,1,5120,18,4571780109
341,2977580,171028,3148608,7,0,0,1024,18,8900754861
342,2984300,362800,3347100,9,0,0,138240,17,9301933314
343,2986161,281553,3267714,0,0,0,7680,25,6903966621
344,2994511,203295,3197806,0,0,0,33280,25,3085968784
345,3010010,39735,3049745,0,0,1,4608,25,9135964116
346,3024500,159777,3184277,4,0,0,512,14,5981664331
347,3026500,337322,3363822,9,0,0,16896,17,7461144928
348,3058910,5326,3064236,0,0,1,5632,25,697596224
349,3072739,50754,3123493,7,0,1,7680,18,8762864166
350,3077400,46108,3123508,0,0,1,512,25,9093562416
351,3091390,140124,3231514,7,0,0,512,18,298608085
352,3098910,24613,3123523,0,0,1,4096,25,6084187572
353,3107400,349614,3457014,9,0,0,146944,17,600205122
354,3111870,13619,3125489,0,0,1,2048,25,6658524467
355,3135900,222759,3358659,9,0,0,37888,17,8341686511
356,3136610,2470,3139080,5,0,1,2560,15,3119805589
357,3140530,3422,3143952,0,0,1,3584,25,7098379584
358,3149051,2946,3151997,2,0,1,3072,9,5033379128
359,3154210,59749,3213959,4,0,0,1024,14,1670158058
360,3178420,185885,3364305,7,0,0,1536,18,4699463970
361,3202520,3645,3206165,5,0,1,10240,15,3337276542
362,3202930,9037,3211967,5,0,1,6656,15,9857129922
363,3258230,216183,3474413,4,0,0,1536,14,10734121041
364,3268961,189207,3458168,0,0,0,3584,25,10121488150
365,3287560,211615,3499175,7,0,0,1024,18,3045409867
366,3293790,76075,3369865,5,0,1,5632,15,9448900500
367,3299251,206625,3505876,0,0,0,512,25,2486162326
368,3303030,70381,3373411,5,0,1,5632,15,5128395334
369,3318110,140229,3458339,4,0,0,512,14,9932975805
370,3318779,186903,3505682,5,0,0,19968,15,6944802848
371,3322019,51738,3373757,7,0,1,512,18,4905774315
372,3342640,31783,3374423,0,0,1,1024,25,9887758745
373,3343910,33739,3377649,0,0,1,5120,25,9806721844
374,3348350,110347,3458697,7,0,0,512,18,6148258148
375,3360900,189710,3550610,9,0,0,36352,17,10096379630
376,3367880,183080,3550960,4,0,0,1024,14,8860761491
377,3370920,7715,3378635,5,0,1,1536,15,7657281279
378,3372680,85846,3458526,4,0,0,512,14,9640859106
379,3373449,8412,3381861,7,0,1,5120,18,8975972357
380,3391860,290168,3682028,7,0,0,512,18,10457392945
381,3402640,133585,3536225,7,0,0,512,18,3966546551
382,3409480,47557,3457037,5,0,1,17408,15,8735087670
383,3418920,41254,3460174,0,0,1,1536,25,746693128
384,3423789,39233,3463022,7,0,1,4096,18,9072289667
385,3424660,391493,3816153,9,0,0,79360,17,1951059921
386,3426431,194685,3621116,2,0,0,29696,9,9626965260
387,3443340,20988,3464328,1,0,1,2048,2,8047408107
388,3444080,62184,3506264,7,0,0,512,18,9816360553
389,3463940,7706,3471646,6,0,1,8192,8,1761474489
390,3491829,6278,3498107,7,0,1,6656,18,9134747202
391,3492550,13147,3505697,1,0,1,5120,2,6457437335
392,3501420,7837,3509257,5,0,1,3584,15,1022449747
393,3522360,2470,3524830,6,0,1,2560,8,3883827461
394,3524840,133206,3658046,4,0,0,3584,14,7180147251
395,3531141,115997,3647138,0,0,0,3072,25,4851747629
396,3538959,11666,3550625,7,0,1,5632,18,9097108891
397,3547451,151626,3699077,0,0,0,1024,25,353857469
398,3549490,47381,3596871,4,0,0,1024,14,918481057
399,3552650,4937,3557587,5,0,1,12800,15,10537421603
400,3583361,124309,3707670,2,0,0,4608,9,2827292670
401,3626990,2946,3629936,3,0,1,3072,29,10365459269
402,3628701,130151,3758852,2,0,0,6656,9,2671129837
403,3634761,1042,3635803,4,0,1,1024,14,4035864901
404,3650900,59833,3710733,7,0,0,1024,18,9752870848
405,3652170,64532,3716702,7,0,0,512,18,4253764093
406,3657390,48404,3705794,9,0,0,3072,17,7217161178
407,3664119,6754,3670873,7,0,1,7168,18,3970668573
408,3702651,161172,3863823,2,0,0,17920,9,279551578
409,3707090,3658,3710748,5,0,1,3072,15,707518546
410,3708480,4394,3712874,5,0,1,3584,15,9663764452
411,3718660,43904,3762564,4,0,0,512,14,8771580348
412,3719320,7706,3727026,0,0,1,8192,25,9870490111
413,3729730,121745,3851475,7,0,0,1024,18,6638110635
414,3738070,87598,3825668,9,0,0,19456,17,705993871
415,3744460,1042,3745502,0,0,1,1024,25,1879030170
416,3748769,2470,3751239,7,0,1,2560,18,2296133107
417,3751100,180093,3931193,4,0,0,512,14,6569749783
418,3758010,7112,3765122,5,0,1,6656,15,2994961597
419,3769440,2470,3771910,3,0,1,2560,29,6690274488
420,3774350,101768,3876118,7,0,0,512,18,1831468986
421,3782850,214253,3997103,9,0,0,36352,17,2130050760
422,3790411,97502,3887913,2,0,0,5120,9,9237447287
423,3804341,21350,3825691,4,0,1,12800,14,5980805924
424,3814371,11335,3825706,4,0,1,1024,14,3417007737
425,3820750,11697,3832447,6,0,1,7168,8,4931747234
426,3824061,9052,3833113,2,0,1,1024,9,8622119520
427,3845380,140632,3986012,9,0,0,41984,17,10029414277
428,3846501,1994,3848495,4,0,1,2048,14,3206225305
429,3896740,1518,3898258,6,0,1,1536,8,8430394608
430,3935810,5454,3941264,6,0,1,13824,8,4760917142
431,3939350,2900,3942250,5,0,1,1536,15,1385478340
432,3943840,57313,4001153,7,0,0,1024,18,1560286948
433,3947031,110046,4057077,2,0,0,16896,9,4088072731
434,3947610,1994,3949604,5,0,1,2048,15,6540334310
435,3952009,6754,3958763,7,0,1,7168,18,6671375029
436,3955520,4229,3959749,6,0,1,1536,8,4741969900
437,3972491,163072,4135563,2,0,0,41472,9,8252279542
438,3977320,63679,4040999,7,0,0,512,18,8279796722
439,3986970,16121,4003091,5,0,1,14848,15,6804237637
440,4005330,1042,4006372,6,0,1,1024,8,2810557826
441,4007650,566,4008216,5,0,1,512,15,6733160984
442,4013470,84852,4098322,4,0,0,2048,14,8827230054
443,4035870,140655,4176525,7,0,0,1024,18,2221187472
444,4038469,4374,4042843,7,0,1,4608,18,3408502935
445,4039860,4482,4044342,0,0,1,11776,25,10495090151
446,4043711,216901,4260612,0,0,0,512,25,1571068807
447,4044710,2470,4047180,0,0,1,2560,25,8922745524
448,4047289,2946,4050235,7,0,1,3072,18,9611304668
449,4053109,7605,4060714,7,0,1,10240,18,1033692727
450,4063689,566,4064255,7,0,1,512,18,727506588
451,4071810,79887,4151697,4,0,0,2560,14,6660815911
452,4080580,4374,4084954,0,0,1,4608,25,355396920
453,4084599,1518,4086117,7,0,1,1536,18,9651908362
454,4085000,61020,4146020,9,0,0,3072,17,6513998547
455,4085250,417990,4503240,7,0,0,512,18,2771162967
456,4090701,375941,4466642,2,0,0,37888,9,6750862594
457,4092370,113115,4205485,9,0,0,28672,17,2224377158
458,4092620,1518,4094138,0,0,1,1536,25,9887786717
459,4098450,150976,4249426,7,0,0,512,18,3200656919
460,4100760,3645,4104405,6,0,1,10240,8,7735715985
461,4101500,348966,4450466,9,0,0,33792,17,9071981815
462,4106370,4374,4110744,5,0,1,4608,15,10352095063
463,4108370,173827,4282197,9,0,0,17920,17,4628128233
464,4116210,176856,4293066,7,0,0,512,18,1294964737
465,4117749,3422,4121171,7,0,1,3584,18,8524816610
466,4124509,11629,4136138,7,0,1,512,18,4040330601
467,4125570,14056,4139626,0,0,1,4096,25,5475129551
468,4135880,6332,4142212,0,0,1,4096,25,1535125226
469,4139750,350009,4489759,9,0,0,57856,17,8635832041
470,4143119,4850,4147969,7,0,1,5120,18,970935645
471,4147750,2470,4150220,6,0,1,2560,8,2337016817
472,4154340,128036,4282376,7,0,0,512,18,4176424345
473,4158350,97968,4256318,4,0,0,512,14,2250632309
474,4161521,98920,4260441,0,0,0,512,25,6003030178
475,4173530,5326,4178856,0,0,1,5632,25,8232470534
476,4175920,3602,4179522,5,0,1,1024,15,9185298325
477,4186131,3645,4189776,4,0,1,10240,14,1870431686
478,4189579,3422,4193001,7,0,1,3584,18,8088393080
479,4201011,8381,4209392,4,0,1,4096,14,2368992351
480,4203011,7047,4210058,2,0,1,1024,9,834716865
481,4207620,291445,4499065,4,0,0,1024,14,5218016529
482,4212741,5971,4218712,4,0,1,14848,14,798145258
483,4217521,70376,4287897,2,0,0,1024,9,3001855099
484,4222551,1042,4223593,4,0,1,1024,14,5030757643
485,4232940,6754,4239694,0,0,1,7168,25,4516009933
486,4254960,2470,4257430,0,0,1,2560,25,8262742041
487,4258921,3422,4262343,4,0,1,3584,14,10242806907
488,4259840,195243,4455083,7,0,0,2560,18,3557052106
489,4263661,3645,4267306,4,0,1,10240,14,3342174935
490,4281740,5791,4287531,0,0,1,13312,25,9890620082
491,4289701,566,4290267,4,0,1,512,14,7067079594
492,4299790,198908,4498698,9,0,0,29184,17,2437705147
493,4303310,250835,4554145,9,0,0,8704,17,4369103259
494,4306470,261890,4568360,9,0,0,6656,17,7372588047
495,4314481,108654,4423135,0,0,0,512,25,8536987143
496,4318511,51117,4369628,0,0,0,1024,25,7115707255
497,4318770,93513,4412283,4,0,0,3072,14,7840728926
498,4333551,168309,4501860,0,0,0,1024,25,5658640214
499,4340380,193993,4534373,9,0,0,52736,17,4816276241
500,4349000,219531,4568531,4,0,0,512,14,728230190
501,4349741,4162,4353903,2,0,1,11264,9,2168040480
502,4360000,281440,4641440,7,0,0,512,18,3237358098
503,4373781,133277,4507058,0,0,0,512,25,4708788807
504,4381230,5196,4386426,0,0,1,13312,25,6285154823
505,4388061,178256,4566317,2,0,0,4096,9,5414102653
506,4388290,1042,4389332,0,0,1,1024,25,7798560476
507,4390511,11274,4401785,4,0,1,18432,14,8287647390
508,4400050,4961,4405011,0,0,1,5120,25,5060242597
509,4402101,132607,4534708,0,0,0,1024,25,8410849870
510,4413860,1518,4415378,0,0,1,1536,25,8635150919
511,4442440,10964,4453404,0,0,1,3072,25,7590025386
512,4472379,26895,4499274,9,0,1,512,17,5549025361
513,4473601,76404,4550005,0,0,0,1536,25,5715013606
514,4474609,25331,4499940,9,0,1,1024,17,5196157166
515,4477961,196649,4674610,2,0,0,24576,9,5107631302
516,4480959,244632,4725591,5,0,0,17408,15,1937789173
517,4488720,199641,4688361,9,0,0,45056,17,5182685162
518,4491800,9126,4500926,5,0,1,1536,15,5351417457
519,4498691,56654,4555345,0,0,0,2560,25,6762478956
520,4501910,61779,4563689,4,0,0,512,14,2810767472
521,4503681,86513,4590194,2,0,0,11264,9,3571954604
522,4511341,292939,4804280,0,0,0,512,25,7109379324
523,4512911,235744,4748655,2,0,0,22528,9,2017654435
524,4524790,113779,4638569,9,0,0,1536,17,2693563812
525,4537540,2946,4540486,0,0,1,3072,25,6655436707
526,4580280,252902,4833182,9,0,0,17920,17,9460138
527,4589460,245951,4835411,9,0,0,5120,17,4200265696
528,4595690,47288,4642978,4,0,0,1536,14,2708755043
529,4599990,566,4600556,0,0,1,512,25,266157280
530,4600050,89574,4689624,9,0,0,4096,17,9616620398
531,4605039,215573,4820612,5,0,0,2560,15,10207394203
532,4653910,73175,4727085,4,0,0,1024,14,8727855981
533,4656841,182389,4839230,0,0,0,2048,25,8491237235
534,4658210,145891,4804101,9,0,0,47104,17,314655679
535,4659760,66485,4726245,4,0,0,2048,14,4609016693
536,4667080,74696,4741776,9,0,0,15872,17,7757691696
537,4670390,163431,4833821,7,0,0,2048,18,77497372
538,4685431,104099,4789530,0,0,0,1536,25,6002148456
539,4715199,159905,4875104,5,0,0,8192,15,8445437902
540,4717659,7947,4725606,7,0,1,3072,18,8758190893
541,4727260,2946,4730206,0,0,1,3072,25,5597439968
542,4730920,226282,4957202,9,0,0,49664,17,10103922350
543,4738540,14005,4752545,5,0,1,4096,15,2480751973
544,4758040,2946,4760986,0,0,1,3072,25,5067593122
545,4790510,202666,4993176,7,0,0,512,18,9382677383
546,4798409,13093,4811502,7,0,1,7680,18,7315393661
547,4809721,165216,4974937,2,0,0,5120,9,9913602789
548,4815400,174704,4990104,9,0,0,512,17,4465043544
549,4825339,181373,5006712,5,0,0,4608,15,105119351
550,4827090,6746,4833836,0,0,1,2048,25,724945235
551,4831041,64166,4895207,0,0,0,1024,25,3754915373
552,4831659,81513,4913172,5,0,0,10752,15,7279841864
553,4838360,1994,4840354,0,0,1,2048,25,4191753972
554,4845620,204072,5049692,9,0,0,14336,17,10186434225
555,4854250,182618,5036868,4,0,0,512,14,5888893273
556,4859700,2870,4862570,5,0,1,8704,15,1186809743
557,4861720,1247,4862967,5,0,1,512,15,4973230326
558,4865320,4374,4869694,5,0,1,4608,15,1177047340
559,4873300,4266,4877566,0,0,1,2560,25,6738049981
560,4878410,309878,5188288,9,0,0,106496,17,7786277820
561,4899950,68886,4968836,7,0,0,1024,18,2760577245
562,4900120,206202,5106322,9,0,0,100352,17,1892911170
563,4903910,3128,4907038,5,0,1,9216,15,10689375629
564,4904890,334296,5239186,9,0,0,45568,17,7801989406
565,4905551,60384,4965935,0,0,0,512,25,1369475113
566,4905861,59903,4965764,0,0,0,1024,25,242379477
567,4910409,156583,5066992,5,0,0,15360,15,4281222661
568,4913390,11016,4924406,5,0,1,17920,15,948590334
569,4931200,257750,5188950,7,0,0,2048,18,3264543272
570,4946399,17090,4963489,7,0,1,6656,18,10661155176
571,4948830,19485,4968315,5,0,1,7680,15,10288571528
572,4976529,1518,4978047,7,0,1,1536,18,734921758
573,4979270,2470,4981740,0,0,1,2560,25,8224975915
574,4982070,257310,5239380,4,0,0,512,14,6734274179
575,4996370,1518,4997888,0,0,1,1536,25,5232794852
576,5001050,120268,5121318,7,0,0,1536,18,1981560944
577,5001400,566,5001966,5,0,1,512,15,7961477076
578,5003849,264789,5268638,5,0,0,41984,15,4841667128
579,5018880,2470,5021350,0,0,1,2560,25,9130395215
580,5022400,2870,5025270,0,0,1,8704,25,1138697228
581,5041369,1042,5042411,7,0,1,1024,18,7388479428
582,5077749,30150,5107899,9,0,1,1536,17,5756180993
583,5085870,33028,5118898,0,0,1,19968,25,180154841
584,5089199,233822,5323021,5,0,0,78336,15,5878148454
585,5090080,29586,5119666,0,0,1,11776,25,536219259
586,5114510,6142,5120652,0,0,1,1536,25,1425786644
587,5141119,4420,5145539,9,0,1,11776,17,264053385
588,5147191,108632,5255823,2,0,0,7168,9,1043605250
589,5151210,37093,5188303,5,0,1,7168,15,2912349861
590,5168411,78893,5247304,0,0,0,512,25,5312385358
591,5223450,15751,5239201,5,0,1,4096,15,8477762194
592,5224469,362873,5587342,5,0,0,16896,15,1846780804
593,5224640,199343,5423983,9,0,0,15360,17,4767480958
594,5224641,227473,5452114,0,0,0,38912,25,1458059642
595,5227930,12476,5240406,0,0,1,1024,25,2013454201
596,5238800,5726,5244526,5,0,1,5120,15,5735665165
597,5239741,460281,5700022,0,0,0,23552,25,6283265678
598,5252871,293188,5546059,0,0,0,5632,25,7008907965
599,5255491,288837,5544328,0,0,0,108544,25,4367517494
600,5256001,390321,5646322,2,0,0,3584,9,8798376606
601,5256509,200389,5456898,5,0,0,5120,15,5616479472
602,5268530,113117,5381647,9,0,0,27648,17,1040783262
603,5275470,566,5276036,5,0,1,512,15,1427480243
604,5283860,329915,5613775,9,0,0,20992,17,2829701501
605,5297570,509138,5806708,9,0,0,34816,17,8209291116
606,5304510,20973,5325483,5,0,1,2560,15,9216840782
607,5340640,3422,5344062,0,0,1,3584,25,7673232332
608,5342340,48798,5391138,7,0,0,1024,18,4077190629
609,5347740,6754,5354494,5,0,1,7168,15,5883499307
610,5361990,5326,5367316,0,0,1,5632,25,4488879450
611,5364159,354262,5718421,5,0,0,55808,15,6607912799
612,5370720,211459,5582179,9,0,0,27136,17,3409745214
613,5372941,539673,5912614,0,0,0,109056,25,2112289590
614,5384009,211322,5595331,5,0,0,3584,15,9135789673
615,5390070,1994,5392064,5,0,1,2048,15,6388574218
616,5390759,183137,5573896,5,0,0,59392,15,4047325345
617,5393620,4937,5398557,5,0,1,12800,15,4357620983
618,5437810,158603,5596413,7,0,0,1024,18,7571947326
619,5439970,12159,5452129,5,0,1,2048,15,10318508243
620,5442641,241520,5684161,2,0,0,6656,9,10350394209
621,5446230,188302,5634532,9,0,0,4096,17,9658206160
622,5534480,502148,6036628,3,0,0,15872,29,8765249191
623,5541729,419179,5960908,5,0,0,87040,15,5248822037
624,5566930,154276,5721206,7,0,0,1024,18,10363689692
625,5574150,679141,6253291,9,0,0,91648,17,5793685514
626,5581400,530246,6111646,2,0,0,119808,9,644724402
627,5593999,327374,5921373,5,0,0,28672,15,1818839895
628,5624600,1042,5625642,5,0,1,1024,15,2920515156
629,5634199,192363,5826562,5,0,0,3072,15,3689167264
630,5651040,505105,6156145,2,0,0,51200,9,102901094
631,5663219,646466,6309685,5,0,0,23552,15,2003881915
632,5671710,294563,5966273,9,0,0,15360,17,2437932676
633,5672559,840327,6512886,5,0,0,16896,15,7096039036
634,5672601,298384,5970985,0,0,0,3072,25,7728499818
635,5679670,1019514,6699184,9,0,0,113664,17,5830031636
636,5681401,288369,5969770,2,0,0,4096,9,9170713923
637,5725621,773661,6499282,2,0,0,52736,9,9107518105
638,5761439,277856,6039295,5,0,0,8704,15,9263794117
639,5778471,187973,5966444,0,0,0,512,25,3923707207
640,5821670,154100,5975770,3,0,0,1536,29,5770949158
641,5821920,139315,5961235,7,0,0,1024,18,5125781742
642,5843441,118121,5961562,0,0,0,1024,25,5544222006
643,5881099,43361,5924460,9,0,1,9216,17,2589378838
644,5941409,26988,5968397,9,0,1,2048,17,1323148454
645,5943519,249052,6192571,5,0,0,48640,15,6199233202
646,5962019,326579,6288598,5,0,0,69632,15,9202645323
647,5983770,583995,6567765,3,0,0,50176,29,8280646222
648,5984520,680002,6664522,3,0,0,63488,29,1611042440
649,5992219,755093,6747312,5,0,0,1536,15,7844744835
650,5997190,129167,6126357,3,0,0,48128,29,10028356078
651,6029639,132020,6161659,5,0,0,7680,15,8225451579
652,6041110,383865,6424975,9,0,0,68096,17,6543428384
653,6058730,208637,6267367,3,0,0,17408,29,6651853048
654,6059790,956071,7015861,3,0,0,52736,29,4406765926
655,6063929,100736,6164665,5,0,0,4096,15,10058889763
656,6078550,48332,6126882,8,0,1,512,26,5674582543
657,6091710,431410,6523120,2,0,0,18944,9,4961032885
658,6098059,30407,6128466,9,0,1,2048,17,3361755644
659,6100059,29713,6129772,9,0,1,2048,17,7107397850
660,6126450,96373,6222823,3,0,0,17408,29,6618632200
661,6136090,302682,6438772,7,0,0,512,18,3029927874
662,6146679,558387,6705066,5,0,0,17408,15,1485772922
663,6154500,375146,6529646,3,0,0,11264,29,834433786
664,6160951,6995,6167946,2,0,1,6656,9,8613144334
665,6161330,876341,7037671,3,0,0,12288,29,3060557933
666,6173441,226856,6400297,1,0,0,53760,2,5484756864
667,6189139,112440,6301579,5,0,0,8704,15,10348343358
668,6201329,1518,6202847,7,0,1,1536,18,6302201237
669,6205020,6488,6211508,6,0,1,15872,8,653504415
670,6216819,6019,6222838,7,0,1,1024,18,9308458586
671,6221119,32187,6253306,7,0,1,3584,18,4943691495
672,6222479,181733,6404212,5,0,0,12800,15,9577887958
673,6257701,182382,6440083,2,0,0,4096,9,7445029581
674,6258060,201416,6459476,9,0,0,24064,17,4996948220
675,6258481,180120,6438601,2,0,0,44544,9,1147706381
676,6269379,20746,6290125,7,0,1,1536,18,5604248018
677,6280169,517206,6797375,5,0,0,36352,15,4931837155
678,6293509,8085,6301594,9,0,1,6656,17,7986156915
679,6320379,4420,6324799,9,0,1,11776,17,5861753547
680,6324509,5802,6330311,7,0,1,6144,18,9937173048
681,6328130,136447,6464577,7,0,0,1536,18,3146205391
682,6337229,198831,6536060,5,0,0,16896,15,1222268145
683,6338030,214416,6552446,9,0,0,25600,17,4464537106
684,6382201,42789,6424990,4,0,1,8192,14,603926975
685,6394711,46398,6441109,4,0,1,1024,14,7642702195
686,6408121,492213,6900334,2,0,0,41472,9,1800863065
687,6408901,456658,6865559,1,0,0,98816,2,596679662
688,6413521,286186,6699707,0,0,0,1536,25,9831691291
689,6414149,31581,6445730,7,0,1,5632,18,6653259896
690,6417670,95870,6513540,7,0,0,2048,18,2248804397
691,6419210,532131,6951341,3,0,0,26112,29,5306955451
692,6421190,27446,6448636,4,0,1,4608,14,5813628538
693,6422780,26317,6449097,5,0,1,10240,15,609511154
694,6424360,390042,6814402,9,0,0,55808,17,4269921958
695,6433549,16534,6450083,7,0,1,1536,18,1960808232
696,6439359,795867,7235226,5,0,0,26112,15,8377636717
697,6444780,893662,7338442,9,0,0,79360,17,521008831
698,6447441,3128,6450569,4,0,1,9216,14,376664509
699,6447499,11992,6459491,9,0,1,11776,17,6977391480
700,6455100,540448,6995548,3,0,0,95744,29,9077164378
701,6455411,622871,7078282,1,0,0,109056,2,9731160315
702,6459779,11533,6471312,7,0,1,18944,18,10171905138
703,6476360,650312,7126672,9,0,0,43008,17,1871561957
704,6485499,19763,6505262,7,0,1,14848,18,2867780582
705,6498059,8509,6506568,9,0,1,2048,17,10245383411
706,6499419,13482,6512901,7,0,1,7680,18,6717123738
707,6546851,26199,6573050,2,0,1,5632,9,3924638197
708,6549010,161985,6710995,2,0,0,1024,9,7717885506
709,6559901,14455,6574356,2,0,1,2048,9,2611150575
710,6560141,14561,6574702,2,0,1,512,9,5634890
711,6566230,546598,7112828,9,0,0,42496,17,4674642549
712,6583620,287757,6871377,3,0,0,18944,29,4520268906
713,6590249,509600,7099849,5,0,0,70656,15,4445286054
714,6590961,223932,6814893,0,0,0,1536,25,3916766916
715,6597260,2470,6599730,4,0,1,2560,14,8282157099
716,6608301,505221,7113522,0,0,0,1024,25,6336504773
717,6608920,11791,6620711,4,0,1,19456,14,9023235588
718,6614441,7256,6621697,4,0,1,1536,14,5830309191
719,6644231,20306,6664537,2,0,1,6144,9,9285319491
720,6659009,600683,7259692,5,0,0,64000,15,7901500067
721,6661109,743749,7404858,5,0,0,50176,15,1745507536
722,6663231,333495,6996726,0,0,0,2560,25,3063980462
723,6664220,765482,7429702,2,0,0,3584,9,9806184205
724,6673939,553308,7227247,5,0,0,9728,15,4073729722
725,6680260,315639,6995899,7,0,0,1024,18,9888432996
726,6682231,23836,6706067,4,0,1,1024,14,3241632265
727,6686090,609725,7295815,9,0,0,50688,17,10120445234
728,6687529,536723,7224252,5,0,0,156160,15,4088508167
729,6687790,18623,6706413,4,0,1,512,14,6657160389
730,6761111,474466,7235577,0,0,0,1024,25,4328205017
731,6761720,279720,7041440,9,0,0,9728,17,9438547296
732,6774021,140755,6914776,0,0,0,2048,25,5214197169
733,6788879,32712,6821591,7,0,1,7680,18,1283048183
734,6799830,659356,7459186,9,0,0,34816,17,8629688079
735,6801761,24336,6826097,2,0,1,7168,9,9202859603
736,6808580,18503,6827083,4,0,1,1536,14,9639404516
737,6815491,571788,7387279,1,0,0,94208,2,7586941486
738,6832290,33284,6865574,1,0,1,3584,2,9230483840
739,6832750,343899,7176649,3,0,0,64000,29,4538467332
740,6847870,265309,7113179,2,0,0,1024,9,7609186774
741,6854381,504179,7358560,1,0,0,14336,2,8798410961
742,6865890,442801,7308691,2,0,0,1536,9,5260873879
743,6873291,434917,7308208,1,0,0,18432,2,3783944858
744,6899200,251328,7150528,7,0,0,2560,18,9003494370
745,6919399,7230,6926629,7,0,1,7680,18,7651940326
746,6919519,12256,6931775,7,0,1,8192,18,8116587697
747,6923211,203984,7127195,0,0,0,1536,25,1809748063
748,6935320,454227,7389547,7,0,0,1024,18,4606924488
749,6939930,449290,7389220,9,0,0,4096,17,1868435885
750,6962731,636401,7599132,0,0,0,512,25,2061391128
751,6966361,30589,6996950,2,0,1,1024,9,3241330518
752,6969310,326699,7296009,2,0,0,512,9,1003363682
753,6978341,19275,6997616,4,0,1,1024,14,9792904665
754,6989650,425760,7415410,7,0,0,2048,18,209875468
755,6993621,709569,7703190,1,0,0,73728,2,6275334900
756,7034941,411366,7446307,1,0,0,28160,2,10408444997
757,7037529,725,7038254,7,0,1,512,18,1579435156
758,7045591,67946,7113537,2,0,1,512,9,6283036868
759,7065660,230520,7296180,7,0,0,512,18,1580236272
760,7066630,321327,7387957,2,0,0,1024,9,7872985930
761,7072800,332579,7405379,7,0,0,512,18,3961041369
762,7083461,255152,7338613,0,0,0,512,25,3539104806
763,7086680,185937,7272617,9,0,0,16896,17,5842605358
764,7088229,38997,7127226,7,0,1,512,18,6185910543
765,7091880,626724,7718604,9,0,0,12288,17,5453837847
766,7093361,34182,7127543,2,0,1,512,9,4793690254
767,7106019,27678,7133697,9,0,1,7168,17,7061899606
768,7106859,28756,7135615,9,0,1,15872,17,10290967552
769,7117681,378019,7495700,1,0,0,30208,2,3348573233
770,7117980,20777,7138757,1,0,1,12288,2,1482181735
771,7121229,20491,7141720,9,0,1,4096,17,9265885592
772,7133811,296875,7430686,0,0,0,512,25,3443603130
773,7140480,4937,7145417,1,0,1,12800,2,9975853934
774,7142499,245115,7387614,5,0,0,1024,15,9317986156
775,7147600,444244,7591844,3,0,0,46080,29,8652857137
776,7149820,201993,7351813,9,0,0,15360,17,5046358847
777,7158721,301692,7460413,0,0,0,1536,25,473039176
778,7185070,274302,7459372,7,0,0,512,18,7589529757
779,7185779,50874,7236653,7,0,1,1024,18,9796388905
780,7193461,43538,7236999,4,0,1,512,14,2196076425
781,7212389,552324,7764713,5,0,0,63488,15,5107925241
782,7214560,24490,7239050,1,0,1,3072,2,7241581087
783,7215071,579247,7794318,0,0,0,2560,25,1586696198
784,7216831,42876,7259707,4,0,1,7168,14,5697398074
785,7219571,185629,7405200,0,0,0,1024,25,5006366191
786,7221061,328422,7549483,1,0,0,46592,2,1596464472
787,7234859,236930,7471789,5,0,0,3584,15,8700849734
788,7257759,3934,7261693,9,0,1,2048,17,6769030838
789,7266461,6171,7272632,2,0,1,2048,9,5895621915
790,7267251,7706,7274957,4,0,1,8192,14,1525527201
791,7276811,19019,7295830,4,0,1,6144,14,7811119309
792,7283320,420353,7703673,7,0,0,1536,18,9843158888
793,7299921,12825,7312746,4,0,1,21504,14,5427595307
794,7302990,180345,7483335,3,0,0,15360,29,2280107923
795,7307450,139044,7446494,2,0,0,512,9,8654910594
796,7316121,736684,8052805,1,0,0,98816,2,4132434578
797,7328769,11396,7340165,9,0,1,1536,17,7911488770
798,7330920,763574,8094494,9,0,0,46592,17,2935749586
799,7344871,1994,7346865,2,0,1,2048,9,7914202228
800,7347209,279590,7626799,5,0,0,2560,15,9982301309
801,7358680,46193,7404873,1,0,1,512,2,7526452753
802,7368180,743828,8112008,3,0,0,34304,29,5389327127
803,7369009,252276,7621285,5,0,0,54272,15,491260549
804,7399119,226861,7625980,5,0,0,15360,15,9180420046
805,7405651,5326,7410977,2,0,1,5632,9,7887971683
806,7417231,2470,7419701,2,0,1,2560,9,4861405616
807,7421701,287146,7708847,0,0,0,512,25,9914623434
808,7421800,764863,8186663,7,0,0,1024,18,305120580
809,7438541,20660,7459201,2,0,1,13312,9,10398694321
810,7438661,481932,7920593,1,0,0,24064,2,727766069
811,7443581,269715,7713296,0,0,0,512,25,6576334816
812,7445551,13876,7459427,4,0,1,7168,14,6494474934
813,7449901,363386,7813287,0,0,0,2048,25,2622254748
814,7452920,9966,7462886,0,0,1,3584,25,1844078508
815,7452951,196965,7649916,0,0,0,2048,25,3263386769
816,7453391,670080,8123471,0,0,0,2560,25,4711730490
817,7457230,14574,7471804,1,0,1,16896,2,6627785849
818,7471169,551326,8022495,5,0,0,81920,15,3643315379
819,7477761,5802,7483563,2,0,1,6144,9,2298735440
820,7485400,192978,7678378,3,0,0,1536,29,8372878621
821,7485420,795892,8281312,3,0,0,89600,29,5321344808
822,7491330,832732,8324062,3,0,0,27136,29,6722180128
823,7493279,6617,7499896,9,0,1,11264,17,9822883394
824,7494210,586020,8080230,9,0,0,15360,17,7139288840
825,7497180,158779,7655959,9,0,0,5632,17,5083007160
826,7526029,7230,7533259,9,0,1,7680,17,3800212937
827,7530940,3305,7534245,4,0,1,1536,14,4762875356
828,7535279,17341,7552620,9,0,1,9216,17,9307341588
829,7540881,372357,7913238,1,0,0,93184,2,8850058685
830,7556941,518570,8075511,1,0,0,68096,2,7762327371
831,7559141,1994,7561135,4,0,1,2048,14,5314170056
832,7560199,425294,7985493,5,0,0,40960,15,8732963923
833,7563760,6754,7570514,1,0,1,7168,2,9009653061
834,7567200,4940,7572140,1,0,1,2560,2,302833119
835,7572600,450066,8022666,7,0,0,512,18,3822943906
836,7575859,16000,7591859,9,0,1,13312,17,3350740181
837,7582420,10014,7592434,1,0,1,512,2,7158638270
838,7589391,512150,8101541,1,0,0,17408,2,4813868818
839,7595480,109458,7704938,7,0,0,512,18,9331105896
840,7603260,1042,7604302,5,0,1,1024,15,3362592042
841,7603690,136751,7740441,7,0,0,1024,18,2557568436
842,7619620,8180,7627800,6,0,1,1024,8,359678356
843,7619799,11950,7631749,9,0,1,12288,17,2371565934
844,7620010,14226,7634236,0,0,1,3584,25,5135767328
845,7630650,6812,7637462,4,0,1,5120,14,2548066581
846,7632830,5618,7638448,1,0,1,1536,2,8894932005
847,7655630,887,7656517,1,0,1,512,2,8171796446
848,7661551,271295,7932846,0,0,0,1024,25,9990413172
849,7661630,7230,7668860,0,0,1,7680,25,10417961326
850,7695240,237084,7932324,3,0,0,38400,29,1741332367
851,7705991,1994,7707985,4,0,1,2048,14,9698913845
852,7734420,318712,8053132,2,0,0,1024,9,7556349288
853,7766151,3422,7769573,2,0,1,3584,9,6403202276
854,7790179,207341,7997520,5,0,0,39424,15,5349130267
855,7791500,303211,8094711,2,0,0,512,9,4023315295
856,7795850,4850,7800700,1,0,1,5120,2,1049983879
857,7803470,325675,8129145,7,0,0,1024,18,76378200
858,7806650,2946,7809596,0,0,1,3072,25,8000811445
859,7810810,121701,7932511,7,0,0,512,18,935373561
860,7812230,1518,7813748,0,0,1,1536,25,8435384120
861,7820800,1518,7822318,1,0,1,1536,2,2936124201
862,7831180,139207,7970387,7,0,0,1024,18,5430293348
863,7846171,3898,7850069,2,0,1,4096,9,333968802
864,7860269,326067,8186336,5,0,0,31744,15,6728014583
865,7867481,368200,8235681,0,0,0,512,25,1153130619
866,7883470,512274,8395744,9,0,0,74752,17,1200739522
867,7885920,315974,8201894,7,0,0,1024,18,1768827905
868,7888360,45628,7933988,0,0,1,1536,25,2301597995
869,7893931,232298,8126229,0,0,0,1536,25,7536334398
870,7911361,24253,7935614,4,0,1,2560,14,8455130740
871,7915910,21010,7936920,0,0,1,2048,25,5035510174
872,7925101,12165,7937266,4,0,1,512,14,9648407446
873,7931109,16209,7947318,9,0,1,24576,17,889801910
874,7931141,20363,7951504,4,0,1,6656,14,7686463909
875,7946920,6210,7953130,1,0,1,2560,2,2360935625
876,7948299,287211,8235510,5,0,0,62976,15,10177406044
877,7951061,2735,7953796,2,0,1,1024,9,8514549184
878,7951291,4131,7955422,2,0,1,2560,9,3042760891
879,7952829,3259,7956088,9,0,1,1024,17,5882029768
880,7954311,352683,8306994,1,0,0,25088,2,1237566477
881,7963029,529978,8493007,5,0,0,38912,15,8338112403
882,7964050,511848,8475898,9,0,0,94720,17,8396670216
883,7970200,382479,8352679,2,0,0,2048,9,9061469196
884,7991160,89085,8080245,0,0,1,6656,25,6150747432
885,8004240,76020,8080260,6,0,1,1536,8,6521415818
886,8013540,268107,8281647,7,0,0,1024,18,5752999004
887,8013621,66662,8080283,4,0,1,1536,14,909623817
888,8013989,195141,8209130,5,0,0,8192,15,5499437208
889,8022050,72459,8094509,6,0,1,13312,8,8279958420
890,8026930,208930,8235860,2,0,0,512,9,6670324666
891,8028420,147620,8176040,7,0,0,1536,18,1496790661
892,8030791,268544,8299335,1,0,0,23552,2,371425132
893,8034159,60373,8094532,9,0,1,9216,17,2892117791
894,8038931,55795,8094726,4,0,1,2048,14,7928712221
895,8048060,46689,8094749,1,0,1,1536,2,3125972519
896,8049791,346296,8396087,0,0,0,1024,25,10586561364
897,8058161,37090,8095251,2,0,1,512,9,7495793287
898,8068680,295614,8364294,3,0,0,29696,29,1790710983
899,8076011,36012,8112023,2,0,1,3584,9,134764158
900,8084330,161462,8245792,3,0,0,1536,29,2390096344
901,8085101,26945,8112046,4,0,1,17408,14,3332986179
902,8098590,193539,8292129,2,0,0,1024,9,3963280378
903,8109010,4080,8113090,1,0,1,1024,2,991858413
904,8119220,6229,8125449,6,0,1,15360,8,987551184
905,8121250,374042,8495292,2,0,0,2560,9,2600057042
906,8141930,2470,8144400,1,0,1,2560,2,3364087288
907,8147800,253874,8401674,7,0,0,512,18,7423447867
908,8148881,2946,8151827,4,0,1,3072,14,2541387861
909,8154109,4374,8158483,9,0,1,4608,17,2333793826
910,8155030,324175,8479205,3,0,0,10752,29,1320842840
911,8157121,2028,8159149,2,0,1,1024,9,3179597347
912,8164900,405136,8570036,3,0,0,76800,29,7755367917
913,8186031,648166,8834197,1,0,0,192512,2,2330475676
914,8192510,566,8193076,1,0,1,512,2,6167442380
915,8194369,696385,8890754,5,0,0,113152,15,9964287542
916,8202711,6442,8209153,4,0,1,14336,14,5671065702
917,8206311,521465,8727776,1,0,0,512,2,2139605370
918,8209800,269576,8479376,2,0,0,512,9,4733720839
919,8224611,171959,8396570,0,0,0,1536,25,737480155
920,8237441,11533,8248974,2,0,1,18944,9,5358320221
921,8248751,3645,8252396,2,0,1,10240,9,4849632817
922,8258549,320581,8579130,5,0,0,29696,15,10492638133
923,8277850,8468,8286318,3,0,1,12288,29,8141668729
924,8285510,158614,8444124,9,0,0,13312,17,928079532
925,8290630,16387,8307017,1,0,1,13824,2,5124892949
926,8291440,18993,8310433,1,0,1,3584,2,9599140327
927,8305269,106854,8412123,5,0,0,512,15,2610388716
928,8321900,775635,9097535,2,0,0,1536,9,5517926974
929,8323380,357993,8681373,2,0,0,512,9,2160909028
930,8326720,634273,8960993,9,0,0,40960,17,7153791637
931,8343900,1042,8344942,1,0,1,1024,2,1600376306
932,8344251,567110,8911361,1,0,0,67584,2,1543432255
933,8350310,505921,8856231,9,0,0,71680,17,10069507128
934,8363280,287420,8650700,7,0,0,1536,18,7861389577
935,8368141,566,8368707,2,0,1,512,9,8414813214
936,8373039,24081,8397120,7,0,1,512,18,1789812404
937,8373149,39398,8412547,7,0,1,30720,18,10662876512
938,8384210,535831,8920041,2,0,0,512,9,6630670783
939,8397331,18122,8415453,2,0,1,4608,9,8789403367
940,8418939,910265,9329204,5,0,0,124928,15,7701999535
941,8423990,578535,9002525,2,0,0,512,9,7932802893
942,8442739,36660,8479399,7,0,1,40448,18,10413473836
943,8444029,741028,9185057,5,0,0,86016,15,6891672401
944,8450841,280007,8730848,0,0,0,512,25,699437431
945,8451180,463044,8914224,9,0,0,9216,17,3789409727
946,8466780,236907,8703687,7,0,0,2048,18,3266610686
947,8477279,65742,8543021,7,0,1,107008,18,7536220826
948,8480440,748309,9228749,9,0,0,68096,17,957883438
949,8500120,69931,8570051,1,0,1,6144,2,3804268105
950,8501850,835949,9337799,3,0,0,28160,29,129189923
951,8502230,500124,9002354,9,0,0,60416,17,1368215273
952,8504589,74564,8579153,7,0,1,67072,18,6775198545
953,8520719,58449,8579168,9,0,1,3584,17,6957778706
954,8522740,56451,8579191,1,0,1,14848,2,1728983455
955,8529320,507541,9036861,3,0,0,28160,29,7385251574
956,8536029,45716,8581745,7,0,1,32768,18,3416696906
957,8536489,696205,9232694,5,0,0,12288,15,395169808
958,8541560,40531,8582091,1,0,1,512,2,6694180693
959,8546649,1046895,9593544,5,0,0,36864,15,2627171630
960,8559320,368745,8928065,2,0,0,1024,9,9613256186
961,8596470,331238,8927708,3,0,0,25088,29,5955789034
962,8609341,339157,8948498,1,0,0,39936,2,4687315986
963,8622129,431882,9054011,5,0,0,43008,15,5841331135
964,8627831,3645,8631476,4,0,1,10240,14,4094505497
965,8644920,4679,8649599,1,0,1,12288,2,2271819087
966,8647351,272519,8919870,1,0,0,6144,2,8032568702
967,8659811,377221,9037032,0,0,0,512,25,6022962448
968,8660229,538259,9198488,5,0,0,44032,15,4692632860
969,8666191,407516,9073707,0,0,0,1536,25,1331471317
970,8688310,146066,8834376,2,0,0,512,9,7496254613
971,8698170,791963,9490133,3,0,0,94720,29,7781752603
972,8698909,2946,8701855,7,0,1,3072,18,10360298441
973,8700230,547939,9248169,3,0,0,50688,29,2261196646
974,8720760,687167,9407927,9,0,0,62976,17,392246273
975,8722161,621465,9343626,1,0,0,1024,2,3010557269
976,8727461,190522,8917983,1,0,0,12288,2,8551441682
977,8728920,1042,8729962,1,0,1,1024,2,3396883169
978,8729969,3388,8733357,7,0,1,9728,18,2392063092
979,8751990,2870,8754860,1,0,1,8704,2,3416547007
980,8752440,320776,9073216,3,0,0,29184,29,6730689939
981,8788970,413136,9202106,9,0,0,11776,17,7425146362
982,8807950,119773,8927723,1,0,1,2048,2,1310280589
983,8813060,114678,8927738,3,0,1,4096,29,7040900474
984,8815900,145756,8961656,7,0,0,2048,18,5163360742
985,8818609,146407,8965016,7,0,1,83968,18,7065762613
986,8851440,271673,9123113,7,0,0,512,18,206020533
987,8854460,281372,9135832,7,0,0,1536,18,4176042339
988,8893540,76302,8969842,1,0,1,7680,2,6119958362
989,8921171,369954,9291125,1,0,0,68608,2,7006241368
990,8937450,312637,9250087,2,0,0,512,9,8162912437
991,8955330,17098,8972428,6,0,1,4096,8,9748165634
992,8957760,16614,8974374,0,0,1,3072,25,5412802625
993,8958540,16500,8975040,1,0,1,1024,2,1301375500
994,8959691,269244,9228935,0,0,0,512,25,273319244
995,8969660,6968,8976628,1,0,1,15872,2,6597483061
996,8974040,844014,9818054,3,0,0,68608,29,10358678843
997,8977090,279785,9256875,3,0,0,3584,29,1258861564
998,8977511,165246,9142757,1,0,0,7680,2,1972038467
999,8986010,20422,9006432,6,0,1,4096,8,5933321655
1000,8988730,19648,9008378,6,0,1,3072,8,10175633076
1001,9005101,337808,9342909,1,0,0,15872,2,209202621
1002,9015779,6754,9022533,7,0,1,7168,18,3671446713
1003,9021230,321850,9343080,2,0,0,512,9,8235577032
1004,9027261,346137,9373398,0,0,0,512,25,9229298550
1005,9028220,77895,9106115,3,0,0,4096,29,7602958813
1006,9041940,18618,9060558,0,0,1,15872,25,9521542829
1007,9043890,294152,9338042,2,0,0,512,9,5426027579
1008,9045491,297760,9343251,0,0,0,512,25,9049082027
1009,9053970,290482,9344452,2,0,0,2560,9,2149260226
1010,9067040,285251,9352291,9,0,0,25600,17,10055083099
1011,9071050,284939,9355989,7,0,0,1024,18,4025047762
1012,9088130,556870,9645000,3,0,0,4096,29,10730591035
1013,9093920,155988,9249908,9,0,0,5632,17,3875621669
1014,9105179,93324,9198503,7,0,1,95744,18,10192668688
1015,9109910,92211,9202121,6,0,1,6144,8,6412372553
1016,9137460,215369,9352829,2,0,0,1536,9,10458533479
1017,9150271,55831,9206102,0,0,0,512,25,2986057470
1018,9175761,29841,9205602,4,0,1,3584,14,8676468225
1019,9181530,25378,9206908,1,0,1,2048,2,4582755188
1020,9188191,40573,9228764,4,0,1,4096,14,2648264322
1021,9191491,313498,9504989,1,0,0,15360,2,1151775949
1022,9214799,128850,9343649,7,0,1,114688,18,1893062261
1023,9216719,850481,10067200,5,0,0,14848,15,7789575971
1024,9224389,744926,9969315,5,0,0,132608,15,7166229315
1025,9258010,1489819,10747829,9,0,0,316416,17,8815801273
1026,9263630,426268,9689898,9,0,0,39424,17,2577926999
1027,9265981,86365,9352346,4,0,1,4608,14,5105364257
1028,9267289,92813,9360102,7,0,1,27648,18,9150397860
1029,9271161,296127,9567288,1,0,0,39936,2,429947136
1030,9274860,654036,9928896,3,0,0,78848,29,9305301064
1031,9290741,946790,10237531,1,0,0,69120,2,8676009863
1032,9292581,341762,9634343,1,0,0,45568,2,7967460778
1033,9298140,978465,10276605,3,0,0,16896,29,366874368
1034,9300041,60407,9360448,4,0,1,512,14,693226007
1035,9301600,1087261,10388861,3,0,0,11264,29,10398721342
1036,9306970,851953,10158923,2,0,0,1024,9,9558347863
1037,9307130,54944,9362074,5,0,1,2560,15,7320201795
1038,9307190,959937,10267127,7,0,0,1024,18,7797471063
1039,9310410,588279,9898689,2,0,0,1024,9,2107535374
1040,9312660,50080,9362740,5,0,1,1024,15,8174716640
1041,9313660,49426,9363086,5,0,1,512,15,8810005789
1042,9318289,90457,9408746,5,0,0,2560,15,5535156994
1043,9330560,33512,9364072,5,0,1,1536,15,9208615892
1044,9343580,20838,9364418,5,0,1,512,15,1814331101
1045,9346990,182182,9529172,3,0,0,13312,29,4433732722
1046,9354621,11423,9366044,4,0,1,2560,14,2949738728
1047,9356520,14030,9370550,1,0,1,7168,2,10639331818
1048,9357530,667504,10025034,9,0,0,15360,17,2473202889
1049,9376050,352440,9728490,2,0,0,1024,9,2700831015
1050,9380610,618320,9998930,9,0,0,30208,17,6023283194
1051,9382410,325218,9707628,3,0,0,14336,29,690494728
1052,9384350,1058369,10442719,3,0,0,15872,29,9107034159
1053,9384950,1417788,10802738,9,0,0,89600,17,6075259364
1054,9392030,20097,9412127,0,0,1,3584,25,1151160733
1055,9393921,313886,9707807,0,0,0,512,25,8663291697
1056,9402671,415726,9818397,0,0,0,1024,25,9488158773
1057,9430440,7230,9437670,1,0,1,7680,2,225146241
1058,9444711,3422,9448133,4,0,1,3584,14,2036884992
1059,9445521,309192,9754713,0,0,0,4608,25,4552380172
1060,9454530,2870,9457400,5,0,1,8704,15,6487998394
1061,9456211,682162,10138373,0,0,0,19968,25,9726692571
1062,9458619,802290,10260909,5,0,0,5120,15,936926348
1063,9468661,25926,9494587,4,0,1,11776,14,8787083000
1064,9487540,1341109,10828649,9,0,0,84992,17,10159830359
1065,9487600,410552,9898152,3,0,0,47616,29,3293821600
1066,9522810,1128556,10651366,9,0,0,109568,17,1428674394
1067,9547690,1070269,10617959,3,0,0,156672,29,6917899054
1068,9555900,19178,9575078,0,0,1,8192,25,2849478180
1069,9557879,551441,10109320,5,0,0,22016,15,5981779012
1070,9558830,21394,9580224,0,0,1,8192,25,8725221615
1071,9562170,1386177,10948347,3,0,0,88576,29,1551434517
1072,9564340,29219,9593559,0,0,1,5632,25,10155095474
1073,9583940,13100,9597040,0,0,1,3584,25,4949532755
1074,9584841,392827,9977668,0,0,0,9216,25,7493848288
1075,9589980,399715,9989695,3,0,0,39424,29,3391960981
1076,9593010,7256,9600266,1,0,1,5120,2,9045963728
1077,9612121,823666,10435787,1,0,0,105472,2,2271961462
1078,9615411,632234,10247645,0,0,0,13824,25,138282281
1079,9615660,18698,9634358,0,0,1,5632,25,1224627679
1080,9616591,17782,9634373,4,0,1,512,14,3570462135
1081,9618930,702073,10321003,9,0,0,15360,17,9406192289
1082,9629720,7608,9637328,0,0,1,3072,25,6440559766
1083,9632560,6145,9638705,1,0,1,9728,2,6067987131
1084,9634831,931726,10566557,1,0,0,1024,2,9839139631
1085,9639510,6754,9646264,0,0,1,7168,25,1571189081
1086,9640360,394975,10035335,7,0,0,512,18,960816636
1087,9642461,1195033,10837494,0,0,0,13824,25,8410386680
1088,9658080,7230,9665310,5,0,1,7680,15,3857840150
1089,9663120,1165716,10828836,7,0,0,512,18,2987019468
1090,9672121,329812,10001933,1,0,0,9728,2,6243076166
1091,9675141,624712,10299853,0,0,0,20480,25,1716293322
1092,9687480,9164,9696644,0,0,1,7168,25,10336929572
1093,9703181,411904,10115085,0,0,0,7680,25,8852630406
1094,9704590,270255,9974845,7,0,0,15872,18,7261949187
1095,9721140,248822,9969962,2,0,0,2048,9,7269682593
1096,9735651,1518,9737169,4,0,1,1536,14,4633499027
1097,9746850,722897,10469747,3,0,0,23552,29,8280971550
1098,9756660,1076583,10833243,7,0,0,14336,18,7029295025
1099,9761610,1518,9763128,5,0,1,1536,15,4060147802
1100,9761820,1113424,10875244,9,0,0,58880,17,1557241951
1101,9771881,347803,10119684,1,0,0,2048,2,7770382457
1102,9780910,373253,10154163,3,0,0,19456,29,3424174866
1103,9788080,424130,10212210,7,0,0,7168,18,2953136743
1104,9800530,483517,10284047,7,0,0,6144,18,1062653270
1105,9800569,454267,10254836,6,0,0,23552,8,7307621988
1106,9804119,956985,10761104,5,0,0,43520,15,2702623456
1107,9815101,587206,10402307,0,0,0,44032,25,2628454264
1108,9819459,495648,10315107,5,0,0,25600,15,9666144906
1109,9823170,5802,9828972,1,0,1,6144,2,2665499915
1110,9830571,1073338,10903909,1,0,0,26112,2,5112566293
1111,9854959,1029000,10883959,5,0,0,28160,15,3769082016
1112,9857340,4420,9861760,1,0,1,11776,2,6046961402
1113,9896939,230581,10127520,5,0,0,2560,15,5815247981
1114,9908580,858373,10766953,3,0,0,7168,29,3126521750
1115,9925090,1225365,11150455,3,0,0,109568,29,8135560290
1116,9947261,54687,10001948,4,0,1,1536,14,8780617000
1117,9949280,957155,10906435,3,0,0,8192,29,3575934356
1118,9957150,1075930,11033080,7,0,0,54272,18,1988412075
1119,9967691,1199831,11167522,1,0,0,55808,2,4390525423
1120,9979410,478667,10458077,2,0,0,1536,9,757755262
1121,9981640,28023,10009663,0,0,1,8192,25,307861174
1122,9983339,1015890,10999229,5,0,0,3072,15,6565586753
1123,9991660,18669,10010329,5,0,1,1024,15,5838086772
1124,9996230,267034,10263264,3,0,0,7680,29,1237898689
1125,10010341,427519,10437860,1,0,0,6144,2,10131946211
1126,10010760,267904,10278664,3,0,0,6656,29,395609078
1127,10016160,8889,10025049,1,0,1,6144,2,3412996426
1128,10019741,5767,10025508,2,0,1,5632,9,10613238950
1129,10028930,5454,10034384,3,0,1,13824,29,8226238693
1130,10032351,6294,10038645,4,0,1,13824,14,1114952921
1131,10034159,964111,10998270,5,0,0,7168,15,789874953
1132,10035090,422464,10457554,9,0,0,48640,17,1180111334
1133,10035440,400533,10435973,2,0,0,512,9,7829876937
1134,10037051,7262,10044313,4,0,1,7168,14,6424346098
1135,10045930,1994,10047924,3,0,1,2048,29,8968099109
1136,10049311,566,10049877,4,0,1,512,14,10474830155
1137,10049681,1230048,11279729,1,0,0,99328,2,719859551
1138,10064490,4738,10069228,1,0,1,2048,2,3546437732
1139,10065350,7358,10072708,1,0,1,5120,2,7249084693
1140,10065589,699157,10764746,5,0,0,512,15,6571446306
1141,10069810,5484,10075294,5,0,1,4096,15,2382930695
1142,10076910,770606,10847516,3,0,0,31744,29,4823595297
1143,10086111,566,10086677,2,0,1,512,9,1161673803
1144,10086340,6278,10092618,5,0,1,6656,15,6029516793
1145,10087140,1006528,11093668,2,0,0,512,9,8743087273
1146,10095541,4850,10100391,2,0,1,5120,9,5529474460
1147,10128481,1042,10129523,2,0,1,1024,9,7604801611
1148,10131790,6598,10138388,5,0,1,512,15,6138707241
1149,10133460,5486,10138946,5,0,1,512,15,4673551018
1150,10144610,9576,10154186,5,0,1,11264,15,4764741104
1151,10148231,968825,11117056,1,0,0,74240,2,1424760485
1152,10179240,6754,10185994,1,0,1,7168,2,3646818550
1153,10182420,4138,10186558,0,0,1,10752,25,6142472672
1154,10190541,1518,10192059,2,0,1,1536,9,2149835845
1155,10194120,277326,10471446,2,0,0,1536,9,9201554283
1156,10197389,327337,10524726,5,0,0,512,15,2322396310
1157,10201661,1083566,11285227,0,0,0,14848,25,10347759078
1158,10207270,7706,10214976,5,0,1,8192,15,7858458110
1159,10214781,22765,10237546,2,0,1,4096,9,2297362580
1160,10219621,19076,10238697,4,0,1,1024,14,2235827060
1161,10222420,32455,10254875,5,0,1,19968,15,9727082246
1162,10228090,1201720,11429810,9,0,0,16384,17,6848967374
1163,10231271,1224113,11455384,0,0,0,35328,25,8445769867
1164,10232230,22660,10254890,5,0,1,4096,15,10501647511
1165,10232980,21933,10254913,0,0,1,512,25,9105955423
1166,10239771,19052,10258823,4,0,1,10752,14,731095229
1167,10239930,535493,10775423,2,0,0,1024,9,3055242017
1168,10240480,1008970,11249450,9,0,0,65024,17,396040316
1169,10252839,10440,10263279,9,0,1,2048,17,5200146482
1170,10269789,1082627,11352416,5,0,0,512,15,10206328049
1171,10272090,585191,10857281,2,0,0,512,9,9109079036
1172,10275671,8391,10284062,2,0,1,4608,9,4035779590
1173,10287330,5802,10293132,5,0,1,6144,15,5417936214
1174,10304460,1042,10305502,1,0,1,1024,2,7472459987
1175,10306481,920484,11226965,1,0,0,35328,2,4213085670
1176,10308681,1289667,11598348,0,0,0,100864,25,9965639827
1177,10330971,433604,10764575,1,0,0,11264,2,5279035766
1178,10336700,1052568,11389268,9,0,0,51712,17,804315167
1179,10338260,499569,10837829,2,0,0,1024,9,1589940681
1180,10339410,656577,10995987,7,0,0,156160,18,2803873510
1181,10340540,1518,10342058,0,0,1,1536,25,1008178372
1182,10341001,12364,10353365,4,0,1,20480,14,3571239199
1183,10353510,1518,10355028,1,0,1,1536,2,6952050925
1184,10370220,4162,10374382,0,0,1,11264,25,5552147898
1185,10380140,2946,10383086,5,0,1,3072,15,4726351977
1186,10381450,3582,10385032,1,0,1,3072,2,6130647899
1187,10382029,1253747,11635776,5,0,0,512,15,8030873808
1188,10382631,6245,10388876,4,0,1,1024,14,9876935320
1189,10398900,36902,10435802,5,0,1,2048,15,4221634129
1190,10402431,1500092,11902523,1,0,0,21504,2,9557252077
1191,10403120,1302596,11705716,9,0,0,12800,17,2792474030
1192,10425640,35802,10461442,0,0,1,10752,25,7987246843
1193,10436739,35015,10471754,7,0,1,17408,18,2696524996
1194,10440041,901512,11341553,0,0,0,35840,25,1788458033
1195,10442031,333057,10775088,0,0,0,26624,25,3830261363
1196,10443061,35806,10478867,2,0,1,20992,9,7347206541
1197,10446160,410942,10857102,7,0,0,31232,18,603114348
1198,10446270,36783,10483053,0,0,1,6656,25,4963857853
1199,10449350,604657,11054007,7,0,0,68608,18,3480981234
1200,10454320,29399,10483719,0,0,1,1024,25,6477715611
1201,10478521,6504,10485025,2,0,1,2048,9,959944164
1202,10479670,6341,10486011,0,0,1,1536,25,9245382718
1203,10484121,7230,10491351,2,0,1,7680,9,9578695818
1204,10504670,1201396,11706066,2,0,0,1024,9,68327843
1205,10524310,1011978,11536288,3,0,0,41984,29,2625682708
1206,10548261,1087009,11635270,0,0,0,65024,25,8835464563
1207,10554709,1249271,11803980,5,0,0,512,15,6619446190
1208,10557770,566,10558336,6,0,1,512,8,9718239660
1209,10563590,449421,11013011,3,0,0,44544,29,6621142111
1210,10568109,1994,10570103,9,0,1,2048,17,6311848743
1211,10570760,276771,10847531,5,0,1,3584,15,10649144497
1212,10596570,1681174,12277744,9,0,0,79360,17,4421173582
1213,10598880,417601,11016481,9,0,0,10752,17,290155222
1214,10603520,475475,11078995,2,0,0,1024,9,6671683183
1215,10613831,1607103,12220934,0,0,0,8192,25,8721161179
1216,10614410,398780,11013190,2,0,0,512,9,6036608136
1217,10619300,772814,11392114,3,0,0,8704,29,5932281626
1218,10620680,746844,11367524,2,0,0,512,9,1811900312
1219,10659460,224530,10883990,5,0,1,4608,15,2030514672
1220,10662190,221823,10884013,0,0,1,3584,25,2634641632
1221,10666371,842076,11508447,0,0,0,22528,25,10375944750
1222,10696530,1638436,12334966,9,0,0,24064,17,8514931677
1223,10709769,177167,10886936,9,0,1,18944,17,4927644649
1224,10719550,279866,10999416,2,0,0,512,9,7754746128
1225,10724130,164752,10888882,5,0,1,3072,15,656701927
1226,10731830,157923,10889753,6,0,1,12288,8,4384442742
1227,10743070,149909,10892979,0,0,1,5120,25,5488206064
1228,10743870,1385145,12129015,3,0,0,14336,29,4783052709
1229,10751730,144155,10895885,0,0,1,4608,25,7197039726
1230,10758831,145093,10903924,4,0,1,5632,14,8078055599
1231,10774390,132060,10906450,0,0,1,4608,25,10703541459
1232,10778090,405984,11184074,7,0,0,11776,18,110295708
1233,10780021,1147045,11927066,0,0,0,30720,25,5431856834
1234,10784960,121505,10906465,5,0,1,2048,15,5447419968
1235,10786750,119754,10906504,0,0,1,3584,25,8779170023
1236,10791741,116434,10908175,4,0,1,3584,14,1895589034
1237,10795221,114580,10909801,4,0,1,2560,14,8413614270
1238,10795460,556770,11352230,9,0,0,22016,17,3872866151
1239,10796471,272061,11068532,1,0,0,3584,2,4196872395
1240,10797189,115518,10912707,9,0,1,4608,17,10624230338
1241,10805990,618408,11424398,3,0,0,74240,29,9827084968
1242,10819230,1128935,11948165,7,0,0,69120,18,9369787504
1243,10827709,90695,10918404,9,0,1,27136,17,949607490
1244,10832410,86660,10919070,0,0,1,1024,25,3806691780
1245,10849280,99082,10948362,5,0,1,7680,15,8247600437
1246,10851881,96496,10948377,2,0,1,1536,9,6803124909
1247,10859671,88721,10948392,4,0,1,7680,14,7256082201
1248,10867439,916009,11783448,5,0,0,512,15,5005787653
1249,10867750,990132,11857882,9,0,0,27136,17,7956677769
1250,10877320,118682,10996002,0,0,1,3072,25,1782328185
1251,10878739,312370,11191109,5,0,0,3072,15,3019475778
1252,10882421,113596,10996017,2,0,1,15360,9,2325960444
1253,10889221,106819,10996040,4,0,1,2048,14,3741828452
1254,10893470,992105,11885575,9,0,0,10752,17,819855360
1255,10902341,93714,10996055,4,0,1,15872,14,9434449507
1256,10905871,578487,11484358,1,0,0,13824,2,6887617538
1257,10908241,404032,11312273,1,0,0,48128,2,7599671495
1258,10909021,1504923,12413944,1,0,0,120832,2,1715766020
1259,10933781,120249,11054030,2,0,1,512,9,3776247916
1260,10941030,113023,11054053,0,0,1,1536,25,8579169190
1261,10943741,623860,11567601,1,0,0,15872,2,4284308068
1262,10945870,108198,11054068,5,0,1,15360,15,1470747365
1263,10965869,88230,11054099,9,0,1,12800,17,10087810976
1264,10965880,780295,11746175,3,0,0,39936,29,6359148520
1265,10971160,370579,11341739,9,0,0,512,17,8122025309
1266,10972279,417168,11389447,5,0,0,512,15,10493361049
1267,10991460,1007197,11998657,3,0,0,4096,29,5704805082
1268,10997029,60392,11057421,9,0,1,3584,17,4786421567
1269,11001590,56177,11057767,5,0,1,512,15,5834967951
1270,11011880,47236,11059116,5,0,1,10240,15,4537951354
1271,11021521,996963,12018484,1,0,0,65024,2,8013139963
1272,11021980,1214757,12236737,9,0,0,51712,17,5030945700
1273,11032311,521435,11553746,0,0,0,15872,25,6919322201
1274,11032931,29558,11062489,2,0,1,4096,9,6423527803
1275,11033219,247469,11280688,5,0,0,3072,15,6807711093
1276,11036381,26774,11063155,4,0,1,1024,14,3415030227
1277,11041021,794569,11835590,0,0,0,12800,25,5598698713
1278,11046699,132794,11179493,5,0,0,512,15,2649221116
1279,11058760,125329,11184089,5,0,1,199168,15,7703504044
1280,11069650,1445217,12514867,3,0,0,36864,29,8869488985
1281,11081511,233437,11314948,1,0,0,8704,2,7891615275
1282,11100529,83575,11184104,9,0,1,512,17,2107201890
1283,11103499,80620,11184119,9,0,1,10752,17,9887579922
1284,11112011,73649,11185660,2,0,1,2560,9,7202869121
1285,11115139,483380,11598519,5,0,0,512,15,2590401245
1286,11129530,295195,11424725,2,0,0,1024,9,3211792152
1287,11130901,1431561,12562462,0,0,0,156160,25,7473588929
1288,11134241,618927,11753168,1,0,0,512,2,9903156181
1289,11139870,291436,11431306,2,0,0,1024,9,4886373383
1290,11141100,55287,11196387,5,0,1,43008,15,667121232
1291,11148321,1228305,12376626,0,0,0,27136,25,2047706801
1292,11155559,45974,11201533,9,0,1,8192,17,5089412645
1293,11161030,124212,11285242,5,0,1,112128,15,766289605
1294,11165439,119826,11285265,9,0,1,4096,17,763775055
1295,11170059,184112,11354171,5,0,0,512,15,2232940354
1296,11170800,1272970,12443770,3,0,0,97792,29,2742133072
1297,11173380,381785,11555165,9,0,0,4608,17,3518492665
1298,11177931,596857,11774788,1,0,0,68096,2,7450571132
1299,11181031,104249,11285280,4,0,1,1024,14,8929927097
1300,11188441,833701,12022142,1,0,0,11264,2,2771879782
1301,11188529,834204,12022733,5,0,0,1024,15,8609140747
1302,11201771,1016636,12218407,1,0,0,105984,2,816778150
1303,11212729,646411,11859140,5,0,0,1536,15,4355358835
1304,11246409,42330,11288739,9,0,1,3584,17,9641750196
1305,11255209,254345,11509554,5,0,0,3584,15,5874126956
1306,11257170,740224,11997394,3,0,0,61440,29,140234576
1307,11272550,450603,11723153,2,0,0,1536,9,5439783181
1308,11275511,528298,11803809,0,0,0,27648,25,7990697825
1309,11291820,23143,11314963,5,0,1,36352,15,10210897831
1310,11306859,442094,11748953,5,0,0,512,15,8806767886
1311,11315619,1031391,12347010,5,0,0,512,15,1545299113
1312,11315880,319717,11635597,2,0,0,1024,9,7945515523
1313,11324371,17197,11341568,2,0,1,7680,9,5602359218
1314,11335861,265714,11601575,1,0,0,2048,2,3270086969
1315,11344249,7996,11352245,9,0,1,12288,17,272397988
1316,11351109,691393,12042502,5,0,0,1024,15,7611329665
1317,11355220,530838,11886058,2,0,0,1536,9,2155886114
1318,11364350,1331100,12695450,9,0,0,133120,17,5982054153
1319,11373900,1242561,12616461,9,0,0,35840,17,10186243480
1320,11391810,573065,11964875,2,0,0,512,9,5921591116
1321,11408809,21662,11430471,9,0,1,14336,17,1357013483
1322,11411040,449324,11860364,2,0,0,512,9,4211396983
1323,11411399,610922,12022321,5,0,0,512,15,1740602662
1324,11426479,431886,11858365,5,0,0,1536,15,6851107245
1325,11432801,566,11433367,2,0,1,512,9,243796
1326,11434641,4162,11438803,2,0,1,11264,9,5316986463
1327,11437071,1168145,12605216,1,0,0,69120,2,1211532209
1328,11453180,370986,11824166,2,0,0,512,9,4120955862
1329,11456779,4374,11461153,9,0,1,4608,17,4573868125
1330,11467589,398950,11866539,5,0,0,512,15,724820615
1331,11485120,1215353,12700473,9,0,0,11264,17,8647311545
1332,11517959,759987,12277946,5,0,0,512,15,10624005514
1333,11520251,16052,11536303,2,0,1,12288,9,8976355811
1334,11546731,1210868,12757599,1,0,0,88064,2,3099531462
1335,11619779,21282,11641061,9,0,1,5632,17,1964227546
1336,11677209,2946,11680155,9,0,1,3072,17,10691160308
1337,11695361,1031511,12726872,1,0,0,78848,2,942263572
1338,11700149,1071479,12771628,5,0,0,512,15,9646626008
1339,11700651,5088,11705739,2,0,1,9216,9,9643998365
1340,11703431,4588,11708019,2,0,1,2048,9,6063044982
1341,11716971,5326,11722297,2,0,1,5632,9,2302784300
1342,11737851,12214,11750065,2,0,1,4096,9,7135566259
1343,11747151,4217,11751368,2,0,1,10752,9,5197498134
1344,11749380,269315,12018695,2,0,0,512,9,9456467856
1345,11778650,678613,12457263,9,0,0,1024,17,2628527359
1346,11804709,698887,12503596,5,0,0,1024,15,8754908091
1347,11807501,923206,12730707,1,0,0,12288,2,2035776754
1348,11808030,757641,12565671,9,0,0,6656,17,6526552857
1349,11809299,3904,11813203,9,0,1,10752,17,9488561455
1350,11838340,1994,11840334,3,0,1,2048,29,3768360016
1351,11885920,6408,11892328,1,0,1,6656,2,378372777
1352,11889731,12807,11902538,2,0,1,7680,9,10544713162
1353,11909560,889366,12798926,3,0,0,41984,29,6119084899
1354,11918360,32259,11950619,3,0,1,2560,29,7954240366
1355,11918371,33554,11951925,2,0,1,2048,9,2948993288
1356,11919599,643065,12562664,5,0,0,512,15,5923693534
1357,11924220,98156,12022376,5,0,1,109568,15,9564720960
1358,11928269,94122,12022391,9,0,1,12800,17,9248181920
1359,11938900,1374873,13313773,3,0,0,113152,29,801060185
1360,11946221,76185,12022406,2,0,1,2560,9,8106069746
1361,11972170,964336,12936506,9,0,0,12800,17,2916009376
1362,11978500,49388,12027888,3,0,1,13312,29,7552785230
1363,11981299,819849,12801148,5,0,0,1024,15,2936656114
1364,11986901,42293,12029194,2,0,1,2048,9,2434643685
1365,11989251,44399,12033650,2,0,1,6656,9,10386715686
1366,11996311,41845,12038156,2,0,1,7168,9,351261440
1367,12000359,67829,12068188,7,0,1,64512,18,6049100552
1368,12005569,67804,12073373,7,0,1,16384,18,4779116759
1369,12006780,66952,12073732,6,0,1,9728,8,9777162735
1370,12012320,61566,12073886,6,0,1,8704,8,10425586421
1371,12012730,490483,12503213,3,0,0,5120,29,8180074372
1372,12025579,269988,12295567,5,0,0,4096,15,3784165400
1373,12027780,577607,12605387,2,0,0,512,9,7889287151
1374,12039250,37862,12077112,3,0,1,5120,29,4629917918
1375,12042080,36978,12079058,6,0,1,3072,8,6499514789
1376,12042680,41563,12084243,6,0,1,16384,8,5787620229
1377,12046250,40579,12086829,6,0,1,4096,8,3591582855
1378,12053230,35865,12089095,6,0,1,3584,8,4353859048
1379,12053609,36792,12090401,9,0,1,2048,17,6146100005
1380,12058889,42649,12101538,7,0,1,45056,18,6649454920
1381,12061290,42834,12104124,5,0,1,4096,15,9806123972
1382,12067260,38452,12105712,3,0,1,15872,29,8014853540
1383,12073620,32451,12106071,6,0,1,9728,8,9750007602
1384,12080560,31105,12111665,5,0,1,26624,15,6029957458
1385,12085479,27057,12112536,9,0,1,12288,17,3092898858
1386,12089991,479151,12569142,1,0,0,11264,2,4275140045
1387,12097279,15616,12112895,9,0,1,9728,17,6241636768
1388,12097840,18839,12116679,3,0,1,14848,29,4612162115
1389,12098300,20325,12118625,5,0,1,3072,15,3733227249
1390,12102131,18457,12120588,2,0,1,11776,9,2081430748
1391,12104731,396891,12501622,0,0,0,145408,25,2477824808
1392,12130900,3422,12134322,6,0,1,3584,8,1810389397
1393,12134740,322149,12456889,3,0,0,43008,29,3607989540
1394,12139080,13083,12152163,0,0,1,22016,25,9659061125
1395,12145179,8290,12153469,9,0,1,2048,17,10582110449
1396,12158350,1042,12159392,0,0,1,1024,25,9887566520
1397,12159570,3898,12163468,3,0,1,4096,29,2548451600
1398,12161820,2954,12164774,0,0,1,2048,25,5884970698
1399,12171590,4850,12176440,6,0,1,5120,8,1033384725
1400,12189000,47776,12236776,5,0,1,6144,15,4582030007
1401,12191081,372338,12563419,0,0,0,2048,25,1228405407
1402,12199339,40303,12239642,9,0,1,3072,17,9912761757
1403,12199920,40068,12239988,6,0,1,512,8,5645848114
1404,12214349,30193,12244542,9,0,1,7168,17,1437425826
1405,12247690,572267,12819957,9,0,0,43008,17,3057010673
1406,12252529,25246,12277775,9,0,1,17920,17,6579453834
1407,12254450,29282,12283732,6,0,1,6144,8,1971798719
1408,12259499,29059,12288558,9,0,1,7680,17,3028309554
1409,12269040,19864,12288904,0,0,1,512,25,7811126210
1410,12281690,281938,12563628,2,0,0,512,9,6106397171
1411,12294710,289431,12584141,3,0,0,49152,29,1687658332
1412,12302490,1042,12303532,6,0,1,1024,8,969007238
1413,12302690,5011,12307701,3,0,1,5120,29,8857125339
1414,12317931,445019,12762950,1,0,0,17408,2,685522155
1415,12339310,586249,12925559,3,0,0,52224,29,9660863692
1416,12346949,2999,12349948,9,0,1,3072,17,7453605318
1417,12349900,2001,12351901,0,0,1,2048,25,1124594864
1418,12352091,5971,12358062,2,0,1,14848,9,9426504904
1419,12362970,4374,12367344,0,0,1,4608,25,1009885517
1420,12370260,325673,12695933,2,0,0,1536,9,4738064978
1421,12370549,43410,12413959,9,0,1,7680,17,6516475921
1422,12371519,85393,12456912,7,0,1,32256,18,4618784834
1423,12395511,166982,12562493,2,0,1,512,9,1919755284
1424,12398350,1017970,13416320,3,0,0,49152,29,8494802267
1425,12405611,490929,12896540,1,0,0,56832,2,2926374936
1426,12407011,155668,12562679,2,0,1,10752,9,6606310303
1427,12421880,140814,12562694,6,0,1,7680,8,3315104257
1428,12432721,130036,12562757,2,0,1,17920,9,9114493324
1429,12441000,121780,12562780,0,0,1,5632,25,8791374546
1430,12441120,122322,12563442,3,0,1,1536,29,8877832156
1431,12445121,118336,12563457,2,0,1,2560,9,7161200935
1432,12450910,154556,12605466,5,0,1,52736,15,3715074867
1433,12452940,152541,12605481,0,0,1,3584,25,532925381
1434,12460640,144856,12605496,5,0,1,11776,15,1272795364
1435,12461009,144502,12605511,9,0,1,9216,17,10240358464
1436,12487819,117707,12605526,7,0,1,15872,18,9098428335
1437,12509860,107535,12617395,0,0,1,19968,25,6437688352
1438,12511450,215437,12726887,5,0,1,150016,15,2685518388
1439,12519080,177104,12696184,9,0,0,512,17,471730986
1440,12520440,280381,12800821,9,0,0,6144,17,4814855508
1441,12524251,542288,13066539,1,0,0,47104,2,3344476522
1442,12532640,399895,12932535,3,0,0,18432,29,7030807862
1443,12547110,320633,12867743,3,0,0,38912,29,2640332720
1444,12553431,352379,12905810,1,0,0,15360,2,6068278962
1445,12559119,410020,12969139,5,0,0,512,15,4336982162
1446,12569349,157553,12726902,9,0,1,4096,17,5117841560
1447,12569610,208474,12778084,2,0,0,1536,9,9325084356
1448,12577740,945446,13523186,2,0,0,512,9,8173868458
1449,12581870,286356,12868226,3,0,0,1536,29,5657184735
1450,12585139,141778,12726917,7,0,1,9728,18,5370105538
1451,12590430,136502,12726932,3,0,1,2048,29,9710181033
1452,12607250,987474,13594724,3,0,0,9216,29,4863862697
1453,12609861,472863,13082724,0,0,0,11264,25,7421794185
1454,12610911,119811,12730722,2,0,1,7680,9,8589334567
1455,12615181,394229,13009410,0,0,0,40448,25,971063090
1456,12623741,579491,13203232,1,0,0,5632,2,4183231009
1457,12631340,191128,12822468,3,0,0,8192,29,1452105578
1458,12664879,65858,12730737,7,0,1,25088,18,7925288604
1459,12669671,406525,13076196,0,0,0,26624,25,8962341712
1460,12674270,318129,12992399,3,0,0,34304,29,6550281714
1461,12677971,299700,12977671,0,0,0,6144,25,10597275839
1462,12682479,48273,12730752,9,0,1,512,17,5426680110
1463,12697861,483556,13181417,0,0,0,56320,25,2389468257
1464,12698659,64314,12762973,7,0,1,53760,18,6244740238
1465,12699031,502470,13201501,0,0,0,64512,25,2696337301
1466,12708910,54086,12762996,6,0,1,8704,8,6611149703
1467,12727399,244968,12972367,5,0,0,1024,15,7371014797
1468,12741130,292466,13033596,3,0,0,32256,29,2029772539
1469,12747509,19331,12766840,9,0,1,4096,17,6226480736
1470,12753529,13657,12767186,9,0,1,512,17,7221741412
1471,12783931,540480,13324411,0,0,0,29696,25,4880200147
1472,12789059,33424,12822483,7,0,1,20992,18,1779308930
1473,12798829,75937,12874766,7,0,1,114176,18,6844735467
1474,12810429,154228,12964657,7,0,1,125952,18,2441168009
1475,12815030,177400,12992430,6,0,1,7680,8,7642821779
1476,12819100,616796,13435896,3,0,0,18432,29,5400034036
1477,12820660,171785,12992445,6,0,1,1536,8,602050191
1478,12827690,164770,12992460,6,0,1,3072,8,6488627542
1479,12853860,138615,12992475,6,0,1,512,8,2558053033
1480,12863001,612657,13475658,1,0,0,3072,2,10328852237
1481,12871839,137586,13009425,7,0,1,38912,18,6793328785
1482,12874550,595602,13470152,3,0,0,64512,29,8959719060
1483,12879339,436009,13315348,5,0,0,5120,15,72737469
1484,12881420,246110,13127530,5,0,1,59392,15,1272562546
1485,12893309,235207,13128516,9,0,1,1536,17,1474192121
1486,12898070,867421,13765491,2,0,0,512,9,7764364475
1487,12900209,371856,13272065,5,0,0,3584,15,8615996301
1488,12902729,227093,13129822,7,0,1,2048,18,923505081
1489,12903639,238982,13142621,9,0,1,2048,17,9323145425
1490,12903899,277845,13181744,5,0,0,1024,15,5293014650
1491,12918760,224527,13143287,3,0,1,1024,29,4992005975
1492,12923071,817814,13740885,1,0,0,1536,2,5350673320
1493,12969300,263265,13232565,3,0,0,14336,29,119472117
1494,12982260,230250,13212510,2,0,0,2048,9,6687194544
1495,12983741,272110,13255851,1,0,0,19968,2,3981659665
1496,12991459,232583,13224042,7,0,1,80384,18,2067458184
1497,13017410,307243,13324653,5,0,1,79872,15,3965577291
1498,13035150,289518,13324668,5,0,1,1024,15,5128020606
1499,13037600,178681,13216281,2,0,0,4096,9,10728734035
1500,13054120,270462,13324582,2,0,0,512,9,232293571
1501,13056381,155490,13211871,0,0,0,17920,25,6383234239
1502,13084949,164803,13249752,5,0,0,1024,15,10635452765
1503,13085560,239680,13325240,6,0,1,8192,8,10176096704
1504,13090591,562333,13652924,0,0,0,38912,25,6268800142
1505,13095451,334806,13430257,1,0,0,45056,2,6085249746
1506,13100450,570647,13671097,3,0,0,51712,29,5861927309
1507,13103421,445846,13549267,0,0,0,22528,25,7891048056
1508,13126260,480727,13606987,3,0,0,13824,29,2739702981
1509,13132030,208867,13340897,6,0,1,1536,8,8813993447
1510,13151400,189843,13341243,5,0,1,512,15,9761834270
1511,13152500,228646,13381146,2,0,0,512,9,7584451107
1512,13157030,317669,13474699,3,0,0,14848,29,692935688
1513,13170570,170929,13341499,6,0,1,9216,8,1987825175
1514,13204550,176425,13380975,2,0,0,1024,9,3209465279
1515,13205330,155088,13360418,5,0,1,29696,15,5999806880
1516,13210460,177809,13388269,6,0,1,6144,8,2859429270
1517,13213640,182067,13395707,5,0,1,20992,15,3964302876
1518,13237060,290849,13527909,2,0,0,512,9,5240829509
1519,13239440,177074,13416514,6,0,1,13312,8,10152768171
1520,13245040,261390,13506430,5,0,1,100352,15,6055883703
1521,13274000,480758,13754758,5,0,1,140800,15,4248993407
1522,13279051,415186,13694237,0,0,0,64000,25,10605309212
1523,13288349,128142,13416491,5,0,0,512,15,8497613516
1524,13293601,411103,13704704,1,0,0,34304,2,1114269878
1525,13295870,597481,13893351,5,0,1,83456,15,10187842505
1526,13299109,638057,13937166,5,0,0,1024,15,10635591359
1527,13312150,625031,13937181,5,0,1,49152,15,10374632854
1528,13317101,619567,13936668,1,0,0,122368,2,7563349078
1529,13324300,621702,13946002,6,0,1,4608,8,4722399034
1530,13346890,396911,13743801,2,0,0,1024,9,2224942258
1531,13366461,505247,13871708,1,0,0,37376,2,8681160503
1532,13370910,596606,13967516,3,0,1,18432,29,8287176989
1533,13375190,334354,13709544,2,0,0,1024,9,5199746709
1534,13393240,574635,13967875,5,0,1,9728,15,1806392458
1535,13393600,596451,13990051,5,0,1,23552,15,7410747655
1536,13403851,864133,14267984,1,0,0,28160,2,7759881359
1537,13415450,609626,14025076,6,0,1,4608,8,9493977046
1538,13438730,341184,13779914,3,0,0,38912,29,216060631
1539,13458141,393374,13851515,0,0,0,130560,25,10138807462
1540,13473860,572028,14045888,5,0,1,55808,15,5266949324
1541,13494770,356916,13851686,2,0,0,512,9,6262969460
1542,13511911,348378,13860289,1,0,0,28160,2,5714175981
1543,13541491,345878,13887369,0,0,0,41984,25,6314065536
1544,13544000,79493,13623493,3,0,0,4096,29,7541706532
1545,13548591,344737,13893328,1,0,0,19456,2,10213831761
1546,13554890,226485,13781375,2,0,0,2048,9,1357750952
1547,13560131,394859,13954990,1,0,0,7168,2,5661196101
1548,13582599,311259,13893858,5,0,0,1536,15,8200620537
1549,13592619,112256,13704875,5,0,0,512,15,7068393883
1550,13597260,566617,14163877,5,0,1,79872,15,9870019375
1551,13633051,476541,14109592,0,0,0,39936,25,4231871182
1552,13636910,299929,13936839,2,0,0,512,9,9658990515
1553,13639021,406844,14045865,1,0,0,38912,2,3489784983
1554,13640830,369797,14010627,2,0,0,512,9,9967176214
1555,13731451,279005,14010456,1,0,0,39424,2,7568376809
1556,13746780,147405,13894185,2,0,0,1024,9,6379132672
1557,13763569,247401,14010970,5,0,0,1024,15,6895555466
1558,13770841,488377,14259218,1,0,0,84992,2,2621176703
1559,13789479,236515,14025994,5,0,0,1024,15,10414198337
1560,13797400,371520,14168920,5,0,1,8704,15,1698686436
1561,13799241,388020,14187261,0,0,0,24064,25,6311137110
1562,13821201,309066,14130267,0,0,0,29696,25,5295549037
1563,13825230,344996,14170226,6,0,1,2048,8,1877654934
1564,13835971,154065,13990036,0,0,0,5120,25,2943436099
1565,13856269,301654,14157923,5,0,0,1536,15,4794590970
1566,13879420,291457,14170877,6,0,1,512,8,8606769658
1567,13881441,326133,14207574,0,0,0,19456,25,1756600627
1568,13881580,326336,14207916,2,0,0,512,9,6439150111
1569,13883700,259521,14143221,2,0,0,512,9,1012606614
1570,13884321,550264,14434585,0,0,0,88064,25,7712335625
1571,13898341,455803,14354144,1,0,0,24064,2,7235633322
1572,13936801,601687,14538488,1,0,0,18432,2,737610839
1573,13938509,269236,14207745,5,0,0,512,15,5660717964
1574,13941020,233403,14174423,8,0,1,5632,26,10432193717
1575,13941920,232759,14174679,6,0,1,9216,8,6479879719
1576,13945171,494109,14439280,1,0,0,15360,2,10265670922
1577,13949630,229555,14179185,6,0,1,7168,8,7599021337
1578,13957529,301860,14259389,5,0,0,512,15,5358804227
1579,13970060,209791,14179851,6,0,1,1024,8,3517725193
1580,13978220,209056,14187276,8,0,1,512,26,3598826144
1581,13993770,193529,14187299,8,0,1,3584,26,477140629
1582,13995450,273181,14268631,2,0,0,2048,9,8528685414
1583,13995641,325220,14320861,0,0,0,51200,25,2504571947
1584,14006571,354304,14360875,1,0,0,22016,2,3708565135
1585,14007809,313277,14321086,5,0,0,512,15,9454583378
1586,14034220,326982,14361202,2,0,0,1024,9,9166060207
1587,14049589,435715,14485304,5,0,0,512,15,4208046013
1588,14053510,133804,14187314,6,0,1,2048,8,2777259064
1589,14066631,433984,14500615,0,0,0,50176,25,3194892468
1590,14080161,436093,14516254,1,0,0,51200,2,6166433485
1591,14085850,111561,14197411,6,0,1,512,8,919069319
1592,14093640,107317,14200957,8,0,1,5632,26,8533103798
1593,14182241,302876,14485117,1,0,0,87552,2,1588352524
1594,14219949,312818,14532767,6,0,0,19456,8,8883286522
1595,14263420,9544,14272964,6,0,1,4608,8,3003045161
1596,14279819,292107,14571926,5,0,0,1024,15,5331747437
1597,14287049,14117,14301166,7,0,1,24064,18,2125022296
1598,14287871,261765,14549636,1,0,0,4608,2,4266219628
1599,14291380,10452,14301832,8,0,1,11264,26,5668707621
1600,14292041,28835,14320876,4,0,1,7680,14,4228680590
1601,14293851,457370,14751221,1,0,0,68096,2,7510234308
1602,14302200,18699,14320899,5,0,1,15872,15,10615692140
1603,14305941,19478,14325419,4,0,1,4608,14,9654509541
1604,14310589,251262,14561851,5,0,0,512,15,6427241491
1605,14319330,7395,14326725,6,0,1,2048,8,9821982189
1606,14347781,302674,14650455,1,0,0,29696,2,5995073875
1607,14367840,149410,14517250,2,0,0,2048,9,6056787110
1608,14374540,1994,14376534,8,0,1,2048,26,2759129951
1609,14387180,10499,14397679,6,0,1,16896,8,9889326509
1610,14388769,127842,14516611,5,0,0,1024,15,4894877355
1611,14389110,11795,14400905,8,0,1,5120,26,4777110926
1612,14398271,6500,14404771,4,0,1,6144,14,3343529585
1613,14399509,116760,14516269,7,0,1,138752,18,2281602361
1614,14409461,557639,14967100,1,0,0,45056,2,2124097252
1615,14413391,102893,14516284,4,0,1,10752,14,290926123
1616,14417141,100124,14517265,4,0,1,2048,14,7867465446
1617,14436780,80500,14517280,8,0,1,512,26,2391149380
1618,14453469,63826,14517295,7,0,1,8704,18,8022933949
1619,14459651,73131,14532782,4,0,1,5632,14,507295238
1620,14462100,76403,14538503,8,0,1,5632,26,8610591200
1621,14468261,301710,14769971,0,0,0,60928,25,7856245032
1622,14480949,270443,14751392,5,0,0,512,15,601510770
1623,14550590,5326,14555916,6,0,1,5632,8,7061471812
1624,14557790,6795,14564585,6,0,1,5632,8,3495169047
1625,14571240,3387,14574627,6,0,1,9728,8,9358912387
1626,14571970,6206,14578176,8,0,1,4096,26,2332575323
1627,14573250,197155,14770405,2,0,0,512,9,1600428681
1628,14578740,2946,14581686,8,0,1,3072,26,558331776
1629,14608159,243007,14851166,5,0,0,1024,15,1484694632
1630,14627320,4374,14631694,8,0,1,4608,26,6739771128
1631,14636901,13569,14650470,4,0,1,7168,14,8970354676
1632,14662070,3898,14665968,8,0,1,4096,26,6830793251
1633,14669150,1042,14670192,8,0,1,1024,26,4295913425
1634,14672501,4850,14677351,4,0,1,5120,14,6603790638
1635,14681730,14804,14696534,5,0,1,28672,15,9608489598
1636,14683560,14280,14697840,6,0,1,2048,8,3439799795
1637,14690121,246449,14936570,0,0,0,16384,25,1196607378
1638,14711059,138001,14849060,5,0,0,2048,15,9394083735
1639,14714009,130921,14844930,7,0,1,215552,18,3755759026
1640,14726019,178493,14904512,7,0,1,79360,18,5646657624
1641,14730090,178677,14908767,6,0,1,4096,8,2680654360
1642,14733661,330195,15063856,0,0,0,33792,25,8620940448
1643,14743360,167118,14910478,5,0,1,3584,15,10221021770
1644,14775011,133741,14908752,1,0,0,12800,2,2752948496
1645,14797831,202479,15000310,1,0,0,21504,2,2206485796
1646,14810411,100733,14911144,4,0,1,1024,14,2158105516
1647,14817639,225307,15042946,7,0,1,195584,18,6674367198
1648,14819580,233372,15052952,6,0,1,1024,8,2544259814
1649,14836440,227431,15063871,6,0,1,5120,8,3098780696
1650,14841451,306717,15148168,1,0,0,15872,2,1776063193
1651,14855939,207947,15063886,7,0,1,8704,18,6786657286
1652,14856019,262350,15118369,7,0,1,77312,18,5653898343
1653,14860090,264419,15124509,6,0,1,4096,8,7008546979
1654,14861701,263474,15125175,4,0,1,1024,14,2525488373
1655,14865140,201405,15066545,2,0,0,1024,9,8067579563
1656,14877109,293861,15170970,7,0,1,93184,18,561248646
1657,14878309,304976,15183285,7,0,1,2560,18,9759898409
1658,14881000,304804,15185804,6,0,1,3072,8,925623092
1659,14894980,291388,15186368,6,0,1,10752,8,5479637664
1660,14902461,284893,15187354,4,0,1,1536,14,5801606660
1661,14918260,278337,15196597,6,0,1,24576,8,6796234296
1662,14928279,277562,15205841,7,0,1,12288,18,1466616043
1663,14928759,156791,15085550,5,0,0,512,15,5106317873
1664,14929660,253610,15183270,2,0,0,2048,9,8756377358
1665,14938561,306459,15245020,0,0,0,1536,25,581357228
1666,14949640,255008,15204648,2,0,0,512,9,5195007230
1667,14953101,253726,15206827,4,0,1,1536,14,6949058314
1668,14976909,253125,15230034,7,0,1,58880,18,10233101436
1669,14992179,399912,15392091,7,0,1,224256,18,6080352663
1670,14992620,413013,15405633,5,0,1,7680,15,9132979411
1671,15007339,473252,15480591,5,0,0,512,15,6738355684
1672,15012841,444063,15456904,1,0,0,32768,2,9708521618
1673,15017770,391729,15409499,1,0,1,6144,2,4897270352
1674,15028440,408878,15437318,5,0,1,99328,15,6781976438
1675,15043151,225251,15268402,1,0,0,1536,2,6257798556
1676,15055231,470574,15525805,1,0,0,62464,2,5903434132
1677,15071981,384946,15456927,4,0,1,1024,14,4622789613
1678,15084140,372802,15456942,1,0,1,4096,2,8397107714
1679,15108411,216116,15324527,1,0,0,3072,2,4448319400
1680,15109790,349469,15459259,1,0,1,17408,2,2721149173
1681,15120011,342794,15462805,4,0,1,5632,14,6070211589
1682,15137601,602781,15740382,0,0,0,180224,25,6823906516
1683,15141310,321649,15462959,1,0,1,8704,2,1990532688
1684,15146191,319994,15466185,2,0,1,5120,9,10027528380
1685,15203591,269345,15472936,4,0,1,4096,14,6468921664
1686,15206600,343566,15550166,5,0,1,143360,15,9313159577
1687,15230459,296000,15526459,5,0,0,1024,15,4690648534
1688,15230770,327070,15557840,1,0,1,3072,2,5278649587
1689,15244430,314396,15558826,1,0,1,1536,2,2913293678
1690,15245111,353268,15598379,4,0,1,14848,14,6921448070
1691,15302110,308730,15610840,5,0,1,20992,15,2521039387
1692,15307030,306009,15613039,6,0,1,1024,8,2092270814
1693,15315239,210893,15526132,5,0,0,1024,15,195055319
1694,15338350,309502,15647852,5,0,1,28160,15,7248252854
1695,15354630,304353,15658983,5,0,1,25600,15,1046561856
1696,15365699,302393,15668092,5,0,0,1536,15,8524385106
1697,15370131,293172,15663303,4,0,1,2560,14,3431022808
1698,15381051,282598,15663649,4,0,1,512,14,5327052933
1699,15419069,142482,15561551,5,0,0,1024,15,6110257246
1700,15448670,220164,15668834,5,0,1,17408,15,6486314062
1701,15524620,280458,15805078,5,0,1,179712,15,5688459
1702,15535240,280606,15815846,5,0,1,28672,15,3831371849
1703,15537211,461724,15998935,1,0,0,123392,2,3734148407
1704,15544360,272254,15816614,5,0,1,11776,15,594629284
1705,15576671,323319,15899990,0,0,0,55296,25,9239323044
1706,15588349,203999,15792348,5,0,0,2560,15,9759442262
1707,15591231,585908,16177139,1,0,0,62464,2,354326736
1708,15630940,246043,15876983,5,0,1,72704,15,645409016
1709,15652330,225639,15877969,5,0,1,1536,15,9229728001
1710,15661551,525914,16187465,1,0,0,29696,2,1544033198
1711,15669640,230373,15900013,5,0,1,56320,15,3109238287
1712,15677441,237086,15914527,0,0,0,7680,25,8679259909
1713,15725591,592897,16318488,1,0,0,44032,2,8166166792
1714,15732191,519106,16251297,0,0,0,25600,25,6766178998
1715,15747201,361489,16108690,1,0,0,39936,2,7957147408
1716,15768101,373993,16142094,1,0,0,29184,2,3558873718
1717,15783031,308578,16091609,0,0,0,9728,25,7306086672
1718,15792441,492536,16284977,0,0,0,57344,25,4791190303
1719,15825149,247901,16073050,5,0,0,1536,15,6932218702
1720,15830241,399263,16229504,1,0,0,5120,2,5049826072
1721,15847941,379980,16227921,0,0,0,46592,25,6277067862
1722,15862461,315941,16178402,0,0,0,4096,25,10637681438
1723,15883321,373295,16256616,1,0,0,17408,2,3967450245
1724,15905449,282515,16187964,5,0,0,1536,15,2089234822
1725,15924041,418575,16342616,1,0,0,22528,2,10324308930
1726,15932471,2102,15934573,4,0,1,1024,14,1686220785
1727,15941611,271005,16212616,1,0,0,6656,2,7635193023
1728,15945331,382092,16327423,0,0,0,18944,25,7184739007
1729,15967591,393400,16360991,1,0,0,15360,2,4657531749
1730,15972801,317666,16290467,0,0,0,16384,25,7785295446
1731,16021921,123165,16145086,1,0,0,9728,2,2172485530
1732,16046650,33850,16080500,5,0,1,55808,15,5565257985
1733,16110031,446496,16556527,1,0,0,63488,2,4908289845
1734,16111311,124292,16235603,1,0,0,19968,2,4141307406
1735,16116059,273547,16389606,5,0,0,4096,15,4486353674
1736,16117411,218326,16335737,0,0,0,26624,25,2962509579
1737,16148671,217792,16366463,1,0,0,3072,2,9213154908
1738,16180729,104731,16285460,5,0,0,1536,15,9170708111
1739,16185641,272995,16458636,1,0,0,44544,2,8219651540
1740,16190589,468581,16659170,5,0,0,1536,15,8741945436
1741,16213471,389174,16602645,0,0,0,47616,25,4860198447
1742,16216291,420425,16636716,1,0,0,40960,2,7749513877
1743,16236711,300457,16537168,1,0,0,66048,2,7555448131
1744,16267451,301316,16568767,0,0,0,25600,25,2554771202
1745,16305661,190295,16495956,0,0,0,1024,25,2527442963
1746,16308351,279763,16588114,1,0,0,15360,2,767185218
1747,16351771,285124,16636895,1,0,0,512,2,8877770831
1748,16368411,1518,16369929,2,0,1,1536,9,7152014255
1749,16449659,167564,16617223,5,0,0,512,15,7704114401
1750,16469479,359436,16828915,5,0,0,512,15,8089372752
1751,16488011,324733,16812744,0,0,0,10240,25,1149042455
1752,16531301,223326,16754627,1,0,0,16896,2,5009121956
1753,16535561,545445,17081006,0,0,0,182272,25,3307534530
1754,16552491,195143,16747634,0,0,0,73728,25,2362658852
1755,16562719,250352,16813071,5,0,0,1024,15,10678599368
1756,16577220,566,16577786,1,0,1,512,2,3551065486
1757,16584460,18710,16603170,1,0,1,512,2,889151761
1758,16629600,10676,16640276,1,0,1,3584,2,1934828680
1759,16657491,351770,17009261,0,0,0,13312,25,9361693977
1760,16664401,650417,17314818,0,0,0,57344,25,3809441523
1761,16672439,310595,16983034,5,0,0,1024,15,2739809234
1762,16673231,556895,17230126,0,0,0,113664,25,1941109158
1763,16674959,223425,16898384,5,0,0,512,15,10359743003
1764,16679060,1994,16681054,1,0,1,2048,2,5627223024
1765,16685281,261040,16946321,1,0,0,32768,2,1870573270
1766,16732680,15554,16748234,1,0,1,512,2,9702826835
1767,16734781,446359,17181140,0,0,0,45568,25,3807408179
1768,16734810,19832,16754642,1,0,1,9216,2,9294125815
1769,16756631,622651,17379282,0,0,0,103936,25,8957353298
1770,16769981,389477,17159458,0,0,0,12800,25,9507738770
1771,16806250,6836,16813086,1,0,1,4608,2,6584291647
1772,16870981,372264,17243245,0,0,0,43008,25,1947187208
1773,16886461,363515,17249976,0,0,0,22016,25,7340800332
1774,16909040,3898,16912938,1,0,1,4096,2,8536966285
1775,16934730,566,16935296,1,0,1,512,2,10214546381
1776,16937161,157987,17095148,0,0,0,2048,25,5638517270
1777,16981200,4850,16986050,1,0,1,5120,2,9468667490
1778,16989490,1042,16990532,3,0,1,1024,29,5337684873
1779,17035781,246878,17282659,1,0,0,30208,2,354905904
1780,17053371,482998,17536369,1,0,0,112640,2,2017411380
1781,17056429,133379,17189808,5,0,0,512,15,3240255121
1782,17120301,337383,17457684,0,0,0,12288,25,4363120547
1783,17123520,1518,17125038,1,0,1,1536,2,5206366011
1784,17124939,221206,17346145,5,0,0,512,15,9198623557
1785,17146039,233578,17379617,5,0,0,1024,15,4234473421
1786,17173611,223185,17396796,1,0,0,25600,2,6496175363
1787,17178611,304105,17482716,1,0,0,2560,2,5840996037
1788,17184209,352675,17536884,5,0,0,1536,15,7205195934
1789,17218400,33103,17251503,3,0,1,1536,29,8246497265
1790,17226619,153349,17379968,5,0,0,1024,15,7835811917
1791,17237851,300608,17538459,0,0,0,5120,25,10706735097
1792,17270469,59973,17330442,5,0,0,512,15,6007282490
1793,17272359,211173,17483532,5,0,0,512,15,4263750432
1794,17277801,387328,17665129,1,0,0,4096,2,6108381364
1795,17281971,329165,17611136,0,0,0,118784,25,6819225435
1796,17282580,11654,17294234,1,0,1,18944,2,4790317784
1797,17284510,30323,17314833,1,0,1,6144,2,2550428284
1798,17327940,4374,17332314,3,0,1,4608,29,9389939253
1799,17355681,41130,17396811,2,0,1,16384,9,7312003532
1800,17366491,177957,17544448,0,0,0,6144,25,385581404
1801,17367610,29216,17396826,1,0,1,1536,2,8991204842
1802,17369540,27301,17396841,3,0,1,1024,29,7125875866
1803,17374771,167775,17542546,1,0,0,13312,2,6663826471
1804,17383831,275274,17659105,1,0,0,29696,2,8610329488
1805,17414720,1042,17415762,1,0,1,1024,2,5969388811
1806,17435440,14804,17450244,3,0,1,28672,29,3338036126
1807,17444640,13059,17457699,1,0,1,8192,2,8734344605
1808,17465291,318924,17784215,0,0,0,9728,25,3499691930
1809,17483480,6322,17489802,8,0,1,6656,26,8838358945
1810,17511310,31251,17542561,1,0,1,1024,2,637485520
1811,17511509,136002,17647511,5,0,0,1024,15,4905477780
1812,17511770,33238,17545008,1,0,1,6656,2,2946134190
1813,17516811,167381,17684192,0,0,0,58880,25,7026498808
1814,17567941,43210,17611151,2,0,1,23040,9,3696335401
1815,17584879,158147,17743026,5,0,0,1536,15,2665254207
1816,17622700,10241,17632941,3,0,1,16384,29,7053021961
1817,17624460,11707,17636167,1,0,1,5120,2,3102521624
1818,17685951,2946,17688897,2,0,1,3072,9,9856169081
1819,17697399,204802,17902201,5,0,0,1024,15,4752233911
1820,17702930,52549,17755479,5,0,1,85504,15,4933555251
1821,17709780,48605,17758385,3,0,1,4608,29,10683725464
1822,17719371,39680,17759051,4,0,1,1024,14,966897281
1823,17735569,168299,17903868,5,0,0,512,15,6828834501
1824,17739510,22447,17761957,1,0,1,4608,2,2020790415
1825,17748421,16122,17764543,2,0,1,4096,9,9961043800
1826,17748819,16710,17765529,9,0,1,1536,17,10389493125
1827,17753951,250273,18004224,0,0,0,10752,25,4750837117
1828,17770431,228688,17999119,1,0,0,53248,2,4707482325
1829,17777131,2946,17780077,2,0,1,3072,9,5118322211
1830,17784100,2577,17786677,1,0,1,2560,2,7422212497
1831,17814820,3422,17818242,1,0,1,3584,2,2503926066
1832,17838210,4374,17842584,1,0,1,4608,2,7192349790
1833,17866481,328016,18194497,1,0,0,143872,2,220387455
1834,17883681,369971,18253652,1,0,0,194048,2,5591137464
1835,17890211,1994,17892205,2,0,1,2048,9,6338908444
1836,17891610,4374,17895984,1,0,1,4608,2,9123974696
1837,17897861,2470,17900331,2,0,1,2560,9,8550548089
1838,17961801,3898,17965699,2,0,1,4096,9,1947439277
1839,17975421,2470,17977891,2,0,1,2560,9,7470917917
1840,17979571,19563,17999134,2,0,1,4096,9,8705135423
1841,17981869,308653,18290522,5,0,0,56320,15,10696847777
1842,18010101,113013,18123114,1,0,0,4096,2,7153711191
1843,18012590,3898,18016488,1,0,1,4096,2,4190777938
1844,18013561,7113,18020674,2,0,1,6656,9,1635085204
1845,18032591,398568,18431159,1,0,0,39936,2,6172880803
1846,18062901,5802,18068703,2,0,1,6144,9,3287231874
1847,18073249,256272,18329521,5,0,0,12288,15,9622592815
1848,18080671,222221,18302892,0,0,0,13312,25,513345012
1849,18097219,201602,18298821,5,0,0,27136,15,7024972874
1850,18100181,153814,18253995,0,0,0,1024,25,9353743465
1851,18105011,2870,18107881,2,0,1,8704,9,1541278
1852,18105351,167988,18273339,1,0,0,13824,2,3059581983
1853,18122081,8731,18130812,2,0,1,8192,9,8673547778
1854,18162581,235540,18398121,0,0,0,36864,25,5018148207
1855,18162740,91913,18254653,1,0,1,1024,2,1289470887
1856,18209699,334565,18544264,5,0,0,80384,15,6937415281
1857,18221461,37946,18259407,4,0,1,5632,14,3321382991
1858,18225181,469276,18694457,0,0,0,38912,25,7132887442
1859,18226400,37513,18263913,8,0,1,7168,26,6771376024
1860,18233719,407889,18641608,5,0,0,90112,15,9537628599
1861,18236181,418086,18654267,0,0,0,41472,25,6670424863
1862,18270861,296850,18567711,0,0,0,76800,25,2089516029
1863,18273691,133567,18407258,1,0,0,4096,2,4124039062
1864,18287121,77196,18364317,1,0,0,1536,2,6126702943
1865,18338301,344285,18682586,1,0,0,18432,2,4706106887
1866,18370489,74517,18445006,5,0,0,3584,15,1889255519
1867,18392871,11537,18404408,2,0,1,6656,9,5730914898
1868,18396421,8333,18404754,2,0,1,512,9,555397973
1869,18399160,9780,18408940,8,0,1,6656,26,2678064276
1870,18402761,13341,18416102,4,0,1,22528,14,10685313167
1871,18407281,9167,18416448,4,0,1,512,14,5391127356
1872,18417261,1518,18418779,4,0,1,1536,14,9528352253
1873,18417771,558467,18976238,1,0,0,101888,2,9417242930
1874,18421300,12363,18433663,8,0,1,2560,26,2286597694
1875,18422051,233947,18655998,0,0,0,5632,25,2247292190
1876,18430209,171901,18602110,5,0,0,36864,15,8413072032
1877,18443549,213564,18657113,5,0,0,3584,15,5882275422
1878,18475031,3128,18478159,2,0,1,9216,9,8320386261
1879,18478549,301533,18780082,5,0,0,34304,15,927959434
1880,18511561,1518,18513079,4,0,1,1536,14,7711021845
1881,18524560,48461,18573021,8,0,1,5632,26,2888824143
1882,18527071,350245,18877316,0,0,0,17920,25,9866005317
1883,18531050,42317,18573367,0,0,1,512,25,5112548275
1884,18540009,305791,18845800,5,0,0,22016,15,4516338837
1885,18543809,524869,19068678,5,0,0,45568,15,1326000297
1886,18549891,26382,18576273,2,0,1,4608,9,8838309639
1887,18553580,24639,18578219,8,0,1,3072,26,7217049278
1888,18561761,17943,18579704,2,0,1,15360,9,10064949561
1889,18563850,17800,18581650,8,0,1,3072,26,2527594891
1890,18599161,346018,18945179,1,0,0,30720,2,2364073901
1891,18603051,566,18603617,4,0,1,512,14,4690533333
1892,18604160,1518,18605678,0,0,1,1536,25,5220193542
1893,18616441,42149,18658590,2,0,1,1536,9,6299772652
1894,18636930,22326,18659256,1,0,1,1024,2,2939864386
1895,18647540,18093,18665633,1,0,1,8192,2,9918987100
1896,18648610,22208,18670818,8,0,1,16384,26,622787710
1897,18656720,15724,18672444,0,0,1,2560,25,3947953655
1898,18657881,255744,18913625,0,0,0,24064,25,459492337
1899,18665769,317918,18983687,5,0,0,20992,15,9639961842
1900,18666261,7463,18673724,4,0,1,14336,14,2481180278
1901,18671071,200770,18871841,0,0,0,23040,25,3749751768
1902,18676110,18362,18694472,1,0,1,6144,2,4241201554
1903,18695991,6278,18702269,4,0,1,6656,14,9952276517
1904,18698221,5674,18703895,2,0,1,2560,9,5856970360
1905,18703380,3898,18707278,1,0,1,4096,2,7779743141
1906,18706891,733,18707624,2,0,1,512,9,2892969786
1907,18715449,365100,19080549,5,0,0,38912,15,5668213725
1908,18718661,24412,18743073,4,0,1,44032,14,2629104385
1909,18773171,8914,18782085,2,0,1,2048,9,9203426257
1910,18774940,7491,18782431,8,0,1,512,26,3165696479
1911,18781490,1607,18783097,0,0,1,1024,25,7195088625
1912,18782229,340522,19122751,5,0,0,13312,15,1805980550
1913,18782680,1518,18784198,8,0,1,1536,26,6836842856
1914,18796631,1042,18797673,4,0,1,1024,14,7535548517
1915,18801231,4850,18806081,4,0,1,5120,14,4415039717
1916,18802600,4147,18806747,5,0,1,1024,15,30545595
1917,18840020,8259,18848279,0,0,1,2560,25,3719672429
1918,18844330,5895,18850225,8,0,1,3072,26,9345241207
1919,18880450,2470,18882920,8,0,1,2560,26,5834924866
1920,18880851,227714,19108565,1,0,0,46592,2,4938094080
1921,18892520,4679,18897199,8,0,1,12288,26,1632780716
1922,18905600,8040,18913640,1,0,1,9216,2,1810516066
1923,18925401,308545,19233946,1,0,0,29696,2,3563159485
1924,18927909,2946,18930855,9,0,1,3072,17,1533226907
1925,18954030,56375,19010405,8,0,1,56320,26,4078139803
1926,18956169,58422,19014591,9,0,1,6656,17,3194295595
1927,18956390,59187,19015577,1,0,1,1536,2,9585146462
1928,18970790,46733,19017523,1,0,1,3072,2,2214198870
1929,19018449,1518,19019967,9,0,1,1536,17,5194467218
1930,19026129,7230,19033359,9,0,1,7680,17,2282259460
1931,19026661,293751,19320412,0,0,0,85504,25,8991614533
1932,19043601,110306,19153907,1,0,0,12800,2,7716680966
1933,19049859,4374,19054233,9,0,1,4608,17,8658796136
1934,19069859,13628,19083487,9,0,1,3072,17,3696347429
1935,19087779,345644,19433423,5,0,0,48128,15,7869685362
1936,19103609,7894,19111503,9,0,1,3072,17,4314265889
1937,19159871,236716,19396587,1,0,0,12288,2,7066073567
1938,19183210,2470,19185680,3,0,1,2560,29,10594001396
1939,19190520,2946,19193466,3,0,1,3072,29,3628582490
1940,19204939,62094,19267033,5,0,0,1024,15,1156534819
1941,19255111,196544,19451655,1,0,0,14336,2,8140611887
1942,19265010,2946,19267956,3,0,1,3072,29,7228150699
1943,19270011,275496,19545507,1,0,0,84992,2,5450047884
1944,19282340,566,19282906,3,0,1,512,29,8115915438
1945,19302729,18258,19320987,9,0,1,512,17,2267993410
1946,19313220,11519,19324739,3,0,1,11264,29,4461122079
1947,19342200,5971,19348171,3,0,1,14848,29,9986732489
1948,19347991,262919,19610910,0,0,0,30720,25,1909353754
1949,19371130,3422,19374552,0,0,1,3584,25,1338846819
1950,19382000,7706,19389706,0,0,1,8192,25,6005633848
1951,19418739,16211,19434950,9,0,1,1536,17,7753087163
1952,19432639,6111,19438750,9,0,1,5120,17,1827553361
1953,19518580,26950,19545530,3,0,1,4608,29,8643437917
1954,19519260,527841,20047101,3,0,0,36352,29,8937422188
1955,19543130,330548,19873678,3,0,0,61440,29,2142670381
1956,19555711,292365,19848076,0,0,0,79360,25,8058303894
1957,19609559,4289,19613848,9,0,1,3072,17,1337917586
1958,19629801,526189,20155990,0,0,0,78336,25,6899964567
1959,19636329,2470,19638799,9,0,1,2560,17,3246467820
1960,19645629,390373,20036002,5,0,0,16384,15,1040585869
1961,19671750,1518,19673268,3,0,1,1536,29,6565638099
1962,19677770,12308,19690078,3,0,1,20480,29,7144802091
1963,19683110,306686,19989796,3,0,0,53248,29,2084963481
1964,19701859,6278,19708137,9,0,1,6656,17,3058754689
1965,19726441,342161,20068602,0,0,0,16896,25,7315051718
1966,19742520,3898,19746418,0,0,1,4096,25,4504442967
1967,19754770,10499,19765269,3,0,1,16896,29,8208578864
1968,19758331,90080,19848411,0,0,0,1024,25,8489501262
1969,19773669,3422,19777091,9,0,1,3584,17,8035011887
1970,19785171,245824,20030995,1,0,0,135168,2,6839474391
1971,19813621,386061,20199682,1,0,0,60416,2,539332693
1972,19818820,1518,19820338,3,0,1,1536,29,7573772693
1973,19832441,387848,20220289,1,0,0,46592,2,2307425727
1974,19836991,210617,20047608,0,0,0,1536,25,873259811
1975,19840479,10937,19851416,9,0,1,3072,17,8858372226
1976,19841950,31743,19873693,3,0,1,5632,29,986400042
1977,19843501,533785,20377286,0,0,0,115712,25,1080227396
1978,19855260,208179,20063439,3,0,0,18432,29,10247692608
1979,19865529,11603,19877132,9,0,1,3584,17,1613970189
1980,19881651,394015,20275666,1,0,0,148480,2,4343807890
1981,19907681,140254,20047935,0,0,0,1024,25,9921807600
1982,19907729,2470,19910199,9,0,1,2560,17,8644597825
1983,19939031,340558,20279589,1,0,0,12800,2,957660738
1984,19955480,6278,19961758,3,0,1,6656,29,5382016119
1985,19960831,1273,19962104,2,0,1,512,9,1973813832
1986,20015720,34311,20050031,0,0,1,3072,25,7995466630
1987,20029789,21868,20051657,9,0,1,2560,17,3358377641
1988,20040360,269187,20309547,3,0,0,30208,29,9617520659
1989,20049190,3773,20052963,0,0,1,2048,25,7810985589
1990,20084160,566,20084726,0,0,1,512,25,10176103804
1991,20095921,3898,20099819,4,0,1,4096,14,6647393834
1992,20153819,16467,20170286,9,0,1,27648,17,2789507353
1993,20155359,20214,20175573,9,0,1,16896,17,8146374893
1994,20205460,14844,20220304,0,0,1,3584,25,8327437678
1995,20241060,41008,20282068,0,0,1,2560,25,1485158383
1996,20261929,397201,20659130,5,0,0,123904,15,1264090164
1997,20262880,152813,20415693,3,0,0,6656,29,2851090007
1998,20277820,4914,20282734,0,0,1,1024,25,10667858150
1999,20278191,234401,20512592,0,0,0,32256,25,4044701127
2000,20298710,10852,20309562,0,0,1,2048,25,2966695887
2001,20306721,358516,20665237,1,0,0,19968,2,9858244878
2002,20322271,277009,20599280,1,0,0,44544,2,375087870
2003,20337471,100926,20438397,1,0,0,512,2,2520540748
2004,20345760,34631,20380391,0,0,1,3072,25,9116309788
2005,20346119,337338,20683457,5,0,0,20480,15,10010454295
2006,20348101,437858,20785959,0,0,0,87040,25,7302047450
2007,20351751,224200,20575951,1,0,0,14848,2,3978090071
2008,20352270,183745,20536015,3,0,0,76800,29,7997040107
2009,20359250,23407,20382657,0,0,1,3584,25,7554788128
2010,20370381,168457,20538838,0,0,0,9216,25,2288901545
2011,20377019,557898,20934917,5,0,0,107520,15,2407732417
2012,20379421,310868,20690289,1,0,0,1024,2,2172794182
2013,20384530,5196,20389726,0,0,1,13312,25,2991582981
2014,20411541,4167,20415708,2,0,1,4096,9,8740943325
2015,20453630,277453,20731083,3,0,0,60416,29,8818865681
2016,20458821,157034,20615855,0,0,0,18944,25,1293193850
2017,20481471,320446,20801917,0,0,0,27648,25,5776161507
2018,20485979,85433,20571412,5,0,0,13824,15,3965106869
2019,20506789,177463,20684252,5,0,0,2560,15,5878946472
2020,20534950,258512,20793462,3,0,0,24576,29,3580695978
2021,20579371,543196,21122567,1,0,0,56832,2,6600076070
2022,20583481,457782,21041263,0,0,0,67072,25,9819208375
2023,20585760,14120,20599880,0,0,1,512,25,4338868084
2024,20588941,12047,20600988,2,0,1,1536,9,8861344924
2025,20597881,395251,20993132,1,0,0,48640,2,6177890519
2026,20604981,12566,20617547,2,0,1,20992,9,3673211841
2027,20613751,572878,21186629,1,0,0,18944,2,9015687225
2028,20625961,681806,21307767,0,0,0,48640,25,10106797336
2029,20671431,270989,20942420,0,0,0,24576,25,4520195746
2030,20682311,5831,20688142,2,0,1,4096,9,8033701297
2031,20687209,452845,21140054,5,0,0,57344,15,3409983511
2032,20701150,2470,20703620,0,0,1,2560,25,8003250807
2033,20706481,2470,20708951,2,0,1,2560,9,7103718399
2034,20724470,253827,20978297,3,0,0,88576,29,103569634
2035,20749019,335864,21084883,5,0,0,33792,15,3036443388
2036,20776569,28278,20804847,9,0,1,3072,17,9680356870
2037,20780649,702006,21482655,5,0,0,67584,15,7741539631
2038,20785139,533883,21319022,5,0,0,36864,15,6602069240
2039,20814280,1042,20815322,1,0,1,1024,2,7688396473
2040,20814571,4444,20819015,2,0,1,4608,9,2968746282
2041,20824440,556889,21381329,3,0,0,55808,29,6836239079
2042,20835840,5454,20841294,1,0,1,13824,2,4775085507
2043,20866430,2470,20868900,1,0,1,2560,2,10675595707
2044,20867271,227652,21094923,0,0,0,7680,25,4824003539
2045,20881660,566,20882226,1,0,1,512,2,6041260613
2046,20926730,611097,21537827,3,0,0,109568,29,10112145616
2047,20938711,4768,20943479,2,0,1,1024,9,6819488875
2048,20946431,3422,20949853,2,0,1,3584,9,4140224007
2049,20947051,3788,20950839,2,0,1,1536,9,1448857074
2050,20976470,17237,20993707,6,0,1,512,8,10569765518
2051,20986950,8341,20995291,6,0,1,2048,8,6082983651
2052,21016210,4420,21020630,1,0,1,11776,2,10426368086
2053,21027070,173925,21200995,3,0,0,11264,29,1011529090
2054,21033150,631814,21664964,3,0,0,26624,29,6677894429
2055,21038161,10374,21048535,2,0,1,7680,9,4746061155
2056,21043471,183226,21226697,0,0,0,14336,25,4100290845
2057,21044940,11791,21056731,6,0,1,19456,8,6379914976
2058,21049300,10337,21059637,1,0,1,4608,2,5890110225
2059,21049400,497677,21547077,3,0,0,14336,29,7166548998
2060,21064940,7230,21072170,6,0,1,7680,8,2231428063
2061,21081510,364103,21445613,3,0,0,105472,29,56605916
2062,21090530,123341,21213871,3,0,0,11264,29,4288504220
2063,21092271,450407,21542678,0,0,0,15872,25,8718632013
2064,21103491,288149,21391640,0,0,0,33792,25,2208092259
2065,21111420,41209,21152629,1,0,1,20992,2,825248401
2066,21126540,26755,21153295,6,0,1,1024,8,6892303011
2067,21144980,403118,21548098,3,0,0,3072,29,7199727405
2068,21175731,188145,21363876,0,0,0,16384,25,1541257420
2069,21190220,311545,21501765,3,0,0,62464,29,9685164639
2070,21202901,259107,21462008,0,0,0,53760,25,2785078897
2071,21221911,7230,21229141,2,0,1,7680,9,6931283010
2072,21224670,6097,21230767,6,0,1,2560,8,8266015290
2073,21226991,7002,21233993,2,0,1,5120,9,8704796779
2074,21240791,4374,21245165,2,0,1,4608,9,2826337629
2075,21293340,29063,21322403,6,0,1,3584,8,9168414497
2076,21342580,69166,21411746,3,0,0,2560,29,2928764992
2077,21347609,44046,21391655,7,0,1,46592,18,1806408181
2078,21352080,224086,21576166,8,0,0,56320,26,3968237441
2079,21362350,29328,21391678,1,0,1,5632,2,576658737
2080,21374811,282002,21656813,0,0,0,71680,25,1285052697
2081,21394440,4374,21398814,8,0,1,4608,26,10534479791
2082,21396031,3129,21399160,2,0,1,512,9,8114174440
2083,21398231,2946,21401177,2,0,1,3072,9,2438395228
2084,21402429,5326,21407755,7,0,1,5632,18,8733939200
2085,21407830,95750,21503580,3,0,0,5632,29,8388021352
2086,21409969,72709,21482678,7,0,1,50176,18,9715598110
2087,21411840,89956,21501796,0,0,1,1024,25,5969542690
2088,21413080,88731,21501811,1,0,1,5120,2,4908902622
2089,21414551,372691,21787242,0,0,0,36352,25,9168294118
2090,21417940,83886,21501826,8,0,1,1536,26,1160049432
2091,21430999,70850,21501849,7,0,1,27648,18,1462644129
2092,21437389,109703,21547092,7,0,1,20992,18,6133640993
2093,21449730,97377,21547107,5,0,1,16896,15,6553111586
2094,21496751,353498,21850249,0,0,0,117248,25,1276281704
2095,21508959,109431,21618390,7,0,1,115200,18,1757576897
2096,21512950,111341,21624291,5,0,1,19968,15,6302474883
2097,21522490,102467,21624957,1,0,1,1024,2,5936004799
2098,21524919,140060,21664979,7,0,1,84992,18,5478261803
2099,21537219,127775,21664994,7,0,1,15360,18,2436294609
2100,21552150,112859,21665009,3,0,1,1536,29,7212564819
2101,21559780,105244,21665024,1,0,1,9216,2,3578784349
2102,21582330,82733,21665063,5,0,1,43008,15,3646646468
2103,21615981,277280,21893261,0,0,0,51712,25,10001167083
2104,21620760,46693,21667453,1,0,1,2560,2,5024880893
2105,21627500,42539,21670039,6,0,1,4096,8,2823686382
2106,21634410,36615,21671025,1,0,1,1536,2,4768261830
2107,21667150,235694,21902844,3,0,0,8192,29,1075141676
2108,21678350,460724,22139074,3,0,0,68096,29,9256647149
2109,21683700,41908,21725608,5,0,1,68096,15,9101487929
2110,21693810,495040,22188850,3,0,0,70144,29,6818989065
2111,21722419,3548,21725967,7,0,1,9728,18,1174401372
2112,21722840,5538,21728378,1,0,1,3072,2,7327214451
2113,21741380,63620,21805000,5,0,1,107008,15,4907845665
2114,21754001,396320,22150321,0,0,0,36864,25,2225042857
2115,21754809,55580,21810389,7,0,1,17408,18,6801142593
2116,21758600,53415,21812015,1,0,1,2560,2,4292592266
2117,21761930,52031,21813961,8,0,1,3072,26,2904437971
2118,21762300,87980,21850280,6,0,1,8192,8,1079743640
2119,21782190,68113,21850303,5,0,1,73216,15,6659688185
2120,21793469,56857,21850326,7,0,1,5120,18,3466563083
2121,21794061,56288,21850349,2,0,1,4096,9,7913165477
2122,21800919,49445,21850364,7,0,1,15872,18,2553341409
2123,21814810,40413,21855223,5,0,1,5120,15,8048915903
2124,21816289,51740,21868029,7,0,1,31232,18,5791346961
2125,21834750,34265,21869015,8,0,1,1536,26,5294377314
2126,21841850,467778,22309628,3,0,0,53760,29,8680470842
2127,21846029,57796,21903825,7,0,1,68096,18,8077665978
2128,21879341,551579,22430920,0,0,0,45056,25,5693776132
2129,21886779,27898,21914677,9,0,1,34816,17,9828761478
2130,21895289,20259,21915548,7,0,1,12288,18,8207122613
2131,21918400,566,21918966,6,0,1,512,8,3226851228
2132,21936690,1042,21937732,6,0,1,1024,8,7303530320
2133,21942660,566,21943226,6,0,1,512,8,6394662431
2134,21946470,3422,21949892,8,0,1,3584,26,7913540486
2135,21948610,2268,21950878,8,0,1,1536,26,9665486033
2136,21952410,13083,21965493,5,0,1,22016,15,9646130917
2137,21962210,4909,21967119,6,0,1,2560,8,4940816239
2138,21979610,2946,21982556,6,0,1,3072,8,4862337767
2139,22017009,2870,22019879,7,0,1,8704,18,5093630010
2140,22017631,4549,22022180,2,0,1,2560,9,6034881913
2141,22043240,7706,22050946,6,0,1,8192,8,8041464778
2142,22045450,5752,22051202,1,0,1,9216,2,1867378677
2143,22045520,5960,22051480,6,0,1,8704,8,9947010809
2144,22065360,3128,22068488,1,0,1,9216,2,5000904041
2145,22086921,5326,22092247,2,0,1,5632,9,4239243075
2146,22133780,298091,22431871,3,0,0,3072,29,5001174552
2147,22139331,13494,22152825,2,0,1,2560,9,10314621881
2148,22143769,45096,22188865,7,0,1,36352,18,9705051102
2149,22154610,34270,22188880,1,0,1,1536,2,3034692589
2150,22195440,1042,22196482,8,0,1,1024,26,3349460364
2151,22216160,13600,22229760,5,0,1,23040,15,4022847590
2152,22220030,13596,22233626,8,0,1,6144,26,9551166134
2153,22223129,10958,22234087,7,0,1,10240,18,471944277
2154,22246770,1518,22248288,8,0,1,1536,26,10582710028
2155,22246980,6585,22253565,1,0,1,6656,2,2225018271
2156,22269891,241963,22511854,0,0,0,40960,25,5765346781
2157,22271321,254243,22525564,0,0,0,14848,25,234344632
2158,22302761,11233,22313994,2,0,1,4608,9,10464847677
2159,22311320,4300,22315620,5,0,1,2560,15,9664074515
2160,22314810,1796,22316606,5,0,1,1536,15,106417056
2161,22318331,6754,22325085,2,0,1,7168,9,1228640057
2162,22323241,4750,22327991,2,0,1,4608,9,1808707205
2163,22327100,1237,22328337,5,0,1,512,15,5749506658
2164,22343380,566,22343946,5,0,1,512,15,8356244199
2165,22361481,2470,22363951,2,0,1,2560,9,9314667964
2166,22382979,22691,22405670,7,0,1,37376,18,1423707748
2167,22386420,21516,22407936,5,0,1,3584,15,9676141808
2168,22407141,108948,22516089,0,0,0,13824,25,8134216268
2169,22482030,1994,22484024,0,0,1,2048,25,8055132501
2170,22506501,12959,22519460,2,0,1,9728,9,5928366696
2171,22510241,15338,22525579,2,0,1,3072,9,296816498
2172,22514139,57892,22572031,7,0,1,84480,18,1971478601
2173,22526621,221693,22748314,0,0,0,66560,25,7162477518
2174,22531969,41048,22573017,7,0,1,1536,18,4282461694
2175,22547571,27072,22574643,2,0,1,2560,9,3871040788
2176,22553670,21959,22575629,0,0,1,1536,25,9615681686
2177,22560060,18155,22578215,0,0,1,4096,25,4653748154
2178,22575651,6488,22582139,2,0,1,15872,9,10555903387
2179,22589880,3422,22593302,0,0,1,3584,25,8528078275
2180,22590710,6458,22597168,0,0,1,6144,25,361813356
2181,22593710,4764,22598474,8,0,1,2048,26,4690127445
2182,22597640,7706,22605346,6,0,1,8192,8,4151010559
2183,22610940,4374,22615314,8,0,1,4608,26,4639982665
2184,22617691,1518,22619209,2,0,1,1536,9,1587625292
2185,22622471,1042,22623513,2,0,1,1024,9,6145636799
2186,22627189,1994,22629183,7,0,1,2048,18,2882913314
2187,22629590,12825,22642415,0,0,1,21504,25,9399779189
2188,22640960,3081,22644041,0,0,1,2560,25,1329095064
2189,22643380,1327,22644707,6,0,1,1024,8,87786802
2190,22654209,3422,22657631,7,0,1,3584,18,9920029674
2191,22662340,566,22662906,6,0,1,512,8,5191167149
2192,22667660,1518,22669178,8,0,1,1536,26,716466810
2193,22701950,117615,22819565,9,0,0,10752,17,3487567680
2194,22720901,171832,22892733,0,0,0,24576,25,6329714854
2195,22721850,1994,22723844,8,0,1,2048,26,2963011549
2196,22765930,1518,22767448,8,0,1,1536,26,587406717
2197,22786540,6278,22792818,0,0,1,6656,25,4767605336
2198,22828690,133289,22961979,7,0,0,4096,18,9981318747
2199,22840590,2946,22843536,6,0,1,3072,8,4944479029
2200,22849410,3422,22852832,8,0,1,3584,26,1185964968
2201,22853711,2470,22856181,2,0,1,2560,9,2036949103
2202,22872221,166875,23039096,0,0,0,33280,25,7636226662
2203,22889171,100895,22990066,0,0,0,22528,25,1328495267
2204,22899820,6278,22906098,0,0,1,6656,25,3386245739
2205,22920671,62516,22983187,0,0,0,6144,25,6251974914
2206,22939800,156425,23096225,7,0,0,31744,18,6328448102
2207,22953520,2470,22955990,0,0,1,2560,25,2759137016
2208,22995191,1994,22997185,2,0,1,2048,9,4898437859
2209,22998800,7706,23006506,8,0,1,8192,26,2733047743
2210,23012740,1042,23013782,0,0,1,1024,25,7525710154
2211,23019180,3645,23022825,6,0,1,10240,8,4161054659
2212,23023710,3422,23027132,8,0,1,3584,26,8452034881
2213,23066460,2470,23068930,0,0,1,2560,25,9822729373
2214,23075330,6278,23081608,8,0,1,6656,26,4768150115
2215,23109691,1518,23111209,2,0,1,1536,9,2110057518
2216,23132301,4937,23137238,2,0,1,12800,9,528510768
2217,23144890,2946,23147836,6,0,1,3072,8,2218933598
2218,23164100,80216,23244316,7,0,0,13824,18,1593695114
2219,23164280,6754,23171034,6,0,1,7168,8,3447481375
2220,23168930,3128,23172058,8,0,1,9216,26,7051667509
2221,23172440,161474,23333914,7,0,0,12288,18,1408194636
2222,23181589,7230,23188819,9,0,1,7680,17,9701618419
2223,23183510,119033,23302543,7,0,0,77824,18,1928183239
2224,23190900,2870,23193770,8,0,1,8704,26,9304033122
2225,23197641,146984,23344625,0,0,0,27648,25,9346063791
2226,23201880,6278,23208158,8,0,1,6656,26,826108480
2227,23202290,7814,23210104,6,0,1,3072,8,8126969965
2228,23232171,566,23232737,2,0,1,512,9,5558141229
2229,23270611,117266,23387877,0,0,0,17408,25,8566402079
2230,23294491,11466,23305957,2,0,1,3584,9,2183198580
2231,23332081,12583,23344664,2,0,1,8192,9,5357421364
2232,23336211,240370,23576581,0,0,0,120832,25,8416853567
2233,23337121,8588,23345709,2,0,1,1024,9,3080132328
2234,23340469,6546,23347015,9,0,1,2048,17,474396601
2235,23349881,242471,23592352,0,0,0,51712,25,1205903815
2236,23361440,1042,23362482,6,0,1,1024,8,3387094462
2237,23366781,172961,23539742,0,0,0,29696,25,2302594851
2238,23403290,7706,23410996,6,0,1,8192,8,9707609256
2239,23468780,1994,23470774,6,0,1,2048,8,6883061001
2240,23474400,1042,23475442,5,0,1,1024,15,7508868937
2241,23491310,4420,23495730,6,0,1,11776,8,2349389957
2242,23531259,65731,23596990,9,0,1,12288,17,9966211802
2243,23540290,58385,23598675,1,0,1,2560,2,10232207226
2244,23542534,59367,23601901,6,0,1,5120,8,1813583505
2245,23559551,42696,23602247,4,0,1,512,14,9279719252
2246,23561879,40714,23602593,9,0,1,512,17,9489654853
2247,23568010,36849,23604859,6,0,1,3584,8,9678768077
2248,23573880,115252,23689132,7,0,0,24576,18,4361179816
2249,23603191,190477,23793668,0,0,0,37888,25,4367743702
2250,23612120,144058,23756178,7,0,0,47104,18,6361246511
2251,23616760,10241,23627001,6,0,1,16384,8,8496711185
2252,23632031,170552,23802583,0,0,0,29184,25,10051928081
2253,23640049,3422,23643471,9,0,1,3584,17,5144125678
2254,23691719,3422,23695141,9,0,1,3584,17,10219849340
2255,23692240,184119,23876359,7,0,0,512,18,5924874123
2256,23704650,2470,23707120,3,0,1,2560,29,5784382006
2257,23708559,5326,23713885,9,0,1,5632,17,9911171225
2258,23714129,2470,23716599,9,0,1,2560,17,9590392104
2259,23733421,6278,23739699,4,0,1,6656,14,7932798369
2260,23735291,20902,23756193,4,0,1,5632,14,2757641644
2261,23736951,19257,23756208,4,0,1,4608,14,2460820312
2262,23761031,273246,24034277,0,0,0,90624,25,5101459440
2263,23764580,104312,23868892,7,0,0,42496,18,2920656968
2264,23768960,404576,24173536,7,0,0,57344,18,5092392959
2265,23777250,2470,23779720,6,0,1,2560,8,4232453474
2266,23785590,22689,23808279,8,0,1,14336,26,9374023049
2267,23792000,19334,23811334,6,0,1,4608,8,3378009454
2268,23797001,319824,24116825,0,0,0,56832,25,1368116759
2269,23840091,7230,23847321,4,0,1,7680,14,1729894949
2270,23843530,4937,23848467,6,0,1,12800,8,5987469959
2271,23854491,14416,23868907,4,0,1,2048,14,5771875814
2272,23881019,5326,23886345,9,0,1,5632,17,2476382634
2273,23888459,1518,23889977,9,0,1,1536,17,8694814524
2274,23900190,1994,23902184,1,0,1,2048,2,8945132748
2275,23909219,6278,23915497,9,0,1,6656,17,6148496978
2276,23918250,3645,23921895,1,0,1,10240,2,9420369913
2277,23933320,7230,23940550,6,0,1,7680,8,5081287551
2278,23942640,270708,24213348,7,0,0,55808,18,9758124513
2279,23949431,566,23949997,4,0,1,512,14,764952943
2280,23955020,268483,24223503,7,0,0,33280,18,4844056444
2281,23967930,4374,23972304,6,0,1,4608,8,10451046819
2282,23969141,3829,23972970,4,0,1,1024,14,1515452192
2283,23975299,7230,23982529,9,0,1,7680,17,5506463192
2284,23975569,9226,23984795,9,0,1,3584,17,3573738852
2285,23980250,4801,23985051,1,0,1,9216,2,2105297047
2286,23989421,166620,24156041,0,0,0,44544,25,1420748220
2287,24009741,257700,24267441,0,0,0,24576,25,7535450850
2288,24042350,3422,24045772,1,0,1,3584,2,10145649506
2289,24051959,3904,24055863,7,0,1,10752,18,10026189607
2290,24056370,254485,24310855,7,0,0,108544,18,1587847678
2291,24084851,192901,24277752,0,0,0,33792,25,8404150442
2292,24091800,255937,24347737,7,0,0,32768,18,5010862170
2293,24092090,4420,24096510,6,0,1,11776,8,9165080378
2294,24112020,332287,24444307,7,0,0,58368,18,7694751210
2295,24123399,5326,24128725,9,0,1,5632,17,5331764344
2296,24134491,223610,24358101,0,0,0,17408,25,8401626351
2297,24146330,38439,24184769,6,0,1,18432,8,630692208
2298,24159880,25350,24185230,6,0,1,10240,8,8101514408
2299,24163369,23807,24187176,9,0,1,3072,17,9711679605
2300,24166840,22922,24189762,6,0,1,4096,8,3952744801
2301,24175189,16519,24191708,7,0,1,3072,18,9762087235
2302,24178850,13524,24192374,0,0,1,1024,25,5479429603
2303,24192481,31037,24223518,4,0,1,8192,14,6545903761
2304,24207231,17463,24224694,4,0,1,1024,14,7601734838
2305,24207259,22934,24230193,9,0,1,15360,17,2993929661
2306,24211751,19748,24231499,4,0,1,2048,14,388092342
2307,24216090,15755,24231845,6,0,1,512,8,9864505035
2308,24216430,16898,24233328,0,0,1,10752,25,4581602800
2309,24221220,14902,24236122,1,0,1,3584,2,5625456215
2310,24223219,14477,24237696,9,0,1,10752,17,5971531960
2311,24224950,17057,24242007,1,0,1,5120,2,3352392185
2312,24239841,5072,24244913,4,0,1,4608,14,5629886159
2313,24247689,1518,24249207,9,0,1,1536,17,2731807623
2314,24261581,353422,24615003,0,0,0,28672,25,8343493835
2315,24263769,52421,24316190,7,0,1,5632,18,6288042835
2316,24269889,46967,24316856,7,0,1,1024,18,8555302120
2317,24270501,46701,24317202,4,0,1,512,14,9926733998
2318,24301589,15959,24317548,9,0,1,512,17,7841016550
2319,24304369,15125,24319494,7,0,1,3072,18,1443403194
2320,24318630,360414,24679044,7,0,0,9216,18,3034526513
2321,24321280,1042,24322322,8,0,1,1024,26,9272296217
2322,24334571,1042,24335613,4,0,1,1024,14,541533284
2323,24335219,1518,24336737,7,0,1,1536,18,4152282339
2324,24336130,1273,24337403,0,0,1,1024,25,7908476583
2325,24336590,11170,24347760,6,0,1,4608,8,4966446270
2326,24337060,14141,24351201,1,0,1,3584,2,1843440030
2327,24341641,10226,24351867,4,0,1,1024,14,5243033928
2328,24343560,14556,24358116,8,0,1,8192,26,2016805721
2329,24350660,7471,24358131,6,0,1,10752,8,5355585105
2330,24360350,3898,24364248,1,0,1,4096,2,4794253180
2331,24367860,3387,24371247,6,0,1,9728,8,6015906906
2332,24377801,365324,24743125,0,0,0,137216,25,5050607286
2333,24386550,289656,24676206,7,0,0,136704,18,1256997785
2334,24394060,1994,24396054,1,0,1,2048,2,6516533093
2335,24402649,566,24403215,7,0,1,512,18,9233372904
2336,24433590,21742,24455332,8,0,1,17920,26,481047674
2337,24443610,246004,24689614,7,0,0,20480,18,8869813009
2338,24457411,107881,24565292,0,0,0,11776,25,558337892
2339,24457520,5802,24463322,8,0,1,6144,26,4808545013
2340,24509280,1994,24511274,6,0,1,2048,8,1787221466
2341,24519710,262391,24782101,7,0,0,15872,18,2667651798
2342,24527210,7230,24534440,1,0,1,7680,2,4048044127
2343,24537050,1042,24538092,6,0,1,1024,8,1318444562
2344,24543630,3128,24546758,6,0,1,9216,8,4339244495
2345,24563071,254150,24817221,0,0,0,16896,25,8508458740
2346,24563270,258646,24821916,7,0,0,15360,18,2219288095
2347,24572580,3898,24576478,6,0,1,4096,8,8074874670
2348,24578461,6278,24584739,4,0,1,6656,14,6858819956
2349,24587920,3422,24591342,1,0,1,3584,2,10095208938
2350,24590611,275496,24866107,0,0,0,26112,25,1154052220
2351,24601171,210887,24812058,0,0,0,84480,25,400978722
2352,24601390,1994,24603384,1,0,1,2048,2,8646327479
2353,24633440,42781,24676221,6,0,1,1536,8,1903259636
2354,24639330,40915,24680245,6,0,1,1024,8,4079440460
2355,24639430,42121,24681551,1,0,1,2048,2,4221199708
2356,24646811,228795,24875606,0,0,0,12288,25,3534749377
2357,24648041,35136,24683177,4,0,1,2560,14,2226742471
2358,24648079,41550,24689629,7,0,1,9216,18,7817249485
2359,24653989,35655,24689644,7,0,1,512,18,4190849941
2360,24674290,15393,24689683,8,0,1,2048,26,8604644400
2361,24675370,14328,24689698,1,0,1,512,2,6340756095
2362,24681901,8860,24690761,4,0,1,1024,14,9402783368
2363,24683400,8667,24692067,8,0,1,2048,26,520437093
2364,24684450,10579,24695029,8,0,1,4608,26,9870675769
2365,24689051,54089,24743140,4,0,1,24576,14,3716333129
2366,24715759,33461,24749220,7,0,1,14848,18,9882889614
2367,24716160,36033,24752193,6,0,1,11776,8,4706265403
2368,24720460,35275,24755735,1,0,1,4608,2,9224431574
2369,24722610,33381,24755991,6,0,1,9216,8,8008726371
2370,24732291,28478,24760769,4,0,1,13312,14,5428740507
2371,24737200,153288,24890488,7,0,0,5632,18,6972309438
2372,24817939,8819,24826758,7,0,1,5120,18,5333415557
2373,24845841,2946,24848787,4,0,1,3072,14,1754670684
2374,24861000,307332,25168332,7,0,0,16384,18,8578314579
2375,24872040,6028,24878068,1,0,1,2560,2,5843145203
2376,24887239,1518,24888757,7,0,1,1536,18,6049271706
2377,24888131,68874,24957005,0,0,0,2048,25,9082431995
2378,24894960,257109,25152069,7,0,0,56320,18,10608992042
2379,24912600,1518,24914118,6,0,1,1536,8,1552814371
2380,24915520,12308,24927828,6,0,1,20480,8,7762254776
2381,24921160,7654,24928814,1,0,1,1536,2,9770492753
2382,24946010,1994,24948004,1,0,1,2048,2,5919199657
2383,24956270,750,24957020,1,0,1,512,2,7141103831
2384,25015551,188294,25203845,0,0,0,1536,25,6230452493
2385,25029360,566,25029926,1,0,1,512,2,4022465947
2386,25052510,144927,25197437,7,0,0,6656,18,5698117275
2387,25078830,6754,25085584,1,0,1,7168,2,5712912210
2388,25094450,81509,25175959,7,0,0,512,18,3157697927
2389,25097850,11533,25109383,1,0,1,18944,2,8282360520
2390,25098090,119798,25217888,3,0,0,2048,29,5321129576
2391,25101881,147320,25249201,0,0,0,6144,25,9544398371
2392,25121161,1518,25122679,4,0,1,1536,14,7373126752
2393,25126061,91188,25217249,0,0,0,10240,25,73709526
2394,25151680,6183,25157863,6,0,1,6144,8,6752164610
2395,25186511,1994,25188505,4,0,1,2048,14,3905359293
2396,25192321,5131,25197452,4,0,1,5120,14,6259646084
2397,25199651,1994,25201645,4,0,1,2048,14,9224932614
2398,25203910,6488,25210398,1,0,1,15872,2,7288347083
2399,25208641,214346,25422987,0,0,0,74240,25,8554982382
2400,25252540,89325,25341865,7,0,0,512,18,8012308805
2401,25257631,122175,25379806,0,0,0,33280,25,5702886026
2402,25262820,228422,25491242,7,0,0,23552,18,1769404216
2403,25288241,11791,25300032,4,0,1,19456,14,757581450
2404,25288519,12179,25300698,7,0,1,1024,18,7633216156
2405,25294470,9134,25303604,6,0,1,4608,8,14968743
2406,25302721,12995,25315716,4,0,1,25088,14,1727653440
2407,25304310,12392,25316702,0,0,1,1536,25,3194153211
2408,25308679,9329,25318008,7,0,1,2048,18,764643095
2409,25312590,6084,25318674,0,0,1,1024,25,2099520885
2410,25323780,2470,25326250,6,0,1,2560,8,7402463406
2411,25330329,4420,25334749,7,0,1,11776,18,7739997521
2412,25345550,1518,25347068,0,0,1,1536,25,1222817412
2413,25370640,10242,25380882,0,0,1,1024,25,10586758520
2414,25375621,9381,25385002,4,0,1,5120,14,2581876996
2415,25378959,8629,25387588,9,0,1,4096,17,4458651950
2416,25379930,179696,25559626,3,0,0,59392,29,634309645
2417,25393580,1042,25394622,0,0,1,1024,25,6507140988
2418,25394890,115552,25510442,7,0,0,512,18,224648206
2419,25408050,109246,25517296,7,0,0,1024,18,4132137380
2420,25438679,1994,25440673,9,0,1,2048,17,9263918472
2421,25442970,167156,25610126,3,0,0,8192,29,5494810165
2422,25447040,4850,25451890,3,0,1,5120,29,281543734
2423,25454320,2870,25457190,0,0,1,8704,25,7521517412
2424,25466770,566,25467336,0,0,1,512,25,5401429133
2425,25477371,6278,25483649,4,0,1,6656,14,3121926645
2426,25478880,89572,25568452,7,0,0,1536,18,3796243917
2427,25481490,9767,25491257,0,0,1,14848,25,853717580
2428,25498470,1042,25499512,1,0,1,1024,2,7998322565
2429,25509000,122842,25631842,7,0,0,1024,18,4539621033
2430,25509141,128688,25637829,0,0,0,10752,25,6067912018
2431,25530470,1994,25532464,3,0,1,2048,29,5532214945
2432,25546620,14633,25561253,1,0,1,1536,2,9015663465
2433,25550681,12944,25563625,4,0,1,3584,14,1523833110
2434,25554110,14415,25568525,1,0,1,7680,2,5068908900
2435,25557930,61779,25619709,7,0,0,2048,18,3716120566
2436,25558751,13960,25572711,4,0,1,6656,14,6021319292
2437,25558961,14109,25573070,4,0,1,9728,14,1133587713
2438,25583390,276102,25859492,3,0,0,50176,29,1355348358
2439,25587931,11274,25599205,4,0,1,18432,14,7505771654
2440,25594730,4821,25599551,0,0,1,512,25,3220386679
2441,25620179,5454,25625633,7,0,1,13824,18,6749758831
2442,25628250,65422,25693672,7,0,0,512,18,6482016952
2443,25629340,1994,25631334,0,0,1,2048,25,3380568686
2444,25630159,3121,25633280,7,0,1,3072,18,4719021486
2445,25633510,4374,25637884,3,0,1,4608,29,4004551483
2446,25655580,45596,25701176,7,0,0,1024,18,8700236585
2447,25657490,4850,25662340,1,0,1,5120,2,4347060845
2448,25694639,1518,25696157,7,0,1,1536,18,4677220202
2449,25695421,304465,25999886,0,0,0,138240,25,9250505014
2450,25697541,566,25698107,4,0,1,512,14,3452415433
2451,25699310,4850,25704160,3,0,1,5120,29,9691135964
2452,25700380,159283,25859663,7,0,0,512,18,10195747627
2453,25708530,125337,25833867,3,0,0,13824,29,9397337167
2454,25709631,4850,25714481,4,0,1,5120,14,59773196
2455,25720241,1042,25721283,4,0,1,1024,14,5356108949
2456,25726610,4420,25731030,3,0,1,11776,29,988426376
2457,25730010,1686,25731696,1,0,1,1024,2,9089707114
2458,25741311,71002,25812313,0,0,0,3072,25,9756967757
2459,25745600,6229,25751829,3,0,1,15360,29,6502618133
2460,25781310,2946,25784256,3,0,1,3072,29,9792013594
2461,25786230,87349,25873579,3,0,0,4608,29,7934036216
2462,25793300,3422,25796722,0,0,1,3584,25,4003015252
2463,25799400,3645,25803045,1,0,1,10240,2,1515909226
2464,25801980,211501,26013481,3,0,0,44544,29,7963006151
2465,25802190,1201,25803391,3,0,1,512,29,2410499773
2466,25813720,230424,26044144,3,0,0,5120,29,9870137291
2467,25825371,2470,25827841,4,0,1,2560,14,2222920789
2468,25831170,8491,25839661,3,0,1,6144,29,61306703
2469,25836390,4577,25840967,0,0,1,2048,25,445203726
2470,25843601,198021,26041622,0,0,0,12288,25,8517439072
2471,25875380,3422,25878802,1,0,1,3584,2,686837624
2472,25882610,228600,26111210,3,0,0,79360,29,1860054824
2473,25882740,1042,25883782,1,0,1,1024,2,8848622519
2474,25893450,3387,25896837,3,0,1,9728,29,6802551070
2475,25916129,1994,25918123,7,0,1,2048,18,6656161796
2476,25919320,566,25919886,3,0,1,512,29,836181687
2477,25920670,121123,26041793,7,0,0,512,18,10478543900
2478,25925360,188742,26114102,3,0,0,8192,29,6747038821
2479,25950260,161277,26111537,7,0,0,1024,18,6515562587
2480,25960001,186540,26146541,0,0,0,28160,25,7304984293
2481,25978140,39537,26017677,5,0,1,11264,15,8304077112
2482,25981670,36993,26018663,1,0,1,1536,2,4042995414
2483,25989800,29849,26019649,5,0,1,1536,15,6033175561
2484,26043100,85801,26128901,7,0,0,512,18,5742978034
2485,26044230,1042,26045272,3,0,1,1024,29,4409601837
2486,26116340,209364,26325704,3,0,0,1024,29,8978160922
2487,26133380,180260,26313640,3,0,0,21504,29,5817722172
2488,26135551,60091,26195642,0,0,0,512,25,362365078
2489,26144919,4742,26149661,7,0,1,9216,18,8733122787
2490,26147650,8970,26156620,1,0,1,7680,2,7365419288
2491,26155400,45596,26200996,7,0,0,1024,18,8730098302
2492,26174280,211018,26385298,3,0,0,64000,29,616387324
2493,26184220,73136,26257356,3,0,0,10752,29,2262637997
2494,26211489,5326,26216815,7,0,1,5632,18,10661166855
2495,26216850,5454,26222304,1,0,1,13824,2,8986148114
2496,26228480,20624,26249104,3,0,1,33280,29,167489822
2497,26232550,81261,26313811,7,0,0,512,18,5639081074
2498,26248849,2470,26251319,7,0,1,2560,18,7827045637
2499,26268219,1994,26270213,7,0,1,2048,18,4834764014
2500,26280980,7230,26288210,3,0,1,7680,29,4716374614
2501,26322781,289910,26612691,0,0,0,276480,25,8662176091
2502,26331130,84707,26415837,7,0,0,512,18,6879452133
2503,26331221,342844,26674065,0,0,0,110080,25,9490104474
2504,26348351,292114,26640465,0,0,0,33792,25,4214802500
2505,26356399,5326,26361725,7,0,1,5632,18,6492595847
2506,26416249,3898,26420147,7,0,1,4096,18,1591065855
2507,26436220,299423,26735643,3,0,0,113152,29,8700090088
2508,26447530,173796,26621326,3,0,0,28160,29,10652349607
2509,26557970,65334,26623304,3,0,1,2048,29,3107457633
2510,26563880,60090,26623970,3,0,1,1024,29,10368518262
2511,26578409,47999,26626408,7,0,1,11264,18,9265248048
2512,26580809,48767,26629576,7,0,1,4096,18,9217817795
2513,26588140,52340,26640480,1,0,1,1536,2,5009255844
2514,26607890,32605,26640495,3,0,1,1024,29,7625884598
2515,26613019,27491,26640510,9,0,1,512,17,7897542880
2516,26642239,36539,26678778,7,0,1,12288,18,1328517100
2517,26647289,33115,26680404,7,0,1,2560,18,295623211
2518,26673170,9180,26682350,1,0,1,3072,2,8232939043
2519,26674240,10056,26684296,3,0,1,3072,29,874717748
2520,26675390,9572,26684962,3,0,1,1024,29,2698379238
2521,26710799,27348,26738147,7,0,1,2560,18,8557171522
2522,26720060,19525,26739585,0,0,1,9216,25,7012556736
2523,26725670,15113,26740783,0,0,1,1536,25,6541272917
2524,26748420,3422,26751842,1,0,1,3584,2,90228200
2525,26749180,3968,26753148,3,0,1,2048,29,7432952131
2526,26752650,62620,26815270,7,0,0,512,18,5774866617
2527,26761050,5326,26766376,1,0,1,5632,2,7942131188
2528,26761630,5732,26767362,0,0,1,1536,25,8798833473
2529,26787880,566,26788446,0,0,1,512,25,5941022331
2530,26811880,111249,26923129,7,0,0,512,18,4264738995
2531,26814010,214819,27028829,3,0,0,53760,29,10226683821
2532,26822910,1994,26824904,1,0,1,2048,2,4771745084
2533,26828470,43904,26872374,7,0,0,512,18,4242576270
2534,26828640,6754,26835394,0,0,1,7168,25,7613584299
2535,26838350,119857,26958207,7,0,0,512,18,2672068819
2536,26864320,2870,26867190,3,0,1,8704,29,7928064386
2537,26879050,3422,26882472,1,0,1,3584,2,7801018311
2538,26879410,14381,26893791,3,0,1,23040,29,698536513
2539,26881550,15147,26896697,3,0,1,4608,29,7840407776
2540,26885690,14553,26900243,1,0,1,5632,2,8777513366
2541,26894830,43904,26938734,7,0,0,512,18,5466823247
2542,26896170,6339,26902509,0,0,1,3584,25,8273929293
2543,26916870,566,26917436,0,0,1,512,25,10676914394
2544,26922160,189031,27111191,3,0,0,86016,29,1789941112
2545,26936631,4374,26941005,4,0,1,4608,14,10666194897
2546,26961570,7706,26969276,1,0,1,8192,2,2189497341
2547,26963801,6755,26970556,4,0,1,14336,14,6162864763
2548,26978880,7706,26986586,1,0,1,8192,2,1449322798
2549,26988600,566,26989166,0,0,1,512,25,2659651972
2550,27004010,377375,27381385,3,0,0,60416,29,2507021795
2551,27004870,5802,27010672,0,0,1,6144,25,4051440514
2552,27008149,2869,27011018,7,0,1,512,18,5864240192
2553,27017391,13900,27031291,4,0,1,2560,14,6084536523
2554,27029580,3657,27033237,0,0,1,3072,25,8355298137
2555,27030561,4302,27034863,4,0,1,2560,14,1655144404
2556,27040490,175417,27215907,7,0,0,2048,18,2566894218
2557,27043051,1042,27044093,4,0,1,1024,14,6417481502
2558,27049530,79854,27129384,7,0,0,512,18,3139901255
2559,27054891,1042,27055933,4,0,1,1024,14,3043152017
2560,27058140,1994,27060134,0,0,1,2048,25,6917422021
2561,27061670,3898,27065568,1,0,1,4096,2,9908020089
2562,27064900,56910,27121810,7,0,0,1024,18,7720271408
2563,27067030,1518,27068548,3,0,1,1536,29,10100638302
2564,27090410,25665,27116075,0,0,1,5120,25,10585826399
2565,27095490,28569,27124059,1,0,1,18432,2,9055869490
2566,27106500,18942,27125442,3,0,1,14848,29,8388881096
2567,27113751,12037,27125788,4,0,1,512,14,92583883
2568,27115071,172851,27287922,1,0,0,11264,2,7473237103
2569,27126091,6754,27132845,4,0,1,7168,14,1447863006
2570,27127350,201798,27329148,3,0,0,36352,29,6115188155
2571,27132950,3128,27136078,1,0,1,9216,2,4584583018
2572,27133460,4341,27137801,1,0,1,2048,2,10721664145
2573,27136270,2837,27139107,3,0,1,2048,29,1999989621
2574,27137670,2743,27140413,1,0,1,2048,2,4948111149
2575,27146389,12825,27159214,9,0,1,21504,17,4344209147
2576,27152010,210888,27362898,3,0,0,110592,29,33590654
2577,27154279,5601,27159880,9,0,1,1024,17,4827541020
2578,27154600,6586,27161186,0,0,1,2048,25,1539867049
2579,27163079,3422,27166501,9,0,1,3584,17,369427346
2580,27190119,6278,27196397,7,0,1,6656,18,1394903979
2581,27203400,1994,27205394,0,0,1,2048,25,7970392766
2582,27220399,2470,27222869,7,0,1,2560,18,594959648
2583,27222070,4937,27227007,8,0,1,12800,26,9168232021
2584,27228120,13083,27241203,8,0,1,22016,26,8896612142
2585,27233010,8539,27241549,6,0,1,512,8,3859715573
2586,27234840,165978,27400818,3,0,0,8704,29,299610379
2587,27236750,9625,27246375,3,0,1,7680,29,4643327494
2588,27240070,10811,27250881,6,0,1,7168,8,8506949155
2589,27242020,10487,27252507,3,0,1,2560,29,5801017181
2590,27255410,3422,27258832,1,0,1,3584,2,10211097842
2591,27255920,181795,27437715,7,0,0,512,18,7499487231
2592,27257719,2419,27260138,7,0,1,2048,18,4962250272
2593,27277720,1042,27278762,1,0,1,1024,2,8387550985
2594,27284481,98635,27383116,1,0,0,5632,2,3020955558
2595,27291249,13858,27305107,9,0,1,23552,17,1303644125
2596,27293621,16671,27310292,4,0,1,16384,14,6855160133
2597,27312930,16241,27329171,6,0,1,7680,8,6738017393
2598,27319870,63301,27383171,3,0,1,8704,29,8570579639
2599,27321509,61709,27383218,9,0,1,2560,17,4461738002
2600,27322440,320951,27643391,3,0,0,54784,29,8845799489
2601,27326349,57342,27383691,7,0,1,512,18,5446896029
2602,27326630,57407,27384037,8,0,1,512,26,2291644066
2603,27328010,56693,27384703,3,0,1,1024,29,8291819463
2604,27339960,50075,27390035,3,0,1,6656,29,7517447943
2605,27343790,48831,27392621,6,0,1,4096,8,1065711073
2606,27347300,45987,27393287,6,0,1,1024,8,6940927668
2607,27350850,42796,27393646,6,0,1,9728,8,10017123625
2608,27358970,35662,27394632,3,0,1,1536,29,5546953434
2609,27365020,30809,27395829,3,0,1,12800,29,3474665822
2610,27372070,28771,27400841,3,0,1,4608,29,9085338666
2611,27372850,135023,27507873,3,0,0,17920,29,8971511030
2612,27386660,16692,27403352,8,0,1,6656,26,2216344217
2613,27397611,265701,27663312,1,0,0,35328,2,450855670
2614,27403060,2470,27405530,1,0,1,2560,2,5778490239
2615,27410360,4162,27414522,6,0,1,11264,8,2613620737
2616,27411520,4808,27416328,1,0,1,2560,2,3342344610
2617,27412189,8678,27420867,7,0,1,15360,18,2065449474
2618,27414409,7124,27421533,7,0,1,1024,18,227993740
2619,27420410,3069,27423479,5,0,1,3072,15,9324546419
2620,27421430,2715,27424145,6,0,1,1024,8,10170184526
2621,27436760,1518,27438278,6,0,1,1536,8,6502782691
2622,27439020,212101,27651121,7,0,0,1024,18,9409879221
2623,27446199,566,27446765,9,0,1,512,17,7856757036
2624,27449781,227841,27677622,1,0,0,512,2,1092718059
2625,27462460,3898,27466358,1,0,1,4096,2,6261871776
2626,27482420,1994,27484414,8,0,1,2048,26,739078201
2627,27488551,1518,27490069,4,0,1,1536,14,5842461685
2628,27497909,9979,27507888,7,0,1,6144,18,417633452
2629,27502301,5602,27507903,4,0,1,1536,14,2797967059
2630,27507050,11602,27518652,1,0,1,17408,2,10553556062
2631,27509090,10868,27519958,0,0,1,2048,25,2000127862
2632,27526259,1518,27527777,7,0,1,1536,18,10525141136
2633,27531420,200336,27731756,3,0,0,49152,29,6042323262
2634,27540221,3422,27543643,4,0,1,3584,14,8687641538
2635,27545389,7706,27553095,7,0,1,8192,18,9603161889
2636,27556621,6754,27563375,4,0,1,7168,14,1053037984
2637,27562850,871,27563721,3,0,1,512,29,2048873503
2638,27575460,3898,27579358,3,0,1,4096,29,6719398742
2639,27578939,3128,27582067,7,0,1,9216,18,10484316055
2640,27581040,6566,27587606,3,0,1,6144,29,1106406830
2641,27585170,4382,27589552,6,0,1,3072,8,7884187386
2642,27592110,6754,27598864,0,0,1,7168,25,10076224301
2643,27601791,4162,27605953,4,0,1,11264,14,7204274897
2644,27608010,2946,27610956,0,0,1,3072,25,7918576785
2645,27616890,1042,27617932,6,0,1,1024,8,6754168202
2646,27619121,1518,27620639,4,0,1,1536,14,3828252946
2647,27629750,19001,27648751,6,0,1,5632,8,9119740225
2648,27630350,21627,27651977,0,0,1,5120,25,7374268043
2649,27639250,186436,27825686,3,0,0,25088,29,9599200428
2650,27645821,204984,27850805,1,0,0,68608,2,5539377327
2651,27650589,12746,27663335,7,0,1,7680,18,2078105328
2652,27653279,17305,27670584,7,0,1,7680,18,8138312050
2653,27661900,207862,27869762,3,0,0,1536,29,5000363280
2654,27662150,11020,27673170,3,0,1,4096,29,4149463767
2655,27670350,118496,27788846,3,0,0,4096,29,4401837950
2656,27671710,3726,27675436,1,0,1,3584,2,1050607283
2657,27674610,5326,27679936,6,0,1,5632,8,9469364981
2658,27680940,1994,27682934,1,0,1,2048,2,1060844915
2659,27699300,6754,27706054,8,0,1,7168,26,5850510153
2660,27712900,18871,27731771,6,0,1,4608,8,425907107
2661,27713621,18165,27731786,4,0,1,10752,14,2302731030
2662,27720320,173445,27893765,3,0,0,10752,29,5491303925
2663,27720990,12373,27733363,6,0,1,1536,8,6492898343
2664,27721270,15722,27736992,1,0,1,12288,2,6386936588
2665,27729671,393398,28123069,1,0,0,223744,2,2817315842
2666,27747350,566,27747916,1,0,1,512,2,5182362050
2667,27752199,13083,27765282,7,0,1,22016,18,7023143681
2668,27756421,10167,27766588,4,0,1,2048,14,4343019061
2669,27757830,14455,27772285,0,0,1,18944,25,6330363274
2670,27759160,13791,27772951,1,0,1,1024,2,8185872649
2671,27783280,248702,28031982,3,0,0,26112,29,6561876895
2672,27788460,1896,27790356,0,0,1,1536,25,2341684662
2673,27806180,192592,27998772,3,0,0,45568,29,6843874303
2674,27811120,1994,27813114,1,0,1,2048,2,3175811617
2675,27814950,203732,28018682,7,0,0,1024,18,8976921060
2676,27815800,314835,28130635,7,0,0,512,18,4079615537
2677,27816520,183211,27999731,8,0,0,3072,26,8652502217
2678,27825371,1349,27826720,4,0,1,1024,14,1472846208
2679,27829551,21277,27850828,4,0,1,2560,14,3418075014
2680,27830030,21433,27851463,8,0,1,512,26,9219316131
2681,27837740,15307,27853047,0,0,1,2048,25,6499189257
2682,27845780,9213,27854993,0,0,1,3072,25,1629697082
2683,27845791,10188,27855979,4,0,1,1536,14,7802889542
2684,27848280,282176,28130456,3,0,0,24064,29,577462320
2685,27855860,147253,28003113,7,0,0,2048,18,1805356148
2686,27858841,2470,27861311,4,0,1,2560,14,8646651914
2687,27861450,365595,28227045,3,0,0,58368,29,10016193623
2688,27879820,566,27880386,0,0,1,512,25,1879538246
2689,27890261,3519,27893780,4,0,1,1536,14,10049714076
2690,27906630,7706,27914336,3,0,1,8192,29,9323802834
2691,27915410,5802,27921212,1,0,1,6144,2,19484158
2692,27922580,4374,27926954,8,0,1,4608,26,10054921111
2693,27927370,374255,28301625,3,0,0,141824,29,6867660632
2694,27927869,1042,27928911,7,0,1,1024,18,623753851
2695,27930310,371665,28301975,2,0,0,512,9,279535075
2696,27936419,3387,27939806,7,0,1,9728,18,7669978004
2697,27957839,1994,27959833,7,0,1,2048,18,10052474224
2698,27961210,3422,27964632,6,0,1,3584,8,10623270977
2699,27964341,11274,27975615,4,0,1,18432,14,2723309169
2700,27968080,12361,27980441,6,0,1,7680,8,9576042384
2701,27970560,11187,27981747,3,0,1,2048,29,1758816581
2702,27973270,26476,27999746,6,0,1,28160,8,5038625841
2703,27985920,199848,28185768,7,0,0,512,18,455612049
2704,27996270,4552,28000822,6,0,1,1024,8,7592365960
2705,27998299,3189,28001488,7,0,1,1024,18,10025502693
2706,27999430,3044,28002474,6,0,1,1536,8,7776571102
2707,28004909,2946,28007855,7,0,1,3072,18,2079806110
2708,28019550,3422,28022972,1,0,1,3584,2,8983774980
2709,28071660,59575,28131235,0,0,1,512,25,882772982
2710,28075310,317136,28392446,3,0,0,23552,29,290048362
2711,28085520,48433,28133953,1,0,1,9216,2,6445070409
2712,28087660,214144,28301804,7,0,0,512,18,1761617544
2713,28087990,139398,28227388,2,0,0,1024,9,7319551584
2714,28094790,39509,28134299,0,0,1,512,25,8363573478
2715,28103660,34077,28137737,1,0,1,4096,2,4690162633
2716,28106200,34123,28140323,8,0,1,4096,26,3171085952
2717,28109800,196647,28306447,3,0,0,1536,29,774115593
2718,28129141,11336,28140477,4,0,1,8704,14,4322520589
2719,28130540,197763,28328303,3,0,0,23040,29,2509058367
2720,28130790,16001,28146791,8,0,1,8192,26,3147547653
2721,28133871,215418,28349289,1,0,0,45056,2,8943527706
2722,28140330,358355,28498685,7,0,0,1024,18,9999013972
2723,28142231,8106,28150337,4,0,1,5632,14,5192834498
2724,28153151,7706,28160857,4,0,1,8192,14,1534081502
2725,28167490,10757,28178247,8,0,1,17408,26,1082861620
2726,28173780,154850,28328630,2,0,0,1024,9,1938040553
2727,28175670,3883,28179553,0,0,1,2048,25,1105402225
2728,28177910,5802,28183712,8,0,1,6144,26,5998910381
2729,28182350,133540,28315890,7,0,0,512,18,1850721074
2730,28182390,5327,28187717,8,0,1,5632,26,647077535
2731,28189930,112396,28302326,7,0,0,1024,18,8231307999
2732,28192110,1042,28193152,8,0,1,1024,26,9629972249
2733,28201701,233761,28435462,1,0,0,32768,2,256708414
2734,28222910,7383,28230293,6,0,1,3072,8,9051409195
2735,28225100,381942,28607042,7,0,0,512,18,8782502217
2736,28231551,336386,28567937,1,0,0,61952,2,8038082585
2737,28257600,566,28258166,0,0,1,512,25,5636609884
2738,28271830,163959,28435789,7,0,0,1024,18,6868222139
2739,28280180,24600,28304780,6,0,1,2560,8,10678049118
2740,28280190,26272,28306462,8,0,1,2560,26,2420433205
2741,28292390,68557,28360947,7,0,0,1536,18,7780792329
2742,28300810,7222,28308032,1,0,1,11264,2,1033487641
2743,28306150,6092,28312242,0,0,1,5120,25,5781737780
2744,28307010,6538,28313548,1,0,1,2048,2,1982569809
2745,28314060,3898,28317958,8,0,1,4096,26,1593345151
2746,28323990,6626,28330616,8,0,1,2048,26,2159367112
2747,28356051,566,28356617,4,0,1,512,14,3675647350
2748,28372310,6278,28378588,8,0,1,6656,26,3964173980
2749,28385960,197936,28583896,3,0,0,52224,29,10239813747
2750,28404310,2470,28406780,8,0,1,2560,26,328595056
2751,28417431,566,28417997,4,0,1,512,14,1965320755
2752,28420550,241288,28661838,3,0,0,50176,29,5620498871
2753,28427431,9868,28437299,4,0,1,1536,14,370941153
2754,28441210,4850,28446060,6,0,1,5120,8,7145598844
2755,28443820,4186,28448006,0,0,1,3072,25,8472905250
2756,28456390,4850,28461240,8,0,1,5120,26,7636139462
2757,28457920,126171,28584091,3,0,0,512,29,279935016
2758,28459020,3904,28462924,0,0,1,10752,25,6957223113
2759,28469940,2470,28472410,6,0,1,2560,8,7550040438
2760,28490250,218059,28708309,7,0,0,1024,18,7861788783
2761,28500101,3898,28503999,4,0,1,4096,14,6220592014
2762,28523710,566,28524276,8,0,1,512,26,4021683690
2763,28531810,174069,28705879,7,0,0,512,18,7199283237
2764,28541470,129671,28671141,7,0,0,1024,18,7030290388
2765,28546850,1518,28548368,8,0,1,1536,26,8763302601
2766,28550990,37715,28588705,0,0,1,5120,25,1417657270
2767,28554970,34721,28589691,6,0,1,1536,8,221410808
2768,28557690,176127,28733817,3,0,0,63488,29,2212881183
2769,28557710,34247,28591957,8,0,1,3584,26,9312209321
2770,28575220,60124,28635344,7,0,0,1536,18,3259304517
2771,28579601,273485,28853086,1,0,0,18432,2,531571696
2772,28580209,12094,28592303,7,0,1,512,18,5787620130
2773,28581280,351013,28932293,7,0,0,1024,18,5917584898
2774,28585079,9810,28594889,7,0,1,4096,18,7785578391
2775,28607339,3387,28610726,7,0,1,9728,18,1952792331
2776,28639960,261284,28901244,7,0,0,1536,18,7486044956
2777,28641680,184449,28826129,2,0,0,2560,9,6565900583
2778,28682290,218471,28900761,3,0,0,147968,29,3634925996
2779,28746649,4374,28751023,7,0,1,4608,18,511199074
2780,28755140,77419,28832559,7,0,0,512,18,2992754942
2781,28757981,74407,28832388,1,0,0,5120,2,7165492685
2782,28782399,4374,28786773,7,0,1,4608,18,6068081262
2783,28790120,7706,28797826,8,0,1,8192,26,9968122861
2784,28790870,110733,28901603,7,0,0,1024,18,8276252140
2785,28794550,134515,28929065,7,0,0,512,18,7356873218
2786,28807421,148642,28956063,1,0,0,11264,2,10158843245
2787,28830150,114333,28944483,2,0,0,11264,9,253635852
2788,28849940,74224,28924164,7,0,0,512,18,2764513975
2789,28884219,18861,28903080,7,0,1,1536,18,5704990461
2790,28887299,20185,28907484,7,0,1,13824,18,4079731099
2791,28887960,361355,29249315,2,0,0,19968,9,5168420263
2792,28893171,179268,29072439,1,0,0,58880,2,2005702710
2793,28906120,110420,29016540,3,0,0,512,29,4661544777
2794,28915360,101009,29016369,3,0,0,1024,29,8463989654
2795,28942130,72547,29014677,7,0,0,512,18,5918390876
2796,28967831,7706,28975537,2,0,1,8192,9,6664915357
2797,28985011,1518,28986529,2,0,1,1536,9,7355279364
2798,29003291,497239,29500530,1,0,0,174592,2,6967238163
2799,29004401,1042,29005443,2,0,1,1024,9,8584043689
2800,29006820,6488,29013308,3,0,1,15872,29,2073470686
2801,29009590,4064,29013654,6,0,1,512,8,1005664944
2802,29011150,2850,29014000,3,0,1,512,29,8363327670
2803,29015941,5196,29021137,2,0,1,13312,9,217790561
2804,29025201,395912,29421113,1,0,0,47104,2,6626702742
2805,29046021,1994,29048015,2,0,1,2048,9,2870700415
2806,29061530,176119,29237649,7,0,0,512,18,7514522128
2807,29064741,153073,29217814,1,0,0,7168,2,1824329579
2808,29081229,3128,29084357,7,0,1,9216,18,3180645717
2809,29104670,3645,29108315,6,0,1,10240,8,3256707852
2810,29105989,4737,29110726,7,0,1,8704,18,5709783717
2811,29106199,4875,29111074,7,0,1,512,18,565214492
2812,29111801,3898,29115699,2,0,1,4096,9,1510713583
2813,29133270,314041,29447311,2,0,0,66048,9,2156531353
2814,29135460,2870,29138330,3,0,1,8704,29,272489938
2815,29144960,3898,29148858,6,0,1,4096,8,6860201260
2816,29146170,122603,29268773,2,0,0,2048,9,729338013
2817,29152770,148197,29300967,7,0,0,512,18,3501634817
2818,29179060,4679,29183739,6,0,1,12288,8,1613559288
2819,29179921,343443,29523364,1,0,0,6656,2,2583005111
2820,29187130,219616,29406746,2,0,0,49664,9,2200001053
2821,29201260,5326,29206586,6,0,1,5632,8,9723849691
2822,29202679,9053,29211732,7,0,1,8192,18,6885659846
2823,29202820,10090,29212910,6,0,1,13824,8,2585134988
2824,29215659,5569,29221228,7,0,1,3584,18,1150082416
2825,29227711,1518,29229229,2,0,1,1536,9,4498378428
2826,29228391,7706,29236097,2,0,1,8192,9,9478425318
2827,29232031,485235,29717266,1,0,0,273920,2,8568405407
2828,29235081,5196,29240277,4,0,1,13312,14,1499340540
2829,29238250,4339,29242589,3,0,1,9728,29,4352860934
2830,29241160,329108,29570268,2,0,0,11776,9,1518191995
2831,29256641,482775,29739416,1,0,0,17408,2,7470533510
2832,29261410,6278,29267688,3,0,1,6656,29,7040361508
2833,29278340,1042,29279382,3,0,1,1024,29,9629425321
2834,29285320,1042,29286362,3,0,1,1024,29,1937115941
2835,29285570,432359,29717929,3,0,0,2048,29,8763768749
2836,29293970,438676,29732646,3,0,0,2560,29,8449884862
2837,29295860,3422,29299282,6,0,1,3584,8,10175218642
2838,29323590,272359,29595949,2,0,0,1024,9,3662232005
2839,29333290,1994,29335284,6,0,1,2048,8,9875058474
2840,29342150,389701,29731851,2,0,0,32768,9,10271343879
2841,29349921,371923,29721844,1,0,0,12800,2,3243198263
2842,29375461,247215,29622676,1,0,0,16896,2,1469866479
2843,29377110,170333,29547443,7,0,0,1024,18,8078834023
2844,29390970,401160,29792130,7,0,0,34816,18,743942131
2845,29412810,199139,29611949,3,0,0,2048,29,8016385312
2846,29436409,64671,29501080,7,0,1,512,18,8803120884
2847,29447221,420318,29867539,1,0,0,45568,2,9158219913
2848,29478879,26716,29505595,6,0,1,5120,8,10175575378
2849,29480770,29011,29509781,6,0,1,6656,8,8237858845
2850,29495540,15547,29511087,3,0,1,2048,29,8349841286
2851,29504731,8942,29513673,4,0,1,4096,14,1940845040
2852,29511970,269514,29781484,7,0,0,94720,18,2319230566
2853,29528151,325489,29853640,1,0,0,56832,2,10146345680
2854,29555690,6488,29562178,6,0,1,15872,8,7252768929
2855,29561599,4162,29565761,9,0,1,11264,17,6036225219
2856,29572240,4374,29576614,3,0,1,4608,29,7350848220
2857,29572979,4359,29577338,9,0,1,10240,17,5143677659
2858,29607650,4314,29611964,3,0,1,10752,29,3123812931
2859,29607781,126300,29734081,1,0,0,4608,2,1902885749
2860,29635230,104209,29739439,3,0,1,5120,29,7173377295
2861,29637100,292201,29929301,7,0,0,57856,18,6935103871
2862,29637320,238042,29875362,7,0,0,25600,18,4852129834
2863,29647949,93527,29741476,9,0,1,4096,17,10161264953
2864,29690700,213183,29903883,3,0,0,1024,29,8479979039
2865,29692620,210936,29903556,2,0,0,33792,9,9725317950
2866,29735110,228644,29963754,7,0,0,23552,18,10354722856
2867,29750249,31258,29781507,9,0,1,6656,17,3510338166
2868,29755970,263506,30019476,7,0,0,8704,18,1213650482
2869,29796351,6278,29802629,4,0,1,6656,14,2437912170
2870,29812889,7230,29820119,9,0,1,7680,17,4948467635
2871,29813200,241981,30055181,2,0,0,12800,9,4919324589
2872,29846650,159145,30005795,7,0,0,3072,18,5804086172
2873,29851360,236846,30088206,2,0,0,81920,9,10260207276
2874,29872139,8107,29880246,9,0,1,5120,17,10261736057
2875,29875110,118870,29993980,2,0,0,23552,9,165785856
2876,29877421,125939,30003360,1,0,0,12288,2,1979826789
2877,29887401,232681,30120082,1,0,0,48128,2,3531084278
2878,29901070,266420,30167490,2,0,0,55808,9,2563557670
2879,29944230,178987,30123217,2,0,0,10240,9,10128331831
2880,29951121,566,29951687,4,0,1,512,14,8044418705
2881,29966000,566,29966566,8,0,1,512,26,4129289980
2882,29980431,213477,30193908,1,0,0,15360,2,4898580446
2883,29986360,158983,30145343,2,0,0,70656,9,203232356
2884,30007061,1042,30008103,2,0,1,1024,9,6269181765
2885,30018560,254337,30272897,7,0,0,26624,18,7745312718
2886,30047031,100691,30147722,1,0,0,7680,2,6179277530
2887,30086030,9398,30095428,8,0,1,7680,26,8548398249
2888,30125481,147587,30273068,1,0,0,512,2,7836955370
2889,30129581,18691,30148272,4,0,1,512,14,7467653371
2890,30141531,207356,30348887,1,0,0,43008,2,9418013877
2891,30144309,23204,30167513,9,0,1,24576,17,8270753990
2892,30155841,99574,30255415,1,0,0,9728,2,6233812493
2893,30186819,1518,30188337,9,0,1,1536,17,2942288494
2894,30194059,6278,30200337,9,0,1,6656,17,2296954398
2895,30223831,142258,30366089,1,0,0,2560,2,5709214608
2896,30235160,3422,30238582,8,0,1,3584,26,7801995730
2897,30247591,120726,30368317,1,0,0,2048,2,5466005853
2898,30251411,242112,30493523,1,0,0,81920,2,9561685732
2899,30256350,1994,30258344,8,0,1,2048,26,3327919800
2900,30269881,3745,30273626,4,0,1,512,14,448579588
2901,30274521,1518,30276039,4,0,1,1536,14,7035296063
2902,30307721,202682,30510403,1,0,0,28672,2,543929133
2903,30312441,224462,30536903,1,0,0,15360,2,2415020995
2904,30322140,252589,30574729,7,0,0,66560,18,9731282117
2905,30330310,134413,30464723,7,0,0,98304,18,3796981503
2906,30333539,15371,30348910,9,0,1,13824,17,4663374447
2907,30336050,15299,30351349,8,0,1,2560,26,5693181723
2908,30352360,566,30352926,8,0,1,512,26,6798412308
2909,30359911,238989,30598900,1,0,0,37888,2,2268325279
2910,30375090,90690,30465780,4,0,0,512,14,1071629255
2911,30381720,2470,30384190,8,0,1,2560,26,1654066629
2912,30382759,2417,30385176,9,0,1,1536,17,8570334927
2913,30387419,566,30387985,9,0,1,512,17,1554490623
2914,30421780,177299,30599079,4,0,0,512,14,462381070
2915,30427430,263061,30690491,7,0,0,63488,18,3003358005
2916,30444530,155032,30599562,4,0,0,1536,14,10719019620
2917,30447299,46239,30493538,9,0,1,11776,17,6665430584
2918,30451941,41612,30493553,4,0,1,1024,14,10092075265
2919,30458590,34978,30493568,8,0,1,3072,26,990927816
2920,30459121,34462,30493583,2,0,1,9216,9,6108209157
2921,30461869,31729,30493598,9,0,1,9728,17,7562992869
2922,30487550,215488,30703038,2,0,0,11264,9,2941468357
2923,30492910,2699,30495609,8,0,1,2048,26,2439416139
2924,30497521,344537,30842058,1,0,0,144896,2,5785309557
2925,30498311,12107,30510418,4,0,1,5120,14,9211655912
2926,30504451,410121,30914572,1,0,0,4096,2,4873666108
2927,30508020,6789,30514809,8,0,1,4608,26,1004559756
2928,30539570,116135,30655705,4,0,0,2048,14,4116125891
2929,30549201,200476,30749677,1,0,0,18432,2,1647651601
2930,30558900,488060,31046960,2,0,0,41984,9,10240317416
2931,30569971,307728,30877699,1,0,0,11776,2,5012253306
2932,30575551,190663,30766214,1,0,0,51712,2,2820328209
2933,30576220,266321,30842541,4,0,0,1536,14,9197521993
2934,30577540,335761,30913301,7,0,0,115712,18,6981222828
2935,30581469,5326,30586795,9,0,1,5632,17,10099729413
2936,30583419,3530,30586949,9,0,1,8704,17,1664240267
2937,30587851,446302,31034153,1,0,0,64512,2,2903373593
2938,30598591,7717,30606308,4,0,1,7168,14,10196276265
2939,30603031,4679,30607710,4,0,1,12288,14,3483013724
2940,30605679,5565,30611244,9,0,1,11776,17,6860193453
2941,30608871,4468,30613339,4,0,1,8704,14,3321722744
2942,30620140,245864,30866004,2,0,0,35840,9,5036332688
2943,30643679,507897,31151576,6,0,0,54272,8,5417486501
2944,30651880,416163,31068043,2,0,0,69120,9,7980181614
2945,30657989,5326,30663315,9,0,1,5632,17,8453360752
2946,30683499,277374,30960873,6,0,0,49664,8,3741446840
2947,30707909,3645,30711554,9,0,1,10240,17,6518980472
2948,30708841,6657,30715498,4,0,1,11776,14,9141106516
2949,30725700,1994,30727694,0,0,1,2048,25,7225180331
2950,30734020,353046,31087066,2,0,0,24064,9,7398660416
2951,30735829,566,30736395,9,0,1,512,17,1192186043
2952,30739299,3422,30742721,9,0,1,3584,17,3594800671
2953,30745081,21148,30766229,4,0,1,6144,14,8419715321
2954,30777551,4850,30782401,4,0,1,5120,14,7262567832
2955,30778220,209178,30987398,4,0,0,512,14,6729572604
2956,30793440,121467,30914907,4,0,0,1024,14,4721627624
2957,30797711,44853,30842564,4,0,1,7680,14,4609440431
2958,30804711,38538,30843249,4,0,1,512,14,5708714097
2959,30807560,354307,31161867,4,0,0,1024,14,3594784752
2960,30812401,387336,31199737,1,0,0,99328,2,1177739542
2961,30814010,298346,31112356,7,0,0,5120,18,3049004124
2962,30816120,198362,31014482,7,0,0,9728,18,10339629733
2963,30833400,432397,31265797,2,0,0,21504,9,1528243052
2964,30840680,80095,30920775,4,0,0,1024,14,4910854725
2965,30859629,10804,30870433,9,0,1,11776,17,8034706478
2966,30865859,11855,30877714,9,0,1,7168,17,557043573
2967,30884220,322533,31206753,4,0,0,1024,14,3941854092
2968,30892429,28715,30921144,9,0,1,6656,17,10247304743
2969,30916589,85726,31002315,6,0,0,3072,8,8517215746
2970,30922050,3387,30925437,0,0,1,9728,25,5753353221
2971,30946781,19477,30966258,4,0,1,5632,14,5201019704
2972,30952740,385490,31338230,2,0,0,69632,9,7165801507
2973,30953091,509493,31462584,1,0,0,73216,2,8373028452
2974,30958950,461873,31420823,2,0,0,167936,9,7938870390
2975,30972729,158215,31130944,6,0,0,5632,8,4585465456
2976,30974090,5326,30979416,0,0,1,5632,25,8967134669
2977,30996970,306368,31303338,2,0,0,2560,9,9793488759
2978,31024210,198794,31223004,2,0,0,13312,9,7994829373
2979,31067621,4788,31072409,4,0,1,4608,14,7252252631
2980,31081219,562834,31644053,6,0,0,90624,8,117315069
2981,31084510,218033,31302543,2,0,0,47104,9,10716641997
2982,31124709,218848,31343557,6,0,0,17408,8,4899987146
2983,31126250,130049,31256299,4,0,0,1536,14,9731017507
2984,31131010,309243,31440253,2,0,0,44544,9,6366024665
2985,31131860,566,31132426,8,0,1,512,26,8987925718
2986,31134800,227434,31362234,7,0,0,20480,18,9295700414
2987,31145411,424722,31570133,1,0,0,46592,2,6067544455
2988,31165290,2870,31168160,8,0,1,8704,26,1376506509
2989,31175730,25058,31200788,8,0,1,1024,26,5819132935
2990,31182290,312847,31495137,2,0,0,20480,9,7944838350
2991,31206079,220555,31426634,6,0,0,18944,8,2266874155
2992,31210350,496613,31706963,7,0,0,69120,18,391501277
2993,31234591,566,31235157,4,0,1,512,14,9345315364
2994,31251369,347527,31598896,6,0,0,87552,8,1167178502
2995,31251730,519783,31771513,7,0,0,37376,18,9600728662
2996,31269710,12566,31282276,0,0,1,20992,25,8554638395
2997,31280391,2231,31282622,4,0,1,512,14,886504551
2998,31281980,4679,31286659,0,0,1,12288,25,3559167132
2999,31292589,386796,31679385,6,0,0,23040,8,6886871278
3000,31293850,16752,31310602,0,0,1,7680,25,10122766210
3001,31298390,16398,31314788,0,0,1,6656,25,7422395312
3002,31309921,349444,31659365,1,0,0,14848,2,1330934631
3003,31317230,145533,31462763,4,0,0,512,14,9817115631
3004,31339130,331805,31670935,4,0,0,2048,14,8331193610
3005,31339499,511737,31851236,6,0,0,77312,8,299347496
3006,31346750,465922,31812672,7,0,0,112128,18,4885517004
3007,31349911,362995,31712906,1,0,0,19456,2,9389066985
3008,31376940,85838,31462778,0,0,1,5120,25,7901148839
3009,31379721,83072,31462793,4,0,1,2048,14,3844495963
3010,31403740,196746,31600486,2,0,0,5120,9,8318452130
3011,31417480,152832,31570312,4,0,0,512,14,8610551619
3012,31421040,43973,31465013,0,0,1,2560,25,2564553917
3013,31425091,429756,31854847,1,0,0,11776,2,470720827
3014,31434350,34551,31468901,0,0,1,13824,25,8254436171
3015,31438490,221225,31659715,2,0,0,1024,9,5965965944
3016,31438560,231736,31670296,7,0,0,13312,18,6736680759
3017,31441099,159870,31600969,6,0,0,1536,8,7787446074
3018,31468180,3898,31472078,0,0,1,4096,25,9186426936
3019,31474389,285721,31760110,6,0,0,18432,8,447884531
3020,31489640,190275,31679915,4,0,0,512,14,2472691297
3021,31516960,129300,31646260,2,0,0,7168,9,5188542374
3022,31527969,362604,31890573,6,0,0,6656,8,3504349844
3023,31529520,4374,31533894,0,0,1,4608,25,1225557066
3024,31543700,1994,31545694,0,0,1,2048,25,3408853975
3025,31559649,380831,31940480,6,0,0,30208,8,7090751810
3026,31561141,37770,31598911,4,0,1,3072,14,4650658548
3027,31589000,299514,31888514,7,0,0,92672,18,583958648
3028,31598710,6174,31604884,0,0,1,4096,25,3137856884
3029,31608590,119386,31727976,2,0,0,512,9,6174726038
3030,31618911,194720,31813631,1,0,0,3072,2,137685672
3031,31654671,4717,31659388,4,0,1,2560,14,467105591
3032,31654820,8752,31663572,0,0,1,4096,25,9931982596
3033,31677880,3491,31681371,0,0,1,2048,25,7272772267
3034,31713979,10757,31724736,7,0,1,17408,18,7373918267
3035,31723540,100004,31823544,4,0,0,1024,14,6836183728
3036,31736360,156732,31893092,7,0,0,8192,18,424205227
3037,31764909,198221,31963130,6,0,0,9216,8,3783038346
3038,31781170,136022,31917192,7,0,0,8704,18,2801618348
3039,31804339,14610,31818949,7,0,1,5632,18,694659341
3040,31831949,25752,31857701,7,0,1,8704,18,5738091631
3041,31838670,54437,31893107,0,0,1,17408,25,1280883069
3042,31858731,36880,31895611,4,0,1,2560,14,1210335424
3043,31860570,94244,31954814,4,0,0,512,14,9491380581
3044,31865090,144833,32009923,2,0,0,6656,9,2334144708
3045,31870650,185287,32055937,7,0,0,512,18,4989559393
3046,31875610,96999,31972609,2,0,0,16384,9,745023925
3047,31884960,192026,32076986,7,0,0,25088,18,1190547083
3048,31889230,289925,32179155,2,0,0,51712,9,9093533039
3049,31911930,216871,32128801,7,0,0,40448,18,5261472350
3050,31933410,183052,32116462,4,0,0,512,14,4594472188
3051,31935431,130994,32066425,1,0,0,9728,2,8839765572
3052,31967189,175874,32143063,6,0,0,33280,8,10212023345
3053,31967650,8373,31976023,0,0,1,3584,25,256364866
3054,31987480,566,31988046,6,0,1,512,8,4877112616
3055,31993260,123007,32116267,7,0,0,35840,18,415878100
3056,31996490,82829,32079319,4,0,0,512,14,2113286965
3057,32030039,1518,32031557,7,0,1,1536,18,10234356384
3058,32030671,99713,32130384,1,0,0,5120,2,8357191115
3059,32034399,4162,32038561,7,0,1,11264,18,5516080133
3060,32067131,199514,32266645,1,0,0,71168,2,9295670336
3061,32110779,32299,32143078,7,0,1,4608,18,6078680406
3062,32110860,213038,32323898,7,0,0,101376,18,2243622525
3063,32110971,262632,32373603,1,0,0,67584,2,8475209270
3064,32123319,19774,32143093,7,0,1,512,18,6720140059
3065,32128749,303397,32432146,6,0,0,4096,8,1056045435
3066,32191551,239316,32430867,1,0,0,94208,2,2961586510
3067,32206521,6488,32213009,4,0,1,15872,14,5133664221
3068,32225851,100308,32326159,1,0,0,4608,2,3409294355
3069,32226820,1518,32228338,0,0,1,1536,25,165859665
3070,32259960,178285,32438245,2,0,0,19968,9,1573470967
3071,32263839,262783,32526622,6,0,0,88576,8,6830371600
3072,32264170,178302,32442472,2,0,0,13824,9,10288246232
3073,32303520,296625,32600145,2,0,0,9728,9,8924109902
3074,32322009,4165,32326174,7,0,1,1024,18,6497857909
3075,32323439,257052,32580491,6,0,0,40960,8,7657187144
3076,32334830,2870,32337700,0,0,1,8704,25,3678402835
3077,32337571,4374,32341945,4,0,1,4608,14,3736775445
3078,32355509,453514,32809023,6,0,0,195072,8,1965619525
3079,32365839,202133,32567972,6,0,0,71680,8,2038449590
3080,32395180,273214,32668394,2,0,0,66560,9,8384923876
3081,32403530,45655,32449185,6,0,1,7168,8,9167752474
3082,32407909,41942,32449851,7,0,1,1024,18,9700479476
3083,32445819,5338,32451157,9,0,1,2048,17,7108008142
3084,32453870,3898,32457768,0,0,1,4096,25,298920981
3085,32463140,7230,32470370,6,0,1,7680,8,5841805923
3086,32484320,4374,32488694,0,0,1,4608,25,7405089819
3087,32489349,142559,32631908,6,0,0,7680,8,9796117676
3088,32495010,249218,32744228,7,0,0,7680,18,2880081651
3089,32505900,404133,32910033,7,0,0,32768,18,766985406
3090,32535451,364575,32900026,1,0,0,124928,2,2412514393
3091,32554810,291183,32845993,4,0,0,1024,14,10524412340
3092,32555739,274694,32830433,6,0,0,1536,8,306816501
3093,32561550,268392,32829942,2,0,0,68608,9,8498652226
3094,32573780,271862,32845642,2,0,0,47104,9,6009013382
3095,32579480,1611,32581091,6,0,1,512,8,6716609858
3096,32579700,8687,32588387,5,0,1,8192,15,6688727567
3097,32590939,239977,32830916,6,0,0,1536,8,2941624726
3098,32592120,76445,32668565,4,0,0,512,14,4127613858
3099,32593360,6800,32600160,6,0,1,4096,8,2278533054
3100,32601800,3422,32605222,6,0,1,3584,8,731262906
3101,32603380,227871,32831251,4,0,0,1024,14,6484506734
3102,32645480,1518,32646998,6,0,1,1536,8,2498986866
3103,32695691,216081,32911772,1,0,0,5632,2,7085662660
3104,32697150,7706,32704856,0,0,1,8192,25,9892608476
3105,32705770,2946,32708716,6,0,1,3072,8,1568679414
3106,32765730,146377,32912107,2,0,0,1024,9,10668878040
3107,32795970,164143,32960113,4,0,0,1024,14,5997060449
3108,32806459,167869,32974328,6,0,0,1024,8,3290258441
3109,32807979,40568,32848547,9,0,1,3072,17,6716754489
3110,32809680,39853,32849533,0,0,1,1536,25,5517821615
3111,32838190,22189,32860379,6,0,1,22528,8,877670247
3112,32850620,83191,32933811,2,0,0,8704,9,903161812
3113,32864470,48162,32912632,0,0,1,512,25,7916343657
3114,32887310,28384,32915694,0,0,1,3584,25,1223212058
3115,32889329,27447,32916776,9,0,1,9728,17,7311512686
3116,32901971,114490,33016461,1,0,0,38400,2,4525339668
3117,32908501,87559,32996060,1,0,0,20480,2,4951417549
3118,32910400,106232,33016632,4,0,0,512,14,4810722115
3119,32929100,10757,32939857,0,0,1,17408,25,5363109175
3120,32938470,10499,32948969,6,0,1,16896,8,8680319955
3121,32943280,73679,33016959,7,0,0,1024,18,10514503364
3122,32944089,8426,32952515,9,0,1,5632,17,10090909714
3123,32950289,84934,33035223,6,0,0,3072,8,9086193961
3124,32951409,2092,32953501,9,0,1,1536,17,5387286153
3125,32954900,4850,32959750,6,0,1,5120,8,6483440389
3126,32964389,104757,33069146,6,0,0,1024,8,2172486629
3127,32977779,3128,32980907,9,0,1,9216,17,8490444998
3128,32984750,1518,32986268,1,0,1,1536,2,4334376024
3129,32988000,114542,33102542,2,0,0,18944,9,3084463248
3130,32993891,137239,33131130,1,0,0,4608,2,3492678251
3131,32998760,427882,33426642,4,0,0,512,14,2989400288
3132,33019270,299368,33318638,2,0,0,131072,9,3162276149
3133,33035950,352950,33388900,2,0,0,223744,9,10103782899
3134,33040179,62534,33102713,6,0,0,512,8,10366874980
3135,33052630,5802,33058432,6,0,1,6144,8,8471183281
3136,33055410,371061,33426471,7,0,0,30720,18,606387412
3137,33091439,335773,33427212,6,0,0,1536,8,8242547211
3138,33092890,578345,33671235,7,0,0,23552,18,6666841899
3139,33100721,298030,33398751,1,0,0,32256,2,5387749514
3140,33116280,294545,33410825,7,0,0,37888,18,9313306097
3141,33129280,3898,33133178,6,0,1,4096,8,7677791323
3142,33142611,274485,33417096,1,0,0,20480,2,7935571755
3143,33145160,368000,33513160,7,0,0,20992,18,10081616146
3144,33152940,167757,33320697,2,0,0,6656,9,1379908942
3145,33153071,510965,33664036,1,0,0,207360,2,285408611
3146,33183060,2946,33186006,6,0,1,3072,8,1131215046
3147,33193980,2946,33196926,6,0,1,3072,8,2376323811
3148,33209010,258610,33467620,7,0,0,33792,18,10576080365
3149,33241691,322425,33564116,1,0,0,15872,2,7582361993
3150,33251790,254959,33506749,4,0,0,1024,14,7678473167
3151,33252780,1994,33254774,6,0,1,2048,8,5030837979
3152,33258090,313338,33571428,7,0,0,16384,18,3290082988
3153,33267611,468479,33736090,1,0,0,39424,2,6934492404
3154,33273580,125686,33399266,4,0,0,1536,14,1037485874
3155,33281390,529782,33811172,7,0,0,49152,18,7344545513
3156,33282361,144360,33426721,4,0,1,512,14,7005717891
3157,33291440,214974,33506414,2,0,0,34304,9,1088752732
3158,33292010,221649,33513659,4,0,0,1536,14,5468964647
3159,33303419,125301,33428720,9,0,1,2048,17,3508348674
3160,33313629,120024,33433653,9,0,1,6656,17,656594962
3161,33317769,222916,33540685,6,0,0,1024,8,221076344
3162,33321410,210140,33531550,4,0,0,512,14,4904863515
3163,33333879,402709,33736588,6,0,0,1536,8,1919824661
3164,33338201,255960,33594161,1,0,0,16384,2,238606555
3165,33372520,301086,33673606,7,0,0,7680,18,5935809710
3166,33378090,322403,33700493,7,0,0,46080,18,8758431269
3167,33381739,169037,33550776,6,0,0,512,8,10082645456
3168,33383489,50830,33434319,9,0,1,1024,17,10365314238
3169,33383560,51745,33435305,6,0,1,1536,8,7812660561
3170,33391140,136820,33527960,2,0,0,3072,9,7078208398
3171,33406739,32432,33439171,9,0,1,6144,17,6272752304
3172,33411600,347657,33759257,4,0,0,512,14,6356625662
3173,33427080,12245,33439325,6,0,1,8704,8,9795365033
3174,33429009,12582,33441591,9,0,1,3584,17,3836082032
3175,33445040,394308,33839348,2,0,0,30720,9,7628008743
3176,33460440,121817,33582257,4,0,0,512,14,7414748707
3177,33493281,255490,33748771,1,0,0,39936,2,635630841
3178,33495991,69388,33565379,1,0,0,4096,2,9677678922
3179,33510089,24411,33534500,9,0,1,33792,17,8556999867
3180,33510109,24737,33534846,9,0,1,512,17,7050385606
3181,33518080,182599,33700679,4,0,0,512,14,2265475495
3182,33526279,9233,33535512,9,0,1,1024,17,7271597161
3183,33527289,233504,33760793,6,0,0,512,8,6180288015
3184,33529751,8027,33537778,4,0,1,3584,14,4674234857
3185,33535240,223105,33758345,4,0,0,2560,14,7711480833
3186,33535540,3864,33539404,6,0,1,2560,8,8600834097
3187,33540470,3629,33544099,6,0,1,3584,8,9351183151
3188,33577011,5802,33582813,4,0,1,6144,14,9356678792
3189,33600169,148773,33748942,6,0,0,512,8,1404159984
3190,33607599,70365,33677964,7,0,1,4608,18,5576930529
3191,33613431,66159,33679590,2,0,1,2560,9,8414100105
3192,33652321,27935,33680256,4,0,1,1024,14,5421760490
3193,33661851,23231,33685082,4,0,1,7680,14,1339178115
3194,33667451,18617,33686068,4,0,1,1536,14,462711339
3195,33667511,32997,33700508,4,0,1,18432,14,6411250698
3196,33675010,220849,33895859,4,0,0,1024,14,9897565686
3197,33708991,3128,33712119,4,0,1,9216,14,10339323741
3198,33715690,225724,33941414,2,0,0,137728,9,5996587099
3199,33721060,15045,33736105,6,0,1,9216,8,849260725
3200,33762580,179029,33941609,4,0,0,512,14,4730698093
3201,33794711,566,33795277,2,0,1,512,9,9241432665
3202,33796831,86359,33883190,1,0,0,6656,2,7571308372
3203,33801510,195637,33997147,2,0,0,39424,9,8091668296
3204,33814870,3898,33818768,6,0,1,4096,8,10469208861
3205,33820701,566,33821267,2,0,1,512,9,600697606
3206,33851450,11533,33862983,6,0,1,18944,8,8128980660
3207,33856560,115971,33972531,2,0,0,6144,9,858884284
3208,33864670,200525,34065195,4,0,0,512,14,1562407619
3209,33866579,1994,33868573,6,0,1,2048,8,5651613664
3210,33868700,168633,34037333,4,0,0,512,14,5894634159
3211,33872150,238619,34110769,2,0,0,23040,9,7764197981
3212,33882701,1999,33884700,4,0,1,1536,14,8850801807
3213,33891219,51045,33942264,6,0,0,2048,8,3660335777
3214,33902570,42123,33944693,3,0,1,2560,29,4715730311
3215,33904771,413388,34318159,1,0,0,153088,2,2177450072
3216,33908880,88438,33997318,4,0,0,512,14,7679770614
3217,33918870,28729,33947599,6,0,1,4608,8,6222563418
3218,33933470,261893,34195363,2,0,0,72704,9,730750983
3219,33952441,193202,34145643,1,0,0,40448,2,8300895414
3220,34013920,566,34014486,0,0,1,512,25,9108518119
3221,34025061,211654,34236715,1,0,0,47104,2,6186130507
3222,34029090,1042,34030132,6,0,1,1024,8,5526292882
3223,34033179,1042,34034221,6,0,1,1024,8,10060827459
3224,34047011,1518,34048529,2,0,1,1536,9,8396162222
3225,34050510,110913,34161423,4,0,0,1536,14,9525203936
3226,34057879,566,34058445,6,0,1,512,8,4859683345
3227,34060040,259070,34319110,4,0,0,3072,14,5461833876
3228,34076560,135989,34212549,7,0,0,4608,18,4135262990
3229,34081120,127463,34208583,2,0,0,11264,9,10676306090
3230,34081711,244614,34326325,1,0,0,23552,2,7542478511
3231,34108420,6503,34114923,6,0,1,11264,8,164104511
3232,34127250,122338,34249588,7,0,0,26112,18,4830417083
3233,34139061,14297,34153358,4,0,1,8192,14,10555572116
3234,34142800,203227,34346027,4,0,0,42496,14,10550108632
3235,34155460,177588,34333048,7,0,0,22016,18,1113195903
3236,34159191,99573,34258764,1,0,0,4608,2,1754436938
3237,34168781,1518,34170299,2,0,1,1536,9,9253694997
3238,34185011,23587,34208598,2,0,1,18432,9,6475895973
3239,34191700,16913,34208613,1,0,1,10752,2,1853240994
3240,34199210,11866,34211076,3,0,1,6144,29,2532056869
3241,34220710,28901,34249611,3,0,1,39936,29,3316214924
3242,34221521,172122,34393643,1,0,0,20480,2,1410984292
3243,34227900,221446,34449346,2,0,0,86016,9,10399054546
3244,34236720,12906,34249626,3,0,1,2048,29,9263885030
3245,34240891,8750,34249641,4,0,1,512,14,9281727443
3246,34242221,12254,34254475,2,0,1,5120,9,10535409420
3247,34248011,264553,34512564,1,0,0,16896,2,855660400
3248,34250541,5880,34256421,4,0,1,3072,14,5108220659
3249,34254960,6754,34261714,3,0,1,7168,29,1792031058
3250,34285190,63792,34348982,3,0,1,3072,29,7736409156
3251,34285961,67289,34353250,4,0,1,6656,14,3296777959
3252,34288620,433658,34722278,7,0,0,8192,18,8532660108
3253,34300321,122802,34423123,1,0,0,5120,2,9560627359
3254,34303471,51405,34354876,4,0,1,2560,14,2652298012
3255,34308010,47212,34355222,0,0,1,512,25,9609913120
3256,34313831,349838,34663669,1,0,0,51200,2,10670681941
3257,34324240,31328,34355568,3,0,1,512,29,7808553361
3258,34327750,169686,34497436,2,0,0,512,9,10702744550
3259,34340970,240515,34581485,2,0,0,46592,9,2521739968
3260,34346270,383043,34729313,2,0,0,23040,9,1104700277
3261,34373430,566,34373996,3,0,1,512,29,3611541414
3262,34374971,239424,34614395,1,0,0,40448,2,2579886976
3263,34385871,566,34386437,4,0,1,512,14,1322961399
3264,34388130,311951,34700081,7,0,0,35328,18,1981242300
3265,34388620,17606,34406226,3,0,1,20992,29,7415574056
3266,34407889,2470,34410359,6,0,1,2560,8,6156286777
3267,34423210,178838,34602048,4,0,0,20992,14,5584166976
3268,34426090,24382,34450472,3,0,1,1024,29,1579551875
3269,34430830,21858,34452688,3,0,1,3072,29,5079230714
3270,34440839,12195,34453034,6,0,1,512,8,9007170321
3271,34447460,458904,34906364,7,0,0,26112,18,6030938629
3272,34466400,4374,34470774,3,0,1,4608,29,10733151520
3273,34469161,90251,34559412,1,0,0,2048,2,6452141941
3274,34486631,225009,34711640,1,0,0,37888,2,8602821197
3275,34494200,427155,34921355,7,0,0,49152,18,3473871940
3276,34503881,8698,34512579,4,0,1,6144,14,9871799283
3277,34511970,207797,34719767,4,0,0,26624,14,2229625306
3278,34513520,5802,34519322,3,0,1,6144,29,7757861431
3279,34520070,2946,34523016,6,0,1,3072,8,3790616729
3280,34520789,6544,34527333,6,0,1,6656,8,5699280788
3281,34523410,259363,34782773,4,0,0,101888,14,6143068937
3282,34525880,286527,34812407,7,0,0,26624,18,3368458848
3283,34548900,305559,34854459,4,0,0,15360,14,4176918500
3284,34562540,432300,34994840,7,0,0,133120,18,7438983112
3285,34567951,17430,34585381,2,0,1,10752,9,7155105298
3286,34598150,19626,34617776,3,0,1,3584,29,3875609795
3287,34621290,239545,34860835,7,0,0,13824,18,1223923674
3288,34626851,1518,34628369,2,0,1,1536,9,3076003084
3289,34648790,367437,35016227,4,0,0,70144,14,1858206204
3290,34660890,7992,34668882,6,0,1,13312,8,2010642145
3291,34666970,6017,34672987,6,0,1,13312,8,4686995970
3292,34679601,1042,34680643,2,0,1,1024,9,114343232
3293,34721290,14769,34736059,3,0,1,7168,29,9655979017
3294,34744630,2946,34747576,6,0,1,3072,8,7785075904
3295,34754361,31291,34785652,2,0,1,8704,9,9949664954
3296,34767021,279495,35046516,1,0,0,14848,2,3451316358
3297,34840809,13665,34854474,6,0,1,18432,8,188332211
3298,34841030,13459,34854489,6,0,1,1024,8,6734356960
3299,34855270,351290,35206560,2,0,0,64000,9,1703071634
3300,34877880,255570,35133450,4,0,0,72192,14,2896154419
3301,34930640,438058,35368698,4,0,0,75776,14,7952690820
3302,34963049,53828,35016877,6,0,1,512,8,5883956076
3303,34974030,343953,35317983,7,0,0,69632,18,6044615757
3304,34984109,34352,35018461,6,0,1,2048,8,5497286843
3305,34999910,171763,35171673,4,0,0,59392,14,8805909789
3306,35006961,318057,35325018,1,0,0,23040,2,3964455292
3307,35028741,218994,35247735,1,0,0,25600,2,4950380598
3308,35080269,5326,35085595,6,0,1,5632,8,2316284515
3309,35097431,186772,35284203,1,0,0,39424,2,3845786908
3310,35127371,301243,35428614,1,0,0,111104,2,4262852294
3311,35133020,159310,35292330,7,0,0,26624,18,8382319528
3312,35172300,263349,35435649,7,0,0,23040,18,3686681773
3313,35195571,181433,35377004,1,0,0,12288,2,3200412370
3314,35208679,4162,35212841,6,0,1,11264,8,10731062624
3315,35210049,4105,35214154,6,0,1,2048,8,4913656822
3316,35217920,1994,35219914,6,0,1,2048,8,7123314169
3317,35225960,147277,35373237,2,0,0,14848,9,6490799653
3318,35248760,130443,35379203,7,0,0,7168,18,6707100149
3319,35262210,4374,35266584,3,0,1,4608,29,7205805985
3320,35311850,157859,35469709,4,0,0,29696,14,3892809198
3321,35335260,101184,35436444,2,0,0,2560,9,2120430158
3322,35345491,198360,35543851,1,0,0,45056,2,6675946715
3323,35355169,24559,35379728,7,0,1,512,18,6594953541
3324,35390391,80433,35470824,1,0,0,3584,2,2125776778
3325,35391430,189303,35580733,4,0,0,8704,14,6373668097
3326,35392291,163530,35555821,1,0,0,2560,2,10135460061
3327,35422259,20690,35442949,9,0,1,15872,17,4997735922
3328,35436450,281630,35718080,4,0,0,28672,14,6054416891
3329,35437220,311725,35748945,7,0,0,26112,18,1268800570
3330,35468661,174460,35643121,1,0,0,47104,2,5476835570
3331,35486531,295833,35782364,1,0,0,78336,2,9888759726
3332,35491200,118849,35610049,2,0,0,3584,9,4867502034
3333,35499020,6278,35505298,3,0,1,6656,29,6945804310
3334,35511789,1994,35513783,7,0,1,2048,18,2554100397
3335,35514989,1042,35516031,7,0,1,1024,18,7511719650
3336,35538610,8103,35546713,3,0,1,8704,29,2208644758
3337,35546131,58866,35604997,1,0,0,512,2,8624209797
3338,35564269,1994,35566263,7,0,1,2048,18,9152796759
3339,35568210,1994,35570204,3,0,1,2048,29,7942854719
3340,35571490,90129,35661619,7,0,0,13824,18,1239277227
3341,35584019,5326,35589345,7,0,1,5632,18,10729030481
3342,35584591,281875,35866466,1,0,0,121344,2,2851115217
3343,35603600,4374,35607974,1,0,1,4608,2,7591720497
3344,35622100,21036,35643136,1,0,1,7680,2,5018632908
3345,35706730,184178,35890908,2,0,0,11264,9,6467714212
3346,35724020,265834,35989854,2,0,0,42496,9,8368798127
3347,35734689,566,35735255,7,0,1,512,18,8864669516
3348,35750370,119167,35869537,7,0,0,2560,18,6803391832
3349,35758199,24180,35782379,7,0,1,3584,18,6685711582
3350,35769061,181375,35950436,1,0,0,38912,2,1695107115
3351,35775219,7760,35782979,9,0,1,512,17,828303084
3352,35778969,4356,35783325,9,0,1,512,17,4791110349
3353,35794721,302545,36097266,1,0,0,70144,2,8051956070
3354,35804950,244074,36049024,2,0,0,12800,9,7547590467
3355,35806009,1518,35807527,9,0,1,1536,17,1356363254
3356,35814270,150860,35965130,2,0,0,48128,9,75191433
3357,35815349,1518,35816867,7,0,1,1536,18,6368442595
3358,35817749,2946,35820695,9,0,1,3072,17,10200285529
3359,35826880,39601,35866481,1,0,1,4096,2,1623036056
3360,35872980,235274,36108254,4,0,0,15872,14,3491815867
3361,35873590,5196,35878786,0,0,1,13312,25,4927958260
3362,35881980,8943,35890923,0,0,1,7168,25,9287225912
3363,35909710,299222,36208932,7,0,0,62464,18,4702723904
3364,35917760,1518,35919278,1,0,1,1536,2,8404439280
3365,35938109,12342,35950451,9,0,1,2560,17,3332570138
3366,35947530,24463,35971993,1,0,1,7168,2,728617029
3367,35955170,34699,35989869,0,0,1,8192,25,6035792203
3368,35958500,31392,35989892,8,0,1,2560,26,10585423552
3369,35961130,334450,36295580,2,0,0,81408,9,10564581048
3370,35963870,81239,36045109,4,0,0,12288,14,8096158217
3371,35964139,25768,35989907,7,0,1,8192,18,5767979974
3372,35966469,23453,35989922,9,0,1,4096,17,6578077779
3373,35971990,298763,36270753,2,0,0,132096,9,5822510290
3374,35978571,169182,36147753,1,0,0,32768,2,5914200403
3375,35991870,7706,35999576,1,0,1,8192,2,8276107639
3376,36001819,1518,36003337,9,0,1,1536,17,3310762030
3377,36003410,4850,36008260,1,0,1,5120,2,3029024829
3378,36008340,566,36008906,3,0,1,512,29,3072349854
3379,36027669,2946,36030615,7,0,1,3072,18,7253207158
3380,36029279,3645,36032924,7,0,1,10240,18,10491095582
3381,36033250,2470,36035720,0,0,1,2560,25,9645729554
3382,36044579,6431,36051010,9,0,1,2048,17,9610328929
3383,36059890,276521,36336411,7,0,0,37888,18,9434750596
3384,36062420,7230,36069650,3,0,1,7680,29,5981667864
3385,36073200,24089,36097289,1,0,1,12288,2,3994436625
3386,36075149,27936,36103085,7,0,1,6144,18,9746891222
3387,36082450,277864,36360314,2,0,0,17408,9,3101667305
3388,36101089,7188,36108277,7,0,1,13312,18,520666281
3389,36101630,395442,36497072,7,0,0,87040,18,4840968437
3390,36125630,3422,36129052,3,0,1,3584,29,5968272721
3391,36127999,3898,36131897,9,0,1,4096,17,3277854834
3392,36129550,220813,36350363,7,0,0,32256,18,9621502164
3393,36134130,2470,36136600,1,0,1,2560,2,1577258973
3394,36145310,6826,36152136,3,0,1,4608,29,1642231549
3395,36147319,4971,36152290,9,0,1,8704,17,424746283
3396,36150229,6575,36156804,7,0,1,12800,18,9889244269
3397,36180329,4374,36184703,7,0,1,4608,18,6469727174
3398,36204950,5016,36209966,3,0,1,1024,29,748435435
3399,36211840,1994,36213834,1,0,1,2048,2,432446263
3400,36241310,67337,36308647,1,0,1,22016,2,7120508075
3401,36261420,443376,36704796,4,0,0,72192,14,10571122620
3402,36271390,157030,36428420,4,0,0,23040,14,4550937327
3403,36283231,323498,36606729,1,0,0,2048,2,1485505652
3404,36284260,265881,36550141,4,0,0,58880,14,1373241474
3405,36286130,454889,36741019,7,0,0,118784,18,9432367210
3406,36307480,338810,36646290,7,0,0,17408,18,9186736935
3407,36313950,248526,36562476,2,0,0,35840,9,1572652886
3408,36327330,338285,36665615,4,0,0,32256,14,8513139258
3409,36340000,192186,36532186,7,0,0,55808,18,10270404756
3410,36356900,5876,36362776,1,0,1,2560,2,8496849470
3411,36382681,566,36383247,4,0,1,512,14,4264319288
3412,36415590,1042,36416632,1,0,1,1024,2,2898540095
3413,36434921,154799,36589720,1,0,0,1536,2,1213920168
3414,36448380,1042,36449422,8,0,1,1024,26,3358242204
3415,36460690,1518,36462208,8,0,1,1536,26,7961736747
3416,36468799,28288,36497087,7,0,1,9216,18,8294467816
3417,36477161,25720,36502881,4,0,1,6144,14,1619463560
3418,36507290,2946,36510236,8,0,1,3072,26,10522440354
3419,36531270,148419,36679689,7,0,0,2048,18,9325672406
3420,36532431,30060,36562491,4,0,1,4608,14,933305863
3421,36532500,30014,36562514,8,0,1,8192,26,9531923916
3422,36532990,30326,36563316,8,0,1,5632,26,10665782532
3423,36535559,32263,36567822,7,0,1,7168,18,2168509815
3424,36540799,29609,36570408,7,0,1,4096,18,493344619
3425,36553239,21355,36574594,7,0,1,6656,18,9054021314
3426,36564071,11509,36575580,4,0,1,1536,14,2881727222
3427,36580770,3128,36583898,5,0,1,9216,15,6469736400
3428,36597100,3422,36600522,5,0,1,3584,15,3773045000
3429,36603350,238073,36841423,7,0,0,19456,18,8004914617
3430,36614761,126461,36741222,1,0,0,512,2,5810014065
3431,36632980,1042,36634022,8,0,1,1024,26,7227627413
3432,36655011,186895,36841906,1,0,0,1536,2,7580125054
3433,36671721,4374,36676095,4,0,1,4608,14,3708982928
3434,36680670,122677,36803347,4,0,0,55808,14,2308106367
3435,36686460,125178,36811638,7,0,0,27136,18,7955849231
3436,36691660,383833,37075493,4,0,0,3584,14,6552885232
3437,36696530,256839,36953369,4,0,0,12800,14,6626131914
3438,36709130,35022,36744152,8,0,1,3072,26,5723822277
3439,36714271,70694,36784965,1,0,0,512,2,7240018294
3440,36715760,233670,36949430,4,0,0,122880,14,5071725850
3441,36726020,185067,36911087,4,0,0,20480,14,1067302981
3442,36742800,136030,36878830,4,0,0,1024,14,1789169724
3443,36748420,3422,36751842,5,0,1,3584,15,2588351703
3444,36756561,4850,36761411,4,0,1,5120,14,7188318764
3445,36761141,246189,37007330,1,0,0,1024,2,852089715
3446,36765790,3128,36768918,5,0,1,9216,15,531460827
3447,36766940,376313,37143253,7,0,0,147456,18,3180761339
3448,36775020,428591,37203611,2,0,0,196096,9,5779484341
3449,36795840,292353,37088193,4,0,0,3584,14,10245504655
3450,36799751,15007,36814758,4,0,1,9216,14,8177105439
3451,36826040,3904,36829944,5,0,1,10752,15,10055058201
3452,36836780,8064,36844844,5,0,1,3072,15,4925052065
3453,36848330,1518,36849848,8,0,1,1536,26,9611251053
3454,36857601,4374,36861975,4,0,1,4608,14,2467008189
3455,36880370,1994,36882364,8,0,1,2048,26,3547485182
3456,36883921,166462,37050383,1,0,0,1536,2,8119988312
3457,36885260,2946,36888206,8,0,1,3072,26,6763614435
3458,36903961,7141,36911102,4,0,1,14848,14,70744559
3459,36928231,29972,36958203,4,0,1,5120,14,70049658
3460,36936771,206973,37143744,1,0,0,1536,2,4085005881
3461,36937810,270292,37208102,7,0,0,12800,18,9680446729
3462,36945001,16748,36961749,4,0,1,5632,14,10553531970
3463,36954210,7885,36962095,8,0,1,512,26,3181106325
3464,36998780,242953,37241733,7,0,0,6656,18,10326333093
3465,37005541,70915,37076456,1,0,0,1536,2,5200512579
3466,37008510,1042,37009552,5,0,1,1024,15,10057488129
3467,37031900,1518,37033418,0,0,1,1536,25,7212923985
3468,37032190,13568,37045758,8,0,1,22528,26,10224537710
3469,37052841,151306,37204147,1,0,0,1024,2,8807292678
3470,37055980,266864,37322844,2,0,0,5120,9,168815837
3471,37062521,141261,37203782,1,0,0,512,2,3920116889
3472,37067450,218914,37286364,4,0,0,1536,14,8549878266
3473,37067780,260331,37328111,4,0,0,16384,14,3711279253
3474,37078239,5326,37083565,9,0,1,5632,17,9815642750
3475,37082010,2541,37084551,0,0,1,1536,25,1962453812
3476,37085290,524820,37610110,4,0,0,36352,14,5077393682
3477,37085320,406676,37491996,2,0,0,87040,9,1884288252
3478,37092160,5196,37097356,8,0,1,13312,26,1784794342
3479,37095440,2582,37098022,0,0,1,1024,25,6072059732
3480,37106290,97507,37203797,8,0,1,6656,26,1586327255
3481,37120880,82932,37203812,8,0,1,512,26,1471706163
3482,37124721,330414,37455135,1,0,0,28160,2,4676660647
3483,37127980,592596,37720576,4,0,0,34816,14,7812385283
3484,37136981,691506,37828487,1,0,0,137216,2,5386077498
3485,37138120,797644,37935764,4,0,0,59392,14,1615501053
3486,37140570,145288,37285858,7,0,0,65536,18,3498353623
3487,37157680,57636,37215316,0,0,1,7680,25,7919386321
3488,37167411,172675,37340086,1,0,0,4096,2,9431737622
3489,37167470,331141,37498611,2,0,0,21504,9,5614950549
3490,37175070,43472,37218542,1,0,1,5120,2,8581150504
3491,37179940,606716,37786656,7,0,0,79872,18,6264510715
3492,37185549,34619,37220168,9,0,1,2560,17,1161634390
3493,37197700,343097,37540797,2,0,0,10752,9,2966289559
3494,37204239,19155,37223394,9,0,1,5120,17,6367593435
3495,37205370,19509,37224879,5,0,1,15360,15,4617885186
3496,37208130,311710,37519840,2,0,0,53760,9,7822260126
3497,37208750,16795,37225545,0,0,1,1024,25,651411432
3498,37218700,407049,37625749,2,0,0,51200,9,4016567643
3499,37221189,4702,37225891,9,0,1,512,17,6339792258
3500,37221200,637688,37858888,4,0,0,6144,14,2042439722
3501,37222810,222406,37445216,7,0,0,5632,18,4532775143
3502,37228829,566,37229395,9,0,1,512,17,4813508768
3503,37231580,3128,37234708,8,0,1,9216,26,10630689692
3504,37253270,343856,37597126,4,0,0,3584,14,10333780509
3505,37260610,25271,37285881,5,0,1,7168,15,3852171491
3506,37266891,192128,37459019,1,0,0,10240,2,4049363562
3507,37289020,1042,37290062,8,0,1,1024,26,3408117454
3508,37314709,3128,37317837,9,0,1,9216,17,8936581071
3509,37321350,438740,37760090,4,0,0,129536,14,4987232899
3510,37321380,535590,37856970,4,0,0,45056,14,10563380963
3511,37329790,2946,37332736,8,0,1,3072,26,8560070313
3512,37336110,4420,37340530,0,0,1,11776,25,10197596384
3513,37345961,1042,37347003,4,0,1,1024,14,8560565826
3514,37357620,2870,37360490,0,0,1,8704,25,6702807825
3515,37359910,6689,37366599,5,0,1,6656,15,2035883114
3516,37366630,3128,37369758,8,0,1,9216,26,6003745982
3517,37367651,747464,38115115,1,0,0,25600,2,5833556141
3518,37368300,1804,37370104,5,0,1,512,15,5209575203
3519,37379920,3898,37383818,5,0,1,4096,15,2076032697
3520,37392240,566,37392806,8,0,1,512,26,7108771017
3521,37422339,5802,37428141,9,0,1,6144,17,5000930470
3522,37430800,590737,38021537,7,0,0,90624,18,9942483630
3523,37468059,33006,37501065,9,0,1,2560,17,1500178137
3524,37469970,31761,37501731,0,0,1,1024,25,7903408944
3525,37477319,24758,37502077,9,0,1,512,17,10689658511
3526,37481330,747834,38229164,4,0,0,31232,14,9249063702
3527,37482271,554257,38036528,1,0,0,49152,2,9285571212
3528,37485120,357928,37843048,7,0,0,47616,18,8791992625
3529,37491150,461641,37952791,4,0,0,55808,14,2565922428
3530,37497580,22275,37519855,0,0,1,3072,25,6208033407
3531,37500070,19800,37519870,5,0,1,3584,15,8996960857
3532,37518400,3456,37521856,8,0,1,2048,26,5985354375
3533,37526220,354986,37881206,7,0,0,31744,18,1406524989
3534,37536669,4151,37540820,9,0,1,1536,17,2229230599
3535,37537780,667798,38205578,4,0,0,95232,14,1029551760
3536,37554431,207858,37762289,1,0,0,7168,2,5125744367
3537,37571860,726996,38298856,4,0,0,57856,14,5401249854
3538,37576860,266367,37843227,2,0,0,512,9,448093731
3539,37578860,566,37579426,5,0,1,512,15,4944678406
3540,37599649,32813,37632462,9,0,1,7168,17,1534664557
3541,37600770,354696,37955466,2,0,0,8704,9,5245886412
3542,37606899,29749,37636648,9,0,1,6656,17,10415046913
3543,37616491,759046,38375537,1,0,0,83456,2,6940993932
3544,37620950,486335,38107285,4,0,0,76288,14,8885912181
3545,37621190,19004,37640194,5,0,1,5632,15,4595788344
3546,37647240,1994,37649234,5,0,1,2048,15,9101570606
3547,37677891,182884,37860775,1,0,0,6144,2,5592513380
3548,37690420,350343,38040763,2,0,0,13824,9,1329762307
3549,37708370,12229,37720599,0,0,1,8704,25,40808659
3550,37710970,117532,37828502,5,0,1,8192,15,7586878198
3551,37714580,113937,37828517,5,0,1,512,15,215775731
3552,37739610,117391,37857001,0,0,1,4096,25,2631072413
3553,37771349,89449,37860798,9,0,1,1024,17,8048665451
3554,37821700,39600,37861300,0,0,1,512,25,9019047106
3555,37877020,342613,38219633,4,0,0,46080,14,3769905321
3556,37915510,346055,38261565,4,0,0,69120,14,6913361952
3557,37929100,399405,38328505,2,0,0,14848,9,4454081323
3558,37934339,25986,37960325,9,0,1,5120,17,8781335848
3559,37947120,387336,38334456,2,0,0,19456,9,2889591925
3560,37948130,325370,38273500,7,0,0,38912,18,6457891441
3561,37965560,548489,38514049,7,0,0,44544,18,7079548475
3562,37967630,268617,38236247,2,0,0,23040,9,1676931510
3563,37975650,305509,38281159,4,0,0,25088,14,174035484
3564,38006190,418061,38424251,4,0,0,15360,14,7401207808
3565,38045650,806845,38852495,7,0,0,19968,18,5116742941
3566,38051820,1518,38053338,0,0,1,1536,25,3373445753
3567,38054290,282521,38336811,2,0,0,7680,9,9263215292
3568,38070760,452554,38523314,2,0,0,19456,9,6730135975
3569,38075350,6278,38081628,0,0,1,6656,25,402257800
3570,38076279,31021,38107300,7,0,1,4096,18,5983038588
3571,38078250,298238,38376488,4,0,0,3072,14,10701965245
3572,38079030,161444,38240474,4,0,0,13824,14,3024191569
3573,38111190,525017,38636207,2,0,0,63488,9,10649998270
3574,38136511,921436,39057947,1,0,0,56832,2,2549020684
3575,38174619,149339,38323958,5,0,0,36352,15,7110739759
3576,38179241,711468,38890709,1,0,0,38400,2,952419646
3577,38180509,645766,38826275,5,0,0,95232,15,8542574998
3578,38197979,83219,38281198,7,0,1,7680,18,1863141756
3579,38205180,76033,38281213,0,0,1,3072,25,7842541008
3580,38205600,93271,38298871,0,0,1,4096,25,1528415614
3581,38207700,91186,38298886,0,0,1,5632,25,1387291878
3582,38217201,466052,38683253,1,0,0,17920,2,10461610763
3583,38220929,261990,38482919,5,0,0,46592,15,4223406110
3584,38224099,760672,38984771,5,0,0,18432,15,4996995893
3585,38227870,485151,38713021,2,0,0,4608,9,3646754044
3586,38245769,53140,38298909,7,0,1,8192,18,10737290068
3587,38247201,594270,38841471,1,0,0,8192,2,6525992722
3588,38251680,248766,38500446,7,0,0,45056,18,6012643228
3589,38266650,287898,38554548,4,0,0,45056,14,4718684704
3590,38288500,479187,38767687,7,0,0,26624,18,4904105484
3591,38290699,918544,39209243,5,0,0,107520,15,7265882111
3592,38297991,929387,39227378,1,0,0,59392,2,7782597962
3593,38322200,14642,38336842,3,0,1,7168,29,5264852334
3594,38328249,12001,38340250,9,0,1,3584,17,9386566383
3595,38331380,346398,38677778,4,0,0,23552,14,4989593801
3596,38362741,987316,39350057,1,0,0,59392,2,6951630784
3597,38382360,596756,38979116,4,0,0,512,14,8339173196
3598,38385801,604617,38990418,1,0,0,18432,2,4083563084
3599,38387479,580671,38968150,5,0,0,181760,15,7449016899
3600,38397009,6278,38403287,7,0,1,6656,18,3734214296
3601,38397900,722715,39120615,4,0,0,35840,14,5286813986
3602,38412550,3898,38416448,0,0,1,4096,25,4388614238
3603,38415010,11791,38426801,0,0,1,19456,25,2574002102
3604,38426210,2470,38428680,0,0,1,2560,25,5746990209
3605,38429480,566,38430046,0,0,1,512,25,1395428935
3606,38429909,3904,38433813,9,0,1,10752,17,2050210002
3607,38435790,1034870,39470660,2,0,0,10240,9,10336943665
3608,38442019,6278,38448297,7,0,1,6656,18,9495453357
3609,38451869,4937,38456806,9,0,1,12800,17,9490231288
3610,38466600,446155,38912755,4,0,0,63488,14,9991405156
3611,38478389,279504,38757893,5,0,0,3584,15,647082663
3612,38491010,25468,38516478,0,0,1,2560,25,2599039799
3613,38493189,519824,39013013,5,0,0,4608,15,9778141852
3614,38513920,465025,38978945,4,0,0,35328,14,10233623422
3615,38529949,3898,38533847,7,0,1,4096,18,9337342815
3616,38531180,644815,39175995,7,0,0,7680,18,9383498749
3617,38538460,298290,38836750,2,0,0,34304,9,10264582069
3618,38560350,2946,38563296,0,0,1,3072,25,8894226133
3619,38562820,3898,38566718,0,0,1,4096,25,664803012
3620,38570419,521834,39092253,5,0,0,41472,15,6269262540
3621,38570751,299085,38869836,1,0,0,5120,2,4400522365
3622,38574221,300960,38875181,1,0,0,2560,2,2654914852
3623,38575049,12825,38587874,7,0,1,21504,18,8990643328
3624,38575139,14015,38589154,7,0,1,14336,18,3247600220
3625,38576139,15281,38591420,9,0,1,3584,17,9088774928
3626,38584709,890802,39475511,5,0,0,15872,15,7421636906
3627,38590690,404291,38994981,7,0,0,14848,18,4251354063
3628,38608600,387715,38996315,2,0,0,4096,9,2098926991
3629,38618029,20657,38638686,7,0,1,2560,18,2595726874
3630,38632230,372703,39004933,7,0,0,27136,18,4921719999
3631,38643210,6754,38649964,1,0,1,7168,2,10422417388
3632,38648509,4374,38652883,9,0,1,4608,17,2243261217
3633,38660649,4374,38665023,9,0,1,4608,17,2019962576
3634,38666019,1518,38667537,7,0,1,1536,18,9401284827
3635,38687310,392054,39079364,4,0,0,35328,14,9229988685
3636,38691949,3645,38695594,9,0,1,10240,17,3675655944
3637,38719149,304064,39023213,5,0,0,1024,15,7133986785
3638,38751930,540329,39292259,4,0,0,57344,14,3021260787
3639,38755680,566,38756246,0,0,1,512,25,8415191280
3640,38771639,812943,39584582,5,0,0,69632,15,6036930827
3641,38807040,317315,39124355,4,0,0,9216,14,6334538722
3642,38844749,7769,38852518,7,0,1,6656,18,6847810919
3643,38847910,261770,39109680,2,0,0,15360,9,3033161098
3644,38852689,566,38853255,9,0,1,512,17,7511038524
3645,38868110,1032144,39900254,4,0,0,149504,14,7233291343
3646,38875720,228319,39104039,4,0,0,33280,14,2041705631
3647,38917010,335644,39252654,2,0,0,10752,9,3914919048
3648,38922200,72852,38995052,0,0,1,1024,25,3818691840
3649,38933860,71088,39004948,0,0,1,3072,25,4815177427
3650,38934669,70294,39004963,9,0,1,10752,17,9162124178
3651,38937550,67428,39004978,0,0,1,3072,25,2027080776
3652,38943799,61525,39005324,7,0,1,5120,18,4426130212
3653,38950829,55801,39006630,9,0,1,2048,17,10129640776
3654,38971949,156985,39128934,5,0,0,10240,15,8765678983
3655,38977609,29175,39006784,9,0,1,8704,17,4156425022
3656,38981621,469330,39450951,1,0,0,86528,2,5880621891
3657,38993849,14826,39008675,7,0,1,10240,18,5704474367
3658,38998829,10192,39009021,7,0,1,512,18,3056377845
3659,39030440,566,39031006,0,0,1,512,25,8670981576
3660,39041950,382598,39424548,7,0,0,104960,18,10534878144
3661,39043750,615520,39659270,4,0,0,131072,14,3588327395
3662,39046610,14783,39061393,0,0,1,9728,25,5109755604
3663,39052910,747174,39800084,7,0,0,47616,18,4832480041
3664,39059370,453088,39512458,7,0,0,17408,18,4907471162
3665,39074460,409334,39483794,7,0,0,27136,18,4368388053
3666,39075941,301001,39376942,1,0,0,10752,2,7835445350
3667,39114720,253320,39368040,7,0,0,10240,18,4891042942
3668,39115121,10378,39125499,4,0,1,5120,14,2249812510
3669,39116220,388680,39504900,4,0,0,69120,14,7028894511
3670,39121589,9512,39131101,9,0,1,7168,17,4647634619
3671,39138830,572267,39711097,2,0,0,16384,9,7550378881
3672,39154429,1518,39155947,9,0,1,1536,17,6930315517
3673,39164030,343077,39507107,4,0,0,7168,14,4085335823
3674,39176909,55754,39232663,9,0,1,5632,17,2630816988
3675,39184080,281090,39465170,7,0,0,46592,18,8945191584
3676,39193599,41970,39235569,9,0,1,4608,17,757488546
3677,39233649,5466,39239115,9,0,1,5632,17,4388098362
3678,39235251,379388,39614639,1,0,0,1024,2,8964212830
3679,39247709,4960,39252669,7,0,1,11264,18,587541623
3680,39252430,215095,39467525,2,0,0,7680,9,2428178054
3681,39257839,4679,39262518,9,0,1,12288,17,2217438634
3682,39261341,405284,39666625,1,0,0,24064,2,3167672545
3683,39268270,343420,39611690,7,0,0,8192,18,10250225823
3684,39277180,651611,39928791,7,0,0,4608,18,1325663039
3685,39280129,13682,39293811,9,0,1,1536,17,8755501994
3686,39286279,7878,39294157,7,0,1,512,18,1120912447
3687,39303400,1518,39304918,3,0,1,1536,29,876167084
3688,39314189,1518,39315707,9,0,1,1536,17,5767079058
3689,39320551,580209,39900760,1,0,0,1536,2,10705283542
3690,39331420,481385,39812805,4,0,0,24064,14,4927928981
3691,39351080,239913,39590993,4,0,0,20992,14,3197187056
3692,39387041,371830,39758871,1,0,0,98816,2,8617585455
3693,39389140,551241,39940381,4,0,0,36864,14,9629143290
3694,39398390,278882,39677272,4,0,0,34816,14,659309166
3695,39408659,75158,39483817,9,0,1,4096,17,1690967600
3696,39415090,640234,40055324,4,0,0,18432,14,9739316516
3697,39448420,233391,39681811,4,0,0,14848,14,7043538609
3698,39461179,51302,39512481,9,0,1,512,17,3535471051
3699,39471790,248371,39720161,7,0,0,25600,18,8506630594
3700,39478360,337736,39816096,7,0,0,10752,18,1143364794
3701,39485919,27064,39512983,7,0,1,512,18,9881633234
3702,39496200,415214,39911414,4,0,0,22528,14,1246236705
3703,39507840,12004,39519844,0,0,1,7680,25,3434012846
3704,39512820,429644,39942464,7,0,0,6656,18,6398853734
3705,39515179,9171,39524350,7,0,1,7168,18,3818206711
3706,39546061,155681,39701742,1,0,0,6656,2,5948762889
3707,39546150,380263,39926413,7,0,0,49152,18,5140612259
3708,39551749,249704,39801453,6,0,0,512,8,8969671218
3709,39554030,300657,39854687,2,0,0,77824,9,5438383439
3710,39562110,589091,40151201,7,0,0,80384,18,1929456851
3711,39587921,381546,39969467,1,0,0,49664,2,5707196732
3712,39598310,306209,39904519,2,0,0,12288,9,9699604903
3713,39602409,326709,39929118,6,0,0,1024,8,1047719977
3714,39620610,400505,40021115,4,0,0,57856,14,9508356079
3715,39624240,487249,40111489,4,0,0,87040,14,7243814739
3716,39645971,281401,39927372,1,0,0,3072,2,3360425781
3717,39649340,430245,40079585,7,0,0,6656,18,10606784849
3718,39698421,342053,40040474,1,0,0,63488,2,2141697714
3719,39716129,402285,40118414,6,0,0,512,8,7970802348
3720,39726420,323273,40049693,7,0,0,30208,18,6919132156
3721,39726949,218773,39945722,6,0,0,1024,8,2138734775
3722,39727579,444292,40171871,6,0,0,512,8,8483754117
3723,39759289,306862,40066151,6,0,0,512,8,8776749915
3724,39768489,2470,39770959,7,0,1,2560,18,8284644374
3725,39776080,395604,40171684,7,0,0,67072,18,5358002018
3726,39786499,183139,39969638,6,0,0,512,8,9831473636
3727,39789110,329125,40118235,2,0,0,20480,9,8236098194
3728,39794310,10190,39804500,0,0,1,4608,25,3854105738
3729,39825911,240054,40065965,1,0,0,17408,2,5498258514
3730,39827710,1994,39829704,0,0,1,2048,25,10430922931
3731,39830349,69928,39900277,7,0,1,12288,18,1717864658
3732,39834810,477118,40311928,4,0,0,48640,14,8321109741
3733,39845220,365172,40210392,2,0,0,40448,9,3455437866
3734,39848980,475154,40324134,4,0,0,39936,14,5599375708
3735,39851109,91386,39942495,7,0,1,512,18,5545164529
3736,39870630,73787,39944417,0,0,1,2048,25,2710464601
3737,39898170,343185,40241355,7,0,0,28672,18,3669353464
3738,39900631,331973,40232604,1,0,0,27648,2,6614075415
3739,39904000,276014,40180014,7,0,0,26624,18,2105668071
3740,39904810,287323,40192133,2,0,0,512,9,10276897265
3741,39909189,202783,40111972,6,0,0,1536,8,3627948244
3742,39923489,23203,39946692,7,0,1,10240,18,7927797266
3743,39961839,11706,39973545,7,0,1,4096,18,2774550311
3744,39969349,4862,39974211,7,0,1,1024,18,5716535984
3745,39991219,1994,39993213,7,0,1,2048,18,2159142529
3746,39998029,198749,40196778,6,0,0,512,8,6743009951
3747,39998490,1994,40000484,0,0,1,2048,25,4479143869
3748,40046550,326250,40372800,7,0,0,36864,18,2193464909
3749,40047370,9982,40057352,0,0,1,2048,25,5069973155
3750,40050670,15310,40065980,0,0,1,5120,25,1308213403
3751,40078360,1783,40080143,0,0,1,512,25,1016797978
3752,40082799,100399,40183198,6,0,0,1536,8,160174996
3753,40090071,28893,40118964,4,0,1,512,14,5269927641
3754,40093831,391030,40484861,1,0,0,16384,2,3750510633
3755,40110909,12495,40123404,7,0,1,5120,18,5440743474
3756,40132819,50873,40183692,7,0,1,19968,18,1074563365
3757,40137259,378570,40515829,6,0,0,1536,8,5816787228
3758,40138499,46179,40184678,7,0,1,1536,18,7769075504
3759,40139200,461528,40600728,2,0,0,182784,9,3000335688
3760,40157930,321924,40479854,2,0,0,25600,9,7995106445
3761,40164860,487431,40652291,4,0,0,134656,14,7801655039
3762,40171959,13065,40185024,7,0,1,512,18,9383207556
3763,40179240,6770,40186010,5,0,1,1536,15,6250506850
3764,40189920,420510,40610430,2,0,0,31744,9,9329958900
3765,40192471,4374,40196845,4,0,1,4608,14,6658778506
3766,40195810,14613,40210423,0,0,1,7168,25,2386681781
3767,40196869,16511,40213380,7,0,1,3072,18,2730269141
3768,40197809,64965,40262774,6,0,0,512,8,9380858902
3769,40205499,450791,40656290,6,0,0,2048,8,5754321741
3770,40213229,566,40213795,7,0,1,512,18,1790925881
3771,40216510,75206,40291716,7,0,0,7680,18,3511964403
3772,40231469,425663,40657132,6,0,0,1536,8,5278902836
3773,40241230,412948,40654178,2,0,0,6144,9,2289829340
3774,40258509,399262,40657771,6,0,0,2048,8,8212898083
3775,40264020,1994,40266014,6,0,1,2048,8,5758414844
3776,40270330,5326,40275656,0,0,1,5632,25,166789205
3777,40295571,16372,40311943,4,0,1,9216,14,8305182933
3778,40303500,398983,40702483,2,0,0,98816,9,8234875113
3779,40316140,396254,40712394,4,0,0,16896,14,8560745701
3780,40347771,4850,40352621,4,0,1,5120,14,8307905909
3781,40355300,420704,40776004,7,0,0,39424,18,6157865964
3782,40363699,132497,40496196,6,0,0,1024,8,5331507547
3783,40371819,239429,40611248,6,0,0,2560,8,5039295431
3784,40378550,288560,40667110,2,0,0,15872,9,578567140
3785,40380500,114808,40495308,2,0,0,8192,9,7954627904
3786,40384481,2470,40386951,4,0,1,2560,14,8739128455
3787,40394160,261164,40655324,4,0,0,3072,14,2828942661
3788,40395631,363232,40758863,0,0,0,1024,25,6790011956
3789,40397810,566,40398376,0,0,1,512,25,10677936373
3790,40450230,206395,40656625,4,0,0,1024,14,6244066821
3791,40460419,195232,40655651,6,0,0,1024,8,5831303867
3792,40465890,241006,40706896,7,0,0,14336,18,5099039247
3793,40469550,262723,40732273,7,0,0,24064,18,10581683783
3794,40504560,6278,40510838,0,0,1,6656,25,9170185238
3795,40507301,385473,40892774,1,0,0,28160,2,5318602533
3796,40508201,199030,40707231,1,0,0,1024,2,7044090837
3797,40523141,131208,40654349,1,0,0,512,2,8632879859
3798,40527570,326804,40854374,4,0,0,28160,14,5010047480
3799,40539481,61262,40600743,4,0,1,15360,14,85979610
3800,40541510,68935,40610445,0,0,1,20992,25,904730744
3801,40562690,396251,40958941,4,0,0,208896,14,1922696532
3802,40586131,268414,40854545,1,0,0,512,2,7254891383
3803,40588701,73403,40662104,4,0,1,4608,14,5598717466
3804,40592381,74760,40667141,4,0,1,5120,14,4556654603
3805,40607131,227706,40834837,1,0,0,512,2,4572661910
3806,40621741,45415,40667156,4,0,1,2048,14,6031548156
3807,40625889,43973,40669862,9,0,1,5120,17,3001068110
3808,40634491,68007,40702498,4,0,1,5632,14,5117409493
3809,40661111,183722,40844833,1,0,0,3072,2,9188149384
3810,40661480,41033,40702513,0,0,1,5120,25,9550629857
3811,40685940,277540,40963480,2,0,0,14848,9,9082383837
3812,40701339,284661,40986000,6,0,0,512,8,8318413046
3813,40719950,294511,41014461,2,0,0,35328,9,5260927465
3814,40724150,243260,40967410,4,0,0,8192,14,9300450134
3815,40739561,336385,41075946,1,0,0,512,2,9410160669
3816,40751400,234429,40985829,4,0,0,22016,14,613657366
3817,40758059,209678,40967737,6,0,0,1024,8,5807351864
3818,40770320,6718,40777038,0,0,1,1024,25,1028542493
3819,40803861,4850,40808711,4,0,1,5120,14,1531409137
3820,40812860,262915,41075775,7,0,0,33792,18,9341242146
3821,40837199,151220,40988419,6,0,0,2048,8,4090010382
3822,40843231,124833,40968064,1,0,0,1024,2,5364965464
3823,40853430,12640,40866070,0,0,1,18944,25,1431205476
3824,40860640,104259,40964899,4,0,0,4608,14,4008734820
3825,40861570,175244,41036814,4,0,0,7168,14,1083470355
3826,40872450,277333,41149783,2,0,0,41472,9,4698310684
3827,40874160,1042,40875202,0,0,1,1024,25,53481917
3828,40968290,219236,41187526,4,0,0,13824,14,4917782678
3829,40969290,1518,40970808,0,0,1,1536,25,7559872774
3830,40989480,1518,40990998,5,0,1,1536,15,743863447
3831,40992470,115297,41107767,7,0,0,34304,18,114290391
3832,40998590,4374,41002964,1,0,1,4608,2,3718020895
3833,41006250,282164,41288414,7,0,0,5632,18,349370183
3834,41013500,1544,41015044,1,0,1,512,2,4606497272
3835,41015670,271005,41286675,7,0,0,12800,18,9901953697
3836,41016631,67103,41083734,1,0,0,512,2,5913079756
3837,41034350,248379,41282729,7,0,0,82944,18,3308061901
3838,41040920,172557,41213477,2,0,0,47616,9,5514998886
3839,41044810,395867,41440677,7,0,0,4608,18,7151699241
3840,41054650,6278,41060928,5,0,1,6656,15,6647687166
3841,41057180,5694,41062874,0,0,1,3072,25,6123424194
3842,41082950,3645,41086595,1,0,1,10240,2,10300534527
3843,41083790,159351,41243141,2,0,0,6656,9,1399832274
3844,41084090,154934,41239024,4,0,0,15360,14,6928322195
3845,41086901,2470,41089371,2,0,1,2560,9,10015544657
3846,41099490,311384,41410874,7,0,0,13824,18,1568374317
3847,41107329,86058,41193387,6,0,0,512,8,3398989046
3848,41147131,66673,41213804,1,0,0,1024,2,1409562777
3849,41155550,233702,41389252,2,0,0,2048,9,815393468
3850,41155939,6754,41162693,7,0,1,7168,18,8556614150
3851,41189560,5802,41195362,8,0,1,6144,26,2633792525
3852,41194880,244370,41439250,7,0,0,44032,18,2262306131
3853,41196171,294762,41490933,1,0,0,2560,2,2260473889
3854,41196190,1064,41197254,1,0,1,1024,2,1004833128
3855,41212450,8100,41220550,8,0,1,7168,26,538282287
3856,41215380,8076,41223456,0,0,1,4608,25,5026198482
3857,41217330,272800,41490130,4,0,0,24576,14,10596813183
3858,41221830,257584,41479414,7,0,0,117760,18,3927098507
3859,41231970,273820,41505790,2,0,0,3072,9,4505607063
3860,41237610,169029,41406639,4,0,0,49152,14,1185910198
3861,41253450,2470,41255920,8,0,1,2560,26,6302226631
3862,41257160,25584,41282744,1,0,1,4096,2,2994495851
3863,41262079,265138,41527217,6,0,0,512,8,2898552867
3864,41263890,27353,41291243,0,0,1,8704,25,8270063379
3865,41275530,234738,41510268,4,0,0,7168,14,4992921934
3866,41302621,108424,41411045,1,0,0,512,2,7576897983
3867,41320081,171575,41491656,1,0,0,1536,2,2154081079
3868,41330679,211347,41542026,6,0,0,2560,8,9839396909
3869,41333860,566,41334426,0,0,1,512,25,4277393866
3870,41358140,3904,41362044,0,0,1,10752,25,7681527296
3871,41379560,103059,41482619,7,0,0,10240,18,2679528071
3872,41392889,113072,41505961,6,0,0,512,8,9911527711
3873,41404021,127599,41531620,1,0,0,1024,2,5969588320
3874,41419180,1042,41420222,3,0,1,1024,29,9835793596
3875,41427779,51658,41479437,7,0,1,6144,18,7143253796
3876,41435940,297812,41733752,7,0,0,14336,18,2456463703
3877,41440440,204975,41645415,7,0,0,19968,18,6470732189
3878,41441701,37751,41479452,4,0,1,6656,14,5386063536
3879,41443120,49439,41492559,3,0,1,2560,29,608748101
3880,41453911,72824,41526735,1,0,0,1536,2,6503967842
3881,41460360,157044,41617404,7,0,0,33792,18,10169905754
3882,41464809,90193,41555002,6,0,0,1024,8,2524862857
3883,41469170,260175,41729345,2,0,0,39424,9,6587880753
3884,41476239,68845,41545084,6,0,0,3072,8,4869811386
3885,41493449,2470,41495919,7,0,1,2560,18,9473756967
3886,41507829,3128,41510957,7,0,1,9216,18,288197997
3887,41507880,277796,41785676,2,0,0,12288,9,10621949748
3888,41509020,6549,41515569,0,0,1,5120,25,3273757399
3889,41525240,81853,41607093,2,0,0,11264,9,4704938503
3890,41529410,3422,41532832,0,0,1,3584,25,4240198712
3891,41532270,1228,41533498,3,0,1,1024,29,10053289842
3892,41534091,3898,41537989,2,0,1,4096,9,10352896429
3893,41537399,1256,41538655,7,0,1,1024,18,6634064937
3894,41539970,177333,41717303,4,0,0,32256,14,5463642302
3895,41545600,5802,41551402,3,0,1,6144,29,8426092442
3896,41566891,50840,41617731,1,0,0,1024,2,5017661159
3897,41568080,285351,41853431,4,0,0,58368,14,3478973584
3898,41590820,177374,41768194,2,0,0,17920,9,3596137928
3899,41612190,361637,41973827,2,0,0,9216,9,606317543
3900,41627571,566,41628137,2,0,1,512,9,6888934149
3901,41649719,84384,41734103,6,0,0,1024,8,10331613575
3902,41652640,2470,41655110,0,0,1,2560,25,1478412486
3903,41652709,3630,41656339,7,0,1,8704,18,2372077362
3904,41656580,2470,41659050,0,0,1,2560,25,7330173795
3905,41662870,566,41663436,3,0,1,512,29,8466150751
3906,41666640,6229,41672869,3,0,1,15360,29,5216969475
3907,41669359,7336,41676695,9,0,1,5632,17,8776995195
3908,41672029,5332,41677361,9,0,1,1024,17,6793795711
3909,41695150,275839,41970989,4,0,0,66048,14,9107834902
3910,41704630,12688,41717318,3,0,1,7168,29,2875851461
3911,41706660,319294,42025954,2,0,0,171008,9,8492989908
3912,41714129,22052,41736181,9,0,1,2560,17,8114437159
3913,41714609,23518,41738127,7,0,1,3072,18,9611152035
3914,41717140,21973,41739113,3,0,1,1536,29,4913147511
3915,41743829,6278,41750107,9,0,1,6656,17,5057985868
3916,41760380,7829,41768209,3,0,1,3584,29,9611660905
3917,41778150,2946,41781096,0,0,1,3072,25,1069267747
3918,41782090,8515,41790605,0,0,1,12800,25,732269704
3919,41796460,1042,41797502,0,0,1,1024,25,8397093153
3920,41808840,223901,42032741,7,0,0,22016,18,849531568
3921,41808850,583,41809433,0,0,1,512,25,8636193170
3922,41816660,413768,42230428,4,0,0,72192,14,3647663083
3923,41817560,880244,42697804,7,0,0,6144,18,72885039
3924,41838199,16266,41854465,7,0,1,1024,18,9412484826
3925,41853640,182670,42036310,2,0,0,8192,9,1890899188
3926,41867670,1994,41869664,3,0,1,2048,29,9418743058
3927,41891759,566,41892325,7,0,1,512,18,2159409402
3928,41901929,2946,41904875,7,0,1,3072,18,9775723374
3929,41904590,196274,42100864,4,0,0,12800,14,6924117139
3930,41923080,1518,41924598,3,0,1,1536,29,1248547470
3931,41936219,566,41936785,7,0,1,512,18,10529476907
3932,41936380,724812,42661192,4,0,0,108032,14,9439093429
3933,41945789,25215,41971004,7,0,1,6656,18,1929124098
3934,41955110,212240,42167350,7,0,0,62976,18,4874184048
3935,41963280,282311,42245591,2,0,0,49664,9,7908290270
3936,41976450,59875,42036325,0,0,1,3584,25,6986164655
3937,41986570,279681,42266251,7,0,0,2560,18,3667786492
3938,41994550,176247,42170797,7,0,0,11264,18,9275861163
3939,41994660,42498,42037158,0,0,1,1536,25,4628638754
3940,41995749,42075,42037824,7,0,1,1024,18,1753730895
3941,41999080,39410,42038490,0,0,1,1024,25,9352638832
3942,42000819,42817,42043636,6,0,1,8192,8,381096728
3943,42021009,27453,42048462,6,0,1,7680,8,872892913
3944,42022970,772436,42795406,7,0,0,46080,18,2795541553
3945,42035350,278958,42314308,4,0,0,27648,14,10530286878
3946,42039409,14545,42053954,7,0,1,17920,18,1904044941
3947,42041130,239074,42280204,2,0,0,7168,9,10513385380
3948,42045229,309076,42354305,6,0,0,1536,8,609866993
3949,42054309,121775,42176084,6,0,0,512,8,10001892307
3950,42056009,21658,42077667,6,0,1,35328,8,5826569618
3951,42075210,270640,42345850,4,0,0,1536,14,8955885329
3952,42114589,4162,42118751,7,0,1,11264,18,1347616369
3953,42117860,262376,42380236,4,0,0,512,14,2575976892
3954,42120781,210995,42331776,1,0,0,5632,2,10209749197
3955,42123790,290160,42413950,2,0,0,10752,9,4148488740
3956,42128890,5802,42134692,0,0,1,6144,25,6575519078
3957,42129970,6037,42136007,0,0,1,13312,25,7884010984
3958,42133500,358957,42492457,4,0,0,27648,14,9444645349
3959,42147730,286965,42434695,2,0,0,66048,9,10541680288
3960,42151150,26219,42177369,0,0,1,15872,25,2612730251
3961,42151810,773687,42925497,2,0,0,26112,9,1309868847
3962,42162400,429312,42591712,2,0,0,19456,9,10678342797
3963,42164370,370591,42534961,7,0,0,51200,18,10705006510
3964,42164781,270405,42435186,1,0,0,1536,2,8430920164
3965,42171030,414731,42585761,2,0,0,113664,9,2925607272
3966,42174810,5831,42180641,3,0,1,5120,29,5688407553
3967,42181120,822342,43003462,8,0,0,15872,26,7612613159
3968,42185760,6754,42192514,0,0,1,7168,25,5951370868
3969,42189099,4081,42193180,7,0,1,1024,18,3238473681
3970,42190240,727286,42917526,7,0,0,80896,18,5121262456
3971,42194150,485013,42679163,7,0,0,58880,18,8279342323
3972,42194519,150848,42345367,6,0,0,2560,8,1726071157
3973,42202830,1157635,43360465,4,0,0,7168,14,10730100469
3974,42208899,205222,42414121,6,0,0,512,8,6744727681
3975,42211041,37004,42248045,2,0,1,2560,9,3021794674
3976,42229069,20602,42249671,7,0,1,2560,18,4983886597
3977,42233169,17895,42251064,6,0,1,10752,8,3347272770
3978,42258010,3387,42261397,8,0,1,9728,26,7219656844
3979,42261290,4976,42266266,3,0,1,12288,29,1224902223
3980,42262370,344208,42606578,8,0,0,47616,26,7088609011
3981,42268270,904045,43172315,4,0,0,10240,14,6448934457
3982,42270580,9639,42280219,3,0,1,8192,29,463460730
3983,42271630,422220,42693850,7,0,0,48128,18,3061076307
3984,42276399,332445,42608844,6,0,0,512,8,7915649185
3985,42301380,394529,42695909,8,0,0,6656,26,9194743039
3986,42329540,4374,42333914,3,0,1,4608,29,10736347441
3987,42329830,5070,42334900,3,0,1,1536,29,5048949425
3988,42336190,3898,42340088,5,0,1,4096,15,9232195769
3989,42336639,7336,42343975,6,0,1,15872,8,4460403125
3990,42339340,4981,42344321,5,0,1,512,15,7421244400
3991,42363599,228440,42592039,6,0,0,1024,8,8515727905
3992,42375839,6754,42382593,7,0,1,7168,18,5227170696
3993,42381349,5326,42386675,7,0,1,5632,18,6804246104
3994,42396529,1022154,43418683,6,0,0,512,8,5800922115
3995,42416429,19407,42435836,7,0,1,512,18,6825160305
3996,42418859,19513,42438372,7,0,1,3072,18,9244349073
3997,42419900,24168,42444068,5,0,1,8192,15,1050310993
3998,42421029,541140,42962169,6,0,0,512,8,7114493072
3999,42431720,456401,42888121,4,0,0,112128,14,9350508484
4000,42433171,1108890,43542061,1,0,0,1024,2,4641176585
4001,42439840,387113,42826953,4,0,0,37888,14,2983706238
4002,42445010,5454,42450464,3,0,1,13824,29,710088356
4003,42454920,3422,42458342,6,0,1,3584,8,433707246
4004,42479129,566,42479695,7,0,1,512,18,6494150489
4005,42485210,10126,42495336,3,0,1,8704,29,4189701775
4006,42486410,759698,43246108,4,0,0,17408,14,7212089864
4007,42498170,1994,42500164,5,0,1,2048,15,4822273097
4008,42501320,1050933,43552253,8,0,0,13312,26,341875485
4009,42525850,410825,42936675,4,0,0,35840,14,3638212740
4010,42528810,6751,42535561,5,0,1,512,15,6444668273
4011,42530290,16652,42546942,8,0,1,19456,26,10129481081
4012,42543500,920691,43464191,2,0,0,108544,9,1862450803
4013,42551719,373949,42925668,6,0,0,512,8,2707360641
4014,42557900,239081,42796981,2,0,0,5120,9,8611101651
4015,42567030,40674,42607704,6,0,1,1024,8,10591465529
4016,42570941,924408,43495349,1,0,0,1536,2,5040553833
4017,42575771,32599,42608370,2,0,1,1024,9,10233092705
4018,42579600,227368,42806968,8,0,0,12800,26,6826443346
4019,42580690,368837,42949527,8,0,0,30720,26,70779982
4020,42585409,383216,42968625,6,0,0,1536,8,7919563138
4021,42593490,299350,42892840,4,0,0,15360,14,8092337273
4022,42598100,12881,42610981,5,0,1,10240,15,5148122958
4023,42612730,1042,42613772,6,0,1,1024,8,951938326
4024,42632740,65103,42697843,6,0,1,2560,8,10685748006
4025,42633760,1073958,43707718,2,0,0,119808,9,10626207507
4026,42649790,449132,43098922,8,0,0,14848,26,1332838500
4027,42676080,26558,42702638,5,0,1,5120,15,6269578883
4028,42686760,16864,42703624,6,0,1,1536,8,9088780167
4029,42689060,355403,43044463,4,0,0,34304,14,5368944405
4030,42698519,8651,42707170,7,0,1,5632,18,3611891872
4031,42707260,5802,42713062,5,0,1,6144,15,5093358512
4032,42707420,10148,42717568,5,0,1,7168,15,9033660186
4033,42712989,5565,42718554,7,0,1,1536,18,9294527268
4034,42719620,417069,43136689,8,0,0,73728,26,3102930143
4035,42726520,767965,43494485,7,0,0,98816,18,10347830794
4036,42734120,904569,43638689,7,0,0,135680,18,521245356
4037,42761470,613358,43374828,2,0,0,36352,9,8629516862
4038,42763479,566,42764045,7,0,1,512,18,4702977341
4039,42764170,1055239,43819409,8,0,0,106496,26,6493837752
4040,42765310,403817,43169127,8,0,0,103936,26,555440990
4041,42801860,869315,43671175,7,0,0,105984,18,3113916825
4042,42812990,374246,43187236,7,0,0,6144,18,8874841187
4043,42826910,4409,42831319,3,0,1,4608,29,905411320
4044,42839790,53065,42892855,3,0,1,48128,29,942466643
4045,42842950,93740,42936690,5,0,1,512,15,216791326
4046,42855819,80894,42936713,7,0,1,1536,18,5101229784
4047,42858720,642900,43501620,7,0,0,20480,18,236343561
4048,42866540,70188,42936728,3,0,1,512,29,9330605668
4049,42890150,439433,43329583,8,0,0,12800,26,5613732594
4050,42894109,608166,43502275,6,0,0,2048,8,3128029178
4051,42904450,45092,42949542,5,0,1,7168,15,7331954068
4052,42911080,1356899,44267979,4,0,0,55808,14,7006153957
4053,42915289,367542,43282831,6,0,0,512,8,4408140877
4054,42920971,459772,43380743,1,0,0,1024,2,5965184824
4055,42932550,17023,42949573,3,0,1,4096,29,2034534065
4056,42936740,841223,43777963,7,0,0,71168,18,6559724814
4057,42943420,8133,42951553,5,0,1,2048,15,6929248873
4058,42945130,10855,42955985,8,0,1,6144,26,7571336989
4059,42961689,1042,42962731,7,0,1,1024,18,837546225
4060,42964789,433020,43397809,6,0,0,512,8,6348700813
4061,42967520,2470,42969990,5,0,1,2560,15,2091601822
4062,42969720,748481,43718201,7,0,0,34304,18,6390001107
4063,42974369,4374,42978743,7,0,1,4608,18,5164847122
4064,42974469,5260,42979729,7,0,1,1536,18,8501286823
4065,42976539,518140,43494679,6,0,0,512,8,39047411
4066,42978659,740720,43719379,6,0,0,512,8,1895530216
4067,42983450,2946,42986396,3,0,1,3072,29,7523491300
4068,42992821,578146,43570967,1,0,0,1024,2,5238552813
4069,42998270,12566,43010836,5,0,1,20992,15,1080709831
4070,42998531,575465,43573996,1,0,0,1024,2,4137996386
4071,43002911,720274,43723185,1,0,0,2560,2,2459003657
4072,43028239,4850,43033089,7,0,1,5120,18,654216728
4073,43029920,14558,43044478,5,0,1,3072,15,4816973848
4074,43047090,271261,43318351,7,0,0,41472,18,2849776845
4075,43055070,960026,44015096,8,0,0,60416,26,6039013532
4076,43058511,450877,43509388,1,0,0,2560,2,739267395
4077,43067181,716443,43783624,1,0,0,512,2,4459416676
4078,43067489,10499,43077988,7,0,1,16896,18,7926769862
4079,43070620,1073857,44144477,8,0,0,67584,26,10540957357
4080,43073480,659135,43732615,8,0,0,18944,26,967888878
4081,43081121,505940,43587061,1,0,0,512,2,8379533329
4082,43084419,566,43084985,9,0,1,512,17,9055262500
4083,43086549,188454,43275003,6,0,0,512,8,4431690369
4084,43089009,1994,43091003,7,0,1,2048,18,5979527373
4085,43095930,368432,43464362,2,0,0,512,9,8335446046
4086,43100721,632657,43733378,1,0,0,1536,2,7268105259
4087,43103880,622916,43726796,2,0,0,11776,9,1926339786
4088,43107229,29475,43136704,7,0,1,8192,18,10705863118
4089,43120129,49013,43169142,9,0,1,4608,17,2769821310
4090,43121620,47537,43169157,3,0,1,14848,29,8979818460
4091,43135470,33710,43169180,5,0,1,5120,15,86937729
4092,43144560,754895,43899455,2,0,0,136192,9,4192065192
4093,43160109,1151417,44311526,6,0,0,11264,8,7845792000
4094,43164600,12148,43176748,8,0,1,4608,26,5073525022
4095,43166940,12394,43179334,3,0,1,4096,29,1654199545
4096,43172130,9150,43181280,8,0,1,3072,26,6521870946
4097,43177610,9641,43187251,3,0,1,8192,29,5382187327
4098,43181730,120195,43301925,7,0,0,2048,18,3742218883
4099,43186440,6605,43193045,3,0,1,6144,29,113405881
4100,43191521,303345,43494866,1,0,0,512,2,8350807214
4101,43201549,1994,43203543,9,0,1,2048,17,1979776589
4102,43205199,620816,43826015,6,0,0,21504,8,7351873267
4103,43240200,322913,43563113,7,0,0,28672,18,2635289959
4104,43274270,3422,43277692,0,0,1,3584,25,5625403408
4105,43278290,807765,44086055,8,0,0,116224,26,1858325703
4106,43287690,551995,43839685,2,0,0,20992,9,3644184198
4107,43288150,4374,43292524,0,0,1,4608,25,3213921851
4108,43291810,704863,43996673,7,0,0,60928,18,5189995270
4109,43297219,1518,43298737,9,0,1,1536,17,7227999923
4110,43310480,602223,43912703,4,0,0,13312,14,5789494589
4111,43326040,8385,43334425,5,0,1,5120,15,1978407495
4112,43330929,4482,43335411,9,0,1,1536,17,6859079532
4113,43334980,4374,43339354,6,0,1,4608,8,1894904089
4114,43339690,187134,43526824,2,0,0,19456,9,10282485920
4115,43340060,623858,43963918,8,0,0,36864,26,5940763116
4116,43355039,2470,43357509,7,0,1,2560,18,5905846694
4117,43359450,15401,43374851,3,0,1,6656,29,854945437
4118,43365310,605651,43970961,8,0,0,23040,26,5897270593
4119,43376199,4850,43381049,7,0,1,5120,18,5658547848
4120,43382400,204490,43586890,2,0,0,13824,9,3532242339
4121,43383480,647534,44031014,8,0,0,32256,26,5702439861
4122,43384510,2470,43386980,6,0,1,2560,8,7292518354
4123,43387259,2946,43390205,6,0,1,3072,8,1769936572
4124,43387279,3272,43390551,6,0,1,512,8,6430502647
4125,43394630,1518,43396148,3,0,1,1536,29,5685440799
4126,43404300,5712,43410012,0,0,1,14336,25,7213843794
4127,43419710,807570,44227280,4,0,0,23552,14,6981877719
4128,43422260,480494,43902754,7,0,0,10752,18,396847696
4129,43428929,65571,43494500,7,0,1,5120,18,2465617782
4130,43430510,789579,44220089,8,0,0,96256,26,1287061712
4131,43440771,198089,43638860,1,0,0,512,2,1315685506
4132,43442970,61258,43504228,3,0,1,2048,29,196758792
4133,43454389,51465,43505854,9,0,1,2560,17,3109300354
4134,43465710,253458,43719168,7,0,0,3072,18,2305108147
4135,43470530,312923,43783453,4,0,0,17920,14,3287327904
4136,43480300,27500,43507800,3,0,1,3072,29,7028289815
4137,43481249,29777,43511026,7,0,1,5120,18,1193756425
4138,43499680,12012,43511692,0,0,1,1024,25,1083937553
4139,43515430,574118,44089548,8,0,0,6656,26,2344673938
4140,43518779,1518,43520297,7,0,1,1536,18,6551241792
4141,43524190,425253,43949443,7,0,0,55808,18,9916923505
4142,43530090,192268,43722358,8,0,0,9728,26,98705866
4143,43530489,1042,43531531,7,0,1,1024,18,10540253798
4144,43534569,5326,43539895,9,0,1,5632,17,1044010076
4145,43534890,6631,43541521,8,0,1,2560,26,8015781998
4146,43542020,5359,43547379,0,0,1,5632,25,6054423993
4147,43544890,193855,43738745,2,0,0,3072,9,763651626
4148,43551600,11528,43563128,3,0,1,4096,29,10570065653
4149,43563170,10499,43573669,0,0,1,16896,25,5702678357
4150,43564060,12515,43576575,3,0,1,4608,29,1447916208
4151,43571410,901372,44472782,2,0,0,116224,9,2916741727
4152,43574531,4679,43579210,4,0,1,12288,14,6657928063
4153,43592371,140524,43732895,1,0,0,512,2,2704427360
4154,43600540,132138,43732678,0,0,1,512,25,7507811330
4155,43608790,123919,43732709,3,0,1,2048,29,4099658965
4156,43608829,1074283,44683112,6,0,0,6656,8,9190571265
4157,43609949,122775,43732724,7,0,1,3584,18,6773548206
4158,43619721,631231,44250952,1,0,0,1024,2,1573222787
4159,43620499,112894,43733393,7,0,1,4608,18,1302226740
4160,43624550,108866,43733416,3,0,1,512,29,3336558582
4161,43630439,104786,43735225,9,0,1,2560,17,1078070509
4162,43643640,398324,44041964,2,0,0,35840,9,5447529657
4163,43646170,90041,43736211,3,0,1,1536,29,657076761
4164,43650569,86948,43737517,7,0,1,2048,18,10581072566
4165,43652449,86311,43738760,7,0,1,512,18,2932187507
4166,43671431,599597,44271028,1,0,0,1024,2,4560235291
4167,43674351,487778,44162129,1,0,0,512,2,9297545657
4168,43685989,53764,43739753,7,0,1,12800,18,2474233083
4169,43691570,409830,44101400,8,0,0,35328,26,10682115218
4170,43694660,853082,44547742,2,0,0,89088,9,6135027799
4171,43711050,559643,44270693,8,0,0,7680,26,4183777093
4172,43713479,27580,43741059,7,0,1,2048,18,1628766215
4173,43722110,1042290,44764400,2,0,0,112128,9,8592418194
4174,43735869,308146,44044015,6,0,0,6656,8,4356794764
4175,43746839,1518,43748357,9,0,1,1536,17,8416982581
4176,43755069,22909,43777978,7,0,1,2048,18,8134409687
4177,43779629,39795,43819424,9,0,1,10240,17,4325418922
4178,43796800,440042,44236842,4,0,0,30720,14,9780336815
4179,43798760,31663,43830423,5,0,1,4608,15,2990258195
4180,43799610,287879,44087489,8,0,0,4608,26,10464159988
4181,43812311,602375,44414686,0,0,0,1024,25,2426089067
4182,43817049,22651,43839700,7,0,1,4608,18,8285080819
4183,43818130,21585,43839715,0,0,1,7168,25,3293788026
4184,43845329,566,43845895,9,0,1,512,17,7591803303
4185,43853920,2470,43856390,0,0,1,2560,25,7496446490
4186,43856799,393786,44250585,6,0,0,45056,8,584841011
4187,43862670,40684,43903354,5,0,1,512,15,2151514691
4188,43881309,25558,43906867,9,0,1,4096,17,4411865164
4189,43892060,20658,43912718,0,0,1,5120,25,3407353415
4190,43898909,409170,44308079,6,0,0,51200,8,4915975199
4191,43900440,271190,44171630,8,0,0,2560,26,554330310
4192,43906219,321240,44227459,6,0,0,512,8,5166087204
4193,43910750,3954,43914704,5,0,1,2048,15,808303857
4194,43935080,14921,43950001,5,0,1,512,15,3610000150
4195,43952920,411244,44364164,7,0,0,53248,18,5539313865
4196,43957730,17402,43975132,5,0,1,11264,15,4274110509
4197,43960660,15458,43976118,5,0,1,1536,15,2608212313
4198,44008540,22489,44031029,0,0,1,15872,25,1141821732
4199,44029909,56161,44086070,7,0,1,7680,18,8648762610
4200,44033450,827694,44861144,4,0,0,79872,14,6454587545
4201,44045800,875386,44921186,4,0,0,3584,14,6066214132
4202,44063261,279359,44342620,1,0,0,2560,2,1993926248
4203,44065730,748033,44813763,4,0,0,1536,14,8928259341
4204,44083010,418404,44501414,8,0,0,64000,26,10177341339
4205,44090590,280297,44370887,2,0,0,22016,9,3382038721
4206,44091609,14683,44106292,9,0,1,5120,17,6502287681
4207,44093181,175141,44268322,1,0,0,1024,2,1338941480
4208,44095929,12035,44107964,9,0,1,12800,17,6563827261
4209,44101420,490048,44591468,4,0,0,38912,14,4591139262
4210,44104479,9251,44113730,7,0,1,7168,18,8743333748
4211,44137809,14366,44152175,7,0,1,8192,18,10057048654
4212,44158831,314949,44473780,0,0,0,1024,25,7975061439
4213,44175319,5196,44180515,7,0,1,13312,18,10230321146
4214,44187659,1042,44188701,7,0,1,1024,18,5388364345
4215,44191751,219039,44410790,0,0,0,512,25,5373170621
4216,44192750,327818,44520568,8,0,0,17920,26,5126487077
4217,44198820,588379,44787199,2,0,0,74752,9,6761021001
4218,44199140,471918,44671058,2,0,0,35328,9,4399929659
4219,44200919,71524,44272443,7,0,1,11264,18,2906868713
4220,44202351,271070,44473421,0,0,0,2048,25,3466651003
4221,44212330,664601,44876931,2,0,0,51712,9,4996867641
4222,44236780,318777,44555557,7,0,0,25600,18,5907650347
4223,44244120,31879,44275999,5,0,1,11264,15,3496884560
4224,44244399,564257,44808656,6,0,0,29184,8,10397788416
4225,44251811,249790,44501601,1,0,0,512,2,9144745862
4226,44259949,386377,44646326,6,0,0,36352,8,8477447082
4227,44267019,339643,44606662,6,0,0,22016,8,8088077185
4228,44267699,13422,44281121,7,0,1,6144,18,5186244
4229,44268139,13328,44281467,7,0,1,512,18,823781322
4230,44270640,338236,44608876,7,0,0,7168,18,563818271
4231,44274269,8589,44282858,7,0,1,13824,18,5303573233
4232,44281910,10241,44292151,5,0,1,16384,15,1443270149
4233,44301060,271582,44572642,4,0,0,11264,14,7825202240
4234,44310689,8084,44318773,9,0,1,7680,17,3330386082
4235,44317710,714566,45032276,2,0,0,98304,9,2665932355
4236,44318060,682135,45000195,2,0,0,90112,9,6119351170
4237,44320350,1518,44321868,5,0,1,1536,15,4420328290
4238,44321870,509221,44831091,4,0,0,3072,14,1377481136
4239,44326210,472868,44799078,8,0,0,38912,26,352968414
4240,44336690,4162,44340852,5,0,1,11264,15,6416772885
4241,44338829,541565,44880394,6,0,0,11264,8,577930219
4242,44360470,11518,44371988,5,0,1,1024,15,9290374019
4243,44361750,12454,44374204,0,0,1,3072,25,5420666715
4244,44365890,447180,44813070,4,0,0,13824,14,565807945
4245,44366950,9520,44376470,0,0,1,3584,25,7834289599
4246,44380600,432657,44813257,4,0,0,512,14,10649953231
4247,44382031,3645,44385676,2,0,1,10240,9,7669700433
4248,44382450,345724,44728174,2,0,0,7168,9,9010632525
4249,44385450,572,44386022,5,0,1,512,15,7893297629
4250,44401339,549819,44951158,6,0,0,73216,8,7084063791
4251,44403129,6278,44409407,9,0,1,6656,17,7476323272
4252,44405099,7534,44412633,9,0,1,5120,17,6063728659
4253,44405761,7538,44413299,2,0,1,1024,9,1840209519
4254,44413039,3898,44416937,9,0,1,4096,17,8117973231
4255,44415200,3363,44418563,5,0,1,2560,15,1704324176
4256,44419820,5802,44425622,0,0,1,6144,25,6724417087
4257,44432539,4374,44436913,7,0,1,4608,18,6063067532
4258,44449629,26580,44476209,9,0,1,2560,17,1709215206
4259,44454230,24885,44479115,0,0,1,4608,25,8240428735
4260,44455111,344638,44799749,0,0,0,2048,25,6137693537
4261,44465601,343234,44808835,0,0,0,512,25,10723468936
4262,44475811,526490,45002301,1,0,0,512,2,9627049392
4263,44483069,473975,44957044,6,0,0,10752,8,3869706797
4264,44485979,486697,44972676,6,0,0,46080,8,772042589
4265,44501239,8060,44509299,7,0,1,8192,18,1894028944
4266,44510900,9683,44520583,5,0,1,6656,15,9978002374
4267,44530130,30286,44560416,0,0,1,5120,25,9362836166
4268,44541920,22682,44564602,5,0,1,6656,15,7078507201
4269,44563881,263983,44827864,1,0,0,512,2,2832174404
4270,44567540,6278,44573818,5,0,1,6656,15,3104916910
4271,44570610,621652,45192262,4,0,0,77824,14,6319775605
4272,44578149,13334,44591483,7,0,1,5120,18,5836334371
4273,44585850,8095,44593945,5,0,1,2560,15,8131681300
4274,44599190,7487,44606677,0,0,1,11264,25,1854966856
4275,44610589,5326,44615915,9,0,1,5632,17,6476345644
4276,44639740,528436,45168176,7,0,0,137216,18,2579426306
4277,44642181,5204,44647385,4,0,1,1024,14,7028337492
4278,44647660,778589,45426249,4,0,0,23040,14,831829626
4279,44662110,9506,44671616,0,0,1,512,25,2052051848
4280,44671950,330180,45002130,4,0,0,6144,14,5011683098
4281,44682969,5847,44688816,7,0,1,14336,18,6378136062
4282,44693100,386797,45079897,8,0,0,21504,26,391224697
4283,44707861,326424,45034285,1,0,0,2560,2,3182114309
4284,44716570,3422,44719992,1,0,1,3584,2,3335126080
4285,44724150,4039,44728189,0,0,1,8704,25,4090679689
4286,44735900,77380,44813280,0,0,1,2560,25,10458111273
4287,44752560,61536,44814096,1,0,1,1024,2,9414170339
4288,44764411,51433,44815844,4,0,1,2560,14,4970447525
4289,44770861,262599,45033460,0,0,0,3584,25,8403304815
4290,44774510,579706,45354216,4,0,0,105472,14,9810923077
4291,44781119,37631,44818750,7,0,1,4608,18,9206967974
4292,44781810,473977,45255787,8,0,0,17920,26,9229311151
4293,44783250,672074,45455324,8,0,0,19456,26,4032047059
4294,44804531,593697,45398228,0,0,0,512,25,737032675
4295,44805480,13616,44819096,5,0,1,512,15,3916912847
4296,44812471,241209,45053680,0,0,0,512,25,4996666423
4297,44815220,4546,44819766,5,0,1,10752,15,10661129120
4298,44831511,572660,45404171,0,0,0,1024,25,2705779393
4299,44831860,783063,45614923,4,0,0,48640,14,3843634796
4300,44833381,280789,45114170,1,0,0,512,2,2372191065
4301,44838550,542161,45380711,2,0,0,5120,9,7171450754
4302,44848980,692487,45541467,2,0,0,32768,9,3402989446
4303,44858010,23410,44881420,3,0,1,1024,29,2448036151
4304,44867669,809450,45677119,6,0,0,64000,8,2184753879
4305,44876170,445895,45322065,8,0,0,103424,26,3685809778
4306,44881710,1518,44883228,1,0,1,1536,2,3273825894
4307,44887589,2946,44890535,7,0,1,3072,18,3533872134
4308,44929731,451465,45381196,1,0,0,512,2,5478349876
4309,44932140,20553,44952693,5,0,1,1536,15,6450962581
4310,44960200,418749,45378949,2,0,0,37376,9,9673834008
4311,44961180,71119,45032299,5,0,1,7680,15,216514678
4312,44963580,68758,45032338,5,0,1,8192,15,5031767198
4313,44965140,67213,45032353,3,0,1,9728,29,8771428393
4314,44966300,67175,45033475,3,0,1,13312,29,5354199444
4315,44966840,66650,45033490,5,0,1,1024,15,6677412593
4316,44974330,59978,45034308,5,0,1,1536,15,8831540042
4317,44992599,128018,45120617,6,0,0,1024,8,2015765858
4318,44996930,492691,45489621,4,0,0,55296,14,1029822604
4319,45007391,161120,45168511,0,0,0,1024,25,7724408881
4320,45010200,357346,45367546,4,0,0,35328,14,873405773
4321,45022101,172377,45194478,1,0,0,2048,2,5276417573
4322,45033770,256262,45290032,2,0,0,64512,9,696894377
4323,45037041,253482,45290523,0,0,0,1536,25,7023733421
4324,45037070,2006,45039076,3,0,1,2048,29,6816257963
4325,45043440,5326,45048766,5,0,1,5632,15,2289598800
4326,45043920,9032,45052952,5,0,1,6656,15,1135994825
4327,45045109,9789,45054898,7,0,1,3072,18,98929871
4328,45047499,11265,45058764,7,0,1,6144,18,9731799975
4329,45054680,4750,45059430,0,0,1,1024,25,5718282678
4330,45063010,4420,45067430,3,0,1,11776,29,1396303737
4331,45073569,345630,45419199,6,0,0,21504,8,5183713136
4332,45074370,282389,45356759,7,0,0,8192,18,4936957264
4333,45085470,461495,45546965,7,0,0,14336,18,4430172486
4334,45089390,5454,45094844,5,0,1,13824,15,2202041159
4335,45089969,637788,45727757,6,0,0,76800,8,3175527172
4336,45091210,5900,45097110,5,0,1,3584,15,5534169522
4337,45120540,635,45121175,5,0,1,512,15,10134130698
4338,45128490,70059,45198549,3,0,1,6656,29,1169623996
4339,45137500,63315,45200815,5,0,1,3584,15,1316984683
4340,45137601,241519,45379120,1,0,0,512,2,6854291993
4341,45138890,457868,45596758,2,0,0,18944,9,2999296772
4342,45147909,53252,45201161,7,0,1,512,18,7703509359
4343,45158220,44567,45202787,5,0,1,2560,15,9484378665
4344,45168590,34556,45203146,1,0,1,9728,2,9191192313
4345,45176881,204144,45381025,0,0,0,512,25,5071219512
4346,45183560,251525,45435085,7,0,0,22528,18,7556440621
4347,45197020,9672,45206692,3,0,1,5632,29,5053458456
4348,45197140,11178,45208318,8,0,1,2560,26,3452538218
4349,45213510,1994,45215504,1,0,1,2048,2,9195198192
4350,45218591,396527,45615118,0,0,0,512,25,690116433
4351,45243090,2870,45245960,8,0,1,8704,26,4597183749
4352,45250710,10540,45261250,8,0,1,13824,26,2745355317
4353,45251071,303907,45554978,1,0,0,512,2,8472550239
4354,45256390,612321,45868711,8,0,0,40448,26,2448456673
4355,45267910,22628,45290538,1,0,1,21504,2,41721186
4356,45271119,109719,45380838,7,0,1,2560,18,761514240
4357,45289830,597936,45887766,7,0,0,62464,18,10691563206
4358,45295770,692073,45987843,8,0,0,28672,26,9445710587
4359,45306590,75372,45381962,8,0,1,1024,26,2797642080
4360,45313140,74453,45387593,3,0,1,6656,29,7447688040
4361,45322320,68179,45390499,8,0,1,4608,26,654789585
4362,45322851,405701,45728552,1,0,0,2560,2,5991395675
4363,45327260,65185,45392445,8,0,1,3072,26,2682729816
4364,45327409,287880,45615289,6,0,0,512,8,95750221
4365,45328870,582249,45911119,2,0,0,26112,9,2082642185
4366,45330190,438552,45768742,4,0,0,26624,14,9194858026
4367,45337460,247099,45584559,8,0,0,17920,26,7587885951
4368,45339640,494986,45834626,7,0,0,46080,18,9914550105
4369,45343530,880685,46224215,4,0,0,7680,14,9420092024
4370,45351769,41662,45393431,7,0,1,1536,18,4742432681
4371,45351959,1115267,46467226,6,0,0,22016,8,1620710937
4372,45353650,188932,45542582,4,0,0,3584,14,6443416220
4373,45354391,101260,45455651,0,0,0,1024,25,1397709780
4374,45354610,501263,45855873,8,0,0,69632,26,2500636810
4375,45356640,37457,45394097,1,0,1,1024,2,5507969942
4376,45357460,42231,45399691,8,0,1,18432,26,5589778626
4377,45382840,21357,45404197,1,0,1,7168,2,4564604210
4378,45385360,318926,45704286,4,0,0,89088,14,2013634746
4379,45385540,20603,45406143,1,0,1,3072,2,2818649547
4380,45386440,23889,45410329,5,0,1,6656,15,5355045550
4381,45390260,20415,45410675,8,0,1,512,26,5402247369
4382,45411850,7364,45419214,5,0,1,1024,15,842361205
4383,45432950,2693,45435643,3,0,1,512,29,4767042307
4384,45437699,2470,45440169,7,0,1,2560,18,7881596479
4385,45438091,3384,45441475,4,0,1,2048,14,9543583886
4386,45443080,3128,45446208,3,0,1,9216,29,9060198305
4387,45449031,407333,45856364,0,0,0,1536,25,2287054953
4388,45464381,264413,45728794,0,0,0,512,25,9680620811
4389,45465590,566,45466156,1,0,1,512,2,9172138238
4390,45469991,19645,45489636,4,0,1,3072,14,9062056505
4391,45480219,692689,46172908,6,0,0,45056,8,794912132
4392,45489550,4477,45494027,3,0,1,4608,29,904347626
4393,45492030,5223,45497253,8,0,1,5120,26,6251508007
4394,45496761,2470,45499231,4,0,1,2560,14,9507461715
4395,45507300,269413,45776713,2,0,0,26112,9,8737021007
4396,45509010,3128,45512138,3,0,1,9216,29,8585142098
4397,45509480,945993,46455473,7,0,0,216064,18,2517942100
4398,45512060,600068,46112128,4,0,0,17408,14,5230747020
4399,45529520,528158,46057678,8,0,0,46080,26,4819519855
4400,45532591,422550,45955141,0,0,0,512,25,2226021212
4401,45539900,8592,45548492,1,0,1,1536,2,5907950869
4402,45540041,11821,45551862,4,0,1,11776,14,7928455513
4403,45554760,348349,45903109,2,0,0,50176,9,3693640113
4404,45556260,741142,46297402,2,0,0,54272,9,4899682184
4405,45557430,397540,45954970,7,0,0,25600,18,4393639455
4406,45568339,1994,45570333,7,0,1,2048,18,6941011137
4407,45574900,9674,45584574,8,0,1,14336,26,4198677875
4408,45581590,8302,45589892,3,0,1,5632,29,9466902001
4409,45591250,7494,45598744,8,0,1,2048,26,3846197687
4410,45596809,18495,45615304,7,0,1,22528,18,3840972829
4411,45600860,909381,46510241,4,0,0,17408,14,1325308431
4412,45604959,10895,45615854,7,0,1,512,18,6543903893
4413,45607630,1080648,46688278,7,0,0,69120,18,10126659281
4414,45612620,410570,46023190,2,0,0,12800,9,10650686905
4415,45616099,1994,45618093,7,0,1,2048,18,3108861268
4416,45621989,882917,46504906,6,0,0,39424,8,9463948645
4417,45631290,969751,46601041,2,0,0,136192,9,5823686915
4418,45634190,334556,45968746,7,0,0,41984,18,2670310988
4419,45653461,1076199,46729660,0,0,0,512,25,2777896270
4420,45654591,1518,45656109,2,0,1,1536,9,1223838972
4421,45660159,68456,45728615,7,0,1,6656,18,5922933746
4422,45664520,1396146,47060666,7,0,0,41984,18,8657877612
4423,45665410,948617,46614027,8,0,0,38912,26,10487847118
4424,45665871,512376,46178247,0,0,0,1024,25,6375604734
4425,45667779,61899,45729678,6,0,1,1024,8,6134964639
4426,45676690,1176634,46853324,8,0,0,53248,26,4872722543
4427,45684300,1071047,46755347,2,0,0,45056,9,7501068786
4428,45686911,44172,45731083,4,0,1,2048,14,2480627170
4429,45693741,42250,45735991,4,0,1,6656,14,6322684423
4430,45696671,44146,45740817,4,0,1,7680,14,10721859043
4431,45699760,43323,45743083,8,0,1,3584,26,8642196850
4432,45702740,1131717,46834457,2,0,0,6144,9,6762421774
4433,45711130,33259,45744389,1,0,1,2048,2,3767374289
4434,45711450,36165,45747615,8,0,1,5120,26,1095185533
4435,45713670,609429,46323099,8,0,0,28160,26,1413849412
4436,45725160,993488,46718648,8,0,0,13824,26,5079919082
4437,45726759,1139536,46866295,6,0,0,42496,8,2135398050
4438,45729900,1008880,46738780,2,0,0,22016,9,5688062005
4439,45733910,14269,45748179,1,0,1,10752,2,6015524863
4440,45734860,14305,45749165,1,0,1,1536,2,1463728187
4441,45734880,19111,45753991,1,0,1,7680,2,4362444851
4442,45738139,722364,46460503,6,0,0,16384,8,5441319355
4443,45739440,963064,46702504,2,0,0,45056,9,1347034704
4444,45740790,14507,45755297,6,0,1,2048,8,3355546387
4445,45746309,464639,46210948,6,0,0,20480,8,8978503712
4446,45748381,189692,45938073,1,0,0,1024,2,3415668215
4447,45748571,8672,45757243,4,0,1,3072,14,2035953886
4448,45755181,4328,45759509,4,0,1,3584,14,3986628821
4449,45770170,714972,46485142,2,0,0,51712,9,7370289123
4450,45772640,10844,45783484,8,0,1,7168,26,1359215038
4451,45781460,5890,45787350,8,0,1,6144,26,998123746
4452,45783710,5906,45789616,5,0,1,3584,15,10720959724
4453,45803310,407809,46211119,2,0,0,512,9,8027468917
4454,45803830,325421,46129251,2,0,0,9216,9,5111635797
4455,45803880,464421,46268301,8,0,0,68608,26,6163000243
4456,45806960,5712,45812672,1,0,1,14336,2,4862341645
4457,45820810,82338,45903148,5,0,1,4096,15,1998332350
4458,45821670,884281,46705951,4,0,0,11264,14,9021614902
4459,45825769,85413,45911182,9,0,1,2048,17,8048410655
4460,45827710,692765,46520475,2,0,0,13312,9,3363099199
4461,45840340,78519,45918859,8,0,1,8192,26,3785635614
4462,45846790,75615,45922405,5,0,1,5632,15,80643065
4463,45853821,613576,46467397,0,0,0,512,25,880504619
4464,45860541,62223,45922764,4,0,1,9728,14,5795015006
4465,45864090,865376,46729466,8,0,0,34304,26,7052928630
4466,45869159,54911,45924070,7,0,1,2048,18,5520205865
4467,45870699,765283,46635982,6,0,0,19456,8,9369085649
4468,45877671,50265,45927936,4,0,1,6144,14,4105953424
4469,45877800,52082,45929882,0,0,1,3072,25,9583438753
4470,45884730,45498,45930228,0,0,1,512,25,2165088845
4471,45901100,1102586,47003686,8,0,0,36352,26,8193443227
4472,45902799,30655,45933454,7,0,1,5120,18,8481806380
4473,45918941,18059,45937000,2,0,1,5632,9,7382433543
4474,45919580,325274,46244854,4,0,0,4608,14,2904749362
4475,45922030,16596,45938626,1,0,1,2560,2,2588027207
4476,45926160,762601,46688761,7,0,0,1536,18,7062421272
4477,45927361,1357271,47284632,1,0,0,1024,2,2866809747
4478,45933850,9602,45943452,0,0,1,7680,25,1554009630
4479,45941049,823361,46764410,6,0,0,29696,8,8401919796
4480,45943769,1994,45945763,7,0,1,2048,18,1554250539
4481,45944111,2958,45947069,2,0,1,2048,9,5505458517
4482,45963391,575030,46538421,0,0,0,512,25,10494183258
4483,45965860,748561,46714421,4,0,0,12288,14,9949138244
4484,45968230,914554,46882784,2,0,0,13824,9,8425493374
4485,45968611,750388,46718999,0,0,0,1024,25,3367499613
4486,45977490,1042,45978532,8,0,1,1024,26,9084262934
4487,45982500,12582,45995082,1,0,1,7680,2,6978621832
4488,45983230,486117,46469347,8,0,0,5632,26,9883877308
4489,45998550,143812,46142362,8,0,0,4608,26,3967050114
4490,46000699,2470,46003169,9,0,1,2560,17,3477900896
4491,46008461,1518,46009979,4,0,1,1536,14,7473991373
4492,46013430,3898,46017328,0,0,1,4096,25,5358272647
4493,46018850,1211582,47230432,4,0,0,84480,14,9057938809
4494,46029970,1141378,47171348,4,0,0,86528,14,2409656099
4495,46029979,309715,46339694,6,0,0,10752,8,107026027
4496,46030841,12049,46042890,4,0,1,19968,14,5418968743
4497,46032250,1248357,47280607,8,0,0,94208,26,6547630056
4498,46033540,24161,46057701,0,0,1,2560,25,10302220913
4499,46044200,319790,46363990,2,0,0,7680,9,10022824356
4500,46044631,301191,46345822,0,0,0,1024,25,6924809010
4501,46050970,9771,46060741,1,0,1,3072,2,7826525692
4502,46052890,11397,46064287,1,0,1,5632,2,13219722
4503,46054050,12503,46066553,6,0,1,3584,8,5372581896
4504,46055961,15418,46071379,4,0,1,7680,14,3174821026
4505,46060439,13206,46073645,7,0,1,3584,18,1139328704
4506,46068109,5882,46073991,7,0,1,512,18,10123771212
4507,46069330,150378,46219708,2,0,0,4096,9,2501533094
4508,46070010,13770,46083780,6,0,1,26624,8,956251436
4509,46070900,17706,46088606,8,0,1,7680,26,4824166321
4510,46076681,541853,46618534,0,0,0,1536,25,5922775848
4511,46080040,479466,46559506,4,0,0,37888,14,6561729499
4512,46086351,5196,46091547,4,0,1,13312,14,1229707498
4513,46099290,4850,46104140,8,0,1,5120,26,1795783221
4514,46103291,8860,46112151,2,0,1,7680,9,8791409521
4515,46104179,7987,46112166,7,0,1,512,18,2007593342
4516,46105100,7713,46112813,8,0,1,3072,26,2829743013
4517,46109160,9296,46118456,1,0,1,6656,2,5665433414
4518,46111011,356573,46467584,0,0,0,512,25,611499166
4519,46111261,490139,46601400,1,0,0,1024,2,8962558143
4520,46112250,7512,46119762,8,0,1,2048,26,7547080527
4521,46117001,3107,46120108,4,0,1,512,14,3935103844
4522,46118950,13083,46132033,6,0,1,22016,8,9146271645
4523,46119031,13348,46132379,2,0,1,512,9,8975763825
4524,46125709,1378267,47503976,6,0,0,318976,8,1177967237
4525,46132821,742716,46875537,0,0,0,1536,25,8648751864
4526,46133199,2470,46135669,7,0,1,2560,18,10464947127
4527,46134521,4374,46138895,2,0,1,4608,9,460292499
4528,46139900,689203,46829103,2,0,0,31744,9,9354739702
4529,46157291,15632,46172923,4,0,1,5632,14,1780220127
4530,46164501,12805,46177306,2,0,1,4608,9,9088298910
4531,46172450,5812,46178262,6,0,1,10240,8,8735972296
4532,46176221,3278,46179499,4,0,1,2048,14,9884619767
4533,46178299,532355,46710654,6,0,0,15360,8,8582566746
4534,46183590,752689,46936279,2,0,0,28160,9,8086700355
4535,46197350,981828,47179178,8,0,0,20480,26,7703704016
4536,46201561,2946,46204507,2,0,1,3072,9,1036973370
4537,46208171,1405121,47613292,0,0,0,87552,25,8479605359
4538,46223019,7466,46230485,7,0,1,6656,18,5179329313
4539,46227670,3801,46231471,0,0,1,1536,25,1946117065
4540,46228020,892414,47120434,8,0,0,22016,26,5676850899
4541,46242911,2946,46245857,2,0,1,3072,9,1669869329
4542,46247350,24555,46271905,6,0,1,10240,8,6150250821
4543,46250840,831438,47082278,4,0,0,32256,14,2376478095
4544,46253550,1299940,47553490,2,0,0,157696,9,8811143215
4545,46255121,1517950,47773071,0,0,0,29696,25,3781165196
4546,46260750,11501,46272251,8,0,1,512,26,697811532
4547,46262160,10437,46272597,6,0,1,512,8,263176630
4548,46279401,18016,46297417,2,0,1,1536,9,710514008
4549,46288391,716121,47004512,1,0,0,512,2,1234539504
4550,46290080,11269,46301349,0,0,1,4096,25,9589263770
4551,46291249,1275696,47566945,6,0,0,44032,8,10079106392
4552,46305159,4374,46309533,7,0,1,4608,18,9365337675
4553,46305290,1370906,47676196,7,0,0,9728,18,5883136171
4554,46310361,12753,46323114,2,0,1,4608,9,6430386337
4555,46319330,5787,46325117,8,0,1,2048,26,8722706733
4556,46321790,3993,46325783,8,0,1,1024,26,9526734140
4557,46331850,1066318,47398168,4,0,0,22016,14,8100979063
4558,46332159,7550,46339709,7,0,1,5632,18,2825584825
4559,46342340,4374,46346714,8,0,1,4608,26,6340855387
4560,46354830,3128,46357958,6,0,1,9216,8,1419326902
4561,46362039,1710839,48072878,6,0,0,30720,8,10722058637
4562,46370750,3898,46374648,0,0,1,4096,25,2900305523
4563,46376380,610819,46987199,4,0,0,12288,14,9817295882
4564,46383061,4374,46387435,2,0,1,4608,9,3502329080
4565,46386869,719498,47106367,6,0,0,24576,8,1704614725
4566,46388249,67239,46455488,7,0,1,2048,18,5249196751
4567,46394190,95761,46489951,0,0,1,5120,25,9131755076
4568,46403001,601332,47004333,0,0,0,2048,25,1817055517
4569,46410891,1170312,47581203,0,0,0,2560,25,3976616619
4570,46417990,72627,46490617,0,0,1,1024,25,2834213639
4571,46430939,820949,47251888,6,0,0,66560,8,9039556527
4572,46432290,1154084,47586374,4,0,0,16896,14,1436841659
4573,46436010,55593,46491603,6,0,1,1536,8,6313102735
4574,46441431,68833,46510264,2,0,1,7680,9,8599180024
4575,46442430,1443589,47886019,7,0,0,62976,18,2165914332
4576,46444271,1171953,47616224,1,0,0,1536,2,3682488218
4577,46459389,50890,46510279,7,0,1,3072,18,3047171858
4578,46460610,49684,46510294,0,0,1,2048,25,10265438566
4579,46478431,31878,46510309,2,0,1,4608,9,997254480
4580,46485460,24864,46510324,8,0,1,1536,26,2528609179
4581,46487290,1364506,47851796,4,0,0,9216,14,8651815820
4582,46488640,21715,46510355,0,0,1,3584,25,7052124051
4583,46495541,2017725,48513266,0,0,0,70144,25,5549862505
4584,46505000,1698423,48203423,2,0,0,43520,9,2272758399
4585,46508080,1158120,47666200,8,0,0,72704,26,6132146250
4586,46514421,6069,46520490,2,0,1,10240,9,6805072835
4587,46522361,3904,46526265,4,0,1,10752,14,1756401033
4588,46538410,1827995,48366405,4,0,0,62976,14,2012210457
4589,46539839,1042,46540881,7,0,1,1024,18,4920742763
4590,46548721,1445455,47994176,0,0,0,25600,25,9700784026
4591,46549310,1315143,47864453,8,0,0,38400,26,1648972971
4592,46552439,1658799,48211238,6,0,0,25600,8,10625295746
4593,46558060,55982,46614042,6,0,1,2560,8,1890148172
4594,46559171,54886,46614057,4,0,1,5120,14,6278453109
4595,46573381,40691,46614072,4,0,1,6144,14,7425224876
4596,46587420,1360259,47947679,7,0,0,58368,18,1122191735
4597,46616311,2098300,48714611,1,0,0,512,2,3095872906
4598,46616590,556333,47172923,4,0,0,5120,14,7540239033
4599,46632440,686376,47318816,2,0,0,8704,9,3965550209
4600,46633760,4709,46638469,8,0,1,2560,26,10015492954
4601,46646141,2470,46648611,2,0,1,2560,9,5752457793
4602,46650701,1235521,47886222,1,0,0,512,2,2366821830
4603,46660970,3422,46664392,0,0,1,3584,25,8981635787
4604,46681140,48349,46729489,0,0,1,1024,25,5951292941
4605,46691061,1161062,47852123,1,0,0,1024,2,9738706292
4606,46711800,1458524,48170324,8,0,0,36864,26,4784639338
4607,46716701,22094,46738795,4,0,1,5632,14,8962289635
4608,46721281,17976,46739257,4,0,1,7168,14,3894696118
4609,46721599,18324,46739923,7,0,1,1024,18,10382245773
4610,46725741,38684,46764425,4,0,1,8192,14,4077498061
4611,46729089,35351,46764440,7,0,1,1024,18,9491425310
4612,46733641,30814,46764455,2,0,1,8704,9,1371938883
4613,46746340,18765,46765105,8,0,1,512,26,7001146355
4614,46752350,1359354,48111704,7,0,0,30208,18,6452626873
4615,46759841,1527913,48287754,0,0,0,94208,25,10631098791
4616,46759919,11054,46770973,7,0,1,6656,18,5828452538
4617,46760710,1003298,47764008,4,0,0,43008,14,7540248771
4618,46766589,1153243,47919832,6,0,0,66048,8,4542084201
4619,46779021,284686,47063707,1,0,0,512,2,1210407544
4620,46788159,1549382,48337541,6,0,0,9216,8,5173507025
4621,46788911,1544343,48333254,0,0,0,45056,25,4794774865
4622,46794850,1252932,48047782,8,0,0,91648,26,9711417919
4623,46804950,1118678,47923628,2,0,0,9728,9,4743264113
4624,46808800,422777,47231577,2,0,0,3584,9,1246261028
4625,46813429,4162,46817591,7,0,1,11264,18,5681922361
4626,46821431,13041,46834472,2,0,1,4608,9,10691638848
4627,46821940,683463,47505403,2,0,0,4608,9,1522430031
4628,46828601,5886,46834487,2,0,1,1024,9,4585440084
4629,46830710,4453,46835163,8,0,1,1536,26,6875644503
4630,46841760,1599358,48441118,7,0,0,22016,18,4121953935
4631,46853461,430836,47284297,0,0,0,10240,25,6374154767
4632,46862060,753611,47615671,4,0,0,7680,14,330285118
4633,46867951,3422,46871373,2,0,1,3584,9,651013594
4634,46873840,1228637,48102477,7,0,0,1536,18,5134235552
4635,46895360,776657,47672017,8,0,0,15360,26,8130672860
4636,46908351,372771,47281122,1,0,0,1536,2,321830433
4637,46920920,1238079,48158999,2,0,0,3584,9,3737839041
4638,46926621,775287,47701908,1,0,0,512,2,3788263919
4639,46937650,2470,46940120,0,0,1,2560,25,9254243281
4640,46938851,7706,46946557,2,0,1,8192,9,10737137503
4641,46941550,8553,46950103,8,0,1,5632,26,9431686600
4642,46955331,1431727,48387058,0,0,0,18944,25,8650028468
4643,46970651,1481607,48452258,0,0,0,31232,25,8659971983
4644,46978690,1435624,48414314,2,0,0,48640,9,3514977351
4645,46983340,1097785,48081125,2,0,0,11264,9,9187971788
4646,46995290,13079,47008369,8,0,1,4096,26,4349497522
4647,46998530,1103448,48101978,2,0,0,39424,9,1078668604
4648,47015580,3645,47019225,1,0,1,10240,2,850779348
4649,47030021,942356,47972377,0,0,0,48128,25,3771759089
4650,47040911,1518,47042429,2,0,1,1536,9,4783924267
4651,47042900,3422,47046322,8,0,1,3584,26,3156616080
4652,47043111,17570,47060681,2,0,1,3072,9,10040846313
4653,47054540,1791468,48846008,8,0,0,90112,26,363493368
4654,47069511,1677007,48746518,0,0,0,49152,25,10124664224
4655,47069639,1970049,49039688,6,0,0,73216,8,6549752687
4656,47077110,503290,47580400,7,0,0,44032,18,6303426835
4657,47087059,1294212,48381271,6,0,0,48640,8,1601965665
4658,47127850,1798086,48925936,4,0,0,20992,14,7872941978
4659,47139409,610109,47749518,6,0,0,20480,8,35071972
4660,47160711,893365,48054076,0,0,0,7680,25,3554996219
4661,47162351,466424,47628775,1,0,0,512,2,2791333123
4662,47190710,12308,47203018,8,0,1,20480,26,6292119393
4663,47190750,39697,47230447,8,0,1,4608,26,10324480971
4664,47204350,26112,47230462,8,0,1,12288,26,1135256853
4665,47213550,1045485,48259035,2,0,0,78336,9,3061545205
4666,47214400,76457,47290857,8,0,1,16384,26,9790327693
4667,47214740,78703,47293443,8,0,1,4096,26,9554054398
4668,47226290,1173189,48399479,8,0,0,9216,26,2579163860
4669,47226981,359620,47586601,1,0,0,512,2,3883215935
4670,47246430,49599,47296029,8,0,1,4096,26,3188684319
4671,47249431,417891,47667322,1,0,0,3584,2,4609934407
4672,47252590,614226,47866816,8,0,0,7680,26,1465946096
4673,47253100,1932193,49185293,4,0,0,54784,14,3884365526
4674,47256370,1333366,48589736,8,0,0,20992,26,10054684979
4675,47261110,1058401,48319511,4,0,0,52736,14,9294718293
4676,47280411,18844,47299255,2,0,1,5120,9,848509018
4677,47291380,760317,48051697,4,0,0,12800,14,7393017062
4678,47308060,1983039,49291099,8,0,0,115200,26,9445817275
4679,47319471,1258847,48578318,1,0,0,512,2,3153619668
4680,47325571,1331571,48657142,0,0,0,53248,25,9803618871
4681,47329100,1375317,48704417,4,0,0,94208,14,4486734796
4682,47340740,1373700,48714440,8,0,0,32768,26,444888951
4683,47351410,3898,47355308,8,0,1,4096,26,7803071772
4684,47364730,4850,47369580,8,0,1,5120,26,9272396039
4685,47384631,1042,47385673,2,0,1,1024,9,2230263413
4686,47392561,995682,48388243,1,0,0,3072,2,2734241105
4687,47392830,12602,47405432,5,0,1,7680,15,7546010804
4688,47397720,1180427,48578147,2,0,0,33792,9,2450200007
4689,47398741,659118,48057859,0,0,0,12288,25,3096584053
4690,47401690,710349,48112039,8,0,0,1024,26,971284206
4691,47405450,780037,48185487,4,0,0,49664,14,6040908514
4692,47411230,741636,48152866,8,0,0,15872,26,2206670008
4693,47414470,876975,48291445,4,0,0,11776,14,6201459464
4694,47420160,195526,47615686,5,0,1,4608,15,2917122701
4695,47426130,576611,48002741,4,0,0,1024,14,9351246790
4696,47443380,404018,47847398,4,0,0,7680,14,2607608944
4697,47443430,172295,47615725,8,0,1,2048,26,8920035305
4698,47454210,1077110,48531320,8,0,0,23552,26,2701465177
4699,47472721,337662,47810383,0,0,0,1536,25,7369511486
4700,47472801,146753,47619554,2,0,1,6656,9,4769243728
4701,47480810,140465,47621275,5,0,1,14848,15,886087616
4702,47495649,807771,48303420,6,0,0,38912,8,5240697340
4703,47513570,721574,48235144,4,0,0,74752,14,5966217983
4704,47530091,95555,47625646,2,0,1,6144,9,6178118989
4705,47530901,1024929,48555830,1,0,0,2048,2,7106993273
4706,47532160,94472,47626632,5,0,1,1536,15,10267645761
4707,47539130,673215,48212345,4,0,0,3584,14,232327890
4708,47548010,1897002,49445012,2,0,0,19968,9,10693301612
4709,47565160,1214943,48780103,2,0,0,28672,9,9001676659
4710,47586919,42939,47629858,7,0,1,5120,18,6978696986
4711,47593860,36984,47630844,8,0,1,1536,26,9171768653
4712,47599870,31960,47631830,8,0,1,1536,26,538970210
4713,47611390,723298,48334688,8,0,0,4608,26,1330193722
4714,47612940,1995317,49608257,2,0,0,214016,9,9058412171
4715,47628930,6126,47635056,5,0,1,5120,15,9428004352
4716,47635049,1263377,48898426,6,0,0,66560,8,2976154412
4717,47643101,23114,47666215,4,0,1,10752,14,6463677752
4718,47680591,1121143,48801734,0,0,0,3072,25,6818042467
4719,47683070,2470,47685540,8,0,1,2560,26,9432659591
4720,47691950,1564034,49255984,4,0,0,72192,14,6743953728
4721,47700910,1284522,48985432,2,0,0,8192,9,4712641691
4722,47710791,872534,48583325,0,0,0,16384,25,2824526067
4723,47715449,2946,47718395,6,0,1,3072,8,5705451393
4724,47716240,4101,47720341,3,0,1,3072,29,741955670
4725,47717900,4387,47722287,6,0,1,3072,8,7623624638
4726,47720139,3774,47723913,6,0,1,2560,8,6241023669
4727,47720351,666878,48387229,1,0,0,512,2,7222385107
4728,47721151,1671127,49392278,0,0,0,23040,25,6502190283
4729,47723839,943176,48667015,6,0,0,32256,8,5414894285
4730,47736679,3422,47740101,6,0,1,3584,8,7955325480
4731,47753661,26674,47780335,4,0,1,7680,14,1081506456
4732,47763370,1621834,49385204,8,0,0,105984,26,10736008014
4733,47770301,1530055,49300356,0,0,0,18944,25,4682873818
4734,47793781,1211516,49005297,0,0,0,4096,25,7528568047
4735,47799800,1119709,48919509,8,0,0,69120,26,9153039154
4736,47809271,263793,48073064,1,0,0,512,2,10501473370
4737,47851041,2504249,50355290,0,0,0,206848,25,8361534754
4738,47852031,919313,48771344,0,0,0,15360,25,6784372555
4739,47853271,933660,48786931,1,0,0,2048,2,4152726873
4740,47859280,1885076,49744356,8,0,0,62976,26,7313916045
4741,47864121,1238945,49103066,0,0,0,53248,25,9988139590
4742,47865020,1570542,49435562,4,0,0,103936,14,636431100
4743,47866901,864362,48731263,0,0,0,21504,25,9257777930
4744,47899921,946882,48846803,1,0,0,2560,2,7578161425
4745,47900440,1870030,49770470,4,0,0,26112,14,9156285038
4746,47909850,706968,48616818,2,0,0,13824,9,4180601064
4747,47935379,1375858,49311237,6,0,0,20992,8,2154830460
4748,47939490,2579192,50518682,2,0,0,19968,9,872198795
4749,47949751,564162,48513913,1,0,0,2048,2,3279456648
4750,47964431,9932,47974363,4,0,1,2048,14,6377037102
4751,47979251,1776413,49755664,0,0,0,1024,25,1904414195
4752,47998091,560018,48558109,1,0,0,512,2,4870632271
4753,48008970,6278,48015248,1,0,1,6656,2,5871226547
4754,48024931,34430,48059361,4,0,1,1536,14,10375519502
4755,48024950,2952448,50977398,8,0,0,73216,26,1160832590
4756,48025740,398737,48424477,8,0,0,1024,26,6546762018
4757,48034529,38364,48072893,7,0,1,6144,18,1847258112
4758,48040489,582244,48622733,6,0,0,2560,8,1288172506
4759,48040640,678206,48718846,4,0,0,13824,14,8531072962
4760,48043540,2733231,50776771,8,0,0,2048,26,5570284697
4761,48053251,19828,48073079,4,0,1,1536,14,3603026933
4762,48057889,1569165,49627054,6,0,0,23552,8,3962358900
4763,48060841,12253,48073094,4,0,1,1024,14,6733455621
4764,48068029,7068,48075097,7,0,1,2048,18,1909550337
4765,48069130,15096,48084226,5,0,1,16896,15,768696056
4766,48092230,24629,48116859,1,0,1,13312,2,4613101273
4767,48092930,254256,48347186,4,0,0,31232,14,3724529154
4768,48100240,1692490,49792730,4,0,0,23552,14,6655011726
4769,48114100,4065,48118165,5,0,1,2048,15,4624293897
4770,48119469,1031545,49151014,6,0,0,1024,8,9861774508
4771,48138740,3898,48142638,0,0,1,4096,25,3880038789
4772,48142630,3898,48146528,1,0,1,4096,2,7445590372
4773,48146761,6128,48152889,4,0,1,5120,14,7051715841
4774,48150539,3837,48154376,7,0,1,1536,18,1371186636
4775,48155571,2716341,50871912,0,0,0,121344,25,343475789
4776,48161210,1523502,49684712,8,0,0,56832,26,1448674174
4777,48161421,395308,48556729,1,0,0,1024,2,124361793
4778,48171640,463503,48635143,2,0,0,10240,9,3017711917
4779,48211510,1537853,49749363,8,0,0,16384,26,8629299799
4780,48218241,115028,48333269,2,0,1,5632,9,5862222186
4781,48228860,105843,48334703,5,0,1,5120,15,1909220325
4782,48229770,104948,48334718,1,0,1,6144,2,8820518920
4783,48233701,103855,48337556,4,0,1,7168,14,7500632992
4784,48235060,102511,48337571,1,0,1,7168,2,3299669776
4785,48236829,100773,48337602,7,0,1,19968,18,819091142
4786,48239430,98195,48337625,5,0,1,15872,15,473059937
4787,48246220,1796134,50042354,2,0,0,79360,9,2039184685
4788,48254801,82839,48337640,4,0,1,512,14,5803293184
4789,48258721,1279845,49538566,0,0,0,92672,25,445908233
4790,48260740,76915,48337655,1,0,1,1536,2,1014936647
4791,48272379,2938159,51210538,6,0,0,107520,8,511119939
4792,48286351,166390,48452741,1,0,0,1536,2,8021595423
4793,48286609,1637851,49924460,6,0,0,57856,8,1597231617
4794,48287840,78596,48366436,5,0,1,4096,15,7218177884
4795,48288899,2795830,51084729,6,0,0,66560,8,1273283192
4796,48291041,1003520,49294561,1,0,0,512,2,2019008089
4797,48311160,76132,48387292,5,0,1,9216,15,1505102346
4798,48316451,71839,48388290,2,0,1,7168,9,3999094339
4799,48320731,71783,48392514,2,0,1,5632,9,5140694811
4800,48322580,71560,48394140,5,0,1,2560,15,3312147541
4801,48352780,42666,48395446,5,0,1,2048,15,4509862777
4802,48353049,42743,48395792,7,0,1,512,18,9563092464
4803,48357449,700342,49057791,6,0,0,3584,8,5882318384
4804,48363020,1256819,49619839,4,0,0,37888,14,1503328442
4805,48368290,3004979,51373269,8,0,0,2560,26,1192262279
4806,48369640,44697,48414337,5,0,1,16896,15,4879220880
4807,48373910,40442,48414352,1,0,1,9728,2,4215368368
4808,48374730,39637,48414367,6,0,1,1024,8,9452178278
4809,48376140,38250,48414390,5,0,1,2048,15,9230836674
4810,48376951,833645,49210596,1,0,0,512,2,4062386472
4811,48397580,30858,48428438,6,0,1,27136,8,5074289473
4812,48402249,1825535,50227784,6,0,0,177664,8,1627142094
4813,48405211,24853,48430064,2,0,1,2560,9,9143085364
4814,48411221,29912,48441133,4,0,1,7168,14,3193790734
4815,48423900,17248,48441148,5,0,1,512,15,2188303407
4816,48437630,1283244,49720874,4,0,0,29696,14,4701555544
4817,48437681,3033939,51471620,0,0,0,104448,25,3469821654
4818,48453071,1085690,49538761,1,0,0,512,2,146511729
4819,48456900,1351910,49808810,2,0,0,2048,9,6321901170
4820,48471430,4850,48476280,5,0,1,5120,15,6579476769
4821,48471681,840154,49311835,1,0,0,1024,2,1011088229
4822,48482710,6278,48488988,1,0,1,6656,2,9530851706
4823,48482950,6384,48489334,6,0,1,512,8,424449044
4824,48485320,5000,48490320,3,0,1,1536,29,9134682994
4825,48496700,1904086,50400786,4,0,0,35328,14,3640450417
4826,48507200,11125,48518325,1,0,1,11776,2,2105892673
4827,48539541,3904,48543445,4,0,1,10752,14,4381896902
4828,48551160,3898,48555058,0,0,1,4096,25,9886250535
4829,48562700,2218618,50781318,2,0,0,14848,9,2243816381
4830,48564430,1424314,49988744,4,0,0,107520,14,9548378954
4831,48593121,4850,48597971,4,0,1,5120,14,6778879545
4832,48593479,2907546,51501025,6,0,0,65024,8,3694402308
4833,48603980,700806,49304786,8,0,0,4608,26,4801663239
4834,48608371,1994,48610365,4,0,1,2048,14,1405758070
4835,48610580,6253,48616833,6,0,1,3072,8,4507054936
4836,48615491,840349,49455840,1,0,0,512,2,3991395800
4837,48622540,573579,49196119,4,0,0,20480,14,5789549077
4838,48623390,1994,48625384,5,0,1,2048,15,606175637
4839,48629101,1120589,49749690,1,0,0,1024,2,1399759307
4840,48629720,5438,48635158,5,0,1,3584,15,5947433026
4841,48630270,26887,48657157,6,0,1,16896,8,6426812405
4842,48639659,17513,48657172,6,0,1,12288,8,8115022470
4843,48649090,1499128,50148218,4,0,0,75264,14,1786081056
4844,48652319,1015054,49667373,6,0,0,37888,8,7100331497
4845,48654549,15454,48670003,6,0,1,3072,8,3634683362
4846,48668150,735729,49403879,2,0,0,22528,9,7085335585
4847,48674800,1708593,50383393,2,0,0,92160,9,3952667320
4848,48686121,2186632,50872753,1,0,0,2048,2,1623809709
4849,48688061,477026,49165087,1,0,0,3584,2,8798334012
4850,48691920,1164483,49856403,8,0,0,4608,26,5864564724
4851,48702680,1777368,50480048,8,0,0,75776,26,1209234509
4852,48719670,4162,48723832,5,0,1,11264,15,6831022156
4853,48744680,4958,48749638,0,0,1,9216,25,7168854215
4854,48767090,1310310,50077400,2,0,0,11776,9,9778563455
4855,48771571,12915,48784486,4,0,1,4608,14,6676470103
4856,48776020,2149972,50925992,8,0,0,5632,26,3026369440
4857,48789440,513895,49303335,2,0,0,9728,9,2980172016
4858,48792729,11016,48803745,6,0,1,17920,8,9536501053
4859,48807881,410668,49218549,1,0,0,1024,2,4432002804
4860,48812380,2870,48815250,3,0,1,8704,29,2141061397
4861,48814281,870642,49684923,1,0,0,512,2,831173460
4862,48826270,665296,49491566,8,0,0,45056,26,9354543336
4863,48829189,360643,49189832,6,0,0,14848,8,3725463008
4864,48831191,1000282,49831473,0,0,0,34816,25,1099661055
4865,48832470,15484,48847954,3,0,1,1024,29,6981034637
4866,48837221,268716,49105937,1,0,0,1024,2,5360924103
4867,48837479,607704,49445183,6,0,0,512,8,2437048720
4868,48847510,907827,49755337,2,0,0,18432,9,1126611766
4869,48854571,2085365,50939936,1,0,0,3584,2,454039228
4870,48866180,3645,48869825,3,0,1,10240,29,295191053
4871,48867480,3011,48870491,3,0,1,1024,29,8414152313
4872,48873460,1366547,50240007,4,0,0,35328,14,8558218779
4873,48874080,1649929,50524009,8,0,0,17408,26,2010449746
4874,48879950,61549,48941499,3,0,1,30208,29,1285588455
4875,48891081,53964,48945045,4,0,1,5632,14,8813063720
4876,48891541,1336422,50227963,1,0,0,512,2,6756909667
4877,48898409,1694594,50593003,6,0,0,20992,8,6196851580
4878,48933371,12340,48945711,4,0,1,1024,14,4014664202
4879,48948050,346340,49294390,4,0,0,10752,14,1773602871
4880,48968221,6278,48974499,4,0,1,6656,14,6129196054
4881,48980599,1270975,50251574,6,0,0,37888,8,8369426564
4882,48995720,3898,48999618,3,0,1,4096,29,5110768442
4883,49006531,503784,49510315,0,0,0,5120,25,8944985364
4884,49008740,1381243,50389983,2,0,0,20992,9,304307761
4885,49016631,23088,49039719,4,0,1,19456,14,863149150
4886,49019340,873236,49892576,2,0,0,14336,9,10346096818
4887,49019430,757685,49777115,8,0,0,1024,26,4631453989
4888,49029500,11280,49040780,0,0,1,1024,25,3572681541
4889,49041031,2572010,51613041,2,0,0,76288,9,7312787812
4890,49047121,1518,49048639,4,0,1,1536,14,3689198246
4891,49048311,886964,49935275,0,0,0,8704,25,731332380
4892,49060710,4374,49065084,3,0,1,4608,29,5919317330
4893,49061731,416092,49477823,2,0,0,20992,9,3078322767
4894,49137110,4420,49141530,3,0,1,11776,29,9266181809
4895,49148821,1004429,50153250,0,0,0,10240,25,3475882693
4896,49149870,5971,49155841,5,0,1,14848,15,5045426392
4897,49166729,2536226,51702955,6,0,0,94720,8,9818386040
4898,49176950,2146486,51323436,8,0,0,56832,26,6907864490
4899,49180909,875982,50056891,6,0,0,7680,8,249565976
4900,49187010,2594975,51781985,8,0,0,88064,26,7409265900
4901,49188259,1586415,50774674,6,0,0,245760,8,4141660815
4902,49202389,1994,49204383,9,0,1,2048,17,6956268915
4903,49207010,230759,49437769,8,0,0,7168,26,4220761600
4904,49211681,226423,49438104,1,0,0,1024,2,231841776
4905,49214871,4374,49219245,4,0,1,4608,14,6194309550
4906,49217950,3898,49221848,0,0,1,4096,25,839971091
4907,49243160,68100,49311260,0,0,1,9728,25,7942347295
4908,49258969,1665284,50924253,6,0,0,65024,8,4962054721
4909,49261330,2592431,51853761,4,0,0,116224,14,1257226698
4910,49266460,44815,49311275,5,0,1,1536,15,5506210982
4911,49278081,34050,49312131,4,0,1,10752,14,710986868
4912,49297121,800745,50097866,2,0,0,14848,9,2107179181
4913,49302930,9547,49312477,0,0,1,512,25,5178854279
4914,49308490,644623,49953113,8,0,0,9728,26,10251749439
4915,49314911,4162,49319073,2,0,1,11264,9,3741675350
4916,49315799,1263383,50579182,6,0,0,78848,8,6320777699
4917,49318250,569943,49888193,4,0,0,53760,14,676376821
4918,49327729,1818520,51146249,6,0,0,169472,8,3271210105
4919,49340310,1155533,50495843,4,0,0,51712,14,7138162128
4920,49343441,1042,49344483,4,0,1,1024,14,4897312969
4921,49345341,39886,49385227,4,0,1,26624,14,2701624216
4922,49358659,2544068,51902727,6,0,0,3584,8,5468261520
4923,49365930,28777,49394707,0,0,1,2560,25,5515017735
4924,49367480,1571349,50938829,8,0,0,12800,26,542740034
4925,49417070,28128,49445198,5,0,1,6656,15,8794249225
4926,49433941,12666,49446607,4,0,1,3584,14,4346482131
4927,49448219,643659,50091878,6,0,0,8192,8,2066249017
4928,49452361,566,49452927,4,0,1,512,14,3581795239
4929,49469579,1042,49470621,9,0,1,1024,17,3048214761
4930,49471579,21138,49492717,9,0,1,1024,17,9667738043
4931,49481830,1746392,51228222,4,0,0,31232,14,10001593742
4932,49482320,291903,49774223,8,0,0,6656,26,6115990303
4933,49483181,744977,50228158,1,0,0,512,2,4272479517
4934,49484400,13816,49498216,0,0,1,15360,25,8684581522
4935,49488891,9671,49498562,4,0,1,512,14,1231843291
4936,49498960,6754,49505714,5,0,1,7168,15,122812596
4937,49502280,1562154,51064434,4,0,0,61952,14,8157818339
4938,49510441,532084,50042525,2,0,0,512,9,158991642
4939,49512850,95430,49608280,0,0,1,8192,25,5457127422
4940,49522491,1134740,50657231,2,0,0,15872,9,3059421160
4941,49530251,1352780,50883031,2,0,0,4608,9,8058867893
4942,49531320,1863444,51394764,8,0,0,14848,26,5903807112
4943,49537991,1393647,50931638,2,0,0,512,9,7249505185
4944,49543099,88338,49631437,9,0,1,4608,17,7558719606
4945,49557630,74793,49632423,0,0,1,1536,25,673004214
4946,49559751,1589952,51149703,1,0,0,512,2,9015532122
4947,49563510,1023050,50586560,4,0,0,23040,14,906430313
4948,49603220,32749,49635969,5,0,1,5632,15,1312227388
4949,49608230,564899,50173129,4,0,0,25088,14,10626538753
4950,49610270,26685,49636955,0,0,1,1536,25,2360703611
4951,49635489,2772,49638261,9,0,1,2048,17,7522162911
4952,49644520,1784155,51428675,8,0,0,42496,26,5959551165
4953,49648310,2470,49650780,5,0,1,2560,15,5716473827
4954,49651060,1721414,51372474,4,0,0,130048,14,3145444561
4955,49655819,34754,49690573,9,0,1,6144,17,4572203852
4956,49661979,35688,49697667,9,0,1,17920,17,7386399694
4957,49664410,37443,49701853,0,0,1,6656,25,6508738017
4958,49665060,1003916,50668976,8,0,0,6656,26,7600162415
4959,49665730,37109,49702839,5,0,1,1536,15,6864519035
4960,49690330,14455,49704785,0,0,1,3072,25,4851996740
4961,49693890,1210528,50904418,8,0,0,70144,26,3909276631
4962,49708909,11980,49720889,9,0,1,4096,17,4041004310
4963,49730290,25899,49756189,5,0,1,512,15,87142100
4964,49730860,28306,49759166,0,0,1,9728,25,6434519724
4965,49752809,9095,49761904,9,0,1,9216,17,3506523451
4966,49767509,4471,49771980,9,0,1,1536,17,45409407
4967,49774781,2470,49777251,4,0,1,2560,14,6592809890
4968,49775080,3477,49778557,5,0,1,2048,15,1953271122
4969,49776950,2593,49779543,5,0,1,1536,15,5460992488
4970,49778899,1310,49780209,9,0,1,1024,17,6497029413
4971,49795781,608199,50403980,2,0,0,2560,9,868574592
4972,49799451,818333,50617784,2,0,0,512,9,8026334910
4973,49814801,174590,49989391,1,0,0,2048,2,6406737706
4974,49835701,1249207,51084908,1,0,0,512,2,6017641850
4975,49839651,2870,49842521,4,0,1,8704,14,3243601947
4976,49847640,1301853,51149493,4,0,0,10240,14,2493199785
4977,49887481,7081,49894562,4,0,1,2048,14,6407503895
4978,49902379,365525,50267904,6,0,0,17408,8,2717103289
4979,49943611,552575,50496186,1,0,0,1024,2,10679194254
4980,49957649,1295893,51253542,6,0,0,58880,8,4178150933
4981,49963710,1295775,51259485,4,0,0,19456,14,8059918913
4982,50014281,242873,50257154,1,0,0,1024,2,5261699998
4983,50055360,499767,50555127,8,0,0,96256,26,7023496878
4984,50064739,343537,50408276,6,0,0,1536,8,4434384284
4985,50078231,1909137,51987368,2,0,0,1024,9,9164139151
4986,50078271,4375,50082646,4,0,1,4608,14,6042415441
4987,50085620,524748,50610368,8,0,0,18944,26,9807875330
4988,50091861,505092,50596953,2,0,0,512,9,4093047374
4989,50107041,6229,50113270,4,0,1,15360,14,9659388318
4990,50125309,541453,50666762,6,0,0,31232,8,4088825547
4991,50141241,315393,50456634,2,0,0,512,9,7276057799
4992,50142311,10954,50153265,4,0,1,11264,14,4828065925
4993,50160131,223433,50383564,2,0,0,512,9,2780631721
4994,50161820,566,50162386,8,0,1,512,26,9294843080
4995,50184781,649107,50833888,1,0,0,1536,2,10551103204
4996,50209629,1303282,51512911,6,0,0,38912,8,7613572382
4997,50212851,38738,50251589,4,0,1,6656,14,2651514553
4998,50221180,1948638,52169818,8,0,0,190464,26,3515093773
4999,50232791,19348,50252139,4,0,1,512,14,3614402141
5000,50237990,588907,50826897,8,0,0,15360,26,4694997274
5001,50248801,330716,50579517,2,0,0,1024,9,2299122954
5002,50256711,410222,50666933,2,0,0,512,9,8428062643
5003,50257470,394910,50652380,8,0,0,59392,26,6052868165
5004,50273649,1264440,51538089,6,0,0,59392,8,5409145018
5005,50317390,368860,50686250,8,0,0,17408,26,2163460547
5006,50341591,64116,50405707,4,0,1,12800,14,2163330091
5007,50361281,44772,50406053,2,0,1,512,9,156242086
5008,50365351,851764,51217115,2,0,0,1024,9,204347908
5009,50373639,932123,51305762,6,0,0,82432,8,9838911657
5010,50379241,1015734,51394975,1,0,0,512,2,6909899109
5011,50389810,624079,51013889,8,0,0,28160,26,7169621598
5012,50401391,14008,50415399,4,0,1,16896,14,7145674845
5013,50415690,629853,51045543,4,0,0,33280,14,2252973567
5014,50457961,43167,50501128,4,0,1,5632,14,47454533
5015,50459160,316956,50776116,4,0,0,4096,14,6292952183
5016,50469250,33504,50502754,1,0,1,2560,2,9416279763
5017,50482161,20939,50503100,2,0,1,512,9,7514498815
5018,50495221,279632,50774853,1,0,0,512,2,2960010377
5019,50498831,478939,50977770,1,0,0,1024,2,8421748426
5020,50503001,369105,50872106,2,0,0,512,9,2888527143
5021,50504651,566,50505217,2,0,1,512,9,3921622577
5022,50516831,892470,51409301,1,0,0,512,2,2572406790
5023,50527131,65911,50593042,2,0,1,2048,9,1327464654
5024,50530420,62637,50593057,4,0,1,1024,14,9834556222
5025,50536311,877986,51414297,2,0,0,1024,9,1085202043
5026,50551689,375901,50927590,6,0,0,5120,8,126466274
5027,50558399,1635372,52193771,6,0,0,1536,8,1222924950
5028,50560699,983957,51544656,6,0,0,21504,8,8413029917
5029,50569791,27177,50596968,2,0,1,4096,9,2368536265
5030,50570891,28646,50599537,2,0,1,4096,9,2414361192
5031,50578750,24973,50603723,4,0,1,6656,14,7062478569
5032,50594991,8988,50603979,2,0,1,9216,9,6261637334
5033,50609900,605809,51215709,4,0,0,16896,14,2852144693
5034,50621549,854953,51476502,6,0,0,12800,8,5705898602
5035,50622141,7706,50629847,2,0,1,8192,9,1141051034
5036,50660129,969947,51630076,6,0,0,55808,8,6396559621
5037,50720251,61082,50781333,2,0,1,2048,9,9262455811
5038,50744319,536312,51280631,6,0,0,37888,8,7420234723
5039,50761111,785804,51546915,1,0,0,1536,2,9032200885
5040,50784151,300944,51085095,1,0,0,512,2,4326370652
5041,50784829,604078,51388907,6,0,0,51200,8,9434633457
5042,50793000,566,50793566,4,0,1,512,14,9250801066
5043,50793271,466876,51260147,2,0,0,512,9,6136728369
5044,50816589,936342,51752931,6,0,0,82944,8,777543885
5045,50832719,39208,50871927,7,0,1,5120,18,4078836828
5046,50845740,28966,50874706,3,0,1,2048,29,7106532440
5047,50848961,27051,50876012,2,0,1,2048,9,691843708
5048,50885949,40066,50926015,7,0,1,1024,18,2275005402
5049,50911129,19366,50930495,7,0,1,3072,18,9180084313
5050,50948999,28414,50977413,7,0,1,8192,18,598445221
5051,50949721,703265,51652986,1,0,0,2048,2,10704876465
5052,50950750,26678,50977428,1,0,1,2560,2,2799723624
5053,50952179,25264,50977443,9,0,1,512,17,5483134881
5054,50952981,306987,51259968,1,0,0,1536,2,720736062
5055,50994819,566,50995385,7,0,1,512,18,7839872584
5056,51002510,170262,51172772,4,0,0,2048,14,7623488970
5057,51008349,166085,51174434,6,0,0,1536,8,6607523901
5058,51010449,251741,51262190,6,0,0,6656,8,2766911674
5059,51024521,3898,51028419,2,0,1,4096,9,1817570031
5060,51025219,1431345,52456564,6,0,0,44032,8,1024400956
5061,51061530,271281,51332811,4,0,0,30720,14,10204403926
5062,51067070,21406,51088476,5,0,1,3584,15,802109577
5063,51069780,1489633,52559413,4,0,0,74240,14,8440762921
5064,51090209,349572,51439781,6,0,0,36352,8,10705866942
5065,51096199,53333,51149532,7,0,1,1536,18,6645946617
5066,51096501,376078,51472579,2,0,0,3072,9,5415128450
5067,51096519,998349,52094868,6,0,0,18432,8,9393442346
5068,51099721,206376,51306097,1,0,0,1024,2,828475440
5069,51101120,50802,51151922,4,0,1,2560,14,7089608723
5070,51104891,285311,51390202,2,0,0,4096,9,3306037944
5071,51110831,123271,51234102,2,0,0,1024,9,4548305764
5072,51141920,12268,51154188,4,0,1,3584,14,836157524
5073,51147141,331888,51479029,2,0,0,8192,9,1444122995
5074,51184550,33162,51217712,3,0,1,2048,29,2194019303
5075,51204760,23477,51228237,3,0,1,2048,29,215469468
5076,51205659,194150,51399809,6,0,0,512,8,10433758181
5077,51210559,17693,51228252,7,0,1,4096,18,3577529330
5078,51225669,189579,51415248,6,0,0,3072,8,3352156651
5079,51231389,961891,52193280,6,0,0,76800,8,4568401852
5080,51242729,21414,51264143,7,0,1,2048,18,3251491271
5081,51296799,76493,51373292,7,0,1,4608,18,751397538
5082,51303239,1350608,52653847,6,0,0,89600,8,502018716
5083,51319380,946197,52265577,4,0,0,29184,14,4481542155
5084,51320069,70148,51390217,7,0,1,1536,18,7294496082
5085,51347819,47971,51395790,7,0,1,1024,18,9260159284
5086,51353940,44542,51398482,4,0,1,3584,14,4743366567
5087,51363440,38268,51401708,4,0,1,5120,14,9260199236
5088,51363720,40894,51404614,4,0,1,4608,14,8132014248
5089,51376470,1454017,52830487,4,0,0,107520,14,9376974472
5090,51385579,324099,51709678,6,0,0,22016,8,8786654619
5091,51392931,696298,52089229,2,0,0,86528,9,5873312943
5092,51400499,5421,51405920,7,0,1,2048,18,520556077
5093,51412950,342180,51755130,4,0,0,7168,14,4464134501
5094,51413709,14981,51428690,7,0,1,8192,18,10567078270
5095,51433540,67500,51501040,4,0,1,7680,14,7437367702
5096,51463111,330397,51793508,0,0,0,13312,25,7412737788
5097,51471170,41756,51512926,4,0,1,5632,14,3035153208
5098,51496009,314204,51810213,6,0,0,7680,8,3341568569
5099,51509759,9479,51519238,7,0,1,6656,18,4121828033
5100,51510481,367159,51877640,1,0,0,512,2,9484216690
5101,51515719,460474,51976193,6,0,0,75264,8,2320523499
5102,51525400,20833,51546233,4,0,1,1536,14,7984341574
5103,51533481,443218,51976699,1,0,0,512,2,1886846267
5104,51537541,1335837,52873378,2,0,0,5120,9,8083144309
5105,51543951,333510,51877461,2,0,0,27648,9,4894053746
5106,51554889,1518,51556407,7,0,1,1536,18,9560986278
5107,51559649,1994,51561643,7,0,1,2048,18,1566872327
5108,51565289,5326,51570615,7,0,1,5632,18,3164889724
5109,51590081,290569,51880650,1,0,0,1024,2,4152808003
5110,51610760,500979,52111739,4,0,0,55296,14,3253578217
5111,51707801,183238,51891039,1,0,0,512,2,6575960190
5112,51715661,260867,51976528,1,0,0,1024,2,6335517225
5113,51745620,38819,51784439,4,0,1,2560,14,3757302697
5114,51752159,499418,52251577,6,0,0,107520,8,1660640030
5115,51794389,424357,52218746,6,0,0,81920,8,835392742
5116,51830110,458403,52288513,4,0,0,15360,14,5930490891
5117,51851271,419781,52271052,2,0,0,17920,9,6362317592
5118,51853599,7910,51861509,9,0,1,8192,17,113682544
5119,51859300,480454,52339754,4,0,0,7168,14,8536220702
5120,51871001,412809,52283810,2,0,0,20480,9,6377238061
5121,51883730,5802,51889532,8,0,1,6144,26,1169053644
5122,51914629,670717,52585346,6,0,0,54784,8,6745379265
5123,51925720,1518,51927238,4,0,1,1536,14,5749994900
5124,51929891,394599,52324490,2,0,0,27648,9,4189444363
5125,51947780,4374,51952154,4,0,1,4608,14,10310518763
5126,51958669,297915,52256584,6,0,0,16384,8,1890865274
5127,51966810,11875,51978685,4,0,1,2048,14,6244171240
5128,52008780,352383,52361163,4,0,0,39424,14,2826704569
5129,52016999,566,52017565,9,0,1,512,17,8436029341
5130,52047009,880150,52927159,5,0,0,39424,15,2887293748
5131,52058699,566,52059265,9,0,1,512,17,3859410654
5132,52070900,98949,52169849,8,0,1,3584,26,9999713271
5133,52082601,477311,52559912,1,0,0,1536,2,5697040402
5134,52089560,187919,52277479,4,0,0,20992,14,5512700523
5135,52090249,199847,52290096,6,0,0,5120,8,7755348859
5136,52094739,442031,52536770,6,0,0,31232,8,6873594002
5137,52104551,1091305,53195856,1,0,0,3584,2,475011741
5138,52107880,148767,52256647,4,0,1,2560,14,5033596273
5139,52120090,993925,53114015,4,0,0,198144,14,4858551066
5140,52125339,131323,52256662,9,0,1,2048,17,6370404649
5141,52141590,135920,52277510,0,0,1,512,25,1082284596
5142,52160580,116945,52277525,4,0,1,3584,14,10621380351
5143,52163790,452459,52616249,4,0,0,101376,14,4229188066
5144,52169540,108000,52277540,4,0,1,2560,14,3621841123
5145,52170970,499911,52670881,4,0,0,55808,14,9975861138
5146,52172880,104675,52277555,4,0,1,9728,14,1259025049
5147,52187849,102262,52290111,9,0,1,3584,17,2307004939
5148,52208311,81815,52290126,4,0,1,1024,14,5757763532
5149,52222991,234220,52457211,1,0,0,2048,2,3453793878
5150,52229121,505386,52734507,2,0,0,31744,9,10037570562
5151,52235190,56228,52291418,0,0,1,3072,25,1406747421
5152,52264439,355929,52620368,5,0,0,13312,15,1355709877
5153,52282370,391520,52673890,4,0,0,9728,14,10629597016
5154,52305950,1042,52306992,8,0,1,1024,26,10566952390
5155,52322411,1072297,53394708,2,0,0,47104,9,10100542301
5156,52323130,1943,52325073,4,0,1,512,14,4590985025
5157,52325150,4679,52329829,8,0,1,12288,26,6531471575
5158,52358831,7667,52366498,4,0,1,5632,14,446592304
5159,52359561,911288,53270849,2,0,0,96768,9,10325455766
5160,52364781,507022,52871803,2,0,0,11264,9,3916961552
5161,52371331,370316,52741647,2,0,0,14848,9,6382262024
5162,52372580,566,52373146,8,0,1,512,26,4335949728
5163,52385040,7230,52392270,0,0,1,7680,25,5186306685
5164,52406089,346060,52752149,6,0,0,25600,8,3283155533
5165,52408229,875738,53283967,6,0,0,41472,8,4795911257
5166,52410681,451700,52862381,2,0,0,18432,9,495364239
5167,52427480,613911,53041391,4,0,0,132096,14,3188976240
5168,52435569,21657,52457226,9,0,1,16896,17,7914943671
5169,52443980,14723,52458703,0,0,1,1536,25,7512980852
5170,52470280,1042,52471322,0,0,1,1024,25,993925481
5171,52488919,401152,52890071,6,0,0,19456,8,8431205276
5172,52510230,1042,52511272,0,0,1,1024,25,2042761988
5173,52519020,675729,53194749,4,0,0,117760,14,7112037459
5174,52524369,2470,52526839,9,0,1,2560,17,4933184029
5175,52528639,587155,53115794,5,0,0,5632,15,10181101312
5176,52538949,317785,52856734,5,0,0,86016,15,3569613302
5177,52557071,563262,53120333,2,0,0,14848,9,10411422754
5178,52576789,47486,52624275,9,0,1,4096,17,9593213379
5179,52578750,45745,52624495,0,0,1,8704,25,1113875501
5180,52579679,74183,52653862,7,0,1,5632,18,653273141
5181,52580371,461214,53041585,1,0,0,512,2,7836467059
5182,52583080,285252,52868332,4,0,0,19456,14,2122221800
5183,52585010,85886,52670896,8,0,1,8192,26,8574768917
5184,52596519,74392,52670911,6,0,1,2048,8,6189676721
5185,52596720,77185,52673905,0,0,1,3584,25,7203297373
5186,52641090,495950,53137040,4,0,0,54784,14,7556170307
5187,52649849,507798,53157647,6,0,0,67584,8,2850023944
5188,52675701,377911,53053612,2,0,0,39424,9,8268979188
5189,52676160,6278,52682438,0,0,1,6656,25,185699299
5190,52676630,6154,52682784,0,0,1,512,25,6434042508
5191,52689820,3422,52693242,8,0,1,3584,26,7881341336
5192,52699930,2470,52702400,8,0,1,2560,26,7129376534
5193,52701880,6754,52708634,0,0,1,7168,25,9319735307
5194,52708989,512224,53221213,5,0,0,82944,15,4931668796
5195,52709789,255984,52965773,5,0,0,39936,15,3107451031
5196,52753640,566,52754206,0,0,1,512,25,4901554846
5197,52761179,1994,52763173,9,0,1,2048,17,4263041149
5198,52765180,4850,52770030,8,0,1,5120,26,8991268342
5199,52773820,4850,52778670,5,0,1,5120,15,7263146715
5200,52786061,726514,53512575,2,0,0,39936,9,8292290158
5201,52799851,439816,53239667,2,0,0,60416,9,9971544021
5202,52802130,71287,52873417,4,0,1,1024,14,1913115700
5203,52815101,343208,53158309,1,0,0,1536,2,6933786996
5204,52819751,602959,53422710,2,0,0,80896,9,5124203381
5205,52822721,112632,52935353,1,0,0,2560,2,4942276005
5206,52825239,54401,52879640,6,0,1,6656,8,8662603292
5207,52846599,33707,52880306,9,0,1,1024,17,1264000112
5208,52848221,393121,53241342,1,0,0,512,2,9044963666
5209,52853739,304079,53157818,5,0,0,512,15,419042438
5210,52873401,367715,53241116,2,0,0,4608,9,1760940282
5211,52893130,1994,52895124,8,0,1,2048,26,5845232858
5212,52909020,1042,52910062,8,0,1,1024,26,6413724605
5213,52909170,18004,52927174,0,0,1,15360,25,768089894
5214,52917081,241765,53158846,1,0,0,1536,2,5539052188
5215,52920650,9028,52929678,8,0,1,2560,26,9994257502
5216,52926860,4764,52931624,8,0,1,3072,26,9858527682
5217,52932849,357708,53290557,6,0,0,21504,8,7259446357
5218,52937169,2946,52940115,9,0,1,3072,17,2643800444
5219,52937871,333204,53271075,1,0,0,512,2,2348417311
5220,52944129,566,52944695,6,0,1,512,8,78600562
5221,52953610,362802,53316412,4,0,0,5632,14,10213222247
5222,52986441,349056,53335497,2,0,0,56320,9,3127585180
5223,52995369,319242,53314611,6,0,0,78848,8,6227782805
5224,53001020,40386,53041406,8,0,1,1024,26,7971284787
5225,53006279,152069,53158348,6,0,1,4608,8,414887722
5226,53023649,356692,53380341,5,0,0,11776,15,212250199
5227,53023780,134583,53158363,8,0,1,6656,26,5715481500
5228,53036749,499697,53536446,5,0,0,22016,15,8361477892
5229,53040239,155664,53195903,9,0,1,3072,17,8807839215
5230,53053769,142149,53195918,9,0,1,1024,17,4229392124
5231,53056810,367951,53424761,4,0,0,6656,14,3411632910
5232,53105129,116115,53221244,9,0,1,2560,17,2131711664
5233,53109519,130163,53239682,6,0,1,2560,8,1226361589
5234,53147239,92458,53239697,6,0,1,512,8,7873117806
5235,53155131,287595,53442726,1,0,0,1536,2,1614248052
5236,53175609,65562,53241171,9,0,1,2048,17,569009520
5237,53188979,81925,53270904,9,0,1,2048,17,2967334014
5238,53208719,75271,53283990,6,0,1,4608,8,6970930066
5239,53215011,75561,53290572,2,0,1,1536,9,8286350721
5240,53215059,608032,53823091,5,0,0,76800,15,9491038890
5241,53219971,205117,53425088,1,0,0,1024,2,5487536354
5242,53225661,204051,53429712,1,0,0,512,2,3784411918
5243,53235989,78677,53314666,9,0,1,29184,17,1903741139
5244,53239511,280115,53519626,1,0,0,512,2,10398999091
5245,53242221,72460,53314681,2,0,1,3584,9,9385907707
5246,53267200,229730,53496930,4,0,0,13312,14,819371520
5247,53274290,61222,53335512,8,0,1,2560,26,8390806551
5248,53274819,60708,53335527,9,0,1,9216,17,4336005240
5249,53277571,57971,53335542,2,0,1,11264,9,7934569361
5250,53278210,57347,53335557,8,0,1,11776,26,1196107734
5251,53286349,383088,53669437,6,0,0,56832,8,3171899521
5252,53298819,353271,53652090,6,0,0,110592,8,7045030647
5253,53300760,34828,53335588,8,0,1,6144,26,3204647822
5254,53319521,23283,53342804,2,0,1,7680,9,5498848707
5255,53327159,279410,53606569,5,0,0,76800,15,5046717487
5256,53340579,6091,53346670,6,0,1,6144,8,9410585606
5257,53350419,2470,53352889,9,0,1,2560,17,740071252
5258,53350469,6105,53356574,6,0,1,5632,8,1144734766
5259,53358600,392718,53751318,4,0,0,92160,14,3474574788
5260,53362820,566,53363386,8,0,1,512,26,6772255394
5261,53388100,8594,53396694,8,0,1,2048,26,8730982416
5262,53404369,21294,53425663,9,0,1,512,17,7856831600
5263,53419859,10720,53430579,9,0,1,5632,17,167531363
5264,53421720,482659,53904379,4,0,0,3584,14,10701887505
5265,53432619,246462,53679081,6,0,0,7680,8,2983296243
5266,53467889,2470,53470359,6,0,1,2560,8,88306578
5267,53482550,673035,54155585,4,0,0,149504,14,7068696903
5268,53507460,6191,53513651,8,0,1,1024,26,5226208839
5269,53507770,12381,53520151,8,0,1,7680,26,5837976139
5270,53507809,14288,53522097,6,0,1,3072,8,5955578322
5271,53518599,8644,53527243,7,0,1,8192,18,10641899699
5272,53527689,427772,53955461,5,0,0,2048,15,5446860363
5273,53540309,492615,54032924,6,0,0,201216,8,8835556689
5274,53542089,527638,54069727,5,0,0,70144,15,5411260648
5275,53555089,4850,53559939,6,0,1,5120,8,4589798729
5276,53555839,4446,53560285,7,0,1,512,18,5755056833
5277,53566081,543937,54110018,1,0,0,1024,2,2886117274
5278,53576429,1994,53578423,9,0,1,2048,17,5226970008
5279,53589989,20259,53610248,7,0,1,10240,18,450427412
5280,53594649,18202,53612851,6,0,1,9216,8,544168373
5281,53603709,620475,54224184,6,0,0,174592,8,5682191193
5282,53622619,48796,53671415,6,0,1,2048,8,7180453956
5283,53629121,194180,53823301,1,0,0,512,2,7177348890
5284,53633019,403376,54036395,6,0,0,11264,8,9705501884
5285,53680679,3645,53684324,9,0,1,10240,17,9401004563
5286,53715030,1518,53716548,8,0,1,1536,26,1868514426
5287,53726320,28454,53754774,8,0,1,3584,26,9785405097
5288,53729739,440416,54170155,5,0,0,36864,15,478319530
5289,53733841,436485,54170326,1,0,0,512,2,3682237891
5290,53751559,4521,53756080,7,0,1,2048,18,5845109502
5291,53755079,4850,53759929,6,0,1,5120,8,5584890693
5292,53757090,352553,54109643,4,0,0,110592,14,4996145538
5293,53784589,441498,54226087,5,0,0,6144,15,6120613084
5294,53794430,3128,53797558,3,0,1,9216,29,8668791338
5295,53796439,26683,53823122,9,0,1,21504,17,10077869922
5296,53798419,372554,54170973,5,0,0,2048,15,7451682021
5297,53806549,18705,53825254,7,0,1,2048,18,6296004968
5298,53816510,9090,53825600,4,0,1,512,14,3201853969
5299,53823389,5117,53828506,7,0,1,4608,18,8444705250
5300,53827789,2946,53830735,6,0,1,3072,8,6569301404
5301,53849541,432987,54282528,1,0,0,98816,2,9935355394
5302,53851769,448680,54300449,5,0,0,58368,15,1834855288
5303,53851879,1994,53853873,6,0,1,2048,8,9336112054
5304,53859239,485967,54345206,6,0,0,17920,8,3712760001
5305,53867830,566,53868396,8,0,1,512,26,8380831692
5306,53870131,382171,54252302,1,0,0,18432,2,9169232034
5307,53878839,280061,54158900,5,0,0,10752,15,2533503320
5308,53879700,3898,53883598,3,0,1,4096,29,5119700451
5309,53894040,5712,53899752,3,0,1,14336,29,1624343359
5310,53897639,2459,53900098,7,0,1,512,18,8698767055
5311,53898770,5802,53904572,8,0,1,6144,26,7209247815
5312,53922261,777157,54699418,1,0,0,105472,2,9743010530
5313,53928069,4850,53932919,6,0,1,5120,8,4800392788
5314,53950930,491075,54442005,4,0,0,71168,14,4729223513
5315,53955940,4850,53960790,8,0,1,5120,26,1246615460
5316,53959419,287228,54246647,6,0,0,67072,8,6773333757
5317,53971679,65266,54036945,6,0,1,512,8,6143856790
5318,53984160,53131,54037291,3,0,1,512,29,2293409428
5319,53989551,346847,54336398,1,0,0,30720,2,7878753470
5320,54028920,440449,54469369,3,0,0,512,29,7246602512
5321,54083670,142432,54226102,8,0,1,5120,26,4947928286
5322,54090219,263797,54354016,5,0,0,16896,15,8944559769
5323,54090590,135527,54226117,5,0,1,512,15,4547375310
5324,54091300,218507,54309807,9,0,0,4608,17,760915328
5325,54096800,129332,54226132,8,0,1,3072,26,9016280969
5326,54099861,635350,54735211,1,0,0,13824,2,9697426639
5327,54117689,473635,54591324,6,0,0,29696,8,7408797733
5328,54132590,119767,54252357,5,0,1,3584,15,4269313928
5329,54141940,140611,54282551,8,0,1,512,26,1238554611
5330,54145890,136692,54282582,5,0,1,5120,15,5906299855
5331,54170181,543799,54713980,1,0,0,25088,2,4348135911
5332,54172210,110387,54282597,3,0,1,2560,29,1694874474
5333,54173550,359254,54532804,3,0,0,1536,29,3006953916
5334,54174570,206895,54381465,3,0,0,1536,29,7986114935
5335,54176570,106050,54282620,8,0,1,6144,26,4503570003
5336,54177310,105325,54282635,3,0,1,1024,29,9225159051
5337,54179050,545994,54725044,4,0,0,27136,14,6105198156
5338,54210780,71870,54282650,3,0,1,2560,29,2846699644
5339,54211840,88624,54300464,5,0,1,1024,15,509646757
5340,54215860,297700,54513560,4,0,0,37376,14,2652537644
5341,54234160,591490,54825650,9,0,0,92672,17,9884778552
5342,54234640,65863,54300503,8,0,1,3072,26,1225560147
5343,54239129,61389,54300518,6,0,1,512,8,2895275517
5344,54243930,365478,54609408,9,0,0,27648,17,5415742896
5345,54250109,54526,54304635,6,0,1,11264,8,3183157635
5346,54260640,283215,54543855,9,0,0,2048,17,5056531692
5347,54270980,435325,54706305,9,0,0,22528,17,3611026202
5348,54281749,576768,54858517,5,0,0,30208,15,10120747783
5349,54287760,549308,54837068,4,0,0,37376,14,6999466169
5350,54287790,19661,54307451,5,0,1,3584,15,10524972738
5351,54288160,21662,54309822,8,0,1,2048,26,4701287997
5352,54298240,11597,54309837,8,0,1,512,26,5336883557
5353,54304010,5842,54309852,3,0,1,512,29,3792825634
5354,54307520,168432,54475952,4,0,0,9728,14,7401930787
5355,54316901,265360,54582261,1,0,0,60416,2,8600425879
5356,54364840,2870,54367710,8,0,1,8704,26,215565310
5357,54366340,278345,54644685,3,0,0,512,29,9620662559
5358,54370540,360444,54730984,4,0,0,16384,14,5158102872
5359,54390599,353690,54744289,5,0,0,29696,15,8331004420
5360,54399019,371524,54770543,6,0,0,79360,8,8196575106
5361,54433499,12402,54445901,6,0,1,10752,8,9224013070
5362,54442770,7506,54450276,5,0,1,12800,15,5034128710
5363,54443130,7492,54450622,3,0,1,512,29,5793822618
5364,54465960,4162,54470122,8,0,1,11264,26,3253531657
5365,54471959,4008,54475967,6,0,1,2048,8,3396233690
5366,54483819,2470,54486289,6,0,1,2560,8,7315238463
5367,54493489,2470,54495959,6,0,1,2560,8,10355171726
5368,54494599,1706,54496305,6,0,1,512,8,6108623968
5369,54506740,342550,54849290,3,0,0,512,29,8740131297
5370,54514560,417296,54931856,9,0,0,89088,17,3609776683
5371,54521380,4850,54526230,8,0,1,5120,26,4511235992
5372,54541310,307793,54849103,9,0,0,39424,17,2228891110
5373,54575911,283268,54859179,1,0,0,512,2,7489093650
5374,54577629,326665,54904294,5,0,0,5120,15,3763657480
5375,54579370,30061,54609431,3,0,1,19456,29,3417509212
5376,54584331,276384,54860715,1,0,0,512,2,7221597446
5377,54602590,14516,54617106,3,0,1,8192,29,8914687927
5378,54618480,271298,54889778,3,0,0,512,29,4051935345
5379,54649239,291251,54940490,5,0,0,23552,15,6231356464
5380,54658100,6754,54664854,3,0,1,7168,29,426519582
5381,54667290,339785,55007075,9,0,0,24064,17,2681683327
5382,54679190,37244,54716434,8,0,1,2560,26,7140605497
5383,54681000,44059,54725059,3,0,1,3072,29,2803712023
5384,54704210,20864,54725074,0,0,1,2560,25,1169245735
5385,54723529,11697,54735226,6,0,1,4096,8,1717856492
5386,54731559,296539,55028098,5,0,0,29696,15,9359475188
5387,54731570,38988,54770558,3,0,1,9216,29,8566559042
5388,54738270,280765,55019035,9,0,0,32768,17,8524291994
5389,54748630,26691,54775321,5,0,1,12288,15,10717055404
5390,54750781,277964,55028745,1,0,0,2048,2,1598160007
5391,54759290,531285,55290575,3,0,0,1536,29,6487185948
5392,54764110,11877,54775987,0,0,1,1024,25,1387059371
5393,54769940,7033,54776973,0,0,1,1536,25,2944720757
5394,54775019,364748,55139767,5,0,0,18432,15,10132457427
5395,54792860,2470,54795330,6,0,1,2560,8,3496912111
5396,54795460,30205,54825665,0,0,1,4096,25,7590683809
5397,54804210,55784,54859994,5,0,1,1536,15,22189300
5398,54805989,371036,55177025,6,0,0,41472,8,5283833037
5399,54823629,388214,55211843,5,0,0,70144,15,6675055365
5400,54829909,360547,55190456,6,0,0,44032,8,3241669142
5401,54840500,20480,54860980,0,0,1,1536,25,9568170871
5402,54851070,11216,54862286,5,0,1,2048,15,7576307577
5403,54851079,376658,55227737,6,0,0,46592,8,280510405
5404,54859740,3532,54863272,5,0,1,1536,15,6564896848
5405,54865280,2470,54867750,0,0,1,2560,25,7178909878
5406,54873780,1042,54874822,0,0,1,1024,25,509143140
5407,54878070,4850,54882920,3,0,1,5120,29,2092508814
5408,54884450,4850,54889300,0,0,1,5120,25,5260359900
5409,54894900,5802,54900702,5,0,1,6144,15,438361332
5410,54897889,208414,55106303,5,0,0,9728,15,9134837375
5411,54908590,23866,54932456,3,0,1,512,29,9430898289
5412,54910780,29725,54940505,3,0,1,2048,29,6627296127
5413,54919100,21420,54940520,5,0,1,512,15,9820454824
5414,54934880,9294,54944174,4,0,1,10240,14,6189842690
5415,54938290,9257,54947547,5,0,1,4096,15,6552253960
5416,54943880,11823,54955703,0,0,1,17408,25,9513091687
5417,54947200,291794,55238994,9,0,0,33280,17,1340765292
5418,54953299,195467,55148766,5,0,0,5632,15,530761110
5419,54967419,389011,55356430,6,0,0,5632,8,6529836213
5420,54971020,5326,54976346,5,0,1,5632,15,4536233777
5421,54982640,1994,54984634,4,0,1,2048,14,4248114301
5422,55005671,116669,55122340,1,0,0,512,2,3311613602
5423,55017320,16321,55033641,4,0,1,12800,14,4950860983
5424,55030480,253273,55283753,4,0,0,69120,14,8836787371
5425,55052690,1518,55054208,3,0,1,1536,29,4531173786
5426,55053140,4917,55058057,4,0,1,5120,14,1776203567
5427,55053320,7003,55060323,4,0,1,3584,14,9728153598
5428,55054950,440726,55495676,9,0,0,164352,17,1235045956
5429,55060060,1994,55062054,5,0,1,2048,15,344144729
5430,55071140,156962,55228102,3,0,0,1024,29,7533138068
5431,55074490,5196,55079686,0,0,1,13312,25,2313618702
5432,55075971,286982,55362953,1,0,0,1024,2,1921186817
5433,55085940,359645,55445585,9,0,0,33792,17,6801355924
5434,55088350,2470,55090820,5,0,1,2560,15,2788080696
5435,55092870,15321,55108191,5,0,1,29696,15,8292759798
5436,55104790,6627,55111417,3,0,1,5120,29,5285189954
5437,55113630,7706,55121336,5,0,1,8192,15,161222065
5438,55146510,4937,55151447,3,0,1,12800,29,5322719319
5439,55148890,7379,55156269,3,0,1,6144,29,3916712969
5440,55156170,1042,55157212,3,0,1,1024,29,4782767238
5441,55186510,26935,55213445,4,0,1,1536,14,2650747351
5442,55189620,195023,55384643,3,0,0,512,29,7371238928
5443,55194180,223929,55418109,9,0,0,16384,17,1777235675
5444,55202850,24910,55227760,4,0,1,2048,14,6007589152
5445,55204640,23135,55227775,3,0,1,2048,29,5389812463
5446,55213410,25599,55239009,4,0,1,1024,14,548323767
5447,55223130,15902,55239032,4,0,1,7168,14,9853207030
5448,55223719,331812,55555531,5,0,0,1024,15,8676696733
5449,55230209,276677,55506886,5,0,0,6144,15,4637366251
5450,55260720,1518,55262238,3,0,1,1536,29,4314846417
5451,55276600,8187,55284787,0,0,1,1024,25,6121675678
5452,55300329,204622,55504951,5,0,0,30208,15,2821738587
5453,55301920,116672,55418592,3,0,0,1536,29,3399380473
5454,55343660,1518,55345178,4,0,1,1536,14,9140762761
5455,55357620,269940,55627560,9,0,0,31744,17,9549193829
5456,55394460,375500,55769960,9,0,0,21504,17,4436004968
5457,55397470,234785,55632255,9,0,0,15360,17,2128134130
5458,55401470,1042,55402512,0,0,1,1024,25,3231289984
5459,55419310,11533,55430843,3,0,1,18944,29,6611166661
5460,55424149,339196,55763345,5,0,0,126976,15,9511298834
5461,55443759,537125,55980884,6,0,0,7168,8,9475916428
5462,55446390,60614,55507004,3,0,1,2048,29,876679704
5463,55450620,57690,55508310,3,0,1,2048,29,502248228
5464,55456730,365691,55822421,3,0,0,1024,29,1545281559
5465,55462570,477236,55939806,9,0,0,58880,17,4807669820
5466,55468949,591680,56060629,5,0,0,12288,15,3297887354
5467,55469299,237096,55706395,6,0,0,25088,8,2900446139
5468,55475460,33196,55508656,3,0,1,512,29,379764118
5469,55478170,30832,55509002,4,0,1,512,14,5203394295
5470,55493530,18058,55511588,0,0,1,4096,25,1121804001
5471,55494960,302543,55797503,3,0,0,1024,29,10429576469
5472,55507330,7484,55514814,3,0,1,5120,29,4564545378
5473,55509420,8620,55518040,3,0,1,5120,29,9515363267
5474,55515440,693823,56209263,9,0,0,94720,17,1291439870
5475,55516860,1846,55518706,4,0,1,1024,14,7989432394
5476,55523660,1994,55525654,4,0,1,2048,14,3869642876
5477,55527820,4420,55532240,6,0,1,11776,8,7528763122
5478,55543290,637066,56180356,9,0,0,197120,17,4770203188
5479,55543629,365876,55909505,5,0,0,84480,15,9061508158
5480,55553660,1994,55555654,3,0,1,2048,29,2164952429
5481,55566710,411477,55978187,9,0,0,81920,17,2583276849
5482,55570840,1042,55571882,0,0,1,1024,25,5047604842
5483,55576030,3422,55579452,0,0,1,3584,25,10247318446
5484,55605050,6754,55611804,0,0,1,7168,25,7489189848
5485,55611340,5971,55617311,3,0,1,14848,29,10111811760
5486,55615329,437259,56052588,5,0,0,5632,15,4119252102
5487,55624950,318163,55943113,9,0,0,10752,17,6084592045
5488,55644469,2470,55646939,7,0,1,2560,18,10490237981
5489,55645630,2295,55647925,3,0,1,1536,29,5717914484
5490,55653260,325410,55978670,3,0,0,1536,29,6522481068
5491,55669620,275692,55945312,9,0,0,7168,17,10071582455
5492,55678980,5802,55684782,0,0,1,6144,25,9683107544
5493,55703179,279436,55982615,5,0,0,5632,15,3755020099
5494,55709599,530347,56239946,6,0,0,35840,8,5287150740
5495,55716430,559537,56275967,9,0,0,95232,17,1922066503
5496,55725849,588083,56313932,5,0,0,50688,15,7164189050
5497,55732820,306393,56039213,3,0,0,512,29,5654995731
5498,55736519,35394,55771913,6,0,1,2048,8,9583233059
5499,55737089,36130,55773219,7,0,1,2048,18,6275647136
5500,55746609,36866,55783475,7,0,1,20480,18,4686177838
5501,55747990,39031,55787021,3,0,1,5632,29,7095589972
5502,55769520,18167,55787687,3,0,1,1024,29,3847017120
5503,55782409,5944,55788353,7,0,1,1024,18,2461741855
5504,55783650,5049,55788699,4,0,1,512,14,10564425278
5505,55788600,2946,55791546,3,0,1,3072,29,9571599693
5506,55790559,431292,56221851,5,0,0,11264,15,1879716939
5507,55791060,282268,56073328,9,0,0,7168,17,826829732
5508,55802140,1042,55803182,4,0,1,1024,14,5452248726
5509,55807010,242351,56049361,3,0,0,512,29,8683317872
5510,55808570,2946,55811516,3,0,1,3072,29,9316599151
5511,55810760,533821,56344581,9,0,0,53248,17,369648817
5512,55823240,566,55823806,0,0,1,512,25,5674195111
5513,55829099,611878,56440977,6,0,0,72192,8,7195200914
5514,55838510,371252,56209762,3,0,0,1536,29,7773618873
5515,55853400,3422,55856822,4,0,1,3584,14,4130983138
5516,55860470,1518,55861988,3,0,1,1536,29,8456008323
5517,55870749,507504,56378253,5,0,0,27648,15,489303493
5518,55874120,2946,55877066,4,0,1,3072,14,3724758282
5519,55912660,7230,55919890,3,0,1,7680,29,10543242239
5520,55920769,177227,56097996,5,0,0,4608,15,5581876226
5521,55923669,404171,56327840,6,0,0,39424,8,9419009055
5522,55927699,18188,55945887,7,0,1,512,18,10263678092
5523,55932440,16165,55948605,4,0,1,9216,14,4147206141
5524,55938720,590706,56529426,3,0,0,1536,29,952194245
5525,55948500,2946,55951446,3,0,1,3072,29,3929915270
5526,55952900,25785,55978685,3,0,1,1024,29,2910342177
5527,55983830,374338,56358168,9,0,0,44544,17,6109639355
5528,56000660,4850,56005510,3,0,1,5120,29,10249309776
5529,56001370,6661,56008031,3,0,1,14336,29,6892886896
5530,56001771,10718,56012489,2,0,1,6144,9,4971723636
5531,56001900,216465,56218365,9,0,0,28160,17,7438395078
5532,56022350,2470,56024820,8,0,1,2560,26,5770106005
5533,56023931,4850,56028781,2,0,1,5120,9,3392719600
5534,56041870,1042,56042912,3,0,1,1024,29,6175221849
5535,56054040,234937,56288977,9,0,0,22528,17,7124024805
5536,56056390,7706,56064096,8,0,1,8192,26,653247452
5537,56057429,219201,56276630,6,0,0,2048,8,10331253419
5538,56068820,1518,56070338,4,0,1,1536,14,549851852
5539,56070199,409379,56479578,5,0,0,62464,15,7293079326
5540,56090980,4679,56095659,4,0,1,12288,14,5207548701
5541,56111180,1518,56112698,3,0,1,1536,29,2376117833
5542,56138050,601168,56739218,9,0,0,46080,17,5687804901
5543,56138630,302690,56441320,3,0,0,1024,29,1068859513
5544,56163380,297097,56460477,9,0,0,59392,17,3878245157
5545,56166821,51575,56218396,2,0,1,6144,9,1837331479
5546,56189950,36105,56226055,3,0,1,8192,29,4947078451
5547,56203419,320174,56523593,6,0,0,45568,8,5488114096
5548,56209000,317892,56526892,9,0,0,10752,17,9983673955
5549,56215559,509596,56725155,6,0,0,53760,8,4944483522
5550,56231400,250245,56481645,9,0,0,6656,17,8355705495
5551,56256579,32413,56288992,6,0,1,15360,8,5647215412
5552,56257079,31944,56289023,6,0,1,8192,8,8944092370
5553,56262681,29840,56292521,2,0,1,5632,9,1477602872
5554,56284350,9477,56293827,8,0,1,2048,26,6309792142
5555,56288240,5946,56294186,4,0,1,9728,14,9894712715
5556,56291820,6628,56298448,3,0,1,6144,29,2317404100
5557,56308710,276259,56584969,3,0,0,1536,29,4034287883
5558,56326610,31597,56358207,8,0,1,17920,26,9341113064
5559,56330150,34889,56365039,3,0,1,7168,29,6682646968
5560,56332549,424327,56756876,6,0,0,57856,8,5141488518
5561,56338320,29945,56368265,3,0,1,5120,29,3684314493
5562,56345119,33149,56378268,6,0,1,3584,8,6824882388
5563,56355969,172974,56528943,6,0,0,6656,8,8469239119
5564,56357030,21261,56378291,3,0,1,16896,29,2475577372
5565,56362150,16156,56378306,5,0,1,2048,15,5921313035
5566,56370919,399092,56770011,5,0,0,43008,15,4433052518
5567,56387199,1518,56388717,6,0,1,1536,8,151605086
5568,56397199,181347,56578546,6,0,0,11776,8,7063929670
5569,56411450,358732,56770182,3,0,0,512,29,9551862361
5570,56414311,1042,56415353,2,0,1,1024,9,1475127860
5571,56417009,422499,56839508,6,0,0,84992,8,2224615993
5572,56430031,30461,56460492,2,0,1,10240,9,6174919848
5573,56436740,23767,56460507,4,0,1,2560,14,6101775322
5574,56450091,33091,56483182,2,0,1,10240,9,5464192725
5575,56452069,347776,56799845,6,0,0,97280,8,3509120207
5576,56458370,27932,56486302,4,0,1,10240,14,192327940
5577,56460689,29035,56489724,6,0,1,4096,8,7534625929
5578,56483901,7885,56491786,4,0,1,12288,14,8228788035
5579,56509339,479080,56988419,5,0,0,104448,15,3396968973
5580,56510821,25393,56536214,2,0,1,7168,9,5810651215
5581,56517150,117068,56634218,3,0,0,1024,29,6162103034
5582,56521321,16519,56537840,2,0,1,2560,9,3546637223
5583,56522160,467140,56989300,3,0,0,2048,29,5880931124
5584,56523120,330644,56853764,9,0,0,46592,17,5216806635
5585,56534091,6015,56540106,2,0,1,3584,9,3724127977
5586,56537010,338520,56875530,9,0,0,18944,17,9584787657
5587,56546069,351408,56897477,6,0,0,44032,8,3975207920
5588,56551441,2946,56554387,2,0,1,3072,9,97342093
5589,56552361,4744,56557105,2,0,1,12288,9,8991955087
5590,56604250,423686,57027936,3,0,0,512,29,733239634
5591,56616380,6229,56622609,8,0,1,15360,26,5465979665
5592,56631851,1518,56633369,4,0,1,1536,14,6374036823
5593,56652131,15062,56667193,4,0,1,29184,14,9488758588
5594,56655180,14279,56669459,6,0,1,3584,8,1914499740
5595,56657300,16665,56673965,6,0,1,7168,8,8717393980
5596,56659121,16150,56675271,2,0,1,2048,9,9519369968
5597,56660020,16019,56676039,6,0,1,11776,8,9087723546
5598,56661510,14888,56676398,8,0,1,9728,26,6147335786
5599,56663241,13823,56677064,2,0,1,1024,9,8905767588
5600,56666900,14350,56681250,3,0,1,6656,29,3621834053
5601,56677579,237976,56915555,6,0,0,26624,8,165130047
5602,56690220,188688,56878908,3,0,0,1536,29,3712174747
5603,56694211,3128,56697339,4,0,1,9216,14,621015051
5604,56697159,242628,56939787,5,0,0,5120,15,4410017399
5605,56701061,38172,56739233,2,0,1,23552,9,1631219895
5606,56708980,90888,56799868,3,0,1,5120,29,9658592406
5607,56733261,77559,56810820,4,0,1,17920,14,9476873590
5608,56748980,239626,56988606,3,0,0,512,29,2188933562
5609,56778469,321102,57099571,5,0,0,26624,15,9858476097
5610,56779680,33086,56812766,6,0,1,3072,8,6232918514
5611,56780501,32611,56813112,2,0,1,512,9,4002504777
5612,56783880,55643,56839523,5,0,1,1536,15,7898413962
5613,56793840,45698,56839538,5,0,1,1536,15,329240215
5614,56798970,40583,56839553,5,0,1,5632,15,658613143
5615,56799531,54248,56853779,2,0,1,4608,9,6135667433
5616,56822211,36281,56858492,2,0,1,12288,9,2024309845
5617,56824350,36153,56860503,3,0,1,3072,29,240275795
5618,56841309,419277,57260586,6,0,0,38912,8,5909543109
5619,56856730,4439,56861169,8,0,1,1024,26,904881253
5620,56857850,3665,56861515,5,0,1,512,15,4951500331
5621,56859449,349799,57209248,5,0,0,14848,15,2831651960
5622,56873990,193045,57067035,3,0,0,512,29,10664540333
5623,56875779,5802,56881581,9,0,1,6144,17,842008419
5624,56877971,5876,56883847,4,0,1,3584,14,10201496387
5625,56883379,183477,57066856,5,0,0,28672,15,8373419827
5626,56885389,158237,57043626,5,0,0,3584,15,5535747733
5627,56900100,1518,56901618,3,0,1,1536,29,2718554977
5628,56912340,6594,56918934,5,0,1,9728,15,3800522717
5629,56918310,1292,56919602,8,0,1,1024,26,6435241546
5630,56934680,2470,56937150,3,0,1,2560,29,8359588391
5631,56941011,2946,56943957,4,0,1,3072,14,8945401598
5632,56947161,3422,56950583,2,0,1,3584,9,8803924668
5633,56947720,135474,57083194,3,0,0,512,29,7182779772
5634,56948670,3128,56951798,8,0,1,9216,26,2356319866
5635,56948760,6665,56955425,8,0,1,4096,26,8569898512
5636,56952560,36061,56988621,3,0,1,12288,29,914164004
5637,56953729,240417,57194146,6,0,0,2048,8,2650454853
5638,56955009,447319,57402328,6,0,0,163328,8,9162833973
5639,56961250,31907,56993157,5,0,1,4096,15,267071948
5640,56961610,34133,56995743,3,0,1,4096,29,5657409249
5641,56965320,32689,56998009,5,0,1,3584,15,1637352821
5642,56974060,24615,56998675,5,0,1,1024,15,5367050122
5643,56980190,21711,57001901,1,0,1,5120,2,2825033106
5644,56994059,185127,57179186,6,0,0,1024,8,9386707866
5645,56998911,6536,57005447,4,0,1,5632,14,6047478204
5646,57002401,4672,57007073,2,0,1,2560,9,4549917150
5647,57004091,3648,57007739,4,0,1,1024,14,7429283238
5648,57011700,340849,57352549,9,0,0,26624,17,1899782709
5649,57017901,4374,57022275,2,0,1,4608,9,760327850
5650,57029090,2470,57031560,8,0,1,2560,26,7698290437
5651,57036689,284670,57321359,6,0,0,14848,8,9620571927
5652,57046111,3898,57050009,4,0,1,4096,14,3546589509
5653,57050321,5196,57055517,4,0,1,13312,14,4368276485
5654,57051390,5113,57056503,3,0,1,1536,29,8638809320
5655,57057639,204990,57262629,6,0,0,6656,8,10372557404
5656,57059961,9027,57068988,4,0,1,2048,14,8351950195
5657,57073359,271063,57344422,6,0,0,25088,8,5863391963
5658,57085030,1518,57086548,3,0,1,1536,29,5865724060
5659,57088840,128973,57217813,9,0,0,5120,17,2209837740
5660,57109079,369601,57478680,5,0,0,10752,15,3591154700
5661,57121679,329226,57450905,5,0,0,26624,15,2771599164
5662,57141100,5326,57146426,3,0,1,5632,29,1478311279
5663,57142930,186293,57329223,3,0,0,512,29,543653074
5664,57147531,1042,57148573,4,0,1,1024,14,10628773168
5665,57149139,313621,57462760,6,0,0,23040,8,6904256860
5666,57157749,255250,57412999,5,0,0,34816,15,9262037166
5667,57166489,380727,57547216,5,0,0,30720,15,5096846607
5668,57179930,3645,57183575,8,0,1,10240,26,1894417709
5669,57193491,4518,57198009,2,0,1,10752,9,1331254089
5670,57201951,1518,57203469,2,0,1,1536,9,6495154717
5671,57204030,5233,57209263,8,0,1,3584,26,5697135183
5672,57210129,529615,57739744,5,0,0,16384,15,2436635139
5673,57212870,408776,57621646,9,0,0,41984,17,432417504
5674,57219009,385184,57604193,6,0,0,43520,8,460761326
5675,57221310,1042,57222352,3,0,1,1024,29,2009178508
5676,57225791,1518,57227309,4,0,1,1536,14,10314388507
5677,57226790,434535,57661325,9,0,0,33792,17,10125470656
5678,57265110,2946,57268056,5,0,1,3072,15,8953643208
5679,57286311,5802,57292113,4,0,1,6144,14,5464372126
5680,57301951,12049,57314000,2,0,1,19968,9,5029344637
5681,57326700,353096,57679796,3,0,0,1536,29,10445784837
5682,57327281,1042,57328323,4,0,1,1024,14,9313787890
5683,57362120,52381,57414501,3,0,1,1536,29,3103619231
5684,57363429,200687,57564116,5,0,0,17408,15,10153902378
5685,57371150,150633,57521783,9,0,0,1024,17,1997141538
5686,57391050,274346,57665396,9,0,0,13312,17,8813907753
5687,57393461,21386,57414847,4,0,1,512,14,9289334637
5688,57397359,90151,57487510,6,0,0,16384,8,2847469975
5689,57400920,185000,57585920,3,0,0,1024,29,1859914361
5690,57405370,9823,57415193,3,0,1,512,29,9438042826
5691,57407699,316407,57724106,5,0,0,9728,15,283544059
5692,57407980,12346,57420326,3,0,1,15872,29,2889153127
5693,57423300,6754,57430054,3,0,1,7168,29,4517468603
5694,57425491,6509,57432000,4,0,1,3072,14,3659603000
5695,57446150,201655,57647805,9,0,0,10752,17,6166197920
5696,57449351,13424,57462775,4,0,1,6656,14,6825861128
5697,57477990,109300,57587290,3,0,0,1024,29,2137780202
5698,57480760,6765,57487525,3,0,1,2560,29,8336754327
5699,57487020,8203,57495223,4,0,1,8192,14,8475254247
5700,57490520,6649,57497169,3,0,1,3072,29,10178068132
5701,57496970,7230,57504200,8,0,1,7680,26,5652074202
5702,57511469,289662,57801131,5,0,0,25600,15,5447537525
5703,57518190,3645,57521835,4,0,1,10240,14,1089390820
5704,57536540,10691,57547231,4,0,1,2560,14,9555845347
5705,57550920,167194,57718114,9,0,0,8704,17,6060472661
5706,57553550,10581,57564131,8,0,1,6144,26,9739432270
5707,57560891,136422,57697313,1,0,0,1536,2,999970036
5708,57593470,147751,57741221,3,0,0,512,29,9134331611
5709,57593830,250959,57844789,9,0,0,30208,17,9675348483
5710,57593960,11334,57605294,3,0,1,1024,29,6986497142
5711,57594320,27341,57621661,4,0,1,7168,14,5373219078
5712,57611660,14413,57626073,4,0,1,11776,14,9190210407
5713,57622620,7520,57630140,8,0,1,5120,26,1026116899
5714,57643360,5326,57648686,1,0,1,5632,2,6228785448
5715,57651680,20479,57672159,1,0,1,7168,2,7843474660
5716,57664430,8075,57672505,3,0,1,512,29,2042448190
5717,57692320,4420,57696740,1,0,1,11776,2,3890859491
5718,57699840,5326,57705166,3,0,1,5632,29,9576366959
5719,57704760,292000,57996760,9,0,0,44544,17,9255462945
5720,57719180,4941,57724121,3,0,1,5120,29,2601375896
5721,57719579,292633,58012212,6,0,0,22528,8,7736446351
5722,57733190,1042,57734232,8,0,1,1024,26,8705949452
5723,57733550,1028,57734578,4,0,1,512,14,9196685398
5724,57738199,76179,57814378,5,0,0,9216,15,3041875880
5725,57759660,169754,57929414,3,0,0,2048,29,6141220904
5726,57770900,182801,57953701,9,0,0,52736,17,4008973234
5727,57782550,5712,57788262,1,0,1,14336,2,8637244962
5728,57784660,5194,57789854,3,0,1,8704,29,9619786426
5729,57786110,5996,57792106,3,0,1,2560,29,900580644
5730,57831720,13084,57844804,8,0,1,12288,26,4384771786
5731,57847319,265436,58112755,6,0,0,56832,8,1683515567
5732,57866579,104854,57971433,6,0,0,1536,8,1637350958
5733,57874729,207500,58082229,5,0,0,2048,15,8537657985
5734,57882950,1042,57883992,8,0,1,1024,26,10539713799
5735,57888369,108726,57997095,6,0,0,1024,8,803587642
5736,57896790,5326,57902116,4,0,1,5632,14,6920718837
5737,57903460,6229,57909689,4,0,1,15360,14,8290982903
5738,57903759,291510,58195269,6,0,0,7680,8,7911422972
5739,57920810,234396,58155206,9,0,0,17408,17,3647973802
5740,57924110,2946,57927056,1,0,1,3072,2,857168344
5741,57931610,22106,57953716,8,0,1,7168,26,6800880248
5742,57940850,335666,58276516,9,0,0,47104,17,658462436
5743,57943850,231597,58175447,3,0,0,512,29,336172602
5744,57954490,4374,57958864,1,0,1,4608,2,1728688822
5745,57956119,217236,58173355,6,0,0,1024,8,579186350
5746,57957370,2160,57959530,1,0,1,1024,2,8253798399
5747,57974389,265299,58239688,6,0,0,87552,8,2219676907
5748,57990400,11504,58001904,8,0,1,5120,26,2323588824
5749,58023110,1994,58025104,1,0,1,2048,2,5526303279
5750,58027540,155477,58183017,3,0,0,512,29,9880648922
5751,58031889,2470,58034359,9,0,1,2560,17,1201757378
5752,58046831,6278,58053109,4,0,1,6656,14,9305541744
5753,58048110,132257,58180367,3,0,0,1536,29,1442227232
5754,58050710,83641,58134351,9,0,0,6656,17,7096513609
5755,58063650,2470,58066120,8,0,1,2560,26,3231688872
5756,58079670,129038,58208708,3,0,0,2048,29,6268616787
5757,58079930,90197,58170127,3,0,0,512,29,6252074930
5758,58082600,125469,58208069,9,0,0,5632,17,7396303894
5759,58099600,13713,58113313,3,0,1,512,29,10168553991
5760,58114370,6278,58120648,8,0,1,6656,26,9125329789
5761,58148189,321909,58470098,6,0,0,16896,8,10057240346
5762,58151970,5698,58157668,8,0,1,2560,26,9070940605
5763,58169470,295465,58464935,9,0,0,59392,17,6460663200
5764,58172720,241040,58413760,3,0,0,512,29,7049609149
5765,58186220,1518,58187738,8,0,1,1536,26,1083419748
5766,58210669,143297,58353966,6,0,0,31232,8,7466968779
5767,58226869,264984,58491853,6,0,0,20480,8,10025503680
5768,58261779,337232,58599011,6,0,0,212992,8,10600557625
5769,58262620,14947,58277567,3,0,1,1024,29,6375978241
5770,58270010,10725,58280735,8,0,1,4096,26,2332847307
5771,58322190,2470,58324660,1,0,1,2560,2,9462375286
5772,58323679,192137,58515816,6,0,0,9728,8,1888956674
5773,58327070,189385,58516455,3,0,0,2048,29,10592652267
5774,58353240,4616,58357856,5,0,1,4096,15,7926175271
5775,58364109,294111,58658220,6,0,0,7168,8,2697432145
5776,58364730,5326,58370056,3,0,1,5632,29,8932098799
5777,58364780,5622,58370402,5,0,1,512,15,4550160188
5778,58388750,4679,58393429,3,0,1,12288,29,3740771919
5779,58418410,566,58418976,3,0,1,512,29,2071025325
5780,58420720,3387,58424107,1,0,1,9728,2,8344161212
5781,58421910,3341,58425251,3,0,1,1536,29,174373102
5782,58431960,5196,58437156,5,0,1,13312,15,4427177561
5783,58434260,4842,58439102,3,0,1,3072,29,2698106511
5784,58458450,60073,58518523,3,0,0,1024,29,9947222493
5785,58460390,10784,58471174,3,0,1,1024,29,1298395738
5786,58463739,179525,58643264,6,0,0,22016,8,104108658
5787,58486530,7802,58494332,4,0,1,2560,14,9937735280
5788,58491101,5817,58496918,2,0,1,4096,9,8899444611
5789,58495660,223313,58718973,9,0,0,25088,17,5494426159
5790,58508800,566,58509366,3,0,1,512,29,2385961045
5791,58511041,1518,58512559,2,0,1,1536,9,778478618
5792,58514031,3934,58517965,2,0,1,1536,9,9264223609
5793,58518021,3422,58521443,2,0,1,3584,9,3791963931
5794,58537700,63840,58601540,5,0,1,2560,15,1843746593
5795,58557110,46127,58603237,5,0,1,9728,15,6568556074
5796,58584100,214339,58798439,9,0,0,15872,17,7633742119
5797,58593569,12667,58606236,9,0,1,3584,17,7632762556
5798,58600980,90979,58691959,3,0,0,1536,29,4537774247
5799,58605411,1171,58606582,2,0,1,512,9,7112973321
5800,58605650,7706,58613356,1,0,1,8192,2,8854735593
5801,58605840,11702,58617542,3,0,1,6656,29,8262500989
5802,58606050,13438,58619488,1,0,1,3072,2,7329479089
5803,58621151,566,58621717,2,0,1,512,9,8937281741
5804,58622580,6488,58629068,1,0,1,15872,2,2050405747
5805,58623220,7474,58630694,3,0,1,2560,29,1976700925
5806,58629880,1480,58631360,5,0,1,1024,15,7884106957
5807,58637251,10872,58648123,2,0,1,5120,9,3963965593
5808,58641230,7559,58648789,1,0,1,1024,2,8660810840
5809,58656860,2870,58659730,1,0,1,1536,2,1155991211
5810,58665420,183768,58849188,9,0,0,47104,17,2922614450
5811,58671670,298192,58969862,9,0,0,108544,17,8191200191
5812,58679870,4162,58684032,3,0,1,11264,29,3637406052
5813,58683220,2601,58685821,8,0,1,2560,26,10530391994
5814,58684271,5326,58689597,2,0,1,5632,9,4256342376
5815,58714240,138349,58852589,3,0,0,512,29,8614327859
5816,58715060,4972,58720032,5,0,1,1024,15,7201699443
5817,58727051,566,58727617,2,0,1,512,9,2724485453
5818,58731150,3128,58734278,1,0,1,9216,2,8145324677
5819,58735899,338354,59074253,6,0,0,16896,8,6563764093
5820,58748420,4420,58752840,3,0,1,11776,29,189114715
5821,58749170,221331,58970501,9,0,0,2048,17,10689095779
5822,58753200,430180,59183380,9,0,0,25088,17,5204591654
5823,58773259,450998,59224257,6,0,0,81920,8,8841175260
5824,58776830,272131,59048961,9,0,0,39936,17,7920076293
5825,58785621,7706,58793327,2,0,1,8192,9,2318828025
5826,58785730,12724,58798454,0,0,1,2560,25,5723694281
5827,58792350,6119,58798469,0,0,1,512,25,3865729740
5828,58811480,566,58812046,1,0,1,512,2,3873810417
5829,58818860,2946,58821806,5,0,1,3072,15,4345778041
5830,58823279,488548,59311827,6,0,0,167936,8,9976104739
5831,58832790,16421,58849211,1,0,1,7680,2,407623351
5832,58835760,20199,58855959,0,0,1,7168,25,4411755063
5833,58843799,387025,59230824,6,0,0,21504,8,7038106970
5834,58870810,5712,58876522,3,0,1,14336,29,4494638159
5835,58871630,7158,58878788,1,0,1,3584,2,8236393499
5836,58874599,224903,59099502,6,0,0,31232,8,10354479287
5837,58875790,447206,59322996,9,0,0,35840,17,9711140168
5838,58887660,5326,58892986,5,0,1,5632,15,1642756718
5839,58897560,4850,58902410,5,0,1,5120,15,953629048
5840,58898161,4595,58902756,2,0,1,512,9,8766200808
5841,58910041,1042,58911083,2,0,1,1024,9,1101465473
5842,58910890,3422,58914312,3,0,1,3584,29,10009868585
5843,58915080,10757,58925837,8,0,1,17408,26,2116739847
5844,58917229,326558,59243787,6,0,0,42496,8,6131930078
5845,58919201,7622,58926823,2,0,1,1536,9,4801771833
5846,58930090,314819,59244909,3,0,0,1536,29,6400509949
5847,58945611,25465,58971076,2,0,1,512,9,4387761323
5848,58949670,362391,59312061,3,0,0,512,29,1790433744
5849,58985171,1042,58986213,2,0,1,1024,9,6321550814
5850,58990770,4679,58995449,0,0,1,12288,25,6468845850
5851,58992530,3905,58996435,3,0,1,1536,29,6970431543
5852,59006490,431363,59437853,9,0,0,69632,17,5623355313
5853,59030970,3422,59034392,8,0,1,3584,26,6681137592
5854,59033921,15071,59048992,2,0,1,10752,9,3703656772
5855,59034550,422217,59456767,9,0,0,61952,17,4339977859
5856,59036980,14017,59050997,1,0,1,2048,2,2962193597
5857,59048330,196096,59244426,3,0,0,2048,29,3131087089
5858,59077159,334596,59411755,6,0,0,52224,8,8101774575
5859,59080031,7230,59087261,2,0,1,7680,9,6229012875
5860,59080740,18777,59099517,5,0,1,5120,15,7791010322
5861,59096991,7844,59104835,2,0,1,5632,9,8432951633
5862,59118220,6488,59124708,0,0,1,15872,25,2307928464
5863,59130160,7706,59137866,0,0,1,8192,25,3543815162
5864,59136931,1601,59138532,2,0,1,1024,9,7821370642
5865,59141731,566,59142297,2,0,1,512,9,3465348104
5866,59143649,3422,59147071,7,0,1,3584,18,10498245981
5867,59167940,356858,59524798,9,0,0,48640,17,717495496
5868,59172741,10662,59183403,2,0,1,15872,9,811394271
5869,59175571,12651,59188222,2,0,1,5120,9,4502124210
5870,59255159,254804,59509963,6,0,0,49664,8,2456731641
5871,59259650,52200,59311850,5,0,1,3584,15,4628404849
5872,59261949,154665,59416614,6,0,0,15872,8,8441382044
5873,59264510,61391,59325901,8,0,1,3072,26,7877125422
5874,59266989,331413,59598402,6,0,0,19456,8,10292169623
5875,59270720,56487,59327207,8,0,1,2048,26,6931522335
5876,59275490,53343,59328833,5,0,1,2560,15,5812709694
5877,59287460,43959,59331419,8,0,1,4096,26,9585847764
5878,59336100,1042,59337142,5,0,1,1024,15,1333628133
5879,59342080,4420,59346500,8,0,1,11776,26,9344513727
5880,59352080,3904,59355984,8,0,1,10752,26,10048579257
5881,59358200,5326,59363526,0,0,1,5632,25,763333070
5882,59368410,196760,59565170,9,0,0,77312,17,4013854034
5883,59382901,7230,59390131,2,0,1,7680,9,7460755117
5884,59396460,41416,59437876,8,0,1,2560,26,2083294690
5885,59416631,45947,59462578,2,0,1,6144,9,707112853
5886,59426800,36649,59463449,5,0,1,12288,15,418353
5887,59428119,174629,59602748,6,0,0,2048,8,7436228692
5888,59444551,24095,59468646,2,0,1,15360,9,8993323165
5889,59477600,141796,59619396,3,0,0,1536,29,10455417192
5890,59487120,188786,59675906,9,0,0,8192,17,7774561196
5891,59533891,566,59534457,2,0,1,512,9,3228615795
5892,59537590,1994,59539584,0,0,1,2048,25,5830502702
5893,59539641,1518,59541159,2,0,1,1536,9,3346551787
5894,59540610,104074,59644684,3,0,0,5120,29,3604138047
5895,59567960,236813,59804773,3,0,0,1536,29,1473335523
5896,59578140,6278,59584418,0,0,1,6656,25,275361745
5897,59588190,3898,59592088,0,0,1,4096,25,6851023354
5898,59600611,2470,59603081,2,0,1,2560,9,1691236586
5899,59607560,1518,59609078,5,0,1,1536,15,3461471826
5900,59612299,94505,59706804,6,0,0,1024,8,3679371992
5901,59620251,1994,59622245,2,0,1,2048,9,1993898487
5902,59621960,430268,60052228,9,0,0,209920,17,5858609242
5903,59624701,14804,59639505,2,0,1,28672,9,6710678423
5904,59638241,2890,59641131,2,0,1,2560,9,6959636419
5905,59664291,4850,59669141,2,0,1,5120,9,2451050063
5906,59671540,157267,59828807,9,0,0,25600,17,9543494476
5907,59672970,2951,59675921,8,0,1,1024,26,8270666997
5908,59682821,566,59683387,2,0,1,512,9,4746113568
5909,59683860,2470,59686330,8,0,1,2560,26,3186269562
5910,59697720,376390,60074110,9,0,0,53760,17,4208148104
5911,59708580,2470,59711050,0,0,1,2560,25,3837486904
5912,59728210,2470,59730680,5,0,1,2560,15,1707102123
5913,59734370,1518,59735888,5,0,1,1536,15,6714460875
5914,59738870,90123,59828993,3,0,0,512,29,5514510075
5915,59745290,204398,59949688,3,0,0,512,29,1338111897
5916,59788940,196347,59985287,9,0,0,2560,17,5252327786
5917,59793380,1042,59794422,5,0,1,1024,15,3821750316
5918,59798181,1042,59799223,2,0,1,1024,9,5625697949
5919,59820580,8242,59828822,8,0,1,4096,26,9168918186
5920,59834379,218176,60052555,6,0,0,1024,8,7619704095
5921,59845480,1994,59847474,5,0,1,2048,15,3310150825
5922,59846901,4374,59851275,2,0,1,4608,9,5012100391
5923,59858831,1518,59860349,2,0,1,1536,9,848277037
5924,59872481,5712,59878193,2,0,1,14336,9,4253255901
5925,59881820,4374,59886194,8,0,1,4608,26,1373951896
5926,59903290,232114,60135404,9,0,0,64000,17,3723372467
5927,59903340,1518,59904858,5,0,1,1536,15,1240954642
5928,59922831,1518,59924349,2,0,1,1536,9,8025172029
5929,59928950,123776,60052726,3,0,0,512,29,4154971729
5930,59945720,2470,59948190,5,0,1,2560,15,3285316936
5931,59946400,10390,59956790,0,0,1,16384,25,4598111449
5932,59946650,318316,60264966,9,0,0,30208,17,9929371167
5933,59950560,211684,60162244,9,0,0,28672,17,7089261451
5934,59964699,202766,60167465,6,0,0,512,8,6672503099
5935,59979261,1042,59980303,2,0,1,1024,9,2893822402
5936,60002000,51827,60053827,8,0,1,1024,26,4573009463
5937,60007780,66345,60074125,0,0,1,5632,25,344162904
5938,60017501,56639,60074140,2,0,1,512,9,3424160030
5939,60031791,42364,60074155,2,0,1,1536,9,999336214
5940,60061290,17536,60078826,5,0,1,12288,15,347724675
5941,60078580,6754,60085334,8,0,1,7168,26,6018472125
5942,60080830,196502,60277332,9,0,0,39936,17,6972908414
5943,60091150,2470,60093620,0,0,1,2560,25,6507176825
5944,60101540,3422,60104962,5,0,1,3584,15,5435926107
5945,60112869,117747,60230616,6,0,0,2048,8,2076039022
5946,60120420,18039,60138459,8,0,1,3072,26,1253658342
5947,60122990,18695,60141685,8,0,1,5120,26,7233583426
5948,60124501,19130,60143631,2,0,1,3072,9,2067033993
5949,60126960,21177,60148137,8,0,1,7168,26,10000507997
5950,60130120,18683,60148803,0,0,1,1024,25,415620677
5951,60135349,142170,60277519,6,0,0,512,8,848744652
5952,60176850,145609,60322459,9,0,0,14336,17,8899270794
5953,60193290,1042,60194332,0,0,1,1024,25,6231742613
5954,60219980,5326,60225306,0,0,1,5632,25,7663432250
5955,60265201,17756,60282957,2,0,1,13824,9,6932200925
5956,60266351,18232,60284583,2,0,1,2560,9,8044362884
5957,60275429,63790,60339219,6,0,0,2048,8,1330479372
5958,60297669,566,60298235,7,0,1,512,18,4024191143
5959,60313440,2470,60315910,0,0,1,2560,25,9131458484
5960,60319920,6435,60326355,0,0,1,10752,25,3846228514
5961,60326619,95031,60421650,6,0,0,512,8,3724488573
5962,60327851,1994,60329845,2,0,1,2048,9,2183842961
5963,60341719,137173,60478892,6,0,0,512,8,1212648345
5964,60366320,77830,60444150,3,0,0,2560,29,4820516508
5965,60374150,4420,60378570,4,0,1,11776,14,6028378307
5966,60380111,3422,60383533,2,0,1,3584,9,9760932667
5967,60385711,566,60386277,2,0,1,512,9,1952601994
5968,60407719,56273,60463992,6,0,0,512,8,10611553099
5969,60430401,5802,60436203,2,0,1,6144,9,4249583535
5970,60451979,53661,60505640,6,0,0,1536,8,905456950
5971,60453659,566,60454225,7,0,1,512,18,8153455021
5972,60458170,153937,60612107,3,0,0,2560,29,7261920409
5973,60460649,129300,60589949,6,0,0,1536,8,8781479861
5974,60477810,1518,60479328,0,0,1,1536,25,6153943279
5975,60490600,54649,60545249,3,0,0,1024,29,7690671009
5976,60490900,133581,60624481,3,0,0,512,29,142387498
5977,60538830,74189,60613019,3,0,0,512,29,4749262261
5978,60542590,11016,60553606,0,0,1,17920,25,1148579857
5979,60574570,5326,60579896,4,0,1,5632,14,6922985096
5980,60593620,3422,60597042,0,0,1,3584,25,1651230429
5981,60598460,566,60599026,1,0,1,512,2,4451718872
5982,60600601,2470,60603071,2,0,1,2560,9,6669059998
5983,60659989,103595,60763584,6,0,0,512,8,3443943670
5984,60670610,172579,60843189,9,0,0,18944,17,10343195831
5985,60706011,1042,60707053,2,0,1,1024,9,3306178677
5986,60718700,114810,60833510,9,0,0,12288,17,8679748306
5987,60728501,6754,60735255,2,0,1,7168,9,5103110064
5988,60735481,1994,60737475,2,0,1,2048,9,6577733182
5989,60745010,82246,60827256,3,0,0,512,29,5558854409
5990,60755439,117022,60872461,6,0,0,1024,8,3200975980
5991,60775120,10499,60785619,0,0,1,16896,25,5867630107
5992,60792590,43904,60836494,3,0,0,512,29,6907789187
5993,60796431,3387,60799818,2,0,1,9728,9,8845738372
5994,60802100,78785,60880885,9,0,0,3072,17,4716891592
5995,60803240,6278,60809518,0,0,1,6656,25,4848833778
5996,60817511,1518,60819029,2,0,1,1536,9,3091615352
5997,60822890,4381,60827271,0,0,1,4608,25,8802713648
5998,60846330,190334,61036664,3,0,0,5632,29,7624188044
5999,60849460,1518,60850978,5,0,1,1536,15,6671216289
6000,60854600,1518,60856118,5,0,1,1536,15,1394203924
6001,60867820,11016,60878836,5,0,1,17920,15,8101322383
6002,60935250,129722,61064972,9,0,0,26624,17,4794436328
6003,60943460,3128,60946588,3,0,1,9216,29,8250965666
6004,60950489,114654,61065143,6,0,0,512,8,7479579798
6005,60951990,1518,60953508,5,0,1,1536,15,6139264153
6006,60965630,6278,60971908,5,0,1,6656,15,5769381252
6007,60971920,3128,60975048,0,0,1,9216,25,5651491862
6008,60976229,43904,61020133,6,0,0,512,8,1522069344
6009,60979531,6278,60985809,2,0,1,6656,9,6643546434
6010,60983230,3245,60986475,8,0,1,1024,26,7910241086
6011,61012500,5196,61017696,8,0,1,13312,26,1282751846
6012,61013300,5062,61018362,5,0,1,1024,15,25102631
6013,61014900,3808,61018708,8,0,1,512,26,9320830869
6014,61026621,3645,61030266,2,0,1,10240,9,2390891601
6015,61030611,6068,61036679,2,0,1,12800,9,3297818078
6016,61031130,6376,61037506,5,0,1,3072,15,6668155820
6017,61040130,7230,61047360,0,0,1,7680,25,9793444996
6018,61045580,4686,61050266,5,0,1,4608,15,9800463305
6019,61049040,5454,61054494,8,0,1,13824,26,97144585
6020,61056770,8388,61065158,5,0,1,10752,15,6781581100
6021,61064359,70002,61134361,6,0,0,512,8,6025335079
6022,61064830,143853,61208683,3,0,0,512,29,8980784568
6023,61095541,2470,61098011,2,0,1,2560,9,2883505718
6024,61098760,1042,61099802,5,0,1,1024,15,4190309457
6025,61116481,1042,61117523,2,0,1,1024,9,6456913542
6026,61117409,125322,61242731,6,0,0,3072,8,68366377
6027,61134910,59930,61194840,3,0,0,512,29,6391366392
6028,61135930,2870,61138800,8,0,1,8704,26,4683292342
6029,61143290,1042,61144332,0,0,1,1024,25,7478112799
6030,61159180,1518,61160698,6,0,1,1536,8,3999544350
6031,61160180,2470,61162650,0,0,1,2560,25,2244307330
6032,61185890,75453,61261343,9,0,0,8704,17,8606884581
6033,61194110,4162,61198272,1,0,1,11264,2,2661831807
6034,61200340,194183,61394523,9,0,0,41984,17,3975117599
6035,61214340,2470,61216810,5,0,1,2560,15,4353120535
6036,61235160,77265,61312425,3,0,0,512,29,1772954172
6037,61238450,1994,61240444,5,0,1,2048,15,5907316485
6038,61250961,2470,61253431,2,0,1,2560,9,3019918078
6039,61290740,566,61291306,5,0,1,512,15,7305959830
6040,61328130,5326,61333456,1,0,1,5632,2,3208300954
6041,61337110,566,61337676,8,0,1,512,26,3839736848
6042,61340310,164769,61505079,3,0,0,2560,29,3938076797
6043,61341970,3898,61345868,1,0,1,4096,2,5272309862
6044,61347829,218701,61566530,6,0,0,1536,8,4418499070
6045,61349840,7706,61357546,8,0,1,8192,26,3581407256
6046,61368860,4374,61373234,8,0,1,4608,26,5451947540
6047,61385000,11985,61396985,5,0,1,2560,15,7610632083
6048,61402490,74773,61477263,9,0,0,1536,17,1734746883
6049,61408540,43904,61452444,3,0,0,512,29,8148280990
6050,61421030,3898,61424928,8,0,1,4096,26,9137911566
6051,61436330,3904,61440234,5,0,1,10752,15,19410931
6052,61441461,1518,61442979,2,0,1,1536,9,10360235735
6053,61449680,7706,61457386,1,0,1,8192,2,4207847215
6054,61465880,170046,61635926,9,0,0,9216,17,6509876409
6055,61481139,157055,61638194,6,0,0,1536,8,3115844313
6056,61486340,32816,61519156,8,0,1,53760,26,860810698
6057,61492420,28362,61520782,0,0,1,2560,25,6210457384
6058,61504130,18278,61522408,8,0,1,2560,26,5890014465
6059,61529110,3422,61532532,1,0,1,3584,2,6983641541
6060,61530230,4568,61534798,1,0,1,3584,2,5617776544
6061,61552900,4374,61557274,0,0,1,4608,25,9118946267
6062,61558620,2946,61561566,0,0,1,3072,25,4433334507
6063,61561290,7230,61568520,5,0,1,7680,15,6866293854
6064,61582820,12308,61595128,0,0,1,20480,25,3467765487
6065,61586890,128837,61715727,3,0,0,512,29,4146791968
6066,61593000,6488,61599488,0,0,1,15872,25,62623848
6067,61593530,126373,61719903,3,0,0,1536,29,2104057737
6068,61615441,85316,61700757,2,0,0,20480,9,7421579653
6069,61618940,60033,61678973,9,0,0,512,17,6787129457
6070,61653980,212166,61866146,9,0,0,5120,17,5956115603
6071,61691461,339650,62031111,2,0,0,98304,9,2399758352
6072,61708630,105841,61814471,9,0,0,9728,17,2243528009
6073,61737400,566,61737966,5,0,1,512,15,10601705244
6074,61750941,13341,61764282,2,0,1,22528,9,2344717530
6075,61751851,107515,61859366,2,0,0,33280,9,6819435118
6076,61755311,13157,61768468,2,0,1,6656,9,6068405084
6077,61755610,13524,61769134,8,0,1,1024,26,2421697039
6078,61769830,1518,61771348,1,0,1,1536,2,6791241260
6079,61791501,566,61792067,2,0,1,512,9,3591251403
6080,61793420,271730,62065150,9,0,0,111616,17,2781997390
6081,61813211,2770,61815981,2,0,1,1536,9,6805346022
6082,61855010,11151,61866161,5,0,1,6144,15,1814383315
6083,61873240,10241,61883481,1,0,1,16384,2,9621759729
6084,61880440,3707,61884147,1,0,1,1024,2,5663728342
6085,61887300,3904,61891204,5,0,1,10752,15,7266297483
6086,61906650,191707,62098357,9,0,0,72192,17,6695767531
6087,61908420,4374,61912794,1,0,1,4608,2,7111479270
6088,61908580,4880,61913460,8,0,1,1024,26,8059497934
6089,61931350,1042,61932392,5,0,1,1024,15,6297755533
6090,61936720,3422,61940142,8,0,1,3584,26,59769156
6091,61961260,1518,61962778,1,0,1,1536,2,4516497296
6092,61974210,125284,62099494,3,0,0,2048,29,5472013893
6093,61977280,1042,61978322,1,0,1,1024,2,5548422975
6094,61992450,196349,62188799,9,0,0,1024,17,6023115849
6095,61993130,2470,61995600,5,0,1,2560,15,6696034027
6096,61998360,100495,62098855,3,0,0,512,29,5331395568
6097,62011800,59612,62071412,1,0,1,6656,2,7530332040
6098,62020500,78184,62098684,3,0,0,1024,29,4759073988
6099,62028620,159836,62188456,9,0,0,51712,17,3132190461
6100,62059270,129700,62188970,3,0,0,512,29,3232368855
6101,62094500,7856,62102356,5,0,1,8704,15,135154159
6102,62118410,90623,62209033,3,0,0,512,29,9580480635
6103,62122740,86122,62208862,9,0,0,6656,17,536893275
6104,62149560,3128,62152688,5,0,1,9216,15,370697417
6105,62175090,20618,62195708,8,0,1,7168,26,3346842834
6106,62177770,18924,62196694,5,0,1,1536,15,7129747587
6107,62182620,15060,62197680,1,0,1,1536,2,9351393702
6108,62234671,3904,62238575,2,0,1,10752,9,3929138779
6109,62246350,4850,62251200,1,0,1,5120,2,3652383757
6110,62256690,117211,62373901,3,0,0,512,29,4409575321
6111,62261310,1518,62262828,1,0,1,1536,2,4086042148
6112,62261370,3404,62264774,1,0,1,3072,2,138165610
6113,62286911,5326,62292237,2,0,1,5632,9,5424407895
6114,62299580,4420,62304000,1,0,1,11776,2,5188482280
6115,62361720,3387,62365107,1,0,1,9728,2,5037586889
6116,62371790,6754,62378544,8,0,1,7168,26,10451014561
6117,62382350,236479,62618829,9,0,0,109056,17,2814993509
6118,62388360,3422,62391782,1,0,1,3584,2,426046408
6119,62431300,4162,62435462,1,0,1,11264,2,767577919
6120,62436170,6229,62442399,1,0,1,15360,2,5245069619
6121,62438020,181292,62619312,3,0,0,1536,29,1230101439
6122,62458440,324508,62782948,9,0,0,17408,17,8033533738
6123,62467000,54136,62521136,3,0,0,512,29,7434036268
6124,62500130,6278,62506408,3,0,1,6656,29,1184510373
6125,62532120,211714,62743834,9,0,0,36352,17,3804493605
6126,62568860,110240,62679100,9,0,0,61952,17,7000805378
6127,62628230,4374,62632604,1,0,1,4608,2,2278338435
6128,62646210,215092,62861302,9,0,0,46592,17,4319353102
6129,62678670,7652,62686322,1,0,1,7680,2,8580371400
6130,62757970,566,62758536,3,0,1,512,29,463364192
6131,62771360,171704,62943064,9,0,0,16384,17,5299053868
6132,62774490,136276,62910766,9,0,0,47616,17,1513039891
6133,62817439,1518,62818957,9,0,1,1536,17,7677792236
6134,62825250,162982,62988232,9,0,0,18432,17,7951282975
6135,62827470,54056,62881526,3,0,0,3584,29,8318905322
6136,62846080,15237,62861317,3,0,1,2048,29,6436714314
6137,62874980,45596,62920576,3,0,0,1024,29,8657325687
6138,62888600,150998,63039598,9,0,0,90112,17,3559346746
6139,62893870,16911,62910781,3,0,1,3584,29,3825637439
6140,62952660,87436,63040096,3,0,0,512,29,2207833272
6141,62969980,69945,63039925,3,0,0,1024,29,8669139561
6142,62987800,66692,63054492,3,0,0,512,29,5444265796
6143,63029400,105352,63134752,9,0,0,15872,17,8566431260
6144,63048410,47288,63095698,3,0,0,1536,29,8035340559
6145,63077440,1042,63078482,1,0,1,1024,2,5983544145
6146,63097900,4420,63102320,1,0,1,11776,2,9603043322
6147,63120570,117977,63238547,9,0,0,21504,17,8391045885
6148,63227190,1518,63228708,1,0,1,1536,2,10594915437
6149,63232620,49823,63282443,3,0,0,512,29,51982505
6150,63269160,45596,63314756,3,0,0,1024,29,4241714019
6151,63272170,88232,63360402,9,0,0,19968,17,9628546274
6152,63301000,97604,63398604,9,0,0,20480,17,520486011
6153,63340350,93734,63434084,3,0,0,2048,29,2617154369
6154,63372460,1994,63374454,1,0,1,2048,2,10631988721
6155,63373170,64578,63437748,3,0,0,512,29,8762270202
6156,63384160,2946,63387106,1,0,1,3072,2,5566280079
6157,63410200,50182,63460382,9,0,0,1536,17,4021744691
6158,63412530,44468,63456998,3,0,0,512,29,3138459994
6159,63452770,47288,63500058,3,0,0,1536,29,3599327100
6160,63475670,43904,63519574,3,0,0,512,29,9214738523
6161,63477390,1042,63478432,1,0,1,1024,2,10377916978
6162,63534840,44419,63579259,3,0,0,512,29,50115360
6163,63541580,3387,63544967,1,0,1,9728,2,3812779320
6164,63575010,315216,63890226,3,0,0,1024,29,7323361505
6165,63640070,237794,63877864,9,0,0,249856,17,7867746635
6166,63651740,238151,63889891,9,0,0,39424,17,3161620908
6167,63661220,234496,63895716,3,0,0,5120,29,4704470770
6168,63670830,2946,63673776,0,0,1,3072,25,3089991617
6169,63692130,203913,63896043,9,0,0,1024,17,8995231027
6170,63699700,194441,63894141,9,0,0,12800,17,8020878449
6171,63700420,4374,63704794,5,0,1,4608,15,2617572767
6172,63711240,185130,63896370,3,0,0,1024,29,884342873
6173,63835520,98267,63933787,3,0,0,512,29,5288386531
6174,63880560,118554,63999114,9,0,0,37376,17,7831273640
6175,63930990,152364,64083354,9,0,0,69632,17,8740323287
6176,63933290,44189,63977479,3,0,0,512,29,499620360
6177,63938280,45596,63983876,3,0,0,1024,29,8822515270
6178,63986770,129068,64115838,9,0,0,19968,17,7106368798
6179,64014440,182842,64197282,9,0,0,12800,17,8306953942
6180,64016520,67620,64084140,3,0,0,512,29,4095766752
6181,64027840,279953,64307793,9,0,0,101376,17,7034948246
6182,64040450,227362,64267812,9,0,0,124416,17,2567394906
6183,64046130,230589,64276719,9,0,0,29184,17,2895316349
6184,64049730,100096,64149826,9,0,0,8704,17,4264553940
6185,64120130,66284,64186414,3,0,0,512,29,5396024186
6186,64137230,139660,64276890,3,0,0,512,29,1295671368
6187,64142530,165754,64308284,3,0,0,1536,29,1520711559
6188,64161950,164884,64326834,7,0,0,12288,18,6533567455
6189,64168710,198924,64367634,9,0,0,17920,17,770131765
6190,64176620,1518,64178138,1,0,1,1536,2,8548488569
6191,64205180,116715,64321895,9,0,0,44544,17,8158138371
6192,64207230,2470,64209700,1,0,1,2560,2,7856809635
6193,64257730,99035,64356765,3,0,0,2048,29,10580588769
6194,64260840,66009,64326849,1,0,1,4608,2,840112226
6195,64272460,62589,64335049,1,0,1,19456,2,8366783148
6196,64278510,104265,64382775,9,0,0,5632,17,9273691092
6197,64322120,143236,64465356,3,0,0,2560,29,4498904918
6198,64329250,243939,64573189,9,0,0,123392,17,9496590308
6199,64366380,92208,64458588,3,0,0,512,29,7398342656
6200,64409610,6278,64415888,1,0,1,6656,2,8744530299
6201,64428140,2870,64431010,1,0,1,8704,2,6742570466
6202,64434990,12825,64447815,1,0,1,21504,2,592632643
6203,64470650,53153,64523803,9,0,0,512,17,4890664727
6204,64476180,566,64476746,1,0,1,512,2,5668258685
6205,64492530,137759,64630289,9,0,0,512,17,3924115238
6206,64509340,3422,64512762,1,0,1,3584,2,258433046
6207,64551570,25065,64576635,1,0,1,9728,2,4834910326
6208,64558040,60762,64618802,9,0,0,1024,17,7497858613
6209,64562080,79948,64642028,9,0,0,512,17,9763480305
6210,64572810,72602,64645412,3,0,0,1536,29,2147980849
6211,64600670,1042,64601712,1,0,1,1024,2,5962796643
6212,64610250,58388,64668638,9,0,0,1024,17,7111242808
6213,64615280,53770,64669050,3,0,0,512,29,1664829601
6214,64623850,49808,64673658,9,0,0,512,17,3765907483
6215,64672510,1518,64674028,1,0,1,1536,2,3085581673
6216,64679270,2946,64682216,1,0,1,3072,2,4688498130
6217,64680660,2542,64683202,5,0,1,1536,15,6371213254
6218,64690750,566,64691316,5,0,1,512,15,1491830333
6219,64715280,61811,64777091,3,0,0,512,29,7885093786
6220,64729591,4420,64734011,4,0,1,11776,14,6197295519
6221,64730620,60676,64791296,3,0,0,1024,29,6355716235
6222,64741330,7230,64748560,1,0,1,7680,2,478669656
6223,64745700,67121,64812821,3,0,0,512,29,2836865467
6224,64778950,3422,64782372,5,0,1,3584,15,5058862138
6225,64779140,44855,64823995,9,0,0,512,17,2382205
6226,64784230,45596,64829826,9,0,0,1024,17,6056252943
6227,64801010,56942,64857952,3,0,0,512,29,10583987183
6228,64812480,4850,64817330,1,0,1,5120,2,3821144224
6229,64871450,566,64872016,5,0,1,512,15,700158227
6230,64876480,4850,64881330,5,0,1,5120,15,3813494565
6231,64897820,43904,64941724,3,0,0,512,29,1082012558
6232,64929840,47288,64977128,9,0,0,1536,17,7061244515
6233,64943850,1042,64944892,0,0,1,1024,25,8235132174
6234,64946750,43904,64990654,3,0,0,512,29,5470177302
6235,64955830,45596,65001426,3,0,0,1024,29,10119546924
6236,64965079,3387,64968466,9,0,1,9728,17,4807155395
6237,64968779,1518,64970297,6,0,1,1536,8,4703396059
6238,64997320,187872,65185192,3,0,0,512,29,7221226433
6239,65013260,5326,65018586,8,0,1,5632,26,10304977238
6240,65017869,1703,65019572,9,0,1,1536,17,9283726188
6241,65039841,10241,65050082,4,0,1,16384,14,4174742201
6242,65098900,191229,65290129,3,0,0,512,29,1223036693
6243,65102030,55552,65157582,3,0,0,1024,29,2889310149
6244,65111810,1994,65113804,8,0,1,2048,26,3815228202
6245,65119279,4162,65123441,9,0,1,11264,17,10107546283
6246,65133109,3422,65136531,6,0,1,3584,8,7970979323
6247,65151581,6016,65157597,4,0,1,14336,14,8746406095
6248,65152611,8237,65160848,4,0,1,5120,14,8003038026
6249,65156610,136642,65293252,9,0,0,1024,17,4299039673
6250,65183260,4420,65187680,5,0,1,11776,15,6981633805
6251,65185540,2806,65188346,1,0,1,1024,2,2471214097
6252,65205210,1994,65207204,1,0,1,2048,2,9552867615
6253,65220110,1518,65221628,6,0,1,1536,8,1476724919
6254,65230870,1518,65232388,8,0,1,1536,26,10611734327
6255,65239661,566,65240227,4,0,1,512,14,6199868303
6256,65260310,3898,65264208,8,0,1,4096,26,8772521497
6257,65261810,177187,65438997,3,0,0,1024,29,1021270853
6258,65262860,2654,65265514,1,0,1,2048,2,6435223576
6259,65294540,43904,65338444,3,0,0,512,29,7347754228
6260,65305391,566,65305957,4,0,1,512,14,5743233743
6261,65319110,4162,65323272,5,0,1,11264,15,1342497322
6262,65319590,4028,65323618,1,0,1,512,2,6951620874
6263,65328350,1042,65329392,8,0,1,1024,26,10016198428
6264,65338530,63535,65402065,3,0,0,512,29,8438570845
6265,65359389,1994,65361383,9,0,1,2048,17,1865520754
6266,65368949,1042,65369991,9,0,1,1024,17,5368875161
6267,65375570,6278,65381848,4,0,1,6656,14,3782367143
6268,65380670,120173,65500843,3,0,0,21504,29,1741886715
6269,65389430,50202,65439632,9,0,0,512,17,2403848504
6270,65398370,2870,65401240,5,0,1,8704,15,9766509686
6271,65400949,688,65401637,6,0,1,512,8,3570077668
6272,65435669,4850,65440519,6,0,1,5120,8,10376860920
6273,65439239,4850,65444089,9,0,1,5120,17,7945568391
6274,65441989,5646,65447635,7,0,1,5632,18,6511650922
6275,65445029,4232,65449261,6,0,1,2560,8,3030877156
6276,65467289,5326,65472615,9,0,1,5632,17,418164006
6277,65490070,103461,65593531,9,0,0,512,17,9211691987
6278,65511739,566,65512305,7,0,1,512,18,9049215875
6279,65524289,4679,65528968,9,0,1,12288,17,3385122962
6280,65556400,181166,65737566,3,0,0,62464,29,3630846205
6281,65560029,4850,65564879,7,0,1,5120,18,4223537591
6282,65562819,4006,65566825,6,0,1,3072,8,2279474302
6283,65566979,566,65567545,7,0,1,512,18,3224846371
6284,65577859,6278,65584137,7,0,1,6656,18,5205974350
6285,65591170,6278,65597448,8,0,1,6656,26,9415311898
6286,65628401,2946,65631347,4,0,1,3072,14,249947626
6287,65639589,5326,65644915,7,0,1,5632,18,5863137038
6288,65649639,2470,65652109,6,0,1,2560,8,2875088276
6289,65668420,83614,65752034,9,0,0,512,17,483424025
6290,65676809,2470,65679279,7,0,1,2560,18,10046401915
6291,65681549,1994,65683543,7,0,1,2048,18,8194176907
6292,65695440,3645,65699085,5,0,1,10240,15,2764133150
6293,65775640,1518,65777158,8,0,1,1536,26,3528385344
6294,65780239,2946,65783185,6,0,1,3072,8,1802749363
6295,65782779,6754,65789533,7,0,1,7168,18,10602183260
6296,65784460,6379,65790839,8,0,1,2048,26,4194586713
6297,65788929,6278,65795207,7,0,1,6656,18,8709769178
6298,65801280,1994,65803274,5,0,1,2048,15,3229331090
6299,65803180,2946,65806126,5,0,1,3072,15,8665219619
6300,65819540,2946,65822486,8,0,1,3072,26,5734376700
6301,65844410,50672,65895082,9,0,0,2560,17,7713414542
6302,65851149,3128,65854277,6,0,1,9216,8,1492842955
6303,65858490,5802,65864292,8,0,1,6144,26,9999813467
6304,65861080,145095,66006175,9,0,0,3072,17,3683619836
6305,65883550,69823,65953373,3,0,0,3072,29,656108873
6306,65896309,3898,65900207,6,0,1,4096,8,4395516114
6307,65905430,2946,65908376,8,0,1,3072,26,8582132758
6308,65928600,80491,66009091,9,0,0,2560,17,5997264286
6309,65931150,5802,65936952,5,0,1,6144,15,5249748710
6310,65960100,566,65960666,8,0,1,512,26,10274063598
6311,65980439,1042,65981481,6,0,1,1024,8,1023270367
6312,66008450,2151,66010601,8,0,1,1536,26,10204256156
6313,66020580,2470,66023050,8,0,1,2560,26,5896845271
6314,66033499,566,66034065,6,0,1,512,8,3346635857
6315,66049980,1518,66051498,8,0,1,1536,26,8258770305
6316,66050199,2605,66052804,6,0,1,2048,8,6834136806
6317,66073899,5454,66079353,6,0,1,13824,8,6080421925
6318,66085079,6754,66091833,6,0,1,7168,8,4265279533
6319,66117600,1518,66119118,8,0,1,1536,26,6195934717
6320,66144189,6754,66150943,6,0,1,7168,8,9053590811
6321,66144720,147593,66292313,9,0,0,1024,17,404409060
6322,66164710,130543,66295253,3,0,0,5632,29,374614780
6323,66173280,106092,66279372,3,0,0,47616,29,4453054562
6324,66193520,158051,66351571,3,0,0,30208,29,8891407998
6325,66210200,4850,66215050,8,0,1,5120,26,6646520221
6326,66215940,3898,66219838,8,0,1,4096,26,5047068642
6327,66225370,5326,66230696,8,0,1,5632,26,5215918743
6328,66260960,184206,66445166,3,0,0,40448,29,112870581
6329,66276880,4044,66280924,0,0,1,1536,25,8958149117
6330,66277460,4770,66282230,0,0,1,2048,25,215322604
6331,66278580,4316,66282896,0,0,1,1024,25,5504869654
6332,66293109,3898,66297007,6,0,1,4096,8,2893693661
6333,66305920,1042,66306962,3,0,1,1024,29,8679063062
6334,66320959,2870,66323829,6,0,1,8704,8,6936867299
6335,66341910,9676,66351586,8,0,1,2048,26,1035673569
6336,66352970,7230,66360200,3,0,1,7680,29,4630110804
6337,66371190,136894,66508084,9,0,0,1024,17,4883145746
6338,66377291,4937,66382228,2,0,1,12800,9,2469180093
6339,66379029,5633,66384662,6,0,1,3584,8,8070507455
6340,66382481,2527,66385008,2,0,1,512,9,6208430061
6341,66393911,566,66394477,2,0,1,512,9,2119586463
6342,66410030,566,66410596,8,0,1,512,26,10141485795
6343,66433690,15859,66449549,0,0,1,4608,25,5801257173
6344,66437270,15280,66452550,8,0,1,14848,26,8495094146
6345,66484731,6278,66491009,2,0,1,6656,9,1379340103
6346,66499579,79735,66579314,6,0,0,512,8,6803807639
6347,66501130,4679,66505809,8,0,1,12288,26,370609391
6348,66517690,213501,66731191,3,0,0,11264,29,6984603663
6349,66530611,566,66531177,2,0,1,512,9,6301623426
6350,66544650,5326,66549976,8,0,1,5632,26,2219299885
6351,66546500,7342,66553842,0,0,1,6144,25,5723756677
6352,66549750,5718,66555468,8,0,1,2560,26,2708815227
6353,66550340,5282,66555622,8,0,1,8704,26,1014202871
6354,66566090,95857,66661947,3,0,0,6144,29,10077820335
6355,66567070,4679,66571749,1,0,1,12288,2,2439787520
6356,66576100,566,66576666,1,0,1,512,2,6099526080
6357,66577731,4420,66582151,2,0,1,11776,9,7336383235
6358,66585030,3898,66588928,1,0,1,4096,2,4306624826
6359,66597700,90074,66687774,9,0,0,3072,17,5610367888
6360,66605410,2946,66608356,8,0,1,3072,26,9456891277
6361,66633670,172725,66806395,3,0,0,51200,29,2682370901
6362,66638891,1994,66640885,2,0,1,2048,9,3129368204
6363,66639080,6286,66645366,3,0,1,6144,29,2881697905
6364,66646680,3422,66650102,1,0,1,3584,2,9084684409
6365,66648270,3458,66651728,0,0,1,2560,25,10671181317
6366,66655839,6123,66661962,7,0,1,11776,18,5127042390
6367,66674480,192138,66866618,3,0,0,24576,29,10476222209
6368,66681909,566,66682475,7,0,1,512,18,6236828876
6369,66695071,75444,66770515,2,0,0,6144,9,5772141284
6370,66702560,7230,66709790,1,0,1,7680,2,4707625450
6371,66713660,566,66714226,3,0,1,512,29,5887589996
6372,66747740,3387,66751127,0,0,1,9728,25,5573386922
6373,66751680,2470,66754150,0,0,1,2560,25,622807385
6374,66758289,57395,66815684,6,0,0,512,8,2879428593
6375,66764859,113996,66878855,6,0,0,1024,8,1588557953
6376,66765350,5802,66771152,8,0,1,6144,26,6086575071
6377,66799830,162851,66962681,3,0,0,26112,29,2812088746
6378,66802160,227090,67029250,3,0,0,74240,29,9872150788
6379,66804911,3996,66808907,2,0,1,2560,9,6879172663
6380,66808260,4374,66812634,8,0,1,4608,26,8750012061
6381,66815950,175564,66991514,9,0,0,1536,17,3623844256
6382,66839600,1994,66841594,8,0,1,2048,26,566439478
6383,66842340,87359,66929699,9,0,0,1536,17,3311925579
6384,66854630,566,66855196,0,0,1,512,25,9579724210
6385,66854770,1107,66855877,0,0,1,1024,25,402410995
6386,66865040,2136,66867176,3,0,1,512,29,4597465086
6387,66867210,566,66867776,8,0,1,512,26,8923280266
6388,66870890,92430,66963320,9,0,0,2048,17,4305648381
6389,66872469,1042,66873511,7,0,1,1024,18,9428199682
6390,66877190,3422,66880612,8,0,1,3584,26,1476146997
6391,66901121,3422,66904543,2,0,1,3584,9,4267428267
6392,66912979,2946,66915925,7,0,1,3072,18,5821775217
6393,66917770,4850,66922620,1,0,1,5120,2,3677779351
6394,66933651,1042,66934693,2,0,1,1024,9,2352708869
6395,66945639,5454,66951093,7,0,1,13824,18,2608952801
6396,66961241,8349,66969590,2,0,1,6656,9,8883421805
6397,66964080,7280,66971360,8,0,1,14848,26,1135884046
6398,66970961,4850,66975811,2,0,1,5120,9,6286475567
6399,66971550,7807,66979357,8,0,1,5632,26,4687277158
6400,66995950,33315,67029265,1,0,1,27136,2,4803057135
6401,67001990,27298,67029288,8,0,1,3072,26,2358254818
6402,67011540,29275,67040815,3,0,1,18944,29,10393414840
6403,67023591,65928,67089519,1,0,0,512,2,6506598443
6404,67029491,11990,67041481,2,0,1,11264,9,5195433182
6405,67035920,6843,67042763,3,0,1,11264,29,4701289597
6406,67036921,6508,67043429,2,0,1,1024,9,1434018317
6407,67046790,1518,67048308,8,0,1,1536,26,2887201621
6408,67053250,1042,67054292,3,0,1,1024,29,943713384
6409,67059050,321348,67380398,3,0,0,70144,29,10575916812
6410,67088909,625,67089534,7,0,1,512,18,6253342452
6411,67094000,305601,67399601,3,0,0,62976,29,3226483733
6412,67118890,175590,67294480,3,0,0,30720,29,3677130915
6413,67121760,3387,67125147,0,0,1,9728,25,4021311492
6414,67128269,1518,67129787,7,0,1,1536,18,1034838977
6415,67128360,2093,67130453,8,0,1,1024,26,4063024894
6416,67144520,140562,67285082,3,0,0,67072,29,1747823939
6417,67150630,147485,67298115,3,0,0,11776,29,9665247505
6418,67171470,3387,67174857,3,0,1,9728,29,9907984876
6419,67172209,5919,67178128,7,0,1,10240,18,7273163445
6420,67186789,221054,67407843,6,0,0,512,8,239373654
6421,67189750,4850,67194600,8,0,1,5120,26,9841187557
6422,67190490,132914,67323404,9,0,0,4096,17,10560876579
6423,67197440,3898,67201338,0,0,1,4096,25,9009601509
6424,67206510,137112,67343622,3,0,0,6144,29,988984982
6425,67214250,237004,67451254,3,0,0,20992,29,6184592034
6426,67221689,76605,67298294,6,0,0,512,8,10492794817
6427,67243220,183477,67426697,9,0,0,512,17,1067256931
6428,67264119,20978,67285097,7,0,1,5120,18,3765298259
6429,67269361,30955,67300316,2,0,1,6144,9,10269867180
6430,67280859,119069,67399928,6,0,0,1024,8,5719354046
6431,67282569,117866,67400435,6,0,0,1536,8,7942991927
6432,67284830,17406,67302236,8,0,1,11264,26,7674583557
6433,67306210,6278,67312488,3,0,1,6656,29,3770591999
6434,67314340,137587,67451927,9,0,0,1536,17,2504903027
6435,67321760,1659,67323419,5,0,1,1536,15,4136766573
6436,67324469,1518,67325987,6,0,1,1536,8,7843184265
6437,67324780,185642,67510422,9,0,0,1536,17,274038396
6438,67330850,1518,67332368,3,0,1,1536,29,3862233437
6439,67349629,2946,67352575,7,0,1,3072,18,8483574945
6440,67370599,31338,67401937,7,0,1,1536,18,3363657985
6441,67382469,20134,67402603,6,0,1,1024,8,7092421164
6442,67387140,21765,67408905,3,0,1,8192,29,3862371262
6443,67393020,21949,67414969,3,0,1,18432,29,1015542409
6444,67403050,15465,67418515,8,0,1,5632,26,10463328635
6445,67409770,11651,67421421,3,0,1,4608,29,1387528366
6446,67425510,2946,67428456,8,0,1,3072,26,5699155237
6447,67428571,6754,67435325,2,0,1,7168,9,394589374
6448,67438849,3645,67442494,6,0,1,10240,8,9108074514
6449,67447339,128019,67575358,6,0,0,512,8,7885224799
6450,67447979,211831,67659810,6,0,0,36352,8,7188903122
6451,67450120,2218,67452338,8,0,1,1024,26,8822995869
6452,67458409,6278,67464687,6,0,1,6656,8,3639151471
6453,67462791,3645,67466436,2,0,1,10240,9,1948228952
6454,67467060,1042,67468102,3,0,1,1024,29,5922558242
6455,67469300,2470,67471770,0,0,1,2560,25,7148035393
6456,67476800,3904,67480704,0,0,1,10752,25,3201192098
6457,67478029,16900,67494929,7,0,1,28672,18,1016774969
6458,67483669,11414,67495083,7,0,1,8704,18,440317009
6459,67484530,11539,67496069,0,0,1,1536,25,1523581825
6460,67485071,20650,67505721,2,0,1,23040,9,3559896344
6461,67488211,19776,67507987,2,0,1,3584,9,2973345799
6462,67495959,273768,67769727,6,0,0,40960,8,7152907717
6463,67500940,249217,67750157,3,0,0,26112,29,3874401760
6464,67506610,3827,67510437,1,0,1,9728,2,7850473543
6465,67520179,5971,67526150,7,0,1,14848,18,7781285528
6466,67521290,5846,67527136,3,0,1,1536,29,1535504547
6467,67522049,5433,67527482,7,0,1,512,18,4819254836
6468,67535450,239310,67774760,3,0,0,6144,29,84245434
6469,67539120,566,67539686,3,0,1,512,29,6894133936
6470,67539690,3649,67543339,5,0,1,10240,15,1028370287
6471,67552889,3128,67556017,7,0,1,9216,18,1906873973
6472,67564059,230185,67794244,6,0,0,15360,8,6163742708
6473,67566119,3422,67569541,7,0,1,3584,18,6603285663
6474,67566560,5567,67572127,5,0,1,4096,15,1558658599
6475,67600750,1042,67601792,5,0,1,1024,15,10524034641
6476,67608211,271917,67880128,2,0,0,37888,9,4417918696
6477,67615339,15321,67630660,6,0,1,29696,8,6028857991
6478,67630390,616,67631006,3,0,1,512,29,1166649157
6479,67649510,14729,67664239,8,0,1,11776,26,8213780514
6480,67658560,12077,67670637,5,0,1,7680,15,1504025008
6481,67662651,241736,67904387,2,0,0,12800,9,6336404497
6482,67664891,234294,67899185,2,0,0,58368,9,6555041621
6483,67671949,2870,67674819,6,0,1,8704,8,5478094543
6484,67679029,566,67679595,7,0,1,512,18,271748481
6485,67699271,98576,67797847,2,0,0,11776,9,963027507
6486,67715900,2470,67718370,3,0,1,2560,29,6955112255
6487,67732390,5326,67737716,0,0,1,5632,25,8256730535
6488,67740470,159986,67900456,3,0,0,4096,29,117201549
6489,67755680,566,67756246,3,0,1,512,29,3208735066
6490,67775680,160062,67935742,3,0,0,32768,29,8469364915
6491,67813920,2470,67816390,8,0,1,2560,26,6082869510
6492,67814810,2566,67817376,5,0,1,1536,15,8400647337
6493,67817050,3898,67820948,8,0,1,4096,26,3766095038
6494,67832640,7230,67839870,4,0,1,7680,14,420616352
6495,67848100,566,67848666,8,0,1,512,26,3630450984
6496,67852510,371695,68224205,3,0,0,114176,29,639030481
6497,67862679,2470,67865149,6,0,1,2560,8,10262232248
6498,67866710,247745,68114455,3,0,0,13824,29,3526074788
6499,67881710,302751,68184461,3,0,0,165376,29,6597782284
6500,67887129,18735,67905864,7,0,1,1536,18,10660989550
6501,67894520,13164,67907684,5,0,1,8704,15,5441701677
6502,67912301,216683,68128984,2,0,0,13312,9,4092076768
6503,67930920,6332,67937252,3,0,1,1536,29,7682207806
6504,67938730,3898,67942628,8,0,1,4096,26,5784664773
6505,67945559,2470,67948029,7,0,1,2560,18,1556692583
6506,67952390,1994,67954384,5,0,1,2048,15,5304728153
6507,67974620,212828,68187448,3,0,0,9728,29,1409205409
6508,67980829,1518,67982347,7,0,1,1536,18,8900989069
6509,68000920,1518,68002438,3,0,1,1536,29,8668660530
6510,68004449,1042,68005491,7,0,1,1024,18,7461205200
6511,68013961,243682,68257643,2,0,0,33280,9,5032244485
6512,68062400,1518,68063918,5,0,1,1536,15,175359264
6513,68077959,159224,68237183,6,0,0,42496,8,5543803221
6514,68090180,13600,68103780,3,0,1,23040,29,8402953074
6515,68122261,239950,68362211,2,0,0,76800,9,5270771647
6516,68162930,61290,68224220,5,0,1,2560,15,10543396804
6517,68223680,17869,68241549,1,0,1,4608,2,9918747919
6518,68237589,261406,68498995,6,0,0,51712,8,5779920583
6519,68238379,216956,68455335,6,0,0,10240,8,3606828175
6520,68247450,14831,68262281,1,0,1,12288,2,10543435864
6521,68253450,9177,68262627,1,0,1,512,2,3439194454
6522,68262869,100621,68363490,6,0,0,4096,8,2488767908
6523,68293369,5326,68298695,9,0,1,5632,17,469704938
6524,68293550,22983,68316533,3,0,1,34816,29,3675411142
6525,68333180,4850,68338030,5,0,1,5120,15,9417585538
6526,68339260,26759,68366019,1,0,1,2560,2,10557118508
6527,68347830,19495,68367325,1,0,1,2048,2,674325844
6528,68351100,24869,68375969,5,0,1,17920,15,9732520844
6529,68356720,22795,68379515,5,0,1,5632,15,1280841881
6530,68357280,23221,68380501,5,0,1,1536,15,8041198472
6531,68360980,22427,68383407,1,0,1,4608,2,2872922445
6532,68365460,226708,68592168,3,0,0,8704,29,7945872296
6533,68371250,13463,68384713,1,0,1,2048,2,8206185220
6534,68394470,2946,68397416,1,0,1,3072,2,3276320413
6535,68400359,6278,68406637,9,0,1,6656,17,7777274344
6536,68409300,3645,68412945,5,0,1,10240,15,493820314
6537,68443420,5712,68449132,3,0,1,14336,29,2695226923
6538,68473959,260485,68734444,6,0,0,16384,8,8234395528
6539,68484950,17476,68502426,5,0,1,3584,15,10228745468
6540,68488290,14482,68502772,5,0,1,512,15,4531936103
6541,68512141,193280,68705421,2,0,0,69632,9,6548118354
6542,68527810,4679,68532489,3,0,1,12288,29,851310866
6543,68531920,1994,68533914,3,0,1,2048,29,2812066048
6544,68532170,329128,68861298,3,0,0,9216,29,7945164844
6545,68547969,266283,68814252,6,0,0,7168,8,6635540545
6546,68565619,232624,68798243,6,0,0,41984,8,9725817631
6547,68571350,213584,68784934,3,0,0,65024,29,4802076968
6548,68596300,347471,68943771,7,0,0,24576,18,6845342432
6549,68601020,1994,68603014,5,0,1,2048,15,7949006170
6550,68611170,1518,68612688,3,0,1,1536,29,5627950660
6551,68612481,139809,68752290,2,0,0,1536,9,7289625381
6552,68622659,206309,68828968,6,0,0,47104,8,6961572010
6553,68646660,354312,69000972,3,0,0,43520,29,9968360268
6554,68668329,210259,68878588,6,0,0,48640,8,6673758815
6555,68702831,369460,69072291,2,0,0,32256,9,9807209606
6556,68719079,81207,68800286,6,0,0,6656,8,5163985041
6557,68721870,566,68722436,5,0,1,512,15,989408673
6558,68767591,279614,69047205,2,0,0,127488,9,9630817710
6559,68795200,10404,68805604,3,0,1,5632,29,1223581044
6560,68808830,5437,68814267,3,0,1,4096,29,10152808564
6561,68839359,168492,69007851,6,0,0,22528,8,1035498950
6562,68842830,386430,69229260,3,0,0,4096,29,349095775
6563,68845250,4850,68850100,3,0,1,5120,29,3901655570
6564,68847609,356041,69203650,6,0,0,52736,8,1948565095
6565,68863619,84512,68948131,6,0,0,12800,8,4371478564
6566,68869490,12036,68881526,0,0,1,3072,25,9463544741
6567,68878649,176714,69055363,6,0,0,7168,8,1043630140
6568,68878710,368387,69247097,8,0,0,14848,26,2780052158
6569,68879581,295656,69175237,2,0,0,2048,9,4885960257
6570,68903720,269399,69173119,8,0,0,81920,26,8001318916
6571,68911250,400484,69311734,3,0,0,56832,29,4207931630
6572,68916320,3901,68920221,0,0,1,4096,25,8809084044
6573,68920190,135968,69056158,3,0,0,2560,29,6288823353
6574,68923879,361438,69285317,6,0,0,121856,8,1218610602
6575,68925659,6229,68931888,6,0,1,15360,8,1753785012
6576,68933040,175255,69108295,3,0,0,22016,29,10057667553
6577,68933530,10256,68943786,5,0,1,13824,15,176941894
6578,68942100,6046,68948146,5,0,1,512,15,6521496031
6579,68948910,5802,68954712,0,0,1,6144,25,8776404237
6580,68969699,378582,69348281,6,0,0,72704,8,7201008466
6581,68975700,4850,68980550,5,0,1,5120,15,571404443
6582,68991600,55628,69047228,3,0,1,1536,29,4311490585
6583,69009100,409529,69418629,3,0,0,1536,29,7380164532
6584,69039551,253893,69293444,2,0,0,26624,9,822106882
6585,69042421,274820,69317241,2,0,0,17920,9,8142385584
6586,69066179,12858,69079037,6,0,1,7168,8,10731001220
6587,69111369,254928,69366297,6,0,0,58368,8,1650142173
6588,69112710,235742,69348452,3,0,0,512,29,9721565389
6589,69145859,148544,69294403,6,0,0,3072,8,10424380164
6590,69147680,25454,69173134,0,0,1,512,25,1573249758
6591,69153141,446707,69599848,2,0,0,13312,9,1546378401
6592,69164750,11840,69176590,3,0,1,3584,29,5962103969
6593,69166949,220830,69387779,6,0,0,15872,8,2901144318
6594,69183610,1042,69184652,5,0,1,1024,15,421876057
6595,69210900,290983,69501883,3,0,0,2560,29,1334609320
6596,69216239,270391,69486630,6,0,0,35840,8,1827349900
6597,69219281,234708,69453989,2,0,0,10240,9,2635416045
6598,69219520,1042,69220562,3,0,1,1024,29,3700481132
6599,69243351,174795,69418146,2,0,0,55296,9,8383122797
6600,69261759,55513,69317272,9,0,1,512,17,2873133887
6601,69284140,36472,69320612,5,0,1,9728,15,3249583983
6602,69286620,84927,69371547,8,0,0,2560,26,10555821662
6603,69296791,270232,69567023,2,0,0,51712,9,9664211712
6604,69305710,19841,69325551,5,0,1,5632,15,2005129295
6605,69314270,34197,69348467,5,0,1,4608,15,3242563499
6606,69320640,27842,69348482,3,0,1,2560,29,7622804130
6607,69325520,174423,69499943,8,0,0,8704,26,2796220174
6608,69332090,116284,69448374,9,0,0,1024,17,2786528844
6609,69334180,32692,69366872,3,0,1,512,29,2624731332
6610,69341139,26079,69367218,9,0,1,512,17,2760069643
6611,69347719,19845,69367564,9,0,1,512,17,10095011298
6612,69355270,13280,69368550,3,0,1,1536,29,6374706344
6613,69382540,5254,69387794,5,0,1,8704,15,2636628353
6614,69396119,254946,69651065,6,0,0,114688,8,1615770237
6615,69414801,160661,69575462,2,0,0,27648,9,5352948172
6616,69446250,566,69446816,5,0,1,512,15,6140745520
6617,69454610,1042,69455652,5,0,1,1024,15,575911146
6618,69462569,3898,69466467,9,0,1,4096,17,1582921921
6619,69471090,2946,69474036,3,0,1,3072,29,1826044776
6620,69482179,7865,69490044,6,0,1,3584,8,8268621258
6621,69524561,192303,69716864,2,0,0,29184,9,3927133432
6622,69532901,158376,69691277,2,0,0,27648,9,5234746389
6623,69577340,255364,69832704,3,0,0,41984,29,4842805872
6624,69580411,181895,69762306,2,0,0,38912,9,10082892167
6625,69591769,12049,69603818,9,0,1,19968,17,6100319368
6626,69593700,182193,69775893,3,0,0,44544,29,5724118045
6627,69603349,180652,69784001,6,0,0,2048,8,1161530722
6628,69605619,3898,69609517,6,0,1,4096,8,1575636738
6629,69610939,251669,69862608,6,0,0,40960,8,2754931683
6630,69627659,208500,69836159,6,0,0,11264,8,8199447208
6631,69642450,335492,69977942,8,0,0,96256,26,9072923595
6632,69658250,233070,69891320,3,0,0,39936,29,6119538460
6633,69672890,5802,69678692,3,0,1,6144,29,414570436
6634,69770229,8602,69778831,7,0,1,3072,18,6559887573
6635,69786590,4374,69790964,5,0,1,4608,15,752333220
6636,69788260,277897,70066157,3,0,0,43008,29,8326479961
6637,69804869,1518,69806387,6,0,1,1536,8,3122740507
6638,69822929,16576,69839505,6,0,1,9728,8,4092794013
6639,69834640,170820,70005460,8,0,0,4608,26,5181517308
6640,69904670,123078,70027748,8,0,0,31744,26,32470287
6641,69942210,3422,69945632,3,0,1,3584,29,5868309589
6642,69958700,26030,69984730,3,0,1,7168,29,9445745177
6643,69959700,204861,70164561,3,0,0,51200,29,9936756235
6644,69968460,20776,69989236,3,0,1,7168,29,7232180835
6645,70039169,3387,70042556,6,0,1,9728,8,1067277673
6646,70046479,6488,70052967,6,0,1,15872,8,1923179657
6647,70063399,9238,70072637,6,0,1,15872,8,213474981
6648,70087610,5712,70093322,3,0,1,14336,29,3002413153
6649,70118440,128381,70246821,3,0,0,21504,29,7545633950
6650,70135010,4374,70139384,8,0,1,4608,26,1570685991
6651,70155190,10447,70165637,5,0,1,1024,15,309725116
6652,70158449,8174,70166623,6,0,1,1536,8,5628145169
6653,70162480,7832,70170312,3,0,1,12800,29,10283191055
6654,70170720,243329,70414049,8,0,0,43008,26,1196778739
6655,70188119,212811,70400930,6,0,0,51712,8,2242347034
6656,70192079,255430,70447509,6,0,0,10240,8,10363994388
6657,70200239,566,70200805,6,0,1,512,8,7095169677
6658,70220900,5326,70226226,8,0,1,5632,26,7762158460
6659,70222929,6843,70229772,6,0,1,5632,8,9661697811
6660,70237720,12737,70250457,5,0,1,24576,15,9116965921
6661,70241960,59507,70301467,8,0,0,1536,26,9782229648
6662,70270970,12308,70283278,5,0,1,20480,15,10616738171
6663,70286530,201473,70488003,3,0,0,21504,29,2711142720
6664,70296250,135431,70431681,3,0,0,39424,29,9414785392
6665,70313320,3898,70317218,5,0,1,4096,15,4734885686
6666,70321079,2946,70324025,6,0,1,3072,8,4220920819
6667,70324940,7706,70332646,3,0,1,8192,29,6533429873
6668,70328109,207883,70535992,6,0,0,26112,8,10517329166
6669,70334630,171553,70506183,3,0,0,13312,29,3454984366
6670,70336610,26479,70363089,5,0,1,48128,15,4221064765
6671,70338860,24895,70363755,3,0,1,1024,29,4170828471
6672,70357961,7740,70365701,4,0,1,3072,14,1370019182
6673,70361470,7777,70369247,3,0,1,5632,29,1506054742
6674,70394850,20250,70415100,4,0,1,1024,14,9821405172
6675,70408410,9605,70418015,4,0,1,10240,14,8161497055
6676,70418890,13341,70432231,5,0,1,22528,15,3984481879
6677,70434849,256182,70691031,6,0,0,17920,8,1977198887
6678,70435149,3387,70438536,6,0,1,9728,8,5789474194
6679,70443980,106446,70550426,5,0,1,177152,15,9296338142
6680,70456460,387157,70843617,3,0,0,15360,29,739450941
6681,70465940,265519,70731459,3,0,0,24576,29,5560237095
6682,70493580,205996,70699576,3,0,0,3072,29,6192794678
6683,70501500,49797,70551297,3,0,1,12288,29,8884611602
6684,70513250,40953,70554203,3,0,1,4608,29,8740888233
6685,70523090,37424,70560514,5,0,1,30208,15,467784605
6686,70526300,38080,70564380,3,0,1,6144,29,2731294185
6687,70526569,434014,70960583,6,0,0,118784,8,10398496088
6688,70532139,375517,70907656,6,0,0,92160,8,3375644791
6689,70535139,29497,70564636,6,0,1,9216,8,2559167256
6690,70547069,171273,70718342,6,0,0,22016,8,1798179720
6691,70554730,10252,70564982,1,0,1,512,2,6887398301
6692,70568870,1042,70569912,8,0,1,1024,26,8825061410
6693,70578641,2470,70581111,4,0,1,2560,14,9925947104
6694,70579789,3904,70583693,6,0,1,10752,8,507540077
6695,70585020,322963,70907983,3,0,0,1024,29,10278533676
6696,70586710,11533,70598243,8,0,1,18944,26,2993010691
6697,70601990,566,70602556,8,0,1,512,26,7448372212
6698,70621989,287281,70909270,6,0,0,4096,8,8557679792
6699,70639819,11016,70650835,6,0,1,17920,8,1808086398
6700,70641760,10701,70652461,0,0,1,2560,25,5629387316
6701,70680959,351648,71032607,6,0,0,35328,8,5561938682
6702,70692350,11533,70703883,3,0,1,18944,29,3240529331
6703,70694421,10333,70704754,2,0,1,12288,9,7666977667
6704,70694630,419775,71114405,3,0,0,512,29,588818780
6705,70711880,89895,70801775,5,0,1,135680,15,5173537202
6706,70731659,70782,70802441,6,0,1,1024,8,1524861257
6707,70747389,57318,70804707,6,0,1,3584,8,8760629929
6708,70756069,358120,71114189,6,0,0,86016,8,3280251845
6709,70758540,46513,70805053,0,0,1,512,25,7732307289
6710,70764849,40870,70805719,6,0,1,1024,8,4766273649
6711,70769090,36975,70806065,0,0,1,512,25,5736278514
6712,70771580,38031,70809611,4,0,1,5632,14,6290460579
6713,70771650,38307,70809957,0,0,1,512,25,6684986927
6714,70784189,302877,71087066,6,0,0,178688,8,9215372124
6715,70794579,18284,70812863,6,0,1,4608,8,8208702924
6716,70794589,18428,70813017,9,0,1,8704,17,6518827303
6717,70798590,14773,70813363,0,0,1,512,25,1561067183
6718,70830811,5454,70836265,2,0,1,13824,9,3397236387
6719,70846979,380499,71227478,6,0,0,34304,8,7181058392
6720,70902769,10389,70913158,6,0,1,10752,8,10281724546
6721,70903369,328515,71231884,6,0,0,14336,8,5075544535
6722,70904850,55756,70960606,5,0,1,22528,15,6552335741
6723,70907730,52899,70960629,0,0,1,512,25,2596778707
6724,70910811,49833,70960644,2,0,1,11776,9,4554954579
6725,70920980,166617,71087597,3,0,0,1536,29,3881142414
6726,70924510,42509,70967019,0,0,1,6656,25,8951424867
6727,70926050,269769,71195819,3,0,0,1536,29,7783233852
6728,70928109,41496,70969605,6,0,1,4096,8,3071665856
6729,70928539,345206,71273745,6,0,0,1536,8,7429212407
6730,70934510,153298,71087808,3,0,0,512,29,5842134728
6731,70943269,31521,70974790,6,0,1,16384,8,886332640
6732,70959310,16044,70975354,0,0,1,10752,25,3253805846
6733,70961909,512998,71474907,6,0,0,20480,8,1960090726
6734,70968080,9860,70977940,4,0,1,4096,14,4796653275
6735,70970411,11715,70982126,2,0,1,6656,9,6577187069
6736,70973670,345886,71319556,8,0,0,10752,26,10038600495
6737,70985760,5326,70991086,0,0,1,5632,25,4381920981
6738,70996301,1042,70997343,2,0,1,1024,9,654909938
6739,71004559,1042,71005601,6,0,1,1024,8,8168097084
6740,71035261,78943,71114204,2,0,1,4608,9,6470009169
6741,71043740,70479,71114219,0,0,1,2560,25,1682544037
6742,71045920,288989,71334909,8,0,0,40960,26,269187004
6743,71046579,67655,71114234,6,0,1,512,8,2912911886
6744,71054429,59991,71114420,6,0,1,5120,8,2551327381
6745,71069201,45234,71114435,2,0,1,1024,9,802981301
6746,71073809,40641,71114450,6,0,1,1024,8,4939051317
6747,71073899,550193,71624092,6,0,0,28160,8,9635346249
6748,71077389,37076,71114465,6,0,1,12800,8,10555848706
6749,71079540,34940,71114480,4,0,1,512,14,2730959966
6750,71080909,381694,71462603,6,0,0,53760,8,7398964540
6751,71102540,342241,71444781,8,0,0,89088,26,2296146829
6752,71102630,12500,71115130,0,0,1,512,25,2391634446
6753,71105879,19340,71125219,6,0,1,16896,8,528572981
6754,71110529,16956,71127485,6,0,1,3584,8,6213014197
6755,71111170,335038,71446208,8,0,0,4608,26,9423936849
6756,71126609,246244,71372853,6,0,0,14336,8,5334648815
6757,71146069,7230,71153299,6,0,1,7680,8,1704686190
6758,71148041,7204,71155245,2,0,1,3072,9,6805390101
6759,71157971,5802,71163773,2,0,1,6144,9,1032944783
6760,71194940,79246,71274186,3,0,0,512,29,3578414134
6761,71200799,1042,71201841,6,0,1,1024,8,519631310
6762,71204019,2946,71206965,6,0,1,3072,8,5631062832
6763,71209759,354278,71564037,6,0,0,120320,8,847646311
6764,71210189,4374,71214563,6,0,1,4608,8,2804357844
6765,71216520,10973,71227493,4,0,1,2048,14,10270079825
6766,71223620,14977,71238597,0,0,1,7168,25,8571142475
6767,71233321,5622,71238943,2,0,1,512,9,2087971480
6768,71264670,4850,71269520,4,0,1,5120,14,2863307553
6769,71277610,1994,71279604,4,0,1,2048,14,2470676993
6770,71283030,566,71283596,4,0,1,512,14,9857684471
6771,71293671,1042,71294713,2,0,1,1024,9,3203259722
6772,71295170,93182,71388352,3,0,0,512,29,3900866736
6773,71299030,274850,71573880,8,0,0,32256,26,2955739067
6774,71301129,2870,71303999,6,0,1,8704,8,7274702760
6775,71303401,8135,71311536,2,0,1,8192,9,9151707722
6776,71326350,12942,71339292,0,0,1,4608,25,5413032494
6777,71333369,279455,71612824,6,0,0,16384,8,343203205
6778,71343231,3898,71347129,2,0,1,4096,9,1820120640
6779,71354190,260989,71615179,8,0,0,7680,26,2890066846
6780,71381330,2946,71384276,4,0,1,3072,14,10299173683
6781,71425060,43354,71468414,4,0,1,6144,14,1472626427
6782,71430259,38309,71468568,7,0,1,8704,18,1646308667
6783,71441560,33362,71474922,0,0,1,1536,25,5304829939
6784,71452420,22517,71474937,8,0,1,2560,26,649373787
6785,71452680,67603,71520283,5,0,1,83968,15,3292640310
6786,71453921,70548,71524469,2,0,1,6656,9,8048427608
6787,71455500,118395,71573895,0,0,1,7680,25,10065169150
6788,71461419,112856,71574275,6,0,0,1024,8,1757062704
6789,71467289,512327,71979616,6,0,0,272384,8,2492147988
6790,71472459,101459,71573918,6,0,1,6144,8,2325138667
6791,71508779,65154,71573933,6,0,1,6656,8,7899408582
6792,71509059,64889,71573948,6,0,1,1536,8,10114753645
6793,71517080,233310,71750390,3,0,0,2048,29,103207683
6794,71518450,56012,71574462,3,0,0,512,29,1324588657
6795,71521659,513048,72034707,6,0,0,45056,8,813957183
6796,71532741,44150,71576891,2,0,1,2560,9,8009346971
6797,71558040,457362,72015402,8,0,0,91136,26,2472244944
6798,71561349,17808,71579157,9,0,1,3584,17,9077029687
6799,71579799,6754,71586553,6,0,1,7168,8,2488190507
6800,71582430,8309,71590739,0,0,1,6656,25,8002789267
6801,71605109,1042,71606151,6,0,1,1024,8,5749651978
6802,71612271,11836,71624107,2,0,1,3072,9,10541294941
6803,71622850,4671,71627521,0,0,1,3584,25,2668895473
6804,71651689,415818,72067507,6,0,0,33280,8,5416837232
6805,71661189,1994,71663183,6,0,1,2048,8,3180188694
6806,71662750,224419,71887169,3,0,0,1536,29,9675686451
6807,71680811,1994,71682805,2,0,1,2048,9,7440618719
6808,71691820,1518,71693338,0,0,1,1536,25,9198838297
6809,71694030,107963,71801993,8,0,0,1024,26,3361124823
6810,71709930,3422,71713352,0,0,1,3584,25,8539509321
6811,71734529,253066,71987595,6,0,0,26112,8,73834343
6812,71741930,2870,71744800,4,0,1,8704,14,4036418534
6813,71762170,258722,72020892,8,0,0,17408,26,7376795316
6814,71768570,247003,72015573,3,0,0,512,29,209534971
6815,71786170,566,71786736,4,0,1,512,14,1377109598
6816,71797240,4850,71802090,0,0,1,5120,25,3609005641
6817,71802469,1518,71803987,6,0,1,1536,8,586622841
6818,71813160,16354,71829514,4,0,1,31744,14,3965641614
6819,71825960,4220,71830180,0,0,1,1024,25,5166908329
6820,71826990,54969,71881959,3,0,0,512,29,3004173580
6821,71827960,211146,72039106,8,0,0,14336,26,3741232299
6822,71830589,3422,71834011,6,0,1,3584,8,7078031322
6823,71831891,6306,71838197,2,0,1,6656,9,6562937132
6824,71868520,178315,72046835,3,0,0,1536,29,5276912043
6825,71869089,3898,71872987,6,0,1,4096,8,10375968333
6826,71909980,129157,72039137,0,0,1,3584,25,9778408568
6827,71930840,108328,72039168,0,0,1,3584,25,6486915184
6828,71937180,134031,72071211,3,0,0,512,29,3523935307
6829,71942399,96784,72039183,6,0,1,6656,8,7915820444
6830,71970640,138854,72109494,3,0,0,512,29,9761568528
6831,71972560,66646,72039206,4,0,1,2560,14,2295249272
6832,71981579,58528,72040107,6,0,1,1024,8,6541690995
6833,71985909,59270,72045179,6,0,1,6144,8,9203403247
6834,72012861,34264,72047125,2,0,1,3072,9,1748482154
6835,72013190,35881,72049071,4,0,1,3072,14,5839158286
6836,72019979,234242,72254221,6,0,0,7168,8,1634606575
6837,72030771,20246,72051017,2,0,1,3072,9,7603971576
6838,72040591,13972,72054563,2,0,1,5632,9,2859796228
6839,72052589,3600,72056189,6,0,1,2560,8,9358161409
6840,72068510,2946,72071456,4,0,1,3072,14,7881306027
6841,72089139,3422,72092561,9,0,1,3584,17,4416080612
6842,72090440,4387,72094827,4,0,1,3584,14,8550229262
6843,72092109,254806,72346915,6,0,0,68096,8,5544719008
6844,72095870,111456,72207326,3,0,0,1024,29,8657766237
6845,72097969,271312,72369281,6,0,0,4096,8,8566043893
6846,72101069,3898,72104967,6,0,1,4096,8,8001843663
6847,72107201,2946,72110147,2,0,1,3072,9,7175373971
6848,72109500,993,72110493,0,0,1,512,25,2255990150
6849,72114360,4420,72118780,5,0,1,11776,15,10504849762
6850,72119230,1042,72120272,0,0,1,1024,25,7509303503
6851,72137680,3898,72141578,0,0,1,4096,25,4425213765
6852,72139290,5971,72145261,5,0,1,14848,15,3151372101
6853,72170301,4850,72175151,2,0,1,5120,9,9758408658
6854,72172039,3904,72175943,6,0,1,10752,8,384811466
6855,72175580,15837,72191417,5,0,1,30720,15,6932759668
6856,72179359,13044,72192403,9,0,1,1536,17,9017698737
6857,72195830,7230,72203060,4,0,1,7680,14,1987797254
6858,72211120,33850,72244970,5,0,1,55808,15,258530809
6859,72211950,37526,72249476,4,0,1,7168,14,5894736815
6860,72223599,27183,72250782,6,0,1,2048,8,1533348704
6861,72236810,180144,72416954,3,0,0,1024,29,712322575
6862,72238750,164834,72403584,3,0,0,512,29,86389234
6863,72262841,5326,72268167,2,0,1,5632,9,5506680587
6864,72270840,5326,72276166,1,0,1,5632,2,10121454511
6865,72292530,11274,72303804,5,0,1,18432,15,8437849846
6866,72316890,96655,72413545,3,0,0,1024,29,6511492026
6867,72319351,3422,72322773,2,0,1,3584,9,2997518010
6868,72320930,4937,72325867,4,0,1,12800,14,7239559466
6869,72353429,5802,72359231,6,0,1,6144,8,856391763
6870,72353460,65752,72419212,5,0,1,107520,15,9440424872
6871,72377150,42523,72419673,1,0,1,10240,2,3771428435
6872,72389159,37235,72426394,6,0,1,24064,8,2148058802
6873,72391390,36630,72428020,4,0,1,2560,14,6023656972
6874,72407840,30600,72438440,5,0,1,33280,15,5058224202
6875,72420119,20907,72441026,6,0,1,4096,8,4966595982
6876,72421389,266141,72687530,6,0,0,118784,8,96111190
6877,72433500,11072,72444572,5,0,1,5632,15,3585980537
6878,72438291,6947,72445238,2,0,1,1024,9,2171403395
6879,72444329,6754,72451083,6,0,1,7168,8,6504304166
6880,72446820,105956,72552776,8,0,0,32768,26,1025851330
6881,72451480,468853,72920333,8,0,0,109056,26,5241145914
6882,72455970,333413,72789383,8,0,0,41472,26,4543482886
6883,72458360,566,72458926,4,0,1,512,14,4158173262
6884,72460261,566,72460827,2,0,1,512,9,5901713367
6885,72470439,566,72471005,6,0,1,512,8,1370117015
6886,72477209,272413,72749622,6,0,0,2048,8,1596989592
6887,72478520,3898,72482418,4,0,1,4096,14,1902052917
6888,72487449,2870,72490319,6,0,1,8704,8,9369032893
6889,72498980,351260,72850240,8,0,0,58368,26,3012665578
6890,72501120,426299,72927419,3,0,0,1024,29,1698442779
6891,72517829,2870,72520699,7,0,1,8704,18,8217576849
6892,72533591,6754,72540345,2,0,1,7168,9,6396923212
6893,72557649,262291,72819940,6,0,0,10752,8,6112449071
6894,72567489,10499,72577988,6,0,1,16896,8,2531927018
6895,72570689,8170,72578859,7,0,1,12288,18,2763498260
6896,72571280,352858,72924138,8,0,0,12288,26,4634273785
6897,72603070,351856,72954926,3,0,0,27648,29,5243557945
6898,72629929,4162,72634091,6,0,1,11264,8,1070739626
6899,72635819,382908,73018727,6,0,0,29184,8,792676155
6900,72655739,33919,72689658,7,0,1,2048,18,9434592335
6901,72656899,458322,73115221,6,0,0,104960,8,3741021826
6902,72660571,31673,72692244,2,0,1,4096,9,6487746111
6903,72665129,30661,72695790,6,0,1,5632,8,2971507790
6904,72668800,128516,72797316,8,0,0,11264,26,7193041015
6905,72669480,30496,72699976,5,0,1,6656,15,7173649019
6906,72675630,25012,72700642,1,0,1,1024,2,4407370865
6907,72688509,12799,72701308,6,0,1,1024,8,8355140465
6908,72689190,638288,73327478,8,0,0,59904,26,281225845
6909,72691849,10125,72701974,6,0,1,1024,8,4840805977
6910,72691879,11721,72703600,7,0,1,2560,18,6557042500
6911,72692180,434467,73126647,3,0,0,37376,29,1220253354
6912,72695860,9046,72704906,5,0,1,2048,15,9216016357
6913,72701100,11274,72712374,1,0,1,18432,2,8715305181
6914,72704099,9760,72713859,7,0,1,15360,18,9986536153
6915,72709909,4296,72714205,6,0,1,512,8,3244975594
6916,72712180,297609,73009789,8,0,0,73728,26,1172057202
6917,72714340,570985,73285325,8,0,0,60928,26,5311291627
6918,72718790,566,72719356,1,0,1,512,2,10349490821
6919,72727480,510666,73238146,8,0,0,44032,26,4451817531
6920,72734379,239037,72973416,6,0,0,12288,8,2482953861
6921,72734820,433524,73168344,3,0,0,59392,29,4358639963
6922,72741881,1994,72743875,2,0,1,2048,9,10105827584
6923,72752461,1518,72753979,2,0,1,1536,9,7452086459
6924,72755059,395144,73150203,6,0,0,45056,8,7218796783
6925,72758890,488163,73247053,3,0,0,29184,29,8666870780
6926,72760550,1042,72761592,5,0,1,1024,15,2441037618
6927,72775590,13808,72789398,5,0,1,2560,15,2420233828
6928,72784140,13191,72797331,1,0,1,12288,2,10127421208
6929,72789720,7626,72797346,5,0,1,512,15,4303540510
6930,72796159,3173,72799332,6,0,1,2048,8,5759378880
6931,72803030,328352,73131382,8,0,0,15360,26,7465271989
6932,72806590,566,72807156,5,0,1,512,15,8283932251
6933,72813591,6364,72819955,2,0,1,4096,9,2784286275
6934,72831641,566,72832207,2,0,1,512,9,10564150599
6935,72833620,21566,72855186,5,0,1,12800,15,273043593
6936,72841890,23533,72865423,1,0,1,18432,2,6995177656
6937,72852209,15480,72867689,7,0,1,3584,18,8040288676
6938,72876800,43556,72920356,1,0,1,23040,2,1675723839
6939,72883050,37329,72920379,0,0,1,7680,25,5300225770
6940,72888340,498616,73386956,3,0,0,27136,29,4353835213
6941,72894379,33215,72927594,6,0,1,3584,8,9870542679
6942,72904390,23870,72928260,4,0,1,1024,14,1291876609
6943,72915019,13587,72928606,6,0,1,512,8,1673964967
6944,72917299,287749,73205048,6,0,0,14336,8,5740795320
6945,72924389,6588,72930977,6,0,1,13312,8,7338746466
6946,72935780,1518,72937298,4,0,1,1536,14,8493647732
6947,72938710,2470,72941180,5,0,1,2560,15,4391383021
6948,72951231,6633,72957864,2,0,1,3072,9,6919049525
6949,72955801,3369,72959170,2,0,1,2048,9,7662211637
6950,72963571,4850,72968421,2,0,1,5120,9,5934107607
6951,72982440,2470,72984910,4,0,1,2560,14,6041924588
6952,72986481,23331,73009812,2,0,1,3584,9,10472366704
6953,72988560,33821,73022381,3,0,1,10240,29,4242341091
6954,72990940,301051,73291991,8,0,0,1024,26,4600555246
6955,72999320,25507,73024827,4,0,1,3072,14,10708394298
6956,73005330,358254,73363584,8,0,0,8192,26,5510742206
6957,73013489,455054,73468543,6,0,0,78848,8,10038913847
6958,73032079,3128,73035207,7,0,1,9216,18,6339330624
6959,73036310,2870,73039180,3,0,1,8704,29,1727560729
6960,73060060,3422,73063482,1,0,1,3584,2,5307222397
6961,73071539,289502,73361041,6,0,0,110080,8,7447163711
6962,73077991,1042,73079033,2,0,1,1024,9,6203231037
6963,73078861,36375,73115236,2,0,1,7680,9,8925857438
6964,73098501,32944,73131445,2,0,1,2560,9,6095399670
6965,73110379,25862,73136241,7,0,1,5120,18,10567616022
6966,73111140,39078,73150218,1,0,1,6144,2,2001199289
6967,73114490,35743,73150233,8,0,1,14848,26,707576882
6968,73116350,52017,73168367,3,0,1,7168,29,7678702262
6969,73118721,49661,73168382,2,0,1,1024,9,412562012
6970,73123900,44497,73168397,3,0,1,5632,29,6112396482
6971,73143039,28764,73171803,7,0,1,3584,18,3117660970
6972,73165440,238819,73404259,8,0,0,29184,26,4481019447
6973,73186830,1042,73187872,3,0,1,1024,29,8390867927
6974,73188250,1994,73190244,3,0,1,2048,29,5157378891
6975,73192621,1042,73193663,2,0,1,1024,9,4861636229
6976,73195410,9653,73205063,0,0,1,7168,25,7124456363
6977,73206800,7230,73214030,1,0,1,7680,2,9995469347
6978,73224220,295299,73519519,3,0,0,67584,29,9858383197
6979,73241980,8487,73250467,0,0,1,3584,25,4034389253
6980,73250129,143268,73393397,6,0,0,20992,8,4415739797
6981,73251920,1042,73252962,3,0,1,1024,29,9574182640
6982,73252789,6754,73259543,7,0,1,7168,18,5330150240
6983,73254059,220739,73474798,6,0,0,20480,8,5510351971
6984,73259879,4374,73264253,7,0,1,4608,18,7037676281
6985,73314689,48926,73363615,6,0,1,512,8,8023057997
6986,73331140,196551,73527691,3,0,0,8704,29,8738716327
6987,73331739,46608,73378347,9,0,1,28672,17,50101946
6988,73340400,46571,73386971,3,0,1,6656,29,1271466050
6989,73370380,16606,73386986,4,0,1,3584,14,4055854979
6990,73373070,146932,73520002,3,0,0,1536,29,7164109122
6991,73397850,141350,73539200,3,0,0,19968,29,3585564248
6992,73414850,263753,73678603,8,0,0,43008,26,3530075781
6993,73426839,324177,73751016,6,0,0,145920,8,3750539014
6994,73455290,22463,73477753,1,0,1,3072,2,7587932911
6995,73467110,13312,73480422,3,0,1,12288,29,6203435058
6996,73475930,7251,73483181,3,0,1,10240,29,2435232859
6997,73487950,1042,73488992,3,0,1,1024,29,7459157598
6998,73493490,4374,73497864,5,0,1,4608,15,6174788340
6999,73503570,248397,73751967,3,0,0,3072,29,540264763
7000,73565980,1994,73567974,3,0,1,2048,29,8979818087
7001,73577729,416006,73993735,6,0,0,82944,8,5158363351
7002,73597300,2470,73599770,3,0,1,2560,29,4392829403
7003,73610730,2946,73613676,3,0,1,3072,29,7920688546
7004,73617289,5802,73623091,6,0,1,6144,8,1733128681
7005,73637000,4679,73641679,0,0,1,12288,25,6682639826
7006,73640140,175932,73816072,3,0,0,18432,29,3651671498
7007,73642680,111962,73754642,8,0,0,8704,26,4967087739
7008,73679490,4850,73684340,3,0,1,5120,29,188501377
7009,73683270,85913,73769183,8,0,0,7168,26,2649555302
7010,73684870,2470,73687340,0,0,1,2560,25,4083730831
7011,73689260,4420,73693680,3,0,1,11776,29,3490808702
7012,73714560,43588,73758148,0,0,1,3584,25,10121874131
7013,73725290,33524,73758814,0,0,1,1024,25,5562233101
7014,73730809,166153,73896962,6,0,0,5120,8,1997336733
7015,73732700,29980,73762680,3,0,1,6144,29,6251536495
7016,73737709,25957,73763666,6,0,1,1536,8,7228025978
7017,73739410,25242,73764652,0,0,1,1536,25,3487287902
7018,73813940,3642,73817582,3,0,1,1536,29,9495498017
7019,73825860,140589,73966449,3,0,0,34816,29,7020638435
7020,73829230,5802,73835032,3,0,1,6144,29,5606989290
7021,73862110,260243,74122353,3,0,0,39936,29,9780518741
7022,73865990,7706,73873696,3,0,1,8192,29,2614186407
7023,73872420,3128,73875548,5,0,1,9216,15,6406857923
7024,73879920,189502,74069422,8,0,0,21504,26,1834503702
7025,73912569,4850,73917419,6,0,1,5120,8,9954118579
7026,73927340,1042,73928382,3,0,1,1024,29,6338052044
7027,73937210,3898,73941108,3,0,1,4096,29,10071503315
7028,73944560,4374,73948934,5,0,1,4608,15,5251650336
7029,73945240,148428,74093668,8,0,0,9216,26,4629299257
7030,73948000,3128,73951128,0,0,1,9216,25,5272999811
7031,73958750,35000,73993750,0,0,1,8704,25,2052938311
7032,73965990,27783,73993773,5,0,1,11264,15,9809679254
7033,73968980,333817,74302797,3,0,0,31232,29,9834324504
7034,74000020,2470,74002490,0,0,1,2560,25,4905185049
7035,74000229,2927,74003156,6,0,1,1024,8,10577598016
7036,74002500,201608,74204108,8,0,0,45056,26,8527391607
7037,74024879,2946,74027825,6,0,1,3072,8,103750952
7038,74048589,1518,74050107,6,0,1,1536,8,1414755963
7039,74049440,2946,74052386,3,0,1,3072,29,2840066185
7040,74082750,189525,74272275,8,0,0,19456,26,414314429
7041,74117349,8894,74126243,6,0,1,4096,8,8794657787
7042,74126160,262029,74388189,8,0,0,131584,26,183205422
7043,74144860,2470,74147330,3,0,1,2560,29,929000368
7044,74147940,6754,74154694,5,0,1,7168,15,2240138090
7045,74164439,1994,74166433,6,0,1,2048,8,1503404852
7046,74175480,6278,74181758,3,0,1,6656,29,1903306613
7047,74183090,120042,74303132,3,0,0,1024,29,4693217155
7048,74183290,566,74183856,3,0,1,512,29,8984134345
7049,74186700,1042,74187742,5,0,1,1024,15,8041858060
7050,74192680,18191,74210871,0,0,1,7168,25,6660174049
7051,74199690,12487,74212177,3,0,1,2048,29,3431312744
7052,74207620,215100,74422720,8,0,0,40960,26,35596743
7053,74208229,6534,74214763,6,0,1,4096,8,6755854932
7054,74212200,7709,74219909,5,0,1,8192,15,8478477750
7055,74214570,5595,74220165,0,0,1,9216,25,7057851271
7056,74235750,6754,74242504,5,0,1,7168,15,7006948848
7057,74240060,2790,74242850,0,0,1,512,25,566930782
7058,74242959,264437,74507396,6,0,0,81408,8,9960944444
7059,74248520,566,74249086,0,0,1,512,25,4344357226
7060,74296860,11081,74307941,5,0,1,5120,15,10550786099
7061,74308190,324563,74632753,3,0,0,71680,29,5338897944
7062,74308740,1042,74309782,3,0,1,1024,29,8833395461
7063,74314330,5802,74320132,0,0,1,6144,25,8025320448
7064,74322890,235616,74558506,3,0,0,19456,29,4222944587
7065,74334680,201767,74536447,8,0,0,79360,26,1221918962
7066,74356230,189288,74545518,8,0,0,29696,26,771106507
7067,74419570,160264,74579834,8,0,0,60928,26,10244348778
7068,74464930,6278,74471208,3,0,1,6656,29,6787082607
7069,74516420,32955,74549375,3,0,1,4096,29,1628269898
7070,74536499,229186,74765685,6,0,0,131072,8,5521390641
7071,74562110,23212,74585322,3,0,1,13824,29,5620625007
7072,74562970,221918,74784888,8,0,0,62976,26,9903201398
7073,74567640,22152,74589792,8,0,1,14336,26,3668984470
7074,74641240,234535,74875775,8,0,0,20992,26,10272174767
7075,74644570,1042,74645612,3,0,1,1024,29,6743882594
7076,74647370,139093,74786463,8,0,0,5120,26,8709407598
7077,74652539,185084,74837623,6,0,0,93184,8,6460801799
7078,74658930,210434,74869364,8,0,0,22528,26,2589866268
7079,74670010,173244,74843254,8,0,0,18432,26,10333986582
7080,74674529,4850,74679379,6,0,1,5120,8,5712474688
7081,74693880,3898,74697778,8,0,1,4096,26,7791070341
7082,74769130,255862,75024992,3,0,0,77824,29,6936318928
7083,74775270,182462,74957732,3,0,0,17920,29,6636570244
7084,74777920,14863,74792783,8,0,1,6656,26,1152223795
7085,74796860,3387,74800247,3,0,1,9728,29,3656932960
7086,74833110,12130,74845240,8,0,1,2048,26,7391545409
7087,74857939,113661,74971600,6,0,0,11776,8,6088553627
7088,74866890,12539,74879429,3,0,1,10240,29,9679629006
7089,74869280,13522,74882802,8,0,1,4096,26,561406174
7090,74904320,2946,74907266,8,0,1,3072,26,4258324193
7091,74907719,159290,75067009,6,0,0,1024,8,9756207201
7092,74915600,2470,74918070,3,0,1,2560,29,4130971287
7093,74949640,566,74950206,8,0,1,512,26,2221350032
7094,74991360,47288,75038648,8,0,0,1536,26,985495300
7095,74999130,25877,75025007,5,0,1,4608,15,5160994704
7096,75026260,138626,75164886,8,0,0,58880,26,756212633
7097,75032870,7230,75040100,3,0,1,7680,29,66710101
7098,75050120,5802,75055922,5,0,1,6144,15,2662494470
7099,75060960,3387,75064347,3,0,1,9728,29,979158993
7100,75075800,4374,75080174,5,0,1,4608,15,3394060411
7101,75083340,1042,75084382,3,0,1,1024,29,4436555341
7102,75097560,7230,75104790,3,0,1,7680,29,263434146
7103,75115240,108507,75223747,8,0,0,43520,26,890580624
7104,75132200,2470,75134670,3,0,1,2560,29,5282255409
7105,75134189,4850,75139039,9,0,1,5120,17,3249154755
7106,75139559,332732,75472291,5,0,0,83456,15,662538020
7107,75153100,182475,75335575,3,0,0,30208,29,228002988
7108,75163591,13103,75176694,2,0,1,19456,9,8981285882
7109,75177761,1042,75178803,2,0,1,1024,9,5101353186
7110,75178569,341956,75520525,6,0,0,126976,8,6422322388
7111,75180820,264268,75445088,8,0,0,14848,26,10050103122
7112,75181500,138324,75319824,8,0,0,14336,26,806152455
7113,75190620,249913,75440533,8,0,0,66048,26,1233541226
7114,75197460,2946,75200406,5,0,1,3072,15,4607848319
7115,75227790,1994,75229784,5,0,1,2048,15,435953549
7116,75233000,3387,75236387,3,0,1,9728,29,3451147881
7117,75234630,8137,75242767,5,0,1,7168,15,9938043734
7118,75236531,7542,75244073,2,0,1,2048,9,7029230608
7119,75257621,4850,75262471,2,0,1,5120,9,10512972699
7120,75266600,4374,75270974,3,0,1,4608,29,9090640587
7121,75272839,1518,75274357,9,0,1,1536,17,8120002414
7122,75278550,1994,75280544,5,0,1,2048,15,4803748673
7123,75302269,179553,75481822,6,0,0,31232,8,7385407236
7124,75305469,226895,75532364,5,0,0,4608,15,2353050307
7125,75313420,132151,75445571,8,0,0,1536,26,6167925495
7126,75318779,207720,75526499,5,0,0,6144,15,8976459557
7127,75322210,344759,75666969,3,0,0,27136,29,1133203781
7128,75331260,199661,75530921,8,0,0,2048,26,8392071261
7129,75336131,11016,75347147,2,0,1,17920,9,1114327641
7130,75351050,173554,75524604,8,0,0,13312,26,4677545969
7131,75354250,1042,75355292,5,0,1,1024,15,10042756887
7132,75386099,390953,75777052,6,0,0,16384,8,9686171729
7133,75387580,142694,75530274,3,0,0,12288,29,963287671
7134,75395501,3422,75398923,2,0,1,3584,9,4730909963
7135,75395551,5270,75400821,2,0,1,11264,9,9352494584
7136,75396041,5446,75401487,2,0,1,1024,9,1849548527
7137,75428360,117088,75545448,8,0,0,1536,26,1790633194
7138,75432360,202473,75634833,8,0,0,52736,26,3144705334
7139,75461740,412335,75874075,3,0,0,161280,29,6511845743
7140,75466470,236189,75702659,3,0,0,25600,29,3936290558
7141,75478279,70140,75548419,9,0,1,31232,17,6903843101
7142,75486509,317405,75803914,6,0,0,88064,8,9307489672
7143,75494490,55875,75550365,8,0,1,3072,26,2690087698
7144,75516059,292410,75808469,5,0,0,14848,15,4413202321
7145,75519269,31762,75551031,9,0,1,11264,17,3196564280
7146,75521600,31697,75553297,5,0,1,3584,15,9092536092
7147,75554751,2470,75557221,2,0,1,2560,9,5575648529
7148,75579811,3645,75583456,2,0,1,10240,9,7746361950
7149,75581449,3049,75584498,9,0,1,1536,17,8619084927
7150,75595809,1042,75596851,9,0,1,1024,17,3793366209
7151,75619291,27600,75646891,2,0,1,19968,9,2666273456
7152,75628000,24588,75652588,1,0,1,18944,2,2855849829
7153,75640330,12604,75652934,5,0,1,512,15,6291636279
7154,75659141,10965,75670106,2,0,1,9216,9,6504567907
7155,75666111,5193,75671304,2,0,1,1536,9,2125561812
7156,75669310,11492,75680802,5,0,1,16896,15,10270760057
7157,75673431,10917,75684348,2,0,1,5632,9,5171382141
7158,75679149,210885,75890034,5,0,0,52224,15,8750404010
7159,75680429,381651,76062080,5,0,0,56320,15,3862298182
7160,75685680,340956,76026636,3,0,0,13312,29,3210265602
7161,75692889,9793,75702682,9,0,1,6144,17,242036402
7162,75693729,10407,75704136,9,0,1,1536,17,8088166632
7163,75704360,3904,75708264,1,0,1,10752,2,9977019098
7164,75708440,2470,75710910,5,0,1,2560,15,720919974
7165,75734899,419135,76154034,5,0,0,163840,15,6472051322
7166,75736391,1518,75737909,2,0,1,1536,9,4077427148
7167,75744979,3422,75748401,9,0,1,3584,17,9761884330
7168,75745651,14756,75760407,2,0,1,27648,9,7361792007
7169,75752760,8633,75761393,5,0,1,1536,15,4097172108
7170,75765769,11298,75777067,9,0,1,8192,17,9437921532
7171,75783041,27406,75810447,2,0,1,2048,9,5587913000
7172,75791439,280998,76072437,5,0,0,2560,15,10454522203
7173,75800820,210179,76010999,3,0,0,9728,29,10472432695
7174,75817309,448385,76265694,5,0,0,68608,15,3788626122
7175,75820810,250816,76071626,3,0,0,31232,29,9870750282
7176,75841190,329091,76170281,8,0,0,53248,26,7779900677
7177,75843559,362234,76205793,5,0,0,14336,15,4817370661
7178,75845890,355520,76201410,8,0,0,18944,26,8709851368
7179,75855970,38898,75894868,1,0,1,5120,2,153014600
7180,75865539,308509,76174048,5,0,0,12288,15,6193927159
7181,75890790,399408,76290198,8,0,0,64512,26,9001599760
7182,75915599,292705,76208304,5,0,0,8192,15,1205880157
7183,75939261,1518,75940779,2,0,1,1536,9,1111475006
7184,76001091,11274,76012365,2,0,1,18432,9,5944756344
7185,76003260,12651,76015911,4,0,1,5632,14,990070410
7186,76017190,3645,76020835,8,0,1,10240,26,280956291
7187,76042249,262354,76304603,6,0,0,47104,8,6631109229
7188,76042771,19324,76062095,2,0,1,3072,9,10195100149
7189,76058270,255724,76313994,8,0,0,30720,26,8686342191
7190,76062590,165098,76227688,8,0,0,14336,26,8554878901
7191,76087360,331222,76418582,3,0,0,63488,29,1924748186
7192,76116551,63283,76179834,2,0,1,6144,9,4720353103
7193,76134980,47120,76182100,8,0,1,3584,26,8234281674
7194,76148320,34126,76182446,8,0,1,512,26,8664372586
7195,76154700,329238,76483938,8,0,0,93184,26,1783025151
7196,76167999,529396,76697395,6,0,0,54272,8,1180931957
7197,76187549,258954,76446503,6,0,0,89088,8,2065749285
7198,76203359,374921,76578280,6,0,0,132096,8,10520498476
7199,76234009,372663,76606672,6,0,0,45568,8,2740418472
7200,76245460,44761,76290221,3,0,1,5632,29,2147761126
7201,76246820,43416,76290236,3,0,1,512,29,2648445460
7202,76270709,370889,76641598,6,0,0,17920,8,9668016773
7203,76273070,44806,76317876,8,0,1,4096,26,6511853073
7204,76274400,47662,76322062,8,0,1,6656,26,7161677415
7205,76294219,663392,76957611,6,0,0,37888,8,4133277558
7206,76307640,14768,76322408,3,0,1,512,29,9001023427
7207,76320719,360125,76680844,6,0,0,59904,8,8284047033
7208,76330289,395716,76726005,5,0,0,34304,15,4827658312
7209,76331900,7706,76339606,8,0,1,8192,26,9837331353
7210,76338900,7230,76346130,3,0,1,7680,29,9874591559
7211,76339930,396425,76736355,8,0,0,33792,26,3323234458
7212,76347989,102739,76450728,5,0,0,2048,15,1078442757
7213,76357910,566,76358476,3,0,1,512,29,2876395218
7214,76373590,566,76374156,5,0,1,512,15,6843919338
7215,76391289,223533,76614822,6,0,0,26624,8,10280127754
7216,76405989,540055,76946044,6,0,0,75264,8,2976178952
7217,76407319,39199,76446518,7,0,1,2048,18,2271454851
7218,76418810,280168,76698978,3,0,0,5120,29,5476790599
7219,76421240,97053,76518293,3,0,1,116224,29,1477119523
7220,76427800,379320,76807120,8,0,0,53248,26,9945095723
7221,76461340,116987,76578327,3,0,1,123904,29,2897392728
7222,76464169,251361,76715530,5,0,0,51200,15,8253574644
7223,76468120,110222,76578342,1,0,1,4608,2,9688071152
7224,76491389,357659,76849048,6,0,0,56320,8,5814989984
7225,76539159,46927,76586086,7,0,1,8192,18,4110557694
7226,76543219,525838,77069057,6,0,0,56320,8,6115044384
7227,76550790,339136,76889926,3,0,0,16384,29,1110186761
7228,76557250,49437,76606687,3,0,1,24576,29,1336642452
7229,76566250,284217,76850467,3,0,0,4608,29,998131714
7230,76599470,511833,77111303,3,0,0,17408,29,10605365825
7231,76608040,308474,76916514,8,0,0,50688,26,923207790
7232,76631869,9752,76641621,9,0,1,5632,17,6681351480
7233,76636329,436502,77072831,6,0,0,8192,8,2057893027
7234,76678270,353503,77031773,3,0,0,80896,29,1588371227
7235,76690560,35460,76726020,3,0,1,24064,29,9996631379
7236,76709899,26479,76736378,9,0,1,6144,17,3803206620
7237,76714459,284644,76999103,5,0,0,65536,15,3646221999
7238,76715719,31094,76746813,7,0,1,16896,18,6120066552
7239,76752329,170752,76923081,6,0,0,21504,8,8444654585
7240,76760200,3422,76763622,8,0,1,3584,26,6360955532
7241,76762190,269926,77032116,3,0,0,1024,29,4075075058
7242,76765871,2470,76768341,2,0,1,2560,9,3655509260
7243,76802500,20725,76823225,3,0,1,31232,29,9091072044
7244,76804340,265980,77070320,3,0,0,4096,29,1684484244
7245,76815939,320076,77136015,6,0,0,10240,8,6828056431
7246,76824049,2470,76826519,9,0,1,2560,17,3756662717
7247,76854260,1042,76855302,3,0,1,1024,29,7542895076
7248,76862499,383705,77246204,5,0,0,11776,15,1948029110
7249,76867389,236558,77103947,6,0,0,34816,8,1337935640
7250,76878069,1042,76879111,9,0,1,1024,17,1122772149
7251,76879170,126485,77005655,3,0,0,13824,29,5456384733
7252,76881809,8132,76889941,9,0,1,5120,17,1218407324
7253,76904809,365104,77269913,5,0,0,62976,15,2611628637
7254,76906870,290773,77197643,8,0,0,53760,26,244282376
7255,76923429,39467,76962896,9,0,1,5632,17,8292562596
7256,76957890,341502,77299392,3,0,0,49152,29,10712208256
7257,77007379,25262,77032641,9,0,1,512,17,6907434919
7258,77017869,447597,77465466,6,0,0,48640,8,6673201491
7259,77038510,1518,77040028,3,0,1,1536,29,4734023990
7260,77068779,340983,77409762,6,0,0,27136,8,1037623677
7261,77088959,182387,77271346,6,0,0,3584,8,3667825355
7262,77093120,297259,77390379,3,0,0,13824,29,4440209729
7263,77098280,13038,77111318,3,0,1,14848,29,9117399428
7264,77111450,379165,77490615,3,0,0,17920,29,128857987
7265,77120779,566,77121345,6,0,1,512,8,6495030982
7266,77128989,513753,77642742,5,0,0,41472,15,1219594277
7267,77135909,198726,77334635,5,0,0,2048,15,10167252328
7268,77150849,280035,77430884,5,0,0,16896,15,10717977062
7269,77152689,622934,77775623,6,0,0,44544,8,7107761529
7270,77153389,3128,77156517,9,0,1,9216,17,3138181665
7271,77156170,472010,77628180,3,0,0,183296,29,6399263959
7272,77160600,378626,77539226,8,0,0,33280,26,1958600956
7273,77164240,135175,77299415,3,0,1,210432,29,5412333262
7274,77189459,109971,77299430,9,0,1,1024,17,6932862909
7275,77212960,116316,77329276,3,0,1,130048,29,1734499817
7276,77225839,564175,77790014,5,0,0,47104,15,3692233852
7277,77231970,99892,77331862,1,0,1,4096,2,8997875893
7278,77251529,277534,77529063,6,0,0,28160,8,971255936
7279,77286910,45618,77332528,1,0,1,1024,2,9141042317
7280,77297029,36485,77333514,9,0,1,1536,17,10451729036
7281,77297540,350841,77648381,8,0,0,18432,26,104688116
7282,77307720,31286,77339006,3,0,1,17920,29,7000246524
7283,77311779,318312,77630091,5,0,0,6144,15,4336306526
7284,77319669,220672,77540341,5,0,0,3584,15,10375520250
7285,77332330,146170,77478500,3,0,1,241152,29,1950102787
7286,77332390,234665,77567055,3,0,0,512,29,7587874377
7287,77339590,665555,78005145,3,0,0,56320,29,4631520891
7288,77340120,421916,77762036,8,0,0,181760,26,10344460774
7289,77392539,503362,77895901,5,0,0,13824,15,8375560327
7290,77414169,393052,77807221,5,0,0,30208,15,3015103412
7291,77416840,63926,77480766,1,0,1,3584,2,9729290310
7292,77421130,69500,77490630,1,0,1,7680,2,8414900553
7293,77427259,92890,77520149,6,0,0,3072,8,446372713
7294,77439359,729162,78168521,5,0,0,147456,15,5007572736
7295,77461129,367045,77828174,5,0,0,24064,15,8933585475
7296,77472519,18134,77490653,9,0,1,2560,17,447578710
7297,77485650,6966,77492616,1,0,1,2048,2,3663536741
7298,77498619,2946,77501565,9,0,1,3072,17,3776038699
7299,77519609,295271,77814880,5,0,0,25088,15,9292353017
7300,77521179,23460,77544639,6,0,1,13824,8,8804658008
7301,77530979,481216,78012195,6,0,0,22016,8,4539529057
7302,77568889,436583,78005472,5,0,0,1024,15,10160442976
7303,77578699,69697,77648396,9,0,1,1024,17,4537825383
7304,77580479,696827,78277306,5,0,0,3584,15,5092272911
7305,77603279,269005,77872284,5,0,0,16896,15,9590192876
7306,77656479,448364,78104843,5,0,0,124928,15,6427214409
7307,77679390,510937,78190327,8,0,0,6144,26,5089590036
7308,77725810,335585,78061395,3,0,0,23040,29,6575044512
7309,77733800,60071,77793871,1,0,1,4096,2,1223875832
7310,77772130,22087,77794217,0,0,1,512,25,5581480507
7311,77787079,336499,78123578,5,0,0,61440,15,5037266929
7312,77816120,1518,77817638,1,0,1,1536,2,4270810687
7313,77816250,11939,77828189,1,0,1,5120,2,4492237062
7314,77818390,565074,78383464,8,0,0,33280,26,8612031755
7315,77844940,3128,77848068,1,0,1,9216,2,5393252019
7316,77857059,1994,77859053,9,0,1,2048,17,2984674070
7317,77860140,311680,78171820,8,0,0,10752,26,5668513805
7318,77891920,10251,77902171,1,0,1,6656,2,3507721486
7319,77900679,278839,78179518,5,0,0,8192,15,2834013342
7320,77903749,284691,78188440,6,0,0,26112,8,10139076203
7321,77947669,229338,78177007,5,0,0,16896,15,4491433932
7322,77965540,2946,77968486,5,0,1,3072,15,9381944053
7323,77970300,250600,78220900,3,0,0,36352,29,3108587246
7324,77973110,4374,77977484,1,0,1,4608,2,1500898012
7325,77980459,200010,78180469,6,0,0,3072,8,1763961020
7326,78008970,8067,78017037,8,0,1,5120,26,2898918130
7327,78012649,326733,78339382,6,0,0,40960,8,10547518175
7328,78048829,235512,78284341,6,0,0,23040,8,4958389480
7329,78062619,208770,78271389,6,0,0,41984,8,2173597550
7330,78084610,367560,78452170,8,0,0,35328,26,8525038322
7331,78107780,88333,78196113,1,0,1,6144,2,4893775497
7332,78114249,243252,78357501,5,0,0,24576,15,6110438014
7333,78115220,81559,78196779,1,0,1,11264,2,4771136990
7334,78162539,251777,78414316,6,0,0,28160,8,1003702726
7335,78221510,299852,78521362,3,0,0,3072,29,919532271
7336,78223070,262700,78485770,8,0,0,59904,26,92011887
7337,78250770,96980,78347750,8,0,0,18432,26,5534909786
7338,78260530,13338,78273868,1,0,1,2560,2,2979953245
7339,78266560,270943,78537503,3,0,0,15872,29,8402828631
7340,78286349,166476,78452825,5,0,0,2048,15,9180588969
7341,78307680,1994,78309674,1,0,1,2048,2,1116432683
7342,78309260,282032,78591292,3,0,0,70144,29,2539415277
7343,78345939,145618,78491557,5,0,0,18944,15,4327652081
7344,78361900,4850,78366750,1,0,1,5120,2,10498687921
7345,78368729,14750,78383479,9,0,1,5632,17,1784398340
7346,78379940,113883,78493823,3,0,0,3584,29,8361169526
7347,78447310,146493,78593803,3,0,0,8192,29,1919914659
7348,78449540,5714,78455254,1,0,1,2560,2,725461102
7349,78454821,5326,78460147,2,0,1,5632,9,7286467126
7350,78456220,4286,78460506,1,0,1,9728,2,4153129605
7351,78460919,207501,78668420,5,0,0,5120,15,1660087046
7352,78522810,4374,78527184,1,0,1,4608,2,8579526616
7353,78603069,102908,78705977,6,0,0,37888,8,2124485946
7354,78610619,74696,78685315,6,0,0,15872,8,1607019694
7355,78619069,247449,78866518,6,0,0,25088,8,7328388481
7356,78621269,169333,78790602,5,0,0,57344,15,6292584293
7357,78628160,112162,78740322,8,0,0,13312,26,142903155
7358,78630030,3128,78633158,1,0,1,9216,2,5716761433
7359,78653189,167486,78820675,5,0,0,40448,15,4426932748
7360,78665000,63362,78728362,0,0,1,106496,25,9776043778
7361,78678629,167282,78845911,5,0,0,4096,15,3190397120
7362,78726369,219509,78945878,5,0,0,91136,15,616956870
7363,78740260,5380,78745640,8,0,1,5632,26,9033814994
7364,78787819,158854,78946673,6,0,0,2560,8,2023323943
7365,78798659,115725,78914384,6,0,0,4608,8,2615916258
7366,78852801,4374,78857175,2,0,1,4608,9,684722838
7367,78878709,3128,78881837,6,0,1,9216,8,1527089735
7368,78886629,171822,79058451,6,0,0,28672,8,445510370
7369,78899569,133057,79032626,5,0,0,23552,15,8529872332
7370,78941039,284922,79225961,5,0,0,74752,15,10028168428
7371,78942659,162604,79105263,6,0,0,20992,8,525571069
7372,78958341,5712,78964053,2,0,1,14336,9,5627050985
7373,78962700,5512,78968212,1,0,1,13824,2,5448686311
7374,79004120,4420,79008540,1,0,1,11776,2,553339708
7375,79039959,216944,79256903,5,0,0,98816,15,5634052648
7376,79046060,251608,79297668,8,0,0,45056,26,1851873301
7377,79061291,7230,79068521,2,0,1,7680,9,4041610901
7378,79078121,5802,79083923,2,0,1,6144,9,5928492237
7379,79094739,89223,79183962,5,0,0,4096,15,4501859790
7380,79109159,278982,79388141,6,0,0,8704,8,7373061623
7381,79110519,116253,79226772,6,0,0,2560,8,2739364654
7382,79124139,1994,79126133,7,0,1,2048,18,2832139310
7383,79133919,7230,79141149,7,0,1,7680,18,9832584032
7384,79135699,148226,79283925,5,0,0,52224,15,870098494
7385,79144471,3898,79148369,2,0,1,4096,9,3835605516
7386,79145359,157784,79303143,6,0,0,17920,8,6614049747
7387,79148960,7230,79156190,4,0,1,7680,14,4892248917
7388,79154851,4679,79159530,2,0,1,12288,9,1389615873
7389,79188110,157438,79345548,8,0,0,47104,26,7424284264
7390,79189349,194706,79384055,5,0,0,48640,15,5614967856
7391,79189939,2946,79192885,7,0,1,3072,18,1414956906
7392,79196611,1518,79198129,2,0,1,1536,9,8753865123
7393,79205529,57135,79262664,7,0,1,6144,18,6364959813
7394,79215399,252861,79468260,5,0,0,12288,15,4905211630
7395,79222880,162594,79385474,9,0,0,4608,17,10625813926
7396,79242379,181712,79424091,5,0,0,7168,15,1989173712
7397,79244921,18409,79263330,2,0,1,1024,9,5219287596
7398,79261000,203470,79464470,8,0,0,43520,26,7850674654
7399,79295970,136835,79432805,8,0,0,20992,26,2721309799
7400,79304171,2470,79306641,2,0,1,2560,9,940639651
7401,79304480,5846,79310326,4,0,1,5632,14,8303820923
7402,79315959,1518,79317477,7,0,1,1536,18,3393273059
7403,79317441,2946,79320387,2,0,1,3072,9,9377661826
7404,79318509,3824,79322333,7,0,1,3072,18,10659858045
7405,79331599,244373,79575972,5,0,0,32256,15,5409104490
7406,79333970,117217,79451187,8,0,0,20480,26,8078758563
7407,79341949,8078,79350027,7,0,1,11776,18,4019844379
7408,79344859,6154,79351013,7,0,1,1536,18,7149995092
7409,79383461,10643,79394104,2,0,1,14848,9,10517313215
7410,79397169,249081,79646250,6,0,0,75264,8,3867229411
7411,79398770,1518,79400288,4,0,1,1536,14,9002768591
7412,79410501,1994,79412495,2,0,1,2048,9,8043835710
7413,79428589,7154,79435743,7,0,1,3072,18,2246949968
7414,79440499,1042,79441541,7,0,1,1024,18,4040632906
7415,79441891,22594,79464485,2,0,1,5632,9,6513232817
7416,79446890,23832,79470722,4,0,1,6656,14,4513150412
7417,79456901,14807,79471708,2,0,1,1536,9,226712355
7418,79477329,566,79477895,9,0,1,512,17,977981094
7419,79493969,169859,79663828,6,0,0,24064,8,10395737029
7420,79495761,566,79496327,2,0,1,512,9,1926161098
7421,79499839,1042,79500881,9,0,1,1024,17,1396128753
7422,79506699,566,79507265,7,0,1,512,18,3932863162
7423,79515729,149050,79664779,5,0,0,3072,15,10057908788
7424,79519949,1518,79521467,7,0,1,1536,18,5879365492
7425,79553719,3387,79557106,9,0,1,9728,17,437932852
7426,79606709,4374,79611083,7,0,1,4608,18,7351082561
7427,79614349,3422,79617771,9,0,1,3584,17,2019084673
7428,79618789,2946,79621735,9,0,1,3072,17,1293411033
7429,79637181,10145,79647326,2,0,1,1024,9,2519132186
7430,79640690,227733,79868423,8,0,0,95232,26,4935388925
7431,79645549,230065,79875614,5,0,0,23552,15,9851400325
7432,79655299,14029,79669328,7,0,1,27136,18,3909314875
7433,79755581,1994,79757575,2,0,1,2048,9,5658216688
7434,79765069,172718,79937787,6,0,0,14848,8,8756259648
7435,79781279,175499,79956778,5,0,0,10240,15,6318032169
7436,79783081,2946,79786027,2,0,1,3072,9,424284870
7437,79783209,3804,79787013,9,0,1,1536,17,9111335720
7438,79806619,123117,79929736,5,0,0,48640,15,7941107670
7439,79807281,10241,79817522,2,0,1,16384,9,2708924371
7440,79864911,13232,79878143,2,0,1,2560,9,1426734331
7441,79866729,11760,79878489,7,0,1,512,18,2979172104
7442,79871639,81761,79953400,6,0,0,10752,8,8304049511
7443,79874729,302454,80177183,6,0,0,41472,8,8013759978
7444,79877651,4850,79882501,2,0,1,5120,9,438828744
7445,79893719,349146,80242865,6,0,0,66560,8,10292096970
7446,79894599,87847,79982446,5,0,0,13824,15,55456049
7447,79897990,131850,80029840,8,0,0,57344,26,1966898617
7448,79922749,9015,79931764,7,0,1,2048,18,7190367606
7449,79923939,13863,79937802,9,0,1,5120,17,2715873174
7450,79924401,61136,79985537,2,0,1,87552,9,4693363493
7451,79934669,51227,79985896,9,0,1,9728,17,8974855425
7452,79936620,112111,80048731,8,0,0,25088,26,5462039943
7453,79943671,47717,79991388,2,0,1,26112,9,7439563056
7454,79959839,100609,80060448,5,0,0,3584,15,5195943999
7455,79971219,20515,79991734,7,0,1,512,18,5925382547
7456,79984230,13512,79997742,3,0,1,26112,29,7097924914
7457,79984249,292908,80277157,5,0,0,5632,15,9219247716
7458,79985331,21498,80006829,2,0,1,28160,9,3872166309
7459,79997889,10886,80008775,7,0,1,3072,18,5101037844
7460,80000029,29834,80029863,7,0,1,25088,18,8013049147
7461,80013700,16748,80030448,5,0,1,512,15,6589558878
7462,80017549,13245,80030794,7,0,1,512,18,6638843301
7463,80027120,315427,80342547,7,0,0,50688,18,2480846937
7464,80034690,1042,80035732,5,0,1,1024,15,7075853669
7465,80053819,6754,80060573,7,0,1,7168,18,73407063
7466,80059379,2579,80061958,9,0,1,1536,17,8986359886
7467,80073800,197101,80270901,7,0,0,43520,18,7383972452
7468,80073829,177631,80251460,5,0,0,28160,15,5991960768
7469,80078859,1518,80080377,7,0,1,1536,18,9621097754
7470,80101959,5326,80107285,7,0,1,5632,18,6210718898
7471,80108460,310335,80418795,7,0,0,37376,18,148136781
7472,80109461,6229,80115690,2,0,1,15360,9,7198850887
7473,80120999,5802,80126801,9,0,1,6144,17,8531146294
7474,80124849,337639,80462488,5,0,0,16896,15,2121473831
7475,80130169,1994,80132163,9,0,1,2048,17,5261828483
7476,80179310,2470,80181780,5,0,1,2560,15,640563802
7477,80193041,14117,80207158,2,0,1,24064,9,679918436
7478,80197400,329438,80526838,8,0,0,31744,26,557564736
7479,80243519,27397,80270916,7,0,1,7168,18,5059376506
7480,80269699,1775,80271474,7,0,1,512,18,5381858689
7481,80277819,2946,80280765,7,0,1,3072,18,6915844281
7482,80279960,100291,80380251,7,0,0,6656,18,6021075166
7483,80293380,1518,80294898,5,0,1,1536,15,10732966780
7484,80306561,10241,80316802,2,0,1,16384,9,961033437
7485,80349981,5971,80355952,2,0,1,14848,9,1641061733
7486,80351780,165277,80517057,8,0,0,12800,26,8916485852
7487,80357899,12737,80370636,7,0,1,24576,18,2945475803
7488,80397919,50672,80448591,5,0,0,2560,15,6962845896
7489,80412279,9521,80421800,7,0,1,3072,18,5925893664
7490,80415410,84729,80500139,7,0,0,2048,18,3711174727
7491,80415540,9806,80425346,4,0,1,5632,14,8019015263
7492,80417610,10962,80428572,5,0,1,5120,15,5313079860
7493,80445279,4162,80449441,9,0,1,11264,17,1207143575
7494,80452520,205963,80658483,7,0,0,2560,18,1553983605
7495,80453890,186498,80640388,8,0,0,7168,26,2126956331
7496,80455240,7271,80462511,5,0,1,7168,15,6055474918
7497,80461081,15516,80476597,2,0,1,24064,9,5816166829
7498,80467820,169832,80637652,8,0,0,63488,26,8381813957
7499,80478249,93329,80571578,5,0,0,16384,15,7615260046
7500,80484539,1994,80486533,7,0,1,2048,18,6367436349
7501,80516529,10332,80526861,9,0,1,3072,17,5074167025
7502,80518939,9434,80528373,7,0,1,1536,18,10214121385
7503,80524579,5100,80529679,9,0,1,2048,17,1336606188
7504,80532180,190930,80723110,7,0,0,50688,18,2649193206
7505,80544059,392717,80936776,5,0,0,80896,15,9129468363
7506,80565919,5674,80571593,7,0,1,5120,18,326649779
7507,80572330,6754,80579084,5,0,1,7168,15,5608413416
7508,80593569,3387,80596956,7,0,1,9728,18,80661543
7509,80604500,5802,80610302,4,0,1,6144,14,6543335369
7510,80647889,259391,80907280,6,0,0,44032,8,4895982031
7511,80652030,14117,80666147,5,0,1,24064,15,6904950546
7512,80694549,270575,80965124,6,0,0,61952,8,2701919253
7513,80695659,351563,81047222,6,0,0,103424,8,4710852332
7514,80698659,373698,81072357,5,0,0,15360,15,3567778696
7515,80707120,349546,81056666,8,0,0,30208,26,10020821922
7516,80725470,132812,80858282,8,0,0,40448,26,365854866
7517,80730129,4162,80734291,7,0,1,11264,18,5445139230
7518,80748160,5454,80753614,4,0,1,13824,14,6688475535
7519,80762570,4937,80767507,3,0,1,12800,29,9552446943
7520,80776279,200521,80976800,5,0,0,19968,15,2238387629
7521,80787779,1042,80788821,7,0,1,1024,18,2078053059
7522,80792339,255062,81047401,5,0,0,512,15,7763380528
7523,80793270,1994,80795264,5,0,1,2048,15,1595508225
7524,80794370,5802,80800172,0,0,1,6144,25,6207846563
7525,80806040,3128,80809168,5,0,1,9216,15,3335375250
7526,80812260,126849,80939109,8,0,0,7168,26,8746379202
7527,80812549,1042,80813591,7,0,1,1024,18,5275935679
7528,80817740,53583,80871323,3,0,1,87552,29,8100476395
7529,80828420,78875,80907295,3,0,1,93696,29,10511592026
7530,80830900,105891,80936791,0,0,1,68608,25,8617386057
7531,80831370,105436,80936806,0,0,1,25600,25,2434622467
7532,80834030,133782,80967812,3,0,1,111616,29,4458508769
7533,80834340,133818,80968158,4,0,1,512,14,6161854201
7534,80839659,128845,80968504,7,0,1,512,18,357957146
7535,80845999,130816,80976815,7,0,1,6144,18,4308701705
7536,80848630,128200,80976830,5,0,1,5632,15,6917213927
7537,80863589,310418,81174007,5,0,0,11264,15,3949380735
7538,80876029,104713,80980742,7,0,1,7680,18,3680846804
7539,80879339,530815,81410154,6,0,0,40960,8,893675482
7540,80885589,271761,81157350,6,0,0,50688,8,2177649386
7541,80890920,526737,81417657,7,0,0,24576,18,2590856984
7542,80904719,274145,81178864,5,0,0,1536,15,6911558178
7543,80906020,74978,80980998,0,0,1,9216,25,9764492135
7544,80922200,63304,80985504,4,0,1,7168,14,657368608
7545,80936539,300090,81236629,6,0,0,21504,8,8670173698
7546,80938400,48282,80986682,4,0,1,13824,14,4298758448
7547,80939669,51839,80991508,7,0,1,7680,18,10297752265
7548,80950980,51460,81002440,3,0,1,35840,29,3880364647
7549,80975910,71506,81047416,0,0,1,65536,25,8958981256
7550,80984899,62532,81047431,7,0,1,7168,18,10298080669
7551,81001049,555821,81556870,5,0,0,111104,15,2717693563
7552,81011540,427345,81438885,8,0,0,8192,26,9936944084
7553,81015890,56498,81072388,3,0,1,27136,29,4996377329
7554,81029959,456638,81486597,5,0,0,94208,15,1403057462
7555,81034110,38810,81072920,4,0,1,3584,14,6066258489
7556,81054479,22947,81077426,7,0,1,7168,18,7915066693
7557,81062000,33178,81095178,0,0,1,40960,25,4910773360
7558,81062899,33585,81096484,7,0,1,2048,18,9499743938
7559,81077600,40192,81117792,0,0,1,52736,25,552965799
7560,81091230,145414,81236644,3,0,1,216576,29,7775733402
7561,81114569,680650,81795219,6,0,0,141312,8,10519928562
7562,81118920,118193,81237113,0,0,1,3072,25,2661149160
7563,81132330,105142,81237472,4,0,1,9728,14,477469817
7564,81138849,101209,81240058,7,0,1,4096,18,590163193
7565,81159869,82455,81242324,7,0,1,3584,18,2745069511
7566,81164770,78220,81242990,4,0,1,1024,14,4944937215
7567,81169000,95290,81264290,3,0,1,77312,29,656454274
7568,81174360,117494,81291854,7,0,0,3072,18,876776885
7569,81229260,368018,81597278,8,0,0,10240,26,7480809923
7570,81245910,18726,81264636,4,0,1,512,14,4398421566
7571,81257239,304351,81561590,5,0,0,7168,15,2396784814
7572,81268750,5326,81274076,4,0,1,5632,14,3220070276
7573,81275740,5454,81281194,3,0,1,13824,29,7693381295
7574,81308830,276872,81585702,8,0,0,512,26,6614136659
7575,81314489,6754,81321243,7,0,1,7168,18,2821458321
7576,81329980,304851,81634831,7,0,0,2048,18,8625767001
7577,81362209,2946,81365155,7,0,1,3072,18,6316150579
7578,81375510,376600,81752110,7,0,0,40448,18,6683666926
7579,81408620,11941,81420561,8,0,1,8704,26,4514486643
7580,81413279,8106,81421385,7,0,1,1024,18,1611165023
7581,81413280,415446,81828726,4,0,0,22528,14,6251893113
7582,81436811,7520,81444331,2,0,1,13824,9,6566066218
7583,81444200,112685,81556885,3,0,1,134656,29,4997950820
7584,81448760,349438,81798198,7,0,0,9728,18,2650064119
7585,81454680,102220,81556900,4,0,1,1536,14,4318430551
7586,81466739,90176,81556915,7,0,1,5632,18,6580452112
7587,81467180,89750,81556930,4,0,1,4608,14,5815308283
7588,81467249,89696,81556945,7,0,1,10752,18,4148849525
7589,81467449,89511,81556960,6,0,1,2048,8,3016870660
7590,81481550,98683,81580233,8,0,0,1024,26,4259332090
7591,81536780,368851,81905631,7,0,0,7680,18,9788741689
7592,81538029,564619,82102648,6,0,0,9216,8,7868041119
7593,81543519,18086,81561605,7,0,1,2560,18,6459057252
7594,81545119,276728,81821847,5,0,0,4096,15,6810277901
7595,81546171,43461,81589632,2,0,1,51712,9,7422163837
7596,81555270,306085,81861355,4,0,0,48128,14,7926891157
7597,81562719,28219,81590938,7,0,1,2048,18,1176153250
7598,81582829,364585,81947414,5,0,0,2560,15,8772570457
7599,81586340,10953,81597293,4,0,1,7168,14,2913928347
7600,81600580,5802,81606382,4,0,1,6144,14,5823868531
7601,81601390,369108,81970498,7,0,0,46080,18,6016113202
7602,81615130,3422,81618552,4,0,1,3584,14,6321883735
7603,81617509,7706,81625215,6,0,1,8192,8,3588495283
7604,81623620,360716,81984336,7,0,0,17920,18,10131353036
7605,81627170,3645,81630815,4,0,1,10240,14,6848781025
7606,81627269,4592,81631861,6,0,1,1536,8,7854047957
7607,81631830,35571,81667401,4,0,1,62464,14,3553436818
7608,81642180,486875,82129055,7,0,0,12288,18,9434668922
7609,81642229,27758,81669987,6,0,1,4096,8,3552226614
7610,81644149,379616,82023765,5,0,0,18944,15,3879246391
7611,81644431,26427,81670858,2,0,1,12288,9,394391866
7612,81651500,399558,82051058,8,0,0,1536,26,7414012011
7613,81657220,388975,82046195,7,0,0,3584,18,7736667847
7614,81658569,12545,81671114,7,0,1,9216,18,5125354006
7615,81688830,13341,81702171,4,0,1,22528,14,2337986325
7616,81692910,191072,81883982,7,0,0,8704,18,10697556628
7617,81716730,84364,81801094,4,0,0,7680,14,246594089
7618,81720689,345574,82066263,6,0,0,18432,8,10547328014
7619,81724679,1518,81726197,6,0,1,1536,8,6918221257
7620,81729439,2470,81731909,7,0,1,2560,18,5688353366
7621,81729551,22574,81752125,2,0,1,17920,9,9673634639
7622,81730730,144019,81874749,7,0,0,10240,18,2163443206
7623,81732050,431481,82163531,7,0,0,66048,18,148299140
7624,81735239,16909,81752148,6,0,1,17920,8,4599683910
7625,81744050,468689,82212739,4,0,0,46080,14,6092780203
7626,81766131,76813,81842944,2,0,1,76800,9,2441855561
7627,81766720,94650,81861370,4,0,1,17920,14,7222101144
7628,81779020,276530,82055550,8,0,0,1024,26,3984140606
7629,81791880,110720,81902600,7,0,0,1536,18,3716691612
7630,81795949,160494,81956443,6,0,0,20992,8,7147433536
7631,81798429,62972,81861401,6,0,1,1536,8,7213699350
7632,81804039,57377,81861416,7,0,1,1536,18,1850834182
7633,81806170,59689,81865859,4,0,1,57344,14,4646883438
7634,81809269,59816,81869085,6,0,1,5120,8,8994100989
7635,81811609,243614,82055223,6,0,0,5120,8,10631638094
7636,81820700,505134,82325834,4,0,0,183296,14,3052459278
7637,81827199,704688,82531887,5,0,0,77824,15,5087570386
7638,81833140,624260,82457400,8,0,0,512,26,8342365134
7639,81847830,487558,82335388,4,0,0,28160,14,2616758265
7640,81853129,473656,82326785,5,0,0,3072,15,486504638
7641,81859269,10162,81869431,7,0,1,512,18,7552516362
7642,81877661,7230,81884891,2,0,1,7680,9,3953825330
7643,81879630,460336,82339966,4,0,0,14848,14,2351755956
7644,81888531,54358,81942889,2,0,1,89088,9,8914572463
7645,81890489,592272,82482761,5,0,0,31232,15,6865978457
7646,81896491,46962,81943453,2,0,1,10752,9,9959654373
7647,81915699,434578,82350277,5,0,0,33792,15,5193561963
7648,81921941,95029,82016970,2,0,1,158208,9,3285697806
7649,81934861,97560,82032421,2,0,1,49152,9,1822343228
7650,81940931,107043,82047974,2,0,1,57856,9,6822907292
7651,81944660,505878,82450538,8,0,0,512,26,8272577351
7652,81960510,168716,82129226,8,0,0,512,26,7543083511
7653,81965391,100887,82066278,2,0,1,50176,9,7861157637
7654,81967489,471412,82438901,5,0,0,13312,15,10406766179
7655,81973771,120810,82094581,2,0,1,107008,9,4604474723
7656,81977779,610163,82587942,5,0,0,79872,15,2519906614
7657,81989551,113112,82102663,2,0,1,23552,9,9689364100
7658,81993119,424235,82417354,5,0,0,60416,15,3833881633
7659,81999329,641090,82640419,5,0,0,128000,15,2991029868
7660,82027730,83889,82111619,4,0,1,41472,14,1851369678
7661,82064319,48376,82112695,7,0,1,13312,18,5652998850
7662,82069579,317785,82387364,6,0,0,31232,8,4102548059
7663,82072669,40487,82113156,7,0,1,10240,18,1332781715
7664,82082310,290121,82372431,7,0,0,58368,18,321503716
7665,82094490,69056,82163546,4,0,1,89600,14,3131847335
7666,82099530,436663,82536193,8,0,0,1024,26,6600144677
7667,82101140,84280,82185420,4,0,1,103424,14,2105038214
7668,82113640,418574,82532214,9,0,0,1024,17,774178629
7669,82119020,300563,82419583,9,0,0,512,17,9987975920
7670,82124689,465296,82589985,5,0,0,6656,15,8337613131
7671,82141149,460239,82601388,6,0,0,37376,8,10352589910
7672,82146630,50541,82197171,4,0,1,48128,14,1248033607
7673,82162899,534993,82697892,5,0,0,1024,15,578155638
7674,82165430,185198,82350628,9,0,0,1024,17,6121152957
7675,82189619,453959,82643578,5,0,0,10240,15,4209293435
7676,82196360,16410,82212770,4,0,1,17408,14,8280437190
7677,82198480,293846,82492326,8,0,0,512,26,8532212509
7678,82205459,10684,82216143,7,0,1,9728,18,10598826910
7679,82231560,187837,82419397,7,0,0,6656,18,5873364701
7680,82251131,84280,82335411,2,0,1,68608,9,6354220513
7681,82280690,221387,82502077,8,0,0,512,26,1905568266
7682,82286690,560515,82847205,4,0,0,173568,14,7882290097
7683,82307009,470429,82777438,5,0,0,9216,15,6556300309
7684,82316849,578738,82895587,5,0,0,47616,15,4726173288
7685,82333150,39296,82372446,4,0,1,25600,14,6332741632
7686,82338210,53164,82391374,4,0,1,57344,14,4791253978
7687,82343730,380898,82724628,9,0,0,2560,17,10396540602
7688,82350421,68991,82419412,2,0,1,50688,9,1877678157
7689,82360509,520532,82881041,6,0,0,110080,8,7516975742
7690,82364640,405641,82770281,7,0,0,45056,18,1020843572
7691,82371829,332311,82704140,5,0,0,12800,15,8821445464
7692,82380410,39188,82419598,4,0,1,2560,14,5809886417
7693,82390379,29234,82419613,7,0,1,512,18,2595155103
7694,82411699,489690,82901389,5,0,0,17408,15,7812350865
7695,82417139,9245,82426384,7,0,1,7168,18,5525701247
7696,82443170,458390,82901560,8,0,0,512,26,4517725118
7697,82443321,7706,82451027,2,0,1,8192,9,10416369052
7698,82457180,3422,82460602,8,0,1,3584,26,3455875521
7699,82493490,550643,83044133,7,0,0,57344,18,5982248787
7700,82527780,687157,83214937,4,0,0,12288,14,5239455752
7701,82528831,8267,82537098,2,0,1,5120,9,2918243158
7702,82530240,381783,82912023,7,0,0,13312,18,9176011202
7703,82542310,353760,82896070,8,0,0,1536,26,4079235246
7704,82577180,435242,83012422,9,0,0,1024,17,5778149071
7705,82584339,801632,83385971,6,0,0,69632,8,5815695415
7706,82594509,252929,82847438,6,0,0,512,8,6803095550
7707,82599470,427176,83026646,4,0,0,28160,14,2594390293
7708,82607060,534348,83141408,4,0,0,46592,14,5141206187
7709,82628279,273508,82901787,6,0,0,512,8,10394910657
7710,82659681,5196,82664877,2,0,1,13312,9,523502006
7711,82718079,455389,83173468,6,0,0,1024,8,7807590858
7712,82719240,566,82719806,5,0,1,512,15,9074504555
7713,82731440,323840,83055280,4,0,0,36352,14,5546796848
7714,82738200,377529,83115729,7,0,0,106496,18,7292506749
7715,82738620,163518,82902138,8,0,0,1024,26,9338644392
7716,82743541,26755,82770296,2,0,1,28160,9,9434045356
7717,82744201,103019,82847220,2,0,1,69120,9,2885820992
7718,82769980,77255,82847235,5,0,1,1024,15,6001870664
7719,82781750,99314,82881064,0,0,1,84480,25,7424955514
7720,82787340,120457,82907797,0,0,1,6656,25,10329691952
7721,82788939,277197,83066136,6,0,0,1024,8,10259791239
7722,82795081,144295,82939376,2,0,1,62976,9,2640631295
7723,82808661,131791,82940452,2,0,1,13312,9,8170068186
7724,82812240,518929,83331169,8,0,0,512,26,9550346683
7725,82815751,135940,82951691,2,0,1,37376,9,5950939609
7726,82819351,132904,82952255,2,0,1,10752,9,377798323
7727,82821030,136410,82957440,0,0,1,16384,25,9421823696
7728,82823390,742473,83565863,4,0,0,58368,14,7615828455
7729,82831270,127476,82958746,8,0,1,2048,26,6803468435
7730,82833480,587258,83420738,7,0,0,79360,18,2257508383
7731,82852820,265887,83118707,8,0,0,3072,26,6712077429
7732,82853280,509025,83362305,9,0,0,1536,17,8807880592
7733,82853560,106812,82960372,0,0,1,2560,25,8757083850
7734,82871000,103100,82974100,0,0,1,47104,25,5711648809
7735,82877650,313749,83191399,7,0,0,11776,18,8776999703
7736,82886990,370994,83257984,9,0,0,512,17,481291177
7737,82892071,107282,82999353,2,0,1,65024,9,1028896961
7738,82909640,305468,83215108,8,0,0,512,26,50756762
7739,82913110,92759,83005869,0,0,1,31232,25,269317123
7740,82920441,147720,83068161,2,0,1,128000,9,2342633012
7741,82929270,598403,83527673,7,0,0,79872,18,9459593711
7742,82931599,272639,83204238,6,0,0,512,8,8570897737
7743,82936020,247083,83183103,7,0,0,9728,18,4459640471
7744,82940310,267843,83208153,4,0,0,5120,14,5568269176
7745,82943780,511447,83455227,4,0,0,19456,14,2317070662
7746,82960061,155723,83115784,2,0,1,77824,9,10717927222
7747,82965849,821028,83786877,5,0,0,53248,15,2770428926
7748,82972650,143149,83115799,3,0,1,52224,29,2920459297
7749,82993930,365847,83359777,4,0,0,8704,14,2862708654
7750,83002690,463628,83466318,4,0,0,36352,14,4418904924
7751,83016140,105826,83121966,5,0,1,6656,15,3100458059
7752,83023740,102412,83126152,5,0,1,6656,15,8398896732
7753,83027170,99648,83126818,5,0,1,1024,15,10191539017
7754,83051510,213358,83264868,9,0,0,512,17,5033702124
7755,83086859,587205,83674064,6,0,0,1024,8,2107149046
7756,83105881,50153,83156034,2,0,1,62976,9,10137232998
7757,83107830,392525,83500355,4,0,0,9728,14,5294905385
7758,83110810,46850,83157660,5,0,1,2560,15,2131415472
7759,83122111,41450,83163561,2,0,1,19968,9,7560071709
7760,83127481,37386,83164867,2,0,1,2048,9,8228727793
7761,83142209,555426,83697635,5,0,0,77312,15,3372448603
7762,83148770,17083,83165853,5,0,1,1536,15,7985056250
7763,83160159,610447,83770606,5,0,0,80384,15,4098435063
7764,83162720,5719,83168439,5,0,1,4096,15,6150432747
7765,83164980,6685,83171665,5,0,1,5120,15,1113383304
7766,83174690,251523,83426213,7,0,0,17920,18,7115777959
7767,83181769,772756,83954525,5,0,0,14848,15,9396729623
7768,83195960,923858,84119818,4,0,0,53760,14,9714699979
7769,83208180,228039,83436219,9,0,0,1024,17,10432290963
7770,83249240,424497,83673737,7,0,0,28160,18,4434820870
7771,83254530,334638,83589168,9,0,0,512,17,5755308313
7772,83262339,351896,83614235,5,0,0,55808,15,9888892652
7773,83264589,129885,83394474,6,0,0,512,8,4477171672
7774,83265599,300747,83566346,6,0,0,1536,8,5840791228
7775,83296080,642790,83938870,4,0,0,15360,14,3862533720
7776,83299880,535302,83835182,4,0,0,19968,14,2095455038
7777,83346790,182599,83529389,7,0,0,512,18,1173628895
7778,83359309,499338,83858647,5,0,0,60416,15,7080982363
7779,83361890,540971,83902861,9,0,0,1024,17,1656424734
7780,83364650,464433,83829083,4,0,0,32768,14,6981373940
7781,83364760,356510,83721270,9,0,0,512,17,3532037256
7782,83385489,313885,83699374,5,0,0,5632,15,8942170039
7783,83420720,10828,83431548,5,0,1,5632,15,7075239174
7784,83423550,197631,83621181,8,0,0,1024,26,2598938832
7785,83501550,498985,84000535,4,0,0,19456,14,2687275692
7786,83501690,492419,83994109,7,0,0,115712,18,854973446
7787,83509879,307134,83817013,6,0,0,512,8,5158090832
7788,83543330,476966,84020296,4,0,0,44544,14,2386219572
7789,83558919,251805,83810724,6,0,0,1536,8,6708975540
7790,83580871,33395,83614266,2,0,1,44544,9,3140464305
7791,83602990,463026,84066016,4,0,0,33280,14,5958216774
7792,83603470,517331,84120801,8,0,0,3072,26,9095493181
7793,83608340,179980,83788320,7,0,0,4608,18,8620381167
7794,83618610,299969,83918579,8,0,0,2048,26,1712738724
7795,83620690,306108,83926798,4,0,0,25088,14,5887376830
7796,83646870,266579,83913449,8,0,0,1024,26,7365872943
7797,83647420,1042,83648462,5,0,1,1024,15,6821437467
7798,83649191,15321,83664512,2,0,1,29696,9,9416154908
7799,83654910,345820,84000730,9,0,0,512,17,10598901957
7800,83676240,187203,83863443,8,0,0,1024,26,4233247158
7801,83702480,527069,84229549,9,0,0,1536,17,4780929311
7802,83702681,106962,83809643,2,0,1,178176,9,1529653725
7803,83711529,283063,83994592,6,0,0,1536,8,3989391964
7804,83725361,87828,83813189,2,0,1,5632,9,3829257763
7805,83738200,573644,84311844,4,0,0,54272,14,2262254625
7806,83753781,64797,83818578,2,0,1,25600,9,4259143130
7807,83777630,272627,84050257,4,0,0,6144,14,8393641657
7808,83800769,278991,84079760,5,0,0,4608,15,10129362250
7809,83801380,345552,84146932,8,0,0,1024,26,4356342171
7810,83808559,118574,83927133,6,0,0,1024,8,3147384323
7811,83809059,194999,84004058,6,0,0,512,8,3888748445
7812,83817190,254733,84071923,9,0,0,512,17,3339419556
7813,83818710,302582,84121292,7,0,0,1536,18,9607861324
7814,83847760,11921,83859681,1,0,1,1024,2,4895805356
7815,83878999,350051,84229050,5,0,0,49152,15,8749833120
7816,83879029,469537,84348566,5,0,0,47104,15,5334256976
7817,83895110,105807,84000917,7,0,0,512,18,5889556741
7818,83898109,509799,84407908,6,0,0,1024,8,1580978219
7819,83900919,475491,84376410,5,0,0,38400,15,3793871054
7820,83912800,257719,84170519,9,0,0,512,17,7644094096
7821,83913900,2946,83916846,1,0,1,3072,2,5994515105
7822,83924330,337774,84262104,4,0,0,15360,14,648456179
7823,83942220,2470,83944690,4,0,1,2560,14,4695710948
7824,83946609,444948,84391557,5,0,0,49664,15,4926711362
7825,83948040,245698,84193738,8,0,0,1024,26,10240751705
7826,83952320,460256,84412576,9,0,0,512,17,2200379227
7827,83957911,62400,84020311,2,0,1,99840,9,2961805672
7828,83960410,488701,84449111,8,0,0,3072,26,119945185
7829,83972590,47948,84020538,8,0,1,1536,26,8777965798
7830,83974591,70123,84044714,2,0,1,74240,9,10477045933
7831,83993930,149774,84143704,8,0,0,512,26,7681835417
7832,83996550,245207,84241757,4,0,0,3584,14,4543223920
7833,84015070,30950,84046020,1,0,1,2048,2,2589880889
7834,84037459,368351,84405810,5,0,0,18944,15,9198821582
7835,84038090,14343,84052433,8,0,1,22528,26,6156823634
7836,84056430,384967,84441397,7,0,0,1024,18,3081862772
7837,84060769,473560,84534329,5,0,0,54784,15,1852270528
7838,84103890,333965,84437855,8,0,0,512,26,4329929302
7839,84104421,69663,84174084,2,0,1,86016,9,242808711
7840,84104950,286786,84391736,8,0,0,512,26,2660119447
7841,84107600,69390,84176990,8,0,1,4608,26,3438991579
7842,84108931,69442,84178373,2,0,1,14848,9,10691188851
7843,84117921,62718,84180639,2,0,1,3584,9,10362276331
7844,84121080,60430,84181510,8,0,1,12288,26,928832831
7845,84123020,60756,84183776,1,0,1,3584,2,6261486465
7846,84133831,55744,84189575,2,0,1,19456,9,7810780020
7847,84141240,347380,84488620,7,0,0,1536,18,6825250601
7848,84143530,327754,84471284,9,0,0,1024,17,9941900906
7849,84155780,37973,84193753,1,0,1,6144,2,1739296537
7850,84160690,332284,84492974,7,0,0,512,18,6629905779
7851,84166070,119262,84285332,7,0,0,1024,18,3127060355
7852,84190270,361147,84551417,4,0,0,30208,14,10465090027
7853,84203850,272415,84476265,9,0,0,1024,17,3146110872
7854,84210490,412078,84622568,8,0,0,2048,26,10290464808
7855,84220301,13886,84234187,2,0,1,12288,9,9787520466
7856,84227320,7213,84234533,8,0,1,512,26,418580134
7857,84258631,53236,84311867,2,0,1,70144,9,9690675135
7858,84285750,459124,84744874,4,0,0,138240,14,1671762633
7859,84286471,25411,84311882,2,0,1,11776,9,308748582
7860,84296101,57909,84354010,2,0,1,68608,9,6154623690
7861,84315290,225893,84541183,7,0,0,512,18,10308858668
7862,84320060,425172,84745232,9,0,0,512,17,274292556
7863,84321040,268477,84589517,8,0,0,512,26,1133307600
7864,84379810,15272,84395082,8,0,1,9728,26,6955480095
7865,84407089,453682,84860771,5,0,0,19968,15,9682666165
7866,84426730,487504,84914234,8,0,0,2048,26,4893080403
7867,84428070,1042,84429112,8,0,1,1024,26,7712378098
7868,84441499,471568,84913067,5,0,0,35328,15,5696803263
7869,84468010,277035,84745045,7,0,0,512,18,3818311533
7870,84477440,441082,84918522,9,0,0,2048,17,3037560492
7871,84487710,131228,84618938,4,0,0,1536,14,2166465014
7872,84502030,249414,84751444,9,0,0,512,17,3338353302
7873,84502060,411535,84913595,8,0,0,1536,26,1466707121
7874,84539890,44145,84584035,0,0,1,75776,25,3475719487
7875,84550251,33938,84584189,2,0,1,8704,9,5951707082
7876,84568219,508051,85076270,5,0,0,91648,15,4553457956
7877,84569230,479055,85048285,4,0,0,78848,14,2299168213
7878,84572240,519084,85091324,4,0,0,21504,14,7581826365
7879,84579260,316085,84895345,7,0,0,37888,18,8027755023
7880,84581240,297223,84878463,9,0,0,512,17,241081133
7881,84600570,6278,84606848,0,0,1,6656,25,2376649484
7882,84602940,392324,84995264,7,0,0,43008,18,6492541165
7883,84643740,480589,85124329,7,0,0,61952,18,1596778364
7884,84652640,3422,84656062,8,0,1,3584,26,7632360421
7885,84653150,4276,84657426,0,0,1,10240,25,2648318885
7886,84661690,1518,84663208,8,0,1,1536,26,6121977110
7887,84669659,542690,85212349,5,0,0,35328,15,10162528824
7888,84670110,75137,84745247,0,0,1,92672,25,8114827812
7889,84671170,327103,84998273,9,0,0,2048,17,8683708780
7890,84689060,56218,84745278,0,0,1,8192,25,184006705
7891,84691630,432878,85124508,8,0,0,512,26,4167429132
7892,84695220,108160,84803380,7,0,0,1024,18,9168533232
7893,84695391,49902,84745293,2,0,1,4096,9,10053091332
7894,84698000,304206,85002206,8,0,0,2048,26,8215789843
7895,84700830,215958,84916788,7,0,0,3584,18,8659980412
7896,84708000,142840,84850840,9,0,0,512,17,4949559648
7897,84713151,35324,84748475,2,0,1,9216,9,4422116462
7898,84726099,23098,84749197,7,0,1,1024,18,3913332332
7899,84728860,23505,84752365,8,0,1,4096,26,4093918035
7900,84736319,18592,84754911,9,0,1,13312,17,8972761766
7901,84741040,46064,84787104,0,0,1,54784,25,7424783525
7902,84744050,44360,84788410,8,0,1,2048,26,4956995473
7903,84762699,533877,85296576,5,0,0,63488,15,2055356296
7904,84778210,10456,84788666,0,0,1,9216,25,147768821
7905,84786520,44920,84831440,0,0,1,77312,25,7291351184
7906,84788010,612771,85400781,9,0,0,1024,17,7797908040
7907,84803970,342358,85146328,4,0,0,14336,14,5961660701
7908,84818280,19164,84837444,0,0,1,28672,25,5898710826
7909,84826880,24427,84851307,0,0,1,40448,25,6966416476
7910,84830139,254610,85084749,5,0,0,27648,15,1884619810
7911,84831290,81792,84913082,0,0,1,109056,25,4084529202
7912,84847210,65887,84913097,8,0,1,4608,26,7203070116
7913,84852460,60652,84913112,8,0,1,2560,26,6437096277
7914,84859240,409646,85268886,9,0,0,1024,17,8354648703
7915,84874710,285679,85160389,4,0,0,26112,14,9550538823
7916,84874840,262895,85137735,4,0,0,28672,14,5694805613
7917,84880660,34316,84914976,8,0,1,22016,26,10712841691
7918,84882060,391590,85273650,9,0,0,1536,17,718338955
7919,84898630,20212,84918842,8,0,1,6144,26,3462785450
7920,84902260,534362,85436622,4,0,0,48128,14,7895667104
7921,84930099,441433,85371532,5,0,0,9728,15,5073421448
7922,84939650,12049,84951699,8,0,1,19968,26,1148440019
7923,84945060,423470,85368530,4,0,0,39424,14,6646913716
7924,84957670,53753,85011423,0,0,1,91136,25,1391440789
7925,84958140,55229,85013369,8,0,1,3072,26,7904217701
7926,84979750,44346,85024096,0,0,1,34816,25,10385864175
7927,84984080,64228,85048308,8,0,1,4096,26,9493623244
7928,84985140,214773,85199913,4,0,0,14848,14,4720164981
7929,85002039,46284,85048323,9,0,1,7680,17,10453259017
7930,85003720,237791,85241511,4,0,0,36864,14,3824498071
7931,85011490,153442,85164932,9,0,0,2560,17,718726262
7932,85026179,65160,85091339,9,0,1,1536,17,10457433835
7933,85033910,58624,85092534,0,0,1,30720,25,140144126
7934,85051499,43301,85094800,6,0,1,3584,8,575107600
7935,85053810,505969,85559779,7,0,0,20480,18,5759983272
7936,85059430,36676,85096106,1,0,1,2048,2,8554479690
7937,85065580,395345,85460925,7,0,0,78336,18,9223878093
7938,85077129,19613,85096742,9,0,1,10240,17,2244358296
7939,85080660,140993,85221653,9,0,0,1024,17,3603491898
7940,85086890,13701,85100591,8,0,1,4608,26,5571998149
7941,85094110,466799,85560909,9,0,0,3072,17,8438191802
7942,85096860,5997,85102857,8,0,1,3584,26,7136151068
7943,85099360,121259,85220619,9,0,0,1024,17,3886261661
7944,85103289,566,85103855,9,0,1,512,17,1006072815
7945,85115480,44940,85160420,0,0,1,51712,25,10647487379
7946,85122380,281473,85403853,8,0,0,1024,26,6501278542
7947,85131810,164945,85296755,8,0,0,512,26,76057826
7948,85152510,185577,85338087,8,0,0,3072,26,1462593936
7949,85153190,308530,85461720,9,0,0,2560,17,9679819839
7950,85163709,2946,85166655,9,0,1,3072,17,4503410571
7951,85166840,23120,85189960,0,0,1,41472,25,7825525733
7952,85179510,12396,85191906,8,0,1,3072,26,8324598299
7953,85180980,12872,85193852,0,0,1,3072,25,2396219310
7954,85190210,10241,85200451,0,0,1,16384,25,5757864876
7955,85215160,6754,85221914,0,0,1,7168,25,1115122814
7956,85222490,2946,85225436,8,0,1,3072,26,8692730689
7957,85242469,256310,85498779,5,0,0,19968,15,1198374864
7958,85245380,323047,85568427,4,0,0,24576,14,4880651633
7959,85272090,281418,85553508,7,0,0,27648,18,9643103759
7960,85287850,15618,85303468,8,0,1,7168,26,6738545458
7961,85297629,9065,85306694,9,0,1,5120,17,337334906
7962,85299509,337614,85637123,5,0,0,40448,15,6377485209
7963,85310850,271484,85582334,7,0,0,45568,18,6195332590
7964,85315651,6488,85322139,2,0,1,15872,9,6176387682
7965,85318540,300992,85619532,8,0,0,1536,26,747975394
7966,85321889,502011,85823900,5,0,0,12288,15,9725362614
7967,85330190,390604,85720794,9,0,0,1024,17,7015831928
7968,85334179,1042,85335221,9,0,1,1024,17,705277901
7969,85341660,218290,85559950,9,0,0,512,17,7692403903
7970,85342500,13600,85356100,0,0,1,23040,25,815600952
7971,85351520,4836,85356356,0,0,1,9216,25,185113323
7972,85354261,14292,85368553,2,0,1,6656,9,7366964522
7973,85354609,465329,85819938,5,0,0,118272,15,6590981520
7974,85357820,413895,85771715,7,0,0,1024,18,5760348631
7975,85370890,391015,85761905,7,0,0,45568,18,127626387
7976,85387480,205941,85593421,8,0,0,2048,26,6974588720
7977,85404980,270619,85675599,9,0,0,1024,17,5625274723
7978,85410310,172203,85582513,8,0,0,512,26,525271393
7979,85423440,38295,85461735,0,0,1,31232,25,415196470
7980,85435250,26500,85461750,8,0,1,6144,26,6251590847
7981,85479949,1042,85480991,9,0,1,1024,17,39446621
7982,85482540,5802,85488342,0,0,1,6144,25,1912511921
7983,85489950,8844,85498794,0,0,1,12800,25,9327990268
7984,85507319,2946,85510265,9,0,1,3072,17,9371597554
7985,85511000,309133,85820133,9,0,0,512,17,4521066057
7986,85528389,1042,85529431,9,0,1,1024,17,6324095105
7987,85533470,27454,85560924,0,0,1,45568,25,6866804246
7988,85538190,232887,85771077,7,0,0,1536,18,5923867934
7989,85539600,288707,85828307,4,0,0,14336,14,7161208716
7990,85552571,62286,85614857,2,0,1,80384,9,5293511962
7991,85564880,333427,85898307,3,0,0,5632,29,8298272890
7992,85571179,360728,85931907,5,0,0,30208,15,1903715158
7993,85585010,33393,85618403,8,0,1,5632,26,3076054957
7994,85608481,14108,85622589,2,0,1,6656,9,8754252535
7995,85635880,2753,85638633,8,0,1,1536,26,2766108889
7996,85668430,167338,85835768,4,0,0,1024,14,3028100775
7997,85674519,460386,86134905,5,0,0,37376,15,7926947122
7998,85676780,301808,85978588,3,0,0,80384,29,1783427004
7999,85741010,313201,86054211,7,0,0,512,18,5672732228
8000,85754001,74321,85828322,2,0,1,100352,9,8805259802
8001,85760971,67390,85828361,2,0,1,10240,9,5093633568
8002,85765629,399923,86165552,5,0,0,7680,15,9417850464
8003,85782319,490417,86272736,5,0,0,21504,15,7693752477
8004,85793130,160442,85953572,9,0,0,512,17,2148705542
8005,85798890,364307,86163197,3,0,0,36352,29,4704398197
8006,85801300,30879,85832179,1,0,1,4096,2,3222570827
8007,85812130,20395,85832525,1,0,1,512,2,6752787380
8008,85815300,19171,85834471,8,0,1,3072,26,5550768240
8009,85834649,7706,85842355,7,0,1,8192,18,3535339175
8010,85836180,8121,85844301,8,0,1,3072,26,7496344070
8011,85839350,6257,85845607,5,0,1,2048,15,921620818
8012,85842749,292991,86135740,5,0,0,2560,15,7290615520
8013,85846790,690766,86537556,4,0,0,11776,14,4092799771
8014,85849520,758994,86608514,4,0,0,48640,14,6323424793
8015,85853730,575077,86428807,3,0,0,93696,29,4922741043
8016,85858620,211270,86069890,3,0,0,39936,29,5693783141
8017,85876560,4374,85880934,1,0,1,4608,2,106714101
8018,85883510,1042,85884552,8,0,1,1024,26,4851470322
8019,85886479,420722,86307201,5,0,0,15872,15,4357410921
8020,85890300,4420,85894720,5,0,1,11776,15,1899803482
8021,85890319,540687,86431006,5,0,0,7168,15,10212904745
8022,85893170,8022,85901192,1,0,1,7680,2,3424767220
8023,85896360,6138,85902498,1,0,1,2048,2,7636471100
8024,85896940,82733,85979673,4,0,1,131584,14,3787120815
8025,85899890,340297,86240187,7,0,0,13824,18,9492558950
8026,85907770,73209,85980979,1,0,1,2048,2,2309149469
8027,85907960,477261,86385221,7,0,0,102400,18,1396752014
8028,85914910,66428,85981338,8,0,1,9728,26,3998391931
8029,85915180,71547,85986727,4,0,1,17408,14,1080846889
8030,85915890,73423,85989313,1,0,1,4096,2,1850138626
8031,85917350,482878,86400228,3,0,0,49152,29,4104096589
8032,85924090,65889,85989979,4,0,1,1024,14,8122899901
8033,85929210,66261,85995471,8,0,1,17920,26,9943320113
8034,85934400,63657,85998057,8,0,1,4096,26,9106901134
8035,85951720,556462,86508182,4,0,0,59904,14,8489324947
8036,85952880,47443,86000323,5,0,1,3584,15,8529076275
8037,85962740,83020,86045760,4,0,1,111616,14,2155752427
8038,85965280,981210,86946490,4,0,0,69632,14,875143415
8039,85966640,81706,86048346,1,0,1,4096,2,2268918750
8040,85971490,77010,86048500,8,0,1,8704,26,3456230515
8041,85978470,70376,86048846,1,0,1,512,2,1074882106
8042,85980900,71492,86052392,1,0,1,5632,2,2405789513
8043,85990861,283138,86273999,0,0,0,4096,25,10547806820
8044,86003540,853354,86856894,3,0,0,72704,29,1196414133
8045,86007200,46818,86054018,5,0,1,2560,15,1664399824
8046,86018460,171824,86190284,9,0,0,512,17,3968430555
8047,86018680,515257,86533937,7,0,0,84480,18,9126988250
8048,86034190,823655,86857845,9,0,0,3072,17,6096973345
8049,86035550,558121,86593671,3,0,0,108032,29,8779332575
8050,86040150,16774,86056924,1,0,1,4608,2,2202325820
8051,86041690,663480,86705170,4,0,0,35840,14,3679259199
8052,86046210,23695,86069905,1,0,1,3072,2,6819431668
8053,86059809,372500,86432309,5,0,0,4096,15,9529813151
8054,86060751,1244753,87305504,0,0,0,50176,25,2070863448
8055,86061070,60651,86121721,3,0,1,83968,29,4394416266
8056,86072461,757103,86829564,0,0,0,54784,25,5892468774
8057,86076660,88923,86165583,0,0,1,99840,25,8018166963
8058,86083960,823476,86907436,4,0,0,65536,14,6476405156
8059,86085590,223188,86308778,4,0,0,2560,14,4373895590
8060,86095750,78541,86174291,0,0,1,56832,25,1034564433
8061,86105671,912197,87017868,0,0,0,70656,25,2077570110
8062,86106890,431944,86538834,3,0,0,1024,29,8614786547
8063,86113831,187735,86301566,0,0,0,4096,25,5594976417
8064,86125110,49437,86174547,8,0,1,9216,26,2979785144
8065,86140820,36633,86177453,0,0,1,4608,25,70141721
8066,86143430,596504,86739934,4,0,0,56320,14,10576972755
8067,86169771,692637,86862408,0,0,0,14848,25,1843952460
8068,86172049,458868,86630917,5,0,0,14336,15,5217876158
8069,86176031,817628,86993659,0,0,0,4096,25,6538633813
8070,86195781,1362422,87558203,0,0,0,12800,25,498865483
8071,86202450,33075,86235525,0,0,1,54272,25,2649810499
8072,86226800,852331,87079131,4,0,0,58368,14,7410776373
8073,86237150,49241,86286391,0,0,1,79872,25,3934827875
8074,86246080,43537,86289617,8,0,1,5120,26,9417095462
8075,86269650,22233,86291883,8,0,1,3584,26,1144899993
8076,86269750,22479,86292229,8,0,1,512,26,7026528512
8077,86280910,26738,86307648,0,0,1,48640,25,227153662
8078,86298920,626315,86925235,7,0,0,58368,18,1365078893
8079,86313090,951731,87264821,4,0,0,71680,14,3420153998
8080,86329580,1994,86331574,5,0,1,2048,15,4799034029
8081,86356220,78192,86434412,8,0,1,3584,26,9091709421
8082,86360000,1116054,87476054,3,0,0,39424,29,6634324742
8083,86371151,1092852,87464003,0,0,0,210944,25,2477056588
8084,86374120,1025596,87399716,4,0,0,159744,14,8877982377
8085,86384530,51188,86435718,8,0,1,2048,26,3609117110
8086,86393210,60098,86453308,0,0,1,32768,25,8610710682
8087,86415700,43305,86459005,0,0,1,18944,25,6672635419
8088,86419690,572706,86992396,4,0,0,36864,14,6504863680
8089,86422680,660990,87083670,7,0,0,14848,18,6686190169
8090,86425460,319645,86745105,3,0,0,16896,29,8342532177
8091,86441930,901196,87343126,7,0,0,4608,18,1347941073
8092,86459150,4374,86463524,8,0,1,4608,26,9653145236
8093,86472510,362217,86834727,7,0,0,16896,18,8199575743
8094,86520430,1011362,87531792,4,0,0,92160,14,7066010224
8095,86526791,763356,87290147,0,0,0,82432,25,3861930192
8096,86535720,3839,86539559,0,0,1,2048,25,5430211321
8097,86536751,524057,87060808,0,0,0,25088,25,2341797177
8098,86545350,566,86545916,8,0,1,512,26,5187629969
8099,86548971,589326,87138297,0,0,0,4096,25,1010325579
8100,86559370,1340844,87900214,4,0,0,31232,14,5293667077
8101,86560720,47833,86608553,0,0,1,512,25,2695761279
8102,86579350,1129232,87708582,3,0,0,7168,29,2298714043
8103,86583100,28903,86612003,0,0,1,3584,25,4583042591
8104,86583330,1078146,87661476,7,0,0,25088,18,4364224727
8105,86598100,18409,86616509,8,0,1,7168,26,1902610111
8106,86626069,1041008,87667077,5,0,0,8192,15,4125697573
8107,86628071,956279,87584350,0,0,0,24064,25,1123171387
8108,86653210,1042,86654252,5,0,1,1024,15,731607025
8109,86674980,643620,87318600,7,0,0,18944,18,373387546
8110,86695710,49418,86745128,0,0,1,60416,25,3534542912
8111,86701320,852968,87554288,4,0,0,11776,14,7966178078
8112,86707900,1510990,88218890,7,0,0,8192,18,1348936024
8113,86735040,606667,87341707,7,0,0,29696,18,7168761314
8114,86749319,795336,87544655,5,0,0,41984,15,3780352441
8115,86750000,53237,86803237,0,0,1,90112,25,4798883036
8116,86754851,266927,87021778,0,0,0,6144,25,3407194833
8117,86762450,940525,87702975,4,0,0,24064,14,5530376691
8118,86786901,1314100,88101001,0,0,0,98304,25,3853723046
8119,86796860,7363,86804223,5,0,1,1536,15,1665275065
8120,86799580,8829,86808409,5,0,1,6656,15,877343111
8121,86810769,397698,87208467,5,0,0,16896,15,9107415636
8122,86827100,1074533,87901633,7,0,0,4608,18,8016912088
8123,86838790,24143,86862933,5,0,1,512,15,576831638
8124,86850110,96419,86946529,0,0,1,112640,25,6709967680
8125,86908750,45430,86954180,0,0,1,8192,25,2901079182
8126,86915591,958503,87874094,0,0,0,92160,25,1494041468
8127,86922000,43324,86965324,0,0,1,31744,25,165648503
8128,86923450,44780,86968230,8,0,1,4608,26,3966937846
8129,86930820,1187075,88117895,4,0,0,38400,14,7877506875
8130,86935591,641412,87577003,0,0,0,48128,25,5377991071
8131,86939240,1369913,88309153,3,0,0,1024,29,9515146584
8132,86942110,26466,86968576,5,0,1,512,15,484039169
8133,86961111,710241,87671352,0,0,0,2048,25,9693999321
8134,86976870,16804,86993674,0,0,1,7680,25,10420309684
8135,86979650,1386122,88365772,4,0,0,3584,14,249928745
8136,86985440,1003106,87988546,4,0,0,28160,14,843711131
8137,86989160,1494879,88484039,4,0,0,16384,14,3825421589
8138,86993699,24184,87017883,7,0,1,4608,18,2847247868
8139,86994371,556274,87550645,0,0,0,1024,25,3609706255
8140,87041881,804110,87845991,0,0,0,73728,25,2357867937
8141,87051691,213301,87264992,0,0,0,512,25,9428276617
8142,87105289,1994,87107283,7,0,1,2048,18,8184075433
8143,87123801,379888,87503689,0,0,0,90624,25,9900935653
8144,87145450,925413,88070863,4,0,0,43008,14,8848579198
8145,87145860,731533,87877393,3,0,0,10752,29,4189883825
8146,87172899,5326,87178225,7,0,1,5632,18,10315678226
8147,87183180,367114,87550294,3,0,0,18432,29,9561601794
8148,87187489,636023,87823512,5,0,0,93696,15,7247578699
8149,87188590,101572,87290162,0,0,1,117248,25,6565499501
8150,87191640,1457092,88648732,7,0,0,19456,18,4849086993
8151,87224850,462066,87686916,3,0,0,23552,29,1084657228
8152,87229379,60798,87290177,7,0,1,2048,18,4066237224
8153,87246989,58538,87305527,7,0,1,2560,18,1665528006
8154,87247589,57953,87305542,7,0,1,13312,18,3915652407
8155,87253820,51761,87305581,0,0,1,7168,25,5773934467
8156,87282209,27276,87309485,7,0,1,4096,18,7847549332
8157,87290229,452037,87742266,5,0,0,27648,15,9918500936
8158,87290970,1140697,88431667,4,0,0,13824,14,360180037
8159,87295739,356146,87651885,5,0,0,44032,15,9161946879
8160,87318529,600607,87919136,5,0,0,57344,15,1167473166
8161,87362440,528228,87890668,3,0,0,43520,29,4892557565
8162,87364179,562360,87926539,5,0,0,13312,15,9971609819
8163,87375270,906426,88281696,4,0,0,30208,14,4410034182
8164,87404760,758314,88163074,7,0,0,111616,18,5826149351
8165,87412720,1326392,88739112,7,0,0,37888,18,7212305115
8166,87424911,1172223,88597134,0,0,0,33280,25,10388669993
8167,87428051,1056939,88484990,0,0,0,3072,25,4862110525
8168,87433300,767892,88201192,4,0,0,124416,14,2841385980
8169,87461550,754821,88216371,3,0,0,49664,29,7492270587
8170,87473830,84436,87558266,0,0,1,512,25,10297306475
8171,87480950,105172,87586122,3,0,1,61952,29,3875460560
8172,87487399,99709,87587108,7,0,1,1536,18,5752575152
8173,87496940,422523,87919463,4,0,0,1024,14,8318715752
8174,87505430,146518,87651948,3,0,1,120832,29,1783629832
8175,87510850,141113,87651963,3,0,1,8192,29,700674591
8176,87512280,149211,87661491,3,0,1,47616,29,4395153389
8177,87514450,153290,87667740,3,0,1,31744,29,8502245696
8178,87520211,226599,87746810,0,0,0,13312,25,8574773408
8179,87543679,125687,87669366,7,0,1,2560,18,3358207042
8180,87550150,125732,87675882,0,0,1,31232,25,10693204581
8181,87552230,134701,87686931,0,0,1,16384,25,6578925131
8182,87552850,134096,87686946,0,0,1,14336,25,8715977652
8183,87582460,146481,87728941,4,0,1,67072,14,771128736
8184,87589129,1332320,88921449,5,0,0,82432,15,10410842367
8185,87596491,1076113,88672604,0,0,0,27648,25,5459820332
8186,87610180,132101,87742281,0,0,1,25088,25,616835215
8187,87616039,454995,88071034,6,0,0,512,8,10418731515
8188,87632260,258423,87890683,3,0,1,3584,29,2320100573
8189,87643210,299708,87942918,4,0,0,512,14,1716047116
8190,87648460,579224,88227684,0,0,1,180736,25,1810488905
8191,87662269,568961,88231230,7,0,1,5632,18,853624042
8192,87670829,566534,88237363,7,0,1,9216,18,3119026235
8193,87675189,625712,88300901,7,0,1,1536,18,8229601586
8194,87679460,765884,88445344,7,0,0,24576,18,2644160285
8195,87685080,286371,87971451,3,0,0,36352,29,3024282737
8196,87700050,463195,88163245,4,0,0,512,14,3009004643
8197,87713459,587457,88300916,7,0,1,4096,18,2455457702
8198,87716400,570147,88286547,7,0,0,15872,18,2808857711
8199,87717129,538789,88255918,5,0,0,46080,15,10342474170
8200,87756320,636227,88392547,3,0,1,89600,29,834091063
8201,87756909,349263,88106172,5,0,0,16896,15,10393080229
8202,87770030,1001226,88771256,3,0,0,99328,29,2919188886
8203,87794479,255725,88050204,5,0,0,2048,15,5319708780
8204,87809020,455025,88264045,7,0,0,26624,18,5089933701
8205,87824770,740643,88565413,0,0,1,128512,25,1019401364
8206,87884750,507782,88392532,3,0,0,19456,29,127903440
8207,87905060,681919,88586979,7,0,0,70656,18,10420781774
8208,87912521,652877,88565398,0,0,0,91648,25,221603437
8209,87916759,648677,88565436,7,0,1,7168,18,3643208823
8210,87918379,382483,88300862,5,0,0,32256,15,4689529021
8211,87921800,675357,88597157,0,0,1,38400,25,7233507936
8212,87924600,1001481,88926081,3,0,0,512,29,8200871974
8213,87926870,871452,88798322,4,0,0,512,14,4402987843
8214,87944790,719360,88664150,7,0,0,34304,18,1073901304
8215,87944950,832402,88777352,3,0,0,18432,29,514507453
8216,87970310,636912,88607222,4,0,0,1536,14,9141385939
8217,88006149,591031,88597180,7,0,1,5120,18,9923828235
8218,88013200,674677,88687877,3,0,0,30720,29,3039846152
8219,88013439,583756,88597195,7,0,1,1536,18,7365120230
8220,88022999,574211,88597210,7,0,1,4096,18,6032767077
8221,88038100,887459,88925559,7,0,0,12288,18,121711920
8222,88047760,832278,88880038,3,0,0,3072,29,8934081868
8223,88061100,816884,88877984,4,0,0,512,14,6817451461
8224,88080221,374186,88454407,0,0,0,29696,25,10119286982
8225,88093000,214290,88307290,4,0,0,512,14,7020530281
8226,88099330,523766,88623096,4,0,1,25600,14,8517492521
8227,88121280,958009,89079289,3,0,0,25600,29,6226668331
8228,88132600,498577,88631177,4,0,1,7168,14,4065238775
8229,88148499,351796,88500295,5,0,0,21504,15,4908818357
8230,88148640,515525,88664165,3,0,1,35840,29,975038168
8231,88160360,547943,88708303,4,0,1,48640,14,1201967861
8232,88173289,535680,88708969,7,0,1,1024,18,5664199913
8233,88186880,765863,88952743,4,0,1,156672,14,2629802336
8234,88196839,750966,88947805,5,0,0,57856,15,3239012176
8235,88200910,220526,88421436,3,0,0,2560,29,1486058632
8236,88201800,769162,88970962,4,0,1,23040,14,9400084681
8237,88214569,761179,88975748,7,0,1,6656,18,6463099722
8238,88225530,845944,89071474,4,0,1,80896,14,2800036750
8239,88262910,840612,89103522,4,0,1,19968,14,4691216634
8240,88289719,813818,89103537,7,0,1,6656,18,4293052688
8241,88290090,434008,88724098,3,0,0,33792,29,6767076863
8242,88295290,432255,88727545,7,0,0,11264,18,942833909
8243,88315610,707300,89022910,3,0,0,26112,29,366763338
8244,88320730,530608,88851338,3,0,0,33280,29,6816862171
8245,88340500,585410,88925910,4,0,0,1024,14,9303385309
8246,88347760,843731,89191491,7,0,0,30208,18,8779504618
8247,88358510,563266,88921776,4,0,0,1024,14,5798004790
8248,88366700,780446,89147146,4,0,1,48640,14,8311254288
8249,88374919,696205,89071124,5,0,0,67072,15,2110554985
8250,88417159,730002,89147161,7,0,1,512,18,7925977383
8251,88417859,729317,89147176,7,0,1,3584,18,1019565390
8252,88440899,710519,89151418,7,0,1,6144,18,5091197466
8253,88441369,710034,89151403,5,0,0,13824,15,10697898584
8254,88450740,693692,89144432,7,0,0,134144,18,5375704747
8255,88456430,491546,88947976,4,0,0,512,14,2743322404
8256,88466689,391848,88858537,5,0,0,23552,15,10361600119
8257,88469969,633538,89103507,5,0,0,55296,15,3890315706
8258,88474620,821470,89296090,4,0,1,89600,14,10348885891
8259,88497840,684416,89182256,3,0,0,40448,29,2844151214
8260,88547230,803119,89350349,3,0,0,36352,29,9787308038
8261,88571281,716603,89287884,0,0,0,26112,25,1981565597
8262,88587971,444868,89032839,0,0,0,1024,25,8830749469
8263,88607370,270443,88877813,7,0,0,18432,18,7816396621
8264,88614970,861812,89476782,4,0,1,122880,14,6374798920
8265,88619419,948045,89567464,6,0,1,23040,8,6539473267
8266,88630230,411802,89042032,4,0,0,2048,14,3317992268
8267,88630751,163195,88793946,0,0,0,7168,25,9901263446
8268,88632680,348900,88981580,3,0,0,8192,29,6434889854
8269,88637320,509803,89147123,3,0,0,8704,29,3228931818
8270,88639750,931580,89571330,8,0,1,6144,26,8229141322
8271,88650001,514369,89164370,0,0,0,29184,25,4876173466
8272,88652409,920547,89572956,7,0,1,2560,18,6744410230
8273,88653280,922288,89575568,8,0,1,4096,26,1565302426
8274,88656549,920005,89576554,6,0,1,1536,8,6372487032
8275,88676440,115307,88791747,3,0,0,9728,29,733308036
8276,88696340,885501,89581841,0,0,1,16896,25,8411451368
8277,88708880,377756,89086636,7,0,0,24064,18,5052355644
8278,88725160,857654,89582814,4,0,1,12800,14,8144480458
8279,88738870,642802,89381672,3,0,0,2048,29,999886813
8280,88750120,836723,89586843,8,0,1,1536,26,3049924598
8281,88756319,523578,89279897,5,0,0,159232,15,2623118881
8282,88757299,867412,89624711,6,0,1,3072,8,6913377107
8283,88762619,561711,89324330,5,0,0,31744,15,2346968522
8284,88775990,848736,89624726,8,0,1,1536,26,2233263372
8285,88779910,844919,89624829,4,0,1,17408,14,3260883984
8286,88784880,935944,89720824,4,0,1,69120,14,2778793241
8287,88791120,280339,89071459,4,0,0,1024,14,2738060490
8288,88827500,898981,89726481,8,0,1,2560,26,8022801759
8289,88828209,898747,89726956,6,0,1,7168,8,8654932438
8290,88840619,887003,89727622,6,0,1,1024,8,2665945019
8291,88842449,891074,89733523,6,0,1,19968,8,3514564653
8292,88867010,887580,89754590,4,0,1,12800,14,153090431
8293,88876140,894534,89770674,4,0,1,27648,14,2431052940
8294,88886110,590657,89476767,7,0,0,94720,18,8311562560
8295,88887050,408961,89296011,7,0,0,26624,18,7129055727
8296,88901361,498470,89399831,0,0,0,1024,25,6390030130
8297,88908909,623112,89532021,5,0,0,3072,15,4968384704
8298,88909420,861920,89771340,8,0,1,1024,26,375730856
8299,88912671,575647,89488318,0,0,0,6144,25,7063066442
8300,88916590,856235,89772825,4,0,1,15360,14,2061638077
8301,88939630,420672,89360302,7,0,0,512,18,1602843754
8302,88946529,845153,89791682,6,0,1,5632,8,9647140761
8303,88968070,835634,89803704,8,0,1,14848,26,655615487
8304,88968190,184491,89152681,3,0,0,4096,29,4597810066
8305,88980650,874198,89854848,3,0,1,86528,29,8202633634
8306,88987550,875828,89863378,8,0,1,3072,26,8310257959
8307,88994300,958825,89953125,4,0,1,105472,14,9254322771
8308,89009369,945702,89955071,6,0,1,3072,8,9499784576
8309,89022310,934246,89956556,8,0,1,15360,26,5522718044
8310,89027669,963358,89991027,6,0,1,2560,8,7446936255
8311,89037351,493719,89531070,0,0,0,33280,25,230632756
8312,89047051,577645,89624696,0,0,0,115712,25,6890145956
8313,89051979,343505,89395484,5,0,0,32256,15,4474459810
8314,89072959,918734,89991693,6,0,1,1024,8,6222795829
8315,89092230,937325,90029555,7,0,0,81408,18,8171108995
8316,89096560,263571,89360131,7,0,0,15872,18,8060188254
8317,89100449,893830,89994279,6,0,1,4096,8,3062034792
8318,89104889,451306,89556195,5,0,0,23040,15,3937152462
8319,89122950,876781,89999731,8,0,1,2048,26,6833487487
8320,89123880,878437,90002317,4,0,1,4096,14,4552088403
8321,89127510,914117,90041627,4,0,1,59904,14,7828535526
8322,89127939,319626,89447565,5,0,0,2048,15,6137753256
8323,89144779,907587,90052366,7,0,1,1024,18,9862791553
8324,89152779,908589,90061368,6,0,1,12800,8,80756662
8325,89171991,499771,89671762,0,0,0,23040,25,412160679
8326,89190470,872854,90063324,5,0,1,4608,15,5441470522
8327,89194999,870271,90065270,7,0,1,3072,18,3578441067
8328,89195710,487358,89683068,3,0,0,3584,29,1993766263
8329,89196591,869755,90066346,4,0,1,13312,14,6601639523
8330,89203990,146710,89350700,4,0,0,1024,14,3651953040
8331,89207540,239386,89446926,7,0,0,65024,18,644368943
8332,89228559,842933,90071492,7,0,1,8192,18,6235309153
8333,89230201,896848,90127049,0,0,0,163328,25,9088879140
8334,89232670,904423,90137093,8,0,1,4096,26,9117485679
8335,89234749,902359,90137108,6,0,1,1536,8,1300602564
8336,89249379,198513,89447892,5,0,0,1024,15,10452866732
8337,89265870,393968,89659838,4,0,0,3072,14,5816968497
8338,89269350,457116,89726466,7,0,0,13824,18,2189724241
8339,89270430,866701,90137131,4,0,1,8192,14,6946916288
8340,89281640,855506,90137146,8,0,1,4608,26,7702628191
8341,89286519,351223,89637742,5,0,0,1024,15,999366398
8342,89297450,839711,90137161,3,0,1,16896,29,433478494
8343,89298111,910933,90209044,4,0,1,109568,14,8438808667
8344,89306770,965875,90272645,3,0,1,10240,29,744270652
8345,89314630,511056,89825686,4,0,0,512,14,4575572021
8346,89325841,1065720,90391561,4,0,1,113664,14,2260719418
8347,89361530,273272,89634802,7,0,0,2560,18,5242657737
8348,89364740,1042336,90407076,4,0,1,11776,14,7525971734
8349,89365100,1076849,90441949,4,0,1,30208,14,9175403991
8350,89377190,1201386,90578576,3,0,1,164352,29,1806990393
8351,89378849,1224598,90603447,7,0,1,2048,18,761582948
8352,89385660,1284288,90669948,4,0,1,84992,14,3453455739
8353,89394810,82143,89476953,4,0,0,512,14,2243576266
8354,89437741,699166,90136907,0,0,0,13824,25,638823598
8355,89444779,1226155,90670934,7,0,1,1536,18,8824473193
8356,89449800,1225346,90675146,8,0,1,6656,26,1042724662
8357,89450081,1238070,90688151,4,0,1,40448,14,4217639015
8358,89458040,1245078,90703118,8,0,1,2048,26,10606795575
8359,89471941,1243646,90715587,4,0,1,51200,14,5827178968
8360,89491240,1392336,90883576,4,0,1,241152,14,3917309178
8361,89492541,362284,89854825,0,0,0,49664,25,3402369565
8362,89493880,1390055,90883935,4,0,1,9728,14,10340442219
8363,89502360,787268,90289628,3,0,0,12288,29,6557868345
8364,89523100,538253,90061353,7,0,0,13824,18,5153729899
8365,89526010,510424,90036434,7,0,0,22528,18,2629859368
8366,89528490,1361808,90890298,4,0,1,38400,14,1463154282
8367,89547910,702499,90250409,3,0,0,79872,29,8782248245
8368,89548410,584270,90132680,7,0,0,18432,18,5347039453
8369,89553370,1349853,90903223,8,0,1,9728,26,8378760035
8370,89556280,1359217,90915497,1,0,1,5632,2,7428223060
8371,89562809,1353764,90916573,7,0,1,13312,18,3393688834
8372,89567920,1352200,90920120,5,0,1,2048,15,7838045100
8373,89577460,1343006,90920466,8,0,1,512,26,8380195003
8374,89578230,1342582,90920812,5,0,1,512,15,9471198019
8375,89611929,1309344,90921273,7,0,1,10240,18,9547463365
8376,89620339,341121,89961460,5,0,0,1024,15,8726955568
8377,89620540,1320548,90941088,5,0,1,1536,15,3373955752
8378,89622740,418872,90041612,3,0,0,1024,29,8980321481
8379,89624790,1316313,90941103,4,0,1,4096,14,9181870926
8380,89625070,360691,89985761,3,0,0,512,29,7255466074
8381,89630040,1324732,90954772,4,0,1,19968,14,395851197
8382,89631530,286641,89918171,4,0,0,2560,14,4203384340
8383,89656840,728568,90385408,4,0,0,512,14,8321141310
8384,89656849,480229,90137078,5,0,0,512,15,1333482921
8385,89665970,1290428,90956398,8,0,1,2560,26,7899817378
8386,89683460,1276164,90959624,5,0,1,5120,15,7293486232
8387,89684399,1279731,90964130,9,0,1,7168,17,1634650373
8388,89685250,1279866,90965116,5,0,1,1536,15,10493269427
8389,89688321,902271,90590592,0,0,0,30208,25,6504235329
8390,89703770,1270156,90973926,8,0,1,9728,26,7370348726
8391,89710800,1393485,91104285,4,0,1,120832,14,3034156375
8392,89717910,1389281,91107191,8,0,1,4608,26,9354284081
8393,89722880,448059,90170939,7,0,0,49152,18,9393041113
8394,89724960,240643,89965603,3,0,0,1536,29,8655858026
8395,89750219,187703,89937922,5,0,0,512,15,5100523827
8396,89752570,513703,90266273,4,0,0,512,14,4366876155
8397,89788431,687534,90475965,0,0,0,35328,25,4145671635
8398,89791840,282240,90074080,4,0,0,512,14,841690344
8399,89803280,1356368,91159648,8,0,1,11264,26,2716253109
8400,89803499,1377042,91180541,7,0,1,14336,18,195554545
8401,89809980,231305,90041285,3,0,0,15872,29,1766918537
8402,89833860,594873,90428733,7,0,0,69120,18,9819998611
8403,89839870,1341977,91181847,4,0,1,2048,14,1047405935
8404,89855330,284030,90139360,7,0,0,7168,18,3459861922
8405,89862030,1331068,91193098,5,0,1,5120,15,10549868308
8406,89880909,1318617,91199526,7,0,1,7168,18,10314476603
8407,89887470,627964,90515434,7,0,0,22528,18,3573134078
8408,89893020,1307170,91200190,5,0,1,4096,15,9545859494
8409,89898210,1318737,91216947,5,0,1,2560,15,4782923898
8410,89912260,281821,90194081,7,0,0,56320,18,7051413052
8411,89920240,1296722,91216962,8,0,1,1536,26,502980538
8412,89930921,380303,90311224,0,0,0,43520,25,2775539119
8413,89951220,1265757,91216977,5,0,1,3584,15,5428914478
8414,89969310,1247682,91216992,4,0,1,512,14,5999798647
8415,89978960,1238055,91217015,5,0,1,18432,15,1932336649
8416,89990991,640695,90631686,0,0,0,7680,25,5454802011
8417,90000219,730187,90730406,5,0,0,512,15,3978922820
8418,90037339,156913,90194252,5,0,0,512,15,3791869849
8419,90040269,421237,90461506,5,0,0,1024,15,731033591
8420,90042531,314569,90357100,0,0,0,32768,25,8601765252
8421,90047751,298033,90345784,0,0,0,29696,25,3882306841
8422,90049131,1203925,91253056,4,0,1,10752,14,4885545572
8423,90067980,312665,90380645,7,0,0,5632,18,814147555
8424,90077201,1176111,91253312,4,0,1,9216,14,10159913077
8425,90105070,410699,90515769,4,0,0,1024,14,715592643
8426,90130820,1162099,91292919,8,0,1,512,26,10151521418
8427,90143900,1149378,91293278,5,0,1,9728,15,8772780036
8428,90148150,1150274,91298424,8,0,1,8192,26,6990404812
8429,90154110,279638,90433748,7,0,0,16384,18,4422108086
8430,90159840,186279,90346119,4,0,0,1024,14,4486199405
8431,90167270,1131820,91299090,5,0,1,1024,15,4830625776
8432,90182140,1117616,91299756,8,0,1,1024,26,5130546724
8433,90183271,277900,90461171,0,0,0,27648,25,8261612354
8434,90197189,1105153,91302342,7,0,1,4096,18,10306329692
8435,90201420,340939,90542359,7,0,0,19968,18,5348981888
8436,90205630,1099938,91305568,5,0,1,5120,15,10658132073
8437,90206931,200122,90407053,0,0,0,22528,25,2260210614
8438,90217260,1089486,91306746,8,0,1,13824,26,7388465072
8439,90219859,1090779,91310638,7,0,1,6144,18,7280980540
8440,90250799,1119940,91370739,7,0,1,5120,18,7188715702
8441,90260879,1110526,91371405,7,0,1,1024,18,9893408147
8442,90270680,129494,90400174,7,0,0,6656,18,5571688860
8443,90272131,353046,90625177,0,0,0,18432,25,8100263584
8444,90288719,385959,90674678,5,0,0,1024,15,7491929528
8445,90296740,391396,90688136,3,0,0,40448,29,7301707997
8446,90301940,1070131,91372071,5,0,1,1024,15,7409192274
8447,90302750,144331,90447081,4,0,0,1024,14,6994572496
8448,90305520,1068625,91374145,5,0,1,13824,15,8993609
8449,90310529,235472,90546001,5,0,0,1536,15,6138900481
8450,90317461,228041,90545502,0,0,0,10240,25,4661569793
8451,90325130,303806,90628936,7,0,0,12288,18,4965070389
8452,90325700,1048791,91374491,8,0,1,512,26,2390034656
8453,90327911,250650,90578561,0,0,0,20480,25,1454495604
8454,90338230,1039487,91377717,5,0,1,5120,15,5989128362
8455,90346459,1045415,91391874,7,0,1,2048,18,10557026968
8456,90351960,1041860,91393820,8,0,1,3072,26,371074222
8457,90359099,1035592,91394691,7,0,1,12288,18,7300069295
8458,90364849,1032108,91396957,9,0,1,3584,17,4906551202
8459,90369491,232509,90602000,0,0,0,14848,25,10096477358
8460,90382179,171866,90554045,5,0,0,512,15,3933888382
8461,90395490,1005973,91401463,5,0,1,7168,15,6386889199
8462,90401039,1001410,91402449,9,0,1,1536,17,10649660533
8463,90407420,998575,91405995,5,0,1,5632,15,1951533375
8464,90413009,1045570,91458579,7,0,1,18432,18,4793454850
8465,90415359,1043235,91458594,9,0,1,5632,17,6050196166
8466,90446240,1012369,91458609,8,0,1,8704,26,114745293
8467,90453000,1006903,91459903,5,0,1,512,15,10247281378
8468,90483721,375551,90859272,0,0,0,5632,25,3425999431
8469,90487850,453424,90941274,4,0,0,512,14,4099871073
8470,90488450,971468,91459918,8,0,1,1024,26,6979380142
8471,90510200,949749,91459949,8,0,1,16384,26,329233070
8472,90525580,514210,91039790,7,0,0,42496,18,254800863
8473,90534110,985922,91520032,8,0,1,3584,26,5562812463
8474,90538530,981533,91520063,5,0,1,11264,15,6348495051
8475,90541961,1003792,91545753,2,0,1,17920,9,24261506
8476,90547519,998249,91545768,9,0,1,1536,17,6826552194
8477,90551320,172642,90723962,4,0,0,512,14,953160325
8478,90552511,388562,90941073,0,0,0,12288,25,3802059404
8479,90559520,986263,91545783,8,0,1,1024,26,969621082
8480,90560800,266824,90827624,3,0,0,38400,29,1339412961
8481,90577579,968227,91545806,7,0,1,3072,18,3823250476
8482,90585411,972805,91558216,2,0,1,66048,9,234419551
8483,90602310,557152,91159462,3,0,0,54784,29,41422675
8484,90616319,956934,91573253,9,0,1,3584,17,7125720489
8485,90628560,308754,90937314,3,0,0,33792,29,9258307620
8486,90636330,526864,91163194,4,0,0,512,14,1082220399
8487,90645011,197249,90842260,0,0,0,6656,25,2688966844
8488,90648970,924629,91573599,8,0,1,512,26,4842943615
8489,90689339,431704,91121043,5,0,0,512,15,322283295
8490,90697190,886402,91583592,5,0,1,3584,15,534268251
8491,90704019,881519,91585538,9,0,1,3072,17,7825201064
8492,90706290,951686,91657976,7,0,0,124416,18,7255244353
8493,90708630,749926,91458556,3,0,0,79872,29,10216614922
8494,90710579,877545,91588124,7,0,1,4096,18,9924267536
8495,90722520,866910,91589430,5,0,1,2048,15,7619364691
8496,90737519,854497,91592016,9,0,1,4096,17,6734670097
8497,90742290,234076,90976366,3,0,0,4608,29,2259660645
8498,90747000,869824,91616824,5,0,1,12800,15,1510022276
8499,90750640,411330,91161970,4,0,0,1536,14,9782907490
8500,90753869,191147,90945016,5,0,0,512,15,5162617488
8501,90754400,863410,91617810,8,0,1,1536,26,552503276
8502,90764230,755460,91519690,7,0,0,175104,18,8696457428
8503,90770961,887030,91657991,2,0,1,5120,9,4842964817
8504,90771950,241565,91013515,7,0,0,19456,18,8947903863
8505,90790970,867044,91658014,8,0,1,11776,26,6825739374
8506,90796070,294062,91090132,3,0,0,18944,29,8134364793
8507,90801761,486023,91287784,0,0,0,39936,25,4563176378
8508,90802831,979340,91782171,2,0,1,202240,9,2211018902
8509,90803730,355903,91159633,4,0,0,512,14,8914515649
8510,90825930,959147,91785077,5,0,1,4608,15,10556843839
8511,90858790,358142,91216932,7,0,0,50176,18,2733668968
8512,90859340,931546,91790886,8,0,1,5120,26,1483274687
8513,90877010,913891,91790901,5,0,1,1536,15,2586291368
8514,90883940,167269,91051209,4,0,0,1536,14,5853870849
8515,90914920,827303,91742223,3,0,0,8704,29,41981845
8516,90917799,876636,91794435,7,0,1,8192,18,7482397066
8517,90926341,885378,91811719,2,0,1,64512,9,8377040479
8518,90927280,887960,91815240,8,0,1,3584,26,9210130824
8519,90929069,892160,91821229,7,0,1,2560,18,935787007
8520,90936889,889486,91826375,7,0,1,8192,18,912987242
8521,90943741,889844,91833585,2,0,1,22528,9,3094174925
8522,90963781,470424,91434205,0,0,0,37888,25,3313143587
8523,90969069,868062,91837131,7,0,1,5632,18,8821137389
8524,90971771,560989,91532760,0,0,0,39424,25,3458975243
8525,90978030,253083,91231113,3,0,0,12800,29,1625892861
8526,91004950,833167,91838117,5,0,1,1536,15,9450897760
8527,91006910,513107,91520017,4,0,0,1024,14,4057263093
8528,91008119,589946,91598065,5,0,0,2560,15,2133381950
8529,91023190,176321,91199511,3,0,0,10752,29,9834702174
8530,91038591,803392,91841983,2,0,1,6144,9,5631708575
8531,91040439,801890,91842329,7,0,1,512,18,3206075753
8532,91041379,805730,91847109,9,0,1,5120,17,9165011923
8533,91045030,500708,91545738,7,0,0,11776,18,2721721379
8534,91053369,234898,91288267,5,0,0,1536,15,9761837228
8535,91058089,789686,91847775,9,0,1,1024,17,1295406217
8536,91059521,755704,91815225,0,0,0,10240,25,4993228169
8537,91060710,787411,91848121,5,0,1,512,15,4724033586
8538,91063709,457016,91520725,5,0,0,512,15,1376831992
8539,91084320,768947,91853267,8,0,1,8192,26,7696776966
8540,91093960,448175,91542135,3,0,0,30720,29,6324523134
8541,91094189,196240,91290429,5,0,0,512,15,8486816100
8542,91094820,763734,91858554,8,0,1,17920,26,1547103564
8543,91097180,785722,91882902,3,0,1,25088,29,4013260989
8544,91105290,306645,91411935,3,0,0,12288,29,1614196377
8545,91130060,791842,91921902,3,0,1,69632,29,8700641949
8546,91135039,787209,91922248,7,0,1,512,18,8730256332
8547,91137810,786704,91924514,8,0,1,3584,26,358264985
8548,91142100,835286,91977386,3,0,1,13312,29,7457515051
8549,91155130,823127,91978257,0,0,1,12288,25,3373747389
8550,91156300,822303,91978603,5,0,1,512,15,2252894308
8551,91164739,817730,91982469,7,0,1,6144,18,2907624928
8552,91166500,256146,91422646,7,0,0,17920,18,1983420670
8553,91167061,492372,91659433,0,0,0,4608,25,3820243451
8554,91172149,811306,91983455,7,0,1,1536,18,357770550
8555,91172169,811952,91984121,9,0,1,1024,17,10674521543
8556,91189190,795277,91984467,5,0,1,512,15,5373855187
8557,91192469,328085,91520554,5,0,0,1536,15,9356237432
8558,91209140,779193,91988333,5,0,1,6144,15,8745673387
8559,91216850,772154,91989004,0,0,1,1024,25,1504374427
8560,91216990,468680,91685670,3,0,0,9728,29,10580166489
8561,91241940,514107,91756047,4,0,0,512,14,6610128204
8562,91243140,758194,92001334,5,0,1,1024,15,10523880477
8563,91247559,157227,91404786,5,0,0,1024,15,332387156
8564,91256519,762589,92019108,9,0,1,1536,17,7554724433
8565,91263050,760244,92023294,5,0,1,6656,15,3120211318
8566,91265059,201227,91466286,5,0,0,512,15,5518096159
8567,91267050,768972,92036022,0,0,1,25088,25,9664769042
8568,91267140,768897,92036037,8,0,1,8704,26,6343764707
8569,91267299,278678,91545977,5,0,0,512,15,10316143335
8570,91268850,795033,92063883,0,0,1,45056,25,1663310746
8571,91274351,416638,91690989,0,0,0,17408,25,2214870197
8572,91289589,778010,92067599,7,0,1,2048,18,8125566016
8573,91291910,796392,92088302,3,0,1,26624,29,9447031508
8574,91295639,272389,91568028,5,0,0,1024,15,1751996097
8575,91298120,790197,92088317,8,0,1,1536,26,9203019156
8576,91299580,160292,91459872,7,0,0,4096,18,4215710923
8577,91304909,783423,92088332,6,0,1,512,8,423668449
8578,91307290,788120,92095410,8,0,1,11264,26,9024539696
8579,91325910,433365,91759275,4,0,0,1024,14,5850567252
8580,91378389,718327,92096716,9,0,1,2048,17,9519812710
8581,91379210,722332,92101542,0,0,1,7680,25,5568093590
8582,91384810,740200,92125010,5,0,1,11776,15,1075824021
8583,91388310,769575,92157885,0,0,1,39936,25,2710363873
8584,91391769,771262,92163031,7,0,1,8192,18,7097542405
8585,91411751,338451,91750202,0,0,0,26112,25,8324890733
8586,91422110,155602,91577712,4,0,0,2560,14,9064993479
8587,91446090,719848,92165938,5,0,1,15872,15,9388168224
8588,91450239,718925,92169164,9,0,1,5120,17,3965842095
8589,91452890,312183,91765073,4,0,0,512,14,7385364401
8590,91454530,497381,91951911,7,0,0,64512,18,2238620725
8591,91480339,689811,92170150,7,0,1,1536,18,6824368123
8592,91481561,606718,92088279,0,0,0,31232,25,1460266900
8593,91483160,129329,91612489,7,0,0,3584,18,358735091
8594,91489911,300960,91790871,0,0,0,10752,25,9512270276
8595,91508191,242806,91750997,0,0,0,2560,25,6054571301
8596,91517510,653946,92171456,5,0,1,2048,15,8277777436
8597,91518719,653723,92172442,7,0,1,1536,18,4609954149
8598,91547380,328977,91876357,4,0,0,512,14,1802317151
8599,91549110,349228,91898338,4,0,0,512,14,5823899152
8600,91553049,620571,92173620,7,0,1,13824,18,4051813721
8601,91595590,440417,92036007,7,0,0,20992,18,6318805392
8602,91614519,575283,92189802,9,0,1,10240,17,5350326018
8603,91621940,418651,92040591,3,0,0,14336,29,1855191670
8604,91641740,578012,92219752,1,0,1,16896,2,9294504434
8605,91643991,672369,92316360,0,0,0,34304,25,6584271771
8606,91690160,548223,92238383,1,0,1,2560,2,7303420860
8607,91696800,541598,92238398,5,0,1,5632,15,5684474185
8608,91704709,533704,92238413,9,0,1,10240,17,9990786535
8609,91711519,531976,92243495,9,0,1,36352,17,57045613
8610,91739990,384989,92124979,3,0,0,75776,29,3258321527
8611,91762850,423915,92186765,3,0,0,11776,29,3665716604
8612,91772280,485942,92258222,1,0,1,5120,2,5712448675
8613,91795760,442608,92238368,3,0,0,31744,29,7479080326
8614,91798721,193532,91992253,0,0,0,3072,25,4366572641
8615,91805369,460572,92265941,9,0,1,8704,17,4179487448
8616,91809590,317939,92127529,3,0,0,8192,29,5208947030
8617,91816660,260004,92076664,3,0,0,11776,29,899103623
8618,91835690,200518,92036208,4,0,0,512,14,3685778293
8619,91845541,361728,92207269,0,0,0,27136,25,5377641370
8620,91861570,272180,92133750,4,0,0,512,14,10496868390
8621,91973130,363879,92337009,4,0,0,1536,14,3031286701
8622,91988940,277360,92266300,5,0,1,9728,15,7335741581
8623,91999730,266826,92266556,5,0,1,9216,15,3414026496
8624,92022051,613431,92635482,0,0,0,17408,25,1649254172
8625,92045839,227678,92273517,9,0,1,512,17,3485126186
8626,92054280,219596,92273876,5,0,1,9728,15,210232195
8627,92062610,218304,92280914,1,0,1,4608,2,10220091554
8628,92063240,219620,92282860,5,0,1,3072,15,1121905139
8629,92073240,211246,92284486,1,0,1,2560,2,6769404338
8630,92084760,267227,92351987,3,0,0,7168,29,93384162
8631,92092639,193473,92286112,9,0,1,2560,17,2605466337
8632,92106451,392141,92498592,0,0,0,35328,25,8259952174
8633,92107690,355297,92462987,3,0,0,46592,29,1122549459
8634,92112570,175488,92288058,5,0,1,3072,15,1160184110
8635,92125270,164414,92289684,1,0,1,2560,2,4430212851
8636,92187191,294764,92481955,0,0,0,1024,25,1469009236
8637,92203210,426953,92630163,3,0,0,103424,29,2928607091
8638,92203711,276879,92480590,0,0,0,512,25,8709116596
8639,92221640,245458,92467098,4,0,0,512,14,6528054276
8640,92222860,67388,92290248,1,0,1,10752,2,10637573533
8641,92226050,641089,92867139,3,0,0,60928,29,7159785419
8642,92239121,303739,92542860,0,0,0,1024,25,8360054284
8643,92241851,419746,92661597,2,0,0,18944,9,1366523475
8644,92255629,60746,92316375,9,0,1,3584,17,8057284511
8645,92264389,64131,92328520,9,0,1,4096,17,10179735128
8646,92271250,443411,92714661,3,0,0,67072,29,497458023
8647,92300380,99571,92399951,4,0,0,1024,14,196980729
8648,92303459,28927,92332386,9,0,1,6144,17,8338133431
8649,92329180,409048,92738228,4,0,0,2560,14,8947533751
8650,92365941,453115,92819056,2,0,0,69632,9,2015563625
8651,92367271,458318,92825589,2,0,0,12800,9,6423961203
8652,92372790,5971,92378761,1,0,1,14848,2,1382715165
8653,92373121,288647,92661768,0,0,0,512,25,7313859667
8654,92378011,312904,92690915,0,0,0,512,25,2926188851
8655,92383380,6754,92390134,1,0,1,7168,2,10528705954
8656,92383740,11540,92395280,1,0,1,8192,2,5114896836
8657,92406210,3422,92409632,8,0,1,3584,26,2767238089
8658,92415090,334563,92749653,4,0,0,512,14,5299740556
8659,92416740,7230,92423970,8,0,1,7680,26,10048892436
8660,92418140,6176,92424316,1,0,1,512,2,1739620925
8661,92429469,7230,92436699,6,0,1,7680,8,8390734697
8662,92441430,21572,92463002,8,0,1,8192,26,9807917991
8663,92492160,390046,92882206,3,0,0,33792,29,1502809704
8664,92502630,139522,92642152,3,0,0,4096,29,3018341924
8665,92515991,198849,92714840,0,0,0,512,25,4471326208
8666,92519511,329049,92848560,2,0,0,38400,9,3349097137
8667,92527680,187963,92715643,4,0,0,2560,14,5431239582
8668,92590180,229055,92819235,4,0,0,512,14,938909510
8669,92631489,5520,92637009,6,0,1,1536,8,1879555552
8670,92632401,284801,92917202,0,0,0,1024,25,956737296
8671,92637989,4374,92642363,6,0,1,4608,8,4562529391
8672,92638349,4680,92643029,6,0,1,1024,8,8548380076
8673,92665310,1042,92666352,1,0,1,1024,2,8036293053
8674,92676879,3422,92680301,6,0,1,3584,8,9653134407
8675,92683229,2946,92686175,6,0,1,3072,8,3683965952
8676,92696359,21237,92717596,6,0,1,2048,8,4807430491
8677,92704051,241532,92945583,0,0,0,512,25,5735893177
8678,92731670,263771,92995441,4,0,0,1536,14,3593345557
8679,92735681,333481,93069162,2,0,0,96768,9,7402341087
8680,92753830,2946,92756776,8,0,1,3072,26,8385225116
8681,92757960,337577,93095537,3,0,0,59392,29,5041695320
8682,92784040,2470,92786510,8,0,1,2560,26,2578702920
8683,92786830,309049,93095879,4,0,0,1024,14,4051089140
8684,92806291,19313,92825604,4,0,1,5120,14,8988452986
8685,92824381,8445,92832826,4,0,1,7680,14,5964015971
8686,92831150,3942,92835092,1,0,1,3584,2,3736258978
8687,92832051,35103,92867154,4,0,1,17920,14,9199916853
8688,92848690,19039,92867729,1,0,1,512,2,8329841303
8689,92861500,9717,92871217,1,0,1,4096,2,4489276034
8690,92885761,431351,93317112,2,0,0,70144,9,4362256495
8691,92899430,359045,93258475,3,0,0,80384,29,3392866119
8692,92911389,161377,93072766,5,0,0,2048,15,9994636630
8693,92917680,3898,92921578,8,0,1,4096,26,6816503624
8694,92940570,1042,92941612,8,0,1,1024,26,3198437906
8695,92945839,336414,93282253,5,0,0,1024,15,1710615420
8696,92946521,566,92947087,4,0,1,512,14,8053321064
8697,92961260,244761,93206021,4,0,0,512,14,3636236685
8698,92969889,2470,92972359,6,0,1,2560,8,4312881140
8699,92975650,392846,93368496,3,0,0,39936,29,1461798070
8700,92977981,419097,93397078,0,0,0,2560,25,4118787017
8701,92983129,385709,93368838,5,0,0,1024,15,1803249332
8702,92995751,566,92996317,4,0,1,512,14,3794166722
8703,92997850,261295,93259145,4,0,0,1024,14,1302794285
8704,93000831,3387,93004218,4,0,1,9728,14,8806091344
8705,93006289,1518,93007807,6,0,1,1536,8,2430377505
8706,93010861,247949,93258810,0,0,0,1024,25,10604528985
8707,93037831,31346,93069177,4,0,1,9216,14,3254447982
8708,93046941,138639,93185580,2,0,0,2048,9,646329933
8709,93055971,14265,93070236,4,0,1,1024,14,8121530362
8710,93075881,19671,93095552,4,0,1,9216,14,3071093367
8711,93103541,2946,93106487,4,0,1,3072,14,1177993937
8712,93111751,227492,93339243,0,0,0,2560,25,1498421635
8713,93113591,237649,93351240,2,0,0,5120,9,7774423358
8714,93120830,3128,93123958,8,0,1,9216,26,1985322442
8715,93121159,4046,93125205,6,0,1,1536,8,2903032003
8716,93126761,376416,93503177,2,0,0,38400,9,7438760691
8717,93146281,193133,93339414,0,0,0,512,25,9556839906
8718,93157601,332903,93490504,2,0,0,35840,9,9687206166
8719,93171940,11791,93183731,0,0,1,19456,25,1875056468
8720,93175111,11526,93186637,4,0,1,4608,14,1485171603
8721,93183199,5384,93188583,6,0,1,3072,8,2272724393
8722,93184619,4630,93189249,6,0,1,1024,8,1570423703
8723,93191110,68238,93259348,4,0,0,512,14,7426019163
8724,93191880,125731,93317611,4,0,0,1536,14,6672673135
8725,93204521,3898,93208419,4,0,1,4096,14,424796651
8726,93217361,4937,93222298,4,0,1,12800,14,8943562818
8727,93220479,3445,93223924,6,0,1,2560,8,8294438369
8728,93234229,338945,93573174,5,0,0,2048,15,9658944006
8729,93239530,498835,93738365,3,0,0,61952,29,10164652068
8730,93243719,329626,93573345,5,0,0,512,15,9939884850
8731,93245479,16298,93261777,6,0,1,2560,8,3259424044
8732,93253601,316883,93570484,2,0,0,75264,9,4102461023
8733,93258229,4214,93262443,6,0,1,1024,8,1055938851
8734,93268519,3128,93271647,6,0,1,9216,8,10438094172
8735,93287560,284967,93572527,3,0,0,6656,29,693547418
8736,93289680,588994,93878674,3,0,0,13312,29,5970783548
8737,93297109,21052,93318161,6,0,1,512,8,6590395657
8738,93305341,412405,93717746,0,0,0,512,25,9375268565
8739,93315520,189294,93504814,4,0,0,1024,14,1731525402
8740,93319521,336391,93655912,0,0,0,512,25,4318157696
8741,93321020,2870,93323890,8,0,1,8704,26,9988512958
8742,93329740,3422,93333162,8,0,1,3584,26,5843398766
8743,93344430,282305,93626735,3,0,0,44544,29,1469469679
8744,93353429,15082,93368511,6,0,1,6656,8,5493279861
8745,93362789,13271,93376060,6,0,1,7680,8,5210604438
8746,93372820,209022,93581842,4,0,0,512,14,7787710335
8747,93398571,468061,93866632,2,0,0,88064,9,9593117862
8748,93404300,569782,93974082,3,0,0,186880,29,9965327099
8749,93407870,170900,93578770,4,0,0,512,14,9627956094
8750,93408729,97465,93506194,5,0,0,512,15,6365062154
8751,93415001,170069,93585070,0,0,0,1024,25,1618095758
8752,93418069,1042,93419111,6,0,1,1024,8,8497227946
8753,93424769,107392,93532161,5,0,0,512,15,3010607031
8754,93435840,312220,93748060,3,0,0,31744,29,5370332932
8755,93440061,275461,93715522,0,0,0,2048,25,9920908092
8756,93447231,2946,93450177,4,0,1,3072,14,1285290396
8757,93477031,150039,93627070,0,0,0,1024,25,227987192
8758,93484730,389873,93874603,3,0,0,26112,29,8738600473
8759,93509359,183696,93693055,5,0,0,1024,15,1683679561
8760,93515780,23725,93539505,0,0,1,39424,25,2700289186
8761,93520350,466302,93986652,4,0,0,2048,14,4636896549
8762,93556880,21905,93578785,8,0,1,5632,26,7754220517
8763,93574880,304136,93879016,4,0,0,512,14,1600047264
8764,93592780,43975,93636755,8,0,1,72192,26,9116789529
8765,93605361,286154,93891515,0,0,0,1536,25,7623431763
8766,93630051,9290,93639341,4,0,1,4096,14,8041260046
8767,93648590,230255,93878845,4,0,0,512,14,955171882
8768,93652831,3387,93656218,4,0,1,9728,14,225364335
8769,93661361,313104,93974465,0,0,0,1024,25,1068773420
8770,93661761,254672,93916433,0,0,0,1536,25,10732299330
8771,93668401,3898,93672299,4,0,1,4096,14,9077324292
8772,93695270,52821,93748091,0,0,1,59392,25,9565965319
8773,93702610,321200,94023810,3,0,0,25088,29,511686004
8774,93708101,40005,93748106,4,0,1,18944,14,1604796197
8775,93720101,35690,93755791,4,0,1,8192,14,7143000118
8776,93726151,153409,93879560,0,0,0,1024,25,9525140918
8777,93728221,252131,93980352,0,0,0,1536,25,8651631135
8778,93763950,5712,93769662,0,0,1,14336,25,4115197222
8779,93767791,2857,93770648,4,0,1,1536,14,6396677758
8780,93769939,56674,93826613,5,0,0,1024,15,5544616603
8781,93812030,13083,93825113,8,0,1,22016,26,3707511467
8782,93817791,228886,94046677,0,0,0,2048,25,2817063303
8783,93852400,57166,93909566,0,0,1,49152,25,6462456160
8784,93858351,52495,93910846,4,0,1,14336,14,2058683589
8785,93859800,114680,93974480,8,0,1,38912,26,7593614951
8786,93872010,102493,93974503,8,0,1,31232,26,6833200353
8787,93884971,90618,93975589,4,0,1,1024,14,10047553252
8788,93886711,487220,94373931,2,0,0,81408,9,3373772989
8789,93892091,378391,94270482,0,0,0,512,25,6493975343
8790,93895191,446588,94341779,0,0,0,2560,25,4919196178
8791,93908280,239040,94147320,3,0,0,4096,29,936286348
8792,93910690,354688,94265378,3,0,0,51200,29,8295156683
8793,93915051,61524,93976575,4,0,1,1536,14,5762252157
8794,93923971,52950,93976921,4,0,1,512,14,3234481972
8795,93937470,352787,94290257,3,0,0,4096,29,1533812221
8796,93942210,54414,93996624,0,0,1,34304,25,1766845790
8797,93958940,38657,93997597,0,0,1,12800,25,1997619195
8798,93984820,19293,94004113,8,0,1,23040,26,5676210249
8799,93988459,285013,94273472,5,0,0,1024,15,5683818731
8800,93991810,58695,94050505,8,0,1,90624,26,6106349247
8801,94016060,214737,94230797,4,0,0,512,14,2014813190
8802,94030010,294836,94324846,3,0,0,22016,29,6948113848
8803,94033801,378352,94412153,0,0,0,512,25,2464773398
8804,94046439,230763,94277202,5,0,0,512,15,9551014809
8805,94050960,4850,94055810,1,0,1,5120,2,4940661074
8806,94053930,4146,94058076,0,0,1,3584,25,3434769371
8807,94079671,2470,94082141,4,0,1,2560,14,2007315654
8808,94089390,30491,94119881,8,0,1,49152,26,7149648294
8809,94098511,240435,94338946,2,0,0,46080,9,9669625912
8810,94109920,360780,94470700,4,0,0,512,14,1634864130
8811,94124440,34537,94158977,0,0,1,60416,25,7057620821
8812,94127259,314868,94442127,5,0,0,512,15,9232338162
8813,94139010,390600,94529610,3,0,0,43520,29,3756520855
8814,94146759,353072,94499831,5,0,0,3072,15,1489712209
8815,94156431,3852,94160283,4,0,1,2048,14,1795024159
8816,94162861,176287,94339148,0,0,0,512,25,3953663151
8817,94176621,567726,94744347,2,0,0,265216,9,5586453963
8818,94205801,362819,94568620,0,0,0,2048,25,3228821757
8819,94220129,10241,94230370,9,0,1,16384,17,81755393
8820,94238401,1042,94239443,4,0,1,1024,14,10367585432
8821,94247481,17912,94265393,4,0,1,4096,14,1289408079
8822,94257820,67041,94324861,8,0,1,89088,26,9602318455
8823,94267030,298206,94565236,4,0,0,1024,14,8294256398
8824,94297590,27286,94324876,0,0,1,10240,25,5482065997
8825,94299150,173086,94472236,4,0,0,512,14,2662432264
8826,94306211,18680,94324891,4,0,1,10240,14,10590100464
8827,94310471,229573,94540044,0,0,0,1024,25,6556499698
8828,94314481,24480,94338961,4,0,1,5120,14,753254913
8829,94317620,327794,94645414,4,0,0,512,14,5580009335
8830,94324610,49336,94373946,0,0,1,16896,25,3188870195
8831,94332191,88397,94420588,0,0,0,512,25,7256808972
8832,94336771,225713,94562484,0,0,0,1024,25,4020170921
8833,94361010,16868,94377878,5,0,1,4096,15,3811011347
8834,94368639,14385,94383024,9,0,1,8192,17,5994544771
8835,94371409,12383,94383792,9,0,1,11776,17,1780559802
8836,94439690,304984,94744674,4,0,0,1024,14,1031062923
8837,94466469,7230,94473699,9,0,1,7680,17,6808496480
8838,94480821,1042,94481863,4,0,1,1024,14,9344104414
8839,94504080,254243,94758323,4,0,0,512,14,10373065807
8840,94508089,236812,94744901,5,0,0,512,15,4136050392
8841,94510629,19012,94529641,9,0,1,24064,17,8652678699
8842,94512790,61524,94574314,8,0,1,76800,26,9674861062
8843,94521710,223370,94745080,4,0,0,512,14,3675625108
8844,94526401,125645,94652046,0,0,0,1024,25,474715936
8845,94542281,244478,94786759,0,0,0,1024,25,8340635133
8846,94553589,22031,94575620,9,0,1,2048,17,6172421278
8847,94566629,196212,94762841,5,0,0,1024,15,7143051216
8848,94573509,3097,94576606,9,0,1,1536,17,8383809364
8849,94580029,186358,94766387,5,0,0,1536,15,3990702895
8850,94583580,46471,94630051,0,0,1,80384,25,9145286155
8851,94606480,254068,94860548,4,0,0,512,14,5208255960
8852,94613520,262907,94876427,4,0,0,512,14,4055185879
8853,94617541,209538,94827079,2,0,0,36352,9,8124109182
8854,94655321,566,94655887,4,0,1,512,14,6905806664
8855,94661921,392288,95054209,2,0,0,48640,9,8273179115
8856,94671439,246635,94918074,5,0,0,1024,15,9635279873
8857,94679849,230344,94910193,5,0,0,2048,15,8761059500
8858,94694140,155553,94849693,4,0,0,3584,14,3645790882
8859,94694639,153892,94848531,5,0,0,512,15,8685305490
8860,94712460,38907,94751367,8,0,1,6656,26,4642440420
8861,94714901,199875,94914776,0,0,0,512,25,6899640384
8862,94719559,33434,94752993,9,0,1,2560,17,6267194058
8863,94725611,134766,94860377,2,0,0,24576,9,3679653575
8864,94742310,51799,94794109,8,0,1,79872,26,697666563
8865,94743650,155384,94899034,4,0,0,512,14,8319167796
8866,94757011,199197,94956208,0,0,0,512,25,2212156979
8867,94759051,152819,94911870,0,0,0,1536,25,9574051142
8868,94796231,120393,94916624,0,0,0,512,25,278135003
8869,94803829,571,94804400,9,0,1,512,17,6803285496
8870,94804369,95211,94899580,5,0,0,512,15,6890951821
8871,94822001,6588,94828589,4,0,1,1536,14,6347051396
8872,94827791,226745,95054536,0,0,0,1024,25,4476022964
8873,94839290,75315,94914605,4,0,0,512,14,1504694142
8874,94846809,566,94847375,9,0,1,512,17,4885819171
8875,94854589,359152,95213741,5,0,0,512,15,3086153130
8876,94857959,4166,94862125,9,0,1,1536,17,10158851268
8877,94858881,6568,94865449,4,0,1,4608,14,8147686901
8878,94859191,346952,95206143,0,0,0,512,25,7047880537
8879,94861660,62250,94923910,8,0,1,99328,26,2730683995
8880,94872311,118938,94991249,0,0,0,512,25,6523060378
8881,94873771,346640,95220411,0,0,0,512,25,7786790692
8882,94879870,45013,94924883,1,0,1,12800,2,10044708187
8883,94893960,115275,95009235,4,0,0,1024,14,1952760826
8884,94901640,408488,95310128,4,0,0,512,14,150543472
8885,94903971,27633,94931604,4,0,1,24064,14,7282409306
8886,94914131,291833,95205964,2,0,0,19456,9,2915453853
8887,94915470,22035,94937505,0,0,1,28160,25,2271631205
8888,94919280,18571,94937851,1,0,1,512,2,111218312
8889,94925209,142270,95067479,5,0,0,512,15,3453628321
8890,94926521,273401,95199922,2,0,0,169472,9,6625763228
8891,94930079,206313,95136392,5,0,0,1536,15,1422810163
8892,94948650,13083,94961733,8,0,1,22016,26,8593754158
8893,94955739,405999,95361738,5,0,0,1024,15,9418948502
8894,94956391,184198,95140589,0,0,0,2560,25,73769750
8895,94960810,246003,95206813,4,0,0,512,14,1363616805
8896,94972910,13600,94986510,8,0,1,23040,26,779912341
8897,94995999,2470,94998469,9,0,1,2560,17,5906739825
8898,95000030,209784,95209814,4,0,0,1024,14,4005765719
8899,95005239,13770,95019009,9,0,1,26624,17,5178849762
8900,95042200,223116,95265316,4,0,0,512,14,10121029405
8901,95043220,163406,95206626,4,0,0,1536,14,10216500810
8902,95061589,227265,95288854,5,0,0,1024,15,7089800498
8903,95073649,225026,95298675,5,0,0,512,15,849369355
8904,95083560,20366,95103926,8,0,1,32768,26,6028773076
8905,95107170,92775,95199945,8,0,1,84992,26,2398288427
8906,95111779,88181,95199960,9,0,1,1024,17,2552828643
8907,95113649,294738,95408387,5,0,0,1024,15,9333744231
8908,95115101,84874,95199975,4,0,1,9728,14,617653164
8909,95118699,81291,95199990,9,0,1,2048,17,1655516638
8910,95135390,302728,95438118,4,0,0,512,14,3734316157
8911,95135919,64086,95200005,9,0,1,1024,17,306261072
8912,95157539,56488,95214027,9,0,1,7680,17,3733350568
8913,95164971,70904,95235875,2,0,1,48640,9,7306288250
8914,95176849,167415,95344264,5,0,0,512,15,4189285902
8915,95184409,196726,95381135,5,0,0,2560,15,9093755556
8916,95193469,212087,95405556,5,0,0,2048,15,7125537599
8917,95194789,41342,95236131,9,0,1,9216,17,9341016376
8918,95199101,246310,95445411,0,0,0,2560,25,7801963255
8919,95203511,55102,95258613,2,0,1,51712,9,5250418057
8920,95217831,45288,95263119,2,0,1,7168,9,3017968305
8921,95228281,349133,95577414,2,0,0,55808,9,715306678
8922,95241131,24254,95265385,2,0,1,3584,9,2066537641
8923,95266731,5802,95272533,4,0,1,6144,14,2475723477
8924,95276710,182952,95459662,4,0,0,512,14,1510164955
8925,95278671,1994,95280665,4,0,1,2048,14,3429220421
8926,95280291,10241,95290532,2,0,1,16384,9,2144798896
8927,95298269,3898,95302167,9,0,1,4096,17,6182048410
8928,95343079,93503,95436582,5,0,0,512,15,9442283131
8929,95356231,3422,95359653,4,0,1,3584,14,8055326542
8930,95369671,212741,95582412,0,0,0,512,25,1477204934
8931,95450861,566,95451427,4,0,1,512,14,2339254533
8932,95481019,566,95481585,9,0,1,512,17,2478503038
8933,95544851,11533,95556384,4,0,1,18944,14,3423316286
8934,95586181,5802,95591983,4,0,1,6144,14,8426261443
8935,95589579,210746,95800325,5,0,0,2048,15,6688771341
8936,95639409,56244,95695653,5,0,0,512,15,3601205779
8937,95699579,101355,95800934,5,0,0,1536,15,7848196721
8938,95701379,64983,95766362,5,0,0,512,15,773303801
8939,95735869,3128,95738997,6,0,1,9216,8,3252464978
8940,95753410,210577,95963987,9,0,0,1536,17,3334428459
8941,95768159,3422,95771581,9,0,1,3584,17,9710859214
8942,95769209,43995,95813204,5,0,0,512,15,5530241256
8943,95789139,151727,95940866,5,0,0,512,15,3833580640
8944,95822489,11791,95834280,6,0,1,19456,8,2071098386
8945,95865369,1042,95866411,9,0,1,1024,17,5210852314
8946,95929909,116261,96046170,5,0,0,2560,15,2295207963
8947,95937620,57113,95994733,3,0,1,97792,29,10465248472
8948,95946519,219805,96166324,5,0,0,2048,15,7675604706
8949,95955849,39345,95995194,6,0,1,10240,8,5980546164
8950,95957839,37611,95995450,9,0,1,9216,17,1442740204
8951,95980519,15597,95996116,6,0,1,1024,8,4460123572
8952,95994449,2333,95996782,6,0,1,1024,8,6045850246
8953,96000129,249702,96249831,5,0,0,512,15,9813396552
8954,96007759,566,96008325,6,0,1,512,8,5931261087
8955,96010179,1994,96012173,6,0,1,2048,8,610487235
8956,96010329,4168,96014497,9,0,1,10240,17,8709398877
8957,96034719,2470,96037189,9,0,1,2560,17,3932942158
8958,96047389,1042,96048431,9,0,1,1024,17,7099776209
8959,96059779,204181,96263960,5,0,0,3584,15,889335846
8960,96066800,43975,96110775,3,0,1,72192,29,24091608
8961,96070459,40880,96111339,6,0,1,10752,8,6275439918
8962,96101559,244057,96345616,5,0,0,512,15,9319438205
8963,96142399,1042,96143441,6,0,1,1024,8,2530862038
8964,96149289,94847,96244136,5,0,0,2048,15,4900830571
8965,96153290,53325,96206615,3,0,1,87040,29,8290502119
8966,96153900,53061,96206961,5,0,1,512,15,9356990925
8967,96158310,98642,96256952,3,0,1,129536,29,10075750605
8968,96173889,269705,96443594,5,0,0,28672,15,10369842912
8969,96177029,166385,96343414,5,0,0,4608,15,5416042687
8970,96198529,58577,96257106,6,0,1,8704,8,4862785802
8971,96200990,56270,96257260,5,0,1,8704,15,10558242642
8972,96211080,52895,96263975,5,0,1,21504,15,9690877620
8973,96212190,56566,96268756,8,0,1,16896,26,5109508275
8974,96222309,46908,96269217,6,0,1,10240,8,10214443178
8975,96249439,24924,96274363,9,0,1,8192,17,5812173655
8976,96258389,17600,96275989,9,0,1,2560,17,8032157778
8977,96265710,22950,96288660,3,0,1,37888,29,8738020935
8978,96289880,566,96290446,5,0,1,512,15,6507037269
8979,96290659,5196,96295855,9,0,1,13312,17,5479302605
8980,96298370,3645,96302015,3,0,1,10240,29,1403557151
8981,96317130,566,96317696,5,0,1,512,15,2918649754
8982,96327429,1518,96328947,6,0,1,1536,8,148662437
8983,96368919,90713,96459632,5,0,0,1536,15,5658101806
8984,96413839,5971,96419810,9,0,1,14848,17,9735443254
8985,96417069,286455,96703524,5,0,0,19968,15,7379602491
8986,96418339,5552,96423891,6,0,1,13824,8,9978667053
8987,96419290,7782,96427072,5,0,1,4608,15,3447318167
8988,96446550,2946,96449496,3,0,1,3072,29,3176225118
8989,96462749,1042,96463791,6,0,1,1024,8,6230244668
8990,96476649,1042,96477691,9,0,1,1024,17,738057810
8991,96500220,2470,96502690,5,0,1,2560,15,9849661180
8992,96500530,7273,96507803,3,0,1,7168,29,7185395497
8993,96506480,3904,96510384,5,0,1,10752,15,10443714912
8994,96520410,3645,96524055,5,0,1,10240,15,5601976639
8995,96524189,236120,96760309,5,0,0,14336,15,4384384618
8996,96524869,1042,96525911,6,0,1,1024,8,3040965970
8997,96530119,1518,96531637,9,0,1,1536,17,6891858150
8998,96548639,566,96549205,9,0,1,512,17,7837611729
8999,96568870,2870,96571740,5,0,1,8704,15,10033173151
9000,96591600,3422,96595022,5,0,1,3584,15,4574867104
9001,96611839,1042,96612881,9,0,1,1024,17,9453069903
9002,96647819,159610,96807429,5,0,0,4096,15,5343485927
9003,96676389,2470,96678859,6,0,1,2560,8,3867303479
9004,96691680,33591,96725271,3,0,1,55296,29,8861811987
9005,96696599,30298,96726897,6,0,1,2560,8,5711491803
9006,96700869,134444,96835313,5,0,0,5120,15,9502248304
9007,96713200,18984,96732184,3,0,1,16896,29,5596461720
9008,96721900,10540,96732440,5,0,1,9216,15,2749517666
9009,96737110,3898,96741008,5,0,1,4096,15,8013684142
9010,96740380,5326,96745706,5,0,1,5632,15,7453989623
9011,96772900,566,96773466,5,0,1,512,15,1631310322
9012,96773409,109878,96883287,5,0,0,4096,15,7166795142
9013,96776029,196281,96972310,5,0,0,102400,15,9380963722
9014,96808520,52808,96861328,3,0,1,86016,29,4608700617
9015,96809120,56394,96865514,5,0,1,6656,15,661389441
9016,96820989,45396,96866385,6,0,1,12288,8,9377497890
9017,96858100,8746,96866846,3,0,1,10240,29,995141180
9018,96926629,167086,97093715,5,0,0,25088,15,2741542205
9019,96937429,128536,97065965,5,0,0,10752,15,4594301471
9020,96985210,1042,96986252,5,0,1,1024,15,6772708903
9021,96990520,5326,96995846,3,0,1,5632,29,4698379787
9022,97063419,8816,97072235,6,0,1,6656,8,6336196877
9023,97098980,3387,97102367,5,0,1,9728,15,5267981850
9024,97108289,2470,97110759,6,0,1,2560,8,8964228599
9025,97182809,104232,97287041,5,0,0,21504,15,8413793555
9026,97184139,397958,97582097,5,0,0,81408,15,2636980908
9027,97225710,21141,97246851,3,0,1,34304,29,2011311864
9028,97232700,98423,97331123,8,0,0,512,26,9098614005
9029,97250659,2470,97253129,6,0,1,2560,8,3090317316
9030,97267930,64654,97332584,8,0,1,109056,26,9090016000
9031,97343159,3387,97346546,6,0,1,9728,8,9798934356
9032,97350109,11016,97361125,6,0,1,17920,8,9206206734
9033,97377610,259890,97637500,8,0,0,512,26,3491633955
9034,97380029,1042,97381071,6,0,1,1024,8,9789128182
9035,97400080,3128,97403208,3,0,1,9216,29,10348557523
9036,97420760,128023,97548783,8,0,0,1024,26,3766064385
9037,97428670,44404,97473074,3,0,1,76288,29,4021628147
9038,97431840,167912,97599752,8,0,0,512,26,6673494750
9039,97514750,125069,97639819,8,0,0,1536,26,9696868949
9040,97533059,566,97533625,6,0,1,512,8,2078655741
9041,97548009,2946,97550955,6,0,1,3072,8,174230684
9042,97548400,6823,97555223,1,0,1,15360,2,10166887642
9043,97590670,85624,97676294,8,0,0,512,26,5091191765
9044,97630710,2946,97633656,1,0,1,3072,2,4020645429
9045,97655290,41391,97696681,3,0,1,67072,29,9680761268
9046,97666359,31308,97697667,6,0,1,1536,8,7019189221
9047,97708490,43904,97752394,8,0,0,512,26,10687226388
9048,97718029,10241,97728270,6,0,1,16384,8,9379134434
9049,97718779,14676,97733455,9,0,1,16384,17,3450660339
9050,97745100,41132,97786232,3,0,1,66560,29,10624268512
9051,97758300,33833,97792133,1,0,1,19968,2,8592615368
9052,97769530,178899,97948429,8,0,0,2048,26,485859294
9053,97829540,25187,97854727,8,0,1,45568,26,264444794
9054,97835039,20034,97855073,6,0,1,512,8,9445508974
9055,97835190,50913,97886103,3,0,1,69120,29,1963504617
9056,97840320,47729,97888049,1,0,1,3072,2,306006715
9057,97852029,40206,97892235,6,0,1,6656,8,8226891440
9058,97863790,34346,97898136,3,0,1,28160,29,2885616486
9059,97864370,39155,97903525,3,0,1,25600,29,9788030208
9060,97874600,51038,97925638,3,0,1,67072,29,1588670638
9061,97885149,41795,97926944,6,0,1,2048,8,557341785
9062,97885900,42350,97928250,1,0,1,2048,2,1279417889
9063,97889030,45531,97934561,3,0,1,30208,29,586483542
9064,97889689,45858,97935547,9,0,1,1536,17,4856009790
9065,97890269,47224,97937493,6,0,1,3072,8,8321899423
9066,97895570,65385,97960955,3,0,1,75776,29,10420121335
9067,97895640,75940,97971580,3,0,1,34304,29,3776226766
9068,97919800,72773,97992573,3,0,1,67584,29,7798482165
9069,97920830,279589,98200419,8,0,0,512,26,7665047085
9070,97929409,63830,97993239,9,0,1,1024,17,1039246659
9071,97943150,55990,97999140,1,0,1,28160,2,4619431470
9072,97948930,61654,98010584,8,0,1,46592,26,1478585999
9073,97978609,32961,98011570,6,0,1,1536,8,1882471394
9074,97981889,30667,98012556,6,0,1,1536,8,7729377871
9075,97993180,45766,98038946,8,0,1,74752,26,7362752475
9076,97995720,44711,98040431,3,0,1,15360,29,8743519851
9077,98016579,24211,98040790,6,0,1,9728,8,6315110059
9078,98040499,637,98041136,6,0,1,512,8,5400869138
9079,98045690,23983,98069673,1,0,1,39936,2,6705802073
9080,98096749,6278,98103027,6,0,1,6656,8,6429197172
9081,98108590,11274,98119864,3,0,1,18432,29,578409114
9082,98118870,56854,98175724,1,0,1,97280,2,4668399545
9083,98121410,131175,98252585,8,0,0,1024,26,3836730791
9084,98131080,65535,98196615,1,0,1,67072,2,3620590937
9085,98136160,61633,98197793,3,0,1,13824,29,8360296306
9086,98161160,38016,98199176,3,0,1,14848,29,7072339153
9087,98161239,39883,98201122,9,0,1,3072,17,10293832260
9088,98173749,30279,98204028,9,0,1,4608,17,6812877898
9089,98198660,7954,98206614,3,0,1,4096,29,6466530399
9090,98204279,42424,98246703,6,0,1,69120,8,5572052227
9091,98208179,41430,98249609,6,0,1,4608,8,10313508368
9092,98249239,5454,98254693,9,0,1,13824,17,693505976
9093,98276470,166319,98442789,8,0,0,512,26,5863170483
9094,98282500,6488,98288988,8,0,1,15872,26,7220886853
9095,98283630,9081,98292711,3,0,1,5632,29,7726949680
9096,98290910,20624,98311534,1,0,1,33280,2,1390682468
9097,98291080,333323,98624403,8,0,0,512,26,3702198477
9098,98343670,16096,98359766,8,0,1,31232,26,6724260381
9099,98345960,17992,98363952,3,0,1,6656,29,1115973617
9100,98356639,107738,98464377,6,0,1,179712,8,1819194789
9101,98366969,97767,98464736,6,0,1,9728,8,118587577
9102,98405750,62212,98467962,1,0,1,5120,2,760135035
9103,98418059,54089,98472148,9,0,1,6656,17,2481597954
9104,98445940,43195,98489135,1,0,1,56832,2,91606567
9105,98451209,53889,98505098,6,0,1,59904,8,9278423491
9106,98493890,21526,98515416,1,0,1,32768,2,2385172839
9107,98497359,23651,98521010,9,0,1,18432,17,2111276305
9108,98530480,63708,98594188,1,0,1,103936,2,1562092928
9109,98537370,63539,98600909,1,0,1,24064,2,4984180705
9110,98587410,20015,98607425,1,0,1,31232,2,6295983703
9111,98625770,6488,98632258,1,0,1,15872,2,14628432
9112,98645009,1994,98647003,9,0,1,2048,17,8843728724
9113,98649299,22950,98672249,6,0,1,37888,8,7737348269
9114,98652509,22006,98674515,6,0,1,3584,8,7853526316
9115,98652759,42317,98695076,6,0,1,54272,8,8372626450
9116,98669900,30873,98700773,1,0,1,18944,2,6921517719
9117,98670331,36036,98706367,2,0,1,26624,9,1493608236
9118,98687510,78617,98766127,1,0,1,119808,2,9343332956
9119,98693519,75834,98769353,9,0,1,5120,17,10026063335
9120,98744961,28258,98773219,2,0,1,6144,9,7435163392
9121,98745899,37638,98783537,6,0,1,32768,8,840767152
9122,98755419,32304,98787723,6,0,1,6656,8,5556045813
9123,98786961,32558,98819519,2,0,1,53248,9,5669758182
9124,98794871,61608,98856479,2,0,1,90112,9,9506190913
9125,98841609,101882,98943491,6,0,1,164864,8,9409930440
9126,98851319,119322,98970641,6,0,1,97280,8,9483603843
9127,98859820,126272,98986092,1,0,1,57344,2,1330517625
9128,98869420,137460,99006880,1,0,1,66560,2,10583274298
9129,98874079,133467,99007546,9,0,1,1024,17,1793609266
9130,98905759,102133,99007892,9,0,1,512,17,3530658198
9131,98916290,246413,99162703,8,0,0,1536,26,510721456
9132,98923290,91118,99014408,1,0,1,31232,2,9645256644
9133,98962229,54445,99016674,9,0,1,3584,17,8432927423
9134,98979609,48714,99028323,6,0,1,39424,8,2555297322
9135,98982060,48849,99030909,1,0,1,4096,2,9832653200
9136,98982970,49219,99032189,1,0,1,14336,2,3130216907
9137,98998671,37064,99035735,2,0,1,5632,9,8483928066
9138,99063491,5712,99069203,2,0,1,14336,9,9431745227
9139,99071511,4420,99075931,2,0,1,11776,9,9555128423
9140,99084649,124200,99208849,6,0,1,201728,8,1040367442
9141,99093779,121688,99215467,6,0,1,23552,8,6303859440
9142,99137790,78241,99216031,1,0,1,10752,2,3922946934
9143,99141030,159825,99300855,1,0,1,233984,2,3882045054
9144,99157390,159018,99316408,1,0,1,49664,2,1612380054
9145,99160299,247818,99408117,6,0,1,267264,8,5616825308
9146,99162021,246762,99408783,2,0,1,1024,9,1549672088
9147,99174079,260523,99434602,6,0,1,90624,8,2322858304
9148,99178741,256220,99434961,2,0,1,9728,9,2385654518
9149,99178830,276893,99455723,8,0,0,512,26,8023126976
9150,99207000,157012,99364012,8,0,0,2048,26,10052297832
9151,99208570,232600,99441170,1,0,1,29696,2,3476208979
9152,99215401,226755,99442156,2,0,1,1536,9,8380508782
9153,99289489,155253,99444742,9,0,1,4096,17,4240016542
9154,99356699,89989,99446688,9,0,1,3072,17,4079674012
9155,99359559,87795,99447354,9,0,1,1024,17,1640483223
9156,99363549,84471,99448020,9,0,1,1024,17,7977731722
9157,99383019,67267,99450286,9,0,1,3584,17,3875805327
9158,99535680,237680,99773360,8,0,0,1536,26,4942172176
9159,99559799,13600,99573399,9,0,1,23040,17,10720664038
9160,99581610,215611,99797221,8,0,0,512,26,8500596797
9161,99626089,2470,99628559,9,0,1,2560,17,7414745189
9162,99701449,1994,99703443,9,0,1,2048,17,1206594534
9163,99722990,83870,99806860,8,0,1,139776,26,2679089459
9164,99741190,221197,99962387,8,0,0,1536,26,6191876024
9165,99818949,14029,99832978,9,0,1,27136,17,3916477801
9166,99819929,16915,99836844,9,0,1,6144,17,4670972256
9167,99864299,16613,99880912,9,0,1,32256,17,1830723390
9168,100006410,152795,100159205,8,0,0,512,26,2094891344
9169,100078291,4374,100082665,2,0,1,4608,9,1695175139
9170,100152030,253100,100405130,8,0,0,2048,26,6976335856
9171,100169930,62119,100232049,8,0,0,2560,26,649477367
9172,100197711,7706,100205417,2,0,1,8192,9,3855974894
9173,100232471,4850,100237321,2,0,1,5120,9,5062918945
9174,100239360,199486,100438846,8,0,0,512,26,1139221948
9175,100242931,1518,100244449,2,0,1,1536,9,7849085145
9176,100246840,50672,100297512,8,0,0,2560,26,8366995984
9177,100249229,1042,100250271,9,0,1,1024,17,4357345686
9178,100292881,566,100293447,2,0,1,512,9,8727632315
9179,100298359,3422,100301781,9,0,1,3584,17,8065996289
9180,100304439,4850,100309289,9,0,1,5120,17,8849024174
9181,100309941,3422,100313363,2,0,1,3584,9,8969894745
9182,100337389,3128,100340517,9,0,1,9216,17,6659743034
9183,100376019,2870,100378889,9,0,1,8704,17,9355878817
9184,100422120,171531,100593651,8,0,0,512,26,5239113448
9185,100423890,12308,100436198,8,0,1,20480,26,10181724660
9186,100425629,11235,100436864,9,0,1,1024,17,452305505
9187,100493169,3128,100496297,9,0,1,9216,17,898185771
9188,100502189,4850,100507039,9,0,1,5120,17,2660091516
9189,100537489,6754,100544243,9,0,1,7168,17,3446640635
9190,100559520,47444,100606964,8,0,0,2048,26,4063224413
9191,100618800,248653,100867453,8,0,0,1536,26,5730211145
9192,100640511,1518,100642029,2,0,1,1536,9,9170866743
9193,100654651,12737,100667388,2,0,1,24576,9,3015304264
9194,100657909,10785,100668694,9,0,1,2048,17,403992780
9195,100700500,166470,100866970,8,0,0,1536,26,7641609978
9196,100714669,10499,100725168,9,0,1,16896,17,3443990847
9197,100719131,8623,100727754,2,0,1,4096,9,8986784286
9198,100745449,3128,100748577,9,0,1,9216,17,1828611136
9199,100757250,87562,100844812,8,0,0,512,26,7812404849
9200,100771361,1042,100772403,2,0,1,1024,9,2093789544
9201,100788501,3128,100791629,2,0,1,9216,9,340386310
9202,100815801,4374,100820175,2,0,1,4608,9,5146334766
9203,100830109,4374,100834483,9,0,1,4608,17,5632735863
9204,100834549,1042,100835591,9,0,1,1024,17,3518812491
9205,100875301,1042,100876343,2,0,1,1024,9,6469485728
9206,100924860,65341,100990201,8,0,0,1024,26,10508006802
9207,100958989,5454,100964443,9,0,1,13824,17,9294634749
9208,100981209,1994,100983203,9,0,1,2048,17,4458627146
9209,100989999,4356,100994355,9,0,1,11264,17,10151194118
9210,101031839,2470,101034309,9,0,1,2560,17,8606846025
9211,101044179,1994,101046173,9,0,1,2048,17,10445875912
9212,101050479,3422,101053901,9,0,1,3584,17,6188087703
9213,101051791,3387,101055178,2,0,1,9728,9,534130643
9214,101061190,43904,101105094,8,0,0,512,26,10417713017
9215,101091351,5971,101097322,2,0,1,14848,9,1199839654
9216,101295871,3422,101299293,2,0,1,3584,9,9015529352
9217,101346011,1994,101348005,2,0,1,2048,9,6453934711
9218,101409341,2946,101412287,2,0,1,3072,9,5384314015
9219,101451310,63486,101514796,8,0,0,512,26,4913816221
9220,101460221,3387,101463608,2,0,1,9728,9,2793971341
9221,101473241,3387,101476628,2,0,1,9728,9,199401981
9222,101491171,1042,101492213,2,0,1,1024,9,9836221869
9223,101550861,1518,101552379,2,0,1,1536,9,5743134622
9224,101661791,5802,101667593,2,0,1,6144,9,3393115675
9225,101716090,43904,101759994,8,0,0,512,26,10113122337
9226,101728599,22433,101751032,6,0,1,36864,8,7125082602
9227,101790021,1518,101791539,2,0,1,1536,9,3001592209
9228,101853341,7230,101860571,2,0,1,7680,9,4849315091
9229,101926530,43904,101970434,8,0,0,512,26,9446086745
9230,101934929,566,101935495,9,0,1,512,17,3780165893
9231,101985649,2870,101988519,9,0,1,8704,17,8499035714
9232,102018471,2946,102021417,2,0,1,3072,9,419355153
9233,102056721,5712,102062433,2,0,1,14336,9,6562724089
9234,102066490,47288,102113778,8,0,0,1536,26,2959054434
9235,102081300,48980,102130280,8,0,0,2048,26,2038764547
9236,102093501,4374,102097875,2,0,1,4608,9,8057930816
9237,102117971,3898,102121869,2,0,1,4096,9,9913776853
9238,102137159,2946,102140105,9,0,1,3072,17,9659512952
9239,102154141,4937,102159078,2,0,1,12800,9,9422389697
9240,102186770,43904,102230674,8,0,0,512,26,5310956703
9241,102193960,48980,102242940,9,0,0,2048,17,5212271542
9242,102194909,566,102195475,6,0,1,512,8,9768541985
9243,102200579,3645,102204224,6,0,1,10240,8,2514841243
9244,102218630,90929,102309559,9,0,0,6656,17,4568676511
9245,102245531,4679,102250210,2,0,1,12288,9,10275949951
9246,102278021,2946,102280967,2,0,1,3072,9,2425328522
9247,102299581,1042,102300623,2,0,1,1024,9,3472587804
9248,102312741,3898,102316639,2,0,1,4096,9,8597847725
9249,102353370,36087,102389457,8,0,1,63488,26,9013248777
9250,102429661,3904,102433565,2,0,1,10752,9,8929023772
9251,102453190,42424,102495614,1,0,1,69120,2,1118079203
9252,102465800,123721,102589521,8,0,0,512,26,7300941058
9253,102522350,45325,102567675,8,0,0,512,26,8425238320
9254,102523840,33503,102557343,1,0,1,58368,2,7247374323
9255,102526621,32348,102558969,2,0,1,2560,9,8206131837
9256,102528820,30815,102559635,1,0,1,1024,2,7366204558
9257,102538100,32467,102570567,1,0,1,44032,2,2705544069
9258,102542470,61098,102603568,9,0,0,1536,17,8116787336
9259,102566140,43904,102610044,9,0,0,512,17,2020097378
9260,102612601,6754,102619355,2,0,1,7168,9,5962213401
9261,102694130,47288,102741418,9,0,0,1536,17,7934714545
9262,102721431,4850,102726281,2,0,1,5120,9,9940290132
9263,102729611,4420,102734031,2,0,1,11776,9,3673927530
9264,102750250,127744,102877994,9,0,0,1024,17,6651336208
9265,102803421,7706,102811127,2,0,1,8192,9,10453065346
9266,102813350,54100,102867450,1,0,1,88576,2,3917336103
9267,102903790,201325,103105115,8,0,0,512,26,6044797249
9268,102922270,83391,103005661,9,0,0,1024,17,9651227784
9269,102926250,80791,103007041,8,0,0,512,26,1450540931
9270,102982230,43904,103026134,9,0,0,512,17,2016605144
9271,102987690,43112,103030802,1,0,1,73728,2,7078040304
9272,103009471,22202,103031673,2,0,1,12288,9,8987518678
9273,103029161,3178,103032339,2,0,1,1024,9,6764449231
9274,103031710,45596,103077306,8,0,0,1024,26,360002258
9275,103090451,5802,103096253,2,0,1,6144,9,9336232813
9276,103131571,4420,103135991,2,0,1,11776,9,10147041928
9277,103143650,21399,103165049,1,0,1,34816,2,6248685784
9278,103156180,14668,103170848,1,0,1,19456,2,2569965696
9279,103157081,14433,103171514,2,0,1,1024,9,9263033043
9280,103187590,279770,103467360,9,0,0,114688,17,4077023605
9281,103198030,123135,103321165,9,0,0,46080,17,1657077934
9282,103251771,4850,103256621,2,0,1,5120,9,1811538639
9283,103267360,143126,103410486,9,0,0,14848,17,1264959775
9284,103271590,237650,103509240,8,0,0,70656,26,4942854711
9285,103273471,3422,103276893,2,0,1,3584,9,2920097
9286,103286199,4679,103290878,6,0,1,12288,8,6522411963
9287,103292940,84645,103377585,1,0,1,141312,2,1835302155
9288,103296870,91749,103388619,1,0,1,44544,2,5005568338
9289,103321250,372134,103693384,8,0,0,42496,26,962142102
9290,103326570,368389,103694959,9,0,0,5120,17,3524277873
9291,103328960,302375,103631335,9,0,0,80896,17,7622534846
9292,103332281,60844,103393125,2,0,1,7168,9,8559828678
9293,103350110,204941,103555051,8,0,0,89088,26,3954817707
9294,103351521,46110,103397631,2,0,1,7168,9,9679615601
9295,103390480,204562,103595042,9,0,0,19968,17,7920160371
9296,103394030,75554,103469584,1,0,1,126976,2,854738752
9297,103402381,68189,103470570,2,0,1,1536,9,9988653334
9298,103432390,330136,103762526,8,0,0,14336,26,3156693845
9299,103436791,34125,103470916,2,0,1,512,9,1824191708
9300,103555249,4374,103559623,9,0,1,4608,17,7055037084
9301,103565530,284030,103849560,8,0,0,51712,26,5179426923
9302,103578219,2470,103580689,9,0,1,2560,17,2488417417
9303,103607380,226409,103833789,8,0,0,3584,26,4517767072
9304,103611120,21767,103632887,3,0,1,1536,29,10714320463
9305,103622151,12682,103634833,2,0,1,3072,9,10717906605
9306,103636660,174047,103810707,8,0,0,34816,26,4389709679
9307,103637661,566,103638227,2,0,1,512,9,3471092087
9308,103656631,6754,103663385,2,0,1,7168,9,4404243502
9309,103663160,150058,103813218,8,0,0,8192,26,4816709218
9310,103722009,5326,103727335,9,0,1,5632,17,4219887780
9311,103733010,3898,103736908,3,0,1,4096,29,10297984100
9312,103738950,3898,103742848,3,0,1,4096,29,1178295932
9313,103740869,2325,103743194,9,0,1,512,17,8050853515
9314,103761130,2906,103764036,3,0,1,1536,29,8334975294
9315,103788900,274092,104062992,9,0,0,44032,17,3374482554
9316,103800000,137067,103937067,9,0,0,37888,17,1786112190
9317,103887520,214982,104102502,3,0,0,11264,29,8465350474
9318,103909060,133013,104042073,9,0,0,120320,17,3287759168
9319,103927720,168001,104095721,8,0,0,79360,26,9314963911
9320,103949009,6278,103955287,9,0,1,6656,17,4467751610
9321,103998110,123172,104121282,8,0,0,5120,26,7858146583
9322,104019989,25022,104045011,9,0,1,3072,17,8225110298
9323,104063590,125480,104189070,9,0,0,44544,17,2541448908
9324,104083860,117705,104201565,8,0,0,40960,26,3501575747
9325,104104190,1042,104105232,3,0,1,1024,29,5791599382
9326,104125200,1994,104127194,3,0,1,2048,29,3651049096
9327,104125260,240832,104366092,9,0,0,60416,17,3229766719
9328,104132480,1042,104133522,3,0,1,1024,29,6180622504
9329,104135409,1518,104136927,9,0,1,1536,17,6989388427
9330,104148499,5802,104154301,9,0,1,6144,17,8077011023
9331,104235049,1042,104236091,9,0,1,1024,17,4296556182
9332,104252469,52033,104304502,6,0,1,84480,8,4904941892
9333,104268649,41038,104309687,6,0,1,24576,8,10442165546
9334,104311790,566,104312356,3,0,1,512,29,8542031442
9335,104320669,13600,104334269,6,0,1,23040,8,7350285349
9336,104338820,186712,104525532,8,0,0,55296,26,10734442430
9337,104340030,254409,104594439,8,0,0,23040,26,7663844165
9338,104348809,176738,104525547,6,0,1,242176,8,6245459066
9339,104384679,154116,104538795,6,0,1,83456,8,10638117520
9340,104398279,146110,104544389,6,0,1,18432,8,2514972563
9341,104417200,331952,104749152,8,0,0,18944,26,10205494751
9342,104428490,117845,104546335,3,0,1,3072,29,4272696527
9343,104431089,116117,104547206,6,0,1,12288,8,25462941
9344,104450760,108095,104558855,8,0,1,47616,26,10570204231
9345,104459009,100512,104559521,9,0,1,1024,17,7775039505
9346,104481359,135803,104617162,6,0,1,194048,8,7877905875
9347,104533500,324265,104857765,8,0,0,11264,26,9643159291
9348,104541300,392334,104933634,2,0,0,70656,9,7777321989
9349,104572990,335254,104908244,9,0,0,50176,17,7889234292
9350,104582360,75193,104657553,9,0,0,1536,17,2296983947
9351,104596209,22336,104618545,9,0,1,14848,17,7742008632
9352,104600879,34795,104635674,6,0,1,60928,8,8117533172
9353,104604049,33110,104637159,9,0,1,15360,17,1590412327
9354,104610149,90127,104700276,9,0,1,128000,17,381488859
9355,104627539,89007,104716546,6,0,1,53248,8,2223076594
9356,104646300,72512,104718812,3,0,1,3584,29,7445289387
9357,104685989,49298,104735287,6,0,1,54272,8,4905233036
9358,104717070,341896,105058966,8,0,0,30720,26,7918587447
9359,104737309,137079,104874388,6,0,1,226816,8,1630685948
9360,104797010,357477,105154487,9,0,0,26112,17,5026203675
9361,104851310,352335,105203645,9,0,0,19968,17,10352038229
9362,104851399,39566,104890965,6,0,1,54784,8,1532893663
9363,104858950,308344,105167294,2,0,0,41984,9,3698014880
9364,104992000,2946,104994946,1,0,1,3072,2,5954263191
9365,105012770,346877,105359647,9,0,0,72192,17,510915375
9366,105018190,271109,105289299,9,0,0,22528,17,5024931980
9367,105038910,20071,105058981,1,0,1,20480,2,9787074411
9368,105041390,27187,105068577,1,0,1,41984,2,4474602006
9369,105117180,302270,105419450,9,0,0,87552,17,9748474270
9370,105130749,52033,105182782,6,0,1,84480,8,1145738630
9371,105148789,35069,105183858,9,0,1,13312,17,2186912108
9372,105158210,305048,105463258,9,0,0,68608,17,4660726137
9373,105175380,9554,105184934,1,0,1,13312,2,2061149911
9374,105206549,41132,105247681,9,0,1,66560,17,3443503944
9375,105214360,279606,105493966,8,0,0,8704,26,7764829035
9376,105220110,271174,105491284,8,0,0,35840,26,6743328062
9377,105268940,373399,105642339,8,0,0,48128,26,9469639965
9378,105299450,22433,105321883,1,0,1,36864,2,10668644513
9379,105307520,286732,105594252,8,0,0,46080,26,3771318633
9380,105317389,4853,105322242,6,0,1,9728,8,7652618544
9381,105320510,259687,105580197,9,0,0,30208,17,173989115
9382,105329709,29953,105359662,6,0,1,36864,8,3791003903
9383,105378089,41408,105419497,9,0,1,59392,17,8631095039
9384,105392469,70804,105463273,6,0,1,53760,8,3775348645
9385,105392980,704365,106097345,9,0,0,165376,17,731219451
9386,105400280,162399,105562679,8,0,0,10752,26,8431033397
9387,105411660,182763,105594423,8,0,0,512,26,3759718563
9388,105414080,65067,105479147,8,0,1,70656,26,3378831027
9389,105415239,76060,105491299,6,0,1,34816,8,5048128244
9390,105454970,319751,105774721,8,0,0,21504,26,1052346963
9391,105470840,342057,105812897,8,0,0,23552,26,2573827325
9392,105478280,197444,105675724,9,0,0,21504,17,8615452557
9393,105517950,356911,105874861,8,0,0,8704,26,1930287795
9394,105650470,450977,106101447,8,0,0,9728,26,3803002142
9395,105656200,390718,106046918,8,0,0,261120,26,7102026346
9396,105668800,293339,105962139,8,0,0,19456,26,1265155444
9397,105677400,438890,106116290,8,0,0,48640,26,2696963865
9398,105729320,369132,106098452,9,0,0,3584,17,7412402736
9399,105783869,13512,105797381,9,0,1,26112,17,6340634548
9400,105805159,13083,105818242,9,0,1,22016,17,4875325504
9401,105874779,13415,105888194,9,0,1,22528,17,2550682865
9402,105905449,56705,105962154,9,0,1,90624,17,4526143915
9403,105934130,271347,106205477,9,0,0,54784,17,9182570189
9404,105969250,287221,106256471,9,0,0,14336,17,5553579042
9405,105976020,267351,106243371,9,0,0,26624,17,6726229198
9406,105978310,327269,106305579,9,0,0,11776,17,5695132886
9407,106007020,552929,106559949,9,0,0,104448,17,2246584275
9408,106024860,181256,106206116,9,0,0,2048,17,3548445966
9409,106058800,442022,106500822,8,0,0,120832,26,9628035036
9410,106101560,402241,106503801,9,0,0,9728,17,4803373075
9411,106177090,216659,106393749,8,0,0,19968,26,4755598700
9412,106221470,128913,106350383,9,0,0,20480,17,8052412918
9413,106223520,342528,106566048,9,0,0,19968,17,5031838966
9414,106225100,141229,106366329,8,0,0,35840,26,9477397883
9415,106229630,189295,106418925,8,0,0,13824,26,5166304831
9416,106344400,119591,106463991,9,0,0,22528,17,10363105906
9417,106363830,210969,106574799,8,0,0,28672,26,3808898724
9418,106365630,242777,106608407,8,0,0,33280,26,8985365491
9419,106384790,288993,106673783,9,0,0,86528,17,2025731021
9420,106450830,234509,106685339,9,0,0,21504,17,8733291572
9421,106564630,157417,106722047,9,0,0,20992,17,2288746170
9422,106585120,184813,106769933,9,0,0,71168,17,4308024805
9423,106589290,225674,106814964,9,0,0,25088,17,5512367093
9424,106669100,19220,106688320,8,0,1,28160,26,2152607225
9425,106751010,112043,106863053,9,0,0,15872,17,10044400666
9426,106832070,96305,106928375,8,0,0,17408,26,437667619
9427,106840739,105670,106946409,9,0,1,175616,17,2778442478
9428,106866819,80154,106946973,9,0,1,10752,17,2717537821
9429,106886660,115570,107002230,8,0,0,25600,26,7542731312
9430,106902079,61471,106963550,9,0,1,54784,17,6829547865
9431,106905169,64590,106969759,9,0,1,21504,17,2978651291
9432,106978390,190399,107168789,8,0,0,2048,26,526997581
9433,106983400,248263,107231663,9,0,0,53760,17,3177246399
9434,107017249,87488,107104737,9,0,1,146944,17,5409351876
9435,107059220,68750,107127970,8,0,0,7168,26,6305767142
9436,107073220,298322,107371542,9,0,0,122368,17,2737932930
9437,107085540,290579,107376119,9,0,0,14848,17,2627803626
9438,107103500,173121,107276621,8,0,0,13824,26,8534969451
9439,107110050,354703,107464753,9,0,0,43008,17,8374465360
9440,107195619,36059,107231678,9,0,1,59904,17,9498721827
9441,107278220,202247,107480467,9,0,0,12800,17,4132655976
9442,107305569,65988,107371557,9,0,1,64000,17,10137446781
9443,107306860,64712,107371572,3,0,1,1024,29,8820540816
9444,107355229,71848,107427077,9,0,1,82432,17,5410858888
9445,107402629,30145,107432774,9,0,1,27136,17,3236980442
9446,107414530,393569,107808099,8,0,0,130048,26,261823745
9447,107439789,55821,107495610,9,0,1,95232,17,4797954923
9448,107447850,320610,107768460,8,0,0,90624,26,4427356794
9449,107475180,139939,107615119,9,0,0,18944,17,4051283828
9450,107486340,12816,107499156,3,0,1,5632,29,6972203807
9451,107504850,414272,107919122,8,0,0,86528,26,3595728629
9452,107512999,3422,107516421,9,0,1,3584,17,3204637765
9453,107532620,307830,107840450,8,0,0,27648,26,6885232850
9454,107544510,183398,107727908,9,0,0,12288,17,3986256731
9455,107610110,10327,107620437,3,0,1,5632,29,6159741991
9456,107632260,177750,107810010,8,0,0,6144,26,9388318274
9457,107645540,167621,107813161,9,0,0,10240,17,196812853
9458,107675540,217203,107892743,9,0,0,41984,17,8587236081
9459,107701600,228769,107930369,9,0,0,36864,17,10355043566
9460,107748859,69136,107817995,6,0,1,5120,8,6742670468
9461,107755210,66331,107821541,3,0,1,5632,29,8030687190
9462,107755429,95012,107850441,9,0,1,59392,17,9401811217
9463,107761090,187949,107949039,8,0,0,6656,26,10438575633
9464,107763850,86937,107850787,3,0,1,512,29,572710917
9465,107803169,58038,107861207,9,0,1,33280,17,7483445996
9466,107809850,381064,108190914,8,0,0,88064,26,10571330084
9467,107821880,51078,107872958,1,0,1,48128,2,5107182059
9468,107825290,51854,107877144,3,0,1,6656,29,184248398
9469,107828729,101671,107930400,6,0,1,105984,8,8082473056
9470,107890970,139959,108030929,8,0,0,30208,26,2488349031
9471,107894970,69436,107964406,1,0,1,59392,2,4238289618
9472,107930609,33951,107964560,9,0,1,8704,17,5455921087
9473,107949740,573556,108523296,9,0,0,76288,17,6569045947
9474,107950259,24823,107975082,6,0,1,33792,8,3271463176
9475,107971019,7609,107978628,9,0,1,5632,17,188798566
9476,107980280,2470,107982750,1,0,1,2560,2,9059819357
9477,107990430,4374,107994804,3,0,1,4608,29,8847947049
9478,108002920,2470,108005390,3,0,1,2560,29,4149020766
9479,108032769,10757,108043526,9,0,1,17408,17,2299281150
9480,108035400,399566,108434966,9,0,0,14848,17,5947202622
9481,108050920,314997,108365917,8,0,0,107008,26,337547664
9482,108061590,202417,108264007,8,0,0,512,26,4225406181
9483,108062779,14287,108077066,6,0,1,27648,8,8297136706
9484,108075019,4313,108079332,9,0,1,3584,17,105302871
9485,108084400,2870,108087270,3,0,1,8704,29,10082513933
9486,108110740,423039,108533779,9,0,0,34304,17,6585555279
9487,108122010,110646,108232656,8,0,0,7168,26,194213003
9488,108131650,288755,108420405,9,0,0,35328,17,5521106075
9489,108169249,27369,108196618,9,0,1,14336,17,8399497981
9490,108202650,14029,108216679,1,0,1,27136,2,3967216138
9491,108215250,12995,108228245,1,0,1,25088,2,523122970
9492,108217960,87657,108305617,1,0,1,134144,2,5742782935
9493,108225870,96529,108322399,1,0,1,55808,2,9301071310
9494,108229970,102747,108332717,1,0,1,32768,2,2866656190
9495,108235879,130053,108365932,9,0,1,31232,17,4366376597
9496,108240759,125196,108365955,6,0,1,54272,8,5438961943
9497,108272330,93640,108365970,1,0,1,30208,2,9515998921
9498,108283299,95195,108378494,9,0,1,62464,17,2171609180
9499,108344230,130636,108474866,9,0,0,23040,17,10482647981
9500,108387830,3898,108391728,3,0,1,4096,29,3176629443
9501,108425860,359792,108785652,8,0,0,30720,26,6128430673
9502,108433970,7283,108441253,1,0,1,6656,2,2671997273
9503,108434620,6992,108441612,3,0,1,9728,29,195736163
9504,108458030,16851,108474881,3,0,1,24576,29,936158730
9505,108464310,111040,108575350,8,0,0,3072,26,5161572502
9506,108509920,25812,108535732,3,0,1,2048,29,4155947520
9507,108514570,21508,108536078,3,0,1,512,29,8232000521
9508,108554810,249182,108803992,9,0,0,3072,17,5588268543
9509,108593999,10499,108604498,9,0,1,16896,17,1543156703
9510,108601950,24242,108626192,1,0,1,40448,2,2627242579
9511,108647820,23466,108671286,1,0,1,38912,2,7460815123
9512,108650449,44847,108695296,9,0,1,62464,17,4056802911
9513,108693651,126489,108820140,1,0,0,512,2,5055259581
9514,108702819,1042,108703861,9,0,1,1024,17,3877504212
9515,108725570,248622,108974192,9,0,0,28160,17,3503961470
9516,108729250,348686,109077936,9,0,0,28160,17,10413321750
9517,108755470,61641,108817111,1,0,1,99840,2,3700766392
9518,108764829,58081,108822910,9,0,1,19456,17,3622898993
9519,108781910,66921,108848831,1,0,1,91136,2,6183284226
9520,108792249,61767,108854016,9,0,1,16384,17,536856204
9521,108797120,113154,108910274,8,0,0,8704,26,4083446945
9522,108804079,60562,108864641,9,0,1,42496,17,1021183404
9523,108818690,615208,109433898,8,0,0,307712,26,9855628822
9524,108861061,336203,109197264,1,0,0,1024,2,8165059074
9525,108873689,33333,108907022,9,0,1,54784,17,1620673204
9526,108876550,451233,109327783,9,0,0,38912,17,5090365435
9527,108903900,535184,109439084,8,0,0,16896,26,1851382195
9528,108914790,4420,108919210,1,0,1,11776,2,10730621542
9529,108951950,192748,109144698,8,0,0,1024,26,9812928523
9530,108952869,21338,108974207,9,0,1,21504,17,10294759740
9531,108976770,6754,108983524,1,0,1,7168,2,4871394407
9532,108984229,25704,109009933,9,0,1,46592,17,7902146941
9533,109000151,263032,109263183,1,0,0,1024,2,1751522413
9534,109007750,447642,109455392,8,0,0,52224,26,599609015
9535,109010650,259454,109270104,9,0,0,8192,17,2728756498
9536,109041630,201514,109243144,8,0,0,7168,26,10625101022
9537,109046590,64395,109110985,1,0,1,108544,2,1206688688
9538,109078481,192522,109271003,1,0,0,512,2,3946636963
9539,109099020,76071,109175091,1,0,1,128000,2,1739393991
9540,109102430,104330,109206760,1,0,1,102400,2,5697181079
9541,109103739,118472,109222211,9,0,1,57344,17,10541387646
9542,109103880,184351,109288231,1,0,1,163840,2,4501913439
9543,109105460,419478,109524938,8,0,0,38400,26,4946200532
9544,109119540,346163,109465703,8,0,0,33792,26,6237644843
9545,109158060,156604,109314664,1,0,1,93696,2,6461716801
9546,109170081,269338,109439419,1,0,0,1024,2,1523749213
9547,109193270,512470,109705740,8,0,0,36864,26,2914601067
9548,109194940,404955,109599895,8,0,0,5120,26,10421258893
9549,109195070,495290,109690360,9,0,0,128000,17,2336661786
9550,109222030,429307,109651337,9,0,0,111616,17,2937912022
9551,109229560,750273,109979833,9,0,0,156672,17,3139903601
9552,109229671,698365,109928036,1,0,0,1536,2,2739223542
9553,109234420,199493,109433913,1,0,1,85504,2,5147113723
9554,109240059,199375,109439434,9,0,1,158208,17,1113338512
9555,109243080,196369,109439449,1,0,1,19968,2,7439804730
9556,109259180,765668,110024848,9,0,0,31744,17,3693289804
9557,109288541,180837,109469378,1,0,0,512,2,6519225898
9558,109291441,399262,109690703,1,0,0,1024,2,5334578025
9559,109315280,587345,109902625,9,0,0,69632,17,6299176481
9560,109372939,98694,109471633,9,0,1,14848,17,2180232481
9561,109396559,97522,109494081,9,0,1,43008,17,10552054014
9562,109400149,107036,109507185,6,0,1,43008,8,5331164558
9563,109467200,933042,110400242,8,0,0,49152,26,1912128583
9564,109491351,366855,109858206,1,0,0,512,2,2271320008
9565,109515440,499721,110015161,8,0,0,54272,26,10547330215
9566,109523999,32222,109556221,9,0,1,50688,17,1807149370
9567,109535990,341078,109877068,9,0,0,12800,17,2537579965
9568,109565970,642645,110208615,9,0,0,101376,17,9542935917
9569,109582200,414105,109996305,9,0,0,17920,17,6552934022
9570,109600950,6754,109607704,3,0,1,7168,29,3058901281
9571,109615340,373907,109989247,8,0,0,30208,26,4961168145
9572,109640481,406096,110046577,1,0,0,512,2,3503654510
9573,109644129,80199,109724328,9,0,1,55296,17,9613855887
9574,109650890,377873,110028763,9,0,0,12800,17,4166866964
9575,109682089,78304,109760393,9,0,1,86016,17,10629826377
9576,109684561,295451,109980012,1,0,0,512,2,4546174525
9577,109684590,548102,110232692,9,0,0,22016,17,5570094915
9578,109690909,97357,109788266,9,0,1,89088,17,568381476
9579,109695621,409958,110105579,1,0,0,1024,2,9870631484
9580,109716930,71682,109788612,3,0,1,512,29,5994950395
9581,109740241,188884,109929125,1,0,0,1024,2,566146041
9582,109751750,339366,110091116,9,0,0,37888,17,10382408706
9583,109759970,31228,109791198,3,0,1,4096,29,10112304125
9584,109773790,153763,109927553,8,0,0,7680,26,1410052943
9585,109778120,474938,110253058,9,0,0,28160,17,89864595
9586,109928920,295934,110224854,8,0,0,53248,26,2054630619
9587,109933020,292949,110225969,8,0,0,3584,26,9840305737
9588,109940110,339900,110280010,9,0,0,10752,17,3169755264
9589,109949600,40648,109990248,3,0,1,1024,29,7361946343
9590,109980390,15930,109996320,1,0,1,3072,2,10556531340
9591,110012230,20899,110033129,3,0,1,4608,29,7375848166
9592,110047040,238757,110285797,8,0,0,18944,26,5881772827
9593,110058800,1518,110060318,1,0,1,1536,2,10439021089
9594,110075901,220507,110296408,1,0,0,512,2,118167891
9595,110077301,155570,110232871,1,0,0,512,2,1951222072
9596,110115380,221486,110336866,9,0,0,6144,17,3432279634
9597,110121020,202712,110323732,8,0,0,22528,26,10723434148
9598,110131510,7230,110138740,3,0,1,7680,29,8492428273
9599,110132500,22798,110155298,1,0,1,34816,2,962518692
9600,110136710,188753,110325463,8,0,0,5632,26,1338423575
9601,110158590,3898,110162488,3,0,1,4096,29,4530187911
9602,110189750,293395,110483145,9,0,0,21504,17,2029481851
9603,110202731,154783,110357514,1,0,0,1024,2,5931607278
9604,110222800,46667,110269467,1,0,1,64512,2,3306157571
9605,110234180,51640,110285820,1,0,1,41984,2,6906033441
9606,110258840,230248,110489088,8,0,0,2048,26,8310153286
9607,110265811,145774,110411585,1,0,0,2048,2,3786289995
9608,110273750,356574,110630324,8,0,0,8192,26,3006673553
9609,110274180,11655,110285835,1,0,1,17408,2,9995205808
9610,110276150,160339,110436489,8,0,0,29696,26,8283513243
9611,110301600,1994,110303594,3,0,1,2048,29,123848496
9612,110348130,4374,110352504,3,0,1,4608,29,2914877821
9613,110359790,1994,110361784,3,0,1,2048,29,7479887511
9614,110367500,83958,110451458,1,0,1,136704,2,108516233
9615,110380470,149444,110529914,8,0,0,512,26,3769825434
9616,110385370,68674,110454044,3,0,1,4096,29,4961450390
9617,110405310,50040,110455350,3,0,1,2048,29,67744536
9618,110417650,41886,110459536,3,0,1,6656,29,101023764
9619,110419910,66059,110485969,1,0,1,93696,2,8798989738
9620,110465360,20955,110486315,3,0,1,512,29,3276102496
9621,110491990,13858,110505848,1,0,1,23552,2,5273334285
9622,110510610,3645,110514255,3,0,1,10240,29,9778611900
9623,110527520,11274,110538794,3,0,1,18432,29,5926214637
9624,110542320,3422,110545742,1,0,1,3584,2,6391040053
9625,110555541,242891,110798432,1,0,0,512,2,5268915193
9626,110574150,566,110574716,3,0,1,512,29,4048318803
9627,110578860,193820,110772680,9,0,0,59392,17,236217516
9628,110596651,176676,110773327,1,0,0,2048,2,4872209309
9629,110601251,132274,110733525,1,0,0,512,2,2434626369
9630,110602970,234852,110837822,9,0,0,7680,17,875258357
9631,110622341,178511,110800852,1,0,0,2560,2,8845560273
9632,110626061,276558,110902619,1,0,0,11264,2,8610840849
9633,110637340,3898,110641238,3,0,1,4096,29,1540900538
9634,110683020,15837,110698857,1,0,1,30720,2,2808926923
9635,110731541,208227,110939768,1,0,0,14336,2,6523648703
9636,110736161,125480,110861641,1,0,0,12288,2,3109692428
9637,110766781,234009,111000790,1,0,0,27136,2,5527334887
9638,110778861,112172,110891033,1,0,0,2560,2,5273036504
9639,110787030,3904,110790934,3,0,1,10752,29,3944438133
9640,110794970,94947,110889917,9,0,0,13824,17,9347346257
9641,110812250,276849,111089099,9,0,0,13312,17,1013325538
9642,110838731,206296,111045027,1,0,0,70144,2,1154101567
9643,110842459,47473,110889932,6,0,1,77312,8,225976196
9644,110847360,42587,110889947,3,0,1,512,29,4583583312
9645,110883541,177790,111061331,1,0,0,53248,2,4627524315
9646,110889440,4397,110893837,3,0,1,4096,29,7721507218
9647,110947810,355083,111302893,9,0,0,70144,17,9945108326
9648,110962530,2470,110965000,3,0,1,2560,29,9457513511
9649,110969950,262687,111232637,9,0,0,35840,17,9257344569
9650,110972000,226582,111198582,9,0,0,52736,17,2872947423
9651,111013330,3128,111016458,3,0,1,9216,29,6701386469
9652,111022970,22072,111045042,3,0,1,6656,29,6291415799
9653,111078580,3898,111082478,3,0,1,4096,29,6561721900
9654,111097140,4374,111101514,3,0,1,4608,29,333696836
9655,111163331,214640,111377971,1,0,0,88576,2,3098814639
9656,111185010,150565,111335575,9,0,0,36352,17,2771814014
9657,111246981,147994,111394975,1,0,0,13312,2,5128891106
9658,111323950,234950,111558900,9,0,0,77824,17,10670695733
9659,111340990,194183,111535173,9,0,0,121856,17,2495035445
9660,111361021,199454,111560475,1,0,0,5120,2,1095408381
9661,111380791,185783,111566574,1,0,0,19968,2,3947859219
9662,111424780,20366,111445146,8,0,1,32768,26,10435226426
9663,111425420,228486,111653906,9,0,0,46592,17,2488121519
9664,111470460,106113,111576573,9,0,0,32768,17,5199573395
9665,111575561,201934,111777495,1,0,0,68096,2,5092761456
9666,111584430,46471,111630901,8,0,1,80384,26,2815974524
9667,111609321,59730,111669051,1,0,0,2560,2,7647638124
9668,111659441,318946,111978387,1,0,0,41472,2,9546193357
9669,111670430,203163,111873593,9,0,0,136192,17,1635021219
9670,111696750,80760,111777510,8,0,1,103936,26,6226618983
9671,111756200,256705,112012905,9,0,0,57856,17,5592083027
9672,111777391,166880,111944271,1,0,0,5120,2,8955058371
9673,111788080,85528,111873608,8,0,1,134656,26,2196557578
9674,111816211,470671,112286882,1,0,0,199168,2,4711377093
9675,111903491,175295,112078786,1,0,0,5632,2,4286749768
9676,111929511,144392,112073903,1,0,0,104448,2,7493619692
9677,111948500,135579,112084079,9,0,0,14848,17,5183567492
9678,111953400,25002,111978402,8,0,1,35840,26,7004166264
9679,111983871,311169,112295040,1,0,0,25088,2,2812302645
9680,111996540,23629,112020169,8,0,1,7680,26,4988846643
9681,112005920,404639,112410559,9,0,0,68608,17,5038515363
9682,112008051,293712,112301763,1,0,0,22016,2,3620724425
9683,112013150,14744,112027894,8,0,1,20992,26,9392752399
9684,112019990,53936,112073926,1,0,1,59904,2,8543859679
9685,112025450,395069,112420519,9,0,0,24064,17,4952190980
9686,112034040,151140,112185180,9,0,0,5120,17,10458480230
9687,112053560,20901,112074461,8,0,1,512,26,3395221122
9688,112084430,5712,112090142,1,0,1,14336,2,3264793410
9689,112089180,23983,112113163,1,0,1,39936,2,10080790905
9690,112104581,223135,112327716,1,0,0,44544,2,4342950180
9691,112135771,253846,112389617,1,0,0,78336,2,7026734019
9692,112151180,200037,112351217,9,0,0,15872,17,5795538890
9693,112151830,34367,112186197,1,0,1,56832,2,4053406699
9694,112175720,111653,112287373,9,0,0,1536,17,4808040072
9695,112183640,278039,112461679,9,0,0,23040,17,2268722189
9696,112201210,13600,112214810,8,0,1,23040,26,7834867071
9697,112207889,575734,112783623,6,0,0,512,8,668116748
9698,112227441,355791,112583232,1,0,0,10752,2,10282873855
9699,112238340,89407,112327747,1,0,1,42496,2,10537809139
9700,112257530,132110,112389640,1,0,1,90112,2,8484702129
9701,112294720,115854,112410574,1,0,1,62976,2,7069409594
9702,112300040,110557,112410597,8,0,1,17408,26,5352177389
9703,112333870,129900,112463770,1,0,1,90112,2,9371723440
9704,112421840,42903,112464743,1,0,1,12800,2,8506412486
9705,112422401,84962,112507363,1,0,0,8192,2,4938420046
9706,112447589,174453,112622042,6,0,0,1536,8,9053354121
9707,112450591,233205,112683796,1,0,0,108544,2,9863339076
9708,112455561,340805,112796366,1,0,0,25088,2,9265022452
9709,112480480,3128,112483608,1,0,1,9216,2,3681434303
9710,112493710,195873,112689583,9,0,0,18944,17,8157234538
9711,112507259,336033,112843292,6,0,0,512,8,2383329263
9712,112523870,4937,112528807,1,0,1,12800,2,2287578297
9713,112573491,269615,112843106,1,0,0,19968,2,1227101371
9714,112582330,1936,112584266,1,0,1,1024,2,1001956272
9715,112615270,74360,112689630,8,0,1,76288,26,6738462162
9716,112621321,227758,112849079,1,0,0,18944,2,3914259580
9717,112633630,145324,112778954,9,0,0,13312,17,1503616233
9718,112643550,46095,112689645,8,0,1,28160,26,7277272086
9719,112645250,170106,112815356,9,0,0,5632,17,68623791
9720,112647899,432423,113080322,6,0,0,512,8,4392041274
9721,112650449,43107,112693556,6,0,1,4096,8,4975783066
9722,112656230,70763,112726993,8,0,1,63488,26,472534761
9723,112690591,484309,113174900,1,0,0,82944,2,7033926668
9724,112694550,35989,112730539,1,0,1,5632,2,4915677570
9725,112705049,41145,112746194,6,0,1,50176,8,4685263635
9726,112712240,226440,112938680,9,0,0,3584,17,206004998
9727,112715720,32100,112747820,1,0,1,2560,2,3987986326
9728,112718290,106828,112825118,8,0,1,161792,26,4744028123
9729,112720809,104463,112825272,6,0,1,8704,8,5182824569
9730,112742260,85278,112827538,1,0,1,3584,2,7898057855
9731,112752439,90682,112843121,6,0,1,38912,8,845535869
9732,112759519,89575,112849094,6,0,1,28672,8,5140119909
9733,112774850,75525,112850375,8,0,1,16896,26,7097621459
9734,112783771,178179,112961950,1,0,0,13312,2,1013914578
9735,112796390,249315,113045705,9,0,0,13824,17,3718191079
9736,112796690,59484,112856174,8,0,1,19456,26,4092643501
9737,112801319,56481,112857800,9,0,1,2560,17,5200901596
9738,112814069,190017,113004086,6,0,1,310784,8,3400947795
9739,112818920,189672,113008592,1,0,1,7168,2,2588176619
9740,112822199,196813,113019012,6,0,1,41472,8,9512748518
9741,112822700,365323,113188023,9,0,0,2560,17,8372582537
9742,112829230,435929,113265159,9,0,0,18944,17,6909664291
9743,112845669,349277,113194946,6,0,0,1024,8,8468542291
9744,112900649,214629,113115278,6,0,0,512,8,10659388834
9745,112901300,121258,113022558,1,0,1,5632,2,7136972040
9746,112906370,122601,113028971,8,0,1,22528,26,4142067449
9747,112917081,409992,113327073,1,0,0,14336,2,6889097241
9748,112919289,272585,113191874,6,0,0,1024,8,2065204039
9749,112948880,82677,113031557,1,0,1,4096,2,8372201039
9750,112954560,80863,113035423,1,0,1,6144,2,8223391278
9751,112977679,251606,113229285,6,0,0,512,8,6913365569
9752,112978269,306490,113284759,6,0,0,512,8,2510433952
9753,113005279,35290,113040569,6,0,1,8192,8,10671371696
9754,113015190,26045,113041235,1,0,1,11264,2,5406977345
9755,113029439,255851,113285290,6,0,0,512,8,9064134406
9756,113032179,368241,113400420,6,0,0,1024,8,7308513676
9757,113060199,10757,113070956,6,0,1,17408,8,9359281452
9758,113060219,185153,113245372,6,0,0,1536,8,882137318
9759,113068969,211365,113280334,6,0,0,512,8,9657149785
9760,113073919,61641,113135560,6,0,1,99840,8,9111641098
9761,113084940,51081,113136021,8,0,1,10240,26,7204975113
9762,113086291,435364,113521655,1,0,0,47616,2,5441695076
9763,113086689,179310,113265999,6,0,0,1536,8,453851695
9764,113090900,309185,113400085,9,0,0,47104,17,4500978516
9765,113109070,240245,113349315,9,0,0,512,17,5125578527
9766,113123419,204362,113327781,6,0,0,1536,8,7555701279
9767,113133780,338635,113472415,9,0,0,36352,17,8396883289
9768,113147989,355048,113503037,6,0,0,1536,8,10150648553
9769,113154231,290681,113444912,1,0,0,35840,2,3726906566
9770,113177710,1994,113179704,1,0,1,2048,2,2917535629
9771,113180739,231760,113412499,6,0,0,1024,8,9494767754
9772,113237190,1518,113238708,1,0,1,1536,2,7164207021
9773,113271159,46729,113317888,6,0,1,80896,8,1451573164
9774,113278180,40476,113318656,1,0,1,11776,2,7351858145
9775,113287079,40009,113327088,6,0,1,26112,8,8321062381
9776,113297170,277060,113574230,8,0,0,27648,26,6672948463
9777,113313609,186220,113499829,6,0,0,512,8,5082463145
9778,113327039,15620,113342659,6,0,1,30208,8,2583741530
9779,113334711,202883,113537594,1,0,0,5632,2,2809436721
9780,113366370,1518,113367888,1,0,1,1536,2,6332648519
9781,113386339,218985,113605324,6,0,0,1536,8,102341988
9782,113390600,31487,113422087,8,0,1,35328,26,1231953820
9783,113397479,302350,113699829,6,0,0,512,8,10371937447
9784,113480430,209163,113689593,8,0,0,61440,26,9059165184
9785,113500189,106145,113606334,6,0,0,512,8,5797212322
9786,113505679,15991,113521670,6,0,1,19456,8,5163607317
9787,113551859,1518,113553377,6,0,1,1536,8,8394398031
9788,113553179,193423,113746602,6,0,0,512,8,1998505092
9789,113565920,316522,113882442,8,0,0,45568,26,7994662327
9790,113578699,2470,113581169,6,0,1,2560,8,8622339334
9791,113586929,31783,113618712,6,0,1,51712,8,2363141946
9792,113639380,176255,113815635,8,0,0,122368,26,173392004
9793,113683600,218104,113901704,9,0,0,38912,17,5853933881
9794,113713960,254368,113968328,8,0,0,96256,26,3304715492
9795,114074040,188432,114262472,8,0,0,162304,26,8512106750
9796,114119920,200396,114320316,8,0,0,28160,26,8451693805
9797,114126570,136541,114263111,8,0,0,2048,26,7436770425
9798,114189310,101660,114290970,8,0,0,33792,26,9642101682
9799,114280629,40791,114321420,9,0,1,49152,17,2575651509
9800,114304170,389074,114693244,8,0,0,219648,26,8399951250
9801,114307680,188334,114496014,8,0,0,15360,26,3098432706
9802,114336819,1042,114337861,9,0,1,1024,17,738878387
9803,114369989,14545,114384534,9,0,1,28160,17,3064939456
9804,114389770,170917,114560687,8,0,0,12800,26,3919467988
9805,114417499,33503,114451002,9,0,1,58368,17,3620915478
9806,114460279,23378,114483657,9,0,1,41984,17,5646613939
9807,114524160,184636,114708796,8,0,0,16384,26,10278854980
9808,114624520,74384,114698904,8,0,0,14848,26,5153556723
9809,114657950,91394,114749344,8,0,0,1024,26,812290499
9810,114757310,113984,114871294,8,0,0,74240,26,9044900795
9811,114808700,142514,114951214,8,0,0,36864,26,5517851426
9812,114926639,36604,114963243,9,0,1,64512,17,3021737218
9813,114958199,8270,114966469,9,0,1,5120,17,1323034898
9814,115006059,46729,115052788,9,0,1,80896,17,82228197
9815,115057269,84387,115141656,9,0,1,140800,17,7145643324
9816,115163940,112342,115276282,8,0,0,12800,26,456198044
9817,115185700,162849,115348549,8,0,0,38912,26,6365657882
9818,115206379,43628,115250007,9,0,1,74752,17,8372453966
9819,115229150,158904,115388054,8,0,0,18944,26,2372537319
9820,115271259,5038,115276297,9,0,1,11264,17,3887227134
9821,115332499,2470,115334969,9,0,1,2560,17,4035810843
9822,115335890,192671,115528561,8,0,0,5632,26,2021519525
9823,115358400,133248,115491648,8,0,0,6656,26,4780442680
9824,115461820,107265,115569085,8,0,0,32768,26,903843404
9825,115492520,205799,115698319,8,0,0,168448,26,3261039541
9826,115556979,16354,115573333,9,0,1,31744,17,9587709627
9827,115591850,333346,115925196,8,0,0,142848,26,6841790886
9828,115698459,35312,115733771,9,0,1,61952,17,3347313073
9829,115727669,13858,115741527,9,0,1,23552,17,9695739090
9830,115731019,29321,115760340,9,0,1,46080,17,658789513
9831,115738760,113100,115851860,8,0,0,16384,26,532871968
9832,115775679,23120,115798799,9,0,1,41472,17,10601653875
9833,115794940,320552,116115492,8,0,0,22528,26,8870005093
9834,115804729,3128,115807857,9,0,1,9216,17,3344502652
9835,115877829,47382,115925211,9,0,1,48128,17,8725135198
9836,115916820,121156,116037976,8,0,0,18432,26,3026760690
9837,115922629,28303,115950932,9,0,1,46592,17,919047204
9838,115954249,102658,116056907,9,0,1,166400,17,5988363696
9839,115973739,130236,116103975,9,0,1,159744,17,4322366490
9840,116041590,277520,116319110,8,0,0,25600,26,3816187284
9841,116067460,243835,116311295,8,0,0,37376,26,9554059292
9842,116088300,275406,116363706,8,0,0,15360,26,8691305139
9843,116115659,2470,116118129,9,0,1,2560,17,9332254014
9844,116160000,97883,116257883,8,0,0,13312,26,6615212183
9845,116352650,199560,116552210,8,0,0,45056,26,7523192540
9846,116402949,22950,116425899,9,0,1,37888,17,8620525103
9847,116410999,38080,116449079,9,0,1,60416,17,4217141343
9848,116430650,86688,116517338,8,0,0,11264,26,2617144366
9849,116468529,41391,116509920,9,0,1,67072,17,3248017737
9850,116496739,23703,116520442,9,0,1,41984,17,5969037249
9851,116550730,234086,116784816,8,0,0,41472,26,1628206143
9852,116587789,20366,116608155,9,0,1,32768,17,754222571
9853,116640880,98720,116739600,8,0,0,29184,26,955951462
9854,116669710,176429,116846139,8,0,0,6144,26,3844546258
9855,116678549,13253,116691802,9,0,1,25600,17,7981367213
9856,116678579,106252,116784831,9,0,1,158720,17,5885017144
9857,116719510,245532,116965042,8,0,0,33792,26,2155366113
9858,116797200,245260,117042460,8,0,0,59904,26,1759828443
9859,116833350,173974,117007324,8,0,0,10240,26,1155075200
9860,117006179,36296,117042475,9,0,1,52736,17,3860546202
9861,117053469,71507,117124976,9,0,1,115712,17,7940499198
9862,117119689,31266,117150955,9,0,1,50688,17,3334497102
9863,117142549,10032,117152581,9,0,1,2560,17,3049337848
9864,117180689,13858,117194547,9,0,1,23552,17,6264613452
9865,117195409,31266,117226675,9,0,1,50688,17,5557096021
9866,117226640,158022,117384662,8,0,0,15872,26,6719918188
9867,117359910,156738,117516648,8,0,0,31232,26,1664935783
9868,117369380,52364,117421744,8,0,0,3072,26,7339814039
9869,117382329,5195,117387524,9,0,1,8704,17,10327385475
9870,117398800,239722,117638522,8,0,0,86528,26,500311885
9871,117458199,64912,117523111,9,0,1,109568,17,1385625124
9872,117509469,16228,117525697,9,0,1,4096,17,3397177297
9873,117536799,3645,117540444,9,0,1,10240,17,8269972487
9874,117574669,10757,117585426,9,0,1,17408,17,5371011955
9875,117579729,14838,117594567,9,0,1,28160,17,8543177848
9876,117779539,43200,117822739,9,0,1,70656,17,7426669179
9877,117783790,45260,117829050,8,0,1,30208,26,4177776114
9878,117790819,44644,117835463,9,0,1,22528,17,3678880406
9879,117800790,109493,117910283,8,0,1,151040,26,1851741242
9880,117819919,101091,117921010,9,0,1,34816,17,5969960532
9881,117822640,319250,118141890,8,0,0,15872,26,850704361
9882,117833800,88081,117921881,8,0,1,12288,26,932352270
9883,117859140,74185,117933325,8,0,1,46592,26,10329728771
9884,117882790,342233,118225023,8,0,0,55808,26,4520766001
9885,117889330,271295,118160625,8,0,0,61440,26,10487767340
9886,117923119,16927,117940046,9,0,1,24064,17,4110818153
9887,117943199,147462,118090661,9,0,1,243712,17,6607854067
9888,117964660,217594,118182254,8,0,1,267264,26,4580611135
9889,117968860,224531,118193391,8,0,1,36864,26,9315333200
9890,118005800,191457,118197257,8,0,1,6144,26,6756401553
9891,118036259,161766,118198025,9,0,1,11776,17,4852297037
9892,118081070,122140,118203210,8,0,1,24576,26,4556558314
9893,118106449,118589,118225038,9,0,1,39936,17,3417521547
9894,118125979,99074,118225053,9,0,1,31232,17,8582472498
9895,118137350,94649,118231999,8,0,1,33792,26,424105125
9896,118152059,80606,118232665,9,0,1,1024,17,10006063969
9897,118205709,28032,118233741,9,0,1,13312,17,5636984753
9898,118236020,5454,118241474,8,0,1,13824,26,7211230883
9899,118276349,2470,118278819,9,0,1,2560,17,2794556811
9900,118367140,132774,118499914,8,0,1,215040,26,3959381897
9901,118374979,125191,118500170,9,0,1,9216,17,2001660144
9902,118403340,223590,118626930,8,0,0,124928,26,3927468636
9903,118412290,295611,118707901,8,0,0,27648,26,10318740084
9904,118430990,299157,118730147,8,0,0,3584,26,8238212522
9905,118492980,317966,118810946,8,0,0,47616,26,8370548665
9906,118515480,25704,118541184,8,0,1,46592,26,7405442527
9907,118634550,3904,118638454,8,0,1,10752,26,8181419910
9908,118675959,4850,118680809,9,0,1,5120,17,8104803953
9909,118719039,6754,118725793,9,0,1,7168,17,4617066847
9910,118739499,5712,118745211,9,0,1,14336,17,2647076059
9911,118749450,142377,118891827,8,0,0,7168,26,10005554190
9912,118756670,71766,118828436,8,0,1,116224,26,1148736432
9913,118865989,566,118866555,9,0,1,512,17,8203424132
9914,118873829,4850,118878679,9,0,1,5120,17,3034559864
9915,118929789,1042,118930831,9,0,1,1024,17,5317078223
9916,119008899,4679,119013578,9,0,1,12288,17,9537232919
9917,119067909,4850,119072759,9,0,1,5120,17,8176993037
9918,119070510,113004,119183514,8,0,0,31232,26,6787019903
9919,119088379,2470,119090849,9,0,1,2560,17,7652587490
9920,119192580,131410,119323990,8,0,0,44544,26,4842089411
9921,119239850,148898,119388748,8,0,0,24064,26,570378270
9922,119608570,71444,119680014,8,0,0,10240,26,6722085388
9923,119668620,112268,119780888,8,0,0,68608,26,6735148587
9924,119734690,100880,119835570,8,0,0,31232,26,6076415947
9925,119901640,102128,120003768,8,0,0,35328,26,1478154552
9926,119914390,77744,119992134,8,0,0,10752,26,2058487429
9927,119997990,122250,120120240,8,0,0,82432,26,6026848914
9928,120039350,135220,120174570,8,0,0,32768,26,8761019614
9929,120079730,185992,120265722,8,0,0,32256,26,4924374143
9930,120089630,113182,120202812,8,0,0,53760,26,6083046491
9931,120136410,129795,120266205,8,0,0,1536,26,5605128076
9932,120209150,76052,120285202,8,0,0,10240,26,111664585
9933,120297900,85292,120383192,8,0,0,15360,26,38893435
9934,120311890,154462,120466352,8,0,0,126976,26,119729496
9935,120362010,1518,120363528,8,0,1,1536,26,3312563630
9936,120576650,112580,120689230,8,0,0,69632,26,5018609172
9937,120601530,109606,120711136,8,0,0,49664,26,3862460857
9938,120739400,45752,120785152,8,0,0,1536,26,4014532604
9939,120770580,32816,120803396,8,0,1,53760,26,3448009961
9940,120869520,59600,120929120,8,0,0,6656,26,8290378905
9941,120960820,104780,121065600,8,0,0,44032,26,6736797230
9942,120995250,56052,121051302,8,0,0,1024,26,8348427653
9943,121132350,54056,121186406,8,0,0,3584,26,2234767650
9944,121414220,43904,121458124,8,0,0,512,26,3679527879
9945,121452930,47288,121500218,8,0,0,1536,26,6768569465
9946,121811500,48980,121860480,8,0,0,2048,26,3615370778
9947,121911740,43904,121955644,8,0,0,512,26,4494395573
9948,121925010,21916,121946926,8,0,1,35840,26,1435021210
9949,121929790,101257,122031047,8,0,0,1024,26,9197159883
9950,121973170,48980,122022150,8,0,0,2048,26,10680193088
9951,121987130,44088,122031218,8,0,0,512,26,4111943700
9952,122009040,46925,122055965,8,0,0,1024,26,4807403821
9953,122029480,43904,122073384,8,0,0,512,26,4846441735
9954,122178360,43904,122222264,8,0,0,512,26,310315709
9955,122321600,47444,122369044,8,0,0,2048,26,1992276607
9956,122523850,43904,122567754,8,0,0,512,26,1303208640
9957,122711950,43904,122755854,8,0,0,512,26,2055795518
9958,122747060,45596,122792656,8,0,0,1024,26,6983244547
9959,122954410,47600,123002010,8,0,0,2560,26,7914591738
9960,123289320,45596,123334916,8,0,0,1024,26,8169244966
9961,123368490,43904,123412394,8,0,0,512,26,9898238526
9962,123630140,48980,123679120,8,0,0,2048,26,6323025400
9963,123654050,45596,123699646,8,0,0,1024,26,9748004670
9964,123708030,43904,123751934,8,0,0,512,26,3438322757
9965,123852870,43904,123896774,8,0,0,512,26,10489579074
9966,124141230,48980,124190210,8,0,0,2048,26,8764141131
9967,124162470,46202,124208672,8,0,0,1024,26,6845125336
9968,124263740,43904,124307644,8,0,0,512,26,8726322558
9969,124272780,43904,124316684,8,0,0,512,26,9143323460
9970,124310540,49836,124360376,8,0,0,512,26,6121160869
9971,124403860,45596,124449456,8,0,0,1024,26,1758363230
9972,124549280,45596,124594876,8,0,0,1024,26,10693352398
9973,124594710,49138,124643848,8,0,0,2048,26,4018590277
9974,124636100,77363,124713463,8,0,1,130560,26,2430957781
9975,124752400,144344,124896744,8,0,0,2560,26,231144589
9976,124777630,72799,124850429,8,0,1,118272,26,10640298392
9977,125010940,13341,125024281,8,0,1,22528,26,8668267849
9978,125043020,44662,125087682,8,0,1,76800,26,9573915908
9979,125087510,96062,125183572,8,0,1,160256,26,6044770896
9980,125134640,114796,125249436,8,0,1,183296,26,9015950812
9981,125139180,146751,125285931,8,0,1,117248,26,733467544
9982,125184520,117374,125301894,8,0,1,51712,26,4492581176
9983,125196930,111480,125308410,8,0,1,23040,26,9408919227
9984,125227730,65581,125293311,8,0,0,512,26,723097061
9985,125243000,101341,125344341,8,0,0,512,26,2910353610
9986,125265040,47236,125312276,8,0,1,6144,26,1690810907
9987,125314870,215184,125530054,8,0,0,512,26,10528111409
9988,125381500,36604,125418104,8,0,1,64512,26,8194066580
9989,125466330,35312,125501642,8,0,1,61952,26,4779730057
9990,125513630,15579,125529209,8,0,1,30208,26,10371093173
9991,125580960,130359,125711319,8,0,0,1024,26,5478634231
9992,125652450,4374,125656824,8,0,1,4608,26,4036791893
9993,125717340,10499,125727839,8,0,1,16896,26,8042631573
9994,125745140,53237,125798377,8,0,1,90112,26,7057803030
9995,125766170,99851,125866021,8,0,0,512,26,7088528944
9996,125786960,85334,125872294,8,0,0,512,26,5576260032
9997,125801770,49146,125850916,8,0,0,2048,26,9943492549
9998,125802550,197879,126000429,8,0,0,2048,26,8465051779
9999,125885900,103659,125989559,8,0,0,1024,26,7304488673
